,iteration,visit,item_id_list,visitor_id,reward,total_reward,fraction_relevant,percentage_overlap_rating,percentage_overlap_like
0,0,0,[273 286 215  22 301],450,4,4,4.0,0.0,20.0
1,0,1,[286 215  22 301 273],655,1,5,2.5,0.0,20.0
2,0,2,[357 183  12 197 135],457,5,10,3.3333333333333335,0.0,0.0
3,0,3,[357  12 197 135 183],693,3,13,3.25,0.0,0.0
4,0,4,[357  12 135 197 286],639,2,15,3.0,0.0,20.0
5,0,5,[135 357  12 286 301],655,2,17,2.8333333333333335,0.0,20.0
6,0,6,[135 357  12 286  22],450,4,21,3.0,0.0,20.0
7,0,7,[357 135  22  12 286],11,4,25,3.125,0.0,20.0
8,0,8,[151 258 111 173  97],798,2,27,3.0,0.0,0.0
9,0,9,[258 173 357 135  22],535,2,29,2.9,0.0,0.0
10,0,10,[258 173 357 135 286],151,5,34,3.090909090909091,0.0,20.0
11,0,11,[258 173 357 135 286],450,4,38,3.1666666666666665,0.0,20.0
12,0,12,[258 173 357 286 135],11,5,43,3.3076923076923075,0.0,20.0
13,0,13,[258 173 357 286 135],151,5,48,3.4285714285714284,0.0,20.0
14,0,14,[258 173 357 286 135],450,4,52,3.466666666666667,0.0,20.0
15,0,15,[258 173 357 286 135],629,5,57,3.5625,0.0,20.0
16,0,16,[258 173 357 286 135],535,2,59,3.4705882352941178,0.0,20.0
17,0,17,[258 173 357 286 135],11,5,64,3.5555555555555554,0.0,20.0
18,0,18,[258 173 357 286 135],450,4,68,3.5789473684210527,0.0,20.0
19,0,19,[258 173 357 286 135],11,5,73,3.65,0.0,20.0
20,0,20,[258 173 357 286 135],450,4,77,3.6666666666666665,0.0,20.0
21,0,21,[258 173 357 286 135],450,4,81,3.6818181818181817,0.0,20.0
22,0,22,[258 173 357 286  22],629,5,86,3.739130434782609,0.0,20.0
23,0,23,[258 173 357 286  22],344,2,88,3.6666666666666665,0.0,20.0
24,0,24,[173 258 357 286 135],535,2,90,3.6,0.0,20.0
25,0,25,[173 258 357 286  22],796,4,94,3.6153846153846154,0.0,20.0
26,0,26,[173 258 357 286  22],11,5,99,3.6666666666666665,0.0,20.0
27,0,27,[173 258 357 286  22],535,2,101,3.607142857142857,0.0,20.0
28,0,28,[173 258 357 286  22],535,2,103,3.5517241379310347,0.0,20.0
29,0,29,[173 258 357 286 135],629,5,108,3.6,0.0,20.0
30,0,30,[173 258 357 286 135],151,5,113,3.6451612903225805,0.0,20.0
31,0,31,[173 258 357 286 135],535,2,115,3.59375,0.0,20.0
32,0,32,[ 88 161 508 496 132],269,3,118,3.5757575757575757,20.0,0.0
33,0,33,[173 132 496 508 258],535,5,123,3.6176470588235294,20.0,0.0
34,0,34,[173 132 496 508 258],344,4,127,3.6285714285714286,20.0,0.0
35,0,35,[127 294  15   4 269],655,1,128,3.5555555555555554,0.0,20.0
36,0,36,[127 496 173 508 132],269,4,132,3.5675675675675675,20.0,20.0
37,0,37,[475  69   8 215 100],655,0,132,3.473684210526316,0.0,20.0
38,0,38,[127 496 508 132 173],269,4,136,3.4871794871794872,20.0,20.0
39,0,39,[127 496 508 132 173],344,5,141,3.525,20.0,20.0
40,0,40,[ 25 215 187 496 235],716,3,144,3.5121951219512195,20.0,0.0
41,0,41,[127 496 508  25 132],344,5,149,3.5476190476190474,20.0,20.0
42,0,42,[357 216 403 568  82],655,2,151,3.511627906976744,0.0,0.0
43,0,43,[127 496 508  25 216],344,5,156,3.5454545454545454,20.0,20.0
44,0,44,[  4 211 181  82 143],450,3,159,3.533333333333333,0.0,0.0
45,0,45,[127 132  25 496 181],716,5,164,3.5652173913043477,20.0,20.0
46,0,46,[  8 313 588  71 173],344,3,167,3.5531914893617023,0.0,0.0
47,0,47,[597 357  12 135 300],11,2,169,3.5208333333333335,0.0,0.0
48,0,48,[127 132  25 496 181],344,4,173,3.5306122448979593,20.0,20.0
49,0,49,[127 132  25 496 216],344,5,178,3.56,20.0,20.0
50,0,50,[127 132  25 496 216],450,4,182,3.5686274509803924,20.0,20.0
51,0,51,[127 132 496 216 211],321,4,186,3.576923076923077,20.0,20.0
52,0,52,[143 132 588 496 216],450,5,191,3.6037735849056602,20.0,0.0
53,0,53,[143 132 588 496 216],330,5,196,3.6296296296296298,20.0,0.0
54,0,54,[127 282 496   7 153],280,4,200,3.6363636363636362,20.0,20.0
55,0,55,[508 143   7 496 216],269,2,202,3.607142857142857,20.0,0.0
56,0,56,[202 568 176 196  25],344,5,207,3.6315789473684212,0.0,0.0
57,0,57,[200 204 153  98 215],450,4,211,3.6379310344827585,0.0,0.0
58,0,58,[196 132 588 202 176],457,5,216,3.6610169491525424,0.0,0.0
59,0,59,[132 186 179 197 238],457,5,221,3.683333333333333,0.0,0.0
60,0,60,[ 50 175 117 121 144],716,3,224,3.6721311475409837,0.0,20.0
61,0,61,[204 196 186 496 176],269,1,225,3.629032258064516,20.0,0.0
62,0,62,[496  98 132 153 211],796,4,229,3.634920634920635,20.0,0.0
63,0,63,[496  98 132 153 508],280,4,233,3.640625,20.0,0.0
64,0,64,[  7 210 211   1  25],655,0,233,3.5846153846153848,0.0,0.0
65,0,65,[ 97  64 508 144 742],655,1,234,3.5454545454545454,20.0,0.0
66,0,66,[496  50 588 202 179],450,5,239,3.5671641791044775,20.0,20.0
67,0,67,[496  50 588 202 179],786,5,244,3.588235294117647,20.0,20.0
68,0,68,[496  50 588 202 179],389,5,249,3.608695652173913,20.0,20.0
69,0,69,[496  50 588 202 179],786,5,254,3.6285714285714286,20.0,20.0
70,0,70,[496  50 588 202 179],450,5,259,3.647887323943662,20.0,20.0
71,0,71,[496  50 588 202 179],18,4,263,3.6527777777777777,20.0,20.0
72,0,72,[496  50 588 132 179],450,5,268,3.671232876712329,20.0,20.0
73,0,73,[496  50 588 132 179],450,5,273,3.689189189189189,20.0,20.0
74,0,74,[496  50 588 132 179],577,4,277,3.6933333333333334,20.0,20.0
75,0,75,[496  50 588 132 117],807,5,282,3.710526315789474,20.0,20.0
76,0,76,[496  50 588 132 117],450,5,287,3.727272727272727,20.0,20.0
77,0,77,[496  50 588 132 117],280,4,291,3.730769230769231,20.0,20.0
78,0,78,[496 588 132 117 121],716,5,296,3.7468354430379747,20.0,0.0
79,0,79,[496 588 132 117 121],450,4,300,3.75,20.0,0.0
80,0,80,[496 588 132 117  64],344,4,304,3.753086419753086,40.0,0.0
81,0,81,[496 588 132  64 153],18,5,309,3.768292682926829,40.0,0.0
82,0,82,[496 588 132  64 153],796,5,314,3.783132530120482,40.0,0.0
83,0,83,[496 588 132  64 153],389,4,318,3.7857142857142856,40.0,0.0
84,0,84,[496 238 588 132  64],330,5,323,3.8,40.0,0.0
85,0,85,[496 238 588 132  64],389,5,328,3.813953488372093,40.0,0.0
86,0,86,[204 127 197 265 237],878,2,330,3.793103448275862,0.0,20.0
87,0,87,[588 132  98 238  64],330,5,335,3.8068181818181817,20.0,0.0
88,0,88,[588 132  98 238  64],330,5,340,3.8202247191011236,20.0,0.0
89,0,89,[588 132  98 238  64],450,5,345,3.8333333333333335,20.0,0.0
90,0,90,[588 132  98 238  64],796,4,349,3.8351648351648353,20.0,0.0
91,0,91,[588 132  98  64 496],344,5,354,3.847826086956522,40.0,0.0
92,0,92,[588 132  98  64 496],716,5,359,3.860215053763441,40.0,0.0
93,0,93,[588 132  98  64 496],344,5,364,3.872340425531915,40.0,0.0
94,0,94,[588 132  98  64 496],330,5,369,3.8842105263157896,40.0,0.0
95,0,95,[588 132  98  64 496],450,5,374,3.8958333333333335,40.0,0.0
96,0,96,[588 132  98  64 496],450,5,379,3.9072164948453607,40.0,0.0
97,0,97,[ 82  89 186 211 127],655,2,381,3.8877551020408165,0.0,20.0
98,0,98,[496  98 588 132  89],786,5,386,3.898989898989899,20.0,0.0
99,0,99,[496  98 588 132  89],18,4,390,3.9,20.0,0.0
100,0,100,[496  98 588 132  64],716,5,395,3.910891089108911,40.0,0.0
101,0,101,[496  98 588 132  64],330,5,400,3.9215686274509802,40.0,0.0
102,0,102,[496  98 588 132  64],389,5,405,3.9320388349514563,40.0,0.0
103,0,103,[496  98 588 132  64],389,5,410,3.9423076923076925,40.0,0.0
104,0,104,[496  98 588 132  64],450,5,415,3.9523809523809526,40.0,0.0
105,0,105,[496  98 588 132  64],18,5,420,3.9622641509433962,40.0,0.0
106,0,106,[496  98 588 132  64],577,5,425,3.97196261682243,40.0,0.0
107,0,107,[496  98 588 132  64],344,5,430,3.9814814814814814,40.0,0.0
108,0,108,[195   1  69 258 328],151,3,433,3.9724770642201834,0.0,0.0
109,0,109,[496  98 588 132  64],18,5,438,3.981818181818182,40.0,0.0
110,0,110,[496  98 588 132  64],577,5,443,3.990990990990991,40.0,0.0
111,0,111,[496  98 588 132  64],716,5,448,4.0,40.0,0.0
112,0,112,[496  98 588 132  64],450,5,453,4.008849557522124,40.0,0.0
113,0,113,[496  98 588 132  64],796,5,458,4.017543859649122,40.0,0.0
114,0,114,[496  98 588 132  64],796,5,463,4.026086956521739,40.0,0.0
115,0,115,[496  98 588 132  64],450,5,468,4.0344827586206895,40.0,0.0
116,0,116,[496  98 588 132  64],716,5,473,4.042735042735043,40.0,0.0
117,0,117,[496  98 588 132  64],577,5,478,4.0508474576271185,40.0,0.0
118,0,118,[302  50 313  69 211],450,5,483,4.0588235294117645,0.0,20.0
119,0,119,[302 496 588  98  64],344,5,488,4.066666666666666,40.0,0.0
120,0,120,[302 496 588  98  64],450,5,493,4.074380165289257,40.0,0.0
121,0,121,[302 496 588  98  64],344,5,498,4.081967213114754,40.0,0.0
122,0,122,[302 496 588  98  64],450,5,503,4.0894308943089435,40.0,0.0
123,0,123,[111   1 194 143 135],18,2,505,4.07258064516129,0.0,0.0
124,0,124,[302 496 588  98  64],344,5,510,4.08,40.0,0.0
125,0,125,[302 496 588  98  64],389,5,515,4.087301587301587,40.0,0.0
126,0,126,[515 176 161 435 181],269,1,516,4.062992125984252,0.0,0.0
127,0,127,[302 496 588  98  64],450,5,521,4.0703125,40.0,0.0
128,0,128,[234 143 216  96 183],23,2,523,4.054263565891473,0.0,0.0
129,0,129,[302 496 588  98  64],344,5,528,4.061538461538461,40.0,0.0
130,0,130,[237 121 294 258 211],65,4,532,4.061068702290076,0.0,0.0
131,0,131,[302 496 588  98  64],450,5,537,4.068181818181818,40.0,0.0
132,0,132,[172 403 508 258 357],655,2,539,4.052631578947368,0.0,0.0
133,0,133,[ 11   9 603  69 175],655,1,540,4.029850746268656,20.0,0.0
134,0,134,[294 603   8 313 301],655,2,542,4.014814814814815,20.0,0.0
135,0,135,[302 496 588  98  64],450,5,547,4.022058823529412,40.0,0.0
136,0,136,[403 288 185 194 168],450,4,551,4.021897810218978,0.0,0.0
137,0,137,[302 496 588  98  64],450,5,556,4.028985507246377,40.0,0.0
138,0,138,[302 496 588  98  64],344,5,561,4.0359712230215825,40.0,0.0
139,0,139,[302 496 588  98  64],344,5,566,4.042857142857143,40.0,0.0
140,0,140,[546 215 196  28 174],23,1,567,4.0212765957446805,0.0,0.0
141,0,141,[302 496 588  98  64],344,5,572,4.028169014084507,40.0,0.0
142,0,142,[135 234 403 144   4],450,2,574,4.013986013986014,0.0,0.0
143,0,143,[302 496 588  98  64],389,5,579,4.020833333333333,40.0,0.0
144,0,144,[302 496 588  98  64],450,5,584,4.027586206896552,40.0,0.0
145,0,145,[302 496 588  98  64],344,5,589,4.034246575342466,40.0,0.0
146,0,146,[302 496 588  98  64],450,5,594,4.040816326530612,40.0,0.0
147,0,147,[302 496 588  98  64],450,5,599,4.047297297297297,40.0,0.0
148,0,148,[302 496 588  98  64],450,5,604,4.053691275167785,40.0,0.0
149,0,149,[302 496 588  98  64],450,5,609,4.06,40.0,0.0
150,0,150,[301 257 234 588  28],389,4,613,4.059602649006623,0.0,0.0
151,0,151,[302 496 588  98  64],389,5,618,4.065789473684211,40.0,0.0
152,0,152,[302 496 588  98  64],450,5,623,4.071895424836601,40.0,0.0
153,0,153,[302 496 588  98  64],344,5,628,4.077922077922078,40.0,0.0
154,0,154,[302 496 588  98  64],344,5,633,4.083870967741936,40.0,0.0
155,0,155,[302 496 588  98  64],389,5,638,4.089743589743589,40.0,0.0
156,0,156,[ 96 222 100 168 117],450,4,642,4.089171974522293,0.0,20.0
157,0,157,[302 496 588  98  64],389,5,647,4.094936708860759,40.0,0.0
158,0,158,[302 496 588  98  64],344,5,652,4.10062893081761,40.0,0.0
159,0,159,[144 175  69 273 238],655,1,653,4.08125,0.0,0.0
160,0,160,[302 496 588  98  64],389,5,658,4.086956521739131,40.0,0.0
161,0,161,[302 496 588  98  64],389,5,663,4.092592592592593,40.0,0.0
162,0,162,[111 471  15  69 216],457,4,667,4.0920245398773005,0.0,0.0
163,0,163,[588  56 216 118 210],716,4,671,4.091463414634147,0.0,0.0
164,0,164,[276 742  82 288   8],655,1,672,4.072727272727272,0.0,0.0
165,0,165,[302 168 496 471 185],389,5,677,4.078313253012048,20.0,0.0
166,0,166,[302 168 496 471 185],450,5,682,4.083832335329341,20.0,0.0
167,0,167,[132 323  12 197 238],174,3,685,4.0773809523809526,0.0,0.0
168,0,168,[302 496 588  98  56],389,5,690,4.0828402366863905,20.0,0.0
169,0,169,[483 257 111 174  88],401,4,694,4.08235294117647,0.0,0.0
170,0,170,[144  22 742 125 748],796,4,698,4.081871345029239,0.0,0.0
171,0,171,[288 195 210 174  96],504,5,703,4.087209302325581,0.0,0.0
172,0,172,[161 186 588  71 234],389,3,706,4.08092485549133,0.0,0.0
173,0,173,[302 168 483 471 174],535,4,710,4.080459770114943,0.0,0.0
174,0,174,[603 172 496  96 185],796,5,715,4.085714285714285,40.0,0.0
175,0,175,[603 172 496  96 185],716,4,719,4.0852272727272725,40.0,0.0
176,0,176,[237 204 153 151 132],796,5,724,4.090395480225989,0.0,0.0
177,0,177,[603 471 588  98  56],716,4,728,4.089887640449438,20.0,0.0
178,0,178,[172  64 496 174 185],18,3,731,4.083798882681564,40.0,0.0
179,0,179,[405 111 100  64 144],796,4,735,4.083333333333333,20.0,20.0
180,0,180,[328 318 175 172  12],655,2,737,4.071823204419889,20.0,0.0
181,0,181,[187   1 322 742 121],256,4,741,4.071428571428571,0.0,0.0
182,0,182,[125 174 588 322  98],344,3,744,4.065573770491803,0.0,0.0
183,0,183,[210  96 181  28 117],796,3,747,4.059782608695652,0.0,0.0
184,0,184,[175  15 191 153 181],18,4,751,4.059459459459459,0.0,0.0
185,0,185,[111 132  71   4 204],796,5,756,4.064516129032258,0.0,0.0
186,0,186,[196  50 181  82   8],796,4,760,4.064171122994653,0.0,20.0
187,0,187,[  9 427  96 135 742],655,2,762,4.053191489361702,20.0,0.0
188,0,188,[427 174 588  98  56],389,5,767,4.058201058201059,20.0,0.0
189,0,189,[427 174 588  98  56],18,5,772,4.063157894736842,20.0,0.0
190,0,190,[427 174 588  98  56],577,4,776,4.06282722513089,20.0,0.0
191,0,191,[427 748 496 174 515],807,5,781,4.067708333333333,40.0,0.0
192,0,192,[183 194   9 153 182],269,3,784,4.062176165803109,0.0,0.0
193,0,193,[ 64 174 588  98 405],457,5,789,4.06701030927835,20.0,0.0
194,0,194,[ 64 174 588  98 405],330,5,794,4.0717948717948715,20.0,0.0
195,0,195,[ 64 174 588  98 405],577,4,798,4.071428571428571,20.0,0.0
196,0,196,[ 64 427 496 174 182],18,5,803,4.0761421319796955,60.0,0.0
197,0,197,[ 64 427 496 174 182],450,5,808,4.08080808080808,60.0,0.0
198,0,198,[ 64 427 496 174 182],269,4,812,4.080402010050252,60.0,0.0
199,0,199,[216 100 313 202  12],796,4,816,4.08,0.0,20.0
200,0,200,[ 64 427 496 182 515],535,3,819,4.074626865671642,60.0,0.0
201,0,201,[427 748 496 603  64],151,4,823,4.074257425742574,80.0,0.0
202,0,202,[483 588  98 191 318],716,5,828,4.078817733990148,20.0,0.0
203,0,203,[483 588  98 191 318],716,5,833,4.083333333333333,20.0,0.0
204,0,204,[483 588  98 191 318],18,5,838,4.087804878048781,20.0,0.0
205,0,205,[483 588  98 191 318],796,5,843,4.092233009708738,20.0,0.0
206,0,206,[483 588  98 191 318],716,5,848,4.096618357487923,20.0,0.0
207,0,207,[118 200   7  82 427],655,2,850,4.086538461538462,20.0,0.0
208,0,208,[181 515 258 197  82],655,1,851,4.07177033492823,0.0,0.0
209,0,209,[483 588  98 191 318],716,5,856,4.076190476190476,20.0,0.0
210,0,210,[483 588  98 191 318],316,4,860,4.075829383886256,20.0,0.0
211,0,211,[483  98 191 318 276],457,5,865,4.080188679245283,20.0,0.0
212,0,212,[483  98 191 318 276],655,5,870,4.084507042253521,20.0,0.0
213,0,213,[483  98 191 318 276],457,5,875,4.088785046728972,20.0,0.0
214,0,214,[282 194  28 132 294],236,3,878,4.083720930232558,0.0,0.0
215,0,215,[483  98 191 318 276],269,5,883,4.087962962962963,20.0,0.0
216,0,216,[483  98 191 318 276],457,5,888,4.092165898617512,20.0,0.0
217,0,217,[483  98 191 318 276],269,5,893,4.0963302752293576,20.0,0.0
218,0,218,[483  98 191 318 276],18,5,898,4.100456621004566,20.0,0.0
219,0,219,[483  98 191 318 276],18,5,903,4.1045454545454545,20.0,0.0
220,0,220,[483  98 191 318 276],316,4,907,4.104072398190045,20.0,0.0
221,0,221,[496  98 191 318 427],18,5,912,4.108108108108108,60.0,0.0
222,0,222,[496  98 191 318 427],151,4,916,4.1076233183856505,60.0,0.0
223,0,223,[496  98 318 427  64],878,5,921,4.111607142857143,80.0,0.0
224,0,224,[496  98 318 427  64],796,5,926,4.115555555555556,80.0,0.0
225,0,225,[496  98 318 427  64],716,5,931,4.119469026548672,80.0,0.0
226,0,226,[496  98 318 427  64],269,5,936,4.1233480176211454,80.0,0.0
227,0,227,[496  98 318 427  64],151,5,941,4.12719298245614,80.0,0.0
228,0,228,[496  98 318 427  64],716,5,946,4.131004366812227,80.0,0.0
229,0,229,[496  98 318 427  64],18,5,951,4.1347826086956525,80.0,0.0
230,0,230,[496  98 318 427  64],151,5,956,4.138528138528138,80.0,0.0
231,0,231,[496  98 318 427  64],716,5,961,4.142241379310345,80.0,0.0
232,0,232,[496  98 318 427  64],450,5,966,4.145922746781116,80.0,0.0
233,0,233,[496  98 318 427  64],577,5,971,4.14957264957265,80.0,0.0
234,0,234,[496  98 318 427  64],796,5,976,4.153191489361702,80.0,0.0
235,0,235,[496  98 318 427  64],716,5,981,4.156779661016949,80.0,0.0
236,0,236,[496  98 318 427  64],18,5,986,4.160337552742616,80.0,0.0
237,0,237,[496  98 318 427  64],18,5,991,4.163865546218488,80.0,0.0
238,0,238,[496  98 318 427  64],330,5,996,4.167364016736402,80.0,0.0
239,0,239,[496  98 318 427  64],330,5,1001,4.170833333333333,80.0,0.0
240,0,240,[496  98 318 427  64],535,4,1005,4.170124481327801,80.0,0.0
241,0,241,[496 318 427  64 603],151,5,1010,4.1735537190082646,100.0,0.0
242,0,242,[496 318 427  64 603],330,5,1015,4.176954732510288,100.0,0.0
243,0,243,[496 318 427  64 603],18,4,1019,4.176229508196721,100.0,0.0
244,0,244,[111 245 271 237 215],796,4,1023,4.1755102040816325,0.0,0.0
245,0,245,[357 385 322 265 186],786,4,1027,4.17479674796748,0.0,0.0
246,0,246,[483 385 318 427  64],716,4,1031,4.174089068825911,60.0,0.0
247,0,247,[496 318 427  64 271],796,5,1036,4.17741935483871,80.0,0.0
248,0,248,[496 318 427  64 271],796,5,1041,4.180722891566265,80.0,0.0
249,0,249,[ 97   1 168 100 191],151,3,1044,4.176,0.0,20.0
250,0,250,[318 496 435  96  69],269,2,1046,4.1673306772908365,40.0,0.0
251,0,251,[288 313 181 423 385],655,1,1047,4.154761904761905,0.0,0.0
252,0,252,[258 121 181 222 195],344,2,1049,4.146245059288537,0.0,0.0
253,0,253,[496 318 427  64 271],796,5,1054,4.149606299212598,80.0,0.0
254,0,254,[496 318 427  64 271],796,5,1059,4.152941176470589,80.0,0.0
255,0,255,[496 318 427  64 271],796,5,1064,4.15625,80.0,0.0
256,0,256,[496 318 427  64 271],796,5,1069,4.159533073929961,80.0,0.0
257,0,257,[318 403 173 194 121],577,5,1074,4.162790697674419,20.0,0.0
258,0,258,[568 405 168  22 117],450,5,1079,4.166023166023166,0.0,0.0
259,0,259,[ 88 125  22 748 385],796,5,1084,4.1692307692307695,0.0,0.0
260,0,260,[235 144 568  98  88],450,4,1088,4.168582375478927,0.0,0.0
261,0,261,[ 28 237  11 151  50],457,5,1093,4.17175572519084,0.0,20.0
262,0,262,[ 79  96  98 197 194],72,5,1098,4.17490494296578,0.0,0.0
263,0,263,[ 89 222 568 153 294],796,4,1102,4.174242424242424,0.0,0.0
264,0,264,[496  79 318 427  64],18,5,1107,4.1773584905660375,80.0,0.0
265,0,265,[125 294 181 135 234],280,1,1108,4.165413533834586,0.0,0.0
266,0,266,[496  79 318 427  64],716,5,1113,4.168539325842697,80.0,0.0
267,0,267,[496  79 318 427  64],796,5,1118,4.1716417910447765,80.0,0.0
268,0,268,[496  79 318 427  64],577,5,1123,4.174721189591078,80.0,0.0
269,0,269,[496  79 318 427  64],236,4,1127,4.174074074074074,80.0,0.0
270,0,270,[ 79 318 427  64 271],796,5,1132,4.177121771217712,60.0,0.0
271,0,271,[ 79 318 427  64 271],655,4,1136,4.176470588235294,60.0,0.0
272,0,272,[ 79 318 427  64 168],796,5,1141,4.17948717948718,60.0,0.0
273,0,273,[ 79 318 427  64 168],577,5,1146,4.182481751824818,60.0,0.0
274,0,274,[ 79 318 427  64 168],450,5,1151,4.1854545454545455,60.0,0.0
275,0,275,[ 79 318 427  64 168],450,5,1156,4.188405797101449,60.0,0.0
276,0,276,[ 79 318 427  64 168],450,5,1161,4.191335740072202,60.0,0.0
277,0,277,[ 79 318 427  64 168],716,5,1166,4.194244604316546,60.0,0.0
278,0,278,[286 117  15 357   4],629,4,1170,4.193548387096774,0.0,20.0
279,0,279,[ 79 318 427  64 168],577,5,1175,4.196428571428571,60.0,0.0
280,0,280,[ 79 318 427  64 168],577,5,1180,4.199288256227758,60.0,0.0
281,0,281,[ 79 318 427  64 168],796,5,1185,4.202127659574468,60.0,0.0
282,0,282,[228 172  50 597 313],450,5,1190,4.204946996466431,0.0,20.0
283,0,283,[ 79 318 427  64 228],655,4,1194,4.204225352112676,60.0,0.0
284,0,284,[ 79 318 427  64 168],450,5,1199,4.207017543859649,60.0,0.0
285,0,285,[ 79 318 427  64 168],716,5,1204,4.20979020979021,60.0,0.0
286,0,286,[  9  56 196   7 179],65,2,1206,4.2020905923344944,0.0,0.0
287,0,287,[ 79 318 427  64 168],151,5,1211,4.204861111111111,60.0,0.0
288,0,288,[ 89  97  12  82 603],450,4,1215,4.204152249134948,20.0,0.0
289,0,289,[ 79 318 427  64 168],796,5,1220,4.206896551724138,60.0,0.0
290,0,290,[ 79 318 427  64 168],535,4,1224,4.206185567010309,60.0,0.0
291,0,291,[318 427  64 168 483],18,4,1228,4.205479452054795,60.0,0.0
292,0,292,[318 427  64 483 496],450,4,1232,4.204778156996587,80.0,0.0
293,0,293,[318 427  64 496  98],535,4,1236,4.204081632653061,80.0,0.0
294,0,294,[318 427  64 496 588],577,5,1241,4.206779661016949,80.0,0.0
295,0,295,[318 427  64 496 588],18,5,1246,4.20945945945946,80.0,0.0
296,0,296,[318 427  64 496 588],18,5,1251,4.212121212121212,80.0,0.0
297,0,297,[588 118 385  71 286],450,3,1254,4.208053691275167,0.0,20.0
298,0,298,[318 427  64 496 588],330,5,1259,4.210702341137123,80.0,0.0
299,0,299,[186 215  82 300 222],796,3,1262,4.206666666666667,0.0,0.0
300,0,300,[204 269 568 313 508],344,4,1266,4.205980066445183,0.0,0.0
301,0,301,[318 427  64 496 588],330,5,1271,4.208609271523179,80.0,0.0
302,0,302,[318 427  64 496 588],330,5,1276,4.211221122112211,80.0,0.0
303,0,303,[318 427  64 496 588],577,5,1281,4.213815789473684,80.0,0.0
304,0,304,[318 427  64 496 588],716,5,1286,4.216393442622951,80.0,0.0
305,0,305,[318 427  64 496 588],330,5,1291,4.218954248366013,80.0,0.0
306,0,306,[318 427  64 496 588],577,5,1296,4.221498371335505,80.0,0.0
307,0,307,[181 294 215  28  70],655,0,1296,4.207792207792208,0.0,0.0
308,0,308,[174 161  96 210  70],450,4,1300,4.207119741100324,0.0,0.0
309,0,309,[318 427  64 496 588],878,4,1304,4.2064516129032254,80.0,0.0
310,0,310,[318 427  64 496 132],269,5,1309,4.209003215434084,80.0,0.0
311,0,311,[318 427  64 496 132],716,5,1314,4.211538461538462,80.0,0.0
312,0,312,[318 427  64 496 132],796,5,1319,4.214057507987221,80.0,0.0
313,0,313,[318 427  64 496 132],577,5,1324,4.2165605095541405,80.0,0.0
314,0,314,[318 427  64 496 132],450,5,1329,4.219047619047619,80.0,0.0
315,0,315,[318 427  64 496 132],535,5,1334,4.2215189873417724,80.0,0.0
316,0,316,[318 427  64 496 132],269,5,1339,4.2239747634069404,80.0,0.0
317,0,317,[318 427  64 496 132],577,5,1344,4.226415094339623,80.0,0.0
318,0,318,[318 427  64 496 132],796,5,1349,4.22884012539185,80.0,0.0
319,0,319,[318 427  64 496 132],535,5,1354,4.23125,80.0,0.0
320,0,320,[318 427  64 496 132],269,5,1359,4.233644859813084,80.0,0.0
321,0,321,[318 427  64 496 132],556,5,1364,4.236024844720497,80.0,0.0
322,0,322,[318 427  64 496 132],151,5,1369,4.238390092879257,80.0,0.0
323,0,323,[318 427  64 496 132],796,5,1374,4.2407407407407405,80.0,0.0
324,0,324,[318 427  64 496 132],151,5,1379,4.243076923076923,80.0,0.0
325,0,325,[318 427  64 496 132],716,5,1384,4.245398773006135,80.0,0.0
326,0,326,[318 427  64 496 132],796,5,1389,4.247706422018348,80.0,0.0
327,0,327,[318 427  64 496 132],556,5,1394,4.25,80.0,0.0
328,0,328,[318 427  64 496 132],330,5,1399,4.2522796352583585,80.0,0.0
329,0,329,[318 427  64 496 132],151,5,1404,4.254545454545455,80.0,0.0
330,0,330,[318 427  64 496 132],556,5,1409,4.256797583081571,80.0,0.0
331,0,331,[318 427  64 496 132],269,5,1414,4.259036144578313,80.0,0.0
332,0,332,[318 427  64 496 132],796,5,1419,4.261261261261262,80.0,0.0
333,0,333,[318 427  64 496 132],330,5,1424,4.263473053892215,80.0,0.0
334,0,334,[318 427  64 496 132],330,5,1429,4.2656716417910445,80.0,0.0
335,0,335,[ 82 588  88 117 275],457,5,1434,4.267857142857143,0.0,20.0
336,0,336,[275 318 427  64 496],535,5,1439,4.270029673590504,80.0,20.0
337,0,337,[275 318 427  64 496],151,5,1444,4.272189349112426,80.0,20.0
338,0,338,[275 318 427  64 496],236,3,1447,4.268436578171092,80.0,20.0
339,0,339,[318 427  64 496 132],18,5,1452,4.270588235294118,80.0,0.0
340,0,340,[318 427  64 496 132],577,5,1457,4.2727272727272725,80.0,0.0
341,0,341,[318 427  64 496 132],151,5,1462,4.2748538011695905,80.0,0.0
342,0,342,[318 427  64 496 132],796,5,1467,4.276967930029154,80.0,0.0
343,0,343,[318 427  64 132 496],330,5,1472,4.27906976744186,80.0,0.0
344,0,344,[318 427  64 132 496],151,5,1477,4.281159420289855,80.0,0.0
345,0,345,[318 427  64 132 496],556,5,1482,4.283236994219653,80.0,0.0
346,0,346,[318 427  64 132 496],236,4,1486,4.282420749279539,80.0,0.0
347,0,347,[318 427  64 132 496],450,5,1491,4.2844827586206895,80.0,0.0
348,0,348,[318 427  64 132 496],796,5,1496,4.286532951289399,80.0,0.0
349,0,349,[318 427  64 132 496],18,5,1501,4.288571428571428,80.0,0.0
350,0,350,[181 313 202 111 257],655,1,1502,4.279202279202279,0.0,0.0
351,0,351,[318 427  64 132 496],577,5,1507,4.28125,80.0,0.0
352,0,352,[318 427  64 132 496],577,5,1512,4.28328611898017,80.0,0.0
353,0,353,[318 427  64 132 496],151,5,1517,4.285310734463277,80.0,0.0
354,0,354,[318 427  64 132 496],556,5,1522,4.2873239436619714,80.0,0.0
355,0,355,[318 427  64 132 496],535,5,1527,4.28932584269663,80.0,0.0
356,0,356,[174  25 302 546 273],450,3,1530,4.285714285714286,0.0,0.0
357,0,357,[318 427  64 132 496],450,5,1535,4.287709497206704,80.0,0.0
358,0,358,[318 427  64 132 496],269,5,1540,4.289693593314763,80.0,0.0
359,0,359,[318 427  64 132 496],577,5,1545,4.291666666666667,80.0,0.0
360,0,360,[318 427  64 132 496],577,5,1550,4.293628808864266,80.0,0.0
361,0,361,[318 427  64 132 496],535,5,1555,4.295580110497237,80.0,0.0
362,0,362,[318 427  64 132 496],535,5,1560,4.297520661157025,80.0,0.0
363,0,363,[  8 318 588 313 195],280,3,1563,4.293956043956044,20.0,0.0
364,0,364,[318 427  64 132 496],236,4,1567,4.293150684931507,80.0,0.0
365,0,365,[318 427  64 132 588],716,5,1572,4.295081967213115,60.0,0.0
366,0,366,[318 427  64 132 588],316,4,1576,4.294277929155314,60.0,0.0
367,0,367,[318 427  64 132  98],316,5,1581,4.296195652173913,60.0,0.0
368,0,368,[318 427  64 132  98],269,5,1586,4.29810298102981,60.0,0.0
369,0,369,[318 427  64 132  98],330,5,1591,4.3,60.0,0.0
370,0,370,[318 427  64 132  98],450,5,1596,4.30188679245283,60.0,0.0
371,0,371,[318 427  64 132  98],796,5,1601,4.303763440860215,60.0,0.0
372,0,372,[318 427  64 132  98],269,5,1606,4.305630026809651,60.0,0.0
373,0,373,[318 427  64 132  98],236,5,1611,4.307486631016043,60.0,0.0
374,0,374,[318 427  64 132  98],655,4,1615,4.306666666666667,60.0,0.0
375,0,375,[318 427  64 132  98],577,5,1620,4.308510638297872,60.0,0.0
376,0,376,[318 427  64 132  98],693,4,1624,4.3076923076923075,60.0,0.0
377,0,377,[318 427  64 132  98],269,5,1629,4.309523809523809,60.0,0.0
378,0,378,[318 427  64 132  98],18,5,1634,4.311345646437995,60.0,0.0
379,0,379,[318 427  64 132  98],151,5,1639,4.313157894736842,60.0,0.0
380,0,380,[318 427  64 132  98],655,4,1643,4.312335958005249,60.0,0.0
381,0,381,[318 427  64  98 496],330,5,1648,4.31413612565445,80.0,0.0
382,0,382,[318 427  64  98 496],796,5,1653,4.315926892950392,80.0,0.0
383,0,383,[318 427  64  98 496],236,4,1657,4.315104166666667,80.0,0.0
384,0,384,[318 427  64  98 132],236,5,1662,4.316883116883117,60.0,0.0
385,0,385,[318 427  64  98 132],330,5,1667,4.318652849740933,60.0,0.0
386,0,386,[318 427  64  98 132],330,5,1672,4.320413436692506,60.0,0.0
387,0,387,[318 427  64  98 132],450,5,1677,4.322164948453608,60.0,0.0
388,0,388,[318 427  64  98 132],535,4,1681,4.32133676092545,60.0,0.0
389,0,389,[318 427  64 132  98],330,5,1686,4.323076923076923,60.0,0.0
390,0,390,[318 427  64 132  98],655,4,1690,4.32225063938619,60.0,0.0
391,0,391,[318 427  64  98 496],577,5,1695,4.323979591836735,80.0,0.0
392,0,392,[318 427  64  98 496],796,5,1700,4.325699745547074,80.0,0.0
393,0,393,[318 427  64  98 496],577,5,1705,4.3274111675126905,80.0,0.0
394,0,394,[318 427  64  98 496],269,5,1710,4.329113924050633,80.0,0.0
395,0,395,[185 204 258 211 117],450,5,1715,4.33080808080808,0.0,0.0
396,0,396,[117  22 588 118 100],344,2,1717,4.324937027707809,0.0,20.0
397,0,397,[318 427  64  98 496],535,4,1721,4.324120603015075,80.0,0.0
398,0,398,[318 427  64 496 588],796,5,1726,4.325814536340852,80.0,0.0
399,0,399,[318 427  64 496 588],878,4,1730,4.325,80.0,0.0
400,0,400,[318 427  64 496 302],535,4,1734,4.324189526184538,80.0,0.0
401,0,401,[318 427  64 496  98],450,5,1739,4.325870646766169,80.0,0.0
402,0,402,[318 427  64 496  98],535,4,1743,4.325062034739454,80.0,0.0
403,0,403,[318 427  64 496 132],556,5,1748,4.326732673267327,80.0,0.0
404,0,404,[318 427  64 496 132],535,5,1753,4.328395061728395,80.0,0.0
405,0,405,[318 427  64 496 132],716,5,1758,4.330049261083744,80.0,0.0
406,0,406,[318 427  64 496 132],450,5,1763,4.3316953316953315,80.0,0.0
407,0,407,[ 89 234 186  50 546],786,4,1767,4.330882352941177,0.0,20.0
408,0,408,[318 427  64 496 132],450,5,1772,4.332518337408313,80.0,0.0
409,0,409,[318 427  64 496 132],796,5,1777,4.3341463414634145,80.0,0.0
410,0,410,[318 427  64 496 132],330,5,1782,4.335766423357664,80.0,0.0
411,0,411,[318 427  64 496 132],556,5,1787,4.337378640776699,80.0,0.0
412,0,412,[318 427  64 496 132],269,5,1792,4.338983050847458,80.0,0.0
413,0,413,[318 427  64 496 132],236,4,1796,4.338164251207729,80.0,0.0
414,0,414,[318 427  64 496 132],535,5,1801,4.339759036144578,80.0,0.0
415,0,415,[318 427  64 496 132],796,5,1806,4.341346153846154,80.0,0.0
416,0,416,[318 427  64 496 132],716,5,1811,4.342925659472422,80.0,0.0
417,0,417,[318 427  64 496 132],269,5,1816,4.344497607655502,80.0,0.0
418,0,418,[318 427  64 496 132],450,5,1821,4.3460620525059666,80.0,0.0
419,0,419,[318 427  64 496 132],796,5,1826,4.347619047619047,80.0,0.0
420,0,420,[318 427  64 496 132],269,5,1831,4.34916864608076,80.0,0.0
421,0,421,[318 427  64 496 132],577,5,1836,4.350710900473934,80.0,0.0
422,0,422,[318 427  64 496 132],18,5,1841,4.3522458628841605,80.0,0.0
423,0,423,[318 427  64 496 132],577,5,1846,4.35377358490566,80.0,0.0
424,0,424,[318 427  64 496 132],556,5,1851,4.355294117647059,80.0,0.0
425,0,425,[318 427  64 496 132],535,5,1856,4.356807511737089,80.0,0.0
426,0,426,[318 427  64 496 132],18,5,1861,4.3583138173302105,80.0,0.0
427,0,427,[318 427  64 496 132],716,5,1866,4.359813084112149,80.0,0.0
428,0,428,[318 427  64 496 132],18,5,1871,4.361305361305361,80.0,0.0
429,0,429,[318 427  64 496 132],535,5,1876,4.362790697674418,80.0,0.0
430,0,430,[318 427  64 496 132],18,5,1881,4.364269141531323,80.0,0.0
431,0,431,[318 427  64 496 132],716,5,1886,4.3657407407407405,80.0,0.0
432,0,432,[318 427  64 496 132],269,5,1891,4.3672055427251735,80.0,0.0
433,0,433,[318 427  64 496 132],450,5,1896,4.368663594470046,80.0,0.0
434,0,434,[318 427  64 496 132],236,4,1900,4.367816091954023,80.0,0.0
435,0,435,[318 427  64 132 496],18,5,1905,4.3692660550458715,80.0,0.0
436,0,436,[318 427  64 132 496],151,5,1910,4.37070938215103,80.0,0.0
437,0,437,[318 427  64 132 496],556,5,1915,4.372146118721461,80.0,0.0
438,0,438,[318 427  64 132 496],535,5,1920,4.373576309794989,80.0,0.0
439,0,439,[318 427  64 132 496],330,5,1925,4.375,80.0,0.0
440,0,440,[318 427  64 132 496],716,5,1930,4.37641723356009,80.0,0.0
441,0,441,[318 427  64 132 496],535,5,1935,4.377828054298643,80.0,0.0
442,0,442,[286  98 125  71 121],152,4,1939,4.376975169300226,0.0,20.0
443,0,443,[318 427  64 132 496],269,5,1944,4.378378378378378,80.0,0.0
444,0,444,[318 427  64 132 496],716,5,1949,4.379775280898876,80.0,0.0
445,0,445,[318 427  64 132 496],18,5,1954,4.381165919282512,80.0,0.0
446,0,446,[275 196 143 181 202],786,5,1959,4.382550335570469,0.0,20.0
447,0,447,[318 427  64 132 496],556,5,1964,4.383928571428571,80.0,0.0
448,0,448,[318 427  64 132 496],330,5,1969,4.385300668151448,80.0,0.0
449,0,449,[318 427  64 132 496],450,5,1974,4.386666666666667,80.0,0.0
450,0,450,[318 427  64 132 496],556,5,1979,4.388026607538802,80.0,0.0
451,0,451,[318 427  64 132 496],269,5,1984,4.389380530973451,80.0,0.0
452,0,452,[318 427  64 132 496],796,5,1989,4.3907284768211925,80.0,0.0
453,0,453,[318 427  64 132 496],796,5,1994,4.392070484581498,80.0,0.0
454,0,454,[318 427  64 132 496],151,5,1999,4.393406593406594,80.0,0.0
455,0,455,[318 427  64 132 496],151,5,2004,4.394736842105263,80.0,0.0
456,0,456,[318 427  64 132 496],556,5,2009,4.3960612691466086,80.0,0.0
457,0,457,[318 427  64 132 496],330,5,2014,4.397379912663755,80.0,0.0
458,0,458,[318 427  64 132 496],577,5,2019,4.398692810457517,80.0,0.0
459,0,459,[ 96 318   8  88 216],577,4,2023,4.397826086956521,20.0,0.0
460,0,460,[318 427  64 132 496],556,5,2028,4.399132321041215,80.0,0.0
461,0,461,[318 427  64 132 496],716,5,2033,4.4004329004329,80.0,0.0
462,0,462,[318 427  64 132 496],450,5,2038,4.401727861771058,80.0,0.0
463,0,463,[318 427  64 132 496],577,5,2043,4.4030172413793105,80.0,0.0
464,0,464,[  4 257  28 403  71],504,4,2047,4.402150537634409,0.0,0.0
465,0,465,[318 427  64 132 496],716,5,2052,4.4034334763948495,80.0,0.0
466,0,466,[318 427  64 132 496],269,5,2057,4.404710920770878,80.0,0.0
467,0,467,[318 427  64 132 496],535,5,2062,4.405982905982906,80.0,0.0
468,0,468,[318 427  64 132 496],716,5,2067,4.40724946695096,80.0,0.0
469,0,469,[318 427  64 132 496],716,5,2072,4.408510638297872,80.0,0.0
470,0,470,[318 427  64 132 496],577,5,2077,4.409766454352441,80.0,0.0
471,0,471,[318 427  64 132 496],556,5,2082,4.411016949152542,80.0,0.0
472,0,472,[318 427  64 132 496],577,5,2087,4.412262156448203,80.0,0.0
473,0,473,[385   7 748 318 215],151,2,2089,4.4071729957805905,20.0,0.0
474,0,474,[318 427  64 132 496],330,5,2094,4.408421052631579,80.0,0.0
475,0,475,[318 427  64 132 496],18,5,2099,4.409663865546219,80.0,0.0
476,0,476,[318 427  64 132 496],269,5,2104,4.410901467505241,80.0,0.0
477,0,477,[318 427  64 132 496],330,5,2109,4.412133891213389,80.0,0.0
478,0,478,[132 191   7 597  98],457,4,2113,4.411273486430063,0.0,0.0
479,0,479,[318 427  64 132 496],716,5,2118,4.4125,80.0,0.0
480,0,480,[318 427  64 132 496],535,5,2123,4.413721413721413,80.0,0.0
481,0,481,[318 427  64 132 496],330,5,2128,4.4149377593361,80.0,0.0
482,0,482,[318 427  64 132 496],330,5,2133,4.416149068322981,80.0,0.0
483,0,483,[318 427  64 132 496],18,5,2138,4.417355371900826,80.0,0.0
484,0,484,[318 427  64 132 496],450,5,2143,4.418556701030928,80.0,0.0
485,0,485,[318 427  64 132 496],716,5,2148,4.419753086419753,80.0,0.0
486,0,486,[318 427  64 132 496],556,5,2153,4.420944558521561,80.0,0.0
487,0,487,[333  96 238 191 269],655,1,2154,4.413934426229508,0.0,0.0
488,0,488,[318 427  64 132 496],535,5,2159,4.415132924335379,80.0,0.0
489,0,489,[318 427  64 132 496],236,4,2163,4.414285714285715,80.0,0.0
490,0,490,[318 427  64 132 496],151,5,2168,4.415478615071283,80.0,0.0
491,0,491,[318 427  64 132 496],577,5,2173,4.416666666666667,80.0,0.0
492,0,492,[318 427  64 132 496],716,5,2178,4.417849898580122,80.0,0.0
493,0,493,[318 427  64 132 496],269,5,2183,4.419028340080971,80.0,0.0
494,0,494,[318 427  64 132 496],796,5,2188,4.42020202020202,80.0,0.0
495,0,495,[ 12 258  96 195 216],693,5,2193,4.421370967741935,0.0,0.0
496,0,496,[176  50 144   1 748],450,5,2198,4.422535211267606,0.0,20.0
497,0,497,[318 427  64 132 496],716,5,2203,4.423694779116466,80.0,0.0
498,0,498,[318 427  64 132 496],151,5,2208,4.424849699398798,80.0,0.0
499,0,499,[318 427  64 132 496],330,5,2213,4.426,80.0,0.0
500,0,500,[318 427  64 132 496],796,5,2218,4.4271457085828345,80.0,0.0
501,0,501,[318 427  64 132 496],151,5,2223,4.4282868525896415,80.0,0.0
502,0,502,[318 427  64 132 496],269,5,2228,4.429423459244533,80.0,0.0
503,0,503,[318 427  64 132 496],18,5,2233,4.430555555555555,80.0,0.0
504,0,504,[318 427  64 132 496],269,5,2238,4.431683168316832,80.0,0.0
505,0,505,[318 427  64 132 496],577,5,2243,4.432806324110672,80.0,0.0
506,0,506,[318 427  64 132 496],269,5,2248,4.433925049309665,80.0,0.0
507,0,507,[318 427  64 132 496],330,5,2253,4.43503937007874,80.0,0.0
508,0,508,[318 427  64 132 496],236,4,2257,4.43418467583497,80.0,0.0
509,0,509,[318 427  64 132 496],796,5,2262,4.435294117647059,80.0,0.0
510,0,510,[318 427  64 132 496],330,5,2267,4.436399217221135,80.0,0.0
511,0,511,[318 427  64 132 496],236,4,2271,4.435546875,80.0,0.0
512,0,512,[318 427  64 132 496],236,4,2275,4.434697855750487,80.0,0.0
513,0,513,[318 427  64 132 588],796,5,2280,4.43579766536965,60.0,0.0
514,0,514,[318 427  64 132 588],796,5,2285,4.436893203883495,60.0,0.0
515,0,515,[318 427  64 132 588],316,4,2289,4.436046511627907,60.0,0.0
516,0,516,[508 181 318 288 182],280,2,2291,4.431334622823985,20.0,0.0
517,0,517,[318 427  64 132 496],450,5,2296,4.4324324324324325,80.0,0.0
518,0,518,[318 427  64 132 496],151,5,2301,4.433526011560693,80.0,0.0
519,0,519,[318 427  64 132 496],18,5,2306,4.434615384615385,80.0,0.0
520,0,520,[318 427  64 132 496],577,5,2311,4.435700575815739,80.0,0.0
521,0,521,[318 427  64 132 496],556,5,2316,4.436781609195402,80.0,0.0
522,0,522,[318 427  64 132 496],450,5,2321,4.437858508604206,80.0,0.0
523,0,523,[318 427  64 132 496],151,5,2326,4.438931297709924,80.0,0.0
524,0,524,[318 427  64 132 496],577,5,2331,4.44,80.0,0.0
525,0,525,[318 427  64 132 496],151,5,2336,4.44106463878327,80.0,0.0
526,0,526,[318 427  64 132 496],330,5,2341,4.442125237191651,80.0,0.0
527,0,527,[318 427  64 132 496],450,5,2346,4.443181818181818,80.0,0.0
528,0,528,[318 427  64 132 496],796,5,2351,4.444234404536862,80.0,0.0
529,0,529,[318 427  64 132 496],18,5,2356,4.445283018867925,80.0,0.0
530,0,530,[318 427  64 132 496],716,5,2361,4.446327683615819,80.0,0.0
531,0,531,[318 427  64 132 496],796,5,2366,4.447368421052632,80.0,0.0
532,0,532,[318 427  64 132 496],269,5,2371,4.448405253283302,80.0,0.0
533,0,533,[318 427  64 132 496],450,5,2376,4.449438202247191,80.0,0.0
534,0,534,[318 427  64 132 496],450,5,2381,4.450467289719626,80.0,0.0
535,0,535,[318 427  64 132 496],18,5,2386,4.451492537313433,80.0,0.0
536,0,536,[318 427  64 132 496],716,5,2391,4.4525139664804465,80.0,0.0
537,0,537,[318 427  64 132 496],18,5,2396,4.4535315985130115,80.0,0.0
538,0,538,[318 427  64 132 496],18,5,2401,4.454545454545454,80.0,0.0
539,0,539,[318 427  64 132 496],796,5,2406,4.455555555555556,80.0,0.0
540,0,540,[ 96 179 211 597 153],269,2,2408,4.45101663585952,0.0,0.0
541,0,541,[318 427  64 132 496],716,5,2413,4.452029520295203,80.0,0.0
542,0,542,[318 427  64 132 496],18,5,2418,4.45303867403315,80.0,0.0
543,0,543,[318 427  64 132 496],330,5,2423,4.454044117647059,80.0,0.0
544,0,544,[318 427  64 132 496],236,4,2427,4.453211009174312,80.0,0.0
545,0,545,[318 427  64 132 496],151,5,2432,4.454212454212454,80.0,0.0
546,0,546,[318 427  64 132 496],796,5,2437,4.455210237659964,80.0,0.0
547,0,547,[318 427  64 132 496],577,5,2442,4.456204379562044,80.0,0.0
548,0,548,[318 427  64 132 496],269,5,2447,4.457194899817851,80.0,0.0
549,0,549,[318 427  64 132 496],236,4,2451,4.456363636363636,80.0,0.0
550,0,550,[318 427  64 132 496],577,5,2456,4.457350272232305,80.0,0.0
551,0,551,[318 427  64 132 496],716,5,2461,4.458333333333333,80.0,0.0
552,0,552,[ 95  25 546  69 200],450,2,2463,4.4538878842676315,0.0,0.0
553,0,553,[318 427  64 132 496],236,4,2467,4.453068592057762,80.0,0.0
554,0,554,[318 427  64 132 496],716,5,2472,4.454054054054054,80.0,0.0
555,0,555,[318 427  64 132 496],556,5,2477,4.455035971223022,80.0,0.0
556,0,556,[318 427  64 132 496],236,4,2481,4.454219030520647,80.0,0.0
557,0,557,[318 427  64 132 588],716,5,2486,4.455197132616488,60.0,0.0
558,0,558,[318 427  64 132 588],18,5,2491,4.456171735241503,60.0,0.0
559,0,559,[318 427  64 132 588],577,5,2496,4.457142857142857,60.0,0.0
560,0,560,[187 286 179 180 151],18,4,2500,4.45632798573975,0.0,20.0
561,0,561,[318 427 180  64 132],18,5,2505,4.45729537366548,60.0,0.0
562,0,562,[ 15  98 135 210  88],457,5,2510,4.458259325044405,0.0,0.0
563,0,563,[318 427 180  64 132],796,4,2514,4.457446808510638,60.0,0.0
564,0,564,[318 427  64 132 588],18,5,2519,4.458407079646018,60.0,0.0
565,0,565,[318 427  64 132 588],577,5,2524,4.459363957597173,60.0,0.0
566,0,566,[168 742  97 603  88],796,3,2527,4.45679012345679,20.0,0.0
567,0,567,[318 427  64 132 588],316,4,2531,4.455985915492958,60.0,0.0
568,0,568,[318 427  64 132  98],577,5,2536,4.456942003514938,60.0,0.0
569,0,569,[318 427  64 132  98],655,4,2540,4.456140350877193,60.0,0.0
570,0,570,[318 427  64 132  98],330,5,2545,4.457092819614711,60.0,0.0
571,0,571,[318 427  64 132  98],236,5,2550,4.458041958041958,60.0,0.0
572,0,572,[318 427  64 132  98],577,5,2555,4.458987783595114,60.0,0.0
573,0,573,[318 427  64 132  98],236,5,2560,4.45993031358885,60.0,0.0
574,0,574,[318 427  64 132  98],330,5,2565,4.460869565217391,60.0,0.0
575,0,575,[318 427  64 132  98],655,4,2569,4.460069444444445,60.0,0.0
576,0,576,[318 427  64 132  98],655,4,2573,4.459272097053726,60.0,0.0
577,0,577,[318 427  64 132  98],330,5,2578,4.460207612456747,60.0,0.0
578,0,578,[318 427  64 132  98],535,4,2582,4.4594127806563035,60.0,0.0
579,0,579,[318 427  64 132 496],269,5,2587,4.460344827586207,80.0,0.0
580,0,580,[234  98 153 215 385],23,3,2590,4.457831325301205,0.0,0.0
581,0,581,[318 427  64 132 496],796,5,2595,4.458762886597938,80.0,0.0
582,0,582,[204 405 268 385 228],344,2,2597,4.454545454545454,0.0,0.0
583,0,583,[318 427  64 132 496],535,5,2602,4.455479452054795,80.0,0.0
584,0,584,[318 427  64 132 496],330,5,2607,4.456410256410257,80.0,0.0
585,0,585,[318 427  64 132 496],18,5,2612,4.4573378839590445,80.0,0.0
586,0,586,[318 427  64 132 496],577,5,2617,4.458262350936968,80.0,0.0
587,0,587,[111 237  82  96 289],655,0,2617,4.450680272108843,0.0,0.0
588,0,588,[318 427  64 132 496],716,5,2622,4.451612903225806,80.0,0.0
589,0,589,[318 427  64 132 496],716,5,2627,4.452542372881356,80.0,0.0
590,0,590,[318 427  64 132 496],577,5,2632,4.45346869712352,80.0,0.0
591,0,591,[318 427  64 132 496],151,5,2637,4.454391891891892,80.0,0.0
592,0,592,[318 427  64 132 496],330,5,2642,4.455311973018549,80.0,0.0
593,0,593,[318 427  64 132 496],535,5,2647,4.456228956228956,80.0,0.0
594,0,594,[318 427  64 132 496],556,5,2652,4.457142857142857,80.0,0.0
595,0,595,[318 427  64 132 496],556,5,2657,4.458053691275167,80.0,0.0
596,0,596,[318 427  64 132 496],577,5,2662,4.458961474036851,80.0,0.0
597,0,597,[318 427  64 132 496],151,5,2667,4.459866220735786,80.0,0.0
598,0,598,[ 70 235 173 322 385],280,4,2671,4.459098497495827,0.0,0.0
599,0,599,[ 96  56 322 275  28],796,3,2674,4.456666666666667,0.0,20.0
600,0,600,[318 427  64 132 496],151,5,2679,4.457570715474209,80.0,0.0
601,0,601,[ 50 655 301  15 245],450,4,2683,4.456810631229236,0.0,20.0
602,0,602,[655 318 427  64 132],236,4,2687,4.456053067993366,60.0,0.0
603,0,603,[318 427  64 132 496],577,5,2692,4.456953642384106,80.0,0.0
604,0,604,[318 427  64 132 496],796,5,2697,4.457851239669422,80.0,0.0
605,0,605,[318 427  64 132 496],330,5,2702,4.458745874587459,80.0,0.0
606,0,606,[318 427  64 132 496],716,5,2707,4.4596375617792425,80.0,0.0
607,0,607,[318 427  64 132 496],577,5,2712,4.4605263157894735,80.0,0.0
608,0,608,[318 427  64 132 496],450,5,2717,4.461412151067323,80.0,0.0
609,0,609,[318 427  64 132 496],269,5,2722,4.462295081967213,80.0,0.0
610,0,610,[318 427  64 132 496],535,5,2727,4.463175122749591,80.0,0.0
611,0,611,[318 427  64 132 496],151,5,2732,4.4640522875816995,80.0,0.0
612,0,612,[318 427  64 132 496],716,5,2737,4.464926590538336,80.0,0.0
613,0,613,[318 427  64 132 496],151,5,2742,4.465798045602606,80.0,0.0
614,0,614,[323 294 185 174 742],504,4,2746,4.465040650406504,0.0,0.0
615,0,615,[318 427  64 132 496],236,4,2750,4.464285714285714,80.0,0.0
616,0,616,[318 427  64 132 496],716,5,2755,4.46515397082658,80.0,0.0
617,0,617,[318 427  64 132 496],236,4,2759,4.464401294498382,80.0,0.0
618,0,618,[318 427  64 132  79],535,4,2763,4.463651050080776,60.0,0.0
619,0,619,[318 427  64 132 168],316,4,2767,4.462903225806452,60.0,0.0
620,0,620,[318 427  64 132 496],330,5,2772,4.463768115942029,80.0,0.0
621,0,621,[318 427  64 132 496],151,5,2777,4.464630225080386,80.0,0.0
622,0,622,[318 427  64 132 496],556,5,2782,4.465489566613162,80.0,0.0
623,0,623,[318 427  64 132 496],535,5,2787,4.466346153846154,80.0,0.0
624,0,624,[318 427  64 132 496],236,4,2791,4.4656,80.0,0.0
625,0,625,[318 427  64 132  98],450,5,2796,4.466453674121405,60.0,0.0
626,0,626,[318 427  64 132  98],655,4,2800,4.4657097288676235,60.0,0.0
627,0,627,[318 427  64 132  98],577,5,2805,4.4665605095541405,60.0,0.0
628,0,628,[318 427  64 132  98],535,4,2809,4.465818759936407,60.0,0.0
629,0,629,[318 427  64 132 496],330,5,2814,4.466666666666667,80.0,0.0
630,0,630,[318 427  64 132 496],269,5,2819,4.467511885895404,80.0,0.0
631,0,631,[318 276  79 187   8],535,2,2821,4.4636075949367084,20.0,0.0
632,0,632,[318 427  64 132 496],236,4,2825,4.4628751974723535,80.0,0.0
633,0,633,[318 427  64 132 588],316,4,2829,4.462145110410095,60.0,0.0
634,0,634,[ 82 471 210 161 181],280,1,2830,4.456692913385827,0.0,0.0
635,0,635,[318 427  64 132 483],236,5,2835,4.4575471698113205,60.0,0.0
636,0,636,[318 427  64 132 483],716,5,2840,4.45839874411303,60.0,0.0
637,0,637,[318 427  64 132 483],693,3,2843,4.456112852664577,60.0,0.0
638,0,638,[318 427  64 132 496],796,5,2848,4.456964006259781,80.0,0.0
639,0,639,[318 427  64 132 496],716,5,2853,4.4578125,80.0,0.0
640,0,640,[318 427  64 132 496],556,5,2858,4.458658346333853,80.0,0.0
641,0,641,[318 427  64 132 496],330,5,2863,4.459501557632398,80.0,0.0
642,0,642,[318 427  64 132 496],796,5,2868,4.460342146189736,80.0,0.0
643,0,643,[318 427  64 132 496],151,5,2873,4.461180124223603,80.0,0.0
644,0,644,[318 427  64 132 496],535,5,2878,4.462015503875969,80.0,0.0
645,0,645,[211  11 286 427 153],535,4,2882,4.461300309597523,20.0,20.0
646,0,646,[318 427  64 132 496],716,5,2887,4.4621329211746525,80.0,0.0
647,0,647,[318 427  64 132 496],330,5,2892,4.462962962962963,80.0,0.0
648,0,648,[318 427  64 132 496],330,5,2897,4.463790446841294,80.0,0.0
649,0,649,[318 427  64 132 496],556,5,2902,4.464615384615384,80.0,0.0
650,0,650,[318 427  64 132 496],796,5,2907,4.465437788018433,80.0,0.0
651,0,651,[318 427  64 132 496],450,5,2912,4.466257668711656,80.0,0.0
652,0,652,[318 427  64 132 496],450,5,2917,4.467075038284839,80.0,0.0
653,0,653,[318 427  64 132 496],796,5,2922,4.467889908256881,80.0,0.0
654,0,654,[318 427  64 132 496],450,5,2927,4.468702290076336,80.0,0.0
655,0,655,[318 427  64 132 496],151,5,2932,4.469512195121951,80.0,0.0
656,0,656,[318 427  64 132 496],535,5,2937,4.470319634703197,80.0,0.0
657,0,657,[318 427  64 132 496],577,5,2942,4.47112462006079,80.0,0.0
658,0,658,[318 427  64 132 496],796,5,2947,4.471927162367223,80.0,0.0
659,0,659,[273 200 423 302 237],450,3,2950,4.46969696969697,0.0,0.0
660,0,660,[318 427  64 132 496],450,5,2955,4.470499243570348,80.0,0.0
661,0,661,[318 427  64 132 496],151,5,2960,4.471299093655589,80.0,0.0
662,0,662,[318 427  64 132 496],151,5,2965,4.47209653092006,80.0,0.0
663,0,663,[318 427  64 132 496],450,5,2970,4.47289156626506,80.0,0.0
664,0,664,[318 427  64 132 496],18,5,2975,4.473684210526316,80.0,0.0
665,0,665,[269  12 471 568 180],450,5,2980,4.474474474474475,0.0,0.0
666,0,666,[318 427  64 132 496],577,5,2985,4.475262368815592,80.0,0.0
667,0,667,[318 427  64 132 496],151,5,2990,4.476047904191617,80.0,0.0
668,0,668,[318 427  64 132 496],535,5,2995,4.476831091180867,80.0,0.0
669,0,669,[318 427  64 132 496],330,5,3000,4.477611940298507,80.0,0.0
670,0,670,[318 427  64 132 496],577,5,3005,4.478390461997019,80.0,0.0
671,0,671,[318 427  64 132 496],450,5,3010,4.479166666666667,80.0,0.0
672,0,672,[318 427  64 132 496],556,5,3015,4.4799405646359585,80.0,0.0
673,0,673,[318 427  64 132 496],450,5,3020,4.480712166172107,80.0,0.0
674,0,674,[318 427  64 132 496],236,4,3024,4.48,80.0,0.0
675,0,675,[318 427  64 132 496],577,5,3029,4.480769230769231,80.0,0.0
676,0,676,[318 427  64 132 496],151,5,3034,4.481536189069424,80.0,0.0
677,0,677,[318 427  64 132 496],796,5,3039,4.482300884955753,80.0,0.0
678,0,678,[318 427  64 132 496],556,5,3044,4.483063328424153,80.0,0.0
679,0,679,[318 427  64 132 496],330,5,3049,4.483823529411764,80.0,0.0
680,0,680,[318 427  64 132 496],577,5,3054,4.484581497797357,80.0,0.0
681,0,681,[318 427  64 132 496],716,5,3059,4.4853372434017595,80.0,0.0
682,0,682,[318 427  64 132 496],577,5,3064,4.486090775988287,80.0,0.0
683,0,683,[318 427  64 132 496],796,5,3069,4.4868421052631575,80.0,0.0
684,0,684,[318 427  64 132 496],577,5,3074,4.487591240875912,80.0,0.0
685,0,685,[318 427  64 132 496],450,5,3079,4.488338192419825,80.0,0.0
686,0,686,[318 427  64 132 496],236,4,3083,4.487627365356623,80.0,0.0
687,0,687,[318 427  64 132 496],577,5,3088,4.488372093023256,80.0,0.0
688,0,688,[318 427  64 132 496],450,5,3093,4.489114658925979,80.0,0.0
689,0,689,[318 427  64 132 496],577,5,3098,4.489855072463768,80.0,0.0
690,0,690,[289 273  82  98  22],655,2,3100,4.486251808972503,0.0,0.0
691,0,691,[318 427  64 132 496],796,5,3105,4.486994219653179,80.0,0.0
692,0,692,[318 427  64 132 496],577,5,3110,4.487734487734488,80.0,0.0
693,0,693,[318 427  64 132 496],796,5,3115,4.488472622478386,80.0,0.0
694,0,694,[318 427  64 132 496],716,5,3120,4.489208633093525,80.0,0.0
695,0,695,[318 427  64 132 496],577,5,3125,4.489942528735632,80.0,0.0
696,0,696,[318 427  64 132 496],535,5,3130,4.490674318507891,80.0,0.0
697,0,697,[318 427  64 132 496],330,5,3135,4.491404011461318,80.0,0.0
698,0,698,[ 22 187 269  70 127],655,2,3137,4.487839771101574,0.0,20.0
699,0,699,[318 427  64 132 496],330,5,3142,4.488571428571428,80.0,0.0
700,0,700,[318 427  64 132 496],556,5,3147,4.489300998573467,80.0,0.0
701,0,701,[318 427  64 132 496],716,5,3152,4.49002849002849,80.0,0.0
702,0,702,[318 427  64 132 496],236,4,3156,4.489331436699858,80.0,0.0
703,0,703,[318 427  64 132 496],269,5,3161,4.490056818181818,80.0,0.0
704,0,704,[318 427  64 132 496],535,5,3166,4.490780141843971,80.0,0.0
705,0,705,[318 427  64 132 496],716,5,3171,4.491501416430595,80.0,0.0
706,0,706,[318 427  64 132 496],18,5,3176,4.492220650636492,80.0,0.0
707,0,707,[318 427  64 132 496],450,5,3181,4.492937853107344,80.0,0.0
708,0,708,[318 427  64 132 496],450,5,3186,4.493653032440056,80.0,0.0
709,0,709,[318 427  64 132 496],330,5,3191,4.494366197183099,80.0,0.0
710,0,710,[318 427  64 132 496],18,5,3196,4.495077355836849,80.0,0.0
711,0,711,[318 427  64 132 496],330,5,3201,4.495786516853933,80.0,0.0
712,0,712,[318 427  64 132 496],716,5,3206,4.496493688639551,80.0,0.0
713,0,713,[318 427  64 132 496],330,5,3211,4.497198879551821,80.0,0.0
714,0,714,[318 427  64 132 496],577,5,3216,4.497902097902098,80.0,0.0
715,0,715,[318 427  64 132 496],716,5,3221,4.498603351955308,80.0,0.0
716,0,716,[318 427  64 132 496],716,5,3226,4.499302649930265,80.0,0.0
717,0,717,[318 427  64 132 496],269,5,3231,4.5,80.0,0.0
718,0,718,[318 427  64 132 496],236,4,3235,4.499304589707927,80.0,0.0
719,0,719,[318 427  64 132 496],535,5,3240,4.5,80.0,0.0
720,0,720,[318 427  64 132 496],556,5,3245,4.500693481276006,80.0,0.0
721,0,721,[318 427  64 132 496],556,5,3250,4.501385041551247,80.0,0.0
722,0,722,[318 427  64 132 496],330,5,3255,4.5020746887966805,80.0,0.0
723,0,723,[318 427  64 132 496],450,5,3260,4.502762430939226,80.0,0.0
724,0,724,[318 427  64 132 496],18,5,3265,4.503448275862069,80.0,0.0
725,0,725,[318 427  64 132 496],796,5,3270,4.5041322314049586,80.0,0.0
726,0,726,[318 427  64 132 496],535,5,3275,4.504814305364512,80.0,0.0
727,0,727,[318 427  64 132 496],716,5,3280,4.5054945054945055,80.0,0.0
728,0,728,[318 427  64 132 496],535,5,3285,4.506172839506172,80.0,0.0
729,0,729,[318 427  64 132 496],577,5,3290,4.506849315068493,80.0,0.0
730,0,730,[318 427  64 132 496],236,4,3294,4.506155950752394,80.0,0.0
731,0,731,[204 175  69  25 215],11,0,3294,4.5,0.0,0.0
732,0,732,[318 427  64 132 496],151,5,3299,4.5006821282401095,80.0,0.0
733,0,733,[318 427  64 132 496],577,5,3304,4.501362397820164,80.0,0.0
734,0,734,[318 427  64 132 496],716,5,3309,4.502040816326531,80.0,0.0
735,0,735,[318 427  64 132 496],716,5,3314,4.502717391304348,80.0,0.0
736,0,736,[318 427  64 132 496],716,5,3319,4.503392130257802,80.0,0.0
737,0,737,[318 427  64 132 496],535,5,3324,4.504065040650406,80.0,0.0
738,0,738,[318 427  64 132 496],716,5,3329,4.504736129905277,80.0,0.0
739,0,739,[318 427  64 132 496],716,5,3334,4.505405405405406,80.0,0.0
740,0,740,[318 427  64 132 496],556,5,3339,4.506072874493927,80.0,0.0
741,0,741,[318 427  64 132 496],18,5,3344,4.506738544474394,80.0,0.0
742,0,742,[318 427  64 132 496],330,5,3349,4.507402422611037,80.0,0.0
743,0,743,[318 427  64 132 496],18,5,3354,4.508064516129032,80.0,0.0
744,0,744,[318 427  64 132 496],18,5,3359,4.5087248322147655,80.0,0.0
745,0,745,[318 427  64 132 496],577,5,3364,4.509383378016086,80.0,0.0
746,0,746,[318 427  64 132 496],577,5,3369,4.51004016064257,80.0,0.0
747,0,747,[318 427  64 132 496],450,5,3374,4.510695187165775,80.0,0.0
748,0,748,[318 427  64 132 496],450,5,3379,4.511348464619493,80.0,0.0
749,0,749,[318 427  64 132 496],269,5,3384,4.512,80.0,0.0
750,0,750,[318 427  64 132 496],716,5,3389,4.512649800266312,80.0,0.0
751,0,751,[318 427  64 132 496],151,5,3394,4.513297872340425,80.0,0.0
752,0,752,[318 427  64 132 496],450,5,3399,4.51394422310757,80.0,0.0
753,0,753,[318 427  64 132 496],577,5,3404,4.514588859416445,80.0,0.0
754,0,754,[318 427  64 132 496],236,4,3408,4.513907284768212,80.0,0.0
755,0,755,[318 427  64 132 496],535,5,3413,4.514550264550264,80.0,0.0
756,0,756,[318 427  64 132 496],236,4,3417,4.513870541611625,80.0,0.0
757,0,757,[318 427  64 132  98],269,5,3422,4.514511873350924,60.0,0.0
758,0,758,[318 427  64 132  98],450,5,3427,4.515151515151516,60.0,0.0
759,0,759,[318 427  64 132  98],151,5,3432,4.515789473684211,60.0,0.0
760,0,760,[318 427  64 132  98],151,5,3437,4.516425755584757,60.0,0.0
761,0,761,[318 427  64 132  98],450,5,3442,4.517060367454068,60.0,0.0
762,0,762,[318 427  64 132  98],655,4,3446,4.516382699868938,60.0,0.0
763,0,763,[318 427  64 132  98],716,5,3451,4.517015706806283,60.0,0.0
764,0,764,[318 427  64 132  98],577,5,3456,4.517647058823529,60.0,0.0
765,0,765,[318 427  64 132  98],316,5,3461,4.518276762402089,60.0,0.0
766,0,766,[318 427  64 132  98],693,4,3465,4.517601043024772,60.0,0.0
767,0,767,[318 427  64 132  98],330,5,3470,4.518229166666667,60.0,0.0
768,0,768,[318 427  64 132  98],316,5,3475,4.518855656697009,60.0,0.0
769,0,769,[318 427  64 132  98],316,5,3480,4.51948051948052,60.0,0.0
770,0,770,[318 427  64 132  98],236,5,3485,4.5201037613488975,60.0,0.0
771,0,771,[117 276 405 197 174],457,5,3490,4.520725388601036,0.0,0.0
772,0,772,[318 427  64 132  98],693,4,3494,4.520051746442432,60.0,0.0
773,0,773,[318 427  64 132  98],577,5,3499,4.520671834625323,60.0,0.0
774,0,774,[318 427  64 132  98],716,5,3504,4.521290322580645,60.0,0.0
775,0,775,[318 427  64 132  98],655,4,3508,4.520618556701031,60.0,0.0
776,0,776,[318 427  64 132  98],577,5,3513,4.521235521235521,60.0,0.0
777,0,777,[318 427  64 132  98],693,4,3517,4.520565552699229,60.0,0.0
778,0,778,[318 427  64 132  98],316,5,3522,4.521181001283697,60.0,0.0
779,0,779,[318 427  64 132  98],535,4,3526,4.52051282051282,60.0,0.0
780,0,780,[179 191  98 265 187],655,4,3530,4.519846350832267,0.0,0.0
781,0,781,[318 427  64 132  98],316,5,3535,4.520460358056266,60.0,0.0
782,0,782,[318 427  64 132  98],236,5,3540,4.521072796934866,60.0,0.0
783,0,783,[318 427  64 132  98],330,5,3545,4.521683673469388,60.0,0.0
784,0,784,[318 427  64 132  98],693,4,3549,4.521019108280255,60.0,0.0
785,0,785,[318 427  64 132  98],236,5,3554,4.521628498727735,60.0,0.0
786,0,786,[318 427  64 132  98],716,5,3559,4.522236340533672,60.0,0.0
787,0,787,[318 427  64 132  98],716,5,3564,4.522842639593908,60.0,0.0
788,0,788,[318 427  64 132  98],693,4,3568,4.522179974651458,60.0,0.0
789,0,789,[318 427  64 132  98],450,5,3573,4.522784810126582,60.0,0.0
790,0,790,[318 427  64 132  98],316,5,3578,4.52338811630847,60.0,0.0
791,0,791,[318 427  64 132  98],655,4,3582,4.5227272727272725,60.0,0.0
792,0,792,[318 427  64 132  98],269,5,3587,4.523329129886507,60.0,0.0
793,0,793,[742   1 174 180 546],796,2,3589,4.520151133501259,0.0,0.0
794,0,794,[318 427  64 132  98],655,4,3593,4.519496855345912,60.0,0.0
795,0,795,[118 100 300 228  98],450,4,3597,4.518844221105527,0.0,20.0
796,0,796,[318 427  64 132  98],535,4,3601,4.5181932245922205,60.0,0.0
797,0,797,[318 427  64 132 174],269,4,3605,4.517543859649122,60.0,0.0
798,0,798,[318 427  64 132  50],577,5,3610,4.518147684605757,60.0,20.0
799,0,799,[318 427  64 132  50],577,5,3615,4.51875,60.0,20.0
800,0,800,[318 427  64 132  50],316,4,3619,4.5181023720349565,60.0,20.0
801,0,801,[318 427  64 132  98],316,5,3624,4.5187032418952615,60.0,0.0
802,0,802,[318 427  64 132  98],269,5,3629,4.519302615193026,60.0,0.0
803,0,803,[318 427  64 132  98],716,5,3634,4.519900497512438,60.0,0.0
804,0,804,[318 427  64 132  98],316,5,3639,4.520496894409938,60.0,0.0
805,0,805,[318 427  64 132  98],18,5,3644,4.521091811414392,60.0,0.0
806,0,806,[318 427  64 132  98],693,4,3648,4.520446096654275,60.0,0.0
807,0,807,[318 427  64 132  98],693,4,3652,4.51980198019802,60.0,0.0
808,0,808,[318 427  64 132  98],18,5,3657,4.520395550061805,60.0,0.0
809,0,809,[318 427  64 132  98],655,4,3661,4.519753086419753,60.0,0.0
810,0,810,[318 427  64 132  98],577,5,3666,4.520345252774352,60.0,0.0
811,0,811,[318 427  64 132  98],577,5,3671,4.520935960591133,60.0,0.0
812,0,812,[423 111 127  22 265],457,4,3675,4.520295202952029,0.0,20.0
813,0,813,[318 427  64 132  98],330,5,3680,4.520884520884521,60.0,0.0
814,0,814,[318 427  64 132  98],236,5,3685,4.521472392638037,60.0,0.0
815,0,815,[318 427  64 132  98],151,5,3690,4.522058823529412,60.0,0.0
816,0,816,[318 427  64 132  98],316,5,3695,4.522643818849449,60.0,0.0
817,0,817,[117 302 286 546 222],344,2,3697,4.519559902200489,0.0,20.0
818,0,818,[318 427  64 132  98],236,5,3702,4.52014652014652,60.0,0.0
819,0,819,[318 427  64 132  98],693,4,3706,4.519512195121951,60.0,0.0
820,0,820,[318 427  64 132  98],450,5,3711,4.520097442143727,60.0,0.0
821,0,821,[318 427  64 132  98],796,5,3716,4.520681265206813,60.0,0.0
822,0,822,[318 427  64 132  98],316,5,3721,4.521263669501822,60.0,0.0
823,0,823,[318 427  64 132  98],450,5,3726,4.521844660194175,60.0,0.0
824,0,824,[318 427  64 132  98],693,4,3730,4.5212121212121215,60.0,0.0
825,0,825,[318 427  64 132  98],151,5,3735,4.521791767554479,60.0,0.0
826,0,826,[318 427  64 132  98],716,5,3740,4.522370012091899,60.0,0.0
827,0,827,[318 427  64 132  98],716,5,3745,4.5229468599033815,60.0,0.0
828,0,828,[318 427  64 132  98],693,4,3749,4.522316043425814,60.0,0.0
829,0,829,[318 427  64 132  98],316,5,3754,4.52289156626506,60.0,0.0
830,0,830,[318 427  64 132  98],535,4,3758,4.522262334536703,60.0,0.0
831,0,831,[318 427  64 132  98],330,5,3763,4.522836538461538,60.0,0.0
832,0,832,[318 427  64 132  98],796,5,3768,4.523409363745499,60.0,0.0
833,0,833,[318 427  64 132  98],236,5,3773,4.523980815347722,60.0,0.0
834,0,834,[318 427  64 132  98],450,5,3778,4.524550898203593,60.0,0.0
835,0,835,[318 427  64 132  98],151,5,3783,4.52511961722488,60.0,0.0
836,0,836,[318 427  64 132  98],577,5,3788,4.5256869772998805,60.0,0.0
837,0,837,[318 427  64 132  98],330,5,3793,4.526252983293556,60.0,0.0
838,0,838,[318 427  64 132  98],18,5,3798,4.526817640047676,60.0,0.0
839,0,839,[318 427  64 132  98],18,5,3803,4.527380952380953,60.0,0.0
840,0,840,[318 427  64 132  98],535,4,3807,4.526753864447087,60.0,0.0
841,0,841,[318 427  64 132  98],18,5,3812,4.527315914489312,60.0,0.0
842,0,842,[318 427  64 132  98],450,5,3817,4.5278766310794785,60.0,0.0
843,0,843,[318 427  64 132  98],716,5,3822,4.528436018957346,60.0,0.0
844,0,844,[318 427  64 132  98],316,5,3827,4.528994082840237,60.0,0.0
845,0,845,[318 427  64 132  98],535,4,3831,4.528368794326241,60.0,0.0
846,0,846,[269 748 603 235  96],450,4,3835,4.527744982290437,20.0,0.0
847,0,847,[318 427  64 132 496],18,5,3840,4.528301886792453,80.0,0.0
848,0,848,[318 427  64 132 496],18,5,3845,4.528857479387515,80.0,0.0
849,0,849,[318 427  64 132 496],556,5,3850,4.529411764705882,80.0,0.0
850,0,850,[318 427  64 132 496],18,5,3855,4.529964747356051,80.0,0.0
851,0,851,[318 427  64 132 496],556,5,3860,4.530516431924883,80.0,0.0
852,0,852,[318 427  64 132 496],450,5,3865,4.531066822977726,80.0,0.0
853,0,853,[318 427  64 132 496],18,5,3870,4.531615925058548,80.0,0.0
854,0,854,[318 427  64 132 496],450,5,3875,4.5321637426900585,80.0,0.0
855,0,855,[318 427  64 132 496],269,5,3880,4.5327102803738315,80.0,0.0
856,0,856,[318 427  64 132 496],450,5,3885,4.533255542590432,80.0,0.0
857,0,857,[179 265 197 483  15],457,5,3890,4.533799533799534,0.0,0.0
858,0,858,[318 427  64 132 496],716,5,3895,4.534342258440047,80.0,0.0
859,0,859,[318 427  64 132 496],577,5,3900,4.534883720930233,80.0,0.0
860,0,860,[318 427  64 132 496],556,5,3905,4.535423925667828,80.0,0.0
861,0,861,[318 427  64 132 496],151,5,3910,4.535962877030163,80.0,0.0
862,0,862,[318 427  64 132 496],18,5,3915,4.536500579374276,80.0,0.0
863,0,863,[318 427  64 132 496],796,5,3920,4.537037037037037,80.0,0.0
864,0,864,[318 427  64 132 496],716,5,3925,4.53757225433526,80.0,0.0
865,0,865,[318 427  64 132 496],796,5,3930,4.53810623556582,80.0,0.0
866,0,866,[318 427  64 132 496],535,5,3935,4.538638985005767,80.0,0.0
867,0,867,[318 427  64 132 496],450,5,3940,4.539170506912442,80.0,0.0
868,0,868,[318 427  64 132 496],330,5,3945,4.53970080552359,80.0,0.0
869,0,869,[318 427  64 132 496],18,5,3950,4.540229885057471,80.0,0.0
870,0,870,[318 427  64 132 496],236,4,3954,4.539609644087256,80.0,0.0
871,0,871,[318 427  64 132 496],577,5,3959,4.540137614678899,80.0,0.0
872,0,872,[ 82 200 588 195 210],280,2,3961,4.5372279495990835,0.0,0.0
873,0,873,[427 222 271  89 143],807,4,3965,4.536613272311213,20.0,0.0
874,0,874,[318 427  64 132 496],236,4,3969,4.536,80.0,0.0
875,0,875,[318 427  64 132 302],556,5,3974,4.536529680365297,60.0,0.0
876,0,876,[172 153  22 385 135],330,4,3978,4.535917901938427,0.0,0.0
877,0,877,[186 161 183  15  50],786,4,3982,4.5353075170842825,0.0,20.0
878,0,878,[318 427  64 132 302],450,5,3987,4.535836177474403,60.0,0.0
879,0,879,[318 427  64 132 302],269,4,3991,4.535227272727273,60.0,0.0
880,0,880,[318 427  64 132 496],450,5,3996,4.535754824063564,80.0,0.0
881,0,881,[318 427  64 132 496],796,5,4001,4.536281179138322,80.0,0.0
882,0,882,[111 172 153 196 323],796,4,4005,4.535673839184598,0.0,0.0
883,0,883,[318 427  64 132 496],716,5,4010,4.536199095022624,80.0,0.0
884,0,884,[318 427  64 132 496],330,5,4015,4.536723163841808,80.0,0.0
885,0,885,[234 496 179  89 275],18,3,4018,4.534988713318285,20.0,20.0
886,0,886,[318 427  64 132 496],450,5,4023,4.535512965050732,80.0,0.0
887,0,887,[318 427  64 132 496],716,5,4028,4.536036036036036,80.0,0.0
888,0,888,[318 427  64 132 496],269,5,4033,4.536557930258717,80.0,0.0
889,0,889,[318 427  64 132 496],556,5,4038,4.537078651685393,80.0,0.0
890,0,890,[318 427  64 132 496],577,5,4043,4.537598204264871,80.0,0.0
891,0,891,[318 427  64 132 496],236,4,4047,4.536995515695067,80.0,0.0
892,0,892,[318 427  64 132 588],316,4,4051,4.536394176931691,60.0,0.0
893,0,893,[318 427  64 132 496],236,4,4055,4.53579418344519,80.0,0.0
894,0,894,[237 196 127 176 301],655,1,4056,4.5318435754189945,0.0,20.0
895,0,895,[318 427  64 132  98],151,5,4061,4.532366071428571,60.0,0.0
896,0,896,[318 427  64 132  98],577,5,4066,4.53288740245262,60.0,0.0
897,0,897,[318 427  64 132  98],577,5,4071,4.533407572383074,60.0,0.0
898,0,898,[318 427  64 132  98],716,5,4076,4.53392658509455,60.0,0.0
899,0,899,[318 427  64 132  98],151,5,4081,4.5344444444444445,60.0,0.0
900,0,900,[289 403   8  88  96],756,3,4084,4.532741398446171,0.0,0.0
901,0,901,[318 427  64 132  98],693,4,4088,4.532150776053215,60.0,0.0
902,0,902,[318 427  64 132  98],693,4,4092,4.53156146179402,60.0,0.0
903,0,903,[568 132 483 655   4],450,3,4095,4.529867256637168,0.0,0.0
904,0,904,[318 427  64 132  98],535,4,4099,4.529281767955801,60.0,0.0
905,0,905,[318 427  64 132 496],556,5,4104,4.529801324503311,80.0,0.0
906,0,906,[318 322 302 258 268],204,2,4106,4.527012127894157,20.0,0.0
907,0,907,[318 427  64 132 496],577,5,4111,4.527533039647577,80.0,0.0
908,0,908,[318 427  64 132 496],556,5,4116,4.528052805280528,80.0,0.0
909,0,909,[318 427  64 132 496],269,5,4121,4.5285714285714285,80.0,0.0
910,0,910,[318 427  64 132 496],556,5,4126,4.5290889132821075,80.0,0.0
911,0,911,[318 427  64 132 496],796,5,4131,4.529605263157895,80.0,0.0
912,0,912,[318 427  64 132 496],796,5,4136,4.530120481927711,80.0,0.0
913,0,913,[318 427  64 132 496],450,5,4141,4.530634573304158,80.0,0.0
914,0,914,[318 427  64 132 496],269,5,4146,4.531147540983606,80.0,0.0
915,0,915,[318 427  64 132 496],556,5,4151,4.531659388646288,80.0,0.0
916,0,916,[318 427  64 132 496],450,5,4156,4.53217011995638,80.0,0.0
917,0,917,[318 427  64 132 496],535,5,4161,4.532679738562091,80.0,0.0
918,0,918,[318 427  64 132 496],577,5,4166,4.533188248095756,80.0,0.0
919,0,919,[318 427  64 132 496],796,5,4171,4.533695652173913,80.0,0.0
920,0,920,[318 427  64 132 496],535,5,4176,4.534201954397394,80.0,0.0
921,0,921,[ 98 211  95  71  79],389,4,4180,4.533622559652929,0.0,0.0
922,0,922,[318 427  64 132 496],556,5,4185,4.534127843986999,80.0,0.0
923,0,923,[318 427  64 132 496],269,5,4190,4.534632034632034,80.0,0.0
924,0,924,[318 427  64 132 496],330,5,4195,4.535135135135135,80.0,0.0
925,0,925,[318 427  64 132 496],450,5,4200,4.535637149028077,80.0,0.0
926,0,926,[318 427  64 132 496],330,5,4205,4.5361380798274,80.0,0.0
927,0,927,[318 427  64 132 496],236,4,4209,4.535560344827586,80.0,0.0
928,0,928,[318 100 181  88 237],655,1,4210,4.531754574811625,20.0,20.0
929,0,929,[318 427  64 132 496],330,5,4215,4.532258064516129,80.0,0.0
930,0,930,[ 64 257  96 100 288],457,4,4219,4.531686358754028,20.0,20.0
931,0,931,[ 89 271 265 204 117],807,4,4223,4.531115879828326,0.0,0.0
932,0,932,[318 427  64 132 496],330,5,4228,4.531618435155413,80.0,0.0
933,0,933,[318 427  64 132 496],716,5,4233,4.532119914346895,80.0,0.0
934,0,934,[318 427  64 132 496],577,5,4238,4.532620320855615,80.0,0.0
935,0,935,[318 427  64 132 496],236,4,4242,4.532051282051282,80.0,0.0
936,0,936,[318 427  64 132  98],18,5,4247,4.532550693703309,60.0,0.0
937,0,937,[318 427  64 132  98],535,4,4251,4.531982942430703,60.0,0.0
938,0,938,[318 427  64 132 496],151,5,4256,4.532481363152289,80.0,0.0
939,0,939,[318 427  64 132 496],796,5,4261,4.532978723404256,80.0,0.0
940,0,940,[318 427  64 132 496],716,5,4266,4.533475026567482,80.0,0.0
941,0,941,[318 427  64 132 496],236,4,4270,4.532908704883227,80.0,0.0
942,0,942,[318 427  64 132 496],716,5,4275,4.533404029692471,80.0,0.0
943,0,943,[318 427  64 132 496],151,5,4280,4.533898305084746,80.0,0.0
944,0,944,[318 427  64 132 496],556,5,4285,4.534391534391534,80.0,0.0
945,0,945,[318 427  64 132 496],151,5,4290,4.534883720930233,80.0,0.0
946,0,946,[318 427  64 132 496],716,5,4295,4.535374868004224,80.0,0.0
947,0,947,[318 427  64 132 496],577,5,4300,4.5358649789029535,80.0,0.0
948,0,948,[318 427  64 132 496],450,5,4305,4.536354056902002,80.0,0.0
949,0,949,[318 427  64 132 496],535,5,4310,4.536842105263158,80.0,0.0
950,0,950,[318 427  64 132 496],556,5,4315,4.53732912723449,80.0,0.0
951,0,951,[318 427  64 132 496],450,5,4320,4.53781512605042,80.0,0.0
952,0,952,[318 427  64 132 496],269,5,4325,4.538300104931794,80.0,0.0
953,0,953,[318 427  64 132 496],18,5,4330,4.538784067085954,80.0,0.0
954,0,954,[318 427  64 132 496],450,5,4335,4.539267015706806,80.0,0.0
955,0,955,[318 427  64 132 496],577,5,4340,4.539748953974895,80.0,0.0
956,0,956,[318 427  64 132 496],236,4,4344,4.539184952978056,80.0,0.0
957,0,957,[318 427  64 132 496],796,5,4349,4.539665970772442,80.0,0.0
958,0,958,[318 427  64 132 496],330,5,4354,4.54014598540146,80.0,0.0
959,0,959,[318 427  64 132 496],577,5,4359,4.540625,80.0,0.0
960,0,960,[318 427  64 132 496],151,5,4364,4.541103017689906,80.0,0.0
961,0,961,[318 427  64 132 496],236,4,4368,4.54054054054054,80.0,0.0
962,0,962,[318 427  64 132 496],577,5,4373,4.541017653167186,80.0,0.0
963,0,963,[318 427  64 132 496],556,5,4378,4.54149377593361,80.0,0.0
964,0,964,[318 427  64 132 496],450,5,4383,4.541968911917098,80.0,0.0
965,0,965,[318 427  64 132 496],535,5,4388,4.542443064182194,80.0,0.0
966,0,966,[318 427  64 132 496],535,5,4393,4.5429162357807655,80.0,0.0
967,0,967,[318 427  64 132 496],330,5,4398,4.543388429752066,80.0,0.0
968,0,968,[318 427  64 132 496],236,4,4402,4.542827657378741,80.0,0.0
969,0,969,[423   8 234   4 357],457,5,4407,4.543298969072165,0.0,0.0
970,0,970,[318 427  64 132 127],655,4,4411,4.542739443872296,60.0,20.0
971,0,971,[318 427  64 132 127],236,5,4416,4.54320987654321,60.0,20.0
972,0,972,[318 427  64 132 127],269,5,4421,4.543679342240494,60.0,20.0
973,0,973,[318 427  64 132 127],269,5,4426,4.544147843942505,60.0,20.0
974,0,974,[318 427  64 132 127],796,5,4431,4.544615384615384,60.0,20.0
975,0,975,[318 427  64 132 127],269,5,4436,4.545081967213115,60.0,20.0
976,0,976,[318 427  64 132 127],18,5,4441,4.5455475946775845,60.0,20.0
977,0,977,[318 427  64 132 127],655,4,4445,4.544989775051125,60.0,20.0
978,0,978,[318 427  64 132 127],655,4,4449,4.544433094994893,60.0,20.0
979,0,979,[546 195  50 125 265],280,2,4451,4.541836734693877,0.0,20.0
980,0,980,[318 427  64 132 127],716,5,4456,4.54230377166157,60.0,20.0
981,0,981,[318 427  64 132 127],450,5,4461,4.542769857433808,60.0,20.0
982,0,982,[318 427  64 132 127],450,5,4466,4.54323499491353,60.0,20.0
983,0,983,[318 427  64 132 127],316,4,4470,4.5426829268292686,60.0,20.0
984,0,984,[318 427  64 132  98],236,5,4475,4.543147208121828,60.0,0.0
985,0,985,[318 427  64 132  98],796,5,4480,4.543610547667343,60.0,0.0
986,0,986,[318 427  64 132  98],450,5,4485,4.544072948328267,60.0,0.0
987,0,987,[318 427  64 132  98],151,5,4490,4.544534412955466,60.0,0.0
988,0,988,[318 427  64 132  98],693,4,4494,4.543983822042467,60.0,0.0
989,0,989,[182 194 234  97 265],450,4,4498,4.543434343434344,0.0,0.0
990,0,990,[318 427  64 132  98],236,5,4503,4.543895055499496,60.0,0.0
991,0,991,[318 427  64 132  98],330,5,4508,4.544354838709677,60.0,0.0
992,0,992,[318 427  64 132  98],330,5,4513,4.544813695871098,60.0,0.0
993,0,993,[318 427  64 132  98],796,5,4518,4.545271629778672,60.0,0.0
994,0,994,[318 427  64 132  98],716,5,4523,4.545728643216081,60.0,0.0
995,0,995,[318 427  64 132  98],693,4,4527,4.545180722891566,60.0,0.0
996,0,996,[318 427  64 132  98],716,5,4532,4.545636910732196,60.0,0.0
997,0,997,[318 427  64 132  98],716,5,4537,4.546092184368738,60.0,0.0
998,0,998,[318 427  64 132  98],577,5,4542,4.546546546546547,60.0,0.0
999,0,999,[318 427  64 132  98],316,5,4547,4.547,60.0,0.0
1000,0,1000,[515 135 471  88   8],655,2,4549,4.544455544455545,0.0,0.0
1001,0,1001,[318 427  64 132  98],716,5,4554,4.544910179640719,60.0,0.0
1002,0,1002,[318 427  64 132  98],151,5,4559,4.545363908275174,60.0,0.0
1003,0,1003,[194 323 483  95 385],796,4,4563,4.544820717131474,0.0,0.0
1004,0,1004,[318 427  64 132  98],18,5,4568,4.545273631840796,60.0,0.0
1005,0,1005,[318 427  64 132  98],693,4,4572,4.544731610337972,60.0,0.0
1006,0,1006,[318 427  64 132  98],269,5,4577,4.545183714001986,60.0,0.0
1007,0,1007,[318 427  64 132  98],151,5,4582,4.545634920634921,60.0,0.0
1008,0,1008,[318 427  64 132  98],450,5,4587,4.546085232903865,60.0,0.0
1009,0,1009,[318 427  64 132  98],269,5,4592,4.546534653465346,60.0,0.0
1010,0,1010,[318 427  64 132  98],655,4,4596,4.545994065281899,60.0,0.0
1011,0,1011,[318 427  64 132  98],655,4,4600,4.545454545454546,60.0,0.0
1012,0,1012,[318 427  64 132  98],236,5,4605,4.545903257650543,60.0,0.0
1013,0,1013,[318 427  64 132  98],655,4,4609,4.545364891518737,60.0,0.0
1014,0,1014,[318 427  64 132  98],151,5,4614,4.545812807881774,60.0,0.0
1015,0,1015,[318 427  64 132  98],450,5,4619,4.546259842519685,60.0,0.0
1016,0,1016,[318 427  64 132  98],151,5,4624,4.546705998033431,60.0,0.0
1017,0,1017,[318 427  64 132  98],450,5,4629,4.547151277013753,60.0,0.0
1018,0,1018,[318 427  64 132  98],236,5,4634,4.547595682041217,60.0,0.0
1019,0,1019,[ 15 194 187 191 423],269,4,4638,4.547058823529412,0.0,0.0
1020,0,1020,[318 427  64 132  98],450,5,4643,4.547502448579824,60.0,0.0
1021,0,1021,[318 427  64 132  98],269,5,4648,4.5479452054794525,60.0,0.0
1022,0,1022,[318 427  64 132  98],269,5,4653,4.548387096774194,60.0,0.0
1023,0,1023,[318 427  64 132  98],18,5,4658,4.548828125,60.0,0.0
1024,0,1024,[318 427  64 132  98],693,4,4662,4.548292682926829,60.0,0.0
1025,0,1025,[318 427  64 132  98],535,4,4666,4.5477582846003894,60.0,0.0
1026,0,1026,[318 427  64 132  98],693,4,4670,4.547224926971762,60.0,0.0
1027,0,1027,[318 427  64 132  98],450,5,4675,4.547665369649805,60.0,0.0
1028,0,1028,[318 427  64 132  98],693,4,4679,4.5471331389698735,60.0,0.0
1029,0,1029,[318 427  64 132  98],269,5,4684,4.5475728155339805,60.0,0.0
1030,0,1030,[275 234 288 187 268],655,2,4686,4.545101842870999,0.0,20.0
1031,0,1031,[318 427  64 132  98],655,4,4690,4.544573643410852,60.0,0.0
1032,0,1032,[318 427  64 132  98],316,5,4695,4.545014520813165,60.0,0.0
1033,0,1033,[318 427  64 132  98],716,5,4700,4.545454545454546,60.0,0.0
1034,0,1034,[318 427  64 132  98],151,5,4705,4.545893719806763,60.0,0.0
1035,0,1035,[318 427  64 132  98],535,4,4709,4.545366795366795,60.0,0.0
1036,0,1036,[318 427  64 132  98],535,4,4713,4.544840887174542,60.0,0.0
1037,0,1037,[318 427  64 132 496],535,5,4718,4.545279383429673,80.0,0.0
1038,0,1038,[318 427  64 132 496],577,5,4723,4.5457170356111645,80.0,0.0
1039,0,1039,[318 427  64 132 496],330,5,4728,4.546153846153846,80.0,0.0
1040,0,1040,[318 427  64 132 496],18,5,4733,4.54658981748319,80.0,0.0
1041,0,1041,[318 427  64 132 496],18,5,4738,4.547024952015355,80.0,0.0
1042,0,1042,[318 427  64 132 496],556,5,4743,4.547459252157239,80.0,0.0
1043,0,1043,[318 427  64 132 496],796,5,4748,4.547892720306513,80.0,0.0
1044,0,1044,[318 427  64 132 496],151,5,4753,4.548325358851675,80.0,0.0
1045,0,1045,[204 318 435 125 153],655,1,4754,4.544933078393881,20.0,0.0
1046,0,1046,[318 427  64 132 496],330,5,4759,4.545367717287488,80.0,0.0
1047,0,1047,[318 427  64 132 496],236,4,4763,4.544847328244275,80.0,0.0
1048,0,1048,[318 427  64 132  98],330,5,4768,4.5452812202097235,60.0,0.0
1049,0,1049,[318 427  64 132  98],151,5,4773,4.545714285714285,60.0,0.0
1050,0,1050,[318 427  64 132  98],269,5,4778,4.546146527117031,60.0,0.0
1051,0,1051,[318 427  64 132  98],450,5,4783,4.5465779467680605,60.0,0.0
1052,0,1052,[318 427  64 132  98],716,5,4788,4.547008547008547,60.0,0.0
1053,0,1053,[318 427  64 132  98],18,5,4793,4.547438330170778,60.0,0.0
1054,0,1054,[318 427  64 132  98],316,5,4798,4.547867298578199,60.0,0.0
1055,0,1055,[318 427  64 132  98],577,5,4803,4.548295454545454,60.0,0.0
1056,0,1056,[318 427  64 132  98],18,5,4808,4.54872280037843,60.0,0.0
1057,0,1057,[318 427  64 132  98],18,5,4813,4.549149338374291,60.0,0.0
1058,0,1058,[ 79 258 151  25 179],535,4,4817,4.548630783758263,0.0,0.0
1059,0,1059,[318 427  64 132  98],577,5,4822,4.549056603773585,60.0,0.0
1060,0,1060,[318 427  64 132  98],577,5,4827,4.549481621112158,60.0,0.0
1061,0,1061,[318 427  64 132  98],151,5,4832,4.549905838041432,60.0,0.0
1062,0,1062,[318 427  64 132  98],269,5,4837,4.55032925682032,60.0,0.0
1063,0,1063,[318 427  64 132  98],450,5,4842,4.5507518796992485,60.0,0.0
1064,0,1064,[318 427  64 132  98],577,5,4847,4.551173708920188,60.0,0.0
1065,0,1065,[318 427  64 132  98],450,5,4852,4.551594746716698,60.0,0.0
1066,0,1066,[318 427  64 132  98],577,5,4857,4.552014995313964,60.0,0.0
1067,0,1067,[318 427  64 132  98],330,5,4862,4.552434456928839,60.0,0.0
1068,0,1068,[318 427  64 132  98],716,5,4867,4.5528531337698785,60.0,0.0
1069,0,1069,[200 181  15 483  88],655,2,4869,4.550467289719626,0.0,0.0
1070,0,1070,[318 427  64 132  98],577,5,4874,4.550887021475257,60.0,0.0
1071,0,1071,[318 427  64 132  98],316,5,4879,4.5513059701492535,60.0,0.0
1072,0,1072,[318 427  64 132  98],316,5,4884,4.551724137931035,60.0,0.0
1073,0,1073,[318 427  64 132  98],535,4,4888,4.5512104283054,60.0,0.0
1074,0,1074,[318 427  64 132  98],236,5,4893,4.551627906976744,60.0,0.0
1075,0,1075,[318 427  64 132  98],236,5,4898,4.552044609665428,60.0,0.0
1076,0,1076,[588  98 405 235 143],457,4,4902,4.5515320334261835,0.0,0.0
1077,0,1077,[318 427  64 132  98],693,4,4906,4.551020408163265,60.0,0.0
1078,0,1078,[318 427  64 132  98],151,5,4911,4.551436515291937,60.0,0.0
1079,0,1079,[318 427  64 132  98],693,4,4915,4.550925925925926,60.0,0.0
1080,0,1080,[318 427  64 132  98],716,5,4920,4.551341350601295,60.0,0.0
1081,0,1081,[318 427  64 132  98],535,4,4924,4.550831792975971,60.0,0.0
1082,0,1082,[318 427  64 132 588],316,4,4928,4.550323176361958,60.0,0.0
1083,0,1083,[318 427  64 132  98],316,5,4933,4.550738007380073,60.0,0.0
1084,0,1084,[318 427  64 132  98],535,4,4937,4.550230414746544,60.0,0.0
1085,0,1085,[318 427  64 132 496],450,5,4942,4.550644567219153,80.0,0.0
1086,0,1086,[318 427  64 132 496],796,5,4947,4.551057957681692,80.0,0.0
1087,0,1087,[318 427  64 132 496],716,5,4952,4.551470588235294,80.0,0.0
1088,0,1088,[318 427  64 132 496],151,5,4957,4.55188246097337,80.0,0.0
1089,0,1089,[318 427  64 132 496],450,5,4962,4.552293577981652,80.0,0.0
1090,0,1090,[258 185 318 603 153],796,5,4967,4.552703941338222,40.0,0.0
1091,0,1091,[318 427  64 132 496],18,5,4972,4.553113553113553,80.0,0.0
1092,0,1092,[318 427  64 132 496],556,5,4977,4.55352241537054,80.0,0.0
1093,0,1093,[318 427  64 132 496],269,5,4982,4.553930530164534,80.0,0.0
1094,0,1094,[318 427  64 132 496],450,5,4987,4.554337899543379,80.0,0.0
1095,0,1095,[318 427  64 132 496],535,5,4992,4.554744525547445,80.0,0.0
1096,0,1096,[318 427  64 132 496],556,5,4997,4.555150410209663,80.0,0.0
1097,0,1097,[318 427  64 132 496],269,5,5002,4.555555555555555,80.0,0.0
1098,0,1098,[318 427  64 132 496],535,5,5007,4.555959963603276,80.0,0.0
1099,0,1099,[318 427  64 132 496],151,5,5012,4.556363636363637,80.0,0.0
1100,0,1100,[318 427  64 132 496],450,5,5017,4.556766575840145,80.0,0.0
1101,0,1101,[318 427  64 132 496],330,5,5022,4.557168784029038,80.0,0.0
1102,0,1102,[318 427  64 132 496],796,5,5027,4.557570262919311,80.0,0.0
1103,0,1103,[318 427  64 132 496],796,5,5032,4.557971014492754,80.0,0.0
1104,0,1104,[318 427  64 132 496],450,5,5037,4.558371040723982,80.0,0.0
1105,0,1105,[200 603 357 191 179],18,3,5040,4.556962025316456,20.0,0.0
1106,0,1106,[318 427  64 132 496],556,5,5045,4.55736224028907,80.0,0.0
1107,0,1107,[318 427  64 132 496],236,4,5049,4.556859205776173,80.0,0.0
1108,0,1108,[318 427  64 132 496],796,5,5054,4.557258791704238,80.0,0.0
1109,0,1109,[318 427  64 132 496],577,5,5059,4.557657657657658,80.0,0.0
1110,0,1110,[318 427  64 132 496],577,5,5064,4.558055805580558,80.0,0.0
1111,0,1111,[318 427  64 132 496],716,5,5069,4.558453237410072,80.0,0.0
1112,0,1112,[318 427  64 132 496],716,5,5074,4.55884995507637,80.0,0.0
1113,0,1113,[318 427  64 132 496],796,5,5079,4.559245960502693,80.0,0.0
1114,0,1114,[318 427  64 132 496],236,4,5083,4.558744394618834,80.0,0.0
1115,0,1115,[318 427  64 132 496],535,5,5088,4.559139784946237,80.0,0.0
1116,0,1116,[318 427  64 132 496],151,5,5093,4.5595344673231875,80.0,0.0
1117,0,1117,[318 427  64 132 496],151,5,5098,4.559928443649373,80.0,0.0
1118,0,1118,[318 427  64 132 496],18,5,5103,4.560321715817694,80.0,0.0
1119,0,1119,[318 427  64 132 496],556,5,5108,4.560714285714286,80.0,0.0
1120,0,1120,[318 427  64 132 496],450,5,5113,4.561106155218555,80.0,0.0
1121,0,1121,[318 427  64 132 496],796,5,5118,4.561497326203209,80.0,0.0
1122,0,1122,[318 427  64 132 496],330,5,5123,4.561887800534283,80.0,0.0
1123,0,1123,[318 427  64 132 496],18,5,5128,4.562277580071174,80.0,0.0
1124,0,1124,[318 427  64 132 496],796,5,5133,4.562666666666667,80.0,0.0
1125,0,1125,[318 427  64 132 496],450,5,5138,4.5630550621669625,80.0,0.0
1126,0,1126,[318 427  64 132 496],716,5,5143,4.563442768411712,80.0,0.0
1127,0,1127,[318 427  64 132 496],716,5,5148,4.5638297872340425,80.0,0.0
1128,0,1128,[318 427  64 132 496],236,4,5152,4.563330380868025,80.0,0.0
1129,0,1129,[318 427  64 132 496],18,5,5157,4.563716814159292,80.0,0.0
1130,0,1130,[318 427  64 132 496],236,4,5161,4.563218390804598,80.0,0.0
1131,0,1131,[318 427  64 132 496],330,5,5166,4.563604240282685,80.0,0.0
1132,0,1132,[318 427  64 132 496],18,5,5171,4.5639894086496025,80.0,0.0
1133,0,1133,[318 427  64 132 496],330,5,5176,4.564373897707231,80.0,0.0
1134,0,1134,[318 427  64 132 496],796,5,5181,4.564757709251102,80.0,0.0
1135,0,1135,[318 427  64 132 496],796,5,5186,4.565140845070423,80.0,0.0
1136,0,1136,[318 427  64 132 496],236,4,5190,4.564643799472296,80.0,0.0
1137,0,1137,[318 427  64 132  98],18,5,5195,4.565026362038664,60.0,0.0
1138,0,1138,[318 427  64 132  98],316,5,5200,4.565408252853381,60.0,0.0
1139,0,1139,[318 427  64 132  98],18,5,5205,4.565789473684211,60.0,0.0
1140,0,1140,[318 427  64 132  98],577,5,5210,4.566170026292726,60.0,0.0
1141,0,1141,[318 427  64 132  98],577,5,5215,4.566549912434326,60.0,0.0
1142,0,1142,[318 427  64 132  98],535,4,5219,4.566054243219598,60.0,0.0
1143,0,1143,[318 427  64 132 496],18,5,5224,4.566433566433567,80.0,0.0
1144,0,1144,[318 427  64 132 496],151,5,5229,4.5668122270742355,80.0,0.0
1145,0,1145,[318 427  64 132 496],450,5,5234,4.56719022687609,80.0,0.0
1146,0,1146,[318 427  64 132 496],577,5,5239,4.5675675675675675,80.0,0.0
1147,0,1147,[318 427  64 132 496],577,5,5244,4.56794425087108,80.0,0.0
1148,0,1148,[174 302 288 117 186],655,1,5245,4.564838990426458,0.0,0.0
1149,0,1149,[318 427  64 132 496],535,5,5250,4.565217391304348,80.0,0.0
1150,0,1150,[318 427  64 132 496],269,5,5255,4.565595134665508,80.0,0.0
1151,0,1151,[318 427  64 132 496],577,5,5260,4.565972222222222,80.0,0.0
1152,0,1152,[318 427  64 132 496],450,5,5265,4.566348655680833,80.0,0.0
1153,0,1153,[318 427  64 132 496],330,5,5270,4.566724436741768,80.0,0.0
1154,0,1154,[318 427  64 132 496],330,5,5275,4.567099567099567,80.0,0.0
1155,0,1155,[318 427  64 132 496],535,5,5280,4.567474048442906,80.0,0.0
1156,0,1156,[318 427  64 132 496],236,4,5284,4.566983578219533,80.0,0.0
1157,0,1157,[318 427  64 132 496],269,5,5289,4.567357512953368,80.0,0.0
1158,0,1158,[168  12  56 125 194],577,4,5293,4.566867989646247,0.0,0.0
1159,0,1159,[216 268 222 275   8],655,2,5295,4.564655172413793,0.0,20.0
1160,0,1160,[318 427  64 132 496],450,5,5300,4.565030146425495,80.0,0.0
1161,0,1161,[318 427  64 132 496],18,5,5305,4.565404475043029,80.0,0.0
1162,0,1162,[318 427  64 132 496],269,5,5310,4.565778159931212,80.0,0.0
1163,0,1163,[318 427  64 132 496],556,5,5315,4.566151202749141,80.0,0.0
1164,0,1164,[234  70 127 161 197],280,3,5318,4.5648068669527895,0.0,20.0
1165,0,1165,[318 427  64 132 496],535,5,5323,4.565180102915952,80.0,0.0
1166,0,1166,[276 143 175  89  28],655,3,5326,4.563838903170523,0.0,0.0
1167,0,1167,[318 427  64 132 496],716,5,5331,4.564212328767123,80.0,0.0
1168,0,1168,[318 427  64 132 496],716,5,5336,4.564585115483319,80.0,0.0
1169,0,1169,[568  50 117  22 228],716,5,5341,4.564957264957265,0.0,20.0
1170,0,1170,[318 427  64 132 496],330,5,5346,4.56532877882152,80.0,0.0
1171,0,1171,[318 427  64 132 496],330,5,5351,4.565699658703072,80.0,0.0
1172,0,1172,[318 427  64 132 496],269,5,5356,4.566069906223359,80.0,0.0
1173,0,1173,[318 427  64 132 496],18,5,5361,4.566439522998296,80.0,0.0
1174,0,1174,[318 427  64 132 496],151,5,5366,4.566808510638298,80.0,0.0
1175,0,1175,[318 427  64 132 496],796,5,5371,4.567176870748299,80.0,0.0
1176,0,1176,[286 301 135 655 258],629,4,5375,4.566694987255735,0.0,20.0
1177,0,1177,[318 427  64 132 496],796,5,5380,4.567062818336163,80.0,0.0
1178,0,1178,[318 427  64 132 496],269,5,5385,4.567430025445293,80.0,0.0
1179,0,1179,[318 427  64 132 496],556,5,5390,4.567796610169491,80.0,0.0
1180,0,1180,[318 427  64 132 496],330,5,5395,4.5681625740897545,80.0,0.0
1181,0,1181,[318 427  64 132 496],796,5,5400,4.568527918781726,80.0,0.0
1182,0,1182,[200 121  22 100 228],577,3,5403,4.56720202874049,0.0,20.0
1183,0,1183,[318 427  64 132 496],716,5,5408,4.5675675675675675,80.0,0.0
1184,0,1184,[318 427  64 132 496],18,5,5413,4.567932489451477,80.0,0.0
1185,0,1185,[318 427  64 132 496],330,5,5418,4.568296795952782,80.0,0.0
1186,0,1186,[357 257 181 179 118],655,2,5420,4.566133108677338,0.0,0.0
1187,0,1187,[318 427  64 132 496],535,5,5425,4.566498316498317,80.0,0.0
1188,0,1188,[318 427  64 132 496],450,5,5430,4.56686291000841,80.0,0.0
1189,0,1189,[318 427  64 132 496],796,5,5435,4.567226890756302,80.0,0.0
1190,0,1190,[318 427  64 132 496],716,5,5440,4.567590260285474,80.0,0.0
1191,0,1191,[318 427  64 132 496],716,5,5445,4.567953020134228,80.0,0.0
1192,0,1192,[318 427  64 132 496],330,5,5450,4.5683151718357085,80.0,0.0
1193,0,1193,[318 427  64 132 496],330,5,5455,4.568676716917923,80.0,0.0
1194,0,1194,[318 427  64 132 496],716,5,5460,4.569037656903766,80.0,0.0
1195,0,1195,[318 427  64 132 496],269,5,5465,4.5693979933110365,80.0,0.0
1196,0,1196,[318 427  64 132 496],577,5,5470,4.569757727652465,80.0,0.0
1197,0,1197,[318 427  64 132 496],577,5,5475,4.570116861435726,80.0,0.0
1198,0,1198,[318 427  64 132 496],535,5,5480,4.570475396163469,80.0,0.0
1199,0,1199,[195 546 144 603 357],450,5,5485,4.570833333333334,20.0,0.0
1200,0,1200,[318 427  64 132 496],269,5,5490,4.571190674437968,80.0,0.0
1201,0,1201,[318 427  64 132 496],450,5,5495,4.571547420965058,80.0,0.0
1202,0,1202,[318 427  64 132 496],577,5,5500,4.57190357439734,80.0,0.0
1203,0,1203,[318 427  64 132 496],535,5,5505,4.572259136212624,80.0,0.0
1204,0,1204,[318 427  64 132 496],716,5,5510,4.572614107883817,80.0,0.0
1205,0,1205,[318 427  64 132 496],269,5,5515,4.572968490878939,80.0,0.0
1206,0,1206,[318 427  64 132 496],716,5,5520,4.573322286661143,80.0,0.0
1207,0,1207,[318 427  64 132 496],450,5,5525,4.573675496688741,80.0,0.0
1208,0,1208,[318 427  64 132 496],716,5,5530,4.5740281224152195,80.0,0.0
1209,0,1209,[318 427  64 132 496],236,4,5534,4.573553719008265,80.0,0.0
1210,0,1210,[318 427  64 132 496],535,5,5539,4.573905862923204,80.0,0.0
1211,0,1211,[742 100  64 245 111],344,3,5542,4.572607260726072,20.0,20.0
1212,0,1212,[318 427  64 132 496],269,5,5547,4.572959604286892,80.0,0.0
1213,0,1213,[318 427  64 132 496],716,5,5552,4.57331136738056,80.0,0.0
1214,0,1214,[318 427  64 132 496],556,5,5557,4.5736625514403295,80.0,0.0
1215,0,1215,[318 427  64 132 496],716,5,5562,4.574013157894737,80.0,0.0
1216,0,1216,[471 269 176  69 204],450,5,5567,4.574363188167625,0.0,0.0
1217,0,1217,[318 427  64 132 496],151,5,5572,4.574712643678161,80.0,0.0
1218,0,1218,[318 427  64 132 496],236,4,5576,4.574241181296144,80.0,0.0
1219,0,1219,[318 427  64 132 496],269,5,5581,4.574590163934427,80.0,0.0
1220,0,1220,[318 427  64 132 496],151,5,5586,4.574938574938575,80.0,0.0
1221,0,1221,[318 427  64 132 496],556,5,5591,4.575286415711948,80.0,0.0
1222,0,1222,[  7 427 222  95 603],23,5,5596,4.575633687653312,40.0,0.0
1223,0,1223,[318 427  64 132 496],269,5,5601,4.575980392156863,80.0,0.0
1224,0,1224,[318 427  64 132 496],236,4,5605,4.575510204081633,80.0,0.0
1225,0,1225,[318 427  64 132 496],18,5,5610,4.575856443719413,80.0,0.0
1226,0,1226,[318 427  64 132 496],716,5,5615,4.576202118989405,80.0,0.0
1227,0,1227,[318 427  64 132 496],18,5,5620,4.576547231270358,80.0,0.0
1228,0,1228,[318 427  64 132 496],269,5,5625,4.576891781936534,80.0,0.0
1229,0,1229,[318 427  64 132 496],535,5,5630,4.5772357723577235,80.0,0.0
1230,0,1230,[318 427  64 132 496],269,5,5635,4.577579203899269,80.0,0.0
1231,0,1231,[318 427  64 132 496],236,4,5639,4.5771103896103895,80.0,0.0
1232,0,1232,[318 427  64 132 496],535,5,5644,4.5774533657745335,80.0,0.0
1233,0,1233,[318 427  64 132 496],556,5,5649,4.577795786061588,80.0,0.0
1234,0,1234,[318 427  64 132 496],796,5,5654,4.578137651821862,80.0,0.0
1235,0,1235,[172  28 286 195 273],796,2,5656,4.576051779935275,0.0,20.0
1236,0,1236,[318 427 132  64 496],577,5,5661,4.576394502829426,80.0,0.0
1237,0,1237,[318 427 132  64 496],151,5,5666,4.576736672051696,80.0,0.0
1238,0,1238,[318 427 132  64 496],450,5,5671,4.577078288942696,80.0,0.0
1239,0,1239,[588 215 118 275 168],457,5,5676,4.577419354838709,0.0,20.0
1240,0,1240,[318 427 132  64 496],269,5,5681,4.5777598710717164,80.0,0.0
1241,0,1241,[318 427 132  64 496],18,5,5686,4.578099838969404,80.0,0.0
1242,0,1242,[318 427 132  64 496],535,5,5691,4.578439259855189,80.0,0.0
1243,0,1243,[318 427 132  64 496],236,4,5695,4.577974276527331,80.0,0.0
1244,0,1244,[318 427 132  64 496],269,5,5700,4.578313253012048,80.0,0.0
1245,0,1245,[318 427 132  64 496],236,4,5704,4.57784911717496,80.0,0.0
1246,0,1246,[318 427 132  64 127],716,5,5709,4.578187650360866,60.0,20.0
1247,0,1247,[318 427 132  64 127],316,4,5713,4.577724358974359,60.0,20.0
1248,0,1248,[318 427 132  64  98],316,5,5718,4.578062449959968,60.0,0.0
1249,0,1249,[318 427 132  64  98],330,5,5723,4.5784,60.0,0.0
1250,0,1250,[318 427 132  64  98],693,4,5727,4.577937649880096,60.0,0.0
1251,0,1251,[318 427 132  64  98],535,4,5731,4.577476038338658,60.0,0.0
1252,0,1252,[318 427 132  64 496],450,5,5736,4.5778132482043095,80.0,0.0
1253,0,1253,[318 427 132  64 496],535,5,5741,4.578149920255183,80.0,0.0
1254,0,1254,[318 427 132  64 496],450,5,5746,4.578486055776892,80.0,0.0
1255,0,1255,[318 427 132  64 496],18,5,5751,4.578821656050955,80.0,0.0
1256,0,1256,[318 427 132  64 496],577,5,5756,4.579156722354813,80.0,0.0
1257,0,1257,[318 427 132  64 496],535,5,5761,4.579491255961845,80.0,0.0
1258,0,1258,[318 427 132  64 496],535,5,5766,4.579825258141382,80.0,0.0
1259,0,1259,[318 427 132  64 496],577,5,5771,4.58015873015873,80.0,0.0
1260,0,1260,[318 427 132  64 496],450,5,5776,4.580491673275178,80.0,0.0
1261,0,1261,[318 427 132  64 496],269,5,5781,4.580824088748019,80.0,0.0
1262,0,1262,[318 427 132  64 496],796,5,5786,4.581155977830562,80.0,0.0
1263,0,1263,[318 427 132  64 496],556,5,5791,4.581487341772152,80.0,0.0
1264,0,1264,[289 173 211 186 204],786,5,5796,4.581818181818182,0.0,0.0
1265,0,1265,[318 427 132  64 496],236,4,5800,4.581358609794629,80.0,0.0
1266,0,1266,[318 427 132  64 496],796,5,5805,4.581689029202841,80.0,0.0
1267,0,1267,[318 427 132  64 496],269,5,5810,4.582018927444795,80.0,0.0
1268,0,1268,[125  82 300 202 118],504,3,5813,4.580772261623325,0.0,0.0
1269,0,1269,[318 427 132  64 496],577,5,5818,4.581102362204724,80.0,0.0
1270,0,1270,[318 427 132  64 496],535,5,5823,4.581431943351691,80.0,0.0
1271,0,1271,[318 427 132  64 496],535,5,5828,4.581761006289308,80.0,0.0
1272,0,1272,[318 427 132  64 496],796,5,5833,4.582089552238806,80.0,0.0
1273,0,1273,[318 427 132  64 496],577,5,5838,4.582417582417582,80.0,0.0
1274,0,1274,[318 427 132  64 496],151,5,5843,4.582745098039216,80.0,0.0
1275,0,1275,[318 427 132  64 496],236,4,5847,4.582288401253918,80.0,0.0
1276,0,1276,[318 427 132  64 496],330,5,5852,4.582615505090055,80.0,0.0
1277,0,1277,[318 427 132  64 496],269,5,5857,4.582942097026604,80.0,0.0
1278,0,1278,[318 427 132  64 496],18,5,5862,4.583268178264269,80.0,0.0
1279,0,1279,[318 427 132  64 496],236,4,5866,4.5828125,80.0,0.0
1280,0,1280,[318 427 132  64 588],577,5,5871,4.583138173302108,60.0,0.0
1281,0,1281,[318 427 132  64 588],716,5,5876,4.583463338533542,60.0,0.0
1282,0,1282,[318 427 132  64 588],716,5,5881,4.583787996882307,60.0,0.0
1283,0,1283,[318 427 132  64 588],450,5,5886,4.58411214953271,60.0,0.0
1284,0,1284,[238 275   1 423 194],450,5,5891,4.584435797665369,0.0,20.0
1285,0,1285,[318 427 132  64 588],716,5,5896,4.584758942457232,60.0,0.0
1286,0,1286,[318 427 132  64 588],330,5,5901,4.585081585081585,60.0,0.0
1287,0,1287,[318 427 132  64 588],716,5,5906,4.5854037267080745,60.0,0.0
1288,0,1288,[ 88 111  89  70 603],18,1,5907,4.582622187742436,20.0,0.0
1289,0,1289,[ 64 471 210 588  22],450,4,5911,4.582170542635659,20.0,0.0
1290,0,1290,[318 427 132  64 588],796,5,5916,4.582494190549961,60.0,0.0
1291,0,1291,[318 427 132  64 588],577,5,5921,4.5828173374613,60.0,0.0
1292,0,1292,[318 427 132  64 588],18,5,5926,4.583139984532096,60.0,0.0
1293,0,1293,[318 427 132  64 588],450,5,5931,4.583462132921174,60.0,0.0
1294,0,1294,[318 427 132  64 588],330,5,5936,4.583783783783784,60.0,0.0
1295,0,1295,[318 427 132  64 588],577,5,5941,4.584104938271605,60.0,0.0
1296,0,1296,[238 125 174  28 483],457,5,5946,4.584425597532768,0.0,0.0
1297,0,1297,[144 186   7 179 151],535,4,5950,4.583975346687211,0.0,0.0
1298,0,1298,[318 427 132  64 588],18,5,5955,4.584295612009238,60.0,0.0
1299,0,1299,[318 427 132  64 588],716,5,5960,4.584615384615384,60.0,0.0
1300,0,1300,[318 427 132  64 588],716,5,5965,4.584934665641814,60.0,0.0
1301,0,1301,[318 427 132  64 588],330,5,5970,4.585253456221198,60.0,0.0
1302,0,1302,[318 427 132  64 588],316,4,5974,4.584804297774367,60.0,0.0
1303,0,1303,[  8 294 202 588 132],577,5,5979,4.585122699386503,0.0,0.0
1304,0,1304,[318 427 132  64 588],330,5,5984,4.58544061302682,60.0,0.0
1305,0,1305,[318 427 132  64 588],716,5,5989,4.585758039816233,60.0,0.0
1306,0,1306,[318 427 132  64 588],577,5,5994,4.586074980872226,60.0,0.0
1307,0,1307,[318 427 132  64 588],450,5,5999,4.586391437308868,60.0,0.0
1308,0,1308,[318 427 132  64 588],796,5,6004,4.586707410236822,60.0,0.0
1309,0,1309,[333 111   1 289  70],655,0,6004,4.583206106870229,0.0,0.0
1310,0,1310,[318 427 132  64 588],18,5,6009,4.583524027459954,60.0,0.0
1311,0,1311,[318 427 132  64 588],330,5,6014,4.583841463414634,60.0,0.0
1312,0,1312,[318 427 132  64 588],716,5,6019,4.584158415841584,60.0,0.0
1313,0,1313,[318 427 132  64 588],18,5,6024,4.584474885844749,60.0,0.0
1314,0,1314,[318 427 132  64 588],716,5,6029,4.584790874524715,60.0,0.0
1315,0,1315,[318 427 132  64 588],450,5,6034,4.585106382978723,60.0,0.0
1316,0,1316,[318 427 132  64 588],316,4,6038,4.584662110858011,60.0,0.0
1317,0,1317,[318 427 132  64 588],716,5,6043,4.584977238239757,60.0,0.0
1318,0,1318,[318 427 132  64 588],316,4,6047,4.584533737680061,60.0,0.0
1319,0,1319,[318 427 132  64 216],269,4,6051,4.584090909090909,60.0,0.0
1320,0,1320,[318 427 132  64  98],18,5,6056,4.5844057532172595,60.0,0.0
1321,0,1321,[318 427 132  64  98],330,5,6061,4.584720121028744,60.0,0.0
1322,0,1322,[318 427 132  64  98],655,4,6065,4.584278155706727,60.0,0.0
1323,0,1323,[318 427 132  64  98],269,5,6070,4.5845921450151055,60.0,0.0
1324,0,1324,[318 427 132  64  98],330,5,6075,4.584905660377358,60.0,0.0
1325,0,1325,[318 427 132  64  98],577,5,6080,4.585218702865761,60.0,0.0
1326,0,1326,[318 427 132  64  98],18,5,6085,4.58553127354936,60.0,0.0
1327,0,1327,[318 427 132  64  98],535,4,6089,4.585090361445783,60.0,0.0
1328,0,1328,[318 427 132  64 496],796,5,6094,4.585402558314522,80.0,0.0
1329,0,1329,[318 427 132  64 496],151,5,6099,4.585714285714285,80.0,0.0
1330,0,1330,[318 427 132  64 496],18,5,6104,4.58602554470323,80.0,0.0
1331,0,1331,[318 427 132  64 496],535,5,6109,4.586336336336337,80.0,0.0
1332,0,1332,[318 427 132  64 496],535,5,6114,4.586646661665417,80.0,0.0
1333,0,1333,[318 427 132  64 496],716,5,6119,4.586956521739131,80.0,0.0
1334,0,1334,[318 427 132  64 496],796,5,6124,4.587265917602997,80.0,0.0
1335,0,1335,[318 427 132  64 496],18,5,6129,4.587574850299402,80.0,0.0
1336,0,1336,[318 427 132  64 496],535,5,6134,4.587883320867614,80.0,0.0
1337,0,1337,[318 427 132  64 496],330,5,6139,4.588191330343797,80.0,0.0
1338,0,1338,[318 427 132  64 496],535,5,6144,4.588498879761016,80.0,0.0
1339,0,1339,[318 427 132  64 496],18,5,6149,4.588805970149254,80.0,0.0
1340,0,1340,[318 427 132  64 496],330,5,6154,4.589112602535422,80.0,0.0
1341,0,1341,[318 427 132  64 496],556,5,6159,4.589418777943368,80.0,0.0
1342,0,1342,[318 427 132  64 496],796,5,6164,4.589724497393894,80.0,0.0
1343,0,1343,[302 313 127 403 235],450,4,6168,4.589285714285714,0.0,20.0
1344,0,1344,[318 427 132  64 496],716,5,6173,4.589591078066914,80.0,0.0
1345,0,1345,[318 427 132  64 496],236,4,6177,4.589153046062407,80.0,0.0
1346,0,1346,[318 427 132  64 496],450,5,6182,4.589458054936896,80.0,0.0
1347,0,1347,[318 427 132  64 496],269,5,6187,4.589762611275964,80.0,0.0
1348,0,1348,[318 427 132  64 496],450,5,6192,4.59006671608599,80.0,0.0
1349,0,1349,[318 427 132  64 496],236,4,6196,4.58962962962963,80.0,0.0
1350,0,1350,[318 427 132  64 302],655,4,6200,4.58919319022946,60.0,0.0
1351,0,1351,[318 427  64 132 302],655,4,6204,4.588757396449704,60.0,0.0
1352,0,1352,[318 427  64 132 302],269,4,6208,4.588322246858832,60.0,0.0
1353,0,1353,[318 427  64 132 496],236,4,6212,4.587887740029542,80.0,0.0
1354,0,1354,[318 427  64 132  98],18,5,6217,4.588191881918819,60.0,0.0
1355,0,1355,[318 427  64 132  98],450,5,6222,4.588495575221239,60.0,0.0
1356,0,1356,[318 427  64 132  98],655,4,6226,4.588061901252764,60.0,0.0
1357,0,1357,[318 427  64 132  98],236,5,6231,4.588365243004418,60.0,0.0
1358,0,1358,[318 427  64 132  98],330,5,6236,4.588668138337012,60.0,0.0
1359,0,1359,[318 427  64 132  98],151,5,6241,4.588970588235294,60.0,0.0
1360,0,1360,[318 427  64 132  98],330,5,6246,4.589272593681117,60.0,0.0
1361,0,1361,[546  64 276  15 405],256,4,6250,4.588839941262849,20.0,0.0
1362,0,1362,[318 427  64 132  98],655,4,6254,4.5884079236977255,60.0,0.0
1363,0,1363,[318 427  64 132  98],716,5,6259,4.588709677419355,60.0,0.0
1364,0,1364,[318 427  64 132  98],796,5,6264,4.589010989010989,60.0,0.0
1365,0,1365,[318 427  64 132  98],693,4,6268,4.588579795021962,60.0,0.0
1366,0,1366,[318 427  64 132  98],236,5,6273,4.588880760790051,60.0,0.0
1367,0,1367,[ 11 143 185 144 168],450,5,6278,4.5891812865497075,0.0,0.0
1368,0,1368,[318 427  64 132  98],236,5,6283,4.589481373265157,60.0,0.0
1369,0,1369,[318 427  64 132  98],796,5,6288,4.58978102189781,60.0,0.0
1370,0,1370,[318 427  64 132  98],236,5,6293,4.5900802334062725,60.0,0.0
1371,0,1371,[318 427  64 132  98],269,5,6298,4.590379008746356,60.0,0.0
1372,0,1372,[318 427  64 132  98],796,5,6303,4.590677348871085,60.0,0.0
1373,0,1373,[318 427  64 132  98],269,5,6308,4.590975254730713,60.0,0.0
1374,0,1374,[318 427  64 132  98],577,5,6313,4.591272727272727,60.0,0.0
1375,0,1375,[318 427  64 132  98],450,5,6318,4.59156976744186,60.0,0.0
1376,0,1376,[318 427  64 132  98],796,5,6323,4.591866376180102,60.0,0.0
1377,0,1377,[318 427  64 132  98],316,5,6328,4.5921625544267055,60.0,0.0
1378,0,1378,[318 427  64 132  98],18,5,6333,4.592458303118201,60.0,0.0
1379,0,1379,[318 427  64 132  98],577,5,6338,4.592753623188406,60.0,0.0
1380,0,1380,[318 427  64 132  98],535,4,6342,4.592324402606807,60.0,0.0
1381,0,1381,[151   8 144   9  64],535,4,6346,4.5918958031837915,20.0,0.0
1382,0,1382,[318 427  64 132  98],151,5,6351,4.592190889370933,60.0,0.0
1383,0,1383,[318 427  64 132  98],716,5,6356,4.592485549132948,60.0,0.0
1384,0,1384,[318 427  64 132  98],330,5,6361,4.592779783393502,60.0,0.0
1385,0,1385,[318 427  64 132  98],450,5,6366,4.593073593073593,60.0,0.0
1386,0,1386,[318 427  64 132  98],716,5,6371,4.593366979091565,60.0,0.0
1387,0,1387,[318 427  64 132  98],693,4,6375,4.5929394812680115,60.0,0.0
1388,0,1388,[318 427  64 132  98],450,5,6380,4.593232541396688,60.0,0.0
1389,0,1389,[318 427  64 132  98],716,5,6385,4.593525179856115,60.0,0.0
1390,0,1390,[318 427  64 132  98],18,5,6390,4.593817397555715,60.0,0.0
1391,0,1391,[318 427  64 132  98],269,5,6395,4.594109195402299,60.0,0.0
1392,0,1392,[318 427  64 132  98],655,4,6399,4.593682699210337,60.0,0.0
1393,0,1393,[318 427  64 132  98],655,4,6403,4.59325681492109,60.0,0.0
1394,0,1394,[318 427  64 132  98],269,5,6408,4.593548387096774,60.0,0.0
1395,0,1395,[318 427  64 132  98],269,5,6413,4.593839541547278,60.0,0.0
1396,0,1396,[318 427  64 132  98],577,5,6418,4.594130279169649,60.0,0.0
1397,0,1397,[318 427  64 132  98],577,5,6423,4.594420600858369,60.0,0.0
1398,0,1398,[318 427  64 132  98],316,5,6428,4.594710507505361,60.0,0.0
1399,0,1399,[318 427  64 132  98],330,5,6433,4.595,60.0,0.0
1400,0,1400,[318 427  64 132  98],151,5,6438,4.595289079229122,60.0,0.0
1401,0,1401,[318 427  64 132  98],236,5,6443,4.595577746077033,60.0,0.0
1402,0,1402,[202 496 471 183   4],280,1,6444,4.593014967925873,20.0,0.0
1403,0,1403,[318 427  64 132  98],236,5,6449,4.593304843304844,60.0,0.0
1404,0,1404,[318 427  64 132  98],151,5,6454,4.593594306049822,60.0,0.0
1405,0,1405,[318 427  64 132  98],316,5,6459,4.593883357041252,60.0,0.0
1406,0,1406,[  1 125 258 288 200],655,1,6460,4.591329068941009,0.0,0.0
1407,0,1407,[318 427  64 132  98],18,5,6465,4.591619318181818,60.0,0.0
1408,0,1408,[228 271 257 186 143],655,1,6466,4.589070262597587,0.0,0.0
1409,0,1409,[318 427  64 132  98],316,5,6471,4.589361702127659,60.0,0.0
1410,0,1410,[318 427  64 132  98],236,5,6476,4.589652728561304,60.0,0.0
1411,0,1411,[318 427  64 132  98],450,5,6481,4.589943342776204,60.0,0.0
1412,0,1412,[318 427  64 132  98],151,5,6486,4.590233545647559,60.0,0.0
1413,0,1413,[318 427  64 132  98],577,5,6491,4.59052333804809,60.0,0.0
1414,0,1414,[318 427  64 132  98],535,4,6495,4.590106007067138,60.0,0.0
1415,0,1415,[318 427  64 132  98],716,5,6500,4.590395480225989,60.0,0.0
1416,0,1416,[318 427  64 132  98],18,5,6505,4.590684544812985,60.0,0.0
1417,0,1417,[318 427  64 132  98],269,5,6510,4.590973201692525,60.0,0.0
1418,0,1418,[318 427  64 132  98],151,5,6515,4.591261451726568,60.0,0.0
1419,0,1419,[318 427  64 132  98],577,5,6520,4.591549295774648,60.0,0.0
1420,0,1420,[318 427  64 132  98],450,5,6525,4.591836734693878,60.0,0.0
1421,0,1421,[318 427  64 132  98],330,5,6530,4.59212376933896,60.0,0.0
1422,0,1422,[318 427  64 132  98],151,5,6535,4.592410400562192,60.0,0.0
1423,0,1423,[318 427  64 132  98],151,5,6540,4.592696629213483,60.0,0.0
1424,0,1424,[318 427  64 132  98],236,5,6545,4.5929824561403505,60.0,0.0
1425,0,1425,[318 427  64 132  98],716,5,6550,4.593267882187939,60.0,0.0
1426,0,1426,[318 427  64 132  98],716,5,6555,4.593552908199019,60.0,0.0
1427,0,1427,[405 183 483 385  98],450,4,6559,4.5931372549019605,0.0,0.0
1428,0,1428,[318 427  64 132  98],535,4,6563,4.592722183344996,60.0,0.0
1429,0,1429,[318 427  64 132  98],655,4,6567,4.592307692307692,60.0,0.0
1430,0,1430,[318 427  64 132  98],655,4,6571,4.5918937805730256,60.0,0.0
1431,0,1431,[318 427  64 132  98],269,5,6576,4.592178770949721,60.0,0.0
1432,0,1432,[318 427  64 132  98],316,5,6581,4.592463363572924,60.0,0.0
1433,0,1433,[318 427  64 132  98],655,4,6585,4.592050209205021,60.0,0.0
1434,0,1434,[318 427  64 132  98],577,5,6590,4.592334494773519,60.0,0.0
1435,0,1435,[318 427  64 132  98],577,5,6595,4.592618384401114,60.0,0.0
1436,0,1436,[318 427  64 132  98],577,5,6600,4.592901878914405,60.0,0.0
1437,0,1437,[318 427  64 132  98],316,5,6605,4.593184979137691,60.0,0.0
1438,0,1438,[191 125   1 228 180],457,5,6610,4.593467685892981,0.0,0.0
1439,0,1439,[318 427  64 132  98],796,5,6615,4.59375,60.0,0.0
1440,0,1440,[318 427  64 132  98],655,4,6619,4.593337959750174,60.0,0.0
1441,0,1441,[  7  95 286 172 405],280,3,6622,4.592233009708738,0.0,20.0
1442,0,1442,[318 427  64 132  98],693,4,6626,4.5918225918225914,60.0,0.0
1443,0,1443,[318 427  64 132  98],796,5,6631,4.592105263157895,60.0,0.0
1444,0,1444,[318 427  64 132  98],693,4,6635,4.591695501730104,60.0,0.0
1445,0,1445,[318 427  64 132  98],655,4,6639,4.591286307053942,60.0,0.0
1446,0,1446,[318 427  64 132  98],450,5,6644,4.591568762957844,60.0,0.0
1447,0,1447,[318 427  64 132  98],716,5,6649,4.591850828729282,60.0,0.0
1448,0,1448,[318 427  64 132  98],716,5,6654,4.592132505175983,60.0,0.0
1449,0,1449,[318 427  64 132  98],577,5,6659,4.592413793103448,60.0,0.0
1450,0,1450,[318 427  64 132  98],316,5,6664,4.5926946933149555,60.0,0.0
1451,0,1451,[318 427  64 132  98],330,5,6669,4.5929752066115705,60.0,0.0
1452,0,1452,[318 427  64 132  98],151,5,6674,4.593255333792154,60.0,0.0
1453,0,1453,[318 427  64 132  98],796,5,6679,4.59353507565337,60.0,0.0
1454,0,1454,[318 427  64 132  98],236,5,6684,4.59381443298969,60.0,0.0
1455,0,1455,[182 181 228 294  79],256,3,6687,4.59271978021978,0.0,0.0
1456,0,1456,[318 427  64 132  98],577,5,6692,4.5929993136582015,60.0,0.0
1457,0,1457,[121 197 546 301   4],796,3,6695,4.591906721536351,0.0,0.0
1458,0,1458,[318 427  64 132  98],796,5,6700,4.592186429061001,60.0,0.0
1459,0,1459,[318 427  64 132  98],330,5,6705,4.592465753424658,60.0,0.0
1460,0,1460,[318 427  64 132  98],330,5,6710,4.5927446954141,60.0,0.0
1461,0,1461,[179 186 471 302  25],450,3,6713,4.591655266757866,0.0,0.0
1462,0,1462,[318 427  64 132  98],716,5,6718,4.591934381408065,60.0,0.0
1463,0,1463,[318 427  64 132  98],151,5,6723,4.592213114754099,60.0,0.0
1464,0,1464,[318 427  64 132  98],577,5,6728,4.592491467576791,60.0,0.0
1465,0,1465,[318 427  64 132  98],577,5,6733,4.592769440654843,60.0,0.0
1466,0,1466,[318 427  64 132  98],236,5,6738,4.593047034764826,60.0,0.0
1467,0,1467,[318 427  64 132  98],18,5,6743,4.593324250681199,60.0,0.0
1468,0,1468,[318 427  64 132  98],316,5,6748,4.59360108917631,60.0,0.0
1469,0,1469,[318 427  64 132  98],450,5,6753,4.593877551020408,60.0,0.0
1470,0,1470,[318 427  64 132  98],693,4,6757,4.593473827328348,60.0,0.0
1471,0,1471,[318 427  64 132  98],18,5,6762,4.59375,60.0,0.0
1472,0,1472,[288 175 603 222 168],264,5,6767,4.594025797691786,20.0,0.0
1473,0,1473,[318 427  64 132  98],535,4,6771,4.593622795115333,60.0,0.0
1474,0,1474,[318 427  64 132  98],450,5,6776,4.593898305084746,60.0,0.0
1475,0,1475,[318 427  64 132  98],330,5,6781,4.5941734417344176,60.0,0.0
1476,0,1476,[318 427  64 132  98],18,5,6786,4.594448205822613,60.0,0.0
1477,0,1477,[318 427  64 132  98],151,5,6791,4.594722598105548,60.0,0.0
1478,0,1478,[318 427  64 132  98],577,5,6796,4.59499661933739,60.0,0.0
1479,0,1479,[318 427  64 132  98],18,5,6801,4.59527027027027,60.0,0.0
1480,0,1480,[318 427  64 132  98],18,5,6806,4.595543551654288,60.0,0.0
1481,0,1481,[318 427  64 132  98],236,5,6811,4.595816464237517,60.0,0.0
1482,0,1482,[318 427  64 132  98],693,4,6815,4.595414699932569,60.0,0.0
1483,0,1483,[318 427  64 132  98],450,5,6820,4.595687331536388,60.0,0.0
1484,0,1484,[318 427  64 132  98],316,5,6825,4.595959595959596,60.0,0.0
1485,0,1485,[318 427  64 132  98],236,5,6830,4.596231493943472,60.0,0.0
1486,0,1486,[318 427  64 132  98],796,5,6835,4.596503026227303,60.0,0.0
1487,0,1487,[318 427  64 132  98],577,5,6840,4.596774193548387,60.0,0.0
1488,0,1488,[318 427  64 132  98],450,5,6845,4.597044996642041,60.0,0.0
1489,0,1489,[318 427  64 132  98],693,4,6849,4.5966442953020135,60.0,0.0
1490,0,1490,[318 427  64 132  98],535,4,6853,4.596244131455399,60.0,0.0
1491,0,1491,[318 427  64 132  98],450,5,6858,4.596514745308311,60.0,0.0
1492,0,1492,[318 427  64 132  98],796,5,6863,4.596784996651039,60.0,0.0
1493,0,1493,[318 427  64 132  98],18,5,6868,4.597054886211513,60.0,0.0
1494,0,1494,[318 427  64 132  98],269,5,6873,4.597324414715719,60.0,0.0
1495,0,1495,[144 125 323 234 187],796,3,6876,4.596256684491979,0.0,0.0
1496,0,1496,[318 427  64 132  98],535,4,6880,4.595858383433534,60.0,0.0
1497,0,1497,[318 427  64 132  98],693,4,6884,4.595460614152203,60.0,0.0
1498,0,1498,[318 427  64 132  98],18,5,6889,4.595730486991328,60.0,0.0
1499,0,1499,[318 427  64 132  98],693,4,6893,4.5953333333333335,60.0,0.0
1500,0,1500,[318 427  64 132  98],330,5,6898,4.595602931379081,60.0,0.0
1501,0,1501,[318 427  64 132  98],236,5,6903,4.5958721704394145,60.0,0.0
1502,0,1502,[318 427  64 132  98],535,4,6907,4.595475715236194,60.0,0.0
1503,0,1503,[318 427  64 132  98],535,4,6911,4.5950797872340425,60.0,0.0
1504,0,1504,[318 427  64 132  98],236,5,6916,4.595348837209302,60.0,0.0
1505,0,1505,[318 427  64 132  98],535,4,6920,4.5949535192563085,60.0,0.0
1506,0,1506,[318 427  64 132  98],18,5,6925,4.595222295952223,60.0,0.0
1507,0,1507,[318 427  64 132  98],716,5,6930,4.595490716180372,60.0,0.0
1508,0,1508,[318 427  64 132  98],18,5,6935,4.595758780649437,60.0,0.0
1509,0,1509,[318 427  64 132  98],151,5,6940,4.596026490066225,60.0,0.0
1510,0,1510,[318 427  64 132  98],316,5,6945,4.596293845135672,60.0,0.0
1511,0,1511,[318 427  64 132  98],269,5,6950,4.5965608465608465,60.0,0.0
1512,0,1512,[318 427  64 132  98],450,5,6955,4.596827495042961,60.0,0.0
1513,0,1513,[318 427  64 132  98],236,5,6960,4.597093791281374,60.0,0.0
1514,0,1514,[318 427  64 132  98],796,5,6965,4.597359735973598,60.0,0.0
1515,0,1515,[318 427  64 132  98],693,4,6969,4.596965699208443,60.0,0.0
1516,0,1516,[318 427  64 132  98],330,5,6974,4.597231377719183,60.0,0.0
1517,0,1517,[318 427  64 132  98],316,5,6979,4.597496706192358,60.0,0.0
1518,0,1518,[318 427  64 132  98],18,5,6984,4.597761685319289,60.0,0.0
1519,0,1519,[318 427  64 132  98],18,5,6989,4.598026315789474,60.0,0.0
1520,0,1520,[318 427  64 132  98],716,5,6994,4.598290598290598,60.0,0.0
1521,0,1521,[318 427  64 132  98],535,4,6998,4.597897503285151,60.0,0.0
1522,0,1522,[318 427  64 132  98],151,5,7003,4.598161523309258,60.0,0.0
1523,0,1523,[318 427  64 132  98],450,5,7008,4.5984251968503935,60.0,0.0
1524,0,1524,[318 427  64 132  98],450,5,7013,4.598688524590164,60.0,0.0
1525,0,1525,[318 427  64 132  98],269,5,7018,4.598951507208388,60.0,0.0
1526,0,1526,[257 144 117 237 273],401,1,7019,4.596594629993451,0.0,0.0
1527,0,1527,[328 273 135 435 427],236,3,7022,4.595549738219895,20.0,0.0
1528,0,1528,[318 427  64 132  98],236,5,7027,4.595814257684761,60.0,0.0
1529,0,1529,[153 357 117 238 302],450,5,7032,4.596078431372549,0.0,0.0
1530,0,1530,[318 427  64 132  98],535,4,7036,4.595689092096669,60.0,0.0
1531,0,1531,[318 427  64 132  98],330,5,7041,4.595953002610966,60.0,0.0
1532,0,1532,[318 427  64 132  98],655,4,7045,4.5955642530985,60.0,0.0
1533,0,1533,[318 427  64 132  98],577,5,7050,4.595827900912647,60.0,0.0
1534,0,1534,[318 427  64 132  98],269,5,7055,4.596091205211726,60.0,0.0
1535,0,1535,[318 427  64 132  98],693,4,7059,4.595703125,60.0,0.0
1536,0,1536,[318 427  64 132  98],330,5,7064,4.5959661678594665,60.0,0.0
1537,0,1537,[318 427  64 132  98],450,5,7069,4.5962288686605985,60.0,0.0
1538,0,1538,[318 427  64 132  98],316,5,7074,4.5964912280701755,60.0,0.0
1539,0,1539,[318 427  64 132  98],796,5,7079,4.596753246753247,60.0,0.0
1540,0,1540,[318 427  64 132  98],236,5,7084,4.597014925373134,60.0,0.0
1541,0,1541,[318 427  64 132  98],655,4,7088,4.59662775616083,60.0,0.0
1542,0,1542,[318 427  64 132  98],693,4,7092,4.596241088788076,60.0,0.0
1543,0,1543,[318 427  64 132  98],236,5,7097,4.596502590673575,60.0,0.0
1544,0,1544,[318 427  64 132  98],330,5,7102,4.596763754045307,60.0,0.0
1545,0,1545,[318 427  64 132  98],577,5,7107,4.597024579560156,60.0,0.0
1546,0,1546,[318 427  64 132  98],316,5,7112,4.597285067873303,60.0,0.0
1547,0,1547,[318 427  64 132  98],716,5,7117,4.597545219638243,60.0,0.0
1548,0,1548,[318 427  64 132  98],269,5,7122,4.597805035506779,60.0,0.0
1549,0,1549,[318 427  64 132  98],716,5,7127,4.598064516129032,60.0,0.0
1550,0,1550,[318 427  64 132  98],577,5,7132,4.598323662153449,60.0,0.0
1551,0,1551,[318 427  64 132  98],796,5,7137,4.598582474226804,60.0,0.0
1552,0,1552,[318 427  64 132  98],316,5,7142,4.5988409529942045,60.0,0.0
1553,0,1553,[318 427  64 132  98],330,5,7147,4.599099099099099,60.0,0.0
1554,0,1554,[318 427  64 132  98],236,5,7152,4.599356913183279,60.0,0.0
1555,0,1555,[318 427  64 132  98],450,5,7157,4.599614395886889,60.0,0.0
1556,0,1556,[318 427  64 132  98],716,5,7162,4.5998715478484264,60.0,0.0
1557,0,1557,[318 427  64 132  98],796,5,7167,4.600128369704749,60.0,0.0
1558,0,1558,[187 228 121 181 176],450,4,7171,4.599743425272611,0.0,0.0
1559,0,1559,[318 427  64 132  98],18,5,7176,4.6,60.0,0.0
1560,0,1560,[318 427  64 132  98],450,5,7181,4.600256245996157,60.0,0.0
1561,0,1561,[318 427  64 132  98],716,5,7186,4.6005121638924455,60.0,0.0
1562,0,1562,[318 427  64 132  98],18,5,7191,4.600767754318618,60.0,0.0
1563,0,1563,[318 427  64 132  98],330,5,7196,4.601023017902813,60.0,0.0
1564,0,1564,[318 427  64 132  98],330,5,7201,4.6012779552715655,60.0,0.0
1565,0,1565,[318 427  64 132  98],236,5,7206,4.601532567049809,60.0,0.0
1566,0,1566,[318 427  64 132  98],577,5,7211,4.60178685386088,60.0,0.0
1567,0,1567,[318 427  64 132  98],151,5,7216,4.6020408163265305,60.0,0.0
1568,0,1568,[318 427  64 132  98],577,5,7221,4.602294455066922,60.0,0.0
1569,0,1569,[318 427  64 132  98],577,5,7226,4.602547770700637,60.0,0.0
1570,0,1570,[318 427  64 132  98],450,5,7231,4.602800763844685,60.0,0.0
1571,0,1571,[180 471 172 168 257],716,3,7234,4.60178117048346,0.0,0.0
1572,0,1572,[318 427  64 132  98],655,4,7238,4.601398601398602,60.0,0.0
1573,0,1573,[318 427  64 132  98],655,4,7242,4.601016518424396,60.0,0.0
1574,0,1574,[318 427  64 132  98],716,5,7247,4.601269841269842,60.0,0.0
1575,0,1575,[318 427  64 132  98],655,4,7251,4.600888324873097,60.0,0.0
1576,0,1576,[318 427  64 132  98],693,4,7255,4.600507292327204,60.0,0.0
1577,0,1577,[318 427  64 132  98],577,5,7260,4.600760456273764,60.0,0.0
1578,0,1578,[318 427  64 132  98],151,5,7265,4.601013299556682,60.0,0.0
1579,0,1579,[318 427  64 132  98],269,5,7270,4.60126582278481,60.0,0.0
1580,0,1580,[318 427  64 132  98],693,4,7274,4.600885515496521,60.0,0.0
1581,0,1581,[318 427  64 132  98],236,5,7279,4.601137800252845,60.0,0.0
1582,0,1582,[318 427  64 132  98],577,5,7284,4.601389766266583,60.0,0.0
1583,0,1583,[318 427  64 132  98],535,4,7288,4.601010101010101,60.0,0.0
1584,0,1584,[125 181 183 118 235],292,2,7290,4.599369085173501,0.0,0.0
1585,0,1585,[318 427  64 132  98],269,5,7295,4.599621689785624,60.0,0.0
1586,0,1586,[318 427  64 132  98],236,5,7300,4.59987397605545,60.0,0.0
1587,0,1587,[318 427  64 132  98],151,5,7305,4.6001259445843825,60.0,0.0
1588,0,1588,[318 427  64 132  98],535,4,7309,4.599748269351793,60.0,0.0
1589,0,1589,[182 121 151 238 216],457,5,7314,4.6,0.0,0.0
1590,0,1590,[318 427  64 132  98],535,4,7318,4.599622878692646,60.0,0.0
1591,0,1591,[318 427  64 132  98],316,5,7323,4.599874371859296,60.0,0.0
1592,0,1592,[318 427  64 132  98],269,5,7328,4.600125549278092,60.0,0.0
1593,0,1593,[318 427  64 132  98],330,5,7333,4.600376411543287,60.0,0.0
1594,0,1594,[318 427  64 132  98],18,5,7338,4.6006269592476485,60.0,0.0
1595,0,1595,[318 427  64 132  98],151,5,7343,4.600877192982456,60.0,0.0
1596,0,1596,[318 427  64 132  98],151,5,7348,4.601127113337508,60.0,0.0
1597,0,1597,[318 427  64 132  98],18,5,7353,4.6013767209011265,60.0,0.0
1598,0,1598,[318 427  64 132  98],316,5,7358,4.6016260162601625,60.0,0.0
1599,0,1599,[318 427  64 132  98],693,4,7362,4.60125,60.0,0.0
1600,0,1600,[318 427  64 132  98],151,5,7367,4.601499063085572,60.0,0.0
1601,0,1601,[318 427  64 132  98],693,4,7371,4.601123595505618,60.0,0.0
1602,0,1602,[318 427  64 132  98],450,5,7376,4.601372426699937,60.0,0.0
1603,0,1603,[318 427  64 132  98],577,5,7381,4.601620947630923,60.0,0.0
1604,0,1604,[245 300 546 196  98],796,4,7385,4.601246105919003,0.0,0.0
1605,0,1605,[318 427  64 132  98],716,5,7390,4.601494396014944,60.0,0.0
1606,0,1606,[318 427  64 132  98],716,5,7395,4.601742377100186,60.0,0.0
1607,0,1607,[318 427  64 132  98],18,5,7400,4.601990049751244,60.0,0.0
1608,0,1608,[318 427  64 132  98],236,5,7405,4.602237414543194,60.0,0.0
1609,0,1609,[318 427  64 132  98],236,5,7410,4.60248447204969,60.0,0.0
1610,0,1610,[318 427  64 132  98],796,5,7415,4.602731222842955,60.0,0.0
1611,0,1611,[318 427  64 132  98],450,5,7420,4.602977667493796,60.0,0.0
1612,0,1612,[318 427  64 132  98],236,5,7425,4.603223806571606,60.0,0.0
1613,0,1613,[318 427  64 132  98],535,4,7429,4.602850061957868,60.0,0.0
1614,0,1614,[318 427  64 132  98],450,5,7434,4.603095975232198,60.0,0.0
1615,0,1615,[318 427  64 132  98],236,5,7439,4.603341584158416,60.0,0.0
1616,0,1616,[318 427  64 132  98],18,5,7444,4.603586889301175,60.0,0.0
1617,0,1617,[118 276 228 127   8],344,4,7448,4.6032138442521635,0.0,20.0
1618,0,1618,[318 427  64 132  98],577,5,7453,4.603458925262507,60.0,0.0
1619,0,1619,[257 269   9  69 273],655,1,7454,4.601234567901234,0.0,0.0
1620,0,1620,[238 173 194 427   7],421,3,7457,4.600246761258482,20.0,0.0
1621,0,1621,[235 185 174 238 176],716,3,7460,4.599260172626387,0.0,0.0
1622,0,1622,[276 257 234 405  79],457,4,7464,4.598890942698706,0.0,0.0
1623,0,1623,[318 427  64 132  98],316,5,7469,4.599137931034483,60.0,0.0
1624,0,1624,[318 427  64 132  98],577,5,7474,4.599384615384615,60.0,0.0
1625,0,1625,[318 427  64 132  98],716,5,7479,4.599630996309963,60.0,0.0
1626,0,1626,[318 427  64 132  98],577,5,7484,4.599877074370006,60.0,0.0
1627,0,1627,[318 427  64 132  98],450,5,7489,4.60012285012285,60.0,0.0
1628,0,1628,[318 427  64 132  98],655,4,7493,4.5997544505831796,60.0,0.0
1629,0,1629,[318 427  64 132  98],151,5,7498,4.6,60.0,0.0
1630,0,1630,[235  96 197 294 211],716,3,7501,4.599019006744329,0.0,0.0
1631,0,1631,[318 427  64 132  98],796,5,7506,4.599264705882353,60.0,0.0
1632,0,1632,[318 427  64 132  98],535,4,7510,4.598897734231476,60.0,0.0
1633,0,1633,[318 427  64 132  98],577,5,7515,4.599143206854345,60.0,0.0
1634,0,1634,[318 427  64 132  98],655,4,7519,4.598776758409786,60.0,0.0
1635,0,1635,[318 427  64 132  98],655,4,7523,4.59841075794621,60.0,0.0
1636,0,1636,[318 427  64 132  98],450,5,7528,4.598656078191814,60.0,0.0
1637,0,1637,[318 427  64 132  98],693,4,7532,4.598290598290598,60.0,0.0
1638,0,1638,[318 427  64 132  98],655,4,7536,4.597925564368517,60.0,0.0
1639,0,1639,[318 427  64 132  98],151,5,7541,4.5981707317073175,60.0,0.0
1640,0,1640,[318 427  64 132  98],269,5,7546,4.5984156002437535,60.0,0.0
1641,0,1641,[318 427  64 132  98],316,5,7551,4.598660170523751,60.0,0.0
1642,0,1642,[318 427  64 132  98],269,5,7556,4.5989044430919055,60.0,0.0
1643,0,1643,[318 427  64 132  98],236,5,7561,4.599148418491485,60.0,0.0
1644,0,1644,[318 427  64 132  98],151,5,7566,4.599392097264437,60.0,0.0
1645,0,1645,[318 427  64 132  98],450,5,7571,4.599635479951397,60.0,0.0
1646,0,1646,[318 427  64 132  98],796,5,7576,4.5998785670916815,60.0,0.0
1647,0,1647,[318 427  64 132  98],18,5,7581,4.600121359223301,60.0,0.0
1648,0,1648,[196 211 265  70 405],655,0,7581,4.597331716191631,0.0,0.0
1649,0,1649,[318 427  64 132  98],236,5,7586,4.597575757575758,60.0,0.0
1650,0,1650,[318 427  64 132  98],330,5,7591,4.597819503331315,60.0,0.0
1651,0,1651,[318 427  64 132  98],450,5,7596,4.598062953995157,60.0,0.0
1652,0,1652,[318 427  64 132  98],577,5,7601,4.598306110102843,60.0,0.0
1653,0,1653,[318 427  64 132  98],716,5,7606,4.598548972188634,60.0,0.0
1654,0,1654,[318 427  64 132  98],151,5,7611,4.5987915407854985,60.0,0.0
1655,0,1655,[318 427  64 132  98],316,5,7616,4.599033816425121,60.0,0.0
1656,0,1656,[318 427  64 132  98],151,5,7621,4.5992757996378995,60.0,0.0
1657,0,1657,[318 427  64 132  98],535,4,7625,4.598914354644149,60.0,0.0
1658,0,1658,[318 427  64 132  98],316,5,7630,4.59915611814346,60.0,0.0
1659,0,1659,[318 427  64 132  98],535,4,7634,4.598795180722892,60.0,0.0
1660,0,1660,[318 427  64 132  98],330,5,7639,4.59903672486454,60.0,0.0
1661,0,1661,[318 427  64 132  98],577,5,7644,4.59927797833935,60.0,0.0
1662,0,1662,[318 427  64 132  98],316,5,7649,4.599518941671677,60.0,0.0
1663,0,1663,[222  69 173  97 194],796,4,7653,4.599158653846154,0.0,0.0
1664,0,1664,[318 427  64 132  98],269,5,7658,4.5993993993994,60.0,0.0
1665,0,1665,[318 427  64 132  98],655,4,7662,4.599039615846339,60.0,0.0
1666,0,1666,[318 427  64 132  98],577,5,7667,4.599280143971206,60.0,0.0
1667,0,1667,[318 427  64 132  98],18,5,7672,4.599520383693045,60.0,0.0
1668,0,1668,[318 427  64 132  98],716,5,7677,4.599760335530258,60.0,0.0
1669,0,1669,[318 427  64 132  98],269,5,7682,4.6,60.0,0.0
1670,0,1670,[318 427  64 132  98],693,4,7686,4.599640933572711,60.0,0.0
1671,0,1671,[318 427  64 132  98],655,4,7690,4.599282296650718,60.0,0.0
1672,0,1672,[318 427  64 132  98],316,5,7695,4.599521817095039,60.0,0.0
1673,0,1673,[318 427  64 132  98],330,5,7700,4.599761051373955,60.0,0.0
1674,0,1674,[318 427  64 132  98],18,5,7705,4.6,60.0,0.0
1675,0,1675,[318 427  64 132  98],535,4,7709,4.59964200477327,60.0,0.0
1676,0,1676,[318 427  64 132  98],716,5,7714,4.599880739415623,60.0,0.0
1677,0,1677,[318 427  64 132  98],330,5,7719,4.600119189511323,60.0,0.0
1678,0,1678,[318 427  64 132  98],693,4,7723,4.599761762954139,60.0,0.0
1679,0,1679,[318 427  64 132  98],18,5,7728,4.6,60.0,0.0
1680,0,1680,[318 427  64 132  98],716,5,7733,4.6002379535990485,60.0,0.0
1681,0,1681,[318 427  64 132  98],655,4,7737,4.599881093935791,60.0,0.0
1682,0,1682,[318 427  64 132  98],316,5,7742,4.600118835412953,60.0,0.0
1683,0,1683,[568 423 175  98 185],269,4,7746,4.5997624703087885,0.0,0.0
1684,0,1684,[318 427  64 132  98],450,5,7751,4.6,60.0,0.0
1685,0,1685,[318 427  64 132  98],693,4,7755,4.599644128113879,60.0,0.0
1686,0,1686,[318 427  64 132  98],450,5,7760,4.599881446354475,60.0,0.0
1687,0,1687,[318 427  64 132  98],18,5,7765,4.600118483412322,60.0,0.0
1688,0,1688,[318 427  64 132  98],330,5,7770,4.600355239786857,60.0,0.0
1689,0,1689,[ 82 151  22 265 173],716,5,7775,4.600591715976331,0.0,0.0
1690,0,1690,[318 427  64 132  98],269,5,7780,4.600827912477824,60.0,0.0
1691,0,1691,[318 427  64 132  98],796,5,7785,4.601063829787234,60.0,0.0
1692,0,1692,[202 588 196 151 117],457,5,7790,4.601299468399291,0.0,0.0
1693,0,1693,[318 427  64 132  98],716,5,7795,4.601534828807556,60.0,0.0
1694,0,1694,[318 427  64 132  98],450,5,7800,4.601769911504425,60.0,0.0
1695,0,1695,[318 427  64 132  98],316,5,7805,4.602004716981132,60.0,0.0
1696,0,1696,[318 427  64 132  98],796,5,7810,4.602239245727755,60.0,0.0
1697,0,1697,[318 427  64 132  98],577,5,7815,4.602473498233215,60.0,0.0
1698,0,1698,[318 427  64 132  98],577,5,7820,4.602707474985285,60.0,0.0
1699,0,1699,[318 427  64 132  98],693,4,7824,4.602352941176471,60.0,0.0
1700,0,1700,[318 427  64 132  98],535,4,7828,4.601998824221046,60.0,0.0
1701,0,1701,[318 427  64 132  98],450,5,7833,4.602232667450059,60.0,0.0
1702,0,1702,[318 427  64 132  98],796,5,7838,4.602466236054022,60.0,0.0
1703,0,1703,[318 427  64 132  98],330,5,7843,4.602699530516432,60.0,0.0
1704,0,1704,[318 427  64 132  98],450,5,7848,4.602932551319648,60.0,0.0
1705,0,1705,[318 427  64 132  98],796,5,7853,4.603165298944901,60.0,0.0
1706,0,1706,[301 210 322 176  97],796,1,7854,4.601054481546573,0.0,0.0
1707,0,1707,[318 427  64 132  98],151,5,7859,4.601288056206089,60.0,0.0
1708,0,1708,[318 427  64 132  98],18,5,7864,4.601521357519017,60.0,0.0
1709,0,1709,[318 427  64 132  98],236,5,7869,4.601754385964912,60.0,0.0
1710,0,1710,[318 427  64 132  98],535,4,7873,4.6014026884862655,60.0,0.0
1711,0,1711,[318 427  64 132  98],693,4,7877,4.601051401869159,60.0,0.0
1712,0,1712,[318 427  64 132  98],18,5,7882,4.60128429655575,60.0,0.0
1713,0,1713,[318 427  64 132  98],577,5,7887,4.601516919486581,60.0,0.0
1714,0,1714,[318 427  64 132  98],693,4,7891,4.6011661807580175,60.0,0.0
1715,0,1715,[318 427  64 132  98],796,5,7896,4.601398601398602,60.0,0.0
1716,0,1716,[135  69 405 496 183],716,3,7899,4.600465928945836,20.0,0.0
1717,0,1717,[318 427  64 132  98],716,5,7904,4.60069848661234,60.0,0.0
1718,0,1718,[318 427  64 132  98],716,5,7909,4.600930773705643,60.0,0.0
1719,0,1719,[318 427  64 132  98],716,5,7914,4.601162790697674,60.0,0.0
1720,0,1720,[318 427  64 132  98],18,5,7919,4.601394538059268,60.0,0.0
1721,0,1721,[318 427  64 132  98],330,5,7924,4.6016260162601625,60.0,0.0
1722,0,1722,[318 427  64 132  98],269,5,7929,4.601857225769008,60.0,0.0
1723,0,1723,[318 427  64 132  98],655,4,7933,4.601508120649652,60.0,0.0
1724,0,1724,[294 234  28 175 204],23,1,7934,4.599420289855073,0.0,0.0
1725,0,1725,[318 427  64 132  98],330,5,7939,4.59965237543453,60.0,0.0
1726,0,1726,[318 427  64 132  98],450,5,7944,4.59988419224088,60.0,0.0
1727,0,1727,[318 427  64 132  98],535,4,7948,4.599537037037037,60.0,0.0
1728,0,1728,[318 427  64 132  98],693,4,7952,4.59919028340081,60.0,0.0
1729,0,1729,[318 427  64 132  98],269,5,7957,4.599421965317919,60.0,0.0
1730,0,1730,[318 427  64 132  98],236,5,7962,4.599653379549394,60.0,0.0
1731,0,1731,[318 427  64 132  98],450,5,7967,4.599884526558891,60.0,0.0
1732,0,1732,[318 427  64 132  98],330,5,7972,4.600115406809001,60.0,0.0
1733,0,1733,[318 427  64 132  98],693,4,7976,4.599769319492503,60.0,0.0
1734,0,1734,[318 427  64 132  98],269,5,7981,4.6,60.0,0.0
1735,0,1735,[318 427  64 132  98],18,5,7986,4.600230414746544,60.0,0.0
1736,0,1736,[318 427  64 132  98],655,4,7990,4.599884858952216,60.0,0.0
1737,0,1737,[318 427  64 132  98],316,5,7995,4.6001150747986195,60.0,0.0
1738,0,1738,[318 427  64 132  98],316,5,8000,4.6003450258769405,60.0,0.0
1739,0,1739,[318 427  64 132  98],577,5,8005,4.600574712643678,60.0,0.0
1740,0,1740,[318 427  64 132  98],316,5,8010,4.600804135554279,60.0,0.0
1741,0,1741,[318 427  64 132  98],535,4,8014,4.600459242250287,60.0,0.0
1742,0,1742,[318 427  64 132  98],655,4,8018,4.600114744693058,60.0,0.0
1743,0,1743,[318 427  64 132  98],269,5,8023,4.600344036697248,60.0,0.0
1744,0,1744,[318 427  64 132  98],716,5,8028,4.600573065902579,60.0,0.0
1745,0,1745,[318 427  64 132  98],796,5,8033,4.600801832760595,60.0,0.0
1746,0,1746,[318 427  64 132  98],236,5,8038,4.6010303377218085,60.0,0.0
1747,0,1747,[318 427  64 132  98],236,5,8043,4.601258581235698,60.0,0.0
1748,0,1748,[318 427  64 132  98],18,5,8048,4.601486563750715,60.0,0.0
1749,0,1749,[318 427  64 132  98],18,5,8053,4.601714285714285,60.0,0.0
1750,0,1750,[318 427  64 132  98],236,5,8058,4.601941747572815,60.0,0.0
1751,0,1751,[318 427  64 132  98],577,5,8063,4.6021689497716896,60.0,0.0
1752,0,1752,[318 427  64 132  98],269,5,8068,4.602395892755276,60.0,0.0
1753,0,1753,[318 427  64 132  98],18,5,8073,4.602622576966933,60.0,0.0
1754,0,1754,[318 427  64 132  98],535,4,8077,4.6022792022792025,60.0,0.0
1755,0,1755,[318 427  64 132  98],450,5,8082,4.60250569476082,60.0,0.0
1756,0,1756,[318 427  64 132  98],330,5,8087,4.602731929425157,60.0,0.0
1757,0,1757,[318 427  64 132  98],535,4,8091,4.602389078498294,60.0,0.0
1758,0,1758,[318 427  64 132  98],18,5,8096,4.6026151222285385,60.0,0.0
1759,0,1759,[318 427  64 132  98],535,4,8100,4.6022727272727275,60.0,0.0
1760,0,1760,[176 179  69 195 742],450,5,8105,4.602498580352073,0.0,0.0
1761,0,1761,[318 427  64 132 496],18,5,8110,4.60272417707151,80.0,0.0
1762,0,1762,[318 427  64 132 496],18,5,8115,4.6029495178672715,80.0,0.0
1763,0,1763,[318 427  64 132 496],716,5,8120,4.603174603174603,80.0,0.0
1764,0,1764,[318 427  64 132 496],450,5,8125,4.603399433427762,80.0,0.0
1765,0,1765,[318 427  64 132 496],269,5,8130,4.603624009060023,80.0,0.0
1766,0,1766,[318 427  64 132 496],577,5,8135,4.603848330503679,80.0,0.0
1767,0,1767,[318 427  64 132 496],330,5,8140,4.604072398190045,80.0,0.0
1768,0,1768,[318 427  64 132 496],18,5,8145,4.604296212549463,80.0,0.0
1769,0,1769,[318 427  64 132 496],577,5,8150,4.604519774011299,80.0,0.0
1770,0,1770,[318 427  64 132 496],535,5,8155,4.604743083003952,80.0,0.0
1771,0,1771,[318 427  64 132 496],577,5,8160,4.604966139954853,80.0,0.0
1772,0,1772,[ 97 228 483 265 318],457,5,8165,4.605188945290468,20.0,0.0
1773,0,1773,[318 427  64 132 496],236,4,8169,4.604847801578354,80.0,0.0
1774,0,1774,[318 427  64 132 496],556,5,8174,4.605070422535212,80.0,0.0
1775,0,1775,[318 427  64 132 496],450,5,8179,4.605292792792793,80.0,0.0
1776,0,1776,[318 427  64 132 496],535,5,8184,4.605514912774339,80.0,0.0
1777,0,1777,[318 427  64 132 496],236,4,8188,4.605174353205849,80.0,0.0
1778,0,1778,[318 427  64 132  98],151,5,8193,4.6053962900505905,60.0,0.0
1779,0,1779,[318 427  64 132  98],716,5,8198,4.60561797752809,60.0,0.0
1780,0,1780,[318 427  64 132  98],796,5,8203,4.605839416058394,60.0,0.0
1781,0,1781,[318 427  64 132  98],18,5,8208,4.606060606060606,60.0,0.0
1782,0,1782,[318 427  64 132  98],655,4,8212,4.605720695457094,60.0,0.0
1783,0,1783,[318 427  64 132  98],269,5,8217,4.6059417040358746,60.0,0.0
1784,0,1784,[318 427  64 132  98],577,5,8222,4.606162464985994,60.0,0.0
1785,0,1785,[318 427  64 132  98],796,5,8227,4.6063829787234045,60.0,0.0
1786,0,1786,[318 427  64 132  98],693,4,8231,4.606043648573028,60.0,0.0
1787,0,1787,[318 427  64 132  98],450,5,8236,4.6062639821029085,60.0,0.0
1788,0,1788,[318 427  64 132  98],655,4,8240,4.605925097820011,60.0,0.0
1789,0,1789,[318 427  64 132  98],151,5,8245,4.606145251396648,60.0,0.0
1790,0,1790,[318 427  64 132  98],693,4,8249,4.605806811836962,60.0,0.0
1791,0,1791,[318 427  64 132  98],316,5,8254,4.606026785714286,60.0,0.0
1792,0,1792,[318 427  64 132  98],450,5,8259,4.606246514221974,60.0,0.0
1793,0,1793,[318 427  64 132  98],269,5,8264,4.6064659977703455,60.0,0.0
1794,0,1794,[ 97 294  82 153 191],450,4,8268,4.606128133704735,0.0,0.0
1795,0,1795,[318 427  64 132  98],269,5,8273,4.606347438752784,60.0,0.0
1796,0,1796,[318 427  64 132  98],716,5,8278,4.606566499721758,60.0,0.0
1797,0,1797,[318 427  64 132  98],330,5,8283,4.60678531701891,60.0,0.0
1798,0,1798,[318 427  64 132  98],236,5,8288,4.607003891050583,60.0,0.0
1799,0,1799,[318 427  64 132  98],269,5,8293,4.607222222222222,60.0,0.0
1800,0,1800,[318 427  64 132  98],330,5,8298,4.607440310938368,60.0,0.0
1801,0,1801,[318 427  64 132  98],18,5,8303,4.607658157602664,60.0,0.0
1802,0,1802,[318 427  64 132  98],18,5,8308,4.6078757626178595,60.0,0.0
1803,0,1803,[318 427  64 132  98],796,5,8313,4.60809312638581,60.0,0.0
1804,0,1804,[318 427  64 132  98],716,5,8318,4.608310249307479,60.0,0.0
1805,0,1805,[318 427  64 132  98],716,5,8323,4.608527131782946,60.0,0.0
1806,0,1806,[318 427  64 132  98],269,5,8328,4.6087437742114,60.0,0.0
1807,0,1807,[318 427  64 132  98],236,5,8333,4.60896017699115,60.0,0.0
1808,0,1808,[318 427  64 132  98],316,5,8338,4.609176340519624,60.0,0.0
1809,0,1809,[318 427  64 132  98],577,5,8343,4.60939226519337,60.0,0.0
1810,0,1810,[318 427  64 132  98],151,5,8348,4.609607951408062,60.0,0.0
1811,0,1811,[318 427  64 132  98],236,5,8353,4.609823399558499,60.0,0.0
1812,0,1812,[318 427  64 132  98],655,4,8357,4.609487038058466,60.0,0.0
1813,0,1813,[318 427  64 132  98],693,4,8361,4.609151047409041,60.0,0.0
1814,0,1814,[318 427  64 132  98],330,5,8366,4.609366391184573,60.0,0.0
1815,0,1815,[318 427  64 132  98],535,4,8370,4.609030837004405,60.0,0.0
1816,0,1816,[318 427  64 132  98],693,4,8374,4.608695652173913,60.0,0.0
1817,0,1817,[318 427  64 132  98],693,4,8378,4.608360836083609,60.0,0.0
1818,0,1818,[318 427  64 132  98],330,5,8383,4.608576140736669,60.0,0.0
1819,0,1819,[318 427  64 132  98],18,5,8388,4.608791208791208,60.0,0.0
1820,0,1820,[318 427  64 132  98],796,5,8393,4.609006040637013,60.0,0.0
1821,0,1821,[318 427  64 132  98],655,4,8397,4.608671789242591,60.0,0.0
1822,0,1822,[318 427  64 132  98],269,5,8402,4.608886450905102,60.0,0.0
1823,0,1823,[318 427  64 132  98],151,5,8407,4.609100877192983,60.0,0.0
1824,0,1824,[318 427  64 132  98],535,4,8411,4.608767123287671,60.0,0.0
1825,0,1825,[318 427  64 132  98],316,5,8416,4.608981380065718,60.0,0.0
1826,0,1826,[318 427  64 132  98],535,4,8420,4.608648056923919,60.0,0.0
1827,0,1827,[318 427  64 132  98],577,5,8425,4.608862144420131,60.0,0.0
1828,0,1828,[318 427  64 132  98],18,5,8430,4.6090759978130125,60.0,0.0
1829,0,1829,[318 427  64 132  98],450,5,8435,4.609289617486339,60.0,0.0
1830,0,1830,[318 427  64 132  98],796,5,8440,4.609503003823048,60.0,0.0
1831,0,1831,[318 427  64 132  98],18,5,8445,4.6097161572052405,60.0,0.0
1832,0,1832,[318 427  64 132  98],796,5,8450,4.609929078014185,60.0,0.0
1833,0,1833,[318 427  64 132  98],716,5,8455,4.610141766630316,60.0,0.0
1834,0,1834,[318 427  64 132  98],450,5,8460,4.610354223433243,60.0,0.0
1835,0,1835,[318 427  64 132  98],796,5,8465,4.610566448801743,60.0,0.0
1836,0,1836,[318 427  64 132  98],796,5,8470,4.610778443113772,60.0,0.0
1837,0,1837,[318 427  64 132  98],716,5,8475,4.610990206746464,60.0,0.0
1838,0,1838,[318 427  64 132  98],330,5,8480,4.611201740076129,60.0,0.0
1839,0,1839,[318 427  64 132  98],236,5,8485,4.611413043478261,60.0,0.0
1840,0,1840,[318 427  64 132  98],577,5,8490,4.61162411732754,60.0,0.0
1841,0,1841,[318 427  64 132  98],330,5,8495,4.611834961997828,60.0,0.0
1842,0,1842,[318 427  64 132  98],450,5,8500,4.612045577862181,60.0,0.0
1843,0,1843,[318 427  64 132  98],330,5,8505,4.612255965292841,60.0,0.0
1844,0,1844,[318 427  64 132  98],535,4,8509,4.611924119241192,60.0,0.0
1845,0,1845,[318 427  64 132  98],316,5,8514,4.612134344528711,60.0,0.0
1846,0,1846,[318 427  64 132  98],316,5,8519,4.6123443421765025,60.0,0.0
1847,0,1847,[318 427  64 132  98],796,5,8524,4.612554112554113,60.0,0.0
1848,0,1848,[318 427  64 132  98],316,5,8529,4.612763656030286,60.0,0.0
1849,0,1849,[318 427  64 132  98],450,5,8534,4.612972972972973,60.0,0.0
1850,0,1850,[318 427  64 132  98],269,5,8539,4.613182063749325,60.0,0.0
1851,0,1851,[318 427  64 132  98],330,5,8544,4.613390928725702,60.0,0.0
1852,0,1852,[318 427  64 132  98],535,4,8548,4.613059902860226,60.0,0.0
1853,0,1853,[318 427  64 132  98],577,5,8553,4.61326860841424,60.0,0.0
1854,0,1854,[318 427  64 132  98],577,5,8558,4.6134770889487875,60.0,0.0
1855,0,1855,[318 427  64 132  98],577,5,8563,4.613685344827586,60.0,0.0
1856,0,1856,[194  97 245 313 237],796,3,8566,4.612816370490037,0.0,0.0
1857,0,1857,[318 427  64 132  98],236,5,8571,4.613024757804091,60.0,0.0
1858,0,1858,[318 427  64 132  98],330,5,8576,4.6132329209252285,60.0,0.0
1859,0,1859,[318 427  64 132  98],796,5,8581,4.613440860215054,60.0,0.0
1860,0,1860,[318 427  64 132  98],236,5,8586,4.61364857603439,60.0,0.0
1861,0,1861,[318 427  64 132  98],316,5,8591,4.613856068743287,60.0,0.0
1862,0,1862,[318 427  64 132  98],151,5,8596,4.61406333870102,60.0,0.0
1863,0,1863,[318 427  64 132  98],796,5,8601,4.614270386266094,60.0,0.0
1864,0,1864,[318 427  64 132  98],18,5,8606,4.614477211796246,60.0,0.0
1865,0,1865,[318 427  64 132  98],655,4,8610,4.614147909967846,60.0,0.0
1866,0,1866,[318 427  64 132  98],316,5,8615,4.614354579539368,60.0,0.0
1867,0,1867,[318 427  64 132  98],236,5,8620,4.614561027837259,60.0,0.0
1868,0,1868,[318 427  64 132  98],535,4,8624,4.614232209737827,60.0,0.0
1869,0,1869,[ 89 196 135  97 187],655,3,8627,4.613368983957219,0.0,0.0
1870,0,1870,[318 427  64 132  98],330,5,8632,4.613575628006414,60.0,0.0
1871,0,1871,[318 427  64 132  98],269,5,8637,4.613782051282051,60.0,0.0
1872,0,1872,[318 427  64 132  98],236,5,8642,4.613988254137747,60.0,0.0
1873,0,1873,[318 427  64 132  98],716,5,8647,4.614194236926361,60.0,0.0
1874,0,1874,[318 427  64 132  98],316,5,8652,4.6144,60.0,0.0
1875,0,1875,[318 427  64 132  98],450,5,8657,4.614605543710021,60.0,0.0
1876,0,1876,[318 427  64 132  98],693,4,8661,4.61427810335642,60.0,0.0
1877,0,1877,[318 427  64 132  98],18,5,8666,4.614483493077742,60.0,0.0
1878,0,1878,[318 427  64 132  98],535,4,8670,4.614156466205428,60.0,0.0
1879,0,1879,[405 286 195 268 121],344,1,8671,4.612234042553191,0.0,20.0
1880,0,1880,[318 427  64 132 168],151,5,8676,4.6124401913875595,60.0,0.0
1881,0,1881,[318 427  64 132 168],577,5,8681,4.612646121147715,60.0,0.0
1882,0,1882,[318 427  64 132 168],151,5,8686,4.612851832182687,60.0,0.0
1883,0,1883,[318 427  64 132 168],577,5,8691,4.6130573248407645,60.0,0.0
1884,0,1884,[318 427  64 132 168],269,5,8696,4.613262599469496,60.0,0.0
1885,0,1885,[318 427  64 132 168],450,5,8701,4.613467656415694,60.0,0.0
1886,0,1886,[318 427  64 132 168],330,4,8705,4.613142554319025,60.0,0.0
1887,0,1887,[318 427  64 132  98],796,5,8710,4.6133474576271185,60.0,0.0
1888,0,1888,[318 427  64 132  98],269,5,8715,4.61355214399153,60.0,0.0
1889,0,1889,[318 427  64 132  98],151,5,8720,4.613756613756614,60.0,0.0
1890,0,1890,[318 427  64 132  98],18,5,8725,4.613960867265996,60.0,0.0
1891,0,1891,[318 427  64 132  98],577,5,8730,4.614164904862579,60.0,0.0
1892,0,1892,[318 427  64 132  98],269,5,8735,4.614368726888537,60.0,0.0
1893,0,1893,[318 427  64 132  98],693,4,8739,4.614044350580781,60.0,0.0
1894,0,1894,[318 427  64 132  98],269,5,8744,4.614248021108179,60.0,0.0
1895,0,1895,[318 427  64 132  98],535,4,8748,4.613924050632911,60.0,0.0
1896,0,1896,[318 427  64 132  98],577,5,8753,4.614127569847127,60.0,0.0
1897,0,1897,[318 427  64 132  98],796,5,8758,4.614330874604847,60.0,0.0
1898,0,1898,[318 427  64 132  98],236,5,8763,4.614533965244866,60.0,0.0
1899,0,1899,[302 181 174 403  64],269,1,8764,4.612631578947369,20.0,0.0
1900,0,1900,[318 427  64 132  98],236,5,8769,4.612835349815886,60.0,0.0
1901,0,1901,[318 427  64 132  98],330,5,8774,4.6130389064143005,60.0,0.0
1902,0,1902,[318 427  64 132  98],236,5,8779,4.6132422490803995,60.0,0.0
1903,0,1903,[318 427  64 132  98],269,5,8784,4.61344537815126,60.0,0.0
1904,0,1904,[318 427  64 132  98],316,5,8789,4.613648293963254,60.0,0.0
1905,0,1905,[318 427  64 132  98],18,5,8794,4.6138509968520465,60.0,0.0
1906,0,1906,[318 427  64 132  98],693,4,8798,4.613529103303618,60.0,0.0
1907,0,1907,[135 435 132 176 185],450,4,8802,4.613207547169812,0.0,0.0
1908,0,1908,[318 427 132  64  98],577,5,8807,4.613410162388685,60.0,0.0
1909,0,1909,[318 427 132  64  98],655,4,8811,4.613089005235602,60.0,0.0
1910,0,1910,[318 427  64 132  98],796,5,8816,4.613291470434327,60.0,0.0
1911,0,1911,[318 427  64 132  98],269,5,8821,4.6134937238493725,60.0,0.0
1912,0,1912,[318 427  64 132  98],796,5,8826,4.613695765812859,60.0,0.0
1913,0,1913,[318 427  64 132  98],693,4,8830,4.61337513061651,60.0,0.0
1914,0,1914,[318 427 132  64  98],796,5,8835,4.613577023498695,60.0,0.0
1915,0,1915,[318 427 132  64  98],716,5,8840,4.613778705636744,60.0,0.0
1916,0,1916,[318 427 132  64  98],316,5,8845,4.613980177360459,60.0,0.0
1917,0,1917,[318 427 132  64  98],577,5,8850,4.6141814389989575,60.0,0.0
1918,0,1918,[318 427 132  64  98],330,5,8855,4.614382490880667,60.0,0.0
1919,0,1919,[318 427 132  64  98],236,5,8860,4.614583333333333,60.0,0.0
1920,0,1920,[318 427 132  64  98],450,5,8865,4.614783966684019,60.0,0.0
1921,0,1921,[318 427 132  64  98],18,5,8870,4.614984391259105,60.0,0.0
1922,0,1922,[318 427 132  64  98],535,4,8874,4.614664586583463,60.0,0.0
1923,0,1923,[318 427 132  64  98],18,5,8879,4.614864864864865,60.0,0.0
1924,0,1924,[546 125 100 257  97],504,5,8884,4.615064935064935,0.0,20.0
1925,0,1925,[318 427 132  64  98],716,5,8889,4.6152647975077885,60.0,0.0
1926,0,1926,[318 427 132  64  98],655,4,8893,4.614945511157239,60.0,0.0
1927,0,1927,[318 427  64 132  98],716,5,8898,4.615145228215767,60.0,0.0
1928,0,1928,[318 427  64 132  98],577,5,8903,4.615344738206325,60.0,0.0
1929,0,1929,[318 427  64 132  98],330,5,8908,4.615544041450777,60.0,0.0
1930,0,1930,[318 427  64 132  98],716,5,8913,4.615743138270326,60.0,0.0
1931,0,1931,[318 427  64 132  98],535,4,8917,4.615424430641822,60.0,0.0
1932,0,1932,[318 427  64 132  98],330,5,8922,4.615623383341956,60.0,0.0
1933,0,1933,[318 427  64 132  98],716,5,8927,4.615822130299897,60.0,0.0
1934,0,1934,[ 82   4 204 275   1],786,5,8932,4.616020671834625,0.0,20.0
1935,0,1935,[318 427  64 132  98],577,5,8937,4.616219008264463,60.0,0.0
1936,0,1936,[318 427  64 132  98],236,5,8942,4.616417139907073,60.0,0.0
1937,0,1937,[210 318  56 185 357],450,4,8946,4.61609907120743,20.0,0.0
1938,0,1938,[318 427  64 132  98],535,4,8950,4.615781330582775,60.0,0.0
1939,0,1939,[318 427  64 132 496],151,5,8955,4.615979381443299,80.0,0.0
1940,0,1940,[318 427  64 132 496],450,5,8960,4.6161772282328695,80.0,0.0
1941,0,1941,[318 427  64 132 496],796,5,8965,4.616374871266736,80.0,0.0
1942,0,1942,[318 427  64 132 496],556,5,8970,4.616572310859496,80.0,0.0
1943,0,1943,[318 427  64 132 496],330,5,8975,4.616769547325103,80.0,0.0
1944,0,1944,[318 427  64 132 496],236,4,8979,4.616452442159383,80.0,0.0
1945,0,1945,[318 427  64 132  98],796,5,8984,4.6166495375128465,60.0,0.0
1946,0,1946,[318 427  64 132  98],236,5,8989,4.616846430405753,60.0,0.0
1947,0,1947,[318 427  64 132  98],269,5,8994,4.617043121149897,60.0,0.0
1948,0,1948,[318 427  64 132  98],577,5,8999,4.617239610056439,60.0,0.0
1949,0,1949,[318 427  64 132  98],450,5,9004,4.6174358974358976,60.0,0.0
1950,0,1950,[318 427  64 132  98],18,5,9009,4.617631983598155,60.0,0.0
1951,0,1951,[318 427  64 132  98],450,5,9014,4.617827868852459,60.0,0.0
1952,0,1952,[318 427  64 132  98],796,5,9019,4.618023553507425,60.0,0.0
1953,0,1953,[318 427  64 132  98],693,4,9023,4.617707267144319,60.0,0.0
1954,0,1954,[318 427 132  64  98],450,5,9028,4.617902813299232,60.0,0.0
1955,0,1955,[318 427 132  64  98],577,5,9033,4.618098159509202,60.0,0.0
1956,0,1956,[318 427 132  64  98],330,5,9038,4.618293306080735,60.0,0.0
1957,0,1957,[318 427 132  64  98],236,5,9043,4.618488253319714,60.0,0.0
1958,0,1958,[318 427 132  64  98],577,5,9048,4.6186830015313936,60.0,0.0
1959,0,1959,[318 427 132  64  98],577,5,9053,4.618877551020408,60.0,0.0
1960,0,1960,[318 427 132  64  98],693,4,9057,4.6185619581846,60.0,0.0
1961,0,1961,[216 135 202 568 435],389,2,9059,4.617227319062182,0.0,0.0
1962,0,1962,[318 427 132  64  98],450,5,9064,4.617422312786551,60.0,0.0
1963,0,1963,[318 427 132  64  98],693,4,9068,4.617107942973523,60.0,0.0
1964,0,1964,[318 427 132  64  98],655,4,9072,4.616793893129771,60.0,0.0
1965,0,1965,[318 427 132  64  98],450,5,9077,4.616988809766022,60.0,0.0
1966,0,1966,[318 427 132  64  98],716,5,9082,4.617183528215556,60.0,0.0
1967,0,1967,[318 427 132  64  98],577,5,9087,4.617378048780488,60.0,0.0
1968,0,1968,[318 427 132  64  98],796,5,9092,4.617572371762316,60.0,0.0
1969,0,1969,[318 427 132  64  98],577,5,9097,4.617766497461929,60.0,0.0
1970,0,1970,[318 427 132  64  98],269,5,9102,4.617960426179605,60.0,0.0
1971,0,1971,[318 427 132  64  98],18,5,9107,4.6181541582150105,60.0,0.0
1972,0,1972,[318 427 132  64  98],577,5,9112,4.618347693867207,60.0,0.0
1973,0,1973,[318 427 132  64  98],269,5,9117,4.61854103343465,60.0,0.0
1974,0,1974,[318 427 132  64  98],577,5,9122,4.61873417721519,60.0,0.0
1975,0,1975,[318 427 132  64  98],269,5,9127,4.618927125506073,60.0,0.0
1976,0,1976,[318 427 132  64  98],450,5,9132,4.619119878603946,60.0,0.0
1977,0,1977,[318 427 132  64  98],330,5,9137,4.6193124368048535,60.0,0.0
1978,0,1978,[318 427 132  64  98],577,5,9142,4.619504800404244,60.0,0.0
1979,0,1979,[318 427 132  64  98],236,5,9147,4.61969696969697,60.0,0.0
1980,0,1980,[318 427 132  64  98],151,5,9152,4.619888944977284,60.0,0.0
1981,0,1981,[318 427 132  64  98],716,5,9157,4.620080726538849,60.0,0.0
1982,0,1982,[318 427 132  64  98],18,5,9162,4.620272314674735,60.0,0.0
1983,0,1983,[318 427 132  64  98],796,5,9167,4.620463709677419,60.0,0.0
1984,0,1984,[318 427 132  64  98],151,5,9172,4.620654911838791,60.0,0.0
1985,0,1985,[318 427 132  64  98],316,5,9177,4.620845921450151,60.0,0.0
1986,0,1986,[318 427 132  64  98],236,5,9182,4.621036738802214,60.0,0.0
1987,0,1987,[318 427 132  64  98],796,5,9187,4.621227364185111,60.0,0.0
1988,0,1988,[318 427 132  64  98],236,5,9192,4.621417797888386,60.0,0.0
1989,0,1989,[318 427 132  64  98],716,5,9197,4.621608040201005,60.0,0.0
1990,0,1990,[318 427 132  64  98],450,5,9202,4.6217980914113515,60.0,0.0
1991,0,1991,[174 210 161 603 275],716,4,9206,4.621485943775101,20.0,20.0
1992,0,1992,[318 427 132  64  98],796,5,9211,4.621675865529353,60.0,0.0
1993,0,1993,[318 427 132  64  98],330,5,9216,4.6218655967903715,60.0,0.0
1994,0,1994,[318 427 132  64  98],535,4,9220,4.62155388471178,60.0,0.0
1995,0,1995,[318 427 132  64  98],269,5,9225,4.621743486973948,60.0,0.0
1996,0,1996,[318 427 132  64  98],330,5,9230,4.621932899349024,60.0,0.0
1997,0,1997,[237   4  71  70  97],450,3,9233,4.621121121121121,0.0,0.0
1998,0,1998,[318 427 132  64  98],577,5,9238,4.6213106553276635,60.0,0.0
1999,0,1999,[318 427 132  64  98],796,5,9243,4.6215,60.0,0.0
2000,0,2000,[318 427 132  64  98],316,5,9248,4.621689155422289,60.0,0.0
2001,0,2001,[318 427 132  64  98],330,5,9253,4.6218781218781215,60.0,0.0
2002,0,2002,[318 427 132  64  98],693,4,9257,4.6215676485272095,60.0,0.0
2003,0,2003,[318 427 132  64  98],18,5,9262,4.621756487025948,60.0,0.0
2004,0,2004,[318 427 132  64  98],535,4,9266,4.6214463840399,60.0,0.0
2005,0,2005,[318 427 132  64  98],716,5,9271,4.621635094715852,60.0,0.0
2006,0,2006,[318 427 132  64  98],693,4,9275,4.621325361235675,60.0,0.0
2007,0,2007,[318 427 132  64  98],655,4,9279,4.62101593625498,60.0,0.0
2008,0,2008,[318 427 132  64  98],330,5,9284,4.6212045793927325,60.0,0.0
2009,0,2009,[318 427 132  64  98],535,4,9288,4.62089552238806,60.0,0.0
2010,0,2010,[318 427 132  64  98],151,5,9293,4.621084037792143,60.0,0.0
2011,0,2011,[318 427 132  64  98],577,5,9298,4.621272365805169,60.0,0.0
2012,0,2012,[318 427 132  64  98],693,4,9302,4.620963735717834,60.0,0.0
2013,0,2013,[318 427 132  64  98],151,5,9307,4.621151936444885,60.0,0.0
2014,0,2014,[318 427 132  64  98],693,4,9311,4.620843672456576,60.0,0.0
2015,0,2015,[318 427 132  64  98],716,5,9316,4.621031746031746,60.0,0.0
2016,0,2016,[318 427 132  64  98],151,5,9321,4.621219633118493,60.0,0.0
2017,0,2017,[318 427 132  64  98],535,4,9325,4.620911793855302,60.0,0.0
2018,0,2018,[318 427 132  64  98],236,5,9330,4.621099554234769,60.0,0.0
2019,0,2019,[318 427 132  64  98],236,5,9335,4.621287128712871,60.0,0.0
2020,0,2020,[318 427 132  64  98],330,5,9340,4.621474517565562,60.0,0.0
2021,0,2021,[318 427 132  64  98],716,5,9345,4.621661721068249,60.0,0.0
2022,0,2022,[318 427 132  64  98],316,5,9350,4.621848739495798,60.0,0.0
2023,0,2023,[318 427 132  64  98],655,4,9354,4.621541501976284,60.0,0.0
2024,0,2024,[318 427 132  64  98],316,5,9359,4.621728395061728,60.0,0.0
2025,0,2025,[318 427 132  64  98],18,5,9364,4.621915103652517,60.0,0.0
2026,0,2026,[318 427 132  64  98],316,5,9369,4.622101628021707,60.0,0.0
2027,0,2027,[318 427 132  64  98],151,5,9374,4.622287968441815,60.0,0.0
2028,0,2028,[318 427 132  64  98],716,5,9379,4.62247412518482,60.0,0.0
2029,0,2029,[318 427 132  64  98],330,5,9384,4.622660098522167,60.0,0.0
2030,0,2030,[318 427 132  64  98],577,5,9389,4.6228458887247665,60.0,0.0
2031,0,2031,[318 427 132  64  98],316,5,9394,4.623031496062992,60.0,0.0
2032,0,2032,[318 427 132  64  98],655,4,9398,4.6227250368912935,60.0,0.0
2033,0,2033,[318 427 132  64  98],693,4,9402,4.622418879056047,60.0,0.0
2034,0,2034,[318 427 132  64  98],716,5,9407,4.6226044226044225,60.0,0.0
2035,0,2035,[318 427 132  64  98],535,4,9411,4.62229862475442,60.0,0.0
2036,0,2036,[318 427 132  64  98],18,5,9416,4.622484045164457,60.0,0.0
2037,0,2037,[318 427 132  64  98],330,5,9421,4.622669283611383,60.0,0.0
2038,0,2038,[318 427 132  64  98],716,5,9426,4.622854340362923,60.0,0.0
2039,0,2039,[318 427 132  64  98],316,5,9431,4.6230392156862745,60.0,0.0
2040,0,2040,[318 427 132  64  98],535,4,9435,4.622733953944145,60.0,0.0
2041,0,2041,[318 427 132  64  98],655,4,9439,4.622428991185113,60.0,0.0
2042,0,2042,[318 427 132  64  98],151,5,9444,4.622613803230544,60.0,0.0
2043,0,2043,[318 427 132  64  98],18,5,9449,4.62279843444227,60.0,0.0
2044,0,2044,[318 427 132  64  98],316,5,9454,4.622982885085575,60.0,0.0
2045,0,2045,[318 427 132  64  98],18,5,9459,4.62316715542522,60.0,0.0
2046,0,2046,[318 427 132  64  98],577,5,9464,4.623351245725452,60.0,0.0
2047,0,2047,[318 427 132  64  98],716,5,9469,4.62353515625,60.0,0.0
2048,0,2048,[318 427 132  64  98],535,4,9473,4.6232308443143,60.0,0.0
2049,0,2049,[318 427 132  64  98],330,5,9478,4.623414634146341,60.0,0.0
2050,0,2050,[318 427 132  64  98],535,4,9482,4.623110677718186,60.0,0.0
2051,0,2051,[318 427 132  64 588],316,4,9486,4.62280701754386,60.0,0.0
2052,0,2052,[318 427 132  64 496],450,5,9491,4.622990745250853,80.0,0.0
2053,0,2053,[318 427 132  64 496],236,4,9495,4.622687439143135,80.0,0.0
2054,0,2054,[318 427 132  64  98],236,5,9500,4.622871046228711,60.0,0.0
2055,0,2055,[318 427 132  64  98],450,5,9505,4.623054474708171,60.0,0.0
2056,0,2056,[318 427 132  64  98],693,4,9509,4.622751579970831,60.0,0.0
2057,0,2057,[294 275 568 273 258],450,4,9513,4.622448979591836,0.0,20.0
2058,0,2058,[318 427 132  64  98],450,5,9518,4.622632345798931,60.0,0.0
2059,0,2059,[318 427 132  64  98],535,4,9522,4.622330097087379,60.0,0.0
2060,0,2060,[318 427 132  64 496],151,5,9527,4.622513343037361,80.0,0.0
2061,0,2061,[318 427 132  64 496],18,5,9532,4.622696411251212,80.0,0.0
2062,0,2062,[318 427 132  64 496],535,5,9537,4.622879301987397,80.0,0.0
2063,0,2063,[ 12 748 183 180 288],450,4,9541,4.622577519379845,0.0,0.0
2064,0,2064,[318 427 132  64 496],796,5,9546,4.622760290556901,80.0,0.0
2065,0,2065,[318 427 132  64 496],330,5,9551,4.622942884801549,80.0,0.0
2066,0,2066,[318 427 132  64 496],269,5,9556,4.623125302370585,80.0,0.0
2067,0,2067,[405 186 655 237 200],269,2,9558,4.621856866537717,0.0,0.0
2068,0,2068,[318 427 132  64 496],796,5,9563,4.622039632672789,80.0,0.0
2069,0,2069,[318 427 132  64 496],330,5,9568,4.622222222222222,80.0,0.0
2070,0,2070,[318 427 132  64 496],796,5,9573,4.622404635441815,80.0,0.0
2071,0,2071,[318 427 132  64 496],796,5,9578,4.622586872586872,80.0,0.0
2072,0,2072,[318 427 132  64 496],556,5,9583,4.622768933912204,80.0,0.0
2073,0,2073,[318 427 132  64 496],535,5,9588,4.622950819672131,80.0,0.0
2074,0,2074,[318 427 132  64 496],716,5,9593,4.623132530120482,80.0,0.0
2075,0,2075,[318 427 132  64 496],577,5,9598,4.6233140655105975,80.0,0.0
2076,0,2076,[318 427 132  64 496],330,5,9603,4.62349542609533,80.0,0.0
2077,0,2077,[318 427 132  64 496],556,5,9608,4.623676612127046,80.0,0.0
2078,0,2078,[211  50 515  97 127],401,3,9611,4.622895622895623,0.0,40.0
2079,0,2079,[318 427 132  64 496],151,5,9616,4.623076923076923,80.0,0.0
2080,0,2080,[318 427 132  64 496],330,5,9621,4.623258049014897,80.0,0.0
2081,0,2081,[318 427 132  64 496],716,5,9626,4.623439000960615,80.0,0.0
2082,0,2082,[300 245 185 202 210],796,3,9629,4.622659625540086,0.0,0.0
2083,0,2083,[318 427 132  64 185],18,4,9633,4.622360844529751,60.0,0.0
2084,0,2084,[318 427 132  64 496],716,5,9638,4.6225419664268586,80.0,0.0
2085,0,2085,[318 427 132  64 496],330,5,9643,4.6227229146692235,80.0,0.0
2086,0,2086,[318 427 132  64 496],716,5,9648,4.622903689506469,80.0,0.0
2087,0,2087,[318 427 132  64 496],535,5,9653,4.623084291187739,80.0,0.0
2088,0,2088,[ 22 742  56 117 176],280,4,9657,4.622786022020105,0.0,0.0
2089,0,2089,[318 427 132  64 496],151,5,9662,4.622966507177034,80.0,0.0
2090,0,2090,[318 427 132  64 496],535,5,9667,4.623146819703491,80.0,0.0
2091,0,2091,[318 427 132  64 496],577,5,9672,4.623326959847036,80.0,0.0
2092,0,2092,[318 427 132  64 496],18,5,9677,4.623506927854754,80.0,0.0
2093,0,2093,[318 427 132  64 496],450,5,9682,4.623686723973257,80.0,0.0
2094,0,2094,[318 427 132  64 496],556,5,9687,4.623866348448687,80.0,0.0
2095,0,2095,[318 427 132  64 496],236,4,9691,4.623568702290076,80.0,0.0
2096,0,2096,[185 475 181 173 286],503,3,9694,4.62279446828803,0.0,20.0
2097,0,2097,[318 427 132  64 496],269,5,9699,4.6229742612011435,80.0,0.0
2098,0,2098,[294 161 269 318 568],796,3,9702,4.622201048118152,20.0,0.0
2099,0,2099,[318 427 132  64 496],556,5,9707,4.6223809523809525,80.0,0.0
2100,0,2100,[202 174   7   1 603],655,1,9708,4.620656830080914,20.0,0.0
2101,0,2101,[228 357 237 313 328],450,5,9713,4.620837297811608,0.0,0.0
2102,0,2102,[318 427 132  64 496],450,5,9718,4.621017593913457,80.0,0.0
2103,0,2103,[318 427 132  64 496],535,5,9723,4.621197718631179,80.0,0.0
2104,0,2104,[318 427 132  64 496],236,4,9727,4.620902612826604,80.0,0.0
2105,0,2105,[318 427 132  64 496],535,5,9732,4.621082621082621,80.0,0.0
2106,0,2106,[318 427 132  64 496],577,5,9737,4.621262458471761,80.0,0.0
2107,0,2107,[318 427 132  64 496],450,5,9742,4.621442125237191,80.0,0.0
2108,0,2108,[318 427 132  64 496],269,5,9747,4.621621621621622,80.0,0.0
2109,0,2109,[318 427 132  64 496],716,5,9752,4.621800947867299,80.0,0.0
2110,0,2110,[318 427 132  64 496],796,5,9757,4.621980104216012,80.0,0.0
2111,0,2111,[318 427 132  64 496],18,5,9762,4.622159090909091,80.0,0.0
2112,0,2112,[318 427 132  64 496],556,5,9767,4.622337908187411,80.0,0.0
2113,0,2113,[318 427 132  64 496],236,4,9771,4.622043519394513,80.0,0.0
2114,0,2114,[318 427 132  64 496],556,5,9776,4.622222222222222,80.0,0.0
2115,0,2115,[318 427 132  64 496],716,5,9781,4.6224007561436675,80.0,0.0
2116,0,2116,[318 427 132  64 496],330,5,9786,4.622579121398205,80.0,0.0
2117,0,2117,[318 427 132  64 496],330,5,9791,4.62275731822474,80.0,0.0
2118,0,2118,[318 427 132  64 496],236,4,9795,4.6224634261444075,80.0,0.0
2119,0,2119,[318 427 132  64 275],316,5,9800,4.622641509433962,60.0,20.0
2120,0,2120,[318 427 132  64 275],151,5,9805,4.622819424799623,60.0,20.0
2121,0,2121,[318 427 132  64 275],655,4,9809,4.622525918944392,60.0,20.0
2122,0,2122,[195 161  56  98 568],716,3,9812,4.6217616580310885,0.0,0.0
2123,0,2123,[318 427 132  64 275],18,5,9817,4.6219397363465164,60.0,20.0
2124,0,2124,[318 427 132  64 275],450,5,9822,4.622117647058824,60.0,20.0
2125,0,2125,[318 427 132  64 275],535,5,9827,4.622295390404515,60.0,20.0
2126,0,2126,[318 427 132  64 275],316,5,9832,4.622472966619652,60.0,20.0
2127,0,2127,[318 427 132  64 275],716,5,9837,4.62265037593985,60.0,20.0
2128,0,2128,[318 427 132  64 275],18,5,9842,4.622827618600282,60.0,20.0
2129,0,2129,[318 427 132  64 275],316,5,9847,4.62300469483568,60.0,20.0
2130,0,2130,[176 301  88 222 200],655,1,9848,4.62130455185359,0.0,0.0
2131,0,2131,[318 427 132  64 275],535,5,9853,4.621482176360225,60.0,20.0
2132,0,2132,[318 427 132  64 275],330,5,9858,4.621659634317862,60.0,20.0
2133,0,2133,[318 427 132  64 275],330,5,9863,4.621836925960637,60.0,20.0
2134,0,2134,[318 427 132  64 275],236,4,9867,4.6215456674473065,60.0,20.0
2135,0,2135,[318 427 132  64  98],577,5,9872,4.621722846441948,60.0,0.0
2136,0,2136,[318 427 132  64  98],716,5,9877,4.621899859616285,60.0,0.0
2137,0,2137,[318 427 132  64  98],151,5,9882,4.622076707202994,60.0,0.0
2138,0,2138,[318 427 132  64  98],796,5,9887,4.622253389434315,60.0,0.0
2139,0,2139,[318 427 132  64  98],316,5,9892,4.622429906542056,60.0,0.0
2140,0,2140,[318 427 132  64  98],151,5,9897,4.62260625875759,60.0,0.0
2141,0,2141,[318 427 132  64  98],535,4,9901,4.622315592903828,60.0,0.0
2142,0,2142,[318 427 132  64 275],330,5,9906,4.622491833877741,60.0,20.0
2143,0,2143,[318 427 132  64 275],316,5,9911,4.6226679104477615,60.0,20.0
2144,0,2144,[318 427 132  64 275],316,5,9916,4.622843822843823,60.0,20.0
2145,0,2145,[318 427 132  64 275],535,5,9921,4.623019571295433,60.0,20.0
2146,0,2146,[318 427 132  64 275],450,5,9926,4.623195156031672,60.0,20.0
2147,0,2147,[318 427 132  64 275],655,4,9930,4.622905027932961,60.0,20.0
2148,0,2148,[318 427 132  64 275],450,5,9935,4.62308050255933,60.0,20.0
2149,0,2149,[318 427 132  64 275],18,5,9940,4.623255813953488,60.0,20.0
2150,0,2150,[318 427 132  64 275],151,5,9945,4.623430962343096,60.0,20.0
2151,0,2151,[318 427 132  64 275],18,5,9950,4.62360594795539,60.0,20.0
2152,0,2152,[318 427 132  64 275],716,5,9955,4.623780771017185,60.0,20.0
2153,0,2153,[318 427 132  64 275],450,5,9960,4.623955431754875,60.0,20.0
2154,0,2154,[318 427 132  64 275],236,4,9964,4.623665893271462,60.0,20.0
2155,0,2155,[318 427 132  64  98],18,5,9969,4.623840445269017,60.0,0.0
2156,0,2156,[318 427 132  64  98],151,5,9974,4.6240148354195645,60.0,0.0
2157,0,2157,[318 427 132  64  98],577,5,9979,4.6241890639481005,60.0,0.0
2158,0,2158,[318 427 132  64  98],535,4,9983,4.62389995368226,60.0,0.0
2159,0,2159,[318 427 132  64 496],577,5,9988,4.624074074074074,80.0,0.0
2160,0,2160,[318 427 132  64 496],269,5,9993,4.624248033317908,80.0,0.0
2161,0,2161,[318 427 132  64 496],236,4,9997,4.623959296947271,80.0,0.0
2162,0,2162,[318 427 132  64  98],330,5,10002,4.624133148404993,60.0,0.0
2163,0,2163,[318 427 132  64  98],655,4,10006,4.623844731977819,60.0,0.0
2164,0,2164,[318 427 132  64  98],450,5,10011,4.624018475750577,60.0,0.0
2165,0,2165,[318 427 132  64  98],330,5,10016,4.624192059095106,60.0,0.0
2166,0,2166,[318 427 132  64  98],151,5,10021,4.624365482233503,60.0,0.0
2167,0,2167,[318 427 132  64  98],535,4,10025,4.624077490774908,60.0,0.0
2168,0,2168,[318 427 132  64 496],330,5,10030,4.6242508068234205,80.0,0.0
2169,0,2169,[318 427 132  64 496],151,5,10035,4.624423963133641,80.0,0.0
2170,0,2170,[318 427 132  64 496],18,5,10040,4.6245969599263015,80.0,0.0
2171,0,2171,[318 427 132  64 496],269,5,10045,4.624769797421731,80.0,0.0
2172,0,2172,[318 427 132  64 496],236,4,10049,4.624482282558675,80.0,0.0
2173,0,2173,[318 427 132  64 275],151,5,10054,4.624655013799448,60.0,20.0
2174,0,2174,[318 427 132  64 275],236,4,10058,4.624367816091954,60.0,20.0
2175,0,2175,[318 427 132  64  98],655,4,10062,4.624080882352941,60.0,0.0
2176,0,2176,[318 427  64 132  98],269,5,10067,4.624253559944878,60.0,0.0
2177,0,2177,[318 427  64 132  98],151,5,10072,4.624426078971534,60.0,0.0
2178,0,2178,[318 427  64 132  98],330,5,10077,4.6245984396512165,60.0,0.0
2179,0,2179,[318 427  64 132  98],330,5,10082,4.624770642201835,60.0,0.0
2180,0,2180,[318 427  64 132  98],577,5,10087,4.624942686840899,60.0,0.0
2181,0,2181,[318 427  64 132  98],18,5,10092,4.625114573785518,60.0,0.0
2182,0,2182,[318 427  64 132  98],577,5,10097,4.6252863032524045,60.0,0.0
2183,0,2183,[318 427  64 132  98],535,4,10101,4.625,60.0,0.0
2184,0,2184,[318 427  64 132  98],330,5,10106,4.625171624713959,60.0,0.0
2185,0,2185,[318 427  64 132  98],535,4,10110,4.624885635864593,60.0,0.0
2186,0,2186,[318 427  64 132 496],450,5,10115,4.625057155921353,80.0,0.0
2187,0,2187,[318 427  64 132 496],716,5,10120,4.625228519195613,80.0,0.0
2188,0,2188,[318 427  64 132 496],450,5,10125,4.625399725902239,80.0,0.0
2189,0,2189,[318 427  64 132 496],450,5,10130,4.6255707762557075,80.0,0.0
2190,0,2190,[318 427  64 132 496],236,4,10134,4.625285257873117,80.0,0.0
2191,0,2191,[318 427  64 132 191],716,5,10139,4.625456204379562,60.0,0.0
2192,0,2192,[318 427  64 132 191],269,5,10144,4.6256269949840405,60.0,0.0
2193,0,2193,[318 427  64 132 191],450,5,10149,4.6257976298997265,60.0,0.0
2194,0,2194,[318 427  64 132 191],18,5,10154,4.625968109339408,60.0,0.0
2195,0,2195,[318 427  64 132 191],151,4,10158,4.6256830601092895,60.0,0.0
2196,0,2196,[318 427  64 132 496],330,5,10163,4.6258534365043245,80.0,0.0
2197,0,2197,[318 427  64 132 496],18,5,10168,4.626023657870792,80.0,0.0
2198,0,2198,[318 427  64 132 496],18,5,10173,4.626193724420191,80.0,0.0
2199,0,2199,[318 427  64 132 496],556,5,10178,4.626363636363636,80.0,0.0
2200,0,2200,[318 427  64 132 496],556,5,10183,4.626533393911858,80.0,0.0
2201,0,2201,[318 427  64 132 496],716,5,10188,4.6267029972752045,80.0,0.0
2202,0,2202,[318 427  64 132 496],535,5,10193,4.626872446663641,80.0,0.0
2203,0,2203,[318 427  64 132 496],450,5,10198,4.627041742286751,80.0,0.0
2204,0,2204,[318 427  64 132 496],716,5,10203,4.627210884353741,80.0,0.0
2205,0,2205,[318 427  64 132 496],450,5,10208,4.627379873073436,80.0,0.0
2206,0,2206,[318 427  64 132 496],18,5,10213,4.627548708654282,80.0,0.0
2207,0,2207,[318 427  64 132 496],577,5,10218,4.627717391304348,80.0,0.0
2208,0,2208,[318 427  64 132 496],535,5,10223,4.627885921231327,80.0,0.0
2209,0,2209,[318 427  64 132 496],716,5,10228,4.628054298642534,80.0,0.0
2210,0,2210,[318 427  64 132 496],151,5,10233,4.6282225237449115,80.0,0.0
2211,0,2211,[318 427  64 132 496],18,5,10238,4.628390596745027,80.0,0.0
2212,0,2212,[318 427  64 132 496],716,5,10243,4.628558517849074,80.0,0.0
2213,0,2213,[318 427  64 132 496],716,5,10248,4.6287262872628725,80.0,0.0
2214,0,2214,[318 427  64 132 496],330,5,10253,4.628893905191873,80.0,0.0
2215,0,2215,[318 427  64 132 496],535,5,10258,4.629061371841155,80.0,0.0
2216,0,2216,[318 427  64 132 496],577,5,10263,4.629228687415426,80.0,0.0
2217,0,2217,[318 427  64 132 496],556,5,10268,4.629395852119026,80.0,0.0
2218,0,2218,[318 427  64 132 496],330,5,10273,4.6295628661559265,80.0,0.0
2219,0,2219,[318 427  64 132 496],18,5,10278,4.629729729729729,80.0,0.0
2220,0,2220,[318 427  64 132 496],18,5,10283,4.629896443043674,80.0,0.0
2221,0,2221,[318 427  64 132 496],796,5,10288,4.63006300630063,80.0,0.0
2222,0,2222,[318 427  64 132 496],330,5,10293,4.630229419703104,80.0,0.0
2223,0,2223,[318 427  64 132 496],577,5,10298,4.630395683453237,80.0,0.0
2224,0,2224,[318 427  64 132 496],716,5,10303,4.630561797752809,80.0,0.0
2225,0,2225,[318 427  64 132 496],450,5,10308,4.630727762803234,80.0,0.0
2226,0,2226,[318 427  64 132 496],796,5,10313,4.630893578805568,80.0,0.0
2227,0,2227,[318 427  64 132 496],577,5,10318,4.631059245960503,80.0,0.0
2228,0,2228,[318 427  64 132 496],450,5,10323,4.631224764468372,80.0,0.0
2229,0,2229,[318 427  64 132 496],535,5,10328,4.631390134529148,80.0,0.0
2230,0,2230,[ 11 235  22 200 483],457,4,10332,4.6311071268489465,0.0,0.0
2231,0,2231,[318 427  64 132 496],269,5,10337,4.631272401433692,80.0,0.0
2232,0,2232,[318 427  64 132 496],18,5,10342,4.631437527989252,80.0,0.0
2233,0,2233,[318 427  64 132 496],556,5,10347,4.6316025067144135,80.0,0.0
2234,0,2234,[ 98 176 271 301   9],796,3,10350,4.630872483221476,0.0,0.0
2235,0,2235,[187  22  79 216 568],796,5,10355,4.631037567084078,0.0,0.0
2236,0,2236,[318 427  64 132 496],535,5,10360,4.6312025033527044,80.0,0.0
2237,0,2237,[483  88 245  22 403],450,4,10364,4.630920464700625,0.0,0.0
2238,0,2238,[318 187  70  79  97],450,5,10369,4.631085305940152,20.0,0.0
2239,0,2239,[318 427  64 132 496],236,4,10373,4.630803571428571,80.0,0.0
2240,0,2240,[318 427  64 132 496],18,5,10378,4.630968317715306,80.0,0.0
2241,0,2241,[318 427  64 132 496],330,5,10383,4.631132917038358,80.0,0.0
2242,0,2242,[ 97 273 742  56 191],450,4,10387,4.630851538118591,0.0,0.0
2243,0,2243,[318 427  64 132 496],269,5,10392,4.6310160427807485,80.0,0.0
2244,0,2244,[318 427  64 132 496],330,5,10397,4.631180400890869,80.0,0.0
2245,0,2245,[318 427  64 132 496],535,5,10402,4.6313446126447015,80.0,0.0
2246,0,2246,[318 427  64 132 496],450,5,10407,4.63150867823765,80.0,0.0
2247,0,2247,[318 427  64 132 496],151,5,10412,4.631672597864768,80.0,0.0
2248,0,2248,[318 427  64 132 496],535,5,10417,4.631836371720765,80.0,0.0
2249,0,2249,[318 427  64 132 496],450,5,10422,4.632,80.0,0.0
2250,0,2250,[318 427  64 132 496],535,5,10427,4.63216348289649,80.0,0.0
2251,0,2251,[318 427  64 132 496],535,5,10432,4.632326820603907,80.0,0.0
2252,0,2252,[318 427  64 132 496],450,5,10437,4.6324900133155795,80.0,0.0
2253,0,2253,[318 427  64 132 496],18,5,10442,4.63265306122449,80.0,0.0
2254,0,2254,[197 121  79 289 191],655,2,10444,4.631485587583149,0.0,0.0
2255,0,2255,[318 427  64 132 496],796,5,10449,4.631648936170213,80.0,0.0
2256,0,2256,[318 427  64 132 496],236,4,10453,4.631369073992025,80.0,0.0
2257,0,2257,[318 427  64 132 496],450,5,10458,4.631532329495128,80.0,0.0
2258,0,2258,[318 427  64 132 496],556,5,10463,4.631695440460381,80.0,0.0
2259,0,2259,[318 427  64 132 496],577,5,10468,4.631858407079646,80.0,0.0
2260,0,2260,[172 174 588  88 173],796,5,10473,4.632021229544449,0.0,0.0
2261,0,2261,[318 427  64 132 496],18,5,10478,4.632183908045977,80.0,0.0
2262,0,2262,[318 427  64 132 496],535,5,10483,4.632346442775077,80.0,0.0
2263,0,2263,[318 427  64 132 496],330,5,10488,4.6325088339222615,80.0,0.0
2264,0,2264,[318 427  64 132 496],18,5,10493,4.632671081677704,80.0,0.0
2265,0,2265,[318 427  64 132 496],18,5,10498,4.632833186231244,80.0,0.0
2266,0,2266,[318 427  64 132 496],556,5,10503,4.6329951477723865,80.0,0.0
2267,0,2267,[318 427  64 132 496],796,5,10508,4.6331569664903,80.0,0.0
2268,0,2268,[143  89 748 118 269],450,4,10512,4.632877919788453,0.0,0.0
2269,0,2269,[318 427  64 132 496],330,5,10517,4.6330396475770925,80.0,0.0
2270,0,2270,[318 427  64 132 496],269,5,10522,4.633201232937032,80.0,0.0
2271,0,2271,[318 427  64 132 496],716,5,10527,4.633362676056338,80.0,0.0
2272,0,2272,[318 427  64 132 496],269,5,10532,4.633523977122746,80.0,0.0
2273,0,2273,[318 427  64 132 496],796,5,10537,4.633685136323659,80.0,0.0
2274,0,2274,[318 427  64 132 496],556,5,10542,4.633846153846154,80.0,0.0
2275,0,2275,[318 427  64 132 496],330,5,10547,4.634007029876977,80.0,0.0
2276,0,2276,[318 427  64 132 496],450,5,10552,4.634167764602547,80.0,0.0
2277,0,2277,[318 427  64 132 496],269,5,10557,4.634328358208955,80.0,0.0
2278,0,2278,[318 427  64 132 496],556,5,10562,4.634488810881966,80.0,0.0
2279,0,2279,[318 427  64 132 496],716,5,10567,4.6346491228070175,80.0,0.0
2280,0,2280,[318 427  64 132 496],330,5,10572,4.634809294169224,80.0,0.0
2281,0,2281,[318 427  64 132 496],269,5,10577,4.634969325153374,80.0,0.0
2282,0,2282,[318 427  64 132 496],535,5,10582,4.635129215943933,80.0,0.0
2283,0,2283,[318 427  64 132 496],796,5,10587,4.635288966725044,80.0,0.0
2284,0,2284,[318 427  64 132 496],269,5,10592,4.635448577680525,80.0,0.0
2285,0,2285,[318 427  64 132 496],18,5,10597,4.635608048993876,80.0,0.0
2286,0,2286,[318 427  64 132 496],330,5,10602,4.6357673808482724,80.0,0.0
2287,0,2287,[603   1  82  28 423],330,5,10607,4.635926573426573,20.0,0.0
2288,0,2288,[318 427  64 132 496],330,5,10612,4.636085626911315,80.0,0.0
2289,0,2289,[318 427  64 132 496],716,5,10617,4.636244541484716,80.0,0.0
2290,0,2290,[127 301 273 191 117],344,4,10621,4.635966826713226,0.0,20.0
2291,0,2291,[318 427  64 132 496],330,5,10626,4.636125654450262,80.0,0.0
2292,0,2292,[318 427  64 132 496],330,5,10631,4.636284343654601,80.0,0.0
2293,0,2293,[318 427  64 132 496],18,5,10636,4.636442894507411,80.0,0.0
2294,0,2294,[318 427  64 132 496],151,5,10641,4.636601307189543,80.0,0.0
2295,0,2295,[234   4 275 204 222],796,4,10645,4.6363240418118465,0.0,20.0
2296,0,2296,[  1  15 475 333 742],655,0,10645,4.634305616020897,0.0,0.0
2297,0,2297,[318 427  64 132 496],151,5,10650,4.634464751958225,80.0,0.0
2298,0,2298,[318 427  64 132 496],18,5,10655,4.634623749456285,80.0,0.0
2299,0,2299,[318 427  64 132 496],269,5,10660,4.6347826086956525,80.0,0.0
2300,0,2300,[318 427  64 132 496],535,5,10665,4.634941329856584,80.0,0.0
2301,0,2301,[132 357 173 238 161],457,5,10670,4.635099913119027,0.0,0.0
2302,0,2302,[318 427  64 132 496],330,5,10675,4.635258358662614,80.0,0.0
2303,0,2303,[318 427  64 132 496],269,5,10680,4.635416666666667,80.0,0.0
2304,0,2304,[318 427  64 132 496],450,5,10685,4.6355748373101955,80.0,0.0
2305,0,2305,[318 427  64 132 496],18,5,10690,4.635732870771899,80.0,0.0
2306,0,2306,[318 427  64 132 496],556,5,10695,4.635890767230169,80.0,0.0
2307,0,2307,[318 427  64 132 496],716,5,10700,4.636048526863085,80.0,0.0
2308,0,2308,[318 427  64 132 496],556,5,10705,4.6362061498484195,80.0,0.0
2309,0,2309,[318 427  64 132 496],151,5,10710,4.636363636363637,80.0,0.0
2310,0,2310,[318 427  64 132 496],796,5,10715,4.636520986585894,80.0,0.0
2311,0,2311,[318 427  64 132 496],450,5,10720,4.6366782006920415,80.0,0.0
2312,0,2312,[318 427  64 132 496],535,5,10725,4.636835278858626,80.0,0.0
2313,0,2313,[318 427  64 132 496],535,5,10730,4.636992221261885,80.0,0.0
2314,0,2314,[318 427  64 132 496],716,5,10735,4.637149028077753,80.0,0.0
2315,0,2315,[318 427  64 132 496],556,5,10740,4.637305699481865,80.0,0.0
2316,0,2316,[ 98 655 603  22 275],535,3,10743,4.636599050496331,20.0,20.0
2317,0,2317,[318 427  64 132 496],450,5,10748,4.636755823986195,80.0,0.0
2318,0,2318,[318 427  64 132 496],269,5,10753,4.636912462268219,80.0,0.0
2319,0,2319,[318 427  64 132 496],330,5,10758,4.6370689655172415,80.0,0.0
2320,0,2320,[318 427  64 132 496],18,5,10763,4.637225333907798,80.0,0.0
2321,0,2321,[318 427 132  64 496],796,5,10768,4.637381567614126,80.0,0.0
2322,0,2322,[318 427 132  64 496],236,4,10772,4.637107188979767,80.0,0.0
2323,0,2323,[318 427 132  64 496],330,5,10777,4.637263339070568,80.0,0.0
2324,0,2324,[318 427 132  64 496],716,5,10782,4.63741935483871,80.0,0.0
2325,0,2325,[318 427 132  64 496],236,4,10786,4.637145313843508,80.0,0.0
2326,0,2326,[318 427 132  64 496],716,5,10791,4.637301246239794,80.0,0.0
2327,0,2327,[318 427 132  64 496],556,5,10796,4.63745704467354,80.0,0.0
2328,0,2328,[318 427 132  64 496],535,5,10801,4.637612709317303,80.0,0.0
2329,0,2329,[ 69 286 333 173 265],796,4,10805,4.6373390557939915,0.0,20.0
2330,0,2330,[318 427 132  64 496],577,5,10810,4.637494637494638,80.0,0.0
2331,0,2331,[318 427 132  64 496],556,5,10815,4.637650085763293,80.0,0.0
2332,0,2332,[435 132 191 211 322],450,5,10820,4.637805400771539,0.0,0.0
2333,0,2333,[318 427 132  64 496],269,5,10825,4.63796058269066,80.0,0.0
2334,0,2334,[318 427 132  64 496],796,5,10830,4.638115631691649,80.0,0.0
2335,0,2335,[318 427 132  64 496],716,5,10835,4.638270547945205,80.0,0.0
2336,0,2336,[318 427 132  64 496],716,5,10840,4.638425331621737,80.0,0.0
2337,0,2337,[318 427 132  64 496],330,5,10845,4.63857998289136,80.0,0.0
2338,0,2338,[318 427 132  64 496],577,5,10850,4.638734501923899,80.0,0.0
2339,0,2339,[318 427 132  64 496],236,4,10854,4.638461538461539,80.0,0.0
2340,0,2340,[318 427 132  64 496],151,5,10859,4.638615976078599,80.0,0.0
2341,0,2341,[318 427 132  64 496],577,5,10864,4.638770281810419,80.0,0.0
2342,0,2342,[318 427 132  64 496],450,5,10869,4.638924455825864,80.0,0.0
2343,0,2343,[318 427 132  64 496],796,5,10874,4.639078498293515,80.0,0.0
2344,0,2344,[318 427 132  64 496],556,5,10879,4.6392324093816635,80.0,0.0
2345,0,2345,[318 427 132  64 496],556,5,10884,4.639386189258312,80.0,0.0
2346,0,2346,[318 427 132  64 496],716,5,10889,4.6395398380911805,80.0,0.0
2347,0,2347,[318 427 132  64 496],577,5,10894,4.6396933560477,80.0,0.0
2348,0,2348,[318 427 132  64 496],151,5,10899,4.639846743295019,80.0,0.0
2349,0,2349,[318 427 132  64 496],535,5,10904,4.64,80.0,0.0
2350,0,2350,[318 427 132  64 496],577,5,10909,4.6401531263292215,80.0,0.0
2351,0,2351,[318 427 132  64 496],330,5,10914,4.64030612244898,80.0,0.0
2352,0,2352,[318 427 132  64 496],556,5,10919,4.640458988525287,80.0,0.0
2353,0,2353,[318 237   8 210  96],269,1,10920,4.638912489379779,20.0,0.0
2354,0,2354,[318 427 132  64 496],577,5,10925,4.639065817409766,80.0,0.0
2355,0,2355,[318 427 132  64 496],556,5,10930,4.639219015280136,80.0,0.0
2356,0,2356,[318 427 132  64 496],577,5,10935,4.639372083156555,80.0,0.0
2357,0,2357,[318 427 132  64 496],450,5,10940,4.639525021204411,80.0,0.0
2358,0,2358,[318 427 132  64 496],535,5,10945,4.639677829588809,80.0,0.0
2359,0,2359,[318 427 132  64 496],716,5,10950,4.639830508474576,80.0,0.0
2360,0,2360,[318 427 132  64 496],330,5,10955,4.63998305802626,80.0,0.0
2361,0,2361,[318 427 132  64 496],236,4,10959,4.639712108382726,80.0,0.0
2362,0,2362,[318 427 132  64 496],556,5,10964,4.639864578925096,80.0,0.0
2363,0,2363,[423 125 234  98 210],577,3,10967,4.63917089678511,0.0,0.0
2364,0,2364,[318 427 132  64 496],535,5,10972,4.639323467230444,80.0,0.0
2365,0,2365,[318 427 132  64 496],330,5,10977,4.639475908706678,80.0,0.0
2366,0,2366,[318 427 132  64 496],577,5,10982,4.63962822137727,80.0,0.0
2367,0,2367,[318 427 132  64 496],151,5,10987,4.639780405405405,80.0,0.0
2368,0,2368,[318 427 132  64 496],151,5,10992,4.639932460953989,80.0,0.0
2369,0,2369,[318 427 132  64 496],269,5,10997,4.640084388185654,80.0,0.0
2370,0,2370,[174 515 173  88 238],716,5,11002,4.640236187262758,0.0,0.0
2371,0,2371,[318 427 132  64 496],716,5,11007,4.6403878583473865,80.0,0.0
2372,0,2372,[318 427 132  64 496],330,5,11012,4.640539401601348,80.0,0.0
2373,0,2373,[318 427 132  64 496],716,5,11017,4.640690817186184,80.0,0.0
2374,0,2374,[318 427 132  64 496],236,4,11021,4.640421052631579,80.0,0.0
2375,0,2375,[318 427 132  64 496],236,4,11025,4.640151515151516,80.0,0.0
2376,0,2376,[318 427 132  64 496],269,5,11030,4.640302902818679,80.0,0.0
2377,0,2377,[318 427 132  64 496],151,5,11035,4.640454163162321,80.0,0.0
2378,0,2378,[318 427 132  64 496],556,5,11040,4.640605296343002,80.0,0.0
2379,0,2379,[318 427 132  64 496],18,5,11045,4.640756302521009,80.0,0.0
2380,0,2380,[318 427 132  64 496],330,5,11050,4.640907181856363,80.0,0.0
2381,0,2381,[318 427 132  64 496],577,5,11055,4.641057934508816,80.0,0.0
2382,0,2382,[318 427 132  64 496],535,5,11060,4.6412085606378515,80.0,0.0
2383,0,2383,[318 427 132  64 496],535,5,11065,4.641359060402684,80.0,0.0
2384,0,2384,[318 427 132  64 496],796,5,11070,4.6415094339622645,80.0,0.0
2385,0,2385,[318 237 313  69 174],593,5,11075,4.641659681475272,20.0,0.0
2386,0,2386,[318 427 132  64 496],716,5,11080,4.641809803100125,80.0,0.0
2387,0,2387,[318 427 132  64 496],269,5,11085,4.641959798994975,80.0,0.0
2388,0,2388,[318 427 132  64 496],269,5,11090,4.642109669317706,80.0,0.0
2389,0,2389,[318 427 132  64 496],18,5,11095,4.642259414225942,80.0,0.0
2390,0,2390,[313 403 257  50 385],655,2,11097,4.641154328732748,0.0,20.0
2391,0,2391,[204 185 275 118 172],151,4,11101,4.640886287625418,0.0,20.0
2392,0,2392,[318 427 132  64 496],716,5,11106,4.6410363560384456,80.0,0.0
2393,0,2393,[318 427 132  64 496],151,5,11111,4.641186299081036,80.0,0.0
2394,0,2394,[423 183 176 194  50],503,5,11116,4.64133611691023,0.0,20.0
2395,0,2395,[318 427 132  64 496],535,5,11121,4.641485809682805,80.0,0.0
2396,0,2396,[318 427 132  64 496],535,5,11126,4.641635377555278,80.0,0.0
2397,0,2397,[318 427 132  64 496],330,5,11131,4.641784820683903,80.0,0.0
2398,0,2398,[318 427 132  64 496],535,5,11136,4.641934139224677,80.0,0.0
2399,0,2399,[318 427 132  64 496],330,5,11141,4.642083333333333,80.0,0.0
2400,0,2400,[318 427 132  64 496],18,5,11146,4.642232403165348,80.0,0.0
2401,0,2401,[318 427 132  64 496],236,4,11150,4.641965029142382,80.0,0.0
2402,0,2402,[318 427 132  64 496],330,5,11155,4.642114024136496,80.0,0.0
2403,0,2403,[318 427 132  64 496],535,5,11160,4.642262895174709,80.0,0.0
2404,0,2404,[318 427 132  64 496],577,5,11165,4.642411642411642,80.0,0.0
2405,0,2405,[318 427 132  64 496],716,5,11170,4.642560266001663,80.0,0.0
2406,0,2406,[318 427 132  64 496],716,5,11175,4.642708766098878,80.0,0.0
2407,0,2407,[318 427 132  64 496],18,5,11180,4.642857142857143,80.0,0.0
2408,0,2408,[318 427 132  64 496],535,5,11185,4.643005396430054,80.0,0.0
2409,0,2409,[318 427 132  64 496],330,5,11190,4.643153526970955,80.0,0.0
2410,0,2410,[318 427 132  64 496],269,5,11195,4.643301534632933,80.0,0.0
2411,0,2411,[318 427 132  64 496],556,5,11200,4.643449419568823,80.0,0.0
2412,0,2412,[318 427 132  64 496],330,5,11205,4.643597181931206,80.0,0.0
2413,0,2413,[318 427 132  64 496],796,5,11210,4.643744821872411,80.0,0.0
2414,0,2414,[318 427 132  64 496],796,5,11215,4.6438923395445135,80.0,0.0
2415,0,2415,[318 427 132  64 496],716,5,11220,4.644039735099338,80.0,0.0
2416,0,2416,[318 427 132  64 496],796,5,11225,4.644187008688457,80.0,0.0
2417,0,2417,[318 427 132  64 496],330,5,11230,4.644334160463193,80.0,0.0
2418,0,2418,[318 427 132  64 496],18,5,11235,4.644481190574617,80.0,0.0
2419,0,2419,[318 427 132  64 496],18,5,11240,4.644628099173554,80.0,0.0
2420,0,2420,[318 427 132  64 496],236,4,11244,4.644361833952912,80.0,0.0
2421,0,2421,[210 357  15  69 185],835,5,11249,4.644508670520231,0.0,0.0
2422,0,2422,[318 427 132  64 496],236,4,11253,4.644242674370615,80.0,0.0
2423,0,2423,[318 427 132  64 496],716,5,11258,4.644389438943894,80.0,0.0
2424,0,2424,[318 427 132  64 496],796,5,11263,4.644536082474227,80.0,0.0
2425,0,2425,[318 427 132  64 496],269,5,11268,4.644682605111294,80.0,0.0
2426,0,2426,[318 427 132  64 496],556,5,11273,4.644829007004533,80.0,0.0
2427,0,2427,[318 427 132  64 496],151,5,11278,4.64497528830313,80.0,0.0
2428,0,2428,[318 427 132  64 496],577,5,11283,4.645121449156031,80.0,0.0
2429,0,2429,[318 427 132  64 496],716,5,11288,4.645267489711935,80.0,0.0
2430,0,2430,[318 427 132  64 496],796,5,11293,4.645413410119293,80.0,0.0
2431,0,2431,[318 427 132  64 496],556,5,11298,4.645559210526316,80.0,0.0
2432,0,2432,[318 427 132  64 496],151,5,11303,4.64570489108097,80.0,0.0
2433,0,2433,[318 427 132  64 496],796,5,11308,4.645850451930978,80.0,0.0
2434,0,2434,[318 427 132  64 496],796,5,11313,4.6459958932238195,80.0,0.0
2435,0,2435,[318 427 132  64 496],236,4,11317,4.6457307060755335,80.0,0.0
2436,0,2436,[318 427 132  64 496],535,5,11322,4.645876077144029,80.0,0.0
2437,0,2437,[318 427 132  64 496],236,4,11326,4.645611156685808,80.0,0.0
2438,0,2438,[318 427 132  64 496],18,5,11331,4.645756457564576,80.0,0.0
2439,0,2439,[318 427 132  64 496],269,5,11336,4.645901639344262,80.0,0.0
2440,0,2440,[318 427 132  64 496],236,4,11340,4.645637034002458,80.0,0.0
2441,0,2441,[318 427 132  64 496],236,4,11344,4.645372645372645,80.0,0.0
2442,0,2442,[318 427 132  64 496],556,5,11349,4.645517805976259,80.0,0.0
2443,0,2443,[318 427 132  64 496],151,5,11354,4.645662847790508,80.0,0.0
2444,0,2444,[200  50 238 234 174],450,3,11357,4.644989775051124,0.0,20.0
2445,0,2445,[318 427 132  64 496],269,5,11362,4.645134914145544,80.0,0.0
2446,0,2446,[318 427 132  64 496],577,5,11367,4.6452799346138125,80.0,0.0
2447,0,2447,[318 427 132  64 496],716,5,11372,4.645424836601308,80.0,0.0
2448,0,2448,[182  82 210  15 313],796,3,11375,4.644752960391997,0.0,0.0
2449,0,2449,[318 427 132  64 496],716,5,11380,4.644897959183673,80.0,0.0
2450,0,2450,[318 427 132  64 496],269,5,11385,4.6450428396572825,80.0,0.0
2451,0,2451,[318 427 132  64 496],716,5,11390,4.645187601957586,80.0,0.0
2452,0,2452,[318 427 132  64 496],556,5,11395,4.645332246229107,80.0,0.0
2453,0,2453,[318 427 132  64 496],716,5,11400,4.645476772616137,80.0,0.0
2454,0,2454,[318 427 132  64 496],236,4,11404,4.645213849287169,80.0,0.0
2455,0,2455,[318 427 132  64 496],716,5,11409,4.645358306188925,80.0,0.0
2456,0,2456,[318 427 132  64 496],556,5,11414,4.645502645502646,80.0,0.0
2457,0,2457,[318 427 132  64 496],577,5,11419,4.645646867371847,80.0,0.0
2458,0,2458,[318 427 132  64 496],535,5,11424,4.645790971939813,80.0,0.0
2459,0,2459,[318 427 132  64 496],716,5,11429,4.645934959349593,80.0,0.0
2460,0,2460,[318 427 132  64 496],450,5,11434,4.646078829744006,80.0,0.0
2461,0,2461,[318 427 132  64 496],450,5,11439,4.646222583265637,80.0,0.0
2462,0,2462,[318 427 132  64 496],236,4,11443,4.6459602111246445,80.0,0.0
2463,0,2463,[318 427 132  64 496],18,5,11448,4.646103896103896,80.0,0.0
2464,0,2464,[318 427 132  64 496],151,5,11453,4.646247464503043,80.0,0.0
2465,0,2465,[318 427 132  64 496],450,5,11458,4.6463909164639094,80.0,0.0
2466,0,2466,[318 427 132  64 496],18,5,11463,4.646534252128091,80.0,0.0
2467,0,2467,[318 427 132  64 496],556,5,11468,4.646677471636953,80.0,0.0
2468,0,2468,[318 427 132  64 496],577,5,11473,4.646820575131632,80.0,0.0
2469,0,2469,[318 427 132  64 496],151,5,11478,4.646963562753037,80.0,0.0
2470,0,2470,[318 427 132  64 496],269,5,11483,4.647106434641845,80.0,0.0
2471,0,2471,[318 427 132  64 496],151,5,11488,4.647249190938512,80.0,0.0
2472,0,2472,[318 427 132  64 496],151,5,11493,4.647391831783259,80.0,0.0
2473,0,2473,[318 427 132  64 496],450,5,11498,4.647534357316087,80.0,0.0
2474,0,2474,[318 427 132  64 496],330,5,11503,4.647676767676768,80.0,0.0
2475,0,2475,[318 427 132  64 496],535,5,11508,4.647819063004847,80.0,0.0
2476,0,2476,[318 427 132  64 496],796,5,11513,4.647961243439645,80.0,0.0
2477,0,2477,[318 427 132  64 496],716,5,11518,4.648103309120258,80.0,0.0
2478,0,2478,[318 427 132  64 496],236,4,11522,4.647841871722469,80.0,0.0
2479,0,2479,[318 427 132  64 496],269,5,11527,4.647983870967742,80.0,0.0
2480,0,2480,[318 427 132  64 496],236,4,11531,4.647722692462716,80.0,0.0
2481,0,2481,[318 427 132  64 496],556,5,11536,4.647864625302176,80.0,0.0
2482,0,2482,[318 427 132  64 496],716,5,11541,4.6480064438179625,80.0,0.0
2483,0,2483,[318 427 132  64 496],269,5,11546,4.648148148148148,80.0,0.0
2484,0,2484,[318 427 132  64 496],450,5,11551,4.6482897384305835,80.0,0.0
2485,0,2485,[318 427 132  64 496],716,5,11556,4.648431214802896,80.0,0.0
2486,0,2486,[318 427 132  64 496],535,5,11561,4.648572577402493,80.0,0.0
2487,0,2487,[318 427 132  64 496],535,5,11566,4.648713826366559,80.0,0.0
2488,0,2488,[318 427 132  64 496],556,5,11571,4.648854961832061,80.0,0.0
2489,0,2489,[318 427 132  64 496],577,5,11576,4.648995983935743,80.0,0.0
2490,0,2490,[318 427 132  64 496],151,5,11581,4.649136892814131,80.0,0.0
2491,0,2491,[318 427 132  64 496],716,5,11586,4.649277688603531,80.0,0.0
2492,0,2492,[185 196 153  15 117],796,5,11591,4.649418371440032,0.0,0.0
2493,0,2493,[318 427 132  64 496],330,5,11596,4.649558941459503,80.0,0.0
2494,0,2494,[318 427 132  64 496],577,5,11601,4.649699398797595,80.0,0.0
2495,0,2495,[318 427 132  64 496],577,5,11606,4.649839743589744,80.0,0.0
2496,0,2496,[318 427 132  64 496],450,5,11611,4.649979975971165,80.0,0.0
2497,0,2497,[318 427 132  64 496],450,5,11616,4.650120096076861,80.0,0.0
2498,0,2498,[318 427 132  64 496],330,5,11621,4.6502601040416165,80.0,0.0
2499,0,2499,[318 427 132  64 496],535,5,11626,4.6504,80.0,0.0
2500,0,2500,[318 427 132  64 496],577,5,11631,4.650539784086366,80.0,0.0
2501,0,2501,[ 69 202 185 194 357],504,3,11634,4.649880095923262,0.0,0.0
2502,0,2502,[318 427 132  64 496],535,5,11639,4.650019976028766,80.0,0.0
2503,0,2503,[318 427 132  64 496],796,5,11644,4.6501597444089455,80.0,0.0
2504,0,2504,[318 427 132  64 496],556,5,11649,4.650299401197604,80.0,0.0
2505,0,2505,[318 427 132  64 496],269,5,11654,4.650438946528332,80.0,0.0
2506,0,2506,[318 427 132  64 496],330,5,11659,4.650578380534504,80.0,0.0
2507,0,2507,[318 427 132  64 496],269,5,11664,4.650717703349282,80.0,0.0
2508,0,2508,[318 427 132  64 496],18,5,11669,4.65085691510562,80.0,0.0
2509,0,2509,[318 427 132  64 496],716,5,11674,4.650996015936255,80.0,0.0
2510,0,2510,[318 427 132  64 496],796,5,11679,4.651135005973716,80.0,0.0
2511,0,2511,[318 427 132  64 496],716,5,11684,4.651273885350318,80.0,0.0
2512,0,2512,[318 427 132  64 496],556,5,11689,4.65141265419817,80.0,0.0
2513,0,2513,[318 427 132  64 496],716,5,11694,4.651551312649165,80.0,0.0
2514,0,2514,[318 427 132  64 496],716,5,11699,4.65168986083499,80.0,0.0
2515,0,2515,[318 427 132  64 496],716,5,11704,4.651828298887122,80.0,0.0
2516,0,2516,[318 427 132  64 496],236,4,11708,4.651569328565753,80.0,0.0
2517,0,2517,[318 427 132  64 496],450,5,11713,4.651707704527403,80.0,0.0
2518,0,2518,[222 181 405 211 234],655,0,11713,4.649861055974593,0.0,0.0
2519,0,2519,[318 427 132  64 496],577,5,11718,4.65,80.0,0.0
2520,0,2520,[176  98 423 174 318],236,3,11721,4.649345497818326,20.0,0.0
2521,0,2521,[318 427 132  64 496],796,5,11726,4.649484536082475,80.0,0.0
2522,0,2522,[318 427 132  64 496],18,5,11731,4.649623464130004,80.0,0.0
2523,0,2523,[318 427 132  64 496],151,5,11736,4.649762282091918,80.0,0.0
2524,0,2524,[318 427 132  64 496],330,5,11741,4.64990099009901,80.0,0.0
2525,0,2525,[318 427 132  64 496],577,5,11746,4.650039588281868,80.0,0.0
2526,0,2526,[318 427 132  64 496],151,5,11751,4.6501780767708745,80.0,0.0
2527,0,2527,[318 427 132  64 496],716,5,11756,4.650316455696203,80.0,0.0
2528,0,2528,[318 427 132  64 496],556,5,11761,4.650454725187822,80.0,0.0
2529,0,2529,[318 427 132  64 496],236,4,11765,4.650197628458498,80.0,0.0
2530,0,2530,[318 427 132  64 496],796,5,11770,4.650335835638088,80.0,0.0
2531,0,2531,[318 427 132  64 496],269,5,11775,4.650473933649289,80.0,0.0
2532,0,2532,[191 222 197 210 144],796,3,11778,4.649822345045401,0.0,0.0
2533,0,2533,[318 427 132  64 496],716,5,11783,4.649960536700868,80.0,0.0
2534,0,2534,[318 427 132  64 496],236,4,11787,4.649704142011834,80.0,0.0
2535,0,2535,[318 427 132  64 496],151,5,11792,4.649842271293376,80.0,0.0
2536,0,2536,[318 427 132  64 496],577,5,11797,4.64998029168309,80.0,0.0
2537,0,2537,[318 427 132  64 496],330,5,11802,4.650118203309693,80.0,0.0
2538,0,2538,[318 427 132  64 496],577,5,11807,4.650256006301694,80.0,0.0
2539,0,2539,[318 427 132  64 496],151,5,11812,4.650393700787402,80.0,0.0
2540,0,2540,[318 427 132  64 496],330,5,11817,4.650531286894923,80.0,0.0
2541,0,2541,[318 427 132  64 496],556,5,11822,4.650668764752163,80.0,0.0
2542,0,2542,[318 427 132  64 496],556,5,11827,4.650806134486826,80.0,0.0
2543,0,2543,[318 427 132  64 496],269,5,11832,4.650943396226415,80.0,0.0
2544,0,2544,[318 427 132  64 496],151,5,11837,4.651080550098232,80.0,0.0
2545,0,2545,[318 427 132  64 496],269,5,11842,4.65121759622938,80.0,0.0
2546,0,2546,[318 427 132  64 496],330,5,11847,4.651354534746761,80.0,0.0
2547,0,2547,[318 427 132  64 496],535,5,11852,4.65149136577708,80.0,0.0
2548,0,2548,[318 427 132  64 496],796,5,11857,4.651628089446842,80.0,0.0
2549,0,2549,[318 427 132  64 496],269,5,11862,4.651764705882353,80.0,0.0
2550,0,2550,[318 427 132  64 496],269,5,11867,4.651901215209722,80.0,0.0
2551,0,2551,[318 427 132  64 496],796,5,11872,4.652037617554859,80.0,0.0
2552,0,2552,[318 427 132  64 496],796,5,11877,4.6521739130434785,80.0,0.0
2553,0,2553,[318 427 132  64 496],236,4,11881,4.651918559122945,80.0,0.0
2554,0,2554,[318 427 132  64 496],269,5,11886,4.652054794520548,80.0,0.0
2555,0,2555,[318 427 132  64 496],236,4,11890,4.651799687010954,80.0,0.0
2556,0,2556,[318 427 132  64 496],18,5,11895,4.651935862338678,80.0,0.0
2557,0,2557,[318 427 132  64 496],330,5,11900,4.6520719311962475,80.0,0.0
2558,0,2558,[318 427 132  64 496],151,5,11905,4.65220789370848,80.0,0.0
2559,0,2559,[318 427 132  64 496],269,5,11910,4.65234375,80.0,0.0
2560,0,2560,[318 427 132  64 496],151,5,11915,4.652479500195236,80.0,0.0
2561,0,2561,[318 427 132  64 496],577,5,11920,4.652615144418423,80.0,0.0
2562,0,2562,[318 427 132  64 496],556,5,11925,4.652750682793601,80.0,0.0
2563,0,2563,[318 427 132  64 496],269,5,11930,4.652886115444618,80.0,0.0
2564,0,2564,[318 427 132  64 496],716,5,11935,4.653021442495127,80.0,0.0
2565,0,2565,[318 427 132  64 496],577,5,11940,4.6531566640685895,80.0,0.0
2566,0,2566,[318 427 132  64 496],450,5,11945,4.653291780288274,80.0,0.0
2567,0,2567,[318 427 132  64 496],236,4,11949,4.65303738317757,80.0,0.0
2568,0,2568,[318 427 132  64 496],535,5,11954,4.6531724406383805,80.0,0.0
2569,0,2569,[318 427 132  64 496],796,5,11959,4.653307392996109,80.0,0.0
2570,0,2570,[185 127 423 235 228],716,4,11963,4.653053286658888,0.0,20.0
2571,0,2571,[318 427 132  64 496],330,5,11968,4.653188180404355,80.0,0.0
2572,0,2572,[318 427 132  64 496],236,4,11972,4.652934317916829,80.0,0.0
2573,0,2573,[318 427 132  64 496],450,5,11977,4.653069153069153,80.0,0.0
2574,0,2574,[153  15 143 111 427],269,1,11978,4.651650485436893,20.0,0.0
2575,0,2575,[318 427 132  64 496],796,5,11983,4.651785714285714,80.0,0.0
2576,0,2576,[127 322 234 471   4],450,3,11986,4.651144741948001,0.0,20.0
2577,0,2577,[318 427 132  64 496],535,5,11991,4.651280062063615,80.0,0.0
2578,0,2578,[318 427 132  64 496],716,5,11996,4.65141527723924,80.0,0.0
2579,0,2579,[318 427 132  64 496],450,5,12001,4.651550387596899,80.0,0.0
2580,0,2580,[318 427 132  64 496],269,5,12006,4.651685393258427,80.0,0.0
2581,0,2581,[318 427 132  64 496],716,5,12011,4.651820294345469,80.0,0.0
2582,0,2582,[ 25 471   1  98  79],457,5,12016,4.651955090979481,0.0,0.0
2583,0,2583,[318 427 132  64 496],151,5,12021,4.652089783281734,80.0,0.0
2584,0,2584,[172  96  22 210 357],296,4,12025,4.6518375241779495,0.0,0.0
2585,0,2585,[318 427 132  64 496],796,5,12030,4.651972157772621,80.0,0.0
2586,0,2586,[318 427 132  64 496],236,4,12034,4.651720139157325,80.0,0.0
2587,0,2587,[318 427 132  64 496],577,5,12039,4.651854714064915,80.0,0.0
2588,0,2588,[318 427 132  64 496],796,5,12044,4.651989185013519,80.0,0.0
2589,0,2589,[318 427 132  64 496],796,5,12049,4.652123552123552,80.0,0.0
2590,0,2590,[318 427 132  64 496],269,5,12054,4.652257815515245,80.0,0.0
2591,0,2591,[318 427 132  64 496],450,5,12059,4.652391975308642,80.0,0.0
2592,0,2592,[318 427 132  64 496],151,5,12064,4.652526031623602,80.0,0.0
2593,0,2593,[318 427 132  64 496],151,5,12069,4.6526599845798,80.0,0.0
2594,0,2594,[318 427 132  64 496],18,5,12074,4.652793834296724,80.0,0.0
2595,0,2595,[318 427 132  64 496],535,5,12079,4.6529275808936825,80.0,0.0
2596,0,2596,[318 427 132  64 496],535,5,12084,4.653061224489796,80.0,0.0
2597,0,2597,[318 427 132  64 496],796,5,12089,4.653194765204003,80.0,0.0
2598,0,2598,[318 427 132  64 496],556,5,12094,4.65332820315506,80.0,0.0
2599,0,2599,[318 427 132  64 496],535,5,12099,4.6534615384615385,80.0,0.0
2600,0,2600,[100 588 121 172   1],786,4,12103,4.653210303729335,0.0,20.0
2601,0,2601,[318 427 132  64 496],330,5,12108,4.653343581860107,80.0,0.0
2602,0,2602,[318 427 132  64 496],577,5,12113,4.653476757587399,80.0,0.0
2603,0,2603,[318 427 132  64 496],151,5,12118,4.653609831029186,80.0,0.0
2604,0,2604,[318 427 132  64 496],269,5,12123,4.653742802303263,80.0,0.0
2605,0,2605,[318 427 132  64 496],269,5,12128,4.653875671527245,80.0,0.0
2606,0,2606,[318 427 132  64 496],716,5,12133,4.654008438818566,80.0,0.0
2607,0,2607,[318 427 132  64 496],716,5,12138,4.654141104294479,80.0,0.0
2608,0,2608,[318 427 132  64 496],450,5,12143,4.654273668072058,80.0,0.0
2609,0,2609,[318 427 132  64 496],450,5,12148,4.6544061302682,80.0,0.0
2610,0,2610,[318 427 132  64 496],577,5,12153,4.654538490999617,80.0,0.0
2611,0,2611,[183  82 168 546 228],151,2,12155,4.653522205206738,0.0,0.0
2612,0,2612,[318 427 132  64 496],535,5,12160,4.653654802908534,80.0,0.0
2613,0,2613,[318 427 132  64 496],450,5,12165,4.6537872991583775,80.0,0.0
2614,0,2614,[318 427 132  64 496],151,5,12170,4.653919694072658,80.0,0.0
2615,0,2615,[318 427 132  64 496],450,5,12175,4.654051987767584,80.0,0.0
2616,0,2616,[ 97 144 127 174 111],796,4,12179,4.65380206343141,0.0,20.0
2617,0,2617,[318 427 132  64 496],716,5,12184,4.653934300993124,80.0,0.0
2618,0,2618,[318 427 132  64 496],330,5,12189,4.6540664375715926,80.0,0.0
2619,0,2619,[318 427 132  64 496],236,4,12193,4.65381679389313,80.0,0.0
2620,0,2620,[318 427 132  64 496],18,5,12198,4.653948874475391,80.0,0.0
2621,0,2621,[318 427 132  64 496],796,5,12203,4.654080854309687,80.0,0.0
2622,0,2622,[318 427 132  64 496],450,5,12208,4.654212733511247,80.0,0.0
2623,0,2623,[318 427 132  64 496],151,5,12213,4.654344512195122,80.0,0.0
2624,0,2624,[318 427 132  64 496],577,5,12218,4.65447619047619,80.0,0.0
2625,0,2625,[318 427 132  64 496],269,5,12223,4.6546077684691545,80.0,0.0
2626,0,2626,[318 427 132  64 496],236,4,12227,4.654358583936049,80.0,0.0
2627,0,2627,[318 427 132  64 496],236,4,12231,4.654109589041096,80.0,0.0
2628,0,2628,[318 427 132  64 588],716,5,12236,4.654241156333207,60.0,0.0
2629,0,2629,[318 427 132  64 588],450,5,12241,4.654372623574145,60.0,0.0
2630,0,2630,[318 427 132  64 588],716,5,12246,4.654503990877993,60.0,0.0
2631,0,2631,[318 427 132  64 588],450,5,12251,4.654635258358662,60.0,0.0
2632,0,2632,[318 427 132  64 588],18,5,12256,4.65476642612989,60.0,0.0
2633,0,2633,[302 265 200 204 301],151,3,12259,4.6541381928625665,0.0,0.0
2634,0,2634,[318 427 132  64 588],577,5,12264,4.65426944971537,60.0,0.0
2635,0,2635,[318 427 132  64 588],316,4,12268,4.65402124430956,60.0,0.0
2636,0,2636,[483  50 180  98 153],18,5,12273,4.654152445961319,0.0,20.0
2637,0,2637,[318 427 132  64  98],716,5,12278,4.654283548142533,60.0,0.0
2638,0,2638,[318 427 132  64  98],577,5,12283,4.654414550966275,60.0,0.0
2639,0,2639,[318 427 132  64  98],693,4,12287,4.654166666666667,60.0,0.0
2640,0,2640,[318 427 132  64  98],151,5,12292,4.654297614539947,60.0,0.0
2641,0,2641,[318 427 132  64  98],693,4,12296,4.6540499621498865,60.0,0.0
2642,0,2642,[318 427 132  64  98],330,5,12301,4.6541808550889145,60.0,0.0
2643,0,2643,[318 427 132  64  98],693,4,12305,4.653933434190621,60.0,0.0
2644,0,2644,[318 427 132  64  98],535,4,12309,4.653686200378072,60.0,0.0
2645,0,2645,[318 427 132  64 496],556,5,12314,4.653817082388511,80.0,0.0
2646,0,2646,[318 427 132  64 496],577,5,12319,4.653947865508123,80.0,0.0
2647,0,2647,[318 427 132  64 496],556,5,12324,4.6540785498489425,80.0,0.0
2648,0,2648,[318 427 132  64 496],269,5,12329,4.654209135522839,80.0,0.0
2649,0,2649,[302 275 172 175 228],655,3,12332,4.653584905660377,0.0,20.0
2650,0,2650,[318 427 132  64 496],18,5,12337,4.653715579026782,80.0,0.0
2651,0,2651,[318 427 132  64 496],450,5,12342,4.653846153846154,80.0,0.0
2652,0,2652,[318 427 132  64 496],151,5,12347,4.653976630229929,80.0,0.0
2653,0,2653,[318 427 132  64 496],450,5,12352,4.654107008289374,80.0,0.0
2654,0,2654,[318 427 132  64 496],18,5,12357,4.654237288135593,80.0,0.0
2655,0,2655,[318 427 132  64 496],18,5,12362,4.654367469879518,80.0,0.0
2656,0,2656,[318 427 132  64 496],330,5,12367,4.6544975536319155,80.0,0.0
2657,0,2657,[318 427 132  64 496],236,4,12371,4.654251316779534,80.0,0.0
2658,0,2658,[318 427 132  64 496],556,5,12376,4.654381346370816,80.0,0.0
2659,0,2659,[318 427 132  64 496],450,5,12381,4.654511278195489,80.0,0.0
2660,0,2660,[318 427 132  64 496],330,5,12386,4.654641112363773,80.0,0.0
2661,0,2661,[318 427 132  64 496],18,5,12391,4.654770848985725,80.0,0.0
2662,0,2662,[318 427 132  64 496],450,5,12396,4.6549004881712355,80.0,0.0
2663,0,2663,[318 427 132  64 496],450,5,12401,4.65503003003003,80.0,0.0
2664,0,2664,[318 427 132  64 496],450,5,12406,4.655159474671669,80.0,0.0
2665,0,2665,[318 427 132  64 496],535,5,12411,4.655288822205551,80.0,0.0
2666,0,2666,[318 427 132  64 496],269,5,12416,4.655418072740908,80.0,0.0
2667,0,2667,[318 427 132  64 496],151,5,12421,4.6555472263868065,80.0,0.0
2668,0,2668,[318 427 132  64 496],716,5,12426,4.655676283252155,80.0,0.0
2669,0,2669,[318 427 132  64 496],236,4,12430,4.655430711610487,80.0,0.0
2670,0,2670,[318 427 132  64 496],796,5,12435,4.655559715462374,80.0,0.0
2671,0,2671,[318 427 132  64 496],18,5,12440,4.655688622754491,80.0,0.0
2672,0,2672,[318 427 132  64 496],577,5,12445,4.655817433595211,80.0,0.0
2673,0,2673,[318 427 132  64 496],535,5,12450,4.655946148092745,80.0,0.0
2674,0,2674,[318 427 132  64 496],151,5,12455,4.6560747663551405,80.0,0.0
2675,0,2675,[318 427 132  64 496],535,5,12460,4.656203288490284,80.0,0.0
2676,0,2676,[318 427 132  64 496],796,5,12465,4.656331714605902,80.0,0.0
2677,0,2677,[318 427 132  64 496],577,5,12470,4.65646004480956,80.0,0.0
2678,0,2678,[ 71 195 127  70 191],450,4,12474,4.656215005599104,0.0,20.0
2679,0,2679,[318 427 132  64 496],556,5,12479,4.65634328358209,80.0,0.0
2680,0,2680,[318 427 132  64 496],18,5,12484,4.656471465870943,80.0,0.0
2681,0,2681,[318 427 132  64 496],151,5,12489,4.656599552572707,80.0,0.0
2682,0,2682,[318 427 132  64 496],151,5,12494,4.65672754379426,80.0,0.0
2683,0,2683,[318 427 132  64 496],556,5,12499,4.6568554396423245,80.0,0.0
2684,0,2684,[318 427 132  64 496],796,5,12504,4.656983240223464,80.0,0.0
2685,0,2685,[318 427 132  64 496],535,5,12509,4.657110945644081,80.0,0.0
2686,0,2686,[318 427 132  64 496],236,4,12513,4.656866393747674,80.0,0.0
2687,0,2687,[318 427 132  64 496],269,5,12518,4.6569940476190474,80.0,0.0
2688,0,2688,[318 427 132  64 496],577,5,12523,4.657121606545184,80.0,0.0
2689,0,2689,[318 427 132  64 496],330,5,12528,4.657249070631971,80.0,0.0
2690,0,2690,[318 427 132  64 496],450,5,12533,4.657376439985136,80.0,0.0
2691,0,2691,[318 427 132  64 496],556,5,12538,4.657503714710253,80.0,0.0
2692,0,2692,[318 427 132  64 496],535,5,12543,4.657630894912737,80.0,0.0
2693,0,2693,[318 427 132  64 496],151,5,12548,4.657757980697847,80.0,0.0
2694,0,2694,[318 427 132  64 496],330,5,12553,4.657884972170686,80.0,0.0
2695,0,2695,[228 179 234 204 235],450,3,12556,4.65727002967359,0.0,0.0
2696,0,2696,[318 427 132  64 496],535,5,12561,4.657397107897664,80.0,0.0
2697,0,2697,[318 427 132  64 496],577,5,12566,4.6575240919199405,80.0,0.0
2698,0,2698,[357 210  70 216 144],716,4,12570,4.657280474249722,0.0,0.0
2699,0,2699,[318 427 132  64 496],716,5,12575,4.657407407407407,80.0,0.0
2700,0,2700,[118 151 197 161 173],457,5,12580,4.657534246575342,0.0,0.0
2701,0,2701,[318 427 132  64 496],796,5,12585,4.657660991857883,80.0,0.0
2702,0,2702,[318 427 132  64 496],151,5,12590,4.657787643359231,80.0,0.0
2703,0,2703,[204 546 183 210 180],280,2,12592,4.65680473372781,0.0,0.0
2704,0,2704,[318 427 132  64 496],535,5,12597,4.656931608133087,80.0,0.0
2705,0,2705,[318 427 132  64 496],556,5,12602,4.657058388765706,80.0,0.0
2706,0,2706,[318 427 132  64 496],18,5,12607,4.65718507572959,80.0,0.0
2707,0,2707,[318 427 132  64 496],330,5,12612,4.657311669128508,80.0,0.0
2708,0,2708,[111 181 275  11 191],296,4,12616,4.657069029162052,0.0,20.0
2709,0,2709,[318 427 132  64 496],269,5,12621,4.65719557195572,80.0,0.0
2710,0,2710,[318 427 132  64 496],151,5,12626,4.65732202139432,80.0,0.0
2711,0,2711,[318 427 132  64 496],796,5,12631,4.657448377581121,80.0,0.0
2712,0,2712,[318 427 132  64 496],330,5,12636,4.657574640619241,80.0,0.0
2713,0,2713,[318 427 132  64 496],18,5,12641,4.657700810611644,80.0,0.0
2714,0,2714,[318 427 132  64 496],716,5,12646,4.657826887661142,80.0,0.0
2715,0,2715,[318 427 132  64 496],151,5,12651,4.657952871870398,80.0,0.0
2716,0,2716,[318 427 132  64 496],556,5,12656,4.658078763341921,80.0,0.0
2717,0,2717,[318 427 132  64 496],236,4,12660,4.657836644591612,80.0,0.0
2718,0,2718,[125 483 385 143  88],655,2,12662,4.656859139389481,0.0,0.0
2719,0,2719,[318 427 132  64 496],577,5,12667,4.656985294117647,80.0,0.0
2720,0,2720,[318 427 132  64 496],796,5,12672,4.657111356119074,80.0,0.0
2721,0,2721,[318 427 132  64 496],556,5,12677,4.6572373254959585,80.0,0.0
2722,0,2722,[318 427 132  64 496],330,5,12682,4.657363202350349,80.0,0.0
2723,0,2723,[318 427 132  64 496],450,5,12687,4.657488986784141,80.0,0.0
2724,0,2724,[318 427 132  64 496],330,5,12692,4.657614678899082,80.0,0.0
2725,0,2725,[318 427 132  64 496],330,5,12697,4.657740278796772,80.0,0.0
2726,0,2726,[318 427 132  64 496],716,5,12702,4.6578657865786575,80.0,0.0
2727,0,2727,[318 427 132  64 496],556,5,12707,4.657991202346041,80.0,0.0
2728,0,2728,[318 427 132  64 496],18,5,12712,4.658116526200073,80.0,0.0
2729,0,2729,[318 427 132  64 496],236,4,12716,4.657875457875458,80.0,0.0
2730,0,2730,[318 427 132  64 496],716,5,12721,4.658000732332479,80.0,0.0
2731,0,2731,[318 427 132  64 496],535,5,12726,4.658125915080527,80.0,0.0
2732,0,2732,[216 588 185 302 144],401,3,12729,4.657519209659714,0.0,0.0
2733,0,2733,[427 318 132  64 496],269,5,12734,4.65764447695684,80.0,0.0
2734,0,2734,[427 318 132  64 496],18,5,12739,4.657769652650822,80.0,0.0
2735,0,2735,[427 318 132  64 496],796,5,12744,4.657894736842105,80.0,0.0
2736,0,2736,[427 318 132  64 496],716,5,12749,4.658019729630983,80.0,0.0
2737,0,2737,[427 318 132  64 496],535,5,12754,4.6581446311176045,80.0,0.0
2738,0,2738,[427 318 132  64 496],556,5,12759,4.658269441401972,80.0,0.0
2739,0,2739,[427 318 132  64 496],236,4,12763,4.658029197080292,80.0,0.0
2740,0,2740,[302   7 186 211 153],535,4,12767,4.657789128055454,0.0,0.0
2741,0,2741,[427 318 132  64 496],18,5,12772,4.657913931436908,80.0,0.0
2742,0,2742,[427 318 132  64 496],18,5,12777,4.6580386438206345,80.0,0.0
2743,0,2743,[427 318 132  64 496],450,5,12782,4.658163265306122,80.0,0.0
2744,0,2744,[427 318 132  64 496],269,5,12787,4.658287795992714,80.0,0.0
2745,0,2745,[161 182  28 144 202],796,4,12791,4.658048069919883,0.0,0.0
2746,0,2746,[427 318 132  64 496],450,5,12796,4.658172551874772,80.0,0.0
2747,0,2747,[427 318 132  64 496],450,5,12801,4.658296943231441,80.0,0.0
2748,0,2748,[427 318 132  64 496],269,5,12806,4.65842124408876,80.0,0.0
2749,0,2749,[427 318 132  64 496],236,4,12810,4.658181818181818,80.0,0.0
2750,0,2750,[427 318 132  64 496],151,5,12815,4.658306070519811,80.0,0.0
2751,0,2751,[427 318 132  64 496],18,5,12820,4.65843023255814,80.0,0.0
2752,0,2752,[294  95  50 117 183],577,5,12825,4.658554304395206,0.0,20.0
2753,0,2753,[427 318 132  64 496],577,5,12830,4.658678286129266,80.0,0.0
2754,0,2754,[427 318 132  64 496],577,5,12835,4.65880217785844,80.0,0.0
2755,0,2755,[427 318 132  64 496],151,5,12840,4.6589259796806965,80.0,0.0
2756,0,2756,[427 318 132  64 496],796,5,12845,4.65904969169387,80.0,0.0
2757,0,2757,[427 318 132  64 496],330,5,12850,4.659173313995649,80.0,0.0
2758,0,2758,[183 153 168 100  82],269,2,12852,4.6582094961942735,0.0,20.0
2759,0,2759,[427 318 132  64 496],556,5,12857,4.658333333333333,80.0,0.0
2760,0,2760,[427 318 132  64 496],796,5,12862,4.658457080767838,80.0,0.0
2761,0,2761,[168 294 185 153 546],504,3,12865,4.657856625633599,0.0,0.0
2762,0,2762,[427 318 132  64 496],716,5,12870,4.657980456026059,80.0,0.0
2763,0,2763,[427 318 132  64 496],236,4,12874,4.657742402315485,80.0,0.0
2764,0,2764,[427 318 132  64 496],450,5,12879,4.657866184448463,80.0,0.0
2765,0,2765,[427 318 132  64 496],18,5,12884,4.657989877078814,80.0,0.0
2766,0,2766,[427 318 132  64 496],716,5,12889,4.6581134803035775,80.0,0.0
2767,0,2767,[427 318 132  64 496],269,5,12894,4.658236994219653,80.0,0.0
2768,0,2768,[427 318 132  64 496],796,5,12899,4.658360418923799,80.0,0.0
2769,0,2769,[427 318 132  64 496],450,5,12904,4.658483754512635,80.0,0.0
2770,0,2770,[427 318 132  64 496],535,5,12909,4.6586070010826415,80.0,0.0
2771,0,2771,[427 318 132  64 496],18,5,12914,4.658730158730159,80.0,0.0
2772,0,2772,[427 318 132  64 496],796,5,12919,4.658853227551388,80.0,0.0
2773,0,2773,[427 318 132  64 496],716,5,12924,4.658976207642394,80.0,0.0
2774,0,2774,[427 318 132  64 496],556,5,12929,4.659099099099099,80.0,0.0
2775,0,2775,[427 318 132  64 496],796,5,12934,4.659221902017291,80.0,0.0
2776,0,2776,[427 318 132  64 496],716,5,12939,4.659344616492618,80.0,0.0
2777,0,2777,[427 318 132  64 496],577,5,12944,4.6594672426205905,80.0,0.0
2778,0,2778,[427 318 132  64 496],18,5,12949,4.659589780496582,80.0,0.0
2779,0,2779,[427 318 132  64 496],716,5,12954,4.659712230215828,80.0,0.0
2780,0,2780,[427 318 132  64 496],577,5,12959,4.659834591873427,80.0,0.0
2781,0,2781,[385 210 313 568 135],655,2,12961,4.658878504672897,0.0,0.0
2782,0,2782,[427 318 132  64 496],450,5,12966,4.65900107797341,80.0,0.0
2783,0,2783,[427 318 132  64 496],556,5,12971,4.659123563218391,80.0,0.0
2784,0,2784,[427 318 132  64 496],236,4,12975,4.658886894075404,80.0,0.0
2785,0,2785,[427 318 132  64 496],577,5,12980,4.659009332376167,80.0,0.0
2786,0,2786,[427 318 132  64 496],535,5,12985,4.659131682813061,80.0,0.0
2787,0,2787,[427 318 132  64 496],269,5,12990,4.659253945480631,80.0,0.0
2788,0,2788,[427 318 132  64 496],450,5,12995,4.659376120473288,80.0,0.0
2789,0,2789,[427 318 132  64 496],151,5,13000,4.659498207885305,80.0,0.0
2790,0,2790,[427 318 132  64 496],556,5,13005,4.65962020781082,80.0,0.0
2791,0,2791,[427 318 132  64 496],716,5,13010,4.659742120343839,80.0,0.0
2792,0,2792,[427 318 132  64 496],330,5,13015,4.659863945578231,80.0,0.0
2793,0,2793,[427 318 132  64 496],450,5,13020,4.659985683607731,80.0,0.0
2794,0,2794,[427 318 132  64 496],18,5,13025,4.660107334525939,80.0,0.0
2795,0,2795,[427 318 132  64 496],330,5,13030,4.660228898426324,80.0,0.0
2796,0,2796,[427 318 132  64 496],716,5,13035,4.660350375402217,80.0,0.0
2797,0,2797,[427 318 132  64 496],18,5,13040,4.660471765546819,80.0,0.0
2798,0,2798,[427 318 132  64 496],18,5,13045,4.660593068953197,80.0,0.0
2799,0,2799,[427 318 132  64 496],269,5,13050,4.660714285714286,80.0,0.0
2800,0,2800,[427 318 132  64 496],535,5,13055,4.660835415922885,80.0,0.0
2801,0,2801,[427 318 132  64 496],151,5,13060,4.660956459671663,80.0,0.0
2802,0,2802,[ 12 318 427 143 196],796,5,13065,4.661077417053157,40.0,0.0
2803,0,2803,[427 318 132  64 496],556,5,13070,4.661198288159771,80.0,0.0
2804,0,2804,[427 318 132  64 496],236,4,13074,4.66096256684492,80.0,0.0
2805,0,2805,[427 318 132  64 496],151,5,13079,4.661083392729864,80.0,0.0
2806,0,2806,[427 318 132  64 496],330,5,13084,4.661204132525828,80.0,0.0
2807,0,2807,[427 318 132  64 496],716,5,13089,4.661324786324786,80.0,0.0
2808,0,2808,[427 318 132  64 496],716,5,13094,4.661445354218583,80.0,0.0
2809,0,2809,[427 318 132  64 496],236,4,13098,4.661209964412811,80.0,0.0
2810,0,2810,[427 318 132  64 496],151,5,13103,4.661330487371043,80.0,0.0
2811,0,2811,[427 318 132  64 496],236,4,13107,4.661095305832148,80.0,0.0
2812,0,2812,[427 318 132  64  98],655,4,13111,4.660860291503733,60.0,0.0
2813,0,2813,[427 318 132  64  98],796,5,13116,4.660980810234541,60.0,0.0
2814,0,2814,[427 318 132  64  98],577,5,13121,4.661101243339254,60.0,0.0
2815,0,2815,[427 318 132  64  98],796,5,13126,4.661221590909091,60.0,0.0
2816,0,2816,[427 318 132  64  98],655,4,13130,4.660986865459709,60.0,0.0
2817,0,2817,[427 318 132  64  98],316,5,13135,4.6611071682044,60.0,0.0
2818,0,2818,[427 318 132  64  98],450,5,13140,4.66122738559773,60.0,0.0
2819,0,2819,[427 318 132  64  98],535,4,13144,4.660992907801418,60.0,0.0
2820,0,2820,[405 483   9 546 215],457,4,13148,4.660758596242467,0.0,0.0
2821,0,2821,[427 318 132  64 496],330,5,13153,4.660878809355068,80.0,0.0
2822,0,2822,[427 318 132  64 496],18,5,13158,4.660998937300744,80.0,0.0
2823,0,2823,[427 318 132  64 496],269,5,13163,4.661118980169972,80.0,0.0
2824,0,2824,[183   1  69   7 237],457,5,13168,4.661238938053097,0.0,0.0
2825,0,2825,[427 318 132  64 496],269,5,13173,4.66135881104034,80.0,0.0
2826,0,2826,[427 318 132  64 496],18,5,13178,4.66147859922179,80.0,0.0
2827,0,2827,[427 318 132  64 496],556,5,13183,4.661598302687412,80.0,0.0
2828,0,2828,[427 318 132  64 496],556,5,13188,4.661717921527042,80.0,0.0
2829,0,2829,[427 318 132  64 496],269,5,13193,4.661837455830389,80.0,0.0
2830,0,2830,[427 318 132  64 496],330,5,13198,4.6619569056870365,80.0,0.0
2831,0,2831,[427 318 132  64 496],151,5,13203,4.66207627118644,80.0,0.0
2832,0,2832,[427 318 132  64 496],535,5,13208,4.6621955524179315,80.0,0.0
2833,0,2833,[427 318 132  64 496],151,5,13213,4.6623147494707124,80.0,0.0
2834,0,2834,[427 318 132  64 496],151,5,13218,4.662433862433862,80.0,0.0
2835,0,2835,[427 318 132  64 496],269,5,13223,4.6625528913963326,80.0,0.0
2836,0,2836,[427 318 132  64 496],450,5,13228,4.662671836446951,80.0,0.0
2837,0,2837,[427 318 132  64 496],796,5,13233,4.662790697674419,80.0,0.0
2838,0,2838,[427 318 132  64 496],269,5,13238,4.662909475167313,80.0,0.0
2839,0,2839,[427 318 132  64 496],796,5,13243,4.663028169014084,80.0,0.0
2840,0,2840,[427 318 132  64 496],18,5,13248,4.663146779303062,80.0,0.0
2841,0,2841,[427 318 132  64 496],450,5,13253,4.663265306122449,80.0,0.0
2842,0,2842,[427 318 132  64 496],18,5,13258,4.663383749560324,80.0,0.0
2843,0,2843,[427 318 132  64 496],151,5,13263,4.663502109704641,80.0,0.0
2844,0,2844,[427 318 132  64 496],556,5,13268,4.663620386643234,80.0,0.0
2845,0,2845,[427 318 132  64 496],330,5,13273,4.663738580463809,80.0,0.0
2846,0,2846,[427 318 132  64 496],577,5,13278,4.663856691253952,80.0,0.0
2847,0,2847,[427 318 132  64 496],716,5,13283,4.663974719101123,80.0,0.0
2848,0,2848,[196 179 273 318 313],655,4,13287,4.663741663741663,20.0,0.0
2849,0,2849,[427 318 132  64 496],716,5,13292,4.663859649122807,80.0,0.0
2850,0,2850,[427 318 132  64 496],236,4,13296,4.663626797614872,80.0,0.0
2851,0,2851,[427 318 132  64 496],18,5,13301,4.66374474053296,80.0,0.0
2852,0,2852,[427 318 132  64 496],18,5,13306,4.663862600771118,80.0,0.0
2853,0,2853,[153 127 202  88 302],655,2,13308,4.662929222144359,0.0,20.0
2854,0,2854,[427 318 132  64 496],236,4,13312,4.662697022767075,80.0,0.0
2855,0,2855,[427 318 132  64 496],269,5,13317,4.66281512605042,80.0,0.0
2856,0,2856,[427 318 132  64 496],330,5,13322,4.662933146657333,80.0,0.0
2857,0,2857,[238 153 328 385  71],450,4,13326,4.662701189643107,0.0,0.0
2858,0,2858,[427 318 132  64 496],450,5,13331,4.662819167541098,80.0,0.0
2859,0,2859,[427 318 132  64 496],716,5,13336,4.662937062937063,80.0,0.0
2860,0,2860,[427 318 132  64 496],236,4,13340,4.662705347780497,80.0,0.0
2861,0,2861,[427 318 132  64 496],577,5,13345,4.66282320055905,80.0,0.0
2862,0,2862,[427 318 132  64 496],269,5,13350,4.662940971009431,80.0,0.0
2863,0,2863,[427 318 132  64 496],151,5,13355,4.663058659217877,80.0,0.0
2864,0,2864,[427 318 132  64 496],577,5,13360,4.663176265270506,80.0,0.0
2865,0,2865,[427 318 132  64 496],577,5,13365,4.663293789253315,80.0,0.0
2866,0,2866,[496 181 202 215 237],878,2,13367,4.662364841297523,20.0,0.0
2867,0,2867,[427 318 132  64 496],151,5,13372,4.662482566248257,80.0,0.0
2868,0,2868,[427 318 132  64 496],18,5,13377,4.662600209132102,80.0,0.0
2869,0,2869,[427 318 132  64 496],796,5,13382,4.662717770034843,80.0,0.0
2870,0,2870,[427 318 132  64 496],450,5,13387,4.662835249042145,80.0,0.0
2871,0,2871,[427 318 132  64 496],577,5,13392,4.662952646239554,80.0,0.0
2872,0,2872,[427 318 132  64 496],577,5,13397,4.6630699617124955,80.0,0.0
2873,0,2873,[405 282 496 172 118],280,1,13398,4.661795407098121,20.0,0.0
2874,0,2874,[427 318 132  64 496],450,5,13403,4.661913043478261,80.0,0.0
2875,0,2875,[427 318 132  64 496],796,5,13408,4.662030598052851,80.0,0.0
2876,0,2876,[427 318 132  64 496],535,5,13413,4.662148070907195,80.0,0.0
2877,0,2877,[568  56 197   7 100],269,3,13416,4.661570535093815,0.0,20.0
2878,0,2878,[427 318 132  64 496],577,5,13421,4.661688086141021,80.0,0.0
2879,0,2879,[427 318 132  64 496],269,5,13426,4.6618055555555555,80.0,0.0
2880,0,2880,[427 318 132  64 496],330,5,13431,4.6619229434224225,80.0,0.0
2881,0,2881,[427 318 132  64 496],716,5,13436,4.662040249826509,80.0,0.0
2882,0,2882,[427 318 132  64 496],18,5,13441,4.6621574748525845,80.0,0.0
2883,0,2883,[427 318 132  64 496],151,5,13446,4.662274618585299,80.0,0.0
2884,0,2884,[427 318 132  64 496],577,5,13451,4.6623916811091854,80.0,0.0
2885,0,2885,[427 318 132  64 496],330,5,13456,4.662508662508663,80.0,0.0
2886,0,2886,[427 318 132  64 496],236,4,13460,4.662279182542432,80.0,0.0
2887,0,2887,[427 318 132  64 496],556,5,13465,4.662396121883656,80.0,0.0
2888,0,2888,[185 435 200 186 204],151,4,13469,4.662166839736933,0.0,0.0
2889,0,2889,[202 597 176 125 111],344,3,13472,4.6615916955017305,0.0,0.0
2890,0,2890,[427 318 132  64 496],535,5,13477,4.661708751297129,80.0,0.0
2891,0,2891,[427 318 132  64 496],18,5,13482,4.661825726141079,80.0,0.0
2892,0,2892,[427 318 132  64 496],151,5,13487,4.661942620117525,80.0,0.0
2893,0,2893,[427 318 132  64 496],269,5,13492,4.662059433310297,80.0,0.0
2894,0,2894,[427 318 132  64 496],18,5,13497,4.662176165803109,80.0,0.0
2895,0,2895,[427 318 132  64 496],716,5,13502,4.662292817679558,80.0,0.0
2896,0,2896,[427 318 132  64 496],151,5,13507,4.662409389023128,80.0,0.0
2897,0,2897,[427 318 132  64 496],535,5,13512,4.662525879917184,80.0,0.0
2898,0,2898,[427 318 132  64 496],269,5,13517,4.662642290444981,80.0,0.0
2899,0,2899,[427 318 132  64 496],716,5,13522,4.662758620689655,80.0,0.0
2900,0,2900,[427 318 132  64 496],269,5,13527,4.66287487073423,80.0,0.0
2901,0,2901,[228 118 172 215  88],330,5,13532,4.662991040661613,0.0,0.0
2902,0,2902,[427 318 132  64 496],151,5,13537,4.663107130554598,80.0,0.0
2903,0,2903,[427 318 132  64 496],18,5,13542,4.663223140495868,80.0,0.0
2904,0,2904,[427 318 132  64 496],450,5,13547,4.663339070567986,80.0,0.0
2905,0,2905,[427 318 132  64 496],330,5,13552,4.663454920853407,80.0,0.0
2906,0,2906,[427 318 132  64 496],18,5,13557,4.663570691434469,80.0,0.0
2907,0,2907,[427 318 132  64 496],556,5,13562,4.663686382393397,80.0,0.0
2908,0,2908,[508 742 235  64 183],344,3,13565,4.66311447232726,20.0,0.0
2909,0,2909,[427 318 132  64 496],236,4,13569,4.662886597938145,80.0,0.0
2910,0,2910,[427 318 132  64 496],151,5,13574,4.663002404671934,80.0,0.0
2911,0,2911,[427 318 132  64 496],577,5,13579,4.663118131868132,80.0,0.0
2912,0,2912,[427 318 132  64 496],151,5,13584,4.6632337796086505,80.0,0.0
2913,0,2913,[427 318 132  64 496],535,5,13589,4.663349347975291,80.0,0.0
2914,0,2914,[427 318 132  64 496],577,5,13594,4.663464837049743,80.0,0.0
2915,0,2915,[427 318 132  64 496],556,5,13599,4.66358024691358,80.0,0.0
2916,0,2916,[427 318 132  64 496],796,5,13604,4.6636955776482685,80.0,0.0
2917,0,2917,[427 318 132  64 496],18,5,13609,4.663810829335161,80.0,0.0
2918,0,2918,[427 318 132  64 496],535,5,13614,4.663926002055499,80.0,0.0
2919,0,2919,[427 318 132  64 496],716,5,13619,4.664041095890411,80.0,0.0
2920,0,2920,[427 318 132  64 496],796,5,13624,4.664156110920917,80.0,0.0
2921,0,2921,[427 318 132  64 496],151,5,13629,4.664271047227926,80.0,0.0
2922,0,2922,[427 318 132  64 496],556,5,13634,4.664385904892234,80.0,0.0
2923,0,2923,[427 318 132  64 496],716,5,13639,4.664500683994528,80.0,0.0
2924,0,2924,[427 318 132  64 496],151,5,13644,4.664615384615384,80.0,0.0
2925,0,2925,[427 318 132  64 496],18,5,13649,4.66473000683527,80.0,0.0
2926,0,2926,[427 318 132  64 496],269,5,13654,4.66484455073454,80.0,0.0
2927,0,2927,[427 318 132  64 496],151,5,13659,4.664959016393443,80.0,0.0
2928,0,2928,[234 257 357 655 175],457,4,13663,4.664731990440424,0.0,0.0
2929,0,2929,[427 318 132  64 496],236,4,13667,4.664505119453925,80.0,0.0
2930,0,2930,[427 318 132  64 496],236,4,13671,4.664278403275333,80.0,0.0
2931,0,2931,[427 318 132  64 496],330,5,13676,4.664392905866303,80.0,0.0
2932,0,2932,[144 322 588 546  82],280,3,13679,4.66382543470849,0.0,0.0
2933,0,2933,[427 318 132  64 496],236,4,13683,4.66359918200409,80.0,0.0
2934,0,2934,[427 318 132  64 496],450,5,13688,4.663713798977853,80.0,0.0
2935,0,2935,[427 318 132  64 496],577,5,13693,4.6638283378746594,80.0,0.0
2936,0,2936,[427 318 132  64 496],556,5,13698,4.66394279877426,80.0,0.0
2937,0,2937,[427 318 132  64 496],269,5,13703,4.664057181756297,80.0,0.0
2938,0,2938,[179 182 185   8 286],655,3,13706,4.663490983327662,0.0,20.0
2939,0,2939,[427 318 132  64 496],18,5,13711,4.663605442176871,80.0,0.0
2940,0,2940,[427 318 132  64 496],450,5,13716,4.663719823189392,80.0,0.0
2941,0,2941,[427 318 132  64 496],716,5,13721,4.663834126444596,80.0,0.0
2942,0,2942,[427 318 132  64 496],796,5,13726,4.663948352021746,80.0,0.0
2943,0,2943,[288 258 132  50 202],344,4,13730,4.663722826086956,0.0,20.0
2944,0,2944,[427 318 132  64 496],450,5,13735,4.66383701188455,80.0,0.0
2945,0,2945,[427 318 132  64 496],330,5,13740,4.663951120162933,80.0,0.0
2946,0,2946,[ 98  96  50 175 153],655,2,13742,4.663047166610112,0.0,20.0
2947,0,2947,[427 318 132  64 496],577,5,13747,4.663161465400272,80.0,0.0
2948,0,2948,[427 318 132  64 496],236,4,13751,4.6629365886741265,80.0,0.0
2949,0,2949,[427 318 132  64  98],330,5,13756,4.663050847457627,60.0,0.0
2950,0,2950,[ 56 176 186  96 222],655,0,13756,4.661470687902406,0.0,0.0
2951,0,2951,[427 318 132  64  98],535,4,13760,4.661246612466124,60.0,0.0
2952,0,2952,[151 471 181 211  71],535,5,13765,4.661361327463596,0.0,0.0
2953,0,2953,[427 318 132  64 496],716,5,13770,4.6614759647935005,80.0,0.0
2954,0,2954,[427 318 132  64 496],151,5,13775,4.661590524534687,80.0,0.0
2955,0,2955,[427 318 132  64 496],577,5,13780,4.6617050067659,80.0,0.0
2956,0,2956,[427 318 132  64 496],535,5,13785,4.6618194115657765,80.0,0.0
2957,0,2957,[427 318 132  64 496],450,5,13790,4.661933739012847,80.0,0.0
2958,0,2958,[427 318 132  64 496],269,5,13795,4.6620479891855355,80.0,0.0
2959,0,2959,[427 318 132  64 496],556,5,13800,4.662162162162162,80.0,0.0
2960,0,2960,[427 318 132  64 496],269,5,13805,4.662276258020939,80.0,0.0
2961,0,2961,[427 318 132  64 496],151,5,13810,4.662390276839973,80.0,0.0
2962,0,2962,[427 318 132  64 496],450,5,13815,4.662504218697267,80.0,0.0
2963,0,2963,[427 318 132  64 496],18,5,13820,4.662618083670715,80.0,0.0
2964,0,2964,[117 385 182 132 333],796,5,13825,4.662731871838111,0.0,0.0
2965,0,2965,[427 318 132  64 496],450,5,13830,4.662845583277141,80.0,0.0
2966,0,2966,[427 318 132  64 496],716,5,13835,4.662959218065386,80.0,0.0
2967,0,2967,[  1  11 318 179 288],655,2,13837,4.662061994609164,20.0,0.0
2968,0,2968,[427 318 132  64 496],18,5,13842,4.662175816773324,80.0,0.0
2969,0,2969,[328  50 405 143 191],655,3,13845,4.661616161616162,0.0,20.0
2970,0,2970,[427 318 132  64 191],796,5,13850,4.661730057219791,60.0,0.0
2971,0,2971,[427 318 132  64 191],693,3,13853,4.6611709286675636,60.0,0.0
2972,0,2972,[427 318 132  64 496],556,5,13858,4.661284897410024,80.0,0.0
2973,0,2973,[427 318 132  64 496],796,5,13863,4.661398789509079,80.0,0.0
2974,0,2974,[427 318 132  64 496],18,5,13868,4.661512605042017,80.0,0.0
2975,0,2975,[427 318 132  64 496],556,5,13873,4.661626344086022,80.0,0.0
2976,0,2976,[111 318  15 234  50],269,1,13874,4.660396372186765,20.0,20.0
2977,0,2977,[427 318 132  64 496],450,5,13879,4.66051040967092,80.0,0.0
2978,0,2978,[427 318 132  64 496],450,5,13884,4.660624370594159,80.0,0.0
2979,0,2979,[427 318 132  64 496],151,5,13889,4.660738255033557,80.0,0.0
2980,0,2980,[427 318 132  64 496],236,4,13893,4.660516605166052,80.0,0.0
2981,0,2981,[427 318 132  64 496],269,5,13898,4.660630449362844,80.0,0.0
2982,0,2982,[427 318 132  64 496],577,5,13903,4.660744217230976,80.0,0.0
2983,0,2983,[427 318 132  64 496],716,5,13908,4.660857908847185,80.0,0.0
2984,0,2984,[427 318 132  64 496],577,5,13913,4.660971524288107,80.0,0.0
2985,0,2985,[427 318 132  64 496],236,4,13917,4.660750167448091,80.0,0.0
2986,0,2986,[427 318 132  64 496],151,5,13922,4.660863742885839,80.0,0.0
2987,0,2987,[427 318 132  64 496],236,4,13926,4.660642570281125,80.0,0.0
2988,0,2988,[427 318 132  64 496],577,5,13931,4.660756105720977,80.0,0.0
2989,0,2989,[427 318 132  64 496],236,4,13935,4.660535117056856,80.0,0.0
2990,0,2990,[427 318 132  64  98],236,5,13940,4.660648612504179,60.0,0.0
2991,0,2991,[427 318 132  64  98],18,5,13945,4.660762032085562,60.0,0.0
2992,0,2992,[294   7 168 215 318],65,4,13949,4.660541262946876,20.0,0.0
2993,0,2993,[427 318 132  64 168],18,4,13953,4.660320641282565,60.0,0.0
2994,0,2994,[427 318 132  64  98],535,4,13957,4.6601001669449085,60.0,0.0
2995,0,2995,[427 318 132  64 496],716,5,13962,4.6602136181575435,80.0,0.0
2996,0,2996,[427 318 132  64 496],236,4,13966,4.659993326659993,80.0,0.0
2997,0,2997,[427 318 132  64 185],535,5,13971,4.660106737825217,60.0,0.0
2998,0,2998,[427 318 132  64 185],151,5,13976,4.660220073357786,60.0,0.0
2999,0,2999,[427 318 132  64 185],316,4,13980,4.66,60.0,0.0
3000,0,3000,[423 182 100 111 181],593,4,13984,4.659780073308897,0.0,20.0
3001,0,3001,[427 318 132  64 423],236,5,13989,4.659893404397069,60.0,0.0
3002,0,3002,[427 318 132  64 423],450,5,13994,4.66000666000666,60.0,0.0
3003,0,3003,[427 318 132  64 423],655,3,13997,4.659454061251664,60.0,0.0
3004,0,3004,[427 318 132  64 179],236,4,14001,4.659234608985025,60.0,0.0
3005,0,3005,[427 318 132  64  98],796,5,14006,4.659347970725216,60.0,0.0
3006,0,3006,[427 318 132  64  98],796,5,14011,4.659461257066844,60.0,0.0
3007,0,3007,[427 318 132  64  98],269,5,14016,4.659574468085107,60.0,0.0
3008,0,3008,[427 318 132  64  98],535,4,14020,4.659355267530741,60.0,0.0
3009,0,3009,[427 318 132  64 496],151,5,14025,4.659468438538206,80.0,0.0
3010,0,3010,[357 435 210 173 127],629,5,14030,4.659581534373962,0.0,20.0
3011,0,3011,[427 318 132  64 496],716,5,14035,4.659694555112882,80.0,0.0
3012,0,3012,[427 318 132  64 496],151,5,14040,4.6598075008297375,80.0,0.0
3013,0,3013,[427 318 132  64 496],236,4,14044,4.659588586595886,80.0,0.0
3014,0,3014,[427 318 132  64 496],151,5,14049,4.659701492537313,80.0,0.0
3015,0,3015,[427 318 132  64 496],269,5,14054,4.659814323607427,80.0,0.0
3016,0,3016,[427 318 132  64 496],535,5,14059,4.659927079880676,80.0,0.0
3017,0,3017,[405 403 210 174 204],655,0,14059,4.658383035122598,0.0,0.0
3018,0,3018,[427 318 132  64 496],716,5,14064,4.658496190791653,80.0,0.0
3019,0,3019,[427 318 132  64 496],330,5,14069,4.658609271523178,80.0,0.0
3020,0,3020,[427 318 132  64 496],535,5,14074,4.658722277391592,80.0,0.0
3021,0,3021,[427 318 132  64 496],577,5,14079,4.658835208471211,80.0,0.0
3022,0,3022,[ 28  64 173 748 286],151,4,14083,4.658617267614952,20.0,20.0
3023,0,3023,[427 318 132  64 496],151,5,14088,4.658730158730159,80.0,0.0
3024,0,3024,[427 318 132  64 496],796,5,14093,4.658842975206611,80.0,0.0
3025,0,3025,[427 318 132  64 496],577,5,14098,4.658955717118308,80.0,0.0
3026,0,3026,[427 318 132  64 496],577,5,14103,4.659068384539148,80.0,0.0
3027,0,3027,[427 318 132  64 496],330,5,14108,4.659180977542933,80.0,0.0
3028,0,3028,[427 318 132  64 496],535,5,14113,4.659293496203367,80.0,0.0
3029,0,3029,[427 318 132  64 496],577,5,14118,4.659405940594059,80.0,0.0
3030,0,3030,[427 318 132  64 496],236,4,14122,4.659188386671065,80.0,0.0
3031,0,3031,[427 318 132  64 496],556,5,14127,4.659300791556729,80.0,0.0
3032,0,3032,[427 318 132  64 496],236,4,14131,4.659083415759974,80.0,0.0
3033,0,3033,[427 318 132  64  98],655,4,14135,4.6588661832564275,60.0,0.0
3034,0,3034,[427 318 132  64  98],693,4,14139,4.658649093904448,60.0,0.0
3035,0,3035,[427 318 132  64  98],269,5,14144,4.658761528326746,60.0,0.0
3036,0,3036,[427 318 132  64  98],716,5,14149,4.65887388870596,60.0,0.0
3037,0,3037,[427 318 132  64  98],796,5,14154,4.658986175115207,60.0,0.0
3038,0,3038,[427 318 132  64  98],535,4,14158,4.658769332017111,60.0,0.0
3039,0,3039,[427 318 132  64 496],716,5,14163,4.658881578947368,80.0,0.0
3040,0,3040,[200 125 238 180  64],450,4,14167,4.6586649128576125,20.0,0.0
3041,0,3041,[318 427 132  64 496],236,4,14171,4.65844838921762,80.0,0.0
3042,0,3042,[318 427 132  64  98],316,5,14176,4.658560630956293,60.0,0.0
3043,0,3043,[318 427 132  64  98],577,5,14181,4.658672798948752,60.0,0.0
3044,0,3044,[318 427 132  64  98],577,5,14186,4.658784893267652,60.0,0.0
3045,0,3045,[318 427 132  64  98],535,4,14190,4.6585686145764935,60.0,0.0
3046,0,3046,[318 427 132  64 496],577,5,14195,4.658680669510995,80.0,0.0
3047,0,3047,[318 427 132  64 496],716,5,14200,4.6587926509186355,80.0,0.0
3048,0,3048,[318 427 132  64 496],18,5,14205,4.658904558871761,80.0,0.0
3049,0,3049,[318 427 132  64 496],796,5,14210,4.659016393442623,80.0,0.0
3050,0,3050,[197  28 187 151 172],389,5,14215,4.659128154703376,0.0,0.0
3051,0,3051,[318 427 132  64 496],716,5,14220,4.659239842726081,80.0,0.0
3052,0,3052,[318 427 132  64 496],450,5,14225,4.659351457582706,80.0,0.0
3053,0,3053,[318 427 132  64 496],556,5,14230,4.659462999345121,80.0,0.0
3054,0,3054,[318 427 132  64 496],796,5,14235,4.659574468085107,80.0,0.0
3055,0,3055,[318 427 132  64 496],236,4,14239,4.659358638743456,80.0,0.0
3056,0,3056,[318 427 132  64 496],236,4,14243,4.659142950605168,80.0,0.0
3057,0,3057,[ 11 268 301 117 151],296,3,14246,4.658600392413342,0.0,0.0
3058,0,3058,[318 427 132  64  98],18,5,14251,4.658711997384766,60.0,0.0
3059,0,3059,[318 427 132  64  98],693,4,14255,4.658496732026144,60.0,0.0
3060,0,3060,[318 427 132  64  98],693,4,14259,4.65828160731787,60.0,0.0
3061,0,3061,[318 427 132  64  98],236,5,14264,4.658393207054213,60.0,0.0
3062,0,3062,[318 427 132  64  98],577,5,14269,4.658504733920992,60.0,0.0
3063,0,3063,[318 427 132  64  98],450,5,14274,4.658616187989556,60.0,0.0
3064,0,3064,[318 427 132  64  98],693,4,14278,4.6584013050570965,60.0,0.0
3065,0,3065,[318 427 132  64  98],535,4,14282,4.658186562296152,60.0,0.0
3066,0,3066,[318 427 132  64  98],236,5,14287,4.658298011085751,60.0,0.0
3067,0,3067,[318 427 132  64  98],535,4,14291,4.658083441981747,60.0,0.0
3068,0,3068,[318 427 132  64 496],18,5,14296,4.6581948517432386,80.0,0.0
3069,0,3069,[318 427 132  64 496],269,5,14301,4.658306188925081,80.0,0.0
3070,0,3070,[318 427 132  64 496],151,5,14306,4.658417453598177,80.0,0.0
3071,0,3071,[405 185  28 132   1],330,5,14311,4.658528645833333,0.0,0.0
3072,0,3072,[318 427 132  64 496],330,5,14316,4.6586397657012695,80.0,0.0
3073,0,3073,[318 427 132  64 496],236,4,14320,4.658425504229018,80.0,0.0
3074,0,3074,[318 427 132  64 496],269,5,14325,4.658536585365853,80.0,0.0
3075,0,3075,[318 427 132  64 496],450,5,14330,4.658647594278284,80.0,0.0
3076,0,3076,[318 427 132  64 496],18,5,14335,4.658758531036724,80.0,0.0
3077,0,3077,[318 427 132  64 496],796,5,14340,4.658869395711501,80.0,0.0
3078,0,3078,[318 427 132  64 496],577,5,14345,4.6589801883728486,80.0,0.0
3079,0,3079,[318 427 132  64 496],269,5,14350,4.659090909090909,80.0,0.0
3080,0,3080,[318 427 132  64 496],269,5,14355,4.659201557935735,80.0,0.0
3081,0,3081,[318 427 132  64 496],18,5,14360,4.659312134977288,80.0,0.0
3082,0,3082,[318 427 132  64 496],535,5,14365,4.659422640285436,80.0,0.0
3083,0,3083,[  1 427 161 100 597],23,3,14368,4.658884565499352,20.0,20.0
3084,0,3084,[294 117 333 405 301],655,0,14368,4.657374392220421,0.0,0.0
3085,0,3085,[318 427 132  64 496],330,5,14373,4.65748541801685,80.0,0.0
3086,0,3086,[318 427 132  64 496],269,5,14378,4.657596371882086,80.0,0.0
3087,0,3087,[318 427 132  64 496],18,5,14383,4.65770725388601,80.0,0.0
3088,0,3088,[318 427 132  64 496],716,5,14388,4.6578180640984135,80.0,0.0
3089,0,3089,[318 427 132  64 496],450,5,14393,4.657928802588997,80.0,0.0
3090,0,3090,[318 427 132  64 496],716,5,14398,4.6580394694273695,80.0,0.0
3091,0,3091,[318 427 132  64 496],716,5,14403,4.658150064683053,80.0,0.0
3092,0,3092,[318 427 132  64 496],716,5,14408,4.658260588425477,80.0,0.0
3093,0,3093,[318 427 132  64 496],535,5,14413,4.658371040723982,80.0,0.0
3094,0,3094,[318 427 132  64 496],18,5,14418,4.658481421647819,80.0,0.0
3095,0,3095,[318 427 132  64 496],269,5,14423,4.65859173126615,80.0,0.0
3096,0,3096,[318 427 132  64 496],556,5,14428,4.658701969648046,80.0,0.0
3097,0,3097,[318 427 132  64 496],330,5,14433,4.658812136862492,80.0,0.0
3098,0,3098,[318 427 132  64 496],151,5,14438,4.65892223297838,80.0,0.0
3099,0,3099,[318 427 132  64 496],535,5,14443,4.659032258064516,80.0,0.0
3100,0,3100,[318 427 132  64 496],577,5,14448,4.659142212189616,80.0,0.0
3101,0,3101,[318 427 132  64 496],236,4,14452,4.65892972275951,80.0,0.0
3102,0,3102,[318 427 132  64 496],269,5,14457,4.6590396390589754,80.0,0.0
3103,0,3103,[318 427 132  64 496],556,5,14462,4.659149484536083,80.0,0.0
3104,0,3104,[318 427 132  64 496],716,5,14467,4.659259259259259,80.0,0.0
3105,0,3105,[318 427 132  64 496],796,5,14472,4.659368963296845,80.0,0.0
3106,0,3106,[318 427 132  64 496],236,4,14476,4.659156742838751,80.0,0.0
3107,0,3107,[318 427 132  64 496],796,5,14481,4.659266409266409,80.0,0.0
3108,0,3108,[318 427 132  64 496],556,5,14486,4.659376005146349,80.0,0.0
3109,0,3109,[318 427 132  64 496],716,5,14491,4.659485530546624,80.0,0.0
3110,0,3110,[318 427 132  64 496],796,5,14496,4.659594985535198,80.0,0.0
3111,0,3111,[318 427 132  64 496],236,4,14500,4.659383033419023,80.0,0.0
3112,0,3112,[318 427 132  64 496],796,5,14505,4.659492451011886,80.0,0.0
3113,0,3113,[318 427 132  64 496],330,5,14510,4.659601798330122,80.0,0.0
3114,0,3114,[318 427 132  64 496],716,5,14515,4.659711075441413,80.0,0.0
3115,0,3115,[318 427 132  64 496],535,5,14520,4.65982028241335,80.0,0.0
3116,0,3116,[318 427 132  64 496],330,5,14525,4.659929419313443,80.0,0.0
3117,0,3117,[318 427 132  64 496],151,5,14530,4.660038486209109,80.0,0.0
3118,0,3118,[318 427 132  64 496],796,5,14535,4.660147483167682,80.0,0.0
3119,0,3119,[318 427 132  64 496],330,5,14540,4.660256410256411,80.0,0.0
3120,0,3120,[318 427 132  64 496],450,5,14545,4.6603652675424545,80.0,0.0
3121,0,3121,[318 427 132  64 496],236,4,14549,4.660153747597694,80.0,0.0
3122,0,3122,[318 427 132  64 496],556,5,14554,4.660262568043548,80.0,0.0
3123,0,3123,[ 12 173 288 151 313],450,4,14558,4.6600512163892445,0.0,0.0
3124,0,3124,[318 427 132  64 496],269,5,14563,4.66016,80.0,0.0
3125,0,3125,[318 427 132  64 496],18,5,14568,4.660268714011516,80.0,0.0
3126,0,3126,[318 427 132  64 496],556,5,14573,4.660377358490566,80.0,0.0
3127,0,3127,[318 427 132  64 496],236,4,14577,4.6601662404092075,80.0,0.0
3128,0,3128,[318 427 132  64  98],577,5,14582,4.6602748481943115,60.0,0.0
3129,0,3129,[318 427 132  64  98],450,5,14587,4.6603833865814694,60.0,0.0
3130,0,3130,[318 427 132  64  98],316,5,14592,4.660491855637177,60.0,0.0
3131,0,3131,[318 427 132  64  98],716,5,14597,4.660600255427842,60.0,0.0
3132,0,3132,[318 427 132  64  98],796,5,14602,4.66070858601979,60.0,0.0
3133,0,3133,[318 427 132  64  98],450,5,14607,4.66081684747926,60.0,0.0
3134,0,3134,[144 222 181 191 204],296,5,14612,4.660925039872408,0.0,0.0
3135,0,3135,[318 427 132  64  98],316,5,14617,4.661033163265306,60.0,0.0
3136,0,3136,[318 427 132  64  98],269,5,14622,4.66114121772394,60.0,0.0
3137,0,3137,[318 427 132  64  98],577,5,14627,4.661249203314213,60.0,0.0
3138,0,3138,[318 427 132  64  98],577,5,14632,4.661357120101943,60.0,0.0
3139,0,3139,[318 427 132  64  98],693,4,14636,4.661146496815286,60.0,0.0
3140,0,3140,[318 427 132  64  98],693,4,14640,4.660936007640879,60.0,0.0
3141,0,3141,[318 427 132  64  98],535,4,14644,4.660725652450668,60.0,0.0
3142,0,3142,[318 427 132  64  98],316,5,14649,4.660833598472797,60.0,0.0
3143,0,3143,[318 427 132  64  98],655,4,14653,4.660623409669212,60.0,0.0
3144,0,3144,[318 427 132  64  98],18,5,14658,4.6607313195548485,60.0,0.0
3145,0,3145,[318 427 132  64  98],655,4,14662,4.660521296884934,60.0,0.0
3146,0,3146,[318 427 132  64  98],577,5,14667,4.660629170638703,60.0,0.0
3147,0,3147,[318 427 132  64  98],450,5,14672,4.660736975857687,60.0,0.0
3148,0,3148,[318 427 132  64  98],269,5,14677,4.660844712607177,60.0,0.0
3149,0,3149,[318 427 132  64  98],655,4,14681,4.66063492063492,60.0,0.0
3150,0,3150,[318 427 132  64  98],693,4,14685,4.6604252618216435,60.0,0.0
3151,0,3151,[318 427 132  64  98],655,4,14689,4.660215736040609,60.0,0.0
3152,0,3152,[318 427 132  64  98],655,4,14693,4.660006343165239,60.0,0.0
3153,0,3153,[318 427 132  64  98],236,5,14698,4.66011414077362,60.0,0.0
3154,0,3154,[318 427 132  64  98],151,5,14703,4.660221870047543,60.0,0.0
3155,0,3155,[318 427 132  64  98],18,5,14708,4.660329531051964,60.0,0.0
3156,0,3156,[318 427 132  64  98],450,5,14713,4.660437123851758,60.0,0.0
3157,0,3157,[318 427 132  64  98],269,5,14718,4.660544648511716,60.0,0.0
3158,0,3158,[318 427 132  64  98],716,5,14723,4.66065210509655,60.0,0.0
3159,0,3159,[318 427 132  64  98],236,5,14728,4.660759493670886,60.0,0.0
3160,0,3160,[318 427 132  64  98],796,5,14733,4.660866814299272,60.0,0.0
3161,0,3161,[318 427 132  64  98],535,4,14737,4.660657811511702,60.0,0.0
3162,0,3162,[318 427 132  64  98],269,5,14742,4.6607650964274425,60.0,0.0
3163,0,3163,[318 427 132  64  98],236,5,14747,4.660872313527181,60.0,0.0
3164,0,3164,[318 427 132  64  98],535,4,14751,4.660663507109005,60.0,0.0
3165,0,3165,[318 427 132  64  98],450,5,14756,4.660770688566014,60.0,0.0
3166,0,3166,[318 427 132  64  98],330,5,14761,4.660877802336596,60.0,0.0
3167,0,3167,[318 427 132  64  98],330,5,14766,4.660984848484849,60.0,0.0
3168,0,3168,[318 427 132  64  98],535,4,14770,4.660776270116756,60.0,0.0
3169,0,3169,[318 427 132  64 496],796,5,14775,4.660883280757098,80.0,0.0
3170,0,3170,[318 427 132  64 496],716,5,14780,4.660990223904131,80.0,0.0
3171,0,3171,[318 427 132  64 496],18,5,14785,4.661097099621689,80.0,0.0
3172,0,3172,[318 427 132  64 496],151,5,14790,4.661203907973527,80.0,0.0
3173,0,3173,[318 427 132  64 496],577,5,14795,4.6613106490233145,80.0,0.0
3174,0,3174,[323 117 245 603 125],796,3,14798,4.660787401574803,20.0,0.0
3175,0,3175,[318 427 132  64 496],236,4,14802,4.660579345088161,80.0,0.0
3176,0,3176,[318 427 132  64 496],236,4,14806,4.660371419578219,80.0,0.0
3177,0,3177,[318 427 132  64  98],716,5,14811,4.660478288231592,60.0,0.0
3178,0,3178,[204 322 194 318 197],401,4,14815,4.660270525322429,20.0,0.0
3179,0,3179,[318 427 132  64  98],450,5,14820,4.660377358490566,60.0,0.0
3180,0,3180,[318 427 132  64  98],796,5,14825,4.660484124489154,60.0,0.0
3181,0,3181,[318 427 132  64  98],535,4,14829,4.6602765556253924,60.0,0.0
3182,0,3182,[318 427 132  64 496],236,4,14833,4.660069117185046,80.0,0.0
3183,0,3183,[318 427 132  64  98],236,5,14838,4.660175879396985,60.0,0.0
3184,0,3184,[318 427 132  64  98],330,5,14843,4.6602825745682885,60.0,0.0
3185,0,3185,[318 427 132  64  98],693,4,14847,4.660075329566855,60.0,0.0
3186,0,3186,[318 427 132  64  98],796,5,14852,4.66018198933166,60.0,0.0
3187,0,3187,[318 427 132  64  98],236,5,14857,4.6602885821831865,60.0,0.0
3188,0,3188,[318 427 132  64  98],535,4,14861,4.660081530260269,60.0,0.0
3189,0,3189,[318 427 132  64 496],556,5,14866,4.660188087774294,80.0,0.0
3190,0,3190,[318 427 132  64 496],535,5,14871,4.660294578502037,80.0,0.0
3191,0,3191,[318 427 132  64 496],450,5,14876,4.660401002506266,80.0,0.0
3192,0,3192,[318 427 132  64 496],796,5,14881,4.660507359849671,80.0,0.0
3193,0,3193,[318 427 132  64 496],450,5,14886,4.660613650594866,80.0,0.0
3194,0,3194,[  8  11 204 403 200],457,5,14891,4.660719874804382,0.0,0.0
3195,0,3195,[318 427 132  64 496],236,4,14895,4.660513141426783,80.0,0.0
3196,0,3196,[318 427 132  64 588],577,5,14900,4.660619330622459,60.0,0.0
3197,0,3197,[318 427 132  64 588],796,5,14905,4.66072545340838,60.0,0.0
3198,0,3198,[318 427 132  64 588],450,5,14910,4.660831509846827,60.0,0.0
3199,0,3199,[318 427 132  64 588],316,4,14914,4.660625,60.0,0.0
3200,0,3200,[318 427 132  64  98],693,4,14918,4.660418619181506,60.0,0.0
3201,0,3201,[318 427 132  64  98],535,4,14922,4.660212367270456,60.0,0.0
3202,0,3202,[318 427 132  64 496],330,5,14927,4.660318451451764,80.0,0.0
3203,0,3203,[318 427 132  64 496],450,5,14932,4.6604244694132335,80.0,0.0
3204,0,3204,[318 427 132  64 496],535,5,14937,4.660530421216849,80.0,0.0
3205,0,3205,[318 427 132  64 496],556,5,14942,4.660636306924516,80.0,0.0
3206,0,3206,[318 427 132  64 496],236,4,14946,4.660430308699719,80.0,0.0
3207,0,3207,[471 181  82 187  79],72,3,14949,4.659912718204489,0.0,0.0
3208,0,3208,[318 427 132  64 496],269,5,14954,4.660018697413524,80.0,0.0
3209,0,3209,[ 88 427   9  12 183],796,4,14958,4.65981308411215,20.0,0.0
3210,0,3210,[318 427 132  64 496],330,5,14963,4.659919028340081,80.0,0.0
3211,0,3211,[318 427 132  64 496],330,5,14968,4.660024906600249,80.0,0.0
3212,0,3212,[318 427 132  64 496],450,5,14973,4.660130718954249,80.0,0.0
3213,0,3213,[318 427 132  64 496],796,5,14978,4.660236465463597,80.0,0.0
3214,0,3214,[318 427 132  64 496],796,5,14983,4.660342146189736,80.0,0.0
3215,0,3215,[318 427 132  64 496],556,5,14988,4.66044776119403,80.0,0.0
3216,0,3216,[318 427 132  64 496],535,5,14993,4.660553310537768,80.0,0.0
3217,0,3217,[200  96 191  22 483],269,3,14996,4.6600372902423866,0.0,0.0
3218,0,3218,[318 427 132  64 496],577,5,15001,4.660142901522212,80.0,0.0
3219,0,3219,[318 427 132  64 496],577,5,15006,4.660248447204969,80.0,0.0
3220,0,3220,[318 427 132  64 496],269,5,15011,4.660353927351754,80.0,0.0
3221,0,3221,[318 427 132  64 496],577,5,15016,4.660459342023588,80.0,0.0
3222,0,3222,[318 427 132  64 496],450,5,15021,4.660564691281415,80.0,0.0
3223,0,3223,[318 427 132  64 496],577,5,15026,4.660669975186104,80.0,0.0
3224,0,3224,[318 427 132  64 496],18,5,15031,4.660775193798449,80.0,0.0
3225,0,3225,[318 427 132  64 496],556,5,15036,4.6608803471791695,80.0,0.0
3226,0,3226,[318 427 132  64 496],18,5,15041,4.660985435388906,80.0,0.0
3227,0,3227,[318 427 132  64 496],269,5,15046,4.661090458488228,80.0,0.0
3228,0,3228,[318 427 132  64 496],796,5,15051,4.661195416537628,80.0,0.0
3229,0,3229,[318 427 132  64 496],330,5,15056,4.661300309597523,80.0,0.0
3230,0,3230,[318 427 132  64 496],556,5,15061,4.6614051377282575,80.0,0.0
3231,0,3231,[318 427 132  64 496],269,5,15066,4.661509900990099,80.0,0.0
3232,0,3232,[318 427 132  64 496],535,5,15071,4.661614599443242,80.0,0.0
3233,0,3233,[318 427 132  64 496],151,5,15076,4.661719233147805,80.0,0.0
3234,0,3234,[318 427 132  64 496],535,5,15081,4.661823802163833,80.0,0.0
3235,0,3235,[194 257 238  15  50],296,4,15085,4.661619283065513,0.0,20.0
3236,0,3236,[318 427 132  64 496],236,4,15089,4.661414890330553,80.0,0.0
3237,0,3237,[318 427 132  64 496],556,5,15094,4.661519456454601,80.0,0.0
3238,0,3238,[318 427 132  64 496],716,5,15099,4.661623958011732,80.0,0.0
3239,0,3239,[318 427 132  64 496],556,5,15104,4.661728395061728,80.0,0.0
3240,0,3240,[318 427 132  64 496],330,5,15109,4.661832767664301,80.0,0.0
3241,0,3241,[318 427 132  64 496],18,5,15114,4.661937075879087,80.0,0.0
3242,0,3242,[318 427 132  64 496],151,5,15119,4.662041319765649,80.0,0.0
3243,0,3243,[318 427 132  64 496],556,5,15124,4.662145499383477,80.0,0.0
3244,0,3244,[318 427 132  64 496],151,5,15129,4.662249614791988,80.0,0.0
3245,0,3245,[318 427 132  64 496],535,5,15134,4.662353666050524,80.0,0.0
3246,0,3246,[235 603 168 197 118],716,3,15137,4.661841700030798,20.0,0.0
3247,0,3247,[318 427 132  64 496],236,4,15141,4.661637931034483,80.0,0.0
3248,0,3248,[318 427 132  64 496],535,5,15146,4.661742074484457,80.0,0.0
3249,0,3249,[318 427 132  64 496],556,5,15151,4.661846153846154,80.0,0.0
3250,0,3250,[318 427 132  64 496],151,5,15156,4.661950169178715,80.0,0.0
3251,0,3251,[318 427 132  64 496],151,5,15161,4.662054120541206,80.0,0.0
3252,0,3252,[318 427 132  64 496],556,5,15166,4.662158007992622,80.0,0.0
3253,0,3253,[318 427 132  64 496],450,5,15171,4.662261831591887,80.0,0.0
3254,0,3254,[318 427 132  64 496],556,5,15176,4.662365591397849,80.0,0.0
3255,0,3255,[318 427 132  64 496],269,5,15181,4.662469287469287,80.0,0.0
3256,0,3256,[275 175 483 180 197],716,3,15184,4.661958857844643,0.0,20.0
3257,0,3257,[318 427 132  64 496],716,5,15189,4.662062615101289,80.0,0.0
3258,0,3258,[427 435 173 168 603],716,5,15194,4.662166308683645,40.0,0.0
3259,0,3259,[318 427 132  64 496],151,5,15199,4.662269938650307,80.0,0.0
3260,0,3260,[318 427 132  64 496],716,5,15204,4.662373505059797,80.0,0.0
3261,0,3261,[318 427 132  64 496],556,5,15209,4.66247700797057,80.0,0.0
3262,0,3262,[318 427 132  64 496],556,5,15214,4.662580447441005,80.0,0.0
3263,0,3263,[318 427 132  64 496],556,5,15219,4.662683823529412,80.0,0.0
3264,0,3264,[318 427 132  64 496],18,5,15224,4.662787136294027,80.0,0.0
3265,0,3265,[318 427 132  64 496],18,5,15229,4.662890385793019,80.0,0.0
3266,0,3266,[318 427 132  64 496],716,5,15234,4.662993572084481,80.0,0.0
3267,0,3267,[318 427 132  64 496],236,4,15238,4.662790697674419,80.0,0.0
3268,0,3268,[318 427 132  64 496],535,5,15243,4.662893851330682,80.0,0.0
3269,0,3269,[318 427 132  64 496],18,5,15248,4.662996941896025,80.0,0.0
3270,0,3270,[318 427 132  64 496],577,5,15253,4.663099969428309,80.0,0.0
3271,0,3271,[318 427 132  64 496],330,5,15258,4.66320293398533,80.0,0.0
3272,0,3272,[318 427 132  64 496],236,4,15262,4.663000305530095,80.0,0.0
3273,0,3273,[318 427 132  64 275],330,5,15267,4.6631032376298105,60.0,20.0
3274,0,3274,[318 427 132  64 275],330,5,15272,4.663206106870229,60.0,20.0
3275,0,3275,[318 427 132  64 275],535,5,15277,4.663308913308914,60.0,20.0
3276,0,3276,[318 427 132  64 275],535,5,15282,4.663411657003357,60.0,20.0
3277,0,3277,[318 427 132  64 275],716,5,15287,4.663514338010982,60.0,20.0
3278,0,3278,[318 427 132  64 275],716,5,15292,4.663616956389143,60.0,20.0
3279,0,3279,[318 427 132  64 275],716,5,15297,4.663719512195122,60.0,20.0
3280,0,3280,[318 427 132  64 275],330,5,15302,4.663822005486132,60.0,20.0
3281,0,3281,[318 427 132  64 275],716,5,15307,4.663924436319317,60.0,20.0
3282,0,3282,[318 427 132  64 275],316,5,15312,4.664026804751751,60.0,20.0
3283,0,3283,[318 427 132  64 275],796,5,15317,4.664129110840438,60.0,20.0
3284,0,3284,[318 427 132  64 275],236,4,15321,4.66392694063927,60.0,20.0
3285,0,3285,[318 427 132  64 496],716,5,15326,4.664029214850882,80.0,0.0
3286,0,3286,[318 427 132  64 496],535,5,15331,4.664131426832978,80.0,0.0
3287,0,3287,[318 427 132  64 496],269,5,15336,4.664233576642336,80.0,0.0
3288,0,3288,[318 427 132  64 496],716,5,15341,4.664335664335664,80.0,0.0
3289,0,3289,[196  15 173 135 211],389,1,15342,4.66322188449848,0.0,0.0
3290,0,3290,[318 427 132  64 496],18,5,15347,4.6633242175630505,80.0,0.0
3291,0,3291,[318 427 132  64 496],535,5,15352,4.6634264884568655,80.0,0.0
3292,0,3292,[318 427 132  64 496],330,5,15357,4.663528697236562,80.0,0.0
3293,0,3293,[215 125  82 237  70],450,4,15361,4.663327261687917,0.0,0.0
3294,0,3294,[318 427 132  64 496],450,5,15366,4.663429438543248,80.0,0.0
3295,0,3295,[318 427 132  64 496],330,5,15371,4.663531553398058,80.0,0.0
3296,0,3296,[318 427 132  64 496],450,5,15376,4.663633606308766,80.0,0.0
3297,0,3297,[318 427 132  64 496],151,5,15381,4.6637355973317165,80.0,0.0
3298,0,3298,[318 427 132  64 496],577,5,15386,4.663837526523189,80.0,0.0
3299,0,3299,[318 427 132  64 496],330,5,15391,4.663939393939394,80.0,0.0
3300,0,3300,[318 427 132  64 496],330,5,15396,4.664041199636474,80.0,0.0
3301,0,3301,[318 427 132  64 496],450,5,15401,4.664142943670503,80.0,0.0
3302,0,3302,[318 427 132  64 496],716,5,15406,4.664244626097487,80.0,0.0
3303,0,3303,[318 427 132  64 496],577,5,15411,4.664346246973365,80.0,0.0
3304,0,3304,[318 427 132  64 496],151,5,15416,4.664447806354009,80.0,0.0
3305,0,3305,[318 427 132  64 496],535,5,15421,4.664549304295221,80.0,0.0
3306,0,3306,[318 427 132  64 496],556,5,15426,4.6646507408527365,80.0,0.0
3307,0,3307,[318 427 132  64 496],716,5,15431,4.664752116082225,80.0,0.0
3308,0,3308,[318 427 132  64 496],269,5,15436,4.664853430039287,80.0,0.0
3309,0,3309,[318 427 132  64 496],18,5,15441,4.664954682779456,80.0,0.0
3310,0,3310,[318 427 132  64 496],716,5,15446,4.6650558743582,80.0,0.0
3311,0,3311,[ 25 202  28 118 238],450,3,15449,4.6645531400966185,0.0,0.0
3312,0,3312,[318 427 132  64 496],577,5,15454,4.664654391789918,80.0,0.0
3313,0,3313,[318 427 132  64 496],535,5,15459,4.664755582377791,80.0,0.0
3314,0,3314,[153 200  69 197  88],330,5,15464,4.664856711915536,0.0,0.0
3315,0,3315,[318 427 132  64 496],535,5,15469,4.6649577804583835,80.0,0.0
3316,0,3316,[318 427 132  64 496],716,5,15474,4.6650587880615015,80.0,0.0
3317,0,3317,[318 427 132  64 496],269,5,15479,4.665159734779988,80.0,0.0
3318,0,3318,[318 427 132  64 496],577,5,15484,4.665260620668876,80.0,0.0
3319,0,3319,[318 427 132  64 496],577,5,15489,4.665361445783133,80.0,0.0
3320,0,3320,[175 216  70 597 215],11,1,15490,4.664257753688648,0.0,0.0
3321,0,3321,[318 427 132  64 496],450,5,15495,4.664358819987959,80.0,0.0
3322,0,3322,[318 427 132  64 496],556,5,15500,4.6644598254589225,80.0,0.0
3323,0,3323,[318 427 132  64 496],18,5,15505,4.664560770156438,80.0,0.0
3324,0,3324,[318 427 132  64 496],151,5,15510,4.6646616541353385,80.0,0.0
3325,0,3325,[318 427 132  64 496],151,5,15515,4.664762477450391,80.0,0.0
3326,0,3326,[318 427 132  64 496],269,5,15520,4.664863240156297,80.0,0.0
3327,0,3327,[318 427 132  64 496],577,5,15525,4.6649639423076925,80.0,0.0
3328,0,3328,[318 427 132  64 496],330,5,15530,4.665064583959147,80.0,0.0
3329,0,3329,[318 427 132  64 496],151,5,15535,4.665165165165165,80.0,0.0
3330,0,3330,[318 427 132  64 496],236,4,15539,4.664965475833083,80.0,0.0
3331,0,3331,[318 427 132  64 496],269,5,15544,4.665066026410564,80.0,0.0
3332,0,3332,[318 427 132  64 496],151,5,15549,4.665166516651666,80.0,0.0
3333,0,3333,[318 427 132  64 496],18,5,15554,4.665266946610678,80.0,0.0
3334,0,3334,[318 427 132  64 496],796,5,15559,4.665367316341829,80.0,0.0
3335,0,3335,[318 427 132  64 496],450,5,15564,4.66546762589928,80.0,0.0
3336,0,3336,[318 427 132  64 496],450,5,15569,4.665567875337129,80.0,0.0
3337,0,3337,[318 427 132  64 496],151,5,15574,4.665668064709407,80.0,0.0
3338,0,3338,[238 268 118 288 234],655,0,15574,4.664270739742438,0.0,0.0
3339,0,3339,[427 318 132  64 496],151,5,15579,4.66437125748503,80.0,0.0
3340,0,3340,[427 318 132  64 496],535,5,15584,4.664471715055373,80.0,0.0
3341,0,3341,[185  64 257  56 655],457,4,15588,4.66427289048474,20.0,0.0
3342,0,3342,[427 318 132  64 496],236,4,15592,4.664074184863895,80.0,0.0
3343,0,3343,[427 318 132  64 496],556,5,15597,4.664174641148326,80.0,0.0
3344,0,3344,[427 318 132  64 496],151,5,15602,4.664275037369208,80.0,0.0
3345,0,3345,[238 508 597 196  98],11,2,15604,4.663478780633592,0.0,0.0
3346,0,3346,[427 318 132  64 496],716,5,15609,4.663579324768449,80.0,0.0
3347,0,3347,[427 318 132  64 496],18,5,15614,4.663679808841099,80.0,0.0
3348,0,3348,[427 318 132  64 496],18,5,15619,4.663780232905345,80.0,0.0
3349,0,3349,[427 318 132  64 496],269,5,15624,4.663880597014925,80.0,0.0
3350,0,3350,[427 318 132  64 496],236,4,15628,4.663682482840943,80.0,0.0
3351,0,3351,[427 318 132  64 496],535,5,15633,4.663782816229117,80.0,0.0
3352,0,3352,[427 318 132  64 496],796,5,15638,4.663883089770355,80.0,0.0
3353,0,3353,[427 318 132  64 496],535,5,15643,4.6639833035181875,80.0,0.0
3354,0,3354,[427 318 132  64 496],556,5,15648,4.664083457526081,80.0,0.0
3355,0,3355,[427 318 132  64 496],577,5,15653,4.6641835518474375,80.0,0.0
3356,0,3356,[427 318 132  64 496],18,5,15658,4.664283586535597,80.0,0.0
3357,0,3357,[427 318 132  64 496],236,4,15662,4.66408576533651,80.0,0.0
3358,0,3358,[121 301 211 245 300],450,4,15666,4.663888061923191,0.0,0.0
3359,0,3359,[318 427 132  64 496],796,5,15671,4.663988095238095,80.0,0.0
3360,0,3360,[143 181 568 204 742],457,5,15676,4.664088069027075,0.0,0.0
3361,0,3361,[318 427 132  64 496],151,5,15681,4.664187983343248,80.0,0.0
3362,0,3362,[318 427 132  64 496],450,5,15686,4.664287838239667,80.0,0.0
3363,0,3363,[318 427 132  64 496],330,5,15691,4.664387633769322,80.0,0.0
3364,0,3364,[318 427 132  64 496],535,5,15696,4.6644873699851415,80.0,0.0
3365,0,3365,[318 427 132  64 496],535,5,15701,4.664587046939988,80.0,0.0
3366,0,3366,[ 89 271  70  98 176],72,2,15703,4.663795663795664,0.0,0.0
3367,0,3367,[318 427 132  64 496],716,5,15708,4.663895486935867,80.0,0.0
3368,0,3368,[318 427 132  64 496],450,5,15713,4.663995250816266,80.0,0.0
3369,0,3369,[318 427 132  64 496],151,5,15718,4.664094955489614,80.0,0.0
3370,0,3370,[238 265 546 228 405],151,3,15721,4.663601305250667,0.0,0.0
3371,0,3371,[318 427 132  64 496],18,5,15726,4.6637010676156585,80.0,0.0
3372,0,3372,[318 427 132  64 496],716,5,15731,4.663800770827157,80.0,0.0
3373,0,3373,[318 427 132  64 496],535,5,15736,4.66390041493776,80.0,0.0
3374,0,3374,[318 427 132  64 496],716,5,15741,4.664,80.0,0.0
3375,0,3375,[318 427 132  64 496],716,5,15746,4.664099526066351,80.0,0.0
3376,0,3376,[318 427 132  64 496],716,5,15751,4.664198993189221,80.0,0.0
3377,0,3377,[318 427 132  64 496],556,5,15756,4.664298401420959,80.0,0.0
3378,0,3378,[318 427 132  64 496],535,5,15761,4.66439775081385,80.0,0.0
3379,0,3379,[318 427 132  64 496],716,5,15766,4.664497041420119,80.0,0.0
3380,0,3380,[318 427 132  64 496],450,5,15771,4.6645962732919255,80.0,0.0
3381,0,3381,[318 427 132  64 496],450,5,15776,4.664695446481372,80.0,0.0
3382,0,3382,[318 427 132  64 496],151,5,15781,4.664794561040496,80.0,0.0
3383,0,3383,[318 427 132  64 496],450,5,15786,4.664893617021277,80.0,0.0
3384,0,3384,[318 427 132  64 496],151,5,15791,4.6649926144756275,80.0,0.0
3385,0,3385,[318 427 132  64 496],577,5,15796,4.6650915534554045,80.0,0.0
3386,0,3386,[318 427 132  64 496],151,5,15801,4.6651904340124,80.0,0.0
3387,0,3387,[ 89 195 322 197 172],796,3,15804,4.66469893742621,0.0,0.0
3388,0,3388,[ 70 265 185 333 216],655,2,15806,4.663912658601357,0.0,0.0
3389,0,3389,[318 427 132  64 496],577,5,15811,4.664011799410029,80.0,0.0
3390,0,3390,[318 427 132  64 496],151,5,15816,4.664110881745798,80.0,0.0
3391,0,3391,[318 427 132  64 496],330,5,15821,4.664209905660377,80.0,0.0
3392,0,3392,[318 427 132  64 496],535,5,15826,4.664308871205423,80.0,0.0
3393,0,3393,[318 427 132  64 496],535,5,15831,4.664407778432528,80.0,0.0
3394,0,3394,[318 427 132  64 496],450,5,15836,4.664506627393226,80.0,0.0
3395,0,3395,[318 427 132  64 496],716,5,15841,4.664605418138987,80.0,0.0
3396,0,3396,[318 427 132  64 496],796,5,15846,4.664704150721224,80.0,0.0
3397,0,3397,[125  70 100 181 210],457,5,15851,4.664802825191289,0.0,20.0
3398,0,3398,[318 427 132  64 496],450,5,15856,4.66490144160047,80.0,0.0
3399,0,3399,[318 427 132  64 496],330,5,15861,4.665,80.0,0.0
3400,0,3400,[318 427 132  64 496],450,5,15866,4.665098500441046,80.0,0.0
3401,0,3401,[318 427 132  64 496],151,5,15871,4.66519694297472,80.0,0.0
3402,0,3402,[318 427 132  64 496],151,5,15876,4.665295327652072,80.0,0.0
3403,0,3403,[318 427 132  64 496],151,5,15881,4.665393654524089,80.0,0.0
3404,0,3404,[318 427 132  64 496],18,5,15886,4.665491923641703,80.0,0.0
3405,0,3405,[318 427 132  64 496],577,5,15891,4.665590135055784,80.0,0.0
3406,0,3406,[318 427 132  64 496],18,5,15896,4.665688288817141,80.0,0.0
3407,0,3407,[318 427 132  64 496],716,5,15901,4.665786384976526,80.0,0.0
3408,0,3408,[318 427 132  64 496],269,5,15906,4.665884423584629,80.0,0.0
3409,0,3409,[318 427 132  64 496],577,5,15911,4.665982404692082,80.0,0.0
3410,0,3410,[318 427 132  64 496],716,5,15916,4.666080328349458,80.0,0.0
3411,0,3411,[318 427 132  64 496],577,5,15921,4.6661781946072685,80.0,0.0
3412,0,3412,[318 427 132  64 496],535,5,15926,4.666276003515969,80.0,0.0
3413,0,3413,[318 427 132  64 496],556,5,15931,4.666373755125952,80.0,0.0
3414,0,3414,[318 427 132  64 496],151,5,15936,4.666471449487555,80.0,0.0
3415,0,3415,[318 427 132  64 496],236,4,15940,4.666276346604215,80.0,0.0
3416,0,3416,[318 427 132  64 496],796,5,15945,4.666374012291484,80.0,0.0
3417,0,3417,[318 427 132  64 496],330,5,15950,4.666471620830896,80.0,0.0
3418,0,3418,[318 427 132  64 496],330,5,15955,4.666569172272594,80.0,0.0
3419,0,3419,[195 435 300  64 153],535,4,15959,4.666374269005848,20.0,0.0
3420,0,3420,[427 318 132  64 496],577,5,15964,4.666471791873721,80.0,0.0
3421,0,3421,[427 318 132  64 496],535,5,15969,4.666569257744009,80.0,0.0
3422,0,3422,[427 318 132  64 496],18,5,15974,4.666666666666667,80.0,0.0
3423,0,3423,[427 318 132  64 496],535,5,15979,4.666764018691588,80.0,0.0
3424,0,3424,[427 318 132  64 496],716,5,15984,4.666861313868613,80.0,0.0
3425,0,3425,[271  89 234 302 181],655,2,15986,4.666082895504962,0.0,0.0
3426,0,3426,[427 318 132  64 496],330,5,15991,4.666180332652465,80.0,0.0
3427,0,3427,[427 318 132  64 496],577,5,15996,4.666277712952159,80.0,0.0
3428,0,3428,[234  15 568 228 181],655,0,15996,4.664916885389326,0.0,0.0
3429,0,3429,[427 318 132  64 496],450,5,16001,4.665014577259475,80.0,0.0
3430,0,3430,[427 318 132  64 496],535,5,16006,4.665112212183037,80.0,0.0
3431,0,3431,[427 318 132  64 496],269,5,16011,4.66520979020979,80.0,0.0
3432,0,3432,[427 318 132  64 496],535,5,16016,4.665307311389455,80.0,0.0
3433,0,3433,[427 318 132  64 496],716,5,16021,4.6654047757716945,80.0,0.0
3434,0,3434,[427 318 132  64 496],556,5,16026,4.6655021834061134,80.0,0.0
3435,0,3435,[427 318 132  64 496],330,5,16031,4.665599534342259,80.0,0.0
3436,0,3436,[427 318 132  64 496],577,5,16036,4.665696828629619,80.0,0.0
3437,0,3437,[427 318 132  64 496],236,4,16040,4.665503199534613,80.0,0.0
3438,0,3438,[427 318 132  64 496],796,5,16045,4.665600465251527,80.0,0.0
3439,0,3439,[427 318 132  64 496],450,5,16050,4.665697674418604,80.0,0.0
3440,0,3440,[185  96 546 235  89],457,3,16053,4.665213600697472,0.0,0.0
3441,0,3441,[427 318 132  64 496],577,5,16058,4.665310865775711,80.0,0.0
3442,0,3442,[427 318 132  64 496],577,5,16063,4.665408074353762,80.0,0.0
3443,0,3443,[427 318 132  64 496],577,5,16068,4.665505226480836,80.0,0.0
3444,0,3444,[302  98 185 125  15],151,4,16072,4.665312046444122,0.0,0.0
3445,0,3445,[427 318 132  64 496],716,5,16077,4.665409170052235,80.0,0.0
3446,0,3446,[427 318 132  64 496],330,5,16082,4.665506237307804,80.0,0.0
3447,0,3447,[ 69 238 302 161 204],450,5,16087,4.665603248259861,0.0,0.0
3448,0,3448,[427 318 132  64 496],236,4,16091,4.665410263844593,80.0,0.0
3449,0,3449,[427 318 132  64 496],151,5,16096,4.665507246376811,80.0,0.0
3450,0,3450,[427 318 132  64 496],796,5,16101,4.665604172703564,80.0,0.0
3451,0,3451,[427 318 132  64 496],535,5,16106,4.665701042873696,80.0,0.0
3452,0,3452,[427 318 132  64 496],269,5,16111,4.665797856935997,80.0,0.0
3453,0,3453,[427 318 132  64 496],535,5,16116,4.665894614939201,80.0,0.0
3454,0,3454,[427 318 132  64 496],450,5,16121,4.665991316931983,80.0,0.0
3455,0,3455,[427 318 132  64 496],577,5,16126,4.666087962962963,80.0,0.0
3456,0,3456,[427 318 132  64 496],577,5,16131,4.666184553080706,80.0,0.0
3457,0,3457,[427 318 132  64 496],450,5,16136,4.666281087333719,80.0,0.0
3458,0,3458,[427 318 132  64 496],18,5,16141,4.666377565770454,80.0,0.0
3459,0,3459,[427 318 132  64 496],269,5,16146,4.666473988439306,80.0,0.0
3460,0,3460,[427 318 132  64 496],269,5,16151,4.666570355388616,80.0,0.0
3461,0,3461,[427 318 132  64 496],236,4,16155,4.6663778162911616,80.0,0.0
3462,0,3462,[427 318 132  64 496],577,5,16160,4.666474155356627,80.0,0.0
3463,0,3463,[427 318 132  64 496],450,5,16165,4.666570438799076,80.0,0.0
3464,0,3464,[427 318 132  64 496],269,5,16170,4.666666666666667,80.0,0.0
3465,0,3465,[427 318 132  64 496],556,5,16175,4.666762839007501,80.0,0.0
3466,0,3466,[427 318 132  64 496],796,5,16180,4.666858955869628,80.0,0.0
3467,0,3467,[427 318 132  64 496],450,5,16185,4.666955017301038,80.0,0.0
3468,0,3468,[427 318 132  64 496],269,5,16190,4.667051023349669,80.0,0.0
3469,0,3469,[427 318 132  64 496],236,4,16194,4.66685878962536,80.0,0.0
3470,0,3470,[385 269 182   8 111],796,4,16198,4.666666666666667,0.0,0.0
3471,0,3471,[427 318 132  64 496],330,5,16203,4.66676267281106,80.0,0.0
3472,0,3472,[427 318 132  64 496],556,5,16208,4.666858623668299,80.0,0.0
3473,0,3473,[427 318 132  64 496],796,5,16213,4.666954519286126,80.0,0.0
3474,0,3474,[427 318 132  64 496],330,5,16218,4.66705035971223,80.0,0.0
3475,0,3475,[427 318 132  64 496],796,5,16223,4.667146144994247,80.0,0.0
3476,0,3476,[427 318 132  64 496],716,5,16228,4.667241875179752,80.0,0.0
3477,0,3477,[403 423  11 216 471],655,1,16229,4.666187464059805,0.0,0.0
3478,0,3478,[318 427 132  64 496],18,5,16234,4.666283414774361,80.0,0.0
3479,0,3479,[318 427 132  64 496],269,5,16239,4.666379310344827,80.0,0.0
3480,0,3480,[318 427 132  64 496],577,5,16244,4.66647515081873,80.0,0.0
3481,0,3481,[318 427 132  64 496],269,5,16249,4.666570936243538,80.0,0.0
3482,0,3482,[318 427 132  64 496],577,5,16254,4.666666666666667,80.0,0.0
3483,0,3483,[318 427 132  64 496],535,5,16259,4.666762342135477,80.0,0.0
3484,0,3484,[318 427 132  64 496],330,5,16264,4.666857962697274,80.0,0.0
3485,0,3485,[318 427 132  64 496],151,5,16269,4.666953528399311,80.0,0.0
3486,0,3486,[318 427 132  64 496],330,5,16274,4.667049039288787,80.0,0.0
3487,0,3487,[ 56  28 405 183 196],796,4,16278,4.666857798165138,0.0,0.0
3488,0,3488,[ 79 405 135 153  82],716,4,16282,4.666666666666667,0.0,0.0
3489,0,3489,[318 427 132  64 496],330,5,16287,4.66676217765043,80.0,0.0
3490,0,3490,[318 427 132  64 496],151,5,16292,4.666857633915783,80.0,0.0
3491,0,3491,[318 427 132  64 496],450,5,16297,4.666953035509737,80.0,0.0
3492,0,3492,[318 427 132  64 496],236,4,16301,4.666762095619811,80.0,0.0
3493,0,3493,[318 427 132  64 496],269,5,16306,4.666857469948483,80.0,0.0
3494,0,3494,[318 427 132  64 496],330,5,16311,4.666952789699571,80.0,0.0
3495,0,3495,[318 427 132  64 496],450,5,16316,4.667048054919908,80.0,0.0
3496,0,3496,[318 427 132  64 496],450,5,16321,4.667143265656277,80.0,0.0
3497,0,3497,[ 25 183 174 748 237],450,4,16325,4.666952544311035,0.0,0.0
3498,0,3498,[318 427 132  64 496],716,5,16330,4.667047727922263,80.0,0.0
3499,0,3499,[318 427 132  64 496],535,5,16335,4.667142857142857,80.0,0.0
3500,0,3500,[318 427 132  64 496],577,5,16340,4.667237932019423,80.0,0.0
3501,0,3501,[318 427 132  64 496],151,5,16345,4.667332952598515,80.0,0.0
3502,0,3502,[318 427 132  64 496],330,5,16350,4.667427918926634,80.0,0.0
3503,0,3503,[318 427 132  64 496],796,5,16355,4.667522831050229,80.0,0.0
3504,0,3504,[318 427 132  64 496],577,5,16360,4.6676176890156915,80.0,0.0
3505,0,3505,[318 427 132  64 496],577,5,16365,4.6677124928693665,80.0,0.0
3506,0,3506,[318 427 132  64 496],796,5,16370,4.667807242657542,80.0,0.0
3507,0,3507,[318 427 132  64 496],577,5,16375,4.6679019384264535,80.0,0.0
3508,0,3508,[318 427 132  64 496],151,5,16380,4.667996580222286,80.0,0.0
3509,0,3509,[318 427 132  64 496],556,5,16385,4.668091168091168,80.0,0.0
3510,0,3510,[318 427 132  64 496],269,5,16390,4.66818570207918,80.0,0.0
3511,0,3511,[318 427 132  64 496],18,5,16395,4.668280182232346,80.0,0.0
3512,0,3512,[318 427 132  64 496],716,5,16400,4.668374608596641,80.0,0.0
3513,0,3513,[318 427 132  64 496],18,5,16405,4.668468981217985,80.0,0.0
3514,0,3514,[318 427 132  64 496],269,5,16410,4.668563300142248,80.0,0.0
3515,0,3515,[318 427 132  64 496],151,5,16415,4.668657565415245,80.0,0.0
3516,0,3516,[318 427 132  64 496],151,5,16420,4.668751777082741,80.0,0.0
3517,0,3517,[318 427 132  64 496],236,4,16424,4.668561682774303,80.0,0.0
3518,0,3518,[318 427 132  64 496],269,5,16429,4.668655868144359,80.0,0.0
3519,0,3519,[318 427 132  64 496],18,5,16434,4.66875,80.0,0.0
3520,0,3520,[318 427 132  64 496],151,5,16439,4.668844078386822,80.0,0.0
3521,0,3521,[318 427 132  64 496],556,5,16444,4.668938103350369,80.0,0.0
3522,0,3522,[318 427 132  64 496],269,5,16449,4.669032074936134,80.0,0.0
3523,0,3523,[318 427 132  64 496],450,5,16454,4.6691259931895575,80.0,0.0
3524,0,3524,[318 427 132  64 496],577,5,16459,4.669219858156028,80.0,0.0
3525,0,3525,[318 427 132  64 496],269,5,16464,4.669313669880885,80.0,0.0
3526,0,3526,[318 427 132  64 496],535,5,16469,4.669407428409413,80.0,0.0
3527,0,3527,[318 427 132  64 496],236,4,16473,4.66921768707483,80.0,0.0
3528,0,3528,[318 427 132  64 496],236,4,16477,4.669028053272882,80.0,0.0
3529,0,3529,[318 427 132  64 496],796,5,16482,4.669121813031161,80.0,0.0
3530,0,3530,[204 183  82   9 282],457,5,16487,4.669215519682809,0.0,0.0
3531,0,3531,[318 427 132  64 496],450,5,16492,4.669309173272933,80.0,0.0
3532,0,3532,[318 427 132  64 496],716,5,16497,4.669402773846589,80.0,0.0
3533,0,3533,[318 427 132  64 496],236,4,16501,4.669213355970571,80.0,0.0
3534,0,3534,[318 427 132  64 496],577,5,16506,4.669306930693069,80.0,0.0
3535,0,3535,[318 427 132  64 496],716,5,16511,4.669400452488688,80.0,0.0
3536,0,3536,[318 427 132  64 496],556,5,16516,4.669493921402318,80.0,0.0
3537,0,3537,[258 357 132 471 655],693,3,16519,4.669022046353872,0.0,0.0
3538,0,3538,[318 427 132  64 496],18,5,16524,4.669115569369879,80.0,0.0
3539,0,3539,[318 427 132  64 496],535,5,16529,4.669209039548023,80.0,0.0
3540,0,3540,[318 427 132  64 496],330,5,16534,4.66930245693307,80.0,0.0
3541,0,3541,[318 427 132  64 496],535,5,16539,4.669395821569735,80.0,0.0
3542,0,3542,[318 427 132  64 496],450,5,16544,4.669489133502681,80.0,0.0
3543,0,3543,[318 427 132  64 496],236,4,16548,4.669300225733634,80.0,0.0
3544,0,3544,[318 427 132  64 496],796,5,16553,4.669393511988717,80.0,0.0
3545,0,3545,[318 427 132  64 496],151,5,16558,4.669486745628878,80.0,0.0
3546,0,3546,[318 427 132  64 496],18,5,16563,4.669579926698619,80.0,0.0
3547,0,3547,[318 427 132  64 496],269,5,16568,4.66967305524239,80.0,0.0
3548,0,3548,[318 427 132  64 496],236,4,16572,4.669484361792054,80.0,0.0
3549,0,3549,[318 427 132  64 496],151,5,16577,4.669577464788732,80.0,0.0
3550,0,3550,[318 427 132  64 496],577,5,16582,4.669670515347789,80.0,0.0
3551,0,3551,[318 427 132  64 496],330,5,16587,4.669763513513513,80.0,0.0
3552,0,3552,[210 302 127 275 132],344,5,16592,4.669856459330144,0.0,40.0
3553,0,3553,[427 318 132  64 496],330,5,16597,4.6699493528418685,80.0,0.0
3554,0,3554,[427 318 132  64 496],450,5,16602,4.670042194092827,80.0,0.0
3555,0,3555,[427 318 132  64 496],716,5,16607,4.6701349831271095,80.0,0.0
3556,0,3556,[191 121 222 235  70],457,4,16611,4.669946584200169,0.0,0.0
3557,0,3557,[318 427 132  64 496],450,5,16616,4.670039347948285,80.0,0.0
3558,0,3558,[318 427 132  64 496],556,5,16621,4.670132059567294,80.0,0.0
3559,0,3559,[318 427 132  64 496],535,5,16626,4.670224719101124,80.0,0.0
3560,0,3560,[318 427 132  64 496],535,5,16631,4.670317326593653,80.0,0.0
3561,0,3561,[318 427 132  64 496],716,5,16636,4.670409882088714,80.0,0.0
3562,0,3562,[318 427 132  64 496],269,5,16641,4.670502385630087,80.0,0.0
3563,0,3563,[318 427 132  64 496],577,5,16646,4.670594837261504,80.0,0.0
3564,0,3564,[318 427 132  64 496],269,5,16651,4.670687237026648,80.0,0.0
3565,0,3565,[318 427 132  64 496],18,5,16656,4.670779584969153,80.0,0.0
3566,0,3566,[318 427 132  64 496],535,5,16661,4.670871881132604,80.0,0.0
3567,0,3567,[318 427 132  64 496],535,5,16666,4.6709641255605385,80.0,0.0
3568,0,3568,[318 427 132  64 496],535,5,16671,4.671056318296442,80.0,0.0
3569,0,3569,[318 427 132  64 496],556,5,16676,4.671148459383754,80.0,0.0
3570,0,3570,[318 427 132  64 496],577,5,16681,4.671240548865864,80.0,0.0
3571,0,3571,[318 427 132  64 496],577,5,16686,4.671332586786114,80.0,0.0
3572,0,3572,[318 427 132  64 496],18,5,16691,4.671424573187798,80.0,0.0
3573,0,3573,[318 427 132  64 496],796,5,16696,4.671516508114157,80.0,0.0
3574,0,3574,[318 427 132  64 496],577,5,16701,4.671608391608392,80.0,0.0
3575,0,3575,[318 427 132  64 496],450,5,16706,4.671700223713646,80.0,0.0
3576,0,3576,[318 427 132  64 496],716,5,16711,4.671792004473022,80.0,0.0
3577,0,3577,[318 427 132  64 496],556,5,16716,4.67188373392957,80.0,0.0
3578,0,3578,[318 427 132  64 496],330,5,16721,4.671975412126292,80.0,0.0
3579,0,3579,[318 427 132  64 496],236,4,16725,4.671787709497207,80.0,0.0
3580,0,3580,[318 427 132  64 496],577,5,16730,4.671879363306339,80.0,0.0
3581,0,3581,[318 427 132  64 496],577,5,16735,4.671970965940815,80.0,0.0
3582,0,3582,[318 427 132  64 496],577,5,16740,4.672062517443483,80.0,0.0
3583,0,3583,[318 427 132  64 496],236,4,16744,4.671875,80.0,0.0
3584,0,3584,[318 427 132  64 496],535,5,16749,4.671966527196653,80.0,0.0
3585,0,3585,[318 427 132  64 496],236,4,16753,4.671779141104294,80.0,0.0
3586,0,3586,[318 427 132  64 496],535,5,16758,4.671870643992194,80.0,0.0
3587,0,3587,[318 427 132  64 496],269,5,16763,4.6719620958751396,80.0,0.0
3588,0,3588,[318 427 132  64 496],151,5,16768,4.6720534967957645,80.0,0.0
3589,0,3589,[318 427 132  64 496],716,5,16773,4.672144846796657,80.0,0.0
3590,0,3590,[318 427 132  64 496],236,4,16777,4.671957671957672,80.0,0.0
3591,0,3591,[318 427 132  64 275],330,5,16782,4.672048997772828,60.0,20.0
3592,0,3592,[318 427 132  64 275],316,5,16787,4.672140272752574,60.0,20.0
3593,0,3593,[318 427 132  64 275],655,4,16791,4.671953255425709,60.0,20.0
3594,0,3594,[318 427 132  64 275],450,5,16796,4.672044506258692,60.0,20.0
3595,0,3595,[318 427 132  64 275],18,5,16801,4.672135706340378,60.0,20.0
3596,0,3596,[318 427 132  64 275],796,5,16806,4.672226855713094,60.0,20.0
3597,0,3597,[318 427 132  64 275],535,5,16811,4.672317954419122,60.0,20.0
3598,0,3598,[318 427 132  64 275],450,5,16816,4.672409002500695,60.0,20.0
3599,0,3599,[216 423 496 546  12],450,5,16821,4.6725,20.0,0.0
3600,0,3600,[318 427 132  64 275],796,5,16826,4.672590946959178,60.0,20.0
3601,0,3601,[318 427 132  64 275],151,5,16831,4.672681843420322,60.0,20.0
3602,0,3602,[318 427 132  64 275],18,5,16836,4.672772689425479,60.0,20.0
3603,0,3603,[318 427 132  64 275],18,5,16841,4.672863485016649,60.0,20.0
3604,0,3604,[318 427 132  64 275],236,4,16845,4.672676837725382,60.0,20.0
3605,0,3605,[318 427 132  64 275],236,4,16849,4.67249029395452,60.0,20.0
3606,0,3606,[427 318 132  64 496],269,5,16854,4.672581092320488,80.0,0.0
3607,0,3607,[427 318 132  64 496],716,5,16859,4.672671840354767,80.0,0.0
3608,0,3608,[427 318 132  64 496],450,5,16864,4.672762538099197,80.0,0.0
3609,0,3609,[427 318 132  64 496],796,5,16869,4.672853185595568,80.0,0.0
3610,0,3610,[427 318 132  64 496],577,5,16874,4.6729437828856275,80.0,0.0
3611,0,3611,[427 318 132  64 496],269,5,16879,4.673034330011074,80.0,0.0
3612,0,3612,[427 318 132  64 496],556,5,16884,4.673124827013562,80.0,0.0
3613,0,3613,[427 318 132  64 496],535,5,16889,4.673215273934699,80.0,0.0
3614,0,3614,[427 318 132  64 496],577,5,16894,4.6733056708160445,80.0,0.0
3615,0,3615,[427 318 132  64 496],716,5,16899,4.673396017699115,80.0,0.0
3616,0,3616,[427 318 132  64 496],330,5,16904,4.6734863146253804,80.0,0.0
3617,0,3617,[427 318 132  64 496],18,5,16909,4.6735765616362634,80.0,0.0
3618,0,3618,[427 318 132  64 496],151,5,16914,4.673666758773142,80.0,0.0
3619,0,3619,[427 318 132  64 496],716,5,16919,4.673756906077348,80.0,0.0
3620,0,3620,[427 318 132  64 496],716,5,16924,4.6738470035901685,80.0,0.0
3621,0,3621,[427 318 132  64 496],535,5,16929,4.673937051352843,80.0,0.0
3622,0,3622,[427 318 132  64 496],450,5,16934,4.674027049406569,80.0,0.0
3623,0,3623,[427 318 132  64 496],716,5,16939,4.674116997792495,80.0,0.0
3624,0,3624,[427 318 132  64 496],716,5,16944,4.674206896551724,80.0,0.0
3625,0,3625,[427 318 132  64 496],577,5,16949,4.674296745725317,80.0,0.0
3626,0,3626,[427 318 132  64 496],236,4,16953,4.674110835401158,80.0,0.0
3627,0,3627,[427 318 132  64 496],269,5,16958,4.6742006615215,80.0,0.0
3628,0,3628,[427 318 132  64 496],269,5,16963,4.674290438137228,80.0,0.0
3629,0,3629,[427 318 132  64 496],577,5,16968,4.674380165289256,80.0,0.0
3630,0,3630,[427 318 132  64 496],330,5,16973,4.674469843018453,80.0,0.0
3631,0,3631,[427 318 132  64 496],450,5,16978,4.674559471365638,80.0,0.0
3632,0,3632,[427 318 132  64 496],151,5,16983,4.674649050371594,80.0,0.0
3633,0,3633,[427 318 132  64 496],330,5,16988,4.67473858007705,80.0,0.0
3634,0,3634,[427 318 132  64 496],716,5,16993,4.674828060522696,80.0,0.0
3635,0,3635,[427 318 132  64 496],330,5,16998,4.6749174917491745,80.0,0.0
3636,0,3636,[427 318 132  64 496],18,5,17003,4.675006873797085,80.0,0.0
3637,0,3637,[427 318 132  64 496],450,5,17008,4.675096206706982,80.0,0.0
3638,0,3638,[427 318 132  64 496],577,5,17013,4.6751854905193735,80.0,0.0
3639,0,3639,[427 318 132  64 496],577,5,17018,4.6752747252747255,80.0,0.0
3640,0,3640,[427 318 132  64 496],18,5,17023,4.6753639110134575,80.0,0.0
3641,0,3641,[302  82   4  11  88],655,1,17024,4.6743547501372875,0.0,0.0
3642,0,3642,[427 318 132  64 496],269,5,17029,4.674444139445512,80.0,0.0
3643,0,3643,[427 318 132  64 496],577,5,17034,4.674533479692646,80.0,0.0
3644,0,3644,[427 318 132  64 496],796,5,17039,4.6746227709190675,80.0,0.0
3645,0,3645,[427 318 132  64 496],796,5,17044,4.674712013165112,80.0,0.0
3646,0,3646,[496 125 204 144 143],450,5,17049,4.674801206471072,20.0,0.0
3647,0,3647,[427 318 132  64 496],236,4,17053,4.6746162280701755,80.0,0.0
3648,0,3648,[427 318 132  64 496],236,4,17057,4.674431351055084,80.0,0.0
3649,0,3649,[427 318 132  64 496],151,5,17062,4.674520547945206,80.0,0.0
3650,0,3650,[427 318 132  64 496],18,5,17067,4.674609695973706,80.0,0.0
3651,0,3651,[427 318 132  64 496],18,5,17072,4.674698795180723,80.0,0.0
3652,0,3652,[427 318 132  64 496],796,5,17077,4.6747878456063505,80.0,0.0
3653,0,3653,[427 318 132  64 496],269,5,17082,4.674876847290641,80.0,0.0
3654,0,3654,[427 318 132  64 496],151,5,17087,4.674965800273598,80.0,0.0
3655,0,3655,[427 318 132  64 496],716,5,17092,4.675054704595186,80.0,0.0
3656,0,3656,[427 318 132  64 496],535,5,17097,4.675143560295324,80.0,0.0
3657,0,3657,[427 318 132  64 496],151,5,17102,4.675232367413887,80.0,0.0
3658,0,3658,[427 318 132  64 496],450,5,17107,4.675321125990708,80.0,0.0
3659,0,3659,[427 318 132  64 496],556,5,17112,4.675409836065573,80.0,0.0
3660,0,3660,[427 318 132  64 496],716,5,17117,4.67549849767823,80.0,0.0
3661,0,3661,[427 318 132  64 496],330,5,17122,4.675587110868378,80.0,0.0
3662,0,3662,[427 318 132  64 496],535,5,17127,4.675675675675675,80.0,0.0
3663,0,3663,[427 318 132  64 496],450,5,17132,4.675764192139738,80.0,0.0
3664,0,3664,[427 318 132  64 496],330,5,17137,4.675852660300136,80.0,0.0
3665,0,3665,[427 318 132  64 496],450,5,17142,4.6759410801964,80.0,0.0
3666,0,3666,[427 318 132  64 496],236,4,17146,4.675756749386419,80.0,0.0
3667,0,3667,[427 318 132  64 496],796,5,17151,4.675845147219193,80.0,0.0
3668,0,3668,[427 318 132  64 496],269,5,17156,4.675933496865631,80.0,0.0
3669,0,3669,[427 318 132  64 496],716,5,17161,4.676021798365123,80.0,0.0
3670,0,3670,[483 568 180 238 323],796,2,17163,4.67529283573958,0.0,0.0
3671,0,3671,[427 318 132  64 496],577,5,17168,4.675381263616558,80.0,0.0
3672,0,3672,[427 318 132  64 496],577,5,17173,4.675469643343316,80.0,0.0
3673,0,3673,[427 318 132  64 496],716,5,17178,4.6755579749591725,80.0,0.0
3674,0,3674,[427 318 132  64 496],535,5,17183,4.675646258503401,80.0,0.0
3675,0,3675,[427 318 132  64 496],151,5,17188,4.675734494015234,80.0,0.0
3676,0,3676,[427 318 132  64 496],269,5,17193,4.675822681533859,80.0,0.0
3677,0,3677,[427 318 132  64 496],556,5,17198,4.675910821098423,80.0,0.0
3678,0,3678,[427 318 132  64 496],450,5,17203,4.675998912748029,80.0,0.0
3679,0,3679,[427 318 132  64 496],716,5,17208,4.676086956521739,80.0,0.0
3680,0,3680,[427 318 132  64 496],450,5,17213,4.676174952458571,80.0,0.0
3681,0,3681,[427 318 132  64 496],796,5,17218,4.676262900597501,80.0,0.0
3682,0,3682,[427 318 132  64 496],151,5,17223,4.676350800977464,80.0,0.0
3683,0,3683,[427 318 132  64 496],18,5,17228,4.676438653637351,80.0,0.0
3684,0,3684,[427 318 132  64 496],796,5,17233,4.676526458616011,80.0,0.0
3685,0,3685,[427 318 132  64 496],236,4,17237,4.676342919153554,80.0,0.0
3686,0,3686,[427 318 132  64 496],577,5,17242,4.6764307024681315,80.0,0.0
3687,0,3687,[427 318 132  64 496],269,5,17247,4.676518438177874,80.0,0.0
3688,0,3688,[427 318 132  64 496],18,5,17252,4.676606126321496,80.0,0.0
3689,0,3689,[427 318 132  64 496],330,5,17257,4.676693766937669,80.0,0.0
3690,0,3690,[427 318 132  64 496],535,5,17262,4.676781360065023,80.0,0.0
3691,0,3691,[427 318 132  64 496],269,5,17267,4.676868905742145,80.0,0.0
3692,0,3692,[427 318 132  64 496],577,5,17272,4.676956404007582,80.0,0.0
3693,0,3693,[427 318 132  64 496],796,5,17277,4.677043854899837,80.0,0.0
3694,0,3694,[427 318 132  64 496],18,5,17282,4.677131258457375,80.0,0.0
3695,0,3695,[427 318 132  64 496],18,5,17287,4.6772186147186146,80.0,0.0
3696,0,3696,[427 318 132  64 496],18,5,17292,4.677305923721937,80.0,0.0
3697,0,3697,[427 318 132  64 496],330,5,17297,4.677393185505679,80.0,0.0
3698,0,3698,[427 318 132  64 496],535,5,17302,4.677480400108137,80.0,0.0
3699,0,3699,[427 318 132  64 496],716,5,17307,4.677567567567568,80.0,0.0
3700,0,3700,[427 318 132  64 496],269,5,17312,4.677654687922183,80.0,0.0
3701,0,3701,[427 318 132  64 496],577,5,17317,4.677741761210156,80.0,0.0
3702,0,3702,[427 318 132  64 496],450,5,17322,4.677828787469619,80.0,0.0
3703,0,3703,[427 318 132  64 496],236,4,17326,4.677645788336933,80.0,0.0
3704,0,3704,[427 318 132  64 496],151,5,17331,4.677732793522267,80.0,0.0
3705,0,3705,[427 318 132  64 496],577,5,17336,4.677819751753913,80.0,0.0
3706,0,3706,[427 318 132  64 496],236,4,17340,4.677636903156191,80.0,0.0
3707,0,3707,[427 318 132  64 496],716,5,17345,4.6777238403452,80.0,0.0
3708,0,3708,[427 318 132  64 496],796,5,17350,4.677810730655163,80.0,0.0
3709,0,3709,[568 179  71 318 288],450,3,17353,4.6773584905660375,20.0,0.0
3710,0,3710,[427 318 132  64 496],796,5,17358,4.677445432497979,80.0,0.0
3711,0,3711,[427 318 132  64 496],236,4,17362,4.677262931034483,80.0,0.0
3712,0,3712,[427 318 132  64 496],556,5,17367,4.677349851871802,80.0,0.0
3713,0,3713,[427 318 132  64 496],330,5,17372,4.677436725901993,80.0,0.0
3714,0,3714,[427 318 132  64 496],716,5,17377,4.677523553162853,80.0,0.0
3715,0,3715,[427 318 132  64 496],269,5,17382,4.677610333692142,80.0,0.0
3716,0,3716,[427 318 132  64 496],236,4,17386,4.677428033360237,80.0,0.0
3717,0,3717,[288 475 174  28 151],292,4,17390,4.677245831091985,0.0,0.0
3718,0,3718,[427 318 132  64 496],796,5,17395,4.677332616294703,80.0,0.0
3719,0,3719,[427 318 132  64 496],535,5,17400,4.67741935483871,80.0,0.0
3720,0,3720,[427 318 132  64 496],716,5,17405,4.677506046761623,80.0,0.0
3721,0,3721,[427 318 132  64 496],716,5,17410,4.677592692101021,80.0,0.0
3722,0,3722,[427 318 132  64 496],716,5,17415,4.67767929089444,80.0,0.0
3723,0,3723,[427 318 132  64 496],18,5,17420,4.677765843179377,80.0,0.0
3724,0,3724,[427 318 132  64 496],330,5,17425,4.677852348993288,80.0,0.0
3725,0,3725,[427 318 132  64 496],796,5,17430,4.677938808373591,80.0,0.0
3726,0,3726,[427 318 132  64 496],535,5,17435,4.67802522135766,80.0,0.0
3727,0,3727,[427 318 132  64 496],450,5,17440,4.6781115879828326,80.0,0.0
3728,0,3728,[427 318 132  64 496],269,5,17445,4.678197908286404,80.0,0.0
3729,0,3729,[427 318 132  64 496],796,5,17450,4.67828418230563,80.0,0.0
3730,0,3730,[427 318 132  64 496],330,5,17455,4.6783704100777275,80.0,0.0
3731,0,3731,[427 318 132  64 496],577,5,17460,4.678456591639871,80.0,0.0
3732,0,3732,[427 318 132  64 496],18,5,17465,4.678542727029199,80.0,0.0
3733,0,3733,[427 318 132  64 496],236,4,17469,4.678361006963042,80.0,0.0
3734,0,3734,[427 318 132  64 496],577,5,17474,4.678447121820616,80.0,0.0
3735,0,3735,[427 318 132  64 496],716,5,17479,4.678533190578158,80.0,0.0
3736,0,3736,[427 318 132  64 496],269,5,17484,4.678619213272679,80.0,0.0
3737,0,3737,[427 318 132  64 496],269,5,17489,4.678705189941145,80.0,0.0
3738,0,3738,[195 678  15 245 403],256,5,17494,4.678791120620486,0.0,0.0
3739,0,3739,[603 174 483 172  15],796,5,17499,4.678877005347593,20.0,0.0
3740,0,3740,[ 15 194   7 238 127],269,3,17502,4.678428227746592,0.0,20.0
3741,0,3741,[678 318 427 132  64],316,4,17506,4.678246926777125,60.0,0.0
3742,0,3742,[318 427 132  64 496],796,5,17511,4.6783328880577075,80.0,0.0
3743,0,3743,[318 427 132  64 496],716,5,17516,4.678418803418803,80.0,0.0
3744,0,3744,[318 427 132  64 496],151,5,17521,4.678504672897196,80.0,0.0
3745,0,3745,[318 427 132  64 496],716,5,17526,4.678590496529631,80.0,0.0
3746,0,3746,[318 427 132  64 496],151,5,17531,4.678676274352815,80.0,0.0
3747,0,3747,[ 97 655 181 211  98],504,4,17535,4.678495197438634,0.0,0.0
3748,0,3748,[318 427 132  64 496],796,5,17540,4.678580954921312,80.0,0.0
3749,0,3749,[ 88 196 265 194 215],151,4,17544,4.6784,0.0,0.0
3750,0,3750,[318 427 132  64 496],796,5,17549,4.678485737136763,80.0,0.0
3751,0,3751,[318 427 132  64 496],577,5,17554,4.678571428571429,80.0,0.0
3752,0,3752,[318 427 132  64 496],236,4,17558,4.678390620836664,80.0,0.0
3753,0,3753,[318 427 132  64 496],450,5,17563,4.678476291955247,80.0,0.0
3754,0,3754,[257 357 322  28 180],796,2,17565,4.677762982689747,0.0,0.0
3755,0,3755,[318 427 132  64 496],450,5,17570,4.677848775292865,80.0,0.0
3756,0,3756,[318 427 132  64 496],796,5,17575,4.67793452222518,80.0,0.0
3757,0,3757,[318 427 132  64 496],269,5,17580,4.67802022352315,80.0,0.0
3758,0,3758,[318 427 132  64 496],716,5,17585,4.678105879223198,80.0,0.0
3759,0,3759,[318 427 132  64 496],450,5,17590,4.678191489361702,80.0,0.0
3760,0,3760,[318 427 132  64 496],796,5,17595,4.678277053975006,80.0,0.0
3761,0,3761,[318 427 132  64 496],535,5,17600,4.678362573099415,80.0,0.0
3762,0,3762,[318 427 132  64 496],269,5,17605,4.6784480467711935,80.0,0.0
3763,0,3763,[318 427 132  64 496],236,4,17609,4.67826780021254,80.0,0.0
3764,0,3764,[318 427 132  64 496],535,5,17614,4.678353253652058,80.0,0.0
3765,0,3765,[318 427 132  64 496],330,5,17619,4.678438661710037,80.0,0.0
3766,0,3766,[318 427 132  64 496],577,5,17624,4.678524024422617,80.0,0.0
3767,0,3767,[318 427 132  64 496],18,5,17629,4.6786093418259025,80.0,0.0
3768,0,3768,[318 427 132  64 496],330,5,17634,4.678694613955956,80.0,0.0
3769,0,3769,[318 427 132  64 496],18,5,17639,4.678779840848806,80.0,0.0
3770,0,3770,[318 427 132  64 496],330,5,17644,4.67886502254044,80.0,0.0
3771,0,3771,[318 427 132  64 496],535,5,17649,4.678950159066808,80.0,0.0
3772,0,3772,[318 427 132  64 496],577,5,17654,4.679035250463822,80.0,0.0
3773,0,3773,[318 427 132  64 496],330,5,17659,4.679120296767356,80.0,0.0
3774,0,3774,[318 427 132  64 496],716,5,17664,4.679205298013245,80.0,0.0
3775,0,3775,[318 427 132  64 496],18,5,17669,4.679290254237288,80.0,0.0
3776,0,3776,[318 427 132  64 496],796,5,17674,4.679375165475245,80.0,0.0
3777,0,3777,[318 427 132  64 496],269,5,17679,4.679460031762837,80.0,0.0
3778,0,3778,[318 427 132  64 496],151,5,17684,4.67954485313575,80.0,0.0
3779,0,3779,[318 427 132  64 496],796,5,17689,4.67962962962963,80.0,0.0
3780,0,3780,[318 427 132  64 496],716,5,17694,4.679714361280085,80.0,0.0
3781,0,3781,[318 427 132  64 496],577,5,17699,4.679799048122686,80.0,0.0
3782,0,3782,[318 427 132  64 496],796,5,17704,4.679883690192969,80.0,0.0
3783,0,3783,[318 427 132  64 496],269,5,17709,4.679968287526427,80.0,0.0
3784,0,3784,[318 427 132  64 496],18,5,17714,4.68005284015852,80.0,0.0
3785,0,3785,[318 427 132  64 496],18,5,17719,4.68013734812467,80.0,0.0
3786,0,3786,[318 427 132  64 496],450,5,17724,4.6802218114602585,80.0,0.0
3787,0,3787,[318 427 132  64 496],450,5,17729,4.6803062302006335,80.0,0.0
3788,0,3788,[318 427 132  64 496],535,5,17734,4.680390604381103,80.0,0.0
3789,0,3789,[318 427 132  64 496],269,5,17739,4.68047493403694,80.0,0.0
3790,0,3790,[318 427 132  64 496],556,5,17744,4.680559219203376,80.0,0.0
3791,0,3791,[318 427 132  64 496],18,5,17749,4.680643459915612,80.0,0.0
3792,0,3792,[318 427 132  64 496],18,5,17754,4.680727656208806,80.0,0.0
3793,0,3793,[318 427 132  64 496],796,5,17759,4.680811808118081,80.0,0.0
3794,0,3794,[318 427 132  64 496],18,5,17764,4.680895915678525,80.0,0.0
3795,0,3795,[318 427 132  64 496],18,5,17769,4.680979978925184,80.0,0.0
3796,0,3796,[318 427 132  64 496],151,5,17774,4.681063997893073,80.0,0.0
3797,0,3797,[ 28 588 273 333 405],796,3,17777,4.6806213796735125,0.0,0.0
3798,0,3798,[318 427 132  64 496],330,5,17782,4.680705448802317,80.0,0.0
3799,0,3799,[318 427 132  64 496],236,4,17786,4.680526315789474,80.0,0.0
3800,0,3800,[318 427 132  64 496],330,5,17791,4.680610365693239,80.0,0.0
3801,0,3801,[318 427 132  64 496],236,4,17795,4.680431351920042,80.0,0.0
3802,0,3802,[318 427 132  64 496],236,4,17799,4.680252432290297,80.0,0.0
3803,0,3803,[318 427 132  64 496],535,5,17804,4.680336487907466,80.0,0.0
3804,0,3804,[318 427 132  64 496],269,5,17809,4.680420499342969,80.0,0.0
3805,0,3805,[318 427 132  64 496],577,5,17814,4.680504466631635,80.0,0.0
3806,0,3806,[318 427 132  64 496],269,5,17819,4.680588389808248,80.0,0.0
3807,0,3807,[318 427 132  64 496],577,5,17824,4.680672268907563,80.0,0.0
3808,0,3808,[318 427 132  64 496],535,5,17829,4.6807561039642955,80.0,0.0
3809,0,3809,[318 427 132  64 496],330,5,17834,4.680839895013123,80.0,0.0
3810,0,3810,[318 427 132  64 496],716,5,17839,4.680923642088691,80.0,0.0
3811,0,3811,[318 427 132  64 496],151,5,17844,4.681007345225604,80.0,0.0
3812,0,3812,[318 427 132  64 496],18,5,17849,4.681091004458431,80.0,0.0
3813,0,3813,[318 427 132  64 496],796,5,17854,4.68117461982171,80.0,0.0
3814,0,3814,[742  89   1 302 288],655,2,17856,4.680471821756226,0.0,0.0
3815,0,3815,[318 427 132  64 496],151,5,17861,4.680555555555555,80.0,0.0
3816,0,3816,[318 427 132  64 496],269,5,17866,4.680639245480744,80.0,0.0
3817,0,3817,[318 427 132  64 496],577,5,17871,4.680722891566265,80.0,0.0
3818,0,3818,[318 427 132  64 496],577,5,17876,4.680806493846557,80.0,0.0
3819,0,3819,[318 427 132  64 496],269,5,17881,4.680890052356021,80.0,0.0
3820,0,3820,[318 427 132  64 496],450,5,17886,4.680973567129024,80.0,0.0
3821,0,3821,[318 427 132  64 496],716,5,17891,4.681057038199896,80.0,0.0
3822,0,3822,[318 427 132  64 496],577,5,17896,4.68114046560293,80.0,0.0
3823,0,3823,[204 168  50 405 143],457,5,17901,4.681223849372385,0.0,20.0
3824,0,3824,[318 427 132  64 496],269,5,17906,4.681307189542483,80.0,0.0
3825,0,3825,[318 427 132  64 496],796,5,17911,4.6813904861474125,80.0,0.0
3826,0,3826,[318 427 132  64 496],556,5,17916,4.681473739221322,80.0,0.0
3827,0,3827,[318 427 132  64 496],236,4,17920,4.681295715778474,80.0,0.0
3828,0,3828,[318 427 132  64 496],535,5,17925,4.681378950117524,80.0,0.0
3829,0,3829,[318 427 132  64 496],535,5,17930,4.681462140992167,80.0,0.0
3830,0,3830,[318 427 132  64 496],151,5,17935,4.68154528843644,80.0,0.0
3831,0,3831,[318 427 132  64 496],330,5,17940,4.681628392484343,80.0,0.0
3832,0,3832,[318 427 132  64 496],236,4,17944,4.681450560918341,80.0,0.0
3833,0,3833,[328 333  64 173 435],629,4,17948,4.681272822117893,20.0,0.0
3834,0,3834,[318 427 132  64 496],330,5,17953,4.68135593220339,80.0,0.0
3835,0,3835,[318 427 132  64 496],18,5,17958,4.681438998957247,80.0,0.0
3836,0,3836,[318 427 132  64 496],556,5,17963,4.681522022413343,80.0,0.0
3837,0,3837,[318 427 132  64 496],716,5,17968,4.681605002605524,80.0,0.0
3838,0,3838,[318 427 132  64 496],330,5,17973,4.681687939567595,80.0,0.0
3839,0,3839,[237 238 174 333  50],796,4,17977,4.681510416666667,0.0,20.0
3840,0,3840,[176  71 182 588   1],796,4,17981,4.68133298620151,0.0,0.0
3841,0,3841,[318 427 132  64 496],716,5,17986,4.68141592920354,80.0,0.0
3842,0,3842,[318 427 132  64 496],535,5,17991,4.681498829039812,80.0,0.0
3843,0,3843,[318 427 132  64 496],18,5,17996,4.681581685744017,80.0,0.0
3844,0,3844,[318 427 132  64 496],236,4,18000,4.681404421326398,80.0,0.0
3845,0,3845,[318 427 132  64 496],535,5,18005,4.68148725949038,80.0,0.0
3846,0,3846,[186 151 427  56 202],269,3,18008,4.6810501689628286,20.0,0.0
3847,0,3847,[318 427 132  64 496],330,5,18013,4.681133056133056,80.0,0.0
3848,0,3848,[318 427 132  64 496],236,4,18017,4.680956092491556,80.0,0.0
3849,0,3849,[318 427 132  64 496],535,5,18022,4.681038961038961,80.0,0.0
3850,0,3850,[318 427 132  64 496],556,5,18027,4.681121786548949,80.0,0.0
3851,0,3851,[318 427 132  64 496],716,5,18032,4.681204569055036,80.0,0.0
3852,0,3852,[318 427 132  64 496],18,5,18037,4.681287308590709,80.0,0.0
3853,0,3853,[318 427 132  64 496],450,5,18042,4.681370005189414,80.0,0.0
3854,0,3854,[132 200 323 161 655],280,3,18045,4.680933852140078,0.0,0.0
3855,0,3855,[318 427 132  64 496],535,5,18050,4.681016597510373,80.0,0.0
3856,0,3856,[318 427 132  64 496],450,5,18055,4.681099299974073,80.0,0.0
3857,0,3857,[318 427 132  64 496],18,5,18060,4.681181959564541,80.0,0.0
3858,0,3858,[ 12 258 357 748 245],450,5,18065,4.681264576315107,0.0,0.0
3859,0,3859,[318 427 132  64 496],151,5,18070,4.681347150259067,80.0,0.0
3860,0,3860,[318 427 132  64 496],269,5,18075,4.681429681429681,80.0,0.0
3861,0,3861,[423 238 300  50  97],796,3,18078,4.680994303469705,0.0,20.0
3862,0,3862,[318 427 132  64 496],236,4,18082,4.6808180170851665,80.0,0.0
3863,0,3863,[318 427 132  64 496],716,5,18087,4.680900621118012,80.0,0.0
3864,0,3864,[318 427 132  64 496],450,5,18092,4.68098318240621,80.0,0.0
3865,0,3865,[318 427 132  64 496],577,5,18097,4.681065700982928,80.0,0.0
3866,0,3866,[318 427 132  64 496],151,5,18102,4.681148176881304,80.0,0.0
3867,0,3867,[318 427 132  64 496],269,5,18107,4.6812306101344365,80.0,0.0
3868,0,3868,[318 427 132  64 496],236,4,18111,4.681054536055829,80.0,0.0
3869,0,3869,[318 427 132  64 496],796,5,18116,4.681136950904393,80.0,0.0
3870,0,3870,[318 427 132  64 496],577,5,18121,4.681219323172307,80.0,0.0
3871,0,3871,[318 427 132  64 496],151,5,18126,4.681301652892562,80.0,0.0
3872,0,3872,[318 427 132  64 496],716,5,18131,4.681383940098115,80.0,0.0
3873,0,3873,[318 427 132  64 496],450,5,18136,4.68146618482189,80.0,0.0
3874,0,3874,[318 427 132  64 496],577,5,18141,4.6815483870967745,80.0,0.0
3875,0,3875,[318 427 132  64 496],796,5,18146,4.681630546955624,80.0,0.0
3876,0,3876,[318 427 132  64 496],236,4,18150,4.6814547330410115,80.0,0.0
3877,0,3877,[318 427 132  64 496],330,5,18155,4.681536874677669,80.0,0.0
3878,0,3878,[318 427 132  64 496],151,5,18160,4.681618973962362,80.0,0.0
3879,0,3879,[318 427 132  64 496],269,5,18165,4.681701030927835,80.0,0.0
3880,0,3880,[318 427 132  64 496],556,5,18170,4.681783045606802,80.0,0.0
3881,0,3881,[318 427 132  64 496],796,5,18175,4.681865018031942,80.0,0.0
3882,0,3882,[318 427 132  64 496],236,4,18179,4.681689415400464,80.0,0.0
3883,0,3883,[318 427 132  64 496],18,5,18184,4.681771369721936,80.0,0.0
3884,0,3884,[318 427 132  64 496],796,5,18189,4.681853281853281,80.0,0.0
3885,0,3885,[318 427 132  64 496],18,5,18194,4.681935151827071,80.0,0.0
3886,0,3886,[318 427 132  64 496],18,5,18199,4.682016979675843,80.0,0.0
3887,0,3887,[318 427 132  64 496],450,5,18204,4.682098765432099,80.0,0.0
3888,0,3888,[318 427 132  64 496],236,4,18208,4.681923373617897,80.0,0.0
3889,0,3889,[318 427 132  64 496],151,5,18213,4.682005141388175,80.0,0.0
3890,0,3890,[273 258 603 153  11],450,4,18217,4.681829863788229,20.0,0.0
3891,0,3891,[204  50 313 423  28],655,2,18219,4.681140801644399,0.0,20.0
3892,0,3892,[318 427 132  64 496],577,5,18224,4.681222707423581,80.0,0.0
3893,0,3893,[318 427 132  64 496],236,4,18228,4.6810477657935285,80.0,0.0
3894,0,3894,[318 427 132  64 496],577,5,18233,4.681129653401797,80.0,0.0
3895,0,3895,[318 427 132  64 496],577,5,18238,4.681211498973306,80.0,0.0
3896,0,3896,[318 427 132  64 496],450,5,18243,4.681293302540416,80.0,0.0
3897,0,3897,[318 427 132  64 496],330,5,18248,4.681375064135454,80.0,0.0
3898,0,3898,[318 427 132  64 496],577,5,18253,4.681456783790716,80.0,0.0
3899,0,3899,[318 427 132  64 496],796,5,18258,4.681538461538461,80.0,0.0
3900,0,3900,[161  12 215 385 508],655,0,18258,4.680338374775698,0.0,0.0
3901,0,3901,[318 427 132  64 496],556,5,18263,4.680420297283445,80.0,0.0
3902,0,3902,[318 427 132  64 496],330,5,18268,4.680502177811939,80.0,0.0
3903,0,3903,[318 427 132  64 496],151,5,18273,4.680584016393443,80.0,0.0
3904,0,3904,[318 427 132  64 496],450,5,18278,4.6806658130601795,80.0,0.0
3905,0,3905,[318 427 132  64 496],269,5,18283,4.680747567844342,80.0,0.0
3906,0,3906,[318 427 132  64 496],236,4,18287,4.680573329920655,80.0,0.0
3907,0,3907,[318 427 132  64 496],716,5,18292,4.6806550665301945,80.0,0.0
3908,0,3908,[318 427 132  64 496],269,5,18297,4.680736761320031,80.0,0.0
3909,0,3909,[318 427 132  64 496],18,5,18302,4.680818414322251,80.0,0.0
3910,0,3910,[318 427 132  64 496],796,5,18307,4.680900025568908,80.0,0.0
3911,0,3911,[318 427 132  64 496],330,5,18312,4.680981595092025,80.0,0.0
3912,0,3912,[318 427 132  64 496],18,5,18317,4.681063122923588,80.0,0.0
3913,0,3913,[186 127 435 423   1],18,5,18322,4.681144609095554,0.0,20.0
3914,0,3914,[318 427 132  64 496],796,5,18327,4.681226053639847,80.0,0.0
3915,0,3915,[185 655 161 238 174],269,3,18330,4.680796731358529,0.0,0.0
3916,0,3916,[318 427 132  64 496],151,5,18335,4.680878223129946,80.0,0.0
3917,0,3917,[318 427 132  64 496],796,5,18340,4.680959673302706,80.0,0.0
3918,0,3918,[318 427 132  64 496],269,5,18345,4.68104108190865,80.0,0.0
3919,0,3919,[318 427 132  64 496],151,5,18350,4.6811224489795915,80.0,0.0
3920,0,3920,[318 427 132  64 496],577,5,18355,4.681203774547309,80.0,0.0
3921,0,3921,[318 427 132  64 496],450,5,18360,4.6812850586435495,80.0,0.0
3922,0,3922,[318 427 132  64 496],236,4,18364,4.681111394341065,80.0,0.0
3923,0,3923,[196 204 238  95 234],716,5,18369,4.681192660550459,0.0,0.0
3924,0,3924,[318 427 132  64 496],796,5,18374,4.681273885350318,80.0,0.0
3925,0,3925,[318 427 132  64 496],556,5,18379,4.681355068772287,80.0,0.0
3926,0,3926,[318 427 132  64 496],18,5,18384,4.681436210847975,80.0,0.0
3927,0,3927,[318 427 132  64 496],796,5,18389,4.681517311608961,80.0,0.0
3928,0,3928,[318 427 132  64 496],151,5,18394,4.681598371086791,80.0,0.0
3929,0,3929,[318 427 132  64 496],535,5,18399,4.681679389312977,80.0,0.0
3930,0,3930,[318 427 132  64 496],450,5,18404,4.681760366319002,80.0,0.0
3931,0,3931,[318 427 132  64 496],269,5,18409,4.681841302136317,80.0,0.0
3932,0,3932,[318 427 132  64 496],18,5,18414,4.6819221967963385,80.0,0.0
3933,0,3933,[483  82 328 215 186],655,1,18415,4.680986273512964,0.0,0.0
3934,0,3934,[318 427 132  64 496],450,5,18420,4.6810673443456166,80.0,0.0
3935,0,3935,[318 427 132  64 496],450,5,18425,4.681148373983739,80.0,0.0
3936,0,3936,[318 427 132  64 496],535,5,18430,4.681229362458725,80.0,0.0
3937,0,3937,[318 427 132  64 496],535,5,18435,4.68131030980193,80.0,0.0
3938,0,3938,[318 427 132  64 496],535,5,18440,4.681391216044681,80.0,0.0
3939,0,3939,[318 427 132  64 496],18,5,18445,4.681472081218274,80.0,0.0
3940,0,3940,[318 427 132  64 496],716,5,18450,4.681552905353971,80.0,0.0
3941,0,3941,[318 427 132  64 496],18,5,18455,4.681633688483004,80.0,0.0
3942,0,3942,[318 427 132  64 496],450,5,18460,4.681714430636571,80.0,0.0
3943,0,3943,[318 427 132  64 496],556,5,18465,4.681795131845842,80.0,0.0
3944,0,3944,[318 427 132  64 496],330,5,18470,4.681875792141952,80.0,0.0
3945,0,3945,[318 427 132  64 496],535,5,18475,4.681956411556006,80.0,0.0
3946,0,3946,[318 427 132  64 496],556,5,18480,4.6820369901190775,80.0,0.0
3947,0,3947,[318 427 132  64 496],151,5,18485,4.682117527862209,80.0,0.0
3948,0,3948,[318 427 132  64 496],577,5,18490,4.682198024816409,80.0,0.0
3949,0,3949,[318 427 132  64 496],269,5,18495,4.682278481012658,80.0,0.0
3950,0,3950,[318 427 132  64 496],535,5,18500,4.682358896481904,80.0,0.0
3951,0,3951,[318 427 132  64 496],330,5,18505,4.682439271255061,80.0,0.0
3952,0,3952,[318 427 132  64 496],151,5,18510,4.682519605363016,80.0,0.0
3953,0,3953,[318 427 132  64 496],577,5,18515,4.682599898836621,80.0,0.0
3954,0,3954,[318 427 132  64 496],535,5,18520,4.6826801517067,80.0,0.0
3955,0,3955,[318 427 132  64 496],716,5,18525,4.682760364004045,80.0,0.0
3956,0,3956,[318 427 132  64 496],556,5,18530,4.682840535759413,80.0,0.0
3957,0,3957,[318 427 132  64 496],577,5,18535,4.682920667003537,80.0,0.0
3958,0,3958,[318 427 132  64 496],535,5,18540,4.683000757767113,80.0,0.0
3959,0,3959,[318 427 132  64 496],535,5,18545,4.683080808080808,80.0,0.0
3960,0,3960,[318 427 132  64 496],236,4,18549,4.682908356475638,80.0,0.0
3961,0,3961,[318 427 132  64 496],556,5,18554,4.682988389702171,80.0,0.0
3962,0,3962,[318 427 132  64 496],18,5,18559,4.683068382538481,80.0,0.0
3963,0,3963,[318 427 132  64 496],796,5,18564,4.683148335015137,80.0,0.0
3964,0,3964,[245 228 276   4 132],344,4,18568,4.68297604035309,0.0,0.0
3965,0,3965,[318 427 132  64 496],236,4,18572,4.682803832576903,80.0,0.0
3966,0,3966,[318 427 132  64 496],577,5,18577,4.682883791278043,80.0,0.0
3967,0,3967,[318 427 132  64 496],236,4,18581,4.682711693548387,80.0,0.0
3968,0,3968,[161   8 483 202 405],280,3,18584,4.682287729906777,0.0,0.0
3969,0,3969,[318 427 132  64 496],236,4,18588,4.6821158690176325,80.0,0.0
3970,0,3970,[318 427 132  64 496],151,5,18593,4.682195920423068,80.0,0.0
3971,0,3971,[318 427 132  64 496],577,5,18598,4.682275931520644,80.0,0.0
3972,0,3972,[318 427 132  64 496],269,5,18603,4.682355902340801,80.0,0.0
3973,0,3973,[318 427 132  64 496],450,5,18608,4.68243583291394,80.0,0.0
3974,0,3974,[318 427 132  64 496],151,5,18613,4.68251572327044,80.0,0.0
3975,0,3975,[318 427 132  64 496],535,5,18618,4.6825955734406435,80.0,0.0
3976,0,3976,[318 427 132  64 496],716,5,18623,4.682675383454866,80.0,0.0
3977,0,3977,[318 427 132  64 496],236,4,18627,4.682503770739065,80.0,0.0
3978,0,3978,[318 427 132  64 496],269,5,18632,4.682583563709475,80.0,0.0
3979,0,3979,[318 427 132  64 496],269,5,18637,4.682663316582914,80.0,0.0
3980,0,3980,[318 427 132  64 496],796,5,18642,4.6827430293896,80.0,0.0
3981,0,3981,[318 427 132  64 496],796,5,18647,4.682822702159719,80.0,0.0
3982,0,3982,[318 427 132  64 496],716,5,18652,4.6829023349234244,80.0,0.0
3983,0,3983,[234 385  70  98 427],5,2,18654,4.682228915662651,20.0,0.0
3984,0,3984,[318 427 132  64 496],535,5,18659,4.682308657465495,80.0,0.0
3985,0,3985,[318 427 132  64 496],151,5,18664,4.682388359257401,80.0,0.0
3986,0,3986,[318 427 132  64 496],577,5,18669,4.682468021068472,80.0,0.0
3987,0,3987,[318 427 132  64 496],535,5,18674,4.682547642928786,80.0,0.0
3988,0,3988,[475 200 301 125  28],655,1,18675,4.681624467285034,0.0,0.0
3989,0,3989,[318 427 132  64 496],796,5,18680,4.681704260651629,80.0,0.0
3990,0,3990,[318 427 132  64 496],18,5,18685,4.681784014031571,80.0,0.0
3991,0,3991,[318 427 132  64 496],577,5,18690,4.6818637274549095,80.0,0.0
3992,0,3992,[318 427 132  64 496],269,5,18695,4.681943400951665,80.0,0.0
3993,0,3993,[  4 202 187 357 161],450,4,18699,4.681772658988483,0.0,0.0
3994,0,3994,[318 427 132  64 496],796,5,18704,4.681852315394242,80.0,0.0
3995,0,3995,[318 427 132  64 496],450,5,18709,4.681931931931932,80.0,0.0
3996,0,3996,[318 427 132  64 496],330,5,18714,4.682011508631474,80.0,0.0
3997,0,3997,[318 427 132  64 496],535,5,18719,4.682091045522761,80.0,0.0
3998,0,3998,[318 427 132  64 496],151,5,18724,4.682170542635659,80.0,0.0
3999,0,3999,[318 427 132  64 496],18,5,18729,4.68225,80.0,0.0
4000,0,4000,[318 427 132  64 496],236,4,18733,4.682079480129968,80.0,0.0
4001,0,4001,[318 427 132  64 496],796,5,18738,4.68215892053973,80.0,0.0
4002,0,4002,[318 427 132  64 496],796,5,18743,4.682238321259056,80.0,0.0
4003,0,4003,[318 427 132  64 496],18,5,18748,4.682317682317683,80.0,0.0
4004,0,4004,[318 427 132  64 496],535,5,18753,4.682397003745319,80.0,0.0
4005,0,4005,[318 427 132  64 496],796,5,18758,4.682476285571642,80.0,0.0
4006,0,4006,[318 427 132  64 496],450,5,18763,4.682555527826304,80.0,0.0
4007,0,4007,[318 427 132  64 496],796,5,18768,4.682634730538922,80.0,0.0
4008,0,4008,[318 427 132  64 496],577,5,18773,4.682713893739087,80.0,0.0
4009,0,4009,[318 427 132  64 496],535,5,18778,4.682793017456359,80.0,0.0
4010,0,4010,[318 427 132  64 496],450,5,18783,4.682872101720269,80.0,0.0
4011,0,4011,[318 427 132  64 496],330,5,18788,4.682951146560319,80.0,0.0
4012,0,4012,[318 427 132  64 496],269,5,18793,4.683030152005981,80.0,0.0
4013,0,4013,[318 427 132  64 496],535,5,18798,4.683109118086697,80.0,0.0
4014,0,4014,[318 427 132  64 496],269,5,18803,4.683188044831881,80.0,0.0
4015,0,4015,[318 427 132  64 496],151,5,18808,4.683266932270916,80.0,0.0
4016,0,4016,[318 427 132  64 496],236,4,18812,4.6830968384366445,80.0,0.0
4017,0,4017,[318 427 132  64 496],18,5,18817,4.683175709308114,80.0,0.0
4018,0,4018,[318 427 132  64 496],450,5,18822,4.68325454093058,80.0,0.0
4019,0,4019,[318 427 132  64 496],535,5,18827,4.683333333333334,80.0,0.0
4020,0,4020,[ 22   7  98 181 153],269,1,18828,4.682417309127083,0.0,0.0
4021,0,4021,[191  28 135 195 181],236,3,18831,4.681999005469915,0.0,0.0
4022,0,4022,[318 427 132  64 496],556,5,18836,4.682078051205568,80.0,0.0
4023,0,4023,[318 427 132  64 496],18,5,18841,4.682157057654075,80.0,0.0
4024,0,4024,[318 427 132  64 496],716,5,18846,4.682236024844721,80.0,0.0
4025,0,4025,[318 427 132  64 496],577,5,18851,4.682314952806756,80.0,0.0
4026,0,4026,[318 427 132  64 496],556,5,18856,4.682393841569406,80.0,0.0
4027,0,4027,[ 95 174 603  22  25],450,3,18859,4.681976166832174,20.0,0.0
4028,0,4028,[318 427 132  64 496],236,4,18863,4.68180689997518,80.0,0.0
4029,0,4029,[235 197 100 174 435],269,2,18865,4.681141439205955,0.0,20.0
4030,0,4030,[318 427 132  64 496],556,5,18870,4.681220540808733,80.0,0.0
4031,0,4031,[318 427 132  64 496],577,5,18875,4.681299603174603,80.0,0.0
4032,0,4032,[318 427 132  64 496],796,5,18880,4.681378626332755,80.0,0.0
4033,0,4033,[318 427 132  64 496],556,5,18885,4.681457610312345,80.0,0.0
4034,0,4034,[318 427 132  64 496],535,5,18890,4.681536555142503,80.0,0.0
4035,0,4035,[318 427 132  64 496],796,5,18895,4.681615460852329,80.0,0.0
4036,0,4036,[318 427 132  64 496],269,5,18900,4.681694327470894,80.0,0.0
4037,0,4037,[318 427 132  64 496],269,5,18905,4.6817731550272415,80.0,0.0
4038,0,4038,[234 655 127 181  71],504,3,18908,4.681356771478089,0.0,20.0
4039,0,4039,[318 427 132  64 496],450,5,18913,4.681435643564356,80.0,0.0
4040,0,4040,[318 427 132  64 496],236,4,18917,4.681267013115566,80.0,0.0
4041,0,4041,[318 427 132  64 496],330,5,18922,4.681345868381989,80.0,0.0
4042,0,4042,[318 427 132  64 496],716,5,18927,4.681424684640119,80.0,0.0
4043,0,4043,[191 197 183 357 111],457,4,18931,4.681256181998021,0.0,0.0
4044,0,4044,[318 427 132  64 496],796,5,18936,4.6813349814585905,80.0,0.0
4045,0,4045,[273 197 144  12 603],796,3,18939,4.680919426594167,20.0,0.0
4046,0,4046,[318 427 132  64 496],556,5,18944,4.6809982703236965,80.0,0.0
4047,0,4047,[318 427 132  64 496],716,5,18949,4.681077075098814,80.0,0.0
4048,0,4048,[318 427 132  64 496],151,5,18954,4.681155840948382,80.0,0.0
4049,0,4049,[318 427 132  64 496],269,5,18959,4.681234567901234,80.0,0.0
4050,0,4050,[318 427 132  64 496],450,5,18964,4.6813132559861765,80.0,0.0
4051,0,4051,[318 427 132  64 496],577,5,18969,4.681391905231984,80.0,0.0
4052,0,4052,[197 318 742 508 328],655,1,18970,4.680483592400691,20.0,0.0
4053,0,4053,[318 427 132  64 496],796,5,18975,4.680562407498766,80.0,0.0
4054,0,4054,[318 427 132  64 496],151,5,18980,4.680641183723798,80.0,0.0
4055,0,4055,[318 427 132  64 496],716,5,18985,4.6807199211045365,80.0,0.0
4056,0,4056,[318 427 132  64 496],269,5,18990,4.680798619669707,80.0,0.0
4057,0,4057,[318 427 132  64 496],18,5,18995,4.680877279448004,80.0,0.0
4058,0,4058,[318 427 132  64 496],330,5,19000,4.680955900468096,80.0,0.0
4059,0,4059,[318 427 132  64 496],18,5,19005,4.681034482758621,80.0,0.0
4060,0,4060,[318 427 132  64 496],18,5,19010,4.68111302634819,80.0,0.0
4061,0,4061,[318 427 132  64 496],577,5,19015,4.6811915312653865,80.0,0.0
4062,0,4062,[318 427 132  64 496],151,5,19020,4.681269997538765,80.0,0.0
4063,0,4063,[318 427 132  64 496],18,5,19025,4.68134842519685,80.0,0.0
4064,0,4064,[318 427 132  64 496],796,5,19030,4.681426814268143,80.0,0.0
4065,0,4065,[318 427 132  64 496],577,5,19035,4.681505164781112,80.0,0.0
4066,0,4066,[318 427 132  64 496],796,5,19040,4.6815834767641995,80.0,0.0
4067,0,4067,[318 427 132  64 496],535,5,19045,4.681661750245821,80.0,0.0
4068,0,4068,[318 427 132  64 496],269,5,19050,4.681739985254362,80.0,0.0
4069,0,4069,[168 234 496 748 597],796,4,19054,4.6815724815724815,20.0,0.0
4070,0,4070,[318 427 132  64 496],796,5,19059,4.681650700073692,80.0,0.0
4071,0,4071,[318 427 132  64 496],556,5,19064,4.681728880157171,80.0,0.0
4072,0,4072,[289 546 172 318 111],236,4,19068,4.681561502577952,20.0,0.0
4073,0,4073,[318 427 132  64 496],535,5,19073,4.681639666175749,80.0,0.0
4074,0,4074,[191 121  50 183 597],796,5,19078,4.681717791411043,0.0,20.0
4075,0,4075,[318 427 132  64 496],577,5,19083,4.68179587831207,80.0,0.0
4076,0,4076,[318 427 132  64 496],450,5,19088,4.6818739269070395,80.0,0.0
4077,0,4077,[318 427 132  64 496],796,5,19093,4.681951937224129,80.0,0.0
4078,0,4078,[318 427 132  64 496],556,5,19098,4.682029909291493,80.0,0.0
4079,0,4079,[318 427 132  64 496],556,5,19103,4.6821078431372545,80.0,0.0
4080,0,4080,[318 427 132  64 496],577,5,19108,4.682185738789513,80.0,0.0
4081,0,4081,[318 427 132  64 496],535,5,19113,4.682263596276335,80.0,0.0
4082,0,4082,[318 427 132  64 496],556,5,19118,4.682341415625765,80.0,0.0
4083,0,4083,[318 427 132  64 496],556,5,19123,4.682419196865818,80.0,0.0
4084,0,4084,[318 427 132  64 496],236,4,19127,4.682252141982864,80.0,0.0
4085,0,4085,[318 427 132  64 496],18,5,19132,4.68232990699951,80.0,0.0
4086,0,4086,[546 174  82 234 294],23,1,19133,4.6814289209689255,0.0,0.0
4087,0,4087,[318 427 132  64 496],269,5,19138,4.681506849315069,80.0,0.0
4088,0,4088,[318 427 132  64 496],535,5,19143,4.681584739545121,80.0,0.0
4089,0,4089,[318 427 132  64 496],236,4,19147,4.681418092909535,80.0,0.0
4090,0,4090,[318 427 132  64 496],330,5,19152,4.6814959667562945,80.0,0.0
4091,0,4091,[318 427 132  64 496],577,5,19157,4.6815738025415445,80.0,0.0
4092,0,4092,[318 427 132  64 496],796,5,19162,4.681651600293184,80.0,0.0
4093,0,4093,[318 427 132  64 496],330,5,19167,4.681729360039082,80.0,0.0
4094,0,4094,[318 427 132  64 496],535,5,19172,4.681807081807082,80.0,0.0
4095,0,4095,[318 427 132  64 496],18,5,19177,4.681884765625,80.0,0.0
4096,0,4096,[318 427 132  64 496],556,5,19182,4.681962411520625,80.0,0.0
4097,0,4097,[318 427 132  64 496],450,5,19187,4.682040019521718,80.0,0.0
4098,0,4098,[318 427 132  64 496],151,5,19192,4.682117589656014,80.0,0.0
4099,0,4099,[318 427 132  64 496],269,5,19197,4.68219512195122,80.0,0.0
4100,0,4100,[318 427 132  64 496],796,5,19202,4.682272616435016,80.0,0.0
4101,0,4101,[318 427 132  64 496],535,5,19207,4.682350073135056,80.0,0.0
4102,0,4102,[318 427 132  64 496],330,5,19212,4.682427492078967,80.0,0.0
4103,0,4103,[318 427 132  64 496],236,4,19216,4.682261208576998,80.0,0.0
4104,0,4104,[318 427 132  64 496],577,5,19221,4.682338611449452,80.0,0.0
4105,0,4105,[318 427 132  64 496],269,5,19226,4.682415976619581,80.0,0.0
4106,0,4106,[318 427 132  64 496],577,5,19231,4.682493304114926,80.0,0.0
4107,0,4107,[318 427 132  64 496],18,5,19236,4.682570593962999,80.0,0.0
4108,0,4108,[318 427 132  64 496],716,5,19241,4.682647846191287,80.0,0.0
4109,0,4109,[318 427 132  64 496],450,5,19246,4.68272506082725,80.0,0.0
4110,0,4110,[302  79 427  50 216],450,5,19251,4.682802237898321,20.0,20.0
4111,0,4111,[568 427 238  56 257],655,1,19252,4.6819066147859925,20.0,0.0
4112,0,4112,[318 427 132  64 496],330,5,19257,4.6819839533187455,80.0,0.0
4113,0,4113,[318 427 132  64 496],236,4,19261,4.681818181818182,80.0,0.0
4114,0,4114,[318 427 132  64 496],577,5,19266,4.681895504252734,80.0,0.0
4115,0,4115,[318 427 132  64 496],535,5,19271,4.681972789115647,80.0,0.0
4116,0,4116,[318 427 132  64 496],236,4,19275,4.681807141122176,80.0,0.0
4117,0,4117,[318 427 132  64 496],556,5,19280,4.681884409907722,80.0,0.0
4118,0,4118,[318 427 132  64 496],18,5,19285,4.681961641175042,80.0,0.0
4119,0,4119,[318 427 132  64 496],796,5,19290,4.682038834951456,80.0,0.0
4120,0,4120,[318 427 132  64 496],716,5,19295,4.682115991264256,80.0,0.0
4121,0,4121,[318 427 132  64 496],450,5,19300,4.682193110140709,80.0,0.0
4122,0,4122,[318 427 132  64 496],450,5,19305,4.682270191608052,80.0,0.0
4123,0,4123,[318 427 132  64 496],269,5,19310,4.682347235693501,80.0,0.0
4124,0,4124,[318 427 132  64 496],716,5,19315,4.682424242424243,80.0,0.0
4125,0,4125,[135 100 483 357 202],18,3,19318,4.682016480853126,0.0,20.0
4126,0,4126,[318 427 132  64 496],796,5,19323,4.682093530409499,80.0,0.0
4127,0,4127,[318 427 132  64 496],236,4,19327,4.681928294573644,80.0,0.0
4128,0,4128,[318 427 132  64 496],450,5,19332,4.6820053281666265,80.0,0.0
4129,0,4129,[318 427 132  64 496],556,5,19337,4.682082324455206,80.0,0.0
4130,0,4130,[318 427 132  64 496],556,5,19342,4.682159283466473,80.0,0.0
4131,0,4131,[318 427 132  64 496],716,5,19347,4.682236205227492,80.0,0.0
4132,0,4132,[318 427 132  64 496],450,5,19352,4.682313089765303,80.0,0.0
4133,0,4133,[318 427 132  64 496],577,5,19357,4.682389937106918,80.0,0.0
4134,0,4134,[318 427 132  64 496],236,4,19361,4.6822249093107615,80.0,0.0
4135,0,4135,[318 427 132  64 496],450,5,19366,4.682301740812379,80.0,0.0
4136,0,4136,[318 427 132  64 496],151,5,19371,4.682378535170414,80.0,0.0
4137,0,4137,[215 483 357 117 127],457,5,19376,4.6824552924117935,0.0,20.0
4138,0,4138,[318 427 132  64 496],18,5,19381,4.6825320125634216,80.0,0.0
4139,0,4139,[318 427 132  64 496],796,5,19386,4.682608695652174,80.0,0.0
4140,0,4140,[318 427 132  64 496],796,5,19391,4.682685341704902,80.0,0.0
4141,0,4141,[ 11  79 194 186   1],716,4,19395,4.682520521487204,0.0,0.0
4142,0,4142,[318 427 132  64 496],330,5,19400,4.682597151822351,80.0,0.0
4143,0,4143,[318 427 132  64 496],151,5,19405,4.682673745173745,80.0,0.0
4144,0,4144,[245 301 121 357 180],450,4,19409,4.682509047044632,0.0,0.0
4145,0,4145,[318 427 132  64 496],796,5,19414,4.682585624698505,80.0,0.0
4146,0,4146,[318 427 132  64 496],796,5,19419,4.682662165420786,80.0,0.0
4147,0,4147,[182   9  82 196  69],457,5,19424,4.682738669238187,0.0,0.0
4148,0,4148,[318 427 132  64 496],450,5,19429,4.682815136177392,80.0,0.0
4149,0,4149,[318 427 132  64 496],535,5,19434,4.68289156626506,80.0,0.0
4150,0,4150,[318 427 132  64 496],796,5,19439,4.682967959527825,80.0,0.0
4151,0,4151,[318 427 132  64 496],450,5,19444,4.6830443159922925,80.0,0.0
4152,0,4152,[318 427 132  64 496],450,5,19449,4.6831206356850466,80.0,0.0
4153,0,4153,[318 427 132  64 496],151,5,19454,4.683196918632643,80.0,0.0
4154,0,4154,[318 427 132  64 496],577,5,19459,4.683273164861612,80.0,0.0
4155,0,4155,[318 427 132  64 496],556,5,19464,4.68334937439846,80.0,0.0
4156,0,4156,[318 427 132  64 496],535,5,19469,4.683425547269666,80.0,0.0
4157,0,4157,[318 427 132  64 496],535,5,19474,4.683501683501683,80.0,0.0
4158,0,4158,[ 12 200 257   1 181],655,1,19475,4.682616013464775,0.0,0.0
4159,0,4159,[318 427 132  64 496],269,5,19480,4.6826923076923075,80.0,0.0
4160,0,4160,[318 427 132  64 496],535,5,19485,4.682768565248738,80.0,0.0
4161,0,4161,[318 427 132  64 496],269,5,19490,4.6828447861605,80.0,0.0
4162,0,4162,[318 427 132  64 496],450,5,19495,4.682920970453999,80.0,0.0
4163,0,4163,[318 427 132  64 496],151,5,19500,4.68299711815562,80.0,0.0
4164,0,4164,[318 427 132  64 496],18,5,19505,4.6830732292917165,80.0,0.0
4165,0,4165,[318 427 132  64 496],556,5,19510,4.683149303888622,80.0,0.0
4166,0,4166,[245 121 427 269 186],796,2,19512,4.682505399568035,20.0,0.0
4167,0,4167,[318 427 132  64 496],577,5,19517,4.682581573896353,80.0,0.0
4168,0,4168,[318 427 132  64 496],577,5,19522,4.6826577116814585,80.0,0.0
4169,0,4169,[318 427 132  64 496],151,5,19527,4.68273381294964,80.0,0.0
4170,0,4170,[318 427 132  64 496],151,5,19532,4.682809877727164,80.0,0.0
4171,0,4171,[318 427 132  64 496],236,4,19536,4.682646212847555,80.0,0.0
4172,0,4172,[318 427 132  64 496],577,5,19541,4.682722262161515,80.0,0.0
4173,0,4173,[318 427 132  64 496],577,5,19546,4.682798275035937,80.0,0.0
4174,0,4174,[ 89 603 183  71 427],450,4,19550,4.682634730538922,40.0,0.0
4175,0,4175,[318 427 132  64 496],450,5,19555,4.682710727969349,80.0,0.0
4176,0,4176,[318 427 132  64 496],269,5,19560,4.682786689011252,80.0,0.0
4177,0,4177,[318 427 132  64 496],269,5,19565,4.682862613690761,80.0,0.0
4178,0,4178,[318 427 132  64 496],330,5,19570,4.68293850203398,80.0,0.0
4179,0,4179,[318 427 132  64 496],18,5,19575,4.6830143540669855,80.0,0.0
4180,0,4180,[182 172 471 186 179],450,4,19579,4.6828509925855055,0.0,0.0
4181,0,4181,[318 427 132  64 496],535,5,19584,4.682926829268292,80.0,0.0
4182,0,4182,[318 427 132  64 496],236,4,19588,4.682763566818073,80.0,0.0
4183,0,4183,[318 427 132  64 496],236,4,19592,4.682600382409178,80.0,0.0
4184,0,4184,[318 427 132  64 496],556,5,19597,4.682676224611709,80.0,0.0
4185,0,4185,[318 427 132  64 496],577,5,19602,4.682752030578118,80.0,0.0
4186,0,4186,[318 427 132  64 496],151,5,19607,4.682827800334368,80.0,0.0
4187,0,4187,[318 427 132  64 496],577,5,19612,4.6829035339064,80.0,0.0
4188,0,4188,[318 427 132  64 496],716,5,19617,4.682979231320124,80.0,0.0
4189,0,4189,[318 427 132  64 496],236,4,19621,4.682816229116945,80.0,0.0
4190,0,4190,[318 427 132  64 496],269,5,19626,4.682891911238368,80.0,0.0
4191,0,4191,[318 427 132  64 496],796,5,19631,4.682967557251908,80.0,0.0
4192,0,4192,[318 427 132  64 496],535,5,19636,4.683043167183401,80.0,0.0
4193,0,4193,[318 427 132  64 496],556,5,19641,4.683118741058656,80.0,0.0
4194,0,4194,[318 427 132  64 496],535,5,19646,4.683194278903456,80.0,0.0
4195,0,4195,[318 427 132  64 496],796,5,19651,4.683269780743565,80.0,0.0
4196,0,4196,[318 427 132  64 496],716,5,19656,4.683345246604718,80.0,0.0
4197,0,4197,[318 427 132  64 496],535,5,19661,4.683420676512625,80.0,0.0
4198,0,4198,[318 427 132  64 496],716,5,19666,4.683496070492975,80.0,0.0
4199,0,4199,[318 427 132  64 496],716,5,19671,4.683571428571429,80.0,0.0
4200,0,4200,[318 427 132  64 496],236,4,19675,4.683408712211378,80.0,0.0
4201,0,4201,[181 357 118  79 234],593,4,19679,4.683246073298429,0.0,0.0
4202,0,4202,[318 427 132  64 496],236,4,19683,4.683083511777302,80.0,0.0
4203,0,4203,[318 427 132  64 496],535,5,19688,4.683158896289249,80.0,0.0
4204,0,4204,[318 427 132  64 496],577,5,19693,4.683234244946492,80.0,0.0
4205,0,4205,[318 427 132  64 496],450,5,19698,4.683309557774607,80.0,0.0
4206,0,4206,[318 427 132  64 496],330,5,19703,4.683384834799145,80.0,0.0
4207,0,4207,[318 427 132  64 496],269,5,19708,4.683460076045628,80.0,0.0
4208,0,4208,[ 25 228 288  56  96],450,3,19711,4.683060109289618,0.0,0.0
4209,0,4209,[318 427 132  64 496],269,5,19716,4.68313539192399,80.0,0.0
4210,0,4210,[318 427 132  64 496],269,5,19721,4.683210638803135,80.0,0.0
4211,0,4211,[318 427 132  64 496],236,4,19725,4.683048433048433,80.0,0.0
4212,0,4212,[318 427 132  64 496],556,5,19730,4.683123664846902,80.0,0.0
4213,0,4213,[318 427 132  64 496],577,5,19735,4.683198860939725,80.0,0.0
4214,0,4214,[318 427 132  64 496],556,5,19740,4.683274021352313,80.0,0.0
4215,0,4215,[318 427 132  64 496],269,5,19745,4.683349146110057,80.0,0.0
4216,0,4216,[318 427 132  64 496],556,5,19750,4.683424235238321,80.0,0.0
4217,0,4217,[318 427 132  64 496],18,5,19755,4.683499288762446,80.0,0.0
4218,0,4218,[174 153  15 200 100],629,5,19760,4.683574306707751,0.0,20.0
4219,0,4219,[318 427 132  64 496],577,5,19765,4.6836492890995265,80.0,0.0
4220,0,4220,[318 427 132  64 496],796,5,19770,4.683724235963042,80.0,0.0
4221,0,4221,[546 294 173 423  69],796,4,19774,4.68356229275225,0.0,0.0
4222,0,4222,[318 427 132  64 496],577,5,19779,4.683637224721762,80.0,0.0
4223,0,4223,[318 427 132  64 496],269,5,19784,4.683712121212121,80.0,0.0
4224,0,4224,[318 427 132  64 496],236,4,19788,4.683550295857988,80.0,0.0
4225,0,4225,[318 427 132  64 496],269,5,19793,4.683625177472788,80.0,0.0
4226,0,4226,[318 427 132  64 496],151,5,19798,4.68370002365744,80.0,0.0
4227,0,4227,[318 427 132  64 496],236,4,19802,4.683538315988647,80.0,0.0
4228,0,4228,[318 427 132  64 496],18,5,19807,4.683613147316151,80.0,0.0
4229,0,4229,[318 427 132  64 496],577,5,19812,4.683687943262411,80.0,0.0
4230,0,4230,[318 427 132  64 496],796,5,19817,4.683762703852517,80.0,0.0
4231,0,4231,[318 427 132  64 496],151,5,19822,4.683837429111531,80.0,0.0
4232,0,4232,[318 427 132  64 496],535,5,19827,4.683912119064494,80.0,0.0
4233,0,4233,[318 427 132  64 496],330,5,19832,4.68398677373642,80.0,0.0
4234,0,4234,[318 427 132  64 496],556,5,19837,4.6840613931523025,80.0,0.0
4235,0,4235,[318 427 132  64 496],236,4,19841,4.683899905571294,80.0,0.0
4236,0,4236,[318 427 132  64 496],269,5,19846,4.683974510266698,80.0,0.0
4237,0,4237,[318 427 132  64 496],556,5,19851,4.684049079754601,80.0,0.0
4238,0,4238,[318 427 132  64 496],556,5,19856,4.68412361405992,80.0,0.0
4239,0,4239,[318 427 132  64 496],577,5,19861,4.684198113207547,80.0,0.0
4240,0,4240,[318 427 132  64 496],716,5,19866,4.6842725772223535,80.0,0.0
4241,0,4241,[318 427 132  64 496],269,5,19871,4.684347006129184,80.0,0.0
4242,0,4242,[318 427 132  64 496],269,5,19876,4.684421399952863,80.0,0.0
4243,0,4243,[176  79 172 265 322],280,3,19879,4.684024505183789,0.0,0.0
4244,0,4244,[318 427 132  64 496],269,5,19884,4.684098939929329,80.0,0.0
4245,0,4245,[318 427 132  64 496],577,5,19889,4.684173339613754,80.0,0.0
4246,0,4246,[588 132 168 245 258],450,5,19894,4.684247704261832,0.0,0.0
4247,0,4247,[318 427 132  64 496],330,5,19899,4.684322033898305,80.0,0.0
4248,0,4248,[318 427 132  64 496],577,5,19904,4.684396328547893,80.0,0.0
4249,0,4249,[318 427 132  64 496],269,5,19909,4.684470588235294,80.0,0.0
4250,0,4250,[318 427 132  64 496],269,5,19914,4.68454481298518,80.0,0.0
4251,0,4251,[318 427 132  64 496],269,5,19919,4.684619002822202,80.0,0.0
4252,0,4252,[318 427 132  64 496],450,5,19924,4.684693157770985,80.0,0.0
4253,0,4253,[318 427 132  64 496],269,5,19929,4.684767277856135,80.0,0.0
4254,0,4254,[318 427 132  64 496],18,5,19934,4.684841363102232,80.0,0.0
4255,0,4255,[318 427 132  64 496],535,5,19939,4.684915413533835,80.0,0.0
4256,0,4256,[496  64 597  95 100],344,4,19943,4.684754521963824,40.0,20.0
4257,0,4257,[318 427 132  64 496],556,5,19948,4.684828558008455,80.0,0.0
4258,0,4258,[318 427 132  64 496],18,5,19953,4.6849025592862175,80.0,0.0
4259,0,4259,[318 427 132  64 496],151,5,19958,4.684976525821596,80.0,0.0
4260,0,4260,[318 427 132  64 496],716,5,19963,4.6850504576390515,80.0,0.0
4261,0,4261,[318 427 132  64 496],716,5,19968,4.685124354763022,80.0,0.0
4262,0,4262,[318 427 132  64 496],330,5,19973,4.685198217217922,80.0,0.0
4263,0,4263,[ 50   7 191 210 328],65,4,19977,4.6850375234521575,0.0,20.0
4264,0,4264,[318 427 132  64 191],796,5,19982,4.685111371629543,60.0,0.0
4265,0,4265,[318 427 132  64 191],716,5,19987,4.685185185185185,60.0,0.0
4266,0,4266,[318 427 132  64 191],151,4,19991,4.685024607452543,60.0,0.0
4267,0,4267,[222 183 173 546 197],786,4,19995,4.684864104967198,0.0,0.0
4268,0,4268,[318 427 132  64 496],796,5,20000,4.684937924572499,80.0,0.0
4269,0,4269,[318 427 132  64 496],269,5,20005,4.6850117096018735,80.0,0.0
4270,0,4270,[318 427 132  64 496],577,5,20010,4.685085460079606,80.0,0.0
4271,0,4271,[318 427 132  64 496],450,5,20015,4.685159176029963,80.0,0.0
4272,0,4272,[318 427 132  64 496],716,5,20020,4.685232857477183,80.0,0.0
4273,0,4273,[318 427 132  64 496],556,5,20025,4.685306504445484,80.0,0.0
4274,0,4274,[318 427 132  64 496],450,5,20030,4.685380116959064,80.0,0.0
4275,0,4275,[318 427 132  64 496],796,5,20035,4.685453695042096,80.0,0.0
4276,0,4276,[318 427 132  64 496],535,5,20040,4.685527238718728,80.0,0.0
4277,0,4277,[318 427 132  64 496],450,5,20045,4.685600748013091,80.0,0.0
4278,0,4278,[318 427 132  64 496],716,5,20050,4.685674222949287,80.0,0.0
4279,0,4279,[318 427 132  64 496],556,5,20055,4.6857476635514015,80.0,0.0
4280,0,4280,[318 427 132  64 496],556,5,20060,4.685821069843494,80.0,0.0
4281,0,4281,[318 427 132  64 496],18,5,20065,4.685894441849603,80.0,0.0
4282,0,4282,[318 427 132  64 496],236,4,20069,4.685734298388979,80.0,0.0
4283,0,4283,[318 427 132  64 496],330,5,20074,4.685807656395892,80.0,0.0
4284,0,4284,[318 427 132  64 496],269,5,20079,4.68588098016336,80.0,0.0
4285,0,4285,[318 427 132  64 496],556,5,20084,4.685954269715352,80.0,0.0
4286,0,4286,[318 427 132  64 496],18,5,20089,4.6860275250758106,80.0,0.0
4287,0,4287,[318 427 132  64 496],796,5,20094,4.686100746268656,80.0,0.0
4288,0,4288,[ 95 194 275 168   8],796,5,20099,4.686173933317789,0.0,20.0
4289,0,4289,[318 427 132  64 496],151,5,20104,4.686247086247087,80.0,0.0
4290,0,4290,[318 427 132  64 496],577,5,20109,4.686320205080401,80.0,0.0
4291,0,4291,[318 427 132  64 496],269,5,20114,4.686393289841566,80.0,0.0
4292,0,4292,[318 427 132  64 496],269,5,20119,4.686466340554391,80.0,0.0
4293,0,4293,[318 427 132  64 496],716,5,20124,4.686539357242665,80.0,0.0
4294,0,4294,[318 427 132  64 496],236,4,20128,4.686379511059371,80.0,0.0
4295,0,4295,[318 427 132  64 496],18,5,20133,4.68645251396648,80.0,0.0
4296,0,4296,[318 427 132  64 496],796,5,20138,4.686525482895043,80.0,0.0
4297,0,4297,[318 427 132  64 496],151,5,20143,4.686598417868776,80.0,0.0
4298,0,4298,[  8  25  11 117 180],457,5,20148,4.686671318911375,0.0,0.0
4299,0,4299,[318 427 132  64 496],18,5,20153,4.6867441860465116,80.0,0.0
4300,0,4300,[318 427 132  64 496],535,5,20158,4.686817019297838,80.0,0.0
4301,0,4301,[318 427 132  64 496],450,5,20163,4.686889818688982,80.0,0.0
4302,0,4302,[318 427 132  64 496],450,5,20168,4.686962584243551,80.0,0.0
4303,0,4303,[  4 238 202 301 475],389,5,20173,4.68703531598513,0.0,0.0
4304,0,4304,[318 427 132  64 496],236,4,20177,4.686875725900117,80.0,0.0
4305,0,4305,[276 204  79 265 678],280,3,20180,4.686483975847654,0.0,0.0
4306,0,4306,[318 427 132  64 496],18,5,20185,4.686556768052008,80.0,0.0
4307,0,4307,[318 427 132  64 496],236,4,20189,4.686397400185701,80.0,0.0
4308,0,4308,[318 427 132  64 496],535,5,20194,4.686470178695753,80.0,0.0
4309,0,4309,[318 427 132  64 496],577,5,20199,4.6865429234338745,80.0,0.0
4310,0,4310,[318 427 132  64 496],577,5,20204,4.686615634423568,80.0,0.0
4311,0,4311,[318 427 132  64 496],716,5,20209,4.686688311688312,80.0,0.0
4312,0,4312,[183 172 121  50 234],269,0,20209,4.685601669371667,0.0,20.0
4313,0,4313,[318 427 132  64 496],716,5,20214,4.68567454798331,80.0,0.0
4314,0,4314,[318 427 132  64 496],151,5,20219,4.685747392815759,80.0,0.0
4315,0,4315,[318 427 132  64 496],18,5,20224,4.685820203892493,80.0,0.0
4316,0,4316,[318 427 132  64 496],269,5,20229,4.68589298123697,80.0,0.0
4317,0,4317,[318 427 132  64 496],796,5,20234,4.685965724872626,80.0,0.0
4318,0,4318,[318 427 132  64 496],577,5,20239,4.686038434822875,80.0,0.0
4319,0,4319,[211  15 275  89 294],796,3,20242,4.6856481481481485,0.0,20.0
4320,0,4320,[318 427 132  64 496],577,5,20247,4.685720897940292,80.0,0.0
4321,0,4321,[318 427 132  64 496],535,5,20252,4.685793614067562,80.0,0.0
4322,0,4322,[318 427 132  64 496],796,5,20257,4.6858662965533195,80.0,0.0
4323,0,4323,[318 427 132  64 496],330,5,20262,4.685938945420906,80.0,0.0
4324,0,4324,[318 427 132  64 496],330,5,20267,4.686011560693641,80.0,0.0
4325,0,4325,[318 427 132  64 496],269,5,20272,4.686084142394822,80.0,0.0
4326,0,4326,[300 515 427 210 265],716,5,20277,4.686156690547723,20.0,0.0
4327,0,4327,[318 427 132  64 496],330,5,20282,4.686229205175601,80.0,0.0
4328,0,4328,[318 427 132  64 496],450,5,20287,4.686301686301686,80.0,0.0
4329,0,4329,[318 427 132  64 496],450,5,20292,4.686374133949192,80.0,0.0
4330,0,4330,[318 427 132  64 496],716,5,20297,4.686446548141307,80.0,0.0
4331,0,4331,[318 427 132  64 496],556,5,20302,4.686518928901201,80.0,0.0
4332,0,4332,[318 427 132  64 496],535,5,20307,4.686591276252019,80.0,0.0
4333,0,4333,[318 427 132  64 496],450,5,20312,4.68666359021689,80.0,0.0
4334,0,4334,[318 427 132  64 496],450,5,20317,4.686735870818916,80.0,0.0
4335,0,4335,[318 427 132  64 496],236,4,20321,4.686577490774908,80.0,0.0
4336,0,4336,[318 427 132  64 496],556,5,20326,4.686649757897164,80.0,0.0
4337,0,4337,[318 427 132  64 496],450,5,20331,4.686721991701245,80.0,0.0
4338,0,4338,[318 427 132  64 496],151,5,20336,4.686794192210186,80.0,0.0
4339,0,4339,[318 427 132  64 496],450,5,20341,4.686866359447005,80.0,0.0
4340,0,4340,[318 427 132  64 496],236,4,20345,4.686708131766874,80.0,0.0
4341,0,4341,[318 427 132  64 496],716,5,20350,4.686780285582681,80.0,0.0
4342,0,4342,[318 427 132  64 496],535,5,20355,4.68685240617085,80.0,0.0
4343,0,4343,[318 427 132  64 496],18,5,20360,4.6869244935543275,80.0,0.0
4344,0,4344,[318 427 132  64 496],330,5,20365,4.686996547756041,80.0,0.0
4345,0,4345,[318 427 132  64 496],556,5,20370,4.687068568798895,80.0,0.0
4346,0,4346,[318 427 132  64 496],716,5,20375,4.687140556705774,80.0,0.0
4347,0,4347,[318 427 132  64 496],151,5,20380,4.68721251149954,80.0,0.0
4348,0,4348,[318 427 132  64 496],535,5,20385,4.687284433203035,80.0,0.0
4349,0,4349,[318 427 132  64 496],236,4,20389,4.687126436781609,80.0,0.0
4350,0,4350,[318 427 132  64 496],716,5,20394,4.687198345207998,80.0,0.0
4351,0,4351,[318 427 132  64 496],151,5,20399,4.6872702205882355,80.0,0.0
4352,0,4352,[318 427 132  64 496],796,5,20404,4.6873420629450955,80.0,0.0
4353,0,4353,[318 427 132  64 496],577,5,20409,4.687413872301332,80.0,0.0
4354,0,4354,[318 427 132  64 496],236,4,20413,4.687256027554535,80.0,0.0
4355,0,4355,[318 427 132  64 496],330,5,20418,4.68732782369146,80.0,0.0
4356,0,4356,[318 427 132  64 496],18,5,20423,4.687399586871701,80.0,0.0
4357,0,4357,[196 257 121 174 187],796,5,20428,4.687471317117944,0.0,0.0
4358,0,4358,[318 427 132  64 496],18,5,20433,4.6875430144528565,80.0,0.0
4359,0,4359,[318 427 132  64 496],330,5,20438,4.687614678899083,80.0,0.0
4360,0,4360,[318 427 132  64 496],269,5,20443,4.687686310479248,80.0,0.0
4361,0,4361,[318 427 132  64 496],18,5,20448,4.687757909215956,80.0,0.0
4362,0,4362,[318 427 132  64 496],535,5,20453,4.68782947513179,80.0,0.0
4363,0,4363,[318 427 132  64 496],556,5,20458,4.687901008249312,80.0,0.0
4364,0,4364,[318 427 132  64 496],269,5,20463,4.6879725085910655,80.0,0.0
4365,0,4365,[318 427 132  64 496],236,4,20467,4.687814933577646,80.0,0.0
4366,0,4366,[318 427 132  64 496],535,5,20472,4.687886420883902,80.0,0.0
4367,0,4367,[318 427 132  64 496],151,5,20477,4.687957875457876,80.0,0.0
4368,0,4368,[318 427 132  64 496],236,4,20481,4.687800411993591,80.0,0.0
4369,0,4369,[318 427 132  64 127],796,5,20486,4.687871853546911,60.0,20.0
4370,0,4370,[289 515 183 195 153],655,2,20488,4.687256920613132,0.0,0.0
4371,0,4371,[318 427 132  64 127],269,5,20493,4.687328453796889,60.0,20.0
4372,0,4372,[318 427 132  64 127],693,4,20497,4.687171278298651,60.0,20.0
4373,0,4373,[318 427 132  64 127],450,5,20502,4.68724279835391,60.0,20.0
4374,0,4374,[318 427 132  64 127],716,5,20507,4.687314285714286,60.0,20.0
4375,0,4375,[121 216 273 357 237],344,3,20510,4.686928702010969,0.0,0.0
4376,0,4376,[318 427 132  64 127],556,5,20515,4.687000228466987,60.0,20.0
4377,0,4377,[318 427 132  64 127],18,5,20520,4.687071722247602,60.0,20.0
4378,0,4378,[318 427 132  64 127],269,5,20525,4.6871431833752,60.0,20.0
4379,0,4379,[318 427 132  64 127],450,5,20530,4.687214611872146,60.0,20.0
4380,0,4380,[318 427 132  64 127],236,5,20535,4.687286007760785,60.0,20.0
4381,0,4381,[318 427 132  64 127],716,5,20540,4.687357371063442,60.0,20.0
4382,0,4382,[318 427 132  64 127],450,5,20545,4.6874287018024186,60.0,20.0
4383,0,4383,[318 427 132  64 127],716,5,20550,4.6875,60.0,20.0
4384,0,4384,[318 427 132  64 127],655,4,20554,4.687343215507411,60.0,20.0
4385,0,4385,[318 427 132  64 127],236,5,20559,4.687414500683994,60.0,20.0
4386,0,4386,[318 427 132  64 127],655,4,20563,4.68725780715751,60.0,20.0
4387,0,4387,[237 174  12 301 144],450,5,20568,4.687329079307202,0.0,0.0
4388,0,4388,[318 427 132  64 127],18,5,20573,4.687400318979266,60.0,20.0
4389,0,4389,[318 427 132  64 127],450,5,20578,4.6874715261959,60.0,20.0
4390,0,4390,[318 427 132  64 127],450,5,20583,4.687542700979276,60.0,20.0
4391,0,4391,[318 427 132  64 127],796,5,20588,4.687613843351548,60.0,20.0
4392,0,4392,[318 427 132  64 127],450,5,20593,4.687684953334851,60.0,20.0
4393,0,4393,[318 427 132  64 127],716,5,20598,4.687756030951297,60.0,20.0
4394,0,4394,[318 427 132  64 127],716,5,20603,4.68782707622298,60.0,20.0
4395,0,4395,[318 427 132  64 127],450,5,20608,4.687898089171974,60.0,20.0
4396,0,4396,[318 427 132  64 127],450,5,20613,4.6879690698203325,60.0,20.0
4397,0,4397,[318 427 132  64 127],450,5,20618,4.688040018190087,60.0,20.0
4398,0,4398,[318 427 132  64 127],716,5,20623,4.688110934303251,60.0,20.0
4399,0,4399,[318 427 132  64 127],693,4,20627,4.687954545454545,60.0,20.0
4400,0,4400,[318 427 132  64 127],796,5,20632,4.688025448761645,60.0,20.0
4401,0,4401,[318 427 132  64 127],269,5,20637,4.688096319854612,60.0,20.0
4402,0,4402,[318 427 132  64 127],316,4,20641,4.687940040881218,60.0,20.0
4403,0,4403,[318 427 132  64 127],269,5,20646,4.6880108991825615,60.0,20.0
4404,0,4404,[318 427 132  64 127],450,5,20651,4.688081725312145,60.0,20.0
4405,0,4405,[318 427 132  64 127],693,4,20655,4.687925556059918,60.0,20.0
4406,0,4406,[318 427 132  64 127],269,5,20660,4.687996369412299,60.0,20.0
4407,0,4407,[318 427 132  64 127],655,4,20664,4.687840290381125,60.0,20.0
4408,0,4408,[318 427 132  64 127],716,5,20669,4.687911090950329,60.0,20.0
4409,0,4409,[318 427 132  64 127],796,5,20674,4.6879818594104306,60.0,20.0
4410,0,4410,[318 427 132  64 127],269,5,20679,4.688052595783269,60.0,20.0
4411,0,4411,[318 427 132  64 127],316,4,20683,4.6878966455122395,60.0,20.0
4412,0,4412,[318 427 132  64 127],796,5,20688,4.687967369136642,60.0,20.0
4413,0,4413,[318 427 132  64 127],450,5,20693,4.688038060715904,60.0,20.0
4414,0,4414,[318 427 132  64 127],450,5,20698,4.688108720271801,60.0,20.0
4415,0,4415,[318 427 132  64 127],556,5,20703,4.688179347826087,60.0,20.0
4416,0,4416,[318 427 132  64 127],693,4,20707,4.6880235453928005,60.0,20.0
4417,0,4417,[245 483 742 181 143],450,4,20711,4.687867813490267,0.0,0.0
4418,0,4418,[318 427 132  64 127],655,4,20715,4.687712152070604,60.0,20.0
4419,0,4419,[318 427 132  64 127],269,5,20720,4.6877828054298645,60.0,20.0
4420,0,4420,[318 427 132  64 127],716,5,20725,4.68785342682651,60.0,20.0
4421,0,4421,[318 427 132  64 127],18,5,20730,4.687924016282225,60.0,20.0
4422,0,4422,[318 427 132  64 127],236,5,20735,4.687994573818675,60.0,20.0
4423,0,4423,[318 427 132  64 127],450,5,20740,4.688065099457504,60.0,20.0
4424,0,4424,[318 427 132  64 127],655,4,20744,4.687909604519774,60.0,20.0
4425,0,4425,[318 427 132  64 127],655,4,20748,4.687754179846363,60.0,20.0
4426,0,4426,[117 172 111 403 161],280,3,20751,4.68737293878473,0.0,0.0
4427,0,4427,[318 427 132  64 127],236,5,20756,4.687443541102078,60.0,20.0
4428,0,4428,[318 427 132  64 127],18,5,20761,4.687514111537594,60.0,20.0
4429,0,4429,[125  88 135 568 186],450,3,20764,4.687133182844244,0.0,0.0
4430,0,4430,[318 427 132  64 127],269,5,20769,4.687203791469194,60.0,20.0
4431,0,4431,[318 427 132  64 127],18,5,20774,4.687274368231047,60.0,20.0
4432,0,4432,[318 427 132  64 127],655,4,20778,4.687119332280623,60.0,20.0
4433,0,4433,[318 427 132  64 127],236,5,20783,4.687189896256202,60.0,20.0
4434,0,4434,[318 427 132  64 127],450,5,20788,4.687260428410372,60.0,20.0
4435,0,4435,[318 427 132  64 127],236,5,20793,4.687330928764653,60.0,20.0
4436,0,4436,[318 427 132  64 127],450,5,20798,4.687401397340546,60.0,20.0
4437,0,4437,[318 427 132  64 127],236,5,20803,4.687471834159531,60.0,20.0
4438,0,4438,[318 427 132  64 127],269,5,20808,4.687542239243073,60.0,20.0
4439,0,4439,[318 427 132  64 127],18,5,20813,4.687612612612613,60.0,20.0
4440,0,4440,[318 427 132  64 127],693,4,20817,4.687457779779329,60.0,20.0
4441,0,4441,[100  25 191 200 204],457,5,20822,4.687528140477262,0.0,20.0
4442,0,4442,[318 427 132  64 127],693,4,20826,4.687373396353815,60.0,20.0
4443,0,4443,[318 427 132  64 127],269,5,20831,4.687443744374438,60.0,20.0
4444,0,4444,[318 427 132  64 127],796,5,20836,4.687514060742407,60.0,20.0
4445,0,4445,[318 427 132  64 127],450,5,20841,4.687584345479082,60.0,20.0
4446,0,4446,[318 427 132  64 127],716,5,20846,4.687654598605802,60.0,20.0
4447,0,4447,[204 427 496 202 135],389,4,20850,4.6875,40.0,0.0
4448,0,4448,[318 427 132  64 127],716,5,20855,4.687570240503484,60.0,20.0
4449,0,4449,[318 427 132  64 127],556,5,20860,4.687640449438202,60.0,20.0
4450,0,4450,[318 427 132  64 127],18,5,20865,4.6877106268254325,60.0,20.0
4451,0,4451,[318 427 132  64 127],716,5,20870,4.687780772686433,60.0,20.0
4452,0,4452,[318 427 132  64 127],450,5,20875,4.687850887042443,60.0,20.0
4453,0,4453,[318 427 132  64 127],693,4,20879,4.687696452626852,60.0,20.0
4454,0,4454,[318 427 132  64 127],556,5,20884,4.687766554433221,60.0,20.0
4455,0,4455,[318 427 132  64 127],716,5,20889,4.687836624775583,60.0,20.0
4456,0,4456,[318 427 132  64 127],655,4,20893,4.687682297509536,60.0,20.0
4457,0,4457,[216 181 435 210 237],503,4,20897,4.687528039479587,0.0,0.0
4458,0,4458,[318 427 132  64 127],796,5,20902,4.687598116169545,60.0,20.0
4459,0,4459,[318 427 132  64 127],796,5,20907,4.687668161434978,60.0,20.0
4460,0,4460,[318 427 132  64 127],556,5,20912,4.687738175297018,60.0,20.0
4461,0,4461,[318 427 132  64 127],450,5,20917,4.687808157776781,60.0,20.0
4462,0,4462,[318 427 132  64 127],450,5,20922,4.687878108895362,60.0,20.0
4463,0,4463,[318 427 132  64 127],556,5,20927,4.687948028673835,60.0,20.0
4464,0,4464,[318 427 132  64 127],655,4,20931,4.687793952967525,60.0,20.0
4465,0,4465,[318 427 132  64 127],796,5,20936,4.687863860277654,60.0,20.0
4466,0,4466,[318 427 132  64 127],450,5,20941,4.687933736288337,60.0,20.0
4467,0,4467,[ 56 144 286 143 403],450,5,20946,4.688003581020591,0.0,20.0
4468,0,4468,[176 655 197 568 282],693,2,20948,4.687402103378832,0.0,0.0
4469,0,4469,[318 427 132  64 127],716,5,20953,4.687472035794183,60.0,20.0
4470,0,4470,[318 427 132  64 127],556,5,20958,4.687541936926862,60.0,20.0
4471,0,4471,[ 96 143 195 168 161],716,2,20960,4.6869409660107335,0.0,0.0
4472,0,4472,[318  15 403 100  64],577,4,20964,4.686787391012743,40.0,20.0
4473,0,4473,[318 427 132  64 127],450,5,20969,4.686857398301297,60.0,20.0
4474,0,4474,[132  79 204   9 238],535,4,20973,4.686703910614525,0.0,0.0
4475,0,4475,[318 427 132  64 127],655,4,20977,4.686550491510277,60.0,20.0
4476,0,4476,[318 427 132  64 127],236,5,20982,4.686620504802323,60.0,20.0
4477,0,4477,[318 427 132  64 127],796,5,20987,4.686690486824475,60.0,20.0
4478,0,4478,[318 427 132  64 127],693,4,20991,4.686537173476222,60.0,20.0
4479,0,4479,[318 427 132  64 127],716,5,20996,4.6866071428571425,60.0,20.0
4480,0,4480,[318 427 132  64 127],236,5,21001,4.686677081008703,60.0,20.0
4481,0,4481,[318 427 132  64 127],316,4,21005,4.686523873270861,60.0,20.0
4482,0,4482,[161 143 357 176  56],450,5,21010,4.68659379879545,0.0,0.0
4483,0,4483,[318 427 132  64 127],450,5,21015,4.686663693131133,60.0,20.0
4484,0,4484,[318 427 132  64 127],269,5,21020,4.6867335562987735,60.0,20.0
4485,0,4485,[318 427 132  64 127],716,5,21025,4.686803388319215,60.0,20.0
4486,0,4486,[318 427 132  64 127],655,4,21029,4.686650323155783,60.0,20.0
4487,0,4487,[318 427 132  64 127],556,5,21034,4.686720142602495,60.0,20.0
4488,0,4488,[318 427 132  64 127],18,5,21039,4.686789930942304,60.0,20.0
4489,0,4489,[318 427 132  64 127],450,5,21044,4.686859688195991,60.0,20.0
4490,0,4490,[318 427 132  64 127],556,5,21049,4.686929414384324,60.0,20.0
4491,0,4491,[318 427 132  64 127],18,5,21054,4.68699910952805,60.0,20.0
4492,0,4492,[318 427 132  64 127],316,4,21058,4.686846205208101,60.0,20.0
4493,0,4493,[318 427 132  64 127],316,4,21062,4.68669336893636,60.0,20.0
4494,0,4494,[318 427 132  64 127],693,4,21066,4.686540600667408,60.0,20.0
4495,0,4495,[318 427 132  64 127],18,5,21071,4.686610320284697,60.0,20.0
4496,0,4496,[318 427 132  64 127],693,4,21075,4.686457638425617,60.0,20.0
4497,0,4497,[318 427 132  64 127],18,5,21080,4.686527345486883,60.0,20.0
4498,0,4498,[318 427 132  64 127],655,4,21084,4.686374749944432,60.0,20.0
4499,0,4499,[318 427 132  64 127],450,5,21089,4.686444444444445,60.0,20.0
4500,0,4500,[318 427 132  64 127],556,5,21094,4.686514107976006,60.0,20.0
4501,0,4501,[235  56 423 228 222],457,4,21098,4.6863616170590845,0.0,0.0
4502,0,4502,[318 427 132  64 127],716,5,21103,4.686431268043527,60.0,20.0
4503,0,4503,[318 427 132  64 127],556,5,21108,4.686500888099467,60.0,20.0
4504,0,4504,[318 427 132  64 127],450,5,21113,4.6865704772475025,60.0,20.0
4505,0,4505,[318 427 132  64 127],556,5,21118,4.686640035508211,60.0,20.0
4506,0,4506,[318 427 132  64 127],655,4,21122,4.686487685822055,60.0,20.0
4507,0,4507,[318 427 132  64 127],316,4,21126,4.686335403726708,60.0,20.0
4508,0,4508,[ 89 245 357  95  28],796,3,21129,4.685961410512308,0.0,0.0
4509,0,4509,[210  12  28 125  79],655,1,21130,4.685144124168515,0.0,0.0
4510,0,4510,[318 427 132  64 127],693,4,21134,4.684992241188207,60.0,20.0
4511,0,4511,[318 427 132  64 127],655,4,21138,4.684840425531915,60.0,20.0
4512,0,4512,[318 427 132  64 127],269,5,21143,4.684910259251052,60.0,20.0
4513,0,4513,[318 427 132  64 127],796,5,21148,4.6849800620292426,60.0,20.0
4514,0,4514,[318 427 132  64 127],693,4,21152,4.684828349944629,60.0,20.0
4515,0,4515,[318 427 132  64 127],18,5,21157,4.6848981399468554,60.0,20.0
4516,0,4516,[318 427 132  64 127],693,4,21161,4.68474651317246,60.0,20.0
4517,0,4517,[318 427 132  64 127],796,5,21166,4.68481629039398,60.0,20.0
4518,0,4518,[318 427 132  64 127],716,5,21171,4.684886036733791,60.0,20.0
4519,0,4519,[318 427 132  64 127],316,4,21175,4.6847345132743365,60.0,20.0
4520,0,4520,[318 427 132  64 127],269,5,21180,4.684804246848042,60.0,20.0
4521,0,4521,[  1 302 173  71 196],389,3,21183,4.684431667403803,0.0,0.0
4522,0,4522,[318 427 132  64 127],316,4,21187,4.684280344903825,60.0,20.0
4523,0,4523,[318 427 132  64 127],716,5,21192,4.684350132625995,60.0,20.0
4524,0,4524,[318 427 132  64 127],236,5,21197,4.684419889502762,60.0,20.0
4525,0,4525,[318 427 132  64 127],655,4,21201,4.684268669907203,60.0,20.0
4526,0,4526,[ 88 742 180 196 423],693,0,21201,4.683233929754804,0.0,0.0
4527,0,4527,[318 427 132  64 127],655,4,21205,4.683083038869258,60.0,20.0
4528,0,4528,[117 228 405 403 132],807,5,21210,4.683153013910355,0.0,0.0
4529,0,4529,[318 427 132  64 127],716,5,21215,4.683222958057395,60.0,20.0
4530,0,4530,[318 427 132  64 127],716,5,21220,4.683292871330832,60.0,20.0
4531,0,4531,[318 427 132  64 127],655,4,21224,4.683142100617829,60.0,20.0
4532,0,4532,[318 427  64 132 127],236,5,21229,4.683212000882418,60.0,20.0
4533,0,4533,[318 427  64 132 127],693,4,21233,4.683061314512572,60.0,20.0
4534,0,4534,[318 427 132  64 127],716,5,21238,4.683131201764057,60.0,20.0
4535,0,4535,[318 427 132  64 127],18,5,21243,4.683201058201059,60.0,20.0
4536,0,4536,[318 427 132  64 127],236,5,21248,4.683270883843949,60.0,20.0
4537,0,4537,[318 427 132  64 127],796,5,21253,4.68334067871309,60.0,20.0
4538,0,4538,[318 427 132  64 127],556,5,21258,4.683410442828817,60.0,20.0
4539,0,4539,[318 427 132  64 127],316,4,21262,4.6832599118942735,60.0,20.0
4540,0,4540,[318 427 132  64 127],556,5,21267,4.6833296630698085,60.0,20.0
4541,0,4541,[318 427 132  64 127],316,4,21271,4.683179216204315,60.0,20.0
4542,0,4542,[423 174 405 204 143],20,1,21272,4.682368478978648,0.0,0.0
4543,0,4543,[318 427 132  64 127],716,5,21277,4.68243838028169,60.0,20.0
4544,0,4544,[318 427 132  64 127],316,4,21281,4.682288228822882,60.0,20.0
4545,0,4545,[318 427 132  64 127],316,4,21285,4.682138143422789,60.0,20.0
4546,0,4546,[318 427 132  64 127],450,5,21290,4.6822080492632505,60.0,20.0
4547,0,4547,[318 427 132  64 127],556,5,21295,4.682277924362357,60.0,20.0
4548,0,4548,[318 427 132  64 127],18,5,21300,4.6823477687403825,60.0,20.0
4549,0,4549,[318 427 132  64 127],316,4,21304,4.682197802197802,60.0,20.0
4550,0,4550,[318 427 132  64 127],18,5,21309,4.682267633487146,60.0,20.0
4551,0,4551,[318 427 132  64 127],796,5,21314,4.6823374340949035,60.0,20.0
4552,0,4552,[318 427 132  64 127],18,5,21319,4.682407204041292,60.0,20.0
4553,0,4553,[318 427 132  64 127],556,5,21324,4.682476943346509,60.0,20.0
4554,0,4554,[318 427 132  64 127],796,5,21329,4.6825466520307355,60.0,20.0
4555,0,4555,[318 427 132  64 127],236,5,21334,4.6826163301141355,60.0,20.0
4556,0,4556,[318 427 132  64 127],556,5,21339,4.6826859776168535,60.0,20.0
4557,0,4557,[318 427 132  64 127],716,5,21344,4.682755594559017,60.0,20.0
4558,0,4558,[318 427 132  64 127],18,5,21349,4.682825180960737,60.0,20.0
4559,0,4559,[318 427 132  64 127],655,4,21353,4.682675438596491,60.0,20.0
4560,0,4560,[318 427  64 132 127],693,4,21357,4.682525761894321,60.0,20.0
4561,0,4561,[318 427 132  64 127],693,4,21361,4.682376150811048,60.0,20.0
4562,0,4562,[318 427 132  64 127],655,4,21365,4.682226605303528,60.0,20.0
4563,0,4563,[ 96 161  15 238 245],796,3,21368,4.681858019281332,0.0,0.0
4564,0,4564,[318 427 132  64 127],450,5,21373,4.6819277108433734,60.0,20.0
4565,0,4565,[318 427 132  64 127],556,5,21378,4.681997371879106,60.0,20.0
4566,0,4566,[318 427 132  64 127],450,5,21383,4.6820670024085835,60.0,20.0
4567,0,4567,[318 427 132  64 127],450,5,21388,4.6821366024518385,60.0,20.0
4568,0,4568,[318 427 132  64 127],556,5,21393,4.682206172028891,60.0,20.0
4569,0,4569,[318 427 132  64 127],269,5,21398,4.682275711159737,60.0,20.0
4570,0,4570,[318 427 132  64 127],716,5,21403,4.682345219864362,60.0,20.0
4571,0,4571,[318 427 132  64 127],236,5,21408,4.68241469816273,60.0,20.0
4572,0,4572,[185 173  97 435  88],65,4,21412,4.68226547124426,0.0,0.0
4573,0,4573,[318 427 132  64 127],693,4,21416,4.682116309575863,60.0,20.0
4574,0,4574,[318 427 132  64 127],796,5,21421,4.682185792349727,60.0,20.0
4575,0,4575,[318 427 132  64 127],236,5,21426,4.682255244755245,60.0,20.0
4576,0,4576,[318 427 132  64 127],655,4,21430,4.68210618308936,60.0,20.0
4577,0,4577,[318 427 132  64 127],269,5,21435,4.682175622542595,60.0,20.0
4578,0,4578,[318 427 132  64 127],269,5,21440,4.6822450316663025,60.0,20.0
4579,0,4579,[318 427 132  64 127],18,5,21445,4.682314410480349,60.0,20.0
4580,0,4580,[318 427 132  64 127],236,5,21450,4.682383759004584,60.0,20.0
4581,0,4581,[318 427 132  64 127],236,5,21455,4.682453077258839,60.0,20.0
4582,0,4582,[318 427 132  64 127],796,5,21460,4.682522365262928,60.0,20.0
4583,0,4583,[318 427 132  64 127],693,4,21464,4.682373472949389,60.0,20.0
4584,0,4584,[318 427 132  64 127],655,4,21468,4.682224645583424,60.0,20.0
4585,0,4585,[318 427 132  64 127],693,4,21472,4.682075883122547,60.0,20.0
4586,0,4586,[318 427 132  64 127],655,4,21476,4.681927185524308,60.0,20.0
4587,0,4587,[318 427 132  64 127],693,4,21480,4.6817785527462945,60.0,20.0
4588,0,4588,[318 427 132  64 127],269,5,21485,4.681847897145348,60.0,20.0
4589,0,4589,[ 56 322  15 174 282],593,4,21489,4.681699346405229,0.0,0.0
4590,0,4590,[318 427 132  64 127],18,5,21494,4.6817686778479635,60.0,20.0
4591,0,4591,[318 427 132  64 127],18,5,21499,4.681837979094077,60.0,20.0
4592,0,4592,[318 427 132  64 127],269,5,21504,4.681907250163292,60.0,20.0
4593,0,4593,[318 427 132  64 127],796,5,21509,4.681976491075315,60.0,20.0
4594,0,4594,[318 427 132  64 127],716,5,21514,4.6820457018498365,60.0,20.0
4595,0,4595,[318 427 132  64 127],693,4,21518,4.68189730200174,60.0,20.0
4596,0,4596,[318 427 132  64 127],269,5,21523,4.681966499891233,60.0,20.0
4597,0,4597,[318 427 132  64 127],236,5,21528,4.682035667681601,60.0,20.0
4598,0,4598,[318 427 132  64 127],655,4,21532,4.681887366818874,60.0,20.0
4599,0,4599,[318 427 132  64 127],556,5,21537,4.681956521739131,60.0,20.0
4600,0,4600,[ 15 187   8 151 403],18,3,21540,4.681590958487285,0.0,0.0
4601,0,4601,[318 427 132  64 127],716,5,21545,4.681660147761843,60.0,20.0
4602,0,4602,[318 427 132  64 127],556,5,21550,4.681729306973713,60.0,20.0
4603,0,4603,[318 427 132  64 127],716,5,21555,4.6817984361424845,60.0,20.0
4604,0,4604,[318 427 132  64 127],655,4,21559,4.681650380021716,60.0,20.0
4605,0,4605,[318 427 132  64 127],316,4,21563,4.681502388189318,60.0,20.0
4606,0,4606,[318 427 132  64 127],796,5,21568,4.681571521597569,60.0,20.0
4607,0,4607,[318 427 132  64 127],693,4,21572,4.681423611111111,60.0,20.0
4608,0,4608,[181 132   9 301 288],655,0,21572,4.680407897591668,0.0,0.0
4609,0,4609,[318 427 132  64 127],655,4,21576,4.680260303687636,60.0,20.0
4610,0,4610,[318 427  64 132 127],18,5,21581,4.680329646497506,60.0,20.0
4611,0,4611,[318 427  64 132 127],236,5,21586,4.680398959236774,60.0,20.0
4612,0,4612,[318 427  64 132 127],716,5,21591,4.680468241924995,60.0,20.0
4613,0,4613,[318 427  64 132 127],796,5,21596,4.680537494581708,60.0,20.0
4614,0,4614,[318 427  64 132 127],556,5,21601,4.680606717226436,60.0,20.0
4615,0,4615,[318 427  64 132 127],693,4,21605,4.680459272097054,60.0,20.0
4616,0,4616,[318 427 132  64 127],316,4,21609,4.680311890838206,60.0,20.0
4617,0,4617,[318 427 132  64 127],655,4,21613,4.680164573408402,60.0,20.0
4618,0,4618,[318 427  64 132 127],236,5,21618,4.680233816843472,60.0,20.0
4619,0,4619,[318 427  64 132 127],316,4,21622,4.68008658008658,60.0,20.0
4620,0,4620,[318 427  64 132 127],236,5,21627,4.680155810430643,60.0,20.0
4621,0,4621,[318 427  64 132 127],693,4,21631,4.680008654262224,60.0,20.0
4622,0,4622,[318 427 132  64 127],716,5,21636,4.6800778715120055,60.0,20.0
4623,0,4623,[318 427 132  64 127],269,5,21641,4.680147058823529,60.0,20.0
4624,0,4624,[318 427 132  64 127],18,5,21646,4.680216216216216,60.0,20.0
4625,0,4625,[318 427 132  64 127],693,4,21650,4.680069174232599,60.0,20.0
4626,0,4626,[318 427 132  64 127],269,5,21655,4.6801383185649446,60.0,20.0
4627,0,4627,[318 427 132  64 127],18,5,21660,4.680207433016422,60.0,20.0
4628,0,4628,[318 427 132  64 127],236,5,21665,4.680276517606394,60.0,20.0
4629,0,4629,[183 144 118 357  69],796,5,21670,4.680345572354212,0.0,0.0
4630,0,4630,[318 427 132  64 127],269,5,21675,4.6804145972792055,60.0,20.0
4631,0,4631,[318 427 132  64 127],716,5,21680,4.680483592400691,60.0,20.0
4632,0,4632,[318 427 132  64 127],450,5,21685,4.6805525577379665,60.0,20.0
4633,0,4633,[318 427 132  64 127],655,4,21689,4.680405697022011,60.0,20.0
4634,0,4634,[318 427 132  64 127],655,4,21693,4.680258899676375,60.0,20.0
4635,0,4635,[318 427  64 132 127],655,4,21697,4.680112165660052,60.0,20.0
4636,0,4636,[  8 191 385 100 288],457,5,21702,4.680181151606642,0.0,20.0
4637,0,4637,[318 427  64 132 127],693,4,21706,4.680034497628288,60.0,20.0
4638,0,4638,[318 427  64 132 127],655,4,21710,4.679887906876482,60.0,20.0
4639,0,4639,[318 427  64 132 127],236,5,21715,4.679956896551724,60.0,20.0
4640,0,4640,[318 427  64 132 127],796,5,21720,4.680025856496445,60.0,20.0
4641,0,4641,[318 427  64 132 127],236,5,21725,4.680094786729858,60.0,20.0
4642,0,4642,[ 95 300 742 125 195],796,4,21729,4.679948309282791,0.0,0.0
4643,0,4643,[318 427  64 132 127],556,5,21734,4.680017226528855,60.0,20.0
4644,0,4644,[ 79 153 234   1 144],5,2,21736,4.679440258342304,0.0,0.0
4645,0,4645,[318 427  64 132 127],716,5,21741,4.679509255273353,60.0,20.0
4646,0,4646,[300 318   4 144 153],716,3,21744,4.679147837314396,20.0,0.0
4647,0,4647,[318 427  64 132 127],18,5,21749,4.679216867469879,60.0,20.0
4648,0,4648,[318 427  64 132 127],693,4,21753,4.679070767907077,60.0,20.0
4649,0,4649,[265 216 172 427  50],436,2,21755,4.678494623655914,20.0,20.0
4650,0,4650,[318 427  64 132 127],18,5,21760,4.67856374973124,60.0,20.0
4651,0,4651,[318 427  64 132 127],693,4,21764,4.67841788478074,60.0,20.0
4652,0,4652,[318 427 132  64 127],450,5,21769,4.678486997635934,60.0,20.0
4653,0,4653,[318 427 132  64 127],716,5,21774,4.678556080790718,60.0,20.0
4654,0,4654,[318 427 132  64 127],556,5,21779,4.678625134264232,60.0,20.0
4655,0,4655,[318 427 132  64 127],796,5,21784,4.678694158075602,60.0,20.0
4656,0,4656,[318 427 132  64 127],18,5,21789,4.678763152243934,60.0,20.0
4657,0,4657,[318 427 132  64 127],18,5,21794,4.678832116788321,60.0,20.0
4658,0,4658,[385 118   9   8  82],655,0,21794,4.677827860055806,0.0,0.0
4659,0,4659,[318 427 132  64 127],236,5,21799,4.677896995708155,60.0,20.0
4660,0,4660,[318 427 132  64 127],18,5,21804,4.677966101694915,60.0,20.0
4661,0,4661,[222  97  64 271 289],655,1,21805,4.677177177177177,20.0,0.0
4662,0,4662,[318 427 132  64 127],269,5,21810,4.677246407891915,60.0,20.0
4663,0,4663,[318 427 132  64 127],18,5,21815,4.677315608919383,60.0,20.0
4664,0,4664,[318 427 132  64 127],693,4,21819,4.677170418006431,60.0,20.0
4665,0,4665,[318 427 132  64 127],556,5,21824,4.6772396056579515,60.0,20.0
4666,0,4666,[318 427 132  64 127],18,5,21829,4.677308763659739,60.0,20.0
4667,0,4667,[318 427 132  64 127],269,5,21834,4.677377892030848,60.0,20.0
4668,0,4668,[318 427 132  64 127],655,4,21838,4.677232812165346,60.0,20.0
4669,0,4669,[318 427 132  64 127],316,4,21842,4.677087794432548,60.0,20.0
4670,0,4670,[318 427 132  64 127],693,4,21846,4.67694283879255,60.0,20.0
4671,0,4671,[318 427 132  64 127],316,4,21850,4.67679794520548,60.0,20.0
4672,0,4672,[318 427 132  64 127],18,5,21855,4.676867108923604,60.0,20.0
4673,0,4673,[318 427 132  64 127],693,4,21859,4.676722293538725,60.0,20.0
4674,0,4674,[70 98 82 28 79],72,4,21863,4.676577540106952,0.0,0.0
4675,0,4675,[318 427 132  64 127],450,5,21868,4.676646706586826,60.0,20.0
4676,0,4676,[318 427 132  64 127],655,4,21872,4.676502031216592,60.0,20.0
4677,0,4677,[318 427 132  64 127],316,4,21876,4.6763574176998715,60.0,20.0
4678,0,4678,[318 427 132  64 127],18,5,21881,4.676426586877538,60.0,20.0
4679,0,4679,[318 427 132  64 127],269,5,21886,4.676495726495727,60.0,20.0
4680,0,4680,[ 12 197 179 294 222],457,4,21890,4.67635120700705,0.0,0.0
4681,0,4681,[318 427 132  64 127],655,4,21894,4.676206749252456,60.0,20.0
4682,0,4682,[318 427 132  64 127],18,5,21899,4.676275891522528,60.0,20.0
4683,0,4683,[318 427 132  64 127],18,5,21904,4.676345004269855,60.0,20.0
4684,0,4684,[328  56 202  15 333],796,5,21909,4.676414087513341,0.0,0.0
4685,0,4685,[318 427 132  64 127],450,5,21914,4.6764831412718735,60.0,20.0
4686,0,4686,[318 427 132  64 127],556,5,21919,4.676552165564327,60.0,20.0
4687,0,4687,[318 427 132  64 127],18,5,21924,4.676621160409557,60.0,20.0
4688,0,4688,[318 427 132  64 127],556,5,21929,4.676690125826402,60.0,20.0
4689,0,4689,[318 427 132  64 127],236,5,21934,4.676759061833689,60.0,20.0
4690,0,4690,[318 427 132  64 127],556,5,21939,4.676827968450223,60.0,20.0
4691,0,4691,[318 427 132  64 127],556,5,21944,4.6768968456948,60.0,20.0
4692,0,4692,[318 427 132  64 127],796,5,21949,4.676965693586192,60.0,20.0
4693,0,4693,[318 427 132  64 127],556,5,21954,4.677034512143162,60.0,20.0
4694,0,4694,[ 69   8 515 143 195],269,1,21955,4.6762513312034075,0.0,0.0
4695,0,4695,[318 427 132  64 127],236,5,21960,4.6763202725724025,60.0,20.0
4696,0,4696,[318 427 132  64 127],316,4,21964,4.6761762827336595,60.0,20.0
4697,0,4697,[318 427 132  64 127],693,4,21968,4.676032354193274,60.0,20.0
4698,0,4698,[211  89 143 427 200],18,3,21971,4.675675675675675,20.0,0.0
4699,0,4699,[318 427 132  64 127],18,5,21976,4.675744680851063,60.0,20.0
4700,0,4700,[318 427 132  64 127],269,5,21981,4.675813656668794,60.0,20.0
4701,0,4701,[318 427 132  64 127],269,5,21986,4.675882603147596,60.0,20.0
4702,0,4702,[318 427 132  64 127],693,4,21990,4.675738890070168,60.0,20.0
4703,0,4703,[318 427 132  64 127],655,4,21994,4.675595238095238,60.0,20.0
4704,0,4704,[318 427 132  64 127],796,5,21999,4.6756641870350695,60.0,20.0
4705,0,4705,[318 427 132  64 127],316,4,22003,4.675520611984701,60.0,20.0
4706,0,4706,[318 427 132  64 127],716,5,22008,4.675589547482473,60.0,20.0
4707,0,4707,[318 427 132  64 127],18,5,22013,4.675658453695837,60.0,20.0
4708,0,4708,[318 427 132  64 127],556,5,22018,4.675727330643449,60.0,20.0
4709,0,4709,[318 427 132  64 127],796,5,22023,4.6757961783439494,60.0,20.0
4710,0,4710,[318 427 132  64 127],18,5,22028,4.675864996815963,60.0,20.0
4711,0,4711,[318 427 132  64 127],316,4,22032,4.67572156196944,60.0,20.0
4712,0,4712,[318 427 132  64 127],269,5,22037,4.675790367069807,60.0,20.0
4713,0,4713,[318 427 132  64 127],693,4,22041,4.675647008909631,60.0,20.0
4714,0,4714,[  8 276 423 127  88],655,2,22043,4.67507953340403,0.0,20.0
4715,0,4715,[318 427 132  64 127],693,4,22047,4.674936386768448,60.0,20.0
4716,0,4716,[228 238 179  22 471],457,5,22052,4.6750052999788,0.0,0.0
4717,0,4717,[  8 286 204 216 168],878,3,22055,4.6746502755404835,0.0,20.0
4718,0,4718,[318 427 132  64 127],655,4,22059,4.674507310870947,60.0,20.0
4719,0,4719,[144 135 275 568 191],457,5,22064,4.6745762711864405,0.0,20.0
4720,0,4720,[195 471 268 655 282],655,0,22064,4.673586104638848,0.0,0.0
4721,0,4721,[318 427 132  64 127],556,5,22069,4.673655230834393,60.0,20.0
4722,0,4722,[318 427 132  64 127],269,5,22074,4.673724327757781,60.0,20.0
4723,0,4723,[318 427 132  64 127],716,5,22079,4.673793395427603,60.0,20.0
4724,0,4724,[318 427 132  64 127],269,5,22084,4.673862433862434,60.0,20.0
4725,0,4725,[318 427 132  64 127],18,5,22089,4.673931443080829,60.0,20.0
4726,0,4726,[318 427 132  64 127],18,5,22094,4.674000423101333,60.0,20.0
4727,0,4727,[318 427 132  64 127],655,4,22098,4.6738578680203045,60.0,20.0
4728,0,4728,[ 12   9 655 265 508],280,3,22101,4.673503912032142,0.0,0.0
4729,0,4729,[318 427 132  64 127],236,5,22106,4.673572938689218,60.0,20.0
4730,0,4730,[318 427 132  64 127],556,5,22111,4.6736419361657155,60.0,20.0
4731,0,4731,[318 427 132  64 127],236,5,22116,4.673710904480135,60.0,20.0
4732,0,4732,[318 427 132  64 127],693,4,22120,4.673568561166279,60.0,20.0
4733,0,4733,[318 427 132  64 127],796,5,22125,4.673637515842839,60.0,20.0
4734,0,4734,[318 427 132  64 127],316,4,22129,4.673495248152059,60.0,20.0
4735,0,4735,[318 427 132  64 127],18,5,22134,4.6735641891891895,60.0,20.0
4736,0,4736,[318 427 132  64 127],716,5,22139,4.673633101118852,60.0,20.0
4737,0,4737,[318 427 132  64 127],236,5,22144,4.673701983959477,60.0,20.0
4738,0,4738,[318 427 132  64 127],655,4,22148,4.673559822747415,60.0,20.0
4739,0,4739,[318 427 132  64 127],269,5,22153,4.673628691983122,60.0,20.0
4740,0,4740,[318 427 132  64 127],693,4,22157,4.673486606201223,60.0,20.0
4741,0,4741,[318 427 132  64 127],236,5,22162,4.673555461830452,60.0,20.0
4742,0,4742,[318 427 132  64 127],716,5,22167,4.673624288425048,60.0,20.0
4743,0,4743,[318 427 132  64 127],18,5,22172,4.6736930860033725,60.0,20.0
4744,0,4744,[318 427 132  64 127],269,5,22177,4.6737618545837725,60.0,20.0
4745,0,4745,[318 427 132  64 127],450,5,22182,4.673830594184577,60.0,20.0
4746,0,4746,[318 427 132  64 127],450,5,22187,4.6738993048241,60.0,20.0
4747,0,4747,[318 427 132  64 127],796,5,22192,4.6739679865206405,60.0,20.0
4748,0,4748,[318 427 132  64 127],796,5,22197,4.674036639292483,60.0,20.0
4749,0,4749,[318 427 132  64 127],316,4,22201,4.673894736842105,60.0,20.0
4750,0,4750,[318 427 132  64 127],450,5,22206,4.673963376131341,60.0,20.0
4751,0,4751,[318 427 132  64 127],316,4,22210,4.673821548821548,60.0,20.0
4752,0,4752,[318 427 132  64 127],693,4,22214,4.673679781190827,60.0,20.0
4753,0,4753,[318 427 132  64 127],18,5,22219,4.673748422381153,60.0,20.0
4754,0,4754,[  7 288 483 186   9],655,1,22220,4.672975814931651,0.0,0.0
4755,0,4755,[318 427 132  64 127],450,5,22225,4.673044575273339,60.0,20.0
4756,0,4756,[318 427 132  64 127],18,5,22230,4.673113306705907,60.0,20.0
4757,0,4757,[318 427 132  64 127],316,4,22234,4.672971836906263,60.0,20.0
4758,0,4758,[318 427 132  64 127],556,5,22239,4.673040554738391,60.0,20.0
4759,0,4759,[318 427 132  64 127],716,5,22244,4.673109243697479,60.0,20.0
4760,0,4760,[318 427 132  64 127],236,5,22249,4.673177903801722,60.0,20.0
4761,0,4761,[318 427 132  64 127],556,5,22254,4.673246535069299,60.0,20.0
4762,0,4762,[318 427 132  64 127],236,5,22259,4.673315137518371,60.0,20.0
4763,0,4763,[318 427 132  64 127],450,5,22264,4.673383711167086,60.0,20.0
4764,0,4764,[318 427 132  64 127],556,5,22269,4.6734522560335785,60.0,20.0
4765,0,4765,[318 427 132  64 127],450,5,22274,4.673520772135963,60.0,20.0
4766,0,4766,[318 427 132  64 127],450,5,22279,4.673589259492343,60.0,20.0
4767,0,4767,[318 427 132  64 127],716,5,22284,4.673657718120805,60.0,20.0
4768,0,4768,[318 427 132  64 127],556,5,22289,4.673726148039421,60.0,20.0
4769,0,4769,[318 427 132  64 127],693,4,22293,4.673584905660378,60.0,20.0
4770,0,4770,[318 427 132  64 127],556,5,22298,4.673653322154685,60.0,20.0
4771,0,4771,[318 427 132  64 127],316,4,22302,4.673512154233026,60.0,20.0
4772,0,4772,[318 427 132  64 127],269,5,22307,4.673580557301488,60.0,20.0
4773,0,4773,[117 568 475 125 185],655,1,22308,4.6728110599078345,0.0,0.0
4774,0,4774,[318 427 132  64 127],655,4,22312,4.672670157068063,60.0,20.0
4775,0,4775,[318 427 132  64 127],716,5,22317,4.672738693467337,60.0,20.0
4776,0,4776,[318 427 132  64 127],716,5,22322,4.672807201172284,60.0,20.0
4777,0,4777,[318 427 132  64 127],655,4,22326,4.672666387609879,60.0,20.0
4778,0,4778,[318 427 132  64 127],556,5,22331,4.67273488177443,60.0,20.0
4779,0,4779,[318 427 132  64 127],655,4,22335,4.672594142259414,60.0,20.0
4780,0,4780,[318 427 132  64 127],18,5,22340,4.6726626228822425,60.0,20.0
4781,0,4781,[318 427 132  64 127],236,5,22345,4.672731074864074,60.0,20.0
4782,0,4782,[127 183 405 216 357],457,5,22350,4.672799498222873,0.0,20.0
4783,0,4783,[318 427 132  64 127],450,5,22355,4.672867892976589,60.0,20.0
4784,0,4784,[318 427 132  64 127],796,5,22360,4.672936259143156,60.0,20.0
4785,0,4785,[318 427 132  64 127],18,5,22365,4.673004596740493,60.0,20.0
4786,0,4786,[318 427 132  64 127],18,5,22370,4.673072905786505,60.0,20.0
4787,0,4787,[318 427 132  64 127],269,5,22375,4.673141186299081,60.0,20.0
4788,0,4788,[318 427 132  64 127],556,5,22380,4.673209438296095,60.0,20.0
4789,0,4789,[318 427 132  64 127],556,5,22385,4.6732776617954075,60.0,20.0
4790,0,4790,[318 427 132  64 127],316,4,22389,4.67313713212273,60.0,20.0
4791,0,4791,[318 427 132  64 127],316,4,22393,4.672996661101837,60.0,20.0
4792,0,4792,[  1 127 234 403 678],807,2,22395,4.672438973503025,0.0,20.0
4793,0,4793,[318 427 132  64 127],316,4,22399,4.672298706716729,60.0,20.0
4794,0,4794,[318 427 132  64 185],450,5,22404,4.6723670490093845,60.0,0.0
4795,0,4795,[318 427 132  64 185],18,4,22408,4.672226855713094,60.0,0.0
4796,0,4796,[318 427 132  64 168],151,5,22413,4.672295184490307,60.0,0.0
4797,0,4797,[318 427 132  64 168],18,4,22417,4.672155064610254,60.0,0.0
4798,0,4798,[318 427 132  64 127],18,5,22422,4.672223379870807,60.0,20.0
4799,0,4799,[318 427 132  64 127],316,4,22426,4.672083333333333,60.0,20.0
4800,0,4800,[318 427 132  64 496],577,5,22431,4.672151635076026,80.0,0.0
4801,0,4801,[318 427 132  64 496],577,5,22436,4.6722199083715115,80.0,0.0
4802,0,4802,[318 427 132  64 496],236,4,22440,4.672079950031231,80.0,0.0
4803,0,4803,[318 427 132  64 496],269,5,22445,4.672148209825146,80.0,0.0
4804,0,4804,[318 427 132  64 496],535,5,22450,4.672216441207076,80.0,0.0
4805,0,4805,[318 427 132  64 496],556,5,22455,4.6722846441947565,80.0,0.0
4806,0,4806,[318 427 132  64 496],450,5,22460,4.6723528188059085,80.0,0.0
4807,0,4807,[318 427 132  64 496],535,5,22465,4.672420965058237,80.0,0.0
4808,0,4808,[318 427 132  64 496],450,5,22470,4.672489082969432,80.0,0.0
4809,0,4809,[318 427 132  64 496],18,5,22475,4.672557172557172,80.0,0.0
4810,0,4810,[153 151 655 211  79],796,3,22478,4.672209519850343,0.0,0.0
4811,0,4811,[318 427 132  64 496],18,5,22483,4.672277639235245,80.0,0.0
4812,0,4812,[318 427 132  64 496],535,5,22488,4.672345730313734,80.0,0.0
4813,0,4813,[318 427 132  64 496],151,5,22493,4.672413793103448,80.0,0.0
4814,0,4814,[318 427 132  64 496],330,5,22498,4.672481827622015,80.0,0.0
4815,0,4815,[318 427 132  64 496],151,5,22503,4.672549833887043,80.0,0.0
4816,0,4816,[318 427 132  64 496],330,5,22508,4.672617811916131,80.0,0.0
4817,0,4817,[318 427 132  64 496],269,5,22513,4.672685761726858,80.0,0.0
4818,0,4818,[318 427 132  64 496],716,5,22518,4.672753683336792,80.0,0.0
4819,0,4819,[318 427 132  64 496],556,5,22523,4.672821576763486,80.0,0.0
4820,0,4820,[318 427 132  64 496],330,5,22528,4.672889442024476,80.0,0.0
4821,0,4821,[318 427 132  64 496],450,5,22533,4.672957279137288,80.0,0.0
4822,0,4822,[318 427 132  64 496],556,5,22538,4.673025088119428,80.0,0.0
4823,0,4823,[294 271 127  98 234],629,4,22542,4.672885572139304,0.0,20.0
4824,0,4824,[318 427 132  64 496],450,5,22547,4.672953367875648,80.0,0.0
4825,0,4825,[ 96 357 202 301 597],796,4,22551,4.672813924575218,0.0,0.0
4826,0,4826,[318 427 132  64 496],330,5,22556,4.6728817070644295,80.0,0.0
4827,0,4827,[318 427 132  64 496],151,5,22561,4.6729494614747304,80.0,0.0
4828,0,4828,[318 427 132  64 496],556,5,22566,4.673017187823566,80.0,0.0
4829,0,4829,[318 427 132  64 496],556,5,22571,4.673084886128365,80.0,0.0
4830,0,4830,[318 427 132  64 496],556,5,22576,4.673152556406541,80.0,0.0
4831,0,4831,[318 427 132  64 496],796,5,22581,4.673220198675497,80.0,0.0
4832,0,4832,[318 427 132  64 496],330,5,22586,4.673287812952617,80.0,0.0
4833,0,4833,[318 427 132  64 496],796,5,22591,4.673355399255275,80.0,0.0
4834,0,4834,[318 427 132  64 496],330,5,22596,4.6734229576008275,80.0,0.0
4835,0,4835,[318 427 132  64 496],796,5,22601,4.6734904880066175,80.0,0.0
4836,0,4836,[318 427 132  64 496],450,5,22606,4.673557990489973,80.0,0.0
4837,0,4837,[318 427 132  64 496],535,5,22611,4.67362546506821,80.0,0.0
4838,0,4838,[318 427 132  64 496],716,5,22616,4.673692911758628,80.0,0.0
4839,0,4839,[318 427 132  64 496],577,5,22621,4.673760330578513,80.0,0.0
4840,0,4840,[318 427 132  64 496],535,5,22626,4.673827721545135,80.0,0.0
4841,0,4841,[318 427 132  64 496],577,5,22631,4.673895084675753,80.0,0.0
4842,0,4842,[318 427 132  64 496],556,5,22636,4.673962419987611,80.0,0.0
4843,0,4843,[318 427 132  64 496],716,5,22641,4.674029727497936,80.0,0.0
4844,0,4844,[144 174 655 294 318],280,1,22642,4.673271413828689,20.0,0.0
4845,0,4845,[318 427 132  64 496],450,5,22647,4.673338836153529,80.0,0.0
4846,0,4846,[318 427 132  64 496],577,5,22652,4.673406230658139,80.0,0.0
4847,0,4847,[318 427 132  64 496],556,5,22657,4.673473597359736,80.0,0.0
4848,0,4848,[318 427 132  64 496],716,5,22662,4.673540936275521,80.0,0.0
4849,0,4849,[318 427 132  64 496],535,5,22667,4.67360824742268,80.0,0.0
4850,0,4850,[318 427 132  64 496],330,5,22672,4.673675530818388,80.0,0.0
4851,0,4851,[ 11 405 196 237 211],401,2,22674,4.673124484748557,0.0,0.0
4852,0,4852,[318 427 132  64 496],269,5,22679,4.673191840098908,80.0,0.0
4853,0,4853,[318 427 132  64 496],151,5,22684,4.673259167696745,80.0,0.0
4854,0,4854,[318 427 132  64 496],450,5,22689,4.673326467559217,80.0,0.0
4855,0,4855,[318 427 132  64 496],535,5,22694,4.673393739703459,80.0,0.0
4856,0,4856,[318 427 132  64 496],236,4,22698,4.67325509573811,80.0,0.0
4857,0,4857,[318 427 132  64 496],151,5,22703,4.673322354878551,80.0,0.0
4858,0,4858,[318 427 132  64 496],716,5,22708,4.673389586334637,80.0,0.0
4859,0,4859,[318 427 132  64 496],556,5,22713,4.673456790123457,80.0,0.0
4860,0,4860,[318 427 132  64 496],535,5,22718,4.673523966262086,80.0,0.0
4861,0,4861,[318 427 132  64 496],796,5,22723,4.673591114767586,80.0,0.0
4862,0,4862,[318 427 132  64 496],716,5,22728,4.673658235657002,80.0,0.0
4863,0,4863,[318 427 132  64 496],796,5,22733,4.673725328947368,80.0,0.0
4864,0,4864,[588 210 143  11 181],577,2,22735,4.673175745118191,0.0,0.0
4865,0,4865,[318 427 132  64 496],556,5,22740,4.673242909987669,80.0,0.0
4866,0,4866,[174 179 322  22 216],450,5,22745,4.673310047257037,0.0,0.0
4867,0,4867,[318 427 132  64 496],18,5,22750,4.673377156943303,80.0,0.0
4868,0,4868,[318 427 132  64 496],577,5,22755,4.673444239063462,80.0,0.0
4869,0,4869,[318 427 132  64 496],330,5,22760,4.673511293634497,80.0,0.0
4870,0,4870,[318 427 132  64 496],796,5,22765,4.673578320673373,80.0,0.0
4871,0,4871,[318 427 132  64 496],330,5,22770,4.6736453201970445,80.0,0.0
4872,0,4872,[318 427 132  64 496],151,5,22775,4.67371229222245,80.0,0.0
4873,0,4873,[100 117 182 588  71],450,4,22779,4.673574066475174,0.0,20.0
4874,0,4874,[318 427 132  64 496],236,4,22783,4.673435897435898,80.0,0.0
4875,0,4875,[318 427 132  64 496],716,5,22788,4.673502871205907,80.0,0.0
4876,0,4876,[318 427 132  64 496],577,5,22793,4.6735698175107645,80.0,0.0
4877,0,4877,[318 427 132  64 496],577,5,22798,4.673636736367364,80.0,0.0
4878,0,4878,[318 427 132  64 496],577,5,22803,4.67370362779258,80.0,0.0
4879,0,4879,[318 427 132  64 496],535,5,22808,4.673770491803278,80.0,0.0
4880,0,4880,[318 427 132  64 496],269,5,22813,4.673837328416308,80.0,0.0
4881,0,4881,[318 427 132  64 496],577,5,22818,4.673904137648504,80.0,0.0
4882,0,4882,[318 427 132  64 496],236,4,22822,4.673766127380708,80.0,0.0
4883,0,4883,[318 427 132  64 496],269,5,22827,4.673832923832924,80.0,0.0
4884,0,4884,[318 427 132  64 496],535,5,22832,4.673899692937564,80.0,0.0
4885,0,4885,[318 427 132  64 496],556,5,22837,4.673966434711421,80.0,0.0
4886,0,4886,[237 286  95 132 323],280,3,22840,4.673623900143237,0.0,20.0
4887,0,4887,[318 427 132  64 496],716,5,22845,4.673690671031096,80.0,0.0
4888,0,4888,[318 427 132  64 496],151,5,22850,4.673757414604213,80.0,0.0
4889,0,4889,[318 427 132  64 496],18,5,22855,4.673824130879345,80.0,0.0
4890,0,4890,[318 427 132  64 496],556,5,22860,4.673890819873237,80.0,0.0
4891,0,4891,[318 427 132  64 496],18,5,22865,4.673957481602616,80.0,0.0
4892,0,4892,[318 427 132  64 496],18,5,22870,4.674024116084202,80.0,0.0
4893,0,4893,[318 427 132  64 496],577,5,22875,4.674090723334696,80.0,0.0
4894,0,4894,[318 427 132  64 496],450,5,22880,4.674157303370786,80.0,0.0
4895,0,4895,[318 427 132  64 496],151,5,22885,4.67422385620915,80.0,0.0
4896,0,4896,[318 427 132  64 496],151,5,22890,4.674290381866449,80.0,0.0
4897,0,4897,[318 427 132  64 496],716,5,22895,4.674356880359331,80.0,0.0
4898,0,4898,[318 427 132  64 496],330,5,22900,4.674423351704429,80.0,0.0
4899,0,4899,[318 427 132  64 496],556,5,22905,4.674489795918367,80.0,0.0
4900,0,4900,[318 427 132  64 496],236,4,22909,4.674352173025913,80.0,0.0
4901,0,4901,[318 427 132  64 496],716,5,22914,4.674418604651163,80.0,0.0
4902,0,4902,[318 427 132  64 496],577,5,22919,4.6744850091780545,80.0,0.0
4903,0,4903,[318 427 132  64 496],151,5,22924,4.674551386623165,80.0,0.0
4904,0,4904,[318 427 132  64 496],796,5,22929,4.674617737003058,80.0,0.0
4905,0,4905,[318 427 132  64 496],269,5,22934,4.674684060334284,80.0,0.0
4906,0,4906,[318 427 132  64 496],535,5,22939,4.674750356633381,80.0,0.0
4907,0,4907,[318 427 132  64 496],577,5,22944,4.67481662591687,80.0,0.0
4908,0,4908,[318 427 132  64 496],330,5,22949,4.674882868201263,80.0,0.0
4909,0,4909,[318 427 132  64 496],151,5,22954,4.674949083503055,80.0,0.0
4910,0,4910,[216 427 191 175  89],655,4,22958,4.674811647322338,20.0,0.0
4911,0,4911,[318 427 132  64 496],330,5,22963,4.674877850162867,80.0,0.0
4912,0,4912,[318 427 132  64 496],716,5,22968,4.6749440260533275,80.0,0.0
4913,0,4913,[318 427 132  64 496],716,5,22973,4.675010175010175,80.0,0.0
4914,0,4914,[318 427 132  64 496],577,5,22978,4.675076297049848,80.0,0.0
4915,0,4915,[318 427 132  64 496],236,4,22982,4.674938974776241,80.0,0.0
4916,0,4916,[318 427 132  64 496],716,5,22987,4.675005084401057,80.0,0.0
4917,0,4917,[318 427 132  64 496],535,5,22992,4.675071167141114,80.0,0.0
4918,0,4918,[318 427 132  64 496],796,5,22997,4.675137223012808,80.0,0.0
4919,0,4919,[318 427 132  64 496],450,5,23002,4.67520325203252,80.0,0.0
4920,0,4920,[318 427 132  64 496],716,5,23007,4.675269254216623,80.0,0.0
4921,0,4921,[318 427 132  64 496],151,5,23012,4.675335229581471,80.0,0.0
4922,0,4922,[ 15  82 222  71 234],796,3,23015,4.674994921795653,0.0,0.0
4923,0,4923,[318 427 132  64 496],796,5,23020,4.675060926076361,80.0,0.0
4924,0,4924,[318 427 132  64 496],716,5,23025,4.675126903553299,80.0,0.0
4925,0,4925,[318 427 132  64 496],450,5,23030,4.675192854242793,80.0,0.0
4926,0,4926,[318 427 132  64 496],450,5,23035,4.675258778161153,80.0,0.0
4927,0,4927,[318 427 132  64 496],556,5,23040,4.675324675324675,80.0,0.0
4928,0,4928,[318 427 132  64 496],577,5,23045,4.675390545749645,80.0,0.0
4929,0,4929,[318 427 132  64 496],236,4,23049,4.67525354969574,80.0,0.0
4930,0,4930,[318 427 132  64 496],330,5,23054,4.6753194078280265,80.0,0.0
4931,0,4931,[318 427 132  64 496],556,5,23059,4.675385239253853,80.0,0.0
4932,0,4932,[111  97 655 100  50],151,4,23063,4.675248327589702,0.0,40.0
4933,0,4933,[318 427 132  64 496],535,5,23068,4.675314146736928,80.0,0.0
4934,0,4934,[318 427 132  64 496],716,5,23073,4.675379939209726,80.0,0.0
4935,0,4935,[318 427 132  64 496],577,5,23078,4.675445705024311,80.0,0.0
4936,0,4936,[235 508 357  95 222],344,4,23082,4.6753088920397,0.0,0.0
4937,0,4937,[ 98 403   9 100 294],457,4,23086,4.675172134467395,0.0,20.0
4938,0,4938,[318 427 132  64 496],151,5,23091,4.675237902409394,80.0,0.0
4939,0,4939,[318 427 132  64 496],236,4,23095,4.675101214574899,80.0,0.0
4940,0,4940,[ 97 181 194  79  88],798,4,23099,4.674964582068407,0.0,0.0
4941,0,4941,[125 179  95 196 111],450,4,23103,4.674828004856334,0.0,0.0
4942,0,4942,[318 427 132  64 496],716,5,23108,4.674893789196844,80.0,0.0
4943,0,4943,[318 427 132  64 496],269,5,23113,4.6749595469255665,80.0,0.0
4944,0,4944,[318 427 132  64 496],151,5,23118,4.675025278058645,80.0,0.0
4945,0,4945,[200 186 238 268  98],655,2,23120,4.6744844318641325,0.0,0.0
4946,0,4946,[318 427 132  64 496],18,5,23125,4.67455023246412,80.0,0.0
4947,0,4947,[318 427 132  64 496],716,5,23130,4.674616006467259,80.0,0.0
4948,0,4948,[318 427 132  64 496],535,5,23135,4.674681753889675,80.0,0.0
4949,0,4949,[318 427 132  64 496],450,5,23140,4.674747474747475,80.0,0.0
4950,0,4950,[318 427 132  64 496],450,5,23145,4.6748131690567565,80.0,0.0
4951,0,4951,[318 427 132  64 496],269,5,23150,4.674878836833603,80.0,0.0
4952,0,4952,[318 427 132  64 496],236,4,23154,4.674742580254391,80.0,0.0
4953,0,4953,[318 427 132  64 496],330,5,23159,4.674808235769076,80.0,0.0
4954,0,4954,[318 427 132  64 496],236,4,23163,4.674672048435923,80.0,0.0
4955,0,4955,[318 427 132  64 496],151,5,23168,4.674737691686844,80.0,0.0
4956,0,4956,[318 427 132  64 496],556,5,23173,4.674803308452693,80.0,0.0
4957,0,4957,[ 69 286  25 174 186],503,4,23177,4.6746672045179505,0.0,20.0
4958,0,4958,[318 427 132  64 496],556,5,23182,4.674732809034079,80.0,0.0
4959,0,4959,[318 427 132  64 496],577,5,23187,4.674798387096774,80.0,0.0
4960,0,4960,[318 427 132  64 496],716,5,23192,4.674863938722032,80.0,0.0
4961,0,4961,[318 427 132  64 496],450,5,23197,4.674929463925836,80.0,0.0
4962,0,4962,[222 405 742 265 603],796,4,23201,4.67479347169051,20.0,0.0
4963,0,4963,[318 427 132  64 496],796,5,23206,4.674858984689767,80.0,0.0
4964,0,4964,[318 427 132  64 496],18,5,23211,4.674924471299094,80.0,0.0
4965,0,4965,[318 427 132  64 496],577,5,23216,4.6749899315344345,80.0,0.0
4966,0,4966,[318 427 132  64 496],556,5,23221,4.675055365411717,80.0,0.0
4967,0,4967,[318 427 132  64 496],18,5,23226,4.67512077294686,80.0,0.0
4968,0,4968,[318 427 132  64 496],535,5,23231,4.6751861541557655,80.0,0.0
4969,0,4969,[318 427 132  64 496],269,5,23236,4.675251509054326,80.0,0.0
4970,0,4970,[318 427 132  64 496],577,5,23241,4.675316837658419,80.0,0.0
4971,0,4971,[318 427 132  64 496],577,5,23246,4.67538213998391,80.0,0.0
4972,0,4972,[318 427 132  64 496],450,5,23251,4.6754474160466515,80.0,0.0
4973,0,4973,[286 125 483 222 200],280,3,23254,4.675110574989947,0.0,20.0
4974,0,4974,[318 427 132  64 496],450,5,23259,4.675175879396985,80.0,0.0
4975,0,4975,[318 427 132  64 496],716,5,23264,4.67524115755627,80.0,0.0
4976,0,4976,[318 427 132  64 496],330,5,23269,4.675306409483625,80.0,0.0
4977,0,4977,[318 427 132  64 496],796,5,23274,4.675371635194858,80.0,0.0
4978,0,4978,[318 427 132  64 496],151,5,23279,4.675436834705764,80.0,0.0
4979,0,4979,[153 202  88 181 144],23,2,23281,4.674899598393575,0.0,0.0
4980,0,4980,[318 427 132  64 496],18,5,23286,4.674964866492672,80.0,0.0
4981,0,4981,[318 427 132  64 496],577,5,23291,4.675030108390205,80.0,0.0
4982,0,4982,[318 427 132  64 496],269,5,23296,4.675095324101947,80.0,0.0
4983,0,4983,[318 427 132  64 496],535,5,23301,4.67516051364366,80.0,0.0
4984,0,4984,[318 427 132  64 496],330,5,23306,4.675225677031094,80.0,0.0
4985,0,4985,[318 427 132  64 496],556,5,23311,4.675290814279984,80.0,0.0
4986,0,4986,[318 427 132  64 496],151,5,23316,4.6753559254060555,80.0,0.0
4987,0,4987,[318 427 132  64 496],716,5,23321,4.67542101042502,80.0,0.0
4988,0,4988,[318 427 132  64 496],577,5,23326,4.6754860693525755,80.0,0.0
4989,0,4989,[318 427 132  64 496],18,5,23331,4.675551102204409,80.0,0.0
4990,0,4990,[318 427 132  64 496],269,5,23336,4.675616108996193,80.0,0.0
4991,0,4991,[318 427 132  64 496],796,5,23341,4.675681089743589,80.0,0.0
4992,0,4992,[318 427 132  64 496],330,5,23346,4.675746044462247,80.0,0.0
4993,0,4993,[318 427 132  64 496],535,5,23351,4.675810973167802,80.0,0.0
4994,0,4994,[318 427 132  64 496],236,4,23355,4.675675675675675,80.0,0.0
4995,0,4995,[318 427 132  64 496],18,5,23360,4.675740592473979,80.0,0.0
4996,0,4996,[318 427 132  64 496],236,4,23364,4.67560536321793,80.0,0.0
4997,0,4997,[318 427 132  64 496],236,4,23368,4.67547018807523,80.0,0.0
4998,0,4998,[318 427 132  64 496],535,5,23373,4.675535107021404,80.0,0.0
4999,0,4999,[318 427 132  64 496],18,5,23378,4.6756,80.0,0.0
5000,0,5000,[318 427 132  64 496],151,5,23383,4.675664867026595,80.0,0.0
5001,0,5001,[318 427 132  64 496],450,5,23388,4.675729708116753,80.0,0.0
5002,0,5002,[318 427 132  64 496],577,5,23393,4.6757945232860285,80.0,0.0
5003,0,5003,[318 427 132  64 496],330,5,23398,4.67585931254996,80.0,0.0
5004,0,5004,[318 427 132  64 496],269,5,23403,4.675924075924076,80.0,0.0
5005,0,5005,[318 427 132  64 496],236,4,23407,4.675789053136237,80.0,0.0
5006,0,5006,[318 427 132  64 496],269,5,23412,4.675853804673457,80.0,0.0
5007,0,5007,[318 427 132  64 496],450,5,23417,4.675918530351438,80.0,0.0
5008,0,5008,[318 427 132  64 496],236,4,23421,4.67578358953883,80.0,0.0
5009,0,5009,[318 427 132  64 496],330,5,23426,4.675848303393214,80.0,0.0
5010,0,5010,[ 69  79  56 245 182],280,3,23429,4.675513869487128,0.0,0.0
5011,0,5011,[318 427 132  64 496],535,5,23434,4.675578611332801,80.0,0.0
5012,0,5012,[318 427 132  64 496],330,5,23439,4.675643327348893,80.0,0.0
5013,0,5013,[318 427 132  64 496],236,4,23443,4.6755085759872355,80.0,0.0
5014,0,5014,[318 427 132  64 588],716,5,23448,4.675573280159521,60.0,0.0
5015,0,5015,[318 427 132  64 588],330,5,23453,4.675637958532695,60.0,0.0
5016,0,5016,[318 427 132  64 588],450,5,23458,4.675702611122184,60.0,0.0
5017,0,5017,[318 427 132  64 588],18,5,23463,4.675767237943404,60.0,0.0
5018,0,5018,[258 144 385 117   1],655,0,23463,4.67483562462642,0.0,0.0
5019,0,5019,[318 427 132  64 588],577,5,23468,4.674900398406375,60.0,0.0
5020,0,5020,[322 245 294  96 161],504,4,23472,4.6747659828719375,0.0,0.0
5021,0,5021,[318 427 132  64 588],316,4,23476,4.67463162086818,60.0,0.0
5022,0,5022,[318 427 132  64 496],236,4,23480,4.67449731236313,80.0,0.0
5023,0,5023,[318 427 132  64 496],796,5,23485,4.674562101910828,80.0,0.0
5024,0,5024,[318 427 132  64 496],556,5,23490,4.674626865671642,80.0,0.0
5025,0,5025,[318 427 132  64 496],577,5,23495,4.674691603660963,80.0,0.0
5026,0,5026,[318 427 132  64 496],556,5,23500,4.674756315894172,80.0,0.0
5027,0,5027,[318 427 132  64 496],450,5,23505,4.674821002386635,80.0,0.0
5028,0,5028,[318 427 132  64 496],796,5,23510,4.674885663153709,80.0,0.0
5029,0,5029,[318 427 132  64 496],151,5,23515,4.674950298210735,80.0,0.0
5030,0,5030,[318 427 132  64 496],796,5,23520,4.675014907573047,80.0,0.0
5031,0,5031,[318 427 132  64 496],556,5,23525,4.6750794912559615,80.0,0.0
5032,0,5032,[318 427 132  64 496],535,5,23530,4.675144049274786,80.0,0.0
5033,0,5033,[318 427 132  64 496],577,5,23535,4.6752085816448155,80.0,0.0
5034,0,5034,[318 427 132  64 496],796,5,23540,4.6752730883813305,80.0,0.0
5035,0,5035,[318 427 132  64 496],716,5,23545,4.675337569499603,80.0,0.0
5036,0,5036,[318 427 132  64 496],577,5,23550,4.67540202501489,80.0,0.0
5037,0,5037,[318 427 132  64 496],18,5,23555,4.675466454942438,80.0,0.0
5038,0,5038,[318 427 132  64 496],236,4,23559,4.675332407223656,80.0,0.0
5039,0,5039,[318 427 132  64 496],796,5,23564,4.675396825396826,80.0,0.0
5040,0,5040,[318 427 132  64 496],556,5,23569,4.675461218012299,80.0,0.0
5041,0,5041,[318 427 132  64 496],556,5,23574,4.675525585085284,80.0,0.0
5042,0,5042,[ 79 125  98 655  89],796,4,23578,4.6753916319651,0.0,0.0
5043,0,5043,[318 427 132  64 496],535,5,23583,4.675455987311658,80.0,0.0
5044,0,5044,[318 427 132  64 496],535,5,23588,4.675520317145689,80.0,0.0
5045,0,5045,[318 427 132  64 496],269,5,23593,4.675584621482362,80.0,0.0
5046,0,5046,[318 427 132  64 496],535,5,23598,4.675648900336833,80.0,0.0
5047,0,5047,[318 427 132  64 496],18,5,23603,4.675713153724248,80.0,0.0
5048,0,5048,[318 427 132  64 496],330,5,23608,4.675777381659735,80.0,0.0
5049,0,5049,[300 132 237 385 195],796,5,23613,4.675841584158416,0.0,0.0
5050,0,5050,[318 427 132  64 496],716,5,23618,4.675905761235399,80.0,0.0
5051,0,5051,[318 427 132  64 496],450,5,23623,4.67596991290578,80.0,0.0
5052,0,5052,[161  28 181  98 202],716,4,23627,4.675836136948347,0.0,0.0
5053,0,5053,[483 289 111  71 275],236,3,23630,4.675504550850811,0.0,20.0
5054,0,5054,[318 427 132  64 496],796,5,23635,4.675568743818002,80.0,0.0
5055,0,5055,[318 427 132  64 496],535,5,23640,4.675632911392405,80.0,0.0
5056,0,5056,[318 427 132  64 496],330,5,23645,4.675697053589085,80.0,0.0
5057,0,5057,[318 427 132  64 496],330,5,23650,4.675761170423092,80.0,0.0
5058,0,5058,[318 427 132  64 496],716,5,23655,4.675825261909468,80.0,0.0
5059,0,5059,[318 427 132  64 496],236,4,23659,4.6756916996047435,80.0,0.0
5060,0,5060,[318 427 132  64 496],450,5,23664,4.67575577949022,80.0,0.0
5061,0,5061,[318 427 132  64 496],330,5,23669,4.675819834057685,80.0,0.0
5062,0,5062,[318 427 132  64 496],151,5,23674,4.675883863322141,80.0,0.0
5063,0,5063,[318 427 132  64 496],18,5,23679,4.675947867298579,80.0,0.0
5064,0,5064,[475 318   4 515 117],655,2,23681,4.6754195459032575,20.0,0.0
5065,0,5065,[318 427 132  64 496],796,5,23686,4.675483616265298,80.0,0.0
5066,0,5066,[318 427 132  64 496],151,5,23691,4.6755476613380695,80.0,0.0
5067,0,5067,[318 427 132  64 496],577,5,23696,4.675611681136543,80.0,0.0
5068,0,5068,[195 197  82 216 435],269,1,23697,4.6748865653975145,0.0,0.0
5069,0,5069,[318 427 132  64 496],556,5,23702,4.674950690335305,80.0,0.0
5070,0,5070,[228 191  11  69 238],457,5,23707,4.675014789982252,0.0,0.0
5071,0,5071,[318 427 132  64 496],269,5,23712,4.6750788643533125,80.0,0.0
5072,0,5072,[318 427 132  64 496],535,5,23717,4.675142913463434,80.0,0.0
5073,0,5073,[318 427 132  64 496],236,4,23721,4.675009854158455,80.0,0.0
5074,0,5074,[318 427 132  64 496],796,5,23726,4.675073891625615,80.0,0.0
5075,0,5075,[318 427 132  64 496],269,5,23731,4.675137903861308,80.0,0.0
5076,0,5076,[318 427 132  64 496],236,4,23735,4.6750049241678155,80.0,0.0
5077,0,5077,[318 427 132  64  98],693,4,23739,4.674871996849153,60.0,0.0
5078,0,5078,[318 427 132  64  98],577,5,23744,4.6749360110257925,60.0,0.0
5079,0,5079,[318 427 132  64  98],577,5,23749,4.675,60.0,0.0
5080,0,5080,[318 427 132  64  98],796,5,23754,4.6750639637866565,60.0,0.0
5081,0,5081,[ 82 427 385 276 204],655,2,23756,4.674537583628493,20.0,0.0
5082,0,5082,[318 427 132  64  98],693,4,23760,4.67440487900846,60.0,0.0
5083,0,5083,[318 427 132  64  98],18,5,23765,4.674468922108576,60.0,0.0
5084,0,5084,[318 427 132  64  98],269,5,23770,4.674532940019666,60.0,0.0
5085,0,5085,[318 427 132  64  98],716,5,23775,4.674596932756587,60.0,0.0
5086,0,5086,[318 427 132  64  98],450,5,23780,4.674660900334185,60.0,0.0
5087,0,5087,[216 195  12 275 403],655,2,23782,4.674135220125786,0.0,20.0
5088,0,5088,[318 427 132  64  98],535,4,23786,4.674002751031637,60.0,0.0
5089,0,5089,[318 427 132  64 496],269,5,23791,4.674066797642436,80.0,0.0
5090,0,5090,[275 121  28 294 202],655,1,23792,4.6733451188371635,0.0,20.0
5091,0,5091,[318 427 132  64 496],151,5,23797,4.673409269442263,80.0,0.0
5092,0,5092,[318 427 132  64 496],269,5,23802,4.673473394855685,80.0,0.0
5093,0,5093,[318 427 132  64 496],151,5,23807,4.6735374950922655,80.0,0.0
5094,0,5094,[318 427 132  64 496],535,5,23812,4.67360157016683,80.0,0.0
5095,0,5095,[318 427 132  64 496],577,5,23817,4.673665620094192,80.0,0.0
5096,0,5096,[318 427 132  64 496],269,5,23822,4.673729644889151,80.0,0.0
5097,0,5097,[318 427 132  64 496],450,5,23827,4.673793644566497,80.0,0.0
5098,0,5098,[318 427 132  64 496],556,5,23832,4.673857619141008,80.0,0.0
5099,0,5099,[318 427 132  64 496],716,5,23837,4.673921568627451,80.0,0.0
5100,0,5100,[318 427 132  64 496],18,5,23842,4.67398549304058,80.0,0.0
5101,0,5101,[318 427 132  64 496],796,5,23847,4.674049392395139,80.0,0.0
5102,0,5102,[318 427 132  64 496],269,5,23852,4.674113266705859,80.0,0.0
5103,0,5103,[318 427 132  64 496],450,5,23857,4.674177115987461,80.0,0.0
5104,0,5104,[318 427 132  64 496],716,5,23862,4.674240940254652,80.0,0.0
5105,0,5105,[318 427 132  64 496],18,5,23867,4.674304739522131,80.0,0.0
5106,0,5106,[318 427 132  64 496],151,5,23872,4.674368513804582,80.0,0.0
5107,0,5107,[318 427 132  64 496],450,5,23877,4.67443226311668,80.0,0.0
5108,0,5108,[318 427 132  64 496],577,5,23882,4.674495987473087,80.0,0.0
5109,0,5109,[318 427 132  64 496],330,5,23887,4.674559686888454,80.0,0.0
5110,0,5110,[318 427 132  64 496],236,4,23891,4.674427704950108,80.0,0.0
5111,0,5111,[318 427 132  64 496],330,5,23896,4.674491392801252,80.0,0.0
5112,0,5112,[318 427 132  64 496],796,5,23901,4.67455505574027,80.0,0.0
5113,0,5113,[318 427 132  64 496],269,5,23906,4.674618693781776,80.0,0.0
5114,0,5114,[318 427 132  64 496],535,5,23911,4.674682306940372,80.0,0.0
5115,0,5115,[318 427 132  64 496],236,4,23915,4.674550430023456,80.0,0.0
5116,0,5116,[318 427 132  64 496],450,5,23920,4.674614031659175,80.0,0.0
5117,0,5117,[318 427 132  64 496],716,5,23925,4.674677608440797,80.0,0.0
5118,0,5118,[318 427 132  64 496],236,4,23929,4.674545809728462,80.0,0.0
5119,0,5119,[318 427 132  64  98],316,5,23934,4.674609375,60.0,0.0
5120,0,5120,[318 427 132  64  98],330,5,23939,4.674672915446202,60.0,0.0
5121,0,5121,[318 427 132  64  98],693,4,23943,4.674541194845763,60.0,0.0
5122,0,5122,[318 427 132  64  98],796,5,23948,4.674604723794651,60.0,0.0
5123,0,5123,[318 427 132  64  98],316,5,23953,4.674668227946916,60.0,0.0
5124,0,5124,[318 427 132  64  98],236,5,23958,4.674731707317073,60.0,0.0
5125,0,5125,[318 427 132  64  98],693,4,23962,4.674600078033555,60.0,0.0
5126,0,5126,[318 427 132  64  98],316,5,23967,4.674663545933294,60.0,0.0
5127,0,5127,[318 427 132  64  98],716,5,23972,4.674726989079563,60.0,0.0
5128,0,5128,[318 427 132  64  98],330,5,23977,4.67479040748684,60.0,0.0
5129,0,5129,[318 427 132  64  98],151,5,23982,4.674853801169591,60.0,0.0
5130,0,5130,[318 427 132  64  98],655,4,23986,4.674722276359384,60.0,0.0
5131,0,5131,[318 427 132  64  98],655,4,23990,4.674590802805923,60.0,0.0
5132,0,5132,[318 427 132  64  98],330,5,23995,4.674654198324567,60.0,0.0
5133,0,5133,[318 427 132  64  98],330,5,24000,4.674717569146864,60.0,0.0
5134,0,5134,[318 427 132  64  98],236,5,24005,4.674780915287244,60.0,0.0
5135,0,5135,[318 427 132  64  98],269,5,24010,4.674844236760125,60.0,0.0
5136,0,5136,[318 427 132  64  98],18,5,24015,4.67490753357991,60.0,0.0
5137,0,5137,[318 427 132  64  98],269,5,24020,4.674970805760997,60.0,0.0
5138,0,5138,[318 427 132  64  98],151,5,24025,4.675034053317766,60.0,0.0
5139,0,5139,[318 427 132  64  98],330,5,24030,4.675097276264592,60.0,0.0
5140,0,5140,[318 427 132  64  98],316,5,24035,4.675160474615834,60.0,0.0
5141,0,5141,[318 427 132  64  98],535,4,24039,4.675029171528588,60.0,0.0
5142,0,5142,[318 427 132  64  98],535,4,24043,4.674897919502236,60.0,0.0
5143,0,5143,[318 427 132  64  98],577,5,24048,4.674961119751166,60.0,0.0
5144,0,5144,[318 427 132  64  98],450,5,24053,4.675024295432459,60.0,0.0
5145,0,5145,[318 427 132  64  98],151,5,24058,4.675087446560435,60.0,0.0
5146,0,5146,[318 427 132  64  98],236,5,24063,4.675150573149407,60.0,0.0
5147,0,5147,[318 427 132  64  98],151,5,24068,4.6752136752136755,60.0,0.0
5148,0,5148,[318 427 132  64  98],151,5,24073,4.675276752767528,60.0,0.0
5149,0,5149,[318 427 132  64  98],535,4,24077,4.675145631067961,60.0,0.0
5150,0,5150,[318 427 132  64 496],577,5,24082,4.675208697340322,80.0,0.0
5151,0,5151,[318 427 132  64 496],577,5,24087,4.675271739130435,80.0,0.0
5152,0,5152,[318 427 132  64 496],18,5,24092,4.675334756452552,80.0,0.0
5153,0,5153,[318 427 132  64 496],716,5,24097,4.675397749320916,80.0,0.0
5154,0,5154,[318 427 132  64 496],535,5,24102,4.675460717749758,80.0,0.0
5155,0,5155,[318 427 132  64 496],450,5,24107,4.675523661753297,80.0,0.0
5156,0,5156,[318 427 132  64 496],450,5,24112,4.675586581345744,80.0,0.0
5157,0,5157,[318 427 132  64 496],151,5,24117,4.675649476541295,80.0,0.0
5158,0,5158,[318 427 132  64 496],330,5,24122,4.675712347354138,80.0,0.0
5159,0,5159,[318 427 132  64 496],269,5,24127,4.67577519379845,80.0,0.0
5160,0,5160,[318 427 132  64 496],18,5,24132,4.675838015888393,80.0,0.0
5161,0,5161,[318 427 132  64 496],535,5,24137,4.675900813638124,80.0,0.0
5162,0,5162,[318 427 132  64 496],577,5,24142,4.675963587061786,80.0,0.0
5163,0,5163,[318 427 132  64 496],236,4,24146,4.675832687838884,80.0,0.0
5164,0,5164,[423  12 276  98 318],457,5,24151,4.675895450145208,20.0,0.0
5165,0,5165,[318 427 132  64 496],450,5,24156,4.67595818815331,80.0,0.0
5166,0,5166,[318 427 132  64 496],796,5,24161,4.6760209018772985,80.0,0.0
5167,0,5167,[318 427 132  64 496],330,5,24166,4.6760835913312695,80.0,0.0
5168,0,5168,[318 427 132  64 496],450,5,24171,4.676146256529309,80.0,0.0
5169,0,5169,[318 427 132  64 496],151,5,24176,4.676208897485493,80.0,0.0
5170,0,5170,[318 427 132  64 496],330,5,24181,4.6762715142138855,80.0,0.0
5171,0,5171,[318 427 132  64 496],330,5,24186,4.676334106728539,80.0,0.0
5172,0,5172,[318 427 132  64 496],716,5,24191,4.676396675043495,80.0,0.0
5173,0,5173,[318 427 132  64 496],716,5,24196,4.676459219172787,80.0,0.0
5174,0,5174,[318 427 132  64 496],18,5,24201,4.676521739130434,80.0,0.0
5175,0,5175,[318 427 132  64 496],18,5,24206,4.6765842349304485,80.0,0.0
5176,0,5176,[318 427 132  64 496],18,5,24211,4.676646706586826,80.0,0.0
5177,0,5177,[318 427 132  64 496],450,5,24216,4.676709154113557,80.0,0.0
5178,0,5178,[318 427 132  64 496],796,5,24221,4.676771577524619,80.0,0.0
5179,0,5179,[318 427 132  64 496],796,5,24226,4.676833976833977,80.0,0.0
5180,0,5180,[318 427 132  64 496],577,5,24231,4.6768963520555875,80.0,0.0
5181,0,5181,[318 427 132  64 496],18,5,24236,4.676958703203397,80.0,0.0
5182,0,5182,[318 427 132  64 496],269,5,24241,4.677021030291337,80.0,0.0
5183,0,5183,[318 427 132  64 496],18,5,24246,4.677083333333333,80.0,0.0
5184,0,5184,[318 427 132  64 496],796,5,24251,4.677145612343298,80.0,0.0
5185,0,5185,[318 427 132  64 496],330,5,24256,4.677207867335133,80.0,0.0
5186,0,5186,[318 427 132  64 496],269,5,24261,4.6772700983227296,80.0,0.0
5187,0,5187,[318 427 132  64 496],577,5,24266,4.677332305319969,80.0,0.0
5188,0,5188,[318 427 132  64 496],269,5,24271,4.67739448834072,80.0,0.0
5189,0,5189,[318 427 132  64 496],18,5,24276,4.677456647398844,80.0,0.0
5190,0,5190,[318 427 132  64 496],450,5,24281,4.677518782508187,80.0,0.0
5191,0,5191,[318 427 132  64 496],269,5,24286,4.677580893682588,80.0,0.0
5192,0,5192,[318 427 132  64 496],535,5,24291,4.677642980935875,80.0,0.0
5193,0,5193,[318 427 132  64 496],450,5,24296,4.677705044281864,80.0,0.0
5194,0,5194,[318 427 132  64 496],18,5,24301,4.67776708373436,80.0,0.0
5195,0,5195,[318 427 132  64 496],556,5,24306,4.677829099307159,80.0,0.0
5196,0,5196,[318 427 132  64 496],330,5,24311,4.677891091014047,80.0,0.0
5197,0,5197,[603 300 588  98 151],389,4,24315,4.6777606771835325,20.0,0.0
5198,0,5198,[318 427 132  64 496],716,5,24320,4.6778226582035005,80.0,0.0
5199,0,5199,[318 427 132  64 496],796,5,24325,4.677884615384615,80.0,0.0
5200,0,5200,[318 427 132  64 496],450,5,24330,4.677946548740627,80.0,0.0
5201,0,5201,[144 282 222 742 143],450,4,24334,4.677816224529027,0.0,0.0
5202,0,5202,[318 427 132  64 496],450,5,24339,4.677878147222756,80.0,0.0
5203,0,5203,[318 427 132  64 496],450,5,24344,4.677940046118371,80.0,0.0
5204,0,5204,[318 427 132  64 496],716,5,24349,4.678001921229587,80.0,0.0
5205,0,5205,[318 427 132  64 496],796,5,24354,4.678063772570112,80.0,0.0
5206,0,5206,[318 427 132  64 496],716,5,24359,4.678125600153639,80.0,0.0
5207,0,5207,[318 427 132  64 496],450,5,24364,4.678187403993856,80.0,0.0
5208,0,5208,[318 427 132  64 496],450,5,24369,4.678249184104435,80.0,0.0
5209,0,5209,[318 427 132  64 496],577,5,24374,4.67831094049904,80.0,0.0
5210,0,5210,[318 427 132  64 496],556,5,24379,4.678372673191326,80.0,0.0
5211,0,5211,[318 427 132  64 496],18,5,24384,4.678434382194935,80.0,0.0
5212,0,5212,[318 427 132  64 496],330,5,24389,4.678496067523499,80.0,0.0
5213,0,5213,[318 427 132  64 496],796,5,24394,4.678557729190641,80.0,0.0
5214,0,5214,[318 427 132  64 496],236,4,24398,4.678427612655801,80.0,0.0
5215,0,5215,[435  12 257 603 215],655,1,24399,4.677722392638037,20.0,0.0
5216,0,5216,[318 427 132  64 496],330,5,24404,4.6777841671458695,80.0,0.0
5217,0,5217,[318 427 132  64 496],450,5,24409,4.677845917976236,80.0,0.0
5218,0,5218,[318 427 132  64 496],796,5,24414,4.6779076451427475,80.0,0.0
5219,0,5219,[318 427 132  64 496],151,5,24419,4.677969348659004,80.0,0.0
5220,0,5220,[508 483 328 222 427],655,2,24421,4.677456425972036,20.0,0.0
5221,0,5221,[  9 568 238 423  64],457,5,24426,4.6775181922635,20.0,0.0
5222,0,5222,[318 427 132  64 496],577,5,24431,4.677579934903313,80.0,0.0
5223,0,5223,[318 427 132  64 496],151,5,24436,4.677641653905054,80.0,0.0
5224,0,5224,[318 427 132  64 496],577,5,24441,4.677703349282297,80.0,0.0
5225,0,5225,[318 427 132  64 496],796,5,24446,4.677765021048603,80.0,0.0
5226,0,5226,[318 427 132  64 496],796,5,24451,4.6778266692175245,80.0,0.0
5227,0,5227,[318 427 132  64 496],330,5,24456,4.677888293802601,80.0,0.0
5228,0,5228,[318 427 132  64 496],330,5,24461,4.677949894817365,80.0,0.0
5229,0,5229,[318 427 132  64 496],556,5,24466,4.678011472275335,80.0,0.0
5230,0,5230,[318 427 132  64 496],269,5,24471,4.678073026190021,80.0,0.0
5231,0,5231,[318 427 132  64 496],716,5,24476,4.678134556574924,80.0,0.0
5232,0,5232,[318 427 132  64 496],236,4,24480,4.678004968469329,80.0,0.0
5233,0,5233,[318 427 132  64 496],535,5,24485,4.678066488345434,80.0,0.0
5234,0,5234,[318 427 132  64 496],151,5,24490,4.678127984718243,80.0,0.0
5235,0,5235,[318 427 132  64 496],151,5,24495,4.678189457601222,80.0,0.0
5236,0,5236,[318 427 132  64 496],18,5,24500,4.678250907007829,80.0,0.0
5237,0,5237,[200 269  71 318 173],450,3,24503,4.677930507827415,20.0,0.0
5238,0,5238,[318 427 132  64 496],535,5,24508,4.677991983202901,80.0,0.0
5239,0,5239,[318 427 132  64 496],269,5,24513,4.678053435114504,80.0,0.0
5240,0,5240,[318 427 132  64 496],796,5,24518,4.6781148635756535,80.0,0.0
5241,0,5241,[318 427 132  64 496],330,5,24523,4.678176268599771,80.0,0.0
5242,0,5242,[318 427 132  64 496],269,5,24528,4.678237650200267,80.0,0.0
5243,0,5243,[318 427 132  64 496],577,5,24533,4.678299008390542,80.0,0.0
5244,0,5244,[318 427 132  64 496],236,4,24537,4.678169685414681,80.0,0.0
5245,0,5245,[318 427 132  64 496],330,5,24542,4.678231033168128,80.0,0.0
5246,0,5246,[318 427 132  64 496],18,5,24547,4.67829235753764,80.0,0.0
5247,0,5247,[318 427 132  64 496],556,5,24552,4.678353658536586,80.0,0.0
5248,0,5248,[318 427 132  64 496],535,5,24557,4.67841493617832,80.0,0.0
5249,0,5249,[318 427 132  64 496],151,5,24562,4.67847619047619,80.0,0.0
5250,0,5250,[118 161 234 282 405],280,1,24563,4.677775661778709,0.0,0.0
5251,0,5251,[318 427 132  64 496],151,5,24568,4.677837014470678,80.0,0.0
5252,0,5252,[318 427 132  64 496],556,5,24573,4.677898343803541,80.0,0.0
5253,0,5253,[318 427 132  64 496],450,5,24578,4.677959649790636,80.0,0.0
5254,0,5254,[318 427 132  64 496],450,5,24583,4.67802093244529,80.0,0.0
5255,0,5255,[603 471 742 546 172],450,5,24588,4.678082191780822,20.0,0.0
5256,0,5256,[318 427 132  64 496],577,5,24593,4.6781434278105385,80.0,0.0
5257,0,5257,[318 427 132  64 496],716,5,24598,4.678204640547737,80.0,0.0
5258,0,5258,[318 427 132  64 496],535,5,24603,4.678265830005705,80.0,0.0
5259,0,5259,[318 427 132  64 496],151,5,24608,4.678326996197718,80.0,0.0
5260,0,5260,[318 427 132  64 496],796,5,24613,4.678388139137046,80.0,0.0
5261,0,5261,[318 427 132  64 496],269,5,24618,4.678449258836944,80.0,0.0
5262,0,5262,[496 183 117 322 202],450,5,24623,4.678510355310659,20.0,0.0
5263,0,5263,[318 427 132  64 496],151,5,24628,4.678571428571429,80.0,0.0
5264,0,5264,[318 427 132  64 496],236,4,24632,4.6784425451092115,80.0,0.0
5265,0,5265,[357 196 427 282 322],450,5,24637,4.678503608051652,20.0,0.0
5266,0,5266,[333 191 173   9  56],629,4,24641,4.678374786405923,0.0,0.0
5267,0,5267,[318 427 132  64 496],236,4,24645,4.678246013667426,80.0,0.0
5268,0,5268,[318 427 132  64 496],236,4,24649,4.678117289808313,80.0,0.0
5269,0,5269,[318 427 132  64 496],796,5,24654,4.678178368121442,80.0,0.0
5270,0,5270,[318 427 132  64 496],269,5,24659,4.678239423259344,80.0,0.0
5271,0,5271,[318 427 132  64 496],450,5,24664,4.678300455235205,80.0,0.0
5272,0,5272,[ 96  56 144  82 427],450,4,24668,4.678171818699033,20.0,0.0
5273,0,5273,[318 427 132  64 496],330,5,24673,4.6782328403488815,80.0,0.0
5274,0,5274,[318 427 132  64 496],18,5,24678,4.678293838862559,80.0,0.0
5275,0,5275,[318 427 132  64 496],18,5,24683,4.678354814253222,80.0,0.0
5276,0,5276,[318 427 132  64 496],535,5,24688,4.678415766534015,80.0,0.0
5277,0,5277,[318 427 132  64 496],151,5,24693,4.678476695718075,80.0,0.0
5278,0,5278,[318 427 132  64 496],556,5,24698,4.678537601818526,80.0,0.0
5279,0,5279,[318 427 132  64 496],577,5,24703,4.678598484848485,80.0,0.0
5280,0,5280,[191 655 151  28  25],450,4,24707,4.678469986744934,0.0,0.0
5281,0,5281,[318 427 132  64 496],450,5,24712,4.678530859522908,80.0,0.0
5282,0,5282,[318 427 132  64 496],151,5,24717,4.6785917092561045,80.0,0.0
5283,0,5283,[318 427 132  64 496],535,5,24722,4.678652535957608,80.0,0.0
5284,0,5284,[318 427 132  64 496],535,5,24727,4.678713339640492,80.0,0.0
5285,0,5285,[318 427 132  64 496],796,5,24732,4.67877412031782,80.0,0.0
5286,0,5286,[318 427 132  64 496],556,5,24737,4.678834878002648,80.0,0.0
5287,0,5287,[318 427 132  64 496],577,5,24742,4.678895612708018,80.0,0.0
5288,0,5288,[318 427 132  64 496],151,5,24747,4.678956324446966,80.0,0.0
5289,0,5289,[318 427 132  64 496],450,5,24752,4.679017013232515,80.0,0.0
5290,0,5290,[318 427 132  64 496],450,5,24757,4.679077679077679,80.0,0.0
5291,0,5291,[318 427 132  64 496],18,5,24762,4.679138321995465,80.0,0.0
5292,0,5292,[318 427 132  64 496],236,4,24766,4.679010013225014,80.0,0.0
5293,0,5293,[318 427 132  64 496],716,5,24771,4.679070646014356,80.0,0.0
5294,0,5294,[318 427 132  64 496],716,5,24776,4.679131255901794,80.0,0.0
5295,0,5295,[318 427 132  64 496],450,5,24781,4.679191842900302,80.0,0.0
5296,0,5296,[318 427 132  64 496],151,5,24786,4.679252407022843,80.0,0.0
5297,0,5297,[318 427 132  64 496],330,5,24791,4.67931294828237,80.0,0.0
5298,0,5298,[318 427 132  64 496],535,5,24796,4.679373466691828,80.0,0.0
5299,0,5299,[318 427 132  64 496],151,5,24801,4.6794339622641505,80.0,0.0
5300,0,5300,[100  88  82 235 181],450,3,24804,4.67911714770798,0.0,20.0
5301,0,5301,[318 427 132  64 496],236,4,24808,4.6789890607318,80.0,0.0
5302,0,5302,[318 427 132  64 496],577,5,24813,4.679049594569112,80.0,0.0
5303,0,5303,[318 427 132  64 496],796,5,24818,4.679110105580694,80.0,0.0
5304,0,5304,[318 427 132  64 496],577,5,24823,4.679170593779453,80.0,0.0
5305,0,5305,[318 427 132  64 496],716,5,24828,4.679231059178289,80.0,0.0
5306,0,5306,[195 234 405 238  64],655,1,24829,4.678537780290183,20.0,0.0
5307,0,5307,[318 427 132  64 496],556,5,24834,4.6785983421250945,80.0,0.0
5308,0,5308,[318 427 132  64 496],236,4,24838,4.67847052175551,80.0,0.0
5309,0,5309,[318 427 132  64 496],535,5,24843,4.678531073446328,80.0,0.0
5310,0,5310,[318 427 132  64 496],716,5,24848,4.678591602334777,80.0,0.0
5311,0,5311,[318 427 132  64 496],151,5,24853,4.678652108433735,80.0,0.0
5312,0,5312,[318 427 132  64 496],18,5,24858,4.67871259175607,80.0,0.0
5313,0,5313,[318 427 132  64 496],796,5,24863,4.67877305231464,80.0,0.0
5314,0,5314,[318 427 132  64 496],450,5,24868,4.678833490122296,80.0,0.0
5315,0,5315,[318 427 132  64 496],716,5,24873,4.678893905191874,80.0,0.0
5316,0,5316,[318 427 132  64 496],236,4,24877,4.6787662215535075,80.0,0.0
5317,0,5317,[318 427 132  64 496],330,5,24882,4.678826626551335,80.0,0.0
5318,0,5318,[318 427 132  64 496],577,5,24887,4.678887008836248,80.0,0.0
5319,0,5319,[318 427 132  64 496],556,5,24892,4.678947368421053,80.0,0.0
5320,0,5320,[318 427 132  64 496],535,5,24897,4.679007705318549,80.0,0.0
5321,0,5321,[318 427 132  64 496],269,5,24902,4.679068019541526,80.0,0.0
5322,0,5322,[318 427 132  64 496],535,5,24907,4.679128311102762,80.0,0.0
5323,0,5323,[318 427 132  64 496],18,5,24912,4.679188580015026,80.0,0.0
5324,0,5324,[318 427 132  64 496],716,5,24917,4.679248826291079,80.0,0.0
5325,0,5325,[318 427 132  64 496],151,5,24922,4.679309049943672,80.0,0.0
5326,0,5326,[318 427 132  64 496],151,5,24927,4.679369250985546,80.0,0.0
5327,0,5327,[318 427 132  64 496],535,5,24932,4.67942942942943,80.0,0.0
5328,0,5328,[318 427 132  64 496],796,5,24937,4.679489585288047,80.0,0.0
5329,0,5329,[318 427 132  64 496],18,5,24942,4.679549718574108,80.0,0.0
5330,0,5330,[318 427 132  64 496],18,5,24947,4.679609829300319,80.0,0.0
5331,0,5331,[318 427 132  64 496],796,5,24952,4.6796699174793694,80.0,0.0
5332,0,5332,[318 427 132  64 496],151,5,24957,4.679729983123945,80.0,0.0
5333,0,5333,[318 427 132  64 496],151,5,24962,4.679790026246719,80.0,0.0
5334,0,5334,[318 427 132  64 496],796,5,24967,4.6798500468603565,80.0,0.0
5335,0,5335,[318 427 132  64 496],330,5,24972,4.679910044977511,80.0,0.0
5336,0,5336,[276   9 313 153  50],280,3,24975,4.679595278246206,0.0,20.0
5337,0,5337,[318 427 132  64 496],577,5,24980,4.67965530161109,80.0,0.0
5338,0,5338,[318 427 132  64 496],716,5,24985,4.679715302491103,80.0,0.0
5339,0,5339,[318 427 132  64 496],556,5,24990,4.679775280898877,80.0,0.0
5340,0,5340,[318 427 132  64 496],450,5,24995,4.679835236847032,80.0,0.0
5341,0,5341,[318 427 132  64 496],330,5,25000,4.679895170348185,80.0,0.0
5342,0,5342,[318 427 132  64 496],269,5,25005,4.679955081414936,80.0,0.0
5343,0,5343,[318 427 132  64 496],269,5,25010,4.68001497005988,80.0,0.0
5344,0,5344,[318 427 132  64 496],556,5,25015,4.680074836295604,80.0,0.0
5345,0,5345,[318 427 132  64 496],269,5,25020,4.68013468013468,80.0,0.0
5346,0,5346,[318 427 132  64 496],535,5,25025,4.680194501589677,80.0,0.0
5347,0,5347,[318 427 132  64 496],796,5,25030,4.680254300673149,80.0,0.0
5348,0,5348,[194 216 121 185 175],151,5,25035,4.680314077397645,0.0,0.0
5349,0,5349,[318 427 132  64 496],796,5,25040,4.680373831775701,80.0,0.0
5350,0,5350,[318 427 132  64 496],151,5,25045,4.680433563819847,80.0,0.0
5351,0,5351,[318 427 132  64 496],330,5,25050,4.680493273542601,80.0,0.0
5352,0,5352,[318 427 132  64 496],330,5,25055,4.680552960956473,80.0,0.0
5353,0,5353,[318 427 132  64 496],577,5,25060,4.680612626073963,80.0,0.0
5354,0,5354,[318 427 132  64 496],796,5,25065,4.680672268907563,80.0,0.0
5355,0,5355,[318 427 132  64 496],535,5,25070,4.680731889469754,80.0,0.0
5356,0,5356,[318 427 132  64 496],18,5,25075,4.680791487773007,80.0,0.0
5357,0,5357,[318 427 132  64 496],716,5,25080,4.680851063829787,80.0,0.0
5358,0,5358,[228 237  11  89 200],655,2,25082,4.680350811718604,0.0,0.0
5359,0,5359,[318 427 132  64 496],556,5,25087,4.680410447761194,80.0,0.0
5360,0,5360,[318 427 132  64 496],577,5,25092,4.68047006155568,80.0,0.0
5361,0,5361,[318 427 132  64 496],18,5,25097,4.680529653114509,80.0,0.0
5362,0,5362,[318 427 132  64 496],577,5,25102,4.680589222450121,80.0,0.0
5363,0,5363,[318 427 132  64 496],236,4,25106,4.680462341536167,80.0,0.0
5364,0,5364,[318 427 132  64 496],269,5,25111,4.680521901211557,80.0,0.0
5365,0,5365,[318 427 132  64 496],18,5,25116,4.680581438688036,80.0,0.0
5366,0,5366,[318 427 132  64 496],535,5,25121,4.680640953978013,80.0,0.0
5367,0,5367,[318 427 132  64 496],151,5,25126,4.68070044709389,80.0,0.0
5368,0,5368,[318 427 132  64 496],151,5,25131,4.680759918048054,80.0,0.0
5369,0,5369,[318 427 132  64 496],556,5,25136,4.680819366852886,80.0,0.0
5370,0,5370,[318 427 132  64 496],577,5,25141,4.680878793520759,80.0,0.0
5371,0,5371,[318 427 132  64 496],236,4,25145,4.680752047654505,80.0,0.0
5372,0,5372,[318 427 132  64 496],18,5,25150,4.680811464731063,80.0,0.0
5373,0,5373,[318 427 132  64 496],450,5,25155,4.680870859694827,80.0,0.0
5374,0,5374,[318 427 132  64 496],151,5,25160,4.68093023255814,80.0,0.0
5375,0,5375,[318 427 132  64 496],151,5,25165,4.680989583333333,80.0,0.0
5376,0,5376,[318 427 132  64 496],556,5,25170,4.681048912032732,80.0,0.0
5377,0,5377,[318 427 132  64 496],716,5,25175,4.68110821866865,80.0,0.0
5378,0,5378,[318 427 132  64 496],556,5,25180,4.681167503253393,80.0,0.0
5379,0,5379,[318 427 132  64 496],236,4,25184,4.681040892193309,80.0,0.0
5380,0,5380,[318 427 132  64 496],716,5,25189,4.681100167255157,80.0,0.0
5381,0,5381,[318 427 132  64 496],535,5,25194,4.681159420289855,80.0,0.0
5382,0,5382,[318 427 132  64 496],18,5,25199,4.6812186513096785,80.0,0.0
5383,0,5383,[318 427 132  64 496],236,4,25203,4.681092124814264,80.0,0.0
5384,0,5384,[318 427 132  64 496],577,5,25208,4.681151346332405,80.0,0.0
5385,0,5385,[318 427 132  64 496],18,5,25213,4.681210545859636,80.0,0.0
5386,0,5386,[318 427 132  64 496],796,5,25218,4.681269723408205,80.0,0.0
5387,0,5387,[318 427 132  64 496],236,4,25222,4.6811432813659986,80.0,0.0
5388,0,5388,[318 427 132  64 496],535,5,25227,4.681202449434032,80.0,0.0
5389,0,5389,[318 427 132  64 496],269,5,25232,4.68126159554731,80.0,0.0
5390,0,5390,[318 427 132  64 496],796,5,25237,4.681320719718048,80.0,0.0
5391,0,5391,[318 427 132  64 496],535,5,25242,4.681379821958457,80.0,0.0
5392,0,5392,[318 427 132  64 496],236,4,25246,4.681253476729093,80.0,0.0
5393,0,5393,[318 427 132  64 496],330,5,25251,4.68131256952169,80.0,0.0
5394,0,5394,[318 427 132  64 496],18,5,25256,4.681371640407785,80.0,0.0
5395,0,5395,[318 427 132  64 496],450,5,25261,4.681430689399555,80.0,0.0
5396,0,5396,[318 427 132  64 496],269,5,25266,4.681489716509172,80.0,0.0
5397,0,5397,[318 427 132  64 496],535,5,25271,4.681548721748796,80.0,0.0
5398,0,5398,[318 427 132  64 496],556,5,25276,4.681607705130579,80.0,0.0
5399,0,5399,[318 427 132  64 496],796,5,25281,4.681666666666667,80.0,0.0
5400,0,5400,[318 427 132  64 496],577,5,25286,4.6817256063691906,80.0,0.0
5401,0,5401,[196 144 282 568 186],457,5,25291,4.681784524250277,0.0,0.0
5402,0,5402,[318 427 132  64 496],151,5,25296,4.681843420322044,80.0,0.0
5403,0,5403,[ 25 276 282 173 216],593,3,25299,4.681532198371577,0.0,0.0
5404,0,5404,[318 427 132  64 496],450,5,25304,4.68159111933395,80.0,0.0
5405,0,5405,[318 427 132  64 496],236,4,25308,4.681465038845727,80.0,0.0
5406,0,5406,[ 11 197 187 234 238],716,4,25312,4.681339004993527,0.0,0.0
5407,0,5407,[318 427 132  64 496],330,5,25317,4.681397928994083,80.0,0.0
5408,0,5408,[318 427 132  64 496],535,5,25322,4.681456831207247,80.0,0.0
5409,0,5409,[318 427 132  64 496],577,5,25327,4.681515711645102,80.0,0.0
5410,0,5410,[318 427 132  64 496],716,5,25332,4.681574570319719,80.0,0.0
5411,0,5411,[318 427 132  64 496],556,5,25337,4.681633407243163,80.0,0.0
5412,0,5412,[318 427 132  64 496],556,5,25342,4.68169222242749,80.0,0.0
5413,0,5413,[318 427 132  64 496],18,5,25347,4.6817510158847435,80.0,0.0
5414,0,5414,[318 427 132  64 496],151,5,25352,4.681809787626962,80.0,0.0
5415,0,5415,[318 427 132  64 496],269,5,25357,4.681868537666174,80.0,0.0
5416,0,5416,[318 427 132  64 496],716,5,25362,4.681927266014399,80.0,0.0
5417,0,5417,[318 427 132  64 496],796,5,25367,4.6819859726836475,80.0,0.0
5418,0,5418,[318 427 132  64 496],577,5,25372,4.68204465768592,80.0,0.0
5419,0,5419,[161 182 322  97 288],593,3,25375,4.681734317343174,0.0,0.0
5420,0,5420,[318 427 132  64 496],716,5,25380,4.681793027116768,80.0,0.0
5421,0,5421,[318 427 132  64 496],151,5,25385,4.681851715234231,80.0,0.0
5422,0,5422,[318 427 132  64 496],535,5,25390,4.681910381707542,80.0,0.0
5423,0,5423,[318 427 132  64 496],18,5,25395,4.681969026548672,80.0,0.0
5424,0,5424,[318 427 132  64 496],450,5,25400,4.682027649769585,80.0,0.0
5425,0,5425,[318 427 132  64 496],151,5,25405,4.682086251382234,80.0,0.0
5426,0,5426,[318 427 132  64 496],18,5,25410,4.6821448313985625,80.0,0.0
5427,0,5427,[318 427 132  64 496],151,5,25415,4.682203389830509,80.0,0.0
5428,0,5428,[318 427 132  64 496],236,4,25419,4.682077730705471,80.0,0.0
5429,0,5429,[318 427 132  64 496],330,5,25424,4.682136279926335,80.0,0.0
5430,0,5430,[185 286  50  89  82],18,2,25426,4.681642423126496,0.0,40.0
5431,0,5431,[318 427 132  64 496],556,5,25431,4.681701030927835,80.0,0.0
5432,0,5432,[318 427 132  64 496],269,5,25436,4.681759617154427,80.0,0.0
5433,0,5433,[318 427 132  64 496],716,5,25441,4.681818181818182,80.0,0.0
5434,0,5434,[318 427 132  64 496],151,5,25446,4.681876724931003,80.0,0.0
5435,0,5435,[318 427 132  64 496],450,5,25451,4.681935246504783,80.0,0.0
5436,0,5436,[318 427 132  64 496],18,5,25456,4.681993746551407,80.0,0.0
5437,0,5437,[318 427 132  64 496],796,5,25461,4.682052225082751,80.0,0.0
5438,0,5438,[318 427 132  64 496],330,5,25466,4.682110682110682,80.0,0.0
5439,0,5439,[318 427 132  64 496],796,5,25471,4.682169117647059,80.0,0.0
5440,0,5440,[318 427 132  64 496],796,5,25476,4.682227531703731,80.0,0.0
5441,0,5441,[318 427 132  64 496],151,5,25481,4.68228592429254,80.0,0.0
5442,0,5442,[318 427 132  64 496],151,5,25486,4.682344295425317,80.0,0.0
5443,0,5443,[318 427 132  64 496],269,5,25491,4.6824026451138865,80.0,0.0
5444,0,5444,[318 427 132  64 496],796,5,25496,4.682460973370064,80.0,0.0
5445,0,5445,[318 427 132  64 496],556,5,25501,4.682519280205655,80.0,0.0
5446,0,5446,[318 427 132  64 496],450,5,25506,4.682577565632458,80.0,0.0
5447,0,5447,[318 427 132  64 496],716,5,25511,4.682635829662261,80.0,0.0
5448,0,5448,[318 427 132  64 496],330,5,25516,4.6826940723068455,80.0,0.0
5449,0,5449,[318 427 132  64 496],269,5,25521,4.682752293577981,80.0,0.0
5450,0,5450,[318 427 132  64 496],18,5,25526,4.682810493487433,80.0,0.0
5451,0,5451,[318 427 132  64 496],450,5,25531,4.682868672046955,80.0,0.0
5452,0,5452,[318 427 132  64 496],330,5,25536,4.682926829268292,80.0,0.0
5453,0,5453,[318 427 132  64 496],330,5,25541,4.682984965163183,80.0,0.0
5454,0,5454,[318 427 132  64 496],796,5,25546,4.683043079743355,80.0,0.0
5455,0,5455,[318 427 132  64 496],18,5,25551,4.683101173020527,80.0,0.0
5456,0,5456,[318 427 132  64 496],535,5,25556,4.683159245006414,80.0,0.0
5457,0,5457,[318 427 132  64 496],556,5,25561,4.683217295712716,80.0,0.0
5458,0,5458,[318 427 132  64 496],577,5,25566,4.6832753251511265,80.0,0.0
5459,0,5459,[100 111 125 275  97],655,1,25567,4.682600732600733,0.0,40.0
5460,0,5460,[318 427 132  64 496],151,5,25572,4.682658853689801,80.0,0.0
5461,0,5461,[318 427 132  64 496],151,5,25577,4.682716953496888,80.0,0.0
5462,0,5462,[318 427 132  64 496],556,5,25582,4.682775032033681,80.0,0.0
5463,0,5463,[318 427 132  64 496],236,4,25586,4.682650073206442,80.0,0.0
5464,0,5464,[318 427 132  64 496],577,5,25591,4.682708142726441,80.0,0.0
5465,0,5465,[318 427 132  64 496],18,5,25596,4.682766190998902,80.0,0.0
5466,0,5466,[318 427 132  64 496],269,5,25601,4.682824218035486,80.0,0.0
5467,0,5467,[318 427 132  64 496],18,5,25606,4.682882223847842,80.0,0.0
5468,0,5468,[318 427 132  64 496],18,5,25611,4.682940208447614,80.0,0.0
5469,0,5469,[318 427 132  64 496],716,5,25616,4.682998171846435,80.0,0.0
5470,0,5470,[318 427 132  64 496],236,4,25620,4.682873332114787,80.0,0.0
5471,0,5471,[318 427 132  64 496],450,5,25625,4.6829312865497075,80.0,0.0
5472,0,5472,[318 427 132  64 496],450,5,25630,4.682989219806322,80.0,0.0
5473,0,5473,[318 427 132  64 496],330,5,25635,4.683047131896236,80.0,0.0
5474,0,5474,[318 427 132  64 496],450,5,25640,4.68310502283105,80.0,0.0
5475,0,5475,[318 427 132  64 496],330,5,25645,4.683162892622352,80.0,0.0
5476,0,5476,[318 427 132  64 496],556,5,25650,4.6832207412817235,80.0,0.0
5477,0,5477,[318 427 132  64 496],577,5,25655,4.683278568820738,80.0,0.0
5478,0,5478,[318 427 132  64 496],716,5,25660,4.683336375250958,80.0,0.0
5479,0,5479,[318 427 132  64 496],269,5,25665,4.6833941605839415,80.0,0.0
5480,0,5480,[318 427 132  64 496],556,5,25670,4.683451924831235,80.0,0.0
5481,0,5481,[318 427 132  64 496],269,5,25675,4.683509668004378,80.0,0.0
5482,0,5482,[318 427 132  64 496],577,5,25680,4.6835673901149,80.0,0.0
5483,0,5483,[318 427 132  64 496],535,5,25685,4.683625091174325,80.0,0.0
5484,0,5484,[318 427 132  64 496],236,4,25689,4.683500455788514,80.0,0.0
5485,0,5485,[318 427 132  64 496],330,5,25694,4.683558148013124,80.0,0.0
5486,0,5486,[318 427 132  64 496],151,5,25699,4.68361581920904,80.0,0.0
5487,0,5487,[318 427 132  64 496],269,5,25704,4.683673469387755,80.0,0.0
5488,0,5488,[318 427 132  64 496],151,5,25709,4.683731098560758,80.0,0.0
5489,0,5489,[ 56 302 405  98 655],151,3,25712,4.683424408014572,0.0,0.0
5490,0,5490,[318 427 132  64 496],330,5,25717,4.683482061555273,80.0,0.0
5491,0,5491,[318 427 132  64 496],18,5,25722,4.68353969410051,80.0,0.0
5492,0,5492,[318 427 132  64 496],556,5,25727,4.683597305661752,80.0,0.0
5493,0,5493,[318 427 132  64 496],556,5,25732,4.683654896250455,80.0,0.0
5494,0,5494,[318 427 132  64 496],236,4,25736,4.683530482256597,80.0,0.0
5495,0,5495,[318 427 132  64 496],796,5,25741,4.683588064046579,80.0,0.0
5496,0,5496,[318 427 132  64 496],535,5,25746,4.683645624886301,80.0,0.0
5497,0,5497,[318 427 132  64 496],269,5,25751,4.683703164787195,80.0,0.0
5498,0,5498,[318 427 132  64 496],535,5,25756,4.683760683760684,80.0,0.0
5499,0,5499,[318 427 132  64 496],269,5,25761,4.683818181818181,80.0,0.0
5500,0,5500,[204 187 194 546 111],450,5,25766,4.683875658971096,0.0,0.0
5501,0,5501,[318 427 132  64 496],269,5,25771,4.6839331152308255,80.0,0.0
5502,0,5502,[318 427 132  64 496],236,4,25775,4.683808831546429,80.0,0.0
5503,0,5503,[211  96 181 276  11],655,1,25776,4.683139534883721,0.0,0.0
5504,0,5504,[318 427 132  64 496],151,5,25781,4.683197093551317,80.0,0.0
5505,0,5505,[318 427 132  64 496],151,5,25786,4.683254631311296,80.0,0.0
5506,0,5506,[318 427 132  64 496],716,5,25791,4.68331214817505,80.0,0.0
5507,0,5507,[318 427 132  64 496],577,5,25796,4.683369644153958,80.0,0.0
5508,0,5508,[318 427 132  64 496],151,5,25801,4.6834271192593935,80.0,0.0
5509,0,5509,[318 427 132  64 496],535,5,25806,4.683484573502723,80.0,0.0
5510,0,5510,[318 427 132  64 496],556,5,25811,4.6835420068953,80.0,0.0
5511,0,5511,[318 427 132  64 496],577,5,25816,4.683599419448476,80.0,0.0
5512,0,5512,[318 427 132  64 496],450,5,25821,4.68365681117359,80.0,0.0
5513,0,5513,[318 427 132  64 496],450,5,25826,4.683714182081973,80.0,0.0
5514,0,5514,[318 427 132  64 496],535,5,25831,4.6837715321849505,80.0,0.0
5515,0,5515,[318 427 132  64 496],151,5,25836,4.683828861493836,80.0,0.0
5516,0,5516,[318 427 132  64 496],716,5,25841,4.683886170019939,80.0,0.0
5517,0,5517,[318 427 132  64 496],577,5,25846,4.683943457774556,80.0,0.0
5518,0,5518,[318 427 132  64 496],556,5,25851,4.68400072476898,80.0,0.0
5519,0,5519,[318 427 132  64 496],556,5,25856,4.684057971014493,80.0,0.0
5520,0,5520,[318 427 132  64 496],269,5,25861,4.684115196522369,80.0,0.0
5521,0,5521,[318 427 132  64 496],556,5,25866,4.684172401303876,80.0,0.0
5522,0,5522,[318 427 132  64 496],556,5,25871,4.68422958537027,80.0,0.0
5523,0,5523,[268   9 282 276 176],655,1,25872,4.68356263577118,0.0,0.0
5524,0,5524,[318 427 132  64 496],716,5,25877,4.683619909502262,80.0,0.0
5525,0,5525,[318 427 132  64 496],151,5,25882,4.683677162504524,80.0,0.0
5526,0,5526,[318 427 132  64 496],151,5,25887,4.683734394789217,80.0,0.0
5527,0,5527,[318 427 132  64 496],151,5,25892,4.683791606367583,80.0,0.0
5528,0,5528,[318 427 132  64 496],18,5,25897,4.683848797250859,80.0,0.0
5529,0,5529,[318 427 132  64 496],330,5,25902,4.683905967450271,80.0,0.0
5530,0,5530,[318 427 132  64 496],716,5,25907,4.683963116977038,80.0,0.0
5531,0,5531,[318 427 132  64 496],577,5,25912,4.684020245842372,80.0,0.0
5532,0,5532,[318 427 132  64 496],556,5,25917,4.684077354057473,80.0,0.0
5533,0,5533,[318 427 132  64 496],236,4,25921,4.683953740513191,80.0,0.0
5534,0,5534,[318 427 132  64 496],577,5,25926,4.684010840108401,80.0,0.0
5535,0,5535,[318 427 132  64 496],330,5,25931,4.684067919075145,80.0,0.0
5536,0,5536,[318 427 132  64 496],796,5,25936,4.684124977424598,80.0,0.0
5537,0,5537,[318 427 132  64 496],716,5,25941,4.684182015167931,80.0,0.0
5538,0,5538,[318 427 132  64 496],796,5,25946,4.684239032316302,80.0,0.0
5539,0,5539,[318 427 132  64 496],18,5,25951,4.684296028880866,80.0,0.0
5540,0,5540,[318 427 132  64 496],151,5,25956,4.684353004872767,80.0,0.0
5541,0,5541,[318 427 132  64 496],151,5,25961,4.68440996030314,80.0,0.0
5542,0,5542,[318 427 132  64 496],535,5,25966,4.684466895183114,80.0,0.0
5543,0,5543,[318 427 132  64 496],269,5,25971,4.684523809523809,80.0,0.0
5544,0,5544,[318 427 132  64 496],236,4,25975,4.684400360685302,80.0,0.0
5545,0,5545,[318 427 132  64 496],330,5,25980,4.684457266498377,80.0,0.0
5546,0,5546,[318 427 132  64 496],18,5,25985,4.6845141517937625,80.0,0.0
5547,0,5547,[318 427 132  64 496],18,5,25990,4.684571016582552,80.0,0.0
5548,0,5548,[318 427 132  64 496],269,5,25995,4.684627860875834,80.0,0.0
5549,0,5549,[318 427 132  64 496],18,5,26000,4.684684684684685,80.0,0.0
5550,0,5550,[318 427 132  64 496],18,5,26005,4.684741488020177,80.0,0.0
5551,0,5551,[385  69 111 153 245],450,5,26010,4.6847982708933715,0.0,0.0
5552,0,5552,[318 427 132  64 496],269,5,26015,4.684855033315325,80.0,0.0
5553,0,5553,[318 427 132  64 496],796,5,26020,4.684911775297083,80.0,0.0
5554,0,5554,[318 427 132  64 496],796,5,26025,4.6849684968496845,80.0,0.0
5555,0,5555,[318 427 132  64 496],556,5,26030,4.685025197984161,80.0,0.0
5556,0,5556,[318 427 132  64 496],269,5,26035,4.685081878711535,80.0,0.0
5557,0,5557,[318 427 132  64 496],796,5,26040,4.685138539042821,80.0,0.0
5558,0,5558,[318 427 132  64 496],236,4,26044,4.685015290519877,80.0,0.0
5559,0,5559,[318 427 132  64 496],236,4,26048,4.684892086330935,80.0,0.0
5560,0,5560,[318 427 132  64 496],556,5,26053,4.6849487502247795,80.0,0.0
5561,0,5561,[318 427 132  64 496],535,5,26058,4.685005393743258,80.0,0.0
5562,0,5562,[318 427 132  64 496],151,5,26063,4.685062016897358,80.0,0.0
5563,0,5563,[318 427 132  64 496],796,5,26068,4.685118619698059,80.0,0.0
5564,0,5564,[318 427 132  64 496],450,5,26073,4.685175202156334,80.0,0.0
5565,0,5565,[318 427 132  64 496],450,5,26078,4.685231764283148,80.0,0.0
5566,0,5566,[318 427 132  64 496],269,5,26083,4.685288306089456,80.0,0.0
5567,0,5567,[318 427 132  64 496],450,5,26088,4.685344827586207,80.0,0.0
5568,0,5568,[318 427 132  64 496],535,5,26093,4.685401328784342,80.0,0.0
5569,0,5569,[318 427 132  64 496],236,4,26097,4.685278276481149,80.0,0.0
5570,0,5570,[318 427 132  64 496],556,5,26102,4.685334769341232,80.0,0.0
5571,0,5571,[318 427 132  64 496],450,5,26107,4.685391241923905,80.0,0.0
5572,0,5572,[318 427 132  64 496],330,5,26112,4.685447694240086,80.0,0.0
5573,0,5573,[318 427 132  64 496],236,4,26116,4.685324721923215,80.0,0.0
5574,0,5574,[202 405 196 191 194],450,5,26121,4.685381165919282,0.0,0.0
5575,0,5575,[318 427 132  64 496],151,5,26126,4.6854375896700144,80.0,0.0
5576,0,5576,[318 427 132  64 496],450,5,26131,4.6854939931863,80.0,0.0
5577,0,5577,[318 427 132  64 496],577,5,26136,4.685550376479025,80.0,0.0
5578,0,5578,[318 427 132  64 496],716,5,26141,4.685606739559061,80.0,0.0
5579,0,5579,[318 427 132  64 496],556,5,26146,4.685663082437276,80.0,0.0
5580,0,5580,[318 427 132  64 496],577,5,26151,4.685719405124529,80.0,0.0
5581,0,5581,[318 427 132  64 496],556,5,26156,4.685775707631673,80.0,0.0
5582,0,5582,[318 427 132  64 496],716,5,26161,4.68583198996955,80.0,0.0
5583,0,5583,[318 427 132  64 496],535,5,26166,4.685888252148997,80.0,0.0
5584,0,5584,[318 427 132  64 496],236,4,26170,4.685765443151298,80.0,0.0
5585,0,5585,[318 427 132  64 496],450,5,26175,4.685821697099892,80.0,0.0
5586,0,5586,[318 427 132  64 496],556,5,26180,4.685877930911044,80.0,0.0
5587,0,5587,[318 427 132  64 496],796,5,26185,4.685934144595562,80.0,0.0
5588,0,5588,[300 245 333  95 173],796,4,26189,4.685811415280014,0.0,0.0
5589,0,5589,[168 318 300 174  22],716,5,26194,4.685867620751342,20.0,0.0
5590,0,5590,[318 427 132  64 496],577,5,26199,4.685923806116974,80.0,0.0
5591,0,5591,[318 427 132  64 496],236,4,26203,4.685801144492132,80.0,0.0
5592,0,5592,[318 427 132  64 496],577,5,26208,4.685857321652065,80.0,0.0
5593,0,5593,[318 427 132  64 496],151,5,26213,4.685913478727207,80.0,0.0
5594,0,5594,[318 427 132  64 496],556,5,26218,4.685969615728329,80.0,0.0
5595,0,5595,[318 427 132  64 496],796,5,26223,4.68602573266619,80.0,0.0
5596,0,5596,[318 427 132  64 496],151,5,26228,4.686081829551545,80.0,0.0
5597,0,5597,[318 427 132  64 496],330,5,26233,4.686137906395141,80.0,0.0
5598,0,5598,[318 427 132  64 496],236,4,26237,4.686015359885694,80.0,0.0
5599,0,5599,[318 427 132  64 496],450,5,26242,4.686071428571428,80.0,0.0
5600,0,5600,[318 427 132  64 496],450,5,26247,4.686127477236208,80.0,0.0
5601,0,5601,[318 427 132  64 496],556,5,26252,4.686183505890753,80.0,0.0
5602,0,5602,[318 427 132  64 496],236,4,26256,4.686061038729252,80.0,0.0
5603,0,5603,[318 427 132  64 496],556,5,26261,4.686117059243397,80.0,0.0
5604,0,5604,[318 427 132  64 496],556,5,26266,4.686173059768064,80.0,0.0
5605,0,5605,[318 427 132  64 496],535,5,26271,4.6862290403139495,80.0,0.0
5606,0,5606,[318 427 132  64 496],577,5,26276,4.6862850008917425,80.0,0.0
5607,0,5607,[318 427 132  64 496],269,5,26281,4.6863409415121255,80.0,0.0
5608,0,5608,[318 427 132  64 496],796,5,26286,4.686396862185773,80.0,0.0
5609,0,5609,[318 427 132  64 496],236,4,26290,4.686274509803922,80.0,0.0
5610,0,5610,[318 427 132  64 496],535,5,26295,4.686330422384602,80.0,0.0
5611,0,5611,[  7  12 111 265 276],629,4,26299,4.686208125445474,0.0,0.0
5612,0,5612,[318 427 132  64 496],236,4,26303,4.686085872082665,80.0,0.0
5613,0,5613,[318 427 132  64 496],236,4,26307,4.685963662272889,80.0,0.0
5614,0,5614,[318 427 132  64  98],655,4,26311,4.685841495992876,60.0,0.0
5615,0,5615,[318 427 132  64  98],18,5,26316,4.685897435897436,60.0,0.0
5616,0,5616,[318 427 132  64  98],655,4,26320,4.685775324906534,60.0,0.0
5617,0,5617,[318 427 132  64  98],18,5,26325,4.685831256674973,60.0,0.0
5618,0,5618,[318 427 132  64  98],577,5,26330,4.685887168535326,60.0,0.0
5619,0,5619,[318 427 132  64  98],330,5,26335,4.685943060498221,60.0,0.0
5620,0,5620,[318 427 132  64  98],450,5,26340,4.685998932574275,60.0,0.0
5621,0,5621,[318 427 132  64  98],151,5,26345,4.686054784774102,60.0,0.0
5622,0,5622,[318 427 132  64  98],796,5,26350,4.686110617108305,60.0,0.0
5623,0,5623,[318 427 132  64  98],577,5,26355,4.686166429587482,60.0,0.0
5624,0,5624,[318 427 132  64  98],450,5,26360,4.686222222222222,60.0,0.0
5625,0,5625,[318 427 132  64  98],655,4,26364,4.6861002488446495,60.0,0.0
5626,0,5626,[318 427 132  64  98],716,5,26369,4.686156033410343,60.0,0.0
5627,0,5627,[318 427 132  64  98],716,5,26374,4.6862117981520965,60.0,0.0
5628,0,5628,[318 427 132  64  98],151,5,26379,4.6862675430804765,60.0,0.0
5629,0,5629,[318 427 132  64  98],330,5,26384,4.686323268206039,60.0,0.0
5630,0,5630,[ 56 117 153 403 294],280,3,26387,4.686023796838928,0.0,0.0
5631,0,5631,[318 427 132  64  98],796,5,26392,4.686079545454546,60.0,0.0
5632,0,5632,[318 427 132  64  98],18,5,26397,4.686135274276585,60.0,0.0
5633,0,5633,[318 427 132  64  98],450,5,26402,4.686190983315584,60.0,0.0
5634,0,5634,[318 427 132  64  98],269,5,26407,4.686246672582076,60.0,0.0
5635,0,5635,[318 427 132  64  98],796,5,26412,4.686302342086586,60.0,0.0
5636,0,5636,[318 427 132  64  98],796,5,26417,4.686357991839631,60.0,0.0
5637,0,5637,[318 427 132  64  98],151,5,26422,4.68641362185172,60.0,0.0
5638,0,5638,[318 427 132  64  98],577,5,26427,4.686469232133357,60.0,0.0
5639,0,5639,[318 427 132  64  98],693,4,26431,4.686347517730496,60.0,0.0
5640,0,5640,[318 427 132  64  98],535,4,26435,4.68622584648112,60.0,0.0
5641,0,5641,[318 427 132  64  98],535,4,26439,4.686104218362283,60.0,0.0
5642,0,5642,[318 427 132  64  98],450,5,26444,4.686159844054581,60.0,0.0
5643,0,5643,[318 427 132  64  98],18,5,26449,4.686215450035436,60.0,0.0
5644,0,5644,[318 427 132  64  98],716,5,26454,4.686271036315324,60.0,0.0
5645,0,5645,[318 427 132  64  98],535,4,26458,4.6861494863620266,60.0,0.0
5646,0,5646,[318 427 132  64 127],693,4,26462,4.686027979458119,60.0,20.0
5647,0,5647,[318 427 132  64 127],18,5,26467,4.686083569405099,60.0,20.0
5648,0,5648,[318 427 132  64 127],269,5,26472,4.686139139670738,60.0,20.0
5649,0,5649,[318 427 132  64 127],655,4,26476,4.686017699115045,60.0,20.0
5650,0,5650,[655 318 181  56 483],716,5,26481,4.686073261369669,20.0,0.0
5651,0,5651,[318 427 132  64 127],796,5,26486,4.686128803963199,60.0,20.0
5652,0,5652,[318 427 132  64 127],18,5,26491,4.6861843269060675,60.0,20.0
5653,0,5653,[318 427 132  64 127],236,5,26496,4.686239830208701,60.0,20.0
5654,0,5654,[318 427 132  64 127],18,5,26501,4.686295313881521,60.0,20.0
5655,0,5655,[318 427 132  64 127],693,4,26505,4.686173974540311,60.0,20.0
5656,0,5656,[318 427 132  64 127],796,5,26510,4.686229450238643,60.0,20.0
5657,0,5657,[318 427 132  64 127],655,4,26514,4.686108165429481,60.0,20.0
5658,0,5658,[318 427 132  64 127],556,5,26519,4.686163633150733,60.0,20.0
5659,0,5659,[318 427 132  64 127],796,5,26524,4.6862190812720845,60.0,20.0
5660,0,5660,[318 427 132  64 127],796,5,26529,4.686274509803922,60.0,20.0
5661,0,5661,[318 427 132  64 127],693,4,26533,4.686153302719887,60.0,20.0
5662,0,5662,[318 427 132  64 127],655,4,26537,4.686032138442521,60.0,20.0
5663,0,5663,[318 427 132  64 127],236,5,26542,4.686087570621469,60.0,20.0
5664,0,5664,[318 427 132  64 127],556,5,26547,4.686142983230362,60.0,20.0
5665,0,5665,[318 427 132  64 127],450,5,26552,4.686198376279562,60.0,20.0
5666,0,5666,[318 427 132  64 127],450,5,26557,4.686253749779425,60.0,20.0
5667,0,5667,[318 427 132  64 127],18,5,26562,4.686309103740296,60.0,20.0
5668,0,5668,[318 427 132  64 127],18,5,26567,4.686364438172517,60.0,20.0
5669,0,5669,[318 427 132  64 127],655,4,26571,4.686243386243386,60.0,20.0
5670,0,5670,[318 427 132  64 127],693,4,26575,4.686122377005819,60.0,20.0
5671,0,5671,[318 427 132  64 127],796,5,26580,4.686177715091678,60.0,20.0
5672,0,5672,[318 427 132  64 127],796,5,26585,4.686233033668253,60.0,20.0
5673,0,5673,[318 427 132  64 127],796,5,26590,4.686288332745859,60.0,20.0
5674,0,5674,[318 427 132  64 127],18,5,26595,4.6863436123348015,60.0,20.0
5675,0,5675,[318 427 132  64 127],655,4,26599,4.686222692036646,60.0,20.0
5676,0,5676,[318 427 132  64 127],716,5,26604,4.686277963713229,60.0,20.0
5677,0,5677,[318 427 132  64 127],716,5,26609,4.686333215921099,60.0,20.0
5678,0,5678,[318 427 132  64 127],716,5,26614,4.686388448670541,60.0,20.0
5679,0,5679,[318 427 132  64 127],236,5,26619,4.686443661971831,60.0,20.0
5680,0,5680,[318 427 132  64 127],716,5,26624,4.68649885583524,60.0,20.0
5681,0,5681,[318 427 132  64 127],796,5,26629,4.686554030271031,60.0,20.0
5682,0,5682,[318 427 132  64 127],556,5,26634,4.68660918528946,60.0,20.0
5683,0,5683,[125 222 228 191 288],450,3,26637,4.686312456016889,0.0,0.0
5684,0,5684,[318 427 132  64 127],269,5,26642,4.68636763412489,60.0,20.0
5685,0,5685,[318 427 132  64 127],556,5,26647,4.686422792824481,60.0,20.0
5686,0,5686,[ 22   7  97 127 678],344,2,26649,4.68595041322314,0.0,20.0
5687,0,5687,[318 427 132  64 127],796,5,26654,4.6860056258790435,60.0,20.0
5688,0,5688,[318 427 132  64 127],316,4,26658,4.685885041307787,60.0,20.0
5689,0,5689,[318 427 132  64 127],450,5,26663,4.6859402460456945,60.0,20.0
5690,0,5690,[318 427 132  64 127],556,5,26668,4.685995431382885,60.0,20.0
5691,0,5691,[318 427 132  64 127],18,5,26673,4.686050597329586,60.0,20.0
5692,0,5692,[318 427 132  64 127],796,5,26678,4.686105743896013,60.0,20.0
5693,0,5693,[318 427 132  64 127],18,5,26683,4.686160871092378,60.0,20.0
5694,0,5694,[318 427 132  64 127],450,5,26688,4.686215978928885,60.0,20.0
5695,0,5695,[318 427 132  64 127],796,5,26693,4.68627106741573,60.0,20.0
5696,0,5696,[318 427 132  64 127],269,5,26698,4.686326136563103,60.0,20.0
5697,0,5697,[318 427 132  64 127],796,5,26703,4.686381186381186,60.0,20.0
5698,0,5698,[318 427 132  64 127],796,5,26708,4.686436216880154,60.0,20.0
5699,0,5699,[318 427 132  64 127],316,4,26712,4.686315789473684,60.0,20.0
5700,0,5700,[318 427 132  64 127],655,4,26716,4.686195404315033,60.0,20.0
5701,0,5701,[318 427  64 132 127],18,5,26721,4.686250438442651,60.0,20.0
5702,0,5702,[318 427  64 132 127],316,4,26725,4.686130106961248,60.0,20.0
5703,0,5703,[318 427  64 132 127],716,5,26730,4.686185133239832,60.0,20.0
5704,0,5704,[318 427  64 132 127],796,5,26735,4.68624014022787,60.0,20.0
5705,0,5705,[318 427  64 132 127],316,4,26739,4.686119873817034,60.0,20.0
5706,0,5706,[318 427  64 132 127],316,4,26743,4.68599964955318,60.0,20.0
5707,0,5707,[318 427  64 132 127],269,5,26748,4.686054660126139,60.0,20.0
5708,0,5708,[318 427  64 132 127],236,5,26753,4.686109651427571,60.0,20.0
5709,0,5709,[318 427  64 132 127],450,5,26758,4.686164623467601,60.0,20.0
5710,0,5710,[318 427  64 132 127],236,5,26763,4.686219576256347,60.0,20.0
5711,0,5711,[318 427  64 132 127],716,5,26768,4.686274509803922,60.0,20.0
5712,0,5712,[318 427  64 132 127],450,5,26773,4.686329424120427,60.0,20.0
5713,0,5713,[318 427  64 132 127],316,4,26777,4.686209310465523,60.0,20.0
5714,0,5714,[318 427  64 132 496],450,5,26782,4.686264216972878,80.0,0.0
5715,0,5715,[318 427  64 132 496],535,5,26787,4.686319104268719,80.0,0.0
5716,0,5716,[318 427  64 132 496],556,5,26792,4.6863739723631275,80.0,0.0
5717,0,5717,[318 427  64 132 496],796,5,26797,4.686428821266177,80.0,0.0
5718,0,5718,[318 427  64 132 496],151,5,26802,4.686483650987935,80.0,0.0
5719,0,5719,[318 427  64 132 496],450,5,26807,4.686538461538461,80.0,0.0
5720,0,5720,[318 427  64 132 496],18,5,26812,4.68659325292781,80.0,0.0
5721,0,5721,[318 427  64 132 496],716,5,26817,4.686648025166026,80.0,0.0
5722,0,5722,[318 427  64 132 496],18,5,26822,4.6867027782631485,80.0,0.0
5723,0,5723,[ 88 508 273 175 202],344,4,26826,4.686582809224318,0.0,0.0
5724,0,5724,[318 427  64 132 496],535,5,26831,4.686637554585153,80.0,0.0
5725,0,5725,[318 427  64 132 496],796,5,26836,4.68669228082431,80.0,0.0
5726,0,5726,[318 427  64 132 496],151,5,26841,4.686746987951807,80.0,0.0
5727,0,5727,[318 427  64 132 496],151,5,26846,4.686801675977653,80.0,0.0
5728,0,5728,[748 135 194  70  22],11,4,26850,4.6866817943794725,0.0,0.0
5729,0,5729,[318 427  64 132 496],151,5,26855,4.68673647469459,80.0,0.0
5730,0,5730,[318 427  64 132 496],236,4,26859,4.686616646309544,80.0,0.0
5731,0,5731,[144  50 100 186 265],450,4,26863,4.686496859734822,0.0,40.0
5732,0,5732,[318 427  64 132 496],577,5,26868,4.686551543694401,80.0,0.0
5733,0,5733,[318 427  64 132 496],330,5,26873,4.686606208580398,80.0,0.0
5734,0,5734,[318 427  64 132 496],716,5,26878,4.68666085440279,80.0,0.0
5735,0,5735,[318 427  64 132 496],18,5,26883,4.686715481171548,80.0,0.0
5736,0,5736,[318 427  64 132 496],535,5,26888,4.686770088896636,80.0,0.0
5737,0,5737,[318 427  64 132 496],269,5,26893,4.686824677588009,80.0,0.0
5738,0,5738,[318 427  64 132 496],556,5,26898,4.68687924725562,80.0,0.0
5739,0,5739,[318 427  64 132 496],269,5,26903,4.686933797909408,80.0,0.0
5740,0,5740,[318 427  64 132 496],796,5,26908,4.68698832955931,80.0,0.0
5741,0,5741,[318 427  64 132 496],450,5,26913,4.687042842215256,80.0,0.0
5742,0,5742,[318 427  64 132 496],716,5,26918,4.687097335887167,80.0,0.0
5743,0,5743,[318 427  64 132 496],269,5,26923,4.687151810584958,80.0,0.0
5744,0,5744,[318 427  64 132 496],796,5,26928,4.687206266318538,80.0,0.0
5745,0,5745,[318 427  64 132 496],535,5,26933,4.687260703097807,80.0,0.0
5746,0,5746,[318 427  64 132 496],269,5,26938,4.68731512093266,80.0,0.0
5747,0,5747,[318 427  64 132 496],556,5,26943,4.687369519832985,80.0,0.0
5748,0,5748,[318 427  64 132 496],330,5,26948,4.687423899808662,80.0,0.0
5749,0,5749,[318 427  64 132 496],535,5,26953,4.6874782608695655,80.0,0.0
5750,0,5750,[195 655 597 471  70],450,5,26958,4.687532603025561,0.0,0.0
5751,0,5751,[318 427  64 132 496],236,4,26962,4.687413073713491,80.0,0.0
5752,0,5752,[318 427  64 132 496],577,5,26967,4.6874674083087084,80.0,0.0
5753,0,5753,[318 427  64 132 496],236,4,26971,4.68734793187348,80.0,0.0
5754,0,5754,[318 427  64 132 496],330,5,26976,4.6874022589052995,80.0,0.0
5755,0,5755,[318 427  64 132 496],577,5,26981,4.687456567060458,80.0,0.0
5756,0,5756,[318 427  64 132 496],330,5,26986,4.687510856348792,80.0,0.0
5757,0,5757,[318 427  64 132 496],18,5,26991,4.687565126780132,80.0,0.0
5758,0,5758,[318 427  64 132 496],236,4,26995,4.6874457371071365,80.0,0.0
5759,0,5759,[318 427  64 132  98],535,4,26999,4.687326388888889,60.0,0.0
5760,0,5760,[318 427  64 132 496],556,5,27004,4.687380663079327,80.0,0.0
5761,0,5761,[318 427  64 132 496],151,5,27009,4.687434918431101,80.0,0.0
5762,0,5762,[318 427  64 132 496],716,5,27014,4.687489154954017,80.0,0.0
5763,0,5763,[318 427  64 132 496],796,5,27019,4.687543372657877,80.0,0.0
5764,0,5764,[318 427  64 132 496],450,5,27024,4.687597571552472,80.0,0.0
5765,0,5765,[318 427  64 132 496],577,5,27029,4.687651751647589,80.0,0.0
5766,0,5766,[318 427  64 132 496],18,5,27034,4.6877059129530085,80.0,0.0
5767,0,5767,[318 427  64 132 496],535,5,27039,4.687760055478502,80.0,0.0
5768,0,5768,[ 88 228 172 273   9],344,4,27043,4.687640838966892,0.0,0.0
5769,0,5769,[318 427  64 132 496],716,5,27048,4.687694974003466,80.0,0.0
5770,0,5770,[318 427  64 132 496],796,5,27053,4.687749090278981,80.0,0.0
5771,0,5771,[318 427  64 132 496],796,5,27058,4.687803187803188,80.0,0.0
5772,0,5772,[318 427  64 132 496],236,4,27062,4.687684046423004,80.0,0.0
5773,0,5773,[318 427  64 132 496],716,5,27067,4.687738136473849,80.0,0.0
5774,0,5774,[318 427  64 132 496],556,5,27072,4.687792207792207,80.0,0.0
5775,0,5775,[318 427  64 132 496],236,4,27076,4.687673130193906,80.0,0.0
5776,0,5776,[318 427  64 132 496],269,5,27081,4.687727194045352,80.0,0.0
5777,0,5777,[318 427  64 132 496],535,5,27086,4.687781239183108,80.0,0.0
5778,0,5778,[318 427  64 132 496],269,5,27091,4.687835265616889,80.0,0.0
5779,0,5779,[318 427  64 132 496],269,5,27096,4.687889273356402,80.0,0.0
5780,0,5780,[318 427  64 132 496],18,5,27101,4.6879432624113475,80.0,0.0
5781,0,5781,[318 427  64 132 496],535,5,27106,4.687997232791422,80.0,0.0
5782,0,5782,[318 427  64 132 496],716,5,27111,4.688051184506311,80.0,0.0
5783,0,5783,[318 427  64 132 496],236,4,27115,4.6879322268326415,80.0,0.0
5784,0,5784,[318 427  64 132 496],18,5,27120,4.687986171132239,80.0,0.0
5785,0,5785,[318 427  64 132 496],151,5,27125,4.688040096785344,80.0,0.0
5786,0,5786,[318 427  64 132 496],577,5,27130,4.688094003801624,80.0,0.0
5787,0,5787,[318 427  64 132 496],236,4,27134,4.687975120939876,80.0,0.0
5788,0,5788,[318 427  64 132 496],450,5,27139,4.688029020556227,80.0,0.0
5789,0,5789,[318 427  64 132 496],269,5,27144,4.688082901554404,80.0,0.0
5790,0,5790,[318 427  64 132 496],450,5,27149,4.688136763944051,80.0,0.0
5791,0,5791,[318 427  64 132 496],450,5,27154,4.688190607734807,80.0,0.0
5792,0,5792,[318 427  64 132 496],577,5,27159,4.688244432936302,80.0,0.0
5793,0,5793,[318 427  64 132 496],716,5,27164,4.688298239558164,80.0,0.0
5794,0,5794,[318 427  64 132 496],796,5,27169,4.688352027610009,80.0,0.0
5795,0,5795,[318 427  64 132 496],269,5,27174,4.688405797101449,80.0,0.0
5796,0,5796,[318 427  64 132 496],330,5,27179,4.688459548042091,80.0,0.0
5797,0,5797,[318 427  64 132 496],450,5,27184,4.688513280441532,80.0,0.0
5798,0,5798,[318 427  64 132 496],18,5,27189,4.6885669943093635,80.0,0.0
5799,0,5799,[318 427  64 132 496],556,5,27194,4.688620689655172,80.0,0.0
5800,0,5800,[318 427  64 132 496],269,5,27199,4.688674366488536,80.0,0.0
5801,0,5801,[318 427  64 132 496],151,5,27204,4.688728024819028,80.0,0.0
5802,0,5802,[318 427  64 132 496],18,5,27209,4.688781664656212,80.0,0.0
5803,0,5803,[318 427  64 132 496],269,5,27214,4.688835286009649,80.0,0.0
5804,0,5804,[318 427  64 132 496],269,5,27219,4.688888888888889,80.0,0.0
5805,0,5805,[318 427  64 132 496],716,5,27224,4.688942473303479,80.0,0.0
5806,0,5806,[318 427  64 132 496],535,5,27229,4.688996039262959,80.0,0.0
5807,0,5807,[318 427  64 132 496],236,4,27233,4.6888774104683195,80.0,0.0
5808,0,5808,[318 427  64 132 496],450,5,27238,4.688930969185746,80.0,0.0
5809,0,5809,[318 427  64 132 496],535,5,27243,4.6889845094664375,80.0,0.0
5810,0,5810,[318 427  64 132 496],716,5,27248,4.68903803131991,80.0,0.0
5811,0,5811,[318 427  64 132 496],796,5,27253,4.689091534755678,80.0,0.0
5812,0,5812,[318 427  64 132 496],535,5,27258,4.689145019783244,80.0,0.0
5813,0,5813,[228 191 180 117   8],457,5,27263,4.689198486412109,0.0,0.0
5814,0,5814,[318 427  64 132 496],577,5,27268,4.689251934651763,80.0,0.0
5815,0,5815,[151 258 117 234  89],756,3,27271,4.688961485557084,0.0,0.0
5816,0,5816,[318 427  64 132 496],535,5,27276,4.68901495616297,80.0,0.0
5817,0,5817,[318 427  64 132 496],535,5,27281,4.6890684083877625,80.0,0.0
5818,0,5818,[318 427  64 132 496],269,5,27286,4.689121842240935,80.0,0.0
5819,0,5819,[318 427  64 132 496],535,5,27291,4.689175257731959,80.0,0.0
5820,0,5820,[318 427  64 132 496],450,5,27296,4.6892286548702975,80.0,0.0
5821,0,5821,[318 427  64 132 496],450,5,27301,4.689282033665407,80.0,0.0
5822,0,5822,[318 427  64 132 496],535,5,27306,4.689335394126739,80.0,0.0
5823,0,5823,[276  89 237 515 357],296,5,27311,4.689388736263736,0.0,0.0
5824,0,5824,[318 427  64 132 515],535,4,27315,4.689270386266094,60.0,0.0
5825,0,5825,[318 427  64 132 496],151,5,27320,4.689323721249571,80.0,0.0
5826,0,5826,[318 427  64 132 496],535,5,27325,4.689377037926892,80.0,0.0
5827,0,5827,[318 427  64 132 496],577,5,27330,4.689430336307481,80.0,0.0
5828,0,5828,[216 357 597  88 118],457,4,27334,4.689312060387716,0.0,0.0
5829,0,5829,[318 427  64 132 496],269,5,27339,4.689365351629503,80.0,0.0
5830,0,5830,[318 427  64 132 496],577,5,27344,4.689418624592694,80.0,0.0
5831,0,5831,[318 427  64 132 496],716,5,27349,4.689471879286694,80.0,0.0
5832,0,5832,[318 427  64 132 496],151,5,27354,4.689525115720898,80.0,0.0
5833,0,5833,[318 427  64 132 496],151,5,27359,4.689578333904697,80.0,0.0
5834,0,5834,[318 427  64 132 496],556,5,27364,4.689631533847472,80.0,0.0
5835,0,5835,[318 427  64 132 496],18,5,27369,4.6896847155586014,80.0,0.0
5836,0,5836,[318 427  64 132 496],151,5,27374,4.689737879047456,80.0,0.0
5837,0,5837,[318 427  64 132 496],236,4,27378,4.6896197327852,80.0,0.0
5838,0,5838,[318 427  64 132 496],151,5,27383,4.689672889193355,80.0,0.0
5839,0,5839,[318 427  64 132 496],535,5,27388,4.68972602739726,80.0,0.0
5840,0,5840,[318 427  64 132 496],269,5,27393,4.6897791474062664,80.0,0.0
5841,0,5841,[318 427  64 132 496],18,5,27398,4.689832249229716,80.0,0.0
5842,0,5842,[318 427  64 132 496],716,5,27403,4.689885332876947,80.0,0.0
5843,0,5843,[318 427  64 132 496],450,5,27408,4.689938398357289,80.0,0.0
5844,0,5844,[318 427  64 132 496],577,5,27413,4.689991445680069,80.0,0.0
5845,0,5845,[318 427  64 132 496],18,5,27418,4.690044474854601,80.0,0.0
5846,0,5846,[318 427  64 132 496],269,5,27423,4.6900974858902,80.0,0.0
5847,0,5847,[318 427  64 132 496],535,5,27428,4.69015047879617,80.0,0.0
5848,0,5848,[318 427  64 132 496],556,5,27433,4.690203453581809,80.0,0.0
5849,0,5849,[405 202 403 483  64],457,5,27438,4.69025641025641,20.0,0.0
5850,0,5850,[318 427  64 132 496],18,5,27443,4.69030934882926,80.0,0.0
5851,0,5851,[318 427  64 132 496],716,5,27448,4.690362269309638,80.0,0.0
5852,0,5852,[318 427  64 132 496],18,5,27453,4.690415171706817,80.0,0.0
5853,0,5853,[318 427  64 132 496],330,5,27458,4.690468056030065,80.0,0.0
5854,0,5854,[318 427  64 132 496],796,5,27463,4.690520922288642,80.0,0.0
5855,0,5855,[318 427  64 132 496],18,5,27468,4.690573770491803,80.0,0.0
5856,0,5856,[318 427  64 132 496],796,5,27473,4.690626600648796,80.0,0.0
5857,0,5857,[318 427  64 132 496],716,5,27478,4.690679412768863,80.0,0.0
5858,0,5858,[318 427  64 132 496],450,5,27483,4.690732206861239,80.0,0.0
5859,0,5859,[318 427  64 132 496],535,5,27488,4.690784982935154,80.0,0.0
5860,0,5860,[318 427  64 132 496],269,5,27493,4.69083774099983,80.0,0.0
5861,0,5861,[318 427  64 132 496],450,5,27498,4.690890481064483,80.0,0.0
5862,0,5862,[ 69 423  97 238 275],151,5,27503,4.690943203138325,0.0,20.0
5863,0,5863,[234 117 313 194 187],796,4,27507,4.690825375170532,0.0,0.0
5864,0,5864,[318 427  64 132 496],151,5,27512,4.690878090366581,80.0,0.0
5865,0,5865,[318 427  64 132 496],151,5,27517,4.690930787589499,80.0,0.0
5866,0,5866,[318 427  64 132 496],535,5,27522,4.690983466848475,80.0,0.0
5867,0,5867,[318 427  64 132 496],796,5,27527,4.691036128152692,80.0,0.0
5868,0,5868,[318 427  64 132 496],796,5,27532,4.691088771511331,80.0,0.0
5869,0,5869,[318 427  64 132 496],236,4,27536,4.6909710391822825,80.0,0.0
5870,0,5870,[318 427  64 132 496],330,5,27541,4.6910236756940895,80.0,0.0
5871,0,5871,[318 427  64 132 496],716,5,27546,4.691076294277929,80.0,0.0
5872,0,5872,[318 427  64 132 496],535,5,27551,4.69112889494296,80.0,0.0
5873,0,5873,[318 427  64 132 496],716,5,27556,4.691181477698332,80.0,0.0
5874,0,5874,[318 427  64 132 496],556,5,27561,4.691234042553192,80.0,0.0
5875,0,5875,[318 427  64 132 496],716,5,27566,4.691286589516678,80.0,0.0
5876,0,5876,[318 427  64 132 496],330,5,27571,4.6913391185979245,80.0,0.0
5877,0,5877,[318 427  64 132 496],269,5,27576,4.6913916298060565,80.0,0.0
5878,0,5878,[318 427  64 132 496],330,5,27581,4.6914441231501955,80.0,0.0
5879,0,5879,[318 427  64 132 496],450,5,27586,4.691496598639456,80.0,0.0
5880,0,5880,[318 427  64 132 496],330,5,27591,4.691549056282945,80.0,0.0
5881,0,5881,[318 427  64 132 496],151,5,27596,4.691601496089765,80.0,0.0
5882,0,5882,[318 427  64 132 496],535,5,27601,4.691653918069012,80.0,0.0
5883,0,5883,[318 427  64 132 496],535,5,27606,4.691706322229775,80.0,0.0
5884,0,5884,[318 427  64 132 496],450,5,27611,4.691758708581139,80.0,0.0
5885,0,5885,[318 427  64 132 496],330,5,27616,4.691811077132178,80.0,0.0
5886,0,5886,[318 427  64 132 496],151,5,27621,4.691863427891965,80.0,0.0
5887,0,5887,[318 427  64 132 496],556,5,27626,4.691915760869565,80.0,0.0
5888,0,5888,[318 427  64 132 496],151,5,27631,4.691968076074036,80.0,0.0
5889,0,5889,[318 427  64 132 496],236,4,27635,4.691850594227504,80.0,0.0
5890,0,5890,[318 427  64 132 496],269,5,27640,4.691902902732982,80.0,0.0
5891,0,5891,[318 427  64 132 496],151,5,27645,4.691955193482689,80.0,0.0
5892,0,5892,[318 427  64 132 496],716,5,27650,4.692007466485661,80.0,0.0
5893,0,5893,[318 427  64 132 496],796,5,27655,4.692059721750933,80.0,0.0
5894,0,5894,[318 427  64 132 496],796,5,27660,4.692111959287532,80.0,0.0
5895,0,5895,[318 427  64 132 496],577,5,27665,4.692164179104478,80.0,0.0
5896,0,5896,[318 427  64 132 496],151,5,27670,4.692216381210785,80.0,0.0
5897,0,5897,[318 427  64 132 496],716,5,27675,4.692268565615463,80.0,0.0
5898,0,5898,[318 427  64 132 496],236,4,27679,4.6921512120698425,80.0,0.0
5899,0,5899,[318 427  64 132 496],269,5,27684,4.692203389830508,80.0,0.0
5900,0,5900,[127 187  11 318 234],655,3,27687,4.691916624300966,20.0,20.0
5901,0,5901,[318 427  64 132 496],151,5,27692,4.6919688241274145,80.0,0.0
5902,0,5902,[318 427  64 132 496],236,4,27696,4.691851600880908,80.0,0.0
5903,0,5903,[318 427  64 132 496],535,5,27701,4.69190379403794,80.0,0.0
5904,0,5904,[172 117 196   1 176],716,4,27705,4.691786621507197,0.0,0.0
5905,0,5905,[318 427  64 132 496],269,5,27710,4.691838807991872,80.0,0.0
5906,0,5906,[318 427  64 132 496],577,5,27715,4.691890976807178,80.0,0.0
5907,0,5907,[318 427  64 132 496],330,5,27720,4.691943127962086,80.0,0.0
5908,0,5908,[318 427  64 132 496],796,5,27725,4.691995261465561,80.0,0.0
5909,0,5909,[318 427  64 132 496],577,5,27730,4.692047377326565,80.0,0.0
5910,0,5910,[318 427  64 132 496],269,5,27735,4.692099475554052,80.0,0.0
5911,0,5911,[318 427  64 132 496],716,5,27740,4.692151556156968,80.0,0.0
5912,0,5912,[318 427  64 132 496],577,5,27745,4.692203619144259,80.0,0.0
5913,0,5913,[318 427  64 132 496],151,5,27750,4.692255664524856,80.0,0.0
5914,0,5914,[318 427  64 132 496],18,5,27755,4.6923076923076925,80.0,0.0
5915,0,5915,[318 427  64 132 496],330,5,27760,4.69235970250169,80.0,0.0
5916,0,5916,[318 427  64 132 496],151,5,27765,4.692411695115768,80.0,0.0
5917,0,5917,[318 427  64 132 496],236,4,27769,4.69229469415343,80.0,0.0
5918,0,5918,[318 427  64 132 496],535,5,27774,4.692346680182463,80.0,0.0
5919,0,5919,[318 427  64 132 496],556,5,27779,4.692398648648648,80.0,0.0
5920,0,5920,[318 427  64 132 496],18,5,27784,4.692450599560885,80.0,0.0
5921,0,5921,[318 427  64 132 496],151,5,27789,4.6925025329280645,80.0,0.0
5922,0,5922,[318 427  64 132 496],18,5,27794,4.692554448759075,80.0,0.0
5923,0,5923,[318 427  64 132 496],269,5,27799,4.692606347062795,80.0,0.0
5924,0,5924,[318 427  64 132 496],716,5,27804,4.692658227848101,80.0,0.0
5925,0,5925,[318 427  64 132 496],716,5,27809,4.692710091123861,80.0,0.0
5926,0,5926,[318 427  64 132 496],450,5,27814,4.692761936898937,80.0,0.0
5927,0,5927,[318 427  64 132 496],556,5,27819,4.692813765182186,80.0,0.0
5928,0,5928,[318 427  64 132 496],269,5,27824,4.692865575982459,80.0,0.0
5929,0,5929,[318 427  64 132 496],556,5,27829,4.6929173693086,80.0,0.0
5930,0,5930,[318 427  64 132 496],796,5,27834,4.692969145169449,80.0,0.0
5931,0,5931,[318 427  64 132 496],796,5,27839,4.693020903573837,80.0,0.0
5932,0,5932,[318 427  64 132 496],535,5,27844,4.6930726445305915,80.0,0.0
5933,0,5933,[  9  64 132 258 181],457,5,27849,4.693124368048534,20.0,0.0
5934,0,5934,[318 427  64 132 496],556,5,27854,4.6931760741364785,80.0,0.0
5935,0,5935,[318 427  64 132 496],716,5,27859,4.693227762803234,80.0,0.0
5936,0,5936,[318 427  64 132 496],151,5,27864,4.6932794340576045,80.0,0.0
5937,0,5937,[318 427  64 132 496],18,5,27869,4.693331087908387,80.0,0.0
5938,0,5938,[318 427  64 132 496],450,5,27874,4.693382724364371,80.0,0.0
5939,0,5939,[318 427  64 132 496],151,5,27879,4.693434343434343,80.0,0.0
5940,0,5940,[318 427  64 132 496],577,5,27884,4.693485945127083,80.0,0.0
5941,0,5941,[318 427  64 132 496],556,5,27889,4.693537529451363,80.0,0.0
5942,0,5942,[318 427  64 132 496],18,5,27894,4.693589096415952,80.0,0.0
5943,0,5943,[161  95   1 173 222],798,3,27897,4.693304172274563,0.0,0.0
5944,0,5944,[318 427  64 132 496],330,5,27902,4.693355761143819,80.0,0.0
5945,0,5945,[318 427  64 132 496],269,5,27907,4.6934073326606125,80.0,0.0
5946,0,5946,[318 427  64 132 496],535,5,27912,4.693458886833698,80.0,0.0
5947,0,5947,[318 427  64 132 496],330,5,27917,4.693510423671823,80.0,0.0
5948,0,5948,[318 427  64 132 496],796,5,27922,4.693561943183728,80.0,0.0
5949,0,5949,[318 427  64 132 496],796,5,27927,4.693613445378151,80.0,0.0
5950,0,5950,[318 427  64 132 496],450,5,27932,4.693664930263822,80.0,0.0
5951,0,5951,[318 427  64 132 496],556,5,27937,4.693716397849462,80.0,0.0
5952,0,5952,[318 427  64 132 496],577,5,27942,4.693767848143793,80.0,0.0
5953,0,5953,[403   4  95 318 748],450,3,27945,4.693483372522674,20.0,0.0
5954,0,5954,[318 427  64 132 496],330,5,27950,4.693534844668346,80.0,0.0
5955,0,5955,[318 427  64 132 496],535,5,27955,4.693586299529886,80.0,0.0
5956,0,5956,[318 427  64 132 496],796,5,27960,4.693637737115998,80.0,0.0
5957,0,5957,[318 427  64 132 496],269,5,27965,4.693689157435381,80.0,0.0
5958,0,5958,[318 427  64 132 496],556,5,27970,4.693740560496727,80.0,0.0
5959,0,5959,[318 427  64 132 496],330,5,27975,4.693791946308725,80.0,0.0
5960,0,5960,[318 427  64 132 496],330,5,27980,4.693843314880054,80.0,0.0
5961,0,5961,[318 427  64 132 496],151,5,27985,4.693894666219389,80.0,0.0
5962,0,5962,[318 427  64 132 496],577,5,27990,4.693946000335401,80.0,0.0
5963,0,5963,[318 427  64 132 496],151,5,27995,4.693997317236754,80.0,0.0
5964,0,5964,[318 427  64 132 496],151,5,28000,4.694048616932104,80.0,0.0
5965,0,5965,[318 427  64 132 496],236,4,28004,4.6939322829366406,80.0,0.0
5966,0,5966,[318 427  64 132 496],450,5,28009,4.693983576336517,80.0,0.0
5967,0,5967,[318 427  64 132 496],450,5,28014,4.694034852546917,80.0,0.0
5968,0,5968,[197  22 179 210 515],269,3,28017,4.693751047076562,0.0,0.0
5969,0,5969,[318 427  64 132 496],535,5,28022,4.693802345058627,80.0,0.0
5970,0,5970,[318 427  64 132 496],577,5,28027,4.693853625858315,80.0,0.0
5971,0,5971,[318 427  64 132 496],716,5,28032,4.69390488948426,80.0,0.0
5972,0,5972,[318 427  64 132 496],269,5,28037,4.693956135945086,80.0,0.0
5973,0,5973,[318 427  64 132 496],535,5,28042,4.694007365249414,80.0,0.0
5974,0,5974,[318 427  64 132 496],535,5,28047,4.694058577405857,80.0,0.0
5975,0,5975,[318 427  64 132 496],269,5,28052,4.694109772423025,80.0,0.0
5976,0,5976,[318 427  64 132 496],716,5,28057,4.69416095030952,80.0,0.0
5977,0,5977,[318 427  64 132 496],236,4,28061,4.694044831047173,80.0,0.0
5978,0,5978,[318 427  64 132 496],236,4,28065,4.693928750627196,80.0,0.0
5979,0,5979,[318 427  64 132 496],577,5,28070,4.693979933110368,80.0,0.0
5980,0,5980,[318 427  64 132 496],18,5,28075,4.694031098478515,80.0,0.0
5981,0,5981,[546   4 172  56  12],280,3,28078,4.69374791039786,0.0,0.0
5982,0,5982,[318 427  64 132 496],450,5,28083,4.693799097442755,80.0,0.0
5983,0,5983,[318 427  64 132 496],556,5,28088,4.69385026737968,80.0,0.0
5984,0,5984,[300 238 174  25 216],716,5,28093,4.69390142021721,0.0,0.0
5985,0,5985,[318 427  64 132 496],556,5,28098,4.693952555963916,80.0,0.0
5986,0,5986,[318 427  64 132 496],716,5,28103,4.6940036746283615,80.0,0.0
5987,0,5987,[318 427  64 132 496],577,5,28108,4.6940547762191045,80.0,0.0
5988,0,5988,[318 427  64 132 496],796,5,28113,4.694105860744699,80.0,0.0
5989,0,5989,[318 427  64 132 496],151,5,28118,4.6941569282136895,80.0,0.0
5990,0,5990,[318 427  64 132 496],330,5,28123,4.694207978634618,80.0,0.0
5991,0,5991,[318 427  64 132 496],796,5,28128,4.694259012016022,80.0,0.0
5992,0,5992,[318 427  64 132 496],269,5,28133,4.694310028366427,80.0,0.0
5993,0,5993,[318 427  64 132 496],151,5,28138,4.694361027694361,80.0,0.0
5994,0,5994,[318 427  64 132 496],330,5,28143,4.694412010008341,80.0,0.0
5995,0,5995,[318 427  64 132 496],269,5,28148,4.694462975316878,80.0,0.0
5996,0,5996,[318 427  64 132 496],236,4,28152,4.694347173586793,80.0,0.0
5997,0,5997,[318 427  64 132 496],577,5,28157,4.694398132710903,80.0,0.0
5998,0,5998,[318 427  64 132 496],450,5,28162,4.694449074845807,80.0,0.0
5999,0,5999,[318 427  64 132 496],450,5,28167,4.6945,80.0,0.0
6000,0,6000,[318 427  64 132 496],796,5,28172,4.69455090818197,80.0,0.0
6001,0,6001,[318 427  64 132 496],796,5,28177,4.6946017994002,80.0,0.0
6002,0,6002,[318 427  64 132 496],535,5,28182,4.694652673663168,80.0,0.0
6003,0,6003,[318 427  64 132 496],716,5,28187,4.694703530979347,80.0,0.0
6004,0,6004,[318 427  64 132 496],330,5,28192,4.694754371357202,80.0,0.0
6005,0,6005,[318 427  64 132 496],269,5,28197,4.694805194805195,80.0,0.0
6006,0,6006,[318 427  64 132 496],716,5,28202,4.69485600133178,80.0,0.0
6007,0,6007,[318 427  64 132 496],236,4,28206,4.69474034620506,80.0,0.0
6008,0,6008,[318 427  64 132 496],577,5,28211,4.694791146613413,80.0,0.0
6009,0,6009,[318 427  64 132 496],535,5,28216,4.694841930116472,80.0,0.0
6010,0,6010,[318 427  64 132 496],577,5,28221,4.694892696722675,80.0,0.0
6011,0,6011,[318 427  64 132 496],18,5,28226,4.694943446440452,80.0,0.0
6012,0,6012,[318 427  64 132 496],796,5,28231,4.694994179278231,80.0,0.0
6013,0,6013,[318 427  64 132 496],330,5,28236,4.69504489524443,80.0,0.0
6014,0,6014,[318 427  64 132 496],450,5,28241,4.695095594347465,80.0,0.0
6015,0,6015,[655 185 357 195 313],796,4,28245,4.69498005319149,0.0,0.0
6016,0,6016,[318 427  64 132 496],796,5,28250,4.695030746219046,80.0,0.0
6017,0,6017,[318 427  64 132 496],330,5,28255,4.695081422399468,80.0,0.0
6018,0,6018,[318 427  64 132 496],796,5,28260,4.695132081741153,80.0,0.0
6019,0,6019,[318 427  64 132 496],269,5,28265,4.695182724252492,80.0,0.0
6020,0,6020,[318 427  64 132 496],330,5,28270,4.69523334994187,80.0,0.0
6021,0,6021,[318 427  64 132 496],450,5,28275,4.695283958817669,80.0,0.0
6022,0,6022,[318 427  64 132 496],269,5,28280,4.695334550888262,80.0,0.0
6023,0,6023,[318 427  64 132 496],535,5,28285,4.6953851261620185,80.0,0.0
6024,0,6024,[318 427  64 132 496],330,5,28290,4.695435684647303,80.0,0.0
6025,0,6025,[318 427  64 132 496],577,5,28295,4.695486226352473,80.0,0.0
6026,0,6026,[318 427  64 132 496],450,5,28300,4.69553675128588,80.0,0.0
6027,0,6027,[318 427  64 132 496],269,5,28305,4.6955872594558725,80.0,0.0
6028,0,6028,[268 135 182  15 195],629,5,28310,4.695637750870791,0.0,0.0
6029,0,6029,[318 427  64 132 496],269,5,28315,4.695688225538972,80.0,0.0
6030,0,6030,[318 427  64 132 496],450,5,28320,4.695738683468745,80.0,0.0
6031,0,6031,[318 427  64 132 496],535,5,28325,4.695789124668435,80.0,0.0
6032,0,6032,[318 427  64 132 496],716,5,28330,4.695839549146362,80.0,0.0
6033,0,6033,[318 427  64 132 496],796,5,28335,4.695889956910839,80.0,0.0
6034,0,6034,[318 427  64 132 496],535,5,28340,4.695940347970174,80.0,0.0
6035,0,6035,[318 427  64 132 496],450,5,28345,4.69599072233267,80.0,0.0
6036,0,6036,[318 427  64 132 496],269,5,28350,4.6960410800066255,80.0,0.0
6037,0,6037,[318 427  64 132 496],18,5,28355,4.6960914210003315,80.0,0.0
6038,0,6038,[318 427  64 132 496],269,5,28360,4.696141745322073,80.0,0.0
6039,0,6039,[318 427  64 132 496],577,5,28365,4.696192052980132,80.0,0.0
6040,0,6040,[318 427  64 132 496],18,5,28370,4.696242343982784,80.0,0.0
6041,0,6041,[318 427  64 132 496],450,5,28375,4.6962926183382985,80.0,0.0
6042,0,6042,[318 427  64 132 496],330,5,28380,4.696342876054939,80.0,0.0
6043,0,6043,[318 427  64 132 496],151,5,28385,4.696393117140966,80.0,0.0
6044,0,6044,[318 427  64 132 496],716,5,28390,4.696443341604632,80.0,0.0
6045,0,6045,[318 427  64 132 496],330,5,28395,4.696493549454185,80.0,0.0
6046,0,6046,[318 427  64 132 496],556,5,28400,4.696543740697867,80.0,0.0
6047,0,6047,[182 603 257 197 172],389,4,28404,4.696428571428571,20.0,0.0
6048,0,6048,[318 427  64 132 496],556,5,28409,4.696478756819309,80.0,0.0
6049,0,6049,[318 427  64 132 496],450,5,28414,4.696528925619835,80.0,0.0
6050,0,6050,[318 427  64 132 496],577,5,28419,4.696579077838374,80.0,0.0
6051,0,6051,[210 288 275 245 117],450,3,28422,4.696298744216788,0.0,20.0
6052,0,6052,[318 427  64 132 496],716,5,28427,4.696348917891954,80.0,0.0
6053,0,6053,[318 427  64 132 496],716,5,28432,4.696399074991741,80.0,0.0
6054,0,6054,[318 427  64 132 496],330,5,28437,4.6964492155243605,80.0,0.0
6055,0,6055,[318 427  64 132 496],18,5,28442,4.696499339498018,80.0,0.0
6056,0,6056,[318 427  64 132 496],236,4,28446,4.696384348687469,80.0,0.0
6057,0,6057,[318 427  64 132 496],236,4,28450,4.696269395840211,80.0,0.0
6058,0,6058,[318 427  64 132 496],556,5,28455,4.696319524674038,80.0,0.0
6059,0,6059,[318 427  64 132 496],18,5,28460,4.696369636963697,80.0,0.0
6060,0,6060,[318 427  64 132 496],535,5,28465,4.696419732717374,80.0,0.0
6061,0,6061,[546 265 597 245   1],256,5,28470,4.696469811943253,0.0,0.0
6062,0,6062,[318 427  64 132 496],796,5,28475,4.696519874649513,80.0,0.0
6063,0,6063,[318 427  64 132 496],269,5,28480,4.696569920844327,80.0,0.0
6064,0,6064,[318 427  64 132 496],796,5,28485,4.696619950535862,80.0,0.0
6065,0,6065,[318 427  64 132 496],716,5,28490,4.696669963732278,80.0,0.0
6066,0,6066,[318 427  64 132 496],535,5,28495,4.696719960441734,80.0,0.0
6067,0,6067,[318 427  64 132 496],151,5,28500,4.69676994067238,80.0,0.0
6068,0,6068,[318 427  64 132 496],330,5,28505,4.6968199044323615,80.0,0.0
6069,0,6069,[318 427  64 132 496],151,5,28510,4.696869851729819,80.0,0.0
6070,0,6070,[318 427  64 132 496],236,4,28514,4.6967550650634164,80.0,0.0
6071,0,6071,[318 427  64 132 496],269,5,28519,4.696805006587615,80.0,0.0
6072,0,6072,[318 427  64 132 496],535,5,28524,4.696854931664745,80.0,0.0
6073,0,6073,[496  79   9   7 183],344,5,28529,4.69690484030293,20.0,0.0
6074,0,6074,[318 427  64 132 496],236,4,28533,4.69679012345679,80.0,0.0
6075,0,6075,[288 322  79 216 185],256,5,28538,4.696840026333114,0.0,0.0
6076,0,6076,[318 427  64 132 496],796,5,28543,4.696889912785914,80.0,0.0
6077,0,6077,[318 427  64 132 496],450,5,28548,4.696939782823297,80.0,0.0
6078,0,6078,[318 427  64 132 496],535,5,28553,4.696989636453364,80.0,0.0
6079,0,6079,[318 427  64 132 496],716,5,28558,4.69703947368421,80.0,0.0
6080,0,6080,[318 427  64 132 496],450,5,28563,4.697089294523927,80.0,0.0
6081,0,6081,[318 427  64 132 496],450,5,28568,4.697139098980599,80.0,0.0
6082,0,6082,[318 427  64 132 496],236,4,28572,4.697024494492849,80.0,0.0
6083,0,6083,[ 97 496 313   8 275],503,5,28577,4.697074293228139,20.0,20.0
6084,0,6084,[318 427  64 132 496],535,5,28582,4.6971240755957275,80.0,0.0
6085,0,6085,[318 427  64 132 496],716,5,28587,4.69717384160368,80.0,0.0
6086,0,6086,[318 427  64 132 496],330,5,28592,4.697223591260062,80.0,0.0
6087,0,6087,[ 98 168 194 276 180],269,4,28596,4.697109067017083,0.0,0.0
6088,0,6088,[742  97 300   9 294],655,0,28596,4.696337658071933,0.0,0.0
6089,0,6089,[318 427  64 132 496],450,5,28601,4.696387520525452,80.0,0.0
6090,0,6090,[318 427  64 132 496],577,5,28606,4.696437366606468,80.0,0.0
6091,0,6091,[318 427  64 132 496],450,5,28611,4.696487196323047,80.0,0.0
6092,0,6092,[318 427  64 132 496],577,5,28616,4.696537009683243,80.0,0.0
6093,0,6093,[196 175 289 127 195],655,1,28617,4.695930423367247,0.0,20.0
6094,0,6094,[318 427  64 132 496],535,5,28622,4.695980311730927,80.0,0.0
6095,0,6095,[318 427  64 132 496],269,5,28627,4.696030183727034,80.0,0.0
6096,0,6096,[172 161 143 318 423],450,5,28632,4.696080039363621,20.0,0.0
6097,0,6097,[318 427  64 132 496],236,4,28636,4.695965890455887,80.0,0.0
6098,0,6098,[318 427  64 132 496],535,5,28641,4.696015740285293,80.0,0.0
6099,0,6099,[318 427  64 132 496],269,5,28646,4.6960655737704915,80.0,0.0
6100,0,6100,[318 427  64 132 496],535,5,28651,4.6961153909195215,80.0,0.0
6101,0,6101,[318 427  64 132 496],330,5,28656,4.696165191740413,80.0,0.0
6102,0,6102,[318 427  64 132 496],450,5,28661,4.696214976241193,80.0,0.0
6103,0,6103,[318 427  64 132 496],330,5,28666,4.696264744429882,80.0,0.0
6104,0,6104,[318 427  64 132 496],269,5,28671,4.696314496314496,80.0,0.0
6105,0,6105,[318 427  64 132 496],330,5,28676,4.696364231903046,80.0,0.0
6106,0,6106,[286 294 183 496 153],450,5,28681,4.696413951203537,20.0,20.0
6107,0,6107,[318 427  64 132 496],556,5,28686,4.696463654223969,80.0,0.0
6108,0,6108,[318 427  64 132 496],450,5,28691,4.696513340972336,80.0,0.0
6109,0,6109,[597 313   1 183 273],450,4,28695,4.696399345335515,0.0,0.0
6110,0,6110,[  1 742 125 121 176],344,1,28696,4.6957944689903455,0.0,0.0
6111,0,6111,[318 427  64 132 496],716,5,28701,4.695844240837697,80.0,0.0
6112,0,6112,[318 427  64 132 496],450,5,28706,4.695893996401113,80.0,0.0
6113,0,6113,[318 427  64 132 496],577,5,28711,4.695943735688584,80.0,0.0
6114,0,6114,[318 427  64 132 496],535,5,28716,4.695993458708095,80.0,0.0
6115,0,6115,[318 427  64 132 496],796,5,28721,4.696043165467626,80.0,0.0
6116,0,6116,[318 427  64 132 496],236,4,28725,4.69592937714566,80.0,0.0
6117,0,6117,[318 427  64 132 496],450,5,28730,4.695979078130108,80.0,0.0
6118,0,6118,[318 427  64 132 496],269,5,28735,4.69602876286975,80.0,0.0
6119,0,6119,[318 427  64 132 496],577,5,28740,4.696078431372549,80.0,0.0
6120,0,6120,[318 427  64 132 496],556,5,28745,4.696128083646463,80.0,0.0
6121,0,6121,[318 427  64 132 496],556,5,28750,4.6961777196994445,80.0,0.0
6122,0,6122,[257  50 180 196  69],504,4,28754,4.696064020904785,0.0,20.0
6123,0,6123,[318 427  64 132 496],535,5,28759,4.6961136512083606,80.0,0.0
6124,0,6124,[318 427  64 132 496],269,5,28764,4.696163265306122,80.0,0.0
6125,0,6125,[318 427  64 132 496],151,5,28769,4.696212863206007,80.0,0.0
6126,0,6126,[318 427  64 132 496],236,4,28773,4.696099232903542,80.0,0.0
6127,0,6127,[318 427  64 132 496],18,5,28778,4.696148825065274,80.0,0.0
6128,0,6128,[318 427  64 132 496],151,5,28783,4.696198401044216,80.0,0.0
6129,0,6129,[318 427  64 132 496],330,5,28788,4.696247960848287,80.0,0.0
6130,0,6130,[318 427  64 132 496],716,5,28793,4.696297504485402,80.0,0.0
6131,0,6131,[318 427  64 132 496],236,4,28797,4.696183953033268,80.0,0.0
6132,0,6132,[318 427  64 132 496],236,4,28801,4.696070438610794,80.0,0.0
6133,0,6133,[318 427  64 132 496],796,5,28806,4.69611998695794,80.0,0.0
6134,0,6134,[174 237 289 357 121],655,1,28807,4.695517522412388,0.0,0.0
6135,0,6135,[318 427  64 132 496],151,5,28812,4.695567144719687,80.0,0.0
6136,0,6136,[318 427  64 132 496],330,5,28817,4.695616750855467,80.0,0.0
6137,0,6137,[318 427  64 132 496],535,5,28822,4.695666340827631,80.0,0.0
6138,0,6138,[318 427  64 132 496],330,5,28827,4.695715914644079,80.0,0.0
6139,0,6139,[ 11 100  69 132 496],330,5,28832,4.695765472312703,20.0,20.0
6140,0,6140,[318 427  64 132 496],535,5,28837,4.695815013841394,80.0,0.0
6141,0,6141,[318 427  64 132 496],151,5,28842,4.695864539238033,80.0,0.0
6142,0,6142,[  4 182  11 234 111],593,3,28845,4.695588474686635,0.0,0.0
6143,0,6143,[318 427  64 132 496],450,5,28850,4.695638020833333,80.0,0.0
6144,0,6144,[427 172 423   8  25],577,5,28855,4.695687550854353,20.0,0.0
6145,0,6145,[318 427  64 132 496],18,5,28860,4.695737064757566,80.0,0.0
6146,0,6146,[318 427  64 132 496],556,5,28865,4.695786562550838,80.0,0.0
6147,0,6147,[318 427  64 132 496],577,5,28870,4.6958360442420295,80.0,0.0
6148,0,6148,[318 427  64 132 496],18,5,28875,4.695885509838998,80.0,0.0
6149,0,6149,[153  22 275 269 300],450,5,28880,4.695934959349594,0.0,20.0
6150,0,6150,[ 64 200 186 276 275],457,5,28885,4.695984392781662,20.0,20.0
6151,0,6151,[318 427  64 132 496],269,5,28890,4.696033810143043,80.0,0.0
6152,0,6152,[318 427  64 132 496],269,5,28895,4.696083211441573,80.0,0.0
6153,0,6153,[318 427  64 132 496],330,5,28900,4.696132596685083,80.0,0.0
6154,0,6154,[318 427  64 132 496],330,5,28905,4.696181965881397,80.0,0.0
6155,0,6155,[ 79 385  56 234  98],593,4,28909,4.696068875893437,0.0,0.0
6156,0,6156,[318 427  64 132 496],269,5,28914,4.696118239402306,80.0,0.0
6157,0,6157,[318 427  64 132 496],450,5,28919,4.696167586878857,80.0,0.0
6158,0,6158,[318 427  64 132 496],450,5,28924,4.696216918330898,80.0,0.0
6159,0,6159,[318 427  64 132 496],18,5,28929,4.6962662337662335,80.0,0.0
6160,0,6160,[318 427  64 132 496],577,5,28934,4.696315533192664,80.0,0.0
6161,0,6161,[318 427  64 132 496],330,5,28939,4.696364816617981,80.0,0.0
6162,0,6162,[318 427  64 132 496],330,5,28944,4.696414084049976,80.0,0.0
6163,0,6163,[318 427  64 132 496],535,5,28949,4.696463335496431,80.0,0.0
6164,0,6164,[318 427  64 132 496],330,5,28954,4.696512570965126,80.0,0.0
6165,0,6165,[318 427  64 132 496],535,5,28959,4.696561790463834,80.0,0.0
6166,0,6166,[318 427  64 132 496],535,5,28964,4.6966109940003244,80.0,0.0
6167,0,6167,[318 427  64 132 496],269,5,28969,4.69666018158236,80.0,0.0
6168,0,6168,[318 427  64 132 496],151,5,28974,4.6967093532177016,80.0,0.0
6169,0,6169,[318 427  64 132 496],796,5,28979,4.6967585089141,80.0,0.0
6170,0,6170,[318 427  64 132 496],236,4,28983,4.696645600388916,80.0,0.0
6171,0,6171,[318 427  64 132 496],236,4,28987,4.69653272845107,80.0,0.0
6172,0,6172,[318 427  64 132 496],236,4,28991,4.69641989308278,80.0,0.0
6173,0,6173,[318 427  64 132 496],330,5,28996,4.696469063816003,80.0,0.0
6174,0,6174,[318 427  64 132 496],330,5,29001,4.696518218623482,80.0,0.0
6175,0,6175,[228 202 174 197 151],798,1,29002,4.695919689119171,0.0,0.0
6176,0,6176,[318 427  64 132 496],330,5,29007,4.695968916949976,80.0,0.0
6177,0,6177,[318 427  64 132 496],535,5,29012,4.696018128844286,80.0,0.0
6178,0,6178,[318 427  64 132 496],269,5,29017,4.69606732480984,80.0,0.0
6179,0,6179,[318 427  64 132 496],151,5,29022,4.696116504854369,80.0,0.0
6180,0,6180,[318 427  64 132 496],269,5,29027,4.696165668985601,80.0,0.0
6181,0,6181,[300 237 228 202 210],716,5,29032,4.696214817211258,0.0,0.0
6182,0,6182,[318 427  64 132 496],535,5,29037,4.696263949539059,80.0,0.0
6183,0,6183,[318 427  64 132 496],796,5,29042,4.696313065976714,80.0,0.0
6184,0,6184,[318 427  64 132 496],577,5,29047,4.696362166531932,80.0,0.0
6185,0,6185,[318 427  64 132 496],577,5,29052,4.696411251212415,80.0,0.0
6186,0,6186,[318 427  64 132 496],330,5,29057,4.696460320025861,80.0,0.0
6187,0,6187,[318 427  64 132 496],716,5,29062,4.696509372979961,80.0,0.0
6188,0,6188,[318 427  64 132 496],330,5,29067,4.696558410082404,80.0,0.0
6189,0,6189,[318 427  64 132 496],556,5,29072,4.6966074313408726,80.0,0.0
6190,0,6190,[318 427  64 132 496],330,5,29077,4.6966564367630435,80.0,0.0
6191,0,6191,[211  89 196 546 181],23,3,29080,4.696382428940568,0.0,0.0
6192,0,6192,[318 427  64 132 496],236,4,29084,4.696269982238011,80.0,0.0
6193,0,6193,[318 427  64 132 496],330,5,29089,4.696319018404908,80.0,0.0
6194,0,6194,[405  56 117 237 597],256,4,29093,4.696206618240517,0.0,0.0
6195,0,6195,[276 238  22 182 258],457,5,29098,4.696255648805681,0.0,0.0
6196,0,6196,[318 427  64 132 496],151,5,29103,4.6963046635468775,80.0,0.0
6197,0,6197,[318 427  64 132 496],18,5,29108,4.696353662471765,80.0,0.0
6198,0,6198,[318 427  64 132 496],796,5,29113,4.696402645587998,80.0,0.0
6199,0,6199,[318 427  64 132 496],556,5,29118,4.696451612903226,80.0,0.0
6200,0,6200,[318 427  64 132 496],236,4,29122,4.696339300112885,80.0,0.0
6201,0,6201,[318 427  64 132 496],535,5,29127,4.696388261851016,80.0,0.0
6202,0,6202,[318 427  64 132 496],450,5,29132,4.696437207802676,80.0,0.0
6203,0,6203,[318 427  64 132 496],236,4,29136,4.696324951644101,80.0,0.0
6204,0,6204,[318 427  64 132 496],18,5,29141,4.696373892022563,80.0,0.0
6205,0,6205,[318 427  64 132 496],236,4,29145,4.696261682242991,80.0,0.0
6206,0,6206,[318 427  64 132 496],535,5,29150,4.696310617045271,80.0,0.0
6207,0,6207,[318 427  64 132 496],556,5,29155,4.696359536082475,80.0,0.0
6208,0,6208,[318 427  64 132 496],577,5,29160,4.696408439362216,80.0,0.0
6209,0,6209,[318 427  64 132 496],716,5,29165,4.6964573268921095,80.0,0.0
6210,0,6210,[318 427  64 132 496],330,5,29170,4.696506198679762,80.0,0.0
6211,0,6211,[318 427  64 132 496],236,4,29174,4.696394075981971,80.0,0.0
6212,0,6212,[268 204 111 144 181],655,0,29174,4.695638178013842,0.0,0.0
6213,0,6213,[318 427  64 132 496],796,5,29179,4.695687158030254,80.0,0.0
6214,0,6214,[318 427  64 132 496],796,5,29184,4.695736122284795,80.0,0.0
6215,0,6215,[318 427  64 132 496],330,5,29189,4.695785070785071,80.0,0.0
6216,0,6216,[318 427  64 132 496],236,4,29193,4.695673154254464,80.0,0.0
6217,0,6217,[318 427  64 132 496],151,5,29198,4.6957220971373435,80.0,0.0
6218,0,6218,[318 427  64 132 496],330,5,29203,4.695771024280431,80.0,0.0
6219,0,6219,[318 427  64 132 496],18,5,29208,4.695819935691318,80.0,0.0
6220,0,6220,[318 427  64 132 496],269,5,29213,4.695868831377592,80.0,0.0
6221,0,6221,[318 427  64 132 496],716,5,29218,4.695917711346834,80.0,0.0
6222,0,6222,[318 427  64 132 496],577,5,29223,4.6959665756066205,80.0,0.0
6223,0,6223,[318 427  64 132 496],236,4,29227,4.695854755784062,80.0,0.0
6224,0,6224,[318 427  64 132 496],269,5,29232,4.695903614457832,80.0,0.0
6225,0,6225,[318 427  64 132 496],577,5,29237,4.695952457436556,80.0,0.0
6226,0,6226,[318 427  64 132 496],535,5,29242,4.6960012847277985,80.0,0.0
6227,0,6227,[265 269 117 328 423],629,3,29245,4.69572896596018,0.0,0.0
6228,0,6228,[318 427  64 132 496],577,5,29250,4.695777813453203,80.0,0.0
6229,0,6229,[318 427  64 132 496],330,5,29255,4.695826645264847,80.0,0.0
6230,0,6230,[318 427  64 132 496],236,4,29259,4.695714973519499,80.0,0.0
6231,0,6231,[318 427  64 132 127],693,4,29263,4.695603337612323,60.0,20.0
6232,0,6232,[318 427 132  64 127],18,5,29268,4.695652173913044,60.0,20.0
6233,0,6233,[318 427 132  64 127],269,5,29273,4.695700994546038,60.0,20.0
6234,0,6234,[318 427 132  64 127],316,4,29277,4.695589414595028,60.0,20.0
6235,0,6235,[318 427 132  64 496],556,5,29282,4.695638229634381,80.0,0.0
6236,0,6236,[318 427 132  64 496],450,5,29287,4.6956870290203625,80.0,0.0
6237,0,6237,[318 427 132  64 496],716,5,29292,4.6957358127605,80.0,0.0
6238,0,6238,[318 427 132  64 496],269,5,29297,4.695784580862318,80.0,0.0
6239,0,6239,[318 427 132  64 496],535,5,29302,4.695833333333334,80.0,0.0
6240,0,6240,[318 427 132  64 496],535,5,29307,4.695882070181061,80.0,0.0
6241,0,6241,[318 427 132  64 496],151,5,29312,4.695930791413009,80.0,0.0
6242,0,6242,[318 427 132  64 496],236,4,29316,4.695819317635752,80.0,0.0
6243,0,6243,[168 151 186 288 196],457,5,29321,4.69586803331198,0.0,0.0
6244,0,6244,[318 427 132  64 496],269,5,29326,4.695916733386709,80.0,0.0
6245,0,6245,[318 427 132  64 496],18,5,29331,4.695965417867435,80.0,0.0
6246,0,6246,[318 427 132  64 496],236,4,29335,4.695854009924764,80.0,0.0
6247,0,6247,[318 427 132  64 496],330,5,29340,4.695902688860436,80.0,0.0
6248,0,6248,[318 427 132  64 496],716,5,29345,4.695951352216355,80.0,0.0
6249,0,6249,[318 427 132  64 496],450,5,29350,4.696,80.0,0.0
6250,0,6250,[318 427 132  64 496],716,5,29355,4.696048632218845,80.0,0.0
6251,0,6251,[318 427 132  64 496],716,5,29360,4.696097248880358,80.0,0.0
6252,0,6252,[318 427 132  64 496],330,5,29365,4.6961458499920035,80.0,0.0
6253,0,6253,[318 427 132  64 496],796,5,29370,4.696194435561241,80.0,0.0
6254,0,6254,[318 427 132  64 496],796,5,29375,4.696243005595524,80.0,0.0
6255,0,6255,[318 427 132  64 496],269,5,29380,4.696291560102302,80.0,0.0
6256,0,6256,[318 427 132  64 496],236,4,29384,4.696180278088541,80.0,0.0
6257,0,6257,[318 427 132  64 496],450,5,29389,4.696228827101311,80.0,0.0
6258,0,6258,[318 427 132  64 496],236,4,29393,4.696117590669436,80.0,0.0
6259,0,6259,[318 427 132  64  98],236,5,29398,4.696166134185304,60.0,0.0
6260,0,6260,[318 427 132  64  98],316,5,29403,4.696214662194538,60.0,0.0
6261,0,6261,[318 427 132  64  98],716,5,29408,4.696263174704567,60.0,0.0
6262,0,6262,[318 427 132  64  98],796,5,29413,4.696311671722817,60.0,0.0
6263,0,6263,[318 427 132  64  98],316,5,29418,4.696360153256705,60.0,0.0
6264,0,6264,[318 427 132  64  98],18,5,29423,4.696408619313647,60.0,0.0
6265,0,6265,[318 427 132  64  98],796,5,29428,4.6964570699010535,60.0,0.0
6266,0,6266,[318 427 132  64  98],693,4,29432,4.696345939045796,60.0,0.0
6267,0,6267,[318 427 132  64  98],269,5,29437,4.69639438417358,60.0,0.0
6268,0,6268,[318 427 132  64  98],535,4,29441,4.696283298771734,60.0,0.0
6269,0,6269,[318 427 132  64  98],269,5,29446,4.696331738437002,60.0,0.0
6270,0,6270,[318 427 132  64  98],655,4,29450,4.696220698453197,60.0,0.0
6271,0,6271,[318 427 132  64  98],716,5,29455,4.696269132653061,60.0,0.0
6272,0,6272,[318 427 132  64  98],796,5,29460,4.696317551410808,60.0,0.0
6273,0,6273,[318 427 132  64  98],535,4,29464,4.696206566783551,60.0,0.0
6274,0,6274,[ 70 202 176 173  79],450,5,29469,4.696254980079681,0.0,0.0
6275,0,6275,[318 427 132  64 496],269,5,29474,4.6963033779477374,80.0,0.0
6276,0,6276,[318 427 132  64 496],236,4,29478,4.696192448621953,80.0,0.0
6277,0,6277,[318 427 132  64 496],716,5,29483,4.696240841032176,80.0,0.0
6278,0,6278,[318 427 132  64 496],236,4,29487,4.696129956999522,80.0,0.0
6279,0,6279,[318 427 132  64 588],716,5,29492,4.696178343949045,60.0,0.0
6280,0,6280,[187   1 238  25 318],716,4,29496,4.6960675051743355,20.0,0.0
6281,0,6281,[318 427 132  64 588],716,5,29501,4.6961158866603,60.0,0.0
6282,0,6282,[318 427 132  64 588],18,5,29506,4.696164252745504,60.0,0.0
6283,0,6283,[318 427 132  64 588],18,5,29511,4.696212603437301,60.0,0.0
6284,0,6284,[318 427 132  64 588],796,5,29516,4.696260938743039,60.0,0.0
6285,0,6285,[318 427 132  64 588],450,5,29521,4.696309258670061,60.0,0.0
6286,0,6286,[318 427 132  64 588],796,5,29526,4.696357563225704,60.0,0.0
6287,0,6287,[318 427 132  64 588],316,4,29530,4.696246819338422,60.0,0.0
6288,0,6288,[ 56 118  22 546 483],280,4,29534,4.696136110669423,0.0,0.0
6289,0,6289,[ 70 135 475 202 179],269,3,29537,4.695866454689984,0.0,0.0
6290,0,6290,[318 427 132  64  98],577,5,29542,4.695914798919091,60.0,0.0
6291,0,6291,[318 427 132  64  98],330,5,29547,4.69596312778131,60.0,0.0
6292,0,6292,[318 427 132  64  98],716,5,29552,4.696011441283966,60.0,0.0
6293,0,6293,[318 427 132  64  98],450,5,29557,4.696059739434382,60.0,0.0
6294,0,6294,[153 471  64 180 268],535,4,29561,4.695949166004766,20.0,0.0
6295,0,6295,[318 427 132  64  98],151,5,29566,4.695997458703939,60.0,0.0
6296,0,6296,[318 427 132  64  98],236,5,29571,4.696045736064793,60.0,0.0
6297,0,6297,[318 427 132  64  98],716,5,29576,4.696093998094633,60.0,0.0
6298,0,6298,[318 427 132  64  98],151,5,29581,4.696142244800762,60.0,0.0
6299,0,6299,[318 427 132  64  98],450,5,29586,4.696190476190476,60.0,0.0
6300,0,6300,[318 427 132  64  98],693,4,29590,4.6960799873036025,60.0,0.0
6301,0,6301,[258 173 471 174  50],807,3,29593,4.695810853697239,0.0,20.0
6302,0,6302,[318 427 132  64  98],577,5,29598,4.695859114707282,60.0,0.0
6303,0,6303,[318 427 132  64  98],269,5,29603,4.695907360406092,60.0,0.0
6304,0,6304,[318 427 132  64  98],18,5,29608,4.695955590800952,60.0,0.0
6305,0,6305,[318 427 132  64  98],316,5,29613,4.696003805899144,60.0,0.0
6306,0,6306,[318 427 132  64  98],716,5,29618,4.696052005707943,60.0,0.0
6307,0,6307,[318 427 132  64  98],716,5,29623,4.696100190234623,60.0,0.0
6308,0,6308,[ 56 235  28 294 161],457,3,29626,4.695831352036773,0.0,0.0
6309,0,6309,[318 427 132  64  98],269,5,29631,4.6958795562599045,60.0,0.0
6310,0,6310,[318 427 132  64  98],236,5,29636,4.695927745206782,60.0,0.0
6311,0,6311,[318 427 132  64  98],450,5,29641,4.695975918884664,60.0,0.0
6312,0,6312,[318 427 132  64  98],796,5,29646,4.696024077300808,60.0,0.0
6313,0,6313,[318 427 132  64  98],236,5,29651,4.696072220462464,60.0,0.0
6314,0,6314,[318 427 132  64  98],330,5,29656,4.696120348376881,60.0,0.0
6315,0,6315,[318 427 132  64  98],796,5,29661,4.696168461051299,60.0,0.0
6316,0,6316,[318 427 132  64  98],450,5,29666,4.696216558492956,60.0,0.0
6317,0,6317,[588 483 294 100 174],280,2,29668,4.695789806900918,0.0,20.0
6318,0,6318,[318 427 132  64  98],577,5,29673,4.69583794904257,60.0,0.0
6319,0,6319,[318 427 132  64  98],693,4,29677,4.695727848101265,60.0,0.0
6320,0,6320,[318 427 132  64  98],535,4,29681,4.6956177819965195,60.0,0.0
6321,0,6321,[318 427 132  64  98],450,5,29686,4.695665928503638,60.0,0.0
6322,0,6322,[318 427 132  64  98],655,4,29690,4.695555907006168,60.0,0.0
6323,0,6323,[318 427 132  64  98],269,5,29695,4.695604048070841,60.0,0.0
6324,0,6324,[318 427 132  64  98],693,4,29699,4.695494071146245,60.0,0.0
6325,0,6325,[318 427 132  64  98],693,4,29703,4.6953841289914635,60.0,0.0
6326,0,6326,[318 427 132  64  98],693,4,29707,4.695274221590011,60.0,0.0
6327,0,6327,[318 427 132  64  98],535,4,29711,4.6951643489254105,60.0,0.0
6328,0,6328,[318 427 132  64  98],316,5,29716,4.695212513825249,60.0,0.0
6329,0,6329,[318 427 132  64  98],330,5,29721,4.695260663507109,60.0,0.0
6330,0,6330,[318 427 132  64  98],330,5,29726,4.695308797978202,60.0,0.0
6331,0,6331,[318 427 132  64  98],655,4,29730,4.695198989260897,60.0,0.0
6332,0,6332,[318 427 132  64  98],330,5,29735,4.695247118269383,60.0,0.0
6333,0,6333,[318 427 132  64  98],330,5,29740,4.695295232080833,60.0,0.0
6334,0,6334,[318 427 132  64  98],577,5,29745,4.695343330702447,60.0,0.0
6335,0,6335,[318 427 132  64  98],269,5,29750,4.695391414141414,60.0,0.0
6336,0,6336,[318 427 132  64  98],535,4,29754,4.695281679027931,60.0,0.0
6337,0,6337,[318 427 132  64  98],535,4,29758,4.695171978542127,60.0,0.0
6338,0,6338,[318 427 132  64 496],716,5,29763,4.695220066256507,80.0,0.0
6339,0,6339,[ 89 111 597  64 215],344,3,29766,4.6949526813880125,20.0,0.0
6340,0,6340,[ 97 117 294 194 427],577,5,29771,4.695000788519161,20.0,0.0
6341,0,6341,[100 328  56 182 125],450,5,29776,4.695048880479344,0.0,20.0
6342,0,6342,[153  15 258 182 195],796,5,29781,4.695096957275737,0.0,0.0
6343,0,6343,[ 56  88 195 216 173],23,4,29785,4.694987389659521,0.0,0.0
6344,0,6344,[318 427 132  64 496],796,5,29790,4.695035460992908,80.0,0.0
6345,0,6345,[318 427 132  64 496],556,5,29795,4.695083517176174,80.0,0.0
6346,0,6346,[318 427 132  64 496],577,5,29800,4.69513155821648,80.0,0.0
6347,0,6347,[318 427 132  64 496],450,5,29805,4.695179584120983,80.0,0.0
6348,0,6348,[318 427 132  64 496],269,5,29810,4.695227594896834,80.0,0.0
6349,0,6349,[318 427 132  64 496],269,5,29815,4.695275590551181,80.0,0.0
6350,0,6350,[318 427 132  64 496],151,5,29820,4.6953235710911665,80.0,0.0
6351,0,6351,[318 427 132  64 496],450,5,29825,4.69537153652393,80.0,0.0
6352,0,6352,[318 427 132  64 496],151,5,29830,4.695419486856603,80.0,0.0
6353,0,6353,[318 427 132  64 496],535,5,29835,4.695467422096317,80.0,0.0
6354,0,6354,[318 427 132  64 496],716,5,29840,4.6955153422501965,80.0,0.0
6355,0,6355,[318 427 132  64 496],18,5,29845,4.695563247325362,80.0,0.0
6356,0,6356,[318 427 132  64 496],330,5,29850,4.695611137328929,80.0,0.0
6357,0,6357,[318 427 132  64 496],151,5,29855,4.695659012268009,80.0,0.0
6358,0,6358,[318 427 132  64 496],450,5,29860,4.695706872149709,80.0,0.0
6359,0,6359,[318 427 132  64 496],269,5,29865,4.695754716981132,80.0,0.0
6360,0,6360,[318 427 132  64 496],796,5,29870,4.695802546769376,80.0,0.0
6361,0,6361,[318 427 132  64 496],556,5,29875,4.695850361521534,80.0,0.0
6362,0,6362,[318 427 132  64 496],151,5,29880,4.6958981612446955,80.0,0.0
6363,0,6363,[318 427 132  64 496],269,5,29885,4.695945945945946,80.0,0.0
6364,0,6364,[318 427 132  64 496],269,5,29890,4.695993715632365,80.0,0.0
6365,0,6365,[318 427 132  64 496],716,5,29895,4.696041470311028,80.0,0.0
6366,0,6366,[318 427 132  64 496],716,5,29900,4.6960892099890055,80.0,0.0
6367,0,6367,[318 427 132  64 496],151,5,29905,4.696136934673367,80.0,0.0
6368,0,6368,[318 427 132  64 496],796,5,29910,4.696184644371173,80.0,0.0
6369,0,6369,[318 427 132  64 496],716,5,29915,4.696232339089482,80.0,0.0
6370,0,6370,[318 427 132  64 496],18,5,29920,4.696280018835347,80.0,0.0
6371,0,6371,[318 427 132  64 496],716,5,29925,4.696327683615819,80.0,0.0
6372,0,6372,[318 427 132  64 496],577,5,29930,4.696375333437941,80.0,0.0
6373,0,6373,[318 427 132  64 496],151,5,29935,4.696422968308754,80.0,0.0
6374,0,6374,[318 427 132  64 496],450,5,29940,4.696470588235294,80.0,0.0
6375,0,6375,[318 427 132  64 496],535,5,29945,4.696518193224592,80.0,0.0
6376,0,6376,[318 427 132  64 496],151,5,29950,4.696565783283676,80.0,0.0
6377,0,6377,[318 427 132  64 496],535,5,29955,4.696613358419567,80.0,0.0
6378,0,6378,[318 427 132  64 496],556,5,29960,4.696660918639285,80.0,0.0
6379,0,6379,[318 427 132  64 496],18,5,29965,4.696708463949843,80.0,0.0
6380,0,6380,[318 427 132  64 496],450,5,29970,4.696755994358251,80.0,0.0
6381,0,6381,[222 301 427 211 185],796,3,29973,4.696490128486368,20.0,0.0
6382,0,6382,[471 144  69 191 151],716,3,29976,4.696224345918847,0.0,0.0
6383,0,6383,[318 427 132  64 496],269,5,29981,4.696271929824562,80.0,0.0
6384,0,6384,[318 427 132  64 496],556,5,29986,4.696319498825372,80.0,0.0
6385,0,6385,[318 427 132  64 496],18,5,29991,4.696367052928281,80.0,0.0
6386,0,6386,[318 427 132  64 496],236,4,29995,4.696258024111477,80.0,0.0
6387,0,6387,[318 427 132  64 496],151,5,30000,4.69630557294928,80.0,0.0
6388,0,6388,[318 427 132  64 496],330,5,30005,4.696353106902489,80.0,0.0
6389,0,6389,[318 427 132  64 496],151,5,30010,4.69640062597809,80.0,0.0
6390,0,6390,[357 742 328  69 216],450,5,30015,4.69644813018307,0.0,0.0
6391,0,6391,[318 427 132  64 496],18,5,30020,4.696495619524406,80.0,0.0
6392,0,6392,[135 276  98 238 204],18,3,30023,4.696230251837948,0.0,0.0
6393,0,6393,[318 427 132  64 496],556,5,30028,4.696277760400375,80.0,0.0
6394,0,6394,[318 427 132  64 496],330,5,30033,4.696325254104769,80.0,0.0
6395,0,6395,[318 427 132  64 496],269,5,30038,4.696372732958099,80.0,0.0
6396,0,6396,[318 427 132  64 496],450,5,30043,4.6964201969673285,80.0,0.0
6397,0,6397,[318 427 132  64 496],151,5,30048,4.696467646139419,80.0,0.0
6398,0,6398,[318 427 132  64 496],556,5,30053,4.696515080481325,80.0,0.0
6399,0,6399,[318 427 132  64 496],796,5,30058,4.6965625,80.0,0.0
6400,0,6400,[318 427 132  64 496],556,5,30063,4.69660990470239,80.0,0.0
6401,0,6401,[318 427 132  64 496],716,5,30068,4.696657294595439,80.0,0.0
6402,0,6402,[153 245 200   9 322],796,2,30070,4.696236139309699,0.0,0.0
6403,0,6403,[318 427 132  64 496],556,5,30075,4.696283572767021,80.0,0.0
6404,0,6404,[143  64   9 183  12],151,4,30079,4.696174863387978,20.0,0.0
6405,0,6405,[168  15 202 172  82],18,1,30080,4.6955978769903215,0.0,0.0
6406,0,6406,[318 427 132  64 496],577,5,30085,4.695645387857032,80.0,0.0
6407,0,6407,[471 185 204 748 269],450,5,30090,4.6956928838951315,0.0,0.0
6408,0,6408,[318 427 132  64 496],269,5,30095,4.695740365111562,80.0,0.0
6409,0,6409,[318 427 132  64 496],716,5,30100,4.69578783151326,80.0,0.0
6410,0,6410,[318 427 132  64 496],151,5,30105,4.69583528310716,80.0,0.0
6411,0,6411,[318 427 132  64 496],577,5,30110,4.695882719900188,80.0,0.0
6412,0,6412,[  4 174  71 265  96],280,3,30113,4.695618275378139,0.0,0.0
6413,0,6413,[318 427 132  64 496],556,5,30118,4.695665731212972,80.0,0.0
6414,0,6414,[318 427 132  64 496],556,5,30123,4.695713172252533,80.0,0.0
6415,0,6415,[318 427 132  64 496],450,5,30128,4.695760598503741,80.0,0.0
6416,0,6416,[318 427 132  64 496],236,4,30132,4.695652173913044,80.0,0.0
6417,0,6417,[318 427 132  64 496],556,5,30137,4.695699594889374,80.0,0.0
6418,0,6418,[318 427 132  64 496],236,4,30141,4.69559121358467,80.0,0.0
6419,0,6419,[ 82 269  64 195 282],450,4,30145,4.695482866043614,20.0,0.0
6420,0,6420,[318 427 132  64 496],269,5,30150,4.695530291231895,80.0,0.0
6421,0,6421,[238 483 132 121 222],450,2,30152,4.695110557458736,0.0,0.0
6422,0,6422,[318 427 132  64 496],269,5,30157,4.695158025844621,80.0,0.0
6423,0,6423,[318 427 132  64 496],556,5,30162,4.695205479452055,80.0,0.0
6424,0,6424,[318 427 132  64 496],535,5,30167,4.695252918287938,80.0,0.0
6425,0,6425,[318 427 132  64 496],330,5,30172,4.6953003423591655,80.0,0.0
6426,0,6426,[318 427 132  64 496],330,5,30177,4.695347751672631,80.0,0.0
6427,0,6427,[318 427 132  64 496],151,5,30182,4.695395146235221,80.0,0.0
6428,0,6428,[265 385 183 238 125],786,5,30187,4.695442526053819,0.0,0.0
6429,0,6429,[318 427 132  64 496],236,4,30191,4.695334370139969,80.0,0.0
6430,0,6430,[318 427 132  64 496],330,5,30196,4.6953817446742345,80.0,0.0
6431,0,6431,[318 427 132  64 496],151,5,30201,4.695429104477612,80.0,0.0
6432,0,6432,[318 427 132  64 496],450,5,30206,4.695476449556972,80.0,0.0
6433,0,6433,[318 427 132  64 496],556,5,30211,4.69552377991918,80.0,0.0
6434,0,6434,[318 427 132  64 496],716,5,30216,4.695571095571095,80.0,0.0
6435,0,6435,[318 427 132  64 496],151,5,30221,4.695618396519578,80.0,0.0
6436,0,6436,[318 427 132  64 496],450,5,30226,4.695665682771478,80.0,0.0
6437,0,6437,[318 427 132  64 496],535,5,30231,4.6957129543336436,80.0,0.0
6438,0,6438,[318 427 132  64 496],556,5,30236,4.695760211212921,80.0,0.0
6439,0,6439,[318 427 132  64 496],796,5,30241,4.695807453416149,80.0,0.0
6440,0,6440,[318 427 132  64 496],535,5,30246,4.695854680950163,80.0,0.0
6441,0,6441,[ 88  22 153 161 282],450,5,30251,4.6959018938217945,0.0,0.0
6442,0,6442,[318 427 132  64 496],796,5,30256,4.69594909203787,80.0,0.0
6443,0,6443,[318 427 132  64 496],556,5,30261,4.695996275605214,80.0,0.0
6444,0,6444,[318 427 132  64 496],330,5,30266,4.696043444530644,80.0,0.0
6445,0,6445,[318 427 132  64 496],450,5,30271,4.696090598820974,80.0,0.0
6446,0,6446,[318 427 132  64 496],535,5,30276,4.696137738483015,80.0,0.0
6447,0,6447,[318 427 132  64 496],450,5,30281,4.696184863523573,80.0,0.0
6448,0,6448,[318 427 132  64 496],269,5,30286,4.696231973949449,80.0,0.0
6449,0,6449,[318 427 132  64 496],535,5,30291,4.696279069767442,80.0,0.0
6450,0,6450,[318 427 132  64 496],18,5,30296,4.696326150984343,80.0,0.0
6451,0,6451,[318 427 132  64 496],151,5,30301,4.6963732176069435,80.0,0.0
6452,0,6452,[318 427 132  64 496],18,5,30306,4.696420269642027,80.0,0.0
6453,0,6453,[318 427 132  64 496],330,5,30311,4.696467307096374,80.0,0.0
6454,0,6454,[318 427 132  64 496],151,5,30316,4.696514329976762,80.0,0.0
6455,0,6455,[318 427 132  64 496],18,5,30321,4.696561338289963,80.0,0.0
6456,0,6456,[318 427 132  64 496],716,5,30326,4.696608332042745,80.0,0.0
6457,0,6457,[168 161  28 257 186],389,2,30328,4.696190771136575,0.0,0.0
6458,0,6458,[318 427 132  64 496],535,5,30333,4.696237807710172,80.0,0.0
6459,0,6459,[318 427 132  64 496],796,5,30338,4.696284829721362,80.0,0.0
6460,0,6460,[211 357  98 269  79],450,5,30343,4.696331837176907,0.0,0.0
6461,0,6461,[318 427 132  64 496],577,5,30348,4.696378830083566,80.0,0.0
6462,0,6462,[318 427 132  64 496],18,5,30353,4.696425808448089,80.0,0.0
6463,0,6463,[318 427 132  64 496],556,5,30358,4.696472772277228,80.0,0.0
6464,0,6464,[318 427 132  64 496],18,5,30363,4.696519721577726,80.0,0.0
6465,0,6465,[318 427 132  64 496],556,5,30368,4.6965666563563255,80.0,0.0
6466,0,6466,[318 427 132  64 496],716,5,30373,4.696613576619762,80.0,0.0
6467,0,6467,[318 427 132  64 496],796,5,30378,4.696660482374768,80.0,0.0
6468,0,6468,[318 427 132  64 496],151,5,30383,4.6967073736280724,80.0,0.0
6469,0,6469,[318 427 132  64 496],796,5,30388,4.696754250386399,80.0,0.0
6470,0,6470,[318 427 132  64 496],556,5,30393,4.696801112656467,80.0,0.0
6471,0,6471,[318 427 132  64 496],236,4,30397,4.696693448702101,80.0,0.0
6472,0,6472,[318 427 132  64 496],450,5,30402,4.696740305885988,80.0,0.0
6473,0,6473,[318 427 132  64 496],556,5,30407,4.696787148594377,80.0,0.0
6474,0,6474,[318 427 132  64 496],577,5,30412,4.696833976833977,80.0,0.0
6475,0,6475,[318 427 132  64 496],556,5,30417,4.696880790611488,80.0,0.0
6476,0,6476,[318 427 132  64 496],151,5,30422,4.696927589933611,80.0,0.0
6477,0,6477,[496 153 318 269 483],450,4,30426,4.696820006174745,40.0,0.0
6478,0,6478,[318 427 132  64 496],18,5,30431,4.696866800432166,80.0,0.0
6479,0,6479,[318 427 132  64 496],269,5,30436,4.696913580246914,80.0,0.0
6480,0,6480,[318 427 132  64 496],556,5,30441,4.696960345625675,80.0,0.0
6481,0,6481,[318 427 132  64 496],577,5,30446,4.697007096575131,80.0,0.0
6482,0,6482,[318 427 132  64 496],151,5,30451,4.697053833101959,80.0,0.0
6483,0,6483,[318 427 132  64 496],269,5,30456,4.697100555212832,80.0,0.0
6484,0,6484,[318 427 132  64 496],577,5,30461,4.6971472629144175,80.0,0.0
6485,0,6485,[318 427 132  64 496],18,5,30466,4.697193956213383,80.0,0.0
6486,0,6486,[176 273 483 168 216],796,4,30470,4.697086480653615,0.0,0.0
6487,0,6487,[318 427 132  64 496],236,4,30474,4.6969790382244145,80.0,0.0
6488,0,6488,[318 427 132  64 496],556,5,30479,4.697025735860687,80.0,0.0
6489,0,6489,[318 427 132  64 496],269,5,30484,4.697072419106317,80.0,0.0
6490,0,6490,[318 427 132  64 496],269,5,30489,4.697119087967955,80.0,0.0
6491,0,6491,[  4 181  88 180 127],796,4,30493,4.6970117067159585,0.0,20.0
6492,0,6492,[318 427 132  64 496],269,5,30498,4.697058370552903,80.0,0.0
6493,0,6493,[318 427 132  64 496],330,5,30503,4.697105020018479,80.0,0.0
6494,0,6494,[318 427 132  64 496],236,4,30507,4.696997690531178,80.0,0.0
6495,0,6495,[318 427 132  64 496],450,5,30512,4.697044334975369,80.0,0.0
6496,0,6496,[318 427 132  64 496],151,5,30517,4.697090965060798,80.0,0.0
6497,0,6497,[318 427 132  64 496],535,5,30522,4.697137580794091,80.0,0.0
6498,0,6498,[318 427 132  64 496],151,5,30527,4.697184182181874,80.0,0.0
6499,0,6499,[318 427 132  64 496],450,5,30532,4.697230769230769,80.0,0.0
6500,0,6500,[318 427 132  64 496],151,5,30537,4.697277341947393,80.0,0.0
6501,0,6501,[318 427 132  64 496],577,5,30542,4.697323900338358,80.0,0.0
6502,0,6502,[318 427 132  64 496],236,4,30546,4.6972166692295865,80.0,0.0
6503,0,6503,[318 427 132  64 496],236,4,30550,4.697109471094711,80.0,0.0
6504,0,6504,[318 427 132  64 496],716,5,30555,4.697156033820138,80.0,0.0
6505,0,6505,[318 427 132  64 496],796,5,30560,4.697202582231786,80.0,0.0
6506,0,6506,[286 546 496 121  95],786,4,30564,4.6970954356846475,20.0,20.0
6507,0,6507,[318 427 132  64 496],535,5,30569,4.697141979102643,80.0,0.0
6508,0,6508,[195  98 228  50  12],72,3,30572,4.69688124135812,0.0,20.0
6509,0,6509,[318 427 132  64 496],450,5,30577,4.696927803379416,80.0,0.0
6510,0,6510,[318 427 132  64 496],450,5,30582,4.696974351098142,80.0,0.0
6511,0,6511,[318 427 132  64 496],577,5,30587,4.697020884520884,80.0,0.0
6512,0,6512,[318 427 132  64 496],577,5,30592,4.69706740365423,80.0,0.0
6513,0,6513,[318 427 132  64 496],236,4,30596,4.696960392999693,80.0,0.0
6514,0,6514,[318 427 132  64 496],796,5,30601,4.697006907137375,80.0,0.0
6515,0,6515,[318 427 132  64 496],18,5,30606,4.697053406998158,80.0,0.0
6516,0,6516,[318 427 132  64 496],716,5,30611,4.697099892588614,80.0,0.0
6517,0,6517,[318 427 132  64 496],269,5,30616,4.697146363915311,80.0,0.0
6518,0,6518,[318 427 132  64 496],556,5,30621,4.697192820984814,80.0,0.0
6519,0,6519,[318 427 132  64 496],330,5,30626,4.697239263803681,80.0,0.0
6520,0,6520,[318 427 132  64 496],450,5,30631,4.697285692378469,80.0,0.0
6521,0,6521,[318 427 132  64 496],577,5,30636,4.697332106715732,80.0,0.0
6522,0,6522,[357 132 210 257 276],655,2,30638,4.696918595738158,0.0,0.0
6523,0,6523,[132  96 172 288 182],280,3,30641,4.69665849172287,0.0,0.0
6524,0,6524,[318 427 132  64 496],151,5,30646,4.696704980842912,80.0,0.0
6525,0,6525,[318 427 132  64 496],151,5,30651,4.696751455715599,80.0,0.0
6526,0,6526,[318 427 132  64 496],330,5,30656,4.69679791634748,80.0,0.0
6527,0,6527,[318 427 132  64 496],330,5,30661,4.696844362745098,80.0,0.0
6528,0,6528,[318 427 132  64 496],716,5,30666,4.696890794914995,80.0,0.0
6529,0,6529,[318 427 132  64 496],236,4,30670,4.696784073506891,80.0,0.0
6530,0,6530,[318 427 132  64 496],535,5,30675,4.696830500689021,80.0,0.0
6531,0,6531,[318 427 132  64 496],556,5,30680,4.696876913655848,80.0,0.0
6532,0,6532,[318 427 132  64 496],796,5,30685,4.696923312413898,80.0,0.0
6533,0,6533,[318 427 132  64 496],796,5,30690,4.696969696969697,80.0,0.0
6534,0,6534,[318 427 132  64 496],18,5,30695,4.697016067329763,80.0,0.0
6535,0,6535,[318 427 132  64 496],450,5,30700,4.697062423500612,80.0,0.0
6536,0,6536,[328 603   4  97 191],151,3,30703,4.6968028147468255,20.0,0.0
6537,0,6537,[318 427 132  64 603],269,5,30708,4.696849189354543,80.0,0.0
6538,0,6538,[318 427 132  64 603],716,5,30713,4.696895549778254,80.0,0.0
6539,0,6539,[318 427 132  64 603],796,5,30718,4.696941896024465,80.0,0.0
6540,0,6540,[318 427 132  64 603],330,5,30723,4.696988228099679,80.0,0.0
6541,0,6541,[318 427 132  64 603],269,5,30728,4.697034546010395,80.0,0.0
6542,0,6542,[318 427 132  64 603],796,5,30733,4.697080849763106,80.0,0.0
6543,0,6543,[318 427 132  64 603],716,5,30738,4.697127139364303,80.0,0.0
6544,0,6544,[318 427 132  64 603],18,4,30742,4.6970206264323915,80.0,0.0
6545,0,6545,[318 427 132  64 496],556,5,30747,4.697066911090743,80.0,0.0
6546,0,6546,[318 427 132  64 496],151,5,30752,4.697113181609898,80.0,0.0
6547,0,6547,[318 427 132  64 496],18,5,30757,4.697159437996334,80.0,0.0
6548,0,6548,[318 427 132  64 496],556,5,30762,4.697205680256528,80.0,0.0
6549,0,6549,[318 427 132  64 496],535,5,30767,4.697251908396947,80.0,0.0
6550,0,6550,[318 427 132  64 496],151,5,30772,4.6972981224240575,80.0,0.0
6551,0,6551,[318 427 132  64 496],236,4,30776,4.697191697191697,80.0,0.0
6552,0,6552,[318 427 132  64 496],796,5,30781,4.6972379063024565,80.0,0.0
6553,0,6553,[318 427 132  64 496],716,5,30786,4.697284101312175,80.0,0.0
6554,0,6554,[318 427 132  64 496],269,5,30791,4.697330282227307,80.0,0.0
6555,0,6555,[318 427 132  64 496],716,5,30796,4.6973764490543015,80.0,0.0
6556,0,6556,[318 427 132  64 496],556,5,30801,4.6974226017996035,80.0,0.0
6557,0,6557,[318 427 132  64 496],450,5,30806,4.697468740469655,80.0,0.0
6558,0,6558,[318 427 132  64 496],577,5,30811,4.697514865070895,80.0,0.0
6559,0,6559,[318 427 132  64 496],330,5,30816,4.697560975609756,80.0,0.0
6560,0,6560,[313  64 318  96 282],693,4,30820,4.697454656302393,40.0,0.0
6561,0,6561,[318 427 132  64 496],330,5,30825,4.697500761962816,80.0,0.0
6562,0,6562,[318 427 132  64 496],450,5,30830,4.697546853573061,80.0,0.0
6563,0,6563,[318 427 132  64 496],330,5,30835,4.697592931139549,80.0,0.0
6564,0,6564,[318 427 132  64 496],556,5,30840,4.697638994668698,80.0,0.0
6565,0,6565,[318 427 132  64 496],151,5,30845,4.697685044166921,80.0,0.0
6566,0,6566,[318 427 132  64 496],269,5,30850,4.6977310796406275,80.0,0.0
6567,0,6567,[318 427 132  64 496],330,5,30855,4.697777101096224,80.0,0.0
6568,0,6568,[318 427 132  64 496],330,5,30860,4.6978231085401125,80.0,0.0
6569,0,6569,[186  22 195 403 194],450,4,30864,4.697716894977169,0.0,0.0
6570,0,6570,[318 427 132  64 496],151,5,30869,4.697762897580277,80.0,0.0
6571,0,6571,[318 427 132  64 496],535,5,30874,4.69780888618381,80.0,0.0
6572,0,6572,[318 427 132  64 496],796,5,30879,4.697854860794158,80.0,0.0
6573,0,6573,[318 427 132  64 496],18,5,30884,4.697900821417706,80.0,0.0
6574,0,6574,[318 427 132  64 496],716,5,30889,4.697946768060836,80.0,0.0
6575,0,6575,[318 427 132  64 496],269,5,30894,4.697992700729927,80.0,0.0
6576,0,6576,[318 427 132  64 496],577,5,30899,4.698038619431352,80.0,0.0
6577,0,6577,[318 427 132  64 496],716,5,30904,4.698084524171481,80.0,0.0
6578,0,6578,[318 427 132  64 496],796,5,30909,4.6981304149566805,80.0,0.0
6579,0,6579,[318 427 132  64 496],535,5,30914,4.698176291793313,80.0,0.0
6580,0,6580,[318 427 132  64 496],18,5,30919,4.698222154687738,80.0,0.0
6581,0,6581,[318 427 132  64 496],151,5,30924,4.698268003646308,80.0,0.0
6582,0,6582,[318 427 132  64 496],151,5,30929,4.698313838675376,80.0,0.0
6583,0,6583,[318 427 132  64 496],796,5,30934,4.698359659781288,80.0,0.0
6584,0,6584,[318 427 132  64 496],450,5,30939,4.698405466970387,80.0,0.0
6585,0,6585,[318 427 132  64 496],796,5,30944,4.698451260249013,80.0,0.0
6586,0,6586,[318 427 132  64 496],796,5,30949,4.698497039623501,80.0,0.0
6587,0,6587,[318 427 132  64 496],535,5,30954,4.698542805100182,80.0,0.0
6588,0,6588,[318 427 132  64 496],236,4,30958,4.698436788587039,80.0,0.0
6589,0,6589,[318 427 132  64 496],796,5,30963,4.698482549317148,80.0,0.0
6590,0,6590,[318 427 132  64 496],556,5,30968,4.698528296161432,80.0,0.0
6591,0,6591,[318 427 132  64 496],577,5,30973,4.698574029126213,80.0,0.0
6592,0,6592,[318 427 132  64 496],269,5,30978,4.698619748217807,80.0,0.0
6593,0,6593,[318 427 132  64 496],716,5,30983,4.698665453442524,80.0,0.0
6594,0,6594,[318 427 132  64 496],577,5,30988,4.698711144806672,80.0,0.0
6595,0,6595,[318 427 132  64 496],450,5,30993,4.698756822316556,80.0,0.0
6596,0,6596,[318 427 132  64 496],269,5,30998,4.698802485978475,80.0,0.0
6597,0,6597,[318 427 132  64 496],236,4,31002,4.698696574719612,80.0,0.0
6598,0,6598,[318 427 132  64 496],716,5,31007,4.698742233671768,80.0,0.0
6599,0,6599,[318 427 132  64 496],269,5,31012,4.698787878787879,80.0,0.0
6600,0,6600,[318 427 132  64 496],18,5,31017,4.698833510074231,80.0,0.0
6601,0,6601,[180 435 423 427 211],18,5,31022,4.69887912753711,20.0,0.0
6602,0,6602,[318 427 132  64 496],577,5,31027,4.698924731182796,80.0,0.0
6603,0,6603,[318 427 132  64 496],577,5,31032,4.6989703210175655,80.0,0.0
6604,0,6604,[282   4 300 427 204],655,1,31033,4.698410295230886,20.0,0.0
6605,0,6605,[288 176  71 183   4],344,4,31037,4.698304571601574,0.0,0.0
6606,0,6606,[318 427 132  64 496],450,5,31042,4.698350234599667,80.0,0.0
6607,0,6607,[318 427 132  64 496],450,5,31047,4.6983958837772395,80.0,0.0
6608,0,6608,[318 427 132  64 496],716,5,31052,4.698441519140566,80.0,0.0
6609,0,6609,[318 427 132  64 496],716,5,31057,4.698487140695915,80.0,0.0
6610,0,6610,[318 427 132  64 496],556,5,31062,4.698532748449554,80.0,0.0
6611,0,6611,[318 427 132  64 496],330,5,31067,4.698578342407743,80.0,0.0
6612,0,6612,[202 257  82   9 174],457,4,31071,4.698472705277484,0.0,0.0
6613,0,6613,[318 427 132  64 496],18,5,31076,4.698518294526761,80.0,0.0
6614,0,6614,[318 427 132  64 496],236,4,31080,4.698412698412699,80.0,0.0
6615,0,6615,[318 427 132  64 496],269,5,31085,4.698458282950424,80.0,0.0
6616,0,6616,[318 427 132  64 496],716,5,31090,4.6985038537101405,80.0,0.0
6617,0,6617,[318 427 132  64 496],450,5,31095,4.698549410698096,80.0,0.0
6618,0,6618,[117  22 234 222 257],655,0,31095,4.697839552802538,0.0,0.0
6619,0,6619,[318 427 132  64 496],330,5,31100,4.697885196374623,80.0,0.0
6620,0,6620,[318 427 132  64 496],716,5,31105,4.69793082615919,80.0,0.0
6621,0,6621,[318 427 132  64 496],577,5,31110,4.6979764421624886,80.0,0.0
6622,0,6622,[318 427 132  64 496],450,5,31115,4.698022044390759,80.0,0.0
6623,0,6623,[318 427 132  64 496],577,5,31120,4.6980676328502415,80.0,0.0
6624,0,6624,[318 427 132  64 496],18,5,31125,4.69811320754717,80.0,0.0
6625,0,6625,[ 50 405 318 748 175],151,3,31128,4.697856927256264,20.0,20.0
6626,0,6626,[318 427 132  64 496],269,5,31133,4.697902519993964,80.0,0.0
6627,0,6627,[318 427 132  64 496],716,5,31138,4.69794809897405,80.0,0.0
6628,0,6628,[318 427 132  64 496],236,4,31142,4.6978428118871625,80.0,0.0
6629,0,6629,[318 427 132  64 496],556,5,31147,4.69788838612368,80.0,0.0
6630,0,6630,[ 50 471  12 435  98],72,4,31151,4.697783139797919,0.0,20.0
6631,0,6631,[318 427 132  64 496],535,5,31156,4.6978287092882995,80.0,0.0
6632,0,6632,[603 423 216 222 286],655,2,31158,4.69742198100407,20.0,20.0
6633,0,6633,[318 427 132  64 496],269,5,31163,4.697467591196864,80.0,0.0
6634,0,6634,[318 427 132  64 496],577,5,31168,4.697513187641296,80.0,0.0
6635,0,6635,[318 427 132  64 496],556,5,31173,4.697558770343581,80.0,0.0
6636,0,6636,[318 427 132  64 496],330,5,31178,4.69760433930993,80.0,0.0
6637,0,6637,[318 427 132  64 496],535,5,31183,4.69764989454655,80.0,0.0
6638,0,6638,[318 427 132  64 496],269,5,31188,4.6976954360596475,80.0,0.0
6639,0,6639,[318 427 132  64 496],796,5,31193,4.697740963855422,80.0,0.0
6640,0,6640,[318 427 132  64 496],18,5,31198,4.6977864779400695,80.0,0.0
6641,0,6641,[318 427 132  64 496],716,5,31203,4.697831978319783,80.0,0.0
6642,0,6642,[318 427 132  64 496],450,5,31208,4.697877465000753,80.0,0.0
6643,0,6643,[318 427 132  64 496],796,5,31213,4.697922937989163,80.0,0.0
6644,0,6644,[318 427 132  64 496],535,5,31218,4.697968397291197,80.0,0.0
6645,0,6645,[318 427 132  64 496],269,5,31223,4.6980138429130305,80.0,0.0
6646,0,6646,[318 427 132  64 496],577,5,31228,4.69805927486084,80.0,0.0
6647,0,6647,[318 427 132  64 496],716,5,31233,4.698104693140794,80.0,0.0
6648,0,6648,[318 427 132  64 496],450,5,31238,4.698150097759061,80.0,0.0
6649,0,6649,[265  12 210 423 655],450,4,31242,4.698045112781955,0.0,0.0
6650,0,6650,[318 427 132  64 496],269,5,31247,4.698090512704856,80.0,0.0
6651,0,6651,[318 427 132  64 496],716,5,31252,4.698135898977751,80.0,0.0
6652,0,6652,[318 427 132  64 496],577,5,31257,4.698181271606794,80.0,0.0
6653,0,6653,[318 427 132  64 496],716,5,31262,4.698226630598136,80.0,0.0
6654,0,6654,[318 427 132  64 496],716,5,31267,4.698271975957926,80.0,0.0
6655,0,6655,[318 427 132  64 496],535,5,31272,4.6983173076923075,80.0,0.0
6656,0,6656,[318 427 132  64 496],450,5,31277,4.6983626258074205,80.0,0.0
6657,0,6657,[318 427 132  64 496],716,5,31282,4.698407930309402,80.0,0.0
6658,0,6658,[318 427 132  64 496],330,5,31287,4.698453221204385,80.0,0.0
6659,0,6659,[318 427 132  64 496],577,5,31292,4.698498498498498,80.0,0.0
6660,0,6660,[318 427 132  64 496],716,5,31297,4.698543762197868,80.0,0.0
6661,0,6661,[318 427 132  64 496],796,5,31302,4.6985890123086165,80.0,0.0
6662,0,6662,[318 427 132  64 496],796,5,31307,4.698634248836861,80.0,0.0
6663,0,6663,[318 427 132  64 496],716,5,31312,4.698679471788716,80.0,0.0
6664,0,6664,[318 427 132  64 496],18,5,31317,4.698724681170293,80.0,0.0
6665,0,6665,[144 471 273 385 173],401,2,31319,4.6983198319831985,0.0,0.0
6666,0,6666,[318 427 132  64 496],556,5,31324,4.698365081745913,80.0,0.0
6667,0,6667,[318 427 132  64 496],556,5,31329,4.698410317936412,80.0,0.0
6668,0,6668,[318 427 132  64 496],151,5,31334,4.698455540560803,80.0,0.0
6669,0,6669,[318 427 132  64 496],330,5,31339,4.698500749625188,80.0,0.0
6670,0,6670,[318 427 132  64 496],151,5,31344,4.6985459451356615,80.0,0.0
6671,0,6671,[318 427 132  64 496],236,4,31348,4.698441247002398,80.0,0.0
6672,0,6672,[180 216 423 202 237],457,5,31353,4.69848643788401,0.0,0.0
6673,0,6673,[318 427 132  64 496],269,5,31358,4.698531615223255,80.0,0.0
6674,0,6674,[318 427 132  64 496],450,5,31363,4.698576779026217,80.0,0.0
6675,0,6675,[318 427 132  64 496],450,5,31368,4.698621929298981,80.0,0.0
6676,0,6676,[318 427 132  64 496],269,5,31373,4.698667066047626,80.0,0.0
6677,0,6677,[318 427 132  64 496],556,5,31378,4.698712189278227,80.0,0.0
6678,0,6678,[318 427 132  64 496],556,5,31383,4.698757298996856,80.0,0.0
6679,0,6679,[318 427 132  64 496],236,4,31387,4.698652694610779,80.0,0.0
6680,0,6680,[318 427 132  64 496],577,5,31392,4.69869779973058,80.0,0.0
6681,0,6681,[318 427 132  64 496],716,5,31397,4.698742891349895,80.0,0.0
6682,0,6682,[318 427 132  64 496],18,5,31402,4.698787969474787,80.0,0.0
6683,0,6683,[318 427 132  64 496],18,5,31407,4.698833034111311,80.0,0.0
6684,0,6684,[318 427 132  64 496],577,5,31412,4.69887808526552,80.0,0.0
6685,0,6685,[318 427 132  64 496],535,5,31417,4.698923122943464,80.0,0.0
6686,0,6686,[318 427 132  64 496],330,5,31422,4.698968147151189,80.0,0.0
6687,0,6687,[318 427 132  64 496],269,5,31427,4.699013157894737,80.0,0.0
6688,0,6688,[318 427 132  64 496],796,5,31432,4.699058155180147,80.0,0.0
6689,0,6689,[ 56  97 174 748 328],796,4,31436,4.698953662182362,0.0,0.0
6690,0,6690,[318 427 132  64 496],269,5,31441,4.69899865490958,80.0,0.0
6691,0,6691,[ 96 237 222 211 144],796,4,31445,4.698894202032277,0.0,0.0
6692,0,6692,[318 427 132  64 496],577,5,31450,4.698939190198715,80.0,0.0
6693,0,6693,[275  97 405 172 121],450,4,31454,4.698834777412609,0.0,20.0
6694,0,6694,[318 427 132  64 496],535,5,31459,4.698879761015683,80.0,0.0
6695,0,6695,[318 427 132  64 496],577,5,31464,4.698924731182796,80.0,0.0
6696,0,6696,[121 568  71 302  95],450,2,31466,4.698521726146035,0.0,0.0
6697,0,6697,[318 427 132  64 496],796,5,31471,4.698566736339206,80.0,0.0
6698,0,6698,[318 427 132  64 496],577,5,31476,4.698611733094491,80.0,0.0
6699,0,6699,[161 202  69 176 655],716,3,31479,4.698358208955224,0.0,0.0
6700,0,6700,[318 427 132  64 496],269,5,31484,4.698403223399493,80.0,0.0
6701,0,6701,[318 427 132  64 496],577,5,31489,4.698448224410623,80.0,0.0
6702,0,6702,[318 427 132  64 496],577,5,31494,4.698493211994629,80.0,0.0
6703,0,6703,[318 427 132  64 496],151,5,31499,4.698538186157518,80.0,0.0
6704,0,6704,[318 427 132  64 496],796,5,31504,4.698583146905294,80.0,0.0
6705,0,6705,[318 427 132  64 496],236,4,31508,4.698478974053087,80.0,0.0
6706,0,6706,[318 427 132  64 496],535,5,31513,4.698523930222156,80.0,0.0
6707,0,6707,[318 427 132  64 496],556,5,31518,4.698568872987478,80.0,0.0
6708,0,6708,[318 427 132  64 496],556,5,31523,4.698613802355045,80.0,0.0
6709,0,6709,[318 427 132  64 496],535,5,31528,4.69865871833085,80.0,0.0
6710,0,6710,[318 427 132  64 496],330,5,31533,4.698703620920877,80.0,0.0
6711,0,6711,[275 546 117 238 161],457,4,31537,4.698599523241954,0.0,20.0
6712,0,6712,[318 427 132  64 496],330,5,31542,4.698644421272158,80.0,0.0
6713,0,6713,[191 357 180 276 197],316,4,31546,4.69854036341972,0.0,0.0
6714,0,6714,[185 182 742 385  22],796,4,31550,4.698436336559941,0.0,0.0
6715,0,6715,[318 427 132  64 496],330,5,31555,4.698481238832638,80.0,0.0
6716,0,6716,[318 427 132  64 496],151,5,31560,4.6985261277355965,80.0,0.0
6717,0,6717,[318 427 132  64 496],556,5,31565,4.698571003274784,80.0,0.0
6718,0,6718,[318 427 132  64 496],269,5,31570,4.698615865456169,80.0,0.0
6719,0,6719,[ 28 289  71   7 121],786,4,31574,4.698511904761904,0.0,0.0
6720,0,6720,[318 427 132  64 496],450,5,31579,4.698556762386549,80.0,0.0
6721,0,6721,[318 427 132  64 496],535,5,31584,4.698601606664683,80.0,0.0
6722,0,6722,[318 427 132  64 496],450,5,31589,4.698646437602261,80.0,0.0
6723,0,6723,[318 427 132  64 496],151,5,31594,4.698691255205235,80.0,0.0
6724,0,6724,[318 427 132  64 496],556,5,31599,4.698736059479554,80.0,0.0
6725,0,6725,[318 427 132  64 496],796,5,31604,4.698780850431163,80.0,0.0
6726,0,6726,[ 98 294 333 318  69],236,3,31607,4.698528318715623,20.0,0.0
6727,0,6727,[318 427 132  64 496],450,5,31612,4.698573127229489,80.0,0.0
6728,0,6728,[  1  56 282 215 234],450,4,31616,4.698469311933422,0.0,0.0
6729,0,6729,[318 427 132  64 496],18,5,31621,4.69851411589896,80.0,0.0
6730,0,6730,[318 427 132  64 496],236,4,31625,4.698410340216907,80.0,0.0
6731,0,6731,[318 427 132  64 496],450,5,31630,4.69845513963161,80.0,0.0
6732,0,6732,[318 427 132  64 496],796,5,31635,4.698499925738898,80.0,0.0
6733,0,6733,[318 427 132  64 496],269,5,31640,4.698544698544699,80.0,0.0
6734,0,6734,[318 427 132  64 496],716,5,31645,4.698589458054937,80.0,0.0
6735,0,6735,[318 427 132  64 496],18,5,31650,4.6986342042755345,80.0,0.0
6736,0,6736,[ 50 179 174  82 313],577,4,31654,4.698530503191331,0.0,20.0
6737,0,6737,[318 427 132  64 496],450,5,31659,4.698575244879787,80.0,0.0
6738,0,6738,[318 427 132  64 496],269,5,31664,4.698619973289806,80.0,0.0
6739,0,6739,[318 427 132  64 496],236,4,31668,4.698516320474777,80.0,0.0
6740,0,6740,[318 427 132  64 496],18,5,31673,4.698561044355437,80.0,0.0
6741,0,6741,[318 427 132  64 496],236,4,31677,4.698457431029368,80.0,0.0
6742,0,6742,[318 427 132  64 496],535,5,31682,4.69850215037817,80.0,0.0
6743,0,6743,[318 427 132  64 496],796,5,31687,4.698546856465006,80.0,0.0
6744,0,6744,[318 427 132  64 496],556,5,31692,4.698591549295775,80.0,0.0
6745,0,6745,[318 427 132  64 496],151,5,31697,4.698636228876371,80.0,0.0
6746,0,6746,[318 427 132  64 496],577,5,31702,4.6986808952126875,80.0,0.0
6747,0,6747,[318 427 132  64 496],535,5,31707,4.698725548310611,80.0,0.0
6748,0,6748,[318 427 132  64 496],535,5,31712,4.698770188176026,80.0,0.0
6749,0,6749,[318 427 132  64 496],577,5,31717,4.698814814814815,80.0,0.0
6750,0,6750,[ 97 357  25 405 135],716,4,31721,4.698711302029329,0.0,0.0
6751,0,6751,[318 427 132  64 496],18,5,31726,4.698755924170616,80.0,0.0
6752,0,6752,[318 427 132  64 496],18,5,31731,4.698800533096402,80.0,0.0
6753,0,6753,[318 427 132  64 496],18,5,31736,4.698845128812556,80.0,0.0
6754,0,6754,[318 427 132  64 496],556,5,31741,4.698889711324944,80.0,0.0
6755,0,6755,[127 210 322 197 405],401,2,31743,4.698490230905861,0.0,20.0
6756,0,6756,[318 427 132  64 496],330,5,31748,4.6985348527453015,80.0,0.0
6757,0,6757,[318 427 132  64 496],716,5,31753,4.698579461379106,80.0,0.0
6758,0,6758,[318 427 132  64 496],18,5,31758,4.698624056813138,80.0,0.0
6759,0,6759,[318 427 132  64 496],716,5,31763,4.698668639053254,80.0,0.0
6760,0,6760,[318 427 132  64 496],236,4,31767,4.698565300990977,80.0,0.0
6761,0,6761,[183  64 161   8 403],269,1,31768,4.6980183377698905,20.0,0.0
6762,0,6762,[318 427 132  64 496],18,5,31773,4.698062989797427,80.0,0.0
6763,0,6763,[318 427 132  64 496],796,5,31778,4.698107628622117,80.0,0.0
6764,0,6764,[318 427 132  64 496],236,4,31782,4.698004434589801,80.0,0.0
6765,0,6765,[318 427 132  64 496],535,5,31787,4.698049068873781,80.0,0.0
6766,0,6766,[423  96 265   7 748],292,3,31790,4.697798138022757,0.0,0.0
6767,0,6767,[318 427 132  64 496],556,5,31795,4.697842789598108,80.0,0.0
6768,0,6768,[318 427 132  64 496],556,5,31800,4.6978874279805,80.0,0.0
6769,0,6769,[318 427 132  64 496],269,5,31805,4.697932053175776,80.0,0.0
6770,0,6770,[405 245  12 100 143],796,3,31808,4.6976812878452225,0.0,20.0
6771,0,6771,[318 427 132  64 496],716,5,31813,4.697725930301241,80.0,0.0
6772,0,6772,[318 427 132  64 496],236,4,31817,4.697622914513509,80.0,0.0
6773,0,6773,[318 427 132  64 496],535,5,31822,4.697667552406259,80.0,0.0
6774,0,6774,[318 427 132  64 496],577,5,31827,4.697712177121772,80.0,0.0
6775,0,6775,[318 427 132  64 496],330,5,31832,4.697756788665879,80.0,0.0
6776,0,6776,[318 427 132  64 496],236,4,31836,4.697653829127932,80.0,0.0
6777,0,6777,[197 181 135   7  25],693,3,31839,4.697403363824137,0.0,0.0
6778,0,6778,[318 427 132  64 496],236,4,31843,4.697300486797463,80.0,0.0
6779,0,6779,[318 427 132  64 496],556,5,31848,4.697345132743362,80.0,0.0
6780,0,6780,[318 427 132  64 496],269,5,31853,4.69738976552131,80.0,0.0
6781,0,6781,[318 427 132  64 496],796,5,31858,4.697434385137128,80.0,0.0
6782,0,6782,[318 427 132  64 496],151,5,31863,4.697478991596639,80.0,0.0
6783,0,6783,[318 427 132  64 496],18,5,31868,4.69752358490566,80.0,0.0
6784,0,6784,[153   8 588  88 202],796,5,31873,4.697568165070007,0.0,0.0
6785,0,6785,[318 427 132  64 496],151,5,31878,4.69761273209549,80.0,0.0
6786,0,6786,[318 427 132  64 496],796,5,31883,4.697657285987918,80.0,0.0
6787,0,6787,[318 427 132  64 496],450,5,31888,4.697701826753094,80.0,0.0
6788,0,6788,[318 427 132  64 496],796,5,31893,4.697746354396818,80.0,0.0
6789,0,6789,[318 427 132  64 496],716,5,31898,4.69779086892489,80.0,0.0
6790,0,6790,[318 427 132  64 496],796,5,31903,4.6978353703431015,80.0,0.0
6791,0,6791,[318 427 132  64 496],18,5,31908,4.6978798586572434,80.0,0.0
6792,0,6792,[318 427 132  64 496],330,5,31913,4.697924333873105,80.0,0.0
6793,0,6793,[318 427 132  64 496],269,5,31918,4.697968795996467,80.0,0.0
6794,0,6794,[318 427 132  64 496],151,5,31923,4.6980132450331125,80.0,0.0
6795,0,6795,[318 427 132  64 496],236,4,31927,4.697910535609182,80.0,0.0
6796,0,6796,[318 427 132  64 496],236,4,31931,4.6978078564072385,80.0,0.0
6797,0,6797,[318 427 132  64 496],236,4,31935,4.697705207413946,80.0,0.0
6798,0,6798,[318 427 132  64 496],151,5,31940,4.697749669068981,80.0,0.0
6799,0,6799,[318 427 132  64 496],269,5,31945,4.697794117647059,80.0,0.0
6800,0,6800,[318 427 132  64 496],577,5,31950,4.697838553153948,80.0,0.0
6801,0,6801,[318 427 132  64 496],716,5,31955,4.697882975595413,80.0,0.0
6802,0,6802,[318 427 132  64 496],556,5,31960,4.697927384977216,80.0,0.0
6803,0,6803,[318 427 132  64 496],577,5,31965,4.697971781305115,80.0,0.0
6804,0,6804,[318 427 132  64 496],18,5,31970,4.698016164584864,80.0,0.0
6805,0,6805,[318 427 132  64 496],269,5,31975,4.698060534822216,80.0,0.0
6806,0,6806,[318 427 132  64 496],269,5,31980,4.698104892022918,80.0,0.0
6807,0,6807,[318 427 132  64 496],151,5,31985,4.698149236192714,80.0,0.0
6808,0,6808,[318 427 132  64 496],796,5,31990,4.698193567337348,80.0,0.0
6809,0,6809,[318 427 132  64 496],269,5,31995,4.6982378854625555,80.0,0.0
6810,0,6810,[318 427 132  64 496],716,5,32000,4.698282190574071,80.0,0.0
6811,0,6811,[318 427 132  64 496],330,5,32005,4.698326482677627,80.0,0.0
6812,0,6812,[318 427 132  64 496],269,5,32010,4.698370761778952,80.0,0.0
6813,0,6813,[318 427 132  64 496],330,5,32015,4.698415027883769,80.0,0.0
6814,0,6814,[318 427 132  64 496],236,4,32019,4.698312545854733,80.0,0.0
6815,0,6815,[318 427 132  64 496],151,5,32024,4.698356807511737,80.0,0.0
6816,0,6816,[318 427 132  64 496],577,5,32029,4.698401056183072,80.0,0.0
6817,0,6817,[318 427 132  64 496],577,5,32034,4.69844529187445,80.0,0.0
6818,0,6818,[187 215 471  25 182],535,3,32037,4.698196216454026,0.0,0.0
6819,0,6819,[318 427 132  64 496],556,5,32042,4.698240469208211,80.0,0.0
6820,0,6820,[318 427 132  64 496],556,5,32047,4.698284708986952,80.0,0.0
6821,0,6821,[318 427 132  64 496],716,5,32052,4.698328935795955,80.0,0.0
6822,0,6822,[318 427 132  64 496],535,5,32057,4.69837314964092,80.0,0.0
6823,0,6823,[318 427 132  64 496],18,5,32062,4.69841735052755,80.0,0.0
6824,0,6824,[318 427 132  64 496],269,5,32067,4.6984615384615385,80.0,0.0
6825,0,6825,[318 427 132  64 496],236,4,32071,4.698359214767067,80.0,0.0
6826,0,6826,[318 427 132  64 496],796,5,32076,4.6984033982715685,80.0,0.0
6827,0,6827,[318 427 132  64 496],330,5,32081,4.698447568834212,80.0,0.0
6828,0,6828,[318 427 132  64 496],577,5,32086,4.6984917264606825,80.0,0.0
6829,0,6829,[318 427 132  64 496],577,5,32091,4.698535871156662,80.0,0.0
6830,0,6830,[318 427 132  64 496],269,5,32096,4.698580002927829,80.0,0.0
6831,0,6831,[318 427 132  64 496],269,5,32101,4.69862412177986,80.0,0.0
6832,0,6832,[318 427 132  64 496],236,4,32105,4.698521879116054,80.0,0.0
6833,0,6833,[318 427 132  64 496],450,5,32110,4.698565993561604,80.0,0.0
6834,0,6834,[194 161  71 216 173],401,2,32112,4.698171177761521,0.0,0.0
6835,0,6835,[318 427 132  64 496],18,5,32117,4.698215330602691,80.0,0.0
6836,0,6836,[318 427 132  64 496],716,5,32122,4.69825947052801,80.0,0.0
6837,0,6837,[318 427 132  64 496],330,5,32127,4.698303597543141,80.0,0.0
6838,0,6838,[318 427 132  64 496],330,5,32132,4.69834771165375,80.0,0.0
6839,0,6839,[318 427 132  64 496],450,5,32137,4.698391812865497,80.0,0.0
6840,0,6840,[318 427 132  64 496],450,5,32142,4.6984359011840375,80.0,0.0
6841,0,6841,[318 427 132  64 496],716,5,32147,4.698479976615025,80.0,0.0
6842,0,6842,[318 427 132  64 496],577,5,32152,4.698524039164109,80.0,0.0
6843,0,6843,[318 427 132  64 496],151,5,32157,4.698568088836938,80.0,0.0
6844,0,6844,[318 427 132  64 496],18,5,32162,4.698612125639153,80.0,0.0
6845,0,6845,[318 427 132  64 496],330,5,32167,4.6986561495763945,80.0,0.0
6846,0,6846,[318 427 132  64 496],18,5,32172,4.698700160654301,80.0,0.0
6847,0,6847,[318 427 132  64 496],577,5,32177,4.698744158878505,80.0,0.0
6848,0,6848,[  8 186 235  95 289],807,4,32181,4.698642137538327,0.0,0.0
6849,0,6849,[318 427 132  64 496],450,5,32186,4.698686131386862,80.0,0.0
6850,0,6850,[318 427 132  64 496],236,4,32190,4.698584148299519,80.0,0.0
6851,0,6851,[318 427 132  64 496],330,5,32195,4.698628137769994,80.0,0.0
6852,0,6852,[318 427 132  64 496],535,5,32200,4.698672114402451,80.0,0.0
6853,0,6853,[318 427 132  64 496],269,5,32205,4.6987160782025095,80.0,0.0
6854,0,6854,[318 427 132  64 496],269,5,32210,4.6987600291757845,80.0,0.0
6855,0,6855,[318 427 132  64 496],236,4,32214,4.698658109684947,80.0,0.0
6856,0,6856,[318 427 132  64 496],577,5,32219,4.69870205629284,80.0,0.0
6857,0,6857,[471 742 235 196 180],457,4,32223,4.698600174978128,0.0,0.0
6858,0,6858,[318 427 132  64 496],535,5,32228,4.698644117218254,80.0,0.0
6859,0,6859,[318 427 132  64 496],18,5,32233,4.698688046647231,80.0,0.0
6860,0,6860,[318 427 132  64 496],18,5,32238,4.69873196327066,80.0,0.0
6861,0,6861,[318 427 132  64 496],18,5,32243,4.698775867094142,80.0,0.0
6862,0,6862,[318 427 132  64 496],796,5,32248,4.698819758123269,80.0,0.0
6863,0,6863,[318 427 132  64 496],556,5,32253,4.698863636363637,80.0,0.0
6864,0,6864,[318 427 132  64 496],18,5,32258,4.69890750182083,80.0,0.0
6865,0,6865,[318 427 132  64 496],535,5,32263,4.698951354500437,80.0,0.0
6866,0,6866,[318 427 132  64 496],716,5,32268,4.698995194408038,80.0,0.0
6867,0,6867,[318 427 132  64 496],577,5,32273,4.699039021549214,80.0,0.0
6868,0,6868,[210  70  50 258 195],151,4,32277,4.698937254331052,0.0,20.0
6869,0,6869,[318 427 132  64 496],556,5,32282,4.698981077147016,80.0,0.0
6870,0,6870,[318 427 132  64 496],151,5,32287,4.699024887207102,80.0,0.0
6871,0,6871,[318 427 132  64 496],330,5,32292,4.69906868451688,80.0,0.0
6872,0,6872,[318 427 132  64 496],330,5,32297,4.699112469081915,80.0,0.0
6873,0,6873,[318 427 132  64 496],151,5,32302,4.699156240907769,80.0,0.0
6874,0,6874,[318 427 132  64 496],716,5,32307,4.6992,80.0,0.0
6875,0,6875,[318 427 132  64 496],18,5,32312,4.699243746364165,80.0,0.0
6876,0,6876,[318 427 132  64 496],556,5,32317,4.699287480005816,80.0,0.0
6877,0,6877,[318 427 132  64 496],796,5,32322,4.699331200930503,80.0,0.0
6878,0,6878,[318 427 132  64 496],577,5,32327,4.699374909143771,80.0,0.0
6879,0,6879,[318 427 132  64 496],716,5,32332,4.699418604651163,80.0,0.0
6880,0,6880,[318 427 132  64 496],716,5,32337,4.699462287458219,80.0,0.0
6881,0,6881,[318 427 132  64 496],18,5,32342,4.699505957570474,80.0,0.0
6882,0,6882,[318 427 132  64 496],556,5,32347,4.699549614993463,80.0,0.0
6883,0,6883,[318 427 132  64 496],269,5,32352,4.699593259732714,80.0,0.0
6884,0,6884,[318 427 132  64 496],236,4,32356,4.699491648511256,80.0,0.0
6885,0,6885,[318 427 132  64 496],269,5,32361,4.699535288992158,80.0,0.0
6886,0,6886,[197 323 275   1 195],796,2,32363,4.6991433134891825,0.0,20.0
6887,0,6887,[  9 678  98 117  11],344,2,32365,4.6987514518002325,0.0,0.0
6888,0,6888,[318 427 132  64 496],450,5,32370,4.698795180722891,80.0,0.0
6889,0,6889,[318 427 132  64 496],236,4,32374,4.6986937590711175,80.0,0.0
6890,0,6890,[318 427 132  64 496],535,5,32379,4.698737483674358,80.0,0.0
6891,0,6891,[515 197 483 168  88],401,4,32383,4.698636099825885,0.0,0.0
6892,0,6892,[318 427 132  64 496],535,5,32388,4.698679820107356,80.0,0.0
6893,0,6893,[318 427 132  64 496],577,5,32393,4.698723527705251,80.0,0.0
6894,0,6894,[318 427 168 185 182],503,4,32397,4.698622189992748,40.0,0.0
6895,0,6895,[318 427 132  64 496],716,5,32402,4.698665893271461,80.0,0.0
6896,0,6896,[ 12 294  96 216 118],280,3,32405,4.6984196027258225,0.0,0.0
6897,0,6897,[318 427 132  64 496],450,5,32410,4.698463322702232,80.0,0.0
6898,0,6898,[318 427 132  64 496],577,5,32415,4.6985070300043486,80.0,0.0
6899,0,6899,[318 427 132  64 496],269,5,32420,4.698550724637681,80.0,0.0
6900,0,6900,[318 427 132  64 496],330,5,32425,4.698594406607738,80.0,0.0
6901,0,6901,[318 427 132  64 496],151,5,32430,4.698638075920023,80.0,0.0
6902,0,6902,[318 427 132  64 496],18,5,32435,4.698681732580038,80.0,0.0
6903,0,6903,[318 427 132  64 496],556,5,32440,4.698725376593279,80.0,0.0
6904,0,6904,[318 427 132  64 496],716,5,32445,4.698769007965242,80.0,0.0
6905,0,6905,[318 427 132  64 496],796,5,32450,4.698812626701419,80.0,0.0
6906,0,6906,[318 427 132  64 496],151,5,32455,4.698856232807297,80.0,0.0
6907,0,6907,[318 427 132  64 496],330,5,32460,4.698899826288361,80.0,0.0
6908,0,6908,[318 427 132  64 496],535,5,32465,4.698943407150094,80.0,0.0
6909,0,6909,[318 427 132  64 496],796,5,32470,4.698986975397974,80.0,0.0
6910,0,6910,[318 427 132  64 496],535,5,32475,4.699030531037477,80.0,0.0
6911,0,6911,[318 427 132  64 496],796,5,32480,4.699074074074074,80.0,0.0
6912,0,6912,[318 427 132  64 496],577,5,32485,4.699117604513236,80.0,0.0
6913,0,6913,[318 427 132  64 496],450,5,32490,4.699161122360428,80.0,0.0
6914,0,6914,[318 427 132  64 496],236,4,32494,4.699060014461316,80.0,0.0
6915,0,6915,[301 144 471  56 125],655,0,32494,4.698380566801619,0.0,0.0
6916,0,6916,[318 427 132  64 496],330,5,32499,4.6984241723290445,80.0,0.0
6917,0,6917,[318 427 132  64 496],796,5,32504,4.698467765250072,80.0,0.0
6918,0,6918,[318 427 132  64 496],236,4,32508,4.698366816013875,80.0,0.0
6919,0,6919,[318 427 132  64 496],236,4,32512,4.6982658959537575,80.0,0.0
6920,0,6920,[318 427 132  64 496],269,5,32517,4.698309492847854,80.0,0.0
6921,0,6921,[318 427 132  64 496],535,5,32522,4.698353077145334,80.0,0.0
6922,0,6922,[318 427 132  64 496],18,5,32527,4.698396648851654,80.0,0.0
6923,0,6923,[318 427 132  64 496],18,5,32532,4.69844020797227,80.0,0.0
6924,0,6924,[318 427 132  64 496],716,5,32537,4.698483754512635,80.0,0.0
6925,0,6925,[318 427 132  64 496],577,5,32542,4.698527288478198,80.0,0.0
6926,0,6926,[245 111 282 181 182],280,1,32543,4.697993359318608,0.0,0.0
6927,0,6927,[318 427 132  64 496],556,5,32548,4.698036951501154,80.0,0.0
6928,0,6928,[318 427 132  64 496],236,4,32552,4.697936210131332,80.0,0.0
6929,0,6929,[318 427 132  64 496],716,5,32557,4.697979797979798,80.0,0.0
6930,0,6930,[318 427 132  64 496],269,5,32562,4.698023373250614,80.0,0.0
6931,0,6931,[318 427 132  64 496],236,4,32566,4.697922677437969,80.0,0.0
6932,0,6932,[318 427 132  64 496],330,5,32571,4.697966248377326,80.0,0.0
6933,0,6933,[318 427 132  64 496],330,5,32576,4.698009806749351,80.0,0.0
6934,0,6934,[318 427 132  64 496],796,5,32581,4.698053352559481,80.0,0.0
6935,0,6935,[318 427 132  64 496],236,4,32585,4.697952710495963,80.0,0.0
6936,0,6936,[318 427 132  64 496],18,5,32590,4.697996251982125,80.0,0.0
6937,0,6937,[318 427 132  64 496],330,5,32595,4.698039780916691,80.0,0.0
6938,0,6938,[318 427 132  64 496],18,5,32600,4.698083297305087,80.0,0.0
6939,0,6939,[318 427 132  64 496],18,5,32605,4.698126801152738,80.0,0.0
6940,0,6940,[318 427 132  64 496],716,5,32610,4.698170292465063,80.0,0.0
6941,0,6941,[742 168 234 176 125],450,4,32614,4.698069720541631,0.0,0.0
6942,0,6942,[318 427 132  64 496],577,5,32619,4.69811320754717,80.0,0.0
6943,0,6943,[318 427 132  64 496],18,5,32624,4.6981566820276495,80.0,0.0
6944,0,6944,[318 427 132  64 496],535,5,32629,4.698200143988481,80.0,0.0
6945,0,6945,[181   8 161 173 238],389,3,32632,4.697955657932623,0.0,0.0
6946,0,6946,[132  88 127  89   1],655,2,32634,4.697567295235354,0.0,20.0
6947,0,6947,[318 427 132  64 496],556,5,32639,4.697610823258492,80.0,0.0
6948,0,6948,[318 427 132  64 496],556,5,32644,4.697654338753778,80.0,0.0
6949,0,6949,[294 117 172 118 257],796,4,32648,4.697553956834533,0.0,0.0
6950,0,6950,[318 427 132  64 496],716,5,32653,4.697597467990217,80.0,0.0
6951,0,6951,[318 427 132  64 496],716,5,32658,4.697640966628309,80.0,0.0
6952,0,6952,[318 427 132  64 496],269,5,32663,4.697684452754207,80.0,0.0
6953,0,6953,[318 427 132  64 496],330,5,32668,4.69772792637331,80.0,0.0
6954,0,6954,[181  25 151 258 172],535,4,32672,4.697627606038821,0.0,0.0
6955,0,6955,[318 427 132  64 496],577,5,32677,4.69767107533065,80.0,0.0
6956,0,6956,[318 427 132  64 496],18,5,32682,4.697714532125916,80.0,0.0
6957,0,6957,[318 427 132  64 496],236,4,32686,4.697614256970394,80.0,0.0
6958,0,6958,[318 427 132  64 496],151,5,32691,4.697657709441011,80.0,0.0
6959,0,6959,[318 427 132  64 496],450,5,32696,4.697701149425288,80.0,0.0
6960,0,6960,[318 427 132  64 496],796,5,32701,4.697744576928602,80.0,0.0
6961,0,6961,[318 427 132  64 496],577,5,32706,4.697787991956335,80.0,0.0
6962,0,6962,[318 427 132  64 496],716,5,32711,4.697831394513859,80.0,0.0
6963,0,6963,[318 427 132  64 496],269,5,32716,4.697874784606548,80.0,0.0
6964,0,6964,[318 427 132  64 496],535,5,32721,4.6979181622397705,80.0,0.0
6965,0,6965,[318 427 132  64 496],450,5,32726,4.697961527418892,80.0,0.0
6966,0,6966,[318 427 132  64 496],450,5,32731,4.698004880149275,80.0,0.0
6967,0,6967,[318 427 132  64 496],577,5,32736,4.69804822043628,80.0,0.0
6968,0,6968,[318 427 132  64 496],450,5,32741,4.698091548285263,80.0,0.0
6969,0,6969,[483 265 427 173 294],450,4,32745,4.697991391678623,20.0,0.0
6970,0,6970,[318 427 132  64 496],236,4,32749,4.697891263807201,80.0,0.0
6971,0,6971,[318 427 132  64 496],269,5,32754,4.697934595524957,80.0,0.0
6972,0,6972,[318 427 132  64 496],535,5,32759,4.697977914814284,80.0,0.0
6973,0,6973,[ 28 300 127 183 222],796,4,32763,4.697877831947233,0.0,20.0
6974,0,6974,[318 427 132  64 496],18,5,32768,4.697921146953405,80.0,0.0
6975,0,6975,[318 427 132  64 496],450,5,32773,4.697964449541284,80.0,0.0
6976,0,6976,[318 427 132  64 496],796,5,32778,4.6980077397162106,80.0,0.0
6977,0,6977,[318 427 132  64 496],716,5,32783,4.69805101748352,80.0,0.0
6978,0,6978,[318 427 132  64 496],330,5,32788,4.698094282848546,80.0,0.0
6979,0,6979,[318 427 132  64 496],330,5,32793,4.698137535816619,80.0,0.0
6980,0,6980,[318 427 132  64 496],796,5,32798,4.698180776393067,80.0,0.0
6981,0,6981,[ 97 143 471  96  79],450,5,32803,4.6982240045832135,0.0,0.0
6982,0,6982,[318 427 132  64 496],151,5,32808,4.698267220392381,80.0,0.0
6983,0,6983,[318 427 132  64 496],450,5,32813,4.6983104238258875,80.0,0.0
6984,0,6984,[318 427 132  64 496],556,5,32818,4.698353614889048,80.0,0.0
6985,0,6985,[318 427 132  64 496],577,5,32823,4.698396793587174,80.0,0.0
6986,0,6986,[318 427 132  64 496],535,5,32828,4.698439959925576,80.0,0.0
6987,0,6987,[318 427 132  64 496],151,5,32833,4.6984831139095595,80.0,0.0
6988,0,6988,[318 427 132  64 496],151,5,32838,4.698526255544427,80.0,0.0
6989,0,6989,[318 427 132  64 496],796,5,32843,4.698569384835479,80.0,0.0
6990,0,6990,[318 427 132  64 496],330,5,32848,4.698612501788014,80.0,0.0
6991,0,6991,[318 427 132  64 496],151,5,32853,4.698655606407323,80.0,0.0
6992,0,6992,[318 427 132  64 496],236,4,32857,4.698555698555698,80.0,0.0
6993,0,6993,[181  79   8  28 187],655,2,32859,4.698169859879897,0.0,0.0
6994,0,6994,[318 427 132  64 496],269,5,32864,4.698213009292352,80.0,0.0
6995,0,6995,[318 427 132  64 496],18,5,32869,4.698256146369354,80.0,0.0
6996,0,6996,[318 427 132  64 496],236,4,32873,4.698156352722595,80.0,0.0
6997,0,6997,[210 195 655 172 234],716,4,32877,4.698056587596456,0.0,0.0
6998,0,6998,[318 427 132  64 496],18,5,32882,4.698099728532648,80.0,0.0
6999,0,6999,[318 427 132  64 496],330,5,32887,4.698142857142857,80.0,0.0
7000,0,7000,[318 427 132  64 496],556,5,32892,4.698185973432367,80.0,0.0
7001,0,7001,[318 427 132  64 496],330,5,32897,4.698229077406455,80.0,0.0
7002,0,7002,[117 127 588 100 496],344,4,32901,4.698129373125803,20.0,40.0
7003,0,7003,[318 427 132  64 496],151,5,32906,4.698172472872645,80.0,0.0
7004,0,7004,[318 427 132  64 496],269,5,32911,4.698215560314061,80.0,0.0
7005,0,7005,[318 427 132  64 496],450,5,32916,4.698258635455324,80.0,0.0
7006,0,7006,[318 427 132  64 496],269,5,32921,4.698301698301698,80.0,0.0
7007,0,7007,[318 427 132  64 496],796,5,32926,4.698344748858448,80.0,0.0
7008,0,7008,[318 427 132  64 496],577,5,32931,4.698387787130832,80.0,0.0
7009,0,7009,[318 427 132  64 496],151,5,32936,4.698430813124109,80.0,0.0
7010,0,7010,[318 427 132  64 496],236,4,32940,4.698331193838254,80.0,0.0
7011,0,7011,[318 427 132  64 496],577,5,32945,4.698374215630348,80.0,0.0
7012,0,7012,[318 427 132  64 496],18,5,32950,4.698417225153287,80.0,0.0
7013,0,7013,[318 427 132  64 496],796,5,32955,4.698460222412319,80.0,0.0
7014,0,7014,[318 427 132  64 496],151,5,32960,4.698503207412687,80.0,0.0
7015,0,7015,[318 427 132  64 496],18,5,32965,4.698546180159635,80.0,0.0
7016,0,7016,[318 427 132  64 496],796,5,32970,4.698589140658401,80.0,0.0
7017,0,7017,[172 268   8   9 508],535,3,32973,4.698347107438017,0.0,0.0
7018,0,7018,[318 427 132  64 496],556,5,32978,4.698390084057558,80.0,0.0
7019,0,7019,[186 588 655 385 258],457,5,32983,4.698433048433048,0.0,0.0
7020,0,7020,[172 204  96 216 179],655,3,32986,4.698191140863125,0.0,0.0
7021,0,7021,[318 427 132  64 496],577,5,32991,4.698234121332954,80.0,0.0
7022,0,7022,[318 427 132  64 496],269,5,32996,4.698277089562865,80.0,0.0
7023,0,7023,[588 135 318 182 294],280,3,32999,4.698035307517085,20.0,0.0
7024,0,7024,[318 427 132  64 496],18,5,33004,4.698078291814946,80.0,0.0
7025,0,7025,[357  50 127 173 200],269,3,33007,4.697836606888699,0.0,40.0
7026,0,7026,[318 427 132  64 496],450,5,33012,4.697879607229258,80.0,0.0
7027,0,7027,[318 427 132  64 496],450,5,33017,4.697922595332954,80.0,0.0
7028,0,7028,[318 427 132  64 496],151,5,33022,4.697965571205008,80.0,0.0
7029,0,7029,[318 427 132  64 496],269,5,33027,4.69800853485064,80.0,0.0
7030,0,7030,[318 427 132  64 496],236,4,33031,4.6979092589958755,80.0,0.0
7031,0,7031,[318 427 132  64 588],577,5,33036,4.697952218430034,60.0,0.0
7032,0,7032,[318 427 132  64 588],18,5,33041,4.697995165647661,60.0,0.0
7033,0,7033,[318 427 132  64 588],577,5,33046,4.698038100653966,60.0,0.0
7034,0,7034,[318 427 132  64 588],796,5,33051,4.698081023454158,60.0,0.0
7035,0,7035,[318 427 132  64 588],18,5,33056,4.69812393405344,60.0,0.0
7036,0,7036,[318 427 132  64 588],18,5,33061,4.698166832457013,60.0,0.0
7037,0,7037,[318 427 132  64 588],18,5,33066,4.698209718670077,60.0,0.0
7038,0,7038,[318 427 132  64 588],716,5,33071,4.698252592697826,60.0,0.0
7039,0,7039,[318 427 132  64 588],716,5,33076,4.6982954545454545,60.0,0.0
7040,0,7040,[318 427 132  64 588],450,5,33081,4.698338304218151,60.0,0.0
7041,0,7041,[276 183 496  96 125],280,3,33084,4.698097131496734,20.0,0.0
7042,0,7042,[318 427 132  64 588],796,5,33089,4.698139997160301,60.0,0.0
7043,0,7043,[318 427 132  64 588],18,5,33094,4.698182850653038,60.0,0.0
7044,0,7044,[318 427 132  64 588],450,5,33099,4.698225691980128,60.0,0.0
7045,0,7045,[318 427 132  64 588],450,5,33104,4.69826852114675,60.0,0.0
7046,0,7046,[197 286   7 294 181],655,0,33104,4.697601816375763,0.0,20.0
7047,0,7047,[318 427 132  64 588],716,5,33109,4.697644721906924,60.0,0.0
7048,0,7048,[318 427 132  64 588],330,5,33114,4.697687615264576,60.0,0.0
7049,0,7049,[318 427 132  64 588],316,4,33118,4.69758865248227,60.0,0.0
7050,0,7050,[318 427 132  64 588],796,5,33123,4.697631541625301,60.0,0.0
7051,0,7051,[204 179 234 191  98],18,3,33126,4.697390811117414,0.0,0.0
7052,0,7052,[318 427 132  64 588],796,5,33131,4.697433716149156,60.0,0.0
7053,0,7053,[318 427 132  64 588],450,5,33136,4.697476609016161,60.0,0.0
7054,0,7054,[318 427 132  64 588],330,5,33141,4.6975194897236,60.0,0.0
7055,0,7055,[318 427 132  64 588],577,5,33146,4.697562358276644,60.0,0.0
7056,0,7056,[318 427 132  64 588],450,5,33151,4.697605214680459,60.0,0.0
7057,0,7057,[318 427 132  64 588],716,5,33156,4.69764805894021,60.0,0.0
7058,0,7058,[318 427 132  64 588],18,5,33161,4.697690891061057,60.0,0.0
7059,0,7059,[318 427 132  64 588],450,5,33166,4.6977337110481585,60.0,0.0
7060,0,7060,[318 427 132  64 588],716,5,33171,4.697776518906671,60.0,0.0
7061,0,7061,[318 427 132  64 588],450,5,33176,4.697819314641745,60.0,0.0
7062,0,7062,[318 427 132  64 588],716,5,33181,4.69786209825853,60.0,0.0
7063,0,7063,[318 427 132  64 588],330,5,33186,4.697904869762175,60.0,0.0
7064,0,7064,[318 427 132  64 588],18,5,33191,4.69794762915782,60.0,0.0
7065,0,7065,[318 427 132  64 588],330,5,33196,4.697990376450608,60.0,0.0
7066,0,7066,[121 385 196   4  88],151,4,33200,4.697891608886374,0.0,0.0
7067,0,7067,[318 427 132  64 588],577,5,33205,4.697934352009055,60.0,0.0
7068,0,7068,[204 187 111 196  22],18,2,33207,4.697552694864903,0.0,0.0
7069,0,7069,[318 427 132  64 588],18,5,33212,4.697595473833098,60.0,0.0
7070,0,7070,[  8 118 168 174 313],577,4,33216,4.697496817988969,0.0,0.0
7071,0,7071,[186 182 385 269  79],655,2,33218,4.697115384615385,0.0,0.0
7072,0,7072,[237  98 228 186  50],457,5,33223,4.697158207267072,0.0,20.0
7073,0,7073,[318 427 132  64 588],316,4,33227,4.697059655074923,60.0,0.0
7074,0,7074,[318 427 132  64 588],796,5,33232,4.697102473498234,60.0,0.0
7075,0,7075,[318 427 132  64 588],316,4,33236,4.697003957037874,60.0,0.0
7076,0,7076,[318 427 132  64 588],316,4,33240,4.696905468418821,60.0,0.0
7077,0,7077,[318 427 132  64 496],18,5,33245,4.696948290477536,80.0,0.0
7078,0,7078,[318 427 132  64 496],330,5,33250,4.696991100437915,80.0,0.0
7079,0,7079,[318 427 132  64 496],151,5,33255,4.697033898305085,80.0,0.0
7080,0,7080,[275 508 546 357   4],344,4,33259,4.696935461093066,0.0,20.0
7081,0,7081,[318 427 132  64 496],236,4,33263,4.696837051680316,80.0,0.0
7082,0,7082,[318 427 132  64 496],330,5,33268,4.696879853169561,80.0,0.0
7083,0,7083,[318 427 132  64 496],269,5,33273,4.696922642574816,80.0,0.0
7084,0,7084,[318 427 132  64 496],450,5,33278,4.6969654199012,80.0,0.0
7085,0,7085,[318 427 132  64 496],18,5,33283,4.697008185153824,80.0,0.0
7086,0,7086,[ 12 182 121 245  89],450,4,33287,4.696909834908988,0.0,0.0
7087,0,7087,[215 403 132 568  89],655,1,33288,4.696388261851016,0.0,0.0
7088,0,7088,[403 215 100  50 603],72,3,33291,4.696148963182395,20.0,40.0
7089,0,7089,[318 427 132  64 496],269,5,33296,4.696191819464034,80.0,0.0
7090,0,7090,[318 427 132  64 496],535,5,33301,4.696234663658158,80.0,0.0
7091,0,7091,[318 427 132  64 496],535,5,33306,4.696277495769881,80.0,0.0
7092,0,7092,[318 427 132  64 496],18,5,33311,4.696320315804314,80.0,0.0
7093,0,7093,[318 427 132  64 496],556,5,33316,4.696363123766563,80.0,0.0
7094,0,7094,[318 427 132  64 496],236,4,33320,4.696264975334743,80.0,0.0
7095,0,7095,[318 427 132  64  98],693,4,33324,4.696166854565953,60.0,0.0
7096,0,7096,[318 427 132  64  98],18,5,33329,4.69620966605608,60.0,0.0
7097,0,7097,[318 427 132  64  98],236,5,33334,4.6962524654832345,60.0,0.0
7098,0,7098,[318 427 132  64  98],316,5,33339,4.696295252852514,60.0,0.0
7099,0,7099,[318 427 132  64  98],796,5,33344,4.696338028169014,60.0,0.0
7100,0,7100,[318 427 132  64  98],450,5,33349,4.696380791437826,60.0,0.0
7101,0,7101,[318 427 132  64  98],535,4,33353,4.6962827372571105,60.0,0.0
7102,0,7102,[187 471 496 288 238],450,4,33357,4.696184710685626,20.0,0.0
7103,0,7103,[318 427 132  64 496],556,5,33362,4.6962274774774775,80.0,0.0
7104,0,7104,[318 427 132  64 496],330,5,33367,4.696270232230823,80.0,0.0
7105,0,7105,[318 427 132  64 496],330,5,33372,4.696312974950746,80.0,0.0
7106,0,7106,[318 427 132  64 496],18,5,33377,4.696355705642325,80.0,0.0
7107,0,7107,[117 180 195 237 202],280,2,33379,4.695976364659539,0.0,0.0
7108,0,7108,[318 427 132  64 496],330,5,33384,4.696019130679421,80.0,0.0
7109,0,7109,[318 427 132  64 496],236,4,33388,4.69592123769339,80.0,0.0
7110,0,7110,[318 427 132  64 496],330,5,33393,4.695963999437491,80.0,0.0
7111,0,7111,[235 302 265  56 273],450,3,33396,4.695725534308211,0.0,0.0
7112,0,7112,[318 427 132  64 496],577,5,33401,4.695768311542246,80.0,0.0
7113,0,7113,[318 427 132  64 496],269,5,33406,4.69581107675007,80.0,0.0
7114,0,7114,[318 427 132  64 496],577,5,33411,4.695853829936754,80.0,0.0
7115,0,7115,[318 427 132  64 496],151,5,33416,4.6958965711073635,80.0,0.0
7116,0,7116,[318 427 132  64 496],577,5,33421,4.695939300266966,80.0,0.0
7117,0,7117,[318 427 132  64 496],269,5,33426,4.695982017420624,80.0,0.0
7118,0,7118,[318 427 132  64 496],330,5,33431,4.696024722573395,80.0,0.0
7119,0,7119,[318 427 132  64 496],716,5,33436,4.6960674157303375,80.0,0.0
7120,0,7120,[125  15 118   8 273],796,4,33440,4.695969667181576,0.0,0.0
7121,0,7121,[318 427 132  64 496],450,5,33445,4.696012356079753,80.0,0.0
7122,0,7122,[318 427 132  64 496],535,5,33450,4.696055032991717,80.0,0.0
7123,0,7123,[318 427 132  64 496],330,5,33455,4.696097697922515,80.0,0.0
7124,0,7124,[111 204 276 179  28],18,2,33457,4.695719298245614,0.0,0.0
7125,0,7125,[318 427 132  64 496],151,5,33462,4.6957619983160255,80.0,0.0
7126,0,7126,[318 427 132  64 496],236,4,33466,4.6956643749123055,80.0,0.0
7127,0,7127,[318 427 132  64 496],796,5,33471,4.695707070707071,80.0,0.0
7128,0,7128,[ 22 180 322  64  97],450,5,33476,4.695749754523776,20.0,0.0
7129,0,7129,[318 427 132  64 496],716,5,33481,4.695792426367461,80.0,0.0
7130,0,7130,[318 427 132  64 496],18,5,33486,4.6958350862431635,80.0,0.0
7131,0,7131,[318 427 132  64 496],236,4,33490,4.695737521031969,80.0,0.0
7132,0,7132,[318 427 132  64 496],556,5,33495,4.695780176643768,80.0,0.0
7133,0,7133,[275 153 211 204 318],503,3,33498,4.695542472666106,20.0,20.0
7134,0,7134,[318 427 132  64 496],577,5,33503,4.695585143658024,80.0,0.0
7135,0,7135,[318 427 132  64 496],577,5,33508,4.695627802690583,80.0,0.0
7136,0,7136,[318 427 132  64 496],450,5,33513,4.69567044976881,80.0,0.0
7137,0,7137,[318 427 132  64 496],151,5,33518,4.69571308489773,80.0,0.0
7138,0,7138,[196 180 191 228 546],457,4,33522,4.695615632441519,0.0,0.0
7139,0,7139,[197  89   9 286 183],786,4,33526,4.695518207282913,0.0,20.0
7140,0,7140,[173 168 318  88 132],457,5,33531,4.695560845819913,20.0,0.0
7141,0,7141,[318 427 132  64 496],330,5,33536,4.69560347241669,80.0,0.0
7142,0,7142,[318 427 132  64 496],151,5,33541,4.695646087078258,80.0,0.0
7143,0,7143,[318 427 132  64 496],18,5,33546,4.69568868980963,80.0,0.0
7144,0,7144,[318 427 132  64 496],577,5,33551,4.695731280615815,80.0,0.0
7145,0,7145,[318 427 132  64 496],796,5,33556,4.695773859501819,80.0,0.0
7146,0,7146,[318 427 132  64 496],796,5,33561,4.695816426472646,80.0,0.0
7147,0,7147,[318 427 132  64 496],796,5,33566,4.695858981533296,80.0,0.0
7148,0,7148,[318 427 132  64 496],535,5,33571,4.695901524688768,80.0,0.0
7149,0,7149,[318 427 132  64 496],450,5,33576,4.6959440559440555,80.0,0.0
7150,0,7150,[182 172 144 216 174],450,5,33581,4.695986575304153,0.0,0.0
7151,0,7151,[ 88 357 187 200 300],716,4,33585,4.695889261744966,0.0,0.0
7152,0,7152,[318 427 132  64 496],450,5,33590,4.695931776876835,80.0,0.0
7153,0,7153,[318 427 132  64 496],330,5,33595,4.695974280123008,80.0,0.0
7154,0,7154,[318 427 132  64 496],577,5,33600,4.69601677148847,80.0,0.0
7155,0,7155,[318 427 132  64 496],556,5,33605,4.6960592509782,80.0,0.0
7156,0,7156,[318 427 132  64 496],556,5,33610,4.696101718597178,80.0,0.0
7157,0,7157,[318 427 132  64 496],535,5,33615,4.696144174350377,80.0,0.0
7158,0,7158,[318 427 132  64 496],330,5,33620,4.696186618242772,80.0,0.0
7159,0,7159,[318 427 132  64 496],269,5,33625,4.69622905027933,80.0,0.0
7160,0,7160,[318 427 132  64 496],450,5,33630,4.696271470465019,80.0,0.0
7161,0,7161,[318 427 132  64 496],796,5,33635,4.696313878804803,80.0,0.0
7162,0,7162,[318 427 132  64 496],151,5,33640,4.696356275303644,80.0,0.0
7163,0,7163,[318 427 132  64 496],18,5,33645,4.6963986599664995,80.0,0.0
7164,0,7164,[202 294 144 228 333],655,0,33645,4.695743196092114,0.0,0.0
7165,0,7165,[405  97 427 235 135],716,3,33648,4.695506558749651,20.0,0.0
7166,0,7166,[318 427 132  64 496],577,5,33653,4.695549044230501,80.0,0.0
7167,0,7167,[318 427 132  64 496],450,5,33658,4.695591517857143,80.0,0.0
7168,0,7168,[318 427 132  64 496],716,5,33663,4.695633979634538,80.0,0.0
7169,0,7169,[318 427 132  64 496],330,5,33668,4.6956764295676425,80.0,0.0
7170,0,7170,[318 427 132  64 496],716,5,33673,4.695718867661414,80.0,0.0
7171,0,7171,[318 427 132  64 496],151,5,33678,4.695761293920803,80.0,0.0
7172,0,7172,[318 427 132  64 496],716,5,33683,4.69580370835076,80.0,0.0
7173,0,7173,[318 427 132  64 496],716,5,33688,4.69584611095623,80.0,0.0
7174,0,7174,[318 427 132  64 496],18,5,33693,4.69588850174216,80.0,0.0
7175,0,7175,[318 427 132  64 496],151,5,33698,4.695930880713489,80.0,0.0
7176,0,7176,[318 427 132  64 496],269,5,33703,4.695973247875156,80.0,0.0
7177,0,7177,[318 427 132  64 496],716,5,33708,4.696015603232098,80.0,0.0
7178,0,7178,[318 427 132  64 496],269,5,33713,4.696057946789247,80.0,0.0
7179,0,7179,[318 427 132  64 496],269,5,33718,4.6961002785515324,80.0,0.0
7180,0,7180,[318 427 132  64 496],18,5,33723,4.696142598523882,80.0,0.0
7181,0,7181,[318 427 132  64 496],236,4,33727,4.69604566972988,80.0,0.0
7182,0,7182,[318 427 132  64 496],450,5,33732,4.69608798552137,80.0,0.0
7183,0,7183,[318 427 132  64 496],330,5,33737,4.696130289532294,80.0,0.0
7184,0,7184,[318 427 132  64 496],450,5,33742,4.696172581767572,80.0,0.0
7185,0,7185,[318 427 132  64 496],535,5,33747,4.696214862232118,80.0,0.0
7186,0,7186,[318 427 132  64 496],577,5,33752,4.696257130930848,80.0,0.0
7187,0,7187,[318 427 132  64 496],577,5,33757,4.69629938786867,80.0,0.0
7188,0,7188,[318 427 132  64 496],577,5,33762,4.696341633050494,80.0,0.0
7189,0,7189,[318 427 132  64 496],556,5,33767,4.696383866481224,80.0,0.0
7190,0,7190,[318 427 132  64 496],236,4,33771,4.696287025448477,80.0,0.0
7191,0,7191,[318 427 132  64 496],151,5,33776,4.696329254727475,80.0,0.0
7192,0,7192,[318 427 132  64 496],18,5,33781,4.696371472264702,80.0,0.0
7193,0,7193,[318 427 132  64 496],330,5,33786,4.6964136780650545,80.0,0.0
7194,0,7194,[318 427 132  64 496],716,5,33791,4.696455872133426,80.0,0.0
7195,0,7195,[318 427 132  64 496],18,5,33796,4.696498054474708,80.0,0.0
7196,0,7196,[318 427 132  64 496],151,5,33801,4.696540225093789,80.0,0.0
7197,0,7197,[318 427 132  64 496],330,5,33806,4.696582383995555,80.0,0.0
7198,0,7198,[318 427 132  64 496],236,4,33810,4.696485623003195,80.0,0.0
7199,0,7199,[318 427 132  64 496],796,5,33815,4.696527777777778,80.0,0.0
7200,0,7200,[318 427 132  64 496],236,4,33819,4.696431051242883,80.0,0.0
7201,0,7201,[318 427 132  64 496],577,5,33824,4.696473201888364,80.0,0.0
7202,0,7202,[318 427 132  64 496],535,5,33829,4.69651534083021,80.0,0.0
7203,0,7203,[318 427 132  64 496],577,5,33834,4.696557468073292,80.0,0.0
7204,0,7204,[318 427 132  64 496],269,5,33839,4.6965995836224845,80.0,0.0
7205,0,7205,[318 427 132  64 496],535,5,33844,4.6966416874826535,80.0,0.0
7206,0,7206,[318 427 132  64 496],151,5,33849,4.696683779658665,80.0,0.0
7207,0,7207,[318 427 132  64 496],330,5,33854,4.696725860155383,80.0,0.0
7208,0,7208,[318 427 132  64 496],796,5,33859,4.696767928977667,80.0,0.0
7209,0,7209,[318 427 132  64 496],18,5,33864,4.696809986130375,80.0,0.0
7210,0,7210,[318 427 132  64 496],330,5,33869,4.696852031618361,80.0,0.0
7211,0,7211,[318 427 132  64 496],716,5,33874,4.696894065446478,80.0,0.0
7212,0,7212,[318 427 132  64 496],535,5,33879,4.696936087619576,80.0,0.0
7213,0,7213,[318 427 132  64 496],796,5,33884,4.696978098142501,80.0,0.0
7214,0,7214,[318 427 132  64 496],556,5,33889,4.697020097020097,80.0,0.0
7215,0,7215,[318 427 132  64 496],330,5,33894,4.697062084257206,80.0,0.0
7216,0,7216,[318 427 132  64 496],269,5,33899,4.697104059858667,80.0,0.0
7217,0,7217,[318 427 132  64 496],556,5,33904,4.6971460238293155,80.0,0.0
7218,0,7218,[318 427 132  64 496],236,4,33908,4.697049452832802,80.0,0.0
7219,0,7219,[318 427 132  64 496],577,5,33913,4.697091412742382,80.0,0.0
7220,0,7220,[318 427 132  64 496],535,5,33918,4.697133361030328,80.0,0.0
7221,0,7221,[318 427 132  64 496],269,5,33923,4.697175297701468,80.0,0.0
7222,0,7222,[318 427 132  64 496],577,5,33928,4.697217222760626,80.0,0.0
7223,0,7223,[318 427 132  64 496],535,5,33933,4.697259136212624,80.0,0.0
7224,0,7224,[318 427 132  64 496],330,5,33938,4.6973010380622835,80.0,0.0
7225,0,7225,[318 427 132  64 496],330,5,33943,4.69734292831442,80.0,0.0
7226,0,7226,[318 427 132  64 496],716,5,33948,4.697384806973848,80.0,0.0
7227,0,7227,[318 427 132  64 496],716,5,33953,4.697426674045379,80.0,0.0
7228,0,7228,[318 427 132  64 496],450,5,33958,4.697468529533822,80.0,0.0
7229,0,7229,[318 427 132  64 496],18,5,33963,4.697510373443984,80.0,0.0
7230,0,7230,[318 427 132  64 496],330,5,33968,4.697552205780666,80.0,0.0
7231,0,7231,[318 427 132  64 496],796,5,33973,4.697594026548672,80.0,0.0
7232,0,7232,[318 427 132  64 496],796,5,33978,4.697635835752799,80.0,0.0
7233,0,7233,[318 427 132  64 496],556,5,33983,4.697677633397843,80.0,0.0
7234,0,7234,[318 427 132  64 496],18,5,33988,4.697719419488597,80.0,0.0
7235,0,7235,[153 127  28 427 333],655,2,33990,4.697346600331675,20.0,20.0
7236,0,7236,[318 427 132  64 496],796,5,33995,4.697388420616277,80.0,0.0
7237,0,7237,[318 427 132  64 496],18,5,34000,4.697430229345123,80.0,0.0
7238,0,7238,[318 427 132  64 496],577,5,34005,4.697472026523,80.0,0.0
7239,0,7239,[318 427 132  64 496],535,5,34010,4.697513812154696,80.0,0.0
7240,0,7240,[318 427 132  64 496],236,4,34014,4.697417483772959,80.0,0.0
7241,0,7241,[318 427 132  64 496],577,5,34019,4.697459265396299,80.0,0.0
7242,0,7242,[318 427 132  64 496],796,5,34024,4.697501035482535,80.0,0.0
7243,0,7243,[318 427 132  64 496],535,5,34029,4.697542794036444,80.0,0.0
7244,0,7244,[318 427 132  64 496],269,5,34034,4.697584541062802,80.0,0.0
7245,0,7245,[318 427 132  64 496],151,5,34039,4.697626276566382,80.0,0.0
7246,0,7246,[318 427 132  64 496],716,5,34044,4.697668000551952,80.0,0.0
7247,0,7247,[318 427 132  64 496],450,5,34049,4.697709713024283,80.0,0.0
7248,0,7248,[173 237 471 100 483],639,1,34050,4.697199613739826,0.0,20.0
7249,0,7249,[176 546 173 111 301],796,4,34054,4.697103448275862,0.0,0.0
7250,0,7250,[318 427 132  64 496],535,5,34059,4.697145221348779,80.0,0.0
7251,0,7251,[318 427 132  64 496],236,4,34063,4.6970490899062325,80.0,0.0
7252,0,7252,[603 202 168 471 182],389,5,34068,4.697090858954915,20.0,0.0
7253,0,7253,[318 427 132  64 496],269,5,34073,4.697132616487456,80.0,0.0
7254,0,7254,[318 427 132  64 496],236,4,34077,4.6970365265334255,80.0,0.0
7255,0,7255,[318 427 132  64 496],796,5,34082,4.697078280044101,80.0,0.0
7256,0,7256,[318 427 132  64 496],330,5,34087,4.697120022047678,80.0,0.0
7257,0,7257,[318 427 132  64 496],18,5,34092,4.6971617525489116,80.0,0.0
7258,0,7258,[318 427 132  64 496],330,5,34097,4.697203471552555,80.0,0.0
7259,0,7259,[318 427 132  64 496],18,5,34102,4.697245179063361,80.0,0.0
7260,0,7260,[318 427 132  64 496],151,5,34107,4.697286875086077,80.0,0.0
7261,0,7261,[318 427 132  64 496],18,5,34112,4.697328559625448,80.0,0.0
7262,0,7262,[ 12   8 515 423 313],655,2,34114,4.696957180228556,0.0,0.0
7263,0,7263,[318 427 132  64 496],535,5,34119,4.696998898678414,80.0,0.0
7264,0,7264,[318 427 132  64 496],151,5,34124,4.697040605643497,80.0,0.0
7265,0,7265,[318 427 132  64 496],556,5,34129,4.697082301128544,80.0,0.0
7266,0,7266,[318 427 132  64 496],450,5,34134,4.697123985138297,80.0,0.0
7267,0,7267,[318 427 132  64 496],577,5,34139,4.69716565767749,80.0,0.0
7268,0,7268,[318 427 132  64 496],236,4,34143,4.697069748245976,80.0,0.0
7269,0,7269,[318 427 132  64 496],577,5,34148,4.697111416781293,80.0,0.0
7270,0,7270,[318 427 132  64 496],796,5,34153,4.69715307385504,80.0,0.0
7271,0,7271,[318 427 132  64 496],556,5,34158,4.697194719471947,80.0,0.0
7272,0,7272,[318 427 132  64 496],151,5,34163,4.697236353636739,80.0,0.0
7273,0,7273,[318 427 132  64 496],716,5,34168,4.697277976354138,80.0,0.0
7274,0,7274,[318 427 132  64 496],269,5,34173,4.697319587628866,80.0,0.0
7275,0,7275,[318 427 132  64 496],716,5,34178,4.69736118746564,80.0,0.0
7276,0,7276,[318 427 132  64 496],18,5,34183,4.697402775869177,80.0,0.0
7277,0,7277,[318 427 132  64 496],330,5,34188,4.697444352844188,80.0,0.0
7278,0,7278,[318 427 132  64 496],556,5,34193,4.697485918395384,80.0,0.0
7279,0,7279,[318 427 132  64 496],18,5,34198,4.697527472527472,80.0,0.0
7280,0,7280,[318 427 132  64 496],450,5,34203,4.697569015245159,80.0,0.0
7281,0,7281,[318 427 132  64 496],18,5,34208,4.697610546553145,80.0,0.0
7282,0,7282,[318 427 132  64 496],535,5,34213,4.697652066456131,80.0,0.0
7283,0,7283,[318 427 132  64 496],535,5,34218,4.697693574958814,80.0,0.0
7284,0,7284,[318 427 132  64 496],450,5,34223,4.697735072065889,80.0,0.0
7285,0,7285,[318 427 132  64 496],269,5,34228,4.697776557782047,80.0,0.0
7286,0,7286,[318 427 132  64 496],151,5,34233,4.6978180321119805,80.0,0.0
7287,0,7287,[318 427 132  64 496],535,5,34238,4.697859495060373,80.0,0.0
7288,0,7288,[318 427 132  64 496],716,5,34243,4.697900946631911,80.0,0.0
7289,0,7289,[318 427 132  64 496],18,5,34248,4.697942386831276,80.0,0.0
7290,0,7290,[318 427 132  64 496],18,5,34253,4.697983815663147,80.0,0.0
7291,0,7291,[318 427 132  64 496],236,4,34257,4.697888096544158,80.0,0.0
7292,0,7292,[318 427 132  64 496],716,5,34262,4.697929521458933,80.0,0.0
7293,0,7293,[318 427 132  64 496],18,5,34267,4.697970935015081,80.0,0.0
7294,0,7294,[318 427 132  64 496],151,5,34272,4.698012337217272,80.0,0.0
7295,0,7295,[318 427 132  64 496],535,5,34277,4.6980537280701755,80.0,0.0
7296,0,7296,[318 427 132  64 496],269,5,34282,4.698095107578457,80.0,0.0
7297,0,7297,[318 427 132  64 496],18,5,34287,4.69813647574678,80.0,0.0
7298,0,7298,[318 427 132  64 496],556,5,34292,4.698177832579805,80.0,0.0
7299,0,7299,[318 427 132  64 496],151,5,34297,4.698219178082192,80.0,0.0
7300,0,7300,[318 427 132  64 496],535,5,34302,4.698260512258595,80.0,0.0
7301,0,7301,[318 427 132  64 496],450,5,34307,4.698301835113668,80.0,0.0
7302,0,7302,[318 427 132  64 496],269,5,34312,4.698343146652061,80.0,0.0
7303,0,7303,[318 427 132  64 496],535,5,34317,4.698384446878423,80.0,0.0
7304,0,7304,[318 427 132  64 496],18,5,34322,4.698425735797399,80.0,0.0
7305,0,7305,[318 427 132  64 496],577,5,34327,4.698467013413633,80.0,0.0
7306,0,7306,[318 427 132  64 496],535,5,34332,4.698508279731764,80.0,0.0
7307,0,7307,[318 427 132  64 496],151,5,34337,4.698549534756431,80.0,0.0
7308,0,7308,[318 427 132  64 496],269,5,34342,4.69859077849227,80.0,0.0
7309,0,7309,[318 427 132  64 496],450,5,34347,4.698632010943912,80.0,0.0
7310,0,7310,[318 427 132  64 496],796,5,34352,4.69867323211599,80.0,0.0
7311,0,7311,[318 427 132  64 496],18,5,34357,4.698714442013129,80.0,0.0
7312,0,7312,[318 427 132  64 496],151,5,34362,4.698755640639956,80.0,0.0
7313,0,7313,[318 427 132  64 496],450,5,34367,4.698796828001094,80.0,0.0
7314,0,7314,[318 427 132  64 496],556,5,34372,4.698838004101162,80.0,0.0
7315,0,7315,[318 427 132  64 496],716,5,34377,4.698879168944779,80.0,0.0
7316,0,7316,[258 211 180 678 385],504,5,34382,4.698920322536559,0.0,0.0
7317,0,7317,[318 427 132  64 496],151,5,34387,4.698961464881115,80.0,0.0
7318,0,7318,[318 427 132  64 496],236,4,34391,4.698865965295806,80.0,0.0
7319,0,7319,[318 427 132  64 496],556,5,34396,4.698907103825136,80.0,0.0
7320,0,7320,[318 427 132  64 496],716,5,34401,4.698948231115968,80.0,0.0
7321,0,7321,[318 427 132  64 496],330,5,34406,4.698989347172904,80.0,0.0
7322,0,7322,[318 427 132  64 496],716,5,34411,4.699030452000546,80.0,0.0
7323,0,7323,[318 427 132  64 496],236,4,34415,4.698935008192245,80.0,0.0
7324,0,7324,[318 427 132  64 496],151,5,34420,4.698976109215017,80.0,0.0
7325,0,7325,[318 427 132  64 496],796,5,34425,4.699017199017199,80.0,0.0
7326,0,7326,[318 427 132  64 496],716,5,34430,4.699058277603385,80.0,0.0
7327,0,7327,[318 427 132  64 496],577,5,34435,4.6990993449781655,80.0,0.0
7328,0,7328,[318 427 132  64 496],18,5,34440,4.699140401146132,80.0,0.0
7329,0,7329,[318 427 132  64 496],796,5,34445,4.699181446111869,80.0,0.0
7330,0,7330,[318 427 132  64 496],716,5,34450,4.699222479879962,80.0,0.0
7331,0,7331,[318 427 132  64 496],330,5,34455,4.699263502454992,80.0,0.0
7332,0,7332,[318 427 132  64 496],796,5,34460,4.699304513841538,80.0,0.0
7333,0,7333,[318 427 132  64 496],236,4,34464,4.699209162803381,80.0,0.0
7334,0,7334,[318 427 132  64 496],330,5,34469,4.699250170415815,80.0,0.0
7335,0,7335,[318 427 132  64 496],556,5,34474,4.699291166848419,80.0,0.0
7336,0,7336,[318 427 132  64 496],716,5,34479,4.699332152105765,80.0,0.0
7337,0,7337,[318 427 132  64 496],269,5,34484,4.699373126192423,80.0,0.0
7338,0,7338,[318 427 132  64 496],556,5,34489,4.699414089112958,80.0,0.0
7339,0,7339,[318 427 132  64 496],535,5,34494,4.699455040871935,80.0,0.0
7340,0,7340,[318 427 132  64 496],236,4,34498,4.699359760250647,80.0,0.0
7341,0,7341,[318 427 132  64 496],577,5,34503,4.699400708253882,80.0,0.0
7342,0,7342,[318 427 132  64 496],18,5,34508,4.699441645104181,80.0,0.0
7343,0,7343,[318 427 132  64 496],330,5,34513,4.6994825708061,80.0,0.0
7344,0,7344,[318 427 132  64 496],18,5,34518,4.699523485364193,80.0,0.0
7345,0,7345,[318 427 132  64 496],796,5,34523,4.699564388783011,80.0,0.0
7346,0,7346,[318 427 132  64 496],716,5,34528,4.699605281067102,80.0,0.0
7347,0,7347,[318 427 132  64 496],535,5,34533,4.699646162221012,80.0,0.0
7348,0,7348,[318 427 132  64 496],18,5,34538,4.699687032249286,80.0,0.0
7349,0,7349,[318 427 132  64 496],236,4,34542,4.699591836734694,80.0,0.0
7350,0,7350,[318 427 132  64 496],535,5,34547,4.6996327030336005,80.0,0.0
7351,0,7351,[318 427 132  64 496],269,5,34552,4.699673558215451,80.0,0.0
7352,0,7352,[318 427 132  64 496],330,5,34557,4.699714402284782,80.0,0.0
7353,0,7353,[318 427 132  64 496],236,4,34561,4.699619254827305,80.0,0.0
7354,0,7354,[318 427 132  64 496],269,5,34566,4.699660095173352,80.0,0.0
7355,0,7355,[318 427 132  64 496],330,5,34571,4.699700924415443,80.0,0.0
7356,0,7356,[318 427 132  64 496],556,5,34576,4.699741742558108,80.0,0.0
7357,0,7357,[318 427 132  64 496],450,5,34581,4.699782549605871,80.0,0.0
7358,0,7358,[191 181 168  69 238],716,5,34586,4.699823345563256,0.0,0.0
7359,0,7359,[318 427 132  64 496],796,5,34591,4.699864130434783,80.0,0.0
7360,0,7360,[318 427 132  64 496],330,5,34596,4.69990490422497,80.0,0.0
7361,0,7361,[318 427 132  64 496],716,5,34601,4.699945666938332,80.0,0.0
7362,0,7362,[318 427 132  64 496],269,5,34606,4.699986418579384,80.0,0.0
7363,0,7363,[318 427 132  64 496],151,5,34611,4.700027159152635,80.0,0.0
7364,0,7364,[318 427 132  64 496],535,5,34616,4.700067888662593,80.0,0.0
7365,0,7365,[318 427 132  64 496],450,5,34621,4.700108607113766,80.0,0.0
7366,0,7366,[318 427 132  64 496],330,5,34626,4.700149314510655,80.0,0.0
7367,0,7367,[318 427 132  64 496],151,5,34631,4.700190010857764,80.0,0.0
7368,0,7368,[318 427 132  64 496],18,5,34636,4.700230696159587,80.0,0.0
7369,0,7369,[318 427 132  64 496],716,5,34641,4.700271370420624,80.0,0.0
7370,0,7370,[318 427 132  64 496],450,5,34646,4.700312033645367,80.0,0.0
7371,0,7371,[318 427 132  64 496],330,5,34651,4.700352685838307,80.0,0.0
7372,0,7372,[318 427 132  64 496],151,5,34656,4.700393327003933,80.0,0.0
7373,0,7373,[195  70 172  12 197],280,2,34658,4.7000271223216705,0.0,0.0
7374,0,7374,[ 97 196 496  79 294],716,5,34663,4.70006779661017,20.0,0.0
7375,0,7375,[318 427 132  64 496],269,5,34668,4.700108459869848,80.0,0.0
7376,0,7376,[318 427 132  64 496],577,5,34673,4.7001491121051915,80.0,0.0
7377,0,7377,[318 427 132  64 496],716,5,34678,4.700189753320683,80.0,0.0
7378,0,7378,[318 427 132  64 496],236,4,34682,4.700094863802684,80.0,0.0
7379,0,7379,[318 427 132  64 496],716,5,34687,4.700135501355014,80.0,0.0
7380,0,7380,[318 427 132  64 496],330,5,34692,4.700176127895949,80.0,0.0
7381,0,7381,[318 427 132  64 496],716,5,34697,4.700216743429965,80.0,0.0
7382,0,7382,[181 196 228  56 508],655,0,34697,4.699580116483814,0.0,0.0
7383,0,7383,[318 427 132  64 496],330,5,34702,4.699620801733478,80.0,0.0
7384,0,7384,[318 427 132  64 496],577,5,34707,4.699661475964794,80.0,0.0
7385,0,7385,[318 427 132  64 496],151,5,34712,4.699702139182237,80.0,0.0
7386,0,7386,[318 427 132  64 496],796,5,34717,4.69974279139028,80.0,0.0
7387,0,7387,[318 427 132  64 496],535,5,34722,4.699783432593395,80.0,0.0
7388,0,7388,[318 210 322  15 546],593,2,34724,4.699418053863852,20.0,0.0
7389,0,7389,[ 98 187 191   7 322],450,5,34729,4.699458728010826,0.0,0.0
7390,0,7390,[318 427 132  64 496],796,5,34734,4.6994993911514005,80.0,0.0
7391,0,7391,[318 427 132  64 496],450,5,34739,4.699540043290043,80.0,0.0
7392,0,7392,[318 427 132  64 496],450,5,34744,4.6995806844312185,80.0,0.0
7393,0,7393,[204  22 282 161  50],716,3,34747,4.699350824993238,0.0,20.0
7394,0,7394,[318 427 132  64 496],236,4,34751,4.699256254225828,80.0,0.0
7395,0,7395,[289 294 286 300 238],494,4,34755,4.699161709031909,0.0,20.0
7396,0,7396,[271 143 182 185 508],655,3,34758,4.698931999459241,0.0,0.0
7397,0,7397,[318 427 132  64 496],151,5,34763,4.69897269532306,80.0,0.0
7398,0,7398,[271 210  79 168 748],796,4,34767,4.698878226787404,0.0,0.0
7399,0,7399,[318 427 132  64 496],269,5,34772,4.698918918918919,80.0,0.0
7400,0,7400,[318 427 132  64 496],269,5,34777,4.698959600054047,80.0,0.0
7401,0,7401,[318 427 132  64 496],716,5,34782,4.699000270197244,80.0,0.0
7402,0,7402,[318 427 132  64 496],535,5,34787,4.699040929352965,80.0,0.0
7403,0,7403,[318 427 132  64 496],716,5,34792,4.699081577525662,80.0,0.0
7404,0,7404,[318 427 132  64 496],151,5,34797,4.699122214719784,80.0,0.0
7405,0,7405,[318 427 132  64 496],796,5,34802,4.6991628409397785,80.0,0.0
7406,0,7406,[318 427 132  64 496],535,5,34807,4.699203456190091,80.0,0.0
7407,0,7407,[318 427 132  64 496],716,5,34812,4.699244060475162,80.0,0.0
7408,0,7408,[318 427 132  64 496],796,5,34817,4.699284653799433,80.0,0.0
7409,0,7409,[318 427 132  64 496],796,5,34822,4.699325236167342,80.0,0.0
7410,0,7410,[ 50 202  79 269 125],655,2,34824,4.6989610039131025,0.0,20.0
7411,0,7411,[318 427 132  64 496],151,5,34829,4.699001618996222,80.0,0.0
7412,0,7412,[318 427 132  64 496],556,5,34834,4.699042223121543,80.0,0.0
7413,0,7413,[318 427 132  64 496],535,5,34839,4.699082816293499,80.0,0.0
7414,0,7414,[318 427 132  64 496],330,5,34844,4.69912339851652,80.0,0.0
7415,0,7415,[318 427 132  64 496],236,4,34848,4.699029126213592,80.0,0.0
7416,0,7416,[318 427 132  64 496],535,5,34853,4.699069704732372,80.0,0.0
7417,0,7417,[ 56  64 427 186 211],389,4,34857,4.698975465084929,40.0,0.0
7418,0,7418,[318 427 132  64 496],269,5,34862,4.69901603989756,80.0,0.0
7419,0,7419,[318 427 132  64 496],577,5,34867,4.699056603773585,80.0,0.0
7420,0,7420,[318 427 132  64 496],269,5,34872,4.699097156717423,80.0,0.0
7421,0,7421,[318 427 132  64 496],330,5,34877,4.699137698733495,80.0,0.0
7422,0,7422,[318 427 132  64 496],556,5,34882,4.699178229826216,80.0,0.0
7423,0,7423,[276  22 117 181  56],655,1,34883,4.698679956896552,0.0,0.0
7424,0,7424,[318 427 132  64 496],151,5,34888,4.698720538720539,80.0,0.0
7425,0,7425,[318 427 132  64 496],236,4,34892,4.6986264476164825,80.0,0.0
7426,0,7426,[318 427 132  64 496],18,5,34897,4.698667025716978,80.0,0.0
7427,0,7427,[318 427 132  64 496],577,5,34902,4.698707592891761,80.0,0.0
7428,0,7428,[318 427 132  64 496],151,5,34907,4.698748149145241,80.0,0.0
7429,0,7429,[318 427 132  64 496],151,5,34912,4.698788694481831,80.0,0.0
7430,0,7430,[318 427 132  64 496],236,4,34916,4.698694657515812,80.0,0.0
7431,0,7431,[318 427 132  64 496],556,5,34921,4.698735199138859,80.0,0.0
7432,0,7432,[318 427 132  64 496],236,4,34925,4.6986411946724065,80.0,0.0
7433,0,7433,[318 427 132  64 496],716,5,34930,4.698681732580038,80.0,0.0
7434,0,7434,[151 403 182 318 186],450,4,34934,4.698587760591796,20.0,0.0
7435,0,7435,[ 15  88 135  11 427],655,2,34936,4.6982248520710055,20.0,0.0
7436,0,7436,[318 427 132  64 496],236,4,34940,4.698130966787684,80.0,0.0
7437,0,7437,[318 427 132  64 603],535,5,34945,4.698171551492337,80.0,0.0
7438,0,7438,[318 427 132  64 603],18,4,34949,4.698077698615405,80.0,0.0
7439,0,7439,[318 427 132  64 496],796,5,34954,4.698118279569893,80.0,0.0
7440,0,7440,[318 427 132  64 496],151,5,34959,4.698158849616987,80.0,0.0
7441,0,7441,[318 427 132  64 496],716,5,34964,4.698199408761086,80.0,0.0
7442,0,7442,[318 427 132  64 496],796,5,34969,4.698239957006583,80.0,0.0
7443,0,7443,[318 427 132  64 496],18,5,34974,4.698280494357872,80.0,0.0
7444,0,7444,[318 427 132  64 496],796,5,34979,4.698321020819342,80.0,0.0
7445,0,7445,[318 427 132  64 496],269,5,34984,4.69836153639538,80.0,0.0
7446,0,7446,[318 427 132  64 496],269,5,34989,4.698402041090372,80.0,0.0
7447,0,7447,[318 427 132  64 496],450,5,34994,4.6984425349087005,80.0,0.0
7448,0,7448,[318 427 132  64 496],796,5,34999,4.698483017854746,80.0,0.0
7449,0,7449,[318 427 132  64 496],18,5,35004,4.698523489932886,80.0,0.0
7450,0,7450,[318 427 132  64 496],716,5,35009,4.698563951147497,80.0,0.0
7451,0,7451,[318 427 132  64 496],796,5,35014,4.698604401502952,80.0,0.0
7452,0,7452,[318 427 132  64 496],18,5,35019,4.698644841003623,80.0,0.0
7453,0,7453,[318 427 132  64 496],330,5,35024,4.698685269653877,80.0,0.0
7454,0,7454,[318 427 132  64 496],556,5,35029,4.698725687458082,80.0,0.0
7455,0,7455,[318 427 132  64 496],535,5,35034,4.698766094420601,80.0,0.0
7456,0,7456,[318 427 132  64 496],535,5,35039,4.698806490545796,80.0,0.0
7457,0,7457,[318 427 132  64 496],556,5,35044,4.698846875838027,80.0,0.0
7458,0,7458,[318 427 132  64 496],330,5,35049,4.698887250301649,80.0,0.0
7459,0,7459,[318 427 132  64 496],716,5,35054,4.698927613941019,80.0,0.0
7460,0,7460,[318 427 132  64 496],330,5,35059,4.698967966760488,80.0,0.0
7461,0,7461,[318 405 282 748 275],450,5,35064,4.699008308764406,20.0,20.0
7462,0,7462,[318 427 132  64 496],450,5,35069,4.699048639957121,80.0,0.0
7463,0,7463,[318 427 132  64 496],236,4,35073,4.69895498392283,80.0,0.0
7464,0,7464,[318 427 132  64 496],556,5,35078,4.69899531145345,80.0,0.0
7465,0,7465,[318 427 132  64 496],716,5,35083,4.699035628181088,80.0,0.0
7466,0,7466,[318 427 132  64 496],716,5,35088,4.699075934110084,80.0,0.0
7467,0,7467,[318 427 132  64 496],151,5,35093,4.699116229244778,80.0,0.0
7468,0,7468,[318 427 132  64 496],151,5,35098,4.699156513589504,80.0,0.0
7469,0,7469,[318 427 132  64 496],18,5,35103,4.699196787148594,80.0,0.0
7470,0,7470,[318 427 132  64 496],330,5,35108,4.699237049926382,80.0,0.0
7471,0,7471,[318 427 132  64 496],18,5,35113,4.699277301927195,80.0,0.0
7472,0,7472,[318 427 132  64 496],535,5,35118,4.6993175431553595,80.0,0.0
7473,0,7473,[318 427 132  64 496],269,5,35123,4.6993577736151995,80.0,0.0
7474,0,7474,[318 427 132  64 496],577,5,35128,4.699397993311036,80.0,0.0
7475,0,7475,[318 427 132  64 496],450,5,35133,4.699438202247191,80.0,0.0
7476,0,7476,[318 427 132  64 496],151,5,35138,4.699478400427979,80.0,0.0
7477,0,7477,[318 427 132  64 496],269,5,35143,4.699518587857716,80.0,0.0
7478,0,7478,[318 427 132  64 496],450,5,35148,4.699558764540714,80.0,0.0
7479,0,7479,[318 427 132  64 496],236,4,35152,4.699465240641711,80.0,0.0
7480,0,7480,[318 427 132  64 496],151,5,35157,4.699505413714744,80.0,0.0
7481,0,7481,[318 427 132  64 496],716,5,35162,4.699545576049185,80.0,0.0
7482,0,7482,[318 427 132  64 496],450,5,35167,4.699585727649339,80.0,0.0
7483,0,7483,[318 427 132  64 496],796,5,35172,4.699625868519508,80.0,0.0
7484,0,7484,[318 427 132  64 496],269,5,35177,4.699665998663995,80.0,0.0
7485,0,7485,[318 427 132  64 496],577,5,35182,4.699706118087096,80.0,0.0
7486,0,7486,[318 427 132  64 496],269,5,35187,4.699746226793108,80.0,0.0
7487,0,7487,[318 427 132  64 496],450,5,35192,4.6997863247863245,80.0,0.0
7488,0,7488,[318 427 132  64 496],577,5,35197,4.699826412071038,80.0,0.0
7489,0,7489,[318 427 132  64 496],151,5,35202,4.699866488651535,80.0,0.0
7490,0,7490,[318 427 132  64 496],716,5,35207,4.699906554532105,80.0,0.0
7491,0,7491,[318 427 132  64 496],18,5,35212,4.699946609717031,80.0,0.0
7492,0,7492,[318 427 132  64 496],330,5,35217,4.699986654210597,80.0,0.0
7493,0,7493,[318 427 132  64 496],236,4,35221,4.699893247931679,80.0,0.0
7494,0,7494,[318 427 132  64 496],450,5,35226,4.699933288859239,80.0,0.0
7495,0,7495,[318 427 132  64 496],450,5,35231,4.699973319103522,80.0,0.0
7496,0,7496,[174 568 196 172 176],716,4,35235,4.699879951980792,0.0,0.0
7497,0,7497,[318 427 132  64 496],330,5,35240,4.699919978660977,80.0,0.0
7498,0,7498,[318 427 132  64 496],535,5,35245,4.699959994665956,80.0,0.0
7499,0,7499,[318 427 132  64 496],269,5,35250,4.7,80.0,0.0
7500,0,7500,[318 427 132  64 496],151,5,35255,4.700039994667378,80.0,0.0
7501,0,7501,[271 301 200 405 132],796,4,35259,4.699946680885097,0.0,0.0
7502,0,7502,[318 427 132  64 496],151,5,35264,4.699986671997867,80.0,0.0
7503,0,7503,[318 427 132  64 496],577,5,35269,4.700026652452026,80.0,0.0
7504,0,7504,[318 427 132  64 496],556,5,35274,4.700066622251832,80.0,0.0
7505,0,7505,[318 427 132  64 496],577,5,35279,4.7001065814015455,80.0,0.0
7506,0,7506,[318 427 132  64 496],330,5,35284,4.700146529905422,80.0,0.0
7507,0,7507,[318 427 132  64 496],269,5,35289,4.700186467767715,80.0,0.0
7508,0,7508,[318 427 132  64 496],18,5,35294,4.700226394992676,80.0,0.0
7509,0,7509,[318 427 132  64 496],577,5,35299,4.700266311584554,80.0,0.0
7510,0,7510,[318 427 132  64 496],716,5,35304,4.700306217547597,80.0,0.0
7511,0,7511,[318 427 132  64 496],556,5,35309,4.700346112886049,80.0,0.0
7512,0,7512,[318 427 132  64 496],151,5,35314,4.700385997604153,80.0,0.0
7513,0,7513,[318 427 132  64 496],269,5,35319,4.700425871706148,80.0,0.0
7514,0,7514,[318 427 132  64 496],236,4,35323,4.700332667997339,80.0,0.0
7515,0,7515,[318 427 132  64 496],18,5,35328,4.700372538584354,80.0,0.0
7516,0,7516,[318 427 132  64 496],18,5,35333,4.700412398563256,80.0,0.0
7517,0,7517,[318 427 132  64 496],18,5,35338,4.700452247938282,80.0,0.0
7518,0,7518,[318 427 132  64 496],18,5,35343,4.700492086713659,80.0,0.0
7519,0,7519,[318 427 132  64 496],330,5,35348,4.700531914893617,80.0,0.0
7520,0,7520,[318 427 132  64 496],151,5,35353,4.700571732482382,80.0,0.0
7521,0,7521,[318 427 132  64 496],18,5,35358,4.700611539484179,80.0,0.0
7522,0,7522,[318 427 132  64 496],796,5,35363,4.70065133590323,80.0,0.0
7523,0,7523,[318 427 132  64 496],577,5,35368,4.700691121743754,80.0,0.0
7524,0,7524,[196 180 597 276 235],269,1,35369,4.700199335548173,0.0,0.0
7525,0,7525,[318 427 132  64 496],236,4,35373,4.700106298166356,80.0,0.0
7526,0,7526,[173 125 181 172   1],503,4,35377,4.700013285505514,0.0,0.0
7527,0,7527,[318 427 132  64 496],269,5,35382,4.700053134962806,80.0,0.0
7528,0,7528,[318 427 132  64 496],236,4,35386,4.699960154070926,80.0,0.0
7529,0,7529,[187 265 294  64 200],236,1,35387,4.699468791500664,20.0,0.0
7530,0,7530,[318 427 132  64 496],716,5,35392,4.699508697384146,80.0,0.0
7531,0,7531,[318 427 132  64 496],796,5,35397,4.6995485926712695,80.0,0.0
7532,0,7532,[318 427 132  64 496],18,5,35402,4.699588477366255,80.0,0.0
7533,0,7533,[318 427 132  64 496],577,5,35407,4.699628351473321,80.0,0.0
7534,0,7534,[173  71 144 204   4],535,3,35410,4.699402786994028,0.0,0.0
7535,0,7535,[318 427 132  64 496],151,5,35415,4.6994426751592355,80.0,0.0
7536,0,7536,[318 427 132  64 496],716,5,35420,4.699482552739817,80.0,0.0
7537,0,7537,[318 427 132  64 496],535,5,35425,4.699522419739984,80.0,0.0
7538,0,7538,[318 427 132  64 496],450,5,35430,4.699562276163947,80.0,0.0
7539,0,7539,[318 427 132  64 496],151,5,35435,4.699602122015915,80.0,0.0
7540,0,7540,[318 427 132  64 496],450,5,35440,4.699641957300093,80.0,0.0
7541,0,7541,[ 25 258 245 273 132],344,3,35443,4.699416600371254,0.0,0.0
7542,0,7542,[318 427 132  64 496],151,5,35448,4.699456449688453,80.0,0.0
7543,0,7543,[318 427 132  64 496],450,5,35453,4.6994962884411455,80.0,0.0
7544,0,7544,[318 427 132  64 496],269,5,35458,4.699536116633532,80.0,0.0
7545,0,7545,[318 427 132  64 496],330,5,35463,4.699575934269812,80.0,0.0
7546,0,7546,[318 427 132  64 496],535,5,35468,4.69961574135418,80.0,0.0
7547,0,7547,[318 427 132  64 496],796,5,35473,4.699655537890832,80.0,0.0
7548,0,7548,[318 427 132  64 496],556,5,35478,4.699695323883958,80.0,0.0
7549,0,7549,[318 427 132  64 496],269,5,35483,4.699735099337748,80.0,0.0
7550,0,7550,[318 427 132  64 496],716,5,35488,4.69977486425639,80.0,0.0
7551,0,7551,[318 427 132  64 496],236,4,35492,4.6996822033898304,80.0,0.0
7552,0,7552,[318 427 132  64 496],18,5,35497,4.6997219647822055,80.0,0.0
7553,0,7553,[318 427 132  64 496],236,4,35501,4.699629335451417,80.0,0.0
7554,0,7554,[318 427 132  64 496],716,5,35506,4.699669093315685,80.0,0.0
7555,0,7555,[318 427 132  64 496],269,5,35511,4.699708840656432,80.0,0.0
7556,0,7556,[318 427 132  64 496],716,5,35516,4.699748577477835,80.0,0.0
7557,0,7557,[318 427 132  64 496],151,5,35521,4.69978830378407,80.0,0.0
7558,0,7558,[318 427 132  64 496],450,5,35526,4.69982801957931,80.0,0.0
7559,0,7559,[318 427 132  64 496],18,5,35531,4.699867724867725,80.0,0.0
7560,0,7560,[286 322 144 135 197],629,4,35535,4.699775162015606,0.0,20.0
7561,0,7561,[318 427 132  64 496],151,5,35540,4.699814863792647,80.0,0.0
7562,0,7562,[318 427 132  64 496],556,5,35545,4.699854555070739,80.0,0.0
7563,0,7563,[318 427 132  64 496],236,4,35549,4.699762030671602,80.0,0.0
7564,0,7564,[318 427 132  64 496],450,5,35554,4.6998017184401855,80.0,0.0
7565,0,7565,[318 427 132  64 496],577,5,35559,4.6998413957176846,80.0,0.0
7566,0,7566,[318 427 132  64 496],716,5,35564,4.699881062508259,80.0,0.0
7567,0,7567,[318 427 132  64 496],535,5,35569,4.699920718816068,80.0,0.0
7568,0,7568,[318 427 132  64 496],556,5,35574,4.699960364645263,80.0,0.0
7569,0,7569,[318 427 132  64 496],556,5,35579,4.7,80.0,0.0
7570,0,7570,[318 427 132  64 496],269,5,35584,4.700039624884427,80.0,0.0
7571,0,7571,[318 427 132  64 496],577,5,35589,4.700079239302694,80.0,0.0
7572,0,7572,[318 427 132  64 496],18,5,35594,4.700118843258946,80.0,0.0
7573,0,7573,[318 427 132  64 496],556,5,35599,4.700158436757328,80.0,0.0
7574,0,7574,[318 427 132  64 496],330,5,35604,4.70019801980198,80.0,0.0
7575,0,7575,[318 427 132  64 496],535,5,35609,4.700237592397043,80.0,0.0
7576,0,7576,[176 132  56  82   1],577,4,35613,4.700145176191104,0.0,0.0
7577,0,7577,[197 268 496 603 216],269,4,35617,4.700052784375825,40.0,0.0
7578,0,7578,[318 427 132  64 496],535,5,35622,4.700092360469719,80.0,0.0
7579,0,7579,[318 427 132  64 496],716,5,35627,4.700131926121372,80.0,0.0
7580,0,7580,[318 427 132  64 496],577,5,35632,4.700171481334916,80.0,0.0
7581,0,7581,[318 427 132  64 496],450,5,35637,4.700211026114482,80.0,0.0
7582,0,7582,[318 427 132  64 496],236,4,35641,4.700118686535672,80.0,0.0
7583,0,7583,[318 427 132  64 496],236,4,35645,4.700026371308017,80.0,0.0
7584,0,7584,[318 427 132  64 496],577,5,35650,4.7000659195781145,80.0,0.0
7585,0,7585,[318 427 132  64 496],151,5,35655,4.700105457421566,80.0,0.0
7586,0,7586,[318 427 132  64 496],450,5,35660,4.700144984842494,80.0,0.0
7587,0,7587,[318 427 132  64 496],577,5,35665,4.700184501845018,80.0,0.0
7588,0,7588,[318 427 132  64 496],716,5,35670,4.700224008433259,80.0,0.0
7589,0,7589,[318 427 132  64 496],330,5,35675,4.700263504611331,80.0,0.0
7590,0,7590,[318 427 132  64 496],269,5,35680,4.700302990383348,80.0,0.0
7591,0,7591,[318 427 132  64 496],577,5,35685,4.700342465753424,80.0,0.0
7592,0,7592,[318 427 132  64 496],556,5,35690,4.700381930725668,80.0,0.0
7593,0,7593,[318 427 132  64 496],796,5,35695,4.700421385304187,80.0,0.0
7594,0,7594,[318 427 132  64 496],236,4,35699,4.700329163923634,80.0,0.0
7595,0,7595,[318 427 132  64 496],796,5,35704,4.700368615060558,80.0,0.0
7596,0,7596,[318 427 132  64 496],577,5,35709,4.700408055811504,80.0,0.0
7597,0,7597,[318 427 132  64 496],716,5,35714,4.700447486180574,80.0,0.0
7598,0,7598,[318 427 132  64 496],716,5,35719,4.700486906171864,80.0,0.0
7599,0,7599,[318 427 132  64 496],450,5,35724,4.700526315789474,80.0,0.0
7600,0,7600,[318 427 132  64 496],18,5,35729,4.700565715037495,80.0,0.0
7601,0,7601,[318 427 132  64 496],716,5,35734,4.700605103920021,80.0,0.0
7602,0,7602,[318 427 132  64 496],796,5,35739,4.700644482441142,80.0,0.0
7603,0,7603,[ 22  88 742 237 286],344,0,35739,4.700026301946344,0.0,20.0
7604,0,7604,[318 427 132  64 496],330,5,35744,4.700065746219592,80.0,0.0
7605,0,7605,[318 427 132  64 496],796,5,35749,4.700105180120957,80.0,0.0
7606,0,7606,[318 427 132  64 496],556,5,35754,4.700144603654529,80.0,0.0
7607,0,7607,[318 427 132  64 496],796,5,35759,4.700184016824395,80.0,0.0
7608,0,7608,[318 427 132  64 496],330,5,35764,4.700223419634643,80.0,0.0
7609,0,7609,[318 427 132  64 496],151,5,35769,4.700262812089356,80.0,0.0
7610,0,7610,[318 427 132  64 496],151,5,35774,4.7003021941926155,80.0,0.0
7611,0,7611,[318 427 132  64 496],716,5,35779,4.700341565948502,80.0,0.0
7612,0,7612,[318 427 132  64 496],450,5,35784,4.700380927361093,80.0,0.0
7613,0,7613,[318 427 132  64 496],796,5,35789,4.700420278434462,80.0,0.0
7614,0,7614,[318 427 132  64 496],577,5,35794,4.700459619172685,80.0,0.0
7615,0,7615,[127  82 179 258 144],655,2,35796,4.700105042016807,0.0,20.0
7616,0,7616,[204 403  82 238  88],450,4,35800,4.700013128528292,0.0,0.0
7617,0,7617,[483 655 435 496 403],450,4,35804,4.6999212391703855,20.0,0.0
7618,0,7618,[318 427 132  64 496],796,5,35809,4.6999606247539045,80.0,0.0
7619,0,7619,[318 427 132  64 496],18,5,35814,4.7,80.0,0.0
7620,0,7620,[328 211  12 194 258],450,5,35819,4.700039364912741,0.0,0.0
7621,0,7621,[318 427 132  64 496],716,5,35824,4.7000787194961955,80.0,0.0
7622,0,7622,[318 427 132  64 496],269,5,35829,4.700118063754427,80.0,0.0
7623,0,7623,[318 427 132  64 496],577,5,35834,4.7001573976915,80.0,0.0
7624,0,7624,[318 427 132  64 496],236,4,35838,4.700065573770492,80.0,0.0
7625,0,7625,[318 427 132  64 496],269,5,35843,4.700104904274849,80.0,0.0
7626,0,7626,[318 427 132  64 496],330,5,35848,4.700144224465714,80.0,0.0
7627,0,7627,[318 427 132  64 496],18,5,35853,4.7001835343471425,80.0,0.0
7628,0,7628,[318 427 132  64 496],18,5,35858,4.7002228339231875,80.0,0.0
7629,0,7629,[318 427 132  64 496],269,5,35863,4.700262123197903,80.0,0.0
7630,0,7630,[318 427 132  64 496],236,4,35867,4.7001703577512775,80.0,0.0
7631,0,7631,[318 427 132  64 496],716,5,35872,4.70020964360587,80.0,0.0
7632,0,7632,[182 195 357   7 546],457,4,35876,4.700117909078999,0.0,0.0
7633,0,7633,[318 427 132  64 496],716,5,35881,4.700157191511658,80.0,0.0
7634,0,7634,[318 427 132  64 496],796,5,35886,4.700196463654224,80.0,0.0
7635,0,7635,[318 427 132  64 496],151,5,35891,4.700235725510739,80.0,0.0
7636,0,7636,[318 427 132  64 496],556,5,35896,4.700274977085243,80.0,0.0
7637,0,7637,[318 427 132  64 496],716,5,35901,4.700314218381775,80.0,0.0
7638,0,7638,[318 427 132  64 496],330,5,35906,4.700353449404372,80.0,0.0
7639,0,7639,[318 427 132  64 496],151,5,35911,4.700392670157068,80.0,0.0
7640,0,7640,[318 427 132  64 496],269,5,35916,4.700431880643895,80.0,0.0
7641,0,7641,[318 427 132  64 496],151,5,35921,4.7004710808688825,80.0,0.0
7642,0,7642,[318 427 132  64 496],269,5,35926,4.700510270836059,80.0,0.0
7643,0,7643,[318 427 132  64 496],151,5,35931,4.700549450549451,80.0,0.0
7644,0,7644,[318 427 132  64 496],796,5,35936,4.700588620013081,80.0,0.0
7645,0,7645,[187  25 588 100  95],18,4,35940,4.7004969918911845,0.0,20.0
7646,0,7646,[318 427 132  64 496],716,5,35945,4.700536157970446,80.0,0.0
7647,0,7647,[318 427 132  64 496],796,5,35950,4.700575313807532,80.0,0.0
7648,0,7648,[318 427 132  64 496],151,5,35955,4.7006144594064585,80.0,0.0
7649,0,7649,[515 483 195 357  69],18,3,35958,4.700392156862745,0.0,0.0
7650,0,7650,[318 427 132  64 496],716,5,35963,4.700431316167821,80.0,0.0
7651,0,7651,[318 427 132  64 496],269,5,35968,4.700470465237847,80.0,0.0
7652,0,7652,[318 427 132  64 496],330,5,35973,4.700509604076832,80.0,0.0
7653,0,7653,[318 427 132  64 496],236,4,35977,4.700418082048602,80.0,0.0
7654,0,7654,[211  98 288 187 191],450,4,35981,4.70032658393207,0.0,0.0
7655,0,7655,[ 28  96 182 328  11],450,5,35986,4.700365726227795,0.0,0.0
7656,0,7656,[318 427 132  64 496],236,4,35990,4.700274258848113,80.0,0.0
7657,0,7657,[318 427 132  64 496],330,5,35995,4.700313397753983,80.0,0.0
7658,0,7658,[318 427 132  64 496],236,4,35999,4.700221961091526,80.0,0.0
7659,0,7659,[318 427 132  64 275],18,5,36004,4.700261096605744,60.0,20.0
7660,0,7660,[318 427 132  64 275],450,5,36009,4.700300221903146,60.0,20.0
7661,0,7661,[318 427 132  64 275],330,5,36014,4.7003393369877315,60.0,20.0
7662,0,7662,[318 427 132  64 275],450,5,36019,4.7003784418635,60.0,20.0
7663,0,7663,[318 427 132  64 275],716,5,36024,4.700417536534447,60.0,20.0
7664,0,7664,[318 427 132  64 275],716,5,36029,4.700456621004566,60.0,20.0
7665,0,7665,[318 427 132  64 275],330,5,36034,4.7004956952778505,60.0,20.0
7666,0,7666,[318 427 132  64 275],236,4,36038,4.700404330246511,60.0,20.0
7667,0,7667,[ 89 238 496 357 245],796,3,36041,4.70018257694314,20.0,0.0
7668,0,7668,[318 427 132  64 496],796,5,36046,4.700221671665146,80.0,0.0
7669,0,7669,[318 427 132  64 496],556,5,36051,4.70026075619296,80.0,0.0
7670,0,7670,[318 427 132  64 496],796,5,36056,4.70029983053057,80.0,0.0
7671,0,7671,[318 427 132  64 496],796,5,36061,4.70033889468196,80.0,0.0
7672,0,7672,[318 427 132  64 496],535,5,36066,4.700377948651115,80.0,0.0
7673,0,7673,[318 427 132  64 496],236,4,36070,4.700286682303883,80.0,0.0
7674,0,7674,[435 603  79  70 100],151,4,36074,4.700195439739414,20.0,20.0
7675,0,7675,[318 427 132  64 496],151,5,36079,4.700234497133924,80.0,0.0
7676,0,7676,[423 144 151 234 546],807,4,36083,4.700143285137424,0.0,0.0
7677,0,7677,[318 427 132  64 496],796,5,36088,4.70018233915082,80.0,0.0
7678,0,7678,[318 427 132  64 496],151,5,36093,4.700221382992577,80.0,0.0
7679,0,7679,[318 427 132  64 496],269,5,36098,4.700260416666667,80.0,0.0
7680,0,7680,[318 427 132  64 496],18,5,36103,4.70029944017706,80.0,0.0
7681,0,7681,[318 427 132  64 496],577,5,36108,4.700338453527727,80.0,0.0
7682,0,7682,[318 427 132  64 496],236,4,36112,4.700247299232071,80.0,0.0
7683,0,7683,[318 427 132  64  98],450,5,36117,4.700286309213951,60.0,0.0
7684,0,7684,[318 427 132  64  98],450,5,36122,4.700325309043591,60.0,0.0
7685,0,7685,[318 427 132  64  98],450,5,36127,4.7003642987249545,60.0,0.0
7686,0,7686,[318 427 132  64  98],796,5,36132,4.700403278262001,60.0,0.0
7687,0,7687,[318 427 132  64  98],18,5,36137,4.700442247658689,60.0,0.0
7688,0,7688,[318 427 132  64  98],535,4,36141,4.700351150994928,60.0,0.0
7689,0,7689,[318 427 132  64 496],151,5,36146,4.70039011703511,80.0,0.0
7690,0,7690,[318 427 132  64 496],535,5,36151,4.7004290729424,80.0,0.0
7691,0,7691,[318 427 132  64 496],450,5,36156,4.700468018720749,80.0,0.0
7692,0,7692,[318 427 132  64 496],450,5,36161,4.700506954374107,80.0,0.0
7693,0,7693,[318 427 132  64 496],151,5,36166,4.700545879906421,80.0,0.0
7694,0,7694,[318 427 132  64 496],151,5,36171,4.700584795321637,80.0,0.0
7695,0,7695,[318 427 132  64 496],577,5,36176,4.700623700623701,80.0,0.0
7696,0,7696,[318 427 132  64 496],18,5,36181,4.700662595816552,80.0,0.0
7697,0,7697,[318 427 132  64 496],450,5,36186,4.700701480904131,80.0,0.0
7698,0,7698,[161  64 125  56 288],457,5,36191,4.7007403558903755,20.0,0.0
7699,0,7699,[318 427 132  64 496],716,5,36196,4.7007792207792205,80.0,0.0
7700,0,7700,[318 427 132  64 496],450,5,36201,4.700818075574601,80.0,0.0
7701,0,7701,[318 427 132  64 496],450,5,36206,4.700856920280446,80.0,0.0
7702,0,7702,[318 427 132  64 496],18,5,36211,4.700895754900688,80.0,0.0
7703,0,7703,[234 143  97  56 269],450,4,36215,4.700804776739356,0.0,0.0
7704,0,7704,[318 427 132  64 496],151,5,36220,4.700843608046723,80.0,0.0
7705,0,7705,[318 427 132  64 496],716,5,36225,4.700882429275889,80.0,0.0
7706,0,7706,[318 427 132  64 496],151,5,36230,4.700921240430778,80.0,0.0
7707,0,7707,[318 427 132  64 496],535,5,36235,4.700960041515309,80.0,0.0
7708,0,7708,[318 427 132  64 496],236,4,36239,4.700869114022571,80.0,0.0
7709,0,7709,[318 427 132  64 496],269,5,36244,4.700907911802854,80.0,0.0
7710,0,7710,[318 427 132  64 496],18,5,36249,4.700946699520166,80.0,0.0
7711,0,7711,[318 427 132  64 496],716,5,36254,4.700985477178423,80.0,0.0
7712,0,7712,[215 153 100 210 496],796,3,36257,4.700764942305199,20.0,20.0
7713,0,7713,[318 427 132  64 496],18,5,36262,4.70080373347161,80.0,0.0
7714,0,7714,[174 181  28 125 132],450,5,36267,4.700842514581983,0.0,0.0
7715,0,7715,[318 427 132  64 496],236,4,36271,4.700751684810783,80.0,0.0
7716,0,7716,[318 427 132  64 496],269,5,36276,4.700790462615005,80.0,0.0
7717,0,7717,[318 427 132  64 496],577,5,36281,4.700829230370562,80.0,0.0
7718,0,7718,[318 427 132  64 496],269,5,36286,4.700867988081358,80.0,0.0
7719,0,7719,[318 427 132  64 496],18,5,36291,4.700906735751295,80.0,0.0
7720,0,7720,[318 427 132  64 496],236,4,36295,4.700815956482321,80.0,0.0
7721,0,7721,[318 427 132  64 496],716,5,36300,4.700854700854701,80.0,0.0
7722,0,7722,[318 427 132  64 496],556,5,36305,4.700893435193578,80.0,0.0
7723,0,7723,[318 427 132  64 496],535,5,36310,4.700932159502848,80.0,0.0
7724,0,7724,[318 427 132  64 496],450,5,36315,4.7009708737864075,80.0,0.0
7725,0,7725,[318 427 132  64 496],269,5,36320,4.701009578048149,80.0,0.0
7726,0,7726,[318 427 132  64 496],330,5,36325,4.701048272291963,80.0,0.0
7727,0,7727,[318 427 132  64 496],330,5,36330,4.701086956521739,80.0,0.0
7728,0,7728,[655 186  15  70 197],457,5,36335,4.701125630741363,0.0,0.0
7729,0,7729,[318 427 132  64 496],716,5,36340,4.701164294954721,80.0,0.0
7730,0,7730,[318 427 132  64 496],450,5,36345,4.701202949165697,80.0,0.0
7731,0,7731,[318 427 132  64 496],151,5,36350,4.701241593378168,80.0,0.0
7732,0,7732,[318 427 132  64 496],236,4,36354,4.701150911677227,80.0,0.0
7733,0,7733,[318 427 132  64 496],151,5,36359,4.701189552624774,80.0,0.0
7734,0,7734,[318 427 132  64 496],18,5,36364,4.701228183581125,80.0,0.0
7735,0,7735,[234 135 215 151   7],151,4,36368,4.701137538779731,0.0,0.0
7736,0,7736,[318 427 132  64 496],269,5,36373,4.701176166472793,80.0,0.0
7737,0,7737,[318 427 132  64 496],535,5,36378,4.70121478418196,80.0,0.0
7738,0,7738,[318 427 132  64 496],716,5,36383,4.7012533919110995,80.0,0.0
7739,0,7739,[318 427 132  64 496],577,5,36388,4.701291989664083,80.0,0.0
7740,0,7740,[318 427 132  64 496],330,5,36393,4.701330577444774,80.0,0.0
7741,0,7741,[318 427 132  64 496],577,5,36398,4.70136915525704,80.0,0.0
7742,0,7742,[318 427 132  64 496],556,5,36403,4.70140772310474,80.0,0.0
7743,0,7743,[318 427 132  64 496],236,4,36407,4.701317148760331,80.0,0.0
7744,0,7744,[318 427 132  64 496],236,4,36411,4.701226597805036,80.0,0.0
7745,0,7745,[318 427 132  64 496],18,5,36416,4.701265169119545,80.0,0.0
7746,0,7746,[318 427 132  64 496],18,5,36421,4.7013037304763134,80.0,0.0
7747,0,7747,[318 427 132  64 496],330,5,36426,4.701342281879195,80.0,0.0
7748,0,7748,[318 427 132  64 496],269,5,36431,4.701380823332043,80.0,0.0
7749,0,7749,[318 427 132  64 496],577,5,36436,4.70141935483871,80.0,0.0
7750,0,7750,[318 427 132  64 496],236,4,36440,4.701328860792156,80.0,0.0
7751,0,7751,[318 427 132  64  98],716,5,36445,4.701367389060888,60.0,0.0
7752,0,7752,[ 98 118 257 597  50],796,5,36450,4.701405907390687,0.0,20.0
7753,0,7753,[318 427 132  64  98],450,5,36455,4.701444415785401,60.0,0.0
7754,0,7754,[318 427 132  64  98],796,5,36460,4.701482914248872,60.0,0.0
7755,0,7755,[318 427 132  64  98],330,5,36465,4.701521402784941,60.0,0.0
7756,0,7756,[318 427 132  64  98],716,5,36470,4.701559881397447,60.0,0.0
7757,0,7757,[ 25 471 245 100 127],344,3,36473,4.701340551688579,0.0,40.0
7758,0,7758,[318 427 132  64  98],796,5,36478,4.7013790436911975,60.0,0.0
7759,0,7759,[228 357 197 191 121],72,3,36481,4.701159793814433,0.0,0.0
7760,0,7760,[318 427 132  64  98],655,4,36485,4.701069449813168,60.0,0.0
7761,0,7761,[318 427 132  64  98],655,4,36489,4.700979129090441,60.0,0.0
7762,0,7762,[318 427 132  64  98],655,4,36493,4.700888831637253,60.0,0.0
7763,0,7763,[318 427 132  64  98],236,5,36498,4.700927357032458,60.0,0.0
7764,0,7764,[318 427 132  64  98],450,5,36503,4.700965872504829,60.0,0.0
7765,0,7765,[318 427 132  64  98],316,5,36508,4.701004378058203,60.0,0.0
7766,0,7766,[318 427 132  64  98],535,4,36512,4.700914123857345,60.0,0.0
7767,0,7767,[318 427 132  64  98],796,5,36517,4.7009526261586,60.0,0.0
7768,0,7768,[318 427 132  64  98],450,5,36522,4.7009911185480755,60.0,0.0
7769,0,7769,[318 427 132  64  98],236,5,36527,4.701029601029601,60.0,0.0
7770,0,7770,[318 427 132  64  98],655,4,36531,4.700939390039892,60.0,0.0
7771,0,7771,[318 427  64 132  98],151,5,36536,4.700977869274318,60.0,0.0
7772,0,7772,[318 427  64 132  98],236,5,36541,4.701016338608002,60.0,0.0
7773,0,7773,[496 238 135  15  50],18,4,36545,4.700926164136867,20.0,20.0
7774,0,7774,[318 427  64 132  98],716,5,36550,4.70096463022508,60.0,0.0
7775,0,7775,[318 427  64 132  98],236,5,36555,4.701003086419753,60.0,0.0
7776,0,7776,[318 427  64 132  98],577,5,36560,4.701041532724701,60.0,0.0
7777,0,7777,[318 427  64 132  98],269,5,36565,4.701079969143739,60.0,0.0
7778,0,7778,[318 427  64 132  98],535,4,36569,4.700989844453015,60.0,0.0
7779,0,7779,[318 427  64 132  98],269,5,36574,4.701028277634961,60.0,0.0
7780,0,7780,[318 427  64 132  98],796,5,36579,4.701066700938183,60.0,0.0
7781,0,7781,[318 427  64 132  98],18,5,36584,4.701105114366487,60.0,0.0
7782,0,7782,[318 427  64 132  98],796,5,36589,4.70114351792368,60.0,0.0
7783,0,7783,[318 427  64 132  98],236,5,36594,4.701181911613566,60.0,0.0
7784,0,7784,[318 427  64 132  98],796,5,36599,4.701220295439948,60.0,0.0
7785,0,7785,[318 427  64 132  98],236,5,36604,4.701258669406627,60.0,0.0
7786,0,7786,[318 427  64 132  98],796,5,36609,4.701297033517401,60.0,0.0
7787,0,7787,[318 427  64 132  98],316,5,36614,4.701335387776066,60.0,0.0
7788,0,7788,[318 427  64 132  98],18,5,36619,4.701373732186417,60.0,0.0
7789,0,7789,[318 427  64 132  98],450,5,36624,4.701412066752247,60.0,0.0
7790,0,7790,[318 427  64 132  98],330,5,36629,4.701450391477346,60.0,0.0
7791,0,7791,[318 427  64 132  98],316,5,36634,4.701488706365503,60.0,0.0
7792,0,7792,[318 427  64 132  98],151,5,36639,4.701527011420506,60.0,0.0
7793,0,7793,[318 427  64 132  98],151,5,36644,4.701565306646138,60.0,0.0
7794,0,7794,[318 427  64 132  98],577,5,36649,4.701603592046183,60.0,0.0
7795,0,7795,[318 427  64 132  98],655,4,36653,4.701513596716265,60.0,0.0
7796,0,7796,[318 427  64 132  98],450,5,36658,4.701551878927793,60.0,0.0
7797,0,7797,[318 427  64 132  98],269,5,36663,4.701590151320851,60.0,0.0
7798,0,7798,[318 427  64 132  98],796,5,36668,4.7016284138992175,60.0,0.0
7799,0,7799,[318 427  64 132  98],236,5,36673,4.701666666666667,60.0,0.0
7800,0,7800,[318 427  64 132  98],450,5,36678,4.7017049096269705,60.0,0.0
7801,0,7801,[318 427  64 132  98],236,5,36683,4.701743142783902,60.0,0.0
7802,0,7802,[318 427  64 132  98],796,5,36688,4.701781366141228,60.0,0.0
7803,0,7803,[318 427  64 132  98],18,5,36693,4.7018195797027165,60.0,0.0
7804,0,7804,[318 427  64 132  98],655,4,36697,4.701729660474055,60.0,0.0
7805,0,7805,[318 427  64 132  98],796,5,36702,4.701767870868562,60.0,0.0
7806,0,7806,[318 427  64 132  98],535,4,36706,4.701677981298834,60.0,0.0
7807,0,7807,[318 427  64 132  98],330,5,36711,4.70171618852459,60.0,0.0
7808,0,7808,[318 427  64 132  98],236,5,36716,4.701754385964913,60.0,0.0
7809,0,7809,[318 427  64 132  98],151,5,36721,4.7017925736235595,60.0,0.0
7810,0,7810,[286 237 179 216 588],878,3,36724,4.70157470234285,0.0,20.0
7811,0,7811,[318 427  64 132  98],716,5,36729,4.701612903225806,60.0,0.0
7812,0,7812,[318 427  64 132  98],693,4,36733,4.701523102521438,60.0,0.0
7813,0,7813,[318 427  64 132  98],450,5,36738,4.701561300230356,60.0,0.0
7814,0,7814,[318 427  64 132  98],796,5,36743,4.7015994881637875,60.0,0.0
7815,0,7815,[318 427  64 132  98],796,5,36748,4.701637666325486,60.0,0.0
7816,0,7816,[318 427  64 132  98],693,4,36752,4.701547908404759,60.0,0.0
7817,0,7817,[318 427  64 132  98],269,5,36757,4.701586083397288,60.0,0.0
7818,0,7818,[318 427  64 132  98],151,5,36762,4.701624248625144,60.0,0.0
7819,0,7819,[318 427  64 132  98],151,5,36767,4.701662404092072,60.0,0.0
7820,0,7820,[318 427  64 132  98],269,5,36772,4.701700549801815,60.0,0.0
7821,0,7821,[318 427  64 132  98],151,5,36777,4.7017386857581185,60.0,0.0
7822,0,7822,[318 427  64 132  98],18,5,36782,4.701776811964719,60.0,0.0
7823,0,7823,[318 427  64 132  98],655,4,36786,4.701687116564417,60.0,0.0
7824,0,7824,[318 427  64 132  98],269,5,36791,4.701725239616613,60.0,0.0
7825,0,7825,[318 427  64 132  98],716,5,36796,4.701763352926144,60.0,0.0
7826,0,7826,[318 427  64 132  98],236,5,36801,4.701801456496742,60.0,0.0
7827,0,7827,[318 427  64 132  98],577,5,36806,4.701839550332141,60.0,0.0
7828,0,7828,[357  82 273 127 197],655,3,36809,4.701622173968579,0.0,20.0
7829,0,7829,[318 427  64 132  98],577,5,36814,4.701660280970626,60.0,0.0
7830,0,7830,[318 427  64 132  98],330,5,36819,4.7016983782403265,60.0,0.0
7831,0,7831,[318 427  64 132  98],716,5,36824,4.701736465781409,60.0,0.0
7832,0,7832,[318 427  64 132  98],330,5,36829,4.7017745435976,60.0,0.0
7833,0,7833,[173 300 196 515 174],535,3,36832,4.701557314271126,0.0,0.0
7834,0,7834,[318 427  64 132  98],577,5,36837,4.701595405232929,60.0,0.0
7835,0,7835,[318 427  64 132  98],236,5,36842,4.70163348647269,60.0,0.0
7836,0,7836,[318 427  64 132  98],655,4,36846,4.7015439581472505,60.0,0.0
7837,0,7837,[318 427  64 132  98],18,5,36851,4.7015820362337335,60.0,0.0
7838,0,7838,[318 427  64 132  98],236,5,36856,4.701620104605179,60.0,0.0
7839,0,7839,[318 427  64 132  98],716,5,36861,4.701658163265306,60.0,0.0
7840,0,7840,[318 427  64 132  98],796,5,36866,4.701696212217829,60.0,0.0
7841,0,7841,[318 427  64 132  98],450,5,36871,4.701734251466463,60.0,0.0
7842,0,7842,[318 427  64 132  98],316,5,36876,4.701772281014918,60.0,0.0
7843,0,7843,[318 427  64 132  98],655,4,36880,4.701682814890362,60.0,0.0
7844,0,7844,[318 427  64 132  98],269,5,36885,4.701720841300191,60.0,0.0
7845,0,7845,[318 427  64 132  98],316,5,36890,4.701758858016824,60.0,0.0
7846,0,7846,[318 427  64 132  98],655,4,36894,4.701669427806805,60.0,0.0
7847,0,7847,[318 427  64 132  98],796,5,36899,4.701707441386341,60.0,0.0
7848,0,7848,[318 427  64 132  98],535,4,36903,4.701618040514715,60.0,0.0
7849,0,7849,[ 95 173 300 294  82],716,5,36908,4.701656050955414,0.0,0.0
7850,0,7850,[318 427  64 132  98],269,5,36913,4.701694051713157,60.0,0.0
7851,0,7851,[748 172 179 483 427],450,4,36917,4.701604686704025,20.0,0.0
7852,0,7852,[318 427  64 132  98],655,4,36921,4.701515344454348,60.0,0.0
7853,0,7853,[508   1 496 195  50],344,4,36925,4.7014260249554365,20.0,20.0
7854,0,7854,[318 427  64 132  98],450,5,36930,4.701464035646086,60.0,0.0
7855,0,7855,[318 427  64 132  98],269,5,36935,4.701502036659877,60.0,0.0
7856,0,7856,[318 427  64 132  98],535,4,36939,4.701412752959144,60.0,0.0
7857,0,7857,[318 427  64 132  98],151,5,36944,4.701450750827182,60.0,0.0
7858,0,7858,[318 427  64 132  98],577,5,36949,4.701488739025321,60.0,0.0
7859,0,7859,[318 427  64 132  98],151,5,36954,4.701526717557252,60.0,0.0
7860,0,7860,[318 427  64 132  98],796,5,36959,4.701564686426663,60.0,0.0
7861,0,7861,[318 427  64 132  98],577,5,36964,4.701602645637243,60.0,0.0
7862,0,7862,[318 427  64 132  98],450,5,36969,4.701640595192675,60.0,0.0
7863,0,7863,[318 427  64 132  98],330,5,36974,4.701678535096643,60.0,0.0
7864,0,7864,[318 427  64 132  98],450,5,36979,4.701716465352829,60.0,0.0
7865,0,7865,[318 427  64 132  98],716,5,36984,4.701754385964913,60.0,0.0
7866,0,7866,[318 427  64 132  98],18,5,36989,4.701792296936571,60.0,0.0
7867,0,7867,[318 427  64 132  98],269,5,36994,4.701830198271479,60.0,0.0
7868,0,7868,[318 427  64 132  98],450,5,36999,4.701868089973313,60.0,0.0
7869,0,7869,[483  69  89 143 168],151,5,37004,4.7019059720457435,0.0,0.0
7870,0,7870,[357  56  70  12 471],457,5,37009,4.70194384449244,0.0,0.0
7871,0,7871,[318 427  64 132  98],450,5,37014,4.701981707317073,60.0,0.0
7872,0,7872,[475   4 234  11   7],629,2,37016,4.701638511367967,0.0,0.0
7873,0,7873,[318 427  64 132  98],151,5,37021,4.701676403352807,60.0,0.0
7874,0,7874,[318 427  64 132  98],269,5,37026,4.701714285714286,60.0,0.0
7875,0,7875,[318 427  64 132  98],236,5,37031,4.701752158456069,60.0,0.0
7876,0,7876,[318 427  64 132  98],18,5,37036,4.701790021581821,60.0,0.0
7877,0,7877,[318 427  64 132  98],18,5,37041,4.701827875095201,60.0,0.0
7878,0,7878,[318 427  64 132  98],796,5,37046,4.701865718999873,60.0,0.0
7879,0,7879,[318 427  64 132  98],330,5,37051,4.701903553299492,60.0,0.0
7880,0,7880,[318 427  64 132  98],796,5,37056,4.701941377997716,60.0,0.0
7881,0,7881,[318 427  64 132  98],535,4,37060,4.70185232174575,60.0,0.0
7882,0,7882,[318 427  64 132  98],716,5,37065,4.701890143346442,60.0,0.0
7883,0,7883,[318 427  64 132  98],450,5,37070,4.7019279553526125,60.0,0.0
7884,0,7884,[318 427  64 132  98],151,5,37075,4.701965757767914,60.0,0.0
7885,0,7885,[318 427  64 132  98],577,5,37080,4.702003550595993,60.0,0.0
7886,0,7886,[568 405 202  15 655],450,4,37084,4.701914542918727,0.0,0.0
7887,0,7887,[318 427  64 132  98],796,5,37089,4.701952332657201,60.0,0.0
7888,0,7888,[318 427  64 132  98],316,5,37094,4.701990112815312,60.0,0.0
7889,0,7889,[318 427  64 132  98],796,5,37099,4.702027883396704,60.0,0.0
7890,0,7890,[318 427  64 132  98],577,5,37104,4.702065644405018,60.0,0.0
7891,0,7891,[318 427  64 132  98],796,5,37109,4.702103395843893,60.0,0.0
7892,0,7892,[318 427  64 132  98],796,5,37114,4.702141137716964,60.0,0.0
7893,0,7893,[318 427  64 132  98],236,5,37119,4.702178870027869,60.0,0.0
7894,0,7894,[318 427  64 132  98],535,4,37123,4.702089930335656,60.0,0.0
7895,0,7895,[318 427  64 132  98],577,5,37128,4.702127659574468,60.0,0.0
7896,0,7896,[ 22 111 117 187 294],716,4,37132,4.702038748891984,0.0,0.0
7897,0,7897,[318 427  64 132  98],236,5,37137,4.702076475056977,60.0,0.0
7898,0,7898,[318 427  64 132  98],316,5,37142,4.702114191669832,60.0,0.0
7899,0,7899,[318 427  64 132  98],330,5,37147,4.7021518987341775,60.0,0.0
7900,0,7900,[318 427  64 132  98],236,5,37152,4.702189596253639,60.0,0.0
7901,0,7901,[318 427  64 132  98],151,5,37157,4.70222728423184,60.0,0.0
7902,0,7902,[318 427  64 132  98],316,5,37162,4.702264962672403,60.0,0.0
7903,0,7903,[318 427  64 132  98],18,5,37167,4.702302631578948,60.0,0.0
7904,0,7904,[202 496 182 286 301],389,4,37171,4.702213788741303,20.0,20.0
7905,0,7905,[318 427  64 132  98],655,4,37175,4.702124968378447,60.0,0.0
7906,0,7906,[318 427  64 132  98],716,5,37180,4.702162640698115,60.0,0.0
7907,0,7907,[318 427  64 132  98],18,5,37185,4.7022003034901365,60.0,0.0
7908,0,7908,[318 427  64 132  98],796,5,37190,4.702237956758124,60.0,0.0
7909,0,7909,[318 427  64 132  98],655,4,37194,4.702149178255373,60.0,0.0
7910,0,7910,[318 427  64 132  98],18,5,37199,4.702186828466692,60.0,0.0
7911,0,7911,[ 28  56 258 475 313],655,1,37200,4.701718907987867,0.0,0.0
7912,0,7912,[318 427  64 132  98],18,5,37205,4.701756603058259,60.0,0.0
7913,0,7913,[318 427  64 132  98],693,4,37209,4.701667930250189,60.0,0.0
7914,0,7914,[318 427  64 132  98],236,5,37214,4.70170562223626,60.0,0.0
7915,0,7915,[318 427  64 132  98],269,5,37219,4.7017433046993435,60.0,0.0
7916,0,7916,[200 300  96 269  89],655,2,37221,4.701402046229632,0.0,0.0
7917,0,7917,[318 427  64 132  98],655,4,37225,4.701313462995706,60.0,0.0
7918,0,7918,[318 427  64 132  98],693,4,37229,4.701224902134108,60.0,0.0
7919,0,7919,[318 427  64 132  98],716,5,37234,4.7012626262626265,60.0,0.0
7920,0,7920,[318 427  64 132  98],577,5,37239,4.7013003408660525,60.0,0.0
7921,0,7921,[275 181 427 286 151],330,5,37244,4.701338045947993,20.0,40.0
7922,0,7922,[197 435  97 194  95],450,4,37248,4.701249526694434,0.0,0.0
7923,0,7923,[588 200 197 597 288],457,4,37252,4.701161029782938,0.0,0.0
7924,0,7924,[318 427  64 132  98],716,5,37257,4.701198738170347,60.0,0.0
7925,0,7925,[318 427  64 132  98],796,5,37262,4.7012364370426445,60.0,0.0
7926,0,7926,[318 427  64 132  98],330,5,37267,4.7012741264034315,60.0,0.0
7927,0,7927,[318 427  64 132  98],655,4,37271,4.7011856710393545,60.0,0.0
7928,0,7928,[318 427  64 132  98],693,4,37275,4.701097237987136,60.0,0.0
7929,0,7929,[318 427  64 132  98],236,5,37280,4.701134930643128,60.0,0.0
7930,0,7930,[318 427  64 132  98],693,4,37284,4.701046526289245,60.0,0.0
7931,0,7931,[318 427  64 132  98],716,5,37289,4.7010842158345945,60.0,0.0
7932,0,7932,[318 427  64 132  98],693,4,37293,4.700995840161351,60.0,0.0
7933,0,7933,[318 427  64 132  98],18,5,37298,4.701033526594403,60.0,0.0
7934,0,7934,[318 427  64 132  98],151,5,37303,4.70107120352867,60.0,0.0
7935,0,7935,[318 427  64 132  98],18,5,37308,4.701108870967742,60.0,0.0
7936,0,7936,[318 427  64 132  98],716,5,37313,4.701146528915207,60.0,0.0
7937,0,7937,[318 427  64 132  98],655,4,37317,4.701058201058201,60.0,0.0
7938,0,7938,[318 427  64 132  98],450,5,37322,4.701095855901247,60.0,0.0
7939,0,7939,[318 427  64 132  98],450,5,37327,4.701133501259446,60.0,0.0
7940,0,7940,[ 88 237  98  64   1],796,4,37331,4.701045208412038,20.0,0.0
7941,0,7941,[318 427  64 132  98],577,5,37336,4.701082850667338,60.0,0.0
7942,0,7942,[318 427  64 132  98],796,5,37341,4.701120483444543,60.0,0.0
7943,0,7943,[ 96  22   7 235 405],457,4,37345,4.701032225579054,0.0,0.0
7944,0,7944,[318 427  64 132  98],236,5,37350,4.701069855254877,60.0,0.0
7945,0,7945,[318 427  64 132  98],716,5,37355,4.7011074754593505,60.0,0.0
7946,0,7946,[318 427  64 132  98],330,5,37360,4.701145086196049,60.0,0.0
7947,0,7947,[ 15 357 265 118 318],450,3,37363,4.70093105183694,20.0,0.0
7948,0,7948,[318 427  64 132  98],18,5,37368,4.70096867530507,60.0,0.0
7949,0,7949,[318 427  64 132  98],18,5,37373,4.701006289308176,60.0,0.0
7950,0,7950,[318 427  64 132  98],716,5,37378,4.70104389384983,60.0,0.0
7951,0,7951,[318 427  64 132  98],450,5,37383,4.7010814889336014,60.0,0.0
7952,0,7952,[318 427  64 132  98],316,5,37388,4.701119074563058,60.0,0.0
7953,0,7953,[318 427  64 132  98],655,4,37392,4.701030927835052,60.0,0.0
7954,0,7954,[318 427  64 132  98],151,5,37397,4.701068510370836,60.0,0.0
7955,0,7955,[204 286 111 323 172],280,2,37399,4.700729009552539,0.0,20.0
7956,0,7956,[318 427  64 132  98],316,5,37404,4.7007666205856475,60.0,0.0
7957,0,7957,[125 265 286 202 275],151,5,37409,4.700804222166373,0.0,40.0
7958,0,7958,[318 427  64 132  98],796,5,37414,4.700841814298279,60.0,0.0
7959,0,7959,[318 427  64 132  98],151,5,37419,4.7008793969849245,60.0,0.0
7960,0,7960,[318 427  64 132  98],236,5,37424,4.700916970229871,60.0,0.0
7961,0,7961,[318 427  64 132  98],693,4,37428,4.7008289374529015,60.0,0.0
7962,0,7962,[318 427  64 132  98],577,5,37433,4.700866507597639,60.0,0.0
7963,0,7963,[318 427  64 132  98],693,4,37437,4.700778503264691,60.0,0.0
7964,0,7964,[318 427  64 132  98],236,5,37442,4.700816070307596,60.0,0.0
7965,0,7965,[318 427  64 132  98],796,5,37447,4.700853627918654,60.0,0.0
7966,0,7966,[318 427  64 132  98],796,5,37452,4.700891176101418,60.0,0.0
7967,0,7967,[318 427  64 132  98],316,5,37457,4.700928714859438,60.0,0.0
7968,0,7968,[318 427  64 132  98],236,5,37462,4.700966244196261,60.0,0.0
7969,0,7969,[318 427  64 132  98],796,5,37467,4.701003764115433,60.0,0.0
7970,0,7970,[318 427  64 132  98],693,4,37471,4.700915819846945,60.0,0.0
7971,0,7971,[318 427  64 132  98],655,4,37475,4.700827897641746,60.0,0.0
7972,0,7972,[318 427  64 132  98],796,5,37480,4.700865420795184,60.0,0.0
7973,0,7973,[318 427  64 132  98],716,5,37485,4.700902934537246,60.0,0.0
7974,0,7974,[318 427  64 132  98],316,5,37490,4.7009404388714735,60.0,0.0
7975,0,7975,[318 427  64 132  98],330,5,37495,4.700977933801404,60.0,0.0
7976,0,7976,[318 427  64 132  98],450,5,37500,4.7010154193305755,60.0,0.0
7977,0,7977,[318 427  64 132  98],151,5,37505,4.701052895462522,60.0,0.0
7978,0,7978,[318 427  64 132  98],535,4,37509,4.700965033212182,60.0,0.0
7979,0,7979,[202 265 121 546 204],151,4,37513,4.700877192982456,0.0,0.0
7980,0,7980,[318 427  64 132  98],330,5,37518,4.700914672346824,60.0,0.0
7981,0,7981,[318 427  64 132  98],716,5,37523,4.7009521423202205,60.0,0.0
7982,0,7982,[318 427  64 132  98],316,5,37528,4.7009896029061755,60.0,0.0
7983,0,7983,[286 196  88 202 135],389,1,37529,4.700526052104208,0.0,20.0
7984,0,7984,[318 427  64 132  98],236,5,37534,4.700563556668754,60.0,0.0
7985,0,7985,[318 427  64 132  98],330,5,37539,4.700601051840721,60.0,0.0
7986,0,7986,[318 427  64 132  98],450,5,37544,4.700638537623639,60.0,0.0
7987,0,7987,[318 427  64 132  98],796,5,37549,4.700676014021032,60.0,0.0
7988,0,7988,[318 427  64 132  98],151,5,37554,4.700713481036425,60.0,0.0
7989,0,7989,[318 427  64 132  98],577,5,37559,4.700750938673342,60.0,0.0
7990,0,7990,[318 427  64 132  98],151,5,37564,4.700788386935303,60.0,0.0
7991,0,7991,[318 427  64 132  98],655,4,37568,4.7007007007007005,60.0,0.0
7992,0,7992,[318 427  64 132  98],535,4,37572,4.700613036406856,60.0,0.0
7993,0,7993,[318 427  64 132  98],577,5,37577,4.700650487865899,60.0,0.0
7994,0,7994,[318 427  64 132  98],655,4,37581,4.700562851782364,60.0,0.0
7995,0,7995,[318 427  64 132  98],535,4,37585,4.700475237618809,60.0,0.0
7996,0,7996,[318 427  64 132  98],269,5,37590,4.700512692259597,60.0,0.0
7997,0,7997,[111 182 153  96 275],450,5,37595,4.700550137534384,0.0,20.0
7998,0,7998,[318 427  64 132  98],236,5,37600,4.700587573446681,60.0,0.0
7999,0,7999,[318 427  64 132  98],577,5,37605,4.700625,60.0,0.0
8000,0,8000,[318 427  64 132  98],151,5,37610,4.70066241719785,60.0,0.0
8001,0,8001,[318 427  64 132  98],450,5,37615,4.700699825043739,60.0,0.0
8002,0,8002,[318 427  64 132  98],450,5,37620,4.700737223541172,60.0,0.0
8003,0,8003,[318 427  64 132  98],236,5,37625,4.700774612693653,60.0,0.0
8004,0,8004,[318 427  64 132  98],450,5,37630,4.7008119925046845,60.0,0.0
8005,0,8005,[318 427  64 132  98],796,5,37635,4.700849362977767,60.0,0.0
8006,0,8006,[318 427  64 132  98],316,5,37640,4.7008867241163985,60.0,0.0
8007,0,8007,[318 427  64 132  98],535,4,37644,4.700799200799201,60.0,0.0
8008,0,8008,[210  12 568 275 245],450,4,37648,4.700711699338244,0.0,20.0
8009,0,8009,[318 427  64 132  98],655,4,37652,4.700624219725343,60.0,0.0
8010,0,8010,[318 427  64 132  98],269,5,37657,4.700661590313319,60.0,0.0
8011,0,8011,[318 427  64 132  98],269,5,37662,4.700698951572641,60.0,0.0
8012,0,8012,[318 427  64 132  98],693,4,37666,4.700611506302259,60.0,0.0
8013,0,8013,[318 427  64 132  98],316,5,37671,4.700648864487148,60.0,0.0
8014,0,8014,[318 427  64 132  98],316,5,37676,4.700686213349969,60.0,0.0
8015,0,8015,[ 96 172 318 294 118],577,4,37680,4.700598802395209,20.0,0.0
8016,0,8016,[318 427  64 132  98],18,5,37685,4.700636148185106,60.0,0.0
8017,0,8017,[318 427  64 132  98],316,5,37690,4.700673484659516,60.0,0.0
8018,0,8018,[318 427  64 132  98],796,5,37695,4.7007108118219225,60.0,0.0
8019,0,8019,[318 427  64 132  98],535,4,37699,4.700623441396509,60.0,0.0
8020,0,8020,[318 427  64 132  98],716,5,37704,4.700660765490587,60.0,0.0
8021,0,8021,[318 427  64 132  98],535,4,37708,4.700573423086512,60.0,0.0
8022,0,8022,[318 427  64 132  98],716,5,37713,4.700610744110682,60.0,0.0
8023,0,8023,[318 427  64 132  98],316,5,37718,4.700648055832502,60.0,0.0
8024,0,8024,[318 427  64 132  98],18,5,37723,4.700685358255452,60.0,0.0
8025,0,8025,[318 427  64 132  98],151,5,37728,4.700722651383005,60.0,0.0
8026,0,8026,[318 427  64 132  98],716,5,37733,4.700759935218637,60.0,0.0
8027,0,8027,[318 427  64 132  98],655,4,37737,4.70067264573991,60.0,0.0
8028,0,8028,[318 427  64 132  98],716,5,37742,4.700709926516378,60.0,0.0
8029,0,8029,[318 427  64 132  98],269,5,37747,4.7007471980074715,60.0,0.0
8030,0,8030,[318 427  64 132  98],330,5,37752,4.700784460216661,60.0,0.0
8031,0,8031,[318 427  64 132  98],18,5,37757,4.70082171314741,60.0,0.0
8032,0,8032,[318 427  64 132  98],577,5,37762,4.700858956803187,60.0,0.0
8033,0,8033,[318 427  64 132  98],577,5,37767,4.700896191187454,60.0,0.0
8034,0,8034,[318 427  64 132  98],18,5,37772,4.700933416303672,60.0,0.0
8035,0,8035,[318 427  64 132  98],18,5,37777,4.700970632155301,60.0,0.0
8036,0,8036,[318 427  64 132  98],151,5,37782,4.7010078387458005,60.0,0.0
8037,0,8037,[ 11 183 508   7 132],269,2,37784,4.700671808907688,0.0,0.0
8038,0,8038,[318 427  64 132  98],655,4,37788,4.700584649832068,60.0,0.0
8039,0,8039,[318 427  64 132  98],316,5,37793,4.700621890547263,60.0,0.0
8040,0,8040,[318 427  64 132  98],269,5,37798,4.7006591219997516,60.0,0.0
8041,0,8041,[318 427  64 132  98],330,5,37803,4.700696344192987,60.0,0.0
8042,0,8042,[318 427  64 132  98],18,5,37808,4.700733557130424,60.0,0.0
8043,0,8043,[318 427  64 132  98],450,5,37813,4.700770760815515,60.0,0.0
8044,0,8044,[318 427  64 132  98],693,4,37817,4.700683654443754,60.0,0.0
8045,0,8045,[269   9  15 237 191],796,3,37820,4.700472284364902,0.0,0.0
8046,0,8046,[318 427  64 132  98],796,5,37825,4.700509506648441,60.0,0.0
8047,0,8047,[318 427  64 132  98],450,5,37830,4.700546719681909,60.0,0.0
8048,0,8048,[318 427  64 132  98],330,5,37835,4.700583923468754,60.0,0.0
8049,0,8049,[200 187  88 132 258],450,4,37839,4.7004968944099375,0.0,0.0
8050,0,8050,[172 405 161 357  50],716,4,37843,4.700409886970562,0.0,20.0
8051,0,8051,[318 427  64 132  98],18,5,37848,4.700447093889717,60.0,0.0
8052,0,8052,[318 427  64 132  98],236,5,37853,4.70048429156836,60.0,0.0
8053,0,8053,[318 427  64 132  98],151,5,37858,4.700521480009933,60.0,0.0
8054,0,8054,[318 427  64 132  98],236,5,37863,4.700558659217877,60.0,0.0
8055,0,8055,[318 427  64 132  98],655,4,37867,4.7004716981132075,60.0,0.0
8056,0,8056,[318 427  64 132  98],577,5,37872,4.70050887427082,60.0,0.0
8057,0,8057,[318 427  64 132  98],535,4,37876,4.70042194092827,60.0,0.0
8058,0,8058,[144  96 268   8  88],655,0,37876,4.69983868966373,0.0,0.0
8059,0,8059,[318 427  64 132  98],577,5,37881,4.699875930521092,60.0,0.0
8060,0,8060,[318 427  64 132  98],18,5,37886,4.699913162138692,60.0,0.0
8061,0,8061,[318 427  64 132  98],450,5,37891,4.69995038451997,60.0,0.0
8062,0,8062,[318 427  64 132  98],655,4,37895,4.699863574351978,60.0,0.0
8063,0,8063,[318 427  64 132  98],151,5,37900,4.6999007936507935,60.0,0.0
8064,0,8064,[318 427  64 132  98],330,5,37905,4.699938003719777,60.0,0.0
8065,0,8065,[318 427  64 132  98],535,4,37909,4.699851227374163,60.0,0.0
8066,0,8066,[318 427  64 132  98],151,5,37914,4.699888434362216,60.0,0.0
8067,0,8067,[318 427  64 132  98],316,5,37919,4.699925632126921,60.0,0.0
8068,0,8068,[318 427  64 132  98],151,5,37924,4.699962820671707,60.0,0.0
8069,0,8069,[ 70 603 427 111 197],707,3,37927,4.699752168525403,40.0,0.0
8070,0,8070,[318 427  64 132  98],796,5,37932,4.699789369347045,60.0,0.0
8071,0,8071,[318 427  64 132  98],535,4,37936,4.6997026759167495,60.0,0.0
8072,0,8072,[318 427  64 132  98],269,5,37941,4.699739873652917,60.0,0.0
8073,0,8073,[318 427  64 132  98],796,5,37946,4.699777062174882,60.0,0.0
8074,0,8074,[318 427  64 132  98],535,4,37950,4.69969040247678,60.0,0.0
8075,0,8075,[318 427  64 132  98],535,4,37954,4.699603764239723,60.0,0.0
8076,0,8076,[111 143 385  95  98],786,5,37959,4.699640955800421,0.0,0.0
8077,0,8077,[318 427  64 132  98],796,5,37964,4.699678138153009,60.0,0.0
8078,0,8078,[318 427  64 132  98],316,5,37969,4.699715311300904,60.0,0.0
8079,0,8079,[318 427  64 132  98],655,4,37973,4.699628712871287,60.0,0.0
8080,0,8080,[318 427  64 132  98],236,5,37978,4.69966588293528,60.0,0.0
8081,0,8081,[318 427  64 132  98],269,5,37983,4.69970304380104,60.0,0.0
8082,0,8082,[318 427  64 132  98],316,5,37988,4.699740195471978,60.0,0.0
8083,0,8083,[318 427  64 132  98],796,5,37993,4.6997773379515095,60.0,0.0
8084,0,8084,[318 427  64 132  98],577,5,37998,4.699814471243043,60.0,0.0
8085,0,8085,[318 427  64 132  98],151,5,38003,4.699851595349988,60.0,0.0
8086,0,8086,[318 427  64 132  98],450,5,38008,4.699888710275752,60.0,0.0
8087,0,8087,[318 427  64 132  98],18,5,38013,4.699925816023739,60.0,0.0
8088,0,8088,[318 427  64 132  98],577,5,38018,4.699962912597354,60.0,0.0
8089,0,8089,[318 427  64 132  98],269,5,38023,4.7,60.0,0.0
8090,0,8090,[318 427  64 132  98],236,5,38028,4.700037078235076,60.0,0.0
8091,0,8091,[318 427  64 132  98],577,5,38033,4.7000741473059815,60.0,0.0
8092,0,8092,[318 427  64 132  98],693,4,38037,4.699987643642654,60.0,0.0
8093,0,8093,[318 427  64 132  98],236,5,38042,4.700024709661478,60.0,0.0
8094,0,8094,[318 427  64 132  98],316,5,38047,4.700061766522545,60.0,0.0
8095,0,8095,[318 427  64 132  98],269,5,38052,4.700098814229249,60.0,0.0
8096,0,8096,[318 427  64 132  98],796,5,38057,4.700135852784982,60.0,0.0
8097,0,8097,[318 427  64 132  98],577,5,38062,4.700172882193134,60.0,0.0
8098,0,8098,[ 95  11 181 222 282],450,3,38065,4.699962958389925,0.0,0.0
8099,0,8099,[318 427  64 132  98],655,4,38069,4.699876543209877,60.0,0.0
8100,0,8100,[318 427  64 132  98],535,4,38073,4.699790149364276,60.0,0.0
8101,0,8101,[161 111  11 183 301],450,5,38078,4.699827203159714,0.0,0.0
8102,0,8102,[318 427  64 132  98],716,5,38083,4.699864247809454,60.0,0.0
8103,0,8103,[318 427  64 132  98],535,4,38087,4.699777887462981,60.0,0.0
8104,0,8104,[235 210  56 275 603],716,4,38091,4.699691548426897,20.0,20.0
8105,0,8105,[318 427  64 132  98],236,5,38096,4.699728596101653,60.0,0.0
8106,0,8106,[318 427  64 132  98],269,5,38101,4.699765634636734,60.0,0.0
8107,0,8107,[318 427  64 132  98],236,5,38106,4.699802664035521,60.0,0.0
8108,0,8108,[318 427  64 132  98],693,4,38110,4.699716364533234,60.0,0.0
8109,0,8109,[265  97 195  25 546],151,3,38113,4.699506781750925,0.0,0.0
8110,0,8110,[318 427  64 132  98],330,5,38118,4.699543829367526,60.0,0.0
8111,0,8111,[318 427  64 132  98],693,4,38122,4.699457593688363,60.0,0.0
8112,0,8112,[318 427  64 132  98],330,5,38127,4.699494638234931,60.0,0.0
8113,0,8113,[318 427  64 132  98],535,4,38131,4.699408429874292,60.0,0.0
8114,0,8114,[318 427  64 132  98],151,5,38136,4.699445471349353,60.0,0.0
8115,0,8115,[405  95 423 275 257],330,5,38141,4.6994825036964025,0.0,20.0
8116,0,8116,[318 427  64 132  98],151,5,38146,4.699519526918812,60.0,0.0
8117,0,8117,[318 427  64 132  98],693,4,38150,4.699433357969943,60.0,0.0
8118,0,8118,[318 427  64 132  98],655,4,38154,4.699347210247567,60.0,0.0
8119,0,8119,[318 427  64 132  98],18,5,38159,4.699384236453202,60.0,0.0
8120,0,8120,[191 588 286 483 282],401,2,38161,4.699051840906292,0.0,20.0
8121,0,8121,[318 427  64 132  98],693,4,38165,4.698965771977345,60.0,0.0
8122,0,8122,[318 427  64 132  98],693,4,38169,4.698879724239813,60.0,0.0
8123,0,8123,[318 427  64 132  98],450,5,38174,4.69891678975874,60.0,0.0
8124,0,8124,[318 427  64 132  98],316,5,38179,4.698953846153846,60.0,0.0
8125,0,8125,[318 427  64 132  98],269,5,38184,4.698990893428501,60.0,0.0
8126,0,8126,[318 427  64 132  98],450,5,38189,4.6990279315860715,60.0,0.0
8127,0,8127,[318 427  64 132  98],330,5,38194,4.699064960629921,60.0,0.0
8128,0,8128,[318 427  64 132  98],796,5,38199,4.699101980563415,60.0,0.0
8129,0,8129,[ 89 204  82  15 357],450,3,38202,4.698892988929889,0.0,0.0
8130,0,8130,[318 427  64 132  98],330,5,38207,4.698930020907637,60.0,0.0
8131,0,8131,[318 427  64 132  98],269,5,38212,4.698967043777668,60.0,0.0
8132,0,8132,[318 427  64 132  98],655,4,38216,4.698881101684496,60.0,0.0
8133,0,8133,[ 71 180 318  28 427],796,3,38219,4.698672239980329,40.0,0.0
8134,0,8134,[318 427  64 132  98],18,5,38224,4.698709280885065,60.0,0.0
8135,0,8135,[318 427  64 132  98],316,5,38229,4.698746312684365,60.0,0.0
8136,0,8136,[318 427  64 132  98],316,5,38234,4.698783335381591,60.0,0.0
8137,0,8137,[318 427  64 132  98],151,5,38239,4.698820348980093,60.0,0.0
8138,0,8138,[318 427  64 132  98],236,5,38244,4.698857353483229,60.0,0.0
8139,0,8139,[318 427  64 132  98],151,5,38249,4.698894348894349,60.0,0.0
8140,0,8140,[174 588   1 181  79],389,5,38254,4.698931335216804,0.0,0.0
8141,0,8141,[318 427  64 132  98],18,5,38259,4.6989683124539425,60.0,0.0
8142,0,8142,[318 427  64 132  98],316,5,38264,4.6990052806091125,60.0,0.0
8143,0,8143,[318 427  64 132  98],796,5,38269,4.699042239685658,60.0,0.0
8144,0,8144,[318 427  64 132  98],450,5,38274,4.699079189686924,60.0,0.0
8145,0,8145,[318 427  64 132  98],236,5,38279,4.699116130616253,60.0,0.0
8146,0,8146,[318 427  64 132  98],577,5,38284,4.699153062476985,60.0,0.0
8147,0,8147,[318 427  64 132  98],655,4,38288,4.699067255768287,60.0,0.0
8148,0,8148,[318 427  64 132  98],535,4,38292,4.698981470119033,60.0,0.0
8149,0,8149,[318 427  64 132  98],236,5,38297,4.699018404907975,60.0,0.0
8150,0,8150,[ 70 322  22 301 273],344,2,38299,4.698687277634646,0.0,0.0
8151,0,8151,[318 427  64 132  98],151,5,38304,4.698724239450442,60.0,0.0
8152,0,8152,[318 427  64 132  98],269,5,38309,4.69876119219919,60.0,0.0
8153,0,8153,[301 195 153  22 151],796,4,38313,4.698675496688741,0.0,0.0
8154,0,8154,[318 427  64 132  98],151,5,38318,4.698712446351931,60.0,0.0
8155,0,8155,[ 15 257 144 269 180],796,3,38321,4.698504168710152,0.0,0.0
8156,0,8156,[318 427  64 132  98],796,5,38326,4.698541130317519,60.0,0.0
8157,0,8157,[318 427  64 132  98],655,4,38330,4.698455503799951,60.0,0.0
8158,0,8158,[318 427  64 132  98],18,5,38335,4.698492462311558,60.0,0.0
8159,0,8159,[318 427  64 132  98],151,5,38340,4.698529411764706,60.0,0.0
8160,0,8160,[318 427  64 132  98],450,5,38345,4.698566352162725,60.0,0.0
8161,0,8161,[318 427  64 132  98],269,5,38350,4.698603283508944,60.0,0.0
8162,0,8162,[318 427  64 132  98],693,4,38354,4.69851770182531,60.0,0.0
8163,0,8163,[318 427  64 132  98],655,4,38358,4.6984321411073005,60.0,0.0
8164,0,8164,[318 427  64 132  98],269,5,38363,4.698469075321494,60.0,0.0
8165,0,8165,[318 427  64 132  98],577,5,38368,4.698506000489836,60.0,0.0
8166,0,8166,[318 427  64 132  98],316,5,38373,4.698542916615648,60.0,0.0
8167,0,8167,[318 427  64 132  98],577,5,38378,4.698579823702253,60.0,0.0
8168,0,8168,[318 427  64 132  98],269,5,38383,4.698616721752969,60.0,0.0
8169,0,8169,[318 427  64 132  98],330,5,38388,4.698653610771114,60.0,0.0
8170,0,8170,[318 427  64 132  98],18,5,38393,4.698690490760005,60.0,0.0
8171,0,8171,[318 427  64 132  98],269,5,38398,4.698727361722956,60.0,0.0
8172,0,8172,[318 427  64 132  98],450,5,38403,4.698764223663281,60.0,0.0
8173,0,8173,[127 132 301 216 588],344,5,38408,4.698801076584291,0.0,20.0
8174,0,8174,[318 427  64 132  98],655,4,38412,4.698715596330275,60.0,0.0
8175,0,8175,[200 173 195 257 187],716,3,38415,4.698507827788649,0.0,0.0
8176,0,8176,[318 427  64 132  98],693,4,38419,4.6984224043047575,60.0,0.0
8177,0,8177,[318 427  64 132  98],535,4,38423,4.69833700171191,60.0,0.0
8178,0,8178,[318 427  64 132  98],269,5,38428,4.698373884337939,60.0,0.0
8179,0,8179,[318 427  64 132  98],269,5,38433,4.698410757946211,60.0,0.0
8180,0,8180,[318 427  64 132  98],535,4,38437,4.698325388094365,60.0,0.0
8181,0,8181,[318 427  64 132  98],151,5,38442,4.698362258616475,60.0,0.0
8182,0,8182,[318 427  64 132  98],269,5,38447,4.6983991201270925,60.0,0.0
8183,0,8183,[318 427  64 132  98],269,5,38452,4.698435972629521,60.0,0.0
8184,0,8184,[318 427  64 132  98],577,5,38457,4.698472816127062,60.0,0.0
8185,0,8185,[318 427  64 132  98],655,4,38461,4.698387490838016,60.0,0.0
8186,0,8186,[318 427  64 132  98],151,5,38466,4.698424331256871,60.0,0.0
8187,0,8187,[318 427  64 132  98],716,5,38471,4.698461162677089,60.0,0.0
8188,0,8188,[318 427  64 132  98],316,5,38476,4.698497985101966,60.0,0.0
8189,0,8189,[318 427  64 132  98],577,5,38481,4.698534798534799,60.0,0.0
8190,0,8190,[318 427  64 132  98],316,5,38486,4.6985716029788795,60.0,0.0
8191,0,8191,[100 237 313 282  71],450,4,38490,4.698486328125,0.0,20.0
8192,0,8192,[318 427  64 132  98],716,5,38495,4.698523129500793,60.0,0.0
8193,0,8193,[318 427  64 132  98],236,5,38500,4.698559921894069,60.0,0.0
8194,0,8194,[318 427  64 132  98],535,4,38504,4.698474679682733,60.0,0.0
8195,0,8195,[318 427  64 132  98],269,5,38509,4.698511469009273,60.0,0.0
8196,0,8196,[318 427  64 132  98],316,5,38514,4.698548249359522,60.0,0.0
8197,0,8197,[318 427  64 132  98],236,5,38519,4.698585020736765,60.0,0.0
8198,0,8198,[318 427  64 132  98],535,4,38523,4.69849981705086,60.0,0.0
8199,0,8199,[318 427  64 132  98],693,4,38527,4.698414634146341,60.0,0.0
8200,0,8200,[318 427  64 132  98],18,5,38532,4.698451408364834,60.0,0.0
8201,0,8201,[318 427  64 132  98],151,5,38537,4.698488173616191,60.0,0.0
8202,0,8202,[318 427  64 132  98],269,5,38542,4.6985249299036935,60.0,0.0
8203,0,8203,[318 427  64 132  98],577,5,38547,4.698561677230619,60.0,0.0
8204,0,8204,[318 427  64 132  98],577,5,38552,4.698598415600244,60.0,0.0
8205,0,8205,[318 427  64 132  98],716,5,38557,4.698635145015842,60.0,0.0
8206,0,8206,[318 427  64 132  98],796,5,38562,4.698671865480687,60.0,0.0
8207,0,8207,[318 427  64 132  98],716,5,38567,4.698708576998051,60.0,0.0
8208,0,8208,[318 427  64 132  98],796,5,38572,4.698745279571202,60.0,0.0
8209,0,8209,[318 427  64 132  98],450,5,38577,4.698781973203411,60.0,0.0
8210,0,8210,[183 196  97 357 234],796,3,38580,4.698575082206796,0.0,0.0
8211,0,8211,[318 427  64 132  98],269,5,38585,4.698611787627861,60.0,0.0
8212,0,8212,[318 427  64 132  98],450,5,38590,4.6986484841105565,60.0,0.0
8213,0,8213,[318 427  64 132  98],18,5,38595,4.698685171658145,60.0,0.0
8214,0,8214,[318 427  64 132  98],655,4,38599,4.698600121728545,60.0,0.0
8215,0,8215,[318 427  64 132  98],796,5,38604,4.698636806231743,60.0,0.0
8216,0,8216,[168 125 117 258 204],450,5,38609,4.698673481806012,0.0,0.0
8217,0,8217,[318 427  64 132  98],330,5,38614,4.698710148454611,60.0,0.0
8218,0,8218,[318 427  64 132  98],577,5,38619,4.6987468061808,60.0,0.0
8219,0,8219,[318 427  64 132  98],450,5,38624,4.698783454987835,60.0,0.0
8220,0,8220,[318 427  64 132  98],693,4,38628,4.698698455175769,60.0,0.0
8221,0,8221,[318 427  64 132  98],716,5,38633,4.698735100948674,60.0,0.0
8222,0,8222,[318 427  64 132  98],655,4,38637,4.698650127690624,60.0,0.0
8223,0,8223,[318 427  64 132  98],577,5,38642,4.698686770428016,60.0,0.0
8224,0,8224,[318 427  64 132  98],269,5,38647,4.698723404255319,60.0,0.0
8225,0,8225,[318 427  64 132  98],151,5,38652,4.6987600291757845,60.0,0.0
8226,0,8226,[318 427  64 132  98],316,5,38657,4.698796645192658,60.0,0.0
8227,0,8227,[182  97 125 135 269],18,3,38660,4.6985901798736025,0.0,0.0
8228,0,8228,[318 427  64 132  98],716,5,38665,4.698626807631547,60.0,0.0
8229,0,8229,[318 427  64 132  98],796,5,38670,4.698663426488457,60.0,0.0
8230,0,8230,[318 427  64 132  98],535,4,38674,4.698578544526789,60.0,0.0
8231,0,8231,[318 427  64 132  98],693,4,38678,4.698493683187561,60.0,0.0
8232,0,8232,[318 427  64 132  98],18,5,38683,4.698530304870642,60.0,0.0
8233,0,8233,[318 427  64 132  98],535,4,38687,4.6984454700024285,60.0,0.0
8234,0,8234,[318 427  64 132 357],18,5,38692,4.698482088646023,60.0,0.0
8235,0,8235,[216 204 483 222 200],655,3,38695,4.698275862068965,0.0,0.0
8236,0,8236,[318 427  64 132 357],450,5,38700,4.698312492412286,60.0,0.0
8237,0,8237,[318 427  64 132 357],693,4,38704,4.698227725176014,60.0,0.0
8238,0,8238,[318 427  64 132 357],535,4,38708,4.6981429785168105,60.0,0.0
8239,0,8239,[318 427  64 132  98],655,4,38712,4.6980582524271846,60.0,0.0
8240,0,8240,[  9 742 174  79 127],256,5,38717,4.698094891396675,0.0,20.0
8241,0,8241,[318 427  64 132  98],796,5,38722,4.6981315214753705,60.0,0.0
8242,0,8242,[318 427  64 132  98],577,5,38727,4.698168142666505,60.0,0.0
8243,0,8243,[318 427  64 132  98],693,4,38731,4.698083454633673,60.0,0.0
8244,0,8244,[318 427  64 132  98],693,4,38735,4.697998787143724,60.0,0.0
8245,0,8245,[318 427  64 132  98],316,5,38740,4.698035411108417,60.0,0.0
8246,0,8246,[286  22 153 135 210],330,4,38744,4.697950769976961,0.0,20.0
8247,0,8247,[318 427  64 132  98],18,5,38749,4.697987390882639,60.0,0.0
8248,0,8248,[318 427  64 132  98],577,5,38754,4.6980240029094436,60.0,0.0
8249,0,8249,[318 427  64 132  98],796,5,38759,4.698060606060606,60.0,0.0
8250,0,8250,[318 427  64 132  98],18,5,38764,4.698097200339353,60.0,0.0
8251,0,8251,[318 427  64 132  98],796,5,38769,4.698133785748909,60.0,0.0
8252,0,8252,[318 427  64 132  98],655,4,38773,4.6980491942324,60.0,0.0
8253,0,8253,[318 427  64 132  98],577,5,38778,4.6980857765931665,60.0,0.0
8254,0,8254,[318 427  64 132  98],330,5,38783,4.698122350090854,60.0,0.0
8255,0,8255,[318 427  64 132  98],236,5,38788,4.698158914728682,60.0,0.0
8256,0,8256,[200 117 496 403  15],796,5,38793,4.69819547050987,20.0,0.0
8257,0,8257,[318 427  64 132  98],236,5,38798,4.698232017437636,60.0,0.0
8258,0,8258,[318 427  64 132  98],269,5,38803,4.698268555515195,60.0,0.0
8259,0,8259,[318 427  64 132  98],655,4,38807,4.69818401937046,60.0,0.0
8260,0,8260,[228 286 121 182 302],450,4,38811,4.698099503692047,0.0,20.0
8261,0,8261,[318 427  64 132  98],716,5,38816,4.698136044541274,60.0,0.0
8262,0,8262,[318 427  64 132  98],655,4,38820,4.698051555125257,60.0,0.0
8263,0,8263,[318 427  64 132  98],316,5,38825,4.6980880929332045,60.0,0.0
8264,0,8264,[180  88 121 204 210],457,5,38830,4.698124621899576,0.0,0.0
8265,0,8265,[318 427  64 132  98],716,5,38835,4.698161142027583,60.0,0.0
8266,0,8266,[318 427  64 132  98],316,5,38840,4.698197653320431,60.0,0.0
8267,0,8267,[318 427  64 132  98],236,5,38845,4.698234155781326,60.0,0.0
8268,0,8268,[318 427  64 132  98],693,4,38849,4.698149715806022,60.0,0.0
8269,0,8269,[318 427  64 132  98],330,5,38854,4.698186215235792,60.0,0.0
8270,0,8270,[318 427  64 132  98],655,4,38858,4.698101801475033,60.0,0.0
8271,0,8271,[318 427  64 132  98],655,4,38862,4.698017408123791,60.0,0.0
8272,0,8272,[318 427  64 132  98],796,5,38867,4.698053910310649,60.0,0.0
8273,0,8273,[318 427  64 132  98],796,5,38872,4.69809040367416,60.0,0.0
8274,0,8274,[151 237 121 204 117],296,3,38875,4.697885196374623,0.0,0.0
8275,0,8275,[318 427  64 132  98],269,5,38880,4.6979217013049785,60.0,0.0
8276,0,8276,[318 427  64 132  98],269,5,38885,4.697958197414522,60.0,0.0
8277,0,8277,[318 427  64 132  98],330,5,38890,4.697994684706451,60.0,0.0
8278,0,8278,[318 427  64 132  98],796,5,38895,4.698031163183959,60.0,0.0
8279,0,8279,[318 427  64 132  98],330,5,38900,4.6980676328502415,60.0,0.0
8280,0,8280,[318 427  64 132  98],450,5,38905,4.69810409370849,60.0,0.0
8281,0,8281,[318 427  64 132  98],693,4,38909,4.698019801980198,60.0,0.0
8282,0,8282,[318 427  64 132  98],796,5,38914,4.698056259809248,60.0,0.0
8283,0,8283,[191 222 257 235 153],23,2,38916,4.697730564944472,0.0,0.0
8284,0,8284,[318 427  64 132  98],18,5,38921,4.697767048883525,60.0,0.0
8285,0,8285,[318 427  64 132  98],236,5,38926,4.697803524016413,60.0,0.0
8286,0,8286,[475 194 143 508 210],269,3,38929,4.69759864848558,0.0,0.0
8287,0,8287,[318 427  64 132  98],655,4,38933,4.697514478764479,60.0,0.0
8288,0,8288,[318 427  64 132  98],716,5,38938,4.697550971166606,60.0,0.0
8289,0,8289,[318 427  64 132  98],535,4,38942,4.697466827503016,60.0,0.0
8290,0,8290,[318 427  64 132  98],655,4,38946,4.697382704137016,60.0,0.0
8291,0,8291,[318 427  64 132  98],151,5,38951,4.697419199228172,60.0,0.0
8292,0,8292,[318 427  64 132  98],236,5,38956,4.697455685517907,60.0,0.0
8293,0,8293,[318 427  64 132  98],330,5,38961,4.697492163009405,60.0,0.0
8294,0,8294,[318 427  64 132  98],716,5,38966,4.697528631705847,60.0,0.0
8295,0,8295,[318 427  64 132  98],716,5,38971,4.697565091610414,60.0,0.0
8296,0,8296,[318 427  64 132  98],236,5,38976,4.697601542726287,60.0,0.0
8297,0,8297,[204 603  79 234  89],151,5,38981,4.69763798505664,20.0,0.0
8298,0,8298,[245 127 322 204 269],629,2,38983,4.697312929268587,0.0,20.0
8299,0,8299,[ 69 289  89 405  70],655,1,38984,4.696867469879518,0.0,0.0
8300,0,8300,[318 427  64 132  98],269,5,38989,4.696903987471389,60.0,0.0
8301,0,8301,[318 427  64 132  98],450,5,38994,4.69694049626596,60.0,0.0
8302,0,8302,[318 427  64 132  98],316,5,38999,4.69697699626641,60.0,0.0
8303,0,8303,[318 427  64 132  98],535,4,39003,4.696893063583815,60.0,0.0
8304,0,8304,[318 427  64 132  98],655,4,39007,4.696809151113787,60.0,0.0
8305,0,8305,[318 427  64 132  98],316,5,39012,4.6968456537442815,60.0,0.0
8306,0,8306,[318 427  64 132  98],316,5,39017,4.696882147586373,60.0,0.0
8307,0,8307,[318 427  64 132  98],151,5,39022,4.696918632643236,60.0,0.0
8308,0,8308,[318 427  64 132  98],330,5,39027,4.696955108918041,60.0,0.0
8309,0,8309,[318 427  64 132  98],151,5,39032,4.696991576413959,60.0,0.0
8310,0,8310,[237 273  96 215  71],796,4,39036,4.696907712669955,0.0,0.0
8311,0,8311,[318 427  64 132  98],330,5,39041,4.696944177093359,60.0,0.0
8312,0,8312,[318 427  64 132  98],330,5,39046,4.696980632743895,60.0,0.0
8313,0,8313,[318 427  64 132  98],450,5,39051,4.69701707962473,60.0,0.0
8314,0,8314,[318 427  64 132  98],450,5,39056,4.697053517739026,60.0,0.0
8315,0,8315,[318 427  64 132  98],18,5,39061,4.697089947089947,60.0,0.0
8316,0,8316,[318 427  64 132  98],269,5,39066,4.697126367680654,60.0,0.0
8317,0,8317,[318 427  64 132  98],450,5,39071,4.697162779514306,60.0,0.0
8318,0,8318,[318 427  64 132  98],269,5,39076,4.697199182594062,60.0,0.0
8319,0,8319,[318 427  64 132  98],577,5,39081,4.697235576923077,60.0,0.0
8320,0,8320,[222   9 216 678 313],344,3,39084,4.697031606778031,0.0,0.0
8321,0,8321,[318 427  64 132  98],535,4,39088,4.696947849074742,60.0,0.0
8322,0,8322,[318 427  64 132  98],236,5,39093,4.696984260482999,60.0,0.0
8323,0,8323,[318 427  64 132  98],693,4,39097,4.696900528592023,60.0,0.0
8324,0,8324,[289  56 222 117 435],655,0,39097,4.696336336336336,0.0,0.0
8325,0,8325,[318 427  64 132  98],316,5,39102,4.696372808071103,60.0,0.0
8326,0,8326,[318 427  64 132  98],693,4,39106,4.69628917977663,60.0,0.0
8327,0,8327,[318 427  64 132  98],577,5,39111,4.696325648414986,60.0,0.0
8328,0,8328,[318 427  64 132  98],18,5,39116,4.696362108296314,60.0,0.0
8329,0,8329,[235  89 385 100 175],344,3,39119,4.696158463385354,0.0,20.0
8330,0,8330,[318 427  64 132  98],236,5,39124,4.6961949345816825,60.0,0.0
8331,0,8331,[318 427  64 132  98],693,4,39128,4.6961113778204515,60.0,0.0
8332,0,8332,[318 427  64 132  98],577,5,39133,4.696147845913837,60.0,0.0
8333,0,8333,[318 427  64 132  98],151,5,39138,4.69618430525558,60.0,0.0
8334,0,8334,[318 427  64 132  98],796,5,39143,4.69622075584883,60.0,0.0
8335,0,8335,[269  88 237 286 265],655,0,39143,4.695657389635317,0.0,20.0
8336,0,8336,[318 427  64 132  98],18,5,39148,4.695693894686338,60.0,0.0
8337,0,8337,[318 427  64 132  98],655,4,39152,4.69561045814344,60.0,0.0
8338,0,8338,[318 427  64 132  98],716,5,39157,4.695646960067155,60.0,0.0
8339,0,8339,[318 427  64 132  98],236,5,39162,4.69568345323741,60.0,0.0
8340,0,8340,[318 427  64 132  98],269,5,39167,4.695719937657355,60.0,0.0
8341,0,8341,[318 427  64 132  98],18,5,39172,4.695756413330137,60.0,0.0
8342,0,8342,[318 427  64 132  98],316,5,39177,4.6957928802588995,60.0,0.0
8343,0,8343,[318 427  64 132  98],18,5,39182,4.695829338446788,60.0,0.0
8344,0,8344,[318 427  64 132  98],577,5,39187,4.6958657878969445,60.0,0.0
8345,0,8345,[318 427  64 132  98],330,5,39192,4.695902228612509,60.0,0.0
8346,0,8346,[318 427  64 132  98],18,5,39197,4.695938660596622,60.0,0.0
8347,0,8347,[318 427  64 132  98],151,5,39202,4.69597508385242,60.0,0.0
8348,0,8348,[318 427  64 132  98],655,4,39206,4.695891723559708,60.0,0.0
8349,0,8349,[318 427  64 132  98],450,5,39211,4.695928143712575,60.0,0.0
8350,0,8350,[318 427  64 132  98],269,5,39216,4.695964555143097,60.0,0.0
8351,0,8351,[318 427  64 132  98],316,5,39221,4.696000957854406,60.0,0.0
8352,0,8352,[318 427  64 132  98],269,5,39226,4.696037351849635,60.0,0.0
8353,0,8353,[318 427  64 132  98],316,5,39231,4.696073737131913,60.0,0.0
8354,0,8354,[318 427  64 132  98],151,5,39236,4.696110113704369,60.0,0.0
8355,0,8355,[318 427  64 132  98],693,4,39240,4.6960268070847295,60.0,0.0
8356,0,8356,[318 427  64 132  98],535,4,39244,4.695943520402058,60.0,0.0
8357,0,8357,[318 427  64 132  98],655,4,39248,4.695860253649198,60.0,0.0
8358,0,8358,[318 427  64 132  98],18,5,39253,4.6958966383538705,60.0,0.0
8359,0,8359,[318 427  64 132  98],655,4,39257,4.695813397129187,60.0,0.0
8360,0,8360,[318 427  64 132  98],535,4,39261,4.69573017581629,60.0,0.0
8361,0,8361,[435  25 144  28 185],450,4,39265,4.695646974408036,0.0,0.0
8362,0,8362,[318 427  64 132  98],535,4,39269,4.6955637928972855,60.0,0.0
8363,0,8363,[318 427  64 132  98],535,4,39273,4.695480631276901,60.0,0.0
8364,0,8364,[318 427  64 132  98],236,5,39278,4.695517035265989,60.0,0.0
8365,0,8365,[318 427  64 132  98],236,5,39283,4.695553430552235,60.0,0.0
8366,0,8366,[318 427  64 132  98],151,5,39288,4.695589817138759,60.0,0.0
8367,0,8367,[318 427  64 132  98],450,5,39293,4.695626195028681,60.0,0.0
8368,0,8368,[318 427  64 132  98],693,4,39297,4.695543075636277,60.0,0.0
8369,0,8369,[318 427  64 132  98],796,5,39302,4.69557945041816,60.0,0.0
8370,0,8370,[318 427  64 132  98],330,5,39307,4.6956158165093775,60.0,0.0
8371,0,8371,[318 427  64 132  98],577,5,39312,4.695652173913044,60.0,0.0
8372,0,8372,[318 427  64 132  98],269,5,39317,4.69568852263227,60.0,0.0
8373,0,8373,[318 427  64 132  98],18,5,39322,4.695724862670169,60.0,0.0
8374,0,8374,[318 427  64 132  98],450,5,39327,4.695761194029851,60.0,0.0
8375,0,8375,[318 427  64 132  98],269,5,39332,4.695797516714422,60.0,0.0
8376,0,8376,[  8  96 403 197 597],796,4,39336,4.695714456249254,0.0,0.0
8377,0,8377,[318 427  64 132  98],151,5,39341,4.69575077584149,60.0,0.0
8378,0,8378,[318 427  64 132  98],796,5,39346,4.69578708676453,60.0,0.0
8379,0,8379,[318 427  64 132  98],151,5,39351,4.69582338902148,60.0,0.0
8380,0,8380,[318 427  64 132  98],316,5,39356,4.695859682615439,60.0,0.0
8381,0,8381,[318 427  64 132  98],655,4,39360,4.695776664280602,60.0,0.0
8382,0,8382,[318 427  64 132  98],330,5,39365,4.695812954789455,60.0,0.0
8383,0,8383,[318 427  64 132  98],330,5,39370,4.695849236641221,60.0,0.0
8384,0,8384,[318 427  64 132  98],716,5,39375,4.695885509838998,60.0,0.0
8385,0,8385,[172 238 185 515 265],655,3,39378,4.6956832816599094,0.0,0.0
8386,0,8386,[318 427  64 132  98],316,5,39383,4.695719565994993,60.0,0.0
8387,0,8387,[318 427  64 132  98],716,5,39388,4.695755841678588,60.0,0.0
8388,0,8388,[318 427  64 132  98],535,4,39392,4.695672904994636,60.0,0.0
8389,0,8389,[318 427  64 132  98],18,5,39397,4.695709177592372,60.0,0.0
8390,0,8390,[318 427  64 132  98],693,4,39401,4.695626266237635,60.0,0.0
8391,0,8391,[ 22 435 294  70 238],655,0,39401,4.695066730219256,0.0,0.0
8392,0,8392,[318 427  64 132  98],693,4,39405,4.694983915167401,60.0,0.0
8393,0,8393,[318 427  64 132  98],577,5,39410,4.695020252561354,60.0,0.0
8394,0,8394,[318 427  64 132  98],796,5,39415,4.695056581298392,60.0,0.0
8395,0,8395,[318 427  64 132  98],693,4,39419,4.694973797046212,60.0,0.0
8396,0,8396,[258 403 117 300 186],450,4,39423,4.694891032511611,0.0,0.0
8397,0,8397,[318 427  64 132  98],796,5,39428,4.694927363658014,60.0,0.0
8398,0,8398,[318 427  64 132  98],330,5,39433,4.694963686153113,60.0,0.0
8399,0,8399,[318 427  64 132  98],316,5,39438,4.695,60.0,0.0
8400,0,8400,[318 427  64 132  98],18,5,39443,4.695036305201762,60.0,0.0
8401,0,8401,[318 427  64 132  98],796,5,39448,4.695072601761486,60.0,0.0
8402,0,8402,[ 11 168 318 194 357],535,4,39452,4.694989884565036,20.0,0.0
8403,0,8403,[475 405 288 655 174],655,0,39452,4.694431223227035,0.0,0.0
8404,0,8404,[318 427  64 132  98],151,5,39457,4.694467578822129,60.0,0.0
8405,0,8405,[318 427  64 132  98],151,5,39462,4.694503925767309,60.0,0.0
8406,0,8406,[318 427  64 132  98],151,5,39467,4.69454026406566,60.0,0.0
8407,0,8407,[318 427  64 132  98],236,5,39472,4.694576593720266,60.0,0.0
8408,0,8408,[318 427  64 132  98],236,5,39477,4.694612914734213,60.0,0.0
8409,0,8409,[318 427  64 132  98],577,5,39482,4.694649227110583,60.0,0.0
8410,0,8410,[318 427  64 132  98],655,4,39486,4.694566638925217,60.0,0.0
8411,0,8411,[318 427  64 132  98],330,5,39491,4.694602948169282,60.0,0.0
8412,0,8412,[318 427  64 132  98],151,5,39496,4.694639248781647,60.0,0.0
8413,0,8413,[318 427  64 132  98],151,5,39501,4.694675540765391,60.0,0.0
8414,0,8414,[318 427  64 132  98],577,5,39506,4.694711824123589,60.0,0.0
8415,0,8415,[318 427  64 132  98],796,5,39511,4.694748098859316,60.0,0.0
8416,0,8416,[318 427  64 132  98],18,5,39516,4.694784364975645,60.0,0.0
8417,0,8417,[318 427  64 132  98],151,5,39521,4.694820622475647,60.0,0.0
8418,0,8418,[318 427  64 132  98],796,5,39526,4.694856871362394,60.0,0.0
8419,0,8419,[318 427  64 132  98],151,5,39531,4.6948931116389545,60.0,0.0
8420,0,8420,[318 427  64 132  98],693,4,39535,4.694810592566204,60.0,0.0
8421,0,8421,[318 427  64 132  98],450,5,39540,4.694846829731655,60.0,0.0
8422,0,8422,[318 427  64 132  98],450,5,39545,4.69488305829277,60.0,0.0
8423,0,8423,[318 427  64 132  98],796,5,39550,4.694919278252612,60.0,0.0
8424,0,8424,[318 427  64 132  98],577,5,39555,4.694955489614244,60.0,0.0
8425,0,8425,[318 427  64 132  98],796,5,39560,4.694991692380726,60.0,0.0
8426,0,8426,[318 427  64 132  98],577,5,39565,4.6950278865551205,60.0,0.0
8427,0,8427,[318 427  64 132  98],236,5,39570,4.695064072140484,60.0,0.0
8428,0,8428,[318 427  64 132  98],316,5,39575,4.695100249139874,60.0,0.0
8429,0,8429,[318 427  64 132  98],450,5,39580,4.695136417556347,60.0,0.0
8430,0,8430,[318 427  64 132  98],330,5,39585,4.695172577392954,60.0,0.0
8431,0,8431,[318 427  64 132  98],577,5,39590,4.6952087286527515,60.0,0.0
8432,0,8432,[318 427  64 132  98],151,5,39595,4.695244871338788,60.0,0.0
8433,0,8433,[318 427  64 132  98],577,5,39600,4.695281005454114,60.0,0.0
8434,0,8434,[318 427  64 132  98],151,5,39605,4.6953171310017785,60.0,0.0
8435,0,8435,[318 427  64 132  98],18,5,39610,4.695353247984827,60.0,0.0
8436,0,8436,[318 427  64 132  98],236,5,39615,4.695389356406306,60.0,0.0
8437,0,8437,[318 427  64 132  98],269,5,39620,4.695425456269258,60.0,0.0
8438,0,8438,[318 427  64 132  98],693,4,39624,4.695343050124422,60.0,0.0
8439,0,8439,[318 427  64 132  98],269,5,39629,4.695379146919431,60.0,0.0
8440,0,8440,[318 427  64 132  98],450,5,39634,4.695415235161711,60.0,0.0
8441,0,8441,[318 427  64 132  98],796,5,39639,4.6954513148543,60.0,0.0
8442,0,8442,[322 273 118 301 300],796,2,39641,4.695132062063248,0.0,0.0
8443,0,8443,[318 427  64 132  98],236,5,39646,4.695168166745618,60.0,0.0
8444,0,8444,[257  97 182 211 237],655,1,39647,4.694730609828301,0.0,0.0
8445,0,8445,[318 427  64 132  98],716,5,39652,4.694766753492778,60.0,0.0
8446,0,8446,[318 427  64 132  98],693,4,39656,4.694684503373979,60.0,0.0
8447,0,8447,[318 427  64 132  98],716,5,39661,4.694720643939394,60.0,0.0
8448,0,8448,[318 427  64 132  98],18,5,39666,4.694756775949816,60.0,0.0
8449,0,8449,[318 427  64 132  98],316,5,39671,4.694792899408284,60.0,0.0
8450,0,8450,[318 427  64 132  98],151,5,39676,4.694829014317833,60.0,0.0
8451,0,8451,[318 427  64 132  98],535,4,39680,4.6947468054898245,60.0,0.0
8452,0,8452,[318 427  64 132  98],450,5,39685,4.694782917307465,60.0,0.0
8453,0,8453,[318 427  64 132  98],655,4,39689,4.694700733380648,60.0,0.0
8454,0,8454,[318 427  64 132  98],796,5,39694,4.6947368421052635,60.0,0.0
8455,0,8455,[318 427  64 132  98],535,4,39698,4.694654683065279,60.0,0.0
8456,0,8456,[318 427  64 132  98],716,5,39703,4.694690788695755,60.0,0.0
8457,0,8457,[318 427  64 132  98],716,5,39708,4.694726885788603,60.0,0.0
8458,0,8458,[318 427  64 132  98],18,5,39713,4.694762974346849,60.0,0.0
8459,0,8459,[318 427  64 132  98],535,4,39717,4.69468085106383,60.0,0.0
8460,0,8460,[187 222 238 435 271],655,1,39718,4.694244179175039,0.0,0.0
8461,0,8461,[318 427  64 132  98],577,5,39723,4.694280311982983,60.0,0.0
8462,0,8462,[318 427  64 132  98],151,5,39728,4.6943164362519205,60.0,0.0
8463,0,8463,[318 427  64 132  98],655,4,39732,4.694234404536862,60.0,0.0
8464,0,8464,[318 427  64 132  98],693,4,39736,4.69415239220319,60.0,0.0
8465,0,8465,[ 97 357  96 135 174],72,5,39741,4.694188518781006,0.0,0.0
8466,0,8466,[318 427  64 132  98],316,5,39746,4.6942246368253215,60.0,0.0
8467,0,8467,[318 427  64 132  98],269,5,39751,4.694260746339159,60.0,0.0
8468,0,8468,[318 427  64 132  98],269,5,39756,4.69429684732554,60.0,0.0
8469,0,8469,[318 427  64 132  98],330,5,39761,4.694332939787485,60.0,0.0
8470,0,8470,[318 427  64 132  98],716,5,39766,4.694369023728013,60.0,0.0
8471,0,8471,[318 427  64 132  98],330,5,39771,4.694405099150142,60.0,0.0
8472,0,8472,[318 427  64 132  98],18,5,39776,4.694441166056887,60.0,0.0
8473,0,8473,[318 427  64 132  98],796,5,39781,4.694477224451263,60.0,0.0
8474,0,8474,[318 427  64 132  98],535,4,39785,4.694395280235988,60.0,0.0
8475,0,8475,[318 427  64 132  98],450,5,39790,4.69443133553563,60.0,0.0
8476,0,8476,[318 427  64 132  98],151,5,39795,4.694467382328654,60.0,0.0
8477,0,8477,[318 427  64 132  98],18,5,39800,4.69450342061807,60.0,0.0
8478,0,8478,[ 56 475 318 153 135],655,2,39802,4.694185635098479,20.0,0.0
8479,0,8479,[318 427  64 132  98],269,5,39807,4.694221698113208,60.0,0.0
8480,0,8480,[318 427  64 132  98],330,5,39812,4.694257752623511,60.0,0.0
8481,0,8481,[318 427  64 132  98],693,4,39816,4.694175901909927,60.0,0.0
8482,0,8482,[318 427  64 132  98],236,5,39821,4.694211953318401,60.0,0.0
8483,0,8483,[318 427  64 132  98],655,4,39825,4.694130127298444,60.0,0.0
8484,0,8484,[318 427  64 132  98],535,4,39829,4.694048320565704,60.0,0.0
8485,0,8485,[318 427  64 132  98],450,5,39834,4.694084374263493,60.0,0.0
8486,0,8486,[318 427  64 132  98],655,4,39838,4.694002592199835,60.0,0.0
8487,0,8487,[318 427  64 132  98],330,5,39843,4.694038642789821,60.0,0.0
8488,0,8488,[318 427  64 132  98],655,4,39847,4.693956885381081,60.0,0.0
8489,0,8489,[318 427  64 132  98],693,4,39851,4.6938751472320375,60.0,0.0
8490,0,8490,[318 427  64 132  98],236,5,39856,4.693911200094218,60.0,0.0
8491,0,8491,[318 427  64 132  98],693,4,39860,4.6938294865756,60.0,0.0
8492,0,8492,[318 427  64 132  98],330,5,39865,4.693865536324031,60.0,0.0
8493,0,8493,[275 186 197  70 211],535,5,39870,4.693901577584177,0.0,20.0
8494,0,8494,[318 427  64 132  98],151,5,39875,4.6939376103590345,60.0,0.0
8495,0,8495,[318 427  64 132  98],330,5,39880,4.6939736346516,60.0,0.0
8496,0,8496,[318 427  64 132  98],151,5,39885,4.69400965046487,60.0,0.0
8497,0,8497,[318 427  64 132  98],716,5,39890,4.694045657801836,60.0,0.0
8498,0,8498,[318 427  64 132  98],269,5,39895,4.69408165666549,60.0,0.0
8499,0,8499,[318 427  64 132  98],151,5,39900,4.694117647058824,60.0,0.0
8500,0,8500,[318 427  64 132  98],655,4,39904,4.694035995765204,60.0,0.0
8501,0,8501,[318 427  64 132  98],796,5,39909,4.694071983062809,60.0,0.0
8502,0,8502,[318 427  64 132  98],535,4,39913,4.69399035634482,60.0,0.0
8503,0,8503,[318 427  64 132  98],316,5,39918,4.6940263405456255,60.0,0.0
8504,0,8504,[318 427  64 132  98],18,5,39923,4.694062316284539,60.0,0.0
8505,0,8505,[318 427  64 132  98],450,5,39928,4.694098283564543,60.0,0.0
8506,0,8506,[318 427  64 132  98],655,4,39932,4.694016692135888,60.0,0.0
8507,0,8507,[318 427  64 132  98],577,5,39937,4.694052656323461,60.0,0.0
8508,0,8508,[318 427  64 132  98],316,5,39942,4.694088612057821,60.0,0.0
8509,0,8509,[288   9 179 161 174],504,4,39946,4.69400705052879,0.0,0.0
8510,0,8510,[318 427  64 132  98],655,4,39950,4.693925508165903,60.0,0.0
8511,0,8511,[318 427  64 132  98],655,4,39954,4.693843984962406,60.0,0.0
8512,0,8512,[318 427  64 132  98],269,5,39959,4.6938799483143425,60.0,0.0
8513,0,8513,[215  12  98 173  70],280,3,39962,4.693680996006577,0.0,0.0
8514,0,8514,[318 427  64 132  98],330,5,39967,4.693716970052848,60.0,0.0
8515,0,8515,[318 427  64 132  98],796,5,39972,4.69375293565054,60.0,0.0
8516,0,8516,[318 427  64 132  98],330,5,39977,4.69378889280263,60.0,0.0
8517,0,8517,[318 427  64 132  98],151,5,39982,4.693824841512092,60.0,0.0
8518,0,8518,[318 427  64 132  98],655,4,39986,4.693743397112337,60.0,0.0
8519,0,8519,[318 427  64 132  98],269,5,39991,4.693779342723005,60.0,0.0
8520,0,8520,[318 427  64 132  98],151,5,39996,4.693815279896726,60.0,0.0
8521,0,8521,[318 427  64 132  98],330,5,40001,4.69385120863647,60.0,0.0
8522,0,8522,[318 427  64 132  98],330,5,40006,4.693887128945207,60.0,0.0
8523,0,8523,[318 427  64 132  98],577,5,40011,4.693923040825903,60.0,0.0
8524,0,8524,[318 427  64 132  98],236,5,40016,4.693958944281525,60.0,0.0
8525,0,8525,[318 427  64 132  98],796,5,40021,4.693994839315036,60.0,0.0
8526,0,8526,[318 427  64 132  98],236,5,40026,4.694030725929401,60.0,0.0
8527,0,8527,[318 427  64 132  98],655,4,40030,4.693949343339587,60.0,0.0
8528,0,8528,[318 427  64 132  98],236,5,40035,4.693985226873021,60.0,0.0
8529,0,8529,[496  95 144 121  71],807,5,40040,4.694021101992966,20.0,0.0
8530,0,8530,[318 427  64 132  98],450,5,40045,4.694056968702379,60.0,0.0
8531,0,8531,[318 427  64 132  98],236,5,40050,4.694092827004219,60.0,0.0
8532,0,8532,[318 427  64 132  98],535,4,40054,4.694011484823626,60.0,0.0
8533,0,8533,[318 427  64 132  98],18,5,40059,4.694047340051559,60.0,0.0
8534,0,8534,[318 427  64 132  98],796,5,40064,4.694083186877563,60.0,0.0
8535,0,8535,[318 427  64 132  98],716,5,40069,4.694119025304592,60.0,0.0
8536,0,8536,[318 427  64 132  98],330,5,40074,4.694154855335598,60.0,0.0
8537,0,8537,[302 143 200 328 475],655,3,40077,4.693956430077302,0.0,0.0
8538,0,8538,[125   7 678 258   1],15,1,40078,4.693523831830425,0.0,0.0
8539,0,8539,[318 427  64 132  98],577,5,40083,4.693559718969555,60.0,0.0
8540,0,8540,[318 427  64 132  98],18,5,40088,4.693595597705187,60.0,0.0
8541,0,8541,[318 427  64 132  98],716,5,40093,4.693631468040271,60.0,0.0
8542,0,8542,[318 427  64 132  98],236,5,40098,4.693667329977759,60.0,0.0
8543,0,8543,[318 427  64 132  98],236,5,40103,4.693703183520599,60.0,0.0
8544,0,8544,[228 655 202   4  79],716,4,40107,4.693622001170275,0.0,0.0
8545,0,8545,[318 427  64 132  98],577,5,40112,4.693657851626492,60.0,0.0
8546,0,8546,[318 427  64 132  98],450,5,40117,4.693693693693693,60.0,0.0
8547,0,8547,[318 427  64 132  98],236,5,40122,4.693729527374825,60.0,0.0
8548,0,8548,[318 427  64 132  98],236,5,40127,4.693765352672827,60.0,0.0
8549,0,8549,[202   1  88 276 179],18,3,40130,4.693567251461988,0.0,0.0
8550,0,8550,[318 427  64 132  98],269,5,40135,4.693603087358204,60.0,0.0
8551,0,8551,[318 427  64 132  98],577,5,40140,4.693638914873714,60.0,0.0
8552,0,8552,[127   9  70 211 273],401,2,40142,4.693323979890097,0.0,20.0
8553,0,8553,[318 427  64 132  98],18,5,40147,4.693359831657704,60.0,0.0
8554,0,8554,[318 427  64 132  98],236,5,40152,4.693395675043834,60.0,0.0
8555,0,8555,[318 427  64 132  98],330,5,40157,4.693431510051426,60.0,0.0
8556,0,8556,[318 427  64 132  98],269,5,40162,4.693467336683417,60.0,0.0
8557,0,8557,[318 427  64 132  98],151,5,40167,4.693503154942744,60.0,0.0
8558,0,8558,[318 427  64 132  98],330,5,40172,4.6935389648323405,60.0,0.0
8559,0,8559,[318 427  64 132  98],655,4,40176,4.6934579439252335,60.0,0.0
8560,0,8560,[318 427  64 132  98],450,5,40181,4.693493750730055,60.0,0.0
8561,0,8561,[318 427  64 132  98],316,5,40186,4.693529549170755,60.0,0.0
8562,0,8562,[318 427  64 132  98],796,5,40191,4.693565339250263,60.0,0.0
8563,0,8563,[318 427  64 132  98],716,5,40196,4.6936011209715085,60.0,0.0
8564,0,8564,[318 427  64 132  98],269,5,40201,4.69363689433742,60.0,0.0
8565,0,8565,[318 427  64 132  98],577,5,40206,4.693672659350923,60.0,0.0
8566,0,8566,[318 427  64 132  98],151,5,40211,4.693708416014941,60.0,0.0
8567,0,8567,[265  98 202 183 182],655,3,40214,4.693510737628385,0.0,0.0
8568,0,8568,[318 427  64 132  98],796,5,40219,4.693546504843039,60.0,0.0
8569,0,8569,[318 427  64 132  98],796,5,40224,4.693582263710619,60.0,0.0
8570,0,8570,[318 427  64 132  98],450,5,40229,4.693618014234045,60.0,0.0
8571,0,8571,[318 427  64 132  98],18,5,40234,4.693653756416239,60.0,0.0
8572,0,8572,[318 427  64 132  98],796,5,40239,4.693689490260119,60.0,0.0
8573,0,8573,[318 427  64 132  98],693,4,40243,4.693608584091439,60.0,0.0
8574,0,8574,[318 427  64 132  98],151,5,40248,4.693644314868805,60.0,0.0
8575,0,8575,[318 427  64 132  98],151,5,40253,4.693680037313433,60.0,0.0
8576,0,8576,[318 427  64 132  98],236,5,40258,4.693715751428238,60.0,0.0
8577,0,8577,[318 427  64 132  98],577,5,40263,4.693751457216134,60.0,0.0
8578,0,8578,[318 427  64 132  98],716,5,40268,4.693787154680033,60.0,0.0
8579,0,8579,[318 427  64 132  98],535,4,40272,4.693706293706294,60.0,0.0
8580,0,8580,[318 427  64 132  98],330,5,40277,4.693741988113273,60.0,0.0
8581,0,8581,[318 427  64 132  98],577,5,40282,4.693777674201818,60.0,0.0
8582,0,8582,[216 323 275 333 186],796,3,40285,4.693580333216824,0.0,20.0
8583,0,8583,[318 427  64 132  98],577,5,40290,4.693616029822927,60.0,0.0
8584,0,8584,[318 427  64 132  98],236,5,40295,4.693651718112988,60.0,0.0
8585,0,8585,[318 427  64 132  98],577,5,40300,4.693687398089914,60.0,0.0
8586,0,8586,[318 427  64 132  98],316,5,40305,4.693723069756609,60.0,0.0
8587,0,8587,[318 427  64 132  98],330,5,40310,4.693758733115976,60.0,0.0
8588,0,8588,[318 427  64 132  98],236,5,40315,4.693794388170916,60.0,0.0
8589,0,8589,[318 427  64 132  98],18,5,40320,4.69383003492433,60.0,0.0
8590,0,8590,[318 427  64 132  98],693,4,40324,4.693749272494471,60.0,0.0
8591,0,8591,[318 427  64 132  98],796,5,40329,4.693784916201118,60.0,0.0
8592,0,8592,[318 427  64 132  98],655,4,40333,4.693704177819155,60.0,0.0
8593,0,8593,[318 427  64 132  98],693,4,40337,4.69362345822667,60.0,0.0
8594,0,8594,[318 427  64 132  98],577,5,40342,4.693659104130308,60.0,0.0
8595,0,8595,[318 427  64 132  98],450,5,40347,4.6936947417403445,60.0,0.0
8596,0,8596,[318 427  64 132  98],269,5,40352,4.693730371059672,60.0,0.0
8597,0,8597,[318 427  64 132  98],716,5,40357,4.693765992091184,60.0,0.0
8598,0,8598,[318 427  64 132  98],655,4,40361,4.69368531224561,60.0,0.0
8599,0,8599,[318 427  64 132  98],535,4,40365,4.693604651162791,60.0,0.0
8600,0,8600,[318 427  64 132  98],535,4,40369,4.693524008836182,60.0,0.0
8601,0,8601,[318 427  64 132  98],330,5,40374,4.693559637293653,60.0,0.0
8602,0,8602,[318 427  64 132  98],151,5,40379,4.693595257468325,60.0,0.0
8603,0,8603,[245  95 197 222 294],450,3,40382,4.693398419339842,0.0,0.0
8604,0,8604,[318 427  64 132  98],316,5,40387,4.693434049970947,60.0,0.0
8605,0,8605,[318 427  64 132  98],716,5,40392,4.693469672321636,60.0,0.0
8606,0,8606,[318 427  64 132  98],655,4,40396,4.693389101893807,60.0,0.0
8607,0,8607,[318 427  64 132  98],330,5,40401,4.693424721189591,60.0,0.0
8608,0,8608,[318 427  64 132  98],796,5,40406,4.693460332210478,60.0,0.0
8609,0,8609,[318 427  64 132  98],655,4,40410,4.693379790940766,60.0,0.0
8610,0,8610,[318 427  64 132  98],655,4,40414,4.693299268377657,60.0,0.0
8611,0,8611,[318 427  64 132  98],577,5,40419,4.693334881560613,60.0,0.0
8612,0,8612,[318 427  64 132  98],796,5,40424,4.693370486473935,60.0,0.0
8613,0,8613,[318 427  64 132  98],18,5,40429,4.693406083120501,60.0,0.0
8614,0,8614,[318 427  64 132  98],450,5,40434,4.693441671503192,60.0,0.0
8615,0,8615,[318 427  64 132  98],330,5,40439,4.693477251624884,60.0,0.0
8616,0,8616,[318 427  64 132  98],655,4,40443,4.693396773819194,60.0,0.0
8617,0,8617,[ 56  97 125 183  82],577,4,40447,4.6933163146901835,0.0,0.0
8618,0,8618,[318 427  64 132  98],236,5,40452,4.693351896971807,60.0,0.0
8619,0,8619,[318 427  64 132  98],796,5,40457,4.6933874709976795,60.0,0.0
8620,0,8620,[318 427  64 132  98],716,5,40462,4.693423036770676,60.0,0.0
8621,0,8621,[318 427  64 132  98],655,4,40466,4.693342611922987,60.0,0.0
8622,0,8622,[318 427  64 132  98],269,5,40471,4.693378174649194,60.0,0.0
8623,0,8623,[318 427  64 132  98],316,5,40476,4.6934137291280145,60.0,0.0
8624,0,8624,[318 427  64 132  98],269,5,40481,4.693449275362319,60.0,0.0
8625,0,8625,[318 427  64 132  98],269,5,40486,4.693484813354973,60.0,0.0
8626,0,8626,[318 427  64 132  98],450,5,40491,4.693520343108844,60.0,0.0
8627,0,8627,[318 427  64 132  98],269,5,40496,4.693555864626797,60.0,0.0
8628,0,8628,[121   8 181 125 180],457,5,40501,4.693591377911694,0.0,0.0
8629,0,8629,[318 427  64 132  98],535,4,40505,4.69351100811124,60.0,0.0
8630,0,8630,[318 427  64 132  98],716,5,40510,4.693546518364037,60.0,0.0
8631,0,8631,[318 427  64 132  98],450,5,40515,4.6935820203892495,60.0,0.0
8632,0,8632,[318 427  64 132  98],236,5,40520,4.693617514189737,60.0,0.0
8633,0,8633,[318 427  64 132  98],796,5,40525,4.693652999768358,60.0,0.0
8634,0,8634,[318 427  64 132  98],151,5,40530,4.693688477127967,60.0,0.0
8635,0,8635,[318 427  64 132  98],796,5,40535,4.6937239462714215,60.0,0.0
8636,0,8636,[318 427  64 132  98],796,5,40540,4.693759407201575,60.0,0.0
8637,0,8637,[318 427  64 132  98],330,5,40545,4.693794859921278,60.0,0.0
8638,0,8638,[318 427  64 132  98],796,5,40550,4.693830304433384,60.0,0.0
8639,0,8639,[318 427  64 132  98],796,5,40555,4.6938657407407405,60.0,0.0
8640,0,8640,[318 427  64 132  98],236,5,40560,4.693901168846199,60.0,0.0
8641,0,8641,[318 427  64 132  98],796,5,40565,4.693936588752604,60.0,0.0
8642,0,8642,[318 427  64 132  98],693,4,40569,4.693856299895869,60.0,0.0
8643,0,8643,[318 427  64 132  98],796,5,40574,4.693891716797779,60.0,0.0
8644,0,8644,[318 427  64 132  98],330,5,40579,4.693927125506073,60.0,0.0
8645,0,8645,[318 427  64 132  98],535,4,40583,4.693846865602591,60.0,0.0
8646,0,8646,[318 427  64 132  98],535,4,40587,4.69376662426275,60.0,0.0
8647,0,8647,[318 427  64 132  98],693,4,40591,4.693686401480111,60.0,0.0
8648,0,8648,[318 427  64 132  98],450,5,40596,4.693721817551162,60.0,0.0
8649,0,8649,[318 427  64 132  98],330,5,40601,4.693757225433526,60.0,0.0
8650,0,8650,[318 427  64 132  98],316,5,40606,4.693792625130043,60.0,0.0
8651,0,8651,[ 71 313 508 111 269],344,3,40609,4.693596856218216,0.0,0.0
8652,0,8652,[318 427  64 132  98],18,5,40614,4.693632266266035,60.0,0.0
8653,0,8653,[318 427  64 132  98],18,5,40619,4.693667668130344,60.0,0.0
8654,0,8654,[318 427  64 132  98],236,5,40624,4.693703061813981,60.0,0.0
8655,0,8655,[318 427  64 132  98],18,5,40629,4.693738447319778,60.0,0.0
8656,0,8656,[318 427  64 132  98],693,4,40633,4.693658311193254,60.0,0.0
8657,0,8657,[318 427  64 132  98],716,5,40638,4.693693693693693,60.0,0.0
8658,0,8658,[318 427  64 132  98],236,5,40643,4.693729068021711,60.0,0.0
8659,0,8659,[318 427  64 132  98],236,5,40648,4.693764434180139,60.0,0.0
8660,0,8660,[318 427  64 132  98],330,5,40653,4.693799792171805,60.0,0.0
8661,0,8661,[318 427  64 132  98],535,4,40657,4.693719695220503,60.0,0.0
8662,0,8662,[318 427  64 132  98],577,5,40662,4.693755050213552,60.0,0.0
8663,0,8663,[127 568 300 181 222],655,1,40663,4.693328716528162,0.0,20.0
8664,0,8664,[318 427  64 132  98],577,5,40668,4.693364108482401,60.0,0.0
8665,0,8665,[318 427  64 132  98],535,4,40672,4.693284098776829,60.0,0.0
8666,0,8666,[318 427  64 132  98],236,5,40677,4.693319487712011,60.0,0.0
8667,0,8667,[318 427  64 132  98],316,5,40682,4.693354868481772,60.0,0.0
8668,0,8668,[318 427  64 132  98],316,5,40687,4.693390241088937,60.0,0.0
8669,0,8669,[318 427  64 132  98],18,5,40692,4.693425605536333,60.0,0.0
8670,0,8670,[318 427  64 132  98],655,4,40696,4.69334563487487,60.0,0.0
8671,0,8671,[318 427  64 132  98],450,5,40701,4.693380996309963,60.0,0.0
8672,0,8672,[318 427  64 132  98],450,5,40706,4.6934163495906835,60.0,0.0
8673,0,8673,[318 427  64 132  98],236,5,40711,4.693451694719853,60.0,0.0
8674,0,8674,[318 427  64 132  98],269,5,40716,4.693487031700288,60.0,0.0
8675,0,8675,[318 427  64 132  98],330,5,40721,4.693522360534809,60.0,0.0
8676,0,8676,[318 427  64 132  98],269,5,40726,4.69355768122623,60.0,0.0
8677,0,8677,[318 427  64 132  98],18,5,40731,4.693592993777368,60.0,0.0
8678,0,8678,[132 183 742 111  50],577,5,40736,4.693628298191036,0.0,20.0
8679,0,8679,[318 427  64 132  98],236,5,40741,4.693663594470046,60.0,0.0
8680,0,8680,[318 427  64 132  98],716,5,40746,4.69369888261721,60.0,0.0
8681,0,8681,[318 427  64 132  98],151,5,40751,4.693734162635337,60.0,0.0
8682,0,8682,[318 427  64 132  98],236,5,40756,4.693769434527237,60.0,0.0
8683,0,8683,[318 427  64 132  98],330,5,40761,4.6938046982957164,60.0,0.0
8684,0,8684,[318 427  64 132  98],716,5,40766,4.693839953943581,60.0,0.0
8685,0,8685,[318 427  64 132  98],151,5,40771,4.693875201473635,60.0,0.0
8686,0,8686,[318 427  64 132  98],269,5,40776,4.6939104408886845,60.0,0.0
8687,0,8687,[318 427  64 132  98],316,5,40781,4.6939456721915285,60.0,0.0
8688,0,8688,[318 427  64 132  98],316,5,40786,4.6939808953849695,60.0,0.0
8689,0,8689,[318 427  64 132  98],693,4,40790,4.693901035673187,60.0,0.0
8690,0,8690,[318 427  64 132  98],236,5,40795,4.693936255896904,60.0,0.0
8691,0,8691,[318 427  64 132  98],330,5,40800,4.693971468016567,60.0,0.0
8692,0,8692,[318 427  64 132  98],18,5,40805,4.694006672034971,60.0,0.0
8693,0,8693,[318 427  64 132  98],693,4,40809,4.6939268461007595,60.0,0.0
8694,0,8694,[318 427  64 132  98],716,5,40814,4.693962047153536,60.0,0.0
8695,0,8695,[318 427  64 132  98],18,5,40819,4.693997240110396,60.0,0.0
8696,0,8696,[318 427  64 132  98],18,5,40824,4.694032424974129,60.0,0.0
8697,0,8697,[318 427  64 132  98],535,4,40828,4.693952632789147,60.0,0.0
8698,0,8698,[318 427  64 132  98],151,5,40833,4.693987814691344,60.0,0.0
8699,0,8699,[318 427  64 132  98],693,4,40837,4.693908045977011,60.0,0.0
8700,0,8700,[275  56 191 603 173],23,4,40841,4.693828295598207,20.0,20.0
8701,0,8701,[318 427  64 132  98],693,4,40845,4.69374856354861,60.0,0.0
8702,0,8702,[318 427  64 132  98],716,5,40850,4.693783752728944,60.0,0.0
8703,0,8703,[318 427  64 132  98],450,5,40855,4.693818933823529,60.0,0.0
8704,0,8704,[318 427  64 132  98],577,5,40860,4.693854106835152,60.0,0.0
8705,0,8705,[318 427  64 132  98],18,5,40865,4.693889271766598,60.0,0.0
8706,0,8706,[318 427  64 132  98],18,5,40870,4.69392442862065,60.0,0.0
8707,0,8707,[318 427  64 132  98],796,5,40875,4.693959577400092,60.0,0.0
8708,0,8708,[318 427  64 132  98],655,4,40879,4.693879894362154,60.0,0.0
8709,0,8709,[318 427  64 132  98],151,5,40884,4.693915040183697,60.0,0.0
8710,0,8710,[318 427  64 132  98],716,5,40889,4.693950177935943,60.0,0.0
8711,0,8711,[318 427  64 132  98],796,5,40894,4.693985307621671,60.0,0.0
8712,0,8712,[318 427  64 132  98],18,5,40899,4.6940204292436585,60.0,0.0
8713,0,8713,[318 427  64 132  98],693,4,40903,4.693940784943768,60.0,0.0
8714,0,8714,[318 427  64 132  98],796,5,40908,4.693975903614458,60.0,0.0
8715,0,8715,[318 427  64 132  98],716,5,40913,4.694011014226709,60.0,0.0
8716,0,8716,[318 427  64 132  98],796,5,40918,4.694046116783297,60.0,0.0
8717,0,8717,[318 427  64 132  98],693,4,40922,4.693966506079376,60.0,0.0
8718,0,8718,[318 427  64 132  98],693,4,40926,4.693886913636885,60.0,0.0
8719,0,8719,[318 427  64 132  98],693,4,40930,4.693807339449541,60.0,0.0
8720,0,8720,[318 427  64 132  98],316,5,40935,4.693842449260406,60.0,0.0
8721,0,8721,[318 427  64 132  98],269,5,40940,4.6938775510204085,60.0,0.0
8722,0,8722,[318 427  64 132  98],577,5,40945,4.6939126447323165,60.0,0.0
8723,0,8723,[318 427  64 132  98],655,4,40949,4.693833104080697,60.0,0.0
8724,0,8724,[318 427  64 132  98],655,4,40953,4.693753581661891,60.0,0.0
8725,0,8725,[318 427  64 132  98],693,4,40957,4.693674077469631,60.0,0.0
8726,0,8726,[318 427  64 132  98],236,5,40962,4.693709178411825,60.0,0.0
8727,0,8727,[318 427  64 132  98],269,5,40967,4.693744271310724,60.0,0.0
8728,0,8728,[318 427  64 132  98],693,4,40971,4.693664795509222,60.0,0.0
8729,0,8729,[318 427  64 132  98],330,5,40976,4.693699885452463,60.0,0.0
8730,0,8730,[318 427  64 132  98],693,4,40980,4.693620432940098,60.0,0.0
8731,0,8731,[318 427  64 132  98],151,5,40985,4.693655519926707,60.0,0.0
8732,0,8732,[318 427  64 132  98],236,5,40990,4.6936905988778195,60.0,0.0
8733,0,8733,[318 427  64 132  98],316,5,40995,4.693725669796199,60.0,0.0
8734,0,8734,[318 427  64 132  98],236,5,41000,4.693760732684602,60.0,0.0
8735,0,8735,[318 427  64 132  98],655,4,41004,4.693681318681318,60.0,0.0
8736,0,8736,[318 427  64 132  98],693,4,41008,4.693601922856816,60.0,0.0
8737,0,8737,[318 427  64 132  98],535,4,41012,4.693522545204853,60.0,0.0
8738,0,8738,[318 427  64 132  98],693,4,41016,4.69344318571919,60.0,0.0
8739,0,8739,[318 427  64 132  98],151,5,41021,4.693478260869565,60.0,0.0
8740,0,8740,[172 117 257 405 144],457,4,41025,4.693398924608168,0.0,0.0
8741,0,8741,[318 427  64 132  98],269,5,41030,4.693433996797071,60.0,0.0
8742,0,8742,[318 427  64 132  98],269,5,41035,4.693469060963056,60.0,0.0
8743,0,8743,[318 427  64 132  98],236,5,41040,4.6935041171088745,60.0,0.0
8744,0,8744,[318 427  64 132  98],236,5,41045,4.693539165237278,60.0,0.0
8745,0,8745,[318 427  64 132  98],577,5,41050,4.693574205351018,60.0,0.0
8746,0,8746,[301 300  64 118 483],796,4,41054,4.693494912541443,20.0,0.0
8747,0,8747,[318 427  64 132  98],269,5,41059,4.693529949702789,60.0,0.0
8748,0,8748,[318 427  64 132  98],655,4,41063,4.693450680077723,60.0,0.0
8749,0,8749,[318 427  64 132  98],655,4,41067,4.693371428571429,60.0,0.0
8750,0,8750,[318 427  64 132  98],655,4,41071,4.693292195177694,60.0,0.0
8751,0,8751,[318 427  64 132  98],330,5,41076,4.693327239488117,60.0,0.0
8752,0,8752,[318 427  64 132  98],796,5,41081,4.6933622757911575,60.0,0.0
8753,0,8753,[318 427  64 132  98],151,5,41086,4.693397304089559,60.0,0.0
8754,0,8754,[318 427  64 132  98],316,5,41091,4.693432324386065,60.0,0.0
8755,0,8755,[318 427  64 132  98],450,5,41096,4.693467336683417,60.0,0.0
8756,0,8756,[318 427  64 132  98],151,5,41101,4.693502340984355,60.0,0.0
8757,0,8757,[318 427  64 132  98],796,5,41106,4.693537337291619,60.0,0.0
8758,0,8758,[318 427  64 132  98],18,5,41111,4.6935723256079465,60.0,0.0
8759,0,8759,[318 427  64 132  98],269,5,41116,4.693607305936073,60.0,0.0
8760,0,8760,[318 427  64 132  98],236,5,41121,4.693642278278736,60.0,0.0
8761,0,8761,[318 427  64 132  98],577,5,41126,4.693677242638667,60.0,0.0
8762,0,8762,[144 200   4 357  64],629,4,41130,4.6935980828483395,20.0,0.0
8763,0,8763,[318 427  64 132  98],693,4,41134,4.693518941122775,60.0,0.0
8764,0,8764,[318 427  64 132  98],535,4,41138,4.69343981745579,60.0,0.0
8765,0,8765,[318 427  64 132  98],236,5,41143,4.693474788957335,60.0,0.0
8766,0,8766,[318 427  64 132  98],535,4,41147,4.693395688376868,60.0,0.0
8767,0,8767,[318 427  64 132  98],693,4,41151,4.693316605839416,60.0,0.0
8768,0,8768,[318 427  64 132  98],796,5,41156,4.693351579427529,60.0,0.0
8769,0,8769,[318 427  64 132  98],716,5,41161,4.693386545039909,60.0,0.0
8770,0,8770,[318 427  64 132  98],151,5,41166,4.693421502679284,60.0,0.0
8771,0,8771,[318 427  64 132  98],18,5,41171,4.693456452348381,60.0,0.0
8772,0,8772,[318 427  64 132  98],18,5,41176,4.693491394049926,60.0,0.0
8773,0,8773,[318 427  64 132  98],316,5,41181,4.693526327786643,60.0,0.0
8774,0,8774,[318 427  64 132  98],577,5,41186,4.693561253561254,60.0,0.0
8775,0,8775,[318 427  64 132  98],330,5,41191,4.693596171376481,60.0,0.0
8776,0,8776,[318 427  64 132  98],330,5,41196,4.693631081235046,60.0,0.0
8777,0,8777,[318 427  64 132  98],693,4,41200,4.693552061973115,60.0,0.0
8778,0,8778,[318 427  64 132  98],269,5,41205,4.693586968903064,60.0,0.0
8779,0,8779,[318 427  64 132  98],450,5,41210,4.693621867881549,60.0,0.0
8780,0,8780,[318 427  64 132  98],236,5,41215,4.693656758911286,60.0,0.0
8781,0,8781,[318 427  64 132  98],716,5,41220,4.69369164199499,60.0,0.0
8782,0,8782,[318 427  64 132  98],655,4,41224,4.693612660822042,60.0,0.0
8783,0,8783,[222 111 151 168   1],796,4,41228,4.693533697632058,0.0,0.0
8784,0,8784,[318 427  64 132  98],577,5,41233,4.6935685828116105,60.0,0.0
8785,0,8785,[318 427  64 132  98],577,5,41238,4.693603460050079,60.0,0.0
8786,0,8786,[318 427  64 132  98],655,4,41242,4.693524524866279,60.0,0.0
8787,0,8787,[318 427  64 132  98],535,4,41246,4.693445607646791,60.0,0.0
8788,0,8788,[318 427  64 132  98],236,5,41251,4.693480486972351,60.0,0.0
8789,0,8789,[318 427  64 132  98],535,4,41255,4.693401592718999,60.0,0.0
8790,0,8790,[318 427  64 132  98],316,5,41260,4.693436469116142,60.0,0.0
8791,0,8791,[318 427  64 132  98],655,4,41264,4.693357597816196,60.0,0.0
8792,0,8792,[318 427  64 132  98],18,5,41269,4.693392471283976,60.0,0.0
8793,0,8793,[318 427  64 132  98],18,5,41274,4.69342733682056,60.0,0.0
8794,0,8794,[318 427  64 132  98],535,4,41278,4.693348493462194,60.0,0.0
8795,0,8795,[318 427  64 132  98],693,4,41282,4.693269668030923,60.0,0.0
8796,0,8796,[318 427  64 132  98],330,5,41287,4.693304535637149,60.0,0.0
8797,0,8797,[423 168 237 204 568],796,5,41292,4.693339395317118,0.0,0.0
8798,0,8798,[168 322  12 174 143],450,5,41297,4.693374247073531,0.0,0.0
8799,0,8799,[318 427  64 132  98],535,4,41301,4.693295454545455,60.0,0.0
8800,0,8800,[235  95 483 180 496],450,2,41303,4.692989433018975,20.0,0.0
8801,0,8801,[318 427  64 132  98],535,4,41307,4.692910702113156,60.0,0.0
8802,0,8802,[318 427  64 132  98],316,5,41312,4.692945586731796,60.0,0.0
8803,0,8803,[318 427  64 132  98],151,5,41317,4.692980463425716,60.0,0.0
8804,0,8804,[318 427  64 132  98],693,4,41321,4.69290176036343,60.0,0.0
8805,0,8805,[318 427  64 132  98],796,5,41326,4.692936634113105,60.0,0.0
8806,0,8806,[318 427  64 132  98],796,5,41331,4.692971499943227,60.0,0.0
8807,0,8807,[318 427  64 132  98],535,4,41335,4.692892824704813,60.0,0.0
8808,0,8808,[318 427  64 132  98],535,4,41339,4.692814167328868,60.0,0.0
8809,0,8809,[318 427  64 132  98],269,5,41344,4.692849035187288,60.0,0.0
8810,0,8810,[318 427  64 132  98],535,4,41348,4.6927704006355695,60.0,0.0
8811,0,8811,[318 427  64 132  98],655,4,41352,4.692691783931004,60.0,0.0
8812,0,8812,[318 427  64 132  98],18,5,41357,4.692726653806877,60.0,0.0
8813,0,8813,[318 427  64 132  98],535,4,41361,4.692648059904697,60.0,0.0
8814,0,8814,[318 427  64 132  98],796,5,41366,4.692682926829268,60.0,0.0
8815,0,8815,[275 603 288 194  98],450,4,41370,4.692604355716878,20.0,20.0
8816,0,8816,[216 117  28 268  15],174,5,41375,4.692639219689236,0.0,0.0
8817,0,8817,[318 427  64 132  98],716,5,41380,4.692674075754139,60.0,0.0
8818,0,8818,[318 427  64 132  98],577,5,41385,4.692708923914276,60.0,0.0
8819,0,8819,[318 427  64 132  98],655,4,41389,4.692630385487528,60.0,0.0
8820,0,8820,[318 427  64 132  98],316,5,41394,4.692665230699467,60.0,0.0
8821,0,8821,[318 427  64 132  98],316,5,41399,4.6927000680117885,60.0,0.0
8822,0,8822,[318 427  64 132  98],577,5,41404,4.6927348974271785,60.0,0.0
8823,0,8823,[318 427  64 132  98],269,5,41409,4.692769718948322,60.0,0.0
8824,0,8824,[ 56 268   9 271  97],655,0,41409,4.692237960339943,0.0,0.0
8825,0,8825,[318 427  64 132  98],269,5,41414,4.69227283027419,60.0,0.0
8826,0,8826,[318 427  64 132  98],236,5,41419,4.6923076923076925,60.0,0.0
8827,0,8827,[333 471 301 568 100],655,0,41419,4.691776166742184,0.0,20.0
8828,0,8828,[318 427  64 132  98],450,5,41424,4.691811077132178,60.0,0.0
8829,0,8829,[318 427  64 132  98],577,5,41429,4.691845979614949,60.0,0.0
8830,0,8830,[318 427  64 132  98],655,4,41433,4.691767636734232,60.0,0.0
8831,0,8831,[318 427  64 132  98],236,5,41438,4.691802536231884,60.0,0.0
8832,0,8832,[318 427  64 132  98],716,5,41443,4.6918374278274655,60.0,0.0
8833,0,8833,[318 427  64 132  98],796,5,41448,4.6918723115236585,60.0,0.0
8834,0,8834,[318 427  64 132  98],330,5,41453,4.691907187323147,60.0,0.0
8835,0,8835,[318 427  64 132  98],151,5,41458,4.69194205522861,60.0,0.0
8836,0,8836,[357 276 197 269 268],535,2,41460,4.691637433518162,0.0,0.0
8837,0,8837,[318 427  64 132  98],18,5,41465,4.691672324055216,60.0,0.0
8838,0,8838,[318 427  64 132  98],655,4,41469,4.691594071727571,60.0,0.0
8839,0,8839,[318 427  64 132  98],693,4,41473,4.691515837104072,60.0,0.0
8840,0,8840,[318 427  64 132  98],330,5,41478,4.69155072955548,60.0,0.0
8841,0,8841,[318 427  64 132  98],535,4,41482,4.691472517529971,60.0,0.0
8842,0,8842,[318 427  64 132  98],316,5,41487,4.6915074069885785,60.0,0.0
8843,0,8843,[318 427  64 132  98],577,5,41492,4.691542288557214,60.0,0.0
8844,0,8844,[318 427  64 132  98],716,5,41497,4.691577162238553,60.0,0.0
8845,0,8845,[318 427  64 132  98],450,5,41502,4.69161202803527,60.0,0.0
8846,0,8846,[318 427  64 132  98],151,5,41507,4.69164688595004,60.0,0.0
8847,0,8847,[318 427  64 132  98],151,5,41512,4.691681735985534,60.0,0.0
8848,0,8848,[318 427  64 132  98],693,4,41516,4.691603571024975,60.0,0.0
8849,0,8849,[318 427  64 132  98],655,4,41520,4.691525423728813,60.0,0.0
8850,0,8850,[318 427  64 132  98],330,5,41525,4.691560275675065,60.0,0.0
8851,0,8851,[318 427  64 132  98],796,5,41530,4.69159511974695,60.0,0.0
8852,0,8852,[318 427  64 132  98],236,5,41535,4.691629955947136,60.0,0.0
8853,0,8853,[318 427  64 132  98],796,5,41540,4.691664784278292,60.0,0.0
8854,0,8854,[318 427  64 132  98],577,5,41545,4.691699604743083,60.0,0.0
8855,0,8855,[318 427  64 132  98],316,5,41550,4.691734417344174,60.0,0.0
8856,0,8856,[318 427  64 132  98],316,5,41555,4.691769222084227,60.0,0.0
8857,0,8857,[318 427  64 132  98],796,5,41560,4.6918040189659065,60.0,0.0
8858,0,8858,[318 427  64 132  98],316,5,41565,4.691838807991872,60.0,0.0
8859,0,8859,[318 427  64 132  98],655,4,41569,4.69176072234763,60.0,0.0
8860,0,8860,[318 427  64 132  98],450,5,41574,4.691795508407629,60.0,0.0
8861,0,8861,[318 427  64 132  98],269,5,41579,4.691830286617017,60.0,0.0
8862,0,8862,[318 427  64 132  98],269,5,41584,4.6918650569784495,60.0,0.0
8863,0,8863,[318 427  64 132  98],577,5,41589,4.6918998194945845,60.0,0.0
8864,0,8864,[318 427  64 132  98],450,5,41594,4.6919345741680765,60.0,0.0
8865,0,8865,[318 427  64 132  98],716,5,41599,4.691969321001579,60.0,0.0
8866,0,8866,[318 427  64 132  98],151,5,41604,4.692004059997744,60.0,0.0
8867,0,8867,[318 427  64 132  98],535,4,41608,4.69192602616148,60.0,0.0
8868,0,8868,[318 427  64 132  98],18,5,41613,4.691960762205435,60.0,0.0
8869,0,8869,[318 427  64 132  98],535,4,41617,4.691882750845547,60.0,0.0
8870,0,8870,[318 427  64 132  98],18,5,41622,4.691917483936422,60.0,0.0
8871,0,8871,[318 427  64 132  98],693,4,41626,4.691839495040577,60.0,0.0
8872,0,8872,[318 427  64 132  98],577,5,41631,4.6918742251775045,60.0,0.0
8873,0,8873,[318 427  64 132  98],693,4,41635,4.691796258733379,60.0,0.0
8874,0,8874,[318 427  64 132  98],330,5,41640,4.691830985915493,60.0,0.0
8875,0,8875,[318 427  64 132  98],450,5,41645,4.691865705272646,60.0,0.0
8876,0,8876,[318 427  64 132  98],316,5,41650,4.69190041680748,60.0,0.0
8877,0,8877,[318 427  64 132  98],450,5,41655,4.69193512052264,60.0,0.0
8878,0,8878,[318 427  64 132  98],18,5,41660,4.691969816420768,60.0,0.0
8879,0,8879,[318 427  64 132  98],796,5,41665,4.692004504504505,60.0,0.0
8880,0,8880,[318 427  64 132  98],716,5,41670,4.6920391847764895,60.0,0.0
8881,0,8881,[318 427  64 132  98],151,5,41675,4.69207385723936,60.0,0.0
8882,0,8882,[318 427  64 132  98],577,5,41680,4.692108521895756,60.0,0.0
8883,0,8883,[318 427  64 132  98],236,5,41685,4.692143178748312,60.0,0.0
8884,0,8884,[318 427  64 132  98],577,5,41690,4.692177827799663,60.0,0.0
8885,0,8885,[318 427  64 132  98],577,5,41695,4.692212469052442,60.0,0.0
8886,0,8886,[318 427  64 132  98],655,4,41699,4.692134578597952,60.0,0.0
8887,0,8887,[318 427  64 132  98],450,5,41704,4.692169216921692,60.0,0.0
8888,0,8888,[318 427  64 132  98],796,5,41709,4.692203847451907,60.0,0.0
8889,0,8889,[318 427  64 132  98],269,5,41714,4.692238470191226,60.0,0.0
8890,0,8890,[318 427  64 132  98],316,5,41719,4.692273085142279,60.0,0.0
8891,0,8891,[318 427  64 132  98],330,5,41724,4.6923076923076925,60.0,0.0
8892,0,8892,[318 427  64 132  98],716,5,41729,4.692342291690093,60.0,0.0
8893,0,8893,[318 427  64 132  98],796,5,41734,4.692376883292107,60.0,0.0
8894,0,8894,[318 427  64 132  98],450,5,41739,4.692411467116358,60.0,0.0
8895,0,8895,[318 427  64 132  98],450,5,41744,4.692446043165468,60.0,0.0
8896,0,8896,[318 427  64 132  98],716,5,41749,4.692480611442059,60.0,0.0
8897,0,8897,[ 97 483 182 174 237],18,4,41753,4.692402787143179,0.0,0.0
8898,0,8898,[318 427  64 132  98],716,5,41758,4.692437352511518,60.0,0.0
8899,0,8899,[318 427  64 132  98],796,5,41763,4.69247191011236,60.0,0.0
8900,0,8900,[143  69 427 187 508],269,3,41766,4.692281766093697,20.0,0.0
8901,0,8901,[318 427  64 132  98],450,5,41771,4.692316333408223,60.0,0.0
8902,0,8902,[318 427  64 132  98],577,5,41776,4.69235089295743,60.0,0.0
8903,0,8903,[318 427  64 132  98],269,5,41781,4.692385444743936,60.0,0.0
8904,0,8904,[318 427  64 132  98],316,5,41786,4.692419988770354,60.0,0.0
8905,0,8905,[318 427  64 132  98],330,5,41791,4.6924545250393,60.0,0.0
8906,0,8906,[318 427  64 132  98],18,5,41796,4.692489053553385,60.0,0.0
8907,0,8907,[318 427  64 132  98],316,5,41801,4.6925235743152225,60.0,0.0
8908,0,8908,[318 427  64 132  98],269,5,41806,4.692558087327422,60.0,0.0
8909,0,8909,[318 427  64 132  98],693,4,41810,4.692480359147026,60.0,0.0
8910,0,8910,[318 427  64 132  98],796,5,41815,4.692514869262709,60.0,0.0
8911,0,8911,[318 427  64 132  98],450,5,41820,4.692549371633752,60.0,0.0
8912,0,8912,[318 427  64 132  98],450,5,41825,4.692583866262762,60.0,0.0
8913,0,8913,[318 427  64 132  98],693,4,41829,4.692506170069554,60.0,0.0
8914,0,8914,[318 427  64 132  98],655,4,41833,4.692428491306786,60.0,0.0
8915,0,8915,[318 427  64 132  98],655,4,41837,4.692350829968595,60.0,0.0
8916,0,8916,[318 427  64 132  98],151,5,41842,4.692385331389481,60.0,0.0
8917,0,8917,[318 427  64 132  98],236,5,41847,4.692419825072887,60.0,0.0
8918,0,8918,[144 202 151 118 174],450,4,41851,4.692342190828568,0.0,0.0
8919,0,8919,[318 427  64 132  98],655,4,41855,4.692264573991031,60.0,0.0
8920,0,8920,[318 427  64 132  98],796,5,41860,4.69229906961103,60.0,0.0
8921,0,8921,[318 427  64 132  98],693,4,41864,4.692221475005604,60.0,0.0
8922,0,8922,[318 427  64 132  98],716,5,41869,4.6922559677238596,60.0,0.0
8923,0,8923,[318 427  64 132  98],535,4,41873,4.692178395338413,60.0,0.0
8924,0,8924,[318 427  64 132  98],535,4,41877,4.692100840336135,60.0,0.0
8925,0,8925,[318 427  64 132  98],450,5,41882,4.692135334976474,60.0,0.0
8926,0,8926,[318 427  64 132  98],236,5,41887,4.692169821888652,60.0,0.0
8927,0,8927,[318 427  64 132  98],535,4,41891,4.69209229390681,60.0,0.0
8928,0,8928,[318 427  64 132  98],450,5,41896,4.69212677791466,60.0,0.0
8929,0,8929,[318 427  64 132  98],577,5,41901,4.692161254199328,60.0,0.0
8930,0,8930,[318 427  64 132  98],716,5,41906,4.692195722763408,60.0,0.0
8931,0,8931,[318 427  64 132  98],535,4,41910,4.692118226600985,60.0,0.0
8932,0,8932,[318 427  64 132  98],236,5,41915,4.692152692264637,60.0,0.0
8933,0,8933,[318 427  64 132  98],151,5,41920,4.69218715021267,60.0,0.0
8934,0,8934,[318 427  64 132  98],577,5,41925,4.692221600447677,60.0,0.0
8935,0,8935,[318 427  64 132  98],693,4,41929,4.692144136078783,60.0,0.0
8936,0,8936,[318 427  64 132  98],577,5,41934,4.692178583417254,60.0,0.0
8937,0,8937,[318 427  64 132  98],316,5,41939,4.692213023047661,60.0,0.0
8938,0,8938,[318 427  64 132  98],535,4,41943,4.692135585635977,60.0,0.0
8939,0,8939,[318 427  64 132  98],796,5,41948,4.692170022371364,60.0,0.0
8940,0,8940,[318 427  64 132  98],236,5,41953,4.692204451403646,60.0,0.0
8941,0,8941,[318 427  64 132  98],18,5,41958,4.692238872735406,60.0,0.0
8942,0,8942,[318 427  64 132  98],316,5,41963,4.692273286369227,60.0,0.0
8943,0,8943,[318 427  64 132  98],330,5,41968,4.6923076923076925,60.0,0.0
8944,0,8944,[318 427  64 132  98],330,5,41973,4.692342090553382,60.0,0.0
8945,0,8945,[318 427  64 132  98],693,4,41977,4.692264699306953,60.0,0.0
8946,0,8946,[318 427  64 132  98],535,4,41981,4.6921873253604565,60.0,0.0
8947,0,8947,[318 427  64 132  98],450,5,41986,4.692221725525257,60.0,0.0
8948,0,8948,[183 185 588 153 603],911,5,41991,4.692256118002011,20.0,0.0
8949,0,8949,[318 427  64 132  98],693,4,41995,4.69217877094972,60.0,0.0
8950,0,8950,[318 427  64 132  98],450,5,42000,4.692213160540722,60.0,0.0
8951,0,8951,[318 427  64 132  98],236,5,42005,4.692247542448615,60.0,0.0
8952,0,8952,[318 427  64 132  98],236,5,42010,4.692281916675975,60.0,0.0
8953,0,8953,[318 427  64 132  98],316,5,42015,4.692316283225374,60.0,0.0
8954,0,8954,[318 427  64 132  98],716,5,42020,4.6923506420993855,60.0,0.0
8955,0,8955,[318 427  64 132  98],151,5,42025,4.692384993300581,60.0,0.0
8956,0,8956,[318 427  64 132  98],535,4,42029,4.6923076923076925,60.0,0.0
8957,0,8957,[318 427  64 132  98],316,5,42034,4.69234204063407,60.0,0.0
8958,0,8958,[318 427  64 132  98],577,5,42039,4.692376381292555,60.0,0.0
8959,0,8959,[318 427  64 132  98],655,4,42043,4.6922991071428575,60.0,0.0
8960,0,8960,[318 427  64 132  98],577,5,42048,4.692333444928021,60.0,0.0
8961,0,8961,[603 191 301 423 302],450,5,42053,4.692367775050212,20.0,0.0
8962,0,8962,[318 427  64 132  98],716,5,42058,4.6924020975119936,60.0,0.0
8963,0,8963,[318 427  64 132  98],18,5,42063,4.692436412315931,60.0,0.0
8964,0,8964,[ 79 357  98  50 216],719,4,42067,4.6923591745677635,0.0,20.0
8965,0,8965,[318 427  64 132  98],796,5,42072,4.692393486504573,60.0,0.0
8966,0,8966,[318 427  64 132  98],151,5,42077,4.692427790788447,60.0,0.0
8967,0,8967,[318 427  64 132  98],236,5,42082,4.692462087421944,60.0,0.0
8968,0,8968,[318 427  64 132  98],18,5,42087,4.692496376407626,60.0,0.0
8969,0,8969,[318 427  64 132  98],18,5,42092,4.6925306577480494,60.0,0.0
8970,0,8970,[318 427  64 132  98],535,4,42096,4.692453461152603,60.0,0.0
8971,0,8971,[318 427  64 132  98],655,4,42100,4.692376281765493,60.0,0.0
8972,0,8972,[318 427  64 132  98],151,5,42105,4.6924105650284185,60.0,0.0
8973,0,8973,[318 427  64 132  98],151,5,42110,4.692444840650769,60.0,0.0
8974,0,8974,[318 427  64 132  98],151,5,42115,4.692479108635098,60.0,0.0
8975,0,8975,[318 427  64 132  98],330,5,42120,4.692513368983957,60.0,0.0
8976,0,8976,[318 427  64 132  98],330,5,42125,4.6925476216999,60.0,0.0
8977,0,8977,[318 427  64 132  98],151,5,42130,4.692581866785476,60.0,0.0
8978,0,8978,[318 427  64 132  98],236,5,42135,4.692616104243235,60.0,0.0
8979,0,8979,[318 427  64 132  98],316,5,42140,4.692650334075724,60.0,0.0
8980,0,8980,[318 427  64 132  98],716,5,42145,4.692684556285491,60.0,0.0
8981,0,8981,[318 427  64 132  98],693,4,42149,4.692607437096415,60.0,0.0
8982,0,8982,[318 427  64 132  98],330,5,42154,4.692641656462206,60.0,0.0
8983,0,8983,[318 427  64 132  98],269,5,42159,4.692675868210151,60.0,0.0
8984,0,8984,[318 427  64 132  98],151,5,42164,4.692710072342794,60.0,0.0
8985,0,8985,[318 427  64 132  98],535,4,42168,4.692632984642778,60.0,0.0
8986,0,8986,[318 427  64 132  98],18,5,42173,4.69266718593524,60.0,0.0
8987,0,8987,[318 427  64 132  98],450,5,42178,4.692701379617268,60.0,0.0
8988,0,8988,[318 427  64 132  98],236,5,42183,4.6927355656914,60.0,0.0
8989,0,8989,[318 427  64 132  98],269,5,42188,4.692769744160178,60.0,0.0
8990,0,8990,[318 427  64 132  98],151,5,42193,4.692803915026137,60.0,0.0
8991,0,8991,[318 427  64 132  98],330,5,42198,4.692838078291815,60.0,0.0
8992,0,8992,[268  69 238 143  89],269,2,42200,4.692538641165351,0.0,0.0
8993,0,8993,[318 427  64 132  98],236,5,42205,4.6925728263286635,60.0,0.0
8994,0,8994,[318 427  64 132  98],655,4,42209,4.692495831017232,60.0,0.0
8995,0,8995,[318 427  64 132  98],236,5,42214,4.692530013339262,60.0,0.0
8996,0,8996,[153 568 180  25 183],716,3,42217,4.692341891741692,0.0,0.0
8997,0,8997,[318 427  64 132  98],18,5,42222,4.6923760835741275,60.0,0.0
8998,0,8998,[ 89   4 111 181 427],18,1,42223,4.691965773974886,20.0,0.0
8999,0,8999,[318 427  64 132  98],716,5,42228,4.692,60.0,0.0
9000,0,9000,[318 427  64 132  98],450,5,42233,4.692034218420176,60.0,0.0
9001,0,9001,[318 427  64 132  98],655,4,42237,4.691957342812708,60.0,0.0
9002,0,9002,[318 427  64 132  98],330,5,42242,4.691991558369432,60.0,0.0
9003,0,9003,[318 427  64 132  98],316,5,42247,4.692025766326077,60.0,0.0
9004,0,9004,[318 427  64 132  98],796,5,42252,4.692059966685175,60.0,0.0
9005,0,9005,[318 427  64 132  98],716,5,42257,4.6920941594492565,60.0,0.0
9006,0,9006,[318 427  64 132  98],693,4,42261,4.692017319862329,60.0,0.0
9007,0,9007,[318 427  64 132  98],796,5,42266,4.692051509769094,60.0,0.0
9008,0,9008,[318 427  64 132  98],450,5,42271,4.692085692085692,60.0,0.0
9009,0,9009,[318 427  64 132  98],330,5,42276,4.69211986681465,60.0,0.0
9010,0,9010,[318 427  64 132  98],18,5,42281,4.692154033958495,60.0,0.0
9011,0,9011,[318 427  64 132  98],330,5,42286,4.692188193519751,60.0,0.0
9012,0,9012,[318 427  64 132  98],330,5,42291,4.6922223455009435,60.0,0.0
9013,0,9013,[318 427  64 132  98],577,5,42296,4.692256489904593,60.0,0.0
9014,0,9014,[318 427  64 132  98],535,4,42300,4.692179700499168,60.0,0.0
9015,0,9015,[318 427  64 132  98],450,5,42305,4.692213842058562,60.0,0.0
9016,0,9016,[318 427  64 132  98],716,5,42310,4.692247976045248,60.0,0.0
9017,0,9017,[318 427  64 132  98],535,4,42314,4.6921712131292965,60.0,0.0
9018,0,9018,[318 427  64 132  98],655,4,42318,4.692094467235836,60.0,0.0
9019,0,9019,[318 427  64 132  98],316,5,42323,4.692128603104213,60.0,0.0
9020,0,9020,[318 427  64 132  98],535,4,42327,4.692051878949119,60.0,0.0
9021,0,9021,[318 427  64 132  98],151,5,42332,4.692086011970738,60.0,0.0
9022,0,9022,[318 427  64 132  98],450,5,42337,4.692120137426577,60.0,0.0
9023,0,9023,[318 427  64 132  98],535,4,42341,4.692043439716312,60.0,0.0
9024,0,9024,[318 427  64 132  98],330,5,42346,4.69207756232687,60.0,0.0
9025,0,9025,[318 427  64 132  98],269,5,42351,4.692111677376468,60.0,0.0
9026,0,9026,[318 427  64 132  98],577,5,42356,4.69214578486762,60.0,0.0
9027,0,9027,[318 427  64 132  98],693,4,42360,4.692069118298626,60.0,0.0
9028,0,9028,[318 427  64 132  98],236,5,42365,4.692103222948278,60.0,0.0
9029,0,9029,[318 427  64 132  98],269,5,42370,4.692137320044297,60.0,0.0
9030,0,9030,[318 427  64 132  98],316,5,42375,4.692171409589193,60.0,0.0
9031,0,9031,[318 427  64 132  98],316,5,42380,4.692205491585474,60.0,0.0
9032,0,9032,[318 427  64 132  98],450,5,42385,4.6922395660356475,60.0,0.0
9033,0,9033,[318 427  64 132  98],655,4,42389,4.692162940004428,60.0,0.0
9034,0,9034,[318 427  64 132  98],655,4,42393,4.692086330935251,60.0,0.0
9035,0,9035,[318 427  64 132  98],236,5,42398,4.69212040725985,60.0,0.0
9036,0,9036,[318 427  64 132  98],577,5,42403,4.692154476042934,60.0,0.0
9037,0,9037,[318 427  64 132  98],796,5,42408,4.69218853728701,60.0,0.0
9038,0,9038,[318 427  64 132  98],450,5,42413,4.692222590994579,60.0,0.0
9039,0,9039,[318 427  64 132  98],330,5,42418,4.692256637168142,60.0,0.0
9040,0,9040,[318 427  64 132  98],655,4,42422,4.6921800685764845,60.0,0.0
9041,0,9041,[318 427  64 132  98],796,5,42427,4.692214111922141,60.0,0.0
9042,0,9042,[318 427  64 132  98],655,4,42431,4.692137564967378,60.0,0.0
9043,0,9043,[318 427  64 132  98],330,5,42436,4.692171605484299,60.0,0.0
9044,0,9044,[318 427  64 132  98],269,5,42441,4.692205638474295,60.0,0.0
9045,0,9045,[318 427  64 132  98],151,5,42446,4.692239663939863,60.0,0.0
9046,0,9046,[318 427  64 132  98],151,5,42451,4.692273681883497,60.0,0.0
9047,0,9047,[318 427  64 132  98],693,4,42455,4.692197170645446,60.0,0.0
9048,0,9048,[318 427  64 132  98],330,5,42460,4.692231185766383,60.0,0.0
9049,0,9049,[318 427  64 132  98],330,5,42465,4.692265193370166,60.0,0.0
9050,0,9050,[318 427  64 132  98],796,5,42470,4.692299193459286,60.0,0.0
9051,0,9051,[318 427  64 132  98],450,5,42475,4.692333186036235,60.0,0.0
9052,0,9052,[111 234 200 181 294],450,3,42478,4.692146249861924,0.0,0.0
9053,0,9053,[318 427  64 132  98],535,4,42482,4.692069803401812,60.0,0.0
9054,0,9054,[318 427  64 132  98],535,4,42486,4.691993373826615,60.0,0.0
9055,0,9055,[234 100 179 655 238],457,5,42491,4.692027385159011,0.0,20.0
9056,0,9056,[318 427  64 132  98],716,5,42496,4.692061388980899,60.0,0.0
9057,0,9057,[318 427  64 132  98],535,4,42500,4.691984985648046,60.0,0.0
9058,0,9058,[318 427  64 132  98],151,5,42505,4.6920189866431175,60.0,0.0
9059,0,9059,[318 427  64 132  98],655,4,42509,4.6919426048565125,60.0,0.0
9060,0,9060,[318 427  64 132  98],535,4,42513,4.691866239929368,60.0,0.0
9061,0,9061,[318 427  64 132  98],330,5,42518,4.691900242772015,60.0,0.0
9062,0,9062,[318 427  64 132  98],316,5,42523,4.691934238111001,60.0,0.0
9063,0,9063,[318 427  64 132  98],236,5,42528,4.691968225948808,60.0,0.0
9064,0,9064,[228   9 742 234 202],280,2,42530,4.691671263099835,0.0,0.0
9065,0,9065,[318 427  64 132  98],577,5,42535,4.691705272446503,60.0,0.0
9066,0,9066,[318 427  64 132  98],535,4,42539,4.691628984228521,60.0,0.0
9067,0,9067,[318 427  64 132  98],796,5,42544,4.691662990736656,60.0,0.0
9068,0,9068,[318 427  64 132  98],316,5,42549,4.691696989745286,60.0,0.0
9069,0,9069,[318 427  64 132  98],655,4,42553,4.69162072767365,60.0,0.0
9070,0,9070,[318 427  64 132  98],655,4,42557,4.691544482416492,60.0,0.0
9071,0,9071,[318 427  64 132  98],693,4,42561,4.691468253968254,60.0,0.0
9072,0,9072,[318 427  64 132  98],236,5,42566,4.691502259451119,60.0,0.0
9073,0,9073,[318 427  64 132  98],655,4,42570,4.6914260524575715,60.0,0.0
9074,0,9074,[318 427  64 132  98],796,5,42575,4.691460055096419,60.0,0.0
9075,0,9075,[318 427  64 132  98],796,5,42580,4.691494050242397,60.0,0.0
9076,0,9076,[318 427  64 132  98],693,4,42584,4.69141786934009,60.0,0.0
9077,0,9077,[318 427  64 132  98],450,5,42589,4.691451861643534,60.0,0.0
9078,0,9078,[318 427  64 132  98],18,5,42594,4.691485846458861,60.0,0.0
9079,0,9079,[318 427  64 132  98],330,5,42599,4.691519823788546,60.0,0.0
9080,0,9080,[318 427  64 132  98],450,5,42604,4.691553793635062,60.0,0.0
9081,0,9081,[318 427  64 132  98],716,5,42609,4.691587756000881,60.0,0.0
9082,0,9082,[318 427  64 132  98],18,5,42614,4.691621710888473,60.0,0.0
9083,0,9083,[318 427  64 132  98],577,5,42619,4.691655658300308,60.0,0.0
9084,0,9084,[318 427  64 132  98],316,5,42624,4.691689598238855,60.0,0.0
9085,0,9085,[318 427  64 132  98],693,4,42628,4.691613471274488,60.0,0.0
9086,0,9086,[318 427  64 132  98],330,5,42633,4.691647408385606,60.0,0.0
9087,0,9087,[318 427  64 132  98],796,5,42638,4.691681338028169,60.0,0.0
9088,0,9088,[318 427  64 132  98],655,4,42642,4.691605237099791,60.0,0.0
9089,0,9089,[318 427  64 132  98],236,5,42647,4.691639163916392,60.0,0.0
9090,0,9090,[276 234 181 135 215],280,2,42649,4.691343086569134,0.0,0.0
9091,0,9091,[318 427  64 132  98],535,4,42653,4.691267047954246,60.0,0.0
9092,0,9092,[318 427  64 132  98],18,5,42658,4.691301000769823,60.0,0.0
9093,0,9093,[318 427  64 132  98],535,4,42662,4.691224983505608,60.0,0.0
9094,0,9094,[318 427  64 132  98],716,5,42667,4.691258933479934,60.0,0.0
9095,0,9095,[318 427  64 132  98],269,5,42672,4.691292875989446,60.0,0.0
9096,0,9096,[318 427  64 132  98],18,5,42677,4.691326811036605,60.0,0.0
9097,0,9097,[318 427  64 132  98],655,4,42681,4.6912508243570015,60.0,0.0
9098,0,9098,[318 427  64 132  98],450,5,42686,4.691284756566656,60.0,0.0
9099,0,9099,[318 427  64 132  98],450,5,42691,4.691318681318681,60.0,0.0
9100,0,9100,[318 427  64 132  98],269,5,42696,4.691352598615537,60.0,0.0
9101,0,9101,[655 173 211 210 202],401,3,42699,4.69116677653263,0.0,0.0
9102,0,9102,[318 427  64 132  98],236,5,42704,4.691200703064924,60.0,0.0
9103,0,9103,[318 427  64 132  98],269,5,42709,4.691234622144113,60.0,0.0
9104,0,9104,[318 427  64 132  98],693,4,42713,4.691158704008786,60.0,0.0
9105,0,9105,[318 427  64 132  98],450,5,42718,4.691192620250384,60.0,0.0
9106,0,9106,[318 427  64 132  98],236,5,42723,4.691226529043593,60.0,0.0
9107,0,9107,[318 427  64 132  98],450,5,42728,4.691260430390865,60.0,0.0
9108,0,9108,[318 427  64 132  98],450,5,42733,4.691294324294653,60.0,0.0
9109,0,9109,[318 427  64 132  98],577,5,42738,4.691328210757409,60.0,0.0
9110,0,9110,[318 427  64 132  98],655,4,42742,4.691252332345516,60.0,0.0
9111,0,9111,[318 427  64 132  98],450,5,42747,4.691286215978929,60.0,0.0
9112,0,9112,[318 427  64 132  98],796,5,42752,4.691320092176012,60.0,0.0
9113,0,9113,[318 427  64 132  98],330,5,42757,4.691353960939215,60.0,0.0
9114,0,9114,[318 427  64 132  98],330,5,42762,4.691387822270982,60.0,0.0
9115,0,9115,[423   1 273   4 475],655,1,42763,4.690982887231241,0.0,0.0
9116,0,9116,[318 427  64 132  98],236,5,42768,4.69101678183613,60.0,0.0
9117,0,9117,[318 427  64 132  98],269,5,42773,4.691050669006361,60.0,0.0
9118,0,9118,[118 289 678 496 483],807,4,42777,4.690974887597324,20.0,0.0
9119,0,9119,[318 427  64 132  98],236,5,42782,4.691008771929824,60.0,0.0
9120,0,9120,[318 427  64 132  98],316,5,42787,4.691042648832365,60.0,0.0
9121,0,9121,[318 427  64 132  98],655,4,42791,4.69096689322517,60.0,0.0
9122,0,9122,[318 427  64 132  98],18,5,42796,4.691000767291461,60.0,0.0
9123,0,9123,[318 427  64 132  98],269,5,42801,4.691034633932485,60.0,0.0
9124,0,9124,[318 427  64 132  98],716,5,42806,4.691068493150685,60.0,0.0
9125,0,9125,[318  11  98 173 302],535,3,42809,4.6908831908831905,20.0,0.0
9126,0,9126,[318 427  64 132  98],577,5,42814,4.690917059274679,60.0,0.0
9127,0,9127,[318 427  64 132  98],316,5,42819,4.690950920245399,60.0,0.0
9128,0,9128,[318 427  64 132  98],330,5,42824,4.690984773797787,60.0,0.0
9129,0,9129,[ 79  11 405 195 135],292,4,42828,4.6909090909090905,0.0,0.0
9130,0,9130,[161 568 496 318 187],796,5,42833,4.690942941627423,40.0,0.0
9131,0,9131,[318 427  64 132  98],18,5,42838,4.690976784932107,60.0,0.0
9132,0,9132,[318 427  64 132  98],151,5,42843,4.691010620825578,60.0,0.0
9133,0,9133,[318 427  64 132  98],236,5,42848,4.69104444931027,60.0,0.0
9134,0,9134,[318 427  64 132  98],577,5,42853,4.691078270388616,60.0,0.0
9135,0,9135,[318 427  64 132  98],716,5,42858,4.691112084063048,60.0,0.0
9136,0,9136,[318 427  64 132  98],18,5,42863,4.691145890335997,60.0,0.0
9137,0,9137,[318 427  64 132  98],796,5,42868,4.691179689209893,60.0,0.0
9138,0,9138,[318 427  64 132  98],330,5,42873,4.691213480687165,60.0,0.0
9139,0,9139,[318 427  64 132  98],236,5,42878,4.691247264770241,60.0,0.0
9140,0,9140,[318 427  64 132  98],450,5,42883,4.691281041461547,60.0,0.0
9141,0,9141,[318 427  64 132  98],577,5,42888,4.691314810763509,60.0,0.0
9142,0,9142,[318 427  64 132  98],796,5,42893,4.691348572678552,60.0,0.0
9143,0,9143,[318 427  64 132  98],693,4,42897,4.691272965879265,60.0,0.0
9144,0,9144,[318 427  64 132  98],535,4,42901,4.69119737561509,60.0,0.0
9145,0,9145,[318 427  64 132  98],330,5,42906,4.691231139295867,60.0,0.0
9146,0,9146,[318 427  64 132  98],655,4,42910,4.691155570132284,60.0,0.0
9147,0,9147,[318 427  64 132  98],18,5,42915,4.691189331001312,60.0,0.0
9148,0,9148,[ 64 121 318 135 216],450,3,42918,4.691004481364083,40.0,0.0
9149,0,9149,[318 427  64 132  98],535,4,42922,4.690928961748634,60.0,0.0
9150,0,9150,[318 427  64 132  98],716,5,42927,4.690962736312971,60.0,0.0
9151,0,9151,[318 427  64 132  98],577,5,42932,4.690996503496503,60.0,0.0
9152,0,9152,[318 427  64 132  98],796,5,42937,4.691030263301649,60.0,0.0
9153,0,9153,[318 427  64 132  98],655,4,42941,4.690954773869347,60.0,0.0
9154,0,9154,[318 427  64 132  98],18,5,42946,4.690988530857455,60.0,0.0
9155,0,9155,[318 427  64 132  98],316,5,42951,4.691022280471822,60.0,0.0
9156,0,9156,[318 427  64 132  98],330,5,42956,4.6910560227148626,60.0,0.0
9157,0,9157,[318 427  64 132  98],18,5,42961,4.691089757588993,60.0,0.0
9158,0,9158,[318 427  64 132  98],693,4,42965,4.691014302871492,60.0,0.0
9159,0,9159,[318 427  64 132  98],236,5,42970,4.691048034934497,60.0,0.0
9160,0,9160,[318 427  64 132  98],716,5,42975,4.691081759633228,60.0,0.0
9161,0,9161,[318 427  64 132  98],577,5,42980,4.691115476970094,60.0,0.0
9162,0,9162,[318 427  64 132  98],236,5,42985,4.691149186947507,60.0,0.0
9163,0,9163,[318 427  64 132  98],18,5,42990,4.691182889567874,60.0,0.0
9164,0,9164,[ 50 182 234  98 475],629,5,42995,4.691216584833606,0.0,20.0
9165,0,9165,[318 427  64 132  98],655,4,42999,4.6911411739035564,60.0,0.0
9166,0,9166,[318 427  64 132  98],236,5,43004,4.691174866368495,60.0,0.0
9167,0,9167,[ 96 197 202 215 588],450,5,43009,4.69120855148342,0.0,0.0
9168,0,9168,[111  64 294 179  88],457,3,43012,4.691024102955612,20.0,0.0
9169,0,9169,[318 427  64 132  98],18,5,43017,4.691057797164667,60.0,0.0
9170,0,9170,[318 427  64 132  98],330,5,43022,4.691091484025733,60.0,0.0
9171,0,9171,[318 427  64 132  98],151,5,43027,4.691125163541212,60.0,0.0
9172,0,9172,[318 427  64 132  98],693,4,43031,4.691049820124277,60.0,0.0
9173,0,9173,[318 427  64 132  98],693,4,43035,4.690974493132766,60.0,0.0
9174,0,9174,[318 427  64 132  98],796,5,43040,4.691008174386921,60.0,0.0
9175,0,9175,[318 427  64 132  98],18,5,43045,4.691041848299913,60.0,0.0
9176,0,9176,[318 427  64 132  98],535,4,43049,4.690966546801787,60.0,0.0
9177,0,9177,[318 427  64 132  98],655,4,43053,4.690891261712792,60.0,0.0
9178,0,9178,[318 427  64 132  98],316,5,43058,4.6909249373570105,60.0,0.0
9179,0,9179,[318 427  64 132  98],577,5,43063,4.690958605664488,60.0,0.0
9180,0,9180,[318 427  64 132  98],151,5,43068,4.690992266637621,60.0,0.0
9181,0,9181,[318 427  64 132  98],535,4,43072,4.690917011544326,60.0,0.0
9182,0,9182,[318 427  64 132  98],577,5,43077,4.690950669715779,60.0,0.0
9183,0,9183,[318 427  64 132  98],330,5,43082,4.690984320557491,60.0,0.0
9184,0,9184,[318 427  64 132  98],269,5,43087,4.691017964071857,60.0,0.0
9185,0,9185,[318 427  64 132  98],796,5,43092,4.691051600261267,60.0,0.0
9186,0,9186,[318 427  64 132  98],236,5,43097,4.691085229128116,60.0,0.0
9187,0,9187,[318 427  64 132  98],796,5,43102,4.691118850674793,60.0,0.0
9188,0,9188,[318 427  64 132  98],716,5,43107,4.6911524649036895,60.0,0.0
9189,0,9189,[318 427  64 132  98],18,5,43112,4.691186071817192,60.0,0.0
9190,0,9190,[403   7 271 195 117],72,2,43114,4.690893265150691,0.0,0.0
9191,0,9191,[318 427  64 132  98],716,5,43119,4.690926892950392,60.0,0.0
9192,0,9192,[318 427  64 132  98],716,5,43124,4.690960513434135,60.0,0.0
9193,0,9193,[318 427  64 132  98],236,5,43129,4.690994126604307,60.0,0.0
9194,0,9194,[275  79  89 117  69],344,3,43132,4.690810222947254,0.0,20.0
9195,0,9195,[318 427  64 132  98],535,4,43136,4.690735102218356,60.0,0.0
9196,0,9196,[318 427  64 132  98],269,5,43141,4.690768728933348,60.0,0.0
9197,0,9197,[318 427  64 132  98],693,4,43145,4.690693629049793,60.0,0.0
9198,0,9198,[318 427  64 132  98],330,5,43150,4.6907272529622785,60.0,0.0
9199,0,9199,[318 427  64 132  98],796,5,43155,4.690760869565217,60.0,0.0
9200,0,9200,[318 427  64 132  98],535,4,43159,4.69068579502228,60.0,0.0
9201,0,9201,[318 427  64 132  98],151,5,43164,4.690719408824169,60.0,0.0
9202,0,9202,[318 427  64 132  98],535,4,43168,4.690644355101598,60.0,0.0
9203,0,9203,[318 427  64 132  98],796,5,43173,4.690677966101695,60.0,0.0
9204,0,9204,[318 427  64 132  98],535,4,43177,4.690602933188485,60.0,0.0
9205,0,9205,[318 427  64 132  98],269,5,43182,4.690636541386053,60.0,0.0
9206,0,9206,[318 427  64 132  98],577,5,43187,4.690670142283046,60.0,0.0
9207,0,9207,[204  95 202 333 144],796,5,43192,4.690703735881842,0.0,0.0
9208,0,9208,[318 427  64 132  98],330,5,43197,4.690737322184819,60.0,0.0
9209,0,9209,[318 427  64 132  98],151,5,43202,4.690770901194354,60.0,0.0
9210,0,9210,[678 153 210 237 748],280,1,43203,4.690370209532081,0.0,0.0
9211,0,9211,[318 427  64 132  98],716,5,43208,4.690403821102909,60.0,0.0
9212,0,9212,[301 186 211 546 423],450,4,43212,4.690328883099967,0.0,0.0
9213,0,9213,[318 427  64 132  98],316,5,43217,4.6903624918602125,60.0,0.0
9214,0,9214,[318 427  64 132  98],151,5,43222,4.690396093326099,60.0,0.0
9215,0,9215,[318 427  64 132  98],450,5,43227,4.6904296875,60.0,0.0
9216,0,9216,[318 427  64 132  98],330,5,43232,4.69046327438429,60.0,0.0
9217,0,9217,[318 427  64 132  98],693,4,43236,4.690388370579301,60.0,0.0
9218,0,9218,[318 427  64 132  98],535,4,43240,4.690313483024189,60.0,0.0
9219,0,9219,[318 427  64 132  98],450,5,43245,4.690347071583514,60.0,0.0
9220,0,9220,[318 427  64 132  98],330,5,43250,4.690380652857607,60.0,0.0
9221,0,9221,[318 427  64 132  98],316,5,43255,4.69041422684884,60.0,0.0
9222,0,9222,[318 427  64 132  98],535,4,43259,4.690339368968882,60.0,0.0
9223,0,9223,[318 427  64 132  98],450,5,43264,4.690372940156115,60.0,0.0
9224,0,9224,[318 427  64 132  98],236,5,43269,4.690406504065041,60.0,0.0
9225,0,9225,[318 427  64 132  98],796,5,43274,4.690440060698028,60.0,0.0
9226,0,9226,[318 427  64 132  98],18,5,43279,4.69047361005744,60.0,0.0
9227,0,9227,[318 427  64 132  98],269,5,43284,4.690507152145644,60.0,0.0
9228,0,9228,[318 427  64 132  98],316,5,43289,4.690540686965002,60.0,0.0
9229,0,9229,[318 427  64 132  98],236,5,43294,4.690574214517876,60.0,0.0
9230,0,9230,[318 427  64 132  98],693,4,43298,4.690499404181562,60.0,0.0
9231,0,9231,[318 427  64 132  98],716,5,43303,4.690532928942807,60.0,0.0
9232,0,9232,[318 427  64 132  98],796,5,43308,4.6905664464421095,60.0,0.0
9233,0,9233,[318 427  64 132  98],693,4,43312,4.690491661251895,60.0,0.0
9234,0,9234,[318 427  64 132  98],693,4,43316,4.690416892257716,60.0,0.0
9235,0,9235,[318 427  64 132  98],450,5,43321,4.690450411433521,60.0,0.0
9236,0,9236,[318 427  64 132  98],716,5,43326,4.690483923351738,60.0,0.0
9237,0,9237,[318 427  64 132  98],655,4,43330,4.690409179476077,60.0,0.0
9238,0,9238,[ 22 258 144 143 151],796,5,43335,4.690442688602663,0.0,0.0
9239,0,9239,[318 427  64 132  98],716,5,43340,4.690476190476191,60.0,0.0
9240,0,9240,[318 427  64 132  98],716,5,43345,4.690509685099015,60.0,0.0
9241,0,9241,[318 427  64 132  98],18,5,43350,4.6905431724734905,60.0,0.0
9242,0,9242,[318 427  64 132  98],151,5,43355,4.690576652601969,60.0,0.0
9243,0,9243,[318 427  64 132  98],236,5,43360,4.690610125486803,60.0,0.0
9244,0,9244,[318 427  64 132  98],151,5,43365,4.690643591130341,60.0,0.0
9245,0,9245,[318 427  64 132  98],577,5,43370,4.690677049534934,60.0,0.0
9246,0,9246,[318 427  64 132  98],716,5,43375,4.690710500702931,60.0,0.0
9247,0,9247,[318 427  64 132  98],796,5,43380,4.6907439446366785,60.0,0.0
9248,0,9248,[318 427  64 132  98],693,4,43384,4.690669261541788,60.0,0.0
9249,0,9249,[180 385 423 117 197],716,3,43387,4.690486486486487,0.0,0.0
9250,0,9250,[318 427  64 132  98],716,5,43392,4.690519943789861,60.0,0.0
9251,0,9251,[318 427  64 132  98],577,5,43397,4.690553393860787,60.0,0.0
9252,0,9252,[318 427  64 132  98],151,5,43402,4.69058683670161,60.0,0.0
9253,0,9253,[318 427  64 132  98],450,5,43407,4.690620272314675,60.0,0.0
9254,0,9254,[318 427  64 132  98],693,4,43411,4.69054565099946,60.0,0.0
9255,0,9255,[318 427  64 132  98],535,4,43415,4.690471045808124,60.0,0.0
9256,0,9256,[318 427  64 132  98],577,5,43420,4.690504483093875,60.0,0.0
9257,0,9257,[ 28 427 118 181 180],716,3,43423,4.6903218837761935,20.0,0.0
9258,0,9258,[318 427  64 132  98],330,5,43428,4.690355329949239,60.0,0.0
9259,0,9259,[318 427  64 132  98],151,5,43433,4.690388768898488,60.0,0.0
9260,0,9260,[318 427  64 132  98],330,5,43438,4.690422200626283,60.0,0.0
9261,0,9261,[318 427  64 132  98],330,5,43443,4.69045562513496,60.0,0.0
9262,0,9262,[318 427  64 132  98],716,5,43448,4.69048904242686,60.0,0.0
9263,0,9263,[318 427  64 132  98],316,5,43453,4.690522452504318,60.0,0.0
9264,0,9264,[211 238 286 183 269],450,5,43458,4.690555855369671,0.0,20.0
9265,0,9265,[318 427  64 132  98],151,5,43463,4.690589251025254,60.0,0.0
9266,0,9266,[318 427  64 132  98],269,5,43468,4.6906226394734,60.0,0.0
9267,0,9267,[318 427  64 132  98],18,5,43473,4.690656020716443,60.0,0.0
9268,0,9268,[318 427  64 132  98],450,5,43478,4.690689394756716,60.0,0.0
9269,0,9269,[318 427  64 132  98],18,5,43483,4.690722761596548,60.0,0.0
9270,0,9270,[318 427  64 132  98],151,5,43488,4.69075612123827,60.0,0.0
9271,0,9271,[318 427  64 132  98],577,5,43493,4.690789473684211,60.0,0.0
9272,0,9272,[318 427  64 132  98],655,4,43497,4.690714978971207,60.0,0.0
9273,0,9273,[318 427  64 132  98],316,5,43502,4.690748328660772,60.0,0.0
9274,0,9274,[318 427  64 132  98],535,4,43506,4.690673854447439,60.0,0.0
9275,0,9275,[318 427  64 132  98],577,5,43511,4.690707201379905,60.0,0.0
9276,0,9276,[318 427  64 132  98],236,5,43516,4.690740541123208,60.0,0.0
9277,0,9277,[318 427  64 132  98],655,4,43520,4.690666091830136,60.0,0.0
9278,0,9278,[318 427  64 132  98],655,4,43524,4.690591658583899,60.0,0.0
9279,0,9279,[318 427  64 132  98],535,4,43528,4.69051724137931,60.0,0.0
9280,0,9280,[318 427  64 132  98],693,4,43532,4.690442840211184,60.0,0.0
9281,0,9281,[318 427  64 132  98],796,5,43537,4.690476190476191,60.0,0.0
9282,0,9282,[318 427  64 132  98],577,5,43542,4.690509533555963,60.0,0.0
9283,0,9283,[318 427  64 132  98],716,5,43547,4.690542869452822,60.0,0.0
9284,0,9284,[318 427  64 132  98],716,5,43552,4.69057619816909,60.0,0.0
9285,0,9285,[318 427  64 132  98],693,4,43556,4.690501830712901,60.0,0.0
9286,0,9286,[318 427  64 132  98],796,5,43561,4.690535156670615,60.0,0.0
9287,0,9287,[318 427  64 132  98],18,5,43566,4.690568475452197,60.0,0.0
9288,0,9288,[318 427  64 132  98],330,5,43571,4.690601787059963,60.0,0.0
9289,0,9289,[318 427  64 132  98],535,4,43575,4.690527448869752,60.0,0.0
9290,0,9290,[318 427  64 132  98],655,4,43579,4.690453126681735,60.0,0.0
9291,0,9291,[318 427  64 132  98],18,5,43584,4.690486439948343,60.0,0.0
9292,0,9292,[237 211 117 210  98],504,4,43588,4.690412138168514,0.0,0.0
9293,0,9293,[318 427  64 132  98],269,5,43593,4.690445448676566,60.0,0.0
9294,0,9294,[275 471  89  97   4],786,5,43598,4.6904787520172135,0.0,20.0
9295,0,9295,[318 427  64 132 275],796,5,43603,4.690512048192771,60.0,20.0
9296,0,9296,[318 427  64 132 275],716,5,43608,4.69054533720555,60.0,20.0
9297,0,9297,[ 22  69 405 176 357],269,1,43609,4.690148419014842,0.0,0.0
9298,0,9298,[318 427  64 132 275],796,5,43614,4.69018173997204,60.0,20.0
9299,0,9299,[318 427  64 132 275],330,5,43619,4.690215053763441,60.0,20.0
9300,0,9300,[318 427  64 132 275],655,4,43623,4.690140845070423,60.0,20.0
9301,0,9301,[ 71 186 496 168  79],577,5,43628,4.6901741560954635,20.0,0.0
9302,0,9302,[318 427  64 132 275],535,5,43633,4.690207459959153,60.0,20.0
9303,0,9303,[318 427  64 132 275],330,5,43638,4.6902407566638,60.0,20.0
9304,0,9304,[318 427  64 132 275],330,5,43643,4.690274046211714,60.0,20.0
9305,0,9305,[318 427  64 132 275],655,4,43647,4.690199871050935,60.0,20.0
9306,0,9306,[318 427  64 132 275],151,5,43652,4.690233157838186,60.0,20.0
9307,0,9307,[318 427  64 132 275],18,5,43657,4.6902664374731415,60.0,20.0
9308,0,9308,[318 427  64 132 275],450,5,43662,4.690299709958105,60.0,20.0
9309,0,9309,[173 135 197 216 200],457,5,43667,4.690332975295381,0.0,0.0
9310,0,9310,[318 427  64 132 275],535,5,43672,4.690366233487273,60.0,20.0
9311,0,9311,[318 427  64 132 275],655,4,43676,4.690292096219931,60.0,20.0
9312,0,9312,[318 427  64 132 275],535,5,43681,4.690325351658971,60.0,20.0
9313,0,9313,[318 427  64 132 275],330,5,43686,4.690358599957054,60.0,20.0
9314,0,9314,[318 427  64 132 275],535,5,43691,4.690391841116479,60.0,20.0
9315,0,9315,[357  11 496 385  70],450,5,43696,4.690425075139545,20.0,0.0
9316,0,9316,[318 427  64 132 275],655,4,43700,4.690350971342707,60.0,20.0
9317,0,9317,[318 427  64 132 275],716,5,43705,4.690384202618588,60.0,20.0
9318,0,9318,[153  69 100 655  71],885,2,43707,4.690095503809421,0.0,20.0
9319,0,9319,[318 427  64 132 275],716,5,43712,4.690128755364807,60.0,20.0
9320,0,9320,[318 427  64 132 275],236,4,43716,4.6900547151593175,60.0,20.0
9321,0,9321,[318 427  64 132 275],316,5,43721,4.690087963956232,60.0,20.0
9322,0,9322,[318 427  64 132 275],151,5,43726,4.690121205620509,60.0,20.0
9323,0,9323,[385 210 286 403 357],330,5,43731,4.69015444015444,0.0,20.0
9324,0,9324,[318 427  64 132 275],316,5,43736,4.690187667560322,60.0,20.0
9325,0,9325,[318 427  64 132 275],151,5,43741,4.690220887840446,60.0,20.0
9326,0,9326,[318 427  64 132 275],716,5,43746,4.690254100997105,60.0,20.0
9327,0,9327,[318 427  64 132 275],151,5,43751,4.69028730703259,60.0,20.0
9328,0,9328,[318 427  64 132 275],18,5,43756,4.690320505949191,60.0,20.0
9329,0,9329,[318 427  64 132 275],535,5,43761,4.690353697749196,60.0,20.0
9330,0,9330,[318 427  64 132 275],655,4,43765,4.6902797127853395,60.0,20.0
9331,0,9331,[318 427  64 132 275],18,5,43770,4.690312901843121,60.0,20.0
9332,0,9332,[318 427  64 132 275],796,5,43775,4.6903460837887065,60.0,20.0
9333,0,9333,[318 427  64 132 275],535,5,43780,4.690379258624384,60.0,20.0
9334,0,9334,[318 427  64 132 275],535,5,43785,4.690412426352437,60.0,20.0
9335,0,9335,[318 427  64 132 275],716,5,43790,4.69044558697515,60.0,20.0
9336,0,9336,[318 427  64 132 275],151,5,43795,4.690478740494806,60.0,20.0
9337,0,9337,[318 427  64 132 275],330,5,43800,4.690511886913686,60.0,20.0
9338,0,9338,[318 427  64 132 275],330,5,43805,4.690545026234072,60.0,20.0
9339,0,9339,[318 427  64 132 275],236,4,43809,4.690471092077088,60.0,20.0
9340,0,9340,[318 427  64 132 275],330,5,43814,4.690504228669307,60.0,20.0
9341,0,9341,[318 427  64 132 275],316,5,43819,4.690537358167416,60.0,20.0
9342,0,9342,[  1 471   8 174 186],389,4,43823,4.690463448571123,0.0,0.0
9343,0,9343,[318 427  64 132 275],655,4,43827,4.69038955479452,60.0,20.0
9344,0,9344,[318 427  64 132 275],236,4,43831,4.6903156768325305,60.0,20.0
9345,0,9345,[200 187  70  82  50],450,3,43834,4.690134817034025,0.0,20.0
9346,0,9346,[318 427  64 132 275],316,5,43839,4.690167968332085,60.0,20.0
9347,0,9347,[318 427  64 132 275],18,5,43844,4.690201112537441,60.0,20.0
9348,0,9348,[318 427  64 132 275],330,5,43849,4.690234249652369,60.0,20.0
9349,0,9349,[318 427  64 132 275],18,5,43854,4.6902673796791445,60.0,20.0
9350,0,9350,[318 427  64 132 275],18,5,43859,4.69030050262004,60.0,20.0
9351,0,9351,[318 427  64 132 275],450,5,43864,4.690333618477331,60.0,20.0
9352,0,9352,[318 427  64 132 275],330,5,43869,4.690366727253288,60.0,20.0
9353,0,9353,[318 427  64 132 275],330,5,43874,4.690399828950182,60.0,20.0
9354,0,9354,[318 427  64 132 275],151,5,43879,4.690432923570283,60.0,20.0
9355,0,9355,[318 427  64 132 275],236,4,43883,4.690359127832407,60.0,20.0
9356,0,9356,[318 427  64 132 275],330,5,43888,4.690392219728546,60.0,20.0
9357,0,9357,[318 427  64 132 275],535,5,43893,4.690425304552255,60.0,20.0
9358,0,9358,[318 427  64 132 275],316,5,43898,4.690458382305802,60.0,20.0
9359,0,9359,[318 427  64 132 275],796,5,43903,4.690491452991453,60.0,20.0
9360,0,9360,[318 427  64 132 275],716,5,43908,4.6905245166114735,60.0,20.0
9361,0,9361,[318 427  64 132 275],450,5,43913,4.690557573168126,60.0,20.0
9362,0,9362,[ 95 117 196 323  71],796,4,43917,4.69048381928869,0.0,0.0
9363,0,9363,[318 427  64 132 275],330,5,43922,4.69051687313114,60.0,20.0
9364,0,9364,[318 427  64 132 275],236,4,43926,4.6904431393486385,60.0,20.0
9365,0,9365,[318 427  64 132  98],716,5,43931,4.690476190476191,60.0,0.0
9366,0,9366,[318 427  64 132  98],655,4,43935,4.690402476780186,60.0,0.0
9367,0,9367,[318 427  64 132  98],655,4,43939,4.69032877882152,60.0,0.0
9368,0,9368,[318 427  64 132  98],535,4,43943,4.690255096595155,60.0,0.0
9369,0,9369,[318 427  64 132  98],450,5,43948,4.690288153681964,60.0,0.0
9370,0,9370,[318 427  64 132  98],269,5,43953,4.690321203713585,60.0,0.0
9371,0,9371,[318 427  64 132  98],693,4,43957,4.690247545881348,60.0,0.0
9372,0,9372,[318 427  64 132  98],535,4,43961,4.690173903766137,60.0,0.0
9373,0,9373,[318 427  64 132  98],655,4,43965,4.690100277362919,60.0,0.0
9374,0,9374,[318 427  64 132  98],450,5,43970,4.690133333333334,60.0,0.0
9375,0,9375,[318 427  64 132  98],693,4,43974,4.690059726962457,60.0,0.0
9376,0,9376,[318 427  64 132  98],655,4,43978,4.6899861362909245,60.0,0.0
9377,0,9377,[318 427  64 132  98],535,4,43982,4.689912561313713,60.0,0.0
9378,0,9378,[318 427  64 132  98],693,4,43986,4.689839002025803,60.0,0.0
9379,0,9379,[318 427  64 132  98],151,5,43991,4.689872068230277,60.0,0.0
9380,0,9380,[318 427  64 132  98],151,5,43996,4.68990512738514,60.0,0.0
9381,0,9381,[318 427  64 132  98],577,5,44001,4.689938179492645,60.0,0.0
9382,0,9382,[318 427  64 132  98],269,5,44006,4.6899712245550464,60.0,0.0
9383,0,9383,[118 117   9 403 215],796,4,44010,4.689897698209719,0.0,0.0
9384,0,9384,[300  98 588 202  71],450,4,44014,4.689824187533298,0.0,0.0
9385,0,9385,[318 427  64 132  98],577,5,44019,4.689857234178564,60.0,0.0
9386,0,9386,[318 427  64 132  98],269,5,44024,4.689890273782892,60.0,0.0
9387,0,9387,[318 427  64 132  98],535,4,44028,4.689816787388155,60.0,0.0
9388,0,9388,[318 427  64 132  98],693,4,44032,4.6897433166471405,60.0,0.0
9389,0,9389,[318 427  64 132  98],269,5,44037,4.689776357827476,60.0,0.0
9390,0,9390,[318 427  64 132  98],693,4,44041,4.6897029070386544,60.0,0.0
9391,0,9391,[318 427  64 132  98],151,5,44046,4.68973594548552,60.0,0.0
9392,0,9392,[318 427  64 132  98],796,5,44051,4.68976897689769,60.0,0.0
9393,0,9393,[318 427  64 132  98],577,5,44056,4.689802001277411,60.0,0.0
9394,0,9394,[318 427  64 132  98],535,4,44060,4.689728579031399,60.0,0.0
9395,0,9395,[318 427  64 132  98],450,5,44065,4.689761600681141,60.0,0.0
9396,0,9396,[ 95   7  25 215 258],344,3,44068,4.689581781419602,0.0,0.0
9397,0,9397,[318 427  64 132  98],693,4,44072,4.6895084060438395,60.0,0.0
9398,0,9398,[318 427  64 132  98],269,5,44077,4.689541440578785,60.0,0.0
9399,0,9399,[318 427  64 132  98],577,5,44082,4.689574468085106,60.0,0.0
9400,0,9400,[318 427  64 132  98],577,5,44087,4.689607488565046,60.0,0.0
9401,0,9401,[313 237 748 322 301],796,3,44090,4.689427781323123,0.0,0.0
9402,0,9402,[318 427  64 132  98],577,5,44095,4.689460810379666,60.0,0.0
9403,0,9403,[318 427  64 132  98],577,5,44100,4.68949383241174,60.0,0.0
9404,0,9404,[318 427  64 132  98],577,5,44105,4.689526847421584,60.0,0.0
9405,0,9405,[318 427  64 132  98],655,4,44109,4.68945354029343,60.0,0.0
9406,0,9406,[318 427  64 132  98],577,5,44114,4.689486552567237,60.0,0.0
9407,0,9407,[423 197 196 191 176],786,4,44118,4.689413265306122,0.0,0.0
9408,0,9408,[318 427  64 132  98],655,4,44122,4.689339993623126,60.0,0.0
9409,0,9409,[318 427  64 132  98],330,5,44127,4.689373007438895,60.0,0.0
9410,0,9410,[318 427  64 132  98],716,5,44132,4.689406014238657,60.0,0.0
9411,0,9411,[318 427  64 132  98],269,5,44137,4.689439014024649,60.0,0.0
9412,0,9412,[318 427  64 132  98],316,5,44142,4.689472006799107,60.0,0.0
9413,0,9413,[265 282 655  98  11],655,1,44143,4.689080093477799,0.0,0.0
9414,0,9414,[318 427  64 132  98],693,4,44147,4.689006903876792,60.0,0.0
9415,0,9415,[318 427  64 132  98],796,5,44152,4.689039932030586,60.0,0.0
9416,0,9416,[318 427  64 132  98],236,5,44157,4.689072953169799,60.0,0.0
9417,0,9417,[318 427  64 132  98],236,5,44162,4.689105967296666,60.0,0.0
9418,0,9418,[318 427  64 132  98],18,5,44167,4.68913897441342,60.0,0.0
9419,0,9419,[318 427  64 132  98],330,5,44172,4.689171974522293,60.0,0.0
9420,0,9420,[318 427  64 132  98],151,5,44177,4.689204967625518,60.0,0.0
9421,0,9421,[143 300  79 132  95],716,5,44182,4.689237953725324,0.0,0.0
9422,0,9422,[318 427  64 132  98],316,5,44187,4.689270932823941,60.0,0.0
9423,0,9423,[318 427  64 132  98],796,5,44192,4.689303904923599,60.0,0.0
9424,0,9424,[318 427  64 132  98],577,5,44197,4.689336870026525,60.0,0.0
9425,0,9425,[318 427  64 132  98],450,5,44202,4.689369828134946,60.0,0.0
9426,0,9426,[318 427  64 132  98],236,5,44207,4.689402779251087,60.0,0.0
9427,0,9427,[318 427  64 132  98],796,5,44212,4.689435723377175,60.0,0.0
9428,0,9428,[318 427  64 132  98],151,5,44217,4.689468660515431,60.0,0.0
9429,0,9429,[318 427  64 132  98],269,5,44222,4.689501590668081,60.0,0.0
9430,0,9430,[318 427  64 132  98],316,5,44227,4.689534513837345,60.0,0.0
9431,0,9431,[318 427  64 132  98],18,5,44232,4.689567430025445,60.0,0.0
9432,0,9432,[ 56 100 127 194 300],292,5,44237,4.689600339234602,0.0,40.0
9433,0,9433,[318 427  64 132 194],151,5,44242,4.6896332414670345,60.0,0.0
9434,0,9434,[318 427  64 132 194],236,4,44246,4.689560148383678,60.0,0.0
9435,0,9435,[318 427  64 132  98],236,5,44251,4.689593047901654,60.0,0.0
9436,0,9436,[318 427  64 132  98],330,5,44256,4.689625940447176,60.0,0.0
9437,0,9437,[318 427  64 132  98],577,5,44261,4.6896588260224625,60.0,0.0
9438,0,9438,[318 427  64 132  98],577,5,44266,4.689691704629728,60.0,0.0
9439,0,9439,[318 427  64 132  98],577,5,44271,4.689724576271186,60.0,0.0
9440,0,9440,[318 427  64 132  98],655,4,44275,4.689651519966105,60.0,0.0
9441,0,9441,[318 427  64 132  98],655,4,44279,4.689578479135776,60.0,0.0
9442,0,9442,[318 427  64 132  98],316,5,44284,4.689611352324473,60.0,0.0
9443,0,9443,[318 427  64 132  98],151,5,44289,4.689644218551461,60.0,0.0
9444,0,9444,[318 427  64 132  98],577,5,44294,4.689677077818952,60.0,0.0
9445,0,9445,[318 427  64 132  98],693,4,44298,4.689604065212788,60.0,0.0
9446,0,9446,[318 427  64 132  98],151,5,44303,4.689636921774108,60.0,0.0
9447,0,9447,[318 427  64 132  98],18,5,44308,4.689669771380187,60.0,0.0
9448,0,9448,[318 427  64 132  98],535,4,44312,4.689596782728331,60.0,0.0
9449,0,9449,[318 427  64 132  98],18,5,44317,4.689629629629629,60.0,0.0
9450,0,9450,[318 427  64 132  98],316,5,44322,4.689662469579939,60.0,0.0
9451,0,9451,[318 427  64 132  98],796,5,44327,4.689695302581464,60.0,0.0
9452,0,9452,[318 427  64 132  98],151,5,44332,4.689728128636411,60.0,0.0
9453,0,9453,[318 427  64 132  98],535,4,44336,4.689655172413793,60.0,0.0
9454,0,9454,[318 427  64 132  98],535,4,44340,4.689582231623479,60.0,0.0
9455,0,9455,[318 427  64 132  98],535,4,44344,4.689509306260575,60.0,0.0
9456,0,9456,[318 427  64 132  98],693,4,44348,4.689436396320186,60.0,0.0
9457,0,9457,[318 427  64 132  98],269,5,44353,4.689469232395855,60.0,0.0
9458,0,9458,[318 427  64 132  98],18,5,44358,4.689502061528703,60.0,0.0
9459,0,9459,[195 196  50 282 174],504,4,44362,4.689429175475687,0.0,20.0
9460,0,9460,[318 427  64 132  98],151,5,44367,4.689462001902547,60.0,0.0
9461,0,9461,[318 427  64 132  98],151,5,44372,4.689494821390826,60.0,0.0
9462,0,9462,[318 427  64 132  98],655,4,44376,4.689421959209553,60.0,0.0
9463,0,9463,[318 427  64 132  98],269,5,44381,4.689454775993237,60.0,0.0
9464,0,9464,[318 427  64 132  98],269,5,44386,4.689487585842578,60.0,0.0
9465,0,9465,[318 427  64 132  98],330,5,44391,4.689520388759772,60.0,0.0
9466,0,9466,[318 427  64 132  98],693,4,44395,4.689447554663568,60.0,0.0
9467,0,9467,[318 427  64 132  98],796,5,44400,4.689480354879595,60.0,0.0
9468,0,9468,[318 427  64 132  98],151,5,44405,4.6895131481677055,60.0,0.0
9469,0,9469,[318 427  64 132  98],796,5,44410,4.689545934530095,60.0,0.0
9470,0,9470,[318 427  64 132  98],655,4,44414,4.689473128497519,60.0,0.0
9471,0,9471,[318 427  64 132  98],693,4,44418,4.689400337837838,60.0,0.0
9472,0,9472,[318 427  64 132  98],796,5,44423,4.689433125725746,60.0,0.0
9473,0,9473,[588 245 118 423 427],450,4,44427,4.689360354654845,20.0,0.0
9474,0,9474,[318 427  64 132  98],577,5,44432,4.689393139841688,60.0,0.0
9475,0,9475,[318 427  64 132  98],450,5,44437,4.689425918108907,60.0,0.0
9476,0,9476,[318 427  64 132  98],151,5,44442,4.689458689458689,60.0,0.0
9477,0,9477,[318 427  64 132  98],796,5,44447,4.689491453893226,60.0,0.0
9478,0,9478,[318 427  64 132  98],151,5,44452,4.689524211414706,60.0,0.0
9479,0,9479,[318 427  64 132  98],18,5,44457,4.689556962025317,60.0,0.0
9480,0,9480,[318 427  64 132  98],269,5,44462,4.6895897057272435,60.0,0.0
9481,0,9481,[318 427  64 132  98],655,4,44466,4.689516979540182,60.0,0.0
9482,0,9482,[318 427  64 132  98],535,4,44470,4.689444268691342,60.0,0.0
9483,0,9483,[318 427  64 132  98],151,5,44475,4.689477013918178,60.0,0.0
9484,0,9484,[318 427  64 132  98],316,5,44480,4.6895097522403795,60.0,0.0
9485,0,9485,[318 427  64 132  98],796,5,44485,4.689542483660131,60.0,0.0
9486,0,9486,[318 427  64 132  98],151,5,44490,4.6895752081796145,60.0,0.0
9487,0,9487,[318 427  64 132  98],450,5,44495,4.6896079258010115,60.0,0.0
9488,0,9488,[318 427  64 132  98],655,4,44499,4.689535251343661,60.0,0.0
9489,0,9489,[318 427  64 132  98],716,5,44504,4.689567966280295,60.0,0.0
9490,0,9490,[318 427  64 132  98],716,5,44509,4.689600674323043,60.0,0.0
9491,0,9491,[318 427  64 132  98],796,5,44514,4.6896333754740835,60.0,0.0
9492,0,9492,[318 427  64 132  98],151,5,44519,4.689666069735595,60.0,0.0
9493,0,9493,[318 427  64 132  98],577,5,44524,4.6896987571097535,60.0,0.0
9494,0,9494,[318 427  64 132  98],269,5,44529,4.689731437598736,60.0,0.0
9495,0,9495,[318 427  64 132  98],716,5,44534,4.689764111204718,60.0,0.0
9496,0,9496,[318 427  64 132  98],18,5,44539,4.689796777929873,60.0,0.0
9497,0,9497,[318 427  64 132  98],330,5,44544,4.689829437776374,60.0,0.0
9498,0,9498,[ 96 200 234 186  28],716,3,44547,4.689651542267607,0.0,0.0
9499,0,9499,[318 427  64 132  98],693,4,44551,4.689578947368421,60.0,0.0
9500,0,9500,[318 427  64 132  98],796,5,44556,4.689611619829492,60.0,0.0
9501,0,9501,[318 427  64 132  98],577,5,44561,4.689644285413597,60.0,0.0
9502,0,9502,[318 427  64 132  98],236,5,44566,4.689676944122908,60.0,0.0
9503,0,9503,[318 427  64 132  98],796,5,44571,4.689709595959596,60.0,0.0
9504,0,9504,[318 427  64 132  98],535,4,44575,4.689637033140452,60.0,0.0
9505,0,9505,[318 427  64 132  98],269,5,44580,4.689669682305912,60.0,0.0
9506,0,9506,[318 427  64 132  98],316,5,44585,4.689702324602925,60.0,0.0
9507,0,9507,[318 427  64 132  98],577,5,44590,4.689734960033656,60.0,0.0
9508,0,9508,[318 427  64 132  98],716,5,44595,4.689767588600273,60.0,0.0
9509,0,9509,[318 427  64 132  98],577,5,44600,4.689800210304942,60.0,0.0
9510,0,9510,[318 427  64 132  98],577,5,44605,4.689832825149827,60.0,0.0
9511,0,9511,[318 427  64 132  98],577,5,44610,4.68986543313709,60.0,0.0
9512,0,9512,[318 427  64 132  98],577,5,44615,4.689898034268896,60.0,0.0
9513,0,9513,[318 427  64 132  98],316,5,44620,4.689930628547404,60.0,0.0
9514,0,9514,[318 427  64 132  98],796,5,44625,4.689963215974776,60.0,0.0
9515,0,9515,[318 427  64 132  98],693,4,44629,4.689890710382514,60.0,0.0
9516,0,9516,[318 427  64 132  98],450,5,44634,4.689923295156037,60.0,0.0
9517,0,9517,[318 427  64 132  98],450,5,44639,4.689955873082581,60.0,0.0
9518,0,9518,[318 427  64 132  98],269,5,44644,4.689988444164303,60.0,0.0
9519,0,9519,[318 427  64 132  98],236,5,44649,4.690021008403361,60.0,0.0
9520,0,9520,[318 427  64 132  98],450,5,44654,4.690053565801912,60.0,0.0
9521,0,9521,[ 88 143 204  50 191],562,4,44658,4.689981096408317,0.0,20.0
9522,0,9522,[318 427  64 132  98],535,4,44662,4.68990864223459,60.0,0.0
9523,0,9523,[318 427  64 132  98],450,5,44667,4.6899412011759765,60.0,0.0
9524,0,9524,[318 427  64 132  98],236,5,44672,4.68997375328084,60.0,0.0
9525,0,9525,[318 427  64 132  98],316,5,44677,4.690006298551333,60.0,0.0
9526,0,9526,[318 427  64 132  98],450,5,44682,4.690038836989609,60.0,0.0
9527,0,9527,[318 427  64 132  98],716,5,44687,4.690071368597817,60.0,0.0
9528,0,9528,[318 427  64 132  98],577,5,44692,4.690103893378109,60.0,0.0
9529,0,9529,[318 427  64 132  98],655,4,44696,4.6900314795383,60.0,0.0
9530,0,9530,[318 427  64 132  98],330,5,44701,4.690064001678732,60.0,0.0
9531,0,9531,[318 427  64 132  98],316,5,44706,4.690096516995384,60.0,0.0
9532,0,9532,[318 427  64 132  98],796,5,44711,4.690129025490402,60.0,0.0
9533,0,9533,[318 427  64 132  98],693,4,44715,4.690056639395847,60.0,0.0
9534,0,9534,[318 427  64 132  98],18,5,44720,4.690089145254326,60.0,0.0
9535,0,9535,[318 427  64 132  98],269,5,44725,4.690121644295302,60.0,0.0
9536,0,9536,[318 427  64 132  98],330,5,44730,4.690154136520919,60.0,0.0
9537,0,9537,[318 427  64 132  98],269,5,44735,4.69018662193332,60.0,0.0
9538,0,9538,[318 427  64 132  98],450,5,44740,4.690219100534647,60.0,0.0
9539,0,9539,[318 427  64 132  98],450,5,44745,4.690251572327044,60.0,0.0
9540,0,9540,[318 427  64 132  98],330,5,44750,4.690284037312651,60.0,0.0
9541,0,9541,[318 427  64 132  98],18,5,44755,4.690316495493607,60.0,0.0
9542,0,9542,[318 427  64 132  98],18,5,44760,4.690348946872053,60.0,0.0
9543,0,9543,[318 427  64 132  98],577,5,44765,4.690381391450126,60.0,0.0
9544,0,9544,[318 427  64 132  98],535,4,44769,4.6903090623363015,60.0,0.0
9545,0,9545,[318 427  64 132  98],450,5,44774,4.6903415042949925,60.0,0.0
9546,0,9546,[318 427  64 132  98],535,4,44778,4.690269194511365,60.0,0.0
9547,0,9547,[318 427  64 132  98],796,5,44783,4.690301633850021,60.0,0.0
9548,0,9548,[318 427  64 132  98],716,5,44788,4.690334066394387,60.0,0.0
9549,0,9549,[318 427  64 132  98],236,5,44793,4.690366492146597,60.0,0.0
9550,0,9550,[318 427  64 132  98],693,4,44797,4.6902942100303635,60.0,0.0
9551,0,9551,[318 427  64 132  98],693,4,44801,4.690221943048576,60.0,0.0
9552,0,9552,[318 427  64 132  98],18,5,44806,4.690254370354863,60.0,0.0
9553,0,9553,[318 427  64 132  98],151,5,44811,4.690286790872933,60.0,0.0
9554,0,9554,[318 427  64 132  98],577,5,44816,4.6903192046049185,60.0,0.0
9555,0,9555,[318 427  64 132  98],655,4,44820,4.69024696525743,60.0,0.0
9556,0,9556,[318 427  64 132  98],330,5,44825,4.690279376373339,60.0,0.0
9557,0,9557,[318 427  64 132  98],716,5,44830,4.690311780707261,60.0,0.0
9558,0,9558,[318 427  64 132  98],577,5,44835,4.690344178261324,60.0,0.0
9559,0,9559,[318 427  64 132  98],18,5,44840,4.690376569037657,60.0,0.0
9560,0,9560,[318 427  64 132  98],18,5,44845,4.690408953038385,60.0,0.0
9561,0,9561,[318 427  64 132  98],796,5,44850,4.690441330265635,60.0,0.0
9562,0,9562,[318 427  64 132  98],655,4,44854,4.690369131025829,60.0,0.0
9563,0,9563,[318 427  64 132  98],236,5,44859,4.690401505646173,60.0,0.0
9564,0,9564,[318 427  64 132  98],151,5,44864,4.690433873497125,60.0,0.0
9565,0,9565,[318 427  64 132  98],269,5,44869,4.690466234580807,60.0,0.0
9566,0,9566,[318 427  64 132  98],716,5,44874,4.690498588899342,60.0,0.0
9567,0,9567,[318 427  64 132  98],716,5,44879,4.6905309364548495,60.0,0.0
9568,0,9568,[318 427  64 132  98],450,5,44884,4.690563277249451,60.0,0.0
9569,0,9569,[515 121 153 603  50],269,2,44886,4.690282131661442,20.0,20.0
9570,0,9570,[318 427  64 132  98],655,4,44890,4.6902100094034065,60.0,0.0
9571,0,9571,[318 427  64 132  98],450,5,44895,4.690242373589636,60.0,0.0
9572,0,9572,[318 427  64 132  98],236,5,44900,4.690274731014311,60.0,0.0
9573,0,9573,[318 427  64 132  98],18,5,44905,4.690307081679549,60.0,0.0
9574,0,9574,[318 427  64 132  98],450,5,44910,4.690339425587467,60.0,0.0
9575,0,9575,[125 588 228  70 181],450,5,44915,4.690371762740184,0.0,0.0
9576,0,9576,[318 427  64 132  98],450,5,44920,4.690404093139814,60.0,0.0
9577,0,9577,[318 427  64 132  98],316,5,44925,4.690436416788474,60.0,0.0
9578,0,9578,[318 427  64 132  98],316,5,44930,4.690468733688276,60.0,0.0
9579,0,9579,[318 427  64 132  98],577,5,44935,4.690501043841336,60.0,0.0
9580,0,9580,[318 427  64 132  98],269,5,44940,4.690533347249765,60.0,0.0
9581,0,9581,[318 427  64 132  98],716,5,44945,4.690565643915675,60.0,0.0
9582,0,9582,[318 427  64 132  98],716,5,44950,4.690597933841177,60.0,0.0
9583,0,9583,[318 427  64 132  98],330,5,44955,4.690630217028381,60.0,0.0
9584,0,9584,[318 427  64 132  98],716,5,44960,4.690662493479395,60.0,0.0
9585,0,9585,[318 427  64 132  98],330,5,44965,4.690694763196328,60.0,0.0
9586,0,9586,[318 427  64 132  98],796,5,44970,4.690727026181287,60.0,0.0
9587,0,9587,[318 427  64 132  98],316,5,44975,4.690759282436379,60.0,0.0
9588,0,9588,[318 427  64 132  98],269,5,44980,4.690791531963709,60.0,0.0
9589,0,9589,[234  82 143  70 186],151,4,44984,4.690719499478623,0.0,0.0
9590,0,9590,[318 427  64 132  98],450,5,44989,4.690751746428944,60.0,0.0
9591,0,9591,[318 427  64 132  98],450,5,44994,4.690783986655546,60.0,0.0
9592,0,9592,[318 427  64 132  98],236,5,44999,4.690816220160534,60.0,0.0
9593,0,9593,[318 427  64 132  98],316,5,45004,4.690848446946008,60.0,0.0
9594,0,9594,[318 427  64 132  98],693,4,45008,4.69077644606566,60.0,0.0
9595,0,9595,[318 427  64 132  98],716,5,45013,4.690808670279283,60.0,0.0
9596,0,9596,[318 427  64 132  98],716,5,45018,4.690840887777431,60.0,0.0
9597,0,9597,[318 427  64 132  98],655,4,45022,4.690768910189623,60.0,0.0
9598,0,9598,[318 427  64 132  98],693,4,45026,4.690696947598708,60.0,0.0
9599,0,9599,[318 427  64 132  98],716,5,45031,4.690729166666666,60.0,0.0
9600,0,9600,[318 427  64 132  98],450,5,45036,4.6907613790230185,60.0,0.0
9601,0,9601,[318 427  64 132  98],316,5,45041,4.69079358466986,60.0,0.0
9602,0,9602,[318 427  64 132  98],577,5,45046,4.690825783609289,60.0,0.0
9603,0,9603,[318 427  64 132  98],269,5,45051,4.690857975843398,60.0,0.0
9604,0,9604,[318 427  64 132  98],450,5,45056,4.690890161374284,60.0,0.0
9605,0,9605,[318 427  64 132  98],796,5,45061,4.690922340204039,60.0,0.0
9606,0,9606,[318 427  64 132  98],151,5,45066,4.690954512334756,60.0,0.0
9607,0,9607,[318 427  64 132  98],716,5,45071,4.690986677768526,60.0,0.0
9608,0,9608,[318 427  64 132  98],236,5,45076,4.691018836507441,60.0,0.0
9609,0,9609,[318 427  64 132  98],316,5,45081,4.69105098855359,60.0,0.0
9610,0,9610,[318 427  64 132  98],316,5,45086,4.691083133909062,60.0,0.0
9611,0,9611,[318 427  64 132  98],269,5,45091,4.691115272575947,60.0,0.0
9612,0,9612,[318 427  64 132  98],796,5,45096,4.69114740455633,60.0,0.0
9613,0,9613,[100  15 427 179 211],450,4,45100,4.691075514874142,20.0,20.0
9614,0,9614,[318 427  64 132  98],535,4,45104,4.691003640145606,60.0,0.0
9615,0,9615,[318 427  64 132  98],18,5,45109,4.691035773710483,60.0,0.0
9616,0,9616,[318 427  64 132  98],18,5,45114,4.6910679005927,60.0,0.0
9617,0,9617,[318 427  64 132  98],330,5,45119,4.691100020794344,60.0,0.0
9618,0,9618,[318 427  64 132  98],577,5,45124,4.691132134317496,60.0,0.0
9619,0,9619,[204 210 125 257 153],655,0,45124,4.690644490644491,0.0,0.0
9620,0,9620,[318 427  64 132  98],316,5,45129,4.690676644839414,60.0,0.0
9621,0,9621,[318 427  64 132  98],716,5,45134,4.690708792350863,60.0,0.0
9622,0,9622,[318 427  64 132  98],796,5,45139,4.690740933180921,60.0,0.0
9623,0,9623,[318 427  64 132  98],655,4,45143,4.690669160432253,60.0,0.0
9624,0,9624,[318 427  64 132  98],269,5,45148,4.690701298701299,60.0,0.0
9625,0,9625,[318 427  64 132  98],655,4,45152,4.69062954498234,60.0,0.0
9626,0,9626,[318 427  64 132  98],151,5,45157,4.690661680689727,60.0,0.0
9627,0,9627,[318 427  64 132  98],450,5,45162,4.690693809721645,60.0,0.0
9628,0,9628,[318 427  64 132  98],18,5,45167,4.690725932080174,60.0,0.0
9629,0,9629,[318 427  64 132  98],693,4,45171,4.690654205607476,60.0,0.0
9630,0,9630,[318 427  64 132  98],236,5,45176,4.690686325407538,60.0,0.0
9631,0,9631,[318 427  64 132  98],316,5,45181,4.690718438538206,60.0,0.0
9632,0,9632,[318 427  64 132  98],535,4,45185,4.690646735181148,60.0,0.0
9633,0,9633,[318 427  64 132  98],18,5,45190,4.690678845754619,60.0,0.0
9634,0,9634,[318 427  64 132  98],316,5,45195,4.690710949662688,60.0,0.0
9635,0,9635,[318 427  64 132  98],655,4,45199,4.690639269406392,60.0,0.0
9636,0,9636,[318 427  64 132  98],693,4,45203,4.690567604026149,60.0,0.0
9637,0,9637,[318 427  64 132  98],450,5,45208,4.690599709483295,60.0,0.0
9638,0,9638,[318 427  64 132  98],151,5,45213,4.690631808278867,60.0,0.0
9639,0,9639,[318 427  64 132  98],269,5,45218,4.690663900414938,60.0,0.0
9640,0,9640,[318 427  64 132  98],577,5,45223,4.69069598589358,60.0,0.0
9641,0,9641,[318 427  64 132  98],330,5,45228,4.690728064716864,60.0,0.0
9642,0,9642,[318 427  64 132  98],796,5,45233,4.690760136886861,60.0,0.0
9643,0,9643,[318 427  64 132  98],269,5,45238,4.690792202405641,60.0,0.0
9644,0,9644,[318 427  64 132  98],450,5,45243,4.690824261275272,60.0,0.0
9645,0,9645,[318 427  64 132  98],577,5,45248,4.6908563134978225,60.0,0.0
9646,0,9646,[318 427  64 132  98],577,5,45253,4.69088835907536,60.0,0.0
9647,0,9647,[318 427  64 132  98],316,5,45258,4.6909203980099505,60.0,0.0
9648,0,9648,[318 427  64 132  98],577,5,45263,4.690952430303659,60.0,0.0
9649,0,9649,[318 427  64 132  98],693,4,45267,4.690880829015544,60.0,0.0
9650,0,9650,[318 427  64 132  98],450,5,45272,4.690912858771112,60.0,0.0
9651,0,9651,[318 427  64 132  98],716,5,45277,4.690944881889764,60.0,0.0
9652,0,9652,[318 427  64 132  98],330,5,45282,4.690976898373562,60.0,0.0
9653,0,9653,[318 427  64 132  98],330,5,45287,4.69100890822457,60.0,0.0
9654,0,9654,[318 427  64 132  98],577,5,45292,4.691040911444847,60.0,0.0
9655,0,9655,[318 427  64 132  98],269,5,45297,4.691072908036454,60.0,0.0
9656,0,9656,[313 176 286 185 282],796,4,45301,4.69100134617376,0.0,20.0
9657,0,9657,[318 427  64 132  98],151,5,45306,4.691033340236074,60.0,0.0
9658,0,9658,[318 427  64 132  98],577,5,45311,4.691065327673672,60.0,0.0
9659,0,9659,[318 427  64 132  98],655,4,45315,4.690993788819876,60.0,0.0
9660,0,9660,[318 427  64 132  98],269,5,45320,4.691025773729428,60.0,0.0
9661,0,9661,[318 427  64 132  98],716,5,45325,4.6910577520182155,60.0,0.0
9662,0,9662,[318 427  64 132  98],236,5,45330,4.691089723688296,60.0,0.0
9663,0,9663,[318 427  64 132  98],796,5,45335,4.691121688741722,60.0,0.0
9664,0,9664,[318 427  64 132  98],330,5,45340,4.691153647180548,60.0,0.0
9665,0,9665,[318 427  64 132  98],693,4,45344,4.69108214359611,60.0,0.0
9666,0,9666,[318 427  64 132  98],151,5,45349,4.69111409951381,60.0,0.0
9667,0,9667,[318 427  64 132  98],330,5,45354,4.691146048820852,60.0,0.0
9668,0,9668,[ 69   8  15 234 202],796,4,45358,4.691074568207674,0.0,0.0
9669,0,9669,[318 427  64 132  98],316,5,45363,4.6911065149948294,60.0,0.0
9670,0,9670,[318 427  64 132  98],269,5,45368,4.691138455175266,60.0,0.0
9671,0,9671,[318 427  64 132  98],796,5,45373,4.691170388751034,60.0,0.0
9672,0,9672,[318 427  64 132  98],716,5,45378,4.691202315724181,60.0,0.0
9673,0,9673,[318 427  64 132  98],716,5,45383,4.691234236096754,60.0,0.0
9674,0,9674,[318 427  64 132  98],693,4,45387,4.691162790697675,60.0,0.0
9675,0,9675,[318 427  64 132  98],330,5,45392,4.691194708557255,60.0,0.0
9676,0,9676,[318 427  64 132  98],577,5,45397,4.691226619820192,60.0,0.0
9677,0,9677,[318 427  64 132  98],330,5,45402,4.69125852448853,60.0,0.0
9678,0,9678,[318 427  64 132  98],269,5,45407,4.691290422564315,60.0,0.0
9679,0,9679,[318 427  64 132  98],796,5,45412,4.691322314049587,60.0,0.0
9680,0,9680,[318 427  64 132  98],796,5,45417,4.69135419894639,60.0,0.0
9681,0,9681,[318 427  64 132  98],316,5,45422,4.691386077256765,60.0,0.0
9682,0,9682,[318 427  64 132  98],450,5,45427,4.691417948982753,60.0,0.0
9683,0,9683,[318 427  64 132  98],655,4,45431,4.6913465510119785,60.0,0.0
9684,0,9684,[318 427  64 132  98],330,5,45436,4.691378420237481,60.0,0.0
9685,0,9685,[471 174 197 427  98],655,2,45438,4.691100557505679,20.0,0.0
9686,0,9686,[318 427  64 132  98],796,5,45443,4.691132445545577,60.0,0.0
9687,0,9687,[318 427  64 132  98],151,5,45448,4.691164327002477,60.0,0.0
9688,0,9688,[318 427  64 132  98],330,5,45453,4.691196201878419,60.0,0.0
9689,0,9689,[318 427  64 132  98],535,4,45457,4.691124871001032,60.0,0.0
9690,0,9690,[318 427  64 132  98],655,4,45461,4.691053554844701,60.0,0.0
9691,0,9691,[318 427  64 132  98],236,5,45466,4.691085431283533,60.0,0.0
9692,0,9692,[318 427  64 132  98],693,4,45470,4.69101413391107,60.0,0.0
9693,0,9693,[318 427  64 132  98],577,5,45475,4.691046007839901,60.0,0.0
9694,0,9694,[318 427  64 132  98],716,5,45480,4.691077875193399,60.0,0.0
9695,0,9695,[318 427  64 132  98],796,5,45485,4.691109735973598,60.0,0.0
9696,0,9696,[318 427  64 132  98],693,4,45489,4.691038465504795,60.0,0.0
9697,0,9697,[318 427  64 132  98],330,5,45494,4.691070323778098,60.0,0.0
9698,0,9698,[234  70 132 117 180],280,4,45498,4.690999072069285,0.0,0.0
9699,0,9699,[318 427  64 132  98],693,4,45502,4.690927835051546,60.0,0.0
9700,0,9700,[318 427  64 132  98],693,4,45506,4.690856612720338,60.0,0.0
9701,0,9701,[318 427  64 132  98],535,4,45510,4.69078540507112,60.0,0.0
9702,0,9702,[318 427  64 132  98],18,5,45515,4.6908172730083475,60.0,0.0
9703,0,9703,[318 427  64 132  98],269,5,45520,4.690849134377577,60.0,0.0
9704,0,9704,[318 427  64 132  98],236,5,45525,4.690880989180835,60.0,0.0
9705,0,9705,[318 427  64 132  98],693,4,45529,4.690809808365959,60.0,0.0
9706,0,9706,[318 427  64 132  98],655,4,45533,4.690738642216957,60.0,0.0
9707,0,9707,[318 427  64 132  98],18,5,45538,4.690770498557891,60.0,0.0
9708,0,9708,[318 427  64 132  98],269,5,45543,4.690802348336595,60.0,0.0
9709,0,9709,[318 427  64 132  98],151,5,45548,4.690834191555098,60.0,0.0
9710,0,9710,[318 427  64 132  98],316,5,45553,4.690866028215426,60.0,0.0
9711,0,9711,[318 427  64 132  98],796,5,45558,4.690897858319604,60.0,0.0
9712,0,9712,[318 427  64 132  98],716,5,45563,4.690929681869659,60.0,0.0
9713,0,9713,[318 427  64 132  98],330,5,45568,4.690961498867614,60.0,0.0
9714,0,9714,[318 427  64 132  98],18,5,45573,4.690993309315491,60.0,0.0
9715,0,9715,[318 427  64 132  98],535,4,45577,4.6909221902017295,60.0,0.0
9716,0,9716,[318 427  64 132  98],655,4,45581,4.690851085726047,60.0,0.0
9717,0,9717,[318 427  64 132  98],693,4,45585,4.6907799958839265,60.0,0.0
9718,0,9718,[318 427  64 132  98],535,4,45589,4.6907089206708505,60.0,0.0
9719,0,9719,[318 427  64 132  98],236,5,45594,4.690740740740741,60.0,0.0
9720,0,9720,[318 427  64 132  98],796,5,45599,4.6907725542639644,60.0,0.0
9721,0,9721,[318 427  64 132  98],450,5,45604,4.6908043612425425,60.0,0.0
9722,0,9722,[318 427  64 132  98],450,5,45609,4.690836161678495,60.0,0.0
9723,0,9723,[318 427  64 132  98],796,5,45614,4.690867955573838,60.0,0.0
9724,0,9724,[318 427  64 132  98],655,4,45618,4.690796915167095,60.0,0.0
9725,0,9725,[318 427  64 132  98],693,4,45622,4.690725889368703,60.0,0.0
9726,0,9726,[318 427  64 132  98],316,5,45627,4.6907576847949,60.0,0.0
9727,0,9727,[318 427  64 132  98],151,5,45632,4.690789473684211,60.0,0.0
9728,0,9728,[318 427  64 132  98],450,5,45637,4.690821256038648,60.0,0.0
9729,0,9729,[318 427  64 132  98],269,5,45642,4.690853031860226,60.0,0.0
9730,0,9730,[318 427  64 132  98],796,5,45647,4.690884801150961,60.0,0.0
9731,0,9731,[318 427  64 132  98],535,4,45651,4.690813810110974,60.0,0.0
9732,0,9732,[ 97  70 423 294 175],457,4,45655,4.690742833658687,0.0,0.0
9733,0,9733,[318 427  64 132  98],655,4,45659,4.690671871789603,60.0,0.0
9734,0,9734,[318 427  64 132  98],316,5,45664,4.69070364663585,60.0,0.0
9735,0,9735,[318 427  64 132  98],450,5,45669,4.690735414954807,60.0,0.0
9736,0,9736,[318 427  64 132  98],716,5,45674,4.690767176748485,60.0,0.0
9737,0,9737,[125   1 313 597 215],796,4,45678,4.690696241528035,0.0,0.0
9738,0,9738,[318 427  64 132  98],316,5,45683,4.69072800082144,60.0,0.0
9739,0,9739,[318 427  64 132  98],316,5,45688,4.690759753593429,60.0,0.0
9740,0,9740,[318 427  64 132  98],236,5,45693,4.690791499846012,60.0,0.0
9741,0,9741,[318 427  64 132  98],269,5,45698,4.690823239581195,60.0,0.0
9742,0,9742,[318 427  64 132  98],151,5,45703,4.690854972800985,60.0,0.0
9743,0,9743,[318 427  64 132  98],716,5,45708,4.690886699507389,60.0,0.0
9744,0,9744,[318 427  64 132  98],151,5,45713,4.690918419702411,60.0,0.0
9745,0,9745,[318 427  64 132  98],693,4,45717,4.690847527190642,60.0,0.0
9746,0,9746,[318 427  64 132  98],269,5,45722,4.690879244895865,60.0,0.0
9747,0,9747,[318 427  64 132  98],151,5,45727,4.690910956093558,60.0,0.0
9748,0,9748,[318 427  64 132  98],693,4,45731,4.690840086162684,60.0,0.0
9749,0,9749,[318 427  64 132  98],655,4,45735,4.690769230769231,60.0,0.0
9750,0,9750,[318 427  64 132  98],151,5,45740,4.690800943492975,60.0,0.0
9751,0,9751,[318 427  64 132  98],330,5,45745,4.690832649712879,60.0,0.0
9752,0,9752,[318 427  64 132  98],693,4,45749,4.690761816876859,60.0,0.0
9753,0,9753,[318 427  64 132  98],716,5,45754,4.69079352060693,60.0,0.0
9754,0,9754,[318 427  64 132  98],151,5,45759,4.6908252178370065,60.0,0.0
9755,0,9755,[318 427  64 132  98],236,5,45764,4.690856908569086,60.0,0.0
9756,0,9756,[318 427  64 132  98],535,4,45768,4.690786102285538,60.0,0.0
9757,0,9757,[183 197 423  98 333],421,3,45771,4.690612830498053,0.0,0.0
9758,0,9758,[318 427  64 132  98],269,5,45776,4.6906445332513576,60.0,0.0
9759,0,9759,[318 427  64 132  98],450,5,45781,4.690676229508196,60.0,0.0
9760,0,9760,[318 427  64 132  98],316,5,45786,4.690707919270567,60.0,0.0
9761,0,9761,[318 427  64 132  98],236,5,45791,4.690739602540463,60.0,0.0
9762,0,9762,[318 427  64 132  98],693,4,45795,4.69066885178736,60.0,0.0
9763,0,9763,[318 427  64 132  98],577,5,45800,4.690700532568619,60.0,0.0
9764,0,9764,[318 427  64 132  98],269,5,45805,4.690732206861239,60.0,0.0
9765,0,9765,[318 427  64 132  98],716,5,45810,4.690763874667213,60.0,0.0
9766,0,9766,[318 427  64 132  98],18,5,45815,4.690795535988533,60.0,0.0
9767,0,9767,[318 427  64 132  98],716,5,45820,4.690827190827191,60.0,0.0
9768,0,9768,[318 427  64 132  98],450,5,45825,4.690858839185178,60.0,0.0
9769,0,9769,[318 427  64 132  98],151,5,45830,4.690890481064483,60.0,0.0
9770,0,9770,[318 427  64 132  98],18,5,45835,4.690922116467097,60.0,0.0
9771,0,9771,[318 427  64 132  98],18,5,45840,4.6909537453950065,60.0,0.0
9772,0,9772,[318 427  64 132  98],796,5,45845,4.6909853678502,60.0,0.0
9773,0,9773,[318 427  64 132  98],330,5,45850,4.691016983834664,60.0,0.0
9774,0,9774,[318 427  64 132  98],655,4,45854,4.690946291560103,60.0,0.0
9775,0,9775,[318 427  64 132  98],450,5,45859,4.69097790507365,60.0,0.0
9776,0,9776,[318 427  64 132  98],535,4,45863,4.6909072312570315,60.0,0.0
9777,0,9777,[318 427  64 132  98],18,5,45868,4.690938842299039,60.0,0.0
9778,0,9778,[204 318 300 546 195],151,3,45871,4.6907659269863995,20.0,0.0
9779,0,9779,[318 427  64 132  98],330,5,45876,4.69079754601227,60.0,0.0
9780,0,9780,[318 427  64 132  98],330,5,45881,4.690829158572743,60.0,0.0
9781,0,9781,[318 427  64 132  98],236,5,45886,4.690860764669802,60.0,0.0
9782,0,9782,[318 427  64 132  98],716,5,45891,4.690892364305427,60.0,0.0
9783,0,9783,[318 427  64 132  98],716,5,45896,4.690923957481602,60.0,0.0
9784,0,9784,[318 427  64 132  98],269,5,45901,4.690955544200307,60.0,0.0
9785,0,9785,[318 427  64 132  98],716,5,45906,4.690987124463519,60.0,0.0
9786,0,9786,[318 427  64 132  98],450,5,45911,4.691018698273219,60.0,0.0
9787,0,9787,[318 427  64 132  98],151,5,45916,4.691050265631385,60.0,0.0
9788,0,9788,[318 427  64 132  98],236,5,45921,4.691081826539994,60.0,0.0
9789,0,9789,[318 427  64 132  98],450,5,45926,4.6911133810010215,60.0,0.0
9790,0,9790,[318 427  64 132  98],236,5,45931,4.691144929016444,60.0,0.0
9791,0,9791,[111 194 181 132 328],151,4,45935,4.6910743464052285,0.0,0.0
9792,0,9792,[318 427  64 132  98],316,5,45940,4.691105891963647,60.0,0.0
9793,0,9793,[318 427  64 132  98],796,5,45945,4.691137431080254,60.0,0.0
9794,0,9794,[318 427  64 132  98],316,5,45950,4.691168963757019,60.0,0.0
9795,0,9795,[318 427  64 132  98],330,5,45955,4.691200489995917,60.0,0.0
9796,0,9796,[318 427  64 132  98],18,5,45960,4.691232009798918,60.0,0.0
9797,0,9797,[318 427  64 132  98],316,5,45965,4.6912635231679936,60.0,0.0
9798,0,9798,[318 427  64 132  98],796,5,45970,4.691295030105112,60.0,0.0
9799,0,9799,[318 427  64 132  98],151,5,45975,4.691326530612245,60.0,0.0
9800,0,9800,[318 427  64 132  98],18,5,45980,4.691358024691358,60.0,0.0
9801,0,9801,[318 427  64 132  98],655,4,45984,4.691287492348501,60.0,0.0
9802,0,9802,[318 427  64 132  98],18,5,45989,4.691318983984495,60.0,0.0
9803,0,9803,[318 427  64 132  98],655,4,45993,4.69124847001224,60.0,0.0
9804,0,9804,[318 427  64 132  98],796,5,45998,4.691279959204487,60.0,0.0
9805,0,9805,[318 427  64 132  98],330,5,46003,4.691311441974301,60.0,0.0
9806,0,9806,[318 427  64 132  98],18,5,46008,4.691342918323646,60.0,0.0
9807,0,9807,[318 427  64 132  98],330,5,46013,4.691374388254486,60.0,0.0
9808,0,9808,[318 427  64 132  98],316,5,46018,4.691405851768784,60.0,0.0
9809,0,9809,[748 300  50 202  71],760,2,46020,4.691131498470948,0.0,20.0
9810,0,9810,[318 427  64 132  98],693,4,46024,4.6910610539190705,60.0,0.0
9811,0,9811,[318 427  64 132  98],577,5,46029,4.691092539747248,60.0,0.0
9812,0,9812,[318 427  64 132  98],269,5,46034,4.691124019158259,60.0,0.0
9813,0,9813,[318 427  64 132  98],269,5,46039,4.691155492154065,60.0,0.0
9814,0,9814,[318 427  64 132  98],535,4,46043,4.691085073866531,60.0,0.0
9815,0,9815,[318 427  64 132  98],535,4,46047,4.69101466992665,60.0,0.0
9816,0,9816,[318 427  64 132  98],151,5,46052,4.6910461444433125,60.0,0.0
9817,0,9817,[318 427  64 132  98],577,5,46057,4.691077612548381,60.0,0.0
9818,0,9818,[318 427  64 132  98],330,5,46062,4.691109074243813,60.0,0.0
9819,0,9819,[318 427  64 132  98],450,5,46067,4.691140529531568,60.0,0.0
9820,0,9820,[318 427  64 132  98],330,5,46072,4.691171978413603,60.0,0.0
9821,0,9821,[318 427  64 132  98],330,5,46077,4.691203420891876,60.0,0.0
9822,0,9822,[318 427  64 132  98],236,5,46082,4.6912348569683395,60.0,0.0
9823,0,9823,[318 427  64 132  98],151,5,46087,4.691266286644951,60.0,0.0
9824,0,9824,[318 427  64 132  98],330,5,46092,4.691297709923664,60.0,0.0
9825,0,9825,[318 427  64 132  98],796,5,46097,4.691329126806432,60.0,0.0
9826,0,9826,[318 427  64 132  98],450,5,46102,4.691360537295207,60.0,0.0
9827,0,9827,[318 427  64 132  98],18,5,46107,4.691391941391942,60.0,0.0
9828,0,9828,[318 427  64 132  98],269,5,46112,4.691423339098586,60.0,0.0
9829,0,9829,[318 427  64 132  98],18,5,46117,4.691454730417091,60.0,0.0
9830,0,9830,[318 427  64 132  98],269,5,46122,4.691486115349405,60.0,0.0
9831,0,9831,[318 427  64 132  98],330,5,46127,4.691517493897478,60.0,0.0
9832,0,9832,[318 427  64 132  98],577,5,46132,4.691548866063257,60.0,0.0
9833,0,9833,[ 11 211 210 385 238],655,0,46132,4.6910717917429325,0.0,0.0
9834,0,9834,[318 427  64 132  98],330,5,46137,4.691103202846975,60.0,0.0
9835,0,9835,[318 427  64 132  98],577,5,46142,4.6911346075640505,60.0,0.0
9836,0,9836,[318 427  64 132  98],655,4,46146,4.691064348886855,60.0,0.0
9837,0,9837,[318 427  64 132  98],655,4,46150,4.690994104492783,60.0,0.0
9838,0,9838,[318 427  64 132  98],236,5,46155,4.691025510722635,60.0,0.0
9839,0,9839,[318 427  64 132  98],269,5,46160,4.691056910569106,60.0,0.0
9840,0,9840,[318 427  64 132  98],151,5,46165,4.6910883040341425,60.0,0.0
9841,0,9841,[318 427  64 132  98],316,5,46170,4.691119691119691,60.0,0.0
9842,0,9842,[318 427  64 132  98],151,5,46175,4.6911510718276945,60.0,0.0
9843,0,9843,[318 427  64 132  98],316,5,46180,4.691182446160098,60.0,0.0
9844,0,9844,[318 427  64 132  98],18,5,46185,4.691213814118842,60.0,0.0
9845,0,9845,[318 427  64 132  98],535,4,46189,4.691143611618932,60.0,0.0
9846,0,9846,[318 427  64 132  98],236,5,46194,4.691174977150401,60.0,0.0
9847,0,9847,[318 427  64 132  98],577,5,46199,4.691206336311941,60.0,0.0
9848,0,9848,[318 427  64 132  98],693,4,46203,4.691136155954919,60.0,0.0
9849,0,9849,[385 202  50 194  11],716,4,46207,4.691065989847716,0.0,20.0
9850,0,9850,[288 172  50 300 143],450,4,46211,4.690995837985991,0.0,20.0
9851,0,9851,[318 427  64 132  98],450,5,46216,4.691027202598457,60.0,0.0
9852,0,9852,[318 427  64 132  98],693,4,46220,4.690957068913021,60.0,0.0
9853,0,9853,[318 427  64 132  98],577,5,46225,4.690988431093972,60.0,0.0
9854,0,9854,[318 427  64 132  98],330,5,46230,4.691019786910198,60.0,0.0
9855,0,9855,[318 427  64 132  98],151,5,46235,4.691051136363637,60.0,0.0
9856,0,9856,[655 168 268 234 204],269,3,46238,4.690879577964898,0.0,0.0
9857,0,9857,[318 427  64 132  98],693,4,46242,4.690809494826537,60.0,0.0
9858,0,9858,[318 427  64 132  98],796,5,46247,4.690840856070595,60.0,0.0
9859,0,9859,[318 427  64 132  98],330,5,46252,4.690872210953347,60.0,0.0
9860,0,9860,[318 427  64 132  98],269,5,46257,4.690903559476727,60.0,0.0
9861,0,9861,[318 427  64 132  98],316,5,46262,4.6909349016426685,60.0,0.0
9862,0,9862,[318 427  64 132  98],330,5,46267,4.690966237453107,60.0,0.0
9863,0,9863,[318 427  64 132  98],236,5,46272,4.690997566909975,60.0,0.0
9864,0,9864,[318 427  64 132  98],316,5,46277,4.691028890015205,60.0,0.0
9865,0,9865,[318 427  64 132  98],796,5,46282,4.691060206770728,60.0,0.0
9866,0,9866,[318 427  64 132  98],236,5,46287,4.6910915171784735,60.0,0.0
9867,0,9867,[318 427  64 132  98],316,5,46292,4.691122821240373,60.0,0.0
9868,0,9868,[318 427  64 132  98],330,5,46297,4.691154118958354,60.0,0.0
9869,0,9869,[318 427  64 132  98],535,4,46301,4.691084093211753,60.0,0.0
9870,0,9870,[318 427  64 132  98],655,4,46305,4.691014081653328,60.0,0.0
9871,0,9871,[318 427  64 132  98],796,5,46310,4.691045380875202,60.0,0.0
9872,0,9872,[318 427  64 132  98],18,5,46315,4.69107667375671,60.0,0.0
9873,0,9873,[318 427  64 132  98],535,4,46319,4.691006684221187,60.0,0.0
9874,0,9874,[318 427  64 132  98],577,5,46324,4.691037974683544,60.0,0.0
9875,0,9875,[318 427  64 132  98],535,4,46328,4.690968003240179,60.0,0.0
9876,0,9876,[318 427  64 132  98],796,5,46333,4.690999291282778,60.0,0.0
9877,0,9877,[318 427  64 132  98],330,5,46338,4.691030572990484,60.0,0.0
9878,0,9878,[143 742 228 403 483],693,1,46339,4.690656949083915,0.0,0.0
9879,0,9879,[318 427  64 132  98],693,4,46343,4.690587044534413,60.0,0.0
9880,0,9880,[318 427  64 132  98],796,5,46348,4.690618358465742,60.0,0.0
9881,0,9881,[318 427  64 132  98],316,5,46353,4.690649666059502,60.0,0.0
9882,0,9882,[318 427  64 132  98],236,5,46358,4.690680967317616,60.0,0.0
9883,0,9883,[318 427  64 132  98],535,4,46362,4.690611088628086,60.0,0.0
9884,0,9884,[318 427  64 132  98],236,5,46367,4.690642387455741,60.0,0.0
9885,0,9885,[318 427  64 132  98],450,5,46372,4.690673679951447,60.0,0.0
9886,0,9886,[318 427  64 132  98],577,5,46377,4.690704966117123,60.0,0.0
9887,0,9887,[318 427  64 132  98],269,5,46382,4.690736245954692,60.0,0.0
9888,0,9888,[318 427  64 132  98],535,4,46386,4.690666397006775,60.0,0.0
9889,0,9889,[318 427  64 132  98],18,5,46391,4.690697674418605,60.0,0.0
9890,0,9890,[117 135   1 357  22],330,4,46395,4.690627843494085,0.0,0.0
9891,0,9891,[318 427  64 132  98],236,5,46400,4.690659118479579,60.0,0.0
9892,0,9892,[318 427  64 132  98],796,5,46405,4.690690387142424,60.0,0.0
9893,0,9893,[318 427  64 132  98],18,5,46410,4.690721649484536,60.0,0.0
9894,0,9894,[313 196 186 200   4],655,2,46412,4.690449722081859,0.0,0.0
9895,0,9895,[ 98 322 238 300 269],796,2,46414,4.690177849636217,0.0,0.0
9896,0,9896,[318 427  64 132  98],716,5,46419,4.690209154289178,60.0,0.0
9897,0,9897,[318 427  64 132  98],330,5,46424,4.69024045261669,60.0,0.0
9898,0,9898,[318 427  64 132  98],236,5,46429,4.690271744620668,60.0,0.0
9899,0,9899,[318 427  64 132  98],716,5,46434,4.69030303030303,60.0,0.0
9900,0,9900,[318 427  64 132  98],577,5,46439,4.69033430966569,60.0,0.0
9901,0,9901,[318 427  64 132  98],716,5,46444,4.690365582710563,60.0,0.0
9902,0,9902,[318 427  64 132  98],269,5,46449,4.690396849439564,60.0,0.0
9903,0,9903,[318 427  64 132  98],716,5,46454,4.690428109854604,60.0,0.0
9904,0,9904,[318 427  64 132  98],535,4,46458,4.690358404846037,60.0,0.0
9905,0,9905,[161  15   8 546 245],796,4,46462,4.690288713910761,0.0,0.0
9906,0,9906,[265  96  79  56  95],796,5,46467,4.690319975774705,0.0,0.0
9907,0,9907,[318 427  64 132  98],450,5,46472,4.690351231328219,60.0,0.0
9908,0,9908,[318 427  64 132  98],450,5,46477,4.690382480573216,60.0,0.0
9909,0,9909,[318 427  64 132  98],655,4,46481,4.690312815338042,60.0,0.0
9910,0,9910,[318 427  64 132  98],655,4,46485,4.690243164161033,60.0,0.0
9911,0,9911,[318 427  64 132  98],577,5,46490,4.690274414850686,60.0,0.0
9912,0,9912,[318 427  64 132  98],450,5,46495,4.690305659235348,60.0,0.0
9913,0,9913,[318 427  64 132  98],330,5,46500,4.690336897316926,60.0,0.0
9914,0,9914,[318 427  64 132  98],18,5,46505,4.690368129097327,60.0,0.0
9915,0,9915,[318 427  64 132  98],450,5,46510,4.690399354578459,60.0,0.0
9916,0,9916,[318 427  64 132  98],450,5,46515,4.690430573762226,60.0,0.0
9917,0,9917,[318 427  64 132  98],577,5,46520,4.690461786650534,60.0,0.0
9918,0,9918,[318 427  64 132  98],330,5,46525,4.690492993245287,60.0,0.0
9919,0,9919,[318 427  64 132  98],330,5,46530,4.690524193548387,60.0,0.0
9920,0,9920,[318 427  64 132  98],236,5,46535,4.690555387561738,60.0,0.0
9921,0,9921,[318 427  64 132  98],450,5,46540,4.690586575287241,60.0,0.0
9922,0,9922,[204 269 186   9 237],796,2,46542,4.690315428801774,0.0,0.0
9923,0,9923,[318 427  64 132  98],655,4,46546,4.69024586860137,60.0,0.0
9924,0,9924,[318 427  64 132  98],450,5,46551,4.690277078085642,60.0,0.0
9925,0,9925,[318 427  64 132  98],716,5,46556,4.690308281281483,60.0,0.0
9926,0,9926,[318 427  64 132  98],655,4,46560,4.690238742822605,60.0,0.0
9927,0,9927,[318 427  64 132  98],236,5,46565,4.690269943593876,60.0,0.0
9928,0,9928,[318 427  64 132  98],236,5,46570,4.690301138080371,60.0,0.0
9929,0,9929,[318 427  64 132  98],796,5,46575,4.690332326283988,60.0,0.0
9930,0,9930,[318 427  64 132  98],236,5,46580,4.690363508206626,60.0,0.0
9931,0,9931,[318 427  64 132  98],18,5,46585,4.690394683850181,60.0,0.0
9932,0,9932,[318 427  64 132  98],151,5,46590,4.690425853216551,60.0,0.0
9933,0,9933,[318 427  64 132  98],236,5,46595,4.69045701630763,60.0,0.0
9934,0,9934,[318 427  64 132  98],18,5,46600,4.690488173125314,60.0,0.0
9935,0,9935,[318 427  64 132  98],716,5,46605,4.690519323671498,60.0,0.0
9936,0,9936,[318 427  64 132  98],316,5,46610,4.690550467948073,60.0,0.0
9937,0,9937,[318 427  64 132  98],330,5,46615,4.690581605956933,60.0,0.0
9938,0,9938,[318 427  64 132  98],796,5,46620,4.69061273769997,60.0,0.0
9939,0,9939,[655 483 197 143  82],457,5,46625,4.690643863179075,0.0,0.0
9940,0,9940,[318 427  64 132  98],450,5,46630,4.690674982396137,60.0,0.0
9941,0,9941,[318 427  64 132  98],269,5,46635,4.690706095353048,60.0,0.0
9942,0,9942,[318 427  64 132  98],655,4,46639,4.690636628784069,60.0,0.0
9943,0,9943,[318 427  64 132  98],535,4,46643,4.690567176186645,60.0,0.0
9944,0,9944,[318 427  64 132  98],655,4,46647,4.690497737556561,60.0,0.0
9945,0,9945,[318 427  64 132  98],796,5,46652,4.6905288558214355,60.0,0.0
9946,0,9946,[318 427  64 132  98],316,5,46657,4.690559967829496,60.0,0.0
9947,0,9947,[318 427  64 132  98],18,5,46662,4.690591073582629,60.0,0.0
9948,0,9948,[318 427  64 132  98],316,5,46667,4.690622173082722,60.0,0.0
9949,0,9949,[318 427  64 132  98],655,4,46671,4.690552763819095,60.0,0.0
9950,0,9950,[318 427  64 132  98],18,5,46676,4.6905838609185,60.0,0.0
9951,0,9951,[318 427  64 132  98],236,5,46681,4.690614951768489,60.0,0.0
9952,0,9952,[318 427  64 132  98],693,4,46685,4.690545564151512,60.0,0.0
9953,0,9953,[318 427  64 132  98],236,5,46690,4.690576652601969,60.0,0.0
9954,0,9954,[318 427  64 132  98],693,4,46694,4.690507282772476,60.0,0.0
9955,0,9955,[318 427  64 132  98],316,5,46699,4.69053836882282,60.0,0.0
9956,0,9956,[318 427  64 132  98],316,5,46704,4.690569448629105,60.0,0.0
9957,0,9957,[318 427  64 132  98],269,5,46709,4.690600522193211,60.0,0.0
9958,0,9958,[318 427  64 132  98],236,5,46714,4.69063158951702,60.0,0.0
9959,0,9959,[318 427  64 132  98],18,5,46719,4.69066265060241,60.0,0.0
9960,0,9960,[318 427  64 132  98],535,4,46723,4.690593313924305,60.0,0.0
9961,0,9961,[318 427  64 132  98],450,5,46728,4.6906243726159405,60.0,0.0
9962,0,9962,[172 118  89 385 132],796,5,46733,4.6906554250727694,0.0,0.0
9963,0,9963,[318 427  64 132  98],236,5,46738,4.690686471296668,60.0,0.0
9964,0,9964,[318 427  64 132  98],18,5,46743,4.690717511289513,60.0,0.0
9965,0,9965,[318 427  64 132  98],535,4,46747,4.690648203893237,60.0,0.0
9966,0,9966,[127 237 385 357 187],450,5,46752,4.69067924149694,0.0,20.0
9967,0,9967,[318 427  64 132  98],577,5,46757,4.690710272873194,60.0,0.0
9968,0,9968,[318 427  64 132  98],269,5,46762,4.690741298023874,60.0,0.0
9969,0,9969,[300 161 186 282 323],504,4,46766,4.690672016048144,0.0,0.0
9970,0,9970,[318 427  64 132  98],316,5,46771,4.690703038812557,60.0,0.0
9971,0,9971,[318 427  64 132  98],535,4,46775,4.690633774568792,60.0,0.0
9972,0,9972,[318 427  64 132  98],151,5,46780,4.690664794946355,60.0,0.0
9973,0,9973,[318 427  64 132  98],693,4,46784,4.690595548425907,60.0,0.0
9974,0,9974,[318 427  64 132  98],330,5,46789,4.69062656641604,60.0,0.0
9975,0,9975,[318 427  64 132  98],18,5,46794,4.6906575781876505,60.0,0.0
9976,0,9976,[318 427  64 132  98],796,5,46799,4.690688583742608,60.0,0.0
9977,0,9977,[318 427  64 132  98],655,4,46803,4.690619362597715,60.0,0.0
9978,0,9978,[318 427  64 132  98],330,5,46808,4.690650365768113,60.0,0.0
9979,0,9979,[318 427  64 132  98],796,5,46813,4.690681362725451,60.0,0.0
9980,0,9980,[318 427  64 132  98],577,5,46818,4.690712353471596,60.0,0.0
9981,0,9981,[318 427  64 132  98],18,5,46823,4.690743338008415,60.0,0.0
9982,0,9982,[318 427  64 132  98],577,5,46828,4.690774316337774,60.0,0.0
9983,0,9983,[318 427  64 132  98],18,5,46833,4.690805288461538,60.0,0.0
9984,0,9984,[318 427  64 132  98],655,4,46837,4.690736104156234,60.0,0.0
9985,0,9985,[318 427  64 132  98],151,5,46842,4.690767073903465,60.0,0.0
9986,0,9986,[318 427  64 132  98],316,5,46847,4.690798037448683,60.0,0.0
9987,0,9987,[318 427  64 132  98],450,5,46852,4.690828994793753,60.0,0.0
9988,0,9988,[318 427  64 132  98],151,5,46857,4.6908599459405345,60.0,0.0
9989,0,9989,[318 427  64 132  98],236,5,46862,4.690890890890891,60.0,0.0
9990,0,9990,[318 427  64 132  98],236,5,46867,4.690921829646682,60.0,0.0
9991,0,9991,[318 427  64 132  98],693,4,46871,4.690852682145716,60.0,0.0
9992,0,9992,[318 427  64 132  98],18,5,46876,4.690883618532973,60.0,0.0
9993,0,9993,[318 427  64 132  98],151,5,46881,4.690914548729237,60.0,0.0
9994,0,9994,[143 568 475 100 176],269,2,46883,4.6906453226613305,0.0,20.0
9995,0,9995,[318 427  64 132  98],796,5,46888,4.690676270508203,60.0,0.0
9996,0,9996,[318 427  64 132  98],716,5,46893,4.690707212163649,60.0,0.0
9997,0,9997,[318 427  64 132  98],716,5,46898,4.690738147629526,60.0,0.0
9998,0,9998,[318 427  64 132  98],450,5,46903,4.69076907690769,60.0,0.0
9999,0,9999,[ 69  56 289   4 385],655,0,46903,4.6903,0.0,0.0
10000,1,0,[273 286 215  22 301],796,2,2,2.0,0.0,20.0
10001,1,1,[ 22 196 546 143  71],796,5,7,3.5,0.0,0.0
10002,1,2,[ 28 211  64 179 143],655,3,10,3.3333333333333335,20.0,0.0
10003,1,3,[ 22 143 215 546 196],577,3,13,3.25,0.0,0.0
10004,1,4,[ 22  64 215 196  71],344,2,15,3.0,20.0,0.0
10005,1,5,[196 179  64  22 215],450,5,20,3.3333333333333335,20.0,0.0
10006,1,6,[196 179  64  22 215],18,3,23,3.2857142857142856,20.0,0.0
10007,1,7,[179  64  22 196 143],655,3,26,3.25,20.0,0.0
10008,1,8,[179  64 143  22 196],269,2,28,3.111111111111111,20.0,0.0
10009,1,9,[179  64  22 215 143],18,4,32,3.2,20.0,0.0
10010,1,10,[179  64  22 143 196],655,3,35,3.1818181818181817,20.0,0.0
10011,1,11,[179  64 143  22 196],457,5,40,3.3333333333333335,20.0,0.0
10012,1,12,[179  64 143  22 196],450,5,45,3.4615384615384617,20.0,0.0
10013,1,13,[179  64 143  22 196],450,5,50,3.5714285714285716,20.0,0.0
10014,1,14,[179  64 143  22 196],457,5,55,3.6666666666666665,20.0,0.0
10015,1,15,[179  64 143  22 196],655,3,58,3.625,20.0,0.0
10016,1,16,[179  64 143  22 196],18,4,62,3.6470588235294117,20.0,0.0
10017,1,17,[179  64 143  22 196],269,2,64,3.5555555555555554,20.0,0.0
10018,1,18,[179  64 143  22 196],18,4,68,3.5789473684210527,20.0,0.0
10019,1,19,[179  64 143  22 196],450,5,73,3.65,20.0,0.0
10020,1,20,[179  64 143  22 196],457,5,78,3.7142857142857144,20.0,0.0
10021,1,21,[179  64 143  22 196],457,5,83,3.772727272727273,20.0,0.0
10022,1,22,[100 301 196  25  56],593,4,87,3.782608695652174,0.0,20.0
10023,1,23,[ 56 179  64 100 143],18,5,92,3.8333333333333335,20.0,20.0
10024,1,24,[ 56 179  64 100 143],655,3,95,3.8,20.0,20.0
10025,1,25,[179  64 143  22  56],450,5,100,3.8461538461538463,20.0,0.0
10026,1,26,[179  64 143  56  22],457,5,105,3.888888888888889,20.0,0.0
10027,1,27,[179  64 143  56  22],269,3,108,3.857142857142857,20.0,0.0
10028,1,28,[179  64  56 143  22],18,5,113,3.896551724137931,20.0,0.0
10029,1,29,[179  64  56 143  22],577,2,115,3.8333333333333335,20.0,0.0
10030,1,30,[ 64 179 143  56  22],655,3,118,3.806451612903226,20.0,0.0
10031,1,31,[ 64 179 143  22 100],18,5,123,3.84375,20.0,20.0
10032,1,32,[ 64 179 143 100  22],577,3,126,3.8181818181818183,20.0,20.0
10033,1,33,[ 64 179 100 143  22],18,5,131,3.8529411764705883,20.0,20.0
10034,1,34,[ 64 179 100 143  22],450,5,136,3.8857142857142857,20.0,20.0
10035,1,35,[ 64 179 100 143  22],269,3,139,3.861111111111111,20.0,20.0
10036,1,36,[ 64 179 100 143  22],450,5,144,3.891891891891892,20.0,20.0
10037,1,37,[268 202  69 111   7],629,4,148,3.8947368421052633,0.0,0.0
10038,1,38,[111 202  69 268  64],344,3,151,3.871794871794872,20.0,0.0
10039,1,39,[111  64 202 179 100],269,3,154,3.85,20.0,20.0
10040,1,40,[ 64 179 100 143  22],655,3,157,3.8292682926829267,20.0,20.0
10041,1,41,[ 64 179 100 143  22],457,5,162,3.857142857142857,20.0,20.0
10042,1,42,[ 64 179 100 143  22],450,5,167,3.883720930232558,20.0,20.0
10043,1,43,[ 64 179 100 143  22],457,5,172,3.909090909090909,20.0,20.0
10044,1,44,[ 64 179 100 143  22],450,5,177,3.933333333333333,20.0,20.0
10045,1,45,[ 64 179 100 143  22],457,5,182,3.9565217391304346,20.0,20.0
10046,1,46,[ 64 179 100 143  22],655,3,185,3.9361702127659575,20.0,20.0
10047,1,47,[ 64 179 100 143  22],577,3,188,3.9166666666666665,20.0,20.0
10048,1,48,[ 64 179 100 143  22],577,3,191,3.8979591836734695,20.0,20.0
10049,1,49,[ 64 179 100 143  22],577,3,194,3.88,20.0,20.0
10050,1,50,[ 64 179 100 143  22],577,3,197,3.8627450980392157,20.0,20.0
10051,1,51,[ 64 179 100  22 143],457,5,202,3.8846153846153846,20.0,20.0
10052,1,52,[ 64 179 100  22 143],18,5,207,3.9056603773584904,20.0,20.0
10053,1,53,[ 64 179 100  22 143],18,5,212,3.925925925925926,20.0,20.0
10054,1,54,[ 64 100 179  22 143],450,5,217,3.9454545454545453,20.0,20.0
10055,1,55,[182  11 471 202 185],256,4,221,3.9464285714285716,0.0,0.0
10056,1,56,[471  64  11 182 185],450,5,226,3.9649122807017543,20.0,0.0
10057,1,57,[471  64  11 182 185],457,5,231,3.9827586206896552,20.0,0.0
10058,1,58,[471  64  11 182 185],535,4,235,3.983050847457627,20.0,0.0
10059,1,59,[471  64  11 185 100],655,2,237,3.95,20.0,20.0
10060,1,60,[ 64 185 179 100 471],389,5,242,3.9672131147540983,20.0,20.0
10061,1,61,[ 64 185 179 100 471],65,3,245,3.9516129032258065,20.0,20.0
10062,1,62,[ 64 185 179 471 100],65,3,248,3.9365079365079363,20.0,20.0
10063,1,63,[ 64 185 471 179  11],535,5,253,3.953125,20.0,0.0
10064,1,64,[ 64 185 471 179  11],457,5,258,3.9692307692307693,20.0,0.0
10065,1,65,[117 228 222 132 282],280,2,260,3.9393939393939394,0.0,0.0
10066,1,66,[ 64 132 185 117 471],457,5,265,3.955223880597015,20.0,0.0
10067,1,67,[ 64 132 185 117 471],457,5,270,3.9705882352941178,20.0,0.0
10068,1,68,[ 64 132 185 117 471],450,5,275,3.9855072463768115,20.0,0.0
10069,1,69,[ 64 132 185 117 471],716,4,279,3.9857142857142858,20.0,0.0
10070,1,70,[ 64 132 185 117  11],655,2,281,3.9577464788732395,20.0,0.0
10071,1,71,[286 546 508 153 125],280,3,284,3.9444444444444446,0.0,20.0
10072,1,72,[ 64 153 185 471 179],389,4,288,3.9452054794520546,20.0,0.0
10073,1,73,[ 64 185 471 179 132],450,5,293,3.9594594594594597,20.0,0.0
10074,1,74,[ 64 185 471 132 179],655,3,296,3.9466666666666668,20.0,0.0
10075,1,75,[ 64 185 179 117 471],457,5,301,3.960526315789474,20.0,0.0
10076,1,76,[ 64 185 179 117 471],655,3,304,3.948051948051948,20.0,0.0
10077,1,77,[ 64 185 179 100 471],65,3,307,3.9358974358974357,20.0,20.0
10078,1,78,[ 95 175 127 195 118],716,2,309,3.911392405063291,0.0,20.0
10079,1,79,[127  64 185  95 179],389,4,313,3.9125,20.0,20.0
10080,1,80,[127 185  64 179 471],450,5,318,3.925925925925926,20.0,20.0
10081,1,81,[127 185  64 179 471],457,5,323,3.9390243902439024,20.0,20.0
10082,1,82,[496 185 603  79 215],151,4,327,3.9397590361445785,40.0,0.0
10083,1,83,[127 185 603  79  64],716,5,332,3.9523809523809526,40.0,20.0
10084,1,84,[127 185 603  79  64],796,5,337,3.9647058823529413,40.0,20.0
10085,1,85,[127 185 603  79  64],716,5,342,3.9767441860465116,40.0,20.0
10086,1,86,[127 185 603  79  64],655,5,347,3.9885057471264367,40.0,20.0
10087,1,87,[127 185 603  79  64],655,5,352,4.0,40.0,20.0
10088,1,88,[127 185 603  79  64],796,5,357,4.01123595505618,40.0,20.0
10089,1,89,[127 185 603  79  64],389,5,362,4.022222222222222,40.0,20.0
10090,1,90,[127 185 603  79  64],796,5,367,4.032967032967033,40.0,20.0
10091,1,91,[127 185 603  79  64],716,5,372,4.043478260869565,40.0,20.0
10092,1,92,[127 185 603  79  64],655,5,377,4.053763440860215,40.0,20.0
10093,1,93,[127 185 603  79  64],796,5,382,4.0638297872340425,40.0,20.0
10094,1,94,[151 275 742  98  64],796,4,386,4.063157894736842,20.0,20.0
10095,1,95,[127 185 275 603  98],450,5,391,4.072916666666667,20.0,40.0
10096,1,96,[127 185 275 603  98],503,4,395,4.072164948453608,20.0,40.0
10097,1,97,[127 185 275  98  79],236,4,399,4.071428571428571,0.0,40.0
10098,1,98,[127 185  98  79 151],389,5,404,4.08080808080808,0.0,20.0
10099,1,99,[127 185  98  79 151],716,5,409,4.09,0.0,20.0
10100,1,100,[127 185  98  79 151],450,5,414,4.099009900990099,0.0,20.0
10101,1,101,[127 185  98  79 151],18,3,417,4.088235294117647,0.0,20.0
10102,1,102,[127  98  79  64 496],796,5,422,4.097087378640777,40.0,20.0
10103,1,103,[127  98  79  64 496],450,5,427,4.105769230769231,40.0,20.0
10104,1,104,[127  98  79  64 496],344,5,432,4.114285714285714,40.0,20.0
10105,1,105,[127  98  79  64 496],236,4,436,4.113207547169812,40.0,20.0
10106,1,106,[127  98  79  64 185],693,4,440,4.11214953271028,20.0,20.0
10107,1,107,[127  98  79  64 185],389,5,445,4.12037037037037,20.0,20.0
10108,1,108,[127  98  79  64 185],716,5,450,4.128440366972477,20.0,20.0
10109,1,109,[127  98  79  64 185],796,5,455,4.136363636363637,20.0,20.0
10110,1,110,[127  98  79  64 185],719,4,459,4.135135135135135,20.0,20.0
10111,1,111,[ 98  79  64 185 127],457,5,464,4.142857142857143,20.0,20.0
10112,1,112,[ 98  79  64 185 127],18,4,468,4.1415929203539825,20.0,20.0
10113,1,113,[ 98  79  64 127 185],796,5,473,4.149122807017544,20.0,20.0
10114,1,114,[ 98  79  64 127 185],236,5,478,4.156521739130435,20.0,20.0
10115,1,115,[ 98  79  64 127 185],457,5,483,4.163793103448276,20.0,20.0
10116,1,116,[ 98  79  64 127 185],457,5,488,4.170940170940171,20.0,20.0
10117,1,117,[ 98  79  64 127 185],457,5,493,4.177966101694915,20.0,20.0
10118,1,118,[ 98  79  64 127 185],450,5,498,4.184873949579832,20.0,20.0
10119,1,119,[ 98  79  64 127 185],655,5,503,4.191666666666666,20.0,20.0
10120,1,120,[333 135  28 100  69],236,2,505,4.1735537190082646,0.0,20.0
10121,1,121,[ 89  98  64 385 546],344,3,508,4.163934426229508,20.0,0.0
10122,1,122,[742 300 187 655 222],693,0,508,4.130081300813008,0.0,0.0
10123,1,123,[ 89  98  79  64 127],450,5,513,4.137096774193548,20.0,20.0
10124,1,124,[ 89  98  79  64 127],796,5,518,4.144,20.0,20.0
10125,1,125,[ 89  98  79  64 127],655,5,523,4.150793650793651,20.0,20.0
10126,1,126,[ 89  98  79  64 127],72,4,527,4.149606299212598,20.0,20.0
10127,1,127,[ 98  79  64 127 185],450,5,532,4.15625,20.0,20.0
10128,1,128,[ 98  79  64 127 185],450,5,537,4.162790697674419,20.0,20.0
10129,1,129,[ 98  79  64 127 185],256,5,542,4.1692307692307695,20.0,20.0
10130,1,130,[ 98  79  64 127 185],389,5,547,4.175572519083969,20.0,20.0
10131,1,131,[ 98  79  64 127 185],18,4,551,4.174242424242424,20.0,20.0
10132,1,132,[100 117 176   9 237],280,2,553,4.157894736842105,0.0,20.0
10133,1,133,[ 79   9  98  64 127],72,5,558,4.164179104477612,20.0,20.0
10134,1,134,[ 79   9  98  64 127],256,5,563,4.17037037037037,20.0,20.0
10135,1,135,[ 79   9  98  64 127],72,5,568,4.176470588235294,20.0,20.0
10136,1,136,[ 79   9  98  64 127],18,5,573,4.182481751824818,20.0,20.0
10137,1,137,[ 79   9  98  64 127],292,5,578,4.188405797101449,20.0,20.0
10138,1,138,[ 79   9  98  64 127],18,5,583,4.194244604316546,20.0,20.0
10139,1,139,[ 79   9  98  64 127],18,5,588,4.2,20.0,20.0
10140,1,140,[ 79   9  98  64 127],292,5,593,4.205673758865248,20.0,20.0
10141,1,141,[ 79   9  98  64 127],344,5,598,4.211267605633803,20.0,20.0
10142,1,142,[ 79   9  98  64 127],655,4,602,4.20979020979021,20.0,20.0
10143,1,143,[ 79  98  64 127 185],796,5,607,4.215277777777778,20.0,20.0
10144,1,144,[ 79  98  64 127 185],719,4,611,4.213793103448276,20.0,20.0
10145,1,145,[ 79  98  64 127 185],693,4,615,4.212328767123288,20.0,20.0
10146,1,146,[ 79  98  64 127 185],693,4,619,4.210884353741497,20.0,20.0
10147,1,147,[ 79  98  64 127 185],450,5,624,4.216216216216216,20.0,20.0
10148,1,148,[ 79  98  64 127 185],389,5,629,4.221476510067114,20.0,20.0
10149,1,149,[ 79  98  64 127 185],457,5,634,4.226666666666667,20.0,20.0
10150,1,150,[ 79  98  64 127 185],719,4,638,4.225165562913907,20.0,20.0
10151,1,151,[ 98  79  64 185 127],719,4,642,4.223684210526316,20.0,20.0
10152,1,152,[ 98  79  64 185 127],719,4,646,4.222222222222222,20.0,20.0
10153,1,153,[ 98  79  64 185 603],18,3,649,4.214285714285714,40.0,0.0
10154,1,154,[ 98  79  64 185 127],655,5,654,4.219354838709678,20.0,20.0
10155,1,155,[ 98  79  64 185 127],693,4,658,4.217948717948718,20.0,20.0
10156,1,156,[ 98  79  64 185 127],450,5,663,4.222929936305732,20.0,20.0
10157,1,157,[ 98  79  64 185 127],256,5,668,4.227848101265823,20.0,20.0
10158,1,158,[ 98  79  64 185 127],796,5,673,4.232704402515723,20.0,20.0
10159,1,159,[ 98  79  64 185 127],457,5,678,4.2375,20.0,20.0
10160,1,160,[ 98  79  64 185 127],450,5,683,4.24223602484472,20.0,20.0
10161,1,161,[ 98  79  64 185 127],450,5,688,4.246913580246914,20.0,20.0
10162,1,162,[ 98  79  64 185 127],796,5,693,4.251533742331288,20.0,20.0
10163,1,163,[ 98  79  64 185 127],655,5,698,4.2560975609756095,20.0,20.0
10164,1,164,[ 98  79  64 185 127],450,5,703,4.260606060606061,20.0,20.0
10165,1,165,[ 98  79  64 185 127],716,5,708,4.265060240963855,20.0,20.0
10166,1,166,[ 98  79  64 185 127],655,5,713,4.269461077844311,20.0,20.0
10167,1,167,[ 98  79  64 185 127],236,5,718,4.273809523809524,20.0,20.0
10168,1,168,[ 98  79  64 185 127],716,5,723,4.27810650887574,20.0,20.0
10169,1,169,[ 98  79  64 185 127],18,4,727,4.276470588235294,20.0,20.0
10170,1,170,[144  98  12 187 191],655,3,730,4.269005847953216,0.0,0.0
10171,1,171,[ 98 191  79  64 185],457,5,735,4.273255813953488,20.0,0.0
10172,1,172,[ 98 191  79  64 185],151,4,739,4.271676300578035,20.0,0.0
10173,1,173,[ 98  79  64 185 127],389,5,744,4.275862068965517,20.0,20.0
10174,1,174,[ 98  79  64 185 127],719,4,748,4.274285714285714,20.0,20.0
10175,1,175,[ 98  79  64 185 127],719,4,752,4.2727272727272725,20.0,20.0
10176,1,176,[ 98  79  64 185 127],236,5,757,4.27683615819209,20.0,20.0
10177,1,177,[ 98  79  64 185 127],450,5,762,4.280898876404494,20.0,20.0
10178,1,178,[ 98  79  64 185 127],236,5,767,4.284916201117318,20.0,20.0
10179,1,179,[ 98  79  64 185 127],236,5,772,4.288888888888889,20.0,20.0
10180,1,180,[ 98  79  64 185 127],716,5,777,4.292817679558011,20.0,20.0
10181,1,181,[ 98  79  64 185 127],719,4,781,4.291208791208791,20.0,20.0
10182,1,182,[ 98  79  64 185 127],796,5,786,4.295081967213115,20.0,20.0
10183,1,183,[ 98  79  64 185 127],18,4,790,4.293478260869565,20.0,20.0
10184,1,184,[ 98  79  64 185 127],716,5,795,4.297297297297297,20.0,20.0
10185,1,185,[ 98  79  64 185 127],716,5,800,4.301075268817204,20.0,20.0
10186,1,186,[ 98  79  64 185 127],450,5,805,4.304812834224599,20.0,20.0
10187,1,187,[ 98  79  64 185 127],236,5,810,4.308510638297872,20.0,20.0
10188,1,188,[ 98  79  64 185 127],18,4,814,4.306878306878307,20.0,20.0
10189,1,189,[ 98  79  64 185 127],716,5,819,4.310526315789474,20.0,20.0
10190,1,190,[ 98  79  64 185 127],655,5,824,4.31413612565445,20.0,20.0
10191,1,191,[ 98  79  64 185 127],18,4,828,4.3125,20.0,20.0
10192,1,192,[ 98  79  64 185 127],450,5,833,4.316062176165803,20.0,20.0
10193,1,193,[322 127 132 181  28],796,3,836,4.309278350515464,0.0,20.0
10194,1,194,[181  98  79  64 185],450,5,841,4.312820512820513,20.0,0.0
10195,1,195,[181  98  79  64 185],796,5,846,4.316326530612245,20.0,0.0
10196,1,196,[181  98  79  64 185],18,3,849,4.309644670050761,20.0,0.0
10197,1,197,[ 98  79  64 127 185],693,4,853,4.308080808080808,20.0,20.0
10198,1,198,[ 98  79  64 127 185],796,5,858,4.311557788944723,20.0,20.0
10199,1,199,[588 118 234 748 294],796,3,861,4.305,0.0,0.0
10200,1,200,[748 588  79  98  64],450,5,866,4.308457711442786,20.0,0.0
10201,1,201,[179 234  25 216 191],389,3,869,4.301980198019802,0.0,0.0
10202,1,202,[748 588  98  79  64],796,5,874,4.305418719211823,20.0,0.0
10203,1,203,[748 588  98  79  64],796,5,879,4.3088235294117645,20.0,0.0
10204,1,204,[ 11 357   9 174 211],593,4,883,4.307317073170732,0.0,0.0
10205,1,205,[132 182 300  79 118],655,2,885,4.296116504854369,0.0,0.0
10206,1,206,[748 357 588 174  98],450,5,890,4.299516908212561,0.0,0.0
10207,1,207,[748 357 588 174  98],450,5,895,4.302884615384615,0.0,0.0
10208,1,208,[483 403 202 185 172],457,5,900,4.30622009569378,0.0,0.0
10209,1,209,[173 483 237 180 471],280,2,902,4.295238095238095,0.0,0.0
10210,1,210,[172  98 403 483 748],280,2,904,4.2843601895734595,0.0,0.0
10211,1,211,[ 79 357 174  98 483],693,4,908,4.283018867924528,0.0,0.0
10212,1,212,[ 79 180 174  98 357],535,2,910,4.272300469483568,0.0,0.0
10213,1,213,[588 174 180  79  98],796,4,914,4.271028037383178,0.0,0.0
10214,1,214,[588 174  79  98  64],457,5,919,4.274418604651163,20.0,0.0
10215,1,215,[588 174  79  98  64],716,5,924,4.277777777777778,20.0,0.0
10216,1,216,[588 174  79  98  64],457,5,929,4.28110599078341,20.0,0.0
10217,1,217,[588 174  79  98  64],389,5,934,4.284403669724771,20.0,0.0
10218,1,218,[588 174  79  98  64],796,5,939,4.287671232876712,20.0,0.0
10219,1,219,[588 174  79  98  64],796,5,944,4.290909090909091,20.0,0.0
10220,1,220,[588 174  79  98  64],344,5,949,4.294117647058823,20.0,0.0
10221,1,221,[588 174  79  98  64],796,5,954,4.297297297297297,20.0,0.0
10222,1,222,[588 174  79  98  64],18,5,959,4.300448430493273,20.0,0.0
10223,1,223,[588 174  79  98  64],457,5,964,4.303571428571429,20.0,0.0
10224,1,224,[588 174  79  98  64],18,5,969,4.306666666666667,20.0,0.0
10225,1,225,[588 174  79  98  64],389,5,974,4.3097345132743365,20.0,0.0
10226,1,226,[588 174  79  98  64],457,5,979,4.312775330396476,20.0,0.0
10227,1,227,[269 151 282 180 197],450,5,984,4.315789473684211,0.0,0.0
10228,1,228,[197 174 269 588  79],18,5,989,4.318777292576419,0.0,0.0
10229,1,229,[197 174 269 588  79],450,5,994,4.321739130434783,0.0,0.0
10230,1,230,[197 174 269 588  79],450,5,999,4.324675324675325,0.0,0.0
10231,1,231,[197 174 269 588  79],796,3,1002,4.318965517241379,0.0,0.0
10232,1,232,[588 174  79  98  64],457,5,1007,4.3218884120171674,20.0,0.0
10233,1,233,[588 174  79  98  64],344,5,1012,4.3247863247863245,20.0,0.0
10234,1,234,[588 174  79  98  64],577,5,1017,4.327659574468085,20.0,0.0
10235,1,235,[235  96 222 174  97],450,3,1020,4.322033898305085,0.0,0.0
10236,1,236,[ 96 588  97 174  79],796,4,1024,4.320675105485232,0.0,0.0
10237,1,237,[151 423  88 268 121],269,3,1027,4.315126050420168,0.0,0.0
10238,1,238,[174  96 588 423  79],577,5,1032,4.317991631799163,0.0,0.0
10239,1,239,[174  96 588 423  79],796,5,1037,4.320833333333334,0.0,0.0
10240,1,240,[174  96 588 423  79],577,5,1042,4.323651452282157,0.0,0.0
10241,1,241,[174  96 588 423  79],796,5,1047,4.3264462809917354,0.0,0.0
10242,1,242,[174  96 588 423  79],450,5,1052,4.329218106995885,0.0,0.0
10243,1,243,[174  96 588 423  79],450,5,1057,4.331967213114754,0.0,0.0
10244,1,244,[174  96 588 423  79],280,4,1061,4.330612244897959,0.0,0.0
10245,1,245,[ 96 588 423  79  98],457,5,1066,4.333333333333333,0.0,0.0
10246,1,246,[ 96 588 423  79  98],577,5,1071,4.336032388663968,0.0,0.0
10247,1,247,[ 96 588 423  79  98],716,4,1075,4.334677419354839,0.0,0.0
10248,1,248,[588 423  79  98  64],716,5,1080,4.337349397590361,20.0,0.0
10249,1,249,[588 423  79  98  64],450,5,1085,4.34,20.0,0.0
10250,1,250,[588 423  79  98  64],389,5,1090,4.342629482071713,20.0,0.0
10251,1,251,[ 88 117 186 176 385],796,4,1094,4.341269841269841,0.0,0.0
10252,1,252,[423 588  79  98  64],18,5,1099,4.3438735177865615,20.0,0.0
10253,1,253,[423 588  79  98  64],796,5,1104,4.346456692913386,20.0,0.0
10254,1,254,[423 588  79  98  64],796,5,1109,4.349019607843137,20.0,0.0
10255,1,255,[423 588  79  98  64],716,5,1114,4.3515625,20.0,0.0
10256,1,256,[423 588  79  98  64],716,5,1119,4.35408560311284,20.0,0.0
10257,1,257,[423 588  79  98  64],18,5,1124,4.3565891472868215,20.0,0.0
10258,1,258,[423 588  79  98  64],796,5,1129,4.359073359073359,20.0,0.0
10259,1,259,[423 588  79  98  64],450,5,1134,4.361538461538461,20.0,0.0
10260,1,260,[265 301 276 195  50],535,3,1137,4.35632183908046,0.0,20.0
10261,1,261,[ 50 423 588  79  98],796,5,1142,4.358778625954199,0.0,20.0
10262,1,262,[ 50 423 588  79  98],23,4,1146,4.357414448669202,0.0,20.0
10263,1,263,[ 50 588  79  98  64],577,5,1151,4.359848484848484,20.0,20.0
10264,1,264,[ 50 588  79  98  64],457,5,1156,4.362264150943396,20.0,20.0
10265,1,265,[ 50 588  79  98  64],18,5,1161,4.364661654135339,20.0,20.0
10266,1,266,[ 50 588  79  98  64],344,5,1166,4.367041198501872,20.0,20.0
10267,1,267,[ 50 588  79  98  64],796,5,1171,4.369402985074627,20.0,20.0
10268,1,268,[ 50 588  79  98  64],450,5,1176,4.371747211895911,20.0,20.0
10269,1,269,[ 50 588  79  98  64],18,5,1181,4.374074074074074,20.0,20.0
10270,1,270,[ 50 588  79  98  64],18,5,1186,4.376383763837638,20.0,20.0
10271,1,271,[ 50 588  79  98  64],344,5,1191,4.3786764705882355,20.0,20.0
10272,1,272,[ 50 588  79  98  64],457,5,1196,4.380952380952381,20.0,20.0
10273,1,273,[ 50 588  79  98  64],344,5,1201,4.383211678832117,20.0,20.0
10274,1,274,[ 50 588  79  98  64],457,5,1206,4.385454545454546,20.0,20.0
10275,1,275,[ 50 588  79  98  64],457,5,1211,4.38768115942029,20.0,20.0
10276,1,276,[ 50 588  79  98  64],796,5,1216,4.389891696750903,20.0,20.0
10277,1,277,[ 50 588  79  98  64],577,5,1221,4.392086330935252,20.0,20.0
10278,1,278,[ 50 588  79  98  64],450,5,1226,4.39426523297491,20.0,20.0
10279,1,279,[ 50 588  79  98  64],796,5,1231,4.396428571428571,20.0,20.0
10280,1,280,[ 50 588  79  98  64],716,5,1236,4.398576512455516,20.0,20.0
10281,1,281,[ 50 588  79  98  64],450,5,1241,4.400709219858156,20.0,20.0
10282,1,282,[ 50 588  79  98  64],344,5,1246,4.402826855123675,20.0,20.0
10283,1,283,[ 50 588  79  98  64],344,5,1251,4.404929577464789,20.0,20.0
10284,1,284,[483 196 185 282 197],716,4,1255,4.4035087719298245,0.0,0.0
10285,1,285,[ 50 588  79  98  64],344,5,1260,4.405594405594406,20.0,20.0
10286,1,286,[ 50 588  79  98  64],18,5,1265,4.407665505226481,20.0,20.0
10287,1,287,[ 50 588  79  98  64],577,5,1270,4.409722222222222,20.0,20.0
10288,1,288,[ 50 588  79  98  64],389,5,1275,4.411764705882353,20.0,20.0
10289,1,289,[ 50 588  79  98  64],18,5,1280,4.413793103448276,20.0,20.0
10290,1,290,[ 15   7 288 238 318],457,5,1285,4.415807560137457,20.0,0.0
10291,1,291,[318 238  15  50 288],655,2,1287,4.407534246575342,20.0,20.0
10292,1,292,[318 588  50  79  98],796,5,1292,4.409556313993174,20.0,20.0
10293,1,293,[204 385  98 161 180],450,5,1297,4.41156462585034,0.0,0.0
10294,1,294,[ 50 161 588 204 318],280,3,1300,4.406779661016949,20.0,20.0
10295,1,295,[161 588 318  79  98],450,5,1305,4.408783783783784,20.0,0.0
10296,1,296,[161 588 318  79  98],716,4,1309,4.407407407407407,20.0,0.0
10297,1,297,[ 70 194 427  82 183],269,2,1311,4.399328859060403,20.0,0.0
10298,1,298,[318 427 588 194  79],450,5,1316,4.40133779264214,40.0,0.0
10299,1,299,[318 427 588 194  79],18,4,1320,4.4,40.0,0.0
10300,1,300,[318 427 588  79  98],716,5,1325,4.401993355481728,40.0,0.0
10301,1,301,[318 427 588  79  98],716,5,1330,4.403973509933775,40.0,0.0
10302,1,302,[257 210 318 234 197],504,4,1334,4.402640264026402,20.0,0.0
10303,1,303,[427 210 318 588 257],807,5,1339,4.404605263157895,40.0,0.0
10304,1,304,[427 210 318 588 257],796,4,1343,4.4032786885245905,40.0,0.0
10305,1,305,[300 423 153  25  50],151,4,1347,4.401960784313726,0.0,20.0
10306,1,306,[318 588 427 257  79],807,5,1352,4.403908794788274,40.0,0.0
10307,1,307,[318 588 427 257  79],807,5,1357,4.4058441558441555,40.0,0.0
10308,1,308,[318 588 427 257  79],807,5,1362,4.407766990291262,40.0,0.0
10309,1,309,[318 588 427 257  79],807,5,1367,4.409677419354839,40.0,0.0
10310,1,310,[  9  22 195 175 172],457,5,1372,4.411575562700965,0.0,0.0
10311,1,311,[427 318 588 257  79],807,5,1377,4.413461538461538,40.0,0.0
10312,1,312,[ 56 132 100 144 235],292,4,1381,4.412140575079873,0.0,20.0
10313,1,313,[318 257 588 427  79],796,5,1386,4.414012738853503,40.0,0.0
10314,1,314,[318 257 588 427  79],807,5,1391,4.415873015873016,40.0,0.0
10315,1,315,[318 257 588 427  79],807,5,1396,4.417721518987341,40.0,0.0
10316,1,316,[318 257 588 427  79],716,5,1401,4.419558359621451,40.0,0.0
10317,1,317,[318 257 588 427  79],796,5,1406,4.421383647798742,40.0,0.0
10318,1,318,[318 257 588 427  79],716,5,1411,4.423197492163009,40.0,0.0
10319,1,319,[318 257 588 427  79],796,5,1416,4.425,40.0,0.0
10320,1,320,[423 215  28 118 196],151,3,1419,4.420560747663552,0.0,0.0
10321,1,321,[179  15 742 173 655],593,4,1423,4.419254658385094,0.0,0.0
10322,1,322,[318 427 588 257  79],807,5,1428,4.421052631578948,40.0,0.0
10323,1,323,[318 427 588 257  79],807,5,1433,4.422839506172839,40.0,0.0
10324,1,324,[318 427 588 257  79],807,5,1438,4.424615384615384,40.0,0.0
10325,1,325,[132 191 135 202  56],629,4,1442,4.423312883435583,0.0,0.0
10326,1,326,[588 257 318 427  79],807,5,1447,4.425076452599388,40.0,0.0
10327,1,327,[588 257 318 427  79],796,5,1452,4.426829268292683,40.0,0.0
10328,1,328,[  1 196   4 117 742],450,4,1456,4.425531914893617,0.0,0.0
10329,1,329,[318 427 588   1 257],330,5,1461,4.427272727272728,40.0,0.0
10330,1,330,[318 427 588   1 257],330,5,1466,4.429003021148036,40.0,0.0
10331,1,331,[318 427 588   1 257],796,4,1470,4.427710843373494,40.0,0.0
10332,1,332,[257 318 427 588  79],807,5,1475,4.42942942942943,40.0,0.0
10333,1,333,[257 318 427 588  79],807,5,1480,4.431137724550898,40.0,0.0
10334,1,334,[257 318 427 588  79],716,5,1485,4.432835820895522,40.0,0.0
10335,1,335,[257 318 427 588  79],796,5,1490,4.434523809523809,40.0,0.0
10336,1,336,[181 100 211 144 235],450,4,1494,4.433234421364985,0.0,20.0
10337,1,337,[175 172 357 196 405],23,3,1497,4.428994082840236,0.0,0.0
10338,1,338,[427 588 318 257 405],330,5,1502,4.430678466076696,40.0,0.0
10339,1,339,[427 588 318 257 405],796,5,1507,4.432352941176471,40.0,0.0
10340,1,340,[427 588 318 257 405],330,5,1512,4.4340175953079175,40.0,0.0
10341,1,341,[427 588 318 257 405],796,5,1517,4.435672514619883,40.0,0.0
10342,1,342,[181 135 144 496  50],807,5,1522,4.437317784256559,20.0,20.0
10343,1,343,[318 427 588 405 257],330,5,1527,4.438953488372093,40.0,0.0
10344,1,344,[ 82 176 237  97 568],577,4,1531,4.43768115942029,0.0,0.0
10345,1,345,[427 588 257 405 318],807,5,1536,4.4393063583815024,40.0,0.0
10346,1,346,[427 588 257 405 318],796,5,1541,4.4409221902017295,40.0,0.0
10347,1,347,[427 588 257 405 318],807,5,1546,4.442528735632184,40.0,0.0
10348,1,348,[427 588 257 405 318],796,5,1551,4.444126074498567,40.0,0.0
10349,1,349,[427 588 257 405 318],835,2,1553,4.437142857142857,40.0,0.0
10350,1,350,[318 427  79  98 588],716,5,1558,4.438746438746438,40.0,0.0
10351,1,351,[318 427  79  98 588],18,5,1563,4.440340909090909,40.0,0.0
10352,1,352,[318 427  79  98 588],577,5,1568,4.441926345609065,40.0,0.0
10353,1,353,[318 427  79  98 588],577,5,1573,4.443502824858757,40.0,0.0
10354,1,354,[318 427  79  98 588],796,5,1578,4.445070422535212,40.0,0.0
10355,1,355,[318 427  79  98 588],450,5,1583,4.446629213483146,40.0,0.0
10356,1,356,[318 427  79  98 588],796,5,1588,4.448179271708684,40.0,0.0
10357,1,357,[318 427  79  98 588],18,5,1593,4.449720670391062,40.0,0.0
10358,1,358,[318 427  79  98 588],450,5,1598,4.451253481894151,40.0,0.0
10359,1,359,[318 427  79  98 588],796,5,1603,4.4527777777777775,40.0,0.0
10360,1,360,[318 427  79  98 588],577,5,1608,4.454293628808864,40.0,0.0
10361,1,361,[318 427  79  98 588],716,5,1613,4.455801104972376,40.0,0.0
10362,1,362,[318 427  79  98 588],18,5,1618,4.457300275482094,40.0,0.0
10363,1,363,[204 211 496 273 132],236,1,1619,4.447802197802198,20.0,0.0
10364,1,364,[318 427  79  98 588],577,5,1624,4.449315068493151,40.0,0.0
10365,1,365,[318 427  79  98 588],450,5,1629,4.450819672131147,40.0,0.0
10366,1,366,[318 427  79  98 588],450,5,1634,4.452316076294278,40.0,0.0
10367,1,367,[318 427  79  98 588],450,5,1639,4.453804347826087,40.0,0.0
10368,1,368,[318 427  79  98 588],18,5,1644,4.455284552845528,40.0,0.0
10369,1,369,[ 64 216 245 423 568],796,4,1648,4.454054054054054,20.0,0.0
10370,1,370,[ 79 276 357 301  96],655,3,1651,4.450134770889488,0.0,0.0
10371,1,371,[427 318  79  98 588],450,5,1656,4.451612903225806,40.0,0.0
10372,1,372,[427 318  79  98 588],450,5,1661,4.453083109919571,40.0,0.0
10373,1,373,[427 318  79  98 588],18,5,1666,4.454545454545454,40.0,0.0
10374,1,374,[ 64 132 153 475 471],389,4,1670,4.453333333333333,20.0,0.0
10375,1,375,[318 427 475  79  98],655,4,1674,4.452127659574468,40.0,0.0
10376,1,376,[318 427  79  98 588],577,5,1679,4.453580901856764,40.0,0.0
10377,1,377,[117 187 195 238   7],655,1,1680,4.444444444444445,0.0,0.0
10378,1,378,[318 427  79  98 588],716,5,1685,4.445910290237467,40.0,0.0
10379,1,379,[288  70 200 403 275],450,3,1688,4.442105263157894,0.0,20.0
10380,1,380,[ 64 238 257 143  98],457,4,1692,4.440944881889764,20.0,0.0
10381,1,381,[318 427  79  98 588],450,5,1697,4.442408376963351,40.0,0.0
10382,1,382,[186  50 200  69 228],457,5,1702,4.443864229765013,0.0,20.0
10383,1,383,[318 427  79  98 588],18,5,1707,4.4453125,40.0,0.0
10384,1,384,[318 427  79  98 588],716,5,1712,4.4467532467532465,40.0,0.0
10385,1,385,[318 427  79  98 588],577,5,1717,4.448186528497409,40.0,0.0
10386,1,386,[ 79  56 333 748 496],796,5,1722,4.449612403100775,20.0,0.0
10387,1,387,[427 318  79  98 588],577,5,1727,4.451030927835052,40.0,0.0
10388,1,388,[427 318  79  98 588],450,5,1732,4.4524421593830334,40.0,0.0
10389,1,389,[118 427 196 275 117],655,2,1734,4.446153846153846,20.0,20.0
10390,1,390,[235 174 144 403 143],457,4,1738,4.445012787723785,0.0,0.0
10391,1,391,[318 427  79  98 588],716,5,1743,4.446428571428571,40.0,0.0
10392,1,392,[318 427  79  98 588],716,5,1748,4.447837150127226,40.0,0.0
10393,1,393,[288 185 234 302 289],655,2,1750,4.441624365482234,0.0,0.0
10394,1,394,[302 318 427  79  98],655,5,1755,4.443037974683544,40.0,0.0
10395,1,395,[257 144  96 216 181],796,5,1760,4.444444444444445,0.0,0.0
10396,1,396,[423 357 195 258 546],796,5,1765,4.445843828715366,0.0,0.0
10397,1,397,[302 258 318 427  79],450,5,1770,4.447236180904523,40.0,0.0
10398,1,398,[302 258 318 427  79],655,4,1774,4.446115288220551,40.0,0.0
10399,1,399,[603  25 282 301 269],450,4,1778,4.445,20.0,0.0
10400,1,400,[302 318 427  79  98],655,5,1783,4.446384039900249,40.0,0.0
10401,1,401,[ 70 273 186 132   1],450,3,1786,4.442786069651741,0.0,0.0
10402,1,402,[302 318 427  79  98],151,4,1790,4.441687344913151,40.0,0.0
10403,1,403,[153 127  70 328 191],655,2,1792,4.435643564356436,0.0,20.0
10404,1,404,[427 318  79  98 588],796,5,1797,4.437037037037037,40.0,0.0
10405,1,405,[427 318  79  98 588],716,5,1802,4.438423645320197,40.0,0.0
10406,1,406,[427 318  79  98 588],716,5,1807,4.439803439803439,40.0,0.0
10407,1,407,[427 318  79  98 588],716,5,1812,4.4411764705882355,40.0,0.0
10408,1,408,[427 318  79  98 588],716,5,1817,4.442542787286063,40.0,0.0
10409,1,409,[427 318  79  98 588],577,5,1822,4.443902439024391,40.0,0.0
10410,1,410,[427 318  79  98 588],577,5,1827,4.445255474452555,40.0,0.0
10411,1,411,[427 318  79  98 588],450,5,1832,4.446601941747573,40.0,0.0
10412,1,412,[427 318  79  98 588],450,5,1837,4.447941888619854,40.0,0.0
10413,1,413,[427 318  79  98 588],577,5,1842,4.449275362318841,40.0,0.0
10414,1,414,[427 318  79  98 588],577,5,1847,4.450602409638554,40.0,0.0
10415,1,415,[427 318  79  98 588],450,5,1852,4.451923076923077,40.0,0.0
10416,1,416,[427 318  79  98 588],577,5,1857,4.453237410071942,40.0,0.0
10417,1,417,[427 318  79  98 588],716,5,1862,4.454545454545454,40.0,0.0
10418,1,418,[427 318  79  98 588],716,5,1867,4.455847255369928,40.0,0.0
10419,1,419,[427 318  79  98 588],796,5,1872,4.457142857142857,40.0,0.0
10420,1,420,[427 318  79  98 588],18,5,1877,4.458432304038005,40.0,0.0
10421,1,421,[427 318  79  98 588],18,5,1882,4.459715639810427,40.0,0.0
10422,1,422,[427 318  79  98 588],577,5,1887,4.460992907801418,40.0,0.0
10423,1,423,[427 318  79  98 588],450,5,1892,4.462264150943396,40.0,0.0
10424,1,424,[546 117  56 588   8],796,5,1897,4.463529411764706,0.0,0.0
10425,1,425,[318 427   8  79  98],535,3,1900,4.460093896713615,40.0,0.0
10426,1,426,[318 427   8 588  79],796,5,1905,4.46135831381733,40.0,0.0
10427,1,427,[318 427   8 588  79],18,5,1910,4.462616822429907,40.0,0.0
10428,1,428,[318 427   8 588  79],807,5,1915,4.463869463869464,40.0,0.0
10429,1,429,[318 427   8 588  79],18,5,1920,4.465116279069767,40.0,0.0
10430,1,430,[318 427   8 588  79],807,5,1925,4.466357308584687,40.0,0.0
10431,1,431,[318 427   8 588  79],18,5,1930,4.467592592592593,40.0,0.0
10432,1,432,[318 427   8 588  79],807,5,1935,4.468822170900693,40.0,0.0
10433,1,433,[318 427   8 588  79],796,5,1940,4.470046082949309,40.0,0.0
10434,1,434,[318 427   8 588  79],18,5,1945,4.471264367816092,40.0,0.0
10435,1,435,[318 427   8 588  79],577,5,1950,4.472477064220183,40.0,0.0
10436,1,436,[318 427   8 588  79],796,5,1955,4.473684210526316,40.0,0.0
10437,1,437,[318 427   8 588  79],18,5,1960,4.474885844748859,40.0,0.0
10438,1,438,[318 427   8 588  79],18,5,1965,4.476082004555809,40.0,0.0
10439,1,439,[318 427   8 588  79],18,5,1970,4.4772727272727275,40.0,0.0
10440,1,440,[318 427   8 588  79],18,5,1975,4.478458049886621,40.0,0.0
10441,1,441,[318 427   8 588  79],796,5,1980,4.479638009049774,40.0,0.0
10442,1,442,[ 71 200  79 423  69],593,5,1985,4.480812641083522,0.0,0.0
10443,1,443,[318 427   8 588  79],577,5,1990,4.481981981981982,40.0,0.0
10444,1,444,[294  89 268 302  97],655,2,1992,4.476404494382022,0.0,0.0
10445,1,445,[318 427   8 588  79],807,5,1997,4.477578475336323,40.0,0.0
10446,1,446,[318 427   8 588  79],796,5,2002,4.4787472035794185,40.0,0.0
10447,1,447,[318 427   8 588  79],18,5,2007,4.479910714285714,40.0,0.0
10448,1,448,[318 427   8 588  79],577,5,2012,4.481069042316259,40.0,0.0
10449,1,449,[318 427   8 588  79],796,5,2017,4.482222222222222,40.0,0.0
10450,1,450,[318 427   8 588  79],796,5,2022,4.483370288248337,40.0,0.0
10451,1,451,[318 427   8 588  79],807,5,2027,4.484513274336283,40.0,0.0
10452,1,452,[318 427   8 588  79],577,5,2032,4.485651214128035,40.0,0.0
10453,1,453,[ 15 176  28  22 300],796,4,2036,4.484581497797357,0.0,0.0
10454,1,454,[318 427   8 588  79],18,5,2041,4.485714285714286,40.0,0.0
10455,1,455,[318 427   8 588  79],18,5,2046,4.4868421052631575,40.0,0.0
10456,1,456,[ 22 121 318 234 100],577,4,2050,4.485776805251641,20.0,20.0
10457,1,457,[265   7  11 276 238],457,5,2055,4.486899563318778,0.0,0.0
10458,1,458,[318 427   8 588  79],796,5,2060,4.4880174291939,40.0,0.0
10459,1,459,[318 427   8 588  79],796,5,2065,4.489130434782608,40.0,0.0
10460,1,460,[318 427   8 588  79],796,5,2070,4.490238611713666,40.0,0.0
10461,1,461,[318 427   8 588  79],796,5,2075,4.491341991341991,40.0,0.0
10462,1,462,[318 427   8 588  79],18,5,2080,4.49244060475162,40.0,0.0
10463,1,463,[318 427   8 588  79],18,5,2085,4.493534482758621,40.0,0.0
10464,1,464,[127  11 302 173   7],269,1,2086,4.486021505376344,0.0,20.0
10465,1,465,[318   8 427 588  79],18,5,2091,4.487124463519313,40.0,0.0
10466,1,466,[318   8 427 588  79],807,5,2096,4.488222698072805,40.0,0.0
10467,1,467,[318   8 427 588  79],807,5,2101,4.489316239316239,40.0,0.0
10468,1,468,[ 15 181 483 496 194],796,5,2106,4.490405117270789,20.0,0.0
10469,1,469,[318   8 427 588  79],796,5,2111,4.491489361702127,40.0,0.0
10470,1,470,[318   8 427 588  79],18,5,2116,4.492569002123142,40.0,0.0
10471,1,471,[318   8 427 588  79],577,5,2121,4.49364406779661,40.0,0.0
10472,1,472,[318   8 427 588  79],577,5,2126,4.494714587737843,40.0,0.0
10473,1,473,[318   8 427 588  79],577,5,2131,4.4957805907173,40.0,0.0
10474,1,474,[125 180 471 117 132],450,5,2136,4.496842105263158,0.0,0.0
10475,1,475,[318   8 427 588  79],18,5,2141,4.4978991596638656,40.0,0.0
10476,1,476,[318   8 427 588  79],807,5,2146,4.49895178197065,40.0,0.0
10477,1,477,[318   8 427 588  79],18,5,2151,4.5,40.0,0.0
10478,1,478,[318   8 427 588  79],577,5,2156,4.501043841336117,40.0,0.0
10479,1,479,[318   8 427 588  79],807,5,2161,4.502083333333333,40.0,0.0
10480,1,480,[318   8 427 588  79],796,5,2166,4.503118503118503,40.0,0.0
10481,1,481,[318   8 427 588  79],807,5,2171,4.504149377593361,40.0,0.0
10482,1,482,[318   8 427 588  79],807,5,2176,4.505175983436853,40.0,0.0
10483,1,483,[318   8 427 588  79],807,5,2181,4.506198347107438,40.0,0.0
10484,1,484,[318   8 427 588  79],796,5,2186,4.507216494845361,40.0,0.0
10485,1,485,[216  79 300 210  64],693,2,2188,4.502057613168724,20.0,0.0
10486,1,486,[742 191 301 183 318],450,5,2193,4.503080082135524,20.0,0.0
10487,1,487,[121  69 313 174 185],450,4,2197,4.502049180327869,0.0,0.0
10488,1,488,[313   8 318 427 588],807,5,2202,4.5030674846625764,40.0,0.0
10489,1,489,[313   8 318 427 588],807,5,2207,4.504081632653061,40.0,0.0
10490,1,490,[313   8 318 427 588],577,5,2212,4.505091649694501,40.0,0.0
10491,1,491,[313   8 318 427 588],577,5,2217,4.5060975609756095,40.0,0.0
10492,1,492,[313   8 318 427 588],577,5,2222,4.50709939148073,40.0,0.0
10493,1,493,[313   8 318 427 588],577,5,2227,4.508097165991903,40.0,0.0
10494,1,494,[313   8 318 427 588],796,5,2232,4.509090909090909,40.0,0.0
10495,1,495,[313   8 318 427 588],577,5,2237,4.51008064516129,40.0,0.0
10496,1,496,[313   8 318 427 588],796,5,2242,4.511066398390342,40.0,0.0
10497,1,497,[ 79 215 234 403 742],796,3,2245,4.508032128514056,0.0,0.0
10498,1,498,[313   8 318 427 588],807,5,2250,4.509018036072145,40.0,0.0
10499,1,499,[496 655 294 300 215],450,5,2255,4.51,20.0,0.0
10500,1,500,[313   8 318 427 588],796,5,2260,4.510978043912176,40.0,0.0
10501,1,501,[ 28  88   9 471 742],457,5,2265,4.51195219123506,0.0,0.0
10502,1,502,[313   8 318 427 588],807,5,2270,4.512922465208748,40.0,0.0
10503,1,503,[313   8 318 427 588],796,5,2275,4.513888888888889,40.0,0.0
10504,1,504,[117   9 435 655 313],236,3,2278,4.5108910891089105,0.0,0.0
10505,1,505,[427 313   8 435 318],503,4,2282,4.509881422924901,40.0,0.0
10506,1,506,[313   8 318 427 588],807,5,2287,4.510848126232742,40.0,0.0
10507,1,507,[313   8 318 427 588],577,5,2292,4.511811023622047,40.0,0.0
10508,1,508,[313   8 318 427 588],807,5,2297,4.512770137524558,40.0,0.0
10509,1,509,[313   8 318 427 588],796,5,2302,4.513725490196078,40.0,0.0
10510,1,510,[313   8 318 427 588],577,5,2307,4.514677103718199,40.0,0.0
10511,1,511,[313   8 318 427 588],807,5,2312,4.515625,40.0,0.0
10512,1,512,[313   8 318 427 588],796,5,2317,4.516569200779727,40.0,0.0
10513,1,513,[ 79  64 197 204 153],796,4,2321,4.51556420233463,20.0,0.0
10514,1,514,[174 405 194 471  88],577,2,2323,4.5106796116504855,0.0,0.0
10515,1,515,[111  11 515 357 282],716,4,2327,4.50968992248062,0.0,0.0
10516,1,516,[191  64 143 185 282],450,5,2332,4.51063829787234,20.0,0.0
10517,1,517,[313 318 515   8 427],807,5,2337,4.511583011583012,40.0,0.0
10518,1,518,[475 301 118 153 161],655,0,2337,4.502890173410405,0.0,0.0
10519,1,519,[313 318 515   8 427],655,4,2341,4.501923076923077,40.0,0.0
10520,1,520,[ 28 282 121 603 286],450,4,2345,4.500959692898273,20.0,20.0
10521,1,521,[313 318 515 427 588],807,5,2350,4.501915708812261,40.0,0.0
10522,1,522,[313 318 515 427 588],807,5,2355,4.502868068833652,40.0,0.0
10523,1,523,[588 301 273 302  79],450,4,2359,4.501908396946565,0.0,0.0
10524,1,524,[318 515 427 313 588],807,5,2364,4.502857142857143,40.0,0.0
10525,1,525,[ 56 288 216 181 127],693,3,2367,4.5,0.0,20.0
10526,1,526,[313 318 515 427 588],807,5,2372,4.500948766603416,40.0,0.0
10527,1,527,[313 318 515 427 588],807,5,2377,4.5018939393939394,40.0,0.0
10528,1,528,[195 748  15 216 678],256,5,2382,4.502835538752363,0.0,0.0
10529,1,529,[403   7 100 322 282],256,4,2386,4.50188679245283,0.0,20.0
10530,1,530,[515 318 427 313 678],807,4,2390,4.500941619585688,40.0,0.0
10531,1,531,[313 318 515 427 588],807,5,2395,4.5018796992481205,40.0,0.0
10532,1,532,[313 318 515 427 588],807,5,2400,4.50281425891182,40.0,0.0
10533,1,533,[118 228 195  96 151],256,4,2404,4.50187265917603,0.0,0.0
10534,1,534,[313 318 515 427 588],807,5,2409,4.502803738317757,40.0,0.0
10535,1,535,[313 318 515 427 588],807,5,2414,4.503731343283582,40.0,0.0
10536,1,536,[313 318 515 427 588],807,5,2419,4.504655493482309,40.0,0.0
10537,1,537,[125 174  88   9 111],151,5,2424,4.5055762081784385,0.0,0.0
10538,1,538,[435 235 174  15 161],450,3,2427,4.50278293135436,0.0,0.0
10539,1,539,[121 265 357  12 135],655,2,2429,4.4981481481481485,0.0,0.0
10540,1,540,[100 302   8   4  89],344,5,2434,4.499075785582255,0.0,20.0
10541,1,541,[318 515 427 313 588],807,5,2439,4.5,40.0,0.0
10542,1,542,[318 515 427 313 588],807,5,2444,4.500920810313075,40.0,0.0
10543,1,543,[196 403 294 176 132],655,0,2444,4.492647058823529,0.0,0.0
10544,1,544,[588 100  95 168  70],18,4,2448,4.491743119266055,0.0,20.0
10545,1,545,[ 69 235 286 275 118],450,3,2451,4.489010989010989,0.0,40.0
10546,1,546,[200 182  56  95 151],450,3,2454,4.486288848263254,0.0,0.0
10547,1,547,[318 515 427 313 588],807,5,2459,4.487226277372263,40.0,0.0
10548,1,548,[318 515 427 313 588],807,5,2464,4.48816029143898,40.0,0.0
10549,1,549,[ 50  71 183  98 245],504,3,2467,4.485454545454545,0.0,20.0
10550,1,550,[318 515 427 313 588],807,5,2472,4.486388384754991,40.0,0.0
10551,1,551,[187 202  79  28 568],450,5,2477,4.48731884057971,0.0,0.0
10552,1,552,[ 12  28  96 132  69],655,0,2477,4.479204339963833,0.0,0.0
10553,1,553,[100 127 301  96 181],296,5,2482,4.48014440433213,0.0,40.0
10554,1,554,[ 56 179   4 195 546],450,4,2486,4.47927927927928,0.0,0.0
10555,1,555,[191 195  79 211 144],450,5,2491,4.48021582733813,0.0,0.0
10556,1,556,[318 515 427 313 588],807,5,2496,4.481149012567325,40.0,0.0
10557,1,557,[268 121 235 191 202],344,2,2498,4.476702508960574,0.0,0.0
10558,1,558,[121 185  97  22 357],330,5,2503,4.477638640429338,0.0,0.0
10559,1,559,[ 11 483 182 597 196],269,2,2505,4.473214285714286,0.0,0.0
10560,1,560,[318 515 427 313 588],807,5,2510,4.47415329768271,40.0,0.0
10561,1,561,[318 515 427 313 588],807,5,2515,4.47508896797153,40.0,0.0
10562,1,562,[318 515 427 313 588],807,5,2520,4.476021314387212,40.0,0.0
10563,1,563,[289 546 125 245 257],938,1,2521,4.469858156028369,0.0,0.0
10564,1,564,[ 22 588 186  98 427],450,4,2525,4.469026548672566,20.0,0.0
10565,1,565,[318 515 427 313 588],807,5,2530,4.469964664310954,40.0,0.0
10566,1,566,[318 515 427 313 588],807,5,2535,4.470899470899471,40.0,0.0
10567,1,567,[318 515 427 313 588],807,5,2540,4.471830985915493,40.0,0.0
10568,1,568,[318 515 427 313 588],807,5,2545,4.472759226713532,40.0,0.0
10569,1,569,[318 515 427 313 588],807,5,2550,4.473684210526316,40.0,0.0
10570,1,570,[153 282 174 204 176],236,1,2551,4.467600700525394,0.0,0.0
10571,1,571,[ 71  88 435 313 172],450,4,2555,4.466783216783217,0.0,0.0
10572,1,572,[515 313 318 427 588],807,5,2560,4.467713787085515,40.0,0.0
10573,1,573,[515 313 318 427 588],807,5,2565,4.468641114982578,40.0,0.0
10574,1,574,[546  97 111  28 132],450,5,2570,4.469565217391304,0.0,0.0
10575,1,575,[  8 187 357 135  89],269,3,2573,4.467013888888889,0.0,0.0
10576,1,576,[282 475 238  96 172],296,5,2578,4.46793760831889,0.0,0.0
10577,1,577,[318 515 427 313 588],807,5,2583,4.468858131487889,40.0,0.0
10578,1,578,[318 515 427 313 588],807,5,2588,4.469775474956822,40.0,0.0
10579,1,579,[ 82 200 215 222  50],716,5,2593,4.470689655172414,0.0,20.0
10580,1,580,[318 515 427 313 588],807,5,2598,4.4716006884681585,40.0,0.0
10581,1,581,[181 496 333 172 385],796,5,2603,4.472508591065292,20.0,0.0
10582,1,582,[313 318 515 427 588],807,5,2608,4.473413379073756,40.0,0.0
10583,1,583,[294 211  11 269 127],296,4,2612,4.472602739726027,0.0,20.0
10584,1,584,[313 318 515 427 588],807,5,2617,4.473504273504274,40.0,0.0
10585,1,585,[313 318 515 427 588],807,5,2622,4.474402730375426,40.0,0.0
10586,1,586,[313 318 515 427 588],807,5,2627,4.475298126064736,40.0,0.0
10587,1,587,[282   8 286 181 210],796,3,2630,4.4727891156462585,0.0,20.0
10588,1,588,[210  89 323 222 234],256,5,2635,4.473684210526316,0.0,0.0
10589,1,589,[200 127 194  56 195],450,4,2639,4.472881355932204,0.0,20.0
10590,1,590,[ 15  95 286 181 357],330,5,2644,4.473773265651438,0.0,20.0
10591,1,591,[ 82 385  71   9 496],796,3,2647,4.471283783783784,20.0,0.0
10592,1,592,[271   4  96 196 228],655,0,2647,4.463743676222597,0.0,0.0
10593,1,593,[181 655   4 176  82],450,3,2650,4.461279461279461,0.0,0.0
10594,1,594,[125 385 211 168  79],450,5,2655,4.46218487394958,0.0,0.0
10595,1,595,[210 234 508 196 258],693,1,2656,4.456375838926174,0.0,0.0
10596,1,596,[475   1 471 271 216],655,1,2657,4.450586264656616,0.0,0.0
10597,1,597,[127 483  12 215 100],280,3,2660,4.448160535117057,0.0,40.0
10598,1,598,[  8 172 222  79 237],457,5,2665,4.449081803005009,0.0,0.0
10599,1,599,[245 655  12   9 187],629,4,2669,4.448333333333333,0.0,0.0
10600,1,600,[603 195 135 132 423],716,3,2672,4.445923460898502,20.0,0.0
10601,1,601,[228 125 318 111 275],796,5,2677,4.446843853820598,20.0,20.0
10602,1,602,[  9 597  50  71 183],593,3,2680,4.444444444444445,0.0,20.0
10603,1,603,[ 50 322 153 546 183],593,3,2683,4.44205298013245,0.0,20.0
10604,1,604,[568 496 318 168 180],716,4,2687,4.441322314049587,40.0,0.0
10605,1,605,[  7  95 179 111 385],577,3,2690,4.438943894389439,0.0,0.0
10606,1,606,[328 257 118 276 273],938,3,2693,4.436573311367381,0.0,0.0
10607,1,607,[  1 204   9 318 151],18,3,2696,4.434210526315789,20.0,0.0
10608,1,608,[117 597 195  89 121],256,5,2701,4.435139573070607,0.0,0.0
10609,1,609,[181  98 172 118 216],256,4,2705,4.434426229508197,0.0,0.0
10610,1,610,[313 405  71 265 483],796,5,2710,4.435351882160393,0.0,0.0
10611,1,611,[135 185  11 197  15],450,3,2713,4.433006535947713,0.0,0.0
10612,1,612,[ 96  22 181 328 197],796,4,2717,4.432300163132137,0.0,0.0
10613,1,613,[ 64 132   9 301 161],796,3,2720,4.429967426710098,20.0,0.0
10614,1,614,[ 15 405 286 174 161],786,4,2724,4.429268292682927,0.0,20.0
10615,1,615,[313 588 748 322 151],450,5,2729,4.430194805194805,0.0,0.0
10616,1,616,[282 234 195 186 215],504,3,2732,4.427876823338736,0.0,0.0
10617,1,617,[ 64  50 275 135 405],450,4,2736,4.427184466019417,20.0,40.0
10618,1,618,[  7 603  28 185  56],151,5,2741,4.4281098546042,20.0,0.0
10619,1,619,[282 204 228 117 127],280,2,2743,4.424193548387096,0.0,20.0
10620,1,620,[176 405 288 471 357],655,1,2744,4.418679549114332,0.0,0.0
10621,1,621,[143 200 286 161  11],330,5,2749,4.419614147909968,0.0,20.0
10622,1,622,[144 742  69 161 202],280,3,2752,4.417335473515249,0.0,0.0
10623,1,623,[742 182  25 333 385],655,1,2753,4.4118589743589745,0.0,0.0
10624,1,624,[118 405 318 132 151],330,5,2758,4.4128,20.0,0.0
10625,1,625,[194 175 196  79  70],457,5,2763,4.413738019169329,0.0,0.0
10626,1,626,[  7 179 275 282 211],450,5,2768,4.414673046251994,0.0,20.0
10627,1,627,[  9 313 174 238 200],796,3,2771,4.412420382165605,0.0,0.0
10628,1,628,[357 183  82 153 427],911,3,2774,4.410174880763116,20.0,0.0
10629,1,629,[183  79 216  71 282],796,5,2779,4.411111111111111,0.0,0.0
10630,1,630,[222  50  15 742 276],457,5,2784,4.4120443740095086,0.0,20.0
10631,1,631,[181 483   9 300 111],151,5,2789,4.412974683544304,0.0,0.0
10632,1,632,[100 132  82 180 135],457,5,2794,4.41390205371248,0.0,20.0
10633,1,633,[515 265 258 191 202],655,2,2796,4.410094637223975,0.0,0.0
10634,1,634,[294 179 515  79 118],655,3,2799,4.407874015748032,0.0,0.0
10635,1,635,[  4 318 187  88 742],504,3,2802,4.40566037735849,20.0,0.0
10636,1,636,[ 12 185 273 258 222],796,4,2806,4.405023547880691,0.0,0.0
10637,1,637,[210 282 173 182 111],280,1,2807,4.399686520376176,0.0,0.0
10638,1,638,[153 678 423  98  82],280,3,2810,4.397496087636933,0.0,0.0
10639,1,639,[ 12 357 195 175 186],18,4,2814,4.396875,0.0,0.0
10640,1,640,[318 143   4 275  71],796,5,2819,4.3978159126365055,20.0,20.0
10641,1,641,[ 96 197 508 175  12],655,0,2819,4.390965732087228,0.0,0.0
10642,1,642,[173  88 301 271   4],796,4,2823,4.390357698289269,0.0,0.0
10643,1,643,[202 742 117  82 200],577,4,2827,4.3897515527950315,0.0,0.0
10644,1,644,[302 181 603 185 196],269,2,2829,4.386046511627907,20.0,0.0
10645,1,645,[357 153 135   7 172],535,2,2831,4.382352941176471,0.0,0.0
10646,1,646,[294 125 144 210 200],450,3,2834,4.380216383307573,0.0,0.0
10647,1,647,[282 144 357 125  64],401,2,2836,4.3765432098765435,20.0,0.0
10648,1,648,[ 70 435  88 186 265],716,4,2840,4.375963020030817,0.0,0.0
10649,1,649,[ 64 655  22 216 269],655,2,2842,4.372307692307692,20.0,0.0
10650,1,650,[265 173 405   9 174],280,2,2844,4.368663594470046,0.0,0.0
10651,1,651,[483 135  71   1 118],450,1,2845,4.363496932515337,0.0,0.0
10652,1,652,[  8 471  69 181 475],389,5,2850,4.3644716692189895,0.0,0.0
10653,1,653,[ 71 588 121 228 202],796,5,2855,4.365443425076452,0.0,0.0
10654,1,654,[ 15 333 300 289 125],655,0,2855,4.358778625954199,0.0,0.0
10655,1,655,[318 176 301 210 194],796,3,2858,4.3567073170731705,20.0,0.0
10656,1,656,[ 28   8  50  71 588],18,4,2862,4.3561643835616435,0.0,20.0
10657,1,657,[300 118  64  70 333],655,1,2863,4.351063829787234,20.0,0.0
10658,1,658,[423 322 173 183 194],151,3,2866,4.349013657056146,0.0,0.0
10659,1,659,[200 121 117 603 183],796,5,2871,4.35,20.0,0.0
10660,1,660,[237 269   7 301 202],344,4,2875,4.34947049924357,0.0,0.0
10661,1,661,[ 97 196  56 289 275],236,3,2878,4.347432024169184,0.0,20.0
10662,1,662,[210 186 546 235 742],457,3,2881,4.3453996983408745,0.0,0.0
10663,1,663,[588 143 168 204  28],330,4,2885,4.344879518072289,0.0,0.0
10664,1,664,[603 135 546 405 176],450,4,2889,4.344360902255639,20.0,0.0
10665,1,665,[195  98  97 301 196],151,4,2893,4.343843843843844,0.0,0.0
10666,1,666,[286 288 471  22 435],450,4,2897,4.3433283358320836,0.0,20.0
10667,1,667,[245   7 196  70  97],450,5,2902,4.344311377245509,0.0,0.0
10668,1,668,[313 328 273  11 655],450,4,2906,4.343796711509716,0.0,0.0
10669,1,669,[546  89 173 210 121],151,4,2910,4.343283582089552,0.0,0.0
10670,1,670,[328 132 435 125 288],450,4,2914,4.342771982116244,0.0,0.0
10671,1,671,[655 143 153  69  64],796,4,2918,4.342261904761905,20.0,0.0
10672,1,672,[546 588  25   4  98],344,4,2922,4.341753343239227,0.0,0.0
10673,1,673,[211 186 435 100 300],450,4,2926,4.341246290801187,0.0,20.0
10674,1,674,[313 228 300 117 194],796,5,2931,4.342222222222222,0.0,0.0
10675,1,675,[ 50  56  15  70 174],18,5,2936,4.34319526627219,0.0,20.0
10676,1,676,[132 275 187 204  95],786,5,2941,4.344165435745938,0.0,20.0
10677,1,677,[143 197  89 179 191],18,4,2945,4.343657817109144,0.0,0.0
10678,1,678,[234 144  56 323  88],23,1,2946,4.338733431516936,0.0,0.0
10679,1,679,[ 89 216   8 153 179],269,1,2947,4.333823529411765,0.0,0.0
10680,1,680,[265 196 237 121 258],457,5,2952,4.334801762114537,0.0,0.0
10681,1,681,[ 88  64 300  56 196],716,5,2957,4.335777126099707,20.0,0.0
10682,1,682,[187  98  71 215 197],796,4,2961,4.3352855051244505,0.0,0.0
10683,1,683,[515 313 318 588 427],807,5,2966,4.33625730994152,40.0,0.0
10684,1,684,[328 258 194 655 742],450,5,2971,4.337226277372263,0.0,0.0
10685,1,685,[ 56  88 238 204 235],457,4,2975,4.336734693877551,0.0,0.0
10686,1,686,[191  15 286 273  56],629,3,2978,4.334788937409025,0.0,20.0
10687,1,687,[196  79 265 588   4],577,5,2983,4.335755813953488,0.0,0.0
10688,1,688,[210 273  96 282 172],693,2,2985,4.332365747460087,0.0,0.0
10689,1,689,[515 313 318 588 427],807,5,2990,4.333333333333333,40.0,0.0
10690,1,690,[515 313 318 588 427],807,5,2995,4.334298118668596,40.0,0.0
10691,1,691,[515 313 318 588 427],807,5,3000,4.335260115606936,40.0,0.0
10692,1,692,[515 313 318 588 427],807,5,3005,4.336219336219337,40.0,0.0
10693,1,693,[275 204 197 302 328],655,2,3007,4.3328530259366,0.0,20.0
10694,1,694,[  1 204 180 186 181],450,4,3011,4.3323741007194245,0.0,0.0
10695,1,695,[153 222  11 118 202],450,3,3014,4.330459770114943,0.0,0.0
10696,1,696,[588 318 195 168   8],18,3,3017,4.328550932568149,20.0,0.0
10697,1,697,[275  15 117 228 405],330,5,3022,4.329512893982808,0.0,20.0
10698,1,698,[197 276 275 202 475],655,2,3024,4.32618025751073,0.0,20.0
10699,1,699,[286 237   9 238  79],11,4,3028,4.325714285714286,0.0,20.0
10700,1,700,[515 313 318 588 427],807,5,3033,4.326676176890157,40.0,0.0
10701,1,701,[275 286 151 435  12],450,5,3038,4.327635327635328,0.0,40.0
10702,1,702,[ 97 182  11 179 237],593,4,3042,4.327169274537695,0.0,0.0
10703,1,703,[173  25 357 185  88],450,4,3046,4.326704545454546,0.0,0.0
10704,1,704,[515 313 318 588 427],807,5,3051,4.327659574468085,40.0,0.0
10705,1,705,[515 313 318 588 427],807,5,3056,4.328611898016997,40.0,0.0
10706,1,706,[ 50 174 435  98 127],436,4,3060,4.328147100424328,0.0,40.0
10707,1,707,[515 313 318 588 427],807,5,3065,4.3290960451977405,40.0,0.0
10708,1,708,[515 313 318 588 427],807,5,3070,4.330042313117066,40.0,0.0
10709,1,709,[ 64 173 174 191 202],716,5,3075,4.330985915492958,20.0,0.0
10710,1,710,[258 427 117  22   8],655,1,3076,4.3263009845288325,20.0,0.0
10711,1,711,[313 318 515 588 427],807,5,3081,4.327247191011236,40.0,0.0
10712,1,712,[237 423 174 238 194],504,2,3083,4.32398316970547,0.0,0.0
10713,1,713,[195 179 210 655 268],535,4,3087,4.323529411764706,0.0,0.0
10714,1,714,[496 153   8 235   9],269,2,3089,4.3202797202797205,20.0,0.0
10715,1,715,[204 435 300  50   8],807,4,3093,4.319832402234637,0.0,20.0
10716,1,716,[313 318 515 588 427],807,5,3098,4.320781032078103,40.0,0.0
10717,1,717,[151 597 127 427 222],807,4,3102,4.32033426183844,20.0,20.0
10718,1,718,[276 210 258 180 603],535,4,3106,4.319888734353269,20.0,0.0
10719,1,719,[405 180 173 191 195],716,3,3109,4.3180555555555555,0.0,0.0
10720,1,720,[313 318 515 588 427],807,5,3114,4.319001386962552,40.0,0.0
10721,1,721,[210 173 385 300  25],716,4,3118,4.3185595567867034,0.0,0.0
10722,1,722,[318 313 515 588 427],807,5,3123,4.319502074688796,40.0,0.0
10723,1,723,[483 357  89 180 288],457,5,3128,4.320441988950276,0.0,0.0
10724,1,724,[318 313 515 588 427],807,5,3133,4.3213793103448275,40.0,0.0
10725,1,725,[179 161 176 276 183],504,1,3134,4.316804407713499,0.0,0.0
10726,1,726,[318 313 515 588 427],807,5,3139,4.317744154057771,40.0,0.0
10727,1,727,[204 275 183 100   4],457,5,3144,4.318681318681318,0.0,40.0
10728,1,728,[ 50 111 195 655  25],450,4,3148,4.318244170096022,0.0,20.0
10729,1,729,[271  12 144 143 483],796,5,3153,4.3191780821917805,0.0,0.0
10730,1,730,[132  22 118 234  25],450,2,3155,4.316005471956224,0.0,0.0
10731,1,731,[318 313 515 588 427],807,5,3160,4.316939890710382,40.0,0.0
10732,1,732,[318 313 515 588 427],807,5,3165,4.31787175989086,40.0,0.0
10733,1,733,[405 211  28 357 172],796,3,3168,4.316076294277929,0.0,0.0
10734,1,734,[318 313 515 588 427],807,5,3173,4.317006802721089,40.0,0.0
10735,1,735,[187   1  89  15 405],256,4,3177,4.3165760869565215,0.0,0.0
10736,1,736,[318 313 515 588 427],807,5,3182,4.3175033921302575,40.0,0.0
10737,1,737,[301 286 427 258   1],655,1,3183,4.313008130081301,20.0,20.0
10738,1,738,[318 313 515 588 427],807,5,3188,4.313937753721245,40.0,0.0
10739,1,739,[318 313 515 588 427],807,5,3193,4.314864864864865,40.0,0.0
10740,1,740,[179  28 237  82  71],450,3,3196,4.3130904183535765,0.0,0.0
10741,1,741,[318 313 515 588 427],807,5,3201,4.314016172506738,40.0,0.0
10742,1,742,[318 313 515 588 427],807,5,3206,4.314939434724091,40.0,0.0
10743,1,743,[318 313 515 588 427],807,5,3211,4.315860215053763,40.0,0.0
10744,1,744,[237 546 288 210 153],280,3,3214,4.314093959731544,0.0,0.0
10745,1,745,[143 276 182 197  69],269,3,3217,4.3123324396782845,0.0,0.0
10746,1,746,[318 313 515 588 427],807,5,3222,4.313253012048193,40.0,0.0
10747,1,747,[318 313 515 588 427],807,5,3227,4.314171122994653,40.0,0.0
10748,1,748,[318 313 515 588 427],807,5,3232,4.315086782376502,40.0,0.0
10749,1,749,[318 313 515 588 427],807,5,3237,4.316,40.0,0.0
10750,1,750,[195 143 185 127   1],716,4,3241,4.3155792276964045,0.0,20.0
10751,1,751,[ 11   8 210 471 276],593,1,3242,4.3111702127659575,0.0,0.0
10752,1,752,[318 313 515 588 427],807,5,3247,4.3120849933598935,40.0,0.0
10753,1,753,[318 313 515 588 427],807,5,3252,4.312997347480106,40.0,0.0
10754,1,754,[318 313 515 588 427],807,5,3257,4.313907284768212,40.0,0.0
10755,1,755,[318 313 515 588 427],807,5,3262,4.314814814814815,40.0,0.0
10756,1,756,[ 25  22 313 111 121],344,2,3264,4.311756935270806,0.0,0.0
10757,1,757,[175 202 204 181  88],151,5,3269,4.312664907651715,0.0,0.0
10758,1,758,[ 50  98 118 181 588],20,3,3272,4.310935441370224,0.0,20.0
10759,1,759,[318 515 588 427  79],18,5,3277,4.311842105263158,40.0,0.0
10760,1,760,[276 318 125 238 245],593,3,3280,4.31011826544021,20.0,0.0
10761,1,761,[318 515 588 427  79],807,5,3285,4.311023622047244,40.0,0.0
10762,1,762,[318 515 588 427  79],18,5,3290,4.3119266055045875,40.0,0.0
10763,1,763,[318 515 588 427  79],18,5,3295,4.31282722513089,40.0,0.0
10764,1,764,[318 515 588 427  79],716,5,3300,4.313725490196078,40.0,0.0
10765,1,765,[318 515 588 427  79],807,5,3305,4.314621409921671,40.0,0.0
10766,1,766,[318 515 588 427  79],716,5,3310,4.315514993481095,40.0,0.0
10767,1,767,[318 515 588 427  79],18,5,3315,4.31640625,40.0,0.0
10768,1,768,[318 515 588 427  79],807,5,3320,4.317295188556567,40.0,0.0
10769,1,769,[318 515 588 427  79],807,5,3325,4.318181818181818,40.0,0.0
10770,1,770,[318 515 588 427  79],18,5,3330,4.319066147859922,40.0,0.0
10771,1,771,[471  79  88 234 655],716,4,3334,4.318652849740933,0.0,0.0
10772,1,772,[318 515 588 427  79],716,5,3339,4.319534282018111,40.0,0.0
10773,1,773,[318 515 588 427  79],716,5,3344,4.320413436692506,40.0,0.0
10774,1,774,[318 515 588 427  79],18,5,3349,4.321290322580645,40.0,0.0
10775,1,775,[385   4 125   1 210],577,4,3353,4.320876288659794,0.0,0.0
10776,1,776,[153 403 515  50 237],655,2,3355,4.317889317889318,0.0,20.0
10777,1,777,[216 508   1 176   9],280,3,3358,4.316195372750642,0.0,0.0
10778,1,778,[318 515 588 427  79],807,5,3363,4.317073170731708,40.0,0.0
10779,1,779,[318 515 588 427  79],716,5,3368,4.317948717948718,40.0,0.0
10780,1,780,[318 515 588 427  79],716,5,3373,4.3188220230473755,40.0,0.0
10781,1,781,[318 515 588 427  79],716,5,3378,4.319693094629156,40.0,0.0
10782,1,782,[318 515 588 427  79],807,5,3383,4.320561941251596,40.0,0.0
10783,1,783,[  8 202 132 405 143],269,1,3384,4.316326530612245,0.0,0.0
10784,1,784,[318 515 588 427  79],716,5,3389,4.3171974522292995,40.0,0.0
10785,1,785,[318 515 588 427  79],716,5,3394,4.318066157760814,40.0,0.0
10786,1,786,[185 238 211  50 405],151,4,3398,4.3176620076238885,0.0,20.0
10787,1,787,[318 515 588 427  79],716,5,3403,4.318527918781726,40.0,0.0
10788,1,788,[318 515 588 427  79],807,5,3408,4.319391634980988,40.0,0.0
10789,1,789,[318 515 588 427  79],18,5,3413,4.320253164556962,40.0,0.0
10790,1,790,[318 515 588 427  79],18,5,3418,4.321112515802781,40.0,0.0
10791,1,791,[318 515 588 427  79],807,5,3423,4.321969696969697,40.0,0.0
10792,1,792,[328 127 301  15 333],655,1,3424,4.317780580075662,0.0,20.0
10793,1,793,[318 515 588 427  79],716,5,3429,4.318639798488665,40.0,0.0
10794,1,794,[318 515 588 427  79],716,5,3434,4.319496855345912,40.0,0.0
10795,1,795,[318 515 588 427  79],807,5,3439,4.3203517587939695,40.0,0.0
10796,1,796,[318 515 588 427  79],18,5,3444,4.321204516938519,40.0,0.0
10797,1,797,[318 515 588 427  79],716,5,3449,4.322055137844612,40.0,0.0
10798,1,798,[568 182 180 546  25],450,4,3453,4.321652065081351,0.0,0.0
10799,1,799,[318 515 588 427  79],807,5,3458,4.3225,40.0,0.0
10800,1,800,[318 515 588 427  79],18,5,3463,4.32334581772784,40.0,0.0
10801,1,801,[318 515 588 427  79],716,5,3468,4.324189526184538,40.0,0.0
10802,1,802,[174 182 202  25 275],457,5,3473,4.325031133250311,0.0,20.0
10803,1,803,[144 161 323 132  56],562,2,3475,4.3221393034825875,0.0,0.0
10804,1,804,[515 318 588 427  79],716,5,3480,4.3229813664596275,40.0,0.0
10805,1,805,[515 318 588 427  79],807,5,3485,4.323821339950372,40.0,0.0
10806,1,806,[269 174 423 216 100],450,5,3490,4.324659231722428,0.0,20.0
10807,1,807,[515 318 588 427  79],716,5,3495,4.3254950495049505,40.0,0.0
10808,1,808,[515 318 588 427  79],18,5,3500,4.326328800988875,40.0,0.0
10809,1,809,[515 318 588 427  79],716,5,3505,4.327160493827161,40.0,0.0
10810,1,810,[515 318 588 427  79],807,5,3510,4.3279901356350186,40.0,0.0
10811,1,811,[200 475 187 515  69],269,4,3514,4.327586206896552,0.0,0.0
10812,1,812,[515 318 588 427  79],807,5,3519,4.328413284132841,40.0,0.0
10813,1,813,[143   9  70  64 496],269,3,3522,4.326781326781327,40.0,0.0
10814,1,814,[ 70 135  28 423 237],330,4,3526,4.326380368098159,0.0,0.0
10815,1,815,[515 318 588 427  79],18,5,3531,4.327205882352941,40.0,0.0
10816,1,816,[515 318 588 427  79],716,5,3536,4.328029375764994,40.0,0.0
10817,1,817,[237 173 405 143 121],450,4,3540,4.32762836185819,0.0,0.0
10818,1,818,[515 318 588 427  79],807,5,3545,4.328449328449328,40.0,0.0
10819,1,819,[515 318 588 427  79],18,5,3550,4.329268292682927,40.0,0.0
10820,1,820,[515 318 588 427  79],807,5,3555,4.3300852618757615,40.0,0.0
10821,1,821,[515 318 588 427  79],18,5,3560,4.330900243309002,40.0,0.0
10822,1,822,[515 318 588 427  79],18,5,3565,4.331713244228433,40.0,0.0
10823,1,823,[302 403 181 301  70],450,5,3570,4.33252427184466,0.0,0.0
10824,1,824,[515 318 588 427  79],807,5,3575,4.333333333333333,40.0,0.0
10825,1,825,[515 318 588 427  79],716,5,3580,4.3341404358353515,40.0,0.0
10826,1,826,[515 318 588 427  79],18,5,3585,4.334945586457073,40.0,0.0
10827,1,827,[ 82  71 196 182 204],389,4,3589,4.334541062801932,0.0,0.0
10828,1,828,[318 515 588 427  79],716,5,3594,4.3353437876960195,40.0,0.0
10829,1,829,[318 515 588 427  79],716,5,3599,4.336144578313253,40.0,0.0
10830,1,830,[318 515 588 427  79],18,5,3604,4.336943441636582,40.0,0.0
10831,1,831,[318 515 588 427  79],807,5,3609,4.337740384615385,40.0,0.0
10832,1,832,[318 515 588 427  79],18,5,3614,4.3385354141656665,40.0,0.0
10833,1,833,[318 515 588 427  79],716,5,3619,4.339328537170264,40.0,0.0
10834,1,834,[318 515 588 427  79],18,5,3624,4.340119760479042,40.0,0.0
10835,1,835,[318 515 588 427  79],18,5,3629,4.340909090909091,40.0,0.0
10836,1,836,[318 515 588 427  79],807,5,3634,4.341696535244922,40.0,0.0
10837,1,837,[318 515 588 427  79],716,5,3639,4.342482100238663,40.0,0.0
10838,1,838,[318 515 588 427  79],716,5,3644,4.34326579261025,40.0,0.0
10839,1,839,[427 200  88  12 603],707,1,3645,4.339285714285714,40.0,0.0
10840,1,840,[ 69 403 483 182 496],18,3,3648,4.33769322235434,20.0,0.0
10841,1,841,[515 318 588 427  79],807,5,3653,4.338479809976247,40.0,0.0
10842,1,842,[515 318 588 427  79],18,5,3658,4.33926453143535,40.0,0.0
10843,1,843,[742 603 181 318 204],796,4,3662,4.338862559241706,40.0,0.0
10844,1,844,[318 515 588 427  79],807,5,3667,4.339644970414201,40.0,0.0
10845,1,845,[ 79 132 655   7 228],23,4,3671,4.339243498817967,0.0,0.0
10846,1,846,[318 515 588 427  79],18,5,3676,4.340023612750885,40.0,0.0
10847,1,847,[318 515 588 427  79],716,5,3681,4.340801886792453,40.0,0.0
10848,1,848,[318 515 588 427  79],716,5,3686,4.341578327444052,40.0,0.0
10849,1,849,[655  12 191 181  22],577,5,3691,4.342352941176471,0.0,0.0
10850,1,850,[111 276 269   7  95],344,5,3696,4.343125734430083,0.0,0.0
10851,1,851,[318 515 588 427  79],807,5,3701,4.343896713615023,40.0,0.0
10852,1,852,[318 515 588 427  79],18,5,3706,4.344665885111372,40.0,0.0
10853,1,853,[318 515 588 427  79],807,5,3711,4.345433255269321,40.0,0.0
10854,1,854,[318 515 588 427  79],716,5,3716,4.346198830409357,40.0,0.0
10855,1,855,[318 515 588 427  79],716,5,3721,4.34696261682243,40.0,0.0
10856,1,856,[318 515 588 427  79],18,5,3726,4.347724620770128,40.0,0.0
10857,1,857,[318 515 588 427  79],716,5,3731,4.348484848484849,40.0,0.0
10858,1,858,[318 515 588 427  79],716,5,3736,4.349243306169965,40.0,0.0
10859,1,859,[318 515 588 427  79],18,5,3741,4.35,40.0,0.0
10860,1,860,[100 202 186 435 423],151,4,3745,4.349593495934959,0.0,20.0
10861,1,861,[515 318 588 427  79],18,5,3750,4.3503480278422275,40.0,0.0
10862,1,862,[515 318 588 427  79],807,5,3755,4.351100811123986,40.0,0.0
10863,1,863,[515 318 588 427  79],716,5,3760,4.351851851851852,40.0,0.0
10864,1,864,[515 318 588 427  79],807,5,3765,4.3526011560693645,40.0,0.0
10865,1,865,[318  11   4  50 182],280,2,3767,4.349884526558891,20.0,20.0
10866,1,866,[318 515 588 427  79],807,5,3772,4.350634371395617,40.0,0.0
10867,1,867,[318 515 588 427  79],18,5,3777,4.3513824884792625,40.0,0.0
10868,1,868,[ 70 403 196 282 748],450,5,3782,4.352128883774453,0.0,0.0
10869,1,869,[318 515 588 427  79],18,5,3787,4.352873563218391,40.0,0.0
10870,1,870,[318 515 588 427  79],716,5,3792,4.35361653272101,40.0,0.0
10871,1,871,[318 515 588 427  79],18,5,3797,4.354357798165138,40.0,0.0
10872,1,872,[318 515 588 427  79],807,5,3802,4.355097365406643,40.0,0.0
10873,1,873,[318 515 588 427  79],716,5,3807,4.355835240274599,40.0,0.0
10874,1,874,[318 515 588 427  79],18,5,3812,4.356571428571429,40.0,0.0
10875,1,875,[318 515 588 427  79],716,5,3817,4.357305936073059,40.0,0.0
10876,1,876,[318 515 588 427  79],716,5,3822,4.3580387685290765,40.0,0.0
10877,1,877,[318 515 588 427  79],716,5,3827,4.35876993166287,40.0,0.0
10878,1,878,[215 655 117 268 597],174,4,3831,4.3583617747440275,0.0,0.0
10879,1,879,[318 515 588 427  79],716,5,3836,4.359090909090909,40.0,0.0
10880,1,880,[318 515 588 427  79],18,5,3841,4.359818388195233,40.0,0.0
10881,1,881,[318 515 588 427  79],807,5,3846,4.360544217687075,40.0,0.0
10882,1,882,[318 515 588 427  79],18,5,3851,4.361268403171008,40.0,0.0
10883,1,883,[496 135 127 289 597],807,4,3855,4.360859728506787,20.0,20.0
10884,1,884,[  8 216 496 173 174],577,5,3860,4.361581920903955,20.0,0.0
10885,1,885,[515 318 588 427  79],807,5,3865,4.3623024830699775,40.0,0.0
10886,1,886,[515 318 588 427  79],716,5,3870,4.363021420518602,40.0,0.0
10887,1,887,[515 318 588 427  79],18,5,3875,4.363738738738738,40.0,0.0
10888,1,888,[515 318 588 427  79],807,5,3880,4.3644544431946,40.0,0.0
10889,1,889,[273 515 210 282 508],401,2,3882,4.361797752808989,0.0,0.0
10890,1,890,[515 318 588 427  79],807,5,3887,4.362514029180696,40.0,0.0
10891,1,891,[515 318 588 427  79],807,5,3892,4.36322869955157,40.0,0.0
10892,1,892,[176 181 168   1 258],450,5,3897,4.363941769316909,0.0,0.0
10893,1,893,[318 515 588 427  79],716,5,3902,4.364653243847875,40.0,0.0
10894,1,894,[318 515 588 427  79],807,5,3907,4.36536312849162,40.0,0.0
10895,1,895,[318 515 588 427  79],716,5,3912,4.366071428571429,40.0,0.0
10896,1,896,[318 515 588 427  79],18,5,3917,4.366778149386845,40.0,0.0
10897,1,897,[318 515 588 427  79],18,5,3922,4.367483296213808,40.0,0.0
10898,1,898,[318 515 588 427  79],807,5,3927,4.368186874304783,40.0,0.0
10899,1,899,[318 515 588 427  79],18,5,3932,4.368888888888889,40.0,0.0
10900,1,900,[318 515 588 427  79],18,5,3937,4.369589345172031,40.0,0.0
10901,1,901,[318 515 588 427  79],716,5,3942,4.370288248337029,40.0,0.0
10902,1,902,[  1 289 508   4  98],655,1,3943,4.36655592469546,0.0,0.0
10903,1,903,[180 405 245 204  95],280,2,3945,4.363938053097345,0.0,0.0
10904,1,904,[318 515 588 427  79],18,5,3950,4.3646408839779,40.0,0.0
10905,1,905,[318 515 588 427  79],18,5,3955,4.365342163355408,40.0,0.0
10906,1,906,[118 357 216 144 301],655,2,3957,4.362734288864388,0.0,0.0
10907,1,907,[187 179  69 111  82],18,2,3959,4.360132158590308,0.0,0.0
10908,1,908,[ 79   1 322 125   7],151,4,3963,4.35973597359736,0.0,0.0
10909,1,909,[318 515 588 427  79],716,5,3968,4.36043956043956,40.0,0.0
10910,1,910,[318 515 588 427  79],716,5,3973,4.361141602634468,40.0,0.0
10911,1,911,[318 515 588 427  79],807,5,3978,4.3618421052631575,40.0,0.0
10912,1,912,[318 515 588 427  79],807,5,3983,4.362541073384447,40.0,0.0
10913,1,913,[318 515 588 427  79],807,5,3988,4.363238512035011,40.0,0.0
10914,1,914,[318 515 588 427  79],716,5,3993,4.363934426229508,40.0,0.0
10915,1,915,[318 515 588 427  79],18,5,3998,4.364628820960698,40.0,0.0
10916,1,916,[318 515 588 427  79],807,5,4003,4.365321701199564,40.0,0.0
10917,1,917,[318 515 588 427  79],807,5,4008,4.366013071895424,40.0,0.0
10918,1,918,[318 515 588 427  79],18,5,4013,4.366702937976061,40.0,0.0
10919,1,919,[318 515 588 427  79],18,5,4018,4.3673913043478265,40.0,0.0
10920,1,920,[318 515 588 427  79],807,5,4023,4.368078175895765,40.0,0.0
10921,1,921,[318 515 588 427  79],807,5,4028,4.368763557483731,40.0,0.0
10922,1,922,[302  70  50 191 216],344,4,4032,4.3683640303358615,0.0,20.0
10923,1,923,[318 515 588 427  79],807,5,4037,4.369047619047619,40.0,0.0
10924,1,924,[318 515 588 427  79],716,5,4042,4.3697297297297295,40.0,0.0
10925,1,925,[302 144 603  22 135],655,3,4045,4.3682505399568035,20.0,0.0
10926,1,926,[515 318 588 427  79],807,5,4050,4.368932038834951,40.0,0.0
10927,1,927,[515 318 588 427  79],18,5,4055,4.369612068965517,40.0,0.0
10928,1,928,[515 318 588 427  79],807,5,4060,4.3702906350914965,40.0,0.0
10929,1,929,[515 318 588 427  79],716,5,4065,4.370967741935484,40.0,0.0
10930,1,930,[515 318 588 427  79],18,5,4070,4.371643394199785,40.0,0.0
10931,1,931,[515 318 588 427  79],716,5,4075,4.372317596566524,40.0,0.0
10932,1,932,[515 318 588 427  79],716,5,4080,4.372990353697749,40.0,0.0
10933,1,933,[515 318 588 427  79],716,5,4085,4.373661670235546,40.0,0.0
10934,1,934,[268 403 211 515 289],655,1,4086,4.370053475935829,0.0,0.0
10935,1,935,[515 318 588 427  79],716,5,4091,4.370726495726496,40.0,0.0
10936,1,936,[515 318 588 427  79],18,5,4096,4.371398078975454,40.0,0.0
10937,1,937,[515 318 588 427  79],807,5,4101,4.372068230277185,40.0,0.0
10938,1,938,[515 318 588 427  79],18,5,4106,4.372736954206602,40.0,0.0
10939,1,939,[515 318 588 427  79],716,5,4111,4.373404255319149,40.0,0.0
10940,1,940,[515 318 588 427  79],807,5,4116,4.374070138150904,40.0,0.0
10941,1,941,[515 318 588 427  79],807,5,4121,4.3747346072186835,40.0,0.0
10942,1,942,[515 318 588 427  79],18,5,4126,4.375397667020149,40.0,0.0
10943,1,943,[515 318 588 427  79],807,5,4131,4.376059322033898,40.0,0.0
10944,1,944,[515 318 588 427  79],807,5,4136,4.376719576719577,40.0,0.0
10945,1,945,[515 318 588 427  79],18,5,4141,4.37737843551797,40.0,0.0
10946,1,946,[515 318 588 427  79],18,5,4146,4.378035902851109,40.0,0.0
10947,1,947,[742 168 175  98 191],11,1,4147,4.374472573839663,0.0,0.0
10948,1,948,[515 318 588 427  79],807,5,4152,4.375131717597471,40.0,0.0
10949,1,949,[515 318 588 427  79],807,5,4157,4.37578947368421,40.0,0.0
10950,1,950,[515 318 588 427  79],807,5,4162,4.3764458464773925,40.0,0.0
10951,1,951,[515 318 588 427  79],18,5,4167,4.3771008403361344,40.0,0.0
10952,1,952,[515 318 588 427  79],18,5,4172,4.377754459601259,40.0,0.0
10953,1,953,[515 318 588 427  79],807,5,4177,4.378406708595388,40.0,0.0
10954,1,954,[742  70 234 151 483],450,3,4180,4.37696335078534,0.0,0.0
10955,1,955,[135 276  96 742 228],280,4,4184,4.376569037656904,0.0,0.0
10956,1,956,[302 265 135   4 294],450,3,4187,4.375130616509927,0.0,0.0
10957,1,957,[318 515 588 427  79],18,5,4192,4.375782881002087,40.0,0.0
10958,1,958,[318 515 588 427  79],18,5,4197,4.376433785192909,40.0,0.0
10959,1,959,[318 515 588 427  79],18,5,4202,4.377083333333333,40.0,0.0
10960,1,960,[238 121 748 194  88],450,4,4206,4.376690946930281,0.0,0.0
10961,1,961,[318 515 588 427  79],807,5,4211,4.377338877338877,40.0,0.0
10962,1,962,[318 515 588 427  79],18,5,4216,4.3779854620976115,40.0,0.0
10963,1,963,[318 515 588 427  79],716,5,4221,4.378630705394191,40.0,0.0
10964,1,964,[318 515 588 427  79],716,5,4226,4.379274611398964,40.0,0.0
10965,1,965,[195   9 168  97  25],457,5,4231,4.37991718426501,0.0,0.0
10966,1,966,[568 143   4 181  70],457,5,4236,4.380558428128231,0.0,0.0
10967,1,967,[318 515 588 427  79],18,5,4241,4.381198347107438,40.0,0.0
10968,1,968,[ 11  69 191  95 237],344,2,4243,4.378740970072239,0.0,0.0
10969,1,969,[286 100 127 161  64],450,5,4248,4.3793814432989695,20.0,60.0
10970,1,970,[318  15  89 174  79],655,3,4251,4.377960865087538,20.0,0.0
10971,1,971,[318 515 588 427  79],716,5,4256,4.378600823045267,40.0,0.0
10972,1,972,[318 515 588 427  79],807,5,4261,4.379239465570401,40.0,0.0
10973,1,973,[318 515 588 427  79],716,5,4266,4.379876796714579,40.0,0.0
10974,1,974,[318 515 588 427  79],18,5,4271,4.380512820512821,40.0,0.0
10975,1,975,[318 515 588 427  79],807,5,4276,4.381147540983607,40.0,0.0
10976,1,976,[427 144 357  15 125],655,2,4278,4.37871033776868,20.0,0.0
10977,1,977,[318 515 588 427  79],716,5,4283,4.379345603271983,40.0,0.0
10978,1,978,[318 515 588 427  79],18,5,4288,4.379979570990807,40.0,0.0
10979,1,979,[318 515 588 427  79],807,5,4293,4.380612244897959,40.0,0.0
10980,1,980,[144 597 179 175 385],457,4,4297,4.380224260958206,0.0,0.0
10981,1,981,[318 515 588 427  79],716,5,4302,4.380855397148676,40.0,0.0
10982,1,982,[318 515 588 427  79],18,5,4307,4.38148524923703,40.0,0.0
10983,1,983,[318 515 588 427  79],18,5,4312,4.382113821138211,40.0,0.0
10984,1,984,[318 515 588 427  79],18,5,4317,4.382741116751269,40.0,0.0
10985,1,985,[318 515 588 427  79],716,5,4322,4.383367139959432,40.0,0.0
10986,1,986,[318 515 588 427  79],807,5,4327,4.383991894630192,40.0,0.0
10987,1,987,[318 515 588 427  79],716,5,4332,4.384615384615385,40.0,0.0
10988,1,988,[294 742 265 144   1],796,2,4334,4.382204246713853,0.0,0.0
10989,1,989,[318 515 588 427  79],716,5,4339,4.3828282828282825,40.0,0.0
10990,1,990,[318 515 588 427  79],716,5,4344,4.3834510595358225,40.0,0.0
10991,1,991,[318 515 588 427  79],18,5,4349,4.384072580645161,40.0,0.0
10992,1,992,[318 515 588 427  79],18,5,4354,4.384692849949648,40.0,0.0
10993,1,993,[318 515 588 427  79],18,5,4359,4.385311871227364,40.0,0.0
10994,1,994,[318 515 588 427  79],807,5,4364,4.3859296482412065,40.0,0.0
10995,1,995,[318 515 588 427  79],807,5,4369,4.386546184738956,40.0,0.0
10996,1,996,[318 515 588 427  79],18,5,4374,4.38716148445336,40.0,0.0
10997,1,997,[186  82 322  98 127],796,2,4376,4.384769539078157,0.0,20.0
10998,1,998,[318 515 588 427  79],807,5,4381,4.385385385385385,40.0,0.0
10999,1,999,[215 318 471 125 385],280,2,4383,4.383,20.0,0.0
11000,1,1000,[318 515 588 427  79],18,5,4388,4.383616383616384,40.0,0.0
11001,1,1001,[318 515 588 427  79],807,5,4393,4.384231536926148,40.0,0.0
11002,1,1002,[318 515 588 427  79],807,5,4398,4.384845463609173,40.0,0.0
11003,1,1003,[318 515 588 427  79],18,5,4403,4.385458167330677,40.0,0.0
11004,1,1004,[318 515 588 427  79],716,5,4408,4.386069651741294,40.0,0.0
11005,1,1005,[151 161  96 180  11],269,1,4409,4.382703777335984,0.0,0.0
11006,1,1006,[318 515 588 427  79],716,5,4414,4.383316782522344,40.0,0.0
11007,1,1007,[318 300 111   4 238],716,4,4418,4.382936507936508,20.0,0.0
11008,1,1008,[318 515 588 427  79],807,5,4423,4.383548067393459,40.0,0.0
11009,1,1009,[318 515 588 427  79],807,5,4428,4.3841584158415845,40.0,0.0
11010,1,1010,[318 515 588 427  79],716,5,4433,4.384767556874382,40.0,0.0
11011,1,1011,[318 515 588 427  79],18,5,4438,4.3853754940711465,40.0,0.0
11012,1,1012,[318 515 588 427  79],18,5,4443,4.385982230997039,40.0,0.0
11013,1,1013,[318 515 588 427  79],18,5,4448,4.386587771203156,40.0,0.0
11014,1,1014,[210 282 187 185 168],535,3,4451,4.385221674876847,0.0,0.0
11015,1,1015,[172 117 125   8   4],593,4,4455,4.38484251968504,0.0,0.0
11016,1,1016,[318 515 588 427  79],716,5,4460,4.385447394296952,40.0,0.0
11017,1,1017,[318 515 588 427  79],18,5,4465,4.386051080550098,40.0,0.0
11018,1,1018,[318 515 588 427  79],18,5,4470,4.386653581943081,40.0,0.0
11019,1,1019,[318 515 588 427  79],18,5,4475,4.387254901960785,40.0,0.0
11020,1,1020,[318 515 588 427  79],18,5,4480,4.387855044074437,40.0,0.0
11021,1,1021,[ 22 405 176 294  25],457,4,4484,4.387475538160469,0.0,0.0
11022,1,1022,[135 237 172 603 568],655,3,4487,4.386119257086999,20.0,0.0
11023,1,1023,[182 273 197 185 118],450,3,4490,4.384765625,0.0,0.0
11024,1,1024,[318 515 588 427  79],18,5,4495,4.385365853658537,40.0,0.0
11025,1,1025,[318 515 588 427  79],18,5,4500,4.385964912280702,40.0,0.0
11026,1,1026,[318 515 588 427  79],18,5,4505,4.386562804284323,40.0,0.0
11027,1,1027,[318 515 588 427  79],716,5,4510,4.38715953307393,40.0,0.0
11028,1,1028,[318 515 588 427  79],716,5,4515,4.387755102040816,40.0,0.0
11029,1,1029,[318 515 588 427  79],18,5,4520,4.388349514563107,40.0,0.0
11030,1,1030,[318 515 588 427  79],18,5,4525,4.38894277400582,40.0,0.0
11031,1,1031,[318 515 588 427  79],716,5,4530,4.3895348837209305,40.0,0.0
11032,1,1032,[318 515 588 427  79],716,5,4535,4.390125847047434,40.0,0.0
11033,1,1033,[318 515 588 427  79],807,5,4540,4.390715667311412,40.0,0.0
11034,1,1034,[318 515 588 427  79],18,5,4545,4.391304347826087,40.0,0.0
11035,1,1035,[318 515 588 427  79],18,5,4550,4.391891891891892,40.0,0.0
11036,1,1036,[318 515 588 427  79],716,5,4555,4.392478302796529,40.0,0.0
11037,1,1037,[603 202 238 100  15],389,4,4559,4.392100192678227,20.0,20.0
11038,1,1038,[318 515 588 427  79],807,5,4564,4.392685274302214,40.0,0.0
11039,1,1039,[111 161 275 185 117],716,4,4568,4.392307692307693,0.0,20.0
11040,1,1040,[318 515 588 427  79],716,5,4573,4.392891450528338,40.0,0.0
11041,1,1041,[186 176  12  64   1],450,4,4577,4.392514395393474,20.0,0.0
11042,1,1042,[318 515 588 427  79],716,5,4582,4.393096836049856,40.0,0.0
11043,1,1043,[  4 168 546 742   7],457,4,4586,4.39272030651341,0.0,0.0
11044,1,1044,[318 515 588 427  79],716,5,4591,4.393301435406698,40.0,0.0
11045,1,1045,[195  98   4 180 118],450,3,4594,4.3919694072657744,0.0,0.0
11046,1,1046,[318 515 588 427  79],18,5,4599,4.392550143266476,40.0,0.0
11047,1,1047,[318 515 588 427  79],18,5,4604,4.393129770992366,40.0,0.0
11048,1,1048,[318 144 125 228 127],796,5,4609,4.393708293612964,20.0,20.0
11049,1,1049,[318 515 588 427  79],716,5,4614,4.394285714285714,40.0,0.0
11050,1,1050,[183  25 742 202 273],450,3,4617,4.392959086584206,0.0,0.0
11051,1,1051,[318 515 588 427  79],807,5,4622,4.393536121673004,40.0,0.0
11052,1,1052,[318 515 588 427  79],18,5,4627,4.394112060778728,40.0,0.0
11053,1,1053,[318 515 588 427  79],716,5,4632,4.394686907020873,40.0,0.0
11054,1,1054,[125 245 435 187 403],450,5,4637,4.395260663507109,0.0,0.0
11055,1,1055,[318 515 588 427  79],18,5,4642,4.395833333333333,40.0,0.0
11056,1,1056,[318 515 588 427  79],807,5,4647,4.396404919583728,40.0,0.0
11057,1,1057,[174 234 182 357 515],18,4,4651,4.396030245746692,0.0,0.0
11058,1,1058,[318 515 588 427  79],18,5,4656,4.396600566572238,40.0,0.0
11059,1,1059,[318 515 588 427  79],716,5,4661,4.3971698113207545,40.0,0.0
11060,1,1060,[ 28 168   1  22  71],450,4,4665,4.39679547596607,0.0,0.0
11061,1,1061,[228 182 403 197  69],796,4,4669,4.3964218455743875,0.0,0.0
11062,1,1062,[318 515 588 427  79],716,5,4674,4.3969896519285045,40.0,0.0
11063,1,1063,[258   4 172  70 288],655,1,4675,4.393796992481203,0.0,0.0
11064,1,1064,[269 301 200 176 172],450,4,4679,4.393427230046949,0.0,0.0
11065,1,1065,[318 515 588 427  79],18,5,4684,4.393996247654784,40.0,0.0
11066,1,1066,[318 515 588 427  79],807,5,4689,4.39456419868791,40.0,0.0
11067,1,1067,[318 515 588 427  79],807,5,4694,4.395131086142322,40.0,0.0
11068,1,1068,[257 180 322  96 118],504,4,4698,4.394761459307764,0.0,0.0
11069,1,1069,[318 515 588 427  79],716,5,4703,4.395327102803738,40.0,0.0
11070,1,1070,[318 515 588 427  79],716,5,4708,4.395891690009337,40.0,0.0
11071,1,1071,[318 515 588 427  79],18,5,4713,4.396455223880597,40.0,0.0
11072,1,1072,[597 215  25 313 216],344,2,4715,4.394221808014912,0.0,0.0
11073,1,1073,[318 515 588 427  79],716,5,4720,4.394785847299814,40.0,0.0
11074,1,1074,[318 515 588 427  79],716,5,4725,4.395348837209302,40.0,0.0
11075,1,1075,[318 515 588 427  79],807,5,4730,4.395910780669145,40.0,0.0
11076,1,1076,[318 515 588 427  79],807,5,4735,4.396471680594243,40.0,0.0
11077,1,1077,[318 515 588 427  79],716,5,4740,4.397031539888682,40.0,0.0
11078,1,1078,[ 71 168  22 302 132],450,4,4744,4.396663577386469,0.0,0.0
11079,1,1079,[151 173 275 546 168],151,4,4748,4.396296296296296,0.0,20.0
11080,1,1080,[588 273 403 301 210],450,3,4751,4.395004625346901,0.0,0.0
11081,1,1081,[144 282 121 111 234],655,0,4751,4.3909426987061,0.0,0.0
11082,1,1082,[111 235 742 301 173],344,3,4754,4.3896583564173595,0.0,0.0
11083,1,1083,[118 483 187 282 168],450,3,4757,4.388376383763838,0.0,0.0
11084,1,1084,[515 318 588 427  79],716,5,4762,4.388940092165899,40.0,0.0
11085,1,1085,[515 318 588 427  79],807,5,4767,4.389502762430939,40.0,0.0
11086,1,1086,[127 153 172 216 257],655,3,4770,4.388224471021159,0.0,20.0
11087,1,1087,[144 132 180  56 196],535,3,4773,4.3869485294117645,0.0,0.0
11088,1,1088,[196 597 176 257 275],457,3,4776,4.3856749311294765,0.0,20.0
11089,1,1089,[515 318 588 427  79],716,5,4781,4.386238532110092,40.0,0.0
11090,1,1090,[515 318 588 427  79],807,5,4786,4.386801099908341,40.0,0.0
11091,1,1091,[515 318 588 427  79],807,5,4791,4.387362637362638,40.0,0.0
11092,1,1092,[515 318 588 427  79],716,5,4796,4.387923147301007,40.0,0.0
11093,1,1093,[515 318 588 427  79],807,5,4801,4.388482632541133,40.0,0.0
11094,1,1094,[515 318 588 427  79],807,5,4806,4.389041095890411,40.0,0.0
11095,1,1095,[515 318 588 427  79],807,5,4811,4.389598540145985,40.0,0.0
11096,1,1096,[515 318 588 427  79],807,5,4816,4.390154968094804,40.0,0.0
11097,1,1097,[515 318 588 427  79],807,5,4821,4.390710382513661,40.0,0.0
11098,1,1098,[515 318 588 427  79],807,5,4826,4.391264786169245,40.0,0.0
11099,1,1099,[515 318 588 427  79],807,5,4831,4.391818181818182,40.0,0.0
11100,1,1100,[515 318 588 427  79],18,5,4836,4.392370572207084,40.0,0.0
11101,1,1101,[405 121 258 237 318],450,4,4840,4.392014519056262,20.0,0.0
11102,1,1102,[496 235 385 546  50],344,2,4842,4.389845874886673,20.0,20.0
11103,1,1103,[742 273  79 179 100],655,3,4845,4.388586956521739,0.0,20.0
11104,1,1104,[515 318 588 427  79],807,5,4850,4.389140271493213,40.0,0.0
11105,1,1105,[515 318 588 427  79],18,5,4855,4.3896925858951175,40.0,0.0
11106,1,1106,[515 318 588 427  79],18,5,4860,4.390243902439025,40.0,0.0
11107,1,1107,[515 318 588 427  79],18,5,4865,4.390794223826715,40.0,0.0
11108,1,1108,[117 471 268 237 655],655,0,4865,4.386834986474301,0.0,0.0
11109,1,1109,[515 318 588 427  79],807,5,4870,4.387387387387387,40.0,0.0
11110,1,1110,[515 318 588 427  79],18,5,4875,4.387938793879388,40.0,0.0
11111,1,1111,[515 318 588 427  79],807,5,4880,4.388489208633094,40.0,0.0
11112,1,1112,[ 12 195 111   1 603],450,5,4885,4.389038634321653,20.0,0.0
11113,1,1113,[515 318 588 427  79],18,5,4890,4.3895870736086176,40.0,0.0
11114,1,1114,[515 318 588 427  79],807,5,4895,4.390134529147982,40.0,0.0
11115,1,1115,[515 318 588 427  79],807,5,4900,4.39068100358423,40.0,0.0
11116,1,1116,[515 318 588 427  79],716,5,4905,4.391226499552372,40.0,0.0
11117,1,1117,[515 318 588 427  79],18,5,4910,4.391771019677996,40.0,0.0
11118,1,1118,[515 318 588 427  79],807,5,4915,4.392314566577301,40.0,0.0
11119,1,1119,[515 318 588 427  79],807,5,4920,4.392857142857143,40.0,0.0
11120,1,1120,[174 143 273 603 385],796,4,4924,4.392506690454951,20.0,0.0
11121,1,1121,[515 318 588 427  79],18,5,4929,4.393048128342246,40.0,0.0
11122,1,1122,[515 318 588 427  79],18,5,4934,4.393588601959038,40.0,0.0
11123,1,1123,[ 50 143 196 234 265],457,5,4939,4.394128113879003,0.0,20.0
11124,1,1124,[515 318 588 427  79],807,5,4944,4.394666666666667,40.0,0.0
11125,1,1125,[515 318 588 427  79],18,5,4949,4.395204262877442,40.0,0.0
11126,1,1126,[515 318 588 427  79],18,5,4954,4.395740905057675,40.0,0.0
11127,1,1127,[ 88 357 210 111 302],450,4,4958,4.3953900709219855,0.0,0.0
11128,1,1128,[515 318 588 427  79],18,5,4963,4.395925597874225,40.0,0.0
11129,1,1129,[515 318 588 427  79],716,5,4968,4.396460176991151,40.0,0.0
11130,1,1130,[515 318 588 427  79],716,5,4973,4.396993810786914,40.0,0.0
11131,1,1131,[403  56 318 174 179],655,2,4975,4.394876325088339,20.0,0.0
11132,1,1132,[268 151 237 180 185],269,3,4978,4.393645189761695,0.0,0.0
11133,1,1133,[318 515 588 427  79],807,5,4983,4.394179894179894,40.0,0.0
11134,1,1134,[385  89 258 300 301],450,5,4988,4.394713656387665,0.0,0.0
11135,1,1135,[185 313 144  50 289],655,3,4991,4.393485915492958,0.0,20.0
11136,1,1136,[318 515 588 427  79],716,5,4996,4.394019349164468,40.0,0.0
11137,1,1137,[318 515 588 427  79],807,5,5001,4.394551845342707,40.0,0.0
11138,1,1138,[318 515 588 427  79],716,5,5006,4.395083406496927,40.0,0.0
11139,1,1139,[318 515 588 427  79],716,5,5011,4.3956140350877195,40.0,0.0
11140,1,1140,[235  12 132 597 144],450,4,5015,4.395267309377739,0.0,0.0
11141,1,1141,[318 515 588 427  79],716,5,5020,4.395796847635727,40.0,0.0
11142,1,1142,[318 515 588 427  79],716,5,5025,4.396325459317585,40.0,0.0
11143,1,1143,[318 515 588 427  79],18,5,5030,4.396853146853147,40.0,0.0
11144,1,1144,[135   4 181 151 275],18,1,5031,4.393886462882096,0.0,20.0
11145,1,1145,[318 515 588 427  79],716,5,5036,4.394415357766143,40.0,0.0
11146,1,1146,[318 515 588 427  79],18,5,5041,4.394943330427202,40.0,0.0
11147,1,1147,[318 515 588 427  79],807,5,5046,4.395470383275262,40.0,0.0
11148,1,1148,[318 515 588 427  79],18,5,5051,4.395996518711923,40.0,0.0
11149,1,1149,[117 405 216   1  64],655,2,5053,4.3939130434782605,20.0,0.0
11150,1,1150,[318 515 588 427  79],18,5,5058,4.394439617723719,40.0,0.0
11151,1,1151,[318 515 588 427  79],807,5,5063,4.394965277777778,40.0,0.0
11152,1,1152,[100   1 200 143  79],450,4,5067,4.394622723330443,0.0,20.0
11153,1,1153,[318 515 588 427  79],18,5,5072,4.395147313691508,40.0,0.0
11154,1,1154,[318 515 588 427  79],807,5,5077,4.395670995670995,40.0,0.0
11155,1,1155,[318 515 588 427  79],716,5,5082,4.396193771626297,40.0,0.0
11156,1,1156,[318 515 588 427  79],18,5,5087,4.3967156439066555,40.0,0.0
11157,1,1157,[318 515 588 427  79],716,5,5092,4.397236614853195,40.0,0.0
11158,1,1158,[318 515 588 427  79],716,5,5097,4.397756686798965,40.0,0.0
11159,1,1159,[204 273 222  71 289],236,2,5099,4.395689655172414,0.0,0.0
11160,1,1160,[318 515 588 427  79],807,5,5104,4.396210163652024,40.0,0.0
11161,1,1161,[318 515 588 427  79],807,5,5109,4.396729776247849,40.0,0.0
11162,1,1162,[318 515 588 427  79],716,5,5114,4.397248495270851,40.0,0.0
11163,1,1163,[318 515 588 427  79],716,5,5119,4.397766323024055,40.0,0.0
11164,1,1164,[216 117 215  28 318],450,5,5124,4.398283261802575,20.0,0.0
11165,1,1165,[515 318 588 427  79],716,5,5129,4.398799313893654,40.0,0.0
11166,1,1166,[515 318 588 427  79],716,5,5134,4.399314481576693,40.0,0.0
11167,1,1167,[515 318 588 427  79],807,5,5139,4.399828767123288,40.0,0.0
11168,1,1168,[515 318 588 427  79],807,5,5144,4.400342172797263,40.0,0.0
11169,1,1169,[515 318 588 427  79],807,5,5149,4.400854700854701,40.0,0.0
11170,1,1170,[515 318 588 427  79],18,5,5154,4.401366353543979,40.0,0.0
11171,1,1171,[515 318 588 427  79],807,5,5159,4.401877133105802,40.0,0.0
11172,1,1172,[515 318 588 427  79],807,5,5164,4.402387041773231,40.0,0.0
11173,1,1173,[515 318 588 427  79],807,5,5169,4.40289608177172,40.0,0.0
11174,1,1174,[237 179 483   7 568],269,2,5171,4.400851063829787,0.0,0.0
11175,1,1175,[515 318 588 427  79],716,5,5176,4.401360544217687,40.0,0.0
11176,1,1176,[515 318 588 427  79],716,5,5181,4.401869158878505,40.0,0.0
11177,1,1177,[  1 258 265 423 144],655,0,5181,4.398132427843803,0.0,0.0
11178,1,1178,[515 318 588 427  79],807,5,5186,4.398642917726887,40.0,0.0
11179,1,1179,[515 318 588 427  79],18,5,5191,4.399152542372882,40.0,0.0
11180,1,1180,[  4  79 318 403 276],280,3,5194,4.397967823878069,20.0,0.0
11181,1,1181,[515 318 588 427  79],18,5,5199,4.398477157360406,40.0,0.0
11182,1,1182,[515 318 588 427  79],18,5,5204,4.39898562975486,40.0,0.0
11183,1,1183,[515 318 588 427  79],18,5,5209,4.399493243243243,40.0,0.0
11184,1,1184,[515 318 588 427  79],807,5,5214,4.4,40.0,0.0
11185,1,1185,[515 318 588 427  79],18,5,5219,4.400505902192243,40.0,0.0
11186,1,1186,[515 318 588 427  79],716,5,5224,4.401010951979781,40.0,0.0
11187,1,1187,[515 318 588 427  79],807,5,5229,4.401515151515151,40.0,0.0
11188,1,1188,[515 318 588 427  79],807,5,5234,4.40201850294365,40.0,0.0
11189,1,1189,[515 318 588 427  79],18,5,5239,4.402521008403362,40.0,0.0
11190,1,1190,[515 318 588 427  79],716,5,5244,4.403022670025189,40.0,0.0
11191,1,1191,[515 318 588 427  79],716,5,5249,4.403523489932886,40.0,0.0
11192,1,1192,[515 318 588 427  79],807,5,5254,4.404023470243085,40.0,0.0
11193,1,1193,[  7 318  69 238 202],65,2,5256,4.402010050251256,20.0,0.0
11194,1,1194,[515 318 588 427  79],18,5,5261,4.402510460251046,40.0,0.0
11195,1,1195,[515 318 588 427  79],716,5,5266,4.403010033444816,40.0,0.0
11196,1,1196,[186 174 234 168 275],716,4,5270,4.402673350041771,0.0,20.0
11197,1,1197,[515 318 588 427  79],807,5,5275,4.403171953255426,40.0,0.0
11198,1,1198,[515 318 588 427  79],18,5,5280,4.4036697247706424,40.0,0.0
11199,1,1199,[ 97 301 173 269   9],796,1,5281,4.400833333333333,0.0,0.0
11200,1,1200,[515 318 588 427  79],716,5,5286,4.401332223147377,40.0,0.0
11201,1,1201,[515 318 588 427  79],807,5,5291,4.401830282861897,40.0,0.0
11202,1,1202,[238 121  95 100  50],450,3,5294,4.400665004156276,0.0,40.0
11203,1,1203,[118 271 182 269  97],655,1,5295,4.397840531561462,0.0,0.0
11204,1,1204,[515 318 588 427  79],807,5,5300,4.398340248962656,40.0,0.0
11205,1,1205,[515 318 588 427  79],716,5,5305,4.3988391376451075,40.0,0.0
11206,1,1206,[238 174 405 318 655],151,4,5309,4.39850869925435,20.0,0.0
11207,1,1207,[515 318 588 427  79],18,5,5314,4.3990066225165565,40.0,0.0
11208,1,1208,[385 121 181 200 322],504,4,5318,4.398676592224979,0.0,0.0
11209,1,1209,[237 182 568  50 427],269,2,5320,4.396694214876033,20.0,20.0
11210,1,1210,[318 515 588 427  79],716,5,5325,4.39719240297275,40.0,0.0
11211,1,1211,[435  79 318  98 196],11,4,5329,4.396864686468647,20.0,0.0
11212,1,1212,[318 515 588 427  79],716,5,5334,4.397361912613356,40.0,0.0
11213,1,1213,[318 515 588 427  79],18,5,5339,4.397858319604613,40.0,0.0
11214,1,1214,[318 515 588 427  79],716,5,5344,4.398353909465021,40.0,0.0
11215,1,1215,[174 257 118   8 475],655,0,5344,4.394736842105263,0.0,0.0
11216,1,1216,[318 515 588 427  79],18,5,5349,4.395234182415776,40.0,0.0
11217,1,1217,[318 515 588 427  79],807,5,5354,4.3957307060755335,40.0,0.0
11218,1,1218,[318 515 588 427  79],18,5,5359,4.39622641509434,40.0,0.0
11219,1,1219,[318 515 588 427  79],716,5,5364,4.39672131147541,40.0,0.0
11220,1,1220,[318 515 588 427  79],716,5,5369,4.397215397215398,40.0,0.0
11221,1,1221,[318 515 588 427  79],18,5,5374,4.397708674304419,40.0,0.0
11222,1,1222,[234 276 191  88 322],786,2,5376,4.395748160261651,0.0,0.0
11223,1,1223,[318 515 588 427  79],807,5,5381,4.396241830065359,40.0,0.0
11224,1,1224,[318 515 588 427  79],716,5,5386,4.396734693877551,40.0,0.0
11225,1,1225,[318 515 588 427  79],716,5,5391,4.397226753670473,40.0,0.0
11226,1,1226,[318 515 588 427  79],807,5,5396,4.397718011409943,40.0,0.0
11227,1,1227,[174  82 300 427 568],450,4,5400,4.397394136807818,20.0,0.0
11228,1,1228,[318 181  69 132 194],151,5,5405,4.397884458909683,20.0,0.0
11229,1,1229,[318 515 588 427  79],716,5,5410,4.3983739837398375,40.0,0.0
11230,1,1230,[318 515 588 427  79],716,5,5415,4.398862713241267,40.0,0.0
11231,1,1231,[318 515 588 427  79],18,5,5420,4.39935064935065,40.0,0.0
11232,1,1232,[318 515 588 427  79],716,5,5425,4.399837793998378,40.0,0.0
11233,1,1233,[185  82 143 135  89],450,3,5428,4.39870340356564,0.0,0.0
11234,1,1234,[318 515 588 427  79],18,5,5433,4.399190283400809,40.0,0.0
11235,1,1235,[318 515 588 427  79],18,5,5438,4.399676375404531,40.0,0.0
11236,1,1236,[318 515 588 427  79],807,5,5443,4.40016168148747,40.0,0.0
11237,1,1237,[318 515 588 427  79],807,5,5448,4.400646203554119,40.0,0.0
11238,1,1238,[318 515 588 427  79],716,5,5453,4.401129943502825,40.0,0.0
11239,1,1239,[318 515 588 427  79],807,5,5458,4.401612903225806,40.0,0.0
11240,1,1240,[318 515 588 427  79],18,5,5463,4.402095084609186,40.0,0.0
11241,1,1241,[318 515 588 427  79],716,5,5468,4.402576489533011,40.0,0.0
11242,1,1242,[318 515 588 427  79],807,5,5473,4.40305711987128,40.0,0.0
11243,1,1243,[318 515 588 427  79],716,5,5478,4.403536977491961,40.0,0.0
11244,1,1244,[174 300 196 748 273],450,4,5482,4.403212851405622,0.0,0.0
11245,1,1245,[515 318 588 427  79],807,5,5487,4.403691813804174,40.0,0.0
11246,1,1246,[515 318 588 427  79],18,5,5492,4.404170008019246,40.0,0.0
11247,1,1247,[515 318 588 427  79],18,5,5497,4.404647435897436,40.0,0.0
11248,1,1248,[127 111 215  98 202],18,2,5499,4.402722177742194,0.0,20.0
11249,1,1249,[ 98 222 289 181 173],798,2,5501,4.4008,0.0,0.0
11250,1,1250,[515 318 588 427  79],18,5,5506,4.401278976818545,40.0,0.0
11251,1,1251,[238 168 186 215 301],450,4,5510,4.400958466453674,0.0,0.0
11252,1,1252,[515 318 588 427  79],807,5,5515,4.401436552274541,40.0,0.0
11253,1,1253,[515 318 588 427  79],807,5,5520,4.401913875598086,40.0,0.0
11254,1,1254,[603 300 100 176 568],655,1,5521,4.399203187250996,20.0,20.0
11255,1,1255,[515 318 588 427  79],716,5,5526,4.399681528662421,40.0,0.0
11256,1,1256,[515 318 588 427  79],716,5,5531,4.400159108989658,40.0,0.0
11257,1,1257,[515 318 588 427  79],807,5,5536,4.400635930047695,40.0,0.0
11258,1,1258,[515 318 588 427  79],807,5,5541,4.401111993645751,40.0,0.0
11259,1,1259,[151 313 427 546  89],450,5,5546,4.401587301587302,20.0,0.0
11260,1,1260,[515 318 588 427  79],807,5,5551,4.402061855670103,40.0,0.0
11261,1,1261,[515 318 588 427  79],807,5,5556,4.4025356576862125,40.0,0.0
11262,1,1262,[515 318 588 427  79],807,5,5561,4.403008709422011,40.0,0.0
11263,1,1263,[515 318 588 427  79],807,5,5566,4.4034810126582276,40.0,0.0
11264,1,1264,[515 318 588 427  79],18,5,5571,4.40395256916996,40.0,0.0
11265,1,1265,[515 318 588 427  79],18,5,5576,4.404423380726699,40.0,0.0
11266,1,1266,[515 318 588 427  79],18,5,5581,4.404893449092344,40.0,0.0
11267,1,1267,[515 318 588 427  79],18,5,5586,4.405362776025236,40.0,0.0
11268,1,1268,[515 318 588 427  79],716,5,5591,4.405831363278172,40.0,0.0
11269,1,1269,[515 318 588 427  79],18,5,5596,4.406299212598425,40.0,0.0
11270,1,1270,[294  12 258 125 385],457,4,5600,4.405979543666405,0.0,0.0
11271,1,1271,[515 318 588 427  79],18,5,5605,4.406446540880503,40.0,0.0
11272,1,1272,[294 132 173  69 211],796,3,5608,4.405341712490181,0.0,0.0
11273,1,1273,[515 318 588 427  79],18,5,5613,4.4058084772370485,40.0,0.0
11274,1,1274,[515 318 588 427  79],716,5,5618,4.4062745098039215,40.0,0.0
11275,1,1275,[515 318 588 427  79],807,5,5623,4.406739811912225,40.0,0.0
11276,1,1276,[515 318 588 427  79],716,5,5628,4.407204385277995,40.0,0.0
11277,1,1277,[515 318 588 427  79],807,5,5633,4.407668231611893,40.0,0.0
11278,1,1278,[515 318 588 427  79],807,5,5638,4.408131352619233,40.0,0.0
11279,1,1279,[515 318 588 427  79],716,5,5643,4.40859375,40.0,0.0
11280,1,1280,[515 318 588 427  79],807,5,5648,4.409055425448868,40.0,0.0
11281,1,1281,[515 318 588 427  79],18,5,5653,4.409516380655226,40.0,0.0
11282,1,1282,[515 318 588 427  79],18,5,5658,4.409976617303196,40.0,0.0
11283,1,1283,[313 174   8 655 172],577,5,5663,4.410436137071651,0.0,0.0
11284,1,1284,[515 318 588 427  79],807,5,5668,4.410894941634242,40.0,0.0
11285,1,1285,[515 318 588 427  79],807,5,5673,4.411353032659409,40.0,0.0
11286,1,1286,[515 318 588 427  79],18,5,5678,4.411810411810412,40.0,0.0
11287,1,1287,[235 273   1 245 215],450,3,5681,4.410714285714286,0.0,0.0
11288,1,1288,[515 318 588 427  79],716,5,5686,4.4111714507370055,40.0,0.0
11289,1,1289,[515 318 588 427  79],807,5,5691,4.411627906976745,40.0,0.0
11290,1,1290,[515 318 588 427  79],716,5,5696,4.412083656080558,40.0,0.0
11291,1,1291,[258 216 222 173 183],344,4,5700,4.411764705882353,0.0,0.0
11292,1,1292,[515 318 588 427  79],807,5,5705,4.412219644238205,40.0,0.0
11293,1,1293,[515 318 588 427  79],716,5,5710,4.412673879443585,40.0,0.0
11294,1,1294,[515 318 588 427  79],716,5,5715,4.413127413127413,40.0,0.0
11295,1,1295,[515 318 588 427  79],18,5,5720,4.41358024691358,40.0,0.0
11296,1,1296,[515 318 588 427  79],807,5,5725,4.414032382420971,40.0,0.0
11297,1,1297,[515 318 588 427  79],807,5,5730,4.414483821263483,40.0,0.0
11298,1,1298,[515 318 588 427  79],18,5,5735,4.4149345650500385,40.0,0.0
11299,1,1299,[515 318 588 427  79],716,5,5740,4.415384615384616,40.0,0.0
11300,1,1300,[132 173 195 200 471],716,3,5743,4.414296694850115,0.0,0.0
11301,1,1301,[515 318 588 427  79],716,5,5748,4.414746543778802,40.0,0.0
11302,1,1302,[515 318 588 427  79],716,5,5753,4.415195702225633,40.0,0.0
11303,1,1303,[515 318 588 427  79],807,5,5758,4.4156441717791415,40.0,0.0
11304,1,1304,[515 318 588 427  79],807,5,5763,4.416091954022988,40.0,0.0
11305,1,1305,[515 318 588 427  79],807,5,5768,4.416539050535988,40.0,0.0
11306,1,1306,[588 302 222  95 200],450,2,5770,4.41469013006886,0.0,0.0
11307,1,1307,[515 318 588 427  79],18,5,5775,4.415137614678899,40.0,0.0
11308,1,1308,[318  71 435 181   9],18,4,5779,4.414820473644003,20.0,0.0
11309,1,1309,[515 318 588 427  79],716,5,5784,4.415267175572519,40.0,0.0
11310,1,1310,[ 79   8   4 182 318],18,4,5788,4.414950419527079,20.0,0.0
11311,1,1311,[515 318 588 427  79],807,5,5793,4.415396341463414,40.0,0.0
11312,1,1312,[ 56  12 322 273 174],450,4,5797,4.415079969535415,0.0,0.0
11313,1,1313,[121 273  79  50 117],450,3,5800,4.41400304414003,0.0,20.0
11314,1,1314,[179  97 288 276 191],457,5,5805,4.414448669201521,0.0,0.0
11315,1,1315,[ 95 174 118 181 286],389,2,5807,4.4126139817629175,0.0,20.0
11316,1,1316,[515 318 588 427  79],716,5,5812,4.413059984813971,40.0,0.0
11317,1,1317,[515 318 588 427  79],716,5,5817,4.41350531107739,40.0,0.0
11318,1,1318,[515 318 588 427  79],716,5,5822,4.413949962092494,40.0,0.0
11319,1,1319,[515 318 588 427  79],18,5,5827,4.414393939393939,40.0,0.0
11320,1,1320,[515 318 588 427  79],716,5,5832,4.414837244511734,40.0,0.0
11321,1,1321,[515 318 588 427  79],807,5,5837,4.415279878971256,40.0,0.0
11322,1,1322,[515 318 588 427  79],18,5,5842,4.415721844293273,40.0,0.0
11323,1,1323,[288  15 655   4 118],450,1,5843,4.413141993957704,0.0,0.0
11324,1,1324,[275  97  98 174 100],344,4,5847,4.412830188679245,0.0,40.0
11325,1,1325,[515 318 588 427  79],716,5,5852,4.413273001508296,40.0,0.0
11326,1,1326,[196 176 286 191 268],655,1,5853,4.410700828937453,0.0,20.0
11327,1,1327,[515 318 588 427  79],807,5,5858,4.411144578313253,40.0,0.0
11328,1,1328,[515 318 588 427  79],807,5,5863,4.411587659894658,40.0,0.0
11329,1,1329,[ 88 268 742 181  71],344,0,5863,4.408270676691729,0.0,0.0
11330,1,1330,[ 96 135 117 238 187],716,2,5865,4.406461307287754,0.0,0.0
11331,1,1331,[515 318 588 427  79],807,5,5870,4.406906906906907,40.0,0.0
11332,1,1332,[515 318 588 427  79],716,5,5875,4.40735183795949,40.0,0.0
11333,1,1333,[515 318 588 427  79],807,5,5880,4.4077961019490255,40.0,0.0
11334,1,1334,[515 318 588 427  79],18,5,5885,4.408239700374532,40.0,0.0
11335,1,1335,[181 216 210 202 318],504,3,5888,4.407185628742515,20.0,0.0
11336,1,1336,[515 318 588 427  79],716,5,5893,4.407629020194465,40.0,0.0
11337,1,1337,[515 318 588 427  79],807,5,5898,4.408071748878924,40.0,0.0
11338,1,1338,[313 588 257  28 423],835,3,5901,4.407020164301717,0.0,0.0
11339,1,1339,[423  64 238   8 302],655,2,5903,4.405223880597015,20.0,0.0
11340,1,1340,[515 318 427  79 588],807,5,5908,4.405667412378822,40.0,0.0
11341,1,1341,[300 185   1 282 228],796,4,5912,4.405365126676602,0.0,0.0
11342,1,1342,[118 173 202 603  22],796,5,5917,4.405807892777364,20.0,0.0
11343,1,1343,[515 318 427  79 588],716,5,5922,4.40625,40.0,0.0
11344,1,1344,[515 318 427  79 588],807,5,5927,4.406691449814127,40.0,0.0
11345,1,1345,[515 318 427  79 588],18,5,5932,4.407132243684993,40.0,0.0
11346,1,1346,[515 318 427  79 588],716,5,5937,4.4075723830734965,40.0,0.0
11347,1,1347,[515 318 427  79 588],716,5,5942,4.408011869436201,40.0,0.0
11348,1,1348,[515 318 427  79 588],716,5,5947,4.408450704225352,40.0,0.0
11349,1,1349,[181  28 265 282 294],655,0,5947,4.405185185185185,0.0,0.0
11350,1,1350,[515 318 427  79 588],807,5,5952,4.405625462620281,40.0,0.0
11351,1,1351,[515 318 427  79 588],18,5,5957,4.406065088757397,40.0,0.0
11352,1,1352,[515 318 427  79 588],716,5,5962,4.40650406504065,40.0,0.0
11353,1,1353,[196  56  70 385 655],23,2,5964,4.404726735598228,0.0,0.0
11354,1,1354,[515 318 427  79 588],18,5,5969,4.405166051660516,40.0,0.0
11355,1,1355,[515 318 427  79 588],807,5,5974,4.405604719764011,40.0,0.0
11356,1,1356,[515 318 427  79 588],807,5,5979,4.406042741341194,40.0,0.0
11357,1,1357,[282 403 183 202 385],655,1,5980,4.403534609720177,0.0,0.0
11358,1,1358,[515 318 427  79 588],18,5,5985,4.403973509933775,40.0,0.0
11359,1,1359,[515 318 427  79 588],807,5,5990,4.404411764705882,40.0,0.0
11360,1,1360,[515 318 427  79 588],18,5,5995,4.4048493754592215,40.0,0.0
11361,1,1361,[515 318 427  79 588],716,5,6000,4.405286343612334,40.0,0.0
11362,1,1362,[515 318 427  79 588],807,5,6005,4.405722670579604,40.0,0.0
11363,1,1363,[ 98 228  12 125 215],151,4,6009,4.405425219941349,0.0,0.0
11364,1,1364,[515 318 427  79 588],807,5,6014,4.405860805860806,40.0,0.0
11365,1,1365,[515 318 427  79 588],807,5,6019,4.406295754026354,40.0,0.0
11366,1,1366,[515 318 427  79 588],716,5,6024,4.406730065837601,40.0,0.0
11367,1,1367,[748 678  98 125 245],256,5,6029,4.4071637426900585,0.0,0.0
11368,1,1368,[273 385 265 215 318],655,2,6031,4.405405405405405,20.0,0.0
11369,1,1369,[515 318 427  79 588],807,5,6036,4.405839416058394,40.0,0.0
11370,1,1370,[515 318 427  79 588],18,5,6041,4.406272793581327,40.0,0.0
11371,1,1371,[515 318 427  79 588],716,5,6046,4.406705539358601,40.0,0.0
11372,1,1372,[515 318 427  79 588],716,5,6051,4.407137654770575,40.0,0.0
11373,1,1373,[118  98   1 100 132],151,3,6054,4.406113537117904,0.0,20.0
11374,1,1374,[515 318 427  79 588],716,5,6059,4.406545454545455,40.0,0.0
11375,1,1375,[ 12 435 210 118 302],450,3,6062,4.405523255813954,0.0,0.0
11376,1,1376,[ 88 328  56   4 508],655,0,6062,4.402323892519971,0.0,0.0
11377,1,1377,[  7 153 118  98  25],655,1,6063,4.399854862119013,0.0,0.0
11378,1,1378,[515 318 427  79 588],807,5,6068,4.400290065264684,40.0,0.0
11379,1,1379,[515 318 427  79 588],18,5,6073,4.40072463768116,40.0,0.0
11380,1,1380,[515 318 427  79 588],18,5,6078,4.401158580738596,40.0,0.0
11381,1,1381,[  1 496 655 276 144],280,3,6081,4.4001447178002895,20.0,0.0
11382,1,1382,[ 71 186 294 483 234],796,2,6083,4.398409255242227,0.0,0.0
11383,1,1383,[515 318 427  79 588],716,5,6088,4.398843930635838,40.0,0.0
11384,1,1384,[515 318 427  79 588],807,5,6093,4.3992779783393505,40.0,0.0
11385,1,1385,[515 318 427  79 588],716,5,6098,4.3997113997114,40.0,0.0
11386,1,1386,[111  79 216 568 496],389,2,6100,4.397981254506129,20.0,0.0
11387,1,1387,[182   1  88 271 200],796,4,6104,4.3976945244956775,0.0,0.0
11388,1,1388,[515 318 427  79 588],807,5,6109,4.39812814974802,40.0,0.0
11389,1,1389,[515 318 427  79 588],807,5,6114,4.398561151079137,40.0,0.0
11390,1,1390,[515 318 427  79 588],716,5,6119,4.398993529834652,40.0,0.0
11391,1,1391,[515 318 427  79 588],716,5,6124,4.399425287356322,40.0,0.0
11392,1,1392,[515 318 427  79 588],18,5,6129,4.399856424982053,40.0,0.0
11393,1,1393,[515 318 427  79 588],18,5,6134,4.400286944045911,40.0,0.0
11394,1,1394,[515 318 427  79 588],18,5,6139,4.4007168458781365,40.0,0.0
11395,1,1395,[357  79 273  22 173],796,4,6143,4.400429799426934,0.0,0.0
11396,1,1396,[515 318 427  79 588],716,5,6148,4.400858983536149,40.0,0.0
11397,1,1397,[515 318 427  79 588],807,5,6153,4.401287553648069,40.0,0.0
11398,1,1398,[603 237 328  89 222],796,5,6158,4.401715511079343,20.0,0.0
11399,1,1399,[237 282 185 546 125],450,5,6163,4.402142857142858,0.0,0.0
11400,1,1400,[515 318 427  79 588],716,5,6168,4.402569593147752,40.0,0.0
11401,1,1401,[655 300  11 194   7],629,3,6171,4.401569186875892,0.0,0.0
11402,1,1402,[515 318 427  79 588],18,5,6176,4.40199572344975,40.0,0.0
11403,1,1403,[515 318 427  79 588],807,5,6181,4.402421652421652,40.0,0.0
11404,1,1404,[117 313 172 234  79],693,3,6184,4.401423487544484,0.0,0.0
11405,1,1405,[515 318 427  79 588],807,5,6189,4.401849217638691,40.0,0.0
11406,1,1406,[515 318 427  79 588],807,5,6194,4.40227434257285,40.0,0.0
11407,1,1407,[121 191 187 328 196],450,4,6198,4.401988636363637,0.0,0.0
11408,1,1408,[515 318 427  79 588],18,5,6203,4.402413058907026,40.0,0.0
11409,1,1409,[515 318 427  79 588],716,5,6208,4.402836879432624,40.0,0.0
11410,1,1410,[515 318 427  79 588],716,5,6213,4.403260099220411,40.0,0.0
11411,1,1411,[515 318 427  79 588],807,5,6218,4.403682719546742,40.0,0.0
11412,1,1412,[515 318 427  79 588],18,5,6223,4.4041047416843595,40.0,0.0
11413,1,1413,[ 79 210 568 313 357],796,4,6227,4.403818953323904,0.0,0.0
11414,1,1414,[153 286 161 135 200],655,2,6229,4.402120141342756,0.0,20.0
11415,1,1415,[302  22 475 132 186],269,2,6231,4.40042372881356,0.0,0.0
11416,1,1416,[515 318 427  79 588],18,5,6236,4.4008468595624555,40.0,0.0
11417,1,1417,[515 318 427  79 588],18,5,6241,4.401269393511988,40.0,0.0
11418,1,1418,[515 318 427  79 588],18,5,6246,4.40169133192389,40.0,0.0
11419,1,1419,[515 318 427  79 588],807,5,6251,4.402112676056338,40.0,0.0
11420,1,1420,[238 271 423 282 168],796,4,6255,4.4018296973962,0.0,0.0
11421,1,1421,[515 318 427  79 588],18,5,6260,4.4022503516174405,40.0,0.0
11422,1,1422,[515 318 427  79 588],716,5,6265,4.402670414617006,40.0,0.0
11423,1,1423,[515 318 427  79 588],716,5,6270,4.40308988764045,40.0,0.0
11424,1,1424,[515 318 427  79 588],716,5,6275,4.4035087719298245,40.0,0.0
11425,1,1425,[  1  56 216 194 471],450,5,6280,4.403927068723703,0.0,0.0
11426,1,1426,[515 318 427  79 588],716,5,6285,4.404344779257183,40.0,0.0
11427,1,1427,[121 238 135 204 300],450,3,6288,4.4033613445378155,0.0,0.0
11428,1,1428,[515 318 427  79 588],716,5,6293,4.403778866340098,40.0,0.0
11429,1,1429,[515 318 427  79 588],807,5,6298,4.404195804195804,40.0,0.0
11430,1,1430,[286 475 435 185   1],389,4,6302,4.403913347309573,0.0,20.0
11431,1,1431,[211 234 143 603 200],655,3,6305,4.402932960893855,20.0,0.0
11432,1,1432,[515 318 427  79 588],18,5,6310,4.403349616189812,40.0,0.0
11433,1,1433,[117 357  69 125 100],786,5,6315,4.403765690376569,0.0,20.0
11434,1,1434,[ 82 118  69 174 173],716,4,6319,4.403484320557491,0.0,0.0
11435,1,1435,[515 318 427  79 588],18,5,6324,4.403899721448468,40.0,0.0
11436,1,1436,[515 318 427  79 588],716,5,6329,4.404314544189283,40.0,0.0
11437,1,1437,[515 318 427  79 588],807,5,6334,4.404728789986092,40.0,0.0
11438,1,1438,[185 357 210 144 153],450,4,6338,4.4044475330090345,0.0,0.0
11439,1,1439,[423  56  64 121 238],716,5,6343,4.404861111111111,20.0,0.0
11440,1,1440,[515 318 427  79 588],807,5,6348,4.40527411519778,40.0,0.0
11441,1,1441,[185 202 211 135   9],18,2,6350,4.403606102635229,0.0,0.0
11442,1,1442,[182 183   4 301 185],655,3,6353,4.402633402633403,0.0,0.0
11443,1,1443,[515 318 427  79 588],18,5,6358,4.403047091412742,40.0,0.0
11444,1,1444,[515 318 427  79 588],18,5,6363,4.403460207612457,40.0,0.0
11445,1,1445,[ 95   1 144  50 185],450,4,6367,4.403181189488244,0.0,20.0
11446,1,1446,[515 318 427  79 588],807,5,6372,4.403593642017968,40.0,0.0
11447,1,1447,[282 228 151  56 127],296,4,6376,4.403314917127072,0.0,20.0
11448,1,1448,[515 318 427  79 588],716,5,6381,4.403726708074534,40.0,0.0
11449,1,1449,[275 238 215  89 211],796,3,6384,4.402758620689655,0.0,20.0
11450,1,1450,[515 318 427  79 588],716,5,6389,4.403170227429359,40.0,0.0
11451,1,1451,[ 95  89 172 125 273],796,4,6393,4.402892561983471,0.0,0.0
11452,1,1452,[515 318 427  79 588],716,5,6398,4.403303509979353,40.0,0.0
11453,1,1453,[483 127 423  64 269],796,4,6402,4.40302613480055,20.0,20.0
11454,1,1454,[515 318 427  79 588],807,5,6407,4.403436426116839,40.0,0.0
11455,1,1455,[151 301  15 204 322],151,4,6411,4.40315934065934,0.0,0.0
11456,1,1456,[294 191 301 318 423],655,2,6413,4.401509951956074,20.0,0.0
11457,1,1457,[515 318 427  79 588],716,5,6418,4.401920438957476,40.0,0.0
11458,1,1458,[423 405  98 568  97],716,5,6423,4.402330363262508,0.0,0.0
11459,1,1459,[515 318 427  79 588],18,5,6428,4.402739726027397,40.0,0.0
11460,1,1460,[318 181 153  56   7],269,2,6430,4.401095140314853,20.0,0.0
11461,1,1461,[515 318 427  79 588],807,5,6435,4.401504787961696,40.0,0.0
11462,1,1462,[515 318 427  79 588],716,5,6440,4.401913875598086,40.0,0.0
11463,1,1463,[515 318 427  79 588],807,5,6445,4.402322404371585,40.0,0.0
11464,1,1464,[515 318 427  79 588],18,5,6450,4.402730375426621,40.0,0.0
11465,1,1465,[118 132 269  71 385],796,4,6454,4.402455661664393,0.0,0.0
11466,1,1466,[748 125  98 235 153],450,4,6458,4.402181322426721,0.0,0.0
11467,1,1467,[515 318 427  79 588],18,5,6463,4.40258855585831,40.0,0.0
11468,1,1468,[ 96 742  50 568  11],436,5,6468,4.402995234853642,0.0,20.0
11469,1,1469,[515 318 427  79 588],807,5,6473,4.403401360544217,40.0,0.0
11470,1,1470,[515 318 427  79 588],807,5,6478,4.403806934058464,40.0,0.0
11471,1,1471,[515 318 427  79 588],18,5,6483,4.404211956521739,40.0,0.0
11472,1,1472,[515 318 427  79 588],18,5,6488,4.404616429056348,40.0,0.0
11473,1,1473,[515 318 427  79 588],716,5,6493,4.405020352781547,40.0,0.0
11474,1,1474,[515 318 427  79 588],807,5,6498,4.40542372881356,40.0,0.0
11475,1,1475,[515 318 427  79 588],18,5,6503,4.4058265582655824,40.0,0.0
11476,1,1476,[174 121 183 546  98],504,4,6507,4.405551794177387,0.0,0.0
11477,1,1477,[515 318 427  79 588],18,5,6512,4.40595399188092,40.0,0.0
11478,1,1478,[515 318 427  79 588],18,5,6517,4.406355645706559,40.0,0.0
11479,1,1479,[161  95 118  96 100],450,3,6520,4.405405405405405,0.0,20.0
11480,1,1480,[265 183 328 176 234],292,4,6524,4.405131667792032,0.0,0.0
11481,1,1481,[515 318 427  79 588],716,5,6529,4.4055330634278,40.0,0.0
11482,1,1482,[515 318 427  79 588],18,5,6534,4.405933917734322,40.0,0.0
11483,1,1483,[515 318 427  79 588],807,5,6539,4.40633423180593,40.0,0.0
11484,1,1484,[515 318 427  79 588],18,5,6544,4.406734006734006,40.0,0.0
11485,1,1485,[515 318 427  79 588],18,5,6549,4.4071332436069985,40.0,0.0
11486,1,1486,[515 318 427  79 588],716,5,6554,4.407531943510424,40.0,0.0
11487,1,1487,[435 222 568 183 118],756,1,6555,4.405241935483871,0.0,0.0
11488,1,1488,[ 98 273  89 196 269],796,3,6558,4.404298186702485,0.0,0.0
11489,1,1489,[515 318 427  79 588],716,5,6563,4.404697986577181,40.0,0.0
11490,1,1490,[515 318 427  79 588],18,5,6568,4.405097250167673,40.0,0.0
11491,1,1491,[603 194 237 172 273],796,4,6572,4.404825737265416,20.0,0.0
11492,1,1492,[515 318 427  79 588],716,5,6577,4.405224380442063,40.0,0.0
11493,1,1493,[215 181   4  25  98],18,1,6578,4.402945113788487,0.0,0.0
11494,1,1494,[515 318 427  79 588],807,5,6583,4.403344481605351,40.0,0.0
11495,1,1495,[515 318 427  79 588],807,5,6588,4.403743315508021,40.0,0.0
11496,1,1496,[515 318 427  79 588],716,5,6593,4.404141616566466,40.0,0.0
11497,1,1497,[515 318 427  79 588],716,5,6598,4.404539385847797,40.0,0.0
11498,1,1498,[515 318 427  79 588],18,5,6603,4.404936624416277,40.0,0.0
11499,1,1499,[515 318 427  79 588],716,5,6608,4.405333333333333,40.0,0.0
11500,1,1500,[515 318 427  79 588],716,5,6613,4.405729513657562,40.0,0.0
11501,1,1501,[515 318 427  79 588],807,5,6618,4.40612516644474,40.0,0.0
11502,1,1502,[515 318 427  79 588],18,5,6623,4.406520292747838,40.0,0.0
11503,1,1503,[515 318 427  79 588],18,5,6628,4.406914893617022,40.0,0.0
11504,1,1504,[515 318 427  79 588],716,5,6633,4.407308970099668,40.0,0.0
11505,1,1505,[515 318 427  79 588],18,5,6638,4.4077025232403715,40.0,0.0
11506,1,1506,[515 318 427  79 588],18,5,6643,4.408095554080956,40.0,0.0
11507,1,1507,[121 742 405  97  25],344,1,6644,4.405835543766578,0.0,0.0
11508,1,1508,[111  64  70 483 210],655,2,6646,4.404241219350563,20.0,0.0
11509,1,1509,[515 318 427  79 588],18,5,6651,4.404635761589404,40.0,0.0
11510,1,1510,[515 318 427  79 588],807,5,6656,4.405029781601589,40.0,0.0
11511,1,1511,[268 172 403 173 179],269,2,6658,4.4034391534391535,0.0,0.0
11512,1,1512,[176 132 237  69  95],786,5,6663,4.403833443489756,0.0,0.0
11513,1,1513,[515 318 427  79 588],807,5,6668,4.404227212681638,40.0,0.0
11514,1,1514,[515 318 427  79 588],18,5,6673,4.404620462046204,40.0,0.0
11515,1,1515,[515 318 427  79 588],716,5,6678,4.405013192612137,40.0,0.0
11516,1,1516,[515 318 427  79 588],716,5,6683,4.405405405405405,40.0,0.0
11517,1,1517,[655 222 176 258  88],655,0,6683,4.402503293807642,0.0,0.0
11518,1,1518,[100  56 215 269 216],23,4,6687,4.402238314680711,0.0,20.0
11519,1,1519,[ 82  97 168 143 117],504,5,6692,4.402631578947369,0.0,0.0
11520,1,1520,[515 318 427  79 588],807,5,6697,4.403024326101249,40.0,0.0
11521,1,1521,[483 655  82 183 496],911,2,6699,4.401445466491459,20.0,0.0
11522,1,1522,[515 318 427  79 588],807,5,6704,4.401838476690742,40.0,0.0
11523,1,1523,[515 318 427  79 588],716,5,6709,4.402230971128609,40.0,0.0
11524,1,1524,[515 318 427  79 588],18,5,6714,4.402622950819672,40.0,0.0
11525,1,1525,[515 318 427  79 588],716,5,6719,4.403014416775885,40.0,0.0
11526,1,1526,[515 318 427  79 588],807,5,6724,4.403405370006549,40.0,0.0
11527,1,1527,[515 318 427  79 588],716,5,6729,4.403795811518324,40.0,0.0
11528,1,1528,[172 100 111 143  70],593,5,6734,4.404185742315239,0.0,20.0
11529,1,1529,[515 318 427  79 588],716,5,6739,4.404575163398693,40.0,0.0
11530,1,1530,[185  28 168 118  25],504,4,6743,4.404310907903331,0.0,0.0
11531,1,1531,[194 245   7 313  70],450,5,6748,4.404699738903394,0.0,0.0
11532,1,1532,[483  97 269 742 238],450,4,6752,4.4044357469015,0.0,0.0
11533,1,1533,[515 318 427  79 588],807,5,6757,4.404823989569752,40.0,0.0
11534,1,1534,[515 318 427  79 588],18,5,6762,4.405211726384365,40.0,0.0
11535,1,1535,[127 211 111  50   1],655,2,6764,4.403645833333333,0.0,40.0
11536,1,1536,[515 318 427  79 588],807,5,6769,4.4040338321405335,40.0,0.0
11537,1,1537,[515 318 427  79 588],716,5,6774,4.4044213263979195,40.0,0.0
11538,1,1538,[515 318 427  79 588],18,5,6779,4.404808317089019,40.0,0.0
11539,1,1539,[515 318 427  79 588],807,5,6784,4.405194805194805,40.0,0.0
11540,1,1540,[ 56 238 257 546  82],716,4,6788,4.404931862426995,0.0,0.0
11541,1,1541,[515 318 427  79 588],716,5,6793,4.405317769130999,40.0,0.0
11542,1,1542,[515 318 427  79 588],18,5,6798,4.405703175631886,40.0,0.0
11543,1,1543,[515 318 427  79 588],716,5,6803,4.4060880829015545,40.0,0.0
11544,1,1544,[515 318 427  79 588],807,5,6808,4.406472491909385,40.0,0.0
11545,1,1545,[515 318 427  79 588],807,5,6813,4.406856403622251,40.0,0.0
11546,1,1546,[515 318 427  79 588],807,5,6818,4.407239819004525,40.0,0.0
11547,1,1547,[515 318 427  79 588],716,5,6823,4.4076227390180875,40.0,0.0
11548,1,1548,[427  95 202 211 322],796,3,6826,4.406714009038089,20.0,0.0
11549,1,1549,[515 318 427  79 588],807,5,6831,4.4070967741935485,40.0,0.0
11550,1,1550,[237 238 204   8 153],535,5,6836,4.407479045776918,0.0,0.0
11551,1,1551,[515 318 427  79 588],716,5,6841,4.407860824742268,40.0,0.0
11552,1,1552,[515 318 427  79 588],18,5,6846,4.4082421120412105,40.0,0.0
11553,1,1553,[515 318 427  79 588],18,5,6851,4.408622908622909,40.0,0.0
11554,1,1554,[655 111 216 483  64],796,4,6855,4.408360128617363,20.0,0.0
11555,1,1555,[515 318 427  79 588],716,5,6860,4.408740359897172,40.0,0.0
11556,1,1556,[515 318 427  79 588],807,5,6865,4.4091201027617215,40.0,0.0
11557,1,1557,[515 318 427  79 588],716,5,6870,4.409499358151476,40.0,0.0
11558,1,1558,[515 318 427  79 588],716,5,6875,4.4098781270044904,40.0,0.0
11559,1,1559,[100 153 300 357  22],796,4,6879,4.4096153846153845,0.0,20.0
11560,1,1560,[100 403 216  56   1],457,5,6884,4.409993593850096,0.0,20.0
11561,1,1561,[515 318 427  79 588],716,5,6889,4.4103713188220235,40.0,0.0
11562,1,1562,[515 318 427  79 588],18,5,6894,4.410748560460653,40.0,0.0
11563,1,1563,[515 318 427  79 588],807,5,6899,4.411125319693094,40.0,0.0
11564,1,1564,[515 318 427  79 588],807,5,6904,4.411501597444089,40.0,0.0
11565,1,1565,[515 318 427  79 588],807,5,6909,4.411877394636015,40.0,0.0
11566,1,1566,[ 22 222 403 483 245],450,3,6912,4.4109763880025525,0.0,0.0
11567,1,1567,[515 318 427  79 588],716,5,6917,4.411352040816326,40.0,0.0
11568,1,1568,[515 318 427  79 588],807,5,6922,4.411727214786488,40.0,0.0
11569,1,1569,[515 318 427  79 588],18,5,6927,4.412101910828025,40.0,0.0
11570,1,1570,[515 318 427  79 588],18,5,6932,4.412476129853596,40.0,0.0
11571,1,1571,[515 318 427  79 588],807,5,6937,4.412849872773537,40.0,0.0
11572,1,1572,[515 318 427  79 588],716,5,6942,4.413223140495868,40.0,0.0
11573,1,1573,[111   8  50 289 275],756,4,6946,4.412960609911055,0.0,40.0
11574,1,1574,[515 318 427  79 588],18,5,6951,4.413333333333333,40.0,0.0
11575,1,1575,[515 318 427  79 588],807,5,6956,4.413705583756345,40.0,0.0
11576,1,1576,[  7 258 508 144  79],535,3,6959,4.41280913126189,0.0,0.0
11577,1,1577,[515 318 427 588  79],807,5,6964,4.41318124207858,40.0,0.0
11578,1,1578,[515 318 427 588  79],716,5,6969,4.413552881570614,40.0,0.0
11579,1,1579,[197 588  56 275  79],18,5,6974,4.413924050632912,0.0,20.0
11580,1,1580,[ 12 435 100  50   9],72,4,6978,4.413662239089184,0.0,40.0
11581,1,1581,[  4 234 172 195 143],796,4,6982,4.413400758533502,0.0,0.0
11582,1,1582,[ 70 655 173 182 294],457,4,6986,4.413139608338597,0.0,0.0
11583,1,1583,[515 318 427 588  79],716,5,6991,4.413510101010101,40.0,0.0
11584,1,1584,[515 318 427 588  79],807,5,6996,4.413880126182965,40.0,0.0
11585,1,1585,[ 98 423   9 181 268],655,1,6997,4.411727616645649,0.0,0.0
11586,1,1586,[515 318 427 588  79],807,5,7002,4.4120982986767485,40.0,0.0
11587,1,1587,[515 318 427 588  79],807,5,7007,4.412468513853904,40.0,0.0
11588,1,1588,[515 318 427 588  79],716,5,7012,4.412838263058528,40.0,0.0
11589,1,1589,[515 318 427 588  79],807,5,7017,4.413207547169812,40.0,0.0
11590,1,1590,[568 294 185 118 275],716,4,7021,4.412947831552483,0.0,20.0
11591,1,1591,[515 318 427 588  79],716,5,7026,4.413316582914573,40.0,0.0
11592,1,1592,[143 215 202 238 186],716,4,7030,4.413057124921532,0.0,0.0
11593,1,1593,[515 318 427 588  79],716,5,7035,4.4134253450439145,40.0,0.0
11594,1,1594,[117  79 228 318 204],655,2,7037,4.411912225705329,20.0,0.0
11595,1,1595,[ 79 168  64 181 435],18,3,7040,4.4110275689223055,20.0,0.0
11596,1,1596,[204 132 385 172 143],716,4,7044,4.410770194113963,0.0,0.0
11597,1,1597,[515 318 427 588  79],807,5,7049,4.411138923654568,40.0,0.0
11598,1,1598,[515 318 427 588  79],18,5,7054,4.411507191994997,40.0,0.0
11599,1,1599,[546 202 273 144 238],450,4,7058,4.41125,0.0,0.0
11600,1,1600,[515 318 427 588  79],716,5,7063,4.411617738913179,40.0,0.0
11601,1,1601,[515 318 427 588  79],716,5,7068,4.411985018726591,40.0,0.0
11602,1,1602,[515 318 427 588  79],807,5,7073,4.412351840299438,40.0,0.0
11603,1,1603,[515 318 427 588  79],716,5,7078,4.412718204488778,40.0,0.0
11604,1,1604,[515 318 427 588  79],18,5,7083,4.413084112149533,40.0,0.0
11605,1,1605,[515 318 427 588  79],716,5,7088,4.4134495641344955,40.0,0.0
11606,1,1606,[515 318 427 588  79],807,5,7093,4.413814561294338,40.0,0.0
11607,1,1607,[515 318 427 588  79],807,5,7098,4.414179104477612,40.0,0.0
11608,1,1608,[515 318 427 588  79],716,5,7103,4.414543194530764,40.0,0.0
11609,1,1609,[173 180 546 174 258],450,5,7108,4.414906832298136,0.0,0.0
11610,1,1610,[515 318 427 588  79],807,5,7113,4.415270018621974,40.0,0.0
11611,1,1611,[515 318 427 588  79],716,5,7118,4.415632754342432,40.0,0.0
11612,1,1612,[286   1   7 215 204],280,3,7121,4.4147551146931185,0.0,20.0
11613,1,1613,[187 194 172 588 273],450,4,7125,4.41449814126394,0.0,0.0
11614,1,1614,[515 318 427 588  79],807,5,7130,4.414860681114551,40.0,0.0
11615,1,1615,[515 318 427 588  79],807,5,7135,4.415222772277228,40.0,0.0
11616,1,1616,[515 318 427 588  79],807,5,7140,4.415584415584416,40.0,0.0
11617,1,1617,[144 132 143 174 313],655,2,7142,4.414091470951792,0.0,0.0
11618,1,1618,[318 515 427 588  79],807,5,7147,4.414453366275478,40.0,0.0
11619,1,1619,[318 515 427 588  79],716,5,7152,4.4148148148148145,40.0,0.0
11620,1,1620,[269 275 568 210 195],344,5,7157,4.415175817396669,0.0,20.0
11621,1,1621,[111 275  98   7 435],450,5,7162,4.415536374845869,0.0,20.0
11622,1,1622,[ 50 153 210  64 196],450,4,7166,4.415280345040049,20.0,20.0
11623,1,1623,[742 118 300  12 568],450,4,7170,4.415024630541872,0.0,0.0
11624,1,1624,[318 515 427 588  79],716,5,7175,4.415384615384616,40.0,0.0
11625,1,1625,[318 515 427 588  79],18,5,7180,4.415744157441575,40.0,0.0
11626,1,1626,[318 515 427 588  79],18,5,7185,4.416103257529195,40.0,0.0
11627,1,1627,[318 515 427 588  79],18,5,7190,4.416461916461916,40.0,0.0
11628,1,1628,[273   1 182 202 357],655,3,7193,4.415592387968078,0.0,0.0
11629,1,1629,[151 568 204 471 423],450,5,7198,4.415950920245399,0.0,0.0
11630,1,1630,[318 515 427 588  79],18,5,7203,4.416309012875536,40.0,0.0
11631,1,1631,[265 111 187 125 222],796,5,7208,4.416666666666667,0.0,0.0
11632,1,1632,[318 515 427 588  79],807,5,7213,4.417023882424985,40.0,0.0
11633,1,1633,[196 423 211 234 271],655,0,7213,4.414320685434516,0.0,0.0
11634,1,1634,[318 515 427 588  79],807,5,7218,4.414678899082569,40.0,0.0
11635,1,1635,[318 515 427 588  79],18,5,7223,4.415036674816626,40.0,0.0
11636,1,1636,[318 515 427 588  79],716,5,7228,4.415394013439218,40.0,0.0
11637,1,1637,[215 318 258 186 182],655,2,7230,4.413919413919414,20.0,0.0
11638,1,1638,[151 483 173 269 258],450,4,7234,4.413666870042709,0.0,0.0
11639,1,1639,[117 301  15  64 313],655,2,7236,4.412195121951219,20.0,0.0
11640,1,1640,[318 515 427 588  79],716,5,7241,4.4125533211456425,40.0,0.0
11641,1,1641,[286 186 202 322 282],796,2,7243,4.411084043848964,0.0,20.0
11642,1,1642,[318 515 427 588  79],807,5,7248,4.411442483262325,40.0,0.0
11643,1,1643,[318 515 427 588  79],716,5,7253,4.411800486618005,40.0,0.0
11644,1,1644,[318 515 427 588  79],716,5,7258,4.412158054711246,40.0,0.0
11645,1,1645,[318 515 427 588  79],716,5,7263,4.412515188335359,40.0,0.0
11646,1,1646,[204 423 125  96 258],796,5,7268,4.412871888281725,0.0,0.0
11647,1,1647,[318 515 427 588  79],18,5,7273,4.413228155339806,40.0,0.0
11648,1,1648,[318 515 427 588  79],716,5,7278,4.41358399029715,40.0,0.0
11649,1,1649,[318 515 427 588  79],716,5,7283,4.413939393939394,40.0,0.0
11650,1,1650,[318 515 427 588  79],807,5,7288,4.414294367050273,40.0,0.0
11651,1,1651,[ 22  97 282 135 117],450,4,7292,4.414043583535109,0.0,0.0
11652,1,1652,[195 496 318 172 196],151,4,7296,4.413793103448276,40.0,0.0
11653,1,1653,[318 515 427 588  79],18,5,7301,4.414147521160822,40.0,0.0
11654,1,1654,[318 515 427 588  79],807,5,7306,4.414501510574018,40.0,0.0
11655,1,1655,[318 515 427 588  79],807,5,7311,4.4148550724637685,40.0,0.0
11656,1,1656,[318 515 427 588  79],18,5,7316,4.4152082076041035,40.0,0.0
11657,1,1657,[403  71 385 132 294],577,5,7321,4.415560916767189,0.0,0.0
11658,1,1658,[318 515 427 588  79],18,5,7326,4.4159132007233275,40.0,0.0
11659,1,1659,[318 515 427 588  79],18,5,7331,4.416265060240963,40.0,0.0
11660,1,1660,[143 183 427 318  50],835,5,7336,4.416616496086695,40.0,20.0
11661,1,1661,[318 515 427 588  79],716,5,7341,4.4169675090252705,40.0,0.0
11662,1,1662,[ 70 153 508 333 195],655,0,7341,4.414311485267588,0.0,0.0
11663,1,1663,[318 515 427 588  79],807,5,7346,4.414663461538462,40.0,0.0
11664,1,1664,[318 515 427 588  79],716,5,7351,4.415015015015015,40.0,0.0
11665,1,1665,[182 195 568   1 117],72,5,7356,4.415366146458584,0.0,0.0
11666,1,1666,[318 515 427 588  79],807,5,7361,4.415716856628674,40.0,0.0
11667,1,1667,[318 515 427 588  79],807,5,7366,4.416067146282973,40.0,0.0
11668,1,1668,[318 515 427 588  79],716,5,7371,4.416417016177352,40.0,0.0
11669,1,1669,[318 515 427 588  79],807,5,7376,4.416766467065869,40.0,0.0
11670,1,1670,[318 515 427 588  79],716,5,7381,4.4171154997007775,40.0,0.0
11671,1,1671,[318 515 427 588  79],18,5,7386,4.417464114832536,40.0,0.0
11672,1,1672,[ 25  95 185 483 423],389,3,7389,4.4166168559473995,0.0,0.0
11673,1,1673,[318 515 427 588  79],716,5,7394,4.416965352449224,40.0,0.0
11674,1,1674,[301 121 385 597 185],450,4,7398,4.416716417910448,0.0,0.0
11675,1,1675,[318 515 427 588  79],18,5,7403,4.417064439140812,40.0,0.0
11676,1,1676,[318 515 427 588  79],716,5,7408,4.417412045319022,40.0,0.0
11677,1,1677,[  1  64 568 181 202],716,5,7413,4.417759237187128,20.0,0.0
11678,1,1678,[318 515 427 588  79],716,5,7418,4.418106015485408,40.0,0.0
11679,1,1679,[475 135 168 483   1],389,4,7422,4.417857142857143,0.0,0.0
11680,1,1680,[318 515 427 588  79],716,5,7427,4.418203450327186,40.0,0.0
11681,1,1681,[318 515 427 588  79],716,5,7432,4.418549346016647,40.0,0.0
11682,1,1682,[318 515 427 588  79],716,5,7437,4.418894830659537,40.0,0.0
11683,1,1683,[318 515 427 588  79],807,5,7442,4.419239904988124,40.0,0.0
11684,1,1684,[318 515 427 588  79],18,5,7447,4.419584569732938,40.0,0.0
11685,1,1685,[195 258  50 273 475],655,2,7449,4.418149466192171,0.0,20.0
11686,1,1686,[318 515 427 588  79],807,5,7454,4.418494368701838,40.0,0.0
11687,1,1687,[318 515 427 588  79],18,5,7459,4.418838862559242,40.0,0.0
11688,1,1688,[318 515 427 588  79],807,5,7464,4.4191829484902305,40.0,0.0
11689,1,1689,[318 515 427 588  79],716,5,7469,4.419526627218935,40.0,0.0
11690,1,1690,[318 515 427 588  79],807,5,7474,4.419869899467771,40.0,0.0
11691,1,1691,[ 88 588 568 357 275],330,5,7479,4.420212765957447,0.0,20.0
11692,1,1692,[318 515 427 588  79],716,5,7484,4.42055522740697,40.0,0.0
11693,1,1693,[318 515 427 588  79],18,5,7489,4.420897284533648,40.0,0.0
11694,1,1694,[318 515 427 588  79],716,5,7494,4.421238938053097,40.0,0.0
11695,1,1695,[318 515 427 588  79],807,5,7499,4.421580188679245,40.0,0.0
11696,1,1696,[742 185  96 161  82],457,5,7504,4.421921037124337,0.0,0.0
11697,1,1697,[318 515 427 588  79],716,5,7509,4.42226148409894,40.0,0.0
11698,1,1698,[237 742 234 288 174],280,2,7511,4.420835785756327,0.0,0.0
11699,1,1699,[318 515 427 588  79],807,5,7516,4.421176470588235,40.0,0.0
11700,1,1700,[216 121 196 276  11],401,3,7519,4.420340975896531,0.0,0.0
11701,1,1701,[318 515 427 588  79],18,5,7524,4.420681551116334,40.0,0.0
11702,1,1702,[318 515 427 588  79],716,5,7529,4.421021726365238,40.0,0.0
11703,1,1703,[318 515 427 588  79],807,5,7534,4.421361502347418,40.0,0.0
11704,1,1704,[318 515 427 588  79],807,5,7539,4.421700879765396,40.0,0.0
11705,1,1705,[ 69 176  98 197 235],269,2,7541,4.420281359906213,0.0,0.0
11706,1,1706,[318 515 427 588  79],18,5,7546,4.420620972466315,40.0,0.0
11707,1,1707,[318 515 427 588  79],18,5,7551,4.42096018735363,40.0,0.0
11708,1,1708,[318 515 427 588  79],18,5,7556,4.4212990052662375,40.0,0.0
11709,1,1709,[318 515 427 588  79],716,5,7561,4.421637426900585,40.0,0.0
11710,1,1710,[318 515 427 588  79],18,5,7566,4.42197545295149,40.0,0.0
11711,1,1711,[202  28 180 273  12],450,4,7570,4.421728971962617,0.0,0.0
11712,1,1712,[318 515 427 588  79],716,5,7575,4.422066549912435,40.0,0.0
11713,1,1713,[318 515 427 588  79],807,5,7580,4.422403733955659,40.0,0.0
11714,1,1714,[318 515 427 588  79],18,5,7585,4.422740524781341,40.0,0.0
11715,1,1715,[318 515 427 588  79],716,5,7590,4.423076923076923,40.0,0.0
11716,1,1716,[  1  88  82 323 153],562,3,7593,4.422248107163657,0.0,0.0
11717,1,1717,[435 313 168 405 597],807,4,7597,4.422002328288708,0.0,0.0
11718,1,1718,[181 194 180 176 301],450,5,7602,4.4223385689354275,0.0,0.0
11719,1,1719,[318 515 427 588  79],807,5,7607,4.422674418604651,40.0,0.0
11720,1,1720,[318 515 427 588  79],716,5,7612,4.42300987797792,40.0,0.0
11721,1,1721,[318 515 427 588  79],807,5,7617,4.423344947735192,40.0,0.0
11722,1,1722,[318 515 427 588  79],807,5,7622,4.423679628554846,40.0,0.0
11723,1,1723,[318 515 427 588  79],807,5,7627,4.424013921113689,40.0,0.0
11724,1,1724,[318 515 427 588  79],807,5,7632,4.424347826086956,40.0,0.0
11725,1,1725,[318 515 427 588  79],716,5,7637,4.42468134414832,40.0,0.0
11726,1,1726,[318 515 427 588  79],807,5,7642,4.42501447596989,40.0,0.0
11727,1,1727,[318 515 427 588  79],716,5,7647,4.425347222222222,40.0,0.0
11728,1,1728,[318 515 427 588  79],807,5,7652,4.42567958357432,40.0,0.0
11729,1,1729,[318 515 427 588  79],18,5,7657,4.426011560693642,40.0,0.0
11730,1,1730,[186 194 294 313  98],296,3,7660,4.425187752744079,0.0,0.0
11731,1,1731,[151 588 117 172 238],796,4,7664,4.424942263279446,0.0,0.0
11732,1,1732,[318 515 427 588  79],807,5,7669,4.425274091171379,40.0,0.0
11733,1,1733,[318 515 427 588  79],18,5,7674,4.42560553633218,40.0,0.0
11734,1,1734,[318 515 427 588  79],716,5,7679,4.425936599423631,40.0,0.0
11735,1,1735,[318 515 427 588  79],18,5,7684,4.426267281105991,40.0,0.0
11736,1,1736,[175 143 168 161  89],457,5,7689,4.426597582037997,0.0,0.0
11737,1,1737,[258 216 204 313 175],655,2,7691,4.425201380897583,0.0,0.0
11738,1,1738,[153 174  25 111 151],151,4,7695,4.424956871765382,0.0,0.0
11739,1,1739,[318 515 427 588  79],807,5,7700,4.425287356321839,40.0,0.0
11740,1,1740,[318 515 427 588  79],807,5,7705,4.425617461229178,40.0,0.0
11741,1,1741,[318 515 427 588  79],807,5,7710,4.425947187141217,40.0,0.0
11742,1,1742,[318 515 427 588  79],18,5,7715,4.4262765347102695,40.0,0.0
11743,1,1743,[742 288 151 143 258],457,5,7720,4.426605504587156,0.0,0.0
11744,1,1744,[174 273  82  96 313],655,2,7722,4.425214899713467,0.0,0.0
11745,1,1745,[318 515 427 588  79],18,5,7727,4.425544100801833,40.0,0.0
11746,1,1746,[318 515 427 588  79],716,5,7732,4.4258729250143105,40.0,0.0
11747,1,1747,[245  82  96 195 194],450,4,7736,4.425629290617849,0.0,0.0
11748,1,1748,[187 180 183 546 333],693,0,7736,4.423098913664951,0.0,0.0
11749,1,1749,[318 515 427 588  79],807,5,7741,4.4234285714285715,40.0,0.0
11750,1,1750,[313   9 300 121 403],655,1,7742,4.4214734437464305,0.0,0.0
11751,1,1751,[318 515 427 588  79],716,5,7747,4.421803652968037,40.0,0.0
11752,1,1752,[318 515 427 588  79],716,5,7752,4.422133485453508,40.0,0.0
11753,1,1753,[318 515 427 588  79],18,5,7757,4.422462941847207,40.0,0.0
11754,1,1754,[318 515 427 588  79],807,5,7762,4.422792022792023,40.0,0.0
11755,1,1755,[318 515 427 588  79],716,5,7767,4.423120728929385,40.0,0.0
11756,1,1756,[318 515 427 588  79],18,5,7772,4.4234490608992605,40.0,0.0
11757,1,1757,[318 515 427 588  79],807,5,7777,4.423777019340159,40.0,0.0
11758,1,1758,[318 515 427 588  79],716,5,7782,4.424104604889141,40.0,0.0
11759,1,1759,[318 515 427 588  79],18,5,7787,4.4244318181818185,40.0,0.0
11760,1,1760,[318 515 427 588  79],18,5,7792,4.4247586598523565,40.0,0.0
11761,1,1761,[318 515 427 588  79],18,5,7797,4.425085130533485,40.0,0.0
11762,1,1762,[183  15 403  69   1],796,4,7801,4.4248440158820195,0.0,0.0
11763,1,1763,[318 515 427 588  79],18,5,7806,4.425170068027211,40.0,0.0
11764,1,1764,[318 515 427 588  79],807,5,7811,4.425495750708215,40.0,0.0
11765,1,1765,[318 515 427 588  79],716,5,7816,4.425821064552661,40.0,0.0
11766,1,1766,[318 515 427 588  79],18,5,7821,4.426146010186757,40.0,0.0
11767,1,1767,[318 515 427 588  79],807,5,7826,4.426470588235294,40.0,0.0
11768,1,1768,[318 515 427 588  79],18,5,7831,4.426794799321651,40.0,0.0
11769,1,1769,[318 515 427 588  79],18,5,7836,4.4271186440677965,40.0,0.0
11770,1,1770,[302  97 181 268 222],344,2,7838,4.425748164878599,0.0,0.0
11771,1,1771,[318 515 427 588  79],18,5,7843,4.426072234762979,40.0,0.0
11772,1,1772,[318 515 427 588  79],18,5,7848,4.426395939086294,40.0,0.0
11773,1,1773,[111 234 265 357  97],655,1,7849,4.42446448703495,0.0,0.0
11774,1,1774,[ 50 235 678 127 174],344,3,7852,4.4236619718309855,0.0,40.0
11775,1,1775,[318 515 427 588  79],18,5,7857,4.423986486486487,40.0,0.0
11776,1,1776,[318 515 427 588  79],716,5,7862,4.424310635903208,40.0,0.0
11777,1,1777,[318 515 427 588  79],807,5,7867,4.424634420697413,40.0,0.0
11778,1,1778,[202 180  88 186 172],796,3,7870,4.423833614390107,0.0,0.0
11779,1,1779,[176 603 181 323 300],796,4,7874,4.423595505617977,20.0,0.0
11780,1,1780,[318 515 427 588  79],18,5,7879,4.423919146546884,40.0,0.0
11781,1,1781,[318 515 427 588  79],807,5,7884,4.424242424242424,40.0,0.0
11782,1,1782,[318 515 427 588  79],807,5,7889,4.42456533931576,40.0,0.0
11783,1,1783,[ 64  69 191 238 234],655,2,7891,4.423206278026906,20.0,0.0
11784,1,1784,[423 496   9  11 471],535,5,7896,4.423529411764706,20.0,0.0
11785,1,1785,[143 603  96 117 302],450,5,7901,4.423852183650616,20.0,0.0
11786,1,1786,[318 515 427 588  79],807,5,7906,4.42417459429211,40.0,0.0
11787,1,1787,[318 515 427 588  79],18,5,7911,4.424496644295302,40.0,0.0
11788,1,1788,[318 515 427 588  79],18,5,7916,4.424818334264953,40.0,0.0
11789,1,1789,[ 98 655  12 245 273],796,2,7918,4.423463687150838,0.0,0.0
11790,1,1790,[318 515 427 588  79],716,5,7923,4.423785594639866,40.0,0.0
11791,1,1791,[318 515 427 588  79],18,5,7928,4.424107142857143,40.0,0.0
11792,1,1792,[318 515 427 588  79],807,5,7933,4.424428332403792,40.0,0.0
11793,1,1793,[318 515 427 588  79],807,5,7938,4.424749163879599,40.0,0.0
11794,1,1794,[318 515 427 588  79],807,5,7943,4.425069637883008,40.0,0.0
11795,1,1795,[143 655 153 748 173],401,1,7944,4.4231625835189305,0.0,0.0
11796,1,1796,[ 50  82  79 483 435],655,3,7947,4.42237061769616,0.0,20.0
11797,1,1797,[588 237 187  89 357],450,5,7952,4.422691879866519,0.0,0.0
11798,1,1798,[196 300 202 182 275],629,5,7957,4.423012784880489,0.0,20.0
11799,1,1799,[515 318 427 588  79],807,5,7962,4.423333333333333,40.0,0.0
11800,1,1800,[515 318 427 588  79],18,5,7967,4.423653525818989,40.0,0.0
11801,1,1801,[515 318 427 588  79],18,5,7972,4.423973362930077,40.0,0.0
11802,1,1802,[322 427 245 237 200],796,3,7975,4.42318358291736,20.0,0.0
11803,1,1803,[515 318 427 588  79],716,5,7980,4.423503325942351,40.0,0.0
11804,1,1804,[515 318 427 588  79],716,5,7985,4.423822714681441,40.0,0.0
11805,1,1805,[515 318 427 588  79],716,5,7990,4.4241417497231454,40.0,0.0
11806,1,1806,[269 191 238 427 181],796,3,7993,4.423353624792473,20.0,0.0
11807,1,1807,[173 183  70 496 151],344,4,7997,4.423119469026549,20.0,0.0
11808,1,1808,[318 515 427 588  79],807,5,8002,4.423438363736871,40.0,0.0
11809,1,1809,[318 515 427 588  79],807,5,8007,4.423756906077348,40.0,0.0
11810,1,1810,[237 185 282  11  71],450,4,8011,4.42352291551629,0.0,0.0
11811,1,1811,[195  25  69 125 238],450,4,8015,4.423289183222958,0.0,0.0
11812,1,1812,[403 100  82 197 423],756,1,8016,4.421400992829565,0.0,20.0
11813,1,1813,[187 195 196 211   9],655,1,8017,4.419514884233737,0.0,0.0
11814,1,1814,[318 515 427 588  79],716,5,8022,4.419834710743801,40.0,0.0
11815,1,1815,[318 515 427 588  79],716,5,8027,4.420154185022026,40.0,0.0
11816,1,1816,[318 515 427 588  79],807,5,8032,4.4204733076499725,40.0,0.0
11817,1,1817,[318 515 427 588  79],18,5,8037,4.420792079207921,40.0,0.0
11818,1,1818,[318 515 427 588  79],807,5,8042,4.421110500274876,40.0,0.0
11819,1,1819,[603 197 269 117  98],796,3,8045,4.420329670329671,20.0,0.0
11820,1,1820,[318 515 427 588  79],807,5,8050,4.420647995606809,40.0,0.0
11821,1,1821,[195  70  69 194 204],450,5,8055,4.4209659714599345,0.0,0.0
11822,1,1822,[318 515 427 588  79],18,5,8060,4.42128359846407,40.0,0.0
11823,1,1823,[318 515 427 588  79],716,5,8065,4.421600877192983,40.0,0.0
11824,1,1824,[318 515 427 588  79],18,5,8070,4.421917808219178,40.0,0.0
11825,1,1825,[318 515 427 588  79],807,5,8075,4.42223439211391,40.0,0.0
11826,1,1826,[318 515 427 588  79],18,5,8080,4.422550629447181,40.0,0.0
11827,1,1827,[318 515 427 588  79],716,5,8085,4.422866520787746,40.0,0.0
11828,1,1828,[318 515 427 588  79],807,5,8090,4.4231820667031165,40.0,0.0
11829,1,1829,[318 515 427 588  79],716,5,8095,4.423497267759563,40.0,0.0
11830,1,1830,[318 515 427 588  79],716,5,8100,4.423812124522119,40.0,0.0
11831,1,1831,[318 515 427 588  79],807,5,8105,4.424126637554585,40.0,0.0
11832,1,1832,[318 515 427 588  79],18,5,8110,4.424440807419531,40.0,0.0
11833,1,1833,[181 228 100 313 268],344,2,8112,4.423118865866957,0.0,20.0
11834,1,1834,[318 515 427 588  79],18,5,8117,4.423433242506812,40.0,0.0
11835,1,1835,[318 515 427 588  79],18,5,8122,4.423747276688453,40.0,0.0
11836,1,1836,[202 423  15   8 121],796,5,8127,4.4240609689711485,0.0,0.0
11837,1,1837,[318 515 427 588  79],18,5,8132,4.424374319912949,40.0,0.0
11838,1,1838,[318 515 427 588  79],807,5,8137,4.42468733007069,40.0,0.0
11839,1,1839,[318 515 427 588  79],18,5,8142,4.425,40.0,0.0
11840,1,1840,[ 69 125 258 168 237],457,5,8147,4.425312330255296,0.0,0.0
11841,1,1841,[318 515 427 588  79],716,5,8152,4.425624321389794,40.0,0.0
11842,1,1842,[318 515 427 588  79],716,5,8157,4.425935973955507,40.0,0.0
11843,1,1843,[125  79 210 313 185],796,4,8161,4.4257049891540134,0.0,0.0
11844,1,1844,[ 79  97  15  28 172],796,3,8164,4.424932249322493,0.0,0.0
11845,1,1845,[318 515 427 588  79],18,5,8169,4.425243770314193,40.0,0.0
11846,1,1846,[ 56 195 200 202 216],269,2,8171,4.423930698429887,0.0,0.0
11847,1,1847,[318 515 427 588  79],807,5,8176,4.424242424242424,40.0,0.0
11848,1,1848,[318 515 427 588  79],716,5,8181,4.424553812871823,40.0,0.0
11849,1,1849,[ 22 257 357 211 111],716,5,8186,4.4248648648648645,0.0,0.0
11850,1,1850,[318 515 427 588  79],18,5,8191,4.425175580767153,40.0,0.0
11851,1,1851,[318 515 427 588  79],716,5,8196,4.42548596112311,40.0,0.0
11852,1,1852,[318 515 427 588  79],18,5,8201,4.425796006475985,40.0,0.0
11853,1,1853,[318 515 427 588  79],807,5,8206,4.426105717367853,40.0,0.0
11854,1,1854,[318 515 427 588  79],716,5,8211,4.426415094339623,40.0,0.0
11855,1,1855,[318 515 427 588  79],716,5,8216,4.426724137931035,40.0,0.0
11856,1,1856,[197  70  11 194 357],450,5,8221,4.427032848680668,0.0,0.0
11857,1,1857,[132  28  69 597 191],796,4,8225,4.426803013993541,0.0,0.0
11858,1,1858,[318 515 427 588  79],807,5,8230,4.427111350188273,40.0,0.0
11859,1,1859,[318 515 427 588  79],807,5,8235,4.42741935483871,40.0,0.0
11860,1,1860,[318 515 427 588  79],18,5,8240,4.427727028479312,40.0,0.0
11861,1,1861,[318 515 427 588  79],807,5,8245,4.4280343716433945,40.0,0.0
11862,1,1862,[318 515 427 588  79],18,5,8250,4.428341384863124,40.0,0.0
11863,1,1863,[318 515 427 588  79],18,5,8255,4.428648068669528,40.0,0.0
11864,1,1864,[318 515 427 588  79],716,5,8260,4.428954423592494,40.0,0.0
11865,1,1865,[318 515 427 588  79],807,5,8265,4.429260450160772,40.0,0.0
11866,1,1866,[318 515 427 588  79],18,5,8270,4.429566148901982,40.0,0.0
11867,1,1867,[318 515 427 588  79],18,5,8275,4.429871520342612,40.0,0.0
11868,1,1868,[318 515 427 588  79],18,5,8280,4.430176565008026,40.0,0.0
11869,1,1869,[ 79 182 742 603 161],655,3,8283,4.429411764705883,20.0,0.0
11870,1,1870,[318 515 427 588  79],716,5,8288,4.429716729021913,40.0,0.0
11871,1,1871,[318 515 427 588  79],716,5,8293,4.430021367521367,40.0,0.0
11872,1,1872,[508 211 174 275  71],401,3,8296,4.429257875066738,0.0,20.0
11873,1,1873,[125 275 318 357 257],457,4,8300,4.429028815368197,20.0,20.0
11874,1,1874,[318 515 427 588  79],716,5,8305,4.429333333333333,40.0,0.0
11875,1,1875,[175  70 471  88 182],655,1,8306,4.427505330490405,0.0,0.0
11876,1,1876,[318 515 427 588  79],18,5,8311,4.427810335641982,40.0,0.0
11877,1,1877,[318 515 427 588  79],18,5,8316,4.4281150159744405,40.0,0.0
11878,1,1878,[742 228  50 204 196],577,4,8320,4.427887174028739,0.0,20.0
11879,1,1879,[318 515 427 588  79],716,5,8325,4.428191489361702,40.0,0.0
11880,1,1880,[318 515 427 588  79],716,5,8330,4.42849548112706,40.0,0.0
11881,1,1881,[318 515 427 588  79],807,5,8335,4.428799149840595,40.0,0.0
11882,1,1882,[318 515 427 588  79],807,5,8340,4.429102496016994,40.0,0.0
11883,1,1883,[318 515 427 588  79],807,5,8345,4.429405520169851,40.0,0.0
11884,1,1884,[318 515 427 588  79],716,5,8350,4.429708222811671,40.0,0.0
11885,1,1885,[318 515 427 588  79],716,5,8355,4.43001060445387,40.0,0.0
11886,1,1886,[318 515 427 588  79],716,5,8360,4.430312665606783,40.0,0.0
11887,1,1887,[318 515 427 588  79],807,5,8365,4.430614406779661,40.0,0.0
11888,1,1888,[318 515 427 588  79],716,5,8370,4.4309158284806776,40.0,0.0
11889,1,1889,[318 515 427 588  79],807,5,8375,4.431216931216931,40.0,0.0
11890,1,1890,[318 515 427 588  79],18,5,8380,4.431517715494447,40.0,0.0
11891,1,1891,[210 568 186 182 405],457,5,8385,4.431818181818182,0.0,0.0
11892,1,1892,[318 515 427 588  79],807,5,8390,4.432118330692023,40.0,0.0
11893,1,1893,[318 515 427 588  79],807,5,8395,4.432418162618796,40.0,0.0
11894,1,1894,[318 515 427 588  79],807,5,8400,4.432717678100264,40.0,0.0
11895,1,1895,[318 515 427 588  79],18,5,8405,4.43301687763713,40.0,0.0
11896,1,1896,[318 515 427 588  79],18,5,8410,4.4333157617290455,40.0,0.0
11897,1,1897,[318 515 427 588  79],716,5,8415,4.4336143308746045,40.0,0.0
11898,1,1898,[318 515 427 588  79],807,5,8420,4.4339125855713535,40.0,0.0
11899,1,1899,[318 515 427 588  79],18,5,8425,4.434210526315789,40.0,0.0
11900,1,1900,[318 515 427 588  79],807,5,8430,4.434508153603367,40.0,0.0
11901,1,1901,[318 515 427 588  79],807,5,8435,4.434805467928497,40.0,0.0
11902,1,1902,[318 515 427 588  79],716,5,8440,4.4351024697845505,40.0,0.0
11903,1,1903,[318 515 427 588  79],716,5,8445,4.4353991596638656,40.0,0.0
11904,1,1904,[318 515 427 588  79],18,5,8450,4.435695538057743,40.0,0.0
11905,1,1905,[318 515 427 588  79],807,5,8455,4.435991605456453,40.0,0.0
11906,1,1906,[588 127 271 185  97],796,4,8459,4.435762978500263,0.0,20.0
11907,1,1907,[318 515 427 588  79],716,5,8464,4.436058700209643,40.0,0.0
11908,1,1908,[265 132 215 271 211],655,0,8464,4.433734939759036,0.0,0.0
11909,1,1909,[318 515 427 588  79],18,5,8469,4.434031413612566,40.0,0.0
11910,1,1910,[318 515 427 588  79],807,5,8474,4.43432757718472,40.0,0.0
11911,1,1911,[300 117  15  96  64],655,1,8475,4.432531380753138,20.0,0.0
11912,1,1912,[318 515 427 588  79],716,5,8480,4.4328280188186096,40.0,0.0
11913,1,1913,[318 515 427 588  79],18,5,8485,4.433124346917451,40.0,0.0
11914,1,1914,[215 176 357  25 216],450,4,8489,4.4328981723237595,0.0,0.0
11915,1,1915,[318 515 427 588  79],18,5,8494,4.433194154488517,40.0,0.0
11916,1,1916,[273   4 471 127 268],655,2,8496,4.431924882629108,0.0,20.0
11917,1,1917,[318 515 427 588  79],18,5,8501,4.432221063607925,40.0,0.0
11918,1,1918,[318 515 427 588  79],807,5,8506,4.4325169359041166,40.0,0.0
11919,1,1919,[318 515 427 588  79],716,5,8511,4.4328125,40.0,0.0
11920,1,1920,[318 515 427 588  79],18,5,8516,4.433107756376887,40.0,0.0
11921,1,1921,[318 515 427 588  79],18,5,8521,4.433402705515088,40.0,0.0
11922,1,1922,[318 515 427 588  79],716,5,8526,4.433697347893916,40.0,0.0
11923,1,1923,[318 515 427 588  79],18,5,8531,4.433991683991684,40.0,0.0
11924,1,1924,[318 515 427 588  79],716,5,8536,4.434285714285714,40.0,0.0
11925,1,1925,[318 515 427 588  79],716,5,8541,4.434579439252336,40.0,0.0
11926,1,1926,[  8 151 117 322 288],344,3,8544,4.433834976647639,0.0,0.0
11927,1,1927,[318 515 427 588  79],716,5,8549,4.434128630705394,40.0,0.0
11928,1,1928,[318 515 427 588  79],18,5,8554,4.434421980300674,40.0,0.0
11929,1,1929,[318 515 427 588  79],18,5,8559,4.434715025906736,40.0,0.0
11930,1,1930,[318 515 427 588  79],807,5,8564,4.435007767995857,40.0,0.0
11931,1,1931,[318 515 427 588  79],807,5,8569,4.4353002070393375,40.0,0.0
11932,1,1932,[318 515 427 588  79],18,5,8574,4.435592343507501,40.0,0.0
11933,1,1933,[ 25   1 302 173  79],535,2,8576,4.434332988624612,0.0,0.0
11934,1,1934,[ 95  71 234 194 276],18,3,8579,4.43359173126615,0.0,0.0
11935,1,1935,[318 515 427 588  79],716,5,8584,4.433884297520661,40.0,0.0
11936,1,1936,[748 100  25 121 678],256,5,8589,4.434176561693341,0.0,20.0
11937,1,1937,[318 515 427 588  79],18,5,8594,4.434468524251806,40.0,0.0
11938,1,1938,[191 423  70 182 118],457,5,8599,4.434760185662713,0.0,0.0
11939,1,1939,[318 515 427 588  79],716,5,8604,4.435051546391753,40.0,0.0
11940,1,1940,[301 300 546 423 275],450,5,8609,4.435342606903658,0.0,20.0
11941,1,1941,[176 234 195 238 187],716,2,8611,4.4340885684860964,0.0,0.0
11942,1,1942,[318 515 427 588  79],18,5,8616,4.434379825012867,40.0,0.0
11943,1,1943,[318 515 427 588  79],18,5,8621,4.434670781893004,40.0,0.0
11944,1,1944,[318 515 427 588  79],807,5,8626,4.434961439588689,40.0,0.0
11945,1,1945,[318 515 427 588  79],716,5,8631,4.4352517985611515,40.0,0.0
11946,1,1946,[318 515 427 588  79],807,5,8636,4.435541859270673,40.0,0.0
11947,1,1947,[318 515 427 588  79],807,5,8641,4.435831622176591,40.0,0.0
11948,1,1948,[318 515 427 588  79],18,5,8646,4.436121087737301,40.0,0.0
11949,1,1949,[655 161 181 234 483],280,2,8648,4.434871794871795,0.0,0.0
11950,1,1950,[ 71 151 403   8 742],756,2,8650,4.433623782675551,0.0,0.0
11951,1,1951,[318 515 427 588  79],807,5,8655,4.433913934426229,40.0,0.0
11952,1,1952,[204 121 496 200 215],716,5,8660,4.434203789042499,20.0,0.0
11953,1,1953,[174 211 168  96 180],269,2,8662,4.43295803480041,0.0,0.0
11954,1,1954,[195 357 191 269   8],18,4,8666,4.432736572890025,0.0,0.0
11955,1,1955,[318 515 427 588  79],807,5,8671,4.433026584867076,40.0,0.0
11956,1,1956,[318 515 427 588  79],716,5,8676,4.433316300459888,40.0,0.0
11957,1,1957,[427 135 237 405 288],835,3,8679,4.432584269662922,20.0,0.0
11958,1,1958,[318 515 427 588  79],716,5,8684,4.432873915262889,40.0,0.0
11959,1,1959,[187 328  11 294 210],450,4,8688,4.43265306122449,0.0,0.0
11960,1,1960,[318 515 427 588  79],807,5,8693,4.432942376338603,40.0,0.0
11961,1,1961,[318 515 427 588  79],807,5,8698,4.433231396534149,40.0,0.0
11962,1,1962,[318 515 427 588  79],18,5,8703,4.433520122261844,40.0,0.0
11963,1,1963,[318 515 427 588  79],18,5,8708,4.433808553971486,40.0,0.0
11964,1,1964,[318 515 427 588  79],716,5,8713,4.434096692111959,40.0,0.0
11965,1,1965,[ 12 111  70  64 301],344,4,8717,4.433875890132248,20.0,0.0
11966,1,1966,[318 515 427 588  79],716,5,8722,4.434163701067615,40.0,0.0
11967,1,1967,[318 515 427 588  79],716,5,8727,4.434451219512195,40.0,0.0
11968,1,1968,[496 161 423 286 111],796,4,8731,4.434230573895379,20.0,20.0
11969,1,1969,[180  25 282 183  22],457,5,8736,4.4345177664974615,0.0,0.0
11970,1,1970,[568 546 168 172  69],450,5,8741,4.43480466768138,0.0,0.0
11971,1,1971,[ 71 275 168 135 597],450,3,8744,4.434077079107505,0.0,20.0
11972,1,1972,[483 357 546 405  25],450,3,8747,4.4333502280790675,0.0,0.0
11973,1,1973,[276 121 275 127 405],655,3,8750,4.432624113475177,0.0,40.0
11974,1,1974,[318 515 427 588  79],807,5,8755,4.432911392405063,40.0,0.0
11975,1,1975,[318 515 427 588  79],716,5,8760,4.433198380566802,40.0,0.0
11976,1,1976,[168 471 175  97   8],457,5,8765,4.433485078401619,0.0,0.0
11977,1,1977,[234 153 748 118 237],450,3,8768,4.432760364004045,0.0,0.0
11978,1,1978,[515 318 427 588  79],18,5,8773,4.4330469934310255,40.0,0.0
11979,1,1979,[ 71 111  12 117 258],450,4,8777,4.432828282828283,0.0,0.0
11980,1,1980,[515 318 427 588  79],807,5,8782,4.4331145885916206,40.0,0.0
11981,1,1981,[423 153  69 196 288],655,0,8782,4.43087790110999,0.0,0.0
11982,1,1982,[515 318 427 588  79],807,5,8787,4.431164901664145,40.0,0.0
11983,1,1983,[515 318 427 588  79],18,5,8792,4.431451612903226,40.0,0.0
11984,1,1984,[655  97  70 228 187],450,5,8797,4.431738035264484,0.0,0.0
11985,1,1985,[234 289 191  82 202],786,4,8801,4.431520644511581,0.0,0.0
11986,1,1986,[ 71 273 195 603 228],450,3,8804,4.4308002013085055,20.0,0.0
11987,1,1987,[515 318 427 588  79],18,5,8809,4.431086519114688,40.0,0.0
11988,1,1988,[515 318 427 588  79],807,5,8814,4.431372549019608,40.0,0.0
11989,1,1989,[515 318 427 588  79],18,5,8819,4.431658291457286,40.0,0.0
11990,1,1990,[228   9 161 186 185],457,5,8824,4.431943746860874,0.0,0.0
11991,1,1991,[515 318 427 588  79],18,5,8829,4.432228915662651,40.0,0.0
11992,1,1992,[515 318 427 588  79],807,5,8834,4.432513798294029,40.0,0.0
11993,1,1993,[515 318 427 588  79],716,5,8839,4.432798395185556,40.0,0.0
11994,1,1994,[515 318 427 588  79],807,5,8844,4.433082706766918,40.0,0.0
11995,1,1995,[ 28 121 302 268 179],655,2,8846,4.4318637274549095,0.0,0.0
11996,1,1996,[318 200 125 483 195],18,2,8848,4.4306459689534305,20.0,0.0
11997,1,1997,[515 318 427 588  79],716,5,8853,4.430930930930931,40.0,0.0
11998,1,1998,[515 318 427 588  79],807,5,8858,4.431215607803902,40.0,0.0
11999,1,1999,[515 318 427 588  79],18,5,8863,4.4315,40.0,0.0
12000,1,2000,[515 318 427 588  79],716,5,8868,4.431784107946027,40.0,0.0
12001,1,2001,[183 427 187 125 258],655,3,8871,4.431068931068931,20.0,0.0
12002,1,2002,[515 318 427 588  79],807,5,8876,4.431352970544184,40.0,0.0
12003,1,2003,[515 318 427 588  79],716,5,8881,4.431636726546906,40.0,0.0
12004,1,2004,[176  28  11 483 211],716,4,8885,4.43142144638404,0.0,0.0
12005,1,2005,[423 195 678 234 289],807,2,8887,4.430209371884347,0.0,0.0
12006,1,2006,[ 11 427 238 265 125],450,5,8892,4.430493273542601,20.0,0.0
12007,1,2007,[153 216 423 357  11],450,5,8897,4.430776892430279,0.0,0.0
12008,1,2008,[ 98 655  56  28 175],716,4,8901,4.430562468889995,0.0,0.0
12009,1,2009,[515 318 427 588  79],18,5,8906,4.430845771144279,40.0,0.0
12010,1,2010,[515 318 427 588  79],807,5,8911,4.431128791645947,40.0,0.0
12011,1,2011,[515 318 427 588  79],807,5,8916,4.431411530815109,40.0,0.0
12012,1,2012,[515 318 427 588  79],716,5,8921,4.4316939890710385,40.0,0.0
12013,1,2013,[153 655 183 222 322],450,4,8925,4.431479642502483,0.0,0.0
12014,1,2014,[200 195 185 322 174],504,5,8930,4.431761786600497,0.0,0.0
12015,1,2015,[515 318 427 588  79],807,5,8935,4.432043650793651,40.0,0.0
12016,1,2016,[515 318 427 588  79],807,5,8940,4.432325235498265,40.0,0.0
12017,1,2017,[  7 144  50  82 196],23,2,8942,4.431119920713578,0.0,20.0
12018,1,2018,[515 318 427 588  79],807,5,8947,4.431401684001981,40.0,0.0
12019,1,2019,[515 318 427 588  79],716,5,8952,4.431683168316832,40.0,0.0
12020,1,2020,[515 318 427 588  79],807,5,8957,4.431964374072241,40.0,0.0
12021,1,2021,[515 318 427 588  79],716,5,8962,4.432245301681504,40.0,0.0
12022,1,2022,[ 98 483  64 435 405],269,3,8965,4.431537320810677,20.0,0.0
12023,1,2023,[515 318 427 588  79],716,5,8970,4.431818181818182,40.0,0.0
12024,1,2024,[515 318 427 588  79],18,5,8975,4.432098765432099,40.0,0.0
12025,1,2025,[515 318 427 588  79],807,5,8980,4.432379072063179,40.0,0.0
12026,1,2026,[515 318 427 588  79],716,5,8985,4.432659102121361,40.0,0.0
12027,1,2027,[  1 216 245  79 151],885,3,8988,4.431952662721893,0.0,0.0
12028,1,2028,[546 180  95  25 265],450,3,8991,4.43124691966486,0.0,0.0
12029,1,2029,[515 318 427 588  79],807,5,8996,4.431527093596059,40.0,0.0
12030,1,2030,[515 318 427 588  79],716,5,9001,4.431806991629739,40.0,0.0
12031,1,2031,[515 318 427 588  79],807,5,9006,4.432086614173229,40.0,0.0
12032,1,2032,[515 318 427 588  79],716,5,9011,4.432365961633055,40.0,0.0
12033,1,2033,[515 318 427 588  79],716,5,9016,4.4326450344149455,40.0,0.0
12034,1,2034,[515 318 427 588  79],18,5,9021,4.432923832923833,40.0,0.0
12035,1,2035,[515 318 427 588  79],18,5,9026,4.433202357563851,40.0,0.0
12036,1,2036,[515 318 427 588  79],807,5,9031,4.433480608738341,40.0,0.0
12037,1,2037,[515 318 427 588  79],716,5,9036,4.433758586849852,40.0,0.0
12038,1,2038,[ 64  97 423 194 238],796,3,9039,4.433055419323198,20.0,0.0
12039,1,2039,[515 318 427 588  79],807,5,9044,4.433333333333334,40.0,0.0
12040,1,2040,[515 318 427 588  79],18,5,9049,4.4336109750122485,40.0,0.0
12041,1,2041,[515 318 427 588  79],18,5,9054,4.433888344760039,40.0,0.0
12042,1,2042,[515 318 427 588  79],18,5,9059,4.434165442976016,40.0,0.0
12043,1,2043,[515 318 427 588  79],716,5,9064,4.4344422700587085,40.0,0.0
12044,1,2044,[515 318 427 588  79],18,5,9069,4.434718826405868,40.0,0.0
12045,1,2045,[301 546  22 173 237],796,4,9073,4.434506353861193,0.0,0.0
12046,1,2046,[318 515 427 588  79],18,5,9078,4.434782608695652,40.0,0.0
12047,1,2047,[318 515 427 588  79],716,5,9083,4.43505859375,40.0,0.0
12048,1,2048,[187 172 328 183  82],796,4,9087,4.43484626647145,0.0,0.0
12049,1,2049,[318 515 427 588  79],18,5,9092,4.435121951219513,40.0,0.0
12050,1,2050,[318 515 427 588  79],18,5,9097,4.435397367137981,40.0,0.0
12051,1,2051,[318 515 427 588  79],18,5,9102,4.435672514619883,40.0,0.0
12052,1,2052,[318 515 427 588  79],18,5,9107,4.435947394057477,40.0,0.0
12053,1,2053,[318 515 427 588  79],716,5,9112,4.436222005842259,40.0,0.0
12054,1,2054,[186 181 211 168 258],450,4,9116,4.436009732360097,0.0,0.0
12055,1,2055,[318 515 427 588  79],716,5,9121,4.436284046692607,40.0,0.0
12056,1,2056,[318 515 427 588  79],716,5,9126,4.436558094312105,40.0,0.0
12057,1,2057,[143 471  89 588 100],457,5,9131,4.4368318756073855,0.0,20.0
12058,1,2058,[318 515 427 588  79],18,5,9136,4.437105390966488,40.0,0.0
12059,1,2059,[318 515 427 588  79],18,5,9141,4.437378640776699,40.0,0.0
12060,1,2060,[ 56 151 117 194 174],504,3,9144,4.436681222707423,0.0,0.0
12061,1,2061,[515 318 427 588  79],716,5,9149,4.436954413191077,40.0,0.0
12062,1,2062,[515 318 427 588  79],18,5,9154,4.437227338826951,40.0,0.0
12063,1,2063,[294 182  56 322 153],450,5,9159,4.4375,0.0,0.0
12064,1,2064,[ 82 153 496 200 423],716,5,9164,4.437772397094431,20.0,0.0
12065,1,2065,[318 515 427 588  79],18,5,9169,4.438044530493707,40.0,0.0
12066,1,2066,[318 515 427 588  79],716,5,9174,4.438316400580551,40.0,0.0
12067,1,2067,[318 515 427 588  79],18,5,9179,4.438588007736944,40.0,0.0
12068,1,2068,[318 515 427 588  79],807,5,9184,4.438859352344128,40.0,0.0
12069,1,2069,[597 568 175 143 655],269,2,9186,4.43768115942029,0.0,0.0
12070,1,2070,[257 515 228 179  79],655,3,9189,4.436986962819894,0.0,0.0
12071,1,2071,[318 515 427 588  79],18,5,9194,4.437258687258687,40.0,0.0
12072,1,2072,[322   1 111 471 196],786,4,9198,4.437047756874096,0.0,0.0
12073,1,2073,[182 405  88  12 286],280,2,9200,4.435872709739634,0.0,20.0
12074,1,2074,[597 385 195 234 294],23,2,9202,4.434698795180723,0.0,0.0
12075,1,2075,[508 313 403 186 195],655,1,9203,4.4330443159922925,0.0,0.0
12076,1,2076,[515 318 427 588  79],716,5,9208,4.433317284545017,40.0,0.0
12077,1,2077,[515 318 427 588  79],18,5,9213,4.433589990375361,40.0,0.0
12078,1,2078,[  7 357 546 132 222],693,3,9216,4.432900432900433,0.0,0.0
12079,1,2079,[515 318 427 588  79],18,5,9221,4.433173076923077,40.0,0.0
12080,1,2080,[ 22 483   9   1 234],457,5,9226,4.433445458913984,0.0,0.0
12081,1,2081,[515 318 427 588  79],807,5,9231,4.433717579250721,40.0,0.0
12082,1,2082,[515 318 427 588  79],807,5,9236,4.43398943831013,40.0,0.0
12083,1,2083,[515 318 427 588  79],807,5,9241,4.43426103646833,40.0,0.0
12084,1,2084,[515 318 427 588  79],807,5,9246,4.434532374100719,40.0,0.0
12085,1,2085,[515 318 427 588  79],807,5,9251,4.434803451581975,40.0,0.0
12086,1,2086,[515 318 427 588  79],18,5,9256,4.435074269286057,40.0,0.0
12087,1,2087,[515 318 427 588  79],716,5,9261,4.435344827586207,40.0,0.0
12088,1,2088,[515 318 427 588  79],18,5,9266,4.435615126854954,40.0,0.0
12089,1,2089,[427 265 135 211 132],716,4,9270,4.435406698564593,20.0,0.0
12090,1,2090,[515 318 427 588  79],18,5,9275,4.435676709708273,40.0,0.0
12091,1,2091,[515 318 427 588  79],716,5,9280,4.435946462715105,40.0,0.0
12092,1,2092,[515 318 427 588  79],807,5,9285,4.436215957955088,40.0,0.0
12093,1,2093,[515 318 427 588  79],716,5,9290,4.436485195797517,40.0,0.0
12094,1,2094,[515 318 427 588  79],716,5,9295,4.436754176610979,40.0,0.0
12095,1,2095,[515 318 427 588  79],807,5,9300,4.437022900763359,40.0,0.0
12096,1,2096,[276 215 286 191 265],655,2,9302,4.43586075345732,0.0,20.0
12097,1,2097,[ 11 322 276  95 181],344,2,9304,4.434699714013346,0.0,0.0
12098,1,2098,[211 100  70 202 357],655,1,9305,4.433063363506432,0.0,20.0
12099,1,2099,[515 318 427 588  79],807,5,9310,4.433333333333334,40.0,0.0
12100,1,2100,[515 318 427 588  79],716,5,9315,4.433603046168491,40.0,0.0
12101,1,2101,[515 318 427 588  79],716,5,9320,4.433872502378687,40.0,0.0
12102,1,2102,[515 318 427 588  79],18,5,9325,4.434141702330005,40.0,0.0
12103,1,2103,[515 318 427 588  79],716,5,9330,4.434410646387833,40.0,0.0
12104,1,2104,[515 318 427 588  79],716,5,9335,4.434679334916865,40.0,0.0
12105,1,2105,[515 318 427 588  79],18,5,9340,4.434947768281102,40.0,0.0
12106,1,2106,[515 318 427 588  79],716,5,9345,4.4352159468438535,40.0,0.0
12107,1,2107,[515 318 427 588  79],18,5,9350,4.435483870967742,40.0,0.0
12108,1,2108,[515 318 427 588  79],807,5,9355,4.435751541014699,40.0,0.0
12109,1,2109,[515 318 427 588  79],807,5,9360,4.436018957345971,40.0,0.0
12110,1,2110,[515 318 427 588  79],716,5,9365,4.436286120322122,40.0,0.0
12111,1,2111,[515 318 427 588  79],807,5,9370,4.43655303030303,40.0,0.0
12112,1,2112,[515 318 427 588  79],18,5,9375,4.436819687647894,40.0,0.0
12113,1,2113,[515 318 427 588  79],716,5,9380,4.437086092715232,40.0,0.0
12114,1,2114,[515 318 427 588  79],807,5,9385,4.4373522458628845,40.0,0.0
12115,1,2115,[515 318 427 588  79],18,5,9390,4.437618147448015,40.0,0.0
12116,1,2116,[515 318 427 588  79],807,5,9395,4.437883797827114,40.0,0.0
12117,1,2117,[515 318 427 588  79],716,5,9400,4.4381491973559966,40.0,0.0
12118,1,2118,[515 318 427 588  79],807,5,9405,4.4384143463898065,40.0,0.0
12119,1,2119,[135 144  98 186 294],655,2,9407,4.437264150943396,0.0,0.0
12120,1,2120,[286  50  79   1  56],389,4,9411,4.437057991513437,0.0,40.0
12121,1,2121,[216 257  12 175 568],457,4,9415,4.436852026390198,0.0,0.0
12122,1,2122,[515 318 427 588  79],807,5,9420,4.43711728685822,40.0,0.0
12123,1,2123,[515 318 427 588  79],18,5,9425,4.437382297551789,40.0,0.0
12124,1,2124,[515 318 427 588  79],18,5,9430,4.437647058823529,40.0,0.0
12125,1,2125,[515 318 427 588  79],716,5,9435,4.4379115710254,40.0,0.0
12126,1,2126,[515 318 427 588  79],716,5,9440,4.438175834508698,40.0,0.0
12127,1,2127,[515 318 427 588  79],807,5,9445,4.43843984962406,40.0,0.0
12128,1,2128,[515 318 427 588  79],716,5,9450,4.438703616721465,40.0,0.0
12129,1,2129,[197 125 245  56 323],504,4,9454,4.43849765258216,0.0,0.0
12130,1,2130,[318 515 427 588  79],807,5,9459,4.4387611450023465,40.0,0.0
12131,1,2131,[318 515 427 588  79],716,5,9464,4.439024390243903,40.0,0.0
12132,1,2132,[318 515 427 588  79],807,5,9469,4.439287388654478,40.0,0.0
12133,1,2133,[211 161  64   9  89],796,3,9472,4.438612933458295,20.0,0.0
12134,1,2134,[318 515 427 588  79],18,5,9477,4.4388758782201405,40.0,0.0
12135,1,2135,[318 515 427 588  79],807,5,9482,4.439138576779026,40.0,0.0
12136,1,2136,[318 515 427 588  79],716,5,9487,4.43940102948058,40.0,0.0
12137,1,2137,[496  64  15  71 200],330,5,9492,4.439663236669785,40.0,0.0
12138,1,2138,[318 515 427 588  79],807,5,9497,4.439925198690977,40.0,0.0
12139,1,2139,[318 228 328  25  79],655,2,9499,4.438785046728972,20.0,0.0
12140,1,2140,[318 515 427 588  79],716,5,9504,4.439047174217655,40.0,0.0
12141,1,2141,[318 515 427 588  79],716,5,9509,4.439309056956116,40.0,0.0
12142,1,2142,[318 515 427 588  79],716,5,9514,4.439570695286981,40.0,0.0
12143,1,2143,[322 125 181 238 168],151,4,9518,4.439365671641791,0.0,0.0
12144,1,2144,[318 515 427 588  79],18,5,9523,4.439627039627039,40.0,0.0
12145,1,2145,[318 515 427 588  79],18,5,9528,4.439888164026095,40.0,0.0
12146,1,2146,[265 245 100  11 403],256,5,9533,4.44014904517932,0.0,20.0
12147,1,2147,[318 515 427 588  79],716,5,9538,4.440409683426443,40.0,0.0
12148,1,2148,[318 515 427 588  79],716,5,9543,4.440670079106561,40.0,0.0
12149,1,2149,[318 515 427 588  79],716,5,9548,4.44093023255814,40.0,0.0
12150,1,2150,[318 515 427 588  79],716,5,9553,4.441190144119014,40.0,0.0
12151,1,2151,[318 515 427 588  79],18,5,9558,4.441449814126394,40.0,0.0
12152,1,2152,[318 515 427 588  79],807,5,9563,4.44170924291686,40.0,0.0
12153,1,2153,[318 515 427 588  79],18,5,9568,4.441968430826369,40.0,0.0
12154,1,2154,[323 588 405 194  69],796,4,9572,4.441763341067285,0.0,0.0
12155,1,2155,[318 515 427 588  79],716,5,9577,4.442022263450835,40.0,0.0
12156,1,2156,[318 515 427 588  79],807,5,9582,4.4422809457579975,40.0,0.0
12157,1,2157,[318 515 427 588  79],716,5,9587,4.442539388322521,40.0,0.0
12158,1,2158,[318 515 427 588  79],716,5,9592,4.442797591477536,40.0,0.0
12159,1,2159,[318 515 427 588  79],18,5,9597,4.4430555555555555,40.0,0.0
12160,1,2160,[318 515 427 588  79],807,5,9602,4.443313280888478,40.0,0.0
12161,1,2161,[ 25  15 508   1 282],15,1,9603,4.441720629047179,0.0,0.0
12162,1,2162,[318 515 427 588  79],18,5,9608,4.44197873324087,40.0,0.0
12163,1,2163,[ 56 195 185 302  69],151,3,9611,4.441312384473198,0.0,0.0
12164,1,2164,[127 282 200 228 186],655,2,9613,4.440184757505774,0.0,20.0
12165,1,2165,[  8   1 216  71 322],280,5,9618,4.4404432132963985,0.0,0.0
12166,1,2166,[144 132 300 435   7],535,3,9621,4.439778495616059,0.0,0.0
12167,1,2167,[515 318 427 588  79],18,5,9626,4.4400369003690034,40.0,0.0
12168,1,2168,[515 318 427 588  79],716,5,9631,4.440295066851084,40.0,0.0
12169,1,2169,[515 318 427 588  79],716,5,9636,4.440552995391705,40.0,0.0
12170,1,2170,[302 180 265 185 172],535,2,9638,4.439428834638416,0.0,0.0
12171,1,2171,[588 135 235 151 161],716,2,9640,4.4383057090239415,0.0,0.0
12172,1,2172,[515 318 427 588  79],18,5,9645,4.438564196962725,40.0,0.0
12173,1,2173,[515 318 427 588  79],716,5,9650,4.438822447102116,40.0,0.0
12174,1,2174,[515 318 427 588  79],807,5,9655,4.439080459770115,40.0,0.0
12175,1,2175,[515 318 427 588  79],807,5,9660,4.439338235294118,40.0,0.0
12176,1,2176,[515 318 427 588  79],18,5,9665,4.439595774000919,40.0,0.0
12177,1,2177,[176 234 211 385 186],5,3,9668,4.438934802571167,0.0,0.0
12178,1,2178,[276 135 405  79  28],655,3,9671,4.438274437815512,0.0,0.0
12179,1,2179,[181 210 286 173 385],280,2,9673,4.437155963302752,0.0,20.0
12180,1,2180,[210 237  82 288 385],457,5,9678,4.437414030261348,0.0,0.0
12181,1,2181,[318 515 427 588  79],807,5,9683,4.437671860678277,40.0,0.0
12182,1,2182,[  4 125  69 200  50],280,2,9685,4.4365551992670635,0.0,20.0
12183,1,2183,[318 515 427 588  79],807,5,9690,4.436813186813187,40.0,0.0
12184,1,2184,[318 515 427 588  79],18,5,9695,4.437070938215103,40.0,0.0
12185,1,2185,[318 515 427 588  79],807,5,9700,4.437328453796889,40.0,0.0
12186,1,2186,[161 322 121 197  88],796,3,9703,4.436671239140375,0.0,0.0
12187,1,2187,[318 515 427 588  79],807,5,9708,4.436928702010969,40.0,0.0
12188,1,2188,[318 515 427 588  79],716,5,9713,4.437185929648241,40.0,0.0
12189,1,2189,[318 515 427 588  79],18,5,9718,4.437442922374429,40.0,0.0
12190,1,2190,[318 515 427 588  79],807,5,9723,4.437699680511182,40.0,0.0
12191,1,2191,[318 515 427 588  79],716,5,9728,4.437956204379562,40.0,0.0
12192,1,2192,[318 515 427 588  79],716,5,9733,4.438212494300045,40.0,0.0
12193,1,2193,[174 238 286  98 228],655,1,9734,4.436645396536007,0.0,20.0
12194,1,2194,[385 151 210 118  69],716,3,9737,4.435990888382688,0.0,0.0
12195,1,2195,[515 318 427 588  79],18,5,9742,4.436247723132969,40.0,0.0
12196,1,2196,[427 655  25 423 161],577,5,9747,4.436504324078289,20.0,0.0
12197,1,2197,[515 318 427 588  79],18,5,9752,4.436760691537762,40.0,0.0
12198,1,2198,[515 318 427 588  79],716,5,9757,4.4370168258299225,40.0,0.0
12199,1,2199,[515 318 427 588  79],807,5,9762,4.4372727272727275,40.0,0.0
12200,1,2200,[215 121 258 568 302],450,4,9766,4.437074057246706,0.0,0.0
12201,1,2201,[318 515 427 588  79],18,5,9771,4.437329700272479,40.0,0.0
12202,1,2202,[318 515 427 588  79],716,5,9776,4.437585111211984,40.0,0.0
12203,1,2203,[318 515 427 588  79],18,5,9781,4.437840290381125,40.0,0.0
12204,1,2204,[318 515 427 588  79],18,5,9786,4.438095238095238,40.0,0.0
12205,1,2205,[318 515 427 588  79],807,5,9791,4.438349954669084,40.0,0.0
12206,1,2206,[179 132 195 234 183],786,4,9795,4.4381513366560945,0.0,0.0
12207,1,2207,[318 515 427 588  79],716,5,9800,4.438405797101449,40.0,0.0
12208,1,2208,[318 515 427 588  79],716,5,9805,4.438660027161611,40.0,0.0
12209,1,2209,[385  70 237   4  89],457,5,9810,4.4389140271493215,0.0,0.0
12210,1,2210,[318 515 427 588  79],807,5,9815,4.4391677973767525,40.0,0.0
12211,1,2211,[318 515 427 588  79],18,5,9820,4.439421338155515,40.0,0.0
12212,1,2212,[222 191  82 174 294],655,1,9821,4.437867148666968,0.0,0.0
12213,1,2213,[288 268  69 655 269],655,0,9821,4.435862691960253,0.0,0.0
12214,1,2214,[174 194 202  88  64],457,5,9826,4.436117381489842,20.0,0.0
12215,1,2215,[204 546 237 197 196],450,5,9831,4.436371841155235,0.0,0.0
12216,1,2216,[318 515 427 588  79],716,5,9836,4.4366260712674785,40.0,0.0
12217,1,2217,[318 515 427 588  79],716,5,9841,4.43688007213706,40.0,0.0
12218,1,2218,[603 269  82 385 175],655,1,9842,4.435331230283912,20.0,0.0
12219,1,2219,[318 515 427 588  79],716,5,9847,4.435585585585586,40.0,0.0
12220,1,2220,[173  15  97 181 210],577,3,9850,4.434939216569113,0.0,0.0
12221,1,2221,[318 515 427 588  79],807,5,9855,4.435193519351936,40.0,0.0
12222,1,2222,[318 515 427 588  79],716,5,9860,4.43544759334233,40.0,0.0
12223,1,2223,[ 15 216 197  97  22],457,5,9865,4.435701438848921,0.0,0.0
12224,1,2224,[318 515 427 588  79],716,5,9870,4.435955056179775,40.0,0.0
12225,1,2225,[234 179  12  22  97],577,3,9873,4.435309973045822,0.0,0.0
12226,1,2226,[318 515 427 588  79],716,5,9878,4.435563538392456,40.0,0.0
12227,1,2227,[318 515 427 588  79],716,5,9883,4.435816876122082,40.0,0.0
12228,1,2228,[275 153 186 475 269],264,5,9888,4.43606998654105,0.0,20.0
12229,1,2229,[143 301  95  56 222],450,3,9891,4.4354260089686095,0.0,0.0
12230,1,2230,[318 515 427 588  79],807,5,9896,4.435679067682654,40.0,0.0
12231,1,2231,[318 515 427 588  79],716,5,9901,4.435931899641577,40.0,0.0
12232,1,2232,[318 515 427 588  79],18,5,9906,4.436184505150022,40.0,0.0
12233,1,2233,[318 515 427 588  79],807,5,9911,4.436436884512086,40.0,0.0
12234,1,2234,[318 515 427 588  79],18,5,9916,4.43668903803132,40.0,0.0
12235,1,2235,[318 515 427 588  79],807,5,9921,4.4369409660107335,40.0,0.0
12236,1,2236,[318 515 427 588  79],807,5,9926,4.437192668752794,40.0,0.0
12237,1,2237,[135  56  12 286  95],450,3,9929,4.436550491510277,0.0,20.0
12238,1,2238,[318 515 427 588  79],18,5,9934,4.4368021438142025,40.0,0.0
12239,1,2239,[172 182  50  79  22],535,1,9935,4.435267857142857,0.0,20.0
12240,1,2240,[318 515 427 588  79],18,5,9940,4.435519857206605,40.0,0.0
12241,1,2241,[318 515 427 588  79],18,5,9945,4.435771632471008,40.0,0.0
12242,1,2242,[318 515 427 588  79],18,5,9950,4.4360231832367365,40.0,0.0
12243,1,2243,[318 515 427 588  79],18,5,9955,4.436274509803922,40.0,0.0
12244,1,2244,[318 515 427 588  79],807,5,9960,4.436525612472161,40.0,0.0
12245,1,2245,[318 515 427 588  79],716,5,9965,4.436776491540517,40.0,0.0
12246,1,2246,[238 748 174 405 197],450,5,9970,4.437027147307521,0.0,0.0
12247,1,2247,[318 515 427 588  79],716,5,9975,4.437277580071174,40.0,0.0
12248,1,2248,[318 515 427 588  79],18,5,9980,4.4375277901289465,40.0,0.0
12249,1,2249,[132 216  88  50   1],330,5,9985,4.437777777777778,0.0,20.0
12250,1,2250,[318 515 427 588  79],716,5,9990,4.438027543314083,40.0,0.0
12251,1,2251,[318 515 427 588  79],18,5,9995,4.438277087033748,40.0,0.0
12252,1,2252,[483 216 172 515  88],655,4,9999,4.438082556591212,0.0,0.0
12253,1,2253,[318 515 427 588  79],18,5,10004,4.438331854480923,40.0,0.0
12254,1,2254,[168 483 185 143 186],457,5,10009,4.438580931263858,0.0,0.0
12255,1,2255,[318 515 427 588  79],716,5,10014,4.4388297872340425,40.0,0.0
12256,1,2256,[318 515 427 588  79],807,5,10019,4.43907842268498,40.0,0.0
12257,1,2257,[318 515 427 588  79],18,5,10024,4.439326837909655,40.0,0.0
12258,1,2258,[318 515 427 588  79],807,5,10029,4.439575033200531,40.0,0.0
12259,1,2259,[318 515 427 588  79],807,5,10034,4.439823008849557,40.0,0.0
12260,1,2260,[174 144   4  11  50],450,4,10038,4.439628482972136,0.0,20.0
12261,1,2261,[  9 328  15 269 300],655,0,10038,4.437665782493369,0.0,0.0
12262,1,2262,[318 515 427 588  79],807,5,10043,4.43791427308882,40.0,0.0
12263,1,2263,[318 515 427 588  79],716,5,10048,4.438162544169611,40.0,0.0
12264,1,2264,[318 515 427 588  79],18,5,10053,4.43841059602649,40.0,0.0
12265,1,2265,[318 515 427 588  79],807,5,10058,4.438658428949691,40.0,0.0
12266,1,2266,[318 515 427 588  79],716,5,10063,4.438906043228937,40.0,0.0
12267,1,2267,[318 515 427 588  79],807,5,10068,4.439153439153439,40.0,0.0
12268,1,2268,[318 515 427 588  79],716,5,10073,4.439400617011899,40.0,0.0
12269,1,2269,[135 508 143 423 174],269,3,10076,4.438766519823789,0.0,0.0
12270,1,2270,[174 265 271   1 258],807,3,10079,4.43813298106561,0.0,0.0
12271,1,2271,[318 515 427 588  79],18,5,10084,4.438380281690141,40.0,0.0
12272,1,2272,[ 69  56  70 196  64],457,5,10089,4.438627364716234,20.0,0.0
12273,1,2273,[ 56 132 546 405 357],450,5,10094,4.438874230430959,0.0,0.0
12274,1,2274,[237 179   1   4 286],18,3,10097,4.438241758241758,0.0,20.0
12275,1,2275,[318 515 427 588  79],807,5,10102,4.438488576449912,40.0,0.0
12276,1,2276,[222 597  79 588 151],807,5,10107,4.438735177865612,0.0,0.0
12277,1,2277,[318 515 427 588  79],18,5,10112,4.438981562774363,40.0,0.0
12278,1,2278,[318 515 427 588  79],716,5,10117,4.439227731461167,40.0,0.0
12279,1,2279,[318 515 427 588  79],716,5,10122,4.439473684210526,40.0,0.0
12280,1,2280,[174 273 318 508 194],401,3,10125,4.438842612889084,20.0,0.0
12281,1,2281,[318 515 427 588  79],807,5,10130,4.43908851884312,40.0,0.0
12282,1,2282,[318 515 427 588  79],807,5,10135,4.439334209373631,40.0,0.0
12283,1,2283,[294 588 237 182 200],450,4,10139,4.439141856392294,0.0,0.0
12284,1,2284,[ 88 258 135 322 210],151,4,10143,4.438949671772429,0.0,0.0
12285,1,2285,[318 515 427 588  79],18,5,10148,4.439195100612423,40.0,0.0
12286,1,2286,[318 515 427 588  79],18,5,10153,4.439440314822912,40.0,0.0
12287,1,2287,[475 161 118   4 508],655,0,10153,4.4375,0.0,0.0
12288,1,2288,[318 515 427 588  79],807,5,10158,4.437745740498034,40.0,0.0
12289,1,2289,[ 28 132  56 405 121],577,3,10161,4.437117903930131,0.0,0.0
12290,1,2290,[318 515 427 588  79],716,5,10166,4.437363596682672,40.0,0.0
12291,1,2291,[ 11 508 200 235 173],269,2,10168,4.43630017452007,0.0,0.0
12292,1,2292,[318 515 427 588  79],716,5,10173,4.436546009594418,40.0,0.0
12293,1,2293,[318 515 427 588  79],807,5,10178,4.436791630340017,40.0,0.0
12294,1,2294,[ 50 322 328 258 748],15,1,10179,4.435294117647059,0.0,20.0
12295,1,2295,[515 318 427 588  79],807,5,10184,4.435540069686411,40.0,0.0
12296,1,2296,[515 318 427 588  79],807,5,10189,4.4357858075750976,40.0,0.0
12297,1,2297,[515 318 427 588  79],18,5,10194,4.436031331592689,40.0,0.0
12298,1,2298,[515 318 427 588  79],716,5,10199,4.436276642018269,40.0,0.0
12299,1,2299,[515 318 427 588  79],716,5,10204,4.436521739130435,40.0,0.0
12300,1,2300,[515 318 427 588  79],807,5,10209,4.436766623207301,40.0,0.0
12301,1,2301,[515 318 427 588  79],716,5,10214,4.437011294526498,40.0,0.0
12302,1,2302,[515 318 427 588  79],18,5,10219,4.437255753365176,40.0,0.0
12303,1,2303,[515 318 427 588  79],18,5,10224,4.4375,40.0,0.0
12304,1,2304,[515 318 427 588  79],716,5,10229,4.437744034707158,40.0,0.0
12305,1,2305,[515 318 427 588  79],18,5,10234,4.4379878577623595,40.0,0.0
12306,1,2306,[515 318 427 588  79],716,5,10239,4.438231469440832,40.0,0.0
12307,1,2307,[515 318 427 588  79],716,5,10244,4.438474870017331,40.0,0.0
12308,1,2308,[405  25 276  11 174],401,3,10247,4.437851883932439,0.0,0.0
12309,1,2309,[515 318 427 588  79],807,5,10252,4.438095238095238,40.0,0.0
12310,1,2310,[515 318 427 588  79],18,5,10257,4.438338381652964,40.0,0.0
12311,1,2311,[515 318 427 588  79],18,5,10262,4.438581314878893,40.0,0.0
12312,1,2312,[515 318 427 588  79],716,5,10267,4.438824038045828,40.0,0.0
12313,1,2313,[238 204 275  69 302],450,5,10272,4.439066551426102,0.0,20.0
12314,1,2314,[ 95 135 173 471 191],716,3,10275,4.438444924406047,0.0,0.0
12315,1,2315,[175  88 313 471 496],344,2,10277,4.437392055267703,20.0,0.0
12316,1,2316,[318 515 427 588  79],807,5,10282,4.4376348726801895,40.0,0.0
12317,1,2317,[318 515 427 588  79],18,5,10287,4.437877480586713,40.0,0.0
12318,1,2318,[318 515 427 588  79],807,5,10292,4.438119879258301,40.0,0.0
12319,1,2319,[174 385 172 121 269],503,3,10295,4.4375,0.0,0.0
12320,1,2320,[318 515 427 588  79],18,5,10300,4.437742352434295,40.0,0.0
12321,1,2321,[143 405 194  98 265],151,4,10304,4.43755383290267,0.0,0.0
12322,1,2322,[  9 603 423 127 300],796,4,10308,4.4373654756780025,20.0,20.0
12323,1,2323,[318 515 427 588  79],18,5,10313,4.437607573149742,40.0,0.0
12324,1,2324,[318 515 427 588  79],716,5,10318,4.437849462365591,40.0,0.0
12325,1,2325,[318 515 427 588  79],716,5,10323,4.4380911435941535,40.0,0.0
12326,1,2326,[196 496 204   4 127],450,4,10327,4.437902879243661,20.0,20.0
12327,1,2327,[318 515 427 588  79],716,5,10332,4.438144329896907,40.0,0.0
12328,1,2328,[318 515 427 588  79],807,5,10337,4.438385573207385,40.0,0.0
12329,1,2329,[318 515 427 588  79],18,5,10342,4.43862660944206,40.0,0.0
12330,1,2330,[318 515 427 588  79],18,5,10347,4.4388674388674385,40.0,0.0
12331,1,2331,[318 515 427 588  79],18,5,10352,4.439108061749571,40.0,0.0
12332,1,2332,[318 515 427 588  79],18,5,10357,4.43934847835405,40.0,0.0
12333,1,2333,[318 515 427 588  79],807,5,10362,4.439588688946015,40.0,0.0
12334,1,2334,[182 597 357  79 187],796,5,10367,4.43982869379015,0.0,0.0
12335,1,2335,[318 515 427 588  79],716,5,10372,4.440068493150685,40.0,0.0
12336,1,2336,[318 515 427 588  79],716,5,10377,4.440308087291399,40.0,0.0
12337,1,2337,[181 153 211 176 427],5,3,10380,4.439692044482464,20.0,0.0
12338,1,2338,[318 515 588 427  79],18,5,10385,4.43993159469859,40.0,0.0
12339,1,2339,[318 515 588 427  79],807,5,10390,4.44017094017094,40.0,0.0
12340,1,2340,[210 216 228   9 182],655,2,10392,4.43912857753097,0.0,0.0
12341,1,2341,[318 515 588 427  79],716,5,10397,4.43936806148591,40.0,0.0
12342,1,2342,[215 173 588 257 186],796,4,10401,4.439180537772087,0.0,0.0
12343,1,2343,[318 515 588 427  79],716,5,10406,4.439419795221843,40.0,0.0
12344,1,2344,[ 15  96 423 483  89],796,5,10411,4.439658848614073,0.0,0.0
12345,1,2345,[318 515 588 427  79],807,5,10416,4.439897698209719,40.0,0.0
12346,1,2346,[318 515 588 427  79],18,5,10421,4.44013634426928,40.0,0.0
12347,1,2347,[318 515 588 427  79],18,5,10426,4.440374787052811,40.0,0.0
12348,1,2348,[318 515 588 427  79],807,5,10431,4.440613026819923,40.0,0.0
12349,1,2349,[276 174 222   1  15],786,3,10434,4.44,0.0,0.0
12350,1,2350,[318 515 588 427  79],716,5,10439,4.440238196512123,40.0,0.0
12351,1,2351,[318 515 588 427  79],807,5,10444,4.440476190476191,40.0,0.0
12352,1,2352,[318 515 588 427  79],807,5,10449,4.440713982150446,40.0,0.0
12353,1,2353,[265 180  88 403  89],457,5,10454,4.440951571792693,0.0,0.0
12354,1,2354,[318 515 588 427  79],18,5,10459,4.441188959660297,40.0,0.0
12355,1,2355,[318 515 588 427  79],716,5,10464,4.441426146010187,40.0,0.0
12356,1,2356,[318 515 588 427  79],716,5,10469,4.441663131098855,40.0,0.0
12357,1,2357,[ 88 187 301 117 186],450,4,10473,4.4414758269720105,0.0,0.0
12358,1,2358,[318 515 588 427  79],18,5,10478,4.4417125900805425,40.0,0.0
12359,1,2359,[318 515 588 427  79],716,5,10483,4.441949152542373,40.0,0.0
12360,1,2360,[318 515 588 427  79],807,5,10488,4.4421855146124525,40.0,0.0
12361,1,2361,[318 515 588 427  79],807,5,10493,4.4424216765453,40.0,0.0
12362,1,2362,[318 515 588 427  79],18,5,10498,4.442657638595007,40.0,0.0
12363,1,2363,[100 588 515 322 276],401,3,10501,4.442047377326565,0.0,20.0
12364,1,2364,[257 210 172 118 234],457,4,10505,4.441860465116279,0.0,0.0
12365,1,2365,[318 515 427 588  79],716,5,10510,4.442096365173288,40.0,0.0
12366,1,2366,[318 515 427 588  79],807,5,10515,4.442332065906211,40.0,0.0
12367,1,2367,[318 515 427 588  79],807,5,10520,4.4425675675675675,40.0,0.0
12368,1,2368,[318 515 427 588  79],716,5,10525,4.442802870409455,40.0,0.0
12369,1,2369,[318 515 427 588  79],807,5,10530,4.443037974683544,40.0,0.0
12370,1,2370,[318 515 427 588  79],716,5,10535,4.4432728806410795,40.0,0.0
12371,1,2371,[318 515 427 588  79],716,5,10540,4.443507588532884,40.0,0.0
12372,1,2372,[568 151 427  88  96],796,5,10545,4.443742098609356,20.0,0.0
12373,1,2373,[318 515 427 588  79],807,5,10550,4.443976411120472,40.0,0.0
12374,1,2374,[318 515 427 588  79],716,5,10555,4.444210526315789,40.0,0.0
12375,1,2375,[318 515 427 588  79],807,5,10560,4.444444444444445,40.0,0.0
12376,1,2376,[318 515 427 588  79],716,5,10565,4.444678165755153,40.0,0.0
12377,1,2377,[318 515 427 588  79],716,5,10570,4.444911690496215,40.0,0.0
12378,1,2378,[200  56 195 151 357],269,4,10574,4.444724674232871,0.0,0.0
12379,1,2379,[318 515 427 588  79],18,5,10579,4.4449579831932775,40.0,0.0
12380,1,2380,[318 515 427 588  79],18,5,10584,4.4451910961780765,40.0,0.0
12381,1,2381,[318 515 427 588  79],18,5,10589,4.445424013434089,40.0,0.0
12382,1,2382,[183 153 210  89 588],450,4,10593,4.445237096097356,0.0,0.0
12383,1,2383,[194   8  12 286 172],707,3,10596,4.444630872483222,0.0,20.0
12384,1,2384,[318 515 427 588  79],716,5,10601,4.444863731656184,40.0,0.0
12385,1,2385,[318 515 427 588  79],807,5,10606,4.44509639564124,40.0,0.0
12386,1,2386,[318 515 427 588  79],716,5,10611,4.445328864683703,40.0,0.0
12387,1,2387,[197  98 273 403 211],655,2,10613,4.44430485762144,0.0,0.0
12388,1,2388,[318 515 427 588  79],807,5,10618,4.444537463373797,40.0,0.0
12389,1,2389,[318 515 427 588  79],807,5,10623,4.444769874476988,40.0,0.0
12390,1,2390,[318 515 427 588  79],716,5,10628,4.44500209117524,40.0,0.0
12391,1,2391,[318 515 427 588  79],716,5,10633,4.445234113712375,40.0,0.0
12392,1,2392,[318 515 427 588  79],807,5,10638,4.4454659423318015,40.0,0.0
12393,1,2393,[ 96 748 118 197  64],292,3,10641,4.4448621553884715,20.0,0.0
12394,1,2394,[588 191 174  79 182],450,5,10646,4.4450939457202505,0.0,0.0
12395,1,2395,[318 515 427 588  79],807,5,10651,4.445325542570951,40.0,0.0
12396,1,2396,[ 64   1 161  15 471],577,3,10654,4.444722569879016,20.0,0.0
12397,1,2397,[318 515 427 588  79],716,5,10659,4.444954128440367,40.0,0.0
12398,1,2398,[202 403 496 228 132],577,4,10663,4.444768653605669,20.0,0.0
12399,1,2399,[318 515 427 588  79],18,5,10668,4.445,40.0,0.0
12400,1,2400,[300 195 183 275 185],716,3,10671,4.444398167430237,0.0,20.0
12401,1,2401,[515 318 427 588  79],18,5,10676,4.444629475437136,40.0,0.0
12402,1,2402,[515 318 427 588  79],807,5,10681,4.444860590928006,40.0,0.0
12403,1,2403,[515 318 427 588  79],18,5,10686,4.445091514143095,40.0,0.0
12404,1,2404,[ 97   1 161  64 294],655,1,10687,4.443659043659044,20.0,0.0
12405,1,2405,[111 328  71 273  11],450,3,10690,4.44305901911887,0.0,0.0
12406,1,2406,[515 318 427 588  79],18,5,10695,4.443290402991275,40.0,0.0
12407,1,2407,[515 318 427 588  79],807,5,10700,4.443521594684386,40.0,0.0
12408,1,2408,[515 318 427 588  79],807,5,10705,4.443752594437526,40.0,0.0
12409,1,2409,[515 318 427 588  79],18,5,10710,4.443983402489627,40.0,0.0
12410,1,2410,[515 318 427 588  79],18,5,10715,4.4442140190792205,40.0,0.0
12411,1,2411,[515 318 427 588  79],807,5,10720,4.444444444444445,40.0,0.0
12412,1,2412,[515 318 427 588  79],18,5,10725,4.444674678823042,40.0,0.0
12413,1,2413,[143 100 328 111 385],796,4,10729,4.444490472245236,0.0,20.0
12414,1,2414,[515 318 427 588  79],18,5,10734,4.44472049689441,40.0,0.0
12415,1,2415,[515 318 427 588  79],807,5,10739,4.444950331125828,40.0,0.0
12416,1,2416,[172  64  79 216  28],151,5,10744,4.445179975175837,20.0,0.0
12417,1,2417,[515 318 427 588  79],716,5,10749,4.445409429280397,40.0,0.0
12418,1,2418,[515 318 427 588  79],18,5,10754,4.445638693675073,40.0,0.0
12419,1,2419,[515 318 427 588  79],18,5,10759,4.445867768595042,40.0,0.0
12420,1,2420,[515 318 427 588  79],716,5,10764,4.446096654275093,40.0,0.0
12421,1,2421,[515 318 427 588  79],716,5,10769,4.446325350949628,40.0,0.0
12422,1,2422,[172 655  97 496 204],535,4,10773,4.446141147338011,20.0,0.0
12423,1,2423,[515 318 427 588  79],716,5,10778,4.446369636963697,40.0,0.0
12424,1,2424,[515 318 427 588  79],716,5,10783,4.44659793814433,40.0,0.0
12425,1,2425,[515 318 427 588  79],18,5,10788,4.446826051112943,40.0,0.0
12426,1,2426,[597  82 161 238 176],457,4,10792,4.446641944787804,0.0,0.0
12427,1,2427,[515 318 427 588  79],807,5,10797,4.446869851729819,40.0,0.0
12428,1,2428,[515 318 427 588  79],807,5,10802,4.447097571016879,40.0,0.0
12429,1,2429,[125 216 258 132 313],344,2,10804,4.446090534979424,0.0,0.0
12430,1,2430,[515 318 427 588  79],807,5,10809,4.446318387494858,40.0,0.0
12431,1,2431,[515 318 427 588  79],18,5,10814,4.446546052631579,40.0,0.0
12432,1,2432,[515 318 427 588  79],716,5,10819,4.446773530620633,40.0,0.0
12433,1,2433,[174  25  96 172 211],716,4,10823,4.4465899753492195,0.0,0.0
12434,1,2434,[515 318 427 588  79],807,5,10828,4.446817248459959,40.0,0.0
12435,1,2435,[515 318 427 588  79],18,5,10833,4.447044334975369,40.0,0.0
12436,1,2436,[179 276 197 318 182],535,3,10836,4.446450553959787,20.0,0.0
12437,1,2437,[100  96  28 568 194],450,5,10841,4.44667760459393,0.0,20.0
12438,1,2438,[144 172   7 100  82],655,1,10842,4.445264452644526,0.0,20.0
12439,1,2439,[235  82 191 161 357],269,2,10844,4.444262295081967,0.0,0.0
12440,1,2440,[496 153 211 174  25],593,4,10848,4.444080294961082,20.0,0.0
12441,1,2441,[515 318 427 588  79],18,5,10853,4.444307944307944,40.0,0.0
12442,1,2442,[515 318 427 588  79],716,5,10858,4.444535407286124,40.0,0.0
12443,1,2443,[515 318 427 588  79],18,5,10863,4.444762684124386,40.0,0.0
12444,1,2444,[515 318 427 588  79],807,5,10868,4.444989775051125,40.0,0.0
12445,1,2445,[515 318 427 588  79],716,5,10873,4.445216680294358,40.0,0.0
12446,1,2446,[515 318 427 588  79],716,5,10878,4.445443400081733,40.0,0.0
12447,1,2447,[216 143 174 121 546],593,4,10882,4.4452614379084965,0.0,0.0
12448,1,2448,[195  56 328 186 271],655,0,10882,4.443446304614128,0.0,0.0
12449,1,2449,[515 318 427 588  79],18,5,10887,4.443673469387755,40.0,0.0
12450,1,2450,[172 385 202  70 153],330,5,10892,4.44390044879641,0.0,0.0
12451,1,2451,[515 318 427 588  79],716,5,10897,4.444127243066884,40.0,0.0
12452,1,2452,[515 318 427 588  79],18,5,10902,4.444353852425602,40.0,0.0
12453,1,2453,[515 318 427 588  79],716,5,10907,4.4445802770986145,40.0,0.0
12454,1,2454,[515 318 427 588  79],807,5,10912,4.444806517311609,40.0,0.0
12455,1,2455,[515 318 427 588  79],807,5,10917,4.445032573289902,40.0,0.0
12456,1,2456,[515 318 427 588  79],807,5,10922,4.445258445258445,40.0,0.0
12457,1,2457,[515 318 427 588  79],716,5,10927,4.4454841334418225,40.0,0.0
12458,1,2458,[515 318 427 588  79],18,5,10932,4.445709638064254,40.0,0.0
12459,1,2459,[515 318 427 588  79],18,5,10937,4.445934959349594,40.0,0.0
12460,1,2460,[515 318 427 588  79],716,5,10942,4.446160097521333,40.0,0.0
12461,1,2461,[515 318 427 588  79],807,5,10947,4.4463850528026,40.0,0.0
12462,1,2462,[515 318 427 588  79],807,5,10952,4.446609825416159,40.0,0.0
12463,1,2463,[515 318 427 588  79],18,5,10957,4.446834415584416,40.0,0.0
12464,1,2464,[515 318 427 588  79],807,5,10962,4.447058823529412,40.0,0.0
12465,1,2465,[ 64 427 286 144 333],655,2,10964,4.446066504460665,40.0,20.0
12466,1,2466,[515 318 427 588  79],807,5,10969,4.446291041751115,40.0,0.0
12467,1,2467,[515 318 427 588  79],807,5,10974,4.446515397082658,40.0,0.0
12468,1,2468,[515 318 427 588  79],807,5,10979,4.446739570676387,40.0,0.0
12469,1,2469,[515 318 427 588  79],18,5,10984,4.446963562753036,40.0,0.0
12470,1,2470,[515 318 427 588  79],807,5,10989,4.447187373532983,40.0,0.0
12471,1,2471,[515 318 427 588  79],807,5,10994,4.447411003236246,40.0,0.0
12472,1,2472,[515 318 427 588  79],18,5,10999,4.447634452082491,40.0,0.0
12473,1,2473,[185 182 172 211 328],450,5,11004,4.447857720291027,0.0,0.0
12474,1,2474,[197   1 546  56 151],450,5,11009,4.4480808080808085,0.0,0.0
12475,1,2475,[515 318 427 588  79],807,5,11014,4.448303715670436,40.0,0.0
12476,1,2476,[515 318 427 588  79],716,5,11019,4.448526443278159,40.0,0.0
12477,1,2477,[515 318 427 588  79],807,5,11024,4.448748991121873,40.0,0.0
12478,1,2478,[ 25 125 172 195 135],457,5,11029,4.4489713594191205,0.0,0.0
12479,1,2479,[515 318 427 588  79],807,5,11034,4.449193548387097,40.0,0.0
12480,1,2480,[515 318 427 588  79],807,5,11039,4.449415558242644,40.0,0.0
12481,1,2481,[515 318 427 588  79],716,5,11044,4.449637389202256,40.0,0.0
12482,1,2482,[515 318 427 588  79],18,5,11049,4.449859041482078,40.0,0.0
12483,1,2483,[515 318 427 588  79],18,5,11054,4.450080515297906,40.0,0.0
12484,1,2484,[515 318 427 588  79],807,5,11059,4.4503018108651915,40.0,0.0
12485,1,2485,[ 70 180 483  69 194],450,4,11063,4.450120675784393,0.0,0.0
12486,1,2486,[515 318 427 588  79],716,5,11068,4.450341777241657,40.0,0.0
12487,1,2487,[515 318 427 588  79],807,5,11073,4.45056270096463,40.0,0.0
12488,1,2488,[117 257  28  11 175],655,0,11073,4.448774608276416,0.0,0.0
12489,1,2489,[515 318 427 588  79],18,5,11078,4.448995983935743,40.0,0.0
12490,1,2490,[  1 191 194 117 403],72,4,11082,4.448815736651947,0.0,0.0
12491,1,2491,[515 318 427 588  79],807,5,11087,4.449036918138042,40.0,0.0
12492,1,2492,[202 151 215 185  88],18,0,11087,4.447252306458083,0.0,0.0
12493,1,2493,[515 318 427 588  79],807,5,11092,4.44747393744988,40.0,0.0
12494,1,2494,[515 318 427 588  79],18,5,11097,4.447695390781563,40.0,0.0
12495,1,2495,[515 318 427 588  79],716,5,11102,4.447916666666667,40.0,0.0
12496,1,2496,[515 318 427 588  79],18,5,11107,4.448137765318382,40.0,0.0
12497,1,2497,[  9 273  97 435  88],236,3,11110,4.44755804643715,0.0,0.0
12498,1,2498,[515 318 427 588  79],18,5,11115,4.447779111644658,40.0,0.0
12499,1,2499,[515 318 427 588  79],18,5,11120,4.448,40.0,0.0
12500,1,2500,[515 318 427 588  79],716,5,11125,4.448220711715314,40.0,0.0
12501,1,2501,[515 318 427 588  79],807,5,11130,4.448441247002398,40.0,0.0
12502,1,2502,[515 318 427 588  79],807,5,11135,4.448661606072712,40.0,0.0
12503,1,2503,[515 318 427 588  79],716,5,11140,4.44888178913738,40.0,0.0
12504,1,2504,[269  97 318  96 313],450,5,11145,4.449101796407185,20.0,0.0
12505,1,2505,[216 135  64 357 197],457,5,11150,4.449321628092578,20.0,0.0
12506,1,2506,[318  15   1 100 125],65,3,11153,4.448743518149183,20.0,20.0
12507,1,2507,[515 318 427 588  79],807,5,11158,4.44896331738437,40.0,0.0
12508,1,2508,[515 318 427 588  79],716,5,11163,4.44918294141092,40.0,0.0
12509,1,2509,[ 25 318 210  71  79],577,4,11167,4.449003984063745,20.0,0.0
12510,1,2510,[515 318 427 588  79],807,5,11172,4.449223416965353,40.0,0.0
12511,1,2511,[515 318 427 588  79],716,5,11177,4.4494426751592355,40.0,0.0
12512,1,2512,[322 100 435 318 144],450,5,11182,4.449661758853959,20.0,20.0
12513,1,2513,[515 318 427 588  79],18,5,11187,4.449880668257757,40.0,0.0
12514,1,2514,[471 275  69 181   8],344,2,11189,4.448906560636183,0.0,20.0
12515,1,2515,[515 318 427 588  79],716,5,11194,4.44912559618442,40.0,0.0
12516,1,2516,[515 318 427 588  79],18,5,11199,4.449344457687723,40.0,0.0
12517,1,2517,[515 318 427 588  79],18,5,11204,4.449563145353455,40.0,0.0
12518,1,2518,[515 318 427 588  79],18,5,11209,4.449781659388647,40.0,0.0
12519,1,2519,[515 318 427 588  79],18,5,11214,4.45,40.0,0.0
12520,1,2520,[515 318 427 588  79],716,5,11219,4.450218167393891,40.0,0.0
12521,1,2521,[515 318 427 588  79],18,5,11224,4.450436161776368,40.0,0.0
12522,1,2522,[515 318 427 588  79],807,5,11229,4.450653983353151,40.0,0.0
12523,1,2523,[515 318 427 588  79],716,5,11234,4.450871632329635,40.0,0.0
12524,1,2524,[  4 181 186   8   7],535,4,11238,4.450693069306931,0.0,0.0
12525,1,2525,[515 318 427 588  79],807,5,11243,4.450910530482977,40.0,0.0
12526,1,2526,[180 118  11 228 385],450,4,11247,4.450732093391373,0.0,0.0
12527,1,2527,[515 318 427 588  79],18,5,11252,4.450949367088608,40.0,0.0
12528,1,2528,[515 318 427 588  79],807,5,11257,4.451166468960063,40.0,0.0
12529,1,2529,[515 318 427 588  79],18,5,11262,4.451383399209486,40.0,0.0
12530,1,2530,[ 12 286   7 385 282],280,4,11266,4.4512050572896085,0.0,20.0
12531,1,2531,[515 318 427 588  79],18,5,11271,4.451421800947867,40.0,0.0
12532,1,2532,[515 318 427 588  79],807,5,11276,4.451638373470193,40.0,0.0
12533,1,2533,[515 318 427 588  79],716,5,11281,4.451854775059195,40.0,0.0
12534,1,2534,[515 318 427 588  79],18,5,11286,4.45207100591716,40.0,0.0
12535,1,2535,[515 318 427 588  79],716,5,11291,4.452287066246057,40.0,0.0
12536,1,2536,[286 191 405 301 143],796,3,11294,4.451714623571147,0.0,20.0
12537,1,2537,[515 318 427 588  79],716,5,11299,4.451930654058313,40.0,0.0
12538,1,2538,[515 318 427 588  79],807,5,11304,4.452146514375738,40.0,0.0
12539,1,2539,[515 318 427 588  79],18,5,11309,4.45236220472441,40.0,0.0
12540,1,2540,[515 318 427 588  79],807,5,11314,4.452577725304998,40.0,0.0
12541,1,2541,[180 257 228 179 100],457,4,11318,4.452399685287175,0.0,20.0
12542,1,2542,[515 318 427 588  79],807,5,11323,4.452615021627999,40.0,0.0
12543,1,2543,[200 276 508 121 211],655,2,11325,4.451650943396227,0.0,0.0
12544,1,2544,[515 318 427 588  79],18,5,11330,4.451866404715128,40.0,0.0
12545,1,2545,[515 318 427 588  79],18,5,11335,4.452081696779262,40.0,0.0
12546,1,2546,[515 318 427 588  79],807,5,11340,4.4522968197879855,40.0,0.0
12547,1,2547,[216  95 496 125  64],731,3,11343,4.4517268445839875,40.0,0.0
12548,1,2548,[515 318 427 588  79],18,5,11348,4.451941938014908,40.0,0.0
12549,1,2549,[515 318 427 588  79],716,5,11353,4.452156862745098,40.0,0.0
12550,1,2550,[515 318 427 588  79],18,5,11358,4.452371618972951,40.0,0.0
12551,1,2551,[204  82  50  97 216],151,4,11362,4.452194357366771,0.0,20.0
12552,1,2552,[197 322  56 276 269],629,3,11365,4.451625538582061,0.0,0.0
12553,1,2553,[515 318 427 588  79],807,5,11370,4.451840250587314,40.0,0.0
12554,1,2554,[144 357 211  28  98],23,2,11372,4.450880626223092,0.0,0.0
12555,1,2555,[515 318 427 588  79],18,5,11377,4.451095461658842,40.0,0.0
12556,1,2556,[515 318 427 588  79],807,5,11382,4.4513101290574895,40.0,0.0
12557,1,2557,[515 318 427 588  79],18,5,11387,4.451524628616107,40.0,0.0
12558,1,2558,[515 318 427 588  79],716,5,11392,4.451738960531458,40.0,0.0
12559,1,2559,[515 318 427 588  79],807,5,11397,4.451953125,40.0,0.0
12560,1,2560,[  4 288 235 153 168],450,2,11399,4.4509957048028115,0.0,0.0
12561,1,2561,[515 318 427 588  79],716,5,11404,4.451209992193599,40.0,0.0
12562,1,2562,[282 172 603 258  22],796,5,11409,4.4514241123683185,20.0,0.0
12563,1,2563,[515 318 427 588  79],716,5,11414,4.451638065522621,40.0,0.0
12564,1,2564,[515 318 427 588  79],18,5,11419,4.451851851851852,40.0,0.0
12565,1,2565,[ 64 210 151 568 168],389,3,11422,4.45128604832424,20.0,0.0
12566,1,2566,[ 79 182 174 127  56],256,4,11426,4.451110245422672,0.0,20.0
12567,1,2567,[515 318 427 588  79],18,5,11431,4.451323987538941,40.0,0.0
12568,1,2568,[118 210 289 161 111],756,3,11434,4.450759050214091,0.0,0.0
12569,1,2569,[515 318 427 588  79],716,5,11439,4.450972762645915,40.0,0.0
12570,1,2570,[515 318 427 588  79],807,5,11444,4.451186308829249,40.0,0.0
12571,1,2571,[135  25 313 245 435],450,3,11447,4.4506220839813375,0.0,0.0
12572,1,2572,[196 185 568 132 211],716,5,11452,4.450835600466382,0.0,0.0
12573,1,2573,[515 318 427 588  79],18,5,11457,4.451048951048951,40.0,0.0
12574,1,2574,[515 318 427 588  79],716,5,11462,4.45126213592233,40.0,0.0
12575,1,2575,[515 318 427 588  79],716,5,11467,4.451475155279503,40.0,0.0
12576,1,2576,[515 318 427 588  79],716,5,11472,4.451688009313155,40.0,0.0
12577,1,2577,[515 318 427 588  79],716,5,11477,4.451900698215671,40.0,0.0
12578,1,2578,[515 318 427 588  79],18,5,11482,4.452113222179139,40.0,0.0
12579,1,2579,[515 318 427 588  79],807,5,11487,4.452325581395349,40.0,0.0
12580,1,2580,[175 194 597 275 202],23,3,11490,4.451762882603642,0.0,20.0
12581,1,2581,[515 318 427 588  79],716,5,11495,4.451975213013168,40.0,0.0
12582,1,2582,[515 318 427 588  79],716,5,11500,4.452187379016648,40.0,0.0
12583,1,2583,[515 318 427 588  79],807,5,11505,4.452399380804954,40.0,0.0
12584,1,2584,[173 168 187 323  22],796,4,11509,4.452224371373307,0.0,0.0
12585,1,2585,[ 89 144 161 117 175],457,5,11514,4.452436194895592,0.0,0.0
12586,1,2586,[ 89 100 546 286 385],344,2,11516,4.4514882102821804,0.0,40.0
12587,1,2587,[  8 301 265 197 313],796,3,11519,4.450927357032458,0.0,0.0
12588,1,2588,[515 318 427 588  79],18,5,11524,4.451139436075705,40.0,0.0
12589,1,2589,[515 318 427 588  79],716,5,11529,4.451351351351351,40.0,0.0
12590,1,2590,[515 318 427 588  79],807,5,11534,4.451563103049016,40.0,0.0
12591,1,2591,[515 318 427 588  79],716,5,11539,4.4517746913580245,40.0,0.0
12592,1,2592,[515 318 427 588  79],807,5,11544,4.451986116467412,40.0,0.0
12593,1,2593,[483 100  79 568 172],655,3,11547,4.451426368542791,0.0,20.0
12594,1,2594,[515 318 427 588  79],716,5,11552,4.4516377649325625,40.0,0.0
12595,1,2595,[515 318 427 588  79],716,5,11557,4.451848998459168,40.0,0.0
12596,1,2596,[515 318 427 588  79],716,5,11562,4.452060069310743,40.0,0.0
12597,1,2597,[515 318 427 588  79],716,5,11567,4.452270977675135,40.0,0.0
12598,1,2598,[515 318 427 588  79],716,5,11572,4.4524817237399,40.0,0.0
12599,1,2599,[515 318 427 588  79],716,5,11577,4.452692307692308,40.0,0.0
12600,1,2600,[515 318 427 588  79],807,5,11582,4.452902729719339,40.0,0.0
12601,1,2601,[515 318 427 588  79],18,5,11587,4.4531129900076865,40.0,0.0
12602,1,2602,[ 89 385 181   7 257],457,4,11591,4.452938916634652,0.0,0.0
12603,1,2603,[515 318 427 588  79],807,5,11596,4.453149001536098,40.0,0.0
12604,1,2604,[195   9 678 186 117],504,4,11600,4.452975047984645,0.0,0.0
12605,1,2605,[127 194 546 135 143],807,4,11604,4.452801227935534,0.0,20.0
12606,1,2606,[515 318 427 588  79],18,5,11609,4.4530111238972,40.0,0.0
12607,1,2607,[144 118   4 172 151],450,3,11612,4.4524539877300615,0.0,0.0
12608,1,2608,[181  25  56   7 195],885,2,11614,4.4515139900344955,0.0,0.0
12609,1,2609,[515 318 427 588  79],807,5,11619,4.451724137931034,40.0,0.0
12610,1,2610,[515 318 427 588  79],716,5,11624,4.451934124856377,40.0,0.0
12611,1,2611,[515 318 427 588  79],807,5,11629,4.4521439509954055,40.0,0.0
12612,1,2612,[288 228 258 197 179],655,1,11630,4.450822809031764,0.0,0.0
12613,1,2613,[515 318 427 588  79],807,5,11635,4.451032899770467,40.0,0.0
12614,1,2614,[161 302 288 186   1],655,1,11636,4.449713193116635,0.0,0.0
12615,1,2615,[318 515 427 588  79],716,5,11641,4.449923547400612,40.0,0.0
12616,1,2616,[318 515 427 588  79],807,5,11646,4.450133740924723,40.0,0.0
12617,1,2617,[196 237 183 357 135],269,2,11648,4.449197860962567,0.0,0.0
12618,1,2618,[318 515 427 588  79],807,5,11653,4.449408171057655,40.0,0.0
12619,1,2619,[181 655 100 173   8],796,3,11656,4.448854961832061,0.0,20.0
12620,1,2620,[318 515 427 588  79],807,5,11661,4.449065242273941,40.0,0.0
12621,1,2621,[202  82 176 210 144],457,5,11666,4.449275362318841,0.0,0.0
12622,1,2622,[318 515 427 588  79],807,5,11671,4.44948532215021,40.0,0.0
12623,1,2623,[318 515 427 588  79],807,5,11676,4.449695121951219,40.0,0.0
12624,1,2624,[318 515 427 588  79],807,5,11681,4.449904761904762,40.0,0.0
12625,1,2625,[318 515 427 588  79],18,5,11686,4.45011424219345,40.0,0.0
12626,1,2626,[318 515 427 588  79],18,5,11691,4.450323562999619,40.0,0.0
12627,1,2627,[144 385 117 118 405],716,2,11693,4.449391171993912,0.0,0.0
12628,1,2628,[318 515 427 588  79],18,5,11698,4.449600608596424,40.0,0.0
12629,1,2629,[318 515 427 588  79],716,5,11703,4.449809885931559,40.0,0.0
12630,1,2630,[742 427  95  64 655],796,3,11706,4.449258836944128,40.0,0.0
12631,1,2631,[318 515 427 588  79],18,5,11711,4.449468085106383,40.0,0.0
12632,1,2632,[318 515 427 588  79],18,5,11716,4.449677174325864,40.0,0.0
12633,1,2633,[318 515 427 588  79],18,5,11721,4.449886104783599,40.0,0.0
12634,1,2634,[318 515 427 588  79],716,5,11726,4.450094876660342,40.0,0.0
12635,1,2635,[318 515 427 588  79],807,5,11731,4.45030349013657,40.0,0.0
12636,1,2636,[318 515 427 588  79],807,5,11736,4.450511945392491,40.0,0.0
12637,1,2637,[318 515 427 588  79],18,5,11741,4.450720242608036,40.0,0.0
12638,1,2638,[318 515 427 588  79],716,5,11746,4.450928381962865,40.0,0.0
12639,1,2639,[276 168  12 118 132],457,5,11751,4.451136363636364,0.0,0.0
12640,1,2640,[318 515 427 588  79],807,5,11756,4.451344187807648,40.0,0.0
12641,1,2641,[318 515 427 588  79],716,5,11761,4.451551854655564,40.0,0.0
12642,1,2642,[318 515 427 588  79],807,5,11766,4.451759364358684,40.0,0.0
12643,1,2643,[318 515 427 588  79],807,5,11771,4.45196671709531,40.0,0.0
12644,1,2644,[318 515 427 588  79],807,5,11776,4.452173913043478,40.0,0.0
12645,1,2645,[318 515 427 588  79],807,5,11781,4.4523809523809526,40.0,0.0
12646,1,2646,[318 515 427 588  79],716,5,11786,4.452587835285229,40.0,0.0
12647,1,2647,[318 515 427 588  79],716,5,11791,4.452794561933535,40.0,0.0
12648,1,2648,[265 215 271 286 427],655,1,11792,4.451491128727822,20.0,20.0
12649,1,2649,[318 515 427 588  79],716,5,11797,4.451698113207547,40.0,0.0
12650,1,2650,[153 204 275 423 111],152,5,11802,4.451904941531498,0.0,20.0
12651,1,2651,[318 515 427 588  79],716,5,11807,4.45211161387632,40.0,0.0
12652,1,2652,[318 515 427 588  79],18,5,11812,4.452318130418394,40.0,0.0
12653,1,2653,[302  79  50   4  88],344,4,11816,4.452147701582517,0.0,20.0
12654,1,2654,[318 515 427 588  79],807,5,11821,4.452354048964218,40.0,0.0
12655,1,2655,[318 515 427 588  79],716,5,11826,4.452560240963855,40.0,0.0
12656,1,2656,[151  64 288  28  56],457,5,11831,4.452766277756869,20.0,0.0
12657,1,2657,[318 515 427 588  79],716,5,11836,4.452972159518435,40.0,0.0
12658,1,2658,[181  89   7 294 216],655,2,11838,4.452049642722828,0.0,0.0
12659,1,2659,[318 515 427 588  79],18,5,11843,4.452255639097745,40.0,0.0
12660,1,2660,[318 515 427 588  79],716,5,11848,4.452461480646374,40.0,0.0
12661,1,2661,[269 228 186 385 275],796,3,11851,4.451915852742299,0.0,20.0
12662,1,2662,[318 515 427 588  79],716,5,11856,4.452121667292527,40.0,0.0
12663,1,2663,[318 515 427 588  79],18,5,11861,4.452327327327327,40.0,0.0
12664,1,2664,[318 515 427 588  79],807,5,11866,4.452532833020638,40.0,0.0
12665,1,2665,[318 515 427 588  79],18,5,11871,4.452738184546137,40.0,0.0
12666,1,2666,[318 515 427 588  79],18,5,11876,4.45294338207724,40.0,0.0
12667,1,2667,[318 515 427 588  79],807,5,11881,4.453148425787107,40.0,0.0
12668,1,2668,[318 515 427 588  79],716,5,11886,4.4533533158486325,40.0,0.0
12669,1,2669,[318 515 427 588  79],18,5,11891,4.453558052434457,40.0,0.0
12670,1,2670,[318 515 427 588  79],18,5,11896,4.45376263571696,40.0,0.0
12671,1,2671,[ 28 678 435  89 210],807,3,11899,4.453218562874252,0.0,0.0
12672,1,2672,[515 318 427 588  79],807,5,11904,4.453423120089787,40.0,0.0
12673,1,2673,[ 98 175  79 121  64],344,4,11908,4.453253552729993,20.0,0.0
12674,1,2674,[515 318 427 588  79],807,5,11913,4.453457943925233,40.0,0.0
12675,1,2675,[515 318 427 588  79],716,5,11918,4.453662182361734,40.0,0.0
12676,1,2676,[515 318 427 588  79],18,5,11923,4.4538662682106835,40.0,0.0
12677,1,2677,[515 318 427 588  79],18,5,11928,4.454070201643018,40.0,0.0
12678,1,2678,[153  97  98 235 121],716,4,11932,4.453900709219858,0.0,0.0
12679,1,2679,[515 318 427 588  79],18,5,11937,4.45410447761194,40.0,0.0
12680,1,2680,[515 318 427 588  79],18,5,11942,4.454308093994778,40.0,0.0
12681,1,2681,[515 318 427 588  79],18,5,11947,4.454511558538404,40.0,0.0
12682,1,2682,[515 318 427 588  79],18,5,11952,4.454714871412598,40.0,0.0
12683,1,2683,[515 318 427 588  79],716,5,11957,4.454918032786885,40.0,0.0
12684,1,2684,[515 318 427 588  79],716,5,11962,4.45512104283054,40.0,0.0
12685,1,2685,[515 318 427 588  79],807,5,11967,4.455323901712584,40.0,0.0
12686,1,2686,[515 318 427 588  79],716,5,11972,4.455526609601787,40.0,0.0
12687,1,2687,[289 655 603 195 471],655,1,11973,4.454241071428571,20.0,0.0
12688,1,2688,[515 318 427 588  79],18,5,11978,4.454444031238379,40.0,0.0
12689,1,2689,[515 318 427 588  79],18,5,11983,4.4546468401486985,40.0,0.0
12690,1,2690,[515 318 427 588  79],807,5,11988,4.454849498327759,40.0,0.0
12691,1,2691,[191  50 302 286 186],151,3,11991,4.4543090638930165,0.0,40.0
12692,1,2692,[515 318 427 588  79],716,5,11996,4.454511696992202,40.0,0.0
12693,1,2693,[515 318 427 588  79],807,5,12001,4.454714179658501,40.0,0.0
12694,1,2694,[515 318 427 588  79],18,5,12006,4.454916512059369,40.0,0.0
12695,1,2695,[515 318 427 588  79],807,5,12011,4.455118694362018,40.0,0.0
12696,1,2696,[515 318 427 588  79],807,5,12016,4.455320726733407,40.0,0.0
12697,1,2697,[515 318 427 588  79],716,5,12021,4.455522609340252,40.0,0.0
12698,1,2698,[515 318 427 588  79],716,5,12026,4.4557243423490185,40.0,0.0
12699,1,2699,[405 100 323 496 423],796,3,12029,4.455185185185186,20.0,20.0
12700,1,2700,[515 318 427 588  79],716,5,12034,4.455386893743058,40.0,0.0
12701,1,2701,[515 318 427 588  79],807,5,12039,4.455588452997779,40.0,0.0
12702,1,2702,[204 405 568  95 111],280,2,12041,4.4546799852016274,0.0,0.0
12703,1,2703,[515 318 427 588  79],18,5,12046,4.454881656804734,40.0,0.0
12704,1,2704,[515 318 427 588  79],18,5,12051,4.455083179297597,40.0,0.0
12705,1,2705,[515 318 427 588  79],716,5,12056,4.455284552845528,40.0,0.0
12706,1,2706,[ 88 132 187 182  97],450,5,12061,4.455485777613594,0.0,0.0
12707,1,2707,[483 237 202 222 235],450,2,12063,4.454579025110783,0.0,0.0
12708,1,2708,[515 318 427 588  79],716,5,12068,4.454780361757106,40.0,0.0
12709,1,2709,[515 318 427 588  79],807,5,12073,4.454981549815498,40.0,0.0
12710,1,2710,[117   8  95   1 125],344,2,12075,4.454075986720767,0.0,0.0
12711,1,2711,[515 318 427 588  79],807,5,12080,4.454277286135693,40.0,0.0
12712,1,2712,[515 318 427 588  79],716,5,12085,4.4544784371544415,40.0,0.0
12713,1,2713,[ 97 173 197 174  50],796,3,12088,4.453942520265291,0.0,20.0
12714,1,2714,[515 318 427 588  79],716,5,12093,4.4541436464088395,40.0,0.0
12715,1,2715,[515 318 427 588  79],18,5,12098,4.454344624447717,40.0,0.0
12716,1,2716,[546 427 161  69 151],577,4,12102,4.454177401545823,20.0,0.0
12717,1,2717,[515 318 427 588  79],18,5,12107,4.4543782192788814,40.0,0.0
12718,1,2718,[294 228 222  25 143],457,4,12111,4.4542111070246415,0.0,0.0
12719,1,2719,[515 318 427 588  79],716,5,12116,4.454411764705882,40.0,0.0
12720,1,2720,[200 245 187 196 257],504,4,12120,4.454244762954796,0.0,0.0
12721,1,2721,[515 318 427 588  79],807,5,12125,4.45444526083762,40.0,0.0
12722,1,2722,[176 161 655 100 471],655,0,12125,4.45280940139552,0.0,20.0
12723,1,2723,[182 197   9 127  98],629,5,12130,4.453010279001468,0.0,20.0
12724,1,2724,[515 318 427 588  79],807,5,12135,4.453211009174312,40.0,0.0
12725,1,2725,[515 318 427 588  79],716,5,12140,4.453411592076303,40.0,0.0
12726,1,2726,[215 179 423   1  25],18,3,12143,4.4528786211954525,0.0,0.0
12727,1,2727,[515 318 427 588  79],807,5,12148,4.4530791788856305,40.0,0.0
12728,1,2728,[515 318 427 588  79],716,5,12153,4.453279589593258,40.0,0.0
12729,1,2729,[515 318 427 588  79],18,5,12158,4.453479853479854,40.0,0.0
12730,1,2730,[515 318 427 588  79],716,5,12163,4.453679970706701,40.0,0.0
12731,1,2731,[515 318 427 588  79],807,5,12168,4.453879941434846,40.0,0.0
12732,1,2732,[183 423 275 200 238],151,3,12171,4.453347969264544,0.0,20.0
12733,1,2733,[515 318 427 588  79],807,5,12176,4.453547915142648,40.0,0.0
12734,1,2734,[357  56  70 313  22],655,2,12178,4.452650822669105,0.0,0.0
12735,1,2735,[515 318 427 588  79],716,5,12183,4.452850877192983,40.0,0.0
12736,1,2736,[275 228 174 276 597],457,4,12187,4.452685421994885,0.0,20.0
12737,1,2737,[515 318 427 588  79],716,5,12192,4.452885317750183,40.0,0.0
12738,1,2738,[515 318 427 588  79],807,5,12197,4.453085067542899,40.0,0.0
12739,1,2739,[196 121 204 210 403],457,5,12202,4.453284671532847,0.0,0.0
12740,1,2740,[515 318 427 588  79],716,5,12207,4.453484129879606,40.0,0.0
12741,1,2741,[276  11 301 568 182],593,3,12210,4.452954048140044,0.0,0.0
12742,1,2742,[ 97 273 322  56 173],796,2,12212,4.452059788552679,0.0,0.0
12743,1,2743,[ 11 176 172 405  88],450,5,12217,4.452259475218659,0.0,0.0
12744,1,2744,[515 318 427 588  79],18,5,12222,4.452459016393442,40.0,0.0
12745,1,2745,[515 318 427 588  79],807,5,12227,4.45265841223598,40.0,0.0
12746,1,2746,[515 318 427 588  79],807,5,12232,4.452857662904988,40.0,0.0
12747,1,2747,[204   1 269 173 194],450,5,12237,4.453056768558952,0.0,0.0
12748,1,2748,[194 215 125 135 127],18,1,12238,4.451800654783558,0.0,20.0
12749,1,2749,[515 318 427 588  79],716,5,12243,4.452,40.0,0.0
12750,1,2750,[515 318 427 588  79],716,5,12248,4.452199200290804,40.0,0.0
12751,1,2751,[196 265 471  79 172],716,4,12252,4.4520348837209305,0.0,0.0
12752,1,2752,[515 318 427 588  79],807,5,12257,4.4522339266254995,40.0,0.0
12753,1,2753,[ 95 132 271  79 403],796,5,12262,4.452432824981845,0.0,0.0
12754,1,2754,[515 318 427 588  79],807,5,12267,4.4526315789473685,40.0,0.0
12755,1,2755,[515 318 427 588  79],18,5,12272,4.452830188679245,40.0,0.0
12756,1,2756,[515 318 427 588  79],716,5,12277,4.453028654334421,40.0,0.0
12757,1,2757,[515 318 427 588  79],716,5,12282,4.453226976069615,40.0,0.0
12758,1,2758,[135 385   4   7  96],655,1,12283,4.451975353388909,0.0,0.0
12759,1,2759,[515 318 427 588  79],716,5,12288,4.452173913043478,40.0,0.0
12760,1,2760,[515 318 427 588  79],18,5,12293,4.452372328866352,40.0,0.0
12761,1,2761,[515 318 427 588  79],716,5,12298,4.4525706010137585,40.0,0.0
12762,1,2762,[515 318 427 588  79],716,5,12303,4.452768729641694,40.0,0.0
12763,1,2763,[515 318 427 588  79],716,5,12308,4.4529667149059335,40.0,0.0
12764,1,2764,[111  64 186 269  97],796,2,12310,4.452079566003617,20.0,0.0
12765,1,2765,[515 318 427 588  79],807,5,12315,4.452277657266811,40.0,0.0
12766,1,2766,[515 318 427 588  79],18,5,12320,4.452475605348753,40.0,0.0
12767,1,2767,[748 172 111 235 515],401,2,12322,4.451589595375722,0.0,0.0
12768,1,2768,[515 318 427 588  79],807,5,12327,4.451787648970748,40.0,0.0
12769,1,2769,[515 318 427 588  79],807,5,12332,4.451985559566787,40.0,0.0
12770,1,2770,[ 98   1 216 135 427],655,4,12336,4.4518224467701195,20.0,0.0
12771,1,2771,[515 318 427 588  79],18,5,12341,4.452020202020202,40.0,0.0
12772,1,2772,[515 318 427 588  79],18,5,12346,4.452217814641183,40.0,0.0
12773,1,2773,[515 318 427 588  79],807,5,12351,4.45241528478731,40.0,0.0
12774,1,2774,[515 318 427 588  79],716,5,12356,4.452612612612612,40.0,0.0
12775,1,2775,[515 318 427 588  79],18,5,12361,4.452809798270893,40.0,0.0
12776,1,2776,[515 318 427 588  79],807,5,12366,4.4530068419157365,40.0,0.0
12777,1,2777,[515 318 427 588  79],807,5,12371,4.453203743700504,40.0,0.0
12778,1,2778,[515 318 427 588  79],18,5,12376,4.4534005037783375,40.0,0.0
12779,1,2779,[515 318 427 588  79],18,5,12381,4.453597122302158,40.0,0.0
12780,1,2780,[515 318 427 588  79],716,5,12386,4.453793599424667,40.0,0.0
12781,1,2781,[515 318 427 588  79],18,5,12391,4.453989935298346,40.0,0.0
12782,1,2782,[483   9  82 328 275],151,3,12394,4.4534674811354655,0.0,20.0
12783,1,2783,[ 82 118 196 405 742],450,3,12397,4.452945402298851,0.0,0.0
12784,1,2784,[515 318 427 588  79],18,5,12402,4.45314183123878,40.0,0.0
12785,1,2785,[515 318 427 588  79],716,5,12407,4.453338119167265,40.0,0.0
12786,1,2786,[496 742 117 322 172],593,4,12411,4.453175457481162,20.0,0.0
12787,1,2787,[515 318 427 588  79],716,5,12416,4.453371592539455,40.0,0.0
12788,1,2788,[515 318 427 588  79],807,5,12421,4.4535675869487275,40.0,0.0
12789,1,2789,[515 318 427 588  79],807,5,12426,4.453763440860215,40.0,0.0
12790,1,2790,[515 318 427 588  79],807,5,12431,4.453959154424937,40.0,0.0
12791,1,2791,[515 318 427 588  79],18,5,12436,4.454154727793696,40.0,0.0
12792,1,2792,[515 318 427 588  79],807,5,12441,4.454350161117079,40.0,0.0
12793,1,2793,[515 318 427 588  79],807,5,12446,4.454545454545454,40.0,0.0
12794,1,2794,[515 318 427 588  79],18,5,12451,4.45474060822898,40.0,0.0
12795,1,2795,[515 318 427 588  79],807,5,12456,4.454935622317596,40.0,0.0
12796,1,2796,[515 318 427 588  79],716,5,12461,4.455130496961029,40.0,0.0
12797,1,2797,[515 318 427 588  79],716,5,12466,4.455325232308792,40.0,0.0
12798,1,2798,[515 318 427 588  79],807,5,12471,4.455519828510182,40.0,0.0
12799,1,2799,[515 318 427 588  79],18,5,12476,4.4557142857142855,40.0,0.0
12800,1,2800,[405 300 245 127 546],938,1,12477,4.454480542663335,0.0,20.0
12801,1,2801,[515 318 427 588  79],807,5,12482,4.454675231977159,40.0,0.0
12802,1,2802,[515 318 427 588  79],716,5,12487,4.454869782376026,40.0,0.0
12803,1,2803,[515 318 427 588  79],18,5,12492,4.45506419400856,40.0,0.0
12804,1,2804,[515 318 427 588  79],18,5,12497,4.455258467023173,40.0,0.0
12805,1,2805,[515 318 427 588  79],807,5,12502,4.455452601568068,40.0,0.0
12806,1,2806,[ 71 302 258 238 210],450,3,12505,4.454934093338084,0.0,0.0
12807,1,2807,[515 318 427 588  79],716,5,12510,4.455128205128205,40.0,0.0
12808,1,2808,[ 88 153 173 483 568],450,4,12514,4.45496618013528,0.0,0.0
12809,1,2809,[427 216 228 153  28],23,4,12518,4.454804270462634,20.0,0.0
12810,1,2810,[515 318 427 588  79],807,5,12523,4.454998221273568,40.0,0.0
12811,1,2811,[515 318 427 588  79],716,5,12528,4.455192034139403,40.0,0.0
12812,1,2812,[515 318 427 588  79],716,5,12533,4.455385709207252,40.0,0.0
12813,1,2813,[515 318 427 588  79],716,5,12538,4.455579246624023,40.0,0.0
12814,1,2814,[515 318 427 588  79],807,5,12543,4.4557726465364125,40.0,0.0
12815,1,2815,[515 318 427 588  79],716,5,12548,4.455965909090909,40.0,0.0
12816,1,2816,[515 318 427 588  79],716,5,12553,4.456159034433795,40.0,0.0
12817,1,2817,[515 318 427 588  79],807,5,12558,4.456352022711143,40.0,0.0
12818,1,2818,[515 318 427 588  79],807,5,12563,4.456544874068819,40.0,0.0
12819,1,2819,[ 82 228 204 323 385],796,3,12566,4.4560283687943265,0.0,0.0
12820,1,2820,[515 318 427 588  79],807,5,12571,4.456221198156682,40.0,0.0
12821,1,2821,[515 318 427 588  79],18,5,12576,4.456413890857548,40.0,0.0
12822,1,2822,[515 318 427 588  79],807,5,12581,4.456606447042153,40.0,0.0
12823,1,2823,[515 318 427 588  79],807,5,12586,4.456798866855524,40.0,0.0
12824,1,2824,[515 318 427 588  79],716,5,12591,4.4569911504424775,40.0,0.0
12825,1,2825,[245  89 471 423 286],450,5,12596,4.457183297947629,0.0,20.0
12826,1,2826,[179 185 202 403  98],18,2,12598,4.456314113901662,0.0,0.0
12827,1,2827,[144 132  98 515 121],716,4,12602,4.456152758132956,0.0,0.0
12828,1,2828,[300 183 288 357  95],450,3,12605,4.455638034641216,0.0,0.0
12829,1,2829,[515 318 427 588  79],716,5,12610,4.455830388692579,40.0,0.0
12830,1,2830,[515 318 427 588  79],716,5,12615,4.456022606852702,40.0,0.0
12831,1,2831,[515 318 427 588  79],807,5,12620,4.456214689265536,40.0,0.0
12832,1,2832,[ 96  28  69 496 245],450,5,12625,4.456406636074832,20.0,0.0
12833,1,2833,[515 318 427 588  79],716,5,12630,4.456598447424136,40.0,0.0
12834,1,2834,[515 318 427 588  79],807,5,12635,4.45679012345679,40.0,0.0
12835,1,2835,[357 301 196 471 385],655,1,12636,4.455571227080395,0.0,0.0
12836,1,2836,[515 318 427 588  79],716,5,12641,4.455763130066972,40.0,0.0
12837,1,2837,[228 271 435 168 423],807,3,12644,4.455250176180408,0.0,0.0
12838,1,2838,[515 318 427 588  79],18,5,12649,4.455442057062346,40.0,0.0
12839,1,2839,[132 191 748 196 135],151,3,12652,4.454929577464789,0.0,0.0
12840,1,2840,[161 328 195  79 275],796,5,12657,4.4551214361140445,0.0,20.0
12841,1,2841,[118 385 143 202 172],330,5,12662,4.455313159746657,0.0,0.0
12842,1,2842,[111 423 204 194 568],269,2,12664,4.4544495251494896,0.0,0.0
12843,1,2843,[515 318 427 588  79],716,5,12669,4.45464135021097,40.0,0.0
12844,1,2844,[515 318 427 588  79],18,5,12674,4.454833040421793,40.0,0.0
12845,1,2845,[515 318 427 588  79],807,5,12679,4.455024595924104,40.0,0.0
12846,1,2846,[515 318 427 588  79],807,5,12684,4.455216016859852,40.0,0.0
12847,1,2847,[111  15 265 196  56],796,5,12689,4.455407303370786,0.0,0.0
12848,1,2848,[515 318 427 588  79],807,5,12694,4.455598455598456,40.0,0.0
12849,1,2849,[515 318 427 588  79],18,5,12699,4.45578947368421,40.0,0.0
12850,1,2850,[151 588 275  69 144],716,4,12703,4.455629603647843,0.0,20.0
12851,1,2851,[ 64 282 508 125  50],655,2,12705,4.45476858345021,20.0,20.0
12852,1,2852,[515 318 427 588  79],807,5,12710,4.454959691552752,40.0,0.0
12853,1,2853,[515 318 427 588  79],716,5,12715,4.4551506657323054,40.0,0.0
12854,1,2854,[515 318 427 588  79],807,5,12720,4.455341506129598,40.0,0.0
12855,1,2855,[515 318 427 588  79],807,5,12725,4.455532212885154,40.0,0.0
12856,1,2856,[515 318 427 588  79],716,5,12730,4.455722786139307,40.0,0.0
12857,1,2857,[269 117 403  28 215],450,5,12735,4.45591322603219,0.0,0.0
12858,1,2858,[515 318 427 588  79],18,5,12740,4.456103532703742,40.0,0.0
12859,1,2859,[515 318 427 588  79],18,5,12745,4.456293706293707,40.0,0.0
12860,1,2860,[172 204 153  56 197],269,2,12747,4.455435162530584,0.0,0.0
12861,1,2861,[ 96 117 132 496 405],807,4,12751,4.455276030747729,20.0,0.0
12862,1,2862,[515 318 427 588  79],18,5,12756,4.455466294097101,40.0,0.0
12863,1,2863,[515 318 427 588  79],18,5,12761,4.455656424581005,40.0,0.0
12864,1,2864,[515 318 427 588  79],716,5,12766,4.455846422338569,40.0,0.0
12865,1,2865,[515 318 427 588  79],716,5,12771,4.456036287508723,40.0,0.0
12866,1,2866,[515 318 427 588  79],716,5,12776,4.456226020230206,40.0,0.0
12867,1,2867,[127  56 385 678 195],280,3,12779,4.455718270571827,0.0,20.0
12868,1,2868,[234 237 182  22 496],269,2,12781,4.454862321366329,20.0,0.0
12869,1,2869,[135 237  22 496 282],535,2,12783,4.454006968641115,20.0,0.0
12870,1,2870,[174  79  56 603 173],796,5,12788,4.4541971438523165,20.0,0.0
12871,1,2871,[515 318 427 588  79],18,5,12793,4.454387186629527,40.0,0.0
12872,1,2872,[191 210 271 111 258],655,1,12794,4.4531848242255485,0.0,0.0
12873,1,2873,[515 318 427 588  79],807,5,12799,4.453375086986778,40.0,0.0
12874,1,2874,[515 318 427 588  79],18,5,12804,4.453565217391304,40.0,0.0
12875,1,2875,[515 318 427 588  79],18,5,12809,4.453755215577191,40.0,0.0
12876,1,2876,[186 515 132  88 191],655,2,12811,4.452902328814737,0.0,0.0
12877,1,2877,[515 318 427 588  79],18,5,12816,4.453092425295344,40.0,0.0
12878,1,2878,[174 302  56 222 423],450,4,12820,4.452935046891282,0.0,0.0
12879,1,2879,[515 318 427 588  79],716,5,12825,4.453125,40.0,0.0
12880,1,2880,[515 318 427 588  79],716,5,12830,4.453314821242624,40.0,0.0
12881,1,2881,[111 385 655 245 273],796,2,12832,4.452463566967384,0.0,0.0
12882,1,2882,[515 318 427 588  79],716,5,12837,4.452653485952133,40.0,0.0
12883,1,2883,[100  25 151 568 127],256,5,12842,4.452843273231623,0.0,40.0
12884,1,2884,[515 318 427 588  79],18,5,12847,4.4530329289428074,40.0,0.0
12885,1,2885,[121  88  97 313  15],152,5,12852,4.453222453222454,0.0,0.0
12886,1,2886,[515 318 427 588  79],18,5,12857,4.4534118462071355,40.0,0.0
12887,1,2887,[515 318 427 588  79],807,5,12862,4.453601108033241,40.0,0.0
12888,1,2888,[ 79 300 265 132  70],151,5,12867,4.453790238836968,0.0,0.0
12889,1,2889,[515 318 427 588  79],807,5,12872,4.453979238754325,40.0,0.0
12890,1,2890,[515 318 427 588  79],716,5,12877,4.454168107921134,40.0,0.0
12891,1,2891,[515 318 427 588  79],18,5,12882,4.454356846473029,40.0,0.0
12892,1,2892,[496 202 144 655 153],450,5,12887,4.454545454545454,20.0,0.0
12893,1,2893,[423 202 211 546 135],716,3,12890,4.454042847270214,0.0,0.0
12894,1,2894,[515 318 427 588  79],807,5,12895,4.454231433506045,40.0,0.0
12895,1,2895,[216  56 187  98 742],796,4,12899,4.454074585635359,0.0,0.0
12896,1,2896,[180 742 237 588   1],280,4,12903,4.453917846047635,0.0,0.0
12897,1,2897,[515 318 427 588  79],18,5,12908,4.454106280193237,40.0,0.0
12898,1,2898,[515 318 427 588  79],807,5,12913,4.4542945843394275,40.0,0.0
12899,1,2899,[515 318 427 588  79],716,5,12918,4.454482758620689,40.0,0.0
12900,1,2900,[515 318 427 588  79],807,5,12923,4.45467080317132,40.0,0.0
12901,1,2901,[515 318 427 588  79],807,5,12928,4.454858718125431,40.0,0.0
12902,1,2902,[515 318 427 588  79],18,5,12933,4.455046503616948,40.0,0.0
12903,1,2903,[483 185 197 435 175],151,5,12938,4.455234159779614,0.0,0.0
12904,1,2904,[515 318 427 588  79],807,5,12943,4.455421686746988,40.0,0.0
12905,1,2905,[515 318 427 588  79],18,5,12948,4.455609084652443,40.0,0.0
12906,1,2906,[161 211 186  95 179],389,2,12950,4.454764361885105,0.0,0.0
12907,1,2907,[273 483  50  25 197],693,1,12951,4.453576341127923,0.0,20.0
12908,1,2908,[515 318 427 588  79],18,5,12956,4.453764180130629,40.0,0.0
12909,1,2909,[515 318 427 588  79],716,5,12961,4.453951890034364,40.0,0.0
12910,1,2910,[269 187  50 191 100],450,5,12966,4.454139470972175,0.0,40.0
12911,1,2911,[515 318 427 588  79],807,5,12971,4.454326923076923,40.0,0.0
12912,1,2912,[515 318 427 588  79],716,5,12976,4.454514246481291,40.0,0.0
12913,1,2913,[515 318 427 588  79],18,5,12981,4.454701441317776,40.0,0.0
12914,1,2914,[357 228 211 196 318],450,5,12986,4.454888507718697,20.0,0.0
12915,1,2915,[318 197 215  15 200],330,5,12991,4.4550754458161865,20.0,0.0
12916,1,2916,[515 318 427 588  79],18,5,12996,4.455262255742201,40.0,0.0
12917,1,2917,[515 318 427 588  79],807,5,13001,4.455448937628512,40.0,0.0
12918,1,2918,[515 318 427 588  79],18,5,13006,4.4556354916067145,40.0,0.0
12919,1,2919,[515 318 427 588  79],716,5,13011,4.455821917808219,40.0,0.0
12920,1,2920,[515 318 427 588  79],807,5,13016,4.456008216364259,40.0,0.0
12921,1,2921,[515 318 427 588  79],18,5,13021,4.456194387405886,40.0,0.0
12922,1,2922,[515 318 427 588  79],716,5,13026,4.456380431063975,40.0,0.0
12923,1,2923,[515 318 427 588  79],807,5,13031,4.45656634746922,40.0,0.0
12924,1,2924,[168 496  97 265 275],151,5,13036,4.4567521367521366,20.0,20.0
12925,1,2925,[183 597 286 187 202],450,5,13041,4.456937799043062,0.0,20.0
12926,1,2926,[515 318 427 588  79],18,5,13046,4.457123334472156,40.0,0.0
12927,1,2927,[515 318 427 588  79],807,5,13051,4.457308743169399,40.0,0.0
12928,1,2928,[300   8 202  56 275],389,4,13055,4.457152611812905,0.0,20.0
12929,1,2929,[515 318 427 588  79],716,5,13060,4.4573378839590445,40.0,0.0
12930,1,2930,[515 318 427 588  79],716,5,13065,4.457523029682702,40.0,0.0
12931,1,2931,[515 318 427 588  79],18,5,13070,4.457708049113234,40.0,0.0
12932,1,2932,[ 22 202 118 183 288],280,2,13072,4.456870098874872,0.0,0.0
12933,1,2933,[515 318 427 588  79],716,5,13077,4.457055214723926,40.0,0.0
12934,1,2934,[175 302 405  28 318],151,3,13080,4.456558773424191,20.0,0.0
12935,1,2935,[515 318 427 588  79],18,5,13085,4.456743869209809,40.0,0.0
12936,1,2936,[515 318 427 588  79],18,5,13090,4.456928838951311,40.0,0.0
12937,1,2937,[515 318 427 588  79],807,5,13095,4.4571136827774,40.0,0.0
12938,1,2938,[515 318 427 588  79],807,5,13100,4.4572984008166046,40.0,0.0
12939,1,2939,[515 318 427 588  79],716,5,13105,4.457482993197279,40.0,0.0
12940,1,2940,[515 318 427 588  79],716,5,13110,4.4576674600476025,40.0,0.0
12941,1,2941,[ 97  28 234 127  82],457,5,13115,4.457851801495581,0.0,20.0
12942,1,2942,[515 318 427 588  79],716,5,13120,4.458036017669045,40.0,0.0
12943,1,2943,[515 318 427 588  79],716,5,13125,4.458220108695652,40.0,0.0
12944,1,2944,[515 318 427 588  79],807,5,13130,4.458404074702886,40.0,0.0
12945,1,2945,[515 318 427 588  79],716,5,13135,4.458587915818058,40.0,0.0
12946,1,2946,[515 318 427 588  79],18,5,13140,4.458771632168307,40.0,0.0
12947,1,2947,[515 318 427 588  79],18,5,13145,4.458955223880597,40.0,0.0
12948,1,2948,[143 228 288  88 276],655,2,13147,4.458121397083757,0.0,0.0
12949,1,2949,[515 318 427 588  79],807,5,13152,4.458305084745763,40.0,0.0
12950,1,2950,[132 238 357 121 603],716,5,13157,4.458488647915961,20.0,0.0
12951,1,2951,[515 318 427 588  79],807,5,13162,4.458672086720867,40.0,0.0
12952,1,2952,[515 318 427 588  79],716,5,13167,4.458855401286827,40.0,0.0
12953,1,2953,[515 318 427 588  79],807,5,13172,4.459038591740014,40.0,0.0
12954,1,2954,[515 318 427 588  79],18,5,13177,4.45922165820643,40.0,0.0
12955,1,2955,[515 318 427 588  79],807,5,13182,4.459404600811908,40.0,0.0
12956,1,2956,[655  79  22 515  28],655,2,13184,4.458572877916808,0.0,0.0
12957,1,2957,[ 25 222 195 117 186],655,0,13184,4.4570655848546314,0.0,0.0
12958,1,2958,[ 71 678 234 276 471],280,2,13186,4.456235214599527,0.0,0.0
12959,1,2959,[ 88 288 186 111  96],655,0,13186,4.4547297297297295,0.0,0.0
12960,1,2960,[185 172 182 742 197],457,5,13191,4.454913880445796,0.0,0.0
12961,1,2961,[515 318 427 588  79],18,5,13196,4.4550979068197165,40.0,0.0
12962,1,2962,[515 318 427 588  79],716,5,13201,4.455281808977388,40.0,0.0
12963,1,2963,[515 318 427 588  79],18,5,13206,4.455465587044534,40.0,0.0
12964,1,2964,[515 318 427 588  79],18,5,13211,4.455649241146712,40.0,0.0
12965,1,2965,[515 318 427 588  79],18,5,13216,4.455832771409305,40.0,0.0
12966,1,2966,[515 318 427 588  79],18,5,13221,4.456016177957533,40.0,0.0
12967,1,2967,[515 318 427 588  79],716,5,13226,4.456199460916442,40.0,0.0
12968,1,2968,[515 318 427 588  79],716,5,13231,4.4563826204109125,40.0,0.0
12969,1,2969,[515 318 427 588  79],807,5,13236,4.456565656565656,40.0,0.0
12970,1,2970,[515 318 427 588  79],18,5,13241,4.456748569505217,40.0,0.0
12971,1,2971,[161 483 313  12  96],280,4,13245,4.456594885598923,0.0,0.0
12972,1,2972,[515 318 427 588  79],716,5,13250,4.456777665657585,40.0,0.0
12973,1,2973,[  4 301 153   8 111],796,4,13254,4.456624075319435,0.0,0.0
12974,1,2974,[515 318 427 588  79],18,5,13259,4.456806722689076,40.0,0.0
12975,1,2975,[515 318 427 588  79],807,5,13264,4.456989247311828,40.0,0.0
12976,1,2976,[515 318 427 588  79],716,5,13269,4.4571716493113875,40.0,0.0
12977,1,2977,[515 318 427 588  79],18,5,13274,4.4573539288112825,40.0,0.0
12978,1,2978,[515 318 427 588  79],716,5,13279,4.457536085934877,40.0,0.0
12979,1,2979,[222  79  89 403   9],72,2,13281,4.456711409395973,0.0,0.0
12980,1,2980,[318 515 427 588  79],807,5,13286,4.456893659845689,40.0,0.0
12981,1,2981,[289   9  22 125  11],655,0,13286,4.455399061032864,0.0,0.0
12982,1,2982,[216 258 427 127  95],450,4,13290,4.455246396245391,20.0,20.0
12983,1,2983,[515 318 427 588  79],18,5,13295,4.455428954423592,40.0,0.0
12984,1,2984,[515 318 427 588  79],807,5,13300,4.455611390284757,40.0,0.0
12985,1,2985,[515 318 427 588  79],807,5,13305,4.455793703951775,40.0,0.0
12986,1,2986,[234 294 176 183 181],23,1,13306,4.454636759290258,0.0,0.0
12987,1,2987,[515 318 427 588  79],716,5,13311,4.454819277108434,40.0,0.0
12988,1,2988,[515 318 427 588  79],807,5,13316,4.455001672800267,40.0,0.0
12989,1,2989,[  8 216 471  96 234],655,1,13317,4.453846153846154,0.0,0.0
12990,1,2990,[515 318 427 588  79],807,5,13322,4.454028752925443,40.0,0.0
12991,1,2991,[515 318 427 588  79],716,5,13327,4.454211229946524,40.0,0.0
12992,1,2992,[515 318 427 588  79],807,5,13332,4.454393585031741,40.0,0.0
12993,1,2993,[515 318 427 588  79],716,5,13337,4.454575818303273,40.0,0.0
12994,1,2994,[322 132 301 211 186],796,1,13338,4.453422370617696,0.0,0.0
12995,1,2995,[515 318 427 588  79],18,5,13343,4.453604806408545,40.0,0.0
12996,1,2996,[117 234  64 175 118],716,3,13346,4.45311978645312,20.0,0.0
12997,1,2997,[515 318 427 588  79],807,5,13351,4.453302201467645,40.0,0.0
12998,1,2998,[515 318 427 588  79],807,5,13356,4.453484494831611,40.0,0.0
12999,1,2999,[515 318 427 588  79],716,5,13361,4.453666666666667,40.0,0.0
13000,1,3000,[515 318 427 588  79],807,5,13366,4.453848717094302,40.0,0.0
13001,1,3001,[515 318 427 588  79],18,5,13371,4.454030646235843,40.0,0.0
13002,1,3002,[515 318 427 588  79],18,5,13376,4.454212454212454,40.0,0.0
13003,1,3003,[405 313 222 176   8],655,1,13377,4.45306258322237,0.0,0.0
13004,1,3004,[515 318 427 588  79],807,5,13382,4.45324459234609,40.0,0.0
13005,1,3005,[515 318 427 588  79],18,5,13387,4.453426480372588,40.0,0.0
13006,1,3006,[515 318 427 588  79],18,5,13392,4.453608247422681,40.0,0.0
13007,1,3007,[181 143 322 328  11],401,2,13394,4.45279255319149,0.0,0.0
13008,1,3008,[515 318 427 588  79],807,5,13399,4.452974410103025,40.0,0.0
13009,1,3009,[197  28  88 237 172],716,5,13404,4.453156146179402,0.0,0.0
13010,1,3010,[515 318 427 588  79],807,5,13409,4.453337761541016,40.0,0.0
13011,1,3011,[515 318 427 588  79],807,5,13414,4.453519256308101,40.0,0.0
13012,1,3012,[515 318 427 588  79],716,5,13419,4.45370063060073,40.0,0.0
13013,1,3013,[ 88 508  79 655 286],655,1,13420,4.452554744525547,0.0,20.0
13014,1,3014,[515 318 427 588  79],807,5,13425,4.45273631840796,40.0,0.0
13015,1,3015,[515 318 427 588  79],807,5,13430,4.452917771883289,40.0,0.0
13016,1,3016,[515 318 427 588  79],807,5,13435,4.453099105071263,40.0,0.0
13017,1,3017,[515 318 427 588  79],18,5,13440,4.453280318091451,40.0,0.0
13018,1,3018,[161   1 117 238  50],450,5,13445,4.453461411063266,0.0,20.0
13019,1,3019,[269  89 655 143 427],655,3,13448,4.452980132450331,20.0,0.0
13020,1,3020,[515 318 427 588  79],716,5,13453,4.45316120489904,40.0,0.0
13021,1,3021,[515 318 427 588  79],716,5,13458,4.453342157511582,40.0,0.0
13022,1,3022,[515 318 427 588  79],18,5,13463,4.4535229904068805,40.0,0.0
13023,1,3023,[515 318 427 588  79],807,5,13468,4.453703703703703,40.0,0.0
13024,1,3024,[515 318 427 588  79],807,5,13473,4.453884297520661,40.0,0.0
13025,1,3025,[655 118  50 210 357],593,3,13476,4.45340383344349,0.0,20.0
13026,1,3026,[269 216 194 195  88],23,4,13480,4.453254046911133,0.0,0.0
13027,1,3027,[515 318 427 588  79],807,5,13485,4.453434610303831,40.0,0.0
13028,1,3028,[515 318 427 588  79],18,5,13490,4.453615054473423,40.0,0.0
13029,1,3029,[515 318 427 588  79],716,5,13495,4.4537953795379535,40.0,0.0
13030,1,3030,[435 228  69 269  28],655,0,13495,4.452325965028043,0.0,0.0
13031,1,3031,[515 318 427 588  79],807,5,13500,4.452506596306069,40.0,0.0
13032,1,3032,[515 318 427 588  79],18,5,13505,4.452687108473459,40.0,0.0
13033,1,3033,[515 318 427 588  79],716,5,13510,4.452867501647989,40.0,0.0
13034,1,3034,[228 118 132 328 151],450,4,13514,4.452718286655684,0.0,0.0
13035,1,3035,[515 318 427 588  79],807,5,13519,4.452898550724638,40.0,0.0
13036,1,3036,[515 318 427 588  79],716,5,13524,4.4530786960816595,40.0,0.0
13037,1,3037,[ 64 403  82 111 286],655,1,13525,4.4519420671494405,20.0,20.0
13038,1,3038,[655  96 269 496  15],450,4,13529,4.45179335307667,20.0,0.0
13039,1,3039,[  9 238 483 168 172],457,5,13534,4.451973684210526,0.0,0.0
13040,1,3040,[ 69 228  95 197 423],796,4,13538,4.451825057546859,0.0,0.0
13041,1,3041,[515 318 427 588  79],716,5,13543,4.452005259697567,40.0,0.0
13042,1,3042,[515 318 427 588  79],807,5,13548,4.452185343411108,40.0,0.0
13043,1,3043,[144 302 135 238 200],655,3,13551,4.451708278580814,0.0,0.0
13044,1,3044,[222 204 195 117  89],450,4,13555,4.451559934318555,0.0,0.0
13045,1,3045,[179 471 182 161  22],450,5,13560,4.451739986868024,0.0,0.0
13046,1,3046,[475   1 313 153 483],296,5,13565,4.451919921234,0.0,0.0
13047,1,3047,[515 318 427 588  79],807,5,13570,4.452099737532809,40.0,0.0
13048,1,3048,[  4 269 568 228 143],450,4,13574,4.451951459494916,0.0,0.0
13049,1,3049,[515 318 427 588  79],716,5,13579,4.4521311475409835,40.0,0.0
13050,1,3050,[515 318 427 588  79],716,5,13584,4.4523107177974435,40.0,0.0
13051,1,3051,[515 318 427 588  79],716,5,13589,4.452490170380079,40.0,0.0
13052,1,3052,[515 318 427 588  79],716,5,13594,4.45266950540452,40.0,0.0
13053,1,3053,[515 318 427 588  79],807,5,13599,4.452848722986247,40.0,0.0
13054,1,3054,[515 318 427 588  79],18,5,13604,4.453027823240589,40.0,0.0
13055,1,3055,[515 318 427 588  79],807,5,13609,4.453206806282722,40.0,0.0
13056,1,3056,[185 144 238 286 168],796,3,13612,4.452731436048413,0.0,20.0
13057,1,3057,[173 245 216 182  79],450,5,13617,4.4529103989535646,0.0,0.0
13058,1,3058,[515 318 427 588  79],807,5,13622,4.453089244851259,40.0,0.0
13059,1,3059,[151 588 168  70  97],716,5,13627,4.453267973856209,0.0,0.0
13060,1,3060,[515 318 427 588  79],807,5,13632,4.453446586082979,40.0,0.0
13061,1,3061,[515 318 427 588  79],18,5,13637,4.453625081645983,40.0,0.0
13062,1,3062,[515 318 427 588  79],807,5,13642,4.4538034606594845,40.0,0.0
13063,1,3063,[515 318 427 588  79],18,5,13647,4.453981723237598,40.0,0.0
13064,1,3064,[515 318 427 588  79],18,5,13652,4.4541598694942905,40.0,0.0
13065,1,3065,[515 318 427 588  79],18,5,13657,4.454337899543379,40.0,0.0
13066,1,3066,[151  95  12  88 435],18,3,13660,4.453863710466254,0.0,0.0
13067,1,3067,[515 318 427 588  79],807,5,13665,4.454041720990873,40.0,0.0
13068,1,3068,[515 318 427 588  79],716,5,13670,4.454219615509938,40.0,0.0
13069,1,3069,[546  97 195 568 216],256,5,13675,4.454397394136808,0.0,0.0
13070,1,3070,[515 318 427 588  79],716,5,13680,4.454575056984695,40.0,0.0
13071,1,3071,[515 318 427 588  79],716,5,13685,4.454752604166667,40.0,0.0
13072,1,3072,[515 318 427 588  79],807,5,13690,4.454930035795639,40.0,0.0
13073,1,3073,[515 318 427 588  79],807,5,13695,4.455107351984386,40.0,0.0
13074,1,3074,[515 318 427 588  79],807,5,13700,4.455284552845528,40.0,0.0
13075,1,3075,[515 318 427 588  79],807,5,13705,4.455461638491547,40.0,0.0
13076,1,3076,[210   8 435  15 405],269,0,13705,4.454013649658759,0.0,0.0
13077,1,3077,[515 318 427 588  79],18,5,13710,4.454191033138401,40.0,0.0
13078,1,3078,[515 318 427 588  79],807,5,13715,4.454368301396557,40.0,0.0
13079,1,3079,[ 82 234 301   8   4],655,0,13715,4.452922077922078,0.0,0.0
13080,1,3080,[515 318 427 588  79],716,5,13720,4.4530996429730605,40.0,0.0
13081,1,3081,[515 318 427 588  79],18,5,13725,4.453277092796885,40.0,0.0
13082,1,3082,[196 403  97 121 182],796,4,13729,4.453130068115472,0.0,0.0
13083,1,3083,[515 318 427 588  79],807,5,13734,4.453307392996109,40.0,0.0
13084,1,3084,[515 318 427 588  79],807,5,13739,4.453484602917342,40.0,0.0
13085,1,3085,[515 318 427 588  79],807,5,13744,4.453661697990927,40.0,0.0
13086,1,3086,[515 318 427 588  79],716,5,13749,4.4538386783284745,40.0,0.0
13087,1,3087,[194  71 275 216 655],401,3,13752,4.453367875647668,0.0,20.0
13088,1,3088,[  8  50 228 357 265],796,5,13757,4.453544836516672,0.0,20.0
13089,1,3089,[125 135 200  98 202],655,3,13760,4.453074433656958,0.0,0.0
13090,1,3090,[515 318 427 588  79],807,5,13765,4.45325137495956,40.0,0.0
13091,1,3091,[ 88 176   9 127 161],457,5,13770,4.453428201811126,0.0,20.0
13092,1,3092,[515 318 427 588  79],716,5,13775,4.453604914322664,40.0,0.0
13093,1,3093,[515 318 427 588  79],716,5,13780,4.453781512605042,40.0,0.0
13094,1,3094,[515 318 427 588  79],18,5,13785,4.453957996768982,40.0,0.0
13095,1,3095,[515 318 427 588  79],18,5,13790,4.454134366925064,40.0,0.0
13096,1,3096,[286  56 427 603  69],18,3,13793,4.453664836938973,40.0,20.0
13097,1,3097,[515 318 427 588  79],807,5,13798,4.453841187863137,40.0,0.0
13098,1,3098,[515 318 427 588  79],716,5,13803,4.454017424975799,40.0,0.0
13099,1,3099,[515 318 427 588  79],18,5,13808,4.454193548387097,40.0,0.0
13100,1,3100,[ 69 195 196 191  88],450,5,13813,4.45436955820703,0.0,0.0
13101,1,3101,[515 318 427 588  79],807,5,13818,4.454545454545454,40.0,0.0
13102,1,3102,[515 318 427 588  79],18,5,13823,4.454721237512085,40.0,0.0
13103,1,3103,[515 318 427 588  79],716,5,13828,4.454896907216495,40.0,0.0
13104,1,3104,[125 288  11 405  28],292,2,13830,4.454106280193237,0.0,0.0
13105,1,3105,[515 318 427 588  79],716,5,13835,4.45428203477141,40.0,0.0
13106,1,3106,[276 508  71  96 111],280,4,13839,4.454135822336659,0.0,0.0
13107,1,3107,[515 318 427 588  79],18,5,13844,4.454311454311454,40.0,0.0
13108,1,3108,[ 88 588 194 121 181],457,5,13849,4.454486973303313,0.0,0.0
13109,1,3109,[268 286 282 427  96],655,1,13850,4.453376205787781,20.0,20.0
13110,1,3110,[515 318 427 588  79],716,5,13855,4.453551912568306,40.0,0.0
13111,1,3111,[515 318 427 588  79],18,5,13860,4.453727506426735,40.0,0.0
13112,1,3112,[515 318 427 588  79],716,5,13865,4.453902987471892,40.0,0.0
13113,1,3113,[210 403 228 215   8],577,3,13868,4.453436095054593,0.0,0.0
13114,1,3114,[515 318 427 588  79],18,5,13873,4.453611556982343,40.0,0.0
13115,1,3115,[515 318 427 588  79],716,5,13878,4.453786906290116,40.0,0.0
13116,1,3116,[546 144  98 258  79],693,4,13882,4.453641321783766,0.0,0.0
13117,1,3117,[515 318 427 588  79],716,5,13887,4.453816549069916,40.0,0.0
13118,1,3118,[508 273 125 289 197],655,1,13888,4.452709201667201,0.0,0.0
13119,1,3119,[ 15  69 118 153 216],450,3,13891,4.45224358974359,0.0,0.0
13120,1,3120,[515 318 427 588  79],807,5,13896,4.452419096443448,40.0,0.0
13121,1,3121,[515 318 427 588  79],716,5,13901,4.452594490711083,40.0,0.0
13122,1,3122,[515 318 427 588  79],716,5,13906,4.452769772654499,40.0,0.0
13123,1,3123,[175 216 185  89 135],269,3,13909,4.452304737516005,0.0,0.0
13124,1,3124,[515 318 427 588  79],18,5,13914,4.45248,40.0,0.0
13125,1,3125,[117 603 204 357 328],450,5,13919,4.452655150351887,20.0,0.0
13126,1,3126,[515 318 427 588  79],807,5,13924,4.452830188679245,40.0,0.0
13127,1,3127,[515 318 427 588  79],18,5,13929,4.453005115089514,40.0,0.0
13128,1,3128,[515 318 427 588  79],18,5,13934,4.4531799296899965,40.0,0.0
13129,1,3129,[515 318 427 588  79],18,5,13939,4.4533546325878595,40.0,0.0
13130,1,3130,[118 216 258 185 282],693,4,13943,4.453209837112744,0.0,0.0
13131,1,3131,[515 318 427 588  79],807,5,13948,4.453384418901661,40.0,0.0
13132,1,3132,[181 435 179 286  64],655,2,13950,4.452601340568146,20.0,20.0
13133,1,3133,[515 318 427 588  79],18,5,13955,4.452776005105297,40.0,0.0
13134,1,3134,[515 318 427 588  79],807,5,13960,4.4529505582137165,40.0,0.0
13135,1,3135,[515 318 427 588  79],716,5,13965,4.453125,40.0,0.0
13136,1,3136,[423 127 179 318  96],457,5,13970,4.453299330570609,20.0,20.0
13137,1,3137,[202 200  25 183 187],504,2,13972,4.452517527087317,0.0,0.0
13138,1,3138,[515 318 427 588  79],18,5,13977,4.4526919401083145,40.0,0.0
13139,1,3139,[515 318 427 588  79],716,5,13982,4.452866242038216,40.0,0.0
13140,1,3140,[515 318 427 588  79],807,5,13987,4.453040432983126,40.0,0.0
13141,1,3141,[515 318 427 588  79],716,5,13992,4.453214513049013,40.0,0.0
13142,1,3142,[515 318 427 588  79],716,5,13997,4.453388482341712,40.0,0.0
13143,1,3143,[515 318 427 588  79],807,5,14002,4.453562340966921,40.0,0.0
13144,1,3144,[237 313 196  97 202],639,0,14002,4.4521462639109695,0.0,0.0
13145,1,3145,[515 318 427 588  79],716,5,14007,4.452320406865861,40.0,0.0
13146,1,3146,[195 405 403 191 294],457,4,14011,4.452176676199555,0.0,0.0
13147,1,3147,[515 318 427 588  79],18,5,14016,4.452350698856417,40.0,0.0
13148,1,3148,[385 258  22 483 301],796,4,14020,4.452207049857098,0.0,0.0
13149,1,3149,[515 318 427 588  79],807,5,14025,4.4523809523809526,40.0,0.0
13150,1,3150,[515 318 427 588  79],807,5,14030,4.452554744525547,40.0,0.0
13151,1,3151,[515 318 427 588  79],716,5,14035,4.4527284263959395,40.0,0.0
13152,1,3152,[515 318 427 588  79],716,5,14040,4.45290199809705,40.0,0.0
13153,1,3153,[515 318 427 588  79],716,5,14045,4.453075459733672,40.0,0.0
13154,1,3154,[515 318 427 588  79],716,5,14050,4.45324881141046,40.0,0.0
13155,1,3155,[515 318 427 588  79],716,5,14055,4.4534220532319395,40.0,0.0
13156,1,3156,[515 318 427 588  79],807,5,14060,4.453595185302502,40.0,0.0
13157,1,3157,[ 15 742 588 153 200],450,3,14063,4.453134895503483,0.0,0.0
13158,1,3158,[515 318 427 588  79],18,5,14068,4.453308008863565,40.0,0.0
13159,1,3159,[515 318 427 588  79],807,5,14073,4.453481012658228,40.0,0.0
13160,1,3160,[515 318 427 588  79],807,5,14078,4.453653906991458,40.0,0.0
13161,1,3161,[515 318 427 588  79],716,5,14083,4.45382669196711,40.0,0.0
13162,1,3162,[515 318 427 588  79],716,5,14088,4.453999367688903,40.0,0.0
13163,1,3163,[515 318 427 588  79],716,5,14093,4.45417193426043,40.0,0.0
13164,1,3164,[515 318 427 588  79],18,5,14098,4.45434439178515,40.0,0.0
13165,1,3165,[286 435 357 180  11],11,3,14101,4.453885028427037,0.0,20.0
13166,1,3166,[515 318 427 588  79],716,5,14106,4.454057467634986,40.0,0.0
13167,1,3167,[742 161 127  15  82],450,3,14109,4.453598484848484,0.0,20.0
13168,1,3168,[228 132 161 194 275],23,4,14113,4.453455348690438,0.0,20.0
13169,1,3169,[515 318 427 588  79],18,5,14118,4.453627760252366,40.0,0.0
13170,1,3170,[515 318 427 588  79],716,5,14123,4.453800063071586,40.0,0.0
13171,1,3171,[515 318 427 588  79],18,5,14128,4.453972257250946,40.0,0.0
13172,1,3172,[515 318 427 588  79],18,5,14133,4.454144342893161,40.0,0.0
13173,1,3173,[  8 195 135  64  56],269,3,14136,4.453686200378072,20.0,0.0
13174,1,3174,[271 196 328  97  82],655,0,14136,4.452283464566929,0.0,0.0
13175,1,3175,[222 211  97 471 655],786,5,14141,4.452455919395466,0.0,0.0
13176,1,3176,[ 79 196 748 179  70],450,5,14146,4.452628265659427,0.0,0.0
13177,1,3177,[515 318 427 588  79],18,5,14151,4.4528005034612965,40.0,0.0
13178,1,3178,[515 318 427 588  79],716,5,14156,4.452972632903429,40.0,0.0
13179,1,3179,[210 508 127 186 275],296,3,14159,4.45251572327044,0.0,40.0
13180,1,3180,[515 318 427 588  79],18,5,14164,4.452687834014461,40.0,0.0
13181,1,3181,[515 318 427 588  79],807,5,14169,4.452859836580767,40.0,0.0
13182,1,3182,[515 318 427 588  79],807,5,14174,4.453031731071317,40.0,0.0
13183,1,3183,[515 318 427 588  79],716,5,14179,4.45320351758794,40.0,0.0
13184,1,3184,[515 318 427 588  79],807,5,14184,4.453375196232339,40.0,0.0
13185,1,3185,[515 318 427 588  79],807,5,14189,4.453546767106089,40.0,0.0
13186,1,3186,[515 318 427 588  79],716,5,14194,4.453718230310637,40.0,0.0
13187,1,3187,[515 318 427 588  79],716,5,14199,4.453889585947302,40.0,0.0
13188,1,3188,[515 318 427 588  79],807,5,14204,4.4540608341172785,40.0,0.0
13189,1,3189,[515 318 427 588  79],18,5,14209,4.45423197492163,40.0,0.0
13190,1,3190,[515 318 427 588  79],18,5,14214,4.4544030084612976,40.0,0.0
13191,1,3191,[144 135 471 282 211],693,3,14217,4.453947368421052,0.0,0.0
13192,1,3192,[515 318 427 588  79],807,5,14222,4.454118383964923,40.0,0.0
13193,1,3193,[515 318 427 588  79],807,5,14227,4.454289292423294,40.0,0.0
13194,1,3194,[515 318 427 588  79],807,5,14232,4.454460093896714,40.0,0.0
13195,1,3195,[515 318 427 588  79],18,5,14237,4.454630788485607,40.0,0.0
13196,1,3196,[172  96 742  12 127],693,3,14240,4.454175789802941,0.0,20.0
13197,1,3197,[515 318 427 588  79],807,5,14245,4.454346466541589,40.0,0.0
13198,1,3198,[ 11 179 168  82   1],577,3,14248,4.453891841200375,0.0,0.0
13199,1,3199,[515 318 427 588  79],807,5,14253,4.4540625,40.0,0.0
13200,1,3200,[515 318 427 588  79],18,5,14258,4.454233052171197,40.0,0.0
13201,1,3201,[515 318 427 588  79],807,5,14263,4.454403497813867,40.0,0.0
13202,1,3202,[515 318 427 588  79],807,5,14268,4.4545738370277865,40.0,0.0
13203,1,3203,[515 318 427 588  79],716,5,14273,4.454744069912609,40.0,0.0
13204,1,3204,[127 748 403  71 258],796,5,14278,4.454914196567863,0.0,20.0
13205,1,3205,[515 318 427 588  79],18,5,14283,4.455084217092951,40.0,0.0
13206,1,3206,[515 318 427 588  79],18,5,14288,4.455254131587153,40.0,0.0
13207,1,3207,[515 318 427 588  79],716,5,14293,4.455423940149626,40.0,0.0
13208,1,3208,[515 318 427 588  79],18,5,14298,4.455593642879402,40.0,0.0
13209,1,3209,[515 318 427 588  79],716,5,14303,4.455763239875389,40.0,0.0
13210,1,3210,[515 318 427 588  79],807,5,14308,4.455932731236375,40.0,0.0
13211,1,3211,[515 318 427 588  79],18,5,14313,4.456102117061021,40.0,0.0
13212,1,3212,[196 195 234 603  64],450,4,14317,4.455960161842515,40.0,0.0
13213,1,3213,[100 176  15 191 282],236,3,14320,4.455507156191661,0.0,20.0
13214,1,3214,[515 318 427 588  79],716,5,14325,4.455676516329705,40.0,0.0
13215,1,3215,[515 318 427 588  79],716,5,14330,4.455845771144278,40.0,0.0
13216,1,3216,[515 318 427 588  79],807,5,14335,4.456014920733603,40.0,0.0
13217,1,3217,[515 318 427 588  79],18,5,14340,4.456183965195774,40.0,0.0
13218,1,3218,[515 318 427 588  79],807,5,14345,4.456352904628766,40.0,0.0
13219,1,3219,[ 96 215 185  50 100],450,5,14350,4.456521739130435,0.0,40.0
13220,1,3220,[210  56 228 403 182],280,1,14351,4.455448618441478,0.0,0.0
13221,1,3221,[515 318 427 588  79],807,5,14356,4.455617628801987,40.0,0.0
13222,1,3222,[ 56 135 117  88  89],450,4,14360,4.455476264349985,0.0,0.0
13223,1,3223,[515 318 427 588  79],716,5,14365,4.455645161290323,40.0,0.0
13224,1,3224,[385 202 294   1 403],450,5,14370,4.455813953488372,0.0,0.0
13225,1,3225,[515 318 427 588  79],716,5,14375,4.455982641041538,40.0,0.0
13226,1,3226,[515 318 427 588  79],18,5,14380,4.456151224047103,40.0,0.0
13227,1,3227,[515 318 427 588  79],807,5,14385,4.45631970260223,40.0,0.0
13228,1,3228,[ 96 153   7 546 132],23,4,14389,4.456178383400434,0.0,0.0
13229,1,3229,[357  22 117 588   1],716,5,14394,4.4563467492260065,0.0,0.0
13230,1,3230,[318 515 427 588  79],18,5,14399,4.456515010832559,40.0,0.0
13231,1,3231,[318 515 427 588  79],807,5,14404,4.4566831683168315,40.0,0.0
13232,1,3232,[318 515 427 588  79],716,5,14409,4.456851221775441,40.0,0.0
13233,1,3233,[181 238 187 132  88],18,3,14412,4.456400742115028,0.0,0.0
13234,1,3234,[318 515 427 588  79],807,5,14417,4.456568778979907,40.0,0.0
13235,1,3235,[318 515 427 588  79],807,5,14422,4.456736711990112,40.0,0.0
13236,1,3236,[318 515 427 588  79],716,5,14427,4.456904541241891,40.0,0.0
13237,1,3237,[234 168 121 144 173],5,2,14429,4.456145768993205,0.0,0.0
13238,1,3238,[318 515 427 588  79],807,5,14434,4.456313677060821,40.0,0.0
13239,1,3239,[318 515 427 588  79],18,5,14439,4.4564814814814815,40.0,0.0
13240,1,3240,[318 515 427 588  79],18,5,14444,4.456649182351126,40.0,0.0
13241,1,3241,[318 515 427 588  79],716,5,14449,4.456816779765576,40.0,0.0
13242,1,3242,[ 95 191 196 202 216],716,5,14454,4.456984273820536,0.0,0.0
13243,1,3243,[318 515 427 588  79],18,5,14459,4.45715166461159,40.0,0.0
13244,1,3244,[318 515 427 588  79],807,5,14464,4.457318952234206,40.0,0.0
13245,1,3245,[318 515 427 588  79],18,5,14469,4.457486136783734,40.0,0.0
13246,1,3246,[ 79  97  82  88 204],716,5,14474,4.457653218355405,0.0,0.0
13247,1,3247,[318 515 427 588  79],716,5,14479,4.457820197044335,40.0,0.0
13248,1,3248,[318 515 427 588  79],807,5,14484,4.457987072945522,40.0,0.0
13249,1,3249,[318 515 427 588  79],18,5,14489,4.458153846153846,40.0,0.0
13250,1,3250,[318 515 427 588  79],18,5,14494,4.458320516764073,40.0,0.0
13251,1,3251,[318 515 427 588  79],18,5,14499,4.458487084870849,40.0,0.0
13252,1,3252,[318 515 427 588  79],716,5,14504,4.458653550568706,40.0,0.0
13253,1,3253,[318 515 427 588  79],18,5,14509,4.458819913952059,40.0,0.0
13254,1,3254,[143  25 111 483 286],389,1,14510,4.457757296466974,0.0,20.0
13255,1,3255,[318 515 427 588  79],716,5,14515,4.457923832923833,40.0,0.0
13256,1,3256,[385  69 322 435 568],450,5,14520,4.458090267116979,0.0,0.0
13257,1,3257,[318  97 282  28 288],457,5,14525,4.458256599140577,20.0,0.0
13258,1,3258,[318 515 427 588  79],18,5,14530,4.458422829088677,40.0,0.0
13259,1,3259,[318 515 427 588  79],716,5,14535,4.458588957055214,40.0,0.0
13260,1,3260,[318 515 427 588  79],18,5,14540,4.458754983134008,40.0,0.0
13261,1,3261,[318 515 427 588  79],716,5,14545,4.4589209074187615,40.0,0.0
13262,1,3262,[318 515 427 588  79],716,5,14550,4.459086730003064,40.0,0.0
13263,1,3263,[318 515 427 588  79],807,5,14555,4.459252450980392,40.0,0.0
13264,1,3264,[318 515 427 588  79],716,5,14560,4.459418070444104,40.0,0.0
13265,1,3265,[318 515 427 588  79],18,5,14565,4.459583588487447,40.0,0.0
13266,1,3266,[318 515 427 588  79],807,5,14570,4.459749005203551,40.0,0.0
13267,1,3267,[318 515 427 588  79],716,5,14575,4.459914320685434,40.0,0.0
13268,1,3268,[318 515 427 588  79],18,5,14580,4.460079535026002,40.0,0.0
13269,1,3269,[318 515 427 588  79],18,5,14585,4.460244648318043,40.0,0.0
13270,1,3270,[318 515 427 588  79],18,5,14590,4.460409660654234,40.0,0.0
13271,1,3271,[186 117 174  56 179],655,1,14591,4.4593520782396086,0.0,0.0
13272,1,3272,[ 71 357 603 302  11],401,2,14593,4.458600672166209,20.0,0.0
13273,1,3273,[318 515 427 588  79],807,5,14598,4.458766035430666,40.0,0.0
13274,1,3274,[318 515 427 588  79],807,5,14603,4.458931297709924,40.0,0.0
13275,1,3275,[186  98   1 322 180],796,1,14604,4.457875457875458,0.0,0.0
13276,1,3276,[318 515 427 588  79],807,5,14609,4.458040891058896,40.0,0.0
13277,1,3277,[357 185  50 265  15],796,5,14614,4.458206223306894,0.0,20.0
13278,1,3278,[118 173 508   7 403],280,1,14615,4.457151570600793,0.0,0.0
13279,1,3279,[318 515 427 588  79],716,5,14620,4.4573170731707314,40.0,0.0
13280,1,3280,[151 121  95 269 508],344,4,14624,4.457177689728741,0.0,0.0
13281,1,3281,[318 515 427 588  79],716,5,14629,4.4573430834856795,40.0,0.0
13282,1,3282,[195 194 235  71 121],450,2,14631,4.456594578129759,0.0,0.0
13283,1,3283,[318 515 427 588  79],807,5,14636,4.456760048721072,40.0,0.0
13284,1,3284,[318 515 427 588  79],807,5,14641,4.456925418569254,40.0,0.0
13285,1,3285,[357 186 245  50 143],504,3,14644,4.456482045039562,0.0,20.0
13286,1,3286,[318 515 427 588  79],807,5,14649,4.456647398843931,40.0,0.0
13287,1,3287,[318 515 427 588  79],716,5,14654,4.456812652068127,40.0,0.0
13288,1,3288,[318 515 427 588  79],18,5,14659,4.456977804803892,40.0,0.0
13289,1,3289,[423 216 357 100 176],457,5,14664,4.457142857142857,0.0,20.0
13290,1,3290,[204 100 153 483 180],269,2,14666,4.4563962321482835,0.0,20.0
13291,1,3291,[515 318 427 588  79],807,5,14671,4.456561360874848,40.0,0.0
13292,1,3292,[515 318 427 588  79],18,5,14676,4.456726389310659,40.0,0.0
13293,1,3293,[515 318 427 588  79],716,5,14681,4.456891317547055,40.0,0.0
13294,1,3294,[515 318 427 588  79],807,5,14686,4.457056145675265,40.0,0.0
13295,1,3295,[515 318 427 588  79],18,5,14691,4.457220873786408,40.0,0.0
13296,1,3296,[515 318 427 588  79],716,5,14696,4.45738550197149,40.0,0.0
13297,1,3297,[ 98  22 215  11 173],280,3,14699,4.4569436021831415,0.0,0.0
13298,1,3298,[515 318 427 588  79],18,5,14704,4.457108214610488,40.0,0.0
13299,1,3299,[515 318 427 588  79],807,5,14709,4.457272727272727,40.0,0.0
13300,1,3300,[515 318 427 588  79],18,5,14714,4.457437140260527,40.0,0.0
13301,1,3301,[515 318 427 588  79],716,5,14719,4.457601453664446,40.0,0.0
13302,1,3302,[515 318 427 588  79],716,5,14724,4.4577656675749315,40.0,0.0
13303,1,3303,[216 655 322  82 180],450,4,14728,4.4576271186440675,0.0,0.0
13304,1,3304,[568 257 508 182 172],655,2,14730,4.4568835098335855,0.0,0.0
13305,1,3305,[173 483  98 151 603],911,3,14733,4.456442831215971,20.0,0.0
13306,1,3306,[318 515 427 588  79],716,5,14738,4.456607196855156,40.0,0.0
13307,1,3307,[318 515 427 588  79],716,5,14743,4.4567714631197095,40.0,0.0
13308,1,3308,[286 257  71 183 185],796,4,14747,4.456633423995164,0.0,20.0
13309,1,3309,[318 515 427 588  79],18,5,14752,4.456797583081571,40.0,0.0
13310,1,3310,[318 515 427 588  79],807,5,14757,4.456961643008155,40.0,0.0
13311,1,3311,[318 515 427 588  79],18,5,14762,4.457125603864735,40.0,0.0
13312,1,3312,[318 515 427 588  79],716,5,14767,4.45728946574102,40.0,0.0
13313,1,3313,[318 515 427 588  79],716,5,14772,4.457453228726615,40.0,0.0
13314,1,3314,[318 515 427 588  79],18,5,14777,4.457616892911011,40.0,0.0
13315,1,3315,[215 245  89  82 328],796,3,14780,4.457177322074789,0.0,0.0
13316,1,3316,[175 182  88  89   1],18,3,14783,4.456738016279771,0.0,0.0
13317,1,3317,[328  97 742   4 135],655,1,14784,4.455696202531645,0.0,0.0
13318,1,3318,[318 515 427 588  79],18,5,14789,4.455860198855077,40.0,0.0
13319,1,3319,[318 515 427 588  79],18,5,14794,4.456024096385542,40.0,0.0
13320,1,3320,[318 515 427 588  79],807,5,14799,4.4561878952122855,40.0,0.0
13321,1,3321,[318 515 427 588  79],716,5,14804,4.456351595424443,40.0,0.0
13322,1,3322,[318 515 427 588  79],18,5,14809,4.456515197111044,40.0,0.0
13323,1,3323,[121 471  88  70 748],401,3,14812,4.456077015643802,0.0,0.0
13324,1,3324,[222 289 546 183 161],693,0,14812,4.454736842105263,0.0,0.0
13325,1,3325,[153 282  12  64 161],450,5,14817,4.454900781719783,20.0,0.0
13326,1,3326,[515 318 427 588  79],716,5,14822,4.455064622783288,40.0,0.0
13327,1,3327,[515 318 427 588  79],716,5,14827,4.455228365384615,40.0,0.0
13328,1,3328,[515 318 427 588  79],807,5,14832,4.455392009612496,40.0,0.0
13329,1,3329,[515 318 427 588  79],18,5,14837,4.455555555555556,40.0,0.0
13330,1,3330,[515 318 427 588  79],18,5,14842,4.4557190033023115,40.0,0.0
13331,1,3331,[515 318 427 588  79],716,5,14847,4.455882352941177,40.0,0.0
13332,1,3332,[515 318 427 588  79],18,5,14852,4.456045604560456,40.0,0.0
13333,1,3333,[202 234 186 276  50],786,3,14855,4.455608878224355,0.0,20.0
13334,1,3334,[405 597 385 328 117],796,5,14860,4.455772113943029,0.0,0.0
13335,1,3335,[515 318 427 588  79],716,5,14865,4.455935251798561,40.0,0.0
13336,1,3336,[ 89 403 385 655 202],796,4,14869,4.455798621516332,0.0,0.0
13337,1,3337,[ 98  82 588 204 222],716,5,14874,4.455961653684842,0.0,0.0
13338,1,3338,[181  96 211 471 185],693,2,14876,4.455226115603474,0.0,0.0
13339,1,3339,[515 318 427 588  79],716,5,14881,4.455389221556886,40.0,0.0
13340,1,3340,[385 187 276  15 186],786,3,14884,4.45495360670458,0.0,0.0
13341,1,3341,[515 318 427 588  79],716,5,14889,4.455116696588869,40.0,0.0
13342,1,3342,[515 318 427 588  79],716,5,14894,4.455279688902183,40.0,0.0
13343,1,3343,[515 318 427 588  79],716,5,14899,4.455442583732057,40.0,0.0
13344,1,3344,[515 318 427 588  79],807,5,14904,4.4556053811659195,40.0,0.0
13345,1,3345,[515 318 427 588  79],716,5,14909,4.455768081291094,40.0,0.0
13346,1,3346,[515 318 427 588  79],807,5,14914,4.455930684194802,40.0,0.0
13347,1,3347,[515 318 427 588  79],716,5,14919,4.456093189964157,40.0,0.0
13348,1,3348,[515 318 427 588  79],716,5,14924,4.456255598686175,40.0,0.0
13349,1,3349,[515 318 427 588  79],807,5,14929,4.456417910447761,40.0,0.0
13350,1,3350,[515 318 427 588  79],18,5,14934,4.456580125335721,40.0,0.0
13351,1,3351,[ 98 191 496 176 172],269,3,14937,4.456145584725537,20.0,0.0
13352,1,3352,[515 318 427 588  79],807,5,14942,4.456307784073964,40.0,0.0
13353,1,3353,[515 318 427 588  79],716,5,14947,4.456469886702445,40.0,0.0
13354,1,3354,[471 121  96 282 405],450,4,14951,4.456333830104322,0.0,0.0
13355,1,3355,[515 318 427 588  79],716,5,14956,4.456495828367104,40.0,0.0
13356,1,3356,[515 318 427 588  79],807,5,14961,4.456657730116175,40.0,0.0
13357,1,3357,[515 318 427 588  79],18,5,14966,4.45681953543776,40.0,0.0
13358,1,3358,[515 318 427 588  79],716,5,14971,4.456981244417982,40.0,0.0
13359,1,3359,[435 118 216 200 161],450,3,14974,4.456547619047619,0.0,0.0
13360,1,3360,[153 191 427 271 195],796,5,14979,4.456709312704552,20.0,0.0
13361,1,3361,[515 318 427 588  79],18,5,14984,4.456870910172516,40.0,0.0
13362,1,3362,[515 318 427 588  79],716,5,14989,4.457032411537318,40.0,0.0
13363,1,3363,[515 318 427 588  79],716,5,14994,4.457193816884661,40.0,0.0
13364,1,3364,[515 318 427 588  79],18,5,14999,4.457355126300149,40.0,0.0
13365,1,3365,[515 318 427 588  79],716,5,15004,4.457516339869281,40.0,0.0
13366,1,3366,[515 318 427 588  79],18,5,15009,4.457677457677458,40.0,0.0
13367,1,3367,[515 318 427 588  79],716,5,15014,4.457838479809976,40.0,0.0
13368,1,3368,[515 318 427 588  79],807,5,15019,4.457999406352033,40.0,0.0
13369,1,3369,[515 318 427 588  79],18,5,15024,4.458160237388724,40.0,0.0
13370,1,3370,[515 318 427 588  79],807,5,15029,4.458320973005043,40.0,0.0
13371,1,3371,[174 191 276 143 568],655,3,15032,4.457888493475682,0.0,0.0
13372,1,3372,[515 318 427 588  79],807,5,15037,4.458049214349244,40.0,0.0
13373,1,3373,[515 318 427 588  79],716,5,15042,4.458209839952579,40.0,0.0
13374,1,3374,[323 245 568 216   7],256,5,15047,4.45837037037037,0.0,0.0
13375,1,3375,[515 318 427 588  79],807,5,15052,4.458530805687204,40.0,0.0
13376,1,3376,[515 318 427 588  79],716,5,15057,4.458691145987563,40.0,0.0
13377,1,3377,[515 318 427 588  79],807,5,15062,4.458851391355831,40.0,0.0
13378,1,3378,[515 318 427 588  79],18,5,15067,4.459011541876294,40.0,0.0
13379,1,3379,[515 318 427 588  79],18,5,15072,4.459171597633136,40.0,0.0
13380,1,3380,[515 318 427 588  79],716,5,15077,4.45933155871044,40.0,0.0
13381,1,3381,[515 318 427 588  79],716,5,15082,4.459491425192194,40.0,0.0
13382,1,3382,[515 318 427 588  79],716,5,15087,4.459651197162282,40.0,0.0
13383,1,3383,[515 318 427 588  79],716,5,15092,4.459810874704492,40.0,0.0
13384,1,3384,[ 79 182 172  70 204],535,2,15094,4.4590841949778435,0.0,0.0
13385,1,3385,[515 318 427 588  79],18,5,15099,4.459243945658594,40.0,0.0
13386,1,3386,[515 318 427 588  79],716,5,15104,4.459403602007677,40.0,0.0
13387,1,3387,[515 318 427 588  79],807,5,15109,4.459563164108618,40.0,0.0
13388,1,3388,[515 318 427 588  79],807,5,15114,4.459722632044851,40.0,0.0
13389,1,3389,[471 153  70 269 496],535,5,15119,4.459882005899705,20.0,0.0
13390,1,3390,[515 318 427 588  79],716,5,15124,4.4600412857564145,40.0,0.0
13391,1,3391,[121  95 328 322  22],450,3,15127,4.459610849056604,0.0,0.0
13392,1,3392,[ 12 185  82 318  96],796,4,15131,4.459475390509874,20.0,0.0
13393,1,3393,[515 318 427 588  79],716,5,15136,4.459634649381261,40.0,0.0
13394,1,3394,[515 318 427 588  79],716,5,15141,4.45979381443299,40.0,0.0
13395,1,3395,[ 96   7 195 228  25],256,4,15145,4.459658421672556,0.0,0.0
13396,1,3396,[515 318 427 588  79],807,5,15150,4.459817486017074,40.0,0.0
13397,1,3397,[515 318 427 588  79],18,5,15155,4.459976456739258,40.0,0.0
13398,1,3398,[515 318 427 588  79],716,5,15160,4.460135333921742,40.0,0.0
13399,1,3399,[515 318 427 588  79],18,5,15165,4.4602941176470585,40.0,0.0
13400,1,3400,[515 318 427 588  79],18,5,15170,4.4604528079976475,40.0,0.0
13401,1,3401,[515 318 427 588  79],716,5,15175,4.460611405055849,40.0,0.0
13402,1,3402,[183 111  28 121  25],457,4,15179,4.460476050543638,0.0,0.0
13403,1,3403,[515 318 427 588  79],807,5,15184,4.460634547591069,40.0,0.0
13404,1,3404,[515 318 427 588  79],18,5,15189,4.46079295154185,40.0,0.0
13405,1,3405,[515 318 427 588  79],716,5,15194,4.46095126247798,40.0,0.0
13406,1,3406,[ 69 237 273 294 403],450,4,15198,4.460815967126504,0.0,0.0
13407,1,3407,[515 318 427 588  79],716,5,15203,4.460974178403756,40.0,0.0
13408,1,3408,[515 318 427 588  79],716,5,15208,4.4611322968612495,40.0,0.0
13409,1,3409,[ 98 181 275 286 568],796,4,15212,4.46099706744868,0.0,40.0
13410,1,3410,[515 318 427 588  79],716,5,15217,4.461155086484902,40.0,0.0
13411,1,3411,[515 318 427 588  79],18,5,15222,4.461313012895662,40.0,0.0
13412,1,3412,[  1 301 748 216 238],450,5,15227,4.461470846762379,0.0,0.0
13413,1,3413,[515 318 427 588  79],716,5,15232,4.4616285881663735,40.0,0.0
13414,1,3414,[515 318 427 588  79],18,5,15237,4.461786237188873,40.0,0.0
13415,1,3415,[515 318 427 588  79],807,5,15242,4.461943793911007,40.0,0.0
13416,1,3416,[515 318 427 588  79],716,5,15247,4.4621012584138136,40.0,0.0
13417,1,3417,[515 318 427 588  79],18,5,15252,4.462258630778233,40.0,0.0
13418,1,3418,[515 318 427 588  79],716,5,15257,4.462415911085112,40.0,0.0
13419,1,3419,[515 318 427 588  79],18,5,15262,4.462573099415205,40.0,0.0
13420,1,3420,[515 318 427 588  79],18,5,15267,4.462730195849167,40.0,0.0
13421,1,3421,[515 318 427 588  79],716,5,15272,4.462887200467563,40.0,0.0
13422,1,3422,[216 300 151 427  79],389,3,15275,4.46245983055799,20.0,0.0
13423,1,3423,[515 318 427 588  79],18,5,15280,4.462616822429907,40.0,0.0
13424,1,3424,[515 318 427 588  79],807,5,15285,4.4627737226277375,40.0,0.0
13425,1,3425,[515 318 427 588  79],18,5,15290,4.462930531231757,40.0,0.0
13426,1,3426,[515 318 427 588  79],18,5,15295,4.4630872483221475,40.0,0.0
13427,1,3427,[515 318 427 588  79],807,5,15300,4.463243873978996,40.0,0.0
13428,1,3428,[515 318 427 588  79],807,5,15305,4.463400408282298,40.0,0.0
13429,1,3429,[515 318 427 588  79],716,5,15310,4.463556851311953,40.0,0.0
13430,1,3430,[515 318 427 588  79],18,5,15315,4.46371320314777,40.0,0.0
13431,1,3431,[515 318 427 588  79],716,5,15320,4.463869463869464,40.0,0.0
13432,1,3432,[318 210 215 180 222],796,3,15323,4.463443052723566,20.0,0.0
13433,1,3433,[515 318 427 588  79],716,5,15328,4.463599301106581,40.0,0.0
13434,1,3434,[515 318 427 588  79],18,5,15333,4.463755458515283,40.0,0.0
13435,1,3435,[515 318 427 588  79],716,5,15338,4.463911525029103,40.0,0.0
13436,1,3436,[515 318 427 588  79],716,5,15343,4.464067500727379,40.0,0.0
13437,1,3437,[515 318 427 588  79],807,5,15348,4.464223385689354,40.0,0.0
13438,1,3438,[515 318 427 588  79],716,5,15353,4.464379179994184,40.0,0.0
13439,1,3439,[515 318 427 588  79],807,5,15358,4.464534883720931,40.0,0.0
13440,1,3440,[515 318 427 588  79],18,5,15363,4.4646904969485615,40.0,0.0
13441,1,3441,[515 318 427 588  79],807,5,15368,4.464846019755956,40.0,0.0
13442,1,3442,[515 318 427 588  79],716,5,15373,4.4650014522219,40.0,0.0
13443,1,3443,[515 318 427 588  79],716,5,15378,4.465156794425087,40.0,0.0
13444,1,3444,[385  64 202 235 508],344,3,15381,4.464731494920174,20.0,0.0
13445,1,3445,[ 98  82 135 196  88],18,1,15382,4.463726059199072,0.0,0.0
13446,1,3446,[515 318 427 588  79],18,5,15387,4.463881636205396,40.0,0.0
13447,1,3447,[515 318 427 588  79],716,5,15392,4.464037122969837,40.0,0.0
13448,1,3448,[515 318 427 588  79],716,5,15397,4.46419251957089,40.0,0.0
13449,1,3449,[215 427 211 318  12],655,2,15399,4.463478260869565,40.0,0.0
13450,1,3450,[127 238 211   7 180],450,5,15404,4.463633729353811,0.0,20.0
13451,1,3451,[228  88 294 568 194],457,4,15408,4.463499420625724,0.0,0.0
13452,1,3452,[515 318 427 588  79],807,5,15413,4.4636547929336805,40.0,0.0
13453,1,3453,[515 318 427 588  79],807,5,15418,4.463810075275044,40.0,0.0
13454,1,3454,[ 64 475 257 215 132],655,1,15419,4.462807525325615,20.0,0.0
13455,1,3455,[515 318 427 588  79],18,5,15424,4.462962962962963,40.0,0.0
13456,1,3456,[515 318 427 588  79],716,5,15429,4.463118310673995,40.0,0.0
13457,1,3457,[ 70  28 200  25 197],450,3,15432,4.462695199537305,0.0,0.0
13458,1,3458,[183  25 282 655 191],450,4,15436,4.462561433940445,0.0,0.0
13459,1,3459,[515 318 427 588  79],18,5,15441,4.462716763005781,40.0,0.0
13460,1,3460,[515 318 427 588  79],18,5,15446,4.462872002311471,40.0,0.0
13461,1,3461,[515 318 427 588  79],18,5,15451,4.4630271519352975,40.0,0.0
13462,1,3462,[515 318 427 588  79],18,5,15456,4.463182211954952,40.0,0.0
13463,1,3463,[ 82 318 125 173 222],450,3,15459,4.462759815242494,20.0,0.0
13464,1,3464,[515 318 427 588  79],807,5,15464,4.462914862914863,40.0,0.0
13465,1,3465,[258 186 210 143  11],457,5,15469,4.463069821119446,0.0,0.0
13466,1,3466,[515 318 427 588  79],716,5,15474,4.46322468993366,40.0,0.0
13467,1,3467,[515 318 427 588  79],716,5,15479,4.463379469434833,40.0,0.0
13468,1,3468,[515 318 427 588  79],18,5,15484,4.463534159700202,40.0,0.0
13469,1,3469,[515 318 427 588  79],807,5,15489,4.4636887608069165,40.0,0.0
13470,1,3470,[143 333 301 655 111],655,1,15490,4.462690867185249,0.0,0.0
13471,1,3471,[515 318 427 588  79],807,5,15495,4.462845622119816,40.0,0.0
13472,1,3472,[515 318 427 588  79],716,5,15500,4.463000287935502,40.0,0.0
13473,1,3473,[515 318 427 588  79],807,5,15505,4.463154864709269,40.0,0.0
13474,1,3474,[515 318 427 588  79],18,5,15510,4.463309352517985,40.0,0.0
13475,1,3475,[200  11 405 588 173],280,3,15513,4.462888377445339,0.0,0.0
13476,1,3476,[515 318 427 588  79],807,5,15518,4.463042853034225,40.0,0.0
13477,1,3477,[515 318 427 588  79],18,5,15523,4.463197239792985,40.0,0.0
13478,1,3478,[235 237 215 300 200],716,4,15527,4.463064098878988,0.0,0.0
13479,1,3479,[515 318 427 588  79],716,5,15532,4.463218390804598,40.0,0.0
13480,1,3480,[515 318 427 588  79],716,5,15537,4.46337259408216,40.0,0.0
13481,1,3481,[515 318 427 588  79],18,5,15542,4.463526708788053,40.0,0.0
13482,1,3482,[ 96 144 117 234 271],655,0,15542,4.462245190927361,0.0,0.0
13483,1,3483,[515 318 427 588  79],807,5,15547,4.46239954075775,40.0,0.0
13484,1,3484,[515 318 427 588  79],18,5,15552,4.462553802008609,40.0,0.0
13485,1,3485,[143 187 181 180 300],716,3,15555,4.462134251290878,0.0,0.0
13486,1,3486,[603 179  95 183  56],450,4,15559,4.4620017206768,20.0,0.0
13487,1,3487,[ 56 196 258 427 289],693,3,15562,4.46158256880734,20.0,0.0
13488,1,3488,[515 318 427 588  79],716,5,15567,4.461736887360275,40.0,0.0
13489,1,3489,[275 471 257 483 135],389,3,15570,4.461318051575931,0.0,20.0
13490,1,3490,[515 318 427 588  79],18,5,15575,4.46147235749069,40.0,0.0
13491,1,3491,[187 197  96 195 427],655,2,15577,4.460767468499427,20.0,0.0
13492,1,3492,[515 318 427 588  79],18,5,15582,4.460921843687375,40.0,0.0
13493,1,3493,[515 318 427 588  79],807,5,15587,4.461076130509444,40.0,0.0
13494,1,3494,[222 168 405 597  12],450,4,15591,4.460944206008584,0.0,0.0
13495,1,3495,[515 318 427 588  79],716,5,15596,4.461098398169336,40.0,0.0
13496,1,3496,[357 322 200  28 588],796,3,15599,4.460680583357163,0.0,0.0
13497,1,3497,[234 258  25 742 204],450,3,15602,4.460263007432819,0.0,0.0
13498,1,3498,[322  88  69 132 176],450,5,15607,4.460417262074879,0.0,0.0
13499,1,3499,[127  64 204 313 322],450,5,15612,4.460571428571429,20.0,20.0
13500,1,3500,[515 318 427 588  79],716,5,15617,4.460725506998001,40.0,0.0
13501,1,3501,[515 318 427 588  79],18,5,15622,4.46087949743004,40.0,0.0
13502,1,3502,[202 357 235 678 161],401,2,15624,4.460176991150442,0.0,0.0
13503,1,3503,[515 318 427 588  79],18,5,15629,4.4603310502283104,40.0,0.0
13504,1,3504,[515 318 427 588  79],716,5,15634,4.460485021398003,40.0,0.0
13505,1,3505,[515 318 427 588  79],807,5,15639,4.460638904734741,40.0,0.0
13506,1,3506,[ 15 202 237  64 195],731,4,15643,4.46050755631594,20.0,0.0
13507,1,3507,[515 318 427 588  79],807,5,15648,4.460661345496009,40.0,0.0
13508,1,3508,[515 318 427 588  79],18,5,15653,4.460815047021944,40.0,0.0
13509,1,3509,[515 318 427 588  79],18,5,15658,4.460968660968661,40.0,0.0
13510,1,3510,[258  96  97 153 603],655,1,15659,4.459982910851609,20.0,0.0
13511,1,3511,[515 318 427 588  79],18,5,15664,4.460136674259681,40.0,0.0
13512,1,3512,[143 216 748 117 173],450,5,15669,4.460290350128096,0.0,0.0
13513,1,3513,[286  11  97 168 313],450,5,15674,4.460443938531588,0.0,20.0
13514,1,3514,[515 318 427 588  79],807,5,15679,4.460597439544808,40.0,0.0
13515,1,3515,[515 318 427 588  79],18,5,15684,4.460750853242321,40.0,0.0
13516,1,3516,[515 318 427 588  79],807,5,15689,4.460904179698606,40.0,0.0
13517,1,3517,[515 318 427 588  79],716,5,15694,4.461057418988061,40.0,0.0
13518,1,3518,[515 318 427 588  79],18,5,15699,4.461210571184996,40.0,0.0
13519,1,3519,[515 318 427 588  79],807,5,15704,4.461363636363636,40.0,0.0
13520,1,3520,[515 318 427 588  79],18,5,15709,4.461516614598126,40.0,0.0
13521,1,3521,[515 318 427 588  79],18,5,15714,4.461669505962521,40.0,0.0
13522,1,3522,[515 318 427 588  79],716,5,15719,4.461822310530797,40.0,0.0
13523,1,3523,[515 318 427 588  79],18,5,15724,4.461975028376845,40.0,0.0
13524,1,3524,[ 98 111 143 161 200],577,3,15727,4.461560283687943,0.0,0.0
13525,1,3525,[515 318 427 588  79],716,5,15732,4.4617129892229155,40.0,0.0
13526,1,3526,[515 318 427 588  79],18,5,15737,4.46186560816558,40.0,0.0
13527,1,3527,[ 28 508 405   9 435],11,4,15741,4.461734693877551,0.0,0.0
13528,1,3528,[515 318 427 588  79],807,5,15746,4.461887220175687,40.0,0.0
13529,1,3529,[515 318 427 588  79],18,5,15751,4.462039660056657,40.0,0.0
13530,1,3530,[ 22 135 195   9  89],655,2,15753,4.461342395921835,0.0,0.0
13531,1,3531,[515 318 427 588  79],807,5,15758,4.461494903737259,40.0,0.0
13532,1,3532,[  9 204 215 423 168],796,4,15762,4.461364279649024,0.0,0.0
13533,1,3533,[515 318 427 588  79],807,5,15767,4.461516694963215,40.0,0.0
13534,1,3534,[515 318 427 588  79],18,5,15772,4.4616690240452614,40.0,0.0
13535,1,3535,[515 318 427 588  79],18,5,15777,4.461821266968326,40.0,0.0
13536,1,3536,[515 318 427 588  79],716,5,15782,4.4619734238054845,40.0,0.0
13537,1,3537,[515 318 427 588  79],716,5,15787,4.462125494629734,40.0,0.0
13538,1,3538,[515 318 427 588  79],18,5,15792,4.462277479513987,40.0,0.0
13539,1,3539,[515 318 427 588  79],18,5,15797,4.462429378531073,40.0,0.0
13540,1,3540,[ 56  28  97 234  98],693,3,15800,4.462016379553798,0.0,0.0
13541,1,3541,[515 318 427 588  79],807,5,15805,4.462168266516093,40.0,0.0
13542,1,3542,[172 195 176  50 111],280,1,15806,4.461191081004798,0.0,20.0
13543,1,3543,[515 318 427 588  79],18,5,15811,4.461343115124153,40.0,0.0
13544,1,3544,[ 50 269  28 496 483],796,3,15814,4.460930888575459,20.0,20.0
13545,1,3545,[117  70 294 172 204],401,2,15816,4.460236886632826,0.0,0.0
13546,1,3546,[515 318 427 588  79],18,5,15821,4.460389061178461,40.0,0.0
13547,1,3547,[515 318 427 588  79],807,5,15826,4.46054114994363,40.0,0.0
13548,1,3548,[132 144 180 245 153],450,5,15831,4.460693153000845,0.0,0.0
13549,1,3549,[ 22 268 197 515 191],269,4,15835,4.46056338028169,0.0,0.0
13550,1,3550,[515 318 427 588  79],18,5,15840,4.460715291467192,40.0,0.0
13551,1,3551,[515 318 427 588  79],716,5,15845,4.460867117117117,40.0,0.0
13552,1,3552,[748  79  70  97 182],450,5,15850,4.461018857303687,0.0,0.0
13553,1,3553,[515 318 427 588  79],807,5,15855,4.461170512099043,40.0,0.0
13554,1,3554,[515 318 427 588  79],18,5,15860,4.461322081575246,40.0,0.0
13555,1,3555,[185  69 222 238 597],11,1,15861,4.460348706411699,0.0,0.0
13556,1,3556,[515 318 427 588  79],807,5,15866,4.460500421703683,40.0,0.0
13557,1,3557,[ 79 742 322 181 180],280,4,15870,4.460370994940978,0.0,0.0
13558,1,3558,[515 318 427 588  79],18,5,15875,4.460522618713122,40.0,0.0
13559,1,3559,[515 318 427 588  79],18,5,15880,4.46067415730337,40.0,0.0
13560,1,3560,[257 202 300   4 258],655,0,15880,4.45942151081157,0.0,0.0
13561,1,3561,[515 318 427 588  79],807,5,15885,4.459573273441887,40.0,0.0
13562,1,3562,[357  50 282 300 234],942,5,15890,4.459724950884087,0.0,20.0
13563,1,3563,[515 318 427 588  79],807,5,15895,4.459876543209877,40.0,0.0
13564,1,3564,[222 276 471 568  64],655,2,15897,4.459186535764376,20.0,0.0
13565,1,3565,[515 318 427 588  79],716,5,15902,4.459338194054964,40.0,0.0
13566,1,3566,[ 64 294 357 210  15],450,3,15905,4.458929072049341,20.0,0.0
13567,1,3567,[515 318 427 588  79],716,5,15910,4.459080717488789,40.0,0.0
13568,1,3568,[515 318 427 588  79],807,5,15915,4.459232277949005,40.0,0.0
13569,1,3569,[515 318 427 588  79],18,5,15920,4.459383753501401,40.0,0.0
13570,1,3570,[515 318 427 588  79],807,5,15925,4.459535144217306,40.0,0.0
13571,1,3571,[515 318 427 588  79],716,5,15930,4.459686450167973,40.0,0.0
13572,1,3572,[237 435 143 204  25],716,5,15935,4.459837671424573,0.0,0.0
13573,1,3573,[515 318 427 588  79],18,5,15940,4.459988808058198,40.0,0.0
13574,1,3574,[515 318 427 588  79],716,5,15945,4.4601398601398605,40.0,0.0
13575,1,3575,[435   8 183 496  25],503,4,15949,4.460011185682327,20.0,0.0
13576,1,3576,[515 318 427 588  79],716,5,15954,4.460162147050601,40.0,0.0
13577,1,3577,[  1 265  28 568 742],577,4,15958,4.460033538289547,0.0,0.0
13578,1,3578,[515 318 427 588  79],18,5,15963,4.460184409052808,40.0,0.0
13579,1,3579,[515 318 427 588  79],807,5,15968,4.460335195530726,40.0,0.0
13580,1,3580,[515 318 427 588  79],807,5,15973,4.460485897793912,40.0,0.0
13581,1,3581,[515 318 427 588  79],716,5,15978,4.460636515912898,40.0,0.0
13582,1,3582,[515 318 427 588  79],716,5,15983,4.460787049958135,40.0,0.0
13583,1,3583,[748 176 318  70 427],11,3,15986,4.460379464285714,40.0,0.0
13584,1,3584,[515 318 427 588  79],716,5,15991,4.4605299860529986,40.0,0.0
13585,1,3585,[515 318 427 588  79],716,5,15996,4.460680423870608,40.0,0.0
13586,1,3586,[515 318 427 588  79],807,5,16001,4.460830777808754,40.0,0.0
13587,1,3587,[195 258 204 200   9],504,4,16005,4.460702341137123,0.0,0.0
13588,1,3588,[515 318 427 588  79],716,5,16010,4.460852605182502,40.0,0.0
13589,1,3589,[515 318 427 588  79],716,5,16015,4.46100278551532,40.0,0.0
13590,1,3590,[515 318 427 588  79],807,5,16020,4.461152882205514,40.0,0.0
13591,1,3591,[515 318 427 588  79],807,5,16025,4.46130289532294,40.0,0.0
13592,1,3592,[515 318 427 588  79],807,5,16030,4.461452824937378,40.0,0.0
13593,1,3593,[515 318 427 588  79],18,5,16035,4.461602671118531,40.0,0.0
13594,1,3594,[515 318 427 588  79],716,5,16040,4.461752433936022,40.0,0.0
13595,1,3595,[151 153 322 195 275],796,4,16044,4.461624026696329,0.0,20.0
13596,1,3596,[515 318 427 588  79],716,5,16049,4.461773700305811,40.0,0.0
13597,1,3597,[515 318 427 588  79],716,5,16054,4.461923290717065,40.0,0.0
13598,1,3598,[210  22 515  28 173],807,4,16058,4.461794943039734,0.0,0.0
13599,1,3599,[515 318 427 588  79],716,5,16063,4.461944444444445,40.0,0.0
13600,1,3600,[515 318 427 588  79],807,5,16068,4.462093862815885,40.0,0.0
13601,1,3601,[515 318 427 588  79],807,5,16073,4.462243198223209,40.0,0.0
13602,1,3602,[515 318 427 588  79],716,5,16078,4.462392450735498,40.0,0.0
13603,1,3603,[515 318 427 588  79],18,5,16083,4.462541620421754,40.0,0.0
13604,1,3604,[286 427 132  98  70],535,3,16086,4.462135922330097,20.0,20.0
13605,1,3605,[515 318 427 588  79],716,5,16091,4.46228508042152,40.0,0.0
13606,1,3606,[515 318 427 588  79],716,5,16096,4.46243415580815,40.0,0.0
13607,1,3607,[515 318 427 588  79],18,5,16101,4.462583148558759,40.0,0.0
13608,1,3608,[515 318 427 588  79],716,5,16106,4.462732058742033,40.0,0.0
13609,1,3609,[515 318 427 588  79],807,5,16111,4.462880886426593,40.0,0.0
13610,1,3610,[515 318 427 588  79],716,5,16116,4.463029631680975,40.0,0.0
13611,1,3611,[125 202  88 301 423],796,4,16120,4.462901439645626,0.0,0.0
13612,1,3612,[191 483 423  98 323],23,2,16122,4.462219761970662,0.0,0.0
13613,1,3613,[515 318 427 588  79],807,5,16127,4.462368566685114,40.0,0.0
13614,1,3614,[515 318 427 588  79],716,5,16132,4.462517289073306,40.0,0.0
13615,1,3615,[515 318 427 588  79],716,5,16137,4.46266592920354,40.0,0.0
13616,1,3616,[515 318 427 588  79],18,5,16142,4.462814487144042,40.0,0.0
13617,1,3617,[515 318 427 588  79],807,5,16147,4.462962962962963,40.0,0.0
13618,1,3618,[515 318 427 588  79],18,5,16152,4.463111356728378,40.0,0.0
13619,1,3619,[515 318 427 588  79],716,5,16157,4.463259668508288,40.0,0.0
13620,1,3620,[228 174 168  88 216],457,5,16162,4.463407898370616,0.0,0.0
13621,1,3621,[515 318 427 588  79],18,5,16167,4.463556046383213,40.0,0.0
13622,1,3622,[515 318 427 588  79],716,5,16172,4.463704112613856,40.0,0.0
13623,1,3623,[234 143 196 275 210],450,3,16175,4.463300220750551,0.0,20.0
13624,1,3624,[515 318 427 588  79],18,5,16180,4.463448275862069,40.0,0.0
13625,1,3625,[515 318 427 588  79],807,5,16185,4.463596249310535,40.0,0.0
13626,1,3626,[273 234 127 423 546],450,3,16188,4.463192721257237,0.0,20.0
13627,1,3627,[515 318 427 588  79],807,5,16193,4.463340683572216,40.0,0.0
13628,1,3628,[515 318 427 588  79],18,5,16198,4.463488564342794,40.0,0.0
13629,1,3629,[515 318 427 588  79],716,5,16203,4.463636363636364,40.0,0.0
13630,1,3630,[515 318 427 588  79],807,5,16208,4.4637840815202425,40.0,0.0
13631,1,3631,[515 318 427 588  79],807,5,16213,4.463931718061674,40.0,0.0
13632,1,3632,[111 191 183 172 275],450,5,16218,4.464079273327828,0.0,20.0
13633,1,3633,[515 318 427 588  79],807,5,16223,4.4642267473858,40.0,0.0
13634,1,3634,[515 318 427 588  79],18,5,16228,4.464374140302613,40.0,0.0
13635,1,3635,[515 318 427 588  79],18,5,16233,4.464521452145214,40.0,0.0
13636,1,3636,[423 132   9 483  79],151,5,16238,4.464668682980478,0.0,0.0
13637,1,3637,[515 318 427 588  79],807,5,16243,4.464815832875206,40.0,0.0
13638,1,3638,[515 318 427 588  79],807,5,16248,4.464962901896126,40.0,0.0
13639,1,3639,[515 318 427 588  79],807,5,16253,4.46510989010989,40.0,0.0
13640,1,3640,[202 435 269 181  50],523,5,16258,4.4652567975830815,0.0,20.0
13641,1,3641,[515 318 427 588  79],807,5,16263,4.4654036243822075,40.0,0.0
13642,1,3642,[515 318 427 588  79],18,5,16268,4.465550370573703,40.0,0.0
13643,1,3643,[515 318 427 588  79],716,5,16273,4.46569703622393,40.0,0.0
13644,1,3644,[515 318 427 588  79],18,5,16278,4.465843621399177,40.0,0.0
13645,1,3645,[546 179 204 143 294],457,3,16281,4.465441579813494,0.0,0.0
13646,1,3646,[515 318 427 588  79],18,5,16286,4.465588154647656,40.0,0.0
13647,1,3647,[515 318 427 588  79],18,5,16291,4.465734649122807,40.0,0.0
13648,1,3648,[515 318 427 588  79],807,5,16296,4.465881063305015,40.0,0.0
13649,1,3649,[515 318 427 588  79],716,5,16301,4.466027397260274,40.0,0.0
13650,1,3650,[173 143  98   8 211],269,2,16303,4.46535195836757,0.0,0.0
13651,1,3651,[515 318 427 588  79],716,5,16308,4.4654983570646225,40.0,0.0
13652,1,3652,[515 318 427 588  79],807,5,16313,4.465644675609089,40.0,0.0
13653,1,3653,[515 318 427 588  79],716,5,16318,4.465790914066776,40.0,0.0
13654,1,3654,[742 568 423  25 216],655,1,16319,4.46484268125855,0.0,0.0
13655,1,3655,[515 318 427 588  79],807,5,16324,4.464989059080962,40.0,0.0
13656,1,3656,[515 318 427 588  79],18,5,16329,4.465135356849877,40.0,0.0
13657,1,3657,[515 318 427 588  79],716,5,16334,4.4652815746309455,40.0,0.0
13658,1,3658,[515 318 427 588  79],18,5,16339,4.465427712489752,40.0,0.0
13659,1,3659,[515 318 427 588  79],716,5,16344,4.465573770491804,40.0,0.0
13660,1,3660,[515 318 427 588  79],716,5,16349,4.46571974870254,40.0,0.0
13661,1,3661,[515 318 427 588  79],807,5,16354,4.4658656471873295,40.0,0.0
13662,1,3662,[515 318 427 588  79],18,5,16359,4.466011466011466,40.0,0.0
13663,1,3663,[191 333 118 313 100],796,4,16363,4.465884279475983,0.0,20.0
13664,1,3664,[132   7 211 603 318],655,2,16365,4.465211459754434,40.0,0.0
13665,1,3665,[515 318 427 588  79],807,5,16370,4.465357337697763,40.0,0.0
13666,1,3666,[515 318 427 588  79],807,5,16375,4.465503136078539,40.0,0.0
13667,1,3667,[427 265 118  97 200],796,4,16379,4.465376226826608,20.0,0.0
13668,1,3668,[515 318 427 588  79],18,5,16384,4.465521940583265,40.0,0.0
13669,1,3669,[515 318 427 588  79],716,5,16389,4.46566757493188,40.0,0.0
13670,1,3670,[ 82  28 286 118 222],796,2,16391,4.464995913919913,0.0,20.0
13671,1,3671,[515 318 427 588  79],807,5,16396,4.465141612200436,40.0,0.0
13672,1,3672,[515 318 427 588  79],716,5,16401,4.465287231146202,40.0,0.0
13673,1,3673,[515 318 427 588  79],716,5,16406,4.465432770821993,40.0,0.0
13674,1,3674,[515 318 427 588  79],807,5,16411,4.465578231292517,40.0,0.0
13675,1,3675,[515 318 427 588  79],18,5,16416,4.465723612622416,40.0,0.0
13676,1,3676,[546 471 183 288 222],280,2,16418,4.46505303236334,0.0,0.0
13677,1,3677,[515 318 427 588  79],807,5,16423,4.465198477433388,40.0,0.0
13678,1,3678,[515 318 427 588  79],18,5,16428,4.465343843435717,40.0,0.0
13679,1,3679,[275 257 742   1 405],796,3,16431,4.464945652173913,0.0,20.0
13680,1,3680,[515 318 427 588  79],716,5,16436,4.465091007878294,40.0,0.0
13681,1,3681,[515 318 427 588  79],716,5,16441,4.465236284627919,40.0,0.0
13682,1,3682,[515 318 427 588  79],807,5,16446,4.4653814824871025,40.0,0.0
13683,1,3683,[194 118   1  64 403],796,4,16450,4.465255157437568,20.0,0.0
13684,1,3684,[515 318 427 588  79],807,5,16455,4.465400271370421,40.0,0.0
13685,1,3685,[515 318 427 588  79],18,5,16460,4.4655453065653825,40.0,0.0
13686,1,3686,[515 318 427 588  79],716,5,16465,4.46569026308652,40.0,0.0
13687,1,3687,[515 318 427 588  79],18,5,16470,4.4658351409978305,40.0,0.0
13688,1,3688,[515 318 427 588  79],18,5,16475,4.465979940363242,40.0,0.0
13689,1,3689,[515 318 427 588  79],18,5,16480,4.466124661246613,40.0,0.0
13690,1,3690,[515 318 427 588  79],807,5,16485,4.466269303711731,40.0,0.0
13691,1,3691,[515 318 427 588  79],807,5,16490,4.466413867822318,40.0,0.0
13692,1,3692,[515 318 427 588  79],716,5,16495,4.466558353642025,40.0,0.0
13693,1,3693,[515 318 427 588  79],18,5,16500,4.466702761234434,40.0,0.0
13694,1,3694,[515 318 427 588  79],18,5,16505,4.466847090663058,40.0,0.0
13695,1,3695,[515 318 427 588  79],18,5,16510,4.466991341991342,40.0,0.0
13696,1,3696,[515 318 427 588  79],18,5,16515,4.467135515282662,40.0,0.0
13697,1,3697,[515 318 427 588  79],18,5,16520,4.4672796106003245,40.0,0.0
13698,1,3698,[515 318 427 588  79],807,5,16525,4.46742362800757,40.0,0.0
13699,1,3699,[515 318 427 588  79],18,5,16530,4.467567567567568,40.0,0.0
13700,1,3700,[318  15 153 151 182],269,3,16533,4.467171034855444,20.0,0.0
13701,1,3701,[273  71 100 200 322],450,2,16535,4.466504592112372,0.0,20.0
13702,1,3702,[237  69 742 100 215],577,5,16540,4.4666486632460165,0.0,20.0
13703,1,3703,[515 318 427 588  79],18,5,16545,4.466792656587473,40.0,0.0
13704,1,3704,[ 97 153 483 258 265],655,1,16546,4.465856950067477,0.0,0.0
13705,1,3705,[183  98  79 423  25],716,4,16550,4.465731246627091,0.0,0.0
13706,1,3706,[515 318 427 588  79],716,5,16555,4.465875370919881,40.0,0.0
13707,1,3707,[515 318 427 588  79],716,5,16560,4.466019417475728,40.0,0.0
13708,1,3708,[257 186  28 300 216],504,4,16564,4.465893771906174,0.0,0.0
13709,1,3709,[515 318 427 588  79],807,5,16569,4.466037735849056,40.0,0.0
13710,1,3710,[ 95 211 405  56 273],450,3,16572,4.465642683912692,0.0,0.0
13711,1,3711,[515 318 427 588  79],18,5,16577,4.465786637931035,40.0,0.0
13712,1,3712,[515 318 427 588  79],807,5,16582,4.465930514408834,40.0,0.0
13713,1,3713,[515 318 427 588  79],18,5,16587,4.466074313408724,40.0,0.0
13714,1,3714,[125 197 228 144  98],280,1,16588,4.465141318977119,0.0,0.0
13715,1,3715,[515 318 427 588  79],807,5,16593,4.4652852529601725,40.0,0.0
13716,1,3716,[515 318 427 588  79],807,5,16598,4.465429109496906,40.0,0.0
13717,1,3717,[515 318 427 588  79],716,5,16603,4.465572888649811,40.0,0.0
13718,1,3718,[515 318 427 588  79],18,5,16608,4.465716590481312,40.0,0.0
13719,1,3719,[508   4  96 183 125],655,1,16609,4.464784946236559,0.0,0.0
13720,1,3720,[515 318 427 588  79],807,5,16614,4.464928782585327,40.0,0.0
13721,1,3721,[515 318 427 588  79],807,5,16619,4.465072541644277,40.0,0.0
13722,1,3722,[515 318 427 588  79],716,5,16624,4.465216223475692,40.0,0.0
13723,1,3723,[515 318 427 588  79],18,5,16629,4.465359828141783,40.0,0.0
13724,1,3724,[ 96  28 174 508  82],655,0,16629,4.464161073825504,0.0,0.0
13725,1,3725,[180  11  25 405 237],716,4,16633,4.464036500268384,0.0,0.0
13726,1,3726,[ 79 294 173 132 195],450,5,16638,4.46418030587604,0.0,0.0
13727,1,3727,[515 318 427 588  79],18,5,16643,4.464324034334764,40.0,0.0
13728,1,3728,[515 318 427 588  79],807,5,16648,4.464467685706624,40.0,0.0
13729,1,3729,[515 318 427 588  79],18,5,16653,4.464611260053619,40.0,0.0
13730,1,3730,[515 318 427 588  79],716,5,16658,4.464754757437684,40.0,0.0
13731,1,3731,[515 318 427 588  79],716,5,16663,4.464898177920686,40.0,0.0
13732,1,3732,[ 96 121 176   1 323],796,3,16666,4.464505759442807,0.0,0.0
13733,1,3733,[515 318 427 588  79],716,5,16671,4.464649169791109,40.0,0.0
13734,1,3734,[515 318 427 588  79],807,5,16676,4.46479250334672,40.0,0.0
13735,1,3735,[515 318 427 588  79],807,5,16681,4.464935760171306,40.0,0.0
13736,1,3736,[515 318 427 588  79],807,5,16686,4.465078940326465,40.0,0.0
13737,1,3737,[568 127 245 172 323],280,1,16687,4.464151952915998,0.0,20.0
13738,1,3738,[515 318 427 588  79],18,5,16692,4.464295266113934,40.0,0.0
13739,1,3739,[515 318 427 588  79],716,5,16697,4.464438502673797,40.0,0.0
13740,1,3740,[515 318 427 588  79],807,5,16702,4.464581662657044,40.0,0.0
13741,1,3741,[515 318 427 588  79],807,5,16707,4.464724746125067,40.0,0.0
13742,1,3742,[515 318 427 588  79],716,5,16712,4.464867753139194,40.0,0.0
13743,1,3743,[515 318 427 588  79],716,5,16717,4.465010683760684,40.0,0.0
13744,1,3744,[515 318 427 588  79],18,5,16722,4.465153538050735,40.0,0.0
13745,1,3745,[515 318 427 588  79],716,5,16727,4.465296316070475,40.0,0.0
13746,1,3746,[228 132   8   4  96],344,5,16732,4.465439017880971,0.0,0.0
13747,1,3747,[515 318 427 588  79],807,5,16737,4.465581643543223,40.0,0.0
13748,1,3748,[515 318 427 588  79],716,5,16742,4.465724193118165,40.0,0.0
13749,1,3749,[515 318 427 588  79],807,5,16747,4.465866666666667,40.0,0.0
13750,1,3750,[515 318 427 588  79],716,5,16752,4.466009064249533,40.0,0.0
13751,1,3751,[515 318 427 588  79],18,5,16757,4.466151385927505,40.0,0.0
13752,1,3752,[515 318 427 588  79],807,5,16762,4.466293631761258,40.0,0.0
13753,1,3753,[515 318 427 588  79],807,5,16767,4.466435801811401,40.0,0.0
13754,1,3754,[515 318 427 588  79],18,5,16772,4.466577896138482,40.0,0.0
13755,1,3755,[515 318 427 588  79],18,5,16777,4.466719914802982,40.0,0.0
13756,1,3756,[515 318 427 588  79],18,5,16782,4.466861857865318,40.0,0.0
13757,1,3757,[515 318 427 588  79],18,5,16787,4.467003725385844,40.0,0.0
13758,1,3758,[ 12 405 183 286 181],151,3,16790,4.466613461026869,0.0,20.0
13759,1,3759,[515 318 427 588  79],807,5,16795,4.466755319148936,40.0,0.0
13760,1,3760,[515 318 427 588  79],807,5,16800,4.466897101834618,40.0,0.0
13761,1,3761,[515 318 427 588  79],18,5,16805,4.467038809144072,40.0,0.0
13762,1,3762,[ 11 191 288 483 204],450,3,16808,4.466648950305607,0.0,0.0
13763,1,3763,[172 300 176   1 143],716,4,16812,4.466524973432518,0.0,0.0
13764,1,3764,[515 318 427 588  79],18,5,16817,4.466666666666667,40.0,0.0
13765,1,3765,[ 11 588 265 202   7],280,4,16821,4.466542750929368,0.0,0.0
13766,1,3766,[515 318 427 588  79],716,5,16826,4.466684364215556,40.0,0.0
13767,1,3767,[515 318 427 588  79],807,5,16831,4.466825902335456,40.0,0.0
13768,1,3768,[515 318 427 588  79],716,5,16836,4.466967365348899,40.0,0.0
13769,1,3769,[515 318 427 588  79],807,5,16841,4.4671087533156495,40.0,0.0
13770,1,3770,[515 318 427 588  79],807,5,16846,4.467250066295413,40.0,0.0
13771,1,3771,[301  97  28  15 275],796,2,16848,4.466595970307529,0.0,20.0
13772,1,3772,[515 318 427 588  79],716,5,16853,4.466737344288365,40.0,0.0
13773,1,3773,[515 318 427 588  79],18,5,16858,4.466878643349232,40.0,0.0
13774,1,3774,[ 95 265   9 153  50],796,4,16862,4.466754966887417,0.0,20.0
13775,1,3775,[211 323 216 271  71],796,3,16865,4.466366525423729,0.0,0.0
13776,1,3776,[515 318 427 588  79],18,5,16870,4.466507810431559,40.0,0.0
13777,1,3777,[515 318 427 588  79],18,5,16875,4.4666490206458445,40.0,0.0
13778,1,3778,[515 318 427 588  79],716,5,16880,4.466790156125959,40.0,0.0
13779,1,3779,[515 318 427 588  79],716,5,16885,4.466931216931217,40.0,0.0
13780,1,3780,[515 318 427 588  79],18,5,16890,4.467072203120868,40.0,0.0
13781,1,3781,[175 187 204 153  97],18,4,16894,4.466948704389212,0.0,0.0
13782,1,3782,[515 318 427 588  79],716,5,16899,4.467089611419508,40.0,0.0
13783,1,3783,[515 318 427 588  79],716,5,16904,4.46723044397463,40.0,0.0
13784,1,3784,[515 318 427 588  79],716,5,16909,4.467371202113607,40.0,0.0
13785,1,3785,[588 568   8   9 180],457,5,16914,4.467511885895404,0.0,0.0
13786,1,3786,[515 318 427 588  79],18,5,16919,4.467652495378928,40.0,0.0
13787,1,3787,[515 318 427 588  79],18,5,16924,4.46779303062302,40.0,0.0
13788,1,3788,[515 318 427 588  79],18,5,16929,4.467933491686461,40.0,0.0
13789,1,3789,[515 318 427 588  79],18,5,16934,4.468073878627968,40.0,0.0
13790,1,3790,[144 127 186  82 118],796,3,16937,4.467686626219995,0.0,20.0
13791,1,3791,[515 318 427 588  79],807,5,16942,4.4678270042194095,40.0,0.0
13792,1,3792,[515 318 427 588  79],18,5,16947,4.467967308199315,40.0,0.0
13793,1,3793,[515 318 427 588  79],716,5,16952,4.46810753821824,40.0,0.0
13794,1,3794,[  9 222  79  28  50],292,4,16956,4.46798418972332,0.0,20.0
13795,1,3795,[515 318 427 588  79],807,5,16961,4.468124341412013,40.0,0.0
13796,1,3796,[515 318 427 588  79],18,5,16966,4.468264419278378,40.0,0.0
13797,1,3797,[515 318 427 588  79],18,5,16971,4.4684044233807265,40.0,0.0
13798,1,3798,[318 515  22 186 132],716,4,16975,4.468281126612267,20.0,0.0
13799,1,3799,[211 289 204 275  89],655,2,16977,4.467631578947368,0.0,20.0
13800,1,3800,[ 96  69 216 234  88],693,2,16979,4.466982373059722,0.0,0.0
13801,1,3801,[515 318 427 588  79],807,5,16984,4.467122567069963,40.0,0.0
13802,1,3802,[515 318 427 588  79],807,5,16989,4.467262687352091,40.0,0.0
13803,1,3803,[ 11  12 174 144 234],450,4,16993,4.4671398527865405,0.0,0.0
13804,1,3804,[515 318 427 588  79],807,5,16998,4.467279894875165,40.0,0.0
13805,1,3805,[515 318 427 588  79],716,5,17003,4.46741986337362,40.0,0.0
13806,1,3806,[143 191 153 210 597],796,4,17007,4.467297084318361,0.0,0.0
13807,1,3807,[515 318 427 588  79],807,5,17012,4.467436974789916,40.0,0.0
13808,1,3808,[ 96  70 423 161 515],716,3,17015,4.4670517196114465,0.0,0.0
13809,1,3809,[515 318 427 588  79],807,5,17020,4.467191601049869,40.0,0.0
13810,1,3810,[515 318 427 588  79],807,5,17025,4.467331409078982,40.0,0.0
13811,1,3811,[515 318 427 588  79],807,5,17030,4.467471143756558,40.0,0.0
13812,1,3812,[515 318 427 588  79],716,5,17035,4.46761080514031,40.0,0.0
13813,1,3813,[515 318 427 588  79],807,5,17040,4.467750393287886,40.0,0.0
13814,1,3814,[515 318 427 588  79],716,5,17045,4.467889908256881,40.0,0.0
13815,1,3815,[515 318 427 588  79],807,5,17050,4.468029350104822,40.0,0.0
13816,1,3816,[515 318 427 588  79],18,5,17055,4.46816871888918,40.0,0.0
13817,1,3817,[515 318 427 588  79],807,5,17060,4.4683080146673655,40.0,0.0
13818,1,3818,[515 318 427 588  79],807,5,17065,4.468447237496727,40.0,0.0
13819,1,3819,[471 405  25  97 179],450,4,17069,4.468324607329843,0.0,0.0
13820,1,3820,[515 318 427 588  79],716,5,17074,4.468463752944255,40.0,0.0
13821,1,3821,[515 318 427 588  79],18,5,17079,4.468602825745683,40.0,0.0
13822,1,3822,[603 210 258 328 237],655,1,17080,4.467695527072979,20.0,0.0
13823,1,3823,[515 318 427 588  79],807,5,17085,4.4678347280334725,40.0,0.0
13824,1,3824,[597 132  69 301 238],450,5,17090,4.46797385620915,0.0,0.0
13825,1,3825,[515 318 427 588  79],716,5,17095,4.468112911657083,40.0,0.0
13826,1,3826,[515 318 427 588  79],716,5,17100,4.468251894434283,40.0,0.0
13827,1,3827,[515 318 427 588  79],716,5,17105,4.468390804597701,40.0,0.0
13828,1,3828,[515 318 427 588  79],18,5,17110,4.46852964220423,40.0,0.0
13829,1,3829,[515 318 427 588  79],716,5,17115,4.468668407310705,40.0,0.0
13830,1,3830,[515 318 427 588  79],18,5,17120,4.468807099973898,40.0,0.0
13831,1,3831,[515 318 427 588  79],18,5,17125,4.468945720250522,40.0,0.0
13832,1,3832,[174 182  96 216   9],269,2,17127,4.468301591442734,0.0,0.0
13833,1,3833,[515 318 427 588  79],716,5,17132,4.4684402712571725,40.0,0.0
13834,1,3834,[515 318 427 588  79],18,5,17137,4.46857887874837,40.0,0.0
13835,1,3835,[508  22 238  82   4],655,0,17137,4.4674139728884255,0.0,0.0
13836,1,3836,[228 196 289 118 210],655,0,17137,4.466249674224654,0.0,0.0
13837,1,3837,[515 318 427 588  79],807,5,17142,4.466388744137571,40.0,0.0
13838,1,3838,[515 318 427 588  79],18,5,17147,4.466527741599375,40.0,0.0
13839,1,3839,[515 318 427 588  79],807,5,17152,4.466666666666667,40.0,0.0
13840,1,3840,[515 318 427 588  79],18,5,17157,4.466805519395991,40.0,0.0
13841,1,3841,[273 144 215 186 238],655,1,17158,4.465903175429464,0.0,0.0
13842,1,3842,[515 318 427 588  79],716,5,17163,4.466042154566745,40.0,0.0
13843,1,3843,[245   4 204  15 173],796,4,17167,4.4659209157127995,0.0,0.0
13844,1,3844,[  7 655 471 172 179],655,2,17169,4.465279583875162,0.0,0.0
13845,1,3845,[515 318 427 588  79],807,5,17174,4.46541861674467,40.0,0.0
13846,1,3846,[ 69 275 215 483 515],655,3,17177,4.465037691707824,0.0,20.0
13847,1,3847,[515 318 427 588  79],716,5,17182,4.465176715176715,40.0,0.0
13848,1,3848,[515 318 427 588  79],716,5,17187,4.465315666406859,40.0,0.0
13849,1,3849,[515 318 427 588  79],716,5,17192,4.465454545454546,40.0,0.0
13850,1,3850,[515 318 427 588  79],807,5,17197,4.465593352376006,40.0,0.0
13851,1,3851,[515 318 427 588  79],807,5,17202,4.465732087227415,40.0,0.0
13852,1,3852,[515 318 427 588  79],807,5,17207,4.465870750064885,40.0,0.0
13853,1,3853,[515 318 427 588  79],18,5,17212,4.466009340944473,40.0,0.0
13854,1,3854,[423 191 234 435 202],450,4,17216,4.465888456549935,0.0,0.0
13855,1,3855,[515 318 427 588  79],716,5,17221,4.466026970954357,40.0,0.0
13856,1,3856,[  1 174  96 271  15],796,4,17225,4.465906144672025,0.0,0.0
13857,1,3857,[515 318 427 588  79],716,5,17230,4.4660445826853294,40.0,0.0
13858,1,3858,[  8 151 161 405  88],796,5,17235,4.466182948950506,0.0,0.0
13859,1,3859,[515 318 427 588  79],18,5,17240,4.466321243523316,40.0,0.0
13860,1,3860,[515 318 427 588  79],807,5,17245,4.466459466459466,40.0,0.0
13861,1,3861,[328 173 288 179 234],450,3,17248,4.466079751424132,0.0,0.0
13862,1,3862,[515 318 427 588  79],716,5,17253,4.466217965311934,40.0,0.0
13863,1,3863,[515 318 427 588  79],807,5,17258,4.466356107660456,40.0,0.0
13864,1,3864,[318  70 328 216 515],655,3,17261,4.465976714100906,20.0,0.0
13865,1,3865,[282  82 182  79 294],256,3,17264,4.465597516813244,0.0,0.0
13866,1,3866,[515 318 427 588  79],716,5,17269,4.465735712438583,40.0,0.0
13867,1,3867,[515 318 427 588  79],18,5,17274,4.465873836608067,40.0,0.0
13868,1,3868,[132 301 174  25 121],655,0,17274,4.464719565779271,0.0,0.0
13869,1,3869,[194 143  50 125  79],457,5,17279,4.464857881136951,0.0,20.0
13870,1,3870,[515 318 427 588  79],18,5,17284,4.464996125032291,40.0,0.0
13871,1,3871,[515 318 427 588  79],18,5,17289,4.465134297520661,40.0,0.0
13872,1,3872,[515 318 427 588  79],18,5,17294,4.465272398657372,40.0,0.0
13873,1,3873,[508 135 403 204 271],655,1,17295,4.46437790397522,0.0,0.0
13874,1,3874,[515 318 427 588  79],716,5,17300,4.464516129032258,40.0,0.0
13875,1,3875,[515 318 427 588  79],807,5,17305,4.464654282765738,40.0,0.0
13876,1,3876,[515 318 427 588  79],807,5,17310,4.464792365230848,40.0,0.0
13877,1,3877,[172  15 742 546 423],457,4,17314,4.464672511603919,0.0,0.0
13878,1,3878,[515 318 427 588  79],807,5,17319,4.4648105181747875,40.0,0.0
13879,1,3879,[515 318 427 588  79],18,5,17324,4.4649484536082475,40.0,0.0
13880,1,3880,[515 318 427 588  79],716,5,17329,4.465086317959289,40.0,0.0
13881,1,3881,[515 318 427 588  79],807,5,17334,4.4652241112828435,40.0,0.0
13882,1,3882,[515 318 427 588  79],18,5,17339,4.465361833633788,40.0,0.0
13883,1,3883,[515 318 427 588  79],807,5,17344,4.465499485066942,40.0,0.0
13884,1,3884,[515 318 427 588  79],807,5,17349,4.465637065637066,40.0,0.0
13885,1,3885,[515 318 427 588  79],716,5,17354,4.465774575398868,40.0,0.0
13886,1,3886,[515 318 427 588  79],18,5,17359,4.465912014406998,40.0,0.0
13887,1,3887,[515 318 427 588  79],716,5,17364,4.466049382716049,40.0,0.0
13888,1,3888,[515 318 427 588  79],716,5,17369,4.46618668038056,40.0,0.0
13889,1,3889,[515 318 427 588  79],716,5,17374,4.4663239074550125,40.0,0.0
13890,1,3890,[515 318 427 588  79],18,5,17379,4.466461063993832,40.0,0.0
13891,1,3891,[ 71 234 111 161  15],796,4,17383,4.466341212744091,0.0,0.0
13892,1,3892,[515 318 427 588  79],807,5,17388,4.466478294374518,40.0,0.0
13893,1,3893,[  7 195  25 403 186],693,3,17391,4.466101694915254,0.0,0.0
13894,1,3894,[515 318 427 588  79],18,5,17396,4.466238767650834,40.0,0.0
13895,1,3895,[748 405 191 300  25],151,2,17398,4.465605749486653,0.0,0.0
13896,1,3896,[515 318 427 588  79],18,5,17403,4.465742879137799,40.0,0.0
13897,1,3897,[515 318 427 588  79],18,5,17408,4.465879938429964,40.0,0.0
13898,1,3898,[515 318 427 588  79],18,5,17413,4.466016927417287,40.0,0.0
13899,1,3899,[185 197 357 257 174],457,4,17417,4.4658974358974355,0.0,0.0
13900,1,3900,[515 318 427 588  79],716,5,17422,4.466034350166624,40.0,0.0
13901,1,3901,[515 318 427 588  79],18,5,17427,4.4661711942593545,40.0,0.0
13902,1,3902,[515 318 427 588  79],807,5,17432,4.466307968229567,40.0,0.0
13903,1,3903,[515 318 427 588  79],807,5,17437,4.466444672131147,40.0,0.0
13904,1,3904,[515 318 427 588  79],18,5,17442,4.466581306017925,40.0,0.0
13905,1,3905,[301  89 597 182 202],796,4,17446,4.466461853558628,0.0,0.0
13906,1,3906,[515 318 427 588  79],807,5,17451,4.466598413104684,40.0,0.0
13907,1,3907,[515 318 427 588  79],716,5,17456,4.466734902763562,40.0,0.0
13908,1,3908,[515 318 427 588  79],716,5,17461,4.466871322588897,40.0,0.0
13909,1,3909,[515 318 427 588  79],18,5,17466,4.467007672634271,40.0,0.0
13910,1,3910,[196  64 385 118 151],344,3,17469,4.466632574789056,20.0,0.0
13911,1,3911,[258 182 357 197 117],450,5,17474,4.466768916155419,0.0,0.0
13912,1,3912,[237 268 100 191 273],655,2,17476,4.466138512650141,0.0,20.0
13913,1,3913,[515 318 427 588  79],18,5,17481,4.466274910577415,40.0,0.0
13914,1,3914,[313 282 151 496  96],450,5,17486,4.466411238825032,20.0,0.0
13915,1,3915,[228 172 135  28  15],655,2,17488,4.465781409601634,0.0,0.0
13916,1,3916,[ 88 655 357   7  15],655,1,17489,4.464896604544294,0.0,0.0
13917,1,3917,[515 318 427 588  79],716,5,17494,4.465033180193976,40.0,0.0
13918,1,3918,[ 98  12 286 143 748],450,5,17499,4.465169686144424,0.0,20.0
13919,1,3919,[515 318 427 588  79],807,5,17504,4.46530612244898,40.0,0.0
13920,1,3920,[403  98  97 191  88],577,4,17508,4.465187452180566,0.0,0.0
13921,1,3921,[515 318 427 588  79],18,5,17513,4.465323814380418,40.0,0.0
13922,1,3922,[515 318 427 588  79],716,5,17518,4.465460107060923,40.0,0.0
13923,1,3923,[258 427  98 210 175],655,2,17520,4.464831804281346,20.0,0.0
13924,1,3924,[515 318 427 588  79],18,5,17525,4.464968152866242,40.0,0.0
13925,1,3925,[515 318 427 588  79],18,5,17530,4.46510443199185,40.0,0.0
13926,1,3926,[515 318 427 588  79],18,5,17535,4.46524064171123,40.0,0.0
13927,1,3927,[515 318 427 588  79],807,5,17540,4.465376782077393,40.0,0.0
13928,1,3928,[186 183 238 174 322],450,4,17544,4.4652583354543145,0.0,0.0
13929,1,3929,[153 269 186 245 216],796,2,17546,4.464631043256998,0.0,0.0
13930,1,3930,[515 318 427 588  79],716,5,17551,4.464767234800306,40.0,0.0
13931,1,3931,[515 318 427 588  79],716,5,17556,4.4649033570701935,40.0,0.0
13932,1,3932,[302 135 118  28 435],655,2,17558,4.464276633613018,0.0,0.0
13933,1,3933,[ 50 197  12  15 117],457,5,17563,4.4644128113879,0.0,20.0
13934,1,3934,[515 318 427 588  79],716,5,17568,4.464548919949174,40.0,0.0
13935,1,3935,[515 318 427 588  79],18,5,17573,4.464684959349594,40.0,0.0
13936,1,3936,[483   8 475 135 286],389,3,17576,4.464312928625858,0.0,20.0
13937,1,3937,[515 318 427 588  79],18,5,17581,4.464448958862366,40.0,0.0
13938,1,3938,[515 318 427 588  79],807,5,17586,4.464584920030465,40.0,0.0
13939,1,3939,[ 25 742 127  97   7],450,4,17590,4.464467005076142,0.0,20.0
13940,1,3940,[655 186   9 215 200],655,1,17591,4.463587921847247,0.0,0.0
13941,1,3941,[515 318 427 588  79],716,5,17596,4.463723997970574,40.0,0.0
13942,1,3942,[515 318 427 588  79],18,5,17601,4.46386000507228,40.0,0.0
13943,1,3943,[195 222 204 161 172],655,1,17602,4.462981744421906,0.0,0.0
13944,1,3944,[ 50 318 546 127   7],280,4,17606,4.462864385297846,20.0,40.0
13945,1,3945,[318 515 427 588  79],716,5,17611,4.463000506842372,40.0,0.0
13946,1,3946,[318 515 427 588  79],807,5,17616,4.463136559412212,40.0,0.0
13947,1,3947,[318 515 427 588  79],18,5,17621,4.4632725430597775,40.0,0.0
13948,1,3948,[318 515 427 588  79],807,5,17626,4.463408457837427,40.0,0.0
13949,1,3949,[318 515 427 588  79],807,5,17631,4.463544303797469,40.0,0.0
13950,1,3950,[318 515 427 588  79],807,5,17636,4.4636800809921535,40.0,0.0
13951,1,3951,[318 515 427 588  79],18,5,17641,4.463815789473684,40.0,0.0
13952,1,3952,[204 144 211   8 187],796,4,17645,4.463698456868201,0.0,0.0
13953,1,3953,[289 294 475   4 483],655,1,17646,4.462822458270106,0.0,0.0
13954,1,3954,[294 210 111 403 161],577,4,17650,4.462705436156764,0.0,0.0
13955,1,3955,[ 56  22 111 186 143],655,1,17651,4.461830131445905,0.0,0.0
13956,1,3956,[318 515 427 588  79],807,5,17656,4.461966135961587,40.0,0.0
13957,1,3957,[318 515 427 588  79],18,5,17661,4.462102071753411,40.0,0.0
13958,1,3958,[318 515 427 588  79],18,5,17666,4.462237938873453,40.0,0.0
13959,1,3959,[318 515 427 588  79],716,5,17671,4.4623737373737375,40.0,0.0
13960,1,3960,[318 515 427 588  79],716,5,17676,4.462509467306236,40.0,0.0
13961,1,3961,[318 515 427 588  79],807,5,17681,4.462645128722867,40.0,0.0
13962,1,3962,[318 515 427 588  79],18,5,17686,4.462780721675498,40.0,0.0
13963,1,3963,[318 515 427 588  79],716,5,17691,4.4629162462159435,40.0,0.0
13964,1,3964,[318 515 427 588  79],18,5,17696,4.463051702395965,40.0,0.0
13965,1,3965,[655 276  56 132 423],535,3,17699,4.4626828038325765,0.0,0.0
13966,1,3966,[423 275 210 173 144],457,5,17704,4.462818250567179,0.0,20.0
13967,1,3967,[318 515 427 588  79],716,5,17709,4.462953629032258,40.0,0.0
13968,1,3968,[318 515 427 588  79],18,5,17714,4.463088939279415,40.0,0.0
13969,1,3969,[318 515 427 588  79],716,5,17719,4.463224181360202,40.0,0.0
13970,1,3970,[318 515 427 588  79],807,5,17724,4.463359355326114,40.0,0.0
13971,1,3971,[318 515 427 588  79],807,5,17729,4.4634944612286,40.0,0.0
13972,1,3972,[144  89 111  15  95],796,5,17734,4.463629499119054,0.0,0.0
13973,1,3973,[318 515 427 588  79],807,5,17739,4.463764469048817,40.0,0.0
13974,1,3974,[318 515 427 588  79],716,5,17744,4.463899371069182,40.0,0.0
13975,1,3975,[318 515 427 588  79],18,5,17749,4.464034205231388,40.0,0.0
13976,1,3976,[ 64 196  96  79 195],655,2,17751,4.463414634146342,20.0,0.0
13977,1,3977,[318 515 427 588  79],18,5,17756,4.463549522373052,40.0,0.0
13978,1,3978,[301 269 322 181 273],450,4,17760,4.463433023372707,0.0,0.0
13979,1,3979,[333 258 200 135 234],655,2,17762,4.462814070351759,0.0,0.0
13980,1,3980,[143 161   8 483  50],457,5,17767,4.462949007786988,0.0,20.0
13981,1,3981,[318 515 427 588  79],18,5,17772,4.463083877448518,40.0,0.0
13982,1,3982,[318 515 427 588  79],807,5,17777,4.4632186793873965,40.0,0.0
13983,1,3983,[318 515 427 588  79],807,5,17782,4.463353413654619,40.0,0.0
13984,1,3984,[318 515 427 588  79],807,5,17787,4.463488080301129,40.0,0.0
13985,1,3985,[318 515 427 588  79],18,5,17792,4.463622679377822,40.0,0.0
13986,1,3986,[318 515 427 588  79],807,5,17797,4.46375721093554,40.0,0.0
13987,1,3987,[ 98 195  22 403 185],450,5,17802,4.463891675025075,0.0,0.0
13988,1,3988,[515 318 427 588  79],18,5,17807,4.464026071697167,40.0,0.0
13989,1,3989,[515 318 427 588  79],807,5,17812,4.464160401002506,40.0,0.0
13990,1,3990,[515 318 427 588  79],18,5,17817,4.4642946629917315,40.0,0.0
13991,1,3991,[161 655 185  98 257],796,4,17821,4.464178356713427,0.0,0.0
13992,1,3992,[ 12 423  28   1 174],457,5,17826,4.464312546957175,0.0,0.0
13993,1,3993,[515 318 427 588  79],18,5,17831,4.464446670005008,40.0,0.0
13994,1,3994,[175 300  12 228 204],151,5,17836,4.464580725907385,0.0,0.0
13995,1,3995,[181 405 222 172 185],796,5,17841,4.464714714714715,0.0,0.0
13996,1,3996,[118 302 237 234 568],655,1,17842,4.4638478859144355,0.0,0.0
13997,1,3997,[471 180 286  50 357],786,5,17847,4.463981990995498,0.0,40.0
13998,1,3998,[515 318 427 588  79],716,5,17852,4.4641160290072515,40.0,0.0
13999,1,3999,[515 318 427 588  79],18,5,17857,4.46425,40.0,0.0
14000,1,4000,[286 222 211 257   7],296,5,17862,4.464383904023994,0.0,20.0
14001,1,4001,[515 318 427 588  79],18,5,17867,4.464517741129435,40.0,0.0
14002,1,4002,[515 318 427 588  79],716,5,17872,4.464651511366475,40.0,0.0
14003,1,4003,[168 357 194 211 174],450,5,17877,4.4647852147852145,0.0,0.0
14004,1,4004,[515 318 427 588  79],18,5,17882,4.464918851435705,40.0,0.0
14005,1,4005,[ 70 183  12  25 258],655,1,17883,4.464053919121318,0.0,0.0
14006,1,4006,[143 118 194 153  79],389,2,17885,4.463438981781882,0.0,0.0
14007,1,4007,[515 318 427 588  79],716,5,17890,4.463572854291417,40.0,0.0
14008,1,4008,[515 318 427 588  79],716,5,17895,4.463706660014966,40.0,0.0
14009,1,4009,[515 318 427 588  79],18,5,17900,4.4638403990024935,40.0,0.0
14010,1,4010,[515 318 427 588  79],807,5,17905,4.463974071303914,40.0,0.0
14011,1,4011,[515 318 427 588  79],18,5,17910,4.464107676969093,40.0,0.0
14012,1,4012,[ 64 403 748 423 333],796,5,17915,4.464241216047845,20.0,0.0
14013,1,4013,[515 318 427 588  79],716,5,17920,4.464374688589936,40.0,0.0
14014,1,4014,[515 318 427 588  79],716,5,17925,4.464508094645081,40.0,0.0
14015,1,4015,[515 318 427 588  79],807,5,17930,4.464641434262949,40.0,0.0
14016,1,4016,[515 318 427 588  79],716,5,17935,4.464774707493154,40.0,0.0
14017,1,4017,[ 28 235 318 191  97],450,4,17939,4.464659034345446,20.0,0.0
14018,1,4018,[313 275 328 111 168],450,5,17944,4.464792236874844,0.0,20.0
14019,1,4019,[515 318 427 588  79],716,5,17949,4.464925373134329,40.0,0.0
14020,1,4020,[515 318 427 588  79],18,5,17954,4.46505844317334,40.0,0.0
14021,1,4021,[515 318 427 588  79],18,5,17959,4.465191447041273,40.0,0.0
14022,1,4022,[515 318 427 588  79],18,5,17964,4.465324384787472,40.0,0.0
14023,1,4023,[515 318 427 588  79],807,5,17969,4.4654572564612325,40.0,0.0
14024,1,4024,[ 50 294 301 258 483],902,2,17971,4.464844720496894,0.0,20.0
14025,1,4025,[282 546 117  70 234],593,3,17974,4.46448087431694,0.0,0.0
14026,1,4026,[515 318 427 588  79],716,5,17979,4.464613856468835,40.0,0.0
14027,1,4027,[515 318 427 588  79],807,5,17984,4.464746772591857,40.0,0.0
14028,1,4028,[515 318 427 588  79],18,5,17989,4.46487962273517,40.0,0.0
14029,1,4029,[515 318 427 588  79],716,5,17994,4.465012406947891,40.0,0.0
14030,1,4030,[427 300 282 288 435],655,1,17995,4.464152815678491,20.0,0.0
14031,1,4031,[ 79 195 117 118 655],280,2,17997,4.463541666666667,0.0,0.0
14032,1,4032,[515 318 427 588  79],716,5,18002,4.46367468385817,40.0,0.0
14033,1,4033,[515 318 427 588  79],807,5,18007,4.463807635101636,40.0,0.0
14034,1,4034,[179 423 286 183  28],786,5,18012,4.463940520446097,0.0,20.0
14035,1,4035,[515 318 427 588  79],18,5,18017,4.464073339940535,40.0,0.0
14036,1,4036,[515 318 427 588  79],18,5,18022,4.464206093633886,40.0,0.0
14037,1,4037,[515 318 427 588  79],18,5,18027,4.464338781575037,40.0,0.0
14038,1,4038,[515 318 427 588  79],807,5,18032,4.464471403812825,40.0,0.0
14039,1,4039,[357 117 216 742 197],504,5,18037,4.4646039603960395,0.0,0.0
14040,1,4040,[515 318 427 588  79],716,5,18042,4.4647364513734225,40.0,0.0
14041,1,4041,[ 50 151 125 655 181],151,5,18047,4.464868876793666,0.0,20.0
14042,1,4042,[515 318 427 588  79],18,5,18052,4.465001236705417,40.0,0.0
14043,1,4043,[ 95 111 385  11 471],280,4,18056,4.4648862512364,0.0,0.0
14044,1,4044,[515 318 427 588  79],807,5,18061,4.4650185414091474,40.0,0.0
14045,1,4045,[515 318 427 588  79],807,5,18066,4.465150766188828,40.0,0.0
14046,1,4046,[515 318 427 588  79],18,5,18071,4.465282925623919,40.0,0.0
14047,1,4047,[  7 258  12  11 275],655,1,18072,4.4644268774703555,0.0,20.0
14048,1,4048,[210 181 176 471 215],72,3,18075,4.464065201284268,0.0,0.0
14049,1,4049,[515 318 427 588  79],807,5,18080,4.4641975308641975,40.0,0.0
14050,1,4050,[515 318 427 588  79],18,5,18085,4.4643297951123175,40.0,0.0
14051,1,4051,[121 357  56 405   4],716,4,18089,4.464215202369201,0.0,0.0
14052,1,4052,[471 117 182 144 111],450,5,18094,4.464347396989884,0.0,0.0
14053,1,4053,[515 318 427 588  79],18,5,18099,4.464479526393685,40.0,0.0
14054,1,4054,[515 318 427 588  79],807,5,18104,4.464611590628853,40.0,0.0
14055,1,4055,[ 12 143 427 168  71],18,4,18108,4.464497041420119,20.0,0.0
14056,1,4056,[515 318 427 588  79],18,5,18113,4.46462903623367,40.0,0.0
14057,1,4057,[515 318 427 588  79],716,5,18118,4.4647609659931,40.0,0.0
14058,1,4058,[515 318 427 588  79],716,5,18123,4.464892830746489,40.0,0.0
14059,1,4059,[515 318 427 588  79],18,5,18128,4.465024630541872,40.0,0.0
14060,1,4060,[403 603 238   4 153],655,1,18129,4.46417138635804,20.0,0.0
14061,1,4061,[ 50 202 210 269 204],655,1,18130,4.463318562284589,0.0,20.0
14062,1,4062,[435 179  28 215  88],18,2,18132,4.462712281565346,0.0,0.0
14063,1,4063,[515 318 427 588  79],716,5,18137,4.462844488188976,40.0,0.0
14064,1,4064,[ 82 181 435 185 121],450,3,18140,4.462484624846248,0.0,0.0
14065,1,4065,[210 211 127 111 238],269,3,18143,4.462124938514511,0.0,20.0
14066,1,4066,[294 427 328 215 216],65,5,18148,4.46225719203344,20.0,0.0
14067,1,4067,[515 318 427 588  79],716,5,18153,4.462389380530974,40.0,0.0
14068,1,4068,[515 318 427 588  79],716,5,18158,4.462521504055051,40.0,0.0
14069,1,4069,[568 265 181 273 245],450,4,18162,4.462407862407862,0.0,0.0
14070,1,4070,[515 318 427 588  79],807,5,18167,4.462539916482437,40.0,0.0
14071,1,4071,[515 318 427 588  79],807,5,18172,4.462671905697446,40.0,0.0
14072,1,4072,[196  79 153 603 215],151,3,18175,4.462312791554137,20.0,0.0
14073,1,4073,[515 318 427 588  79],807,5,18180,4.462444771723122,40.0,0.0
14074,1,4074,[191  50 238 204  11],655,2,18182,4.461840490797546,0.0,20.0
14075,1,4075,[515 318 427 588  79],716,5,18187,4.461972522080471,40.0,0.0
14076,1,4076,[515 318 427 588  79],807,5,18192,4.462104488594555,40.0,0.0
14077,1,4077,[515 318 427 588  79],716,5,18197,4.462236390387445,40.0,0.0
14078,1,4078,[117  11 144 191 588],401,2,18199,4.461632753125766,0.0,0.0
14079,1,4079,[515 318 427 588  79],807,5,18204,4.461764705882353,40.0,0.0
14080,1,4080,[151 202 143   8 496],389,4,18208,4.461651555991178,20.0,0.0
14081,1,4081,[515 318 427 588  79],716,5,18213,4.461783439490445,40.0,0.0
14082,1,4082,[515 318 427 588  79],807,5,18218,4.46191525838844,40.0,0.0
14083,1,4083,[515 318 427 588  79],716,5,18223,4.462047012732615,40.0,0.0
14084,1,4084,[515 318 427 588  79],807,5,18228,4.462178702570379,40.0,0.0
14085,1,4085,[ 69 173 288 216 357],593,5,18233,4.462310327949094,0.0,0.0
14086,1,4086,[132 204 161 197 187],786,4,18237,4.462197210667972,0.0,0.0
14087,1,4087,[515 318 427 588  79],18,5,18242,4.462328767123288,40.0,0.0
14088,1,4088,[515 318 427 588  79],807,5,18247,4.462460259232086,40.0,0.0
14089,1,4089,[ 69 313  64   1 172],344,2,18249,4.461858190709046,20.0,0.0
14090,1,4090,[515 318 427 588  79],807,5,18254,4.461989733561476,40.0,0.0
14091,1,4091,[515 318 427 588  79],716,5,18259,4.462121212121212,40.0,0.0
14092,1,4092,[515 318 427 588  79],18,5,18264,4.462252626435378,40.0,0.0
14093,1,4093,[515 318 427 588  79],716,5,18269,4.462383976551051,40.0,0.0
14094,1,4094,[515 318 427 588  79],807,5,18274,4.462515262515263,40.0,0.0
14095,1,4095,[515 318 427 588  79],716,5,18279,4.462646484375,40.0,0.0
14096,1,4096,[515 318 427 588  79],18,5,18284,4.462777642177203,40.0,0.0
14097,1,4097,[515 318 427 588  79],807,5,18289,4.462908735968766,40.0,0.0
14098,1,4098,[515 318 427 588  79],716,5,18294,4.463039765796536,40.0,0.0
14099,1,4099,[515 318 427 588  79],18,5,18299,4.463170731707317,40.0,0.0
14100,1,4100,[515 318 427 588  79],716,5,18304,4.463301633747866,40.0,0.0
14101,1,4101,[515 318 427 588  79],716,5,18309,4.463432471964895,40.0,0.0
14102,1,4102,[515 318 427 588  79],807,5,18314,4.463563246405069,40.0,0.0
14103,1,4103,[515 318 427 588  79],807,5,18319,4.46369395711501,40.0,0.0
14104,1,4104,[515 318 427 588  79],716,5,18324,4.4638246041412915,40.0,0.0
14105,1,4105,[515 318 427 588  79],18,5,18329,4.463955187530443,40.0,0.0
14106,1,4106,[191 286 174 333 588],796,4,18333,4.463842220598977,0.0,20.0
14107,1,4107,[515 318 427 588  79],18,5,18338,4.463972736124635,40.0,0.0
14108,1,4108,[515 318 427 588  79],807,5,18343,4.464103188123631,40.0,0.0
14109,1,4109,[515 318 427 588  79],716,5,18348,4.464233576642336,40.0,0.0
14110,1,4110,[  7 161 385 144  71],450,4,18352,4.464120651909511,0.0,0.0
14111,1,4111,[515 318 427 588  79],807,5,18357,4.464250972762646,40.0,0.0
14112,1,4112,[515 318 427 588  79],18,5,18362,4.4643812302455625,40.0,0.0
14113,1,4113,[515 318 427 588  79],18,5,18367,4.464511424404472,40.0,0.0
14114,1,4114,[186   1 173  64  88],450,4,18371,4.464398541919806,20.0,0.0
14115,1,4115,[515 318 427 588  79],18,5,18376,4.464528668610301,40.0,0.0
14116,1,4116,[515 318 427 588  79],18,5,18381,4.464658732086471,40.0,0.0
14117,1,4117,[515 318 427 588  79],716,5,18386,4.464788732394366,40.0,0.0
14118,1,4118,[515 318 427 588  79],18,5,18391,4.464918669579995,40.0,0.0
14119,1,4119,[215  98 204 222 588],344,4,18395,4.464805825242719,0.0,0.0
14120,1,4120,[515 318 427 588  79],716,5,18400,4.464935695219607,40.0,0.0
14121,1,4121,[215 181 405 273 475],655,1,18401,4.464095099466278,0.0,0.0
14122,1,4122,[515 318 427 588  79],716,5,18406,4.4642250788260975,40.0,0.0
14123,1,4123,[515 318 427 588  79],716,5,18411,4.464354995150339,40.0,0.0
14124,1,4124,[210 132 238  15 121],269,2,18413,4.463757575757576,0.0,0.0
14125,1,4125,[515 318 427 588  79],807,5,18418,4.463887542413961,40.0,0.0
14126,1,4126,[515 318 427 588  79],716,5,18423,4.4640174460867454,40.0,0.0
14127,1,4127,[216 427  96 269 117],450,5,18428,4.464147286821706,20.0,0.0
14128,1,4128,[515 318 427 588  79],18,5,18433,4.464277064664568,40.0,0.0
14129,1,4129,[228 216 161 318  28],716,4,18437,4.464164648910412,20.0,0.0
14130,1,4130,[515 318 427 588  79],807,5,18442,4.464294359719196,40.0,0.0
14131,1,4131,[235  89 427 135 127],450,3,18445,4.463939980638916,20.0,20.0
14132,1,4132,[515 318 427 588  79],716,5,18450,4.464069683038955,40.0,0.0
14133,1,4133,[515 318 427 588  79],18,5,18455,4.464199322689889,40.0,0.0
14134,1,4134,[515 318 427 588  79],18,5,18460,4.464328899637243,40.0,0.0
14135,1,4135,[515 318 427 588  79],807,5,18465,4.464458413926499,40.0,0.0
14136,1,4136,[197 322 127 269 427],796,2,18467,4.463862702441383,20.0,20.0
14137,1,4137,[515 318 427 588  79],807,5,18472,4.463992266795554,40.0,0.0
14138,1,4138,[515 318 427 588  79],716,5,18477,4.4641217685431265,40.0,0.0
14139,1,4139,[258 211   4   7 286],535,3,18480,4.463768115942029,0.0,20.0
14140,1,4140,[515 318 427 588  79],18,5,18485,4.463897609273123,40.0,0.0
14141,1,4141,[ 28 588 176 186  64],457,5,18490,4.464027040077258,20.0,0.0
14142,1,4142,[742 197 211  98 427],693,2,18492,4.463432295438088,20.0,0.0
14143,1,4143,[515 318 427 588  79],18,5,18497,4.463561776061776,40.0,0.0
14144,1,4144,[515 318 427 588  79],18,5,18502,4.463691194209892,40.0,0.0
14145,1,4145,[515 318 427 588  79],18,5,18507,4.463820549927641,40.0,0.0
14146,1,4146,[ 96 144 143 181   4],716,2,18509,4.4632264287436705,0.0,0.0
14147,1,4147,[ 70 475 294 385 333],655,0,18509,4.462150433944069,0.0,0.0
14148,1,4148,[475 200  70 183  88],655,2,18511,4.4615570016871535,0.0,0.0
14149,1,4149,[515 318 427 588  79],807,5,18516,4.461686746987952,40.0,0.0
14150,1,4150,[  8 111 118 313 475],655,1,18517,4.460852806552638,0.0,0.0
14151,1,4151,[515 318 427 588  79],716,5,18522,4.460982658959537,40.0,0.0
14152,1,4152,[515 318 427 588  79],716,5,18527,4.46111244883217,40.0,0.0
14153,1,4153,[515 318 427 588  79],18,5,18532,4.461242176215696,40.0,0.0
14154,1,4154,[515 318 427 588  79],807,5,18537,4.461371841155235,40.0,0.0
14155,1,4155,[515 318 427 588  79],807,5,18542,4.4615014436958615,40.0,0.0
14156,1,4156,[216 183 100 172 195],352,5,18547,4.461630983882608,0.0,20.0
14157,1,4157,[515 318 427 588  79],18,5,18552,4.461760461760462,40.0,0.0
14158,1,4158,[515 318 427 588  79],18,5,18557,4.461889877374369,40.0,0.0
14159,1,4159,[173 202 471 132 215],716,4,18561,4.461778846153846,0.0,0.0
14160,1,4160,[144 215 288 268 483],655,1,18562,4.4609468877673635,0.0,0.0
14161,1,4161,[515 318 427 588  79],716,5,18567,4.461076405574243,40.0,0.0
14162,1,4162,[515 318 427 588  79],716,5,18572,4.4612058611578185,40.0,0.0
14163,1,4163,[515 318 427 588  79],807,5,18577,4.46133525456292,40.0,0.0
14164,1,4164,[515 318 427 588  79],807,5,18582,4.461464585834333,40.0,0.0
14165,1,4165,[515 318 427 588  79],18,5,18587,4.461593855016803,40.0,0.0
14166,1,4166,[568  12 483 195 286],280,3,18590,4.461243100551956,0.0,20.0
14167,1,4167,[179 216  98 655  25],655,3,18593,4.460892514395393,0.0,0.0
14168,1,4168,[515 318 427 588  79],807,5,18598,4.461021827776445,40.0,0.0
14169,1,4169,[515 318 427 588  79],716,5,18603,4.461151079136691,40.0,0.0
14170,1,4170,[515 318 427 588  79],716,5,18608,4.4612802685207384,40.0,0.0
14171,1,4171,[181 191 216 194  82],23,3,18611,4.460930009587727,0.0,0.0
14172,1,4172,[515 318 427 588  79],18,5,18616,4.461059190031152,40.0,0.0
14173,1,4173,[238  88 144  28 173],457,5,18621,4.461188308576904,0.0,0.0
14174,1,4174,[515 318 427 588  79],716,5,18626,4.461317365269461,40.0,0.0
14175,1,4175,[515 318 427 588  79],807,5,18631,4.461446360153257,40.0,0.0
14176,1,4176,[515 318 427 588  79],807,5,18636,4.461575293272683,40.0,0.0
14177,1,4177,[597  95 181 333  98],796,5,18641,4.461704164672092,0.0,0.0
14178,1,4178,[427   4 318  69 127],18,3,18644,4.461354391002632,40.0,20.0
14179,1,4179,[318 515 427 588  79],716,5,18649,4.461483253588517,40.0,0.0
14180,1,4180,[318 515 427 588  79],18,5,18654,4.4616120545324085,40.0,0.0
14181,1,4181,[318 515 427 588  79],18,5,18659,4.461740793878527,40.0,0.0
14182,1,4182,[318 515 427 588  79],18,5,18664,4.46186947167105,40.0,0.0
14183,1,4183,[  4 183 176  12 181],280,1,18665,4.46104206500956,0.0,0.0
14184,1,4184,[318 515 427 588  79],807,5,18670,4.4611708482676224,40.0,0.0
14185,1,4185,[180 100 603 265 427],450,5,18675,4.461299569995222,40.0,20.0
14186,1,4186,[318 515 427 588  79],807,5,18680,4.4614282302364465,40.0,0.0
14187,1,4187,[237  28 742 318  88],504,3,18683,4.461079274116523,20.0,0.0
14188,1,4188,[318 515 427 588  79],18,5,18688,4.461207925519217,40.0,0.0
14189,1,4189,[216 471 655  79  22],450,5,18693,4.461336515513127,0.0,0.0
14190,1,4190,[318 515 427 588  79],716,5,18698,4.4614650441422095,40.0,0.0
14191,1,4191,[318 515 427 588  79],18,5,18703,4.461593511450381,40.0,0.0
14192,1,4192,[318 515 427 588  79],18,5,18708,4.461721917481517,40.0,0.0
14193,1,4193,[ 82  97 423 603 191],450,4,18712,4.461611826418693,20.0,0.0
14194,1,4194,[515 318 427 588  79],18,5,18717,4.461740166865316,40.0,0.0
14195,1,4195,[515 318 427 588  79],716,5,18722,4.46186844613918,40.0,0.0
14196,1,4196,[515 318 427 588  79],807,5,18727,4.461996664284013,40.0,0.0
14197,1,4197,[423 496 265 135  71],280,5,18732,4.4621248213434965,20.0,0.0
14198,1,4198,[515 318 427 588  79],716,5,18737,4.462252917361276,40.0,0.0
14199,1,4199,[403 117  97 300 742],655,0,18737,4.461190476190477,0.0,0.0
14200,1,4200,[228 111 175 276 216],457,4,18741,4.461080695072602,0.0,0.0
14201,1,4201,[515 318 427 588  79],18,5,18746,4.461208948119943,40.0,0.0
14202,1,4202,[515 318 427 588  79],18,5,18751,4.461337140137997,40.0,0.0
14203,1,4203,[515 318 427 588  79],18,5,18756,4.461465271170314,40.0,0.0
14204,1,4204,[515 318 427 588  79],807,5,18761,4.4615933412604045,40.0,0.0
14205,1,4205,[168 183 258 216 186],504,3,18764,4.461245839277223,0.0,0.0
14206,1,4206,[515 318 427 588  79],807,5,18769,4.461373900641788,40.0,0.0
14207,1,4207,[222 322 173  70 328],151,3,18772,4.4610266159695815,0.0,0.0
14208,1,4208,[515 318 427 588  79],716,5,18777,4.461154668567356,40.0,0.0
14209,1,4209,[515 318 427 588  79],716,5,18782,4.461282660332541,40.0,0.0
14210,1,4210,[515 318 427 588  79],807,5,18787,4.461410591308478,40.0,0.0
14211,1,4211,[515 318 427 588  79],716,5,18792,4.461538461538462,40.0,0.0
14212,1,4212,[117 135 100  71  64],330,4,18796,4.461428910515072,20.0,20.0
14213,1,4213,[173 117 100  82 405],450,4,18800,4.461319411485524,0.0,20.0
14214,1,4214,[515 318 427 588  79],18,5,18805,4.461447212336892,40.0,0.0
14215,1,4215,[515 318 427 588  79],716,5,18810,4.46157495256167,40.0,0.0
14216,1,4216,[173  89 228 357 318],450,5,18815,4.461702632202988,20.0,0.0
14217,1,4217,[515 318 427 588  79],807,5,18820,4.461830251303936,40.0,0.0
14218,1,4218,[515 318 427 588  79],807,5,18825,4.461957809907561,40.0,0.0
14219,1,4219,[181 161 228 216 423],577,4,18829,4.461848341232227,0.0,0.0
14220,1,4220,[197 515 294 168 385],401,2,18831,4.461265103056148,0.0,0.0
14221,1,4221,[471 210 200 118 318],450,2,18833,4.460682141165324,20.0,0.0
14222,1,4222,[515 318 427 588  79],716,5,18838,4.460809850816955,40.0,0.0
14223,1,4223,[515 318 427 588  79],716,5,18843,4.4609375,40.0,0.0
14224,1,4224,[515 318 427 588  79],716,5,18848,4.461065088757397,40.0,0.0
14225,1,4225,[515 318 427 588  79],18,5,18853,4.46119261713204,40.0,0.0
14226,1,4226,[515 318 427 588  79],716,5,18858,4.461320085166785,40.0,0.0
14227,1,4227,[515 318 427 588  79],807,5,18863,4.461447492904447,40.0,0.0
14228,1,4228,[ 95 181 405 423 111],450,4,18867,4.461338377867108,0.0,0.0
14229,1,4229,[196 100 568 111 161],450,5,18872,4.461465721040189,0.0,20.0
14230,1,4230,[515 318 427 588  79],18,5,18877,4.4615930040179625,40.0,0.0
14231,1,4231,[515 318 427 588  79],807,5,18882,4.4617202268431,40.0,0.0
14232,1,4232,[ 12 200 471 182  56],450,4,18886,4.46161115048429,0.0,0.0
14233,1,4233,[515 318 427 588  79],18,5,18891,4.461738308927728,40.0,0.0
14234,1,4234,[515 318 427 588  79],716,5,18896,4.461865407319952,40.0,0.0
14235,1,4235,[515 318 427 588  79],18,5,18901,4.461992445703494,40.0,0.0
14236,1,4236,[515 318 427 588  79],18,5,18906,4.46211942412084,40.0,0.0
14237,1,4237,[183 405 588 204  71],344,3,18909,4.461774421897121,0.0,0.0
14238,1,4238,[515 318 427 588  79],716,5,18914,4.4619013918376975,40.0,0.0
14239,1,4239,[294 211  71  88  95],796,3,18917,4.461556603773585,0.0,0.0
14240,1,4240,[515 318 427 588  79],807,5,18922,4.461683565196887,40.0,0.0
14241,1,4241,[515 318 427 588  79],18,5,18927,4.461810466760962,40.0,0.0
14242,1,4242,[515 318 427 588  79],807,5,18932,4.461937308508131,40.0,0.0
14243,1,4243,[515 318 427 588  79],716,5,18937,4.462064090480679,40.0,0.0
14244,1,4244,[515 318 427 588  79],18,5,18942,4.4621908127208485,40.0,0.0
14245,1,4245,[515 318 427 588  79],807,5,18947,4.462317475270843,40.0,0.0
14246,1,4246,[228 265 403  71 187],450,4,18951,4.462208617847892,0.0,0.0
14247,1,4247,[161   8 182 234 174],457,5,18956,4.462335216572504,0.0,0.0
14248,1,4248,[515 318 427 588  79],807,5,18961,4.462461755707225,40.0,0.0
14249,1,4249,[12  1 98 89  4],450,4,18965,4.46235294117647,0.0,0.0
14250,1,4250,[515 318 427 588  79],716,5,18970,4.462479416607857,40.0,0.0
14251,1,4251,[175 471 211 172 135],655,2,18972,4.461900282220132,0.0,0.0
14252,1,4252,[ 70 508 301 275   1],344,3,18975,4.461556548318834,0.0,20.0
14253,1,4253,[176 257 181 185 483],457,4,18979,4.461448048895157,0.0,0.0
14254,1,4254,[515 318 427 588  79],716,5,18984,4.461574618096357,40.0,0.0
14255,1,4255,[515 318 427 588  79],807,5,18989,4.461701127819549,40.0,0.0
14256,1,4256,[172  89  97 222  64],72,2,18991,4.461122856471694,20.0,0.0
14257,1,4257,[322 273 276 127  97],344,3,18994,4.460779708783466,0.0,20.0
14258,1,4258,[318 515 427 588  79],807,5,18999,4.4609063160366285,40.0,0.0
14259,1,4259,[318 515 427 588  79],18,5,19004,4.461032863849765,40.0,0.0
14260,1,4260,[318 515 427 588  79],716,5,19009,4.461159352264726,40.0,0.0
14261,1,4261,[183  69 180 211 238],796,2,19011,4.460581886438292,0.0,0.0
14262,1,4262,[ 12  70  11 117 546],450,5,19016,4.460708421299555,0.0,0.0
14263,1,4263,[318 515 427 588  79],18,5,19021,4.460834896810507,40.0,0.0
14264,1,4264,[318 515 427 588  79],716,5,19026,4.460961313012896,40.0,0.0
14265,1,4265,[318 515 427 588  79],716,5,19031,4.461087669948429,40.0,0.0
14266,1,4266,[318 515 427 588  79],807,5,19036,4.461213967658777,40.0,0.0
14267,1,4267,[423 286 216 202 228],796,4,19040,4.4611059044048735,0.0,20.0
14268,1,4268,[318 515 427 588  79],18,5,19045,4.461232138674163,40.0,0.0
14269,1,4269,[318 515 427 588  79],18,5,19050,4.46135831381733,40.0,0.0
14270,1,4270,[318 515 427 588  79],716,5,19055,4.461484429875907,40.0,0.0
14271,1,4271,[318 515 427 588  79],18,5,19060,4.461610486891386,40.0,0.0
14272,1,4272,[318 515 427 588  79],18,5,19065,4.461736484905219,40.0,0.0
14273,1,4273,[196 313  12 202 300],639,0,19065,4.460692559663079,0.0,0.0
14274,1,4274,[318 515 427 588  79],716,5,19070,4.460818713450292,40.0,0.0
14275,1,4275,[318 515 427 588  79],807,5,19075,4.460944808231993,40.0,0.0
14276,1,4276,[318 515 427 588  79],807,5,19080,4.461070844049567,40.0,0.0
14277,1,4277,[ 96 194  25 143 210],504,4,19084,4.46096306685367,0.0,0.0
14278,1,4278,[515 318 427 588  79],807,5,19089,4.461089039495209,40.0,0.0
14279,1,4279,[515 318 427 588  79],18,5,19094,4.461214953271028,40.0,0.0
14280,1,4280,[515 318 427 588  79],807,5,19099,4.461340808222378,40.0,0.0
14281,1,4281,[515 318 427 588  79],807,5,19104,4.461466604390472,40.0,0.0
14282,1,4282,[515 318 427 588  79],18,5,19109,4.461592341816484,40.0,0.0
14283,1,4283,[515 318 427 588  79],716,5,19114,4.46171802054155,40.0,0.0
14284,1,4284,[ 79 300 161 568 186],716,3,19117,4.461376896149358,0.0,0.0
14285,1,4285,[515 318 427 588  79],807,5,19122,4.461502566495567,40.0,0.0
14286,1,4286,[515 318 427 588  79],807,5,19127,4.461628178213203,40.0,0.0
14287,1,4287,[168 161 176  28 496],389,4,19131,4.46152052238806,20.0,0.0
14288,1,4288,[515 318 427 588  79],807,5,19136,4.461646071345302,40.0,0.0
14289,1,4289,[ 64 289  96 211 117],693,2,19138,4.461072261072261,20.0,0.0
14290,1,4290,[515 318 427 588  79],807,5,19143,4.461197855977628,40.0,0.0
14291,1,4291,[515 318 427 588  79],18,5,19148,4.461323392357875,40.0,0.0
14292,1,4292,[515 318 427 588  79],18,5,19153,4.461448870253902,40.0,0.0
14293,1,4293,[508  15  50 258 125],15,3,19156,4.461108523521192,0.0,20.0
14294,1,4294,[515 318 427 588  79],807,5,19161,4.461233993015134,40.0,0.0
14295,1,4295,[515 318 427 588  79],807,5,19166,4.461359404096834,40.0,0.0
14296,1,4296,[515 318 427 588  79],18,5,19171,4.461484756807074,40.0,0.0
14297,1,4297,[515 318 427 588  79],716,5,19176,4.461610051186598,40.0,0.0
14298,1,4298,[515 318 427 588  79],807,5,19181,4.4617352872761105,40.0,0.0
14299,1,4299,[515 318 427 588  79],716,5,19186,4.461860465116279,40.0,0.0
14300,1,4300,[181 483 322 273  95],796,3,19189,4.4615205766100905,0.0,0.0
14301,1,4301,[515 318 427 588  79],807,5,19194,4.461645746164574,40.0,0.0
14302,1,4302,[228 191  88 313 180],693,1,19195,4.460841273530095,0.0,0.0
14303,1,4303,[269 471  64 427 568],655,2,19197,4.460269516728625,40.0,0.0
14304,1,4304,[515 318 427 588  79],807,5,19202,4.460394889663182,40.0,0.0
14305,1,4305,[515 318 427 588  79],18,5,19207,4.460520204366001,40.0,0.0
14306,1,4306,[515 318 427 588  79],18,5,19212,4.460645460877641,40.0,0.0
14307,1,4307,[515 318 427 588  79],716,5,19217,4.460770659238626,40.0,0.0
14308,1,4308,[ 50 286 655 153 118],151,3,19220,4.460431654676259,0.0,40.0
14309,1,4309,[322 197   1 216 181],796,2,19222,4.459860788863109,0.0,0.0
14310,1,4310,[515 318 427 588  79],807,5,19227,4.459986082115519,40.0,0.0
14311,1,4311,[515 318 427 588  79],18,5,19232,4.460111317254174,40.0,0.0
14312,1,4312,[515 318 427 588  79],807,5,19237,4.460236494319499,40.0,0.0
14313,1,4313,[515 318 427 588  79],18,5,19242,4.4603616133518775,40.0,0.0
14314,1,4314,[  4 405 121 161 302],655,1,19243,4.4595596755504054,0.0,0.0
14315,1,4315,[ 88 179  79 234  12],18,3,19246,4.459221501390176,0.0,0.0
14316,1,4316,[318 515 427 588  79],18,5,19251,4.459346768589298,40.0,0.0
14317,1,4317,[ 70 174  25 655 328],655,0,19251,4.458314034275127,0.0,0.0
14318,1,4318,[238 196 127 186 202],269,2,19253,4.457744848344524,0.0,20.0
14319,1,4319,[ 28  50 195 357 568],450,5,19258,4.457870370370371,0.0,20.0
14320,1,4320,[318 515 427 588  79],807,5,19263,4.457995834297616,40.0,0.0
14321,1,4321,[318 515 427 588  79],807,5,19268,4.45812124016659,40.0,0.0
14322,1,4322,[318 515 427 588  79],18,5,19273,4.45824658801758,40.0,0.0
14323,1,4323,[318 515 427 588  79],807,5,19278,4.458371877890841,40.0,0.0
14324,1,4324,[318 515 427 588  79],716,5,19283,4.45849710982659,40.0,0.0
14325,1,4325,[318 515 427 588  79],716,5,19288,4.458622283865003,40.0,0.0
14326,1,4326,[196  22 180 655  64],450,5,19293,4.458747400046222,20.0,0.0
14327,1,4327,[318 515 427 588  79],18,5,19298,4.458872458410351,40.0,0.0
14328,1,4328,[318 515 427 588  79],807,5,19303,4.458997458997459,40.0,0.0
14329,1,4329,[318 515 427 588  79],18,5,19308,4.4591224018475755,40.0,0.0
14330,1,4330,[258 496 588 301 275],344,4,19312,4.459016393442623,20.0,20.0
14331,1,4331,[318 515 427 588  79],18,5,19317,4.4591412742382275,40.0,0.0
14332,1,4332,[323   4 204 222 117],796,4,19321,4.459035310408493,0.0,0.0
14333,1,4333,[143 313   7  79   8],577,3,19324,4.458698661744347,0.0,0.0
14334,1,4334,[318 515 427 588  79],716,5,19329,4.458823529411765,40.0,0.0
14335,1,4335,[318 515 427 588  79],18,5,19334,4.458948339483395,40.0,0.0
14336,1,4336,[318 515 427 588  79],18,5,19339,4.459073091999078,40.0,0.0
14337,1,4337,[318 515 427 588  79],807,5,19344,4.459197786998617,40.0,0.0
14338,1,4338,[318 515 427 588  79],807,5,19349,4.459322424521779,40.0,0.0
14339,1,4339,[318 515 427 588  79],716,5,19354,4.459447004608295,40.0,0.0
14340,1,4340,[318 515 427 588  79],18,5,19359,4.459571527297857,40.0,0.0
14341,1,4341,[194 435 405 568 423],269,2,19361,4.459005066789498,0.0,0.0
14342,1,4342,[515 318 427 588  79],807,5,19366,4.459129633893622,40.0,0.0
14343,1,4343,[515 318 427 588  79],716,5,19371,4.459254143646409,40.0,0.0
14344,1,4344,[515 318 427 588  79],807,5,19376,4.459378596087457,40.0,0.0
14345,1,4345,[515 318 427 588  79],716,5,19381,4.459502991256327,40.0,0.0
14346,1,4346,[515 318 427 588  79],716,5,19386,4.459627329192546,40.0,0.0
14347,1,4347,[515 318 427 588  79],807,5,19391,4.459751609935602,40.0,0.0
14348,1,4348,[515 318 427 588  79],18,5,19396,4.459875833524948,40.0,0.0
14349,1,4349,[515 318 427 588  79],807,5,19401,4.46,40.0,0.0
14350,1,4350,[515 318 427 588  79],18,5,19406,4.460124109400138,40.0,0.0
14351,1,4351,[191  98 427   9  25],18,4,19410,4.460018382352941,20.0,0.0
14352,1,4352,[515 318 427 588  79],18,5,19415,4.4601424305076955,40.0,0.0
14353,1,4353,[515 318 427 588  79],18,5,19420,4.4602664216812125,40.0,0.0
14354,1,4354,[  9  69 197 172 132],280,3,19423,4.459931113662457,0.0,0.0
14355,1,4355,[265  69 289 179  88],236,2,19425,4.459366391184573,0.0,0.0
14356,1,4356,[385  70 289 180   7],786,5,19430,4.459490475097544,0.0,0.0
14357,1,4357,[515 318 427 588  79],18,5,19435,4.459614502065167,40.0,0.0
14358,1,4358,[515 318 427 588  79],807,5,19440,4.459738472126634,40.0,0.0
14359,1,4359,[515 318 427 588  79],807,5,19445,4.459862385321101,40.0,0.0
14360,1,4360,[546 210 655 185  98],236,3,19448,4.45952763127723,0.0,0.0
14361,1,4361,[117 135 100 200 322],629,4,19452,4.4594222833562585,0.0,20.0
14362,1,4362,[515 318 427 588  79],18,5,19457,4.459546183818474,40.0,0.0
14363,1,4363,[515 318 427 588  79],18,5,19462,4.459670027497708,40.0,0.0
14364,1,4364,[423 202 228 111 172],796,5,19467,4.45979381443299,0.0,0.0
14365,1,4365,[153 237 176 269 655],796,3,19470,4.45945945945946,0.0,0.0
14366,1,4366,[ 97 132 181 172 286],450,5,19475,4.45958323792077,0.0,20.0
14367,1,4367,[515 318 427 588  79],807,5,19480,4.45970695970696,40.0,0.0
14368,1,4368,[515 318 427 588  79],716,5,19485,4.459830624856947,40.0,0.0
14369,1,4369,[515 318 427 588  79],716,5,19490,4.459954233409611,40.0,0.0
14370,1,4370,[151 496 423 276 187],18,4,19494,4.459849004804393,20.0,0.0
14371,1,4371,[515 318 427 588  79],18,5,19499,4.4599725526075025,40.0,0.0
14372,1,4372,[202   7 204 216  98],151,5,19504,4.460096043905786,0.0,0.0
14373,1,4373,[515 318 427 588  79],716,5,19509,4.460219478737997,40.0,0.0
14374,1,4374,[515 318 427 588  79],716,5,19514,4.460342857142857,40.0,0.0
14375,1,4375,[515 318 427 588  79],716,5,19519,4.46046617915905,40.0,0.0
14376,1,4376,[515 318 427 588  79],716,5,19524,4.460589444825223,40.0,0.0
14377,1,4377,[515 318 427 588  79],807,5,19529,4.460712654179991,40.0,0.0
14378,1,4378,[515 318 427 588  79],716,5,19534,4.460835807261932,40.0,0.0
14379,1,4379,[172 153 200 127 237],655,3,19537,4.460502283105023,0.0,20.0
14380,1,4380,[515 318 427 588  79],807,5,19542,4.460625427984478,40.0,0.0
14381,1,4381,[515 318 427 588  79],807,5,19547,4.46074851665906,40.0,0.0
14382,1,4382,[515 318 427 588  79],18,5,19552,4.460871549167237,40.0,0.0
14383,1,4383,[515 318 427 588  79],807,5,19557,4.460994525547445,40.0,0.0
14384,1,4384,[515 318 427 588  79],18,5,19562,4.4611174458380844,40.0,0.0
14385,1,4385,[515 318 427 588  79],716,5,19567,4.461240310077519,40.0,0.0
14386,1,4386,[210 153 100 318 237],236,2,19569,4.460679279689993,20.0,20.0
14387,1,4387,[515 318 427 588  79],716,5,19574,4.460802187784868,40.0,0.0
14388,1,4388,[515 318 427 588  79],807,5,19579,4.460925039872408,40.0,0.0
14389,1,4389,[515 318 427 588  79],716,5,19584,4.461047835990889,40.0,0.0
14390,1,4390,[210 202 655 588  56],280,2,19586,4.460487360510134,0.0,0.0
14391,1,4391,[515 318 427 588  79],716,5,19591,4.4606102003642984,40.0,0.0
14392,1,4392,[515 318 427 588  79],807,5,19596,4.460732984293194,40.0,0.0
14393,1,4393,[515 318 427 588  79],807,5,19601,4.460855712335002,40.0,0.0
14394,1,4394,[515 318 427 588  79],18,5,19606,4.4609783845278725,40.0,0.0
14395,1,4395,[515 318 427 588  79],807,5,19611,4.461101000909918,40.0,0.0
14396,1,4396,[ 22  97 238 183  11],655,1,19612,4.460313850352513,0.0,0.0
14397,1,4397,[515 318 427 588  79],807,5,19617,4.46043656207367,40.0,0.0
14398,1,4398,[515 318 427 588  79],716,5,19622,4.460559218004092,40.0,0.0
14399,1,4399,[515 318 427 588  79],807,5,19627,4.460681818181818,40.0,0.0
14400,1,4400,[515 318 427 588  79],716,5,19632,4.460804362644853,40.0,0.0
14401,1,4401,[ 64 182 286 237 269],535,3,19635,4.460472512494321,20.0,20.0
14402,1,4402,[515 318 427 588  79],716,5,19640,4.460595048830343,40.0,0.0
14403,1,4403,[197 175 403 257  88],655,0,19640,4.459582198001817,0.0,0.0
14404,1,4404,[515 318 427 588  79],716,5,19645,4.459704880817253,40.0,0.0
14405,1,4405,[515 318 427 588  79],716,5,19650,4.4598275079437135,40.0,0.0
14406,1,4406,[515 318 427 588  79],716,5,19655,4.459950079419106,40.0,0.0
14407,1,4407,[210 117 174  71 151],401,2,19657,4.459392014519056,0.0,0.0
14408,1,4408,[515 318 427 588  79],716,5,19662,4.459514629167612,40.0,0.0
14409,1,4409,[515 318 427 588  79],18,5,19667,4.4596371882086165,40.0,0.0
14410,1,4410,[515 318 427 588  79],807,5,19672,4.459759691679891,40.0,0.0
14411,1,4411,[515 318 427 588  79],807,5,19677,4.4598821396192205,40.0,0.0
14412,1,4412,[515 318 427 588  79],807,5,19682,4.460004532064355,40.0,0.0
14413,1,4413,[515 318 427 588  79],716,5,19687,4.460126869053013,40.0,0.0
14414,1,4414,[515 318 427 588  79],807,5,19692,4.460249150622877,40.0,0.0
14415,1,4415,[515 318 427 588  79],807,5,19697,4.460371376811594,40.0,0.0
14416,1,4416,[515 318 427 588  79],716,5,19702,4.460493547656781,40.0,0.0
14417,1,4417,[515 318 427 588  79],18,5,19707,4.460615663196016,40.0,0.0
14418,1,4418,[235 234 655 275 568],716,4,19711,4.46051142792487,0.0,20.0
14419,1,4419,[515 318 427 588  79],807,5,19716,4.460633484162896,40.0,0.0
14420,1,4420,[515 318 427 588  79],716,5,19721,4.460755485184348,40.0,0.0
14421,1,4421,[237  79 282  95 181],716,4,19725,4.460651289009498,0.0,0.0
14422,1,4422,[515 318 427 588  79],18,5,19730,4.4607732308387975,40.0,0.0
14423,1,4423,[515 318 427 588  79],716,5,19735,4.460895117540687,40.0,0.0
14424,1,4424,[515 318 427 588  79],716,5,19740,4.461016949152542,40.0,0.0
14425,1,4425,[515 318 427 588  79],18,5,19745,4.461138725711703,40.0,0.0
14426,1,4426,[515 318 427 588  79],807,5,19750,4.461260447255477,40.0,0.0
14427,1,4427,[515 318 427 588  79],807,5,19755,4.461382113821138,40.0,0.0
14428,1,4428,[144 182 222 200 301],796,4,19759,4.461277940844434,0.0,0.0
14429,1,4429,[515 318 427 588  79],807,5,19764,4.461399548532731,40.0,0.0
14430,1,4430,[515 318 427 588  79],807,5,19769,4.4615211013315275,40.0,0.0
14431,1,4431,[176 127  15 271 183],796,5,19774,4.461642599277979,0.0,20.0
14432,1,4432,[515 318 427 588  79],716,5,19779,4.461764042409204,40.0,0.0
14433,1,4433,[153 282 289  98 222],236,4,19783,4.461659900766802,0.0,0.0
14434,1,4434,[302 508 427  69 268],269,3,19786,4.461330326944758,20.0,0.0
14435,1,4435,[515 318 427 588  79],18,5,19791,4.461451758340847,40.0,0.0
14436,1,4436,[210 289 125 405 195],786,5,19796,4.461573135001127,0.0,0.0
14437,1,4437,[515 318 427 588  79],807,5,19801,4.461694456962595,40.0,0.0
14438,1,4438,[515 318 427 588  79],18,5,19806,4.461815724262221,40.0,0.0
14439,1,4439,[172 210 286 273 200],655,3,19809,4.4614864864864865,0.0,20.0
14440,1,4440,[515 318 427 588  79],18,5,19814,4.4616077460031525,40.0,0.0
14441,1,4441,[515 318 427 588  79],716,5,19819,4.461728950923008,40.0,0.0
14442,1,4442,[515 318 427 588  79],716,5,19824,4.461850101282917,40.0,0.0
14443,1,4443,[515 318 427 588  79],18,5,19829,4.461971197119712,40.0,0.0
14444,1,4444,[515 318 427 588  79],716,5,19834,4.462092238470191,40.0,0.0
14445,1,4445,[301 118 357 191  89],151,3,19837,4.461763382816015,0.0,0.0
14446,1,4446,[515 318 427 588  79],716,5,19842,4.461884416460535,40.0,0.0
14447,1,4447,[515 318 427 588  79],807,5,19847,4.462005395683454,40.0,0.0
14448,1,4448,[294 271 742  71 117],796,3,19850,4.461676781299168,0.0,0.0
14449,1,4449,[515 318 427 588  79],716,5,19855,4.461797752808989,40.0,0.0
14450,1,4450,[185 183 195 174 265],796,5,19860,4.461918669961807,0.0,0.0
14451,1,4451,[568  28 483 385  71],450,3,19863,4.461590296495957,0.0,0.0
14452,1,4452,[515 318 427 588  79],716,5,19868,4.461711205928587,40.0,0.0
14453,1,4453,[515 318 427 588  79],18,5,19873,4.461832061068702,40.0,0.0
14454,1,4454,[515 318 427 588  79],807,5,19878,4.461952861952862,40.0,0.0
14455,1,4455,[151 187 423 200 153],716,4,19882,4.461849192100539,0.0,0.0
14456,1,4456,[174  50   4   8  25],389,4,19886,4.4617455687682295,0.0,20.0
14457,1,4457,[ 22 313 515  69 183],655,3,19889,4.461417676087931,0.0,0.0
14458,1,4458,[ 22 276 238 294 234],655,1,19890,4.460641399416909,0.0,0.0
14459,1,4459,[515 318 427 588  79],18,5,19895,4.460762331838565,40.0,0.0
14460,1,4460,[187 118 265   7 282],256,3,19898,4.460434880071733,0.0,0.0
14461,1,4461,[121  79 187 313 301],296,5,19903,4.460555804571941,0.0,0.0
14462,1,4462,[288 678  70  50   1],344,2,19905,4.4600044812906114,0.0,20.0
14463,1,4463,[515 318 427 588  79],716,5,19910,4.460125448028674,40.0,0.0
14464,1,4464,[515 318 427 588  79],807,5,19915,4.460246360582307,40.0,0.0
14465,1,4465,[515 318 427 588  79],807,5,19920,4.4603672189879084,40.0,0.0
14466,1,4466,[196 427 195 181 403],18,1,19921,4.459592567718827,20.0,0.0
14467,1,4467,[238 275 173  95 161],23,4,19925,4.459489704565801,0.0,20.0
14468,1,4468,[483 271 183 111 222],796,5,19930,4.459610651152383,0.0,0.0
14469,1,4469,[515 318 427 588  79],18,5,19935,4.459731543624161,40.0,0.0
14470,1,4470,[282 127 181 111 186],450,4,19939,4.459628718407515,0.0,20.0
14471,1,4471,[515 318 427 588  79],716,5,19944,4.459749552772808,40.0,0.0
14472,1,4472,[515 318 427 588  79],18,5,19949,4.4598703331097695,40.0,0.0
14473,1,4473,[515 318 427 588  79],18,5,19954,4.459991059454627,40.0,0.0
14474,1,4474,[515 318 427 588  79],18,5,19959,4.4601117318435755,40.0,0.0
14475,1,4475,[515 318 427 588  79],716,5,19964,4.460232350312779,40.0,0.0
14476,1,4476,[181 176 187 111 185],450,5,19969,4.46035291489837,0.0,0.0
14477,1,4477,[318 515 427 588  79],807,5,19974,4.460473425636445,40.0,0.0
14478,1,4478,[427 286  88 174  97],18,4,19978,4.460370618441616,20.0,20.0
14479,1,4479,[318 515 427 588  79],807,5,19983,4.460491071428572,40.0,0.0
14480,1,4480,[318 515 427 588  79],716,5,19988,4.4606114706538715,40.0,0.0
14481,1,4481,[ 28  64 204 168 125],731,3,19991,4.460285586791611,20.0,0.0
14482,1,4482,[187  69 135 118 196],389,2,19993,4.4597367834039705,0.0,0.0
14483,1,4483,[288  11 273 294 238],629,2,19995,4.459188224799286,0.0,0.0
14484,1,4484,[286  96 515  22  28],655,1,19996,4.458416945373467,0.0,20.0
14485,1,4485,[318 515 427 588  79],807,5,20001,4.458537672759697,40.0,0.0
14486,1,4486,[318 515 427 588  79],807,5,20006,4.458658346333853,40.0,0.0
14487,1,4487,[318 515 427 588  79],716,5,20011,4.4587789661319075,40.0,0.0
14488,1,4488,[ 11  12 179   9 475],655,1,20012,4.458008465137001,0.0,0.0
14489,1,4489,[318 515 427 588  79],807,5,20017,4.458129175946548,40.0,0.0
14490,1,4490,[318 515 427 588  79],807,5,20022,4.458249832999332,40.0,0.0
14491,1,4491,[318 515 427 588  79],18,5,20027,4.458370436331256,40.0,0.0
14492,1,4492,[318 515 427 588  79],18,5,20032,4.458490985978188,40.0,0.0
14493,1,4493,[ 50 144 294 185 197],401,3,20035,4.458166444147753,0.0,20.0
14494,1,4494,[483 322 276  69  82],280,4,20039,4.458064516129032,0.0,0.0
14495,1,4495,[318 515 427 588  79],807,5,20044,4.458185053380783,40.0,0.0
14496,1,4496,[257 678   9 125 187],504,4,20048,4.458083166555482,0.0,0.0
14497,1,4497,[ 97  69  11 288 318],457,5,20053,4.458203646064918,20.0,0.0
14498,1,4498,[  8 268 405 174 275],344,3,20056,4.457879528784174,0.0,20.0
14499,1,4499,[300 269 471 265  88],655,0,20056,4.456888888888889,0.0,0.0
14500,1,4500,[318 515 427 588  79],716,5,20061,4.45700955343257,40.0,0.0
14501,1,4501,[318 515 427 588  79],807,5,20066,4.4571301643713905,40.0,0.0
14502,1,4502,[318 515 427 588  79],18,5,20071,4.457250721741062,40.0,0.0
14503,1,4503,[318 515 427 588  79],807,5,20076,4.457371225577265,40.0,0.0
14504,1,4504,[318 515 427 588  79],716,5,20081,4.457491675915649,40.0,0.0
14505,1,4505,[318 515 427 588  79],716,5,20086,4.457612072791833,40.0,0.0
14506,1,4506,[318 515 427 588  79],807,5,20091,4.457732416241402,40.0,0.0
14507,1,4507,[318 515 427 588  79],716,5,20096,4.457852706299911,40.0,0.0
14508,1,4508,[318 515 427 588  79],18,5,20101,4.457972943002883,40.0,0.0
14509,1,4509,[318 515 427 588  79],807,5,20106,4.458093126385809,40.0,0.0
14510,1,4510,[191 313 471 172  25],655,3,20109,4.457769895810242,0.0,0.0
14511,1,4511,[318 515 427 588  79],716,5,20114,4.4578900709219855,40.0,0.0
14512,1,4512,[318 515 427 588  79],716,5,20119,4.458010192776424,40.0,0.0
14513,1,4513,[318 515 427 588  79],807,5,20124,4.45813026140895,40.0,0.0
14514,1,4514,[318 515 427 588  79],716,5,20129,4.458250276854928,40.0,0.0
14515,1,4515,[318 515 427 588  79],807,5,20134,4.45837023914969,40.0,0.0
14516,1,4516,[318 515 427 588  79],18,5,20139,4.458490148328536,40.0,0.0
14517,1,4517,[318 515 427 588  79],18,5,20144,4.458610004426737,40.0,0.0
14518,1,4518,[  4  11  64 508  70],535,4,20148,4.458508519583979,20.0,0.0
14519,1,4519,[318 515 427 588  79],18,5,20153,4.458628318584071,40.0,0.0
14520,1,4520,[318 515 427 588  79],716,5,20158,4.458748064587481,40.0,0.0
14521,1,4521,[204 195 357  89 269],344,5,20163,4.458867757629368,0.0,0.0
14522,1,4522,[385 181 153 275   7],151,3,20166,4.458545213353968,0.0,20.0
14523,1,4523,[ 89  25 403 200 216],655,3,20169,4.458222811671088,0.0,0.0
14524,1,4524,[318 515 427 588  79],716,5,20174,4.458342541436464,40.0,0.0
14525,1,4525,[318 515 427 588  79],716,5,20179,4.4584622182943,40.0,0.0
14526,1,4526,[318 515 427 588  79],716,5,20184,4.4585818422796555,40.0,0.0
14527,1,4527,[568 357 269 183  89],450,5,20189,4.458701413427562,0.0,0.0
14528,1,4528,[318 515 427 588  79],716,5,20194,4.458820931773018,40.0,0.0
14529,1,4529,[318 515 427 588  79],716,5,20199,4.458940397350993,40.0,0.0
14530,1,4530,[318 515 427 588  79],807,5,20204,4.4590598101964245,40.0,0.0
14531,1,4531,[318 515 427 588  79],807,5,20209,4.4591791703442185,40.0,0.0
14532,1,4532,[318 515 427 588  79],807,5,20214,4.459298477829252,40.0,0.0
14533,1,4533,[318 515 427 588  79],716,5,20219,4.4594177326863695,40.0,0.0
14534,1,4534,[195 265 275 194 179],535,4,20223,4.459316427783903,0.0,20.0
14535,1,4535,[318 515 427 588  79],716,5,20228,4.459435626102293,40.0,0.0
14536,1,4536,[318 515 427 588  79],18,5,20233,4.4595547718756885,40.0,0.0
14537,1,4537,[318 515 427 588  79],18,5,20238,4.459673865138828,40.0,0.0
14538,1,4538,[222  82  69 588 215],457,5,20243,4.459792905926416,0.0,0.0
14539,1,4539,[318 515 427 588  79],716,5,20248,4.4599118942731275,40.0,0.0
14540,1,4540,[318 515 427 588  79],18,5,20253,4.46003083021361,40.0,0.0
14541,1,4541,[318 515 427 588  79],18,5,20258,4.460149713782474,40.0,0.0
14542,1,4542,[318 515 427 588  79],716,5,20263,4.460268545014308,40.0,0.0
14543,1,4543,[318 515 427 588  79],18,5,20268,4.460387323943662,40.0,0.0
14544,1,4544,[318 515 427 588  79],18,5,20273,4.46050605060506,40.0,0.0
14545,1,4545,[174 204  15 196  98],796,5,20278,4.4606247250329965,0.0,0.0
14546,1,4546,[318 515 427 588  79],18,5,20283,4.460743347261931,40.0,0.0
14547,1,4547,[318 515 427 588  79],18,5,20288,4.460861917326297,40.0,0.0
14548,1,4548,[318 515 427 588  79],807,5,20293,4.460980435260497,40.0,0.0
14549,1,4549,[318 515 427 588  79],716,5,20298,4.461098901098901,40.0,0.0
14550,1,4550,[318 515 427 588  79],18,5,20303,4.461217314875851,40.0,0.0
14551,1,4551,[318 515 427 588  79],807,5,20308,4.461335676625659,40.0,0.0
14552,1,4552,[318 515 427 588  79],807,5,20313,4.461453986382605,40.0,0.0
14553,1,4553,[318 515 427 588  79],18,5,20318,4.46157224418094,40.0,0.0
14554,1,4554,[318 515 427 588  79],807,5,20323,4.461690450054885,40.0,0.0
14555,1,4555,[546  82 282 385   4],280,2,20325,4.461150131694469,0.0,0.0
14556,1,4556,[318 515 427 588  79],716,5,20330,4.46126837831907,40.0,0.0
14557,1,4557,[318 515 427 588  79],18,5,20335,4.461386573058359,40.0,0.0
14558,1,4558,[318 515 427 588  79],807,5,20340,4.46150471594648,40.0,0.0
14559,1,4559,[318 515 427 588  79],18,5,20345,4.461622807017544,40.0,0.0
14560,1,4560,[318 515 427 588  79],716,5,20350,4.461740846305635,40.0,0.0
14561,1,4561,[318 515 427 588  79],716,5,20355,4.461858833844805,40.0,0.0
14562,1,4562,[318 515 427 588  79],716,5,20360,4.461976769669078,40.0,0.0
14563,1,4563,[318 515 427 588  79],716,5,20365,4.4620946538124455,40.0,0.0
14564,1,4564,[318 515 427 588  79],716,5,20370,4.4622124863088715,40.0,0.0
14565,1,4565,[318 515 427 588  79],716,5,20375,4.462330267192291,40.0,0.0
14566,1,4566,[318 515 427 588  79],18,5,20380,4.462447996496606,40.0,0.0
14567,1,4567,[318 515 427 588  79],716,5,20385,4.462565674255692,40.0,0.0
14568,1,4568,[318 515 427 588  79],18,5,20390,4.462683300503392,40.0,0.0
14569,1,4569,[181 125 100  96 210],655,0,20390,4.461706783369803,0.0,20.0
14570,1,4570,[ 56 210  64 200 568],450,3,20393,4.461387005031722,20.0,0.0
14571,1,4571,[265 655 216 405 282],450,5,20398,4.461504811898513,0.0,0.0
14572,1,4572,[655 176 273 357 153],655,2,20400,4.4609665427509295,0.0,0.0
14573,1,4573,[111 275 328 271 286],629,4,20404,4.460865763008308,0.0,40.0
14574,1,4574,[318 515 427 588  79],807,5,20409,4.460983606557377,40.0,0.0
14575,1,4575,[ 82   7 273 215 300],450,3,20412,4.460664335664336,0.0,0.0
14576,1,4576,[318 515 427 588  79],18,5,20417,4.460782171728206,40.0,0.0
14577,1,4577,[318 515 427 588  79],18,5,20422,4.4608999563128,40.0,0.0
14578,1,4578,[318 515 427 588  79],716,5,20427,4.461017689451845,40.0,0.0
14579,1,4579,[318 515 427 588  79],18,5,20432,4.461135371179039,40.0,0.0
14580,1,4580,[118 245 183 301   7],344,3,20435,4.460816415629775,0.0,0.0
14581,1,4581,[318 515 427 588  79],716,5,20440,4.460934089917067,40.0,0.0
14582,1,4582,[318 515 427 588  79],716,5,20445,4.461051712851844,40.0,0.0
14583,1,4583,[318 515 427 588  79],716,5,20450,4.461169284467714,40.0,0.0
14584,1,4584,[318 515 427 588  79],18,5,20455,4.461286804798255,40.0,0.0
14585,1,4585,[318 515 427 588  79],807,5,20460,4.461404273877017,40.0,0.0
14586,1,4586,[318 515 427 588  79],716,5,20465,4.461521691737519,40.0,0.0
14587,1,4587,[228 143 175  11 289],655,1,20466,4.460767218831735,0.0,0.0
14588,1,4588,[318 515 427 588  79],716,5,20471,4.460884724340815,40.0,0.0
14589,1,4589,[318 515 427 588  79],18,5,20476,4.461002178649237,40.0,0.0
14590,1,4590,[318 515 427 588  79],18,5,20481,4.461119581790459,40.0,0.0
14591,1,4591,[ 28 202  12 323 143],796,3,20484,4.460801393728223,0.0,0.0
14592,1,4592,[318 515 427 588  79],18,5,20489,4.460918789462225,40.0,0.0
14593,1,4593,[318 515 427 588  79],807,5,20494,4.461036134087941,40.0,0.0
14594,1,4594,[588 215  56  50  88],23,3,20497,4.460718171926007,0.0,20.0
14595,1,4595,[318 515 427 588  79],716,5,20502,4.460835509138382,40.0,0.0
14596,1,4596,[318 515 427 588  79],807,5,20507,4.460952795301283,40.0,0.0
14597,1,4597,[ 82 294  56 195 132],23,3,20510,4.460635058721183,0.0,0.0
14598,1,4598,[318 515 427 588  79],716,5,20515,4.460752337464666,40.0,0.0
14599,1,4599,[318 515 427 588  79],807,5,20520,4.460869565217391,40.0,0.0
14600,1,4600,[143 597  97 132  89],457,4,20524,4.460769397956966,0.0,0.0
14601,1,4601,[ 98   1   4 200 179],786,5,20529,4.460886571056062,0.0,0.0
14602,1,4602,[216   9   4 318 655],796,3,20532,4.46056919400391,20.0,0.0
14603,1,4603,[318 515 427 588  79],716,5,20537,4.460686359687228,40.0,0.0
14604,1,4604,[318 515 427 588  79],716,5,20542,4.460803474484257,40.0,0.0
14605,1,4605,[318 515 427 588  79],807,5,20547,4.460920538428137,40.0,0.0
14606,1,4606,[  9 508  69  11 515],401,1,20548,4.460169307575429,0.0,0.0
14607,1,4607,[318 515 427 588  79],716,5,20553,4.460286458333333,40.0,0.0
14608,1,4608,[405 179 204 210 100],885,3,20556,4.459969624647429,0.0,20.0
14609,1,4609,[318 515 427 588  79],807,5,20561,4.460086767895879,40.0,0.0
14610,1,4610,[180 204 228 483 143],716,4,20565,4.459986987638256,0.0,0.0
14611,1,4611,[318 515 427 588  79],18,5,20570,4.4601040763226365,40.0,0.0
14612,1,4612,[273  96 357 546 235],344,3,20573,4.4597875569044,0.0,0.0
14613,1,4613,[318 515 427 588  79],807,5,20578,4.4599046380580845,40.0,0.0
14614,1,4614,[318 515 427 588  79],807,5,20583,4.460021668472373,40.0,0.0
14615,1,4615,[318 515 427 588  79],18,5,20588,4.4601386481802425,40.0,0.0
14616,1,4616,[318 515 427 588  79],807,5,20593,4.4602555772146415,40.0,0.0
14617,1,4617,[318 515 427 588  79],807,5,20598,4.460372455608488,40.0,0.0
14618,1,4618,[318 515 427 588  79],18,5,20603,4.460489283394674,40.0,0.0
14619,1,4619,[318 515 427 588  79],716,5,20608,4.460606060606061,40.0,0.0
14620,1,4620,[318 515 427 588  79],807,5,20613,4.460722787275482,40.0,0.0
14621,1,4621,[294 191 176 127 273],655,3,20616,4.460406750324535,0.0,20.0
14622,1,4622,[181 187 172 234 174],655,2,20618,4.45987454034177,0.0,0.0
14623,1,4623,[318 515 427 588  79],807,5,20623,4.459991349480969,40.0,0.0
14624,1,4624,[318 515 427 588  79],716,5,20628,4.460108108108108,40.0,0.0
14625,1,4625,[318 515 427 588  79],18,5,20633,4.460224816255945,40.0,0.0
14626,1,4626,[118   9 427 282 195],796,4,20637,4.460125351199482,20.0,0.0
14627,1,4627,[318 515 427 588  79],807,5,20642,4.460242005185825,40.0,0.0
14628,1,4628,[318 515 427 588  79],716,5,20647,4.460358608770793,40.0,0.0
14629,1,4629,[318 515 427 588  79],716,5,20652,4.460475161987041,40.0,0.0
14630,1,4630,[313 235 286 403 322],280,3,20655,4.4601597927013605,0.0,20.0
14631,1,4631,[318 515 427 588  79],716,5,20660,4.460276338514681,40.0,0.0
14632,1,4632,[318 515 427 588  79],807,5,20665,4.460392834016836,40.0,0.0
14633,1,4633,[318 515 427 588  79],716,5,20670,4.460509279240397,40.0,0.0
14634,1,4634,[318 515 427 588  79],807,5,20675,4.460625674217908,40.0,0.0
14635,1,4635,[318 515 427 588  79],807,5,20680,4.460742018981881,40.0,0.0
14636,1,4636,[318 515 427 588  79],716,5,20685,4.460858313564805,40.0,0.0
14637,1,4637,[318 515 427 588  79],18,5,20690,4.460974557999138,40.0,0.0
14638,1,4638,[318 515 427 588  79],18,5,20695,4.461090752317309,40.0,0.0
14639,1,4639,[318 515 427 588  79],18,5,20700,4.461206896551724,40.0,0.0
14640,1,4640,[318 515 427 588  79],18,5,20705,4.461322990734756,40.0,0.0
14641,1,4641,[318 515 427 588  79],18,5,20710,4.461439034898751,40.0,0.0
14642,1,4642,[318 515 427 588  79],716,5,20715,4.461555029076028,40.0,0.0
14643,1,4643,[111 153 405  50 475],292,4,20719,4.461455641688199,0.0,20.0
14644,1,4644,[318 515 427 588  79],807,5,20724,4.461571582346609,40.0,0.0
14645,1,4645,[269 176 186 301  71],796,2,20726,4.461041756349548,0.0,0.0
14646,1,4646,[318 515 427 588  79],18,5,20731,4.461157736173876,40.0,0.0
14647,1,4647,[318 515 427 588  79],18,5,20736,4.461273666092943,40.0,0.0
14648,1,4648,[318 515 427 588  79],807,5,20741,4.461389546138955,40.0,0.0
14649,1,4649,[176 191 204  79 597],23,1,20742,4.460645161290323,0.0,0.0
14650,1,4650,[ 70 423  50 100 111],65,3,20745,4.460331111588905,0.0,40.0
14651,1,4651,[318 234 435 237  98],72,4,20749,4.460232158211522,20.0,0.0
14652,1,4652,[318 515 427 588  79],18,5,20754,4.460348162475822,40.0,0.0
14653,1,4653,[318 515 427 588  79],716,5,20759,4.460464116888698,40.0,0.0
14654,1,4654,[318 515 427 588  79],807,5,20764,4.4605800214822775,40.0,0.0
14655,1,4655,[318 515 427 588  79],716,5,20769,4.46069587628866,40.0,0.0
14656,1,4656,[318 515 427 588  79],18,5,20774,4.460811681339918,40.0,0.0
14657,1,4657,[318 515 427 588  79],807,5,20779,4.460927436668098,40.0,0.0
14658,1,4658,[118 200 357 180 161],796,4,20783,4.460828503970809,0.0,0.0
14659,1,4659,[151 210 245 180 238],450,4,20787,4.460729613733905,0.0,0.0
14660,1,4660,[100 403 173 655  71],450,4,20791,4.460630765930058,0.0,20.0
14661,1,4661,[318 515 427 588  79],716,5,20796,4.460746460746461,40.0,0.0
14662,1,4662,[318 515 427 588  79],18,5,20801,4.4608621059403815,40.0,0.0
14663,1,4663,[318 515 427 588  79],18,5,20806,4.460977701543739,40.0,0.0
14664,1,4664,[318 515 427 588  79],716,5,20811,4.461093247588424,40.0,0.0
14665,1,4665,[196 202 302 258 742],450,5,20816,4.461208744106301,0.0,0.0
14666,1,4666,[318 515 427 588  79],716,5,20821,4.461324191129205,40.0,0.0
14667,1,4667,[318 515 427 588  79],18,5,20826,4.461439588688946,40.0,0.0
14668,1,4668,[245 265 234  89  15],450,3,20829,4.46112657956736,0.0,0.0
14669,1,4669,[318 515 427 588  79],18,5,20834,4.461241970021414,40.0,0.0
14670,1,4670,[318 515 427 588  79],18,5,20839,4.461357311068293,40.0,0.0
14671,1,4671,[318 515 427 588  79],18,5,20844,4.461472602739726,40.0,0.0
14672,1,4672,[318 515 427 588  79],18,5,20849,4.461587845067409,40.0,0.0
14673,1,4673,[318 515 427 588  79],716,5,20854,4.461703038083012,40.0,0.0
14674,1,4674,[318 515 427 588  79],18,5,20859,4.461818181818182,40.0,0.0
14675,1,4675,[318 515 427 588  79],18,5,20864,4.461933276304534,40.0,0.0
14676,1,4676,[318 515 427 588  79],18,5,20869,4.462048321573659,40.0,0.0
14677,1,4677,[ 50 245 471 125 235],938,1,20870,4.461308251389482,0.0,20.0
14678,1,4678,[318 515 427 588  79],716,5,20875,4.46142338106433,40.0,0.0
14679,1,4679,[318 515 427 588  79],807,5,20880,4.461538461538462,40.0,0.0
14680,1,4680,[172 228 196 234  96],23,3,20883,4.461226233710746,0.0,0.0
14681,1,4681,[588  25 168 135   7],450,3,20886,4.460914139256728,0.0,0.0
14682,1,4682,[185 742 187  82 748],450,4,20890,4.460815716421098,0.0,0.0
14683,1,4683,[318 515 427 588  79],716,5,20895,4.460930828351836,40.0,0.0
14684,1,4684,[318 515 427 588  79],716,5,20900,4.461045891141942,40.0,0.0
14685,1,4685,[181 405 151  64 127],269,3,20903,4.460734101579172,20.0,20.0
14686,1,4686,[ 69 186 237 568 181],796,4,20907,4.460635801152123,0.0,0.0
14687,1,4687,[318 515 427 588  79],716,5,20912,4.460750853242321,40.0,0.0
14688,1,4688,[318 515 427 588  79],18,5,20917,4.46086585625933,40.0,0.0
14689,1,4689,[403 215 546 174 186],577,4,20921,4.460767590618337,0.0,0.0
14690,1,4690,[313  11 194  15 403],577,3,20924,4.460456192709444,0.0,0.0
14691,1,4691,[132 328 161 237 135],450,4,20928,4.460358056265985,0.0,0.0
14692,1,4692,[318 515 427 588  79],18,5,20933,4.46047304496058,40.0,0.0
14693,1,4693,[318 515 427 588  79],807,5,20938,4.460587984661269,40.0,0.0
14694,1,4694,[318 515 427 588  79],807,5,20943,4.460702875399361,40.0,0.0
14695,1,4695,[318 515 427 588  79],807,5,20948,4.460817717206133,40.0,0.0
14696,1,4696,[318 515 427 588  79],807,5,20953,4.460932510112838,40.0,0.0
14697,1,4697,[  1 204 483 174 323],796,3,20956,4.460621541081311,0.0,0.0
14698,1,4698,[318 515 427 588  79],716,5,20961,4.4607363268780595,40.0,0.0
14699,1,4699,[318 515 427 588  79],716,5,20966,4.460851063829788,40.0,0.0
14700,1,4700,[318 515 427 588  79],716,5,20971,4.460965751967667,40.0,0.0
14701,1,4701,[318 515 427 588  79],18,5,20976,4.461080391322842,40.0,0.0
14702,1,4702,[405 117 175 172 200],716,4,20980,4.460982351690411,0.0,0.0
14703,1,4703,[318 515 427 588  79],807,5,20985,4.46109693877551,40.0,0.0
14704,1,4704,[318 515 427 588  79],807,5,20990,4.461211477151966,40.0,0.0
14705,1,4705,[597  97 471 603 288],450,4,20994,4.461113472163196,20.0,0.0
14706,1,4706,[318 515 427 588  79],807,5,20999,4.461227958359889,40.0,0.0
14707,1,4707,[318 515 427 588  79],18,5,21004,4.461342395921835,40.0,0.0
14708,1,4708,[318 515 427 588  79],716,5,21009,4.461456784880017,40.0,0.0
14709,1,4709,[318 515 427 588  79],18,5,21014,4.461571125265393,40.0,0.0
14710,1,4710,[318 515 427 588  79],716,5,21019,4.461685417108894,40.0,0.0
14711,1,4711,[435  88 100 182  97],18,4,21023,4.461587436332767,0.0,20.0
14712,1,4712,[318 515 427 588  79],716,5,21028,4.461701676214725,40.0,0.0
14713,1,4713,[173 153 483 191 302],269,2,21030,4.461179465422147,0.0,0.0
14714,1,4714,[318 515 427 588  79],807,5,21035,4.461293743372217,40.0,0.0
14715,1,4715,[318 515 427 588  79],716,5,21040,4.461407972858354,40.0,0.0
14716,1,4716,[318 515 427 588  79],18,5,21045,4.4615221539113845,40.0,0.0
14717,1,4717,[237 196 202  69 588],457,5,21050,4.461636286562102,0.0,0.0
14718,1,4718,[318 515 427 588  79],716,5,21055,4.46175037084128,40.0,0.0
14719,1,4719,[318 515 427 588  79],716,5,21060,4.461864406779661,40.0,0.0
14720,1,4720,[318 515 427 588  79],716,5,21065,4.461978394407964,40.0,0.0
14721,1,4721,[318 515 427 588  79],716,5,21070,4.462092333756883,40.0,0.0
14722,1,4722,[318 515 427 588  79],18,5,21075,4.462206224857082,40.0,0.0
14723,1,4723,[318 515 427 588  79],807,5,21080,4.462320067739204,40.0,0.0
14724,1,4724,[258 215 143  98 483],457,5,21085,4.462433862433863,0.0,0.0
14725,1,4725,[318 515 427 588  79],716,5,21090,4.462547608971646,40.0,0.0
14726,1,4726,[318 515 427 588  79],716,5,21095,4.462661307383118,40.0,0.0
14727,1,4727,[318 515 427 588  79],18,5,21100,4.462774957698816,40.0,0.0
14728,1,4728,[301 496 318  22 181],450,5,21105,4.462888559949249,40.0,0.0
14729,1,4729,[318 515 427 588  79],716,5,21110,4.4630021141649046,40.0,0.0
14730,1,4730,[318 515 427 588  79],807,5,21115,4.463115620376242,40.0,0.0
14731,1,4731,[318 515 427 588  79],18,5,21120,4.463229078613694,40.0,0.0
14732,1,4732,[318 515 427 588  79],18,5,21125,4.46334248890767,40.0,0.0
14733,1,4733,[318 515 427 588  79],807,5,21130,4.4634558512885505,40.0,0.0
14734,1,4734,[318 515 427 588  79],716,5,21135,4.463569165786695,40.0,0.0
14735,1,4735,[318 515 427 588  79],807,5,21140,4.4636824324324325,40.0,0.0
14736,1,4736,[179  88 111  70 313],593,5,21145,4.463795651256069,0.0,0.0
14737,1,4737,[318 515 427 588  79],716,5,21150,4.463908822287885,40.0,0.0
14738,1,4738,[318 515 427 588  79],716,5,21155,4.464021945558135,40.0,0.0
14739,1,4739,[318 515 427 588  79],18,5,21160,4.4641350210970465,40.0,0.0
14740,1,4740,[318 515 427 588  79],716,5,21165,4.464248048934824,40.0,0.0
14741,1,4741,[318 515 427 588  79],716,5,21170,4.464361029101645,40.0,0.0
14742,1,4742,[172 273  11 174 403],693,2,21172,4.463841450558718,0.0,0.0
14743,1,4743,[186  88 269 742 475],655,0,21172,4.4629005059021924,0.0,0.0
14744,1,4744,[318 515 427 588  79],716,5,21177,4.463013698630137,40.0,0.0
14745,1,4745,[173  69 271 435 313],807,2,21179,4.4624947324062365,0.0,0.0
14746,1,4746,[318 515 427 588  79],716,5,21184,4.462607962923952,40.0,0.0
14747,1,4747,[202 200 475  70 271],655,1,21185,4.461878685762426,0.0,0.0
14748,1,4748,[ 22 471 294 222 276],655,1,21186,4.461149715729627,0.0,0.0
14749,1,4749,[273 515 161 282  97],655,2,21188,4.4606315789473685,0.0,0.0
14750,1,4750,[318 515 427 588  79],807,5,21193,4.460745106293412,40.0,0.0
14751,1,4751,[318 515 427 588  79],18,5,21198,4.460858585858586,40.0,0.0
14752,1,4752,[318 515 427 588  79],716,5,21203,4.460972017673049,40.0,0.0
14753,1,4753,[318 515 427 588  79],807,5,21208,4.461085401766933,40.0,0.0
14754,1,4754,[318 515 427 588  79],716,5,21213,4.461198738170347,40.0,0.0
14755,1,4755,[269  22 357 655 216],655,2,21215,4.460681244743482,0.0,0.0
14756,1,4756,[318 515 427 588  79],18,5,21220,4.460794618457011,40.0,0.0
14757,1,4757,[318 515 427 588  79],18,5,21225,4.460907944514502,40.0,0.0
14758,1,4758,[318 515 427 588  79],18,5,21230,4.461021222945997,40.0,0.0
14759,1,4759,[318 515 427 588  79],18,5,21235,4.461134453781512,40.0,0.0
14760,1,4760,[ 15 588 111 405 179],450,4,21239,4.4610375971434575,0.0,0.0
14761,1,4761,[ 97 271 186 427 185],796,3,21242,4.460730785384293,20.0,0.0
14762,1,4762,[143 742 194 234 195],796,3,21245,4.460424102456435,0.0,0.0
14763,1,4763,[318 515 427 588  79],716,5,21250,4.460537363560033,40.0,0.0
14764,1,4764,[ 88 183 135 568 333],693,2,21252,4.460020986358867,0.0,0.0
14765,1,4765,[318 515 427 588  79],716,5,21257,4.460134284515317,40.0,0.0
14766,1,4766,[269  69 427  89 271],796,4,21261,4.460037759597231,20.0,0.0
14767,1,4767,[258 211 323 153 546],796,3,21264,4.459731543624161,0.0,0.0
14768,1,4768,[318 515 427 588  79],18,5,21269,4.45984483120151,40.0,0.0
14769,1,4769,[ 96  25 181 228 153],450,4,21273,4.459748427672956,0.0,0.0
14770,1,4770,[318 515 427 588  79],18,5,21278,4.459861664221338,40.0,0.0
14771,1,4771,[194 385  15 202  97],457,5,21283,4.459974853310981,0.0,0.0
14772,1,4772,[318 515 427 588  79],18,5,21288,4.460087994971716,40.0,0.0
14773,1,4773,[318 515 427 588  79],716,5,21293,4.4602010892333475,40.0,0.0
14774,1,4774,[111 196 117 357  97],786,5,21298,4.460314136125654,0.0,0.0
14775,1,4775,[318 515 427 588  79],716,5,21303,4.460427135678392,40.0,0.0
14776,1,4776,[100 603 191 127 313],655,4,21307,4.460330751517689,20.0,40.0
14777,1,4777,[318 515 427 588  79],807,5,21312,4.46044370029301,40.0,0.0
14778,1,4778,[318 515 427 588  79],18,5,21317,4.4605566017995395,40.0,0.0
14779,1,4779,[318 515 427 588  79],716,5,21322,4.460669456066945,40.0,0.0
14780,1,4780,[318 515 427 588  79],716,5,21327,4.4607822631248695,40.0,0.0
14781,1,4781,[318 515 427 588  79],18,5,21332,4.460895023002927,40.0,0.0
14782,1,4782,[318 515 427 588  79],807,5,21337,4.461007735730713,40.0,0.0
14783,1,4783,[  4  70 175 405 118],457,5,21342,4.4611204013377925,0.0,0.0
14784,1,4784,[ 28 403 100  69 427],18,2,21344,4.460606060606061,20.0,20.0
14785,1,4785,[318 515 427 588  79],716,5,21349,4.460718763058922,40.0,0.0
14786,1,4786,[117 172  98 210 111],457,4,21353,4.460622519323167,0.0,0.0
14787,1,4787,[588 483 357  82 215],911,2,21355,4.460108604845447,0.0,0.0
14788,1,4788,[318 515 427 588  79],18,5,21360,4.4602213405721445,40.0,0.0
14789,1,4789,[318 515 427 588  79],807,5,21365,4.460334029227558,40.0,0.0
14790,1,4790,[318 515 427 588  79],807,5,21370,4.4604466708411605,40.0,0.0
14791,1,4791,[318 515 427 588  79],18,5,21375,4.460559265442404,40.0,0.0
14792,1,4792,[318 515 427 588  79],807,5,21380,4.4606718130607135,40.0,0.0
14793,1,4793,[318 515 427 588  79],716,5,21385,4.46078431372549,40.0,0.0
14794,1,4794,[318 515 427 588  79],716,5,21390,4.46089676746611,40.0,0.0
14795,1,4795,[318 515 427 588  79],716,5,21395,4.4610091743119265,40.0,0.0
14796,1,4796,[318 515 427 588  79],716,5,21400,4.461121534292266,40.0,0.0
14797,1,4797,[318 515 427 588  79],18,5,21405,4.461233847436432,40.0,0.0
14798,1,4798,[318 515 427 588  79],18,5,21410,4.461346113773703,40.0,0.0
14799,1,4799,[318 515 427 588  79],807,5,21415,4.461458333333334,40.0,0.0
14800,1,4800,[318 515 427 588  79],18,5,21420,4.461570506144553,40.0,0.0
14801,1,4801,[318 515 427 588  79],716,5,21425,4.461682632236568,40.0,0.0
14802,1,4802,[318 515 427 588  79],18,5,21430,4.461794711638559,40.0,0.0
14803,1,4803,[318 515 427 588  79],807,5,21435,4.461906744379683,40.0,0.0
14804,1,4804,[318 515 427 588  79],807,5,21440,4.462018730489074,40.0,0.0
14805,1,4805,[403 161 742 100  97],577,5,21445,4.4621306699958385,0.0,20.0
14806,1,4806,[318 515 427 588  79],18,5,21450,4.462242562929061,40.0,0.0
14807,1,4807,[318 515 427 588  79],807,5,21455,4.462354409317804,40.0,0.0
14808,1,4808,[195 228 269 197  69],655,0,21455,4.461426491994177,0.0,0.0
14809,1,4809,[318 515 427 588  79],807,5,21460,4.461538461538462,40.0,0.0
14810,1,4810,[318 515 427 588  79],716,5,21465,4.46165038453544,40.0,0.0
14811,1,4811,[275 234  71 588 228],450,3,21468,4.461346633416459,0.0,20.0
14812,1,4812,[318 515 427 588  79],807,5,21473,4.461458549761064,40.0,0.0
14813,1,4813,[318 515 427 588  79],18,5,21478,4.4615704196094725,40.0,0.0
14814,1,4814,[318 515 427 588  79],807,5,21483,4.461682242990654,40.0,0.0
14815,1,4815,[318 515 427 588  79],18,5,21488,4.461794019933555,40.0,0.0
14816,1,4816,[318 515 427 588  79],716,5,21493,4.461905750467095,40.0,0.0
14817,1,4817,[318 515 427 588  79],807,5,21498,4.462017434620174,40.0,0.0
14818,1,4818,[172 273 173 496 597],796,4,21502,4.461921560489728,20.0,0.0
14819,1,4819,[318 515 427 588  79],716,5,21507,4.462033195020747,40.0,0.0
14820,1,4820,[ 71  22  69 742 161],280,5,21512,4.462144783239991,0.0,0.0
14821,1,4821,[318 515 427 588  79],18,5,21517,4.462256325176275,40.0,0.0
14822,1,4822,[318 515 427 588  79],716,5,21522,4.462367820858387,40.0,0.0
14823,1,4823,[268 483   4 210  79],535,2,21524,4.461857379767827,0.0,0.0
14824,1,4824,[318 515 427 588  79],18,5,21529,4.461968911917099,40.0,0.0
14825,1,4825,[318 515 427 588  79],807,5,21534,4.462080397845006,40.0,0.0
14826,1,4826,[318 515 427 588  79],18,5,21539,4.462191837580278,40.0,0.0
14827,1,4827,[318 515 427 588  79],807,5,21544,4.4623032311516155,40.0,0.0
14828,1,4828,[318 515 427 588  79],716,5,21549,4.462414578587699,40.0,0.0
14829,1,4829,[318 515 427 588  79],18,5,21554,4.462525879917184,40.0,0.0
14830,1,4830,[125 111  11 186 175],457,4,21558,4.462430138687642,0.0,0.0
14831,1,4831,[318 515 427 588  79],807,5,21563,4.462541390728477,40.0,0.0
14832,1,4832,[144 197 175 228 118],716,2,21565,4.462031864266502,0.0,0.0
14833,1,4833,[748 313 191 742 301],796,3,21568,4.461729416632188,0.0,0.0
14834,1,4834,[318 515 427 588  79],807,5,21573,4.4618407445708375,40.0,0.0
14835,1,4835,[ 69 588 597 176  56],457,4,21577,4.461745244003309,0.0,0.0
14836,1,4836,[318 515 427 588  79],716,5,21582,4.461856522637999,40.0,0.0
14837,1,4837,[318 515 427 588  79],18,5,21587,4.461967755270773,40.0,0.0
14838,1,4838,[318 515 427 588  79],716,5,21592,4.462078941930151,40.0,0.0
14839,1,4839,[318 515 427 588  79],807,5,21597,4.462190082644628,40.0,0.0
14840,1,4840,[318 515 427 588  79],807,5,21602,4.4623011774426775,40.0,0.0
14841,1,4841,[318 515 427 588  79],807,5,21607,4.462412226352747,40.0,0.0
14842,1,4842,[568 678  69  70  71],344,1,21608,4.461697295065043,0.0,0.0
14843,1,4843,[318 515 427 588  79],716,5,21613,4.461808422791082,40.0,0.0
14844,1,4844,[191  69 143  28 294],796,3,21616,4.461506707946336,0.0,0.0
14845,1,4845,[318 515 427 588  79],716,5,21621,4.461617829137433,40.0,0.0
14846,1,4846,[318 515 427 588  79],716,5,21626,4.461728904476996,40.0,0.0
14847,1,4847,[176 117 215 121 265],796,5,21631,4.461839933993399,0.0,0.0
14848,1,4848,[318 515 427 588  79],18,5,21636,4.461950917714993,40.0,0.0
14849,1,4849,[175 183   1  25 257],716,3,21639,4.461649484536083,0.0,0.0
14850,1,4850,[318 515 427 588  79],716,5,21644,4.461760461760462,40.0,0.0
14851,1,4851,[144 175 257 588 216],23,3,21647,4.461459192085738,0.0,0.0
14852,1,4852,[318 515 427 588  79],807,5,21652,4.461570162785906,40.0,0.0
14853,1,4853,[318 515 427 588  79],716,5,21657,4.46168108776267,40.0,0.0
14854,1,4854,[174 508 313  89 237],344,3,21660,4.461380020597322,0.0,0.0
14855,1,4855,[181 151  50 215 143],18,2,21662,4.460873146622735,0.0,20.0
14856,1,4856,[318 515 427 588  79],807,5,21667,4.460984146592547,40.0,0.0
14857,1,4857,[153 742 568 197 222],655,0,21667,4.460065870728695,0.0,0.0
14858,1,4858,[318 515 427 588  79],716,5,21672,4.460176991150442,40.0,0.0
14859,1,4859,[318 515 427 588  79],716,5,21677,4.4602880658436215,40.0,0.0
14860,1,4860,[318 515 427 588  79],716,5,21682,4.460399094836453,40.0,0.0
14861,1,4861,[ 69 117 228  98 403],72,3,21685,4.460098724804607,0.0,0.0
14862,1,4862,[318 515 427 588  79],18,5,21690,4.46020974706971,40.0,0.0
14863,1,4863,[318 515 427 588  79],716,5,21695,4.460320723684211,40.0,0.0
14864,1,4864,[318 515 427 588  79],807,5,21700,4.460431654676259,40.0,0.0
14865,1,4865,[318 515 427 588  79],807,5,21705,4.460542540073983,40.0,0.0
14866,1,4866,[132 333 143 117  22],655,1,21706,4.4598315183891515,0.0,0.0
14867,1,4867,[318 515 427 588  79],18,5,21711,4.459942481511915,40.0,0.0
14868,1,4868,[318 515 427 588  79],716,5,21716,4.460053399055248,40.0,0.0
14869,1,4869,[318 515 427 588  79],18,5,21721,4.460164271047228,40.0,0.0
14870,1,4870,[179 235 301 385 302],450,4,21725,4.460069800862246,0.0,0.0
14871,1,4871,[318 515 427 588  79],807,5,21730,4.460180623973727,40.0,0.0
14872,1,4872,[318 515 427 588  79],807,5,21735,4.4602914016006565,40.0,0.0
14873,1,4873,[318 515 427 588  79],807,5,21740,4.46040213377103,40.0,0.0
14874,1,4874,[186 286 597 153  88],450,4,21744,4.460307692307692,0.0,20.0
14875,1,4875,[318 515 427 588  79],807,5,21749,4.4604183757178015,40.0,0.0
14876,1,4876,[318 515 427 588  79],716,5,21754,4.460529013737954,40.0,0.0
14877,1,4877,[318 515 427 588  79],18,5,21759,4.460639606396064,40.0,0.0
14878,1,4878,[318 515 427 588  79],18,5,21764,4.460750153720024,40.0,0.0
14879,1,4879,[318 515 427 588  79],716,5,21769,4.460860655737705,40.0,0.0
14880,1,4880,[318 515 427 588  79],807,5,21774,4.460971112476951,40.0,0.0
14881,1,4881,[318 515 427 588  79],716,5,21779,4.461081523965587,40.0,0.0
14882,1,4882,[216 125   4 197 238],457,5,21784,4.461191890231415,0.0,0.0
14883,1,4883,[318 515 427 588  79],716,5,21789,4.461302211302211,40.0,0.0
14884,1,4884,[318 515 427 588  79],716,5,21794,4.461412487205732,40.0,0.0
14885,1,4885,[318 515 427 588  79],18,5,21799,4.461522717969709,40.0,0.0
14886,1,4886,[318 515 427 588  79],807,5,21804,4.461632903621854,40.0,0.0
14887,1,4887,[318 515 427 588  79],807,5,21809,4.461743044189853,40.0,0.0
14888,1,4888,[318 515 427 588  79],716,5,21814,4.46185313970137,40.0,0.0
14889,1,4889,[318 515 427 588  79],716,5,21819,4.461963190184049,40.0,0.0
14890,1,4890,[318 515 427 588  79],18,5,21824,4.462073195665508,40.0,0.0
14891,1,4891,[318 515 427 588  79],807,5,21829,4.462183156173344,40.0,0.0
14892,1,4892,[318 515 427 588  79],716,5,21834,4.4622930717351315,40.0,0.0
14893,1,4893,[318 515 427 588  79],807,5,21839,4.462402942378422,40.0,0.0
14894,1,4894,[318 515 427 588  79],807,5,21844,4.462512768130746,40.0,0.0
14895,1,4895,[200  70   9  50  11],593,4,21848,4.462418300653595,0.0,20.0
14896,1,4896,[121 118 183   4  71],344,2,21850,4.461915458443945,0.0,0.0
14897,1,4897,[187 144 176 210  98],655,2,21852,4.46141282155982,0.0,0.0
14898,1,4898,[ 95 483 168  22 228],716,5,21857,4.461522759746887,0.0,0.0
14899,1,4899,[318 515 427 588  79],18,5,21862,4.4616326530612245,40.0,0.0
14900,1,4900,[318 515 427 588  79],807,5,21867,4.4617425015303,40.0,0.0
14901,1,4901,[318 515 427 588  79],716,5,21872,4.461852305181559,40.0,0.0
14902,1,4902,[333  82 269 202 403],655,0,21872,4.46094228023659,0.0,0.0
14903,1,4903,[ 11   8 187 483 515],535,3,21875,4.460644371941273,0.0,0.0
14904,1,4904,[318 515 427 588  79],18,5,21880,4.460754332313965,40.0,0.0
14905,1,4905,[323 144 282 183 204],280,0,21880,4.459845087647778,0.0,0.0
14906,1,4906,[318 515 427 588  79],18,5,21885,4.4599551660892605,40.0,0.0
14907,1,4907,[168 143 271 121 187],796,5,21890,4.460065199674002,0.0,0.0
14908,1,4908,[318 515 427 588  79],716,5,21895,4.460175188429416,40.0,0.0
14909,1,4909,[318 515 427 588  79],18,5,21900,4.460285132382892,40.0,0.0
14910,1,4910,[318 515 427 588  79],716,5,21905,4.4603950315618,40.0,0.0
14911,1,4911,[268 210 200 111  89],655,2,21907,4.459894136807818,0.0,0.0
14912,1,4912,[118  56  82 191 210],72,3,21910,4.459596987583961,0.0,0.0
14913,1,4913,[318 515 427 588  79],18,5,21915,4.45970695970696,40.0,0.0
14914,1,4914,[318 515 427 588  79],716,5,21920,4.4598168870803665,40.0,0.0
14915,1,4915,[318 515 427 588  79],807,5,21925,4.459926769731489,40.0,0.0
14916,1,4916,[318 515 427 588  79],807,5,21930,4.460036607687615,40.0,0.0
14917,1,4917,[318 515 427 588  79],18,5,21935,4.460146400976006,40.0,0.0
14918,1,4918,[318 515 427 588  79],807,5,21940,4.460256149623907,40.0,0.0
14919,1,4919,[318 515 427 588  79],18,5,21945,4.460365853658536,40.0,0.0
14920,1,4920,[318 515 427 588  79],18,5,21950,4.460475513107092,40.0,0.0
14921,1,4921,[300  50 153 234 588],716,5,21955,4.460585127996749,0.0,20.0
14922,1,4922,[318 515 427 588  79],807,5,21960,4.460694698354661,40.0,0.0
14923,1,4923,[508  12 181 597 245],344,2,21962,4.460194963444354,0.0,0.0
14924,1,4924,[318 515 427 588  79],807,5,21967,4.460304568527919,40.0,0.0
14925,1,4925,[318 515 427 588  79],716,5,21972,4.46041412911084,40.0,0.0
14926,1,4926,[318 515 427 588  79],716,5,21977,4.460523645220215,40.0,0.0
14927,1,4927,[318 515 427 588  79],716,5,21982,4.460633116883117,40.0,0.0
14928,1,4928,[318 515 427 588  79],18,5,21987,4.460742544126598,40.0,0.0
14929,1,4929,[475 301 191 234 357],655,2,21989,4.460243407707911,0.0,0.0
14930,1,4930,[318 515 427 588  79],716,5,21994,4.460352869600487,40.0,0.0
14931,1,4931,[318 515 427 588  79],716,5,21999,4.4604622871046224,40.0,0.0
14932,1,4932,[318 515 427 588  79],807,5,22004,4.460571660247314,40.0,0.0
14933,1,4933,[318 515 427 588  79],807,5,22009,4.4606809890555335,40.0,0.0
14934,1,4934,[ 28  22 187 286  50],655,2,22011,4.460182370820669,0.0,40.0
14935,1,4935,[318 515 427 588  79],807,5,22016,4.460291734197731,40.0,0.0
14936,1,4936,[100 294 546  56 322],280,3,22019,4.459995948956856,0.0,20.0
14937,1,4937,[318 515 427 588  79],807,5,22024,4.460105305791819,40.0,0.0
14938,1,4938,[318 515 427 588  79],18,5,22029,4.4602146183437945,40.0,0.0
14939,1,4939,[318 515 427 588  79],18,5,22034,4.460323886639676,40.0,0.0
14940,1,4940,[318 515 427 588  79],807,5,22039,4.460433110706335,40.0,0.0
14941,1,4941,[318 515 427 588  79],18,5,22044,4.460542290570619,40.0,0.0
14942,1,4942,[318 515 427 588  79],18,5,22049,4.460651426259357,40.0,0.0
14943,1,4943,[318 515 427 588  79],18,5,22054,4.460760517799352,40.0,0.0
14944,1,4944,[318 515 427 588  79],18,5,22059,4.460869565217391,40.0,0.0
14945,1,4945,[ 98  79  56   8 186],796,4,22063,4.4607763849575415,0.0,0.0
14946,1,4946,[  1  98 216 405 204],786,5,22068,4.460885385081868,0.0,0.0
14947,1,4947,[318 515 427 588  79],18,5,22073,4.460994341147939,40.0,0.0
14948,1,4948,[144 216 161  79 597],23,2,22075,4.460497070115175,0.0,0.0
14949,1,4949,[318 515 427 588  79],807,5,22080,4.460606060606061,40.0,0.0
14950,1,4950,[318 515 427 588  79],807,5,22085,4.460715007069279,40.0,0.0
14951,1,4951,[318 515 427 588  79],18,5,22090,4.460823909531502,40.0,0.0
14952,1,4952,[318 515 427 588  79],807,5,22095,4.460932768019382,40.0,0.0
14953,1,4953,[318 515 427 588  79],18,5,22100,4.461041582559548,40.0,0.0
14954,1,4954,[318 515 427 588  79],716,5,22105,4.461150353178607,40.0,0.0
14955,1,4955,[318 515 427 588  79],18,5,22110,4.461259079903147,40.0,0.0
14956,1,4956,[318 515 427 588  79],807,5,22115,4.461367762759734,40.0,0.0
14957,1,4957,[318 515 427 588  79],807,5,22120,4.46147640177491,40.0,0.0
14958,1,4958,[318 515 427 588  79],807,5,22125,4.461584996975197,40.0,0.0
14959,1,4959,[185 181 118   1  25],457,5,22130,4.461693548387097,0.0,0.0
14960,1,4960,[318 515 427 588  79],807,5,22135,4.461802056037089,40.0,0.0
14961,1,4961,[318 515 427 588  79],716,5,22140,4.4619105199516325,40.0,0.0
14962,1,4962,[318 515 427 588  79],716,5,22145,4.462018940157163,40.0,0.0
14963,1,4963,[318 515 427 588  79],716,5,22150,4.462127316680097,40.0,0.0
14964,1,4964,[742 176 597  50 403],457,4,22154,4.462034239677744,0.0,20.0
14965,1,4965,[318 515 427 588  79],18,5,22159,4.462142569472412,40.0,0.0
14966,1,4966,[318 515 427 588  79],716,5,22164,4.462250855647272,40.0,0.0
14967,1,4967,[318 515 427 588  79],716,5,22169,4.462359098228664,40.0,0.0
14968,1,4968,[318 515 427 588  79],807,5,22174,4.462467297242906,40.0,0.0
14969,1,4969,[ 56 197 275 132 204],796,4,22178,4.462374245472837,0.0,20.0
14970,1,4970,[427 185   8 258 275],23,5,22183,4.462482397907865,20.0,20.0
14971,1,4971,[318 515 427 588  79],18,5,22188,4.4625905068382945,40.0,0.0
14972,1,4972,[ 15  89 276 173 176],269,1,22189,4.461894228835713,0.0,0.0
14973,1,4973,[318 515 427 588  79],716,5,22194,4.462002412545235,40.0,0.0
14974,1,4974,[318 515 427 588  79],716,5,22199,4.462110552763819,40.0,0.0
14975,1,4975,[286 228 180   4 357],450,4,22203,4.46201768488746,0.0,20.0
14976,1,4976,[ 70 222 186  97 196],450,3,22206,4.46172393007836,0.0,0.0
14977,1,4977,[ 88 328 174 294 222],655,0,22206,4.460827641623141,0.0,0.0
14978,1,4978,[318 515 427 588  79],807,5,22211,4.460935930909821,40.0,0.0
14979,1,4979,[318 515 427 588  79],716,5,22216,4.461044176706827,40.0,0.0
14980,1,4980,[143  25 185 313 508],655,3,22219,4.460750853242321,0.0,0.0
14981,1,4981,[318 515 427 588  79],716,5,22224,4.460859092733842,40.0,0.0
14982,1,4982,[318 515 427 588  79],807,5,22229,4.460967288781858,40.0,0.0
14983,1,4983,[318 515 427 588  79],716,5,22234,4.46107544141252,40.0,0.0
14984,1,4984,[742 181 268  70 176],655,0,22234,4.460180541624875,0.0,0.0
14985,1,4985,[ 25 328 234 318 603],151,4,22238,4.460088247091857,40.0,0.0
14986,1,4986,[118  88  50  12  79],256,5,22243,4.460196510928414,0.0,20.0
14987,1,4987,[318 515 427 588  79],807,5,22248,4.460304731355253,40.0,0.0
14988,1,4988,[318 515 427 588  79],716,5,22253,4.460412908398476,40.0,0.0
14989,1,4989,[318 515 427 588  79],807,5,22258,4.460521042084168,40.0,0.0
14990,1,4990,[318 515 427 588  79],18,5,22263,4.460629132438389,40.0,0.0
14991,1,4991,[318 515 427 588  79],716,5,22268,4.46073717948718,40.0,0.0
14992,1,4992,[318 515 427 588  79],18,5,22273,4.460845183256559,40.0,0.0
14993,1,4993,[748 204 191 210 234],450,3,22276,4.460552663195835,0.0,0.0
14994,1,4994,[496 117 127 405 288],280,4,22280,4.46046046046046,20.0,20.0
14995,1,4995,[318 515 427 588  79],807,5,22285,4.460568454763811,40.0,0.0
14996,1,4996,[318 515 427 588  79],716,5,22290,4.460676405843506,40.0,0.0
14997,1,4997,[318 515 427 588  79],716,5,22295,4.46078431372549,40.0,0.0
14998,1,4998,[ 12 568 423 210 176],280,2,22297,4.4602920584116825,0.0,0.0
14999,1,4999,[318 515 427 588  79],716,5,22302,4.4604,40.0,0.0
15000,1,5000,[ 79 175 135 546 655],457,4,22306,4.460307938412318,0.0,0.0
15001,1,5001,[318 515 427 588  79],18,5,22311,4.460415833666533,40.0,0.0
15002,1,5002,[318 515 427 588  79],716,5,22316,4.460523685788527,40.0,0.0
15003,1,5003,[568 238 275 269 132],655,1,22317,4.459832134292566,0.0,20.0
15004,1,5004,[318 515 427 588  79],807,5,22322,4.45994005994006,40.0,0.0
15005,1,5005,[100  89  96 515  22],269,2,22324,4.459448661606073,0.0,20.0
15006,1,5006,[ 56 200 258 515  12],655,2,22326,4.458957459556621,0.0,0.0
15007,1,5007,[318 515 427 588  79],18,5,22331,4.459065495207668,40.0,0.0
15008,1,5008,[ 22  64 423 211 357],450,5,22336,4.4591734877221,20.0,0.0
15009,1,5009,[318 515 427 588  79],807,5,22341,4.459281437125749,40.0,0.0
15010,1,5010,[318 515 427 588  79],716,5,22346,4.459389343444422,40.0,0.0
15011,1,5011,[318 515 427 588  79],18,5,22351,4.459497206703911,40.0,0.0
15012,1,5012,[318 515 427 588  79],716,5,22356,4.459605026929982,40.0,0.0
15013,1,5013,[210  15 403 127   4],450,2,22358,4.459114479457519,0.0,20.0
15014,1,5014,[318 515 427 588  79],716,5,22363,4.459222333000997,40.0,0.0
15015,1,5015,[318 515 427 588  79],18,5,22368,4.45933014354067,40.0,0.0
15016,1,5016,[172 191 655 186 742],796,2,22370,4.458839944189755,0.0,0.0
15017,1,5017,[471 100 176 153   7],655,0,22370,4.457951375049821,0.0,20.0
15018,1,5018,[313 180 187 143 173],796,4,22374,4.457860131500299,0.0,0.0
15019,1,5019,[318 515 427 588  79],807,5,22379,4.45796812749004,40.0,0.0
15020,1,5020,[202 328 181 301 195],796,4,22383,4.457876916948815,0.0,0.0
15021,1,5021,[318 515 427 588  79],716,5,22388,4.457984866587017,40.0,0.0
15022,1,5022,[318 515 427 588  79],18,5,22393,4.458092773243082,40.0,0.0
15023,1,5023,[318 515 427 588  79],807,5,22398,4.458200636942675,40.0,0.0
15024,1,5024,[318 515 427 588  79],807,5,22403,4.458308457711443,40.0,0.0
15025,1,5025,[318 515 427 588  79],716,5,22408,4.45841623557501,40.0,0.0
15026,1,5026,[318 515 427 588  79],18,5,22413,4.458523970558981,40.0,0.0
15027,1,5027,[ 64 204 191 117 423],716,5,22418,4.4586316626889415,20.0,0.0
15028,1,5028,[318 515 427 588  79],807,5,22423,4.458739311990455,40.0,0.0
15029,1,5029,[144 357 143 204  82],655,2,22425,4.458250497017892,0.0,0.0
15030,1,5030,[318 515 427 588  79],807,5,22430,4.458358179288412,40.0,0.0
15031,1,5031,[318 515 427 588  79],716,5,22435,4.458465818759937,40.0,0.0
15032,1,5032,[318 515 427 588  79],716,5,22440,4.458573415457978,40.0,0.0
15033,1,5033,[318 515 427 588  79],807,5,22445,4.458680969408025,40.0,0.0
15034,1,5034,[153 151 204 483 423],236,2,22447,4.45819265143992,0.0,0.0
15035,1,5035,[318 515 427 588  79],18,5,22452,4.458300238284353,40.0,0.0
15036,1,5036,[161 427 423 471 181],807,5,22457,4.458407782410164,20.0,0.0
15037,1,5037,[655   1 318  15 546],593,2,22459,4.457919809448193,20.0,0.0
15038,1,5038,[ 12 216 385 215  98],450,5,22464,4.4580273863861875,0.0,0.0
15039,1,5039,[357 118 125  70 271],655,1,22465,4.45734126984127,0.0,0.0
15040,1,5040,[318 515 427 588  79],18,5,22470,4.457448918865304,40.0,0.0
15041,1,5041,[318 515 427 588  79],18,5,22475,4.4575565251884175,40.0,0.0
15042,1,5042,[318 515 427 588  79],18,5,22480,4.45766408883601,40.0,0.0
15043,1,5043,[318 515 427 588  79],716,5,22485,4.457771609833466,40.0,0.0
15044,1,5044,[318 515 427 588  79],716,5,22490,4.457879088206145,40.0,0.0
15045,1,5045,[ 79  50 483 135 183],450,3,22493,4.4575901704320255,0.0,20.0
15046,1,5046,[318 515 427 588  79],716,5,22498,4.457697642163661,40.0,0.0
15047,1,5047,[318 515 427 588  79],807,5,22503,4.457805071315373,40.0,0.0
15048,1,5048,[210 234 597  15  56],796,3,22506,4.457516339869281,0.0,0.0
15049,1,5049,[318 515 427 588  79],716,5,22511,4.457623762376238,40.0,0.0
15050,1,5050,[318 515 427 588  79],807,5,22516,4.45773114234805,40.0,0.0
15051,1,5051,[318 515 427 588  79],716,5,22521,4.457838479809976,40.0,0.0
15052,1,5052,[318 515 427 588  79],716,5,22526,4.457945774787255,40.0,0.0
15053,1,5053,[318 515 427 588  79],18,5,22531,4.458053027305104,40.0,0.0
15054,1,5054,[318 515 427 588  79],716,5,22536,4.458160237388724,40.0,0.0
15055,1,5055,[318 515 427 588  79],716,5,22541,4.4582674050632916,40.0,0.0
15056,1,5056,[318 515 427 588  79],807,5,22546,4.458374530353964,40.0,0.0
15057,1,5057,[318 515 427 588  79],807,5,22551,4.458481613285883,40.0,0.0
15058,1,5058,[100 403 144 300   8],796,4,22555,4.458390986360941,0.0,20.0
15059,1,5059,[194  88   7 216 269],23,4,22559,4.458300395256917,0.0,0.0
15060,1,5060,[318 515 427 588  79],18,5,22564,4.458407429361786,40.0,0.0
15061,1,5061,[318 515 427 588  79],716,5,22569,4.458514421177401,40.0,0.0
15062,1,5062,[318 515 427 588  79],807,5,22574,4.4586213707288165,40.0,0.0
15063,1,5063,[318 515 427 588  79],716,5,22579,4.458728278041074,40.0,0.0
15064,1,5064,[427 275 183 748 168],151,3,22582,4.458440276406713,20.0,20.0
15065,1,5065,[191 238 423 210 588],457,5,22587,4.458547177260166,0.0,0.0
15066,1,5066,[427 100 258 603 204],151,4,22591,4.4584566804815475,40.0,20.0
15067,1,5067,[318 515 427 588  79],18,5,22596,4.458563535911602,40.0,0.0
15068,1,5068,[405 302 111  88 475],269,1,22597,4.457881238903137,0.0,0.0
15069,1,5069,[318 515 427 588  79],807,5,22602,4.457988165680473,40.0,0.0
15070,1,5070,[318 515 427 588  79],807,5,22607,4.45809505028594,40.0,0.0
15071,1,5071,[318 515 427 588  79],18,5,22612,4.458201892744479,40.0,0.0
15072,1,5072,[588 191 153 483 174],796,5,22617,4.458308693081017,0.0,0.0
15073,1,5073,[  9 204 483 179 313],236,3,22620,4.458021284982262,0.0,0.0
15074,1,5074,[318 515 427 588  79],807,5,22625,4.458128078817734,40.0,0.0
15075,1,5075,[200 328 176 655 301],450,4,22629,4.458037825059102,0.0,0.0
15076,1,5076,[318 515 427 588  79],807,5,22634,4.4581445735670675,40.0,0.0
15077,1,5077,[318 515 427 588  79],18,5,22639,4.458251280031509,40.0,0.0
15078,1,5078,[318 515 427 588  79],18,5,22644,4.458357944477259,40.0,0.0
15079,1,5079,[318 515 427 588  79],807,5,22649,4.458464566929134,40.0,0.0
15080,1,5080,[318 515 427 588  79],716,5,22654,4.458571147411927,40.0,0.0
15081,1,5081,[196 202  88   7  89],786,5,22659,4.458677685950414,0.0,0.0
15082,1,5082,[  4 300 172 215 328],655,1,22660,4.457997245721031,0.0,0.0
15083,1,5083,[132  79 300 435 496],151,5,22665,4.458103855232101,20.0,0.0
15084,1,5084,[237 117 748 313 568],280,1,22666,4.457423795476893,0.0,0.0
15085,1,5085,[318 515 427 588  79],807,5,22671,4.4575304758159655,40.0,0.0
15086,1,5086,[318 515 427 588  79],807,5,22676,4.457637114212699,40.0,0.0
15087,1,5087,[318 515 427 588  79],716,5,22681,4.457743710691824,40.0,0.0
15088,1,5088,[318 515 427 588  79],716,5,22686,4.457850265278051,40.0,0.0
15089,1,5089,[318 515 427 588  79],716,5,22691,4.4579567779960705,40.0,0.0
15090,1,5090,[318 515 427 588  79],18,5,22696,4.458063248870556,40.0,0.0
15091,1,5091,[289  12 100 118 174],655,0,22696,4.457187745483111,0.0,20.0
15092,1,5092,[318 515 427 588  79],18,5,22701,4.457294325544866,40.0,0.0
15093,1,5093,[318 515 427 588  79],807,5,22706,4.457400863761288,40.0,0.0
15094,1,5094,[318 515 427 588  79],807,5,22711,4.457507360157017,40.0,0.0
15095,1,5095,[318 515 427 588  79],807,5,22716,4.457613814756672,40.0,0.0
15096,1,5096,[318 515 427 588  79],18,5,22721,4.457720227584854,40.0,0.0
15097,1,5097,[318 515 427 588  79],807,5,22726,4.457826598666143,40.0,0.0
15098,1,5098,[318 515 427 588  79],807,5,22731,4.4579329280251025,40.0,0.0
15099,1,5099,[318 515 427 588  79],716,5,22736,4.4580392156862745,40.0,0.0
15100,1,5100,[318 515 427 588  79],18,5,22741,4.458145461674182,40.0,0.0
15101,1,5101,[318 515 427 588  79],807,5,22746,4.458251666013328,40.0,0.0
15102,1,5102,[318 515 427 588  79],807,5,22751,4.458357828728199,40.0,0.0
15103,1,5103,[318 515 427 588  79],807,5,22756,4.45846394984326,40.0,0.0
15104,1,5104,[318 515 427 588  79],18,5,22761,4.458570029382958,40.0,0.0
15105,1,5105,[318 515 427 588  79],18,5,22766,4.458676067371719,40.0,0.0
15106,1,5106,[318 515 427 588  79],18,5,22771,4.4587820638339535,40.0,0.0
15107,1,5107,[215 238 127 175  22],18,4,22775,4.458692247454972,0.0,20.0
15108,1,5108,[194 603 216 286   1],401,3,22778,4.458406733215893,20.0,20.0
15109,1,5109,[238 286 185 357 427],18,4,22782,4.458317025440313,20.0,20.0
15110,1,5110,[  7 228 200 300  79],151,4,22786,4.458227352768539,0.0,0.0
15111,1,5111,[275   1 117  95 210],796,3,22789,4.457942097026604,0.0,20.0
15112,1,5112,[318 515 427 588  79],18,5,22794,4.458048112654019,40.0,0.0
15113,1,5113,[318 515 427 588  79],716,5,22799,4.4581540868204925,40.0,0.0
15114,1,5114,[318 515 427 588  79],716,5,22804,4.458260019550342,40.0,0.0
15115,1,5115,[318 515 427 588  79],716,5,22809,4.458365910867865,40.0,0.0
15116,1,5116,[318 515 427 588  79],716,5,22814,4.458471760797342,40.0,0.0
15117,1,5117,[121 286   1 181 275],593,3,22817,4.458186791715514,0.0,40.0
15118,1,5118,[318 515 427 588  79],807,5,22822,4.458292635280328,40.0,0.0
15119,1,5119,[151 216  79 237 265],796,5,22827,4.4583984375,0.0,0.0
15120,1,5120,[318 515 427 588  79],807,5,22832,4.45850419839875,40.0,0.0
15121,1,5121,[  4 210 301 568 125],344,4,22836,4.4584146817649355,0.0,0.0
15122,1,5122,[318 515 427 588  79],18,5,22841,4.458520398204177,40.0,0.0
15123,1,5123,[318 515 427 588  79],18,5,22846,4.458626073380172,40.0,0.0
15124,1,5124,[318 515 427 588  79],18,5,22851,4.458731707317074,40.0,0.0
15125,1,5125,[318 515 427 588  79],807,5,22856,4.458837300039017,40.0,0.0
15126,1,5126,[318 515 427 588  79],18,5,22861,4.458942851570119,40.0,0.0
15127,1,5127,[265 234  64 204  22],796,4,22865,4.458853354134165,20.0,0.0
15128,1,5128,[318 515 427 588  79],716,5,22870,4.458958861376487,40.0,0.0
15129,1,5129,[318 515 427 588  79],18,5,22875,4.45906432748538,40.0,0.0
15130,1,5130,[318 515 427 588  79],807,5,22880,4.459169752484896,40.0,0.0
15131,1,5131,[318 515 427 588  79],716,5,22885,4.459275136399064,40.0,0.0
15132,1,5132,[318 515 427 588  79],18,5,22890,4.4593804792519,40.0,0.0
15133,1,5133,[318 515 427 588  79],807,5,22895,4.459485781067394,40.0,0.0
15134,1,5134,[ 64 655 143 195  96],450,5,22900,4.459591041869523,20.0,0.0
15135,1,5135,[182   1 483 202 191],389,5,22905,4.459696261682243,0.0,0.0
15136,1,5136,[318 515 427 588  79],716,5,22910,4.459801440529492,40.0,0.0
15137,1,5137,[318 515 427 588  79],716,5,22915,4.459906578435189,40.0,0.0
15138,1,5138,[318 515 427 588  79],716,5,22920,4.460011675423234,40.0,0.0
15139,1,5139,[318 515 427 588  79],716,5,22925,4.46011673151751,40.0,0.0
15140,1,5140,[318 515 427 588  79],716,5,22930,4.460221746741879,40.0,0.0
15141,1,5141,[318 515 427 588  79],18,5,22935,4.460326721120187,40.0,0.0
15142,1,5142,[318 515 427 588  79],18,5,22940,4.460431654676259,40.0,0.0
15143,1,5143,[237 301 182 210 118],593,3,22943,4.4601477449455675,0.0,0.0
15144,1,5144,[318 515 427 588  79],807,5,22948,4.46025267249757,40.0,0.0
15145,1,5145,[168 328 286 125 181],450,5,22953,4.460357559269335,0.0,20.0
15146,1,5146,[318 515 427 588  79],807,5,22958,4.460462405284632,40.0,0.0
15147,1,5147,[286 508 748 257 289],15,1,22959,4.45979020979021,0.0,20.0
15148,1,5148,[318 515 427 588  79],716,5,22964,4.4598951252670425,40.0,0.0
15149,1,5149,[318 515 427 588  79],18,5,22969,4.46,40.0,0.0
15150,1,5150,[265  96 210 196  82],577,4,22973,4.459910696952048,0.0,0.0
15151,1,5151,[318 515 427 588  79],716,5,22978,4.46001552795031,40.0,0.0
15152,1,5152,[318 515 427 588  79],807,5,22983,4.4601203182612075,40.0,0.0
15153,1,5153,[ 28 588 427 471 265],577,4,22987,4.460031043849438,20.0,0.0
15154,1,5154,[211 202 275 318 286],18,4,22991,4.459941804073715,20.0,40.0
15155,1,5155,[318 515 427 588  79],716,5,22996,4.460046547711404,40.0,0.0
15156,1,5156,[238 275 211 186 588],786,5,23001,4.460151250727167,0.0,20.0
15157,1,5157,[742 588 100 197 313],450,5,23006,4.460255913144629,0.0,20.0
15158,1,5158,[318 515 427 588  79],807,5,23011,4.460360534987401,40.0,0.0
15159,1,5159,[318 515 427 588  79],716,5,23016,4.46046511627907,40.0,0.0
15160,1,5160,[318 515 427 588  79],807,5,23021,4.460569657043209,40.0,0.0
15161,1,5161,[318 515 427 588  79],807,5,23026,4.46067415730337,40.0,0.0
15162,1,5162,[302 197  50  15 471],389,4,23030,4.460584931241526,0.0,20.0
15163,1,5163,[318 515 427 588  79],18,5,23035,4.460689388071263,40.0,0.0
15164,1,5164,[216   9 313 288 515],655,3,23038,4.460406582768635,0.0,0.0
15165,1,5165,[211 151   1  11 237],296,4,23042,4.4603174603174605,0.0,0.0
15166,1,5166,[300 289 546  11 423],693,1,23043,4.459647764660344,0.0,0.0
15167,1,5167,[405 196 597 132  15],269,1,23044,4.458978328173375,0.0,0.0
15168,1,5168,[318 515 427 588  79],18,5,23049,4.459082994776552,40.0,0.0
15169,1,5169,[603 273 655 742  56],450,4,23053,4.4589941972920695,20.0,0.0
15170,1,5170,[269 678   9 175 235],344,3,23056,4.458712047959776,0.0,0.0
15171,1,5171,[200  98 118  56 125],504,3,23059,4.458430007733952,0.0,0.0
15172,1,5172,[318 515 427 588  79],807,5,23064,4.458534699400735,40.0,0.0
15173,1,5173,[435 216  50 151 168],450,5,23069,4.4586393505991495,0.0,20.0
15174,1,5174,[318 515 427 588  79],807,5,23074,4.458743961352657,40.0,0.0
15175,1,5175,[318 515 427 588  79],18,5,23079,4.458848531684699,40.0,0.0
15176,1,5176,[318 515 427 588  79],18,5,23084,4.458953061618698,40.0,0.0
15177,1,5177,[100  95 273  50 245],796,2,23086,4.458478176902279,0.0,40.0
15178,1,5178,[323 173 496 300  71],796,4,23090,4.458389650511682,20.0,0.0
15179,1,5179,[318 515 427 588  79],807,5,23095,4.4584942084942085,40.0,0.0
15180,1,5180,[318 515 427 588  79],807,5,23100,4.45859872611465,40.0,0.0
15181,1,5181,[318 515 427 588  79],807,5,23105,4.4587032033963725,40.0,0.0
15182,1,5182,[318 515 427 588  79],807,5,23110,4.458807640362724,40.0,0.0
15183,1,5183,[318 515 427 588  79],807,5,23115,4.458912037037037,40.0,0.0
15184,1,5184,[318 515 427 588  79],807,5,23120,4.459016393442623,40.0,0.0
15185,1,5185,[318 515 427 588  79],716,5,23125,4.459120709602777,40.0,0.0
15186,1,5186,[318 515 427 588  79],18,5,23130,4.459224985540775,40.0,0.0
15187,1,5187,[318 515 427 588  79],807,5,23135,4.4593292212798765,40.0,0.0
15188,1,5188,[318 515 427 588  79],18,5,23140,4.459433416843322,40.0,0.0
15189,1,5189,[515 204 153  98 100],655,2,23142,4.458959537572254,0.0,20.0
15190,1,5190,[289   7 180 471 200],786,5,23147,4.459063764207282,0.0,0.0
15191,1,5191,[191 144 202  28 161],655,1,23148,4.4583975346687215,0.0,0.0
15192,1,5192,[318 515 427 588  79],18,5,23153,4.458501829385711,40.0,0.0
15193,1,5193,[318 515 427 588  79],807,5,23158,4.458606083943011,40.0,0.0
15194,1,5194,[318 515 427 588  79],18,5,23163,4.458710298363811,40.0,0.0
15195,1,5195,[191 172  50 228 200],796,5,23168,4.4588144726712855,0.0,20.0
15196,1,5196,[238 181  70 186  50],504,0,23168,4.4579565133731,0.0,20.0
15197,1,5197,[318 515 427 588  79],807,5,23173,4.458060792612543,40.0,0.0
15198,1,5198,[300 202 168 174 143],389,3,23176,4.457780342373534,0.0,0.0
15199,1,5199,[318 515 427 588  79],716,5,23181,4.457884615384615,40.0,0.0
15200,1,5200,[ 71 111 238  15 153],18,4,23185,4.4577965775812345,0.0,0.0
15201,1,5201,[318 515 427 588  79],18,5,23190,4.457900807381776,40.0,0.0
15202,1,5202,[318 515 427 588  79],807,5,23195,4.4580049971170475,40.0,0.0
15203,1,5203,[427 143  15 258 318],655,3,23198,4.4577248270561105,40.0,0.0
15204,1,5204,[318 515 427 588  79],807,5,23203,4.457829010566763,40.0,0.0
15205,1,5205,[269 204  79 172 182],535,2,23205,4.457356895889358,0.0,0.0
15206,1,5206,[318 515 427 588  79],807,5,23210,4.4574611100441714,40.0,0.0
15207,1,5207,[318 515 427 588  79],716,5,23215,4.457565284178187,40.0,0.0
15208,1,5208,[742 194 357 322  98],796,3,23218,4.457285467460165,0.0,0.0
15209,1,5209,[318 515 427 588  79],716,5,23223,4.457389635316699,40.0,0.0
15210,1,5210,[185 187 258 588 275],450,5,23228,4.457493763193245,0.0,20.0
15211,1,5211,[318 515 427 588  79],18,5,23233,4.4575978511128165,40.0,0.0
15212,1,5212,[318 515 427 588  79],716,5,23238,4.457701899098407,40.0,0.0
15213,1,5213,[318 515 427 588  79],807,5,23243,4.457805907172996,40.0,0.0
15214,1,5214,[318 515 427 588  79],807,5,23248,4.457909875359539,40.0,0.0
15215,1,5215,[318 515 427 588  79],716,5,23253,4.4580138036809815,40.0,0.0
15216,1,5216,[ 95 200  11 191 121],716,5,23258,4.458117692160245,0.0,0.0
15217,1,5217,[318 515 427 588  79],716,5,23263,4.4582215408202375,40.0,0.0
15218,1,5218,[318 515 427 588  79],716,5,23268,4.4583253496838475,40.0,0.0
15219,1,5219,[318 515 427 588  79],18,5,23273,4.458429118773946,40.0,0.0
15220,1,5220,[318 515 427 588  79],807,5,23278,4.458532848113388,40.0,0.0
15221,1,5221,[318 515 427 588  79],716,5,23283,4.45863653772501,40.0,0.0
15222,1,5222,[ 70  82 180  56 215],716,4,23287,4.458548726785373,0.0,0.0
15223,1,5223,[318 515 427 588  79],716,5,23292,4.458652373660031,40.0,0.0
15224,1,5224,[318 515 427 588  79],807,5,23297,4.458755980861244,40.0,0.0
15225,1,5225,[318 515 427 588  79],18,5,23302,4.458859548411787,40.0,0.0
15226,1,5226,[318 515 427 588  79],716,5,23307,4.458963076334418,40.0,0.0
15227,1,5227,[318 515 427 588  79],18,5,23312,4.459066564651875,40.0,0.0
15228,1,5228,[196 215 173 172  95],450,4,23316,4.458978772231784,0.0,0.0
15229,1,5229,[ 95  28 196 194 173],23,3,23319,4.458699808795411,0.0,0.0
15230,1,5230,[318 515 427 588  79],18,5,23324,4.458803288090231,40.0,0.0
15231,1,5231,[195  95 403 127  22],280,3,23327,4.458524464831804,0.0,20.0
15232,1,5232,[405  22  82 174  64],577,4,23331,4.458436843111026,20.0,0.0
15233,1,5233,[318 515 427 588  79],716,5,23336,4.458540313335881,40.0,0.0
15234,1,5234,[318 515 427 588  79],716,5,23341,4.458643744030564,40.0,0.0
15235,1,5235,[496 245 187 357 127],796,4,23345,4.458556149732621,20.0,20.0
15236,1,5236,[318 515 427 588  79],18,5,23350,4.4586595379033795,40.0,0.0
15237,1,5237,[228 143 483 742 405],655,2,23352,4.4581901489117985,0.0,0.0
15238,1,5238,[318 515 427 588  79],807,5,23357,4.458293567474709,40.0,0.0
15239,1,5239,[318 515 427 588  79],807,5,23362,4.458396946564886,40.0,0.0
15240,1,5240,[318 515 427 588  79],18,5,23367,4.458500286204923,40.0,0.0
15241,1,5241,[182 100 405  88 265],655,1,23368,4.457840518885922,0.0,20.0
15242,1,5242,[318 515 427 588  79],716,5,23373,4.457943925233645,40.0,0.0
15243,1,5243,[318 515 427 588  79],807,5,23378,4.458047292143402,40.0,0.0
15244,1,5244,[318 515 427 588  79],807,5,23383,4.45815061963775,40.0,0.0
15245,1,5245,[318 515 427 588  79],807,5,23388,4.45825390773923,40.0,0.0
15246,1,5246,[483 151 471  69  71],401,2,23390,4.457785401181628,0.0,0.0
15247,1,5247,[318 515 427 588  79],716,5,23395,4.457888719512195,40.0,0.0
15248,1,5248,[427  56  28 180 235],450,4,23399,4.457801485997333,20.0,0.0
15249,1,5249,[318 515 427 588  79],716,5,23404,4.457904761904762,40.0,0.0
15250,1,5250,[318 515 427 588  79],807,5,23409,4.45800799847648,40.0,0.0
15251,1,5251,[234  79  88  56 175],23,3,23412,4.457730388423458,0.0,0.0
15252,1,5252,[318 515 427 588  79],716,5,23417,4.457833618884447,40.0,0.0
15253,1,5253,[  4 173 471 197 200],450,3,23420,4.457556147696993,0.0,0.0
15254,1,5254,[318 515 427 588  79],807,5,23425,4.457659372026641,40.0,0.0
15255,1,5255,[318 515 427 588  79],18,5,23430,4.457762557077626,40.0,0.0
15256,1,5256,[318 515 427 588  79],716,5,23435,4.45786570287236,40.0,0.0
15257,1,5257,[318 515 427 588  79],18,5,23440,4.457968809433244,40.0,0.0
15258,1,5258,[318 515 427 588  79],807,5,23445,4.458071876782658,40.0,0.0
15259,1,5259,[ 28 508 111  56 655],655,0,23445,4.4572243346007605,0.0,0.0
15260,1,5260,[318 515 427 588  79],716,5,23450,4.457327504276753,40.0,0.0
15261,1,5261,[318 515 427 588  79],18,5,23455,4.457430634739643,40.0,0.0
15262,1,5262,[121  97 196 191 258],65,4,23459,4.457343720311609,0.0,0.0
15263,1,5263,[121 111 202 228 211],716,5,23464,4.457446808510638,0.0,0.0
15264,1,5264,[318 515 427 588  79],807,5,23469,4.457549857549857,40.0,0.0
15265,1,5265,[318 515 427 588  79],807,5,23474,4.457652867451576,40.0,0.0
15266,1,5266,[318 515 427 588  79],18,5,23479,4.457755838238087,40.0,0.0
15267,1,5267,[318 515 427 588  79],716,5,23484,4.457858769931663,40.0,0.0
15268,1,5268,[323 237   1 328 471],938,1,23485,4.457202505219207,0.0,0.0
15269,1,5269,[568 191 195 403 168],450,5,23490,4.4573055028463,0.0,0.0
15270,1,5270,[318 515 427 588  79],716,5,23495,4.457408461392525,40.0,0.0
15271,1,5271,[318 515 427 588  79],807,5,23500,4.457511380880121,40.0,0.0
15272,1,5272,[318 515 427 588  79],716,5,23505,4.457614261331311,40.0,0.0
15273,1,5273,[318 515 427 588  79],716,5,23510,4.457717102768298,40.0,0.0
15274,1,5274,[210  82 200  12 196],450,2,23512,4.457251184834123,0.0,0.0
15275,1,5275,[318 515 427 588  79],807,5,23517,4.457354056103108,40.0,0.0
15276,1,5276,[318 515 427 588  79],807,5,23522,4.457456888383551,40.0,0.0
15277,1,5277,[318 515 427 588  79],807,5,23527,4.457559681697613,40.0,0.0
15278,1,5278,[318 515 427 588  79],18,5,23532,4.457662436067437,40.0,0.0
15279,1,5279,[211  88  22 435 313],655,1,23533,4.457007575757576,0.0,0.0
15280,1,5280,[318 515 427 588  79],807,5,23538,4.457110395758379,40.0,0.0
15281,1,5281,[318 515 427 588  79],18,5,23543,4.45721317682696,40.0,0.0
15282,1,5282,[318 515 427 588  79],807,5,23548,4.457315918985425,40.0,0.0
15283,1,5283,[318 515 427 588  79],716,5,23553,4.457418622255867,40.0,0.0
15284,1,5284,[191 258  28 195 100],655,1,23554,4.456764427625354,0.0,20.0
15285,1,5285,[318 515 427 588  79],18,5,23559,4.456867196367764,40.0,0.0
15286,1,5286,[318 515 427 588  79],716,5,23564,4.4569699262341596,40.0,0.0
15287,1,5287,[318 515 427 588  79],716,5,23569,4.457072617246596,40.0,0.0
15288,1,5288,[286 282 748 183 187],450,5,23574,4.457175269427113,0.0,20.0
15289,1,5289,[318 515 427 588  79],807,5,23579,4.457277882797731,40.0,0.0
15290,1,5290,[183 300 269 271 234],655,1,23580,4.456624456624457,0.0,0.0
15291,1,5291,[181  11  96 151 111],457,4,23584,4.456538170823885,0.0,0.0
15292,1,5292,[318 515 427 588  79],807,5,23589,4.456640846400907,40.0,0.0
15293,1,5293,[172 228 211 195 143],151,4,23593,4.4565545901020025,0.0,0.0
15294,1,5294,[318 515 427 588  79],807,5,23598,4.456657223796034,40.0,0.0
15295,1,5295,[318 515 427 588  79],716,5,23603,4.4567598187311175,40.0,0.0
15296,1,5296,[318 515 427 588  79],807,5,23608,4.456862374929205,40.0,0.0
15297,1,5297,[318 515 427 588  79],716,5,23613,4.456964892412231,40.0,0.0
15298,1,5298,[318 515 427 588  79],716,5,23618,4.457067371202114,40.0,0.0
15299,1,5299,[318 515 427 588  79],716,5,23623,4.457169811320755,40.0,0.0
15300,1,5300,[ 98 194 191 294 202],23,2,23625,4.4567062818336165,0.0,0.0
15301,1,5301,[257 568 186 118 127],716,3,23628,4.45643153526971,0.0,20.0
15302,1,5302,[182  95 195 357  98],450,4,23632,4.4563454648312275,0.0,0.0
15303,1,5303,[215 179 197  50 222],457,5,23637,4.456447963800905,0.0,20.0
15304,1,5304,[385 286  88 273 143],401,2,23639,4.455984919886899,0.0,20.0
15305,1,5305,[185 143 135 181 111],389,2,23641,4.455522050508858,0.0,0.0
15306,1,5306,[318 515 427 588  79],807,5,23646,4.455624646693047,40.0,0.0
15307,1,5307,[187  70 215 235 161],716,2,23648,4.455162019593067,0.0,0.0
15308,1,5308,[289 258 211 288 234],693,1,23649,4.454511207383688,0.0,0.0
15309,1,5309,[318 515 427 588  79],716,5,23654,4.454613935969868,40.0,0.0
15310,1,5310,[318 515 427 588  79],807,5,23659,4.454716625870834,40.0,0.0
15311,1,5311,[318 515 427 588  79],716,5,23664,4.454819277108434,40.0,0.0
15312,1,5312,[318 515 427 588  79],716,5,23669,4.454921889704498,40.0,0.0
15313,1,5313,[265  11 228 237 172],256,3,23672,4.45464809936018,0.0,0.0
15314,1,5314,[318 515 427 588  79],18,5,23677,4.454750705550329,40.0,0.0
15315,1,5315,[318 515 427 588  79],716,5,23682,4.454853273137697,40.0,0.0
15316,1,5316,[318 515 427 588  79],716,5,23687,4.454955802144066,40.0,0.0
15317,1,5317,[318 515 427 588  79],716,5,23692,4.4550582925911995,40.0,0.0
15318,1,5318,[318 515 427 588  79],716,5,23697,4.455160744500846,40.0,0.0
15319,1,5319,[318 515 427 588  79],18,5,23702,4.455263157894737,40.0,0.0
15320,1,5320,[318 515 427 588  79],18,5,23707,4.455365532794588,40.0,0.0
15321,1,5321,[318 515 427 588  79],716,5,23712,4.455467869222097,40.0,0.0
15322,1,5322,[174  12 258 313 546],450,5,23717,4.455570167198948,0.0,0.0
15323,1,5323,[318 515 427 588  79],18,5,23722,4.455672426746807,40.0,0.0
15324,1,5324,[318 515 427 588  79],18,5,23727,4.455774647887324,40.0,0.0
15325,1,5325,[318 515 427 588  79],18,5,23732,4.455876830642133,40.0,0.0
15326,1,5326,[318 515 427 588  79],716,5,23737,4.455978975032852,40.0,0.0
15327,1,5327,[318 515 427 588  79],807,5,23742,4.456081081081081,40.0,0.0
15328,1,5328,[318 515 427 588  79],716,5,23747,4.456183148808407,40.0,0.0
15329,1,5329,[228 483 302 191  98],655,4,23751,4.45609756097561,0.0,0.0
15330,1,5330,[318 515 427 588  79],807,5,23756,4.456199587319452,40.0,0.0
15331,1,5331,[ 64 181 258 135  50],151,5,23761,4.456301575393849,20.0,20.0
15332,1,5332,[318 515 427 588  79],716,5,23766,4.456403525220327,40.0,0.0
15333,1,5333,[318 515 427 588  79],716,5,23771,4.456505436820398,40.0,0.0
15334,1,5334,[318 515 427 588  79],18,5,23776,4.456607310215557,40.0,0.0
15335,1,5335,[318 515 427 588  79],807,5,23781,4.456709145427286,40.0,0.0
15336,1,5336,[161 275 237 153 179],593,4,23785,4.456623571294735,0.0,20.0
15337,1,5337,[318 515 427 588  79],18,5,23790,4.456725365305358,40.0,0.0
15338,1,5338,[ 88 121 237 210  64],457,5,23795,4.456827121183743,20.0,0.0
15339,1,5339,[173 151   7  50 423],535,5,23800,4.456928838951311,0.0,20.0
15340,1,5340,[111 269  15 234 100],655,0,23800,4.456094364351245,0.0,20.0
15341,1,5341,[318 515 427 588  79],716,5,23805,4.456196181205541,40.0,0.0
15342,1,5342,[318 515 427 588  79],807,5,23810,4.456297959947595,40.0,0.0
15343,1,5343,[318 515 427 588  79],807,5,23815,4.456399700598802,40.0,0.0
15344,1,5344,[318 515 427 588  79],716,5,23820,4.4565014031805426,40.0,0.0
15345,1,5345,[318 515 427 588  79],18,5,23825,4.456603067714179,40.0,0.0
15346,1,5346,[ 25 546 228  96 234],457,4,23829,4.456517673461755,0.0,0.0
15347,1,5347,[318 515 427 588  79],807,5,23834,4.456619296933433,40.0,0.0
15348,1,5348,[318 515 427 588  79],716,5,23839,4.456720882407927,40.0,0.0
15349,1,5349,[318 515 427 588  79],18,5,23844,4.456822429906542,40.0,0.0
15350,1,5350,[318 515 427 588  79],807,5,23849,4.45692393945057,40.0,0.0
15351,1,5351,[318 515 427 588  79],18,5,23854,4.457025411061285,40.0,0.0
15352,1,5352,[403 176 603 318 153],655,2,23856,4.456566411358117,40.0,0.0
15353,1,5353,[318 515 427 588  79],716,5,23861,4.456667911841614,40.0,0.0
15354,1,5354,[318 515 427 588  79],807,5,23866,4.456769374416433,40.0,0.0
15355,1,5355,[318 515 427 588  79],807,5,23871,4.456870799103809,40.0,0.0
15356,1,5356,[318 515 427 588  79],18,5,23876,4.456972185924958,40.0,0.0
15357,1,5357,[318 515 427 588  79],18,5,23881,4.457073534901083,40.0,0.0
15358,1,5358,[318 515 427 588  79],716,5,23886,4.457174846053368,40.0,0.0
15359,1,5359,[318 515 427 588  79],807,5,23891,4.4572761194029855,40.0,0.0
15360,1,5360,[318 515 427 588  79],807,5,23896,4.457377354971087,40.0,0.0
15361,1,5361,[318 515 427 588  79],18,5,23901,4.457478552778814,40.0,0.0
15362,1,5362,[143 282 215  79 151],450,5,23906,4.457579712847287,0.0,0.0
15363,1,5363,[318 515 427 588  79],716,5,23911,4.457680835197614,40.0,0.0
15364,1,5364,[318 515 427 588  79],807,5,23916,4.457781919850885,40.0,0.0
15365,1,5365,[318 515 427 588  79],18,5,23921,4.457882966828177,40.0,0.0
15366,1,5366,[318 515 427 588  79],807,5,23926,4.457983976150549,40.0,0.0
15367,1,5367,[318 515 427 588  79],18,5,23931,4.458084947839046,40.0,0.0
15368,1,5368,[318 515 427 588  79],716,5,23936,4.458185881914695,40.0,0.0
15369,1,5369,[318 515 427 588  79],807,5,23941,4.45828677839851,40.0,0.0
15370,1,5370,[173 483 216 153 186],269,1,23942,4.4576428970396575,0.0,0.0
15371,1,5371,[318 515 427 588  79],716,5,23947,4.457743857036485,40.0,0.0
15372,1,5372,[318 515 427 588  79],716,5,23952,4.457844779452819,40.0,0.0
15373,1,5373,[328 286 237 118 153],796,4,23956,4.457759583178266,0.0,20.0
15374,1,5374,[318 515 427 588  79],18,5,23961,4.457860465116279,40.0,0.0
15375,1,5375,[318 515 427 588  79],18,5,23966,4.457961309523809,40.0,0.0
15376,1,5376,[318 515 427 588  79],807,5,23971,4.458062116421797,40.0,0.0
15377,1,5377,[318 515 427 588  79],807,5,23976,4.458162885831164,40.0,0.0
15378,1,5378,[318 515 427 588  79],807,5,23981,4.45826361777282,40.0,0.0
15379,1,5379,[195 215 222 286  22],344,2,23983,4.4578066914498145,0.0,20.0
15380,1,5380,[318 515 427 588  79],18,5,23988,4.457907452146441,40.0,0.0
15381,1,5381,[265 245 471 302  15],450,4,23992,4.457822370865849,0.0,0.0
15382,1,5382,[143 186 179 588   4],786,5,23997,4.457923091213078,0.0,0.0
15383,1,5383,[191 234 427  95   4],450,2,23999,4.457466567607726,20.0,0.0
15384,1,5384,[318 515 427 588  79],807,5,24004,4.457567316620241,40.0,0.0
15385,1,5385,[322 385 313  69 228],450,5,24009,4.457668028221314,0.0,0.0
15386,1,5386,[275 151 100 117   1],733,2,24011,4.457211806200111,0.0,40.0
15387,1,5387,[318 515 427 588  79],18,5,24016,4.457312546399406,40.0,0.0
15388,1,5388,[ 98 237 135 301 173],535,3,24019,4.457042122842828,0.0,0.0
15389,1,5389,[318 515 427 588  79],716,5,24024,4.457142857142857,40.0,0.0
15390,1,5390,[318 515 427 588  79],18,5,24029,4.457243554071601,40.0,0.0
15391,1,5391,[318 515 427 588  79],716,5,24034,4.457344213649852,40.0,0.0
15392,1,5392,[301 127 742 333 483],655,2,24036,4.456888559243464,0.0,20.0
15393,1,5393,[318 515 427 588  79],716,5,24041,4.456989247311828,40.0,0.0
15394,1,5394,[318 515 427 588  79],716,5,24046,4.457089898053754,40.0,0.0
15395,1,5395,[318 515 427 588  79],18,5,24051,4.457190511489992,40.0,0.0
15396,1,5396,[318 515 427 588  79],807,5,24056,4.457291087641282,40.0,0.0
15397,1,5397,[197 118 191 180 172],693,0,24056,4.456465357539829,0.0,0.0
15398,1,5398,[179 742  82  22 385],655,1,24057,4.455825152806075,0.0,0.0
15399,1,5399,[318 515 427 588  79],807,5,24062,4.455925925925926,40.0,0.0
15400,1,5400,[318 515 427 588  79],716,5,24067,4.456026661729309,40.0,0.0
15401,1,5401,[318 515 427 588  79],18,5,24072,4.456127360236949,40.0,0.0
15402,1,5402,[318 515 427 588  79],716,5,24077,4.4562280214695535,40.0,0.0
15403,1,5403,[318 515 427 588  79],18,5,24082,4.456328645447816,40.0,0.0
15404,1,5404,[238  82 179  15 185],18,3,24085,4.456059204440333,0.0,0.0
15405,1,5405,[235 385  50 175 238],716,2,24087,4.4556048834628195,0.0,20.0
15406,1,5406,[ 98 202 742 655 322],504,4,24091,4.4555206214166825,0.0,0.0
15407,1,5407,[403 423 603 200 125],796,5,24096,4.455621301775148,20.0,0.0
15408,1,5408,[318 515 427 588  79],807,5,24101,4.455721944906637,40.0,0.0
15409,1,5409,[318 515 427 588  79],807,5,24106,4.455822550831793,40.0,0.0
15410,1,5410,[185  28  12 276 182],655,3,24109,4.4555535021253005,0.0,0.0
15411,1,5411,[318 515 427 588  79],716,5,24114,4.455654101995566,40.0,0.0
15412,1,5412,[318 515 427 588  79],716,5,24119,4.455754664696102,40.0,0.0
15413,1,5413,[ 15   4 125  69 265],786,4,24123,4.45567048393055,0.0,0.0
15414,1,5414,[318 515 427 588  79],716,5,24128,4.455771006463527,40.0,0.0
15415,1,5415,[318 515 427 588  79],716,5,24133,4.455871491875923,40.0,0.0
15416,1,5416,[318 515 427 588  79],18,5,24138,4.455971940188296,40.0,0.0
15417,1,5417,[318 515 427 588  79],18,5,24143,4.456072351421189,40.0,0.0
15418,1,5418,[ 79   4  56 245 183],593,4,24147,4.4559881897028975,0.0,0.0
15419,1,5419,[318 515 427 588  79],18,5,24152,4.4560885608856085,40.0,0.0
15420,1,5420,[318 515 427 588  79],18,5,24157,4.456188895037816,40.0,0.0
15421,1,5421,[ 50 135  71 172 322],280,3,24160,4.4559203246034675,0.0,20.0
15422,1,5422,[318 515 427 588  79],18,5,24165,4.456020652775217,40.0,0.0
15423,1,5423,[197  25 483 200 568],716,5,24170,4.4561209439528024,0.0,0.0
15424,1,5424,[423 403 197  25 265],450,4,24174,4.456036866359447,0.0,0.0
15425,1,5425,[318 515 427 588  79],807,5,24179,4.456137117582013,40.0,0.0
15426,1,5426,[318 515 427 588  79],716,5,24184,4.4562373318592226,40.0,0.0
15427,1,5427,[318 515 427 588  79],716,5,24189,4.456337509211496,40.0,0.0
15428,1,5428,[318 515 427 588  79],716,5,24194,4.456437649659238,40.0,0.0
15429,1,5429,[195 257 323 275  64],796,4,24198,4.456353591160221,20.0,20.0
15430,1,5430,[318 515 427 588  79],18,5,24203,4.456453691769472,40.0,0.0
15431,1,5431,[ 22 191 228 268 333],655,1,24204,4.455817378497791,0.0,0.0
15432,1,5432,[318 515 427 588  79],18,5,24209,4.455917540953433,40.0,0.0
15433,1,5433,[318 515 427 588  79],18,5,24214,4.456017666543982,40.0,0.0
15434,1,5434,[318 515 427 588  79],807,5,24219,4.456117755289789,40.0,0.0
15435,1,5435,[318 515 427 588  79],807,5,24224,4.456217807211185,40.0,0.0
15436,1,5436,[210 294 143 234 276],504,2,24226,4.45576604745264,0.0,0.0
15437,1,5437,[318 515 427 588  79],716,5,24231,4.4558661272526665,40.0,0.0
15438,1,5438,[172   1  50 174 132],535,3,24234,4.455598455598456,0.0,20.0
15439,1,5439,[318 515 427 588  79],807,5,24239,4.455698529411765,40.0,0.0
15440,1,5440,[318 515 427 588  79],18,5,24244,4.455798566439992,40.0,0.0
15441,1,5441,[318 515 427 588  79],807,5,24249,4.455898566703418,40.0,0.0
15442,1,5442,[  9   7 222 423 228],72,2,24251,4.4554473635862575,0.0,0.0
15443,1,5443,[385 132 603  98 216],450,5,24256,4.455547391623806,20.0,0.0
15444,1,5444,[318 515 427 588  79],18,5,24261,4.45564738292011,40.0,0.0
15445,1,5445,[318 515 427 588  79],18,5,24266,4.455747337495409,40.0,0.0
15446,1,5446,[318 515 427 588  79],716,5,24271,4.455847255369928,40.0,0.0
15447,1,5447,[318 515 427 588  79],18,5,24276,4.455947136563877,40.0,0.0
15448,1,5448,[318 515 427 588  79],18,5,24281,4.456046981097449,40.0,0.0
15449,1,5449,[318 515 427 588  79],18,5,24286,4.456146788990826,40.0,0.0
15450,1,5450,[318 515 427 588  79],807,5,24291,4.456246560264172,40.0,0.0
15451,1,5451,[318 515 427 588  79],18,5,24296,4.456346294937638,40.0,0.0
15452,1,5452,[318 515 427 588  79],18,5,24301,4.456445993031359,40.0,0.0
15453,1,5453,[318 515 427 588  79],716,5,24306,4.456545654565456,40.0,0.0
15454,1,5454,[318 515 427 588  79],716,5,24311,4.456645279560036,40.0,0.0
15455,1,5455,[318 515 427 588  79],716,5,24316,4.456744868035191,40.0,0.0
15456,1,5456,[318 515 427 588  79],18,5,24321,4.456844420010995,40.0,0.0
15457,1,5457,[318 515 427 588  79],807,5,24326,4.456943935507512,40.0,0.0
15458,1,5458,[318 515 427 588  79],807,5,24331,4.457043414544788,40.0,0.0
15459,1,5459,[318 515 427 588  79],807,5,24336,4.457142857142857,40.0,0.0
15460,1,5460,[172 197 202 144 168],401,3,24339,4.45687603003113,0.0,0.0
15461,1,5461,[318 515 427 588  79],716,5,24344,4.456975466861955,40.0,0.0
15462,1,5462,[121   4 176  98 173],450,3,24347,4.456708768076148,0.0,0.0
15463,1,5463,[318 515 427 588  79],716,5,24352,4.4568081991215225,40.0,0.0
15464,1,5464,[318 515 427 588  79],807,5,24357,4.456907593778591,40.0,0.0
15465,1,5465,[318 515 427 588  79],18,5,24362,4.457006952067325,40.0,0.0
15466,1,5466,[318 515 427 588  79],18,5,24367,4.457106274007683,40.0,0.0
15467,1,5467,[161 273 210 471 603],655,2,24369,4.456656912948062,20.0,0.0
15468,1,5468,[318 515 427 588  79],18,5,24374,4.456756262570854,40.0,0.0
15469,1,5469,[318 515 427 588  79],716,5,24379,4.4568555758683726,40.0,0.0
15470,1,5470,[318 515 427 588  79],807,5,24384,4.456954852860537,40.0,0.0
15471,1,5471,[200  28 100 153 302],450,4,24388,4.456871345029239,0.0,20.0
15472,1,5472,[182  97 385 144 200],457,5,24393,4.456970582861319,0.0,0.0
15473,1,5473,[496 204 435 300 195],450,5,24398,4.457069784435514,20.0,0.0
15474,1,5474,[318 515 427 588  79],716,5,24403,4.457168949771689,40.0,0.0
15475,1,5475,[318 515 427 588  79],807,5,24408,4.4572680788897,40.0,0.0
15476,1,5476,[318 515 427 588  79],807,5,24413,4.457367171809385,40.0,0.0
15477,1,5477,[318 515 427 588  79],716,5,24418,4.457466228550566,40.0,0.0
15478,1,5478,[318 515 427 588  79],18,5,24423,4.4575652491330535,40.0,0.0
15479,1,5479,[318 515 427 588  79],807,5,24428,4.457664233576643,40.0,0.0
15480,1,5480,[318 515 427 588  79],807,5,24433,4.457763181901113,40.0,0.0
15481,1,5481,[318 515 427 588  79],716,5,24438,4.457862094126232,40.0,0.0
15482,1,5482,[318 515 427 588  79],716,5,24443,4.457960970271749,40.0,0.0
15483,1,5483,[318 515 427 588  79],18,5,24448,4.458059810357403,40.0,0.0
15484,1,5484,[318 515 427 588  79],716,5,24453,4.458158614402917,40.0,0.0
15485,1,5485,[195 245 228 385 597],796,4,24457,4.458075100255195,0.0,0.0
15486,1,5486,[  8  11 181  12  28],457,5,24462,4.458173865500274,0.0,0.0
15487,1,5487,[318 515 427 588  79],716,5,24467,4.458272594752186,40.0,0.0
15488,1,5488,[318 515 427 588  79],807,5,24472,4.458371288030607,40.0,0.0
15489,1,5489,[111 121 153 168 216],450,4,24476,4.458287795992714,0.0,0.0
15490,1,5490,[318 515 427 588  79],18,5,24481,4.458386450555454,40.0,0.0
15491,1,5491,[318 515 427 588  79],18,5,24486,4.458485069191552,40.0,0.0
15492,1,5492,[318 515 427 588  79],716,5,24491,4.458583651920626,40.0,0.0
15493,1,5493,[318 515 427 588  79],807,5,24496,4.458682198762286,40.0,0.0
15494,1,5494,[318 515 427 588  79],807,5,24501,4.458780709736124,40.0,0.0
15495,1,5495,[318 515 427 588  79],807,5,24506,4.4588791848617175,40.0,0.0
15496,1,5496,[318 515 427 588  79],807,5,24511,4.458977624158632,40.0,0.0
15497,1,5497,[318 515 427 588  79],807,5,24516,4.459076027646417,40.0,0.0
15498,1,5498,[215 125 183  97 194],731,2,24518,4.458628841607565,0.0,0.0
15499,1,5499,[318 515 427 588  79],18,5,24523,4.458727272727272,40.0,0.0
15500,1,5500,[318 515 427 588  79],807,5,24528,4.458825668060353,40.0,0.0
15501,1,5501,[318 515 427 588  79],716,5,24533,4.458924027626318,40.0,0.0
15502,1,5502,[318 515 427 588  79],807,5,24538,4.459022351444666,40.0,0.0
15503,1,5503,[118  12 176 191  22],577,4,24542,4.458938953488372,0.0,0.0
15504,1,5504,[318 515 427 588  79],18,5,24547,4.459037238873751,40.0,0.0
15505,1,5505,[318 515 427 588  79],716,5,24552,4.459135488557937,40.0,0.0
15506,1,5506,[265 183 655 200 257],457,4,24556,4.459052115489377,0.0,0.0
15507,1,5507,[318 515 427 588  79],807,5,24561,4.459150326797386,40.0,0.0
15508,1,5508,[318 515 427 588  79],716,5,24566,4.459248502450535,40.0,0.0
15509,1,5509,[318 515 427 588  79],18,5,24571,4.4593466424682395,40.0,0.0
15510,1,5510,[318 515 427 588  79],807,5,24576,4.459444746869897,40.0,0.0
15511,1,5511,[318 515 427 588  79],18,5,24581,4.459542815674891,40.0,0.0
15512,1,5512,[196 275  22 405 328],655,1,24582,4.458915291130056,0.0,20.0
15513,1,5513,[182 405 403 168  69],450,5,24587,4.459013420384476,0.0,0.0
15514,1,5514,[318 515 427 588  79],18,5,24592,4.459111514052584,40.0,0.0
15515,1,5515,[318 515 427 588  79],716,5,24597,4.459209572153735,40.0,0.0
15516,1,5516,[318 515 427 588  79],716,5,24602,4.459307594707268,40.0,0.0
15517,1,5517,[318 515 427 588  79],716,5,24607,4.459405581732511,40.0,0.0
15518,1,5518,[318 515 427 588  79],18,5,24612,4.459503533248777,40.0,0.0
15519,1,5519,[318 515 427 588  79],716,5,24617,4.459601449275362,40.0,0.0
15520,1,5520,[318 515 427 588  79],716,5,24622,4.459699329831552,40.0,0.0
15521,1,5521,[318 515 427 588  79],807,5,24627,4.459797174936617,40.0,0.0
15522,1,5522,[318 515 427 588  79],716,5,24632,4.4598949846098135,40.0,0.0
15523,1,5523,[172 269 271 294 276],629,3,24635,4.459630702389573,0.0,0.0
15524,1,5524,[318 515 427 588  79],716,5,24640,4.4597285067873305,40.0,0.0
15525,1,5525,[121  82 403 197 405],798,4,24644,4.459645313065509,0.0,0.0
15526,1,5526,[195 210 322  15 176],796,3,24647,4.4593812194680655,0.0,0.0
15527,1,5527,[318 515 427 588  79],716,5,24652,4.459479015918958,40.0,0.0
15528,1,5528,[318 515 427 588  79],18,5,24657,4.459576776994031,40.0,0.0
15529,1,5529,[318 515 427 588  79],716,5,24662,4.459674502712478,40.0,0.0
15530,1,5530,[318 515 427 588  79],807,5,24667,4.459772193093473,40.0,0.0
15531,1,5531,[318 515 427 588  79],716,5,24672,4.459869848156182,40.0,0.0
15532,1,5532,[ 89 176 216 313 597],450,5,24677,4.459967467919754,0.0,0.0
15533,1,5533,[318 515 427 588  79],18,5,24682,4.4600650524033245,40.0,0.0
15534,1,5534,[135 111 258 179  15],65,3,24685,4.459801264679314,0.0,0.0
15535,1,5535,[318 515 427 588  79],807,5,24690,4.4598988439306355,40.0,0.0
15536,1,5536,[318 515 427 588  79],807,5,24695,4.459996387935705,40.0,0.0
15537,1,5537,[300 100 333  69 234],629,5,24700,4.460093896713615,0.0,20.0
15538,1,5538,[318 515 427 588  79],18,5,24705,4.460191370283445,40.0,0.0
15539,1,5539,[318 515 427 588  79],18,5,24710,4.46028880866426,40.0,0.0
15540,1,5540,[318 515 427 588  79],807,5,24715,4.460386211875113,40.0,0.0
15541,1,5541,[318 515 427 588  79],807,5,24720,4.460483579935041,40.0,0.0
15542,1,5542,[258  12 301 318 204],450,5,24725,4.460580912863071,20.0,0.0
15543,1,5543,[318 515 427 588  79],716,5,24730,4.460678210678211,40.0,0.0
15544,1,5544,[204 144  82  15 187],655,1,24731,4.460054102795311,0.0,0.0
15545,1,5545,[111 127  25 181 176],450,4,24735,4.459971150378651,0.0,20.0
15546,1,5546,[161  82 168 181  79],796,4,24739,4.4598882278709215,0.0,0.0
15547,1,5547,[318 515 427 588  79],807,5,24744,4.459985580389329,40.0,0.0
15548,1,5548,[318 515 427 588  79],716,5,24749,4.460082897819427,40.0,0.0
15549,1,5549,[215 151  69 132 257],504,5,24754,4.46018018018018,0.0,0.0
15550,1,5550,[318 515 427 588  79],716,5,24759,4.460277427490542,40.0,0.0
15551,1,5551,[161 228  64  97 216],577,4,24763,4.4601945244956775,20.0,0.0
15552,1,5552,[318 515 427 588  79],18,5,24768,4.460291734197731,40.0,0.0
15553,1,5553,[318 515 427 588  79],807,5,24773,4.46038890889449,40.0,0.0
15554,1,5554,[318 515 427 588  79],807,5,24778,4.46048604860486,40.0,0.0
15555,1,5555,[318 515 427 588  79],716,5,24783,4.4605831533477325,40.0,0.0
15556,1,5556,[333 286 132 182  69],655,1,24784,4.4599604102933235,0.0,20.0
15557,1,5557,[318 515 427 588  79],716,5,24789,4.460057574667147,40.0,0.0
15558,1,5558,[405 181 197  11  56],280,2,24791,4.459615038676021,0.0,0.0
15559,1,5559,[234 132 204 175 127],18,3,24794,4.459352517985612,0.0,20.0
15560,1,5560,[228 216 161 176 210],786,5,24799,4.45944973925553,0.0,0.0
15561,1,5561,[210 202 186 144  79],450,3,24802,4.459187342682489,0.0,0.0
15562,1,5562,[318 515 427 588  79],716,5,24807,4.459284558691354,40.0,0.0
15563,1,5563,[117 202 144 168 496],450,5,24812,4.459381739755572,20.0,0.0
15564,1,5564,[318 515 427 588  79],18,5,24817,4.45947888589398,40.0,0.0
15565,1,5565,[215 257  71 322 210],504,5,24822,4.4595759971254045,0.0,0.0
15566,1,5566,[318 515 427 588  79],18,5,24827,4.459673073468655,40.0,0.0
15567,1,5567,[204  50  15  95 111],577,4,24831,4.459590517241379,0.0,20.0
15568,1,5568,[318 515 427 588  79],18,5,24836,4.459687556114203,40.0,0.0
15569,1,5569,[318 515 427 588  79],716,5,24841,4.459784560143627,40.0,0.0
15570,1,5570,[318 515 427 588  79],807,5,24846,4.4598815293484115,40.0,0.0
15571,1,5571,[318 515 427 588  79],807,5,24851,4.459978463747308,40.0,0.0
15572,1,5572,[318 515 427 588  79],807,5,24856,4.460075363359053,40.0,0.0
15573,1,5573,[318 515 427 588  79],18,5,24861,4.460172228202368,40.0,0.0
15574,1,5574,[ 22 186 294 197  11],655,0,24861,4.459372197309417,0.0,0.0
15575,1,5575,[318 515 427 588  79],18,5,24866,4.459469153515064,40.0,0.0
15576,1,5576,[318 515 427 588  79],807,5,24871,4.459566074950691,40.0,0.0
15577,1,5577,[ 70  88 200 186  82],655,1,24872,4.458945858730728,0.0,0.0
15578,1,5578,[318 515 427 588  79],18,5,24877,4.4590428392184975,40.0,0.0
15579,1,5579,[318 515 427 588  79],18,5,24882,4.459139784946236,40.0,0.0
15580,1,5580,[427 435 471 173 289],807,3,24885,4.458878337215553,20.0,0.0
15581,1,5581,[318 515 427 588  79],18,5,24890,4.458975277678252,40.0,0.0
15582,1,5582,[318 515 427 588  79],18,5,24895,4.4590721834139355,40.0,0.0
15583,1,5583,[318 515 427 588  79],716,5,24900,4.4591690544412605,40.0,0.0
15584,1,5584,[318 515 427 588  79],18,5,24905,4.459265890778872,40.0,0.0
15585,1,5585,[318 515 427 588  79],807,5,24910,4.459362692445399,40.0,0.0
15586,1,5586,[318 515 427 588  79],716,5,24915,4.45945945945946,40.0,0.0
15587,1,5587,[ 25  88 144 275 197],401,5,24920,4.459556191839656,0.0,20.0
15588,1,5588,[268 258 282 153  22],535,2,24922,4.45911612095187,0.0,0.0
15589,1,5589,[318 515 427 588  79],18,5,24927,4.459212880143113,40.0,0.0
15590,1,5590,[318 515 427 588  79],18,5,24932,4.4593096047218745,40.0,0.0
15591,1,5591,[318 515 427 588  79],716,5,24937,4.4594062947067235,40.0,0.0
15592,1,5592,[318 515 427 588  79],18,5,24942,4.4595029501162164,40.0,0.0
15593,1,5593,[318 515 427 588  79],18,5,24947,4.459599570968895,40.0,0.0
15594,1,5594,[318 515 427 588  79],18,5,24952,4.459696157283289,40.0,0.0
15595,1,5595,[318 515 427 588  79],807,5,24957,4.459792709077913,40.0,0.0
15596,1,5596,[318 515 427 588  79],807,5,24962,4.459889226371271,40.0,0.0
15597,1,5597,[318 515 427 588  79],18,5,24967,4.459985709181851,40.0,0.0
15598,1,5598,[318 515 427 588  79],716,5,24972,4.46008215752813,40.0,0.0
15599,1,5599,[318 515 427 588  79],18,5,24977,4.460178571428571,40.0,0.0
15600,1,5600,[318 515 427 588  79],716,5,24982,4.460274950901625,40.0,0.0
15601,1,5601,[318 515 427 588  79],807,5,24987,4.460371295965727,40.0,0.0
15602,1,5602,[318 515 427 588  79],18,5,24992,4.4604676066393,40.0,0.0
15603,1,5603,[228 182 302 286  56],450,5,24997,4.460563882940757,0.0,20.0
15604,1,5604,[318 515 427 588  79],716,5,25002,4.460660124888492,40.0,0.0
15605,1,5605,[216  82 173 186 265],450,3,25005,4.4603995718872635,0.0,0.0
15606,1,5606,[318 515 427 588  79],18,5,25010,4.460495808810416,40.0,0.0
15607,1,5607,[318 515 427 588  79],807,5,25015,4.460592011412269,40.0,0.0
15608,1,5608,[318 515 427 588  79],807,5,25020,4.460688179711179,40.0,0.0
15609,1,5609,[318 515 427 588  79],18,5,25025,4.46078431372549,40.0,0.0
15610,1,5610,[216 300 286 111 403],655,1,25026,4.460167528069863,0.0,20.0
15611,1,5611,[318 515 427 588  79],807,5,25031,4.460263720598717,40.0,0.0
15612,1,5612,[318 515 427 588  79],807,5,25036,4.460359878852663,40.0,0.0
15613,1,5613,[318 515 427 588  79],807,5,25041,4.460456002850018,40.0,0.0
15614,1,5614,[ 22 161 269 153  50],796,4,25045,4.4603739982190564,0.0,20.0
15615,1,5615,[318 515 427 588  79],807,5,25050,4.460470085470085,40.0,0.0
15616,1,5616,[318 515 427 588  79],18,5,25055,4.4605661385081,40.0,0.0
15617,1,5617,[318 515 427 588  79],18,5,25060,4.46066215735137,40.0,0.0
15618,1,5618,[222 427 357   1 313],296,5,25065,4.460758142018153,20.0,0.0
15619,1,5619,[318 515 427 588  79],807,5,25070,4.460854092526691,40.0,0.0
15620,1,5620,[318 515 427 588  79],716,5,25075,4.460950008895215,40.0,0.0
15621,1,5621,[100 268 185 173   8],503,5,25080,4.461045891141942,0.0,20.0
15622,1,5622,[318 515 427 588  79],716,5,25085,4.461141739285079,40.0,0.0
15623,1,5623,[318 515 427 588  79],18,5,25090,4.461237553342817,40.0,0.0
15624,1,5624,[318 515 427 588  79],716,5,25095,4.461333333333333,40.0,0.0
15625,1,5625,[385 143 508 475 179],655,2,25097,4.460895840739424,0.0,0.0
15626,1,5626,[ 15 216 603 211 195],151,4,25101,4.460813932823885,20.0,0.0
15627,1,5627,[  1   8 483 118 405],280,3,25104,4.460554371002132,0.0,0.0
15628,1,5628,[318 515 427 588  79],18,5,25109,4.460650204299165,40.0,0.0
15629,1,5629,[318 515 427 588  79],807,5,25114,4.460746003552398,40.0,0.0
15630,1,5630,[318 515 427 588  79],716,5,25119,4.460841768779968,40.0,0.0
15631,1,5631,[318 515 427 588  79],716,5,25124,4.4609375,40.0,0.0
15632,1,5632,[318 515 427 588  79],18,5,25129,4.461033197230606,40.0,0.0
15633,1,5633,[318 515 427 588  79],18,5,25134,4.461128860489882,40.0,0.0
15634,1,5634,[318 515 427 588  79],807,5,25139,4.461224489795918,40.0,0.0
15635,1,5635,[318 515 427 588  79],18,5,25144,4.461320085166785,40.0,0.0
15636,1,5636,[173  12 237 176 257],796,5,25149,4.461415646620543,0.0,0.0
15637,1,5637,[174 194 132 100 228],577,4,25153,4.461333806314296,0.0,20.0
15638,1,5638,[318 515 427 588  79],807,5,25158,4.461429331441745,40.0,0.0
15639,1,5639,[318 515 427 588  79],716,5,25163,4.4615248226950355,40.0,0.0
15640,1,5640,[318 515 427 588  79],18,5,25168,4.461620280092182,40.0,0.0
15641,1,5641,[318 515 427 588  79],18,5,25173,4.461715703651188,40.0,0.0
15642,1,5642,[318 515 427 588  79],716,5,25178,4.461811093390041,40.0,0.0
15643,1,5643,[ 25 194 228 282 117],450,4,25182,4.461729270021261,0.0,0.0
15644,1,5644,[318 515 427 588  79],807,5,25187,4.461824623560673,40.0,0.0
15645,1,5645,[318 515 427 588  79],716,5,25192,4.461919943322706,40.0,0.0
15646,1,5646,[204 273  88 245 211],450,4,25196,4.461838144147335,0.0,0.0
15647,1,5647,[318 515 427 588  79],716,5,25201,4.461933427762039,40.0,0.0
15648,1,5648,[318 515 427 588  79],18,5,25206,4.462028677642061,40.0,0.0
15649,1,5649,[318 515 427 588  79],807,5,25211,4.46212389380531,40.0,0.0
15650,1,5650,[318 515 427 588  79],18,5,25216,4.462219076269687,40.0,0.0
15651,1,5651,[318 515 427 588  79],716,5,25221,4.4623142250530785,40.0,0.0
15652,1,5652,[318 515 427 588  79],807,5,25226,4.462409340173359,40.0,0.0
15653,1,5653,[318 515 427 588  79],716,5,25231,4.462504421648391,40.0,0.0
15654,1,5654,[318 515 427 588  79],716,5,25236,4.462599469496022,40.0,0.0
15655,1,5655,[318 515 427 588  79],716,5,25241,4.462694483734087,40.0,0.0
15656,1,5656,[318 515 427 588  79],716,5,25246,4.462789464380414,40.0,0.0
15657,1,5657,[318 515 427 588  79],716,5,25251,4.46288441145281,40.0,0.0
15658,1,5658,[318 515 427 588  79],807,5,25256,4.4629793249690755,40.0,0.0
15659,1,5659,[318 515 427 588  79],716,5,25261,4.463074204946996,40.0,0.0
15660,1,5660,[318 515 427 588  79],18,5,25266,4.463169051404345,40.0,0.0
15661,1,5661,[235 603 182 275 237],591,2,25268,4.4627340162486755,20.0,20.0
15662,1,5662,[318 515 427 588  79],18,5,25273,4.462828889281299,40.0,0.0
15663,1,5663,[318 515 427 588  79],18,5,25278,4.46292372881356,40.0,0.0
15664,1,5664,[125 211 435  98 483],151,5,25283,4.463018534863195,0.0,0.0
15665,1,5665,[238 174 175 191 173],716,4,25287,4.462936816096011,0.0,0.0
15666,1,5666,[318 515 427 588  79],807,5,25292,4.463031586377272,40.0,0.0
15667,1,5667,[318 515 427 588  79],807,5,25297,4.4631263232180665,40.0,0.0
15668,1,5668,[318 515 427 588  79],18,5,25302,4.463221026636091,40.0,0.0
15669,1,5669,[318 515 427 588  79],18,5,25307,4.46331569664903,40.0,0.0
15670,1,5670,[318 515 427 588  79],716,5,25312,4.463410333274555,40.0,0.0
15671,1,5671,[318 515 427 588  79],18,5,25317,4.463504936530325,40.0,0.0
15672,1,5672,[318 515 427 588  79],716,5,25322,4.463599506433986,40.0,0.0
15673,1,5673,[318 515 427 588  79],807,5,25327,4.463694043003172,40.0,0.0
15674,1,5674,[318 515 427 588  79],18,5,25332,4.463788546255507,40.0,0.0
15675,1,5675,[132 288 238 276 161],504,3,25335,4.4635306553911205,0.0,0.0
15676,1,5676,[318 515 427 588  79],716,5,25340,4.463625154130703,40.0,0.0
15677,1,5677,[318 515 427 588  79],807,5,25345,4.463719619584361,40.0,0.0
15678,1,5678,[318 515 427 588  79],807,5,25350,4.463814051769678,40.0,0.0
15679,1,5679,[318 515 427 588  79],716,5,25355,4.463908450704225,40.0,0.0
15680,1,5680,[318 515 427 588  79],18,5,25360,4.4640028164055625,40.0,0.0
15681,1,5681,[318 515 427 588  79],716,5,25365,4.464097148891235,40.0,0.0
15682,1,5682,[318 515 427 588  79],716,5,25370,4.464191448178779,40.0,0.0
15683,1,5683,[318 515 427 588  79],18,5,25375,4.464285714285714,40.0,0.0
15684,1,5684,[318 515 427 588  79],18,5,25380,4.464379947229552,40.0,0.0
15685,1,5685,[318 515 427 588  79],18,5,25385,4.464474147027787,40.0,0.0
15686,1,5686,[202 568 111 174 153],450,5,25390,4.4645683136979075,0.0,0.0
15687,1,5687,[318 515 427 588  79],18,5,25395,4.464662447257384,40.0,0.0
15688,1,5688,[318 515 427 588  79],716,5,25400,4.4647565477236775,40.0,0.0
15689,1,5689,[318 515 427 588  79],18,5,25405,4.464850615114235,40.0,0.0
15690,1,5690,[318 515 427 588  79],807,5,25410,4.464944649446495,40.0,0.0
15691,1,5691,[318 515 427 588  79],807,5,25415,4.465038650737878,40.0,0.0
15692,1,5692,[318 515 427 588  79],716,5,25420,4.4651326190057965,40.0,0.0
15693,1,5693,[318 515 427 588  79],716,5,25425,4.46522655426765,40.0,0.0
15694,1,5694,[318 515 427 588  79],716,5,25430,4.465320456540825,40.0,0.0
15695,1,5695,[318 515 427 588  79],18,5,25435,4.465414325842697,40.0,0.0
15696,1,5696,[318 515 427 588  79],716,5,25440,4.465508162190627,40.0,0.0
15697,1,5697,[318 515 427 588  79],18,5,25445,4.465601965601966,40.0,0.0
15698,1,5698,[318 515 427 588  79],18,5,25450,4.465695736094052,40.0,0.0
15699,1,5699,[318 515 427 588  79],807,5,25455,4.46578947368421,40.0,0.0
15700,1,5700,[318 515 427 588  79],807,5,25460,4.465883178389756,40.0,0.0
15701,1,5701,[318 515 427 588  79],807,5,25465,4.46597685022799,40.0,0.0
15702,1,5702,[318 515 427 588  79],807,5,25470,4.466070489216202,40.0,0.0
15703,1,5703,[318 515 427 588  79],716,5,25475,4.466164095371669,40.0,0.0
15704,1,5704,[318 515 427 588  79],807,5,25480,4.466257668711656,40.0,0.0
15705,1,5705,[357 435 204  11 210],450,4,25484,4.466175955134946,0.0,0.0
15706,1,5706,[318 515 427 588  79],716,5,25489,4.466269493604345,40.0,0.0
15707,1,5707,[194 204 132 118 161],389,3,25492,4.466012613875263,0.0,0.0
15708,1,5708,[318 515 427 588  79],807,5,25497,4.466106148187073,40.0,0.0
15709,1,5709,[318 515 427 588  79],807,5,25502,4.466199649737303,40.0,0.0
15710,1,5710,[185 318   9 173 301],535,5,25507,4.466293118543162,20.0,0.0
15711,1,5711,[ 88 172 237 318 211],593,5,25512,4.466386554621849,20.0,0.0
15712,1,5712,[191 215 275  98 427],639,3,25515,4.466129879222825,20.0,20.0
15713,1,5713,[318 515 427 588  79],18,5,25520,4.4662233111655585,40.0,0.0
15714,1,5714,[318 515 427 588  79],807,5,25525,4.466316710411198,40.0,0.0
15715,1,5715,[318 515 427 588  79],18,5,25530,4.466410076976907,40.0,0.0
15716,1,5716,[318 515 427 588  79],807,5,25535,4.466503410879832,40.0,0.0
15717,1,5717,[211 125 546  88  97],151,4,25539,4.466421825813222,0.0,0.0
15718,1,5718,[318 515 427 588  79],716,5,25544,4.466515125021857,40.0,0.0
15719,1,5719,[318 515 427 588  79],807,5,25549,4.466608391608392,40.0,0.0
15720,1,5720,[194 195 118 151 181],151,3,25552,4.46635203635728,0.0,0.0
15721,1,5721,[318 515 427 588  79],18,5,25557,4.4664452988465575,40.0,0.0
15722,1,5722,[318 515 427 588  79],18,5,25562,4.466538528743666,40.0,0.0
15723,1,5723,[357  79 742 300 135],693,3,25565,4.466282320055905,0.0,0.0
15724,1,5724,[318 515 427 588  79],716,5,25570,4.466375545851529,40.0,0.0
15725,1,5725,[197 175 185 215   4],655,1,25571,4.465770171149145,0.0,0.0
15726,1,5726,[318 515 427 588  79],807,5,25576,4.465863453815261,40.0,0.0
15727,1,5727,[ 15   7 180  82 273],450,2,25578,4.465432960893855,0.0,0.0
15728,1,5728,[318 515 427 588  79],716,5,25583,4.465526269855123,40.0,0.0
15729,1,5729,[318 515 427 588  79],716,5,25588,4.465619546247819,40.0,0.0
15730,1,5730,[318 515 427 588  79],18,5,25593,4.46571279008899,40.0,0.0
15731,1,5731,[597 288 161  97 328],450,4,25597,4.46563154221912,0.0,0.0
15732,1,5732,[318 515 427 588  79],18,5,25602,4.465724751439037,40.0,0.0
15733,1,5733,[318 515 427 588  79],716,5,25607,4.46581792814789,40.0,0.0
15734,1,5734,[153 204  88  56  82],18,2,25609,4.465387968613775,0.0,0.0
15735,1,5735,[318 515 427 588  79],716,5,25614,4.4654811715481175,40.0,0.0
15736,1,5736,[318 515 427 588  79],807,5,25619,4.465574341990587,40.0,0.0
15737,1,5737,[318 515 427 588  79],716,5,25624,4.4656674799581735,40.0,0.0
15738,1,5738,[318 515 427 588  79],807,5,25629,4.4657605854678515,40.0,0.0
15739,1,5739,[318 515 427 588  79],807,5,25634,4.465853658536585,40.0,0.0
15740,1,5740,[174 257 245 238 187],796,3,25637,4.465598327817453,0.0,0.0
15741,1,5741,[318 515 427 588  79],716,5,25642,4.465691396725879,40.0,0.0
15742,1,5742,[ 50 216 194 475  12],503,3,25645,4.465436183179523,0.0,20.0
15743,1,5743,[318 515 427 588  79],807,5,25650,4.4655292479108635,40.0,0.0
15744,1,5744,[318 515 427 588  79],807,5,25655,4.46562228024369,40.0,0.0
15745,1,5745,[318 515 427 588  79],716,5,25660,4.465715280194918,40.0,0.0
15746,1,5746,[237 173 282 151  69],457,5,25665,4.465808247781451,0.0,0.0
15747,1,5747,[318 515 427 588  79],716,5,25670,4.465901183020181,40.0,0.0
15748,1,5748,[238 121 483 405 211],269,3,25673,4.465646199339015,0.0,0.0
15749,1,5749,[318 515 427 588  79],18,5,25678,4.465739130434782,40.0,0.0
15750,1,5750,[153 496 195 161 173],269,1,25679,4.465136498000348,20.0,0.0
15751,1,5751,[318 515 427 588  79],807,5,25684,4.465229485396383,40.0,0.0
15752,1,5752,[318 515 427 588  79],716,5,25689,4.465322440465844,40.0,0.0
15753,1,5753,[237 423  11  96 174],577,4,25693,4.465241571080987,0.0,0.0
15754,1,5754,[318 515 427 588  79],716,5,25698,4.465334491746307,40.0,0.0
15755,1,5755,[423 173 121 144   1],716,4,25702,4.465253648366922,0.0,0.0
15756,1,5756,[318 515 427 588  79],807,5,25707,4.465346534653466,40.0,0.0
15757,1,5757,[318 515 427 588  79],18,5,25712,4.465439388676624,40.0,0.0
15758,1,5758,[318 515 427 588  79],18,5,25717,4.465532210453204,40.0,0.0
15759,1,5759,[318 515 427 588  79],18,5,25722,4.465625,40.0,0.0
15760,1,5760,[405 357 471 186 318],457,5,25727,4.465717757333796,20.0,0.0
15761,1,5761,[318 515 427 588  79],716,5,25732,4.4658104824713645,40.0,0.0
15762,1,5762,[318 515 427 588  79],18,5,25737,4.465903175429464,40.0,0.0
15763,1,5763,[318 515 427 588  79],807,5,25742,4.4659958362248435,40.0,0.0
15764,1,5764,[191 187  71 427 181],796,5,25747,4.466088464874241,20.0,0.0
15765,1,5765,[194 181 168 196 515],535,4,25751,4.466007630939993,0.0,0.0
15766,1,5766,[483 276 161 195 153],269,2,25753,4.465580024276053,0.0,0.0
15767,1,5767,[318 427 515 588  79],807,5,25758,4.465672676837725,40.0,0.0
15768,1,5768,[318 427 515 588  79],18,5,25763,4.4657652972785575,40.0,0.0
15769,1,5769,[318 427 515 588  79],716,5,25768,4.465857885615251,40.0,0.0
15770,1,5770,[318 427 515 588  79],716,5,25773,4.465950441864495,40.0,0.0
15771,1,5771,[318 427 515 588  79],716,5,25778,4.466042966042966,40.0,0.0
15772,1,5772,[318 427 515 588  79],716,5,25783,4.46613545816733,40.0,0.0
15773,1,5773,[318 427 515 588  79],18,5,25788,4.466227918254243,40.0,0.0
15774,1,5774,[318 427 515 588  79],716,5,25793,4.466320346320346,40.0,0.0
15775,1,5775,[174 234 100 318 121],72,4,25797,4.466239612188366,20.0,20.0
15776,1,5776,[318 427 515 588  79],18,5,25802,4.4663320062316085,40.0,0.0
15777,1,5777,[318 427 515 588  79],18,5,25807,4.466424368293527,40.0,0.0
15778,1,5778,[200 111 202 210 322],629,4,25811,4.466343658072331,0.0,0.0
15779,1,5779,[294 427 216 258 182],450,5,25816,4.466435986159169,20.0,0.0
15780,1,5780,[318 427 515 588  79],716,5,25821,4.4665282823040995,40.0,0.0
15781,1,5781,[318 427 515 588  79],716,5,25826,4.466620546523695,40.0,0.0
15782,1,5782,[215 121  28  97 132],504,5,25831,4.466712778834515,0.0,0.0
15783,1,5783,[318 427 515 588  79],716,5,25836,4.466804979253112,40.0,0.0
15784,1,5784,[204 175 294 568 210],655,0,25836,4.466032843560933,0.0,0.0
15785,1,5785,[318 427 515 588  79],18,5,25841,4.4661251296232285,40.0,0.0
15786,1,5786,[318 427 515 588  79],18,5,25846,4.466217383791256,40.0,0.0
15787,1,5787,[  9 173 496 385 234],280,3,25849,4.46596406357982,20.0,0.0
15788,1,5788,[ 96   8 186 289   4],655,0,25849,4.465192606667818,0.0,0.0
15789,1,5789,[318 427 515 588  79],716,5,25854,4.465284974093264,40.0,0.0
15790,1,5790,[318 427 515 588  79],18,5,25859,4.465377309618374,40.0,0.0
15791,1,5791,[275 271  89  28   8],796,4,25863,4.465296961325967,0.0,20.0
15792,1,5792,[318 427 515 588  79],18,5,25868,4.465389262903504,40.0,0.0
15793,1,5793,[318 427 515 588  79],807,5,25873,4.465481532619951,40.0,0.0
15794,1,5794,[318 427 515 588  79],807,5,25878,4.465573770491804,40.0,0.0
15795,1,5795,[ 79 655  15 423 323],796,3,25881,4.465320910973085,0.0,0.0
15796,1,5796,[318 427 515 588  79],18,5,25886,4.465413144730033,40.0,0.0
15797,1,5797,[ 64 357 191  69  25],18,3,25889,4.465160400137979,20.0,0.0
15798,1,5798,[318 427 515 588  79],18,5,25894,4.465252629763753,40.0,0.0
15799,1,5799,[318 427 515 588  79],807,5,25899,4.465344827586207,40.0,0.0
15800,1,5800,[ 15 588 117  89 153],796,5,25904,4.46543699362179,0.0,0.0
15801,1,5801,[ 22 195  89  15 235],256,4,25908,4.46535677352637,0.0,0.0
15802,1,5802,[748 183  25 435 234],450,3,25911,4.465104256419093,0.0,0.0
15803,1,5803,[318 427 515 588  79],18,5,25916,4.465196416264645,40.0,0.0
15804,1,5804,[127  96 191 183 588],450,5,25921,4.4652885443583115,0.0,20.0
15805,1,5805,[318 427 515 588  79],18,5,25926,4.4653806407165,40.0,0.0
15806,1,5806,[204  25 588 196 180],450,4,25930,4.465300499397279,0.0,0.0
15807,1,5807,[300 187  71 117  56],796,5,25935,4.465392561983471,0.0,0.0
15808,1,5808,[318 427 515 588  79],716,5,25940,4.4654845928731275,40.0,0.0
15809,1,5809,[318 427 515 588  79],807,5,25945,4.465576592082616,40.0,0.0
15810,1,5810,[318 427 515 588  79],807,5,25950,4.465668559628291,40.0,0.0
15811,1,5811,[318 427 515 588  79],807,5,25955,4.465760495526497,40.0,0.0
15812,1,5812,[318 427 515 588  79],18,5,25960,4.465852399793566,40.0,0.0
15813,1,5813,[318 427 515 588  79],807,5,25965,4.46594427244582,40.0,0.0
15814,1,5814,[318 427 515 588  79],18,5,25970,4.46603611349957,40.0,0.0
15815,1,5815,[318 427 515 588  79],18,5,25975,4.466127922971114,40.0,0.0
15816,1,5816,[175 300 301 228 135],151,5,25980,4.46621970087674,0.0,0.0
15817,1,5817,[318 427 515 588  79],18,5,25985,4.466311447232726,40.0,0.0
15818,1,5818,[318 427 515 588  79],716,5,25990,4.466403162055336,40.0,0.0
15819,1,5819,[288 597 186 237 258],457,4,25994,4.466323024054983,0.0,0.0
15820,1,5820,[318 427 515 588  79],716,5,25999,4.466414705377083,40.0,0.0
15821,1,5821,[318 427 515 588  79],716,5,26004,4.466506355204397,40.0,0.0
15822,1,5822,[318 427 515 588  79],18,5,26009,4.466597973553151,40.0,0.0
15823,1,5823,[318 427 515 588  79],807,5,26014,4.46668956043956,40.0,0.0
15824,1,5824,[318 427 515 588  79],716,5,26019,4.4667811158798285,40.0,0.0
15825,1,5825,[318 427 515 588  79],716,5,26024,4.4668726398901475,40.0,0.0
15826,1,5826,[318 427 515 588  79],18,5,26029,4.4669641324867,40.0,0.0
15827,1,5827,[471 196 187 302 172],389,4,26033,4.466884008236102,0.0,0.0
15828,1,5828,[318 427 515 588  79],18,5,26038,4.466975467490135,40.0,0.0
15829,1,5829,[427 185 289 228 357],693,3,26041,4.46672384219554,20.0,0.0
15830,1,5830,[318 427 515 588  79],18,5,26046,4.4668152975475905,40.0,0.0
15831,1,5831,[318 427 515 588  79],18,5,26051,4.466906721536351,40.0,0.0
15832,1,5832,[318 427 515 588  79],716,5,26056,4.466998114177953,40.0,0.0
15833,1,5833,[742 117 318 496   1],450,5,26061,4.467089475488516,40.0,0.0
15834,1,5834,[318 427 515 588  79],807,5,26066,4.467180805484148,40.0,0.0
15835,1,5835,[ 15 294 173  79 357],450,4,26070,4.467100753941056,0.0,0.0
15836,1,5836,[318 427 515 588  79],807,5,26075,4.467192050710982,40.0,0.0
15837,1,5837,[318 427 515 588  79],18,5,26080,4.467283316204179,40.0,0.0
15838,1,5838,[318 427 515 588  79],18,5,26085,4.467374550436719,40.0,0.0
15839,1,5839,[568 185  97 174  56],716,5,26090,4.467465753424658,0.0,0.0
15840,1,5840,[318 427 515 588  79],18,5,26095,4.467556925184044,40.0,0.0
15841,1,5841,[318 427 515 588  79],18,5,26100,4.467648065730914,40.0,0.0
15842,1,5842,[318 427 515 588  79],807,5,26105,4.467739175081294,40.0,0.0
15843,1,5843,[318 427 515 588  79],18,5,26110,4.467830253251198,40.0,0.0
15844,1,5844,[318 427 515 588  79],18,5,26115,4.46792130025663,40.0,0.0
15845,1,5845,[318 427 515 588  79],716,5,26120,4.468012316113582,40.0,0.0
15846,1,5846,[318 427 515 588  79],807,5,26125,4.468103300838036,40.0,0.0
15847,1,5847,[318 427 515 588  79],807,5,26130,4.468194254445964,40.0,0.0
15848,1,5848,[318 427 515 588  79],716,5,26135,4.468285176953326,40.0,0.0
15849,1,5849,[318 427 515 588  79],807,5,26140,4.4683760683760685,40.0,0.0
15850,1,5850,[318 427 515 588  79],18,5,26145,4.468466928730131,40.0,0.0
15851,1,5851,[318 427 515 588  79],807,5,26150,4.468557758031443,40.0,0.0
15852,1,5852,[318 427 515 588  79],716,5,26155,4.468648556295917,40.0,0.0
15853,1,5853,[318 427 515 588  79],18,5,26160,4.46873932353946,40.0,0.0
15854,1,5854,[245 228  88 313 742],280,1,26161,4.468146883005978,0.0,0.0
15855,1,5855,[318 427 515 588  79],716,5,26166,4.468237704918033,40.0,0.0
15856,1,5856,[125 275 118 185 181],796,5,26171,4.468328495816971,0.0,20.0
15857,1,5857,[318 427 515 588  79],716,5,26176,4.4684192557186755,40.0,0.0
15858,1,5858,[318 427 515 588  79],18,5,26181,4.468509984639017,40.0,0.0
15859,1,5859,[318 427 515 588  79],18,5,26186,4.4686006825938565,40.0,0.0
15860,1,5860,[318 427 515 588  79],807,5,26191,4.468691349599045,40.0,0.0
15861,1,5861,[318 427 515 588  79],18,5,26196,4.46878198567042,40.0,0.0
15862,1,5862,[318 427 515 588  79],18,5,26201,4.4688725908238105,40.0,0.0
15863,1,5863,[318 427 515 588  79],18,5,26206,4.468963165075034,40.0,0.0
15864,1,5864,[185 174 245 182 194],450,5,26211,4.469053708439898,0.0,0.0
15865,1,5865,[318 427 515 588  79],807,5,26216,4.469144220934197,40.0,0.0
15866,1,5866,[318 427 515 588  79],716,5,26221,4.469234702573718,40.0,0.0
15867,1,5867,[318 427 515 588  79],716,5,26226,4.469325153374233,40.0,0.0
15868,1,5868,[ 69  64 211 132  95],796,4,26230,4.469245186573522,20.0,0.0
15869,1,5869,[234 182 185 195 191],450,4,26234,4.469165247018739,0.0,0.0
15870,1,5870,[216  69 186 211  15],151,5,26239,4.46925566343042,0.0,0.0
15871,1,5871,[210 204 234 258 125],655,0,26239,4.468494550408719,0.0,0.0
15872,1,5872,[318 427 515 588  79],716,5,26244,4.468585050229866,40.0,0.0
15873,1,5873,[196 318 271 174 216],655,2,26246,4.468164794007491,20.0,0.0
15874,1,5874,[427 257 181 286 127],796,4,26250,4.468085106382978,20.0,40.0
15875,1,5875,[318 427 515 588  79],716,5,26255,4.468175629680054,40.0,0.0
15876,1,5876,[318 427 515 588  79],18,5,26260,4.468266122171176,40.0,0.0
15877,1,5877,[318 427 515 588  79],18,5,26265,4.468356583872065,40.0,0.0
15878,1,5878,[318 427 515 588  79],807,5,26270,4.468447014798435,40.0,0.0
15879,1,5879,[318 427 515 588  79],18,5,26275,4.468537414965986,40.0,0.0
15880,1,5880,[275 176 496 175 483],151,4,26279,4.468457745281415,20.0,20.0
15881,1,5881,[125 153 275 200  88],151,3,26282,4.468208092485549,0.0,20.0
15882,1,5882,[183  79  25 228  28],457,5,26287,4.468298487166412,0.0,0.0
15883,1,5883,[318 427 515 588  79],807,5,26292,4.468388851121686,40.0,0.0
15884,1,5884,[318 427 515 588  79],18,5,26297,4.468479184367035,40.0,0.0
15885,1,5885,[  7 273 275  98 546],344,4,26301,4.468399592252803,0.0,20.0
15886,1,5886,[318 427 515 588  79],716,5,26306,4.468489892984542,40.0,0.0
15887,1,5887,[318 427 515 588  79],716,5,26311,4.4685801630434785,40.0,0.0
15888,1,5888,[318 427 515 588  79],807,5,26316,4.468670402445237,40.0,0.0
15889,1,5889,[318 427 515 588  79],716,5,26321,4.4687606112054326,40.0,0.0
15890,1,5890,[318 427 515 588  79],807,5,26326,4.468850789339671,40.0,0.0
15891,1,5891,[318 427 515 588  79],807,5,26331,4.468940936863544,40.0,0.0
15892,1,5892,[200 275 423 191 176],450,4,26335,4.468861360936705,0.0,20.0
15893,1,5893,[318 427 515 588  79],18,5,26340,4.4689514760773665,40.0,0.0
15894,1,5894,[385  79  50 125   9],151,4,26344,4.468871925360475,0.0,20.0
15895,1,5895,[318 427 515 588  79],18,5,26349,4.468962008141113,40.0,0.0
15896,1,5896,[132 181  70 168 161],330,4,26353,4.46888248261828,0.0,0.0
15897,1,5897,[ 79   9 269 216 202],18,4,26357,4.468802984062394,0.0,0.0
15898,1,5898,[318 427 515 588  79],716,5,26362,4.46889303271741,40.0,0.0
15899,1,5899,[318 427 515 588  79],18,5,26367,4.4689830508474575,40.0,0.0
15900,1,5900,[318 427 515 588  79],807,5,26372,4.469073038468056,40.0,0.0
15901,1,5901,[318 427 515 588  79],18,5,26377,4.469162995594714,40.0,0.0
15902,1,5902,[318 427 515 588  79],807,5,26382,4.469252922242927,40.0,0.0
15903,1,5903,[318 427 515 588  79],807,5,26387,4.469342818428184,40.0,0.0
15904,1,5904,[197 202 313 318 118],796,4,26391,4.4692633361558,20.0,0.0
15905,1,5905,[318 427 515 588  79],807,5,26396,4.469353200135456,40.0,0.0
15906,1,5906,[318 427 515 588  79],716,5,26401,4.469443033688844,40.0,0.0
15907,1,5907,[318 427 515 588  79],18,5,26406,4.469532836831415,40.0,0.0
15908,1,5908,[318 427 515 588  79],716,5,26411,4.469622609578609,40.0,0.0
15909,1,5909,[603  50 496 483 275],535,5,26416,4.469712351945854,40.0,40.0
15910,1,5910,[210  15 211 546 568],450,3,26419,4.469463711723905,0.0,0.0
15911,1,5911,[318 427 515 588  79],807,5,26424,4.469553450608931,40.0,0.0
15912,1,5912,[318 427 515 588  79],716,5,26429,4.469643159140876,40.0,0.0
15913,1,5913,[ 28 275 234 313 144],655,2,26431,4.469225566452486,0.0,20.0
15914,1,5914,[318 427 515 588  79],716,5,26436,4.4693153000845305,40.0,0.0
15915,1,5915,[318 427 515 588  79],807,5,26441,4.469405003380663,40.0,0.0
15916,1,5916,[ 89 215 100  12 286],18,3,26444,4.469156667230015,0.0,40.0
15917,1,5917,[318 427 515 588  79],807,5,26449,4.4692463670158835,40.0,0.0
15918,1,5918,[318 427 515 588  79],807,5,26454,4.469336036492651,40.0,0.0
15919,1,5919,[318 427 515 588  79],18,5,26459,4.469425675675676,40.0,0.0
15920,1,5920,[318 427 515 588  79],18,5,26464,4.469515284580307,40.0,0.0
15921,1,5921,[318 427 515 588  79],18,5,26469,4.4696048632218845,40.0,0.0
15922,1,5922,[121 271 153 238 423],655,0,26469,4.468850244808374,0.0,0.0
15923,1,5923,[318 427 515 588  79],807,5,26474,4.468939905469277,40.0,0.0
15924,1,5924,[318 427 515 588  79],807,5,26479,4.469029535864979,40.0,0.0
15925,1,5925,[318 427 515 588  79],716,5,26484,4.4691191360108,40.0,0.0
15926,1,5926,[655 483  56  98   8],535,3,26487,4.468871267082841,0.0,0.0
15927,1,5927,[318 427 515 588  79],18,5,26492,4.468960863697705,40.0,0.0
15928,1,5928,[318 427 515 588  79],716,5,26497,4.469050430089391,40.0,0.0
15929,1,5929,[318 427 515 588  79],18,5,26502,4.469139966273187,40.0,0.0
15930,1,5930,[215 216 127 286 603],450,5,26507,4.469229472264374,20.0,40.0
15931,1,5931,[318 427 515 588  79],18,5,26512,4.46931894807822,40.0,0.0
15932,1,5932,[318 427 515 588  79],807,5,26517,4.469408393729985,40.0,0.0
15933,1,5933,[288 222 294 200 742],655,1,26518,4.468823727671048,0.0,0.0
15934,1,5934,[318 427 515 588  79],716,5,26523,4.468913226621735,40.0,0.0
15935,1,5935,[588 132  64 258 151],450,5,26528,4.46900269541779,20.0,0.0
15936,1,5936,[127  22 483  98 117],280,5,26533,4.469092134074448,0.0,20.0
15937,1,5937,[318 427 515 588  79],18,5,26538,4.469181542606939,40.0,0.0
15938,1,5938,[318 427 515 588  79],716,5,26543,4.469270921030477,40.0,0.0
15939,1,5939,[318 427 515 588  79],807,5,26548,4.469360269360269,40.0,0.0
15940,1,5940,[318 427 515 588  79],18,5,26553,4.469449587611513,40.0,0.0
15941,1,5941,[318 427 515 588  79],18,5,26558,4.469538875799394,40.0,0.0
15942,1,5942,[318 427 515 588  79],807,5,26563,4.469628133939088,40.0,0.0
15943,1,5943,[318 427 515 588  79],716,5,26568,4.469717362045761,40.0,0.0
15944,1,5944,[282 191  96 483 210],450,3,26571,4.469470142977292,0.0,0.0
15945,1,5945,[  8 228 258 427 333],796,5,26576,4.469559367642113,20.0,0.0
15946,1,5946,[318 427 515 588  79],807,5,26581,4.4696485623003195,40.0,0.0
15947,1,5947,[ 56  15 181 204 197],151,5,26586,4.469737726967048,0.0,0.0
15948,1,5948,[318 427 515 588  79],807,5,26591,4.469826861657421,40.0,0.0
15949,1,5949,[318 427 515 588  79],807,5,26596,4.469915966386554,40.0,0.0
15950,1,5950,[318 427 515 588  79],807,5,26601,4.470005041169552,40.0,0.0
15951,1,5951,[318 427 515 588  79],18,5,26606,4.470094086021505,40.0,0.0
15952,1,5952,[318 427 515 588  79],807,5,26611,4.470183100957501,40.0,0.0
15953,1,5953,[318 427 515 588  79],18,5,26616,4.47027208599261,40.0,0.0
15954,1,5954,[318 427 515 588  79],18,5,26621,4.4703610411418975,40.0,0.0
15955,1,5955,[117 183 328 211 180],450,5,26626,4.470449966420416,0.0,0.0
15956,1,5956,[173  97 121 125  70],151,5,26631,4.47053886184321,0.0,0.0
15957,1,5957,[318 427 515 588  79],807,5,26636,4.470627727425311,40.0,0.0
15958,1,5958,[318 427 515 588  79],716,5,26641,4.470716563181742,40.0,0.0
15959,1,5959,[268   8 271 313 185],655,2,26643,4.470302013422819,0.0,0.0
15960,1,5960,[318 427 515 588  79],716,5,26648,4.470390874014427,40.0,0.0
15961,1,5961,[742 301 286 172  88],450,5,26653,4.470479704797048,0.0,20.0
15962,1,5962,[318 427 515 588  79],18,5,26658,4.470568505785678,40.0,0.0
15963,1,5963,[151 403 385 174  71],807,5,26663,4.470657276995305,0.0,0.0
15964,1,5964,[132   4 257 282   9],655,0,26663,4.469907795473596,0.0,0.0
15965,1,5965,[313 546 204 211 328],450,5,26668,4.469996647670131,0.0,0.0
15966,1,5966,[318 427 515 588  79],807,5,26673,4.47008547008547,40.0,0.0
15967,1,5967,[318 427 515 588  79],807,5,26678,4.470174262734584,40.0,0.0
15968,1,5968,[318 427 515 588  79],18,5,26683,4.470263025632434,40.0,0.0
15969,1,5969,[318 427 515 588  79],18,5,26688,4.47035175879397,40.0,0.0
15970,1,5970,[318 427 515 588  79],716,5,26693,4.470440462234132,40.0,0.0
15971,1,5971,[318 427 515 588  79],807,5,26698,4.47052913596785,40.0,0.0
15972,1,5972,[ 50 603 200 187 655],655,4,26702,4.470450359953122,20.0,20.0
15973,1,5973,[318 427 515 588  79],716,5,26707,4.4705390023434886,40.0,0.0
15974,1,5974,[318 427 515 588  79],807,5,26712,4.470627615062761,40.0,0.0
15975,1,5975,[318 427 515 588  79],716,5,26717,4.470716198125837,40.0,0.0
15976,1,5976,[318 427 515 588  79],716,5,26722,4.4708047515475995,40.0,0.0
15977,1,5977,[186 135 228 211 144],716,2,26724,4.47039143526263,0.0,0.0
15978,1,5978,[318 427 515 588  79],807,5,26729,4.470480013380164,40.0,0.0
15979,1,5979,[318 427 515 588  79],18,5,26734,4.47056856187291,40.0,0.0
15980,1,5980,[318 427 515 588  79],807,5,26739,4.470657080755727,40.0,0.0
15981,1,5981,[318 427 515 588  79],716,5,26744,4.470745570043464,40.0,0.0
15982,1,5982,[496 215 294 269  79],796,3,26747,4.470499749289654,20.0,0.0
15983,1,5983,[318 427 515 588  79],18,5,26752,4.470588235294118,40.0,0.0
15984,1,5984,[318 427 515 588  79],807,5,26757,4.470676691729324,40.0,0.0
15985,1,5985,[318 427 515 588  79],716,5,26762,4.47076511861009,40.0,0.0
15986,1,5986,[318 427 515 588  79],807,5,26767,4.4708535159512275,40.0,0.0
15987,1,5987,[318 427 515 588  79],807,5,26772,4.470941883767535,40.0,0.0
15988,1,5988,[318 427 515 588  79],18,5,26777,4.471030222073802,40.0,0.0
15989,1,5989,[202 185 471 222 257],716,4,26781,4.470951585976628,0.0,0.0
15990,1,5990,[318 427 515 588  79],807,5,26786,4.471039893173093,40.0,0.0
15991,1,5991,[ 22 405  64 471 204],577,3,26789,4.470794392523365,20.0,0.0
15992,1,5992,[318 427 515 588  79],807,5,26794,4.470882696479226,40.0,0.0
15993,1,5993,[153 237 187 245 257],504,2,26796,4.47047047047047,0.0,0.0
15994,1,5994,[318 427 515 588  79],18,5,26801,4.470558798999166,40.0,0.0
15995,1,5995,[318 427 515 588  79],716,5,26806,4.470647098065377,40.0,0.0
15996,1,5996,[318 427 515 588  79],18,5,26811,4.470735367683842,40.0,0.0
15997,1,5997,[318 427 515 588  79],716,5,26816,4.470823607869289,40.0,0.0
15998,1,5998,[318 427 515 588  79],18,5,26821,4.47091181863644,40.0,0.0
15999,1,5999,[318 427 515 588  79],18,5,26826,4.471,40.0,0.0
16000,1,6000,[318 427 515 588  79],18,5,26831,4.471088151974671,40.0,0.0
16001,1,6001,[318 427 515 588  79],807,5,26836,4.471176274575142,40.0,0.0
16002,1,6002,[318 427 515 588  79],18,5,26841,4.471264367816092,40.0,0.0
16003,1,6003,[318 427 515 588  79],716,5,26846,4.471352431712192,40.0,0.0
16004,1,6004,[153  70 187   7 194],269,2,26848,4.470940882597835,0.0,0.0
16005,1,6005,[471 125   7  50 172],450,5,26853,4.4710289710289715,0.0,20.0
16006,1,6006,[318 427 515 588  79],807,5,26858,4.471117030131513,40.0,0.0
16007,1,6007,[318 427 515 588  79],716,5,26863,4.4712050599201065,40.0,0.0
16008,1,6008,[318 427 515 588  79],716,5,26868,4.471293060409386,40.0,0.0
16009,1,6009,[318 427 515 588  79],716,5,26873,4.471381031613976,40.0,0.0
16010,1,6010,[318 427 515 588  79],716,5,26878,4.471468973548494,40.0,0.0
16011,1,6011,[318 427 515 588  79],18,5,26883,4.471556886227545,40.0,0.0
16012,1,6012,[258  12 269 135 515],655,2,26885,4.47114585065691,0.0,0.0
16013,1,6013,[318 427 515 588  79],18,5,26890,4.4712337878284005,40.0,0.0
16014,1,6014,[318 427 515 588  79],716,5,26895,4.471321695760598,40.0,0.0
16015,1,6015,[318 427 515 588  79],807,5,26900,4.471409574468085,40.0,0.0
16016,1,6016,[318 427 515 588  79],18,5,26905,4.471497423965431,40.0,0.0
16017,1,6017,[222 269 121   7 597],344,3,26908,4.471252907942838,0.0,0.0
16018,1,6018,[318 427 515 588  79],807,5,26913,4.47134075427812,40.0,0.0
16019,1,6019,[318 427 515 588  79],716,5,26918,4.4714285714285715,40.0,0.0
16020,1,6020,[318 427 515 588  79],18,5,26923,4.471516359408736,40.0,0.0
16021,1,6021,[318 427 515 588  79],18,5,26928,4.471604118233145,40.0,0.0
16022,1,6022,[318 427 515 588  79],18,5,26933,4.471691847916321,40.0,0.0
16023,1,6023,[318 427 515 588  79],807,5,26938,4.471779548472775,40.0,0.0
16024,1,6024,[318 427 515 588  79],18,5,26943,4.471867219917012,40.0,0.0
16025,1,6025,[318 427 515 588  79],807,5,26948,4.471954862263525,40.0,0.0
16026,1,6026,[191 132  28 204 117],786,5,26953,4.472042475526796,0.0,0.0
16027,1,6027,[318 427 515 588  79],716,5,26958,4.472130059721301,40.0,0.0
16028,1,6028,[180 210 238 357 100],786,5,26963,4.472217614861503,0.0,20.0
16029,1,6029,[318 427 515 588  79],716,5,26968,4.472305140961858,40.0,0.0
16030,1,6030,[588 191 194  25 210],577,4,26972,4.472226828055049,0.0,0.0
16031,1,6031,[318 427 515 588  79],807,5,26977,4.472314323607427,40.0,0.0
16032,1,6032,[181 200  88 318 125],18,1,26978,4.4717387700977955,20.0,0.0
16033,1,6033,[318 427 515 588  79],18,5,26983,4.471826317533974,40.0,0.0
16034,1,6034,[318 427 515 588  79],18,5,26988,4.471913835956918,40.0,0.0
16035,1,6035,[318 427 515 588  79],716,5,26993,4.472001325381047,40.0,0.0
16036,1,6036,[318 427 515 588  79],807,5,26998,4.472088785820772,40.0,0.0
16037,1,6037,[318 427 515 588  79],807,5,27003,4.472176217290493,40.0,0.0
16038,1,6038,[318 427 515 588  79],807,5,27008,4.472263619804603,40.0,0.0
16039,1,6039,[318 427 515 588  79],807,5,27013,4.472350993377484,40.0,0.0
16040,1,6040,[318 427 515 588  79],807,5,27018,4.472438338023506,40.0,0.0
16041,1,6041,[318 427 515 588  79],807,5,27023,4.472525653757034,40.0,0.0
16042,1,6042,[318 427 515 588  79],716,5,27028,4.472612940592421,40.0,0.0
16043,1,6043,[180 143 194 117 176],796,4,27032,4.472534745201853,0.0,0.0
16044,1,6044,[318 427 515 588  79],807,5,27037,4.47262200165426,40.0,0.0
16045,1,6045,[  9 194  69 204 127],504,3,27040,4.472378432021171,0.0,20.0
16046,1,6046,[318 427 515 588  79],18,5,27045,4.472465685463867,40.0,0.0
16047,1,6047,[318 427 515 588  79],807,5,27050,4.47255291005291,40.0,0.0
16048,1,6048,[318 427 515 588  79],807,5,27055,4.472640105802612,40.0,0.0
16049,1,6049,[318 427 515 588  79],807,5,27060,4.472727272727273,40.0,0.0
16050,1,6050,[ 71 153   7 181 125],450,4,27064,4.4726491489010085,0.0,0.0
16051,1,6051,[318 427 515 588  79],807,5,27069,4.472736285525446,40.0,0.0
16052,1,6052,[318 427 515 588  79],18,5,27074,4.472823393358665,40.0,0.0
16053,1,6053,[318 427 515 588  79],807,5,27079,4.472910472414933,40.0,0.0
16054,1,6054,[318 427 515 588  79],807,5,27084,4.472997522708505,40.0,0.0
16055,1,6055,[318 427 515 588  79],716,5,27089,4.4730845442536324,40.0,0.0
16056,1,6056,[ 56 222 132  79 204],450,4,27093,4.473006438831105,0.0,0.0
16057,1,6057,[318 427 515 588  79],18,5,27098,4.473093430174975,40.0,0.0
16058,1,6058,[318 427 515 588  79],18,5,27103,4.473180392804093,40.0,0.0
16059,1,6059,[318 427 515 588  79],18,5,27108,4.473267326732674,40.0,0.0
16060,1,6060,[318 427 515 588  79],716,5,27113,4.4733542319749215,40.0,0.0
16061,1,6061,[318 427 515 588  79],807,5,27118,4.4734411085450345,40.0,0.0
16062,1,6062,[ 56 161 111  89 173],450,5,27123,4.4735279564571995,0.0,0.0
16063,1,6063,[318 427 515 588  79],18,5,27128,4.4736147757255935,40.0,0.0
16064,1,6064,[313 127 508 125 483],296,5,27133,4.473701566364386,0.0,20.0
16065,1,6065,[318 427 515 588  79],716,5,27138,4.473788328387735,40.0,0.0
16066,1,6066,[318 427 515 588  79],18,5,27143,4.473875061809791,40.0,0.0
16067,1,6067,[318 427 515 588  79],716,5,27148,4.473961766644694,40.0,0.0
16068,1,6068,[318 427 515 588  79],716,5,27153,4.474048442906574,40.0,0.0
16069,1,6069,[318 427 515 588  79],716,5,27158,4.474135090609555,40.0,0.0
16070,1,6070,[318 427 515 588  79],807,5,27163,4.474221709767749,40.0,0.0
16071,1,6071,[318 427 515 588  79],807,5,27168,4.474308300395257,40.0,0.0
16072,1,6072,[318 427 515 588  79],716,5,27173,4.474394862506175,40.0,0.0
16073,1,6073,[318 427 515 588  79],18,5,27178,4.474481396114586,40.0,0.0
16074,1,6074,[318 427 515 588  79],807,5,27183,4.474567901234568,40.0,0.0
16075,1,6075,[318 427 515 588  79],716,5,27188,4.474654377880184,40.0,0.0
16076,1,6076,[318 427 515 588  79],807,5,27193,4.474740826065493,40.0,0.0
16077,1,6077,[318 427 515 588  79],18,5,27198,4.474827245804541,40.0,0.0
16078,1,6078,[318 427 515 588  79],716,5,27203,4.474913637111367,40.0,0.0
16079,1,6079,[318 427 515 588  79],18,5,27208,4.475,40.0,0.0
16080,1,6080,[111 288  28 268  89],655,1,27209,4.474428547936195,0.0,0.0
16081,1,6081,[318 427 515 588  79],807,5,27214,4.474514962183492,40.0,0.0
16082,1,6082,[318 427 515 588  79],807,5,27219,4.474601348019069,40.0,0.0
16083,1,6083,[318 427 515 588  79],807,5,27224,4.474687705456936,40.0,0.0
16084,1,6084,[318 427 515 588  79],18,5,27229,4.474774034511093,40.0,0.0
16085,1,6085,[318 427 515 588  79],18,5,27234,4.4748603351955305,40.0,0.0
16086,1,6086,[181  15 172 435 302],269,0,27234,4.4741251848201085,0.0,0.0
16087,1,6087,[318 427 515 588  79],807,5,27239,4.474211563731932,40.0,0.0
16088,1,6088,[118 187 175 318 121],655,2,27241,4.473805222532436,20.0,0.0
16089,1,6089,[318 427 515 588  79],716,5,27246,4.473891625615764,40.0,0.0
16090,1,6090,[318 427 515 588  79],807,5,27251,4.473978000328353,40.0,0.0
16091,1,6091,[318 427 515 588  79],18,5,27256,4.474064346684176,40.0,0.0
16092,1,6092,[318 427 515 588  79],716,5,27261,4.474150664697193,40.0,0.0
16093,1,6093,[318 427 515 588  79],716,5,27266,4.474236954381359,40.0,0.0
16094,1,6094,[318 427 515 588  79],716,5,27271,4.474323215750616,40.0,0.0
16095,1,6095,[200 117 186 125   1],450,3,27274,4.474081364829396,0.0,0.0
16096,1,6096,[318 427 515 588  79],807,5,27279,4.474167623421355,40.0,0.0
16097,1,6097,[228 300 265 568 173],796,5,27284,4.474253853722532,0.0,0.0
16098,1,6098,[318 427 515 588  79],807,5,27289,4.474340055746843,40.0,0.0
16099,1,6099,[318 427 515 588  79],18,5,27294,4.474426229508197,40.0,0.0
16100,1,6100,[318 427 515 588  79],716,5,27299,4.474512375020488,40.0,0.0
16101,1,6101,[318 427 515 588  79],807,5,27304,4.474598492297607,40.0,0.0
16102,1,6102,[318 427 515 588  79],807,5,27309,4.474684581353433,40.0,0.0
16103,1,6103,[151 210 132 174 300],796,4,27313,4.4746068152031455,0.0,0.0
16104,1,6104,[318 427 515 588  79],807,5,27318,4.474692874692875,40.0,0.0
16105,1,6105,[318 427 515 588  79],18,5,27323,4.474778905994104,40.0,0.0
16106,1,6106,[318 427 515 588  79],18,5,27328,4.474864909120681,40.0,0.0
16107,1,6107,[318 427 515 588  79],807,5,27333,4.474950884086444,40.0,0.0
16108,1,6108,[318 427 515 588  79],716,5,27338,4.475036830905222,40.0,0.0
16109,1,6109,[318 427 515 588  79],18,5,27343,4.475122749590835,40.0,0.0
16110,1,6110,[471 135  71 127  79],280,4,27347,4.475045000818197,0.0,20.0
16111,1,6111,[318 427 515 588  79],807,5,27352,4.475130890052356,40.0,0.0
16112,1,6112,[318 427 515 588  79],18,5,27357,4.4752167511859975,40.0,0.0
16113,1,6113,[318 427 515 588  79],18,5,27362,4.475302584232908,40.0,0.0
16114,1,6114,[318 427 515 588  79],716,5,27367,4.475388389206868,40.0,0.0
16115,1,6115,[318 427 515 588  79],18,5,27372,4.475474166121648,40.0,0.0
16116,1,6116,[318 427 515 588  79],716,5,27377,4.475559914991009,40.0,0.0
16117,1,6117,[318 427 515 588  79],18,5,27382,4.475645635828702,40.0,0.0
16118,1,6118,[427  11 405 245 135],450,4,27386,4.475567903252165,20.0,0.0
16119,1,6119,[234 237 235   8 144],280,2,27388,4.4751633986928105,0.0,0.0
16120,1,6120,[318 427 515 588  79],716,5,27393,4.47524914229701,40.0,0.0
16121,1,6121,[318 427 515 588  79],807,5,27398,4.475334857889578,40.0,0.0
16122,1,6122,[318 427 515 588  79],18,5,27403,4.47542054548424,40.0,0.0
16123,1,6123,[181  89 215 228 496],344,3,27406,4.4751796211626385,20.0,0.0
16124,1,6124,[318 427 515 588  79],807,5,27411,4.4752653061224485,40.0,0.0
16125,1,6125,[318 427 515 588  79],716,5,27416,4.475350963108064,40.0,0.0
16126,1,6126,[318 427 515 588  79],18,5,27421,4.475436592133181,40.0,0.0
16127,1,6127,[118  88  50 288 238],450,3,27424,4.4751958224543085,0.0,20.0
16128,1,6128,[318 427 515 588  79],807,5,27429,4.475281448849731,40.0,0.0
16129,1,6129,[318 427 515 588  79],716,5,27434,4.475367047308319,40.0,0.0
16130,1,6130,[318 427 515 588  79],18,5,27439,4.475452617843745,40.0,0.0
16131,1,6131,[318 427 515 588  79],18,5,27444,4.475538160469667,40.0,0.0
16132,1,6132,[318 427 515 588  79],18,5,27449,4.475623675199739,40.0,0.0
16133,1,6133,[318 427 515 588  79],716,5,27454,4.475709162047604,40.0,0.0
16134,1,6134,[318 427 515 588  79],18,5,27459,4.475794621026895,40.0,0.0
16135,1,6135,[196   1 423 546 222],151,4,27463,4.4757170795306385,0.0,0.0
16136,1,6136,[318 427 515 588  79],716,5,27468,4.475802509369399,40.0,0.0
16137,1,6137,[318 427 515 588  79],716,5,27473,4.475887911371783,40.0,0.0
16138,1,6138,[318 427 515 588  79],807,5,27478,4.475973285551393,40.0,0.0
16139,1,6139,[318 427 515 588  79],18,5,27483,4.476058631921824,40.0,0.0
16140,1,6140,[318 427 515 588  79],716,5,27488,4.476143950496661,40.0,0.0
16141,1,6141,[289 228  88 603 211],655,1,27489,4.47557798762618,20.0,0.0
16142,1,6142,[318 427 515 588  79],18,5,27494,4.475663356666124,40.0,0.0
16143,1,6143,[318 427 515 588  79],716,5,27499,4.475748697916667,40.0,0.0
16144,1,6144,[318 427 515 588  79],18,5,27504,4.475834011391375,40.0,0.0
16145,1,6145,[318 427 515 588  79],807,5,27509,4.4759192971038075,40.0,0.0
16146,1,6146,[318 427 515 588  79],18,5,27514,4.4760045550675125,40.0,0.0
16147,1,6147,[318 427 515 588  79],716,5,27519,4.476089785296031,40.0,0.0
16148,1,6148,[318 427 515 588  79],18,5,27524,4.476174987802895,40.0,0.0
16149,1,6149,[318 427 515 588  79],716,5,27529,4.476260162601626,40.0,0.0
16150,1,6150,[318 427 515 588  79],716,5,27534,4.476345309705739,40.0,0.0
16151,1,6151,[318 427 515 588  79],18,5,27539,4.4764304291287385,40.0,0.0
16152,1,6152,[ 12 742  50 151 172],796,4,27543,4.4763529985372985,0.0,20.0
16153,1,6153,[125 144  28  97 195],655,0,27543,4.475625609359766,0.0,0.0
16154,1,6154,[318 427 515 588  79],807,5,27548,4.4757108042242075,40.0,0.0
16155,1,6155,[318 427 515 588  79],18,5,27553,4.475795971410006,40.0,0.0
16156,1,6156,[318 427 515 588  79],716,5,27558,4.475881110930648,40.0,0.0
16157,1,6157,[318 427 515 588  79],807,5,27563,4.47596622279961,40.0,0.0
16158,1,6158,[318 427 515 588  79],18,5,27568,4.476051307030362,40.0,0.0
16159,1,6159,[318 427 515 588  79],18,5,27573,4.476136363636364,40.0,0.0
16160,1,6160,[318 427 515 588  79],807,5,27578,4.476221392631066,40.0,0.0
16161,1,6161,[318 427 515 588  79],716,5,27583,4.476306394027913,40.0,0.0
16162,1,6162,[318 427 515 588  79],807,5,27588,4.476391367840337,40.0,0.0
16163,1,6163,[318 427 515 588  79],18,5,27593,4.476476314081765,40.0,0.0
16164,1,6164,[496 235 216  95 222],450,2,27595,4.476074614760746,20.0,0.0
16165,1,6165,[471   1   4 568  98],577,3,27598,4.475835225429776,0.0,0.0
16166,1,6166,[210 191   9 234  12],72,5,27603,4.47592022052862,0.0,0.0
16167,1,6167,[117 183 176 191 121],655,2,27605,4.475518806744487,0.0,0.0
16168,1,6168,[132  22 228 471 588],577,3,27608,4.475279623926082,0.0,0.0
16169,1,6169,[318 427 515 588  79],807,5,27613,4.475364667747164,40.0,0.0
16170,1,6170,[318 427 515 588  79],807,5,27618,4.4754496840058335,40.0,0.0
16171,1,6171,[318 427 515 588  79],807,5,27623,4.475534672715489,40.0,0.0
16172,1,6172,[318 427 515 588  79],18,5,27628,4.475619633889519,40.0,0.0
16173,1,6173,[318 427 515 588  79],807,5,27633,4.475704567541302,40.0,0.0
16174,1,6174,[318 427 515 588  79],807,5,27638,4.475789473684211,40.0,0.0
16175,1,6175,[318 427 515 588  79],18,5,27643,4.475874352331606,40.0,0.0
16176,1,6176,[318 427 515 588  79],807,5,27648,4.475959203496843,40.0,0.0
16177,1,6177,[318 427 515 588  79],18,5,27653,4.476044027193266,40.0,0.0
16178,1,6178,[318 427 515 588  79],716,5,27658,4.4761288234342125,40.0,0.0
16179,1,6179,[318 427 515 588  79],807,5,27663,4.47621359223301,40.0,0.0
16180,1,6180,[318 427 515 588  79],716,5,27668,4.476298333602977,40.0,0.0
16181,1,6181,[318 427 515 588  79],716,5,27673,4.476383047557425,40.0,0.0
16182,1,6182,[403 234   4 191 194],457,5,27678,4.476467734109655,0.0,0.0
16183,1,6183,[318 427 515 588  79],18,5,27683,4.4765523932729625,40.0,0.0
16184,1,6184,[  1 294 275  82 245],796,1,27684,4.475990299110752,0.0,20.0
16185,1,6185,[318 427 515 588  79],807,5,27689,4.476075008082767,40.0,0.0
16186,1,6186,[318 427 515 588  79],18,5,27694,4.476159689671893,40.0,0.0
16187,1,6187,[318 427 515 588  79],716,5,27699,4.476244343891403,40.0,0.0
16188,1,6188,[318 427 515 588  79],18,5,27704,4.476328970754564,40.0,0.0
16189,1,6189,[748  28 294 318 186],450,4,27708,4.476252019386107,20.0,0.0
16190,1,6190,[318 427 515 588  79],716,5,27713,4.476336617670812,40.0,0.0
16191,1,6191,[318 427 515 588  79],18,5,27718,4.476421188630491,40.0,0.0
16192,1,6192,[161 427  88  50  89],796,5,27723,4.476505732278379,20.0,20.0
16193,1,6193,[405 222  22 568 144],655,0,27723,4.475783015821763,0.0,0.0
16194,1,6194,[200 144   9 265 655],457,5,27728,4.475867635189669,0.0,0.0
16195,1,6195,[173 275 181 405 194],457,5,27733,4.475952227243383,0.0,20.0
16196,1,6196,[318 427 515 588  79],807,5,27738,4.476036791996127,40.0,0.0
16197,1,6197,[318 427 515 588  79],807,5,27743,4.476121329461116,40.0,0.0
16198,1,6198,[318 427 515 588  79],18,5,27748,4.4762058396515565,40.0,0.0
16199,1,6199,[318 427 515 588  79],807,5,27753,4.476290322580645,40.0,0.0
16200,1,6200,[318 427 515 588  79],807,5,27758,4.476374778261571,40.0,0.0
16201,1,6201,[318 427 515 588  79],807,5,27763,4.4764592067075135,40.0,0.0
16202,1,6202,[271 132 111 144 313],655,1,27764,4.475898758665162,0.0,0.0
16203,1,6203,[176 568 237 186 125],796,4,27768,4.475822050290136,0.0,0.0
16204,1,6204,[318 427 515 588  79],18,5,27773,4.475906526994359,40.0,0.0
16205,1,6205,[318 427 515 588  79],807,5,27778,4.47599097647438,40.0,0.0
16206,1,6206,[318 427 515 588  79],716,5,27783,4.476075398743355,40.0,0.0
16207,1,6207,[318 427 515 588  79],716,5,27788,4.476159793814433,40.0,0.0
16208,1,6208,[153 496 143  82  98],716,5,27793,4.476244161700757,20.0,0.0
16209,1,6209,[318 427 515 588  79],807,5,27798,4.476328502415459,40.0,0.0
16210,1,6210,[ 82 318 204 180 322],786,4,27802,4.476251811302528,20.0,0.0
16211,1,6211,[318 427 515 588  79],716,5,27807,4.476336123631681,40.0,0.0
16212,1,6212,[318 427 515 588  79],807,5,27812,4.476420408820216,40.0,0.0
16213,1,6213,[318 427 515 588  79],18,5,27817,4.476504666881236,40.0,0.0
16214,1,6214,[318 427 515 588  79],807,5,27822,4.476588897827836,40.0,0.0
16215,1,6215,[318 427 515 588  79],716,5,27827,4.476673101673102,40.0,0.0
16216,1,6216,[318 427 515 588  79],716,5,27832,4.476757278430111,40.0,0.0
16217,1,6217,[318 427 515 588  79],716,5,27837,4.476841428111933,40.0,0.0
16218,1,6218,[318 427 515 588  79],716,5,27842,4.476925550731629,40.0,0.0
16219,1,6219,[318 427 515 588  79],18,5,27847,4.477009646302251,40.0,0.0
16220,1,6220,[318 427 515 588  79],716,5,27852,4.477093714836843,40.0,0.0
16221,1,6221,[318 427 515 588  79],807,5,27857,4.477177756348441,40.0,0.0
16222,1,6222,[318 427 515 588  79],18,5,27862,4.477261770850072,40.0,0.0
16223,1,6223,[318 427 515 588  79],716,5,27867,4.477345758354756,40.0,0.0
16224,1,6224,[ 56 435 187 282 204],535,2,27869,4.476947791164658,0.0,0.0
16225,1,6225,[318 427 515 588  79],807,5,27874,4.477031802120141,40.0,0.0
16226,1,6226,[318 427 515 588  79],716,5,27879,4.4771157860928215,40.0,0.0
16227,1,6227,[318 427 515 588  79],807,5,27884,4.477199743095697,40.0,0.0
16228,1,6228,[318 427 515 588  79],18,5,27889,4.4772836731417565,40.0,0.0
16229,1,6229,[318 427 515 588  79],18,5,27894,4.477367576243981,40.0,0.0
16230,1,6230,[318 427 515 588  79],18,5,27899,4.477451452415343,40.0,0.0
16231,1,6231,[318 427 515 588  79],18,5,27904,4.477535301668806,40.0,0.0
16232,1,6232,[176 191  22  71 135],450,3,27907,4.477298251243382,0.0,0.0
16233,1,6233,[318 427 515 588  79],716,5,27912,4.477382098171319,40.0,0.0
16234,1,6234,[228 176  70 144 161],450,5,27917,4.477465918203689,0.0,0.0
16235,1,6235,[216 568 300 132 144],450,5,27922,4.477549711353432,0.0,0.0
16236,1,6236,[318 427 515 588  79],807,5,27927,4.477633477633478,40.0,0.0
16237,1,6237,[318 427 515 588  79],716,5,27932,4.477717217056749,40.0,0.0
16238,1,6238,[318 427 515 588  79],716,5,27937,4.477800929636159,40.0,0.0
16239,1,6239,[318 427 515 588  79],807,5,27942,4.477884615384616,40.0,0.0
16240,1,6240,[144 228  96  11 403],457,5,27947,4.477968274315014,0.0,0.0
16241,1,6241,[318 427 515 588  79],807,5,27952,4.4780519064402435,40.0,0.0
16242,1,6242,[172  12 191 258 403],693,2,27954,4.477654973570399,0.0,0.0
16243,1,6243,[318 427 515 588  79],18,5,27959,4.4777386290839205,40.0,0.0
16244,1,6244,[318 427 515 588  79],807,5,27964,4.477822257806245,40.0,0.0
16245,1,6245,[318 427 515 588  79],716,5,27969,4.477905859750241,40.0,0.0
16246,1,6246,[318 427 515 588  79],807,5,27974,4.477989434928766,40.0,0.0
16247,1,6247,[318 427 515 588  79],716,5,27979,4.478072983354673,40.0,0.0
16248,1,6248,[318 427 515 588  79],807,5,27984,4.478156505040807,40.0,0.0
16249,1,6249,[ 88  95 322 144   9],796,3,27987,4.47792,0.0,0.0
16250,1,6250,[318 427 515 588  79],18,5,27992,4.47800351943689,40.0,0.0
16251,1,6251,[294 313 403 187  98],450,5,27997,4.47808701215611,0.0,0.0
16252,1,6252,[ 28 195 276 546 194],457,4,28001,4.478010554933632,0.0,0.0
16253,1,6253,[318 427 515 588  79],18,5,28006,4.478094019827311,40.0,0.0
16254,1,6254,[318 427 515 588  79],807,5,28011,4.478177458033573,40.0,0.0
16255,1,6255,[117 265  89 173 132],457,5,28016,4.478260869565218,0.0,0.0
16256,1,6256,[127 222 405 423 195],716,4,28020,4.478184433434553,0.0,20.0
16257,1,6257,[318 427 515 588  79],716,5,28025,4.478267817193991,40.0,0.0
16258,1,6258,[144 265   8 271 333],796,5,28030,4.478351174308995,0.0,0.0
16259,1,6259,[318 427 515 588  79],807,5,28035,4.478434504792332,40.0,0.0
16260,1,6260,[318 427 515 588  79],18,5,28040,4.478517808656764,40.0,0.0
16261,1,6261,[318 427 515 588  79],18,5,28045,4.478601085915043,40.0,0.0
16262,1,6262,[176 143 405  97 546],786,5,28050,4.478684336579914,0.0,0.0
16263,1,6263,[318 427 515 588  79],18,5,28055,4.478767560664112,40.0,0.0
16264,1,6264,[ 64 435 275 179 187],389,5,28060,4.478850758180367,20.0,20.0
16265,1,6265,[318 427 515 588  79],807,5,28065,4.478933929141398,40.0,0.0
16266,1,6266,[318 427 515 588  79],716,5,28070,4.479017073559917,40.0,0.0
16267,1,6267,[318 427 515 588  79],716,5,28075,4.479100191448628,40.0,0.0
16268,1,6268,[318 427 515 588  79],18,5,28080,4.479183282820227,40.0,0.0
16269,1,6269,[318 427 515 588  79],807,5,28085,4.479266347687401,40.0,0.0
16270,1,6270,[318 427 515 588  79],18,5,28090,4.479349386062829,40.0,0.0
16271,1,6271,[318 427 515 588  79],18,5,28095,4.479432397959184,40.0,0.0
16272,1,6272,[237 483 195  11  69],269,1,28096,4.47887772995377,0.0,0.0
16273,1,6273,[318 427 515 588  79],807,5,28101,4.4789607905642335,40.0,0.0
16274,1,6274,[588  12 276 143 151],457,5,28106,4.479043824701195,0.0,0.0
16275,1,6275,[318 427 515 588  79],807,5,28111,4.47912683237731,40.0,0.0
16276,1,6276,[228 257 405  88 125],457,4,28115,4.479050501832085,0.0,0.0
16277,1,6277,[168 294 210 191 588],716,5,28120,4.479133482000637,0.0,0.0
16278,1,6278,[ 88 179 204  71 202],786,5,28125,4.4792164357381745,0.0,0.0
16279,1,6279,[318 427 515 588  79],18,5,28130,4.479299363057325,40.0,0.0
16280,1,6280,[ 98  96 237 125   8],796,5,28135,4.479382263970705,0.0,0.0
16281,1,6281,[318 427 515 588  79],18,5,28140,4.4794651384909265,40.0,0.0
16282,1,6282,[ 82 276 187  11 237],269,2,28142,4.479070507719243,0.0,0.0
16283,1,6283,[318 427 515 588  79],18,5,28147,4.479153405474221,40.0,0.0
16284,1,6284,[318 427 515 588  79],807,5,28152,4.479236276849642,40.0,0.0
16285,1,6285,[318 427 515 588  79],807,5,28157,4.479319121858097,40.0,0.0
16286,1,6286,[318 427 515 588  79],18,5,28162,4.479401940512168,40.0,0.0
16287,1,6287,[318 427 515 588  79],18,5,28167,4.479484732824427,40.0,0.0
16288,1,6288,[318 427 515 588  79],807,5,28172,4.479567498807442,40.0,0.0
16289,1,6289,[405 168 655 125 200],577,3,28175,4.479332273449921,0.0,0.0
16290,1,6290,[318 427 515 588  79],807,5,28180,4.4794150373549515,40.0,0.0
16291,1,6291,[318 427 515 588  79],18,5,28185,4.47949777495232,40.0,0.0
16292,1,6292,[183 100 515  69 228],655,2,28187,4.479103766089305,0.0,20.0
16293,1,6293,[496 100 357 161 191],786,5,28192,4.479186526850969,20.0,20.0
16294,1,6294,[318 427 515 588  79],716,5,28197,4.479269261318507,40.0,0.0
16295,1,6295,[318 427 515 588  79],807,5,28202,4.479351969504448,40.0,0.0
16296,1,6296,[318 427 515 588  79],716,5,28207,4.479434651421312,40.0,0.0
16297,1,6297,[318 427 515 588  79],18,5,28212,4.479517307081613,40.0,0.0
16298,1,6298,[318 427 515 588  79],18,5,28217,4.4795999364978565,40.0,0.0
16299,1,6299,[318 427 515 588  79],807,5,28222,4.47968253968254,40.0,0.0
16300,1,6300,[318 427 515 588  79],18,5,28227,4.479765116648151,40.0,0.0
16301,1,6301,[318 427 515 588  79],807,5,28232,4.4798476674071726,40.0,0.0
16302,1,6302,[508 144  11 111 161],280,3,28235,4.479612882754244,0.0,0.0
16303,1,6303,[187 196 288 144 403],655,1,28236,4.479060913705584,0.0,0.0
16304,1,6304,[318 427 515 588  79],716,5,28241,4.479143536875496,40.0,0.0
16305,1,6305,[143 186 288 200 168],457,5,28246,4.479226133840786,0.0,0.0
16306,1,6306,[ 71 742 180 318 196],796,3,28249,4.4789915966386555,20.0,0.0
16307,1,6307,[318 427 515 588  79],18,5,28254,4.479074191502853,40.0,0.0
16308,1,6308,[318 427 515 588  79],18,5,28259,4.479156760183864,40.0,0.0
16309,1,6309,[318 427 515 588  79],807,5,28264,4.479239302694136,40.0,0.0
16310,1,6310,[318 427 515 588  79],18,5,28269,4.47932181904611,40.0,0.0
16311,1,6311,[180 742  50 195 118],450,4,28273,4.479245880861851,0.0,20.0
16312,1,6312,[183 496 204 143 191],786,5,28278,4.479328370030097,20.0,0.0
16313,1,6313,[318 427 515 588  79],716,5,28283,4.47941083306937,40.0,0.0
16314,1,6314,[318 427 515 588  79],807,5,28288,4.479493269992083,40.0,0.0
16315,1,6315,[318 427 515 588  79],18,5,28293,4.4795756808106395,40.0,0.0
16316,1,6316,[ 12 258 403 135 222],693,3,28296,4.479341459553585,0.0,0.0
16317,1,6317,[318 427 515 588  79],716,5,28301,4.479423868312757,40.0,0.0
16318,1,6318,[318 427 515 588  79],807,5,28306,4.479506250989081,40.0,0.0
16319,1,6319,[318 427 515 588  79],18,5,28311,4.479588607594937,40.0,0.0
16320,1,6320,[333 222 289 265 471],655,0,28311,4.478879924062649,0.0,0.0
16321,1,6321,[318 427 515 588  79],716,5,28316,4.478962353685542,40.0,0.0
16322,1,6322,[318 427 515 588  79],716,5,28321,4.4790447572354894,40.0,0.0
16323,1,6323,[318 427 515 588  79],807,5,28326,4.479127134724858,40.0,0.0
16324,1,6324,[318 427 515 588  79],716,5,28331,4.479209486166008,40.0,0.0
16325,1,6325,[318 427 515 588  79],18,5,28336,4.479291811571293,40.0,0.0
16326,1,6326,[318 427 515 588  79],716,5,28341,4.479374110953058,40.0,0.0
16327,1,6327,[318 427 515 588  79],716,5,28346,4.479456384323641,40.0,0.0
16328,1,6328,[318 427 515 588  79],807,5,28351,4.4795386316953705,40.0,0.0
16329,1,6329,[318 427 515 588  79],807,5,28356,4.479620853080569,40.0,0.0
16330,1,6330,[318 427 515 588  79],716,5,28361,4.479703048491549,40.0,0.0
16331,1,6331,[318 427 515 588  79],18,5,28366,4.479785217940619,40.0,0.0
16332,1,6332,[318 427 515 588  79],716,5,28371,4.479867361440076,40.0,0.0
16333,1,6333,[318 427 515 588  79],807,5,28376,4.47994947900221,40.0,0.0
16334,1,6334,[318 427 515 588  79],18,5,28381,4.480031570639305,40.0,0.0
16335,1,6335,[318 427 515 588  79],716,5,28386,4.480113636363637,40.0,0.0
16336,1,6336,[318 427 515 588  79],18,5,28391,4.480195676187471,40.0,0.0
16337,1,6337,[127 197  89  97 328],796,3,28394,4.479962133165036,0.0,20.0
16338,1,6338,[318 427 515 588  79],716,5,28399,4.480044171004891,40.0,0.0
16339,1,6339,[318 427 515 588  79],18,5,28404,4.4801261829653,40.0,0.0
16340,1,6340,[318 427 515 588  79],18,5,28409,4.480208169058508,40.0,0.0
16341,1,6341,[181 121  15  95  50],20,2,28411,4.479817092399874,0.0,20.0
16342,1,6342,[318 427 515 588  79],807,5,28416,4.479899101371591,40.0,0.0
16343,1,6343,[318 427 515 588  79],18,5,28421,4.479981084489281,40.0,0.0
16344,1,6344,[ 22  69 222 176 204],716,4,28425,4.479905437352246,0.0,0.0
16345,1,6345,[318 427 515 588  79],18,5,28430,4.479987393633785,40.0,0.0
16346,1,6346,[269 286   8 300  64],655,1,28431,4.4794391050890185,20.0,20.0
16347,1,6347,[496  95 118 588 176],577,4,28435,4.479363579080025,20.0,0.0
16348,1,6348,[318 427 515 588  79],716,5,28440,4.479445581981414,40.0,0.0
16349,1,6349,[210 286 186   1 357],535,2,28442,4.479055118110236,0.0,20.0
16350,1,6350,[ 22 143 483 176  50],655,3,28445,4.478822232719256,0.0,20.0
16351,1,6351,[100 174 588 210  70],344,4,28449,4.478746851385391,0.0,20.0
16352,1,6352,[318 427 515 588  79],716,5,28454,4.4788288997324095,40.0,0.0
16353,1,6353,[318  69  25 385  64],716,4,28458,4.478753541076487,40.0,0.0
16354,1,6354,[318 427 515 588  79],716,5,28463,4.478835562549174,40.0,0.0
16355,1,6355,[318 427 515 588  79],18,5,28468,4.4789175582127125,40.0,0.0
16356,1,6356,[318 427 515 588  79],18,5,28473,4.4789995280792825,40.0,0.0
16357,1,6357,[318 427 515 588  79],716,5,28478,4.479081472161057,40.0,0.0
16358,1,6358,[318 427 515 588  79],807,5,28483,4.4791633904702,40.0,0.0
16359,1,6359,[ 25  11 125  89 132],457,5,28488,4.479245283018868,0.0,0.0
16360,1,6360,[318 427 515 588  79],716,5,28493,4.479327149819211,40.0,0.0
16361,1,6361,[194  97  25 496 215],535,5,28498,4.47940899088337,20.0,0.0
16362,1,6362,[318 427 515 588  79],716,5,28503,4.479490806223479,40.0,0.0
16363,1,6363,[271 273 215 483 268],655,2,28505,4.479101194217473,0.0,0.0
16364,1,6364,[318 427 515 588  79],716,5,28510,4.479183032207384,40.0,0.0
16365,1,6365,[318 427 515 588  79],716,5,28515,4.479264844486334,40.0,0.0
16366,1,6366,[318 427 515 588  79],716,5,28520,4.479346631066436,40.0,0.0
16367,1,6367,[318 427 515 588  79],716,5,28525,4.479428391959799,40.0,0.0
16368,1,6368,[318 427 515 588  79],807,5,28530,4.479510127178521,40.0,0.0
16369,1,6369,[318 427 515 588  79],18,5,28535,4.479591836734694,40.0,0.0
16370,1,6370,[318 427 515 588  79],716,5,28540,4.479673520640402,40.0,0.0
16371,1,6371,[318 427 515 588  79],807,5,28545,4.4797551789077215,40.0,0.0
16372,1,6372,[318 427 515 588  79],18,5,28550,4.479836811548721,40.0,0.0
16373,1,6373,[318 427 515 588  79],807,5,28555,4.479918418575463,40.0,0.0
16374,1,6374,[318 427 515 588  79],716,5,28560,4.48,40.0,0.0
16375,1,6375,[127 132 603 161 300],655,2,28562,4.47961104140527,20.0,20.0
16376,1,6376,[318 427 515 588  79],716,5,28567,4.479692645444566,40.0,0.0
16377,1,6377,[318 427 515 588  79],716,5,28572,4.479774223894638,40.0,0.0
16378,1,6378,[318 427 515 588  79],18,5,28577,4.4798557767675184,40.0,0.0
16379,1,6379,[318 427 515 588  79],18,5,28582,4.479937304075235,40.0,0.0
16380,1,6380,[211  56 176 234 289],693,1,28583,4.479391944836233,0.0,0.0
16381,1,6381,[ 70 483 100  12 197],707,3,28586,4.47916013788781,0.0,20.0
16382,1,6382,[191  69 742 228   4],796,4,28590,4.479085069716434,0.0,0.0
16383,1,6383,[191 333  22 286 135],224,2,28592,4.478696741854637,0.0,20.0
16384,1,6384,[471 288  69 185 588],457,5,28597,4.478778386844166,0.0,0.0
16385,1,6385,[318 427 515 588  79],807,5,28602,4.478860006263702,40.0,0.0
16386,1,6386,[318 427 515 588  79],18,5,28607,4.478941600125254,40.0,0.0
16387,1,6387,[173 302 100  88  69],450,5,28612,4.479023168440826,0.0,20.0
16388,1,6388,[318 427 515 588  79],807,5,28617,4.479104711222414,40.0,0.0
16389,1,6389,[318 427 515 588  79],807,5,28622,4.479186228482003,40.0,0.0
16390,1,6390,[318 427 515 588  79],807,5,28627,4.479267720231576,40.0,0.0
16391,1,6391,[318 427 515 588  79],716,5,28632,4.479349186483104,40.0,0.0
16392,1,6392,[322 483 144 385 357],401,3,28635,4.479117785077428,0.0,0.0
16393,1,6393,[111 323  79   9 471],280,3,28638,4.47888645605255,0.0,0.0
16394,1,6394,[318 427 515 588  79],807,5,28643,4.47896794370602,40.0,0.0
16395,1,6395,[318 427 515 588  79],716,5,28648,4.4790494058786745,40.0,0.0
16396,1,6396,[318 427 515 588  79],716,5,28653,4.47913084258246,40.0,0.0
16397,1,6397,[202 197 181 210 175],269,2,28655,4.478743357299156,0.0,0.0
16398,1,6398,[172 655 475 238 269],629,4,28659,4.4786685419596814,0.0,0.0
16399,1,6399,[288 135  89 655 195],457,5,28664,4.47875,0.0,0.0
16400,1,6400,[318 427 515 588  79],716,5,28669,4.478831432588658,40.0,0.0
16401,1,6401,[318 427 515 588  79],807,5,28674,4.478912839737582,40.0,0.0
16402,1,6402,[318 427 515 588  79],716,5,28679,4.4789942214586915,40.0,0.0
16403,1,6403,[318 427 515 588  79],807,5,28684,4.479075577763898,40.0,0.0
16404,1,6404,[318 427 515 588  79],807,5,28689,4.4791569086651055,40.0,0.0
16405,1,6405,[318 427 515 588  79],807,5,28694,4.479238214174211,40.0,0.0
16406,1,6406,[222 483  79 181   9],693,1,28695,4.4786951771499925,0.0,0.0
16407,1,6407,[318 427 515 588  79],716,5,28700,4.478776529338327,40.0,0.0
16408,1,6408,[318 427 515 588  79],18,5,28705,4.478857856139803,40.0,0.0
16409,1,6409,[168 483 210 302 175],151,4,28709,4.478783151326053,0.0,0.0
16410,1,6410,[318 427 515 588  79],18,5,28714,4.4788644517236005,40.0,0.0
16411,1,6411,[318 427 515 588  79],18,5,28719,4.478945726762321,40.0,0.0
16412,1,6412,[318 427 515 588  79],18,5,28724,4.479026976454078,40.0,0.0
16413,1,6413,[121 588 276 471 181],786,3,28727,4.478796382912379,0.0,0.0
16414,1,6414,[328 194 273 127  71],236,2,28729,4.478409976617304,0.0,20.0
16415,1,6415,[318 427 515 588  79],807,5,28734,4.478491271820449,40.0,0.0
16416,1,6416,[318 427 515 588  79],807,5,28739,4.478572541686146,40.0,0.0
16417,1,6417,[318 427 515 588  79],807,5,28744,4.478653786226238,40.0,0.0
16418,1,6418,[318 427 515 588  79],716,5,28749,4.478735005452562,40.0,0.0
16419,1,6419,[318 427 515 588  79],18,5,28754,4.478816199376947,40.0,0.0
16420,1,6420,[ 82 174 333 135 202],655,1,28755,4.478274412085345,0.0,0.0
16421,1,6421,[121 204  82 216 153],716,5,28760,4.478355652444721,0.0,0.0
16422,1,6422,[318 427 515 588  79],716,5,28765,4.478436867507395,40.0,0.0
16423,1,6423,[ 56 234 125 238  95],450,3,28768,4.478206724782067,0.0,0.0
16424,1,6424,[318 427 515 588  79],807,5,28773,4.478287937743191,40.0,0.0
16425,1,6425,[238 151 222 288 191],450,3,28776,4.478057889822596,0.0,0.0
16426,1,6426,[265 403 202 216  70],280,3,28779,4.477827913489964,0.0,0.0
16427,1,6427,[ 98 216 174 435 181],5,3,28782,4.477598008711886,0.0,0.0
16428,1,6428,[  1   4  50   7 172],256,4,28786,4.477523720640846,0.0,20.0
16429,1,6429,[318 427 515 588  79],807,5,28791,4.47760497667185,40.0,0.0
16430,1,6430,[318 427 515 588  79],18,5,28796,4.477686207432748,40.0,0.0
16431,1,6431,[318 427 515 588  79],716,5,28801,4.477767412935323,40.0,0.0
16432,1,6432,[318 427 515 588  79],807,5,28806,4.477848593191357,40.0,0.0
16433,1,6433,[318 427 515 588  79],716,5,28811,4.47792974821262,40.0,0.0
16434,1,6434,[318 427 515 588  79],716,5,28816,4.478010878010878,40.0,0.0
16435,1,6435,[318 427 515 588  79],716,5,28821,4.478091982597887,40.0,0.0
16436,1,6436,[318 427 515 588  79],716,5,28826,4.478173061985397,40.0,0.0
16437,1,6437,[318 427 515 588  79],807,5,28831,4.478254116185151,40.0,0.0
16438,1,6438,[318 427 515 588  79],807,5,28836,4.4783351452088835,40.0,0.0
16439,1,6439,[318 427 515 588  79],716,5,28841,4.478416149068323,40.0,0.0
16440,1,6440,[318 427 515 588  79],18,5,28846,4.47849712777519,40.0,0.0
16441,1,6441,[318 427 515 588  79],18,5,28851,4.478578081341198,40.0,0.0
16442,1,6442,[143 176 183 132 173],786,5,28856,4.478659009778053,0.0,0.0
16443,1,6443,[318 427 515 588  79],807,5,28861,4.478739913097455,40.0,0.0
16444,1,6444,[318 427 515 588  79],716,5,28866,4.478820791311094,40.0,0.0
16445,1,6445,[318 427 515 588  79],18,5,28871,4.478901644430655,40.0,0.0
16446,1,6446,[318 427 515 588  79],18,5,28876,4.4789824724678144,40.0,0.0
16447,1,6447,[318 427 515 588  79],716,5,28881,4.479063275434243,40.0,0.0
16448,1,6448,[318 427 515 588  79],18,5,28886,4.479144053341603,40.0,0.0
16449,1,6449,[318 427 515 588  79],18,5,28891,4.47922480620155,40.0,0.0
16450,1,6450,[135 216  71 588 197],450,3,28894,4.478995504572935,0.0,0.0
16451,1,6451,[318 427 515 588  79],18,5,28899,4.479076255424674,40.0,0.0
16452,1,6452,[238 276 496 357 508],269,5,28904,4.479156981249031,20.0,0.0
16453,1,6453,[  1 143 121 235 282],401,1,28905,4.478617911372792,0.0,0.0
16454,1,6454,[318 427 515 588  79],18,5,28910,4.4786986831913245,40.0,0.0
16455,1,6455,[318 427 515 588  79],716,5,28915,4.4787794299876085,40.0,0.0
16456,1,6456,[195  97 655 269 182],450,5,28920,4.47886015177327,0.0,0.0
16457,1,6457,[318 427 515 588  79],807,5,28925,4.478940848559926,40.0,0.0
16458,1,6458,[318 427 515 588  79],807,5,28930,4.479021520359189,40.0,0.0
16459,1,6459,[318 427 515 588  79],807,5,28935,4.4791021671826625,40.0,0.0
16460,1,6460,[318 427 515 588  79],18,5,28940,4.479182789041944,40.0,0.0
16461,1,6461,[318 427 515 588  79],716,5,28945,4.479263385948623,40.0,0.0
16462,1,6462,[135 357 245 182 268],629,4,28949,4.479189231007272,0.0,0.0
16463,1,6463,[318 427 515 588  79],18,5,28954,4.479269801980198,40.0,0.0
16464,1,6464,[234 301  64 196  79],796,3,28957,4.4790409899458625,20.0,0.0
16465,1,6465,[318 427 515 588  79],807,5,28962,4.4791215589236,40.0,0.0
16466,1,6466,[471 603 172 186 385],716,2,28964,4.478738209370651,20.0,0.0
16467,1,6467,[318 427 515 588  79],18,5,28969,4.478818800247372,40.0,0.0
16468,1,6468,[ 98 483  95 185  88],389,3,28972,4.478590199412583,0.0,0.0
16469,1,6469,[597 111 288 313 475],463,1,28973,4.47805255023184,0.0,0.0
16470,1,6470,[318 427 515 588  79],18,5,28978,4.478133209704837,40.0,0.0
16471,1,6471,[318 427 515 588  79],716,5,28983,4.4782138442521635,40.0,0.0
16472,1,6472,[318 427 515 588  79],716,5,28988,4.47829445388537,40.0,0.0
16473,1,6473,[318 427 515 588  79],807,5,28993,4.478375038616003,40.0,0.0
16474,1,6474,[318 427 515 588  79],807,5,28998,4.478455598455598,40.0,0.0
16475,1,6475,[318 427 515 588  79],807,5,29003,4.478536133415688,40.0,0.0
16476,1,6476,[318 427 515 588  79],18,5,29008,4.478616643507797,40.0,0.0
16477,1,6477,[318 427 515 588  79],716,5,29013,4.478697128743439,40.0,0.0
16478,1,6478,[318 427 515 588  79],807,5,29018,4.4787775891341255,40.0,0.0
16479,1,6479,[318 427 515 588  79],807,5,29023,4.478858024691358,40.0,0.0
16480,1,6480,[ 82 176 194  79  25],716,4,29027,4.47878413825027,0.0,0.0
16481,1,6481,[318 427 515 588  79],807,5,29032,4.478864547979019,40.0,0.0
16482,1,6482,[318 427 515 588  79],716,5,29037,4.478944932901435,40.0,0.0
16483,1,6483,[318 427 515 588  79],18,5,29042,4.479025293028995,40.0,0.0
16484,1,6484,[318 427 515 588  79],716,5,29047,4.479105628373169,40.0,0.0
16485,1,6485,[318 427 515 588  79],716,5,29052,4.479185938945421,40.0,0.0
16486,1,6486,[318 427 515 588  79],807,5,29057,4.479266224757207,40.0,0.0
16487,1,6487,[318 427 515 588  79],18,5,29062,4.479346485819975,40.0,0.0
16488,1,6488,[151 222 118 302 258],344,3,29065,4.479118508244722,0.0,0.0
16489,1,6489,[318 427 515 588  79],807,5,29070,4.479198767334361,40.0,0.0
16490,1,6490,[318 427 515 588  79],807,5,29075,4.479279001694654,40.0,0.0
16491,1,6491,[318 427 515 588  79],807,5,29080,4.47935921133703,40.0,0.0
16492,1,6492,[318  15 118 175  69],457,5,29085,4.479439396272909,20.0,0.0
16493,1,6493,[318 427 515 588  79],18,5,29090,4.479519556513705,40.0,0.0
16494,1,6494,[318 427 515 588  79],807,5,29095,4.479599692070824,40.0,0.0
16495,1,6495,[318 427 515 588  79],807,5,29100,4.479679802955665,40.0,0.0
16496,1,6496,[182 211 302 742 328],450,5,29105,4.479759889179621,0.0,0.0
16497,1,6497,[318 427 515 588  79],18,5,29110,4.479839950754078,40.0,0.0
16498,1,6498,[318 427 515 588  79],18,5,29115,4.479919987690414,40.0,0.0
16499,1,6499,[153   7 238 100 182],535,4,29119,4.479846153846154,0.0,20.0
16500,1,6500,[318 427 515 588  79],18,5,29124,4.479926165205353,40.0,0.0
16501,1,6501,[318 427 515 588  79],18,5,29129,4.480006151953245,40.0,0.0
16502,1,6502,[318 427 515 588  79],807,5,29134,4.480086114101184,40.0,0.0
16503,1,6503,[318 427 515 588  79],716,5,29139,4.480166051660516,40.0,0.0
16504,1,6504,[318 427 515 588  79],18,5,29144,4.480245964642583,40.0,0.0
16505,1,6505,[318 427 515 588  79],18,5,29149,4.480325853058715,40.0,0.0
16506,1,6506,[318 427 515 588  79],716,5,29154,4.48040571692024,40.0,0.0
16507,1,6507,[318 427 515 588  79],716,5,29159,4.4804855562384756,40.0,0.0
16508,1,6508,[318 427 515 588  79],716,5,29164,4.480565371024735,40.0,0.0
16509,1,6509,[185  82 427 202 294],796,3,29167,4.480337941628264,20.0,0.0
16510,1,6510,[318 427 515 588  79],807,5,29172,4.48041775456919,40.0,0.0
16511,1,6511,[318 427 515 588  79],716,5,29177,4.480497542997543,40.0,0.0
16512,1,6512,[588   7 655 194  64],450,5,29182,4.480577306924612,20.0,0.0
16513,1,6513,[318 427 515 588  79],716,5,29187,4.480657046361682,40.0,0.0
16514,1,6514,[318 427 515 588  79],716,5,29192,4.48073676132003,40.0,0.0
16515,1,6515,[  8 204 179 185 196],457,5,29197,4.480816451810927,0.0,0.0
16516,1,6516,[257 234 161 496 568],389,2,29199,4.48043578333589,20.0,0.0
16517,1,6517,[ 25  98 161 197 210],457,5,29204,4.480515495550782,0.0,0.0
16518,1,6518,[318 427 515 588  79],807,5,29209,4.4805951833103235,40.0,0.0
16519,1,6519,[318 427 515 588  79],807,5,29214,4.480674846625766,40.0,0.0
16520,1,6520,[318 427 515 588  79],18,5,29219,4.480754485508357,40.0,0.0
16521,1,6521,[318 427 515 588  79],18,5,29224,4.480834099969335,40.0,0.0
16522,1,6522,[318 427 515 588  79],807,5,29229,4.480913690019929,40.0,0.0
16523,1,6523,[ 11 215 132  82 235],716,4,29233,4.480839975475169,0.0,0.0
16524,1,6524,[318 427 515 588  79],18,5,29238,4.480919540229885,40.0,0.0
16525,1,6525,[357 234 151 515 275],18,3,29241,4.48069261415875,0.0,20.0
16526,1,6526,[318 427 515 588  79],716,5,29246,4.480772177110464,40.0,0.0
16527,1,6527,[318 427 515 588  79],716,5,29251,4.480851715686274,40.0,0.0
16528,1,6528,[318 427 515 588  79],807,5,29256,4.480931229897381,40.0,0.0
16529,1,6529,[318 427 515 588  79],716,5,29261,4.481010719754977,40.0,0.0
16530,1,6530,[318 427 515 588  79],807,5,29266,4.48109018527025,40.0,0.0
16531,1,6531,[603 202 403 181 187],450,5,29271,4.4811696264543786,20.0,0.0
16532,1,6532,[318 427 515 588  79],716,5,29276,4.481249043318536,40.0,0.0
16533,1,6533,[282 187  71 234 197],450,3,29279,4.481022344658708,0.0,0.0
16534,1,6534,[318 427 515 588  79],716,5,29284,4.481101759755164,40.0,0.0
16535,1,6535,[318 427 515 588  79],716,5,29289,4.481181150550795,40.0,0.0
16536,1,6536,[228 182  97  64 215],655,2,29291,4.480801590943858,20.0,0.0
16537,1,6537,[318 427 515 588  79],18,5,29296,4.480881003364943,40.0,0.0
16538,1,6538,[318 427 515 588  79],18,5,29301,4.480960391497171,40.0,0.0
16539,1,6539,[318 427 515 588  79],716,5,29306,4.481039755351682,40.0,0.0
16540,1,6540,[318 427 515 588  79],716,5,29311,4.481119094939611,40.0,0.0
16541,1,6541,[318 427 515 588  79],18,5,29316,4.481198410272088,40.0,0.0
16542,1,6542,[  8 328  12 204  97],796,4,29320,4.481124866269296,0.0,0.0
16543,1,6543,[318 427 515 588  79],716,5,29325,4.481204156479218,40.0,0.0
16544,1,6544,[153  95 181  50 197],18,4,29329,4.4811306340718104,0.0,20.0
16545,1,6545,[318 427 515 588  79],18,5,29334,4.481209899175068,40.0,0.0
16546,1,6546,[318 427 515 588  79],18,5,29339,4.481289140064152,40.0,0.0
16547,1,6547,[318 427 515 588  79],807,5,29344,4.481368356750153,40.0,0.0
16548,1,6548,[301  56 318   1  82],450,4,29348,4.48129485417621,20.0,0.0
16549,1,6549,[228 322 603 275 748],151,3,29351,4.481068702290076,20.0,20.0
16550,1,6550,[318 427 515 588  79],807,5,29356,4.481147916348649,40.0,0.0
16551,1,6551,[125  82 471  22 568],577,3,29359,4.4809218559218555,0.0,0.0
16552,1,6552,[318 427 515 588  79],18,5,29364,4.481001068213033,40.0,0.0
16553,1,6553,[117 322 748 568 210],280,2,29366,4.480622520598108,0.0,0.0
16554,1,6554,[318 427 515 588  79],807,5,29371,4.480701754385965,40.0,0.0
16555,1,6555,[318 427 515 588  79],716,5,29376,4.480780964002441,40.0,0.0
16556,1,6556,[318 427 515 588  79],18,5,29381,4.480860149458594,40.0,0.0
16557,1,6557,[318 427 515 588  79],716,5,29386,4.480939310765478,40.0,0.0
16558,1,6558,[302 258 245   8   1],344,2,29388,4.480561061137369,0.0,0.0
16559,1,6559,[318 427 515 588  79],18,5,29393,4.480640243902439,40.0,0.0
16560,1,6560,[318 427 515 588  79],18,5,29398,4.480719402530102,40.0,0.0
16561,1,6561,[318 427 515 588  79],716,5,29403,4.480798537031393,40.0,0.0
16562,1,6562,[318 427 515 588  79],807,5,29408,4.48087764741734,40.0,0.0
16563,1,6563,[471 257 742  64 238],655,1,29409,4.480347349177331,20.0,0.0
16564,1,6564,[318 427 515 588  79],716,5,29414,4.48042650418888,40.0,0.0
16565,1,6565,[318 427 515 588  79],18,5,29419,4.480505635089857,40.0,0.0
16566,1,6566,[318 427 515 588  79],18,5,29424,4.480584741891275,40.0,0.0
16567,1,6567,[318 427 515 588  79],807,5,29429,4.480663824604141,40.0,0.0
16568,1,6568,[318 427 515 588  79],807,5,29434,4.480742883239458,40.0,0.0
16569,1,6569,[257 153 216 127 228],716,5,29439,4.480821917808219,0.0,20.0
16570,1,6570,[318 427 515 588  79],18,5,29444,4.480900928321412,40.0,0.0
16571,1,6571,[318 427 515 588  79],807,5,29449,4.4809799147900184,40.0,0.0
16572,1,6572,[318 427 515 588  79],716,5,29454,4.481058877225012,40.0,0.0
16573,1,6573,[318 427 515 588  79],716,5,29459,4.481137815637359,40.0,0.0
16574,1,6574,[195 271 216 172 423],655,2,29461,4.480760456273765,0.0,0.0
16575,1,6575,[318 427 515 588  79],716,5,29466,4.480839416058394,40.0,0.0
16576,1,6576,[318 427 515 588  79],716,5,29471,4.480918351832142,40.0,0.0
16577,1,6577,[318 427 515 588  79],716,5,29476,4.48099726360596,40.0,0.0
16578,1,6578,[318 427 515 588  79],807,5,29481,4.481076151390789,40.0,0.0
16579,1,6579,[318 427 515 588  79],716,5,29486,4.481155015197569,40.0,0.0
16580,1,6580,[318 427 515 588  79],18,5,29491,4.481233855037228,40.0,0.0
16581,1,6581,[603 313 125 328 568],655,2,29493,4.480856882406563,20.0,0.0
16582,1,6582,[318 427 515 588  79],716,5,29498,4.480935743581954,40.0,0.0
16583,1,6583,[318 427 515 588  79],807,5,29503,4.481014580801944,40.0,0.0
16584,1,6584,[318 427 515 588  79],18,5,29508,4.481093394077448,40.0,0.0
16585,1,6585,[318 427 515 588  79],807,5,29513,4.481172183419375,40.0,0.0
16586,1,6586,[318 427 515 588  79],716,5,29518,4.481250948838621,40.0,0.0
16587,1,6587,[318 427 515 588  79],18,5,29523,4.481329690346084,40.0,0.0
16588,1,6588,[318 427 515 588  79],807,5,29528,4.481408407952649,40.0,0.0
16589,1,6589,[318 427 515 588  79],716,5,29533,4.481487101669196,40.0,0.0
16590,1,6590,[318 427 515 588  79],716,5,29538,4.4815657715066,40.0,0.0
16591,1,6591,[318 427 515 588  79],18,5,29543,4.481644417475728,40.0,0.0
16592,1,6592,[318 427 515 588  79],18,5,29548,4.4817230395874414,40.0,0.0
16593,1,6593,[318 427 515 588  79],716,5,29553,4.481801637852593,40.0,0.0
16594,1,6594,[318 427 515 588  79],18,5,29558,4.481880212282032,40.0,0.0
16595,1,6595,[318 427 515 588  79],18,5,29563,4.481958762886598,40.0,0.0
16596,1,6596,[318 427 515 588  79],716,5,29568,4.482037289677126,40.0,0.0
16597,1,6597,[318 427 515 588  79],716,5,29573,4.482115792664444,40.0,0.0
16598,1,6598,[  8 427  56 302 508],535,3,29576,4.481891195635702,20.0,0.0
16599,1,6599,[318 427 515 588  79],716,5,29581,4.481969696969697,40.0,0.0
16600,1,6600,[318 427 515 588  79],807,5,29586,4.482048174519012,40.0,0.0
16601,1,6601,[  4 215 187 294 202],655,1,29587,4.481520751287489,0.0,0.0
16602,1,6602,[318 427 515 588  79],18,5,29592,4.481599273057701,40.0,0.0
16603,1,6603,[318 427 515 588  79],807,5,29597,4.48167777104785,40.0,0.0
16604,1,6604,[ 89 655 176 195 196],786,5,29602,4.481756245268736,0.0,0.0
16605,1,6605,[318 427 515 588  79],807,5,29607,4.481834695731154,40.0,0.0
16606,1,6606,[132 204 168  50 180],457,5,29612,4.48191312244589,0.0,20.0
16607,1,6607,[318 427 515 588  79],18,5,29617,4.481991525423729,40.0,0.0
16608,1,6608,[318 427 515 588  79],18,5,29622,4.482069904675442,40.0,0.0
16609,1,6609,[ 50 127 435  82 318],807,3,29625,4.481845688350983,20.0,40.0
16610,1,6610,[318 427 515 588  79],716,5,29630,4.481924065950688,40.0,0.0
16611,1,6611,[318 427 515 588  79],18,5,29635,4.48200241984271,40.0,0.0
16612,1,6612,[318 427 515 588  79],716,5,29640,4.482080750037804,40.0,0.0
16613,1,6613,[318 427 515 588  79],716,5,29645,4.482159056546719,40.0,0.0
16614,1,6614,[318 427 515 588  79],807,5,29650,4.482237339380196,40.0,0.0
16615,1,6615,[318 427 515 588  79],807,5,29655,4.482315598548972,40.0,0.0
16616,1,6616,[ 71 100 678 286 435],401,2,29657,4.4819404564001815,0.0,40.0
16617,1,6617,[210 228 196 127 191],72,4,29661,4.481867633726202,0.0,20.0
16618,1,6618,[179 125 216 100 132],655,2,29663,4.481492672609155,0.0,20.0
16619,1,6619,[318 427 515 588  79],18,5,29668,4.481570996978852,40.0,0.0
16620,1,6620,[318 427 515 588  79],716,5,29673,4.481649297689171,40.0,0.0
16621,1,6621,[318 427 515 588  79],716,5,29678,4.48172757475083,40.0,0.0
16622,1,6622,[318 427 515 588  79],18,5,29683,4.481805828174544,40.0,0.0
16623,1,6623,[318 427 515 588  79],807,5,29688,4.481884057971015,40.0,0.0
16624,1,6624,[318 427 515 588  79],807,5,29693,4.481962264150943,40.0,0.0
16625,1,6625,[318 427 515 588  79],716,5,29698,4.482040446725023,40.0,0.0
16626,1,6626,[318 427 515 588  79],716,5,29703,4.482118605703938,40.0,0.0
16627,1,6627,[ 82 151 204 172 183],716,4,29707,4.482045866022933,0.0,0.0
16628,1,6628,[318 427 515 588  79],807,5,29712,4.4821240006034095,40.0,0.0
16629,1,6629,[318 427 515 588  79],807,5,29717,4.482202111613876,40.0,0.0
16630,1,6630,[228 153 216 180 210],280,3,29720,4.481978585432062,0.0,0.0
16631,1,6631,[173 300  98  95  88],450,4,29724,4.481905910735827,0.0,0.0
16632,1,6632,[318 427 515 588  79],716,5,29729,4.481984019297452,40.0,0.0
16633,1,6633,[318 427 515 588  79],807,5,29734,4.482062104311124,40.0,0.0
16634,1,6634,[318 427 515 588  79],807,5,29739,4.482140165787491,40.0,0.0
16635,1,6635,[318 427 515 588  79],807,5,29744,4.482218203737191,40.0,0.0
16636,1,6636,[237 174 294 385 179],450,5,29749,4.482296218170861,0.0,0.0
16637,1,6637,[318 427 515 588  79],18,5,29754,4.4823742090991265,40.0,0.0
16638,1,6638,[174 180 151 300  71],504,5,29759,4.48245217653261,0.0,0.0
16639,1,6639,[318 427 515 588  79],716,5,29764,4.482530120481928,40.0,0.0
16640,1,6640,[318 427 515 588  79],716,5,29769,4.482608040957687,40.0,0.0
16641,1,6641,[318 427 515 588  79],716,5,29774,4.482685937970491,40.0,0.0
16642,1,6642,[234 597 196  97 273],450,3,29777,4.482462742736716,0.0,0.0
16643,1,6643,[318 427 515 588  79],807,5,29782,4.482540638169778,40.0,0.0
16644,1,6644,[318 427 515 588  79],807,5,29787,4.482618510158013,40.0,0.0
16645,1,6645,[318 427 515 588  79],807,5,29792,4.4826963587120074,40.0,0.0
16646,1,6646,[234 144  88 118 173],450,3,29795,4.48247329622386,0.0,0.0
16647,1,6647,[318 427 515 588  79],807,5,29800,4.482551143200963,40.0,0.0
16648,1,6648,[318 427 515 588  79],18,5,29805,4.4826289667619195,40.0,0.0
16649,1,6649,[300 546  11  89 237],450,5,29810,4.4827067669172935,0.0,0.0
16650,1,6650,[318 427 515 588  79],18,5,29815,4.482784543677642,40.0,0.0
16651,1,6651,[176 235 228  95 655],716,3,29818,4.482561635598317,0.0,0.0
16652,1,6652,[318 427 515 588  79],807,5,29823,4.482639410792124,40.0,0.0
16653,1,6653,[322 191 125 135  15],224,2,29825,4.482266305981365,0.0,0.0
16654,1,6654,[318 427 515 588  79],18,5,29830,4.482344102178813,40.0,0.0
16655,1,6655,[318 427 515 588  79],716,5,29835,4.482421875,40.0,0.0
16656,1,6656,[318 427 515 588  79],716,5,29840,4.4824996244554605,40.0,0.0
16657,1,6657,[318 427 515 588  79],716,5,29845,4.482577350555722,40.0,0.0
16658,1,6658,[111  89 174 288 301],655,1,29846,4.4820543625168945,0.0,0.0
16659,1,6659,[318 427 515 588  79],716,5,29851,4.482132132132132,40.0,0.0
16660,1,6660,[318 427 515 588  79],807,5,29856,4.482209878396637,40.0,0.0
16661,1,6661,[322 173 546 222 196],786,4,29860,4.482137496247373,0.0,0.0
16662,1,6662,[318 427 515 588  79],807,5,29865,4.482215218370103,40.0,0.0
16663,1,6663,[318 427 515 588  79],716,5,29870,4.482292917166867,40.0,0.0
16664,1,6664,[318 427 515 588  79],807,5,29875,4.482370592648162,40.0,0.0
16665,1,6665,[318 427 515 588  79],716,5,29880,4.482448244824482,40.0,0.0
16666,1,6666,[302 144  50 211 191],450,5,29885,4.482525873706314,0.0,20.0
16667,1,6667,[318 427 515 588  79],807,5,29890,4.48260347930414,40.0,0.0
16668,1,6668,[318 427 515 588  79],18,5,29895,4.48268106162843,40.0,0.0
16669,1,6669,[318 427 515 588  79],716,5,29900,4.482758620689655,40.0,0.0
16670,1,6670,[318 427 515 588  79],807,5,29905,4.482836156498276,40.0,0.0
16671,1,6671,[318 427 515 588  79],716,5,29910,4.482913669064748,40.0,0.0
16672,1,6672,[318 427 515 588  79],716,5,29915,4.48299115839952,40.0,0.0
16673,1,6673,[318 427 515 588  79],716,5,29920,4.483068624513035,40.0,0.0
16674,1,6674,[318 427 515 588  79],716,5,29925,4.48314606741573,40.0,0.0
16675,1,6675,[318 427 515 588  79],807,5,29930,4.4832234871180345,40.0,0.0
16676,1,6676,[318 427 515 588  79],807,5,29935,4.483300883630373,40.0,0.0
16677,1,6677,[318 427 515 588  79],807,5,29940,4.483378256963163,40.0,0.0
16678,1,6678,[174 143 196 245 181],885,2,29942,4.483006438089534,0.0,0.0
16679,1,6679,[318 427 515 588  79],716,5,29947,4.483083832335329,40.0,0.0
16680,1,6680,[318 427 515 588  79],807,5,29952,4.483161203412663,40.0,0.0
16681,1,6681,[318 427 515 588  79],18,5,29957,4.483238551331937,40.0,0.0
16682,1,6682,[318 427 515 588  79],716,5,29962,4.483315876103546,40.0,0.0
16683,1,6683,[318 427 515 588  79],716,5,29967,4.483393177737882,40.0,0.0
16684,1,6684,[318 427 515 588  79],18,5,29972,4.483470456245326,40.0,0.0
16685,1,6685,[318 427 515 588  79],807,5,29977,4.4835477116362545,40.0,0.0
16686,1,6686,[318 427 515 588  79],807,5,29982,4.483624943921041,40.0,0.0
16687,1,6687,[318 427 515 588  79],18,5,29987,4.483702153110048,40.0,0.0
16688,1,6688,[ 96 748 196 172 111],796,5,29992,4.483779339213634,0.0,0.0
16689,1,6689,[132 111 127   7 210],655,1,29993,4.483258594917788,0.0,20.0
16690,1,6690,[318 427 515 588  79],807,5,29998,4.483335824241519,40.0,0.0
16691,1,6691,[318 427 515 588  79],807,5,30003,4.483413030484161,40.0,0.0
16692,1,6692,[191  64 265 258   4],629,3,30006,4.4831913939937245,20.0,0.0
16693,1,6693,[318 427 515 588  79],18,5,30011,4.483268598745145,40.0,0.0
16694,1,6694,[318 427 515 588  79],18,5,30016,4.483345780433159,40.0,0.0
16695,1,6695,[318 427 515 588  79],807,5,30021,4.483422939068101,40.0,0.0
16696,1,6696,[318 427 515 588  79],18,5,30026,4.483500074660296,40.0,0.0
16697,1,6697,[318 427 515 588  79],807,5,30031,4.483577187220066,40.0,0.0
16698,1,6698,[318 427 515 588  79],18,5,30036,4.483654276757725,40.0,0.0
16699,1,6699,[318 427 515 588  79],807,5,30041,4.483731343283582,40.0,0.0
16700,1,6700,[318 427 515 588  79],807,5,30046,4.483808386807939,40.0,0.0
16701,1,6701,[318 427 515 588  79],716,5,30051,4.483885407341092,40.0,0.0
16702,1,6702,[ 28  79 294 357  82],796,2,30053,4.483514844099657,0.0,0.0
16703,1,6703,[588 322 183 197 357],786,3,30056,4.483293556085919,0.0,0.0
16704,1,6704,[318 427 515 588  79],18,5,30061,4.4833706189410885,40.0,0.0
16705,1,6705,[318 427 515 588  79],18,5,30066,4.483447658813003,40.0,0.0
16706,1,6706,[318 427 515 588  79],807,5,30071,4.4835246757119425,40.0,0.0
16707,1,6707,[318 427 515 588  79],716,5,30076,4.4836016696481815,40.0,0.0
16708,1,6708,[318 427 515 588  79],807,5,30081,4.483678640631987,40.0,0.0
16709,1,6709,[318 427 515 588  79],807,5,30086,4.483755588673621,40.0,0.0
16710,1,6710,[318 427 515 588  79],807,5,30091,4.483832513783341,40.0,0.0
16711,1,6711,[318 427 515 588  79],716,5,30096,4.483909415971395,40.0,0.0
16712,1,6712,[318 427 515 588  79],807,5,30101,4.483986295248026,40.0,0.0
16713,1,6713,[111 245 588  71 742],344,2,30103,4.4836163240988975,0.0,0.0
16714,1,6714,[222 191 132 588 288],457,5,30108,4.483693224125093,0.0,0.0
16715,1,6715,[ 11 151  98 187 318],716,4,30112,4.483621203097082,20.0,0.0
16716,1,6716,[742 322  11 237 197],280,3,30115,4.483400327527169,0.0,0.0
16717,1,6717,[318 427 515 588  79],18,5,30120,4.483477225364692,40.0,0.0
16718,1,6718,[318 427 515 588  79],18,5,30125,4.4835541003125465,40.0,0.0
16719,1,6719,[318 427 515 588  79],716,5,30130,4.4836309523809526,40.0,0.0
16720,1,6720,[181  95  70  69  22],716,5,30135,4.483707781580122,0.0,0.0
16721,1,6721,[318 427 515 588  79],18,5,30140,4.483784587920262,40.0,0.0
16722,1,6722,[318 427 515 588  79],18,5,30145,4.483861371411572,40.0,0.0
16723,1,6723,[742 194  69 294 121],450,4,30149,4.483789411064842,0.0,0.0
16724,1,6724,[200 183  97  98  11],655,3,30152,4.483568773234201,0.0,0.0
16725,1,6725,[318 427 515 588  79],807,5,30157,4.483645554564377,40.0,0.0
16726,1,6726,[318 427 515 588  79],18,5,30162,4.483722313066746,40.0,0.0
16727,1,6727,[318 427 515 588  79],18,5,30167,4.483799048751487,40.0,0.0
16728,1,6728,[318 427 515 588  79],807,5,30172,4.483875761628771,40.0,0.0
16729,1,6729,[ 64 286 328 125 275],655,2,30174,4.483506686478455,20.0,40.0
16730,1,6730,[318 427 515 588  79],807,5,30179,4.483583419997029,40.0,0.0
16731,1,6731,[185 121  89  88 234],269,1,30180,4.483065953654189,0.0,0.0
16732,1,6732,[181   8 135 427 174],807,5,30185,4.483142729838111,20.0,0.0
16733,1,6733,[318 427 515 588  79],716,5,30190,4.483219483219483,40.0,0.0
16734,1,6734,[318 427 515 588  79],807,5,30195,4.4832962138084635,40.0,0.0
16735,1,6735,[318 427 515 588  79],18,5,30200,4.483372921615202,40.0,0.0
16736,1,6736,[222 118 135 568   7],693,3,30203,4.483152738607689,0.0,0.0
16737,1,6737,[161 228 237 405 222],72,1,30204,4.482635796972396,0.0,0.0
16738,1,6738,[318 427 515 588  79],18,5,30209,4.482712568630361,40.0,0.0
16739,1,6739,[318 427 515 588  79],807,5,30214,4.482789317507418,40.0,0.0
16740,1,6740,[318 427 515 588  79],807,5,30219,4.482866043613707,40.0,0.0
16741,1,6741,[318 427 515 588  79],716,5,30224,4.48294274695936,40.0,0.0
16742,1,6742,[197  89 211 237   9],655,1,30225,4.482426219783479,0.0,0.0
16743,1,6743,[318 427 515 588  79],716,5,30230,4.482502965599051,40.0,0.0
16744,1,6744,[318 427 515 588  79],18,5,30235,4.482579688658265,40.0,0.0
16745,1,6745,[318 427 515 588  79],18,5,30240,4.482656388971242,40.0,0.0
16746,1,6746,[318 427 515 588  79],716,5,30245,4.482733066548096,40.0,0.0
16747,1,6747,[258 268 405 183 742],655,1,30246,4.48221695317131,0.0,0.0
16748,1,6748,[318 427 515 588  79],18,5,30251,4.482293673136761,40.0,0.0
16749,1,6749,[318 427 515 588  79],716,5,30256,4.48237037037037,40.0,0.0
16750,1,6750,[318 427 515 588  79],807,5,30261,4.48244704488224,40.0,0.0
16751,1,6751,[742  64  28 182 118],796,3,30264,4.482227488151659,20.0,0.0
16752,1,6752,[318 427 515 588  79],807,5,30269,4.482304161113579,40.0,0.0
16753,1,6753,[318 427 515 588  79],18,5,30274,4.48238081137104,40.0,0.0
16754,1,6754,[ 69  97 322 135 151],401,1,30275,4.481865284974093,0.0,0.0
16755,1,6755,[318 427 515 588  79],18,5,30280,4.481941977501481,40.0,0.0
16756,1,6756,[318 427 515 588  79],18,5,30285,4.4820186473286965,40.0,0.0
16757,1,6757,[403 216 204 111 121],450,4,30289,4.481947321692808,0.0,0.0
16758,1,6758,[ 96 125 238 118 175],457,5,30294,4.4820239680426095,0.0,0.0
16759,1,6759,[357 275 257 132  97],796,4,30298,4.481952662721893,0.0,20.0
16760,1,6760,[318 427 515 588  79],716,5,30303,4.482029285608638,40.0,0.0
16761,1,6761,[318 427 515 588  79],716,5,30308,4.482105885832594,40.0,0.0
16762,1,6762,[  8 173 176 135 234],457,5,30313,4.482182463403815,0.0,0.0
16763,1,6763,[603 294 286 125 144],401,2,30315,4.4818154937906565,20.0,20.0
16764,1,6764,[318 427 515 588  79],807,5,30320,4.481892091648189,40.0,0.0
16765,1,6765,[318 427 515 588  79],716,5,30325,4.481968666863731,40.0,0.0
16766,1,6766,[318 427 515 588  79],716,5,30330,4.4820452194473175,40.0,0.0
16767,1,6767,[423   8 135 200  82],330,4,30334,4.481973995271868,0.0,0.0
16768,1,6768,[318 427 515 588  79],807,5,30339,4.482050524449697,40.0,0.0
16769,1,6769,[301 405 135 153  50],655,2,30341,4.481683899556868,0.0,20.0
16770,1,6770,[117  79 568 186 258],450,4,30345,4.481612760301285,0.0,0.0
16771,1,6771,[286 196  11  97 357],535,3,30348,4.481393975191967,0.0,20.0
16772,1,6772,[318 427 515 588  79],716,5,30353,4.481470544810276,40.0,0.0
16773,1,6773,[435 302 301 265   4],450,4,30357,4.481399468556244,0.0,0.0
16774,1,6774,[245 191 202 144  96],796,4,30361,4.481328413284133,0.0,0.0
16775,1,6775,[385  98 405 423  28],796,4,30365,4.481257378984652,0.0,0.0
16776,1,6776,[318 427 515 588  79],716,5,30370,4.481333923564999,40.0,0.0
16777,1,6777,[318 427 515 588  79],716,5,30375,4.481410445559162,40.0,0.0
16778,1,6778,[ 97  56 174  79 200],18,4,30379,4.481339430594483,0.0,0.0
16779,1,6779,[318 427 515 588  79],807,5,30384,4.48141592920354,40.0,0.0
16780,1,6780,[318 427 515 588  79],716,5,30389,4.481492405249963,40.0,0.0
16781,1,6781,[318 427 515 588  79],18,5,30394,4.481568858743733,40.0,0.0
16782,1,6782,[318 427 515 588  79],716,5,30399,4.481645289694825,40.0,0.0
16783,1,6783,[318 427 515 588  79],807,5,30404,4.4817216981132075,40.0,0.0
16784,1,6784,[318 427 515 588  79],18,5,30409,4.481798084008843,40.0,0.0
16785,1,6785,[318 427 515 588  79],716,5,30414,4.4818744473916885,40.0,0.0
16786,1,6786,[603  70  25  64 144],401,4,30418,4.481803447767791,40.0,0.0
16787,1,6787,[318 427 515 588  79],18,5,30423,4.481879787860931,40.0,0.0
16788,1,6788,[318 427 515 588  79],807,5,30428,4.481956105464723,40.0,0.0
16789,1,6789,[318 427 515 588  79],716,5,30433,4.482032400589102,40.0,0.0
16790,1,6790,[318 427 515 588  79],18,5,30438,4.482108673243999,40.0,0.0
16791,1,6791,[318 427 515 588  79],807,5,30443,4.48218492343934,40.0,0.0
16792,1,6792,[318 427 515 588  79],18,5,30448,4.482261151185043,40.0,0.0
16793,1,6793,[318 427 515 588  79],716,5,30453,4.482337356491022,40.0,0.0
16794,1,6794,[405 144 471 183 357],450,5,30458,4.482413539367181,0.0,0.0
16795,1,6795,[318 427 515 588  79],716,5,30463,4.482489699823425,40.0,0.0
16796,1,6796,[318 427 515 588  79],807,5,30468,4.4825658378696485,40.0,0.0
16797,1,6797,[318 427 515 588  79],18,5,30473,4.48264195351574,40.0,0.0
16798,1,6798,[  7 655  95  71 210],786,5,30478,4.482718046771584,0.0,0.0
16799,1,6799,[318 427 515 588  79],18,5,30483,4.4827941176470585,40.0,0.0
16800,1,6800,[318 427 515 588  79],18,5,30488,4.482870166152036,40.0,0.0
16801,1,6801,[318 427 515 588  79],716,5,30493,4.482946192296383,40.0,0.0
16802,1,6802,[318 427 515 588  79],716,5,30498,4.48302219608996,40.0,0.0
16803,1,6803,[222 471 403 282   8],280,1,30499,4.482510288065844,0.0,0.0
16804,1,6804,[318 427 515 588  79],716,5,30504,4.482586333578252,40.0,0.0
16805,1,6805,[318 427 515 588  79],18,5,30509,4.48266235674405,40.0,0.0
16806,1,6806,[318 427 515 588  79],18,5,30514,4.482738357573086,40.0,0.0
16807,1,6807,[318 427 515 588  79],18,5,30519,4.482814336075205,40.0,0.0
16808,1,6808,[318 427 515 588  79],807,5,30524,4.482890292260244,40.0,0.0
16809,1,6809,[318 427 515 588  79],18,5,30529,4.482966226138032,40.0,0.0
16810,1,6810,[318 427 515 588  79],716,5,30534,4.483042137718397,40.0,0.0
16811,1,6811,[132  97 195  69  25],450,4,30538,4.482971227246036,0.0,0.0
16812,1,6812,[318 427 515 588  79],18,5,30543,4.483047115808014,40.0,0.0
16813,1,6813,[318 427 515 588  79],807,5,30548,4.4831229820956855,40.0,0.0
16814,1,6814,[237 118 196 100  82],504,3,30551,4.482905355832722,0.0,20.0
16815,1,6815,[318 427 515 588  79],716,5,30556,4.482981220657277,40.0,0.0
16816,1,6816,[182 181 265 423 568],450,5,30561,4.483057063224292,0.0,0.0
16817,1,6817,[318 427 515 588  79],716,5,30566,4.483132883543561,40.0,0.0
16818,1,6818,[318 427 515 588  79],18,5,30571,4.4832086816248715,40.0,0.0
16819,1,6819,[100 151 127 289 294],296,2,30573,4.482844574780058,0.0,40.0
16820,1,6820,[318 427 515 588  79],18,5,30578,4.4829203929042665,40.0,0.0
16821,1,6821,[318 427 515 588  79],716,5,30583,4.482996188800938,40.0,0.0
16822,1,6822,[318 427 515 588  79],716,5,30588,4.483071962479848,40.0,0.0
16823,1,6823,[318 427 515 588  79],18,5,30593,4.483147713950762,40.0,0.0
16824,1,6824,[318 427 515 588  79],18,5,30598,4.4832234432234435,40.0,0.0
16825,1,6825,[318 427 515 588  79],716,5,30603,4.483299150307647,40.0,0.0
16826,1,6826,[318 427 515 588  79],807,5,30608,4.483374835213124,40.0,0.0
16827,1,6827,[318 427 515 588  79],716,5,30613,4.483450497949619,40.0,0.0
16828,1,6828,[210 197 191 174  28],716,5,30618,4.48352613852687,0.0,0.0
16829,1,6829,[318 427 515 588  79],18,5,30623,4.483601756954612,40.0,0.0
16830,1,6830,[318 427 515 588  79],716,5,30628,4.48367735324257,40.0,0.0
16831,1,6831,[318 427 515 588  79],716,5,30633,4.483752927400468,40.0,0.0
16832,1,6832,[318 427 515 588  79],716,5,30638,4.483828479438022,40.0,0.0
16833,1,6833,[318 427 515 588  79],716,5,30643,4.48390400936494,40.0,0.0
16834,1,6834,[318 427 515 588  79],18,5,30648,4.483979517190929,40.0,0.0
16835,1,6835,[318 427 515 588  79],807,5,30653,4.484055002925688,40.0,0.0
16836,1,6836,[ 64 357 423 127 153],716,5,30658,4.484130466578909,20.0,20.0
16837,1,6837,[318 427 515 588  79],18,5,30663,4.4842059081602805,40.0,0.0
16838,1,6838,[318 427 515 588  79],807,5,30668,4.4842813276794855,40.0,0.0
16839,1,6839,[318 427 515 588  79],716,5,30673,4.484356725146199,40.0,0.0
16840,1,6840,[318 427 515 588  79],807,5,30678,4.484432100570092,40.0,0.0
16841,1,6841,[318 427 515 588  79],807,5,30683,4.4845074539608305,40.0,0.0
16842,1,6842,[318 427 515 588  79],18,5,30688,4.484582785328072,40.0,0.0
16843,1,6843,[117 546 427 143   8],577,3,30691,4.484365867913501,20.0,0.0
16844,1,6844,[318 427 515 588  79],807,5,30696,4.484441197954712,40.0,0.0
16845,1,6845,[318 427 515 588  79],807,5,30701,4.484516505988899,40.0,0.0
16846,1,6846,[275 405 385 496 197],786,4,30705,4.48444574266102,20.0,20.0
16847,1,6847,[318 427 515 588  79],807,5,30710,4.484521028037383,40.0,0.0
16848,1,6848,[318 427 515 588  79],716,5,30715,4.484596291429406,40.0,0.0
16849,1,6849,[318 427 515 588  79],716,5,30720,4.484671532846716,40.0,0.0
16850,1,6850,[318 427 515 588  79],716,5,30725,4.484746752298935,40.0,0.0
16851,1,6851,[318 427 515 588  79],716,5,30730,4.4848219497956805,40.0,0.0
16852,1,6852,[318 427 515 588  79],18,5,30735,4.4848971253465635,40.0,0.0
16853,1,6853,[ 64 125 483 161  88],796,5,30740,4.48497227896119,20.0,0.0
16854,1,6854,[318 427 515 588  79],18,5,30745,4.485047410649162,40.0,0.0
16855,1,6855,[568 180 200   9 288],280,4,30749,4.48497666277713,0.0,0.0
16856,1,6856,[318 427 515 588  79],716,5,30754,4.485051771911915,40.0,0.0
16857,1,6857,[318 427 515 588  79],18,5,30759,4.485126859142607,40.0,0.0
16858,1,6858,[742 210  97 100  98],450,4,30763,4.485056130631287,0.0,20.0
16859,1,6859,[318 427 515 588  79],807,5,30768,4.485131195335277,40.0,0.0
16860,1,6860,[318 427 515 588  79],716,5,30773,4.485206238157703,40.0,0.0
16861,1,6861,[125 405 313 117 168],796,5,30778,4.485281259108132,0.0,0.0
16862,1,6862,[318 427 515 588  79],18,5,30783,4.485356258196124,40.0,0.0
16863,1,6863,[ 64  96 235  50 173],457,4,30787,4.485285547785548,20.0,20.0
16864,1,6864,[100 195 127 215  56],457,5,30792,4.485360524399126,0.0,40.0
16865,1,6865,[ 98 222  96 257 144],457,4,30796,4.485289833964463,0.0,0.0
16866,1,6866,[318 427 515 588  79],807,5,30801,4.4853647881170815,40.0,0.0
16867,1,6867,[318 427 515 588  79],716,5,30806,4.485439720442632,40.0,0.0
16868,1,6868,[  1 294 568  56 200],716,5,30811,4.4855146309506475,0.0,0.0
16869,1,6869,[318 427 515 588  79],807,5,30816,4.485589519650655,40.0,0.0
16870,1,6870,[385  98 168  89  97],796,4,30820,4.485518847329355,0.0,0.0
16871,1,6871,[318 427 515 588  79],716,5,30825,4.485593713620489,40.0,0.0
16872,1,6872,[ 69 210 515  56 257],716,5,30830,4.485668558126,0.0,0.0
16873,1,6873,[318 427 515 588  79],807,5,30835,4.485743380855397,40.0,0.0
16874,1,6874,[318 427 515 588  79],807,5,30840,4.485818181818182,40.0,0.0
16875,1,6875,[318 427 515 588  79],716,5,30845,4.485892961023851,40.0,0.0
16876,1,6876,[318 427 515 588  79],716,5,30850,4.485967718481896,40.0,0.0
16877,1,6877,[318 427 515 588  79],807,5,30855,4.486042454201803,40.0,0.0
16878,1,6878,[318 427 515 588  79],716,5,30860,4.486117168193052,40.0,0.0
16879,1,6879,[318 427 515 588  79],716,5,30865,4.486191860465116,40.0,0.0
16880,1,6880,[427   8  88 202 302],389,4,30869,4.486121203313472,20.0,0.0
16881,1,6881,[423  98 269 197   4],655,1,30870,4.48561464690497,0.0,0.0
16882,1,6882,[322 588  95 132 174],786,4,30874,4.485544094144995,0.0,0.0
16883,1,6883,[318 427 515 588  79],716,5,30879,4.4856188262638,40.0,0.0
16884,1,6884,[318 427 515 588  79],807,5,30884,4.485693536673929,40.0,0.0
16885,1,6885,[318 427 515 588  79],807,5,30889,4.485768225384839,40.0,0.0
16886,1,6886,[318 427 515 588  79],716,5,30894,4.485842892405982,40.0,0.0
16887,1,6887,[318 427 515 588  79],18,5,30899,4.485917537746806,40.0,0.0
16888,1,6888,[ 97 282 172  22 100],796,3,30902,4.485701843518653,0.0,20.0
16889,1,6889,[318 427 515 588  79],716,5,30907,4.48577648766328,40.0,0.0
16890,1,6890,[  7 151 200  50 496],450,4,30911,4.485705993324626,20.0,20.0
16891,1,6891,[318 427 515 588  79],807,5,30916,4.4857806152060355,40.0,0.0
16892,1,6892,[121 237 204  98 144],296,5,30921,4.48585521543595,0.0,0.0
16893,1,6893,[121   1   7 333 237],655,0,30921,4.4852045256745,0.0,0.0
16894,1,6894,[318 427 515 588  79],18,5,30926,4.485279187817259,40.0,0.0
16895,1,6895,[318 427 515 588  79],18,5,30931,4.485353828306264,40.0,0.0
16896,1,6896,[318 427 515 588  79],807,5,30936,4.485428447150936,40.0,0.0
16897,1,6897,[318 427 515 588  79],18,5,30941,4.4855030443606845,40.0,0.0
16898,1,6898,[181 238 603  28 471],389,5,30946,4.4855776199449195,20.0,0.0
16899,1,6899,[318 427 515 588  79],807,5,30951,4.485652173913043,40.0,0.0
16900,1,6900,[318 427 515 588  79],716,5,30956,4.485726706274453,40.0,0.0
16901,1,6901,[238 211 235 161 210],269,2,30958,4.485366560417271,0.0,0.0
16902,1,6902,[318 427 515 588  79],18,5,30963,4.485441112559757,40.0,0.0
16903,1,6903,[423 471 168  82 195],457,5,30968,4.485515643105446,0.0,0.0
16904,1,6904,[174 313 121 265 143],450,4,30972,4.485445329471397,0.0,0.0
16905,1,6905,[423  82 288 195 265],655,0,30972,4.484795829713293,0.0,0.0
16906,1,6906,[318 427 515 588  79],18,5,30977,4.4848704213117125,40.0,0.0
16907,1,6907,[  9  64 275 118 435],655,2,30979,4.484510712217719,20.0,20.0
16908,1,6908,[318 427 515 588  79],716,5,30984,4.484585323491099,40.0,0.0
16909,1,6909,[318 427 515 588  79],18,5,30989,4.4846599131693194,40.0,0.0
16910,1,6910,[318 427 515 588  79],716,5,30994,4.484734481261756,40.0,0.0
16911,1,6911,[318 427 515 588  79],18,5,30999,4.484809027777778,40.0,0.0
16912,1,6912,[318 427 515 588  79],807,5,31004,4.484883552726747,40.0,0.0
16913,1,6913,[318 427 515 588  79],807,5,31009,4.484958056118021,40.0,0.0
16914,1,6914,[318 427 515 588  79],716,5,31014,4.485032537960954,40.0,0.0
16915,1,6915,[318 427 515 588  79],716,5,31019,4.485106998264893,40.0,0.0
16916,1,6916,[318 427 515 588  79],716,5,31024,4.485181437039179,40.0,0.0
16917,1,6917,[318 427 515 588  79],716,5,31029,4.485255854293149,40.0,0.0
16918,1,6918,[318 427 515 588  79],807,5,31034,4.4853302500361325,40.0,0.0
16919,1,6919,[318 427 515 588  79],807,5,31039,4.485404624277456,40.0,0.0
16920,1,6920,[318 427 515 588  79],807,5,31044,4.485478977026442,40.0,0.0
16921,1,6921,[318 427 515 588  79],807,5,31049,4.485553308292401,40.0,0.0
16922,1,6922,[318 427 515 588  79],807,5,31054,4.485627618084646,40.0,0.0
16923,1,6923,[318 427 515 588  79],716,5,31059,4.485701906412478,40.0,0.0
16924,1,6924,[318 427 515 588  79],716,5,31064,4.485776173285198,40.0,0.0
16925,1,6925,[318 427 515 588  79],18,5,31069,4.4858504187121,40.0,0.0
16926,1,6926,[318 427 515 588  79],807,5,31074,4.485924642702469,40.0,0.0
16927,1,6927,[318 427 515 588  79],716,5,31079,4.485998845265589,40.0,0.0
16928,1,6928,[318 427 515 588  79],18,5,31084,4.486073026410738,40.0,0.0
16929,1,6929,[ 97  70  82  98 175],151,4,31088,4.486002886002886,0.0,0.0
16930,1,6930,[318 427 515 588  79],18,5,31093,4.486077045159429,40.0,0.0
16931,1,6931,[318 427 515 588  79],18,5,31098,4.486151182919793,40.0,0.0
16932,1,6932,[742 238  96 151 257],457,4,31102,4.486081061589499,0.0,0.0
16933,1,6933,[313 435  22 194 427],450,5,31107,4.48615517738679,20.0,0.0
16934,1,6934,[318 427 515 588  79],716,5,31112,4.486229271809661,40.0,0.0
16935,1,6935,[318 427 515 588  79],807,5,31117,4.486303344867359,40.0,0.0
16936,1,6936,[318 427 515 588  79],716,5,31122,4.4863773965691225,40.0,0.0
16937,1,6937,[318 427 515 588  79],716,5,31127,4.4864514269241855,40.0,0.0
16938,1,6938,[322 385 125 276  69],504,4,31131,4.4863813229571985,0.0,0.0
16939,1,6939,[  1 118  79 172   8],577,4,31135,4.486311239193084,0.0,0.0
16940,1,6940,[302 288 742 100 117],655,1,31136,4.485808961244778,0.0,20.0
16941,1,6941,[ 50  69  95 603  97],716,5,31141,4.485883030826851,20.0,20.0
16942,1,6942,[318 427 515 588  79],807,5,31146,4.485957079072447,40.0,0.0
16943,1,6943,[318 427 515 588  79],807,5,31151,4.486031105990784,40.0,0.0
16944,1,6944,[318 427 515 588  79],18,5,31156,4.486105111591073,40.0,0.0
16945,1,6945,[318 427 515 588  79],807,5,31161,4.486179095882522,40.0,0.0
16946,1,6946,[318 427 515 588  79],807,5,31166,4.486253058874334,40.0,0.0
16947,1,6947,[174 168 228  70 258],151,5,31171,4.486327000575705,0.0,0.0
16948,1,6948,[ 69  82 197  28 125],457,5,31176,4.486400920995827,0.0,0.0
16949,1,6949,[318 427 515 588  79],716,5,31181,4.486474820143885,40.0,0.0
16950,1,6950,[318 427 515 588  79],807,5,31186,4.48654869802906,40.0,0.0
16951,1,6951,[  9 172 204 196 100],629,5,31191,4.48662255466053,0.0,20.0
16952,1,6952,[318 427 515 588  79],716,5,31196,4.486696390047461,40.0,0.0
16953,1,6953,[318 427 515 588  79],18,5,31201,4.486770204199022,40.0,0.0
16954,1,6954,[318 427 515 588  79],716,5,31206,4.486843997124371,40.0,0.0
16955,1,6955,[318 427 515 588  79],716,5,31211,4.4869177688326625,40.0,0.0
16956,1,6956,[273 678 197 153  71],401,1,31212,4.4864165588615785,0.0,0.0
16957,1,6957,[318 427 515 588  79],18,5,31217,4.486490370796206,40.0,0.0
16958,1,6958,[318 427 515 588  79],716,5,31222,4.486564161517459,40.0,0.0
16959,1,6959,[318 427 515 588  79],807,5,31227,4.486637931034482,40.0,0.0
16960,1,6960,[318 427 515 588  79],18,5,31232,4.486711679356414,40.0,0.0
16961,1,6961,[172  56 173 286 121],593,5,31237,4.4867854064923876,0.0,20.0
16962,1,6962,[508  98 200 186 483],269,4,31241,4.4867154961941695,0.0,0.0
16963,1,6963,[318 427 515 588  79],807,5,31246,4.486789201608271,40.0,0.0
16964,1,6964,[  1 176 222  64  95],716,4,31250,4.486719310839914,20.0,0.0
16965,1,6965,[318 427 515 588  79],18,5,31255,4.486792994544933,40.0,0.0
16966,1,6966,[174  79 216 125  69],151,5,31260,4.486866657097747,0.0,0.0
16967,1,6967,[318 427 515 588  79],716,5,31265,4.486940298507463,40.0,0.0
16968,1,6968,[318 427 515 588  79],807,5,31270,4.487013918783183,40.0,0.0
16969,1,6969,[318 427 515 588  79],716,5,31275,4.487087517934003,40.0,0.0
16970,1,6970,[318 427 515 588  79],716,5,31280,4.4871610959690145,40.0,0.0
16971,1,6971,[318 427 515 588  79],18,5,31285,4.487234652897303,40.0,0.0
16972,1,6972,[318 427 515 588  79],807,5,31290,4.48730818872795,40.0,0.0
16973,1,6973,[318 427 515 588  79],716,5,31295,4.487381703470032,40.0,0.0
16974,1,6974,[318 427 515 588  79],18,5,31300,4.487455197132617,40.0,0.0
16975,1,6975,[318 427 515 588  79],716,5,31305,4.487528669724771,40.0,0.0
16976,1,6976,[318 427 515 588  79],807,5,31310,4.487602121255554,40.0,0.0
16977,1,6977,[318 427 515 588  79],18,5,31315,4.487675551734021,40.0,0.0
16978,1,6978,[117 328 273 333 313],236,2,31317,4.487319100157616,0.0,0.0
16979,1,6979,[318 427 515 588  79],18,5,31322,4.487392550143267,40.0,0.0
16980,1,6980,[318 427 515 588  79],716,5,31327,4.487465979086091,40.0,0.0
16981,1,6981,[318 427 515 588  79],716,5,31332,4.48753938699513,40.0,0.0
16982,1,6982,[318 427 515 588  79],807,5,31337,4.487612773879421,40.0,0.0
16983,1,6983,[318 427 515 588  79],716,5,31342,4.4876861397479955,40.0,0.0
16984,1,6984,[183 117  56 216 215],716,4,31346,4.487616320687187,0.0,0.0
16985,1,6985,[318 427 515 588  79],807,5,31351,4.487689665044375,40.0,0.0
16986,1,6986,[ 70 196   7 179 588],457,5,31356,4.487762988407042,0.0,0.0
16987,1,6987,[318 427 515 588  79],807,5,31361,4.487836290784202,40.0,0.0
16988,1,6988,[318 427 515 588  79],807,5,31366,4.487909572184862,40.0,0.0
16989,1,6989,[318 427 515 588  79],716,5,31371,4.487982832618026,40.0,0.0
16990,1,6990,[318 427 515 588  79],716,5,31376,4.48805607209269,40.0,0.0
16991,1,6991,[318 427 515 588  79],716,5,31381,4.488129290617849,40.0,0.0
16992,1,6992,[318 427 515 588  79],18,5,31386,4.4882024882024885,40.0,0.0
16993,1,6993,[318 427 515 588  79],716,5,31391,4.488275664855591,40.0,0.0
16994,1,6994,[127 186  28 153 172],18,3,31394,4.488062902072909,0.0,20.0
16995,1,6995,[151 161 200 204 301],450,4,31398,4.4879931389365355,0.0,0.0
16996,1,6996,[318 427 515 588  79],807,5,31403,4.488066314134629,40.0,0.0
16997,1,6997,[222  97 655 143 161],693,2,31405,4.487710774507002,0.0,0.0
16998,1,6998,[318 427 515 588  79],18,5,31410,4.487783969138448,40.0,0.0
16999,1,6999,[318 427 515 588  79],807,5,31415,4.487857142857143,40.0,0.0
17000,1,7000,[318 427 515 588  79],807,5,31420,4.487930295672047,40.0,0.0
17001,1,7001,[318 427 515 588  79],716,5,31425,4.488003427592116,40.0,0.0
17002,1,7002,[318 427 515 588  79],716,5,31430,4.488076538626303,40.0,0.0
17003,1,7003,[202 313 222 405 125],655,1,31431,4.487578526556254,0.0,0.0
17004,1,7004,[318 427 515 588  79],18,5,31436,4.487651677373305,40.0,0.0
17005,1,7005,[655  15 423 135   1],655,1,31437,4.487153868113046,0.0,0.0
17006,1,7006,[ 97 210 196 117 153],236,1,31438,4.4866562009419155,0.0,0.0
17007,1,7007,[322 176  82 181 276],504,2,31440,4.486301369863014,0.0,0.0
17008,1,7008,[318 427 515 588  79],807,5,31445,4.48637466114995,40.0,0.0
17009,1,7009,[385 127 568 135  69],450,4,31449,4.486305278174037,0.0,20.0
17010,1,7010,[258 125 210 318  69],457,5,31454,4.486378547996006,20.0,0.0
17011,1,7011,[471 288  88 323 269],174,3,31457,4.486166571591557,0.0,0.0
17012,1,7012,[318 427 515 588  79],807,5,31462,4.486239840296592,40.0,0.0
17013,1,7013,[423 196  96  22  97],450,5,31467,4.486313088109496,0.0,0.0
17014,1,7014,[546 144  12 597 182],457,3,31470,4.486101211689237,0.0,0.0
17015,1,7015,[318 427 515 588  79],18,5,31475,4.486174458380844,40.0,0.0
17016,1,7016,[174 180 153 179  82],269,1,31476,4.4856776400171015,0.0,0.0
17017,1,7017,[318 427 515 588  79],716,5,31481,4.485750926189798,40.0,0.0
17018,1,7018,[318 427 515 588  79],807,5,31486,4.485824191480268,40.0,0.0
17019,1,7019,[228 135 183  98 222],292,4,31490,4.485754985754986,0.0,0.0
17020,1,7020,[318 427 515 588  79],807,5,31495,4.485828229596923,40.0,0.0
17021,1,7021,[318 427 515 588  79],716,5,31500,4.485901452577613,40.0,0.0
17022,1,7022,[318 427 515 588  79],18,5,31505,4.4859746547059665,40.0,0.0
17023,1,7023,[423 301 127 258  98],450,5,31510,4.486047835990888,0.0,20.0
17024,1,7024,[318 427 515 588  79],807,5,31515,4.486120996441281,40.0,0.0
17025,1,7025,[318 427 515 588  79],716,5,31520,4.4861941360660404,40.0,0.0
17026,1,7026,[318 427 515 588  79],18,5,31525,4.486267254874058,40.0,0.0
17027,1,7027,[302 423 132  22 210],450,4,31529,4.4861980648833235,0.0,0.0
17028,1,7028,[318 427 515 588  79],807,5,31534,4.4862711623275,40.0,0.0
17029,1,7029,[318 427 515 588  79],18,5,31539,4.486344238975818,40.0,0.0
17030,1,7030,[265 423 588  82 173],786,5,31544,4.48641729483715,0.0,0.0
17031,1,7031,[318 427 515 588  79],807,5,31549,4.486490329920364,40.0,0.0
17032,1,7032,[318 427 515 588  79],18,5,31554,4.486563344234324,40.0,0.0
17033,1,7033,[318 427 515 588  79],18,5,31559,4.486636337787887,40.0,0.0
17034,1,7034,[318 427 515 588  79],18,5,31564,4.486709310589908,40.0,0.0
17035,1,7035,[125 179 196 187 173],450,5,31569,4.486782262649233,0.0,0.0
17036,1,7036,[318 427 515 588  79],716,5,31574,4.486855193974705,40.0,0.0
17037,1,7037,[318 427 515 588  79],18,5,31579,4.4869281045751634,40.0,0.0
17038,1,7038,[318 427 515 588  79],716,5,31584,4.48700099445944,40.0,0.0
17039,1,7039,[183  15 238 245 322],593,3,31587,4.486789772727272,0.0,0.0
17040,1,7040,[318 427 515 588  79],716,5,31592,4.486862661553756,40.0,0.0
17041,1,7041,[318 427 515 588  79],18,5,31597,4.4869355296790685,40.0,0.0
17042,1,7042,[197 655 117 222 423],796,3,31600,4.486724407212836,0.0,0.0
17043,1,7043,[318 427 515 588  79],18,5,31605,4.48679727427598,40.0,0.0
17044,1,7044,[318 427 515 588  79],807,5,31610,4.486870120652945,40.0,0.0
17045,1,7045,[ 22  64 322 427 197],796,3,31613,4.486659097360205,40.0,0.0
17046,1,7046,[  1  28 258  22 135],807,4,31617,4.486590038314176,0.0,0.0
17047,1,7047,[318 427 515 588  79],807,5,31622,4.4866628830874005,40.0,0.0
17048,1,7048,[318 427 515 588  79],716,5,31627,4.486735707192509,40.0,0.0
17049,1,7049,[515 200 302 202 174],269,2,31629,4.486382978723404,0.0,0.0
17050,1,7050,[318 427 515 588  79],807,5,31634,4.486455821869239,40.0,0.0
17051,1,7051,[235 200  70  28 204],330,5,31639,4.486528644356211,0.0,0.0
17052,1,7052,[202 191  71 174 245],344,3,31642,4.486317878916773,0.0,0.0
17053,1,7053,[153 187 323 271 405],796,4,31646,4.486248936773462,0.0,0.0
17054,1,7054,[318 427 515 588  79],807,5,31651,4.48632175761871,40.0,0.0
17055,1,7055,[318 427 515 588  79],18,5,31656,4.48639455782313,40.0,0.0
17056,1,7056,[176 200 276  95 144],280,3,31659,4.486183930848803,0.0,0.0
17057,1,7057,[318 427 515 588  79],716,5,31664,4.486256729951828,40.0,0.0
17058,1,7058,[318 427 515 588  79],716,5,31669,4.486329508428956,40.0,0.0
17059,1,7059,[  9 174 100 237 318],72,4,31673,4.4862606232294615,20.0,20.0
17060,1,7060,[318 427 515 588  79],807,5,31678,4.486333380541,40.0,0.0
17061,1,7061,[ 96 216 258 588 168],796,5,31683,4.486406117247239,0.0,0.0
17062,1,7062,[318 427 515 588  79],807,5,31688,4.48647883335693,40.0,0.0
17063,1,7063,[300 100 204 655 132],504,4,31692,4.486409966024915,0.0,20.0
17064,1,7064,[318 427 515 588  79],807,5,31697,4.486482661004954,40.0,0.0
17065,1,7065,[ 70 181 603 174 742],450,5,31702,4.486555335409001,20.0,0.0
17066,1,7066,[125 216 100  71 301],450,4,31706,4.486486486486487,0.0,20.0
17067,1,7067,[318 427 515 588  79],807,5,31711,4.486559139784946,40.0,0.0
17068,1,7068,[748 471 238 118   4],450,3,31714,4.486348847078795,0.0,0.0
17069,1,7069,[318 427 515 588  79],807,5,31719,4.486421499292787,40.0,0.0
17070,1,7070,[318 427 515 588  79],716,5,31724,4.486494130957432,40.0,0.0
17071,1,7071,[318 427 515 588  79],18,5,31729,4.486566742081448,40.0,0.0
17072,1,7072,[318 427 515 588  79],18,5,31734,4.486639332673548,40.0,0.0
17073,1,7073,[318 427 515 588  79],18,5,31739,4.486711902742437,40.0,0.0
17074,1,7074,[318 427 515 588  79],716,5,31744,4.48678445229682,40.0,0.0
17075,1,7075,[  1 168 196 597 100],450,5,31749,4.486856981345393,0.0,20.0
17076,1,7076,[318 427 515 588  79],716,5,31754,4.486929489896849,40.0,0.0
17077,1,7077,[318 427 515 588  79],716,5,31759,4.487001977959876,40.0,0.0
17078,1,7078,[  4 257 357 271 265],655,1,31760,4.4865093939822005,0.0,0.0
17079,1,7079,[318 427 515 588  79],716,5,31765,4.486581920903955,40.0,0.0
17080,1,7080,[318 427 515 588  79],807,5,31770,4.486654427340771,40.0,0.0
17081,1,7081,[318 427 515 588  79],18,5,31775,4.486726913301327,40.0,0.0
17082,1,7082,[100  28 185 742  88],457,5,31780,4.486799378794296,0.0,20.0
17083,1,7083,[118 301 216 597 211],796,3,31783,4.486589497459063,0.0,0.0
17084,1,7084,[197 216   7 186  15],450,3,31786,4.486379675370501,0.0,0.0
17085,1,7085,[318 427 515 588  79],716,5,31791,4.486452159187129,40.0,0.0
17086,1,7086,[318 427 515 588  79],716,5,31796,4.486524622548328,40.0,0.0
17087,1,7087,[318 427 515 588  79],807,5,31801,4.486597065462754,40.0,0.0
17088,1,7088,[318 427 515 588  79],18,5,31806,4.486669487939061,40.0,0.0
17089,1,7089,[183 435 286  11 276],655,2,31808,4.486318758815233,0.0,20.0
17090,1,7090,[238  89 288 427  96],655,2,31810,4.485968128613735,20.0,0.0
17091,1,7091,[318 427 515 588  79],716,5,31815,4.4860406091370555,40.0,0.0
17092,1,7092,[318 427 515 588  79],18,5,31820,4.486113069223178,40.0,0.0
17093,1,7093,[318 427 515 588  79],18,5,31825,4.4861855088807445,40.0,0.0
17094,1,7094,[318 427 515 588  79],807,5,31830,4.486257928118393,40.0,0.0
17095,1,7095,[204 597  28 234 655],450,4,31834,4.486189402480271,0.0,0.0
17096,1,7096,[318 427 515 588  79],716,5,31839,4.486261800760885,40.0,0.0
17097,1,7097,[318 427 515 588  79],716,5,31844,4.486334178641871,40.0,0.0
17098,1,7098,[318 427 515 588  79],807,5,31849,4.48640653613185,40.0,0.0
17099,1,7099,[318 427 515 588  79],18,5,31854,4.486478873239436,40.0,0.0
17100,1,7100,[318 427 515 588  79],716,5,31859,4.486551189973243,40.0,0.0
17101,1,7101,[357 748 161 568 313],450,5,31864,4.486623486341876,0.0,0.0
17102,1,7102,[ 88 302 100 211 268],655,1,31865,4.48613262001971,0.0,20.0
17103,1,7103,[318 427 515 588  79],716,5,31870,4.486204954954955,40.0,0.0
17104,1,7104,[405  56 357 215 174],457,5,31875,4.486277269528501,0.0,0.0
17105,1,7105,[318 427 515 588  79],807,5,31880,4.486349563748944,40.0,0.0
17106,1,7106,[318 427 515 588  79],716,5,31885,4.486421837624877,40.0,0.0
17107,1,7107,[318 427 515 588  79],807,5,31890,4.486494091164885,40.0,0.0
17108,1,7108,[151 265 153 127 100],292,5,31895,4.4865663243775495,0.0,40.0
17109,1,7109,[174 275 238  82  12],18,4,31899,4.486497890295358,0.0,20.0
17110,1,7110,[318 427 515 588  79],18,5,31904,4.486570102657854,40.0,0.0
17111,1,7111,[318 427 515 588  79],18,5,31909,4.486642294713161,40.0,0.0
17112,1,7112,[318 427 515 588  79],807,5,31914,4.486714466469844,40.0,0.0
17113,1,7113,[318 427 515 588  79],18,5,31919,4.486786617936463,40.0,0.0
17114,1,7114,[318 427 515 588  79],18,5,31924,4.486858749121574,40.0,0.0
17115,1,7115,[546 183 210 117 168],577,3,31927,4.486649803260258,0.0,0.0
17116,1,7116,[318 427 515 588  79],18,5,31932,4.486721933398904,40.0,0.0
17117,1,7117,[318 427 515 588  79],716,5,31937,4.4867940432705815,40.0,0.0
17118,1,7118,[318 427 515 588  79],807,5,31942,4.486866132883832,40.0,0.0
17119,1,7119,[ 88 183 143 588 202],786,5,31947,4.486938202247191,0.0,0.0
17120,1,7120,[318 427 515 588  79],807,5,31952,4.48701025136919,40.0,0.0
17121,1,7121,[151 204 237  82 173],269,1,31953,4.486520640269587,0.0,0.0
17122,1,7122,[318  69 216  71 257],796,5,31958,4.486592727783237,20.0,0.0
17123,1,7123,[318 427 515 588  79],807,5,31963,4.486664795058956,40.0,0.0
17124,1,7124,[318 427 515 588  79],716,5,31968,4.486736842105263,40.0,0.0
17125,1,7125,[318 427 515 588  79],716,5,31973,4.486808868930677,40.0,0.0
17126,1,7126,[318 427 515 588  79],716,5,31978,4.486880875543707,40.0,0.0
17127,1,7127,[318 427 515 588  79],807,5,31983,4.486952861952862,40.0,0.0
17128,1,7128,[196  95 427 515 238],18,4,31987,4.486884556038715,20.0,0.0
17129,1,7129,[546 403 655 423 405],280,2,31989,4.486535764375876,0.0,0.0
17130,1,7130,[318 427 515 588  79],716,5,31994,4.486607768896368,40.0,0.0
17131,1,7131,[318 427 515 588  79],18,5,31999,4.486679753224902,40.0,0.0
17132,1,7132,[357   9  64 111 265],151,5,32004,4.4867517173699705,20.0,0.0
17133,1,7133,[318 427 515 588  79],807,5,32009,4.486823661340062,40.0,0.0
17134,1,7134,[318 427 515 588  79],807,5,32014,4.486895585143658,40.0,0.0
17135,1,7135,[318 427 515 588  79],807,5,32019,4.4869674887892375,40.0,0.0
17136,1,7136,[318 427 515 588  79],716,5,32024,4.487039372285274,40.0,0.0
17137,1,7137,[318 427 515 588  79],807,5,32029,4.487111235640235,40.0,0.0
17138,1,7138,[318 427 515 588  79],807,5,32034,4.487183078862586,40.0,0.0
17139,1,7139,[318 427 515 588  79],18,5,32039,4.487254901960784,40.0,0.0
17140,1,7140,[318 427 515 588  79],807,5,32044,4.4873267049432854,40.0,0.0
17141,1,7141,[318 427 515 588  79],18,5,32049,4.487398487818538,40.0,0.0
17142,1,7142,[318 427 515 588  79],716,5,32054,4.487470250594988,40.0,0.0
17143,1,7143,[318 427 515 588  79],807,5,32059,4.487541993281075,40.0,0.0
17144,1,7144,[318 427 515 588  79],18,5,32064,4.487613715885234,40.0,0.0
17145,1,7145,[ 11 508   8 268 186],655,0,32064,4.4869857262804365,0.0,0.0
17146,1,7146,[318 427 515 588  79],18,5,32069,4.4870575066461456,40.0,0.0
17147,1,7147,[143 222 168  28 176],796,4,32073,4.486989367655288,0.0,0.0
17148,1,7148,[318 427 515 588  79],18,5,32078,4.48706112743041,40.0,0.0
17149,1,7149,[318 427 515 588  79],716,5,32083,4.487132867132867,40.0,0.0
17150,1,7150,[318 427 515 588  79],807,5,32088,4.487204586771081,40.0,0.0
17151,1,7151,[318 427 515 588  79],18,5,32093,4.487276286353468,40.0,0.0
17152,1,7152,[237 655 546 194  98],457,4,32097,4.4872081644065425,0.0,0.0
17153,1,7153,[318 427 515 588  79],18,5,32102,4.487279843444227,40.0,0.0
17154,1,7154,[318 427 515 588  79],807,5,32107,4.487351502445842,40.0,0.0
17155,1,7155,[ 98 173 748 211 742],450,5,32112,4.487423141419788,0.0,0.0
17156,1,7156,[508 273 211 258   7],693,2,32114,4.487075590331144,0.0,0.0
17157,1,7157,[318 427 515 588  79],716,5,32119,4.48714724783459,40.0,0.0
17158,1,7158,[318 427 515 588  79],716,5,32124,4.487218885319178,40.0,0.0
17159,1,7159,[318 427 515 588  79],18,5,32129,4.487290502793296,40.0,0.0
17160,1,7160,[318 427 515 588  79],18,5,32134,4.487362100265326,40.0,0.0
17161,1,7161,[318 427 515 588  79],807,5,32139,4.487433677743647,40.0,0.0
17162,1,7162,[318 427 515 588  79],18,5,32144,4.4875052352366325,40.0,0.0
17163,1,7163,[  8 403 357 153 172],330,5,32149,4.487576772752652,0.0,0.0
17164,1,7164,[318 427 515 588  79],716,5,32154,4.487648290300069,40.0,0.0
17165,1,7165,[204 173  50 215 174],151,4,32158,4.487580240022328,0.0,20.0
17166,1,7166,[121 423  82 496   1],807,5,32163,4.487651737128505,20.0,0.0
17167,1,7167,[318 427 515 588  79],18,5,32168,4.487723214285714,40.0,0.0
17168,1,7168,[204  71 211 483 132],450,3,32171,4.4875156925652115,0.0,0.0
17169,1,7169,[318 427 515 588  79],716,5,32176,4.487587168758717,40.0,0.0
17170,1,7170,[318 427 515 588  79],807,5,32181,4.487658625017431,40.0,0.0
17171,1,7171,[ 11 125 302 191 678],344,2,32183,4.487311767986615,0.0,0.0
17172,1,7172,[245 294 313 173  71],796,3,32186,4.4871044193503415,0.0,0.0
17173,1,7173,[318 427 515 588  79],807,5,32191,4.487175913019236,40.0,0.0
17174,1,7174,[ 22 678 282 286 204],280,2,32193,4.486829268292683,0.0,20.0
17175,1,7175,[318 427 515 588  79],716,5,32198,4.486900780379041,40.0,0.0
17176,1,7176,[318 427 515 588  79],716,5,32203,4.486972272537272,40.0,0.0
17177,1,7177,[318 427 515 588  79],807,5,32208,4.487043744775703,40.0,0.0
17178,1,7178,[300   9 258  56 211],796,3,32211,4.486836606769745,0.0,0.0
17179,1,7179,[234 288 144 328  56],450,3,32214,4.486629526462395,0.0,0.0
17180,1,7180,[318 427 515 588  79],716,5,32219,4.486701016571508,40.0,0.0
17181,1,7181,[318 427 515 588  79],716,5,32224,4.4867724867724865,40.0,0.0
17182,1,7182,[210 174 185 289  88],655,1,32225,4.486287066685229,0.0,0.0
17183,1,7183,[318 427 515 588  79],807,5,32230,4.486358574610245,40.0,0.0
17184,1,7184,[135  96   1 597  15],457,4,32234,4.4862908837856645,0.0,0.0
17185,1,7185,[173   8 748 235 546],807,3,32237,4.486084052323963,0.0,0.0
17186,1,7186,[318 427 515 588  79],18,5,32242,4.486155558647558,40.0,0.0
17187,1,7187,[318 427 515 588  79],18,5,32247,4.486227045075125,40.0,0.0
17188,1,7188,[385 258  88   8 143],457,5,32252,4.486298511614967,0.0,0.0
17189,1,7189,[121 508 237 257  28],655,0,32252,4.48567454798331,0.0,0.0
17190,1,7190,[318 427 515 588  79],716,5,32257,4.4857460714782365,40.0,0.0
17191,1,7191,[318 427 515 588  79],716,5,32262,4.485817575083426,40.0,0.0
17192,1,7192,[202  56  50 568  95],577,3,32265,4.485611010704852,0.0,20.0
17193,1,7193,[318 427 515 588  79],716,5,32270,4.485682513205449,40.0,0.0
17194,1,7194,[275 228 258 111 127],655,2,32272,4.485337039610841,0.0,40.0
17195,1,7195,[318 427 515 588  79],716,5,32277,4.485408560311284,40.0,0.0
17196,1,7196,[318 427 515 588  79],716,5,32282,4.485480061136585,40.0,0.0
17197,1,7197,[318 427 515 588  79],807,5,32287,4.485551542095027,40.0,0.0
17198,1,7198,[318 427 515 588  79],807,5,32292,4.485623003194888,40.0,0.0
17199,1,7199,[318 427 515 588  79],18,5,32297,4.485694444444444,40.0,0.0
17200,1,7200,[125 300 222 405  12],655,0,32297,4.485071517844744,0.0,0.0
17201,1,7201,[318 427 515 588  79],716,5,32302,4.485143015828936,40.0,0.0
17202,1,7202,[318 427 515 588  79],807,5,32307,4.48521449396085,40.0,0.0
17203,1,7203,[318 427 515 588  79],716,5,32312,4.48528595224875,40.0,0.0
17204,1,7204,[186 181 405  22 228],807,5,32317,4.485357390700902,0.0,0.0
17205,1,7205,[318 427 515 588  79],807,5,32322,4.485428809325562,40.0,0.0
17206,1,7206,[318 427 515 588  79],18,5,32327,4.485500208130984,40.0,0.0
17207,1,7207,[318 427 515 588  79],716,5,32332,4.485571587125416,40.0,0.0
17208,1,7208,[318 427 515 588  79],807,5,32337,4.485642946317103,40.0,0.0
17209,1,7209,[318 427 515 588  79],716,5,32342,4.485714285714286,40.0,0.0
17210,1,7210,[318 427 515 588  79],807,5,32347,4.485785605325198,40.0,0.0
17211,1,7211,[318 427 515 588  79],807,5,32352,4.4858569051580695,40.0,0.0
17212,1,7212,[318 427 515 588  79],716,5,32357,4.485928185221129,40.0,0.0
17213,1,7213,[318 427 515 588  79],807,5,32362,4.485999445522595,40.0,0.0
17214,1,7214,[318 427 515 588  79],716,5,32367,4.486070686070686,40.0,0.0
17215,1,7215,[318 427 515 588  79],716,5,32372,4.486141906873614,40.0,0.0
17216,1,7216,[294  64 127 172 215],457,4,32376,4.486074546210337,20.0,20.0
17217,1,7217,[238 483  50  82 588],796,3,32379,4.4858686616791354,0.0,20.0
17218,1,7218,[318 427 515 588  79],716,5,32384,4.4859398808699265,40.0,0.0
17219,1,7219,[318 427 515 588  79],18,5,32389,4.48601108033241,40.0,0.0
17220,1,7220,[111 185 179 313 237],655,3,32392,4.485805290126021,0.0,0.0
17221,1,7221,[318 427 515 588  79],716,5,32397,4.485876488507339,40.0,0.0
17222,1,7222,[258 197 187  56  71],504,3,32400,4.485670773916655,0.0,0.0
17223,1,7223,[318 427 515 588  79],18,5,32405,4.485741971207087,40.0,0.0
17224,1,7224,[318 427 515 588  79],807,5,32410,4.485813148788927,40.0,0.0
17225,1,7225,[ 28 111 234 435 313],655,1,32411,4.485330750069195,0.0,0.0
17226,1,7226,[318 427 515 588  79],807,5,32416,4.485401964854019,40.0,0.0
17227,1,7227,[318 427 515 588  79],18,5,32421,4.4854731599335915,40.0,0.0
17228,1,7228,[318 427 515 588  79],18,5,32426,4.485544335316088,40.0,0.0
17229,1,7229,[568 423 121 748 603],798,3,32429,4.485338865836791,20.0,0.0
17230,1,7230,[318 427 515 588  79],18,5,32434,4.485410040105103,40.0,0.0
17231,1,7231,[357 132 200 182 202],655,3,32437,4.485204646017699,0.0,0.0
17232,1,7232,[318 427 515 588  79],807,5,32442,4.485275819162173,40.0,0.0
17233,1,7233,[286 496 313 405  69],450,5,32447,4.485346972629251,20.0,20.0
17234,1,7234,[318 427 515 588  79],716,5,32452,4.48541810642709,40.0,0.0
17235,1,7235,[318 427 515 588  79],807,5,32457,4.4854892205638475,40.0,0.0
17236,1,7236,[318 427 515 588  79],18,5,32462,4.485560315047672,40.0,0.0
17237,1,7237,[245 237 132 588  22],280,3,32465,4.485355070461454,0.0,0.0
17238,1,7238,[151 222 237 210 678],344,3,32468,4.485149882580467,0.0,0.0
17239,1,7239,[ 11 211 181  71  97],450,4,32472,4.485082872928177,0.0,0.0
17240,1,7240,[318 427 515 588  79],18,5,32477,4.485153984256319,40.0,0.0
17241,1,7241,[318 427 515 588  79],716,5,32482,4.485225075945872,40.0,0.0
17242,1,7242,[318 427 515 588  79],807,5,32487,4.48529614800497,40.0,0.0
17243,1,7243,[318 427 515 588  79],716,5,32492,4.485367200441745,40.0,0.0
17244,1,7244,[318 427 515 588  79],716,5,32497,4.48543823326432,40.0,0.0
17245,1,7245,[318 427 515 588  79],716,5,32502,4.485509246480817,40.0,0.0
17246,1,7246,[318 427 515 588  79],18,5,32507,4.485580240099352,40.0,0.0
17247,1,7247,[318 427 515 588  79],807,5,32512,4.485651214128035,40.0,0.0
17248,1,7248,[318 427 515 588  79],18,5,32517,4.485722168574976,40.0,0.0
17249,1,7249,[318 427 515 588  79],716,5,32522,4.485793103448276,40.0,0.0
17250,1,7250,[318 427 515 588  79],18,5,32527,4.4858640187560335,40.0,0.0
17251,1,7251,[318 427 515 588  79],807,5,32532,4.485934914506343,40.0,0.0
17252,1,7252,[318 427 515 588  79],807,5,32537,4.486005790707294,40.0,0.0
17253,1,7253,[318 427 515 588  79],18,5,32542,4.4860766473669695,40.0,0.0
17254,1,7254,[318 427 515 588  79],807,5,32547,4.486147484493452,40.0,0.0
17255,1,7255,[318 427 515 588  79],807,5,32552,4.486218302094818,40.0,0.0
17256,1,7256,[211 234 238 175 483],716,4,32556,4.486151302190988,0.0,0.0
17257,1,7257,[117  88  12 204 168],796,5,32561,4.4862220997519975,0.0,0.0
17258,1,7258,[202  89 117 333   4],796,5,32566,4.486292877806861,0.0,0.0
17259,1,7259,[318 427 515 588  79],18,5,32571,4.486363636363636,40.0,0.0
17260,1,7260,[237 182 191   7 183],269,2,32573,4.486021209199834,0.0,0.0
17261,1,7261,[318 427 515 588  79],716,5,32578,4.486091985678876,40.0,0.0
17262,1,7262,[318 427 515 588  79],716,5,32583,4.486162742668319,40.0,0.0
17263,1,7263,[323 588 568 333  71],796,4,32587,4.486095814977974,0.0,0.0
17264,1,7264,[125 117 301  56   8],655,0,32587,4.48547832071576,0.0,0.0
17265,1,7265,[318 427 515 588  79],716,5,32592,4.485549132947977,40.0,0.0
17266,1,7266,[ 79 300 186 328 204],450,4,32596,4.485482317324894,0.0,0.0
17267,1,7267,[318 427 515 588  79],807,5,32601,4.485553109521189,40.0,0.0
17268,1,7268,[318 427 515 588  79],807,5,32606,4.485623882239648,40.0,0.0
17269,1,7269,[168 288 222 588   4],457,5,32611,4.485694635488308,0.0,0.0
17270,1,7270,[318 427 515 588  79],716,5,32616,4.485765369275203,40.0,0.0
17271,1,7271,[318 427 515 588  79],18,5,32621,4.485836083608361,40.0,0.0
17272,1,7272,[318 427 515 588  79],807,5,32626,4.485906778495806,40.0,0.0
17273,1,7273,[318 427 515 588  79],18,5,32631,4.4859774539455595,40.0,0.0
17274,1,7274,[228 161 215   8 117],330,5,32636,4.486048109965636,0.0,0.0
17275,1,7275,[318 427 515 588  79],807,5,32641,4.486118746564046,40.0,0.0
17276,1,7276,[318 427 515 588  79],18,5,32646,4.486189363748798,40.0,0.0
17277,1,7277,[318 427 515 588  79],18,5,32651,4.486259961527892,40.0,0.0
17278,1,7278,[237 185 318  25 435],535,5,32656,4.4863305399093285,20.0,0.0
17279,1,7279,[153 117 385 197 181],504,3,32659,4.486126373626374,0.0,0.0
17280,1,7280,[318 427 515 588  79],807,5,32664,4.4861969509682735,40.0,0.0
17281,1,7281,[318 427 515 588  79],18,5,32669,4.486267508926119,40.0,0.0
17282,1,7282,[318 427 515 588  79],18,5,32674,4.486338047507895,40.0,0.0
17283,1,7283,[ 28 288 151 111  82],174,2,32676,4.485996705107084,0.0,0.0
17284,1,7284,[318 427 515 588  79],807,5,32681,4.486067261496225,40.0,0.0
17285,1,7285,[318 427 515 588  79],18,5,32686,4.4861377985177056,40.0,0.0
17286,1,7286,[588 245 194 118 151],796,4,32690,4.486071085494717,0.0,0.0
17287,1,7287,[318 427 515 588  79],18,5,32695,4.486141602634468,40.0,0.0
17288,1,7288,[318 427 515 588  79],18,5,32700,4.486212100425298,40.0,0.0
17289,1,7289,[318 427 515 588  79],18,5,32705,4.486282578875172,40.0,0.0
17290,1,7290,[  1 275 196 215 265],655,1,32706,4.485804416403785,0.0,20.0
17291,1,7291,[318 427 515 588  79],807,5,32711,4.485874931431706,40.0,0.0
17292,1,7292,[318 427 515 588  79],18,5,32716,4.485945427121898,40.0,0.0
17293,1,7293,[318 427 515 588  79],716,5,32721,4.486015903482314,40.0,0.0
17294,1,7294,[180 405 125  11  25],457,5,32726,4.486086360520905,0.0,0.0
17295,1,7295,[195 235  96  71 322],280,4,32730,4.486019736842105,0.0,0.0
17296,1,7296,[  9 143 161 237 678],401,1,32731,4.485542003563108,0.0,0.0
17297,1,7297,[318 191 194 204 186],18,3,32734,4.485338448890107,20.0,0.0
17298,1,7298,[318 427 515 588  79],807,5,32739,4.485408960131525,40.0,0.0
17299,1,7299,[357 588  82   4 135],450,2,32741,4.485068493150685,0.0,0.0
17300,1,7300,[318 427 515 588  79],18,5,32746,4.485139022051774,40.0,0.0
17301,1,7301,[318 427 515 588  79],18,5,32751,4.485209531635168,40.0,0.0
17302,1,7302,[318 427 515 588  79],807,5,32756,4.485280021908805,40.0,0.0
17303,1,7303,[405 275 211 196  71],796,4,32760,4.485213581599123,0.0,20.0
17304,1,7304,[318 427 515 588  79],18,5,32765,4.485284052019165,40.0,0.0
17305,1,7305,[318 427 515 588  79],18,5,32770,4.4853545031480975,40.0,0.0
17306,1,7306,[318 427 515 588  79],18,5,32775,4.4854249349938415,40.0,0.0
17307,1,7307,[194 182 286 210 204],629,5,32780,4.485495347564313,0.0,20.0
17308,1,7308,[238 216 179 151 202],457,5,32785,4.485565740867424,0.0,0.0
17309,1,7309,[318 427 515 588  79],716,5,32790,4.485636114911081,40.0,0.0
17310,1,7310,[135 100   7 179 215],535,4,32794,4.485569689508959,0.0,20.0
17311,1,7311,[318 427 515 588  79],807,5,32799,4.485640043763676,40.0,0.0
17312,1,7312,[318 427 515 588  79],18,5,32804,4.48571037877752,40.0,0.0
17313,1,7313,[318 427 515 588  79],18,5,32809,4.485780694558382,40.0,0.0
17314,1,7314,[ 88 496 187 322 111],796,4,32813,4.485714285714286,20.0,0.0
17315,1,7315,[318 427 515 588  79],716,5,32818,4.485784581738655,40.0,0.0
17316,1,7316,[471 276 127 187   1],786,4,32822,4.485718190515239,0.0,20.0
17317,1,7317,[318 427 515 588  79],716,5,32827,4.485788466794206,40.0,0.0
17318,1,7318,[132 282  50  71  56],280,3,32830,4.4855854624948766,0.0,20.0
17319,1,7319,[ 25 597 117 357 196],344,3,32833,4.485382513661202,0.0,0.0
17320,1,7320,[257  11 427 508 195],655,1,32834,4.484906433547329,20.0,0.0
17321,1,7321,[318 427 515 588  79],716,5,32839,4.484976782299918,40.0,0.0
17322,1,7322,[318 427 515 588  79],807,5,32844,4.48504711183941,40.0,0.0
17323,1,7323,[318 427 515 588  79],807,5,32849,4.485117422173675,40.0,0.0
17324,1,7324,[ 98 273  79 216 186],655,4,32853,4.485051194539249,0.0,0.0
17325,1,7325,[318 427 515 588  79],716,5,32858,4.485121485121486,40.0,0.0
17326,1,7326,[ 97 197 118 173 597],796,3,32861,4.48491879350348,0.0,0.0
17327,1,7327,[318 427 515 588  79],807,5,32866,4.484989082969432,40.0,0.0
17328,1,7328,[258 286 186 268 302],535,2,32868,4.484650020466639,0.0,20.0
17329,1,7329,[496 161 202 181 172],389,4,32872,4.484583901773534,20.0,0.0
17330,1,7330,[318 427 515 588  79],807,5,32877,4.484654208157141,40.0,0.0
17331,1,7331,[318 427 515 588  79],716,5,32882,4.484724495362793,40.0,0.0
17332,1,7332,[318 427 515 588  79],716,5,32887,4.4847947633983365,40.0,0.0
17333,1,7333,[318 427 515 588  79],18,5,32892,4.484865012271611,40.0,0.0
17334,1,7334,[318 427 515 588  79],716,5,32897,4.484935241990457,40.0,0.0
17335,1,7335,[318 427 515 588  79],18,5,32902,4.485005452562705,40.0,0.0
17336,1,7336,[318 427 515 588  79],716,5,32907,4.485075643996184,40.0,0.0
17337,1,7337,[318 427 515 588  79],716,5,32912,4.485145816298719,40.0,0.0
17338,1,7338,[318 427 515 588  79],807,5,32917,4.485215969478131,40.0,0.0
17339,1,7339,[318 427 515 588  79],18,5,32922,4.485286103542235,40.0,0.0
17340,1,7340,[318 427 515 588  79],807,5,32927,4.4853562184988425,40.0,0.0
17341,1,7341,[318 427 515 588  79],716,5,32932,4.485426314355761,40.0,0.0
17342,1,7342,[318 427 515 588  79],18,5,32937,4.485496391120796,40.0,0.0
17343,1,7343,[276 508 357 144 603],535,2,32939,4.4851579520697165,20.0,0.0
17344,1,7344,[318 427 515 588  79],716,5,32944,4.485228046289993,40.0,0.0
17345,1,7345,[180 191 496 405  69],796,4,32948,4.485161992921317,20.0,0.0
17346,1,7346,[318 427 515 588  79],807,5,32953,4.485232067510548,40.0,0.0
17347,1,7347,[318 427 515 588  79],807,5,32958,4.485302123026674,40.0,0.0
17348,1,7348,[318 427 515 588  79],716,5,32963,4.48537215947748,40.0,0.0
17349,1,7349,[318 427 515 588  79],716,5,32968,4.485442176870748,40.0,0.0
17350,1,7350,[318 427 515 588  79],18,5,32973,4.485512175214256,40.0,0.0
17351,1,7351,[318 427 515 588  79],716,5,32978,4.485582154515778,40.0,0.0
17352,1,7352,[318 427 515 588  79],18,5,32983,4.485652114783082,40.0,0.0
17353,1,7353,[318 427 515 588  79],18,5,32988,4.485722056023932,40.0,0.0
17354,1,7354,[318 427 515 588  79],807,5,32993,4.485791978246091,40.0,0.0
17355,1,7355,[318 427 515 588  79],716,5,32998,4.485861881457314,40.0,0.0
17356,1,7356,[318 427 515 588  79],18,5,33003,4.485931765665352,40.0,0.0
17357,1,7357,[318 427 515 588  79],18,5,33008,4.486001630877956,40.0,0.0
17358,1,7358,[318 427 515 588  79],807,5,33013,4.486071477102867,40.0,0.0
17359,1,7359,[183 125 286 185  56],450,5,33018,4.486141304347826,0.0,20.0
17360,1,7360,[143  98 210 151 245],796,3,33021,4.4859394104061945,0.0,0.0
17361,1,7361,[318 427 515 588  79],807,5,33026,4.486009236620483,40.0,0.0
17362,1,7362,[318 427 515 588  79],807,5,33031,4.4860790438679885,40.0,0.0
17363,1,7363,[318 427 515 588  79],807,5,33036,4.486148832156437,40.0,0.0
17364,1,7364,[318 427 515 588  79],18,5,33041,4.486218601493551,40.0,0.0
17365,1,7365,[318 427 515 588  79],716,5,33046,4.486288351887048,40.0,0.0
17366,1,7366,[318 427 515 588  79],807,5,33051,4.486358083344645,40.0,0.0
17367,1,7367,[318 427 515 588  79],807,5,33056,4.48642779587405,40.0,0.0
17368,1,7368,[318 427 515 588  79],716,5,33061,4.486497489482969,40.0,0.0
17369,1,7369,[318 427 515 588  79],807,5,33066,4.486567164179104,40.0,0.0
17370,1,7370,[318 427 515 588  79],807,5,33071,4.486636819970153,40.0,0.0
17371,1,7371,[318 427 515 588  79],807,5,33076,4.486706456863809,40.0,0.0
17372,1,7372,[153 196 144 204 202],716,4,33080,4.486640444866405,0.0,0.0
17373,1,7373,[143 427 385  95 204],796,5,33085,4.48671006238134,20.0,0.0
17374,1,7374,[546 185 435   4 168],151,4,33089,4.48664406779661,0.0,0.0
17375,1,7375,[318 427 515 588  79],807,5,33094,4.486713665943601,40.0,0.0
17376,1,7376,[568  50 216 121 174],693,3,33097,4.486512132303104,0.0,20.0
17377,1,7377,[318 427 515 588  79],18,5,33102,4.48658172946598,40.0,0.0
17378,1,7378,[318 427 515 588  79],807,5,33107,4.48665130776528,40.0,0.0
17379,1,7379,[318 427 515 588  79],716,5,33112,4.486720867208672,40.0,0.0
17380,1,7380,[318 427 515 588  79],18,5,33117,4.486790407803821,40.0,0.0
17381,1,7381,[318 427 515 588  79],18,5,33122,4.486859929558385,40.0,0.0
17382,1,7382,[318 427 515 588  79],807,5,33127,4.4869294324800215,40.0,0.0
17383,1,7383,[318 427 515 588  79],18,5,33132,4.486998916576382,40.0,0.0
17384,1,7384,[318 427 515 588  79],807,5,33137,4.487068381855112,40.0,0.0
17385,1,7385,[318 300 173 496 385],450,5,33142,4.487137828323856,40.0,0.0
17386,1,7386,[294  15 135  11 678],224,2,33144,4.486801137132801,0.0,0.0
17387,1,7387,[318 427 515 588  79],807,5,33149,4.486870600974553,40.0,0.0
17388,1,7388,[318 427 515 588  79],716,5,33154,4.486940046014346,40.0,0.0
17389,1,7389,[403 151 496  96 179],269,3,33157,4.486738836265223,20.0,0.0
17390,1,7390,[318 427 515 588  79],807,5,33162,4.486808280340955,40.0,0.0
17391,1,7391,[588 197 471  22 282],716,3,33165,4.486607142857143,0.0,0.0
17392,1,7392,[318 427 515 588  79],18,5,33170,4.4866765859596915,40.0,0.0
17393,1,7393,[318 427 515 588  79],716,5,33175,4.486746010278604,40.0,0.0
17394,1,7394,[318 427 515 588  79],18,5,33180,4.486815415821501,40.0,0.0
17395,1,7395,[318 427 515 588  79],716,5,33185,4.4868848025959975,40.0,0.0
17396,1,7396,[318 427 515 588  79],807,5,33190,4.486954170609707,40.0,0.0
17397,1,7397,[153 748 151 197  25],450,4,33194,4.486888348202217,0.0,0.0
17398,1,7398,[318 427 515 588  79],807,5,33199,4.486957696986079,40.0,0.0
17399,1,7399,[318 427 515 588  79],716,5,33204,4.487027027027027,40.0,0.0
17400,1,7400,[318 427 515 588  79],716,5,33209,4.487096338332658,40.0,0.0
17401,1,7401,[318 427 515 588  79],716,5,33214,4.487165630910565,40.0,0.0
17402,1,7402,[318 427 515 588  79],716,5,33219,4.4872349047683375,40.0,0.0
17403,1,7403,[318 427 515 588  79],807,5,33224,4.487304159913561,40.0,0.0
17404,1,7404,[318 427 515 588  79],716,5,33229,4.487373396353815,40.0,0.0
17405,1,7405,[318 427 515 588  79],807,5,33234,4.487442614096678,40.0,0.0
17406,1,7406,[318 427 515 588  79],807,5,33239,4.487511813149723,40.0,0.0
17407,1,7407,[300  97 286  89 210],450,4,33243,4.487446004319654,0.0,20.0
17408,1,7408,[318 427 515 588  79],18,5,33248,4.48751518423539,40.0,0.0
17409,1,7409,[318 427 515 588  79],18,5,33253,4.487584345479083,40.0,0.0
17410,1,7410,[318 427 515 588  79],716,5,33258,4.4876534880582915,40.0,0.0
17411,1,7411,[318 427 515 588  79],807,5,33263,4.487722611980572,40.0,0.0
17412,1,7412,[173 121 228 568  28],577,3,33266,4.487521920949683,0.0,0.0
17413,1,7413,[318 427 515 588  79],716,5,33271,4.487591043970866,40.0,0.0
17414,1,7414,[318 427 515 588  79],18,5,33276,4.487660148347944,40.0,0.0
17415,1,7415,[318 427 515 588  79],807,5,33281,4.487729234088458,40.0,0.0
17416,1,7416,[238 265 168 258  88],151,5,33286,4.4877983011999465,0.0,0.0
17417,1,7417,[185  64 234 357  56],450,4,33290,4.487732542464276,20.0,0.0
17418,1,7418,[318 427 515 588  79],18,5,33295,4.48780159051085,40.0,0.0
17419,1,7419,[318 427 515 588  79],716,5,33300,4.487870619946092,40.0,0.0
17420,1,7420,[ 88 172 161 471  71],786,5,33305,4.4879396307775234,0.0,0.0
17421,1,7421,[318 427 515 588  79],18,5,33310,4.488008623012665,40.0,0.0
17422,1,7422,[318 427 515 588  79],716,5,33315,4.488077596659033,40.0,0.0
17423,1,7423,[318 427 515 588  79],807,5,33320,4.488146551724138,40.0,0.0
17424,1,7424,[318 427 515 588  79],716,5,33325,4.488215488215488,40.0,0.0
17425,1,7425,[318 427 515 588  79],18,5,33330,4.488284406140587,40.0,0.0
17426,1,7426,[ 69 127  22 265 111],280,5,33335,4.4883533055069345,0.0,20.0
17427,1,7427,[318 427 515 588  79],807,5,33340,4.488422186322024,40.0,0.0
17428,1,7428,[318 427 515 588  79],716,5,33345,4.4884910485933505,40.0,0.0
17429,1,7429,[318 427 515 588  79],18,5,33350,4.488559892328398,40.0,0.0
17430,1,7430,[318 427 515 588  79],807,5,33355,4.488628717534652,40.0,0.0
17431,1,7431,[318 427 515 588  79],716,5,33360,4.488697524219591,40.0,0.0
17432,1,7432,[173 483 603  28  15],389,3,33363,4.4884972420287905,20.0,0.0
17433,1,7433,[318 427 515 588  79],18,5,33368,4.488566047888082,40.0,0.0
17434,1,7434,[318 427 515 588  79],18,5,33373,4.488634835238735,40.0,0.0
17435,1,7435,[318 427 515 588  79],807,5,33378,4.48870360408822,40.0,0.0
17436,1,7436,[175 258 121 405 202],344,2,33380,4.488368965980906,0.0,0.0
17437,1,7437,[318 427 515 588  79],18,5,33385,4.488437752083893,40.0,0.0
17438,1,7438,[318 427 515 588  79],807,5,33390,4.488506519693507,40.0,0.0
17439,1,7439,[276 515 100 135 185],269,5,33395,4.488575268817204,0.0,20.0
17440,1,7440,[ 56 496 179 423 483],389,5,33400,4.488643999462438,20.0,0.0
17441,1,7441,[318 427 515 588  79],807,5,33405,4.488712711636657,40.0,0.0
17442,1,7442,[117 228 265  64  79],256,4,33409,4.488647050920328,20.0,0.0
17443,1,7443,[318 427 515 588  79],18,5,33414,4.488715744223536,40.0,0.0
17444,1,7444,[318 427 515 588  79],807,5,33419,4.488784419073204,40.0,0.0
17445,1,7445,[318 427 515 588  79],716,5,33424,4.488853075476766,40.0,0.0
17446,1,7446,[318 427 515 588  79],18,5,33429,4.488921713441655,40.0,0.0
17447,1,7447,[318 427 515 588  79],18,5,33434,4.488990332975296,40.0,0.0
17448,1,7448,[318 427 515 588  79],807,5,33439,4.489058934085112,40.0,0.0
17449,1,7449,[194 269 258 603 186],450,4,33443,4.488993288590604,20.0,0.0
17450,1,7450,[318 427 515 588  79],716,5,33448,4.489061870889813,40.0,0.0
17451,1,7451,[318 427 515 588  79],716,5,33453,4.489130434782608,40.0,0.0
17452,1,7452,[318 427 515 588  79],18,5,33458,4.489198980276399,40.0,0.0
17453,1,7453,[318 427 515 588  79],807,5,33463,4.489267507378589,40.0,0.0
17454,1,7454,[318 427 515 588  79],716,5,33468,4.48933601609658,40.0,0.0
17455,1,7455,[318 427 515 588  79],807,5,33473,4.489404506437769,40.0,0.0
17456,1,7456,[318 427 515 588  79],716,5,33478,4.489472978409548,40.0,0.0
17457,1,7457,[318 427 515 588  79],716,5,33483,4.489541432019308,40.0,0.0
17458,1,7458,[183 197 228 471  71],450,4,33487,4.4894758010457165,0.0,0.0
17459,1,7459,[318 427 515 588  79],807,5,33492,4.489544235924933,40.0,0.0
17460,1,7460,[100 211   4 200 176],151,2,33494,4.489210561586918,0.0,20.0
17461,1,7461,[318 427 515 588  79],807,5,33499,4.4892790136692575,40.0,0.0
17462,1,7462,[318 427 515 588  79],716,5,33504,4.489347447407209,40.0,0.0
17463,1,7463,[318 427 515 588  79],807,5,33509,4.489415862808146,40.0,0.0
17464,1,7464,[318 427 515 588  79],716,5,33514,4.489484259879437,40.0,0.0
17465,1,7465,[318 427 515 588  79],716,5,33519,4.4895526386284486,40.0,0.0
17466,1,7466,[318 427 515 588  79],807,5,33524,4.4896209990625415,40.0,0.0
17467,1,7467,[318 427 515 588  79],18,5,33529,4.489689341189074,40.0,0.0
17468,1,7468,[318 427 515 588  79],807,5,33534,4.489757665015397,40.0,0.0
17469,1,7469,[318 427 515 588  79],716,5,33539,4.489825970548862,40.0,0.0
17470,1,7470,[318 427 515 588  79],18,5,33544,4.489894257796815,40.0,0.0
17471,1,7471,[333   4  56 265   9],629,4,33548,4.48982869379015,0.0,0.0
17472,1,7472,[111 655 435 161  15],655,0,33548,4.489227887060083,0.0,0.0
17473,1,7473,[180  69   8 143  88],269,0,33548,4.488627241102488,0.0,0.0
17474,1,7474,[318 427 515 588  79],716,5,33553,4.488695652173913,40.0,0.0
17475,1,7475,[318 427 515 588  79],807,5,33558,4.48876404494382,40.0,0.0
17476,1,7476,[318 427 515 588  79],18,5,33563,4.488832419419554,40.0,0.0
17477,1,7477,[318 427 515 588  79],716,5,33568,4.488900775608451,40.0,0.0
17478,1,7478,[210   7  28 191 182],72,4,33572,4.488835405802915,0.0,0.0
17479,1,7479,[318 427 515 588  79],716,5,33577,4.488903743315508,40.0,0.0
17480,1,7480,[318 427 515 588  79],716,5,33582,4.4889720625584815,40.0,0.0
17481,1,7481,[318 427 515 588  79],716,5,33587,4.489040363539161,40.0,0.0
17482,1,7482,[483 313   1 181 471],280,2,33589,4.48870773753842,0.0,0.0
17483,1,7483,[318 427 515 588  79],807,5,33594,4.488776055585249,40.0,0.0
17484,1,7484,[318 427 515 588  79],807,5,33599,4.488844355377421,40.0,0.0
17485,1,7485,[ 97  12 151 238 322],796,2,33601,4.488511888859204,0.0,0.0
17486,1,7486,[357 427 655 143  96],796,4,33605,4.4884466408441295,20.0,0.0
17487,1,7487,[135  69 276 237  97],401,2,33607,4.488114316239316,0.0,0.0
17488,1,7488,[ 79 385  70 197  89],457,5,33612,4.488182667912939,0.0,0.0
17489,1,7489,[318 427 515 588  79],716,5,33617,4.488251001335113,40.0,0.0
17490,1,7490,[318 427 515 588  79],18,5,33622,4.488319316513149,40.0,0.0
17491,1,7491,[427 100  89 175  22],18,4,33626,4.48825413774693,20.0,20.0
17492,1,7492,[176 216 357 191 588],835,4,33630,4.488188976377953,0.0,0.0
17493,1,7493,[568  89  56 508 271],655,1,33631,4.487723512143048,0.0,0.0
17494,1,7494,[318 427 515 588  79],716,5,33636,4.487791861240828,40.0,0.0
17495,1,7495,[748 197 118 200 161],450,3,33639,4.487593383137673,0.0,0.0
17496,1,7496,[318 427 515 588  79],807,5,33644,4.487661731359211,40.0,0.0
17497,1,7497,[318 427 515 588  79],18,5,33649,4.487730061349693,40.0,0.0
17498,1,7498,[318 427 515 588  79],716,5,33654,4.487798373116416,40.0,0.0
17499,1,7499,[318 427 515 588  79],807,5,33659,4.487866666666666,40.0,0.0
17500,1,7500,[318 427 515 588  79],18,5,33664,4.487934942007732,40.0,0.0
17501,1,7501,[ 96  28 144 515  25],716,3,33667,4.4877366035723805,0.0,0.0
17502,1,7502,[318 427 515 588  79],18,5,33672,4.487804878048781,40.0,0.0
17503,1,7503,[ 88  89   7   8 300],655,1,33673,4.487340085287847,0.0,0.0
17504,1,7504,[194 423  50  11 257],457,4,33677,4.487275149900067,0.0,20.0
17505,1,7505,[318 427 515 588  79],807,5,33682,4.48734345856648,40.0,0.0
17506,1,7506,[318 427 515 588  79],18,5,33687,4.4874117490342345,40.0,0.0
17507,1,7507,[318 427 515 588  79],807,5,33692,4.487480021310602,40.0,0.0
17508,1,7508,[318 427 515 588  79],807,5,33697,4.48754827540285,40.0,0.0
17509,1,7509,[318 427 515 588  79],18,5,33702,4.487616511318242,40.0,0.0
17510,1,7510,[318 427 515 588  79],716,5,33707,4.487684729064039,40.0,0.0
17511,1,7511,[318 427 515 588  79],716,5,33712,4.487752928647497,40.0,0.0
17512,1,7512,[282   7 508 121 127],15,0,33712,4.48715559696526,0.0,20.0
17513,1,7513,[318 427 515 588  79],716,5,33717,4.487223848815544,40.0,0.0
17514,1,7514,[210 125 195 100 546],796,3,33720,4.487025948103793,0.0,20.0
17515,1,7515,[318 427 515 588  79],807,5,33725,4.487094199042043,40.0,0.0
17516,1,7516,[210 191 603 172 568],269,2,33727,4.486763336437408,20.0,0.0
17517,1,7517,[318 427 515 588  79],18,5,33732,4.48683160415004,40.0,0.0
17518,1,7518,[318 427 515 588  79],716,5,33737,4.48689985370395,40.0,0.0
17519,1,7519,[318 427 515 588  79],18,5,33742,4.486968085106383,40.0,0.0
17520,1,7520,[318 427 515 588  79],716,5,33747,4.487036298364579,40.0,0.0
17521,1,7521,[238 186 286   7 179],450,4,33751,4.486971550119649,0.0,20.0
17522,1,7522,[318 427 515 588  79],18,5,33756,4.487039744782667,40.0,0.0
17523,1,7523,[318 427 515 588  79],716,5,33761,4.487107921318447,40.0,0.0
17524,1,7524,[ 70  11 176  79 216],655,2,33763,4.486777408637874,0.0,0.0
17525,1,7525,[318 427 515 588  79],716,5,33768,4.486845601913367,40.0,0.0
17526,1,7526,[318 427 515 588  79],807,5,33773,4.486913777069217,40.0,0.0
17527,1,7527,[215 286 172 117  88],450,5,33778,4.486981934112646,0.0,20.0
17528,1,7528,[286 182 187   7  97],655,2,33780,4.486651613760127,0.0,20.0
17529,1,7529,[237 161 181 172 143],716,4,33784,4.486586985391766,0.0,0.0
17530,1,7530,[318 427 515 588  79],716,5,33789,4.486655158677467,40.0,0.0
17531,1,7531,[318 427 515 588  79],716,5,33794,4.48672331386086,40.0,0.0
17532,1,7532,[318 427 515 588  79],807,5,33799,4.486791450949157,40.0,0.0
17533,1,7533,[318 427 515 588  79],18,5,33804,4.486859569949562,40.0,0.0
17534,1,7534,[318 427 515 588  79],716,5,33809,4.486927670869277,40.0,0.0
17535,1,7535,[318 427 515 588  79],807,5,33814,4.486995753715499,40.0,0.0
17536,1,7536,[318 427 515 588  79],18,5,33819,4.487063818495423,40.0,0.0
17537,1,7537,[318 427 515 588  79],18,5,33824,4.487131865216238,40.0,0.0
17538,1,7538,[300 245   9 269 301],204,3,33827,4.486934606711766,0.0,0.0
17539,1,7539,[546 202  97 357  28],796,3,33830,4.486737400530504,0.0,0.0
17540,1,7540,[318 427 515 588  79],716,5,33835,4.486805463466384,40.0,0.0
17541,1,7541,[318 427 515 588  79],807,5,33840,4.486873508353222,40.0,0.0
17542,1,7542,[257 597  25 258 742],457,3,33843,4.486676388704759,0.0,0.0
17543,1,7543,[318 427 515 588  79],716,5,33848,4.486744432661718,40.0,0.0
17544,1,7544,[318 427 515 588  79],18,5,33853,4.486812458581842,40.0,0.0
17545,1,7545,[132 153 237 172  25],716,5,33858,4.486880466472303,0.0,0.0
17546,1,7546,[318 427 515 588  79],716,5,33863,4.486948456340268,40.0,0.0
17547,1,7547,[318 427 515 588  79],807,5,33868,4.487016428192899,40.0,0.0
17548,1,7548,[318 427 515 588  79],18,5,33873,4.487084382037356,40.0,0.0
17549,1,7549,[318 427 515 588  79],807,5,33878,4.487152317880795,40.0,0.0
17550,1,7550,[318 427 515 588  79],716,5,33883,4.4872202357303665,40.0,0.0
17551,1,7551,[318 427 515 588  79],807,5,33888,4.487288135593221,40.0,0.0
17552,1,7552,[318 427 515 588  79],807,5,33893,4.4873560174764995,40.0,0.0
17553,1,7553,[318 427 515 588  79],807,5,33898,4.487423881387344,40.0,0.0
17554,1,7554,[237 435 403 318 197],655,1,33899,4.486962276637988,20.0,0.0
17555,1,7555,[318 427 515 588  79],18,5,33904,4.487030174695606,40.0,0.0
17556,1,7556,[318 427 515 588  79],716,5,33909,4.487098054783644,40.0,0.0
17557,1,7557,[318 427 515 588  79],18,5,33914,4.487165916909235,40.0,0.0
17558,1,7558,[318 427 515 588  79],716,5,33919,4.487233761079508,40.0,0.0
17559,1,7559,[318 427 515 588  79],716,5,33924,4.487301587301587,40.0,0.0
17560,1,7560,[238  70  96 168  22],716,4,33928,4.4872371379447165,0.0,0.0
17561,1,7561,[  7 357 181  88 200],151,4,33932,4.48717270563343,0.0,0.0
17562,1,7562,[318 427 515 588  79],716,5,33937,4.487240513023933,40.0,0.0
17563,1,7563,[318 427 515 588  79],18,5,33942,4.487308302485458,40.0,0.0
17564,1,7564,[318 427 515 588  79],716,5,33947,4.487376074025116,40.0,0.0
17565,1,7565,[143 117  69 179 742],457,5,33952,4.487443827650013,0.0,0.0
17566,1,7566,[100 597 111 196 405],457,3,33955,4.4872472578300515,0.0,20.0
17567,1,7567,[318 427 515 588  79],716,5,33960,4.487315010570825,40.0,0.0
17568,1,7568,[318 427 515 588  79],807,5,33965,4.487382745408905,40.0,0.0
17569,1,7569,[318 427 515 588  79],807,5,33970,4.487450462351387,40.0,0.0
17570,1,7570,[318 427 515 588  79],18,5,33975,4.4875181614053625,40.0,0.0
17571,1,7571,[318 427 515 588  79],807,5,33980,4.487585842577919,40.0,0.0
17572,1,7572,[318 427 515 588  79],18,5,33985,4.487653505876139,40.0,0.0
17573,1,7573,[318 427 515 588  79],18,5,33990,4.487721151307103,40.0,0.0
17574,1,7574,[742 265 210  11 121],450,3,33993,4.487524752475248,0.0,0.0
17575,1,7575,[318 427 515 588  79],807,5,33998,4.4875923970432945,40.0,0.0
17576,1,7576,[318 427 515 588  79],716,5,34003,4.487660023756104,40.0,0.0
17577,1,7577,[318 427 515 588  79],716,5,34008,4.487727632620745,40.0,0.0
17578,1,7578,[318 427 515 588  79],807,5,34013,4.48779522364428,40.0,0.0
17579,1,7579,[318 427 515 588  79],716,5,34018,4.487862796833773,40.0,0.0
17580,1,7580,[179 111 276  79 185],655,4,34022,4.487798443477113,0.0,0.0
17581,1,7581,[300 655 742 195 475],655,0,34022,4.487206541809549,0.0,0.0
17582,1,7582,[318 427 515 588  79],716,5,34027,4.487274165897402,40.0,0.0
17583,1,7583,[ 64 153 185  28 144],450,5,34032,4.487341772151899,20.0,0.0
17584,1,7584,[318 427 515 588  79],807,5,34037,4.487409360580092,40.0,0.0
17585,1,7585,[111 588 200 174   7],450,4,34041,4.487345109412075,0.0,0.0
17586,1,7586,[318 427 515 588  79],807,5,34046,4.487412679583498,40.0,0.0
17587,1,7587,[318 427 515 588  79],716,5,34051,4.4874802319451765,40.0,0.0
17588,1,7588,[174  97 276  11 118],457,5,34056,4.487547766504151,0.0,0.0
17589,1,7589,[318 427 515 588  79],18,5,34061,4.487615283267457,40.0,0.0
17590,1,7590,[318 427 515 588  79],807,5,34066,4.487682782242129,40.0,0.0
17591,1,7591,[318 427 515 588  79],18,5,34071,4.487750263435195,40.0,0.0
17592,1,7592,[318 427 515 588  79],18,5,34076,4.487817726853681,40.0,0.0
17593,1,7593,[210 172 182 168 117],450,4,34080,4.487753489597051,0.0,0.0
17594,1,7594,[568 238 100  69 427],269,3,34083,4.487557603686636,20.0,20.0
17595,1,7595,[318 427 515 588  79],716,5,34088,4.487625065824118,40.0,0.0
17596,1,7596,[318 427 515 588  79],807,5,34093,4.487692510201395,40.0,0.0
17597,1,7597,[318 427 515 588  79],18,5,34098,4.487759936825481,40.0,0.0
17598,1,7598,[196  88 210 313 357],655,2,34100,4.487432556915383,0.0,0.0
17599,1,7599,[318 427 515 588  79],716,5,34105,4.4875,40.0,0.0
17600,1,7600,[318 427 515 588  79],716,5,34110,4.487567425338772,40.0,0.0
17601,1,7601,[204 174 385 568 655],716,4,34114,4.487503288608261,0.0,0.0
17602,1,7602,[ 50 300 228 588  95],450,4,34118,4.487439168749178,0.0,20.0
17603,1,7603,[265 100 471 174 195],450,5,34123,4.487506575486586,0.0,20.0
17604,1,7604,[301 405 143 180 194],796,3,34126,4.487310979618672,0.0,0.0
17605,1,7605,[318 427 515 588  79],807,5,34131,4.487378385485143,40.0,0.0
17606,1,7606,[318 427 515 588  79],18,5,34136,4.487445773629552,40.0,0.0
17607,1,7607,[318 427 515 588  79],716,5,34141,4.487513144058886,40.0,0.0
17608,1,7608,[318 427 515 588  79],807,5,34146,4.4875804967801285,40.0,0.0
17609,1,7609,[318 427 515 588  79],716,5,34151,4.487647831800262,40.0,0.0
17610,1,7610,[318 427 515 588  79],716,5,34156,4.487715149126265,40.0,0.0
17611,1,7611,[318 427 515 588  79],18,5,34161,4.487782448765108,40.0,0.0
17612,1,7612,[318 427 515 588  79],18,5,34166,4.487849730723762,40.0,0.0
17613,1,7613,[118 546 176 483 427],716,2,34168,4.487522983976885,20.0,0.0
17614,1,7614,[153 405  15 357 237],269,1,34169,4.487065003282994,0.0,0.0
17615,1,7615,[318 427 515 588  79],716,5,34174,4.487132352941177,40.0,0.0
17616,1,7616,[318 427 515 588  79],18,5,34179,4.487199684915321,40.0,0.0
17617,1,7617,[318 427 515 588  79],716,5,34184,4.487266999212392,40.0,0.0
17618,1,7618,[318 427 515 588  79],18,5,34189,4.487334295839349,40.0,0.0
17619,1,7619,[172 328 257 144  11],655,1,34190,4.486876640419948,0.0,0.0
17620,1,7620,[318 427 515 588  79],716,5,34195,4.486943970607532,40.0,0.0
17621,1,7621,[385 180  96 471 135],716,0,34195,4.486355287326161,0.0,0.0
17622,1,7622,[237 282  28 186 496],716,3,34198,4.486160304342122,20.0,0.0
17623,1,7623,[286 471 546 182 179],593,2,34200,4.4858342077649525,0.0,20.0
17624,1,7624,[318 427 515 588  79],18,5,34205,4.485901639344262,40.0,0.0
17625,1,7625,[318 427 515 588  79],18,5,34210,4.48596905323892,40.0,0.0
17626,1,7626,[318 427 515 588  79],18,5,34215,4.48603644945588,40.0,0.0
17627,1,7627,[318 427 515 588  79],807,5,34220,4.486103828002098,40.0,0.0
17628,1,7628,[318 427 515 588  79],807,5,34225,4.486171188884519,40.0,0.0
17629,1,7629,[318 427 515 588  79],18,5,34230,4.486238532110092,40.0,0.0
17630,1,7630,[318 427 515 588  79],18,5,34235,4.486305857685755,40.0,0.0
17631,1,7631,[318 427 515 588  79],807,5,34240,4.486373165618448,40.0,0.0
17632,1,7632,[318 427 515 588  79],716,5,34245,4.486440455915106,40.0,0.0
17633,1,7633,[318 427 515 588  79],807,5,34250,4.486507728582657,40.0,0.0
17634,1,7634,[318 427 515 588  79],18,5,34255,4.486574983628029,40.0,0.0
17635,1,7635,[318 427 515 588  79],807,5,34260,4.486642221058146,40.0,0.0
17636,1,7636,[318 427 515 588  79],716,5,34265,4.486709440879927,40.0,0.0
17637,1,7637,[318 427 515 588  79],807,5,34270,4.4867766431002885,40.0,0.0
17638,1,7638,[237 742 182  28 117],450,5,34275,4.486843827726142,0.0,0.0
17639,1,7639,[318 427 515 588  79],807,5,34280,4.486910994764398,40.0,0.0
17640,1,7640,[318 427 515 588  79],807,5,34285,4.48697814422196,40.0,0.0
17641,1,7641,[318 427 515 588  79],716,5,34290,4.487045276105731,40.0,0.0
17642,1,7642,[318 427 515 588  79],716,5,34295,4.487112390422609,40.0,0.0
17643,1,7643,[161 322 172 333 183],796,4,34299,4.487048665620094,0.0,0.0
17644,1,7644,[111 282 125 742 301],655,0,34299,4.48646173969915,0.0,0.0
17645,1,7645,[143  50 318 186 313],655,4,34303,4.486398116662307,20.0,20.0
17646,1,7646,[318 427 515 588  79],807,5,34308,4.486465280502157,40.0,0.0
17647,1,7647,[318 427 515 588  79],807,5,34313,4.4865324267782425,40.0,0.0
17648,1,7648,[318 427 515 588  79],18,5,34318,4.486599555497451,40.0,0.0
17649,1,7649,[318 427 515 588  79],716,5,34323,4.486666666666666,40.0,0.0
17650,1,7650,[318 427 515 588  79],716,5,34328,4.486733760292772,40.0,0.0
17651,1,7651,[275  12   9 603 286],707,3,34331,4.486539466806064,20.0,40.0
17652,1,7652,[318 427 515 588  79],807,5,34336,4.486606559519143,40.0,0.0
17653,1,7653,[318 427 515 588  79],18,5,34341,4.48667363470081,40.0,0.0
17654,1,7654,[191 496   8 265 568],796,5,34346,4.486740692357936,20.0,0.0
17655,1,7655,[318 427 515 588  79],18,5,34351,4.486807732497388,40.0,0.0
17656,1,7656,[318 427 515 588  79],18,5,34356,4.486874755126029,40.0,0.0
17657,1,7657,[121  25 187 234  82],504,3,34359,4.4866805954557325,0.0,0.0
17658,1,7658,[318 427 515 588  79],807,5,34364,4.4867476171824,40.0,0.0
17659,1,7659,[318 427 515 588  79],18,5,34369,4.486814621409922,40.0,0.0
17660,1,7660,[318 427 515 588  79],807,5,34374,4.486881608145151,40.0,0.0
17661,1,7661,[318 427 515 588  79],18,5,34379,4.486948577394936,40.0,0.0
17662,1,7662,[318 427 515 588  79],18,5,34384,4.487015529166123,40.0,0.0
17663,1,7663,[318 427 515 588  79],807,5,34389,4.487082463465553,40.0,0.0
17664,1,7664,[318 427 515 588  79],716,5,34394,4.487149380300065,40.0,0.0
17665,1,7665,[318 427 515 588  79],807,5,34399,4.487216279676494,40.0,0.0
17666,1,7666,[204 161 678 117 202],401,2,34401,4.486891874266337,0.0,0.0
17667,1,7667,[318 427 515 588  79],807,5,34406,4.4869587897756915,40.0,0.0
17668,1,7668,[318 427 515 588  79],716,5,34411,4.487025687834137,40.0,0.0
17669,1,7669,[ 89   9 234 186 222],786,4,34415,4.4869621903520205,0.0,0.0
17670,1,7670,[318 427 515 588  79],716,5,34420,4.487029070525355,40.0,0.0
17671,1,7671,[318 427 515 588  79],807,5,34425,4.4870959332638165,40.0,0.0
17672,1,7672,[318 427 515 588  79],18,5,34430,4.487162778574222,40.0,0.0
17673,1,7673,[318 427 515 588  79],807,5,34435,4.487229606463383,40.0,0.0
17674,1,7674,[508 196 234 435 186],655,0,34435,4.4866449511400655,0.0,0.0
17675,1,7675,[318 427 515 588  79],18,5,34440,4.486711829077644,40.0,0.0
17676,1,7676,[318 427 515 588  79],716,5,34445,4.486778689592288,40.0,0.0
17677,1,7677,[265 323 111 245  79],280,3,34448,4.4865850481896326,0.0,0.0
17678,1,7678,[195  15 483  70 496],18,4,34452,4.486521682510744,20.0,0.0
17679,1,7679,[318 427 515 588  79],18,5,34457,4.486588541666666,40.0,0.0
17680,1,7680,[318 427 515 588  79],18,5,34462,4.486655383413618,40.0,0.0
17681,1,7681,[318 427 515 588  79],807,5,34467,4.486722207758397,40.0,0.0
17682,1,7682,[288 121 603 228 403],450,3,34470,4.486528699726669,20.0,0.0
17683,1,7683,[ 71 144 100  69  70],450,4,34474,4.486465382613222,0.0,20.0
17684,1,7684,[153 183 515 144  11],292,5,34479,4.486532205595315,0.0,0.0
17685,1,7685,[318 427 515 588  79],807,5,34484,4.486599011189175,40.0,0.0
17686,1,7686,[318 427 515 588  79],716,5,34489,4.486665799401587,40.0,0.0
17687,1,7687,[318 427 515 588  79],716,5,34494,4.486732570239334,40.0,0.0
17688,1,7688,[ 69 483   8 111 173],152,5,34499,4.486799323709195,0.0,0.0
17689,1,7689,[318 427 515 588  79],18,5,34504,4.486866059817945,40.0,0.0
17690,1,7690,[318 427 515 588  79],807,5,34509,4.486932778572357,40.0,0.0
17691,1,7691,[318 427 515 588  79],807,5,34514,4.4869994799791995,40.0,0.0
17692,1,7692,[318 427 515 588  79],807,5,34519,4.487066164045236,40.0,0.0
17693,1,7693,[318 427 515 588  79],807,5,34524,4.487132830777229,40.0,0.0
17694,1,7694,[318 427 515 588  79],716,5,34529,4.487199480181936,40.0,0.0
17695,1,7695,[318 427 515 588  79],807,5,34534,4.487266112266112,40.0,0.0
17696,1,7696,[318 427 515 588  79],716,5,34539,4.487332727036508,40.0,0.0
17697,1,7697,[318 427 515 588  79],807,5,34544,4.4873993244998704,40.0,0.0
17698,1,7698,[318 427 515 588  79],716,5,34549,4.487465904662943,40.0,0.0
17699,1,7699,[318 427 515 588  79],18,5,34554,4.487532467532468,40.0,0.0
17700,1,7700,[318 427 515 588  79],807,5,34559,4.4875990131151795,40.0,0.0
17701,1,7701,[302 471 300 483 333],655,2,34561,4.4872760321994285,0.0,0.0
17702,1,7702,[318 427 515 588  79],18,5,34566,4.487342593794626,40.0,0.0
17703,1,7703,[318 427 515 588  79],18,5,34571,4.487409138110072,40.0,0.0
17704,1,7704,[318 427 515 588  79],807,5,34576,4.487475665152498,40.0,0.0
17705,1,7705,[318 427 515 588  79],807,5,34581,4.487542174928627,40.0,0.0
17706,1,7706,[318 427 515 588  79],18,5,34586,4.48760866744518,40.0,0.0
17707,1,7707,[318 427 515 588  79],18,5,34591,4.4876751427088735,40.0,0.0
17708,1,7708,[318 427 515 588  79],716,5,34596,4.487741600726424,40.0,0.0
17709,1,7709,[ 98   8 196   7 181],577,4,34600,4.487678339818418,0.0,0.0
17710,1,7710,[357 144 182 655  15],655,2,34602,4.487355725586824,0.0,0.0
17711,1,7711,[318 427 515 588  79],807,5,34607,4.487422199170124,40.0,0.0
17712,1,7712,[318 427 515 588  79],18,5,34612,4.48748865551666,40.0,0.0
17713,1,7713,[318 427 515 588  79],716,5,34617,4.487555094633135,40.0,0.0
17714,1,7714,[318 427 515 588  79],807,5,34622,4.487621516526247,40.0,0.0
17715,1,7715,[228 496 211   1 111],716,5,34627,4.487687921202696,20.0,0.0
17716,1,7716,[175 197 238 294 588],716,4,34631,4.487624724633925,0.0,0.0
17717,1,7717,[318 427 515 588  79],807,5,34636,4.487691111686965,40.0,0.0
17718,1,7718,[318 427 515 588  79],716,5,34641,4.4877574815390595,40.0,0.0
17719,1,7719,[195 301 273 172  96],344,5,34646,4.487823834196891,0.0,0.0
17720,1,7720,[318 427 515 588  79],807,5,34651,4.487890169667142,40.0,0.0
17721,1,7721,[318 427 515 588  79],716,5,34656,4.487956487956488,40.0,0.0
17722,1,7722,[ 82 427   9 234 235],269,2,34658,4.48763433898744,20.0,0.0
17723,1,7723,[318 427 515 588  79],807,5,34663,4.487700673226308,40.0,0.0
17724,1,7724,[185 286  11 135 132],450,4,34667,4.487637540453075,0.0,20.0
17725,1,7725,[318 427 515 588  79],807,5,34672,4.487703857105876,40.0,0.0
17726,1,7726,[318 427 515 588  79],807,5,34677,4.487770156593762,40.0,0.0
17727,1,7727,[318 427 515 588  79],18,5,34682,4.487836438923395,40.0,0.0
17728,1,7728,[318 427 515 588  79],18,5,34687,4.487902704101436,40.0,0.0
17729,1,7729,[318 427 515 588  79],716,5,34692,4.4879689521345405,40.0,0.0
17730,1,7730,[423 100  12 238 748],151,3,34695,4.487776484284051,0.0,20.0
17731,1,7731,[318 427 515 588  79],716,5,34700,4.487842731505432,40.0,0.0
17732,1,7732,[318 427 515 588  79],807,5,34705,4.487908961593172,40.0,0.0
17733,1,7733,[318 427 515 588  79],18,5,34710,4.487975174553918,40.0,0.0
17734,1,7734,[215  96 183 238 210],504,3,34713,4.487782805429864,0.0,0.0
17735,1,7735,[318 427 515 588  79],716,5,34718,4.487849017580145,40.0,0.0
17736,1,7736,[318 196 603 200 322],151,3,34721,4.4876567144888195,40.0,0.0
17737,1,7737,[318 427 515 588  79],18,5,34726,4.487722925820625,40.0,0.0
17738,1,7738,[318 427 515 588  79],18,5,34731,4.487789120041349,40.0,0.0
17739,1,7739,[318 427 515 588  79],807,5,34736,4.487855297157623,40.0,0.0
17740,1,7740,[318 427 515 588  79],807,5,34741,4.487921457176076,40.0,0.0
17741,1,7741,[318 427 515 588  79],807,5,34746,4.487987600103333,40.0,0.0
17742,1,7742,[318 427 515 588  79],716,5,34751,4.488053725946016,40.0,0.0
17743,1,7743,[318 427 515 588  79],807,5,34756,4.488119834710743,40.0,0.0
17744,1,7744,[318 427 515 588  79],716,5,34761,4.488185926404132,40.0,0.0
17745,1,7745,[318 427 515 588  79],18,5,34766,4.488252001032791,40.0,0.0
17746,1,7746,[318 427 515 588  79],716,5,34771,4.488318058603331,40.0,0.0
17747,1,7747,[ 96 151 118  22   9],457,5,34776,4.488384099122354,0.0,0.0
17748,1,7748,[318 427 515 588  79],716,5,34781,4.488450122596464,40.0,0.0
17749,1,7749,[ 50 276 204  79 603],655,4,34785,4.4883870967741935,20.0,20.0
17750,1,7750,[318 427 515 588  79],716,5,34790,4.488453102825442,40.0,0.0
17751,1,7751,[483 173  28 302  96],450,4,34794,4.488390092879257,0.0,0.0
17752,1,7752,[318 427 515 588  79],18,5,34799,4.488456081516833,40.0,0.0
17753,1,7753,[318 427 515 588  79],807,5,34804,4.488522053133867,40.0,0.0
17754,1,7754,[328 322 258 132 282],796,4,34808,4.4884590586718245,0.0,0.0
17755,1,7755,[655  95 483   4  12],450,2,34810,4.488138215575039,0.0,0.0
17756,1,7756,[318 427 515 588  79],807,5,34815,4.488204202655666,40.0,0.0
17757,1,7757,[318 427 515 588  79],807,5,34820,4.4882701727249295,40.0,0.0
17758,1,7758,[318 427 515 588  79],716,5,34825,4.488336125789406,40.0,0.0
17759,1,7759,[318 427 515 588  79],716,5,34830,4.48840206185567,40.0,0.0
17760,1,7760,[318 427 515 588  79],18,5,34835,4.4884679809302925,40.0,0.0
17761,1,7761,[318 427 515 588  79],807,5,34840,4.488533883019841,40.0,0.0
17762,1,7762,[318 427 515 588  79],716,5,34845,4.488599768130877,40.0,0.0
17763,1,7763,[318 427 515 588  79],807,5,34850,4.488665636269964,40.0,0.0
17764,1,7764,[ 28 269  22 197 200],796,2,34852,4.4883451384417254,0.0,0.0
17765,1,7765,[318 427 515 588  79],716,5,34857,4.488411022405357,40.0,0.0
17766,1,7766,[318 427 515 588  79],716,5,34862,4.488476889403889,40.0,0.0
17767,1,7767,[318 427 515 588  79],18,5,34867,4.488542739443872,40.0,0.0
17768,1,7768,[132 546 588  79 655],716,4,34871,4.488479855837302,0.0,0.0
17769,1,7769,[ 12 300 405 427 168],450,5,34876,4.488545688545688,20.0,0.0
17770,1,7770,[318 427 515 588  79],716,5,34881,4.488611504310899,40.0,0.0
17771,1,7771,[161 258   8 200  12],796,5,34886,4.488677303139475,0.0,0.0
17772,1,7772,[318 427 515 588  79],716,5,34891,4.488743085037952,40.0,0.0
17773,1,7773,[318 427 515 588  79],807,5,34896,4.488808850012863,40.0,0.0
17774,1,7774,[318 427 515 588  79],807,5,34901,4.48887459807074,40.0,0.0
17775,1,7775,[318 427 515 588  79],18,5,34906,4.488940329218107,40.0,0.0
17776,1,7776,[318 427 515 588  79],716,5,34911,4.489006043461489,40.0,0.0
17777,1,7777,[204 181 423 228  22],330,5,34916,4.489071740807406,0.0,0.0
17778,1,7778,[318 427 515 588  79],716,5,34921,4.489137421262373,40.0,0.0
17779,1,7779,[318 427 515 588  79],807,5,34926,4.489203084832905,40.0,0.0
17780,1,7780,[204   8 125  11 313],577,4,34930,4.489140213340187,0.0,0.0
17781,1,7781,[318 427 515 588  79],18,5,34935,4.489205859676176,40.0,0.0
17782,1,7782,[318 427 515 588  79],807,5,34940,4.489271489143004,40.0,0.0
17783,1,7783,[ 70  56 186 200 300],450,3,34943,4.489080164439876,0.0,0.0
17784,1,7784,[318 427 515 588  79],18,5,34948,4.489145793192036,40.0,0.0
17785,1,7785,[318 427 515 588  79],716,5,34953,4.489211405086052,40.0,0.0
17786,1,7786,[238  88  64 742 515],655,2,34955,4.488891742648003,20.0,0.0
17787,1,7787,[318 427 515 588  79],18,5,34960,4.488957370313303,40.0,0.0
17788,1,7788,[318 427 515 588  79],807,5,34965,4.48902298112723,40.0,0.0
17789,1,7789,[318 427 515 588  79],807,5,34970,4.489088575096277,40.0,0.0
17790,1,7790,[318 427 515 588  79],716,5,34975,4.489154152226929,40.0,0.0
17791,1,7791,[318 427 515 588  79],807,5,34980,4.489219712525667,40.0,0.0
17792,1,7792,[318 427 515 588  79],18,5,34985,4.489285255998974,40.0,0.0
17793,1,7793,[318 427 515 588  79],807,5,34990,4.489350782653323,40.0,0.0
17794,1,7794,[318 427 515 588  79],716,5,34995,4.489416292495189,40.0,0.0
17795,1,7795,[258 216  88 318   8],11,3,34998,4.489225243714725,20.0,0.0
17796,1,7796,[318 427 515 588  79],716,5,35003,4.489290752853662,40.0,0.0
17797,1,7797,[ 89 172  11 294 435],655,2,35005,4.488971531161837,0.0,0.0
17798,1,7798,[318 427 515 588  79],716,5,35010,4.489037056032824,40.0,0.0
17799,1,7799,[238 100 202  56 180],450,5,35015,4.489102564102564,0.0,20.0
17800,1,7800,[318 427 515 588  79],18,5,35020,4.489168055377515,40.0,0.0
17801,1,7801,[318 427 515 588  79],716,5,35025,4.489233529864137,40.0,0.0
17802,1,7802,[318 427 515 588  79],716,5,35030,4.489298987568883,40.0,0.0
17803,1,7803,[318 427 515 588  79],807,5,35035,4.489364428498206,40.0,0.0
17804,1,7804,[318 427 515 588  79],716,5,35040,4.489429852658552,40.0,0.0
17805,1,7805,[318 427 515 588  79],716,5,35045,4.4894952600563665,40.0,0.0
17806,1,7806,[318 427 515 588  79],716,5,35050,4.489560650698092,40.0,0.0
17807,1,7807,[265 471  64 475 318],655,2,35052,4.489241803278689,40.0,0.0
17808,1,7808,[318 427 515 588  79],716,5,35057,4.4893072096299145,40.0,0.0
17809,1,7809,[ 25 568  71   8  79],593,3,35060,4.489116517285531,0.0,0.0
17810,1,7810,[ 25  96 302 228  70],344,4,35064,4.489053898348483,0.0,0.0
17811,1,7811,[195  50 294 211 228],796,3,35067,4.488863287250384,0.0,20.0
17812,1,7812,[318 427 515 588  79],18,5,35072,4.488928708562652,40.0,0.0
17813,1,7813,[ 97 180 174 294 211],796,1,35073,4.488482211415408,0.0,0.0
17814,1,7814,[508   7 403  79   8],280,3,35076,4.4882917466410746,0.0,0.0
17815,1,7815,[318 427 515 588  79],716,5,35081,4.4883572159672465,40.0,0.0
17816,1,7816,[318 427 515 588  79],18,5,35086,4.48842266854292,40.0,0.0
17817,1,7817,[318 427 515 588  79],716,5,35091,4.48848810437452,40.0,0.0
17818,1,7818,[318 427 515 588  79],807,5,35096,4.488553523468474,40.0,0.0
17819,1,7819,[318 427 515 588  79],716,5,35101,4.488618925831202,40.0,0.0
17820,1,7820,[100 172 194   4 176],796,4,35105,4.488556450581767,0.0,20.0
17821,1,7821,[153 313 273 183 228],655,3,35108,4.488366146765533,0.0,0.0
17822,1,7822,[318 427 515 588  79],716,5,35113,4.488431547999489,40.0,0.0
17823,1,7823,[288  88 181  82 153],504,2,35115,4.488113496932515,0.0,0.0
17824,1,7824,[405 215 204 318  82],151,2,35117,4.48779552715655,20.0,0.0
17825,1,7825,[318 427 515 588  79],807,5,35122,4.487860976233069,40.0,0.0
17826,1,7826,[318 427 515 588  79],18,5,35127,4.487926408585665,40.0,0.0
17827,1,7827,[318 427 515 588  79],807,5,35132,4.487991824220746,40.0,0.0
17828,1,7828,[318 427 515 588  79],716,5,35137,4.488057223144718,40.0,0.0
17829,1,7829,[318 427 515 588  79],18,5,35142,4.488122605363984,40.0,0.0
17830,1,7830,[265 180 427  15 597],796,4,35146,4.48806027327289,20.0,0.0
17831,1,7831,[318 427 515 588  79],716,5,35151,4.4881256384065376,40.0,0.0
17832,1,7832,[175  97  22 121  98],655,1,35152,4.487680326822418,0.0,0.0
17833,1,7833,[318 427 515 588  79],18,5,35157,4.48774572376819,40.0,0.0
17834,1,7834,[318 427 515 588  79],807,5,35162,4.487811104020421,40.0,0.0
17835,1,7835,[318 427 515 588  79],716,5,35167,4.487876467585503,40.0,0.0
17836,1,7836,[318 427 515 588  79],807,5,35172,4.487941814469822,40.0,0.0
17837,1,7837,[175 161  88 117 197],655,0,35172,4.487369226843582,0.0,0.0
17838,1,7838,[322 202  88 174   1],786,4,35176,4.487307054471233,0.0,0.0
17839,1,7839,[318 427 515 588  79],716,5,35181,4.487372448979592,40.0,0.0
17840,1,7840,[483   4  97 143 228],655,2,35183,4.487055222548144,0.0,0.0
17841,1,7841,[318 427 515 588  79],18,5,35188,4.4871206324917114,40.0,0.0
17842,1,7842,[318 427 515 588  79],716,5,35193,4.487186025755451,40.0,0.0
17843,1,7843,[318 427 515 588  79],18,5,35198,4.487251402345742,40.0,0.0
17844,1,7844,[318 427 515 588  79],807,5,35203,4.487316762268961,40.0,0.0
17845,1,7845,[318 427 515 588  79],807,5,35208,4.487382105531481,40.0,0.0
17846,1,7846,[318 427 515 588  79],18,5,35213,4.487447432139671,40.0,0.0
17847,1,7847,[318 427 515 588  79],716,5,35218,4.487512742099898,40.0,0.0
17848,1,7848,[318 427 515 588  79],807,5,35223,4.487578035418525,40.0,0.0
17849,1,7849,[318 427 515 588  79],716,5,35228,4.487643312101911,40.0,0.0
17850,1,7850,[318 427 515 588  79],807,5,35233,4.487708572156413,40.0,0.0
17851,1,7851,[318 427 515 588  79],18,5,35238,4.487773815588385,40.0,0.0
17852,1,7852,[318 427 515 588  79],807,5,35243,4.487839042404176,40.0,0.0
17853,1,7853,[183 294 258 282  56],450,5,35248,4.487904252610135,0.0,0.0
17854,1,7854,[132 161 200 276 748],436,2,35250,4.487587523870147,0.0,0.0
17855,1,7855,[318 427 515 588  79],18,5,35255,4.487652749490835,40.0,0.0
17856,1,7856,[318 427 515 588  79],807,5,35260,4.487717958508337,40.0,0.0
17857,1,7857,[265 655 172 100  56],457,5,35265,4.48778315092899,0.0,20.0
17858,1,7858,[318 427 515 588  79],18,5,35270,4.48784832675913,40.0,0.0
17859,1,7859,[204  96 385 483 194],23,4,35274,4.487786259541985,0.0,0.0
17860,1,7860,[202 153  12  79 182],450,5,35279,4.487851418394606,0.0,0.0
17861,1,7861,[ 82  28 385 237 215],655,0,35279,4.487280590180616,0.0,0.0
17862,1,7862,[318 427 515 588  79],807,5,35284,4.487345796769681,40.0,0.0
17863,1,7863,[318 427 515 588  79],807,5,35289,4.487410986775178,40.0,0.0
17864,1,7864,[318 427 515 588  79],18,5,35294,4.487476160203433,40.0,0.0
17865,1,7865,[318 427 515 588  79],807,5,35299,4.487541317060768,40.0,0.0
17866,1,7866,[318 427 515 588  79],18,5,35304,4.487606457353502,40.0,0.0
17867,1,7867,[318 427 515 588  79],807,5,35309,4.487671581087951,40.0,0.0
17868,1,7868,[318 427 515 588  79],18,5,35314,4.487736688270428,40.0,0.0
17869,1,7869,[318 427 515 588  79],18,5,35319,4.487801778907243,40.0,0.0
17870,1,7870,[318 427 515 588  79],807,5,35324,4.487866853004701,40.0,0.0
17871,1,7871,[318 427 515 588  79],18,5,35329,4.487931910569106,40.0,0.0
17872,1,7872,[318 427 515 588  79],716,5,35334,4.487996951606758,40.0,0.0
17873,1,7873,[186 216 300  28 282],693,2,35336,4.48768097536195,0.0,0.0
17874,1,7874,[318 427 515 588  79],807,5,35341,4.487746031746032,40.0,0.0
17875,1,7875,[318 427 515 588  79],807,5,35346,4.487811071609954,40.0,0.0
17876,1,7876,[405 294 181  50  96],280,1,35347,4.487368287419068,0.0,20.0
17877,1,7877,[318 427 515 588  79],18,5,35352,4.487433358720487,40.0,0.0
17878,1,7878,[318 427 515 588  79],18,5,35357,4.487498413504252,40.0,0.0
17879,1,7879,[318 427 515 588  79],18,5,35362,4.48756345177665,40.0,0.0
17880,1,7880,[125 238 180   7 202],457,5,35367,4.487628473543967,0.0,0.0
17881,1,7881,[318 427 515 588  79],807,5,35372,4.487693478812484,40.0,0.0
17882,1,7882,[302 143 271 301 125],655,2,35374,4.48737790181403,0.0,0.0
17883,1,7883,[185  69  25 568  98],716,5,35379,4.487442922374429,0.0,0.0
17884,1,7884,[318 427 515 588  79],807,5,35384,4.487507926442612,40.0,0.0
17885,1,7885,[318 427 515 588  79],18,5,35389,4.487572914024854,40.0,0.0
17886,1,7886,[273 748 328 196 588],796,4,35393,4.487511094205655,0.0,0.0
17887,1,7887,[318 427 515 588  79],807,5,35398,4.487576064908722,40.0,0.0
17888,1,7888,[318 427 515 588  79],716,5,35403,4.487641019140575,40.0,0.0
17889,1,7889,[318 427 515 588  79],716,5,35408,4.487705956907478,40.0,0.0
17890,1,7890,[318 427 515 588  79],716,5,35413,4.487770878215689,40.0,0.0
17891,1,7891,[318 427 515 588  79],716,5,35418,4.487835783071465,40.0,0.0
17892,1,7892,[182 385  28 655 568],450,5,35423,4.487900671481059,0.0,0.0
17893,1,7893,[318 427 515 588  79],18,5,35428,4.487965543450722,40.0,0.0
17894,1,7894,[318 427 515 588  79],807,5,35433,4.488030398986701,40.0,0.0
17895,1,7895,[197 211 118  79 195],716,3,35436,4.4878419452887535,0.0,0.0
17896,1,7896,[318 427 515 588  79],18,5,35441,4.487906800050652,40.0,0.0
17897,1,7897,[222 117 742 172 176],655,1,35442,4.487465181058496,0.0,0.0
17898,1,7898,[153  50 135  69 435],389,3,35445,4.487276870489936,0.0,20.0
17899,1,7899,[318 427 515 588  79],18,5,35450,4.487341772151899,40.0,0.0
17900,1,7900,[318 427 515 588  79],807,5,35455,4.487406657385141,40.0,0.0
17901,1,7901,[318 427 515 588  79],716,5,35460,4.4874715261958995,40.0,0.0
17902,1,7902,[318 427 515 588  79],807,5,35465,4.487536378590408,40.0,0.0
17903,1,7903,[318 427 515 588  79],18,5,35470,4.487601214574899,40.0,0.0
17904,1,7904,[318 427 515 588  79],716,5,35475,4.487666034155597,40.0,0.0
17905,1,7905,[ 22  95  69 245   7],450,4,35479,4.487604351125727,0.0,0.0
17906,1,7906,[318 427 515 588  79],716,5,35484,4.487669153914253,40.0,0.0
17907,1,7907,[318 427 515 588  79],18,5,35489,4.487733940313606,40.0,0.0
17908,1,7908,[318 427 515 588  79],807,5,35494,4.487798710330003,40.0,0.0
17909,1,7909,[  1 603 286 172 211],151,5,35499,4.487863463969659,20.0,20.0
17910,1,7910,[318 427 515 588  79],716,5,35504,4.487928201238781,40.0,0.0
17911,1,7911,[204   1 435 271 678],807,2,35506,4.487613751263903,0.0,0.0
17912,1,7912,[318 427 515 588  79],716,5,35511,4.487678503728042,40.0,0.0
17913,1,7913,[318 427 515 588  79],18,5,35516,4.487743239828153,40.0,0.0
17914,1,7914,[318 427 515 588  79],18,5,35521,4.487807959570436,40.0,0.0
17915,1,7915,[200 238 403  25  12],655,1,35522,4.487367357251137,0.0,0.0
17916,1,7916,[318 427 515 588  79],716,5,35527,4.487432108121763,40.0,0.0
17917,1,7917,[318 427 515 588  79],716,5,35532,4.48749684263703,40.0,0.0
17918,1,7918,[318 427 515 588  79],18,5,35537,4.487561560803131,40.0,0.0
17919,1,7919,[318 427 515 588  79],807,5,35542,4.487626262626263,40.0,0.0
17920,1,7920,[318 427 515 588  79],18,5,35547,4.487690948112612,40.0,0.0
17921,1,7921,[318 427 515 588  79],716,5,35552,4.487755617268366,40.0,0.0
17922,1,7922,[195   9 111  12 191],151,3,35555,4.487567840464471,0.0,0.0
17923,1,7923,[318 427 515 588  79],716,5,35560,4.487632508833922,40.0,0.0
17924,1,7924,[318 427 515 588  79],716,5,35565,4.487697160883281,40.0,0.0
17925,1,7925,[318 427 515 588  79],807,5,35570,4.487761796618723,40.0,0.0
17926,1,7926,[318 427 515 588  79],716,5,35575,4.487826416046423,40.0,0.0
17927,1,7927,[318 427 515 588  79],18,5,35580,4.487891019172553,40.0,0.0
17928,1,7928,[427 257 176  69 127],716,4,35584,4.487829486694413,20.0,20.0
17929,1,7929,[423 185 196 276  25],504,4,35588,4.487767969735183,0.0,0.0
17930,1,7930,[318 427 515 588  79],18,5,35593,4.48783255579372,40.0,0.0
17931,1,7931,[318 427 515 588  79],807,5,35598,4.487897125567322,40.0,0.0
17932,1,7932,[318 427 515 588  79],18,5,35603,4.4879616790621455,40.0,0.0
17933,1,7933,[318 427 515 588  79],716,5,35608,4.488026216284346,40.0,0.0
17934,1,7934,[318 427 515 588  79],807,5,35613,4.488090737240076,40.0,0.0
17935,1,7935,[318 427 515 588  79],18,5,35618,4.488155241935484,40.0,0.0
17936,1,7936,[318 427 515 588  79],18,5,35623,4.488219730376716,40.0,0.0
17937,1,7937,[318 427 515 588  79],807,5,35628,4.488284202569917,40.0,0.0
17938,1,7938,[318 427 515 588  79],18,5,35633,4.488348658521224,40.0,0.0
17939,1,7939,[318 427 515 588  79],807,5,35638,4.488413098236776,40.0,0.0
17940,1,7940,[318 427 515 588  79],807,5,35643,4.488477521722705,40.0,0.0
17941,1,7941,[318 427 515 588  79],18,5,35648,4.488541928985143,40.0,0.0
17942,1,7942,[318 427 515 588  79],807,5,35653,4.4886063200302155,40.0,0.0
17943,1,7943,[318 427 515 588  79],18,5,35658,4.488670694864048,40.0,0.0
17944,1,7944,[318 427 515 588  79],807,5,35663,4.488735053492762,40.0,0.0
17945,1,7945,[135 288 333 655 183],655,2,35665,4.488421847470425,0.0,0.0
17946,1,7946,[ 98 234 508 153  15],269,2,35667,4.488108720271801,0.0,0.0
17947,1,7947,[318 427 515 588  79],18,5,35672,4.488173125314544,40.0,0.0
17948,1,7948,[318 427 515 588  79],716,5,35677,4.488237514152724,40.0,0.0
17949,1,7949,[318 427 515 588  79],716,5,35682,4.488301886792453,40.0,0.0
17950,1,7950,[318 427 515 588  79],716,5,35687,4.488366243239844,40.0,0.0
17951,1,7951,[357 423  12 182 168],450,5,35692,4.488430583501006,0.0,0.0
17952,1,7952,[318 427 515 588  79],807,5,35697,4.488494907582044,40.0,0.0
17953,1,7953,[318 427 515 588  79],716,5,35702,4.488559215489062,40.0,0.0
17954,1,7954,[427 385 174 153 471],655,1,35703,4.488120678818353,20.0,0.0
17955,1,7955,[318 427 515 588  79],807,5,35708,4.488185017596782,40.0,0.0
17956,1,7956,[318 427 515 588  79],807,5,35713,4.488249340203594,40.0,0.0
17957,1,7957,[318 427 515 588  79],807,5,35718,4.488313646644886,40.0,0.0
17958,1,7958,[357 405 588  82 176],450,4,35722,4.488252293001634,0.0,0.0
17959,1,7959,[318 427 515 588  79],716,5,35727,4.488316582914573,40.0,0.0
17960,1,7960,[318 427 515 588  79],716,5,35732,4.488380856676297,40.0,0.0
17961,1,7961,[318 427 515 588  79],18,5,35737,4.488445114292891,40.0,0.0
17962,1,7962,[125 197  97  89 180],457,5,35742,4.4885093557704385,0.0,0.0
17963,1,7963,[318 427 515 588  79],716,5,35747,4.488573581115017,40.0,0.0
17964,1,7964,[318 427 515 588  79],18,5,35752,4.488637790332706,40.0,0.0
17965,1,7965,[318 427 515 588  79],18,5,35757,4.488701983429576,40.0,0.0
17966,1,7966,[318 427 515 588  79],18,5,35762,4.488766160411698,40.0,0.0
17967,1,7967,[318 427 515 588  79],716,5,35767,4.488830321285141,40.0,0.0
17968,1,7968,[318 427 515 588  79],807,5,35772,4.488894466055967,40.0,0.0
17969,1,7969,[ 82  95 143 435 357],450,3,35775,4.48870765370138,0.0,0.0
17970,1,7970,[174 234 132 313 405],450,4,35779,4.488646342993351,0.0,0.0
17971,1,7971,[318 427 515 588  79],18,5,35784,4.488710486703462,40.0,0.0
17972,1,7972,[318 427 515 588  79],807,5,35789,4.488774614323341,40.0,0.0
17973,1,7973,[318 427 515 588  79],716,5,35794,4.488838725859042,40.0,0.0
17974,1,7974,[423 483 546 176 588],716,3,35797,4.4886520376175545,0.0,0.0
17975,1,7975,[  4 211 301  88 215],151,4,35801,4.488590772316951,0.0,0.0
17976,1,7976,[318 427 515 588  79],807,5,35806,4.4886548827880155,40.0,0.0
17977,1,7977,[318 427 515 588  79],18,5,35811,4.488718977187265,40.0,0.0
17978,1,7978,[318 427 515 588  79],716,5,35816,4.4887830555207415,40.0,0.0
17979,1,7979,[121 151   7 385 546],577,3,35819,4.48859649122807,0.0,0.0
17980,1,7980,[318 427 515 588  79],18,5,35824,4.488660568851021,40.0,0.0
17981,1,7981,[ 50  89 173 268 191],344,4,35828,4.488599348534202,0.0,20.0
17982,1,7982,[318 427 515 588  79],807,5,35833,4.488663409745709,40.0,0.0
17983,1,7983,[318 427 515 588  79],807,5,35838,4.48872745490982,40.0,0.0
17984,1,7984,[200 258 195 194 294],629,4,35842,4.488666249217283,0.0,0.0
17985,1,7985,[318 427 515 588  79],807,5,35847,4.488730277986476,40.0,0.0
17986,1,7986,[318 427 515 588  79],716,5,35852,4.488794290722424,40.0,0.0
17987,1,7987,[318 427 515 588  79],807,5,35857,4.488858287431147,40.0,0.0
17988,1,7988,[318 427 515 588  79],18,5,35862,4.488922268118663,40.0,0.0
17989,1,7989,[318 427 515 588  79],18,5,35867,4.488986232790989,40.0,0.0
17990,1,7990,[318 427 515 588  79],716,5,35872,4.489050181454136,40.0,0.0
17991,1,7991,[322 100 175  97 288],344,3,35875,4.488863863863864,0.0,20.0
17992,1,7992,[176 546 257 118 117],716,2,35877,4.488552483422995,0.0,0.0
17993,1,7993,[318 427 515 588  79],18,5,35882,4.48861646234676,40.0,0.0
17994,1,7994,[318 427 515 588  79],18,5,35887,4.488680425265791,40.0,0.0
17995,1,7995,[318 427 515 588  79],716,5,35892,4.488744372186093,40.0,0.0
17996,1,7996,[318 427 515 588  79],716,5,35897,4.488808303113667,40.0,0.0
17997,1,7997,[176  97 194  25  64],577,5,35902,4.488872218054514,20.0,0.0
17998,1,7998,[  9 196 222 100 423],72,4,35906,4.4888111013876735,0.0,20.0
17999,1,7999,[318 427 515 588  79],18,5,35911,4.488875,40.0,0.0
18000,1,8000,[175 191 385 483 403],457,5,35916,4.48893888263967,0.0,0.0
18001,1,8001,[ 79  89 151 172  56],450,5,35921,4.489002749312672,0.0,0.0
18002,1,8002,[318 427 515 588  79],18,5,35926,4.489066600024991,40.0,0.0
18003,1,8003,[318 427 515 588  79],18,5,35931,4.489130434782608,40.0,0.0
18004,1,8004,[318 427 515 588  79],716,5,35936,4.4891942535915055,40.0,0.0
18005,1,8005,[121 222 235  25   1],518,5,35941,4.489258056457657,0.0,0.0
18006,1,8006,[318 427 515 588  79],18,5,35946,4.489321843387036,40.0,0.0
18007,1,8007,[318 427 515 588  79],18,5,35951,4.489385614385615,40.0,0.0
18008,1,8008,[318 427 515 588  79],807,5,35956,4.489449369459358,40.0,0.0
18009,1,8009,[318 427 515 588  79],18,5,35961,4.489513108614232,40.0,0.0
18010,1,8010,[318 427 515 588  79],716,5,35966,4.489576831856198,40.0,0.0
18011,1,8011,[318 427 515 588  79],807,5,35971,4.489640539191213,40.0,0.0
18012,1,8012,[318 427 515 588  79],716,5,35976,4.489704230625234,40.0,0.0
18013,1,8013,[ 89 100 211 234 655],796,1,35977,4.489268779635638,0.0,20.0
18014,1,8014,[301 172 300 194 222],151,5,35982,4.489332501559576,0.0,0.0
18015,1,8015,[318 427 515 588  79],807,5,35987,4.48939620758483,40.0,0.0
18016,1,8016,[318 427 515 588  79],807,5,35992,4.48945989771735,40.0,0.0
18017,1,8017,[318 427 515 588  79],807,5,35997,4.489523571963083,40.0,0.0
18018,1,8018,[318 427 515 588  79],18,5,36002,4.489587230327971,40.0,0.0
18019,1,8019,[ 28 153  89 234 423],796,3,36005,4.489401496259352,0.0,0.0
18020,1,8020,[245 118 176 196 496],796,4,36009,4.489340481236754,20.0,0.0
18021,1,8021,[318 427 515 588  79],716,5,36014,4.489404138618799,40.0,0.0
18022,1,8022,[318 427 515 588  79],18,5,36019,4.48946778013212,40.0,0.0
18023,1,8023,[318 427 515 588  79],18,5,36024,4.489531405782652,40.0,0.0
18024,1,8024,[318 427 515 588  79],18,5,36029,4.489595015576324,40.0,0.0
18025,1,8025,[403 151 161 234 215],450,4,36033,4.489534014453028,0.0,0.0
18026,1,8026,[318 427 515 588  79],716,5,36038,4.489597608072755,40.0,0.0
18027,1,8027,[318 427 515 588  79],716,5,36043,4.489661185849527,40.0,0.0
18028,1,8028,[318 427 515 588  79],716,5,36048,4.489724747789264,40.0,0.0
18029,1,8029,[318 427 515 588  79],716,5,36053,4.489788293897883,40.0,0.0
18030,1,8030,[403  56 195  82 210],457,5,36058,4.489851824181297,0.0,0.0
18031,1,8031,[318 427 515 588  79],807,5,36063,4.489915338645418,40.0,0.0
18032,1,8032,[318 427 515 588  79],807,5,36068,4.489978837296153,40.0,0.0
18033,1,8033,[318 427 515 588  79],807,5,36073,4.490042320139407,40.0,0.0
18034,1,8034,[118 568 508 216 186],655,1,36074,4.489607965152458,0.0,0.0
18035,1,8035,[318 427 515 588  79],716,5,36079,4.489671478347437,40.0,0.0
18036,1,8036,[318 427 515 588  79],716,5,36084,4.489734975737216,40.0,0.0
18037,1,8037,[568  22 132 427 151],330,5,36089,4.4897984573276934,20.0,0.0
18038,1,8038,[318 427 515 588  79],807,5,36094,4.489861923124767,40.0,0.0
18039,1,8039,[318 427 515 588  79],807,5,36099,4.489925373134328,40.0,0.0
18040,1,8040,[318 427 515 588  79],18,5,36104,4.489988807362268,40.0,0.0
18041,1,8041,[228 200 176 161 111],450,4,36108,4.489927878637155,0.0,0.0
18042,1,8042,[318 427 515 588  79],807,5,36113,4.489991296779809,40.0,0.0
18043,1,8043,[153 546 603  25 181],716,4,36117,4.489930382894083,20.0,0.0
18044,1,8044,[318 427 515 588  79],18,5,36122,4.489993784959602,40.0,0.0
18045,1,8045,[318 427 515 588  79],807,5,36127,4.490057171265225,40.0,0.0
18046,1,8046,[318 427 515 588  79],18,5,36132,4.490120541816826,40.0,0.0
18047,1,8047,[318 427 515 588  79],807,5,36137,4.4901838966202785,40.0,0.0
18048,1,8048,[276  82 174 172  50],655,3,36140,4.489998757609641,0.0,20.0
18049,1,8049,[210 172 568 257 143],389,1,36141,4.489565217391305,0.0,0.0
18050,1,8050,[318 427 515 588  79],18,5,36146,4.489628617563036,40.0,0.0
18051,1,8051,[318 427 515 588  79],716,5,36151,4.489692001987084,40.0,0.0
18052,1,8052,[318 427 515 588  79],716,5,36156,4.489755370669315,40.0,0.0
18053,1,8053,[318 427 515 588  79],807,5,36161,4.489818723615595,40.0,0.0
18054,1,8054,[318 427 515 588  79],807,5,36166,4.489882060831781,40.0,0.0
18055,1,8055,[318 427 515 588  79],716,5,36171,4.489945382323734,40.0,0.0
18056,1,8056,[318 427 515 588  79],18,5,36176,4.490008688097307,40.0,0.0
18057,1,8057,[318 427 515 588  79],18,5,36181,4.490071978158352,40.0,0.0
18058,1,8058,[318 427 515 588  79],716,5,36186,4.490135252512719,40.0,0.0
18059,1,8059,[318 427 515 588  79],18,5,36191,4.490198511166253,40.0,0.0
18060,1,8060,[318 427 515 588  79],716,5,36196,4.490261754124798,40.0,0.0
18061,1,8061,[ 12 196 111 237 215],344,3,36199,4.490076903994046,0.0,0.0
18062,1,8062,[318 427 515 588  79],716,5,36204,4.490140146347513,40.0,0.0
18063,1,8063,[318 427 515 588  79],807,5,36209,4.490203373015873,40.0,0.0
18064,1,8064,[318 427 515 588  79],807,5,36214,4.49026658400496,40.0,0.0
18065,1,8065,[318 427 515 588  79],807,5,36219,4.490329779320605,40.0,0.0
18066,1,8066,[172 153 100  11   9],593,4,36223,4.4902689971488785,0.0,20.0
18067,1,8067,[318 427 515 588  79],716,5,36228,4.490332176499752,40.0,0.0
18068,1,8068,[318 427 515 588  79],807,5,36233,4.490395340190854,40.0,0.0
18069,1,8069,[318 427 515 588  79],807,5,36238,4.490458488228005,40.0,0.0
18070,1,8070,[318 427 515 588  79],807,5,36243,4.490521620617024,40.0,0.0
18071,1,8071,[318 427 515 588  79],807,5,36248,4.490584737363727,40.0,0.0
18072,1,8072,[318 427 515 588  79],716,5,36253,4.490647838473925,40.0,0.0
18073,1,8073,[318 427 515 588  79],18,5,36258,4.490710923953431,40.0,0.0
18074,1,8074,[ 22 294 211 228  96],655,0,36258,4.49015479876161,0.0,0.0
18075,1,8075,[318 427 515 588  79],18,5,36263,4.490217929668153,40.0,0.0
18076,1,8076,[318 427 515 588  79],807,5,36268,4.490281044942429,40.0,0.0
18077,1,8077,[318 427 515 588  79],716,5,36273,4.490344144590245,40.0,0.0
18078,1,8078,[125 235 313 328 678],938,1,36274,4.489912117836366,0.0,0.0
18079,1,8079,[318 427 515 588  79],716,5,36279,4.489975247524752,40.0,0.0
18080,1,8080,[ 82 176 210   9 100],280,1,36280,4.489543373344883,0.0,20.0
18081,1,8081,[318 427 515 588  79],716,5,36285,4.489606533036377,40.0,0.0
18082,1,8082,[318 427 515 588  79],807,5,36290,4.489669677100086,40.0,0.0
18083,1,8083,[318 427 515 588  79],18,5,36295,4.489732805541811,40.0,0.0
18084,1,8084,[318 427 515 588  79],807,5,36300,4.489795918367347,40.0,0.0
18085,1,8085,[318 427 515 588  79],716,5,36305,4.489859015582488,40.0,0.0
18086,1,8086,[318 427 515 588  79],716,5,36310,4.489922097193026,40.0,0.0
18087,1,8087,[318 427 515 588  79],716,5,36315,4.489985163204747,40.0,0.0
18088,1,8088,[318 427 515 588  79],807,5,36320,4.49004821362344,40.0,0.0
18089,1,8089,[318 427 515 588  79],807,5,36325,4.490111248454882,40.0,0.0
18090,1,8090,[318 427 515 588  79],807,5,36330,4.490174267704857,40.0,0.0
18091,1,8091,[127 238 357  95 286],450,4,36334,4.490113692535838,0.0,40.0
18092,1,8092,[546 197 194 195 100],504,4,36338,4.4900531323365875,0.0,20.0
18093,1,8093,[318 427 515 588  79],716,5,36343,4.490116135408945,40.0,0.0
18094,1,8094,[318 427 515 588  79],807,5,36348,4.49017912291538,40.0,0.0
18095,1,8095,[318 427 515 588  79],18,5,36353,4.49024209486166,40.0,0.0
18096,1,8096,[180 245 183 210 546],796,2,36355,4.489934543658145,0.0,0.0
18097,1,8097,[318 427 515 588  79],18,5,36360,4.489997530254384,40.0,0.0
18098,1,8098,[318 427 515 588  79],18,5,36365,4.4900605012964565,40.0,0.0
18099,1,8099,[318 427 515 588  79],807,5,36370,4.490123456790124,40.0,0.0
18100,1,8100,[318 427 515 588  79],18,5,36375,4.4901863967411435,40.0,0.0
18101,1,8101,[200  11  22 186  12],577,3,36378,4.490002468526289,0.0,0.0
18102,1,8102,[318 427 515 588  79],807,5,36383,4.490065407873627,40.0,0.0
18103,1,8103,[294 187 300  69  82],796,3,36386,4.4898815399802565,0.0,0.0
18104,1,8104,[318 427 515 588  79],18,5,36391,4.489944478716842,40.0,0.0
18105,1,8105,[318 427 515 588  79],716,5,36396,4.4900074019245,40.0,0.0
18106,1,8106,[111  79  89 273 183],655,4,36400,4.489946959417787,0.0,0.0
18107,1,8107,[318 427 515 588  79],807,5,36405,4.490009866798224,40.0,0.0
18108,1,8108,[318 427 515 588  79],807,5,36410,4.490072758663214,40.0,0.0
18109,1,8109,[197 405  98   1 195],786,4,36414,4.490012330456227,0.0,0.0
18110,1,8110,[318 427 515 588  79],716,5,36419,4.490075206509678,40.0,0.0
18111,1,8111,[318 427 515 588  79],716,5,36424,4.490138067061144,40.0,0.0
18112,1,8112,[318 427 515 588  79],18,5,36429,4.490200912116356,40.0,0.0
18113,1,8113,[318 427 515 588  79],18,5,36434,4.490263741681045,40.0,0.0
18114,1,8114,[318 427 515 588  79],807,5,36439,4.490326555760936,40.0,0.0
18115,1,8115,[318 427 515 588  79],807,5,36444,4.490389354361755,40.0,0.0
18116,1,8116,[423 211  64 294 183],716,4,36448,4.490328939263275,20.0,0.0
18117,1,8117,[318 427 515 588  79],18,5,36453,4.490391722099039,40.0,0.0
18118,1,8118,[318 427 515 588  79],807,5,36458,4.490454489469147,40.0,0.0
18119,1,8119,[318 427 515 588  79],807,5,36463,4.49051724137931,40.0,0.0
18120,1,8120,[222 182 100  12 197],796,3,36466,4.490333702745967,0.0,20.0
18121,1,8121,[318 427 515 588  79],716,5,36471,4.490396454075351,40.0,0.0
18122,1,8122,[318 427 515 588  79],716,5,36476,4.49045918995445,40.0,0.0
18123,1,8123,[318 427 515 588  79],807,5,36481,4.490521910388971,40.0,0.0
18124,1,8124,[318 427 515 588  79],716,5,36486,4.490584615384615,40.0,0.0
18125,1,8125,[423 318  82  50 405],450,4,36490,4.490524243170071,20.0,20.0
18126,1,8126,[273   4 172 118 471],655,2,36492,4.4902177925433735,0.0,0.0
18127,1,8127,[318 427 515 588  79],18,5,36497,4.490280511811024,40.0,0.0
18128,1,8128,[318 427 515 588  79],716,5,36502,4.490343215647681,40.0,0.0
18129,1,8129,[318 427 515 588  79],18,5,36507,4.490405904059041,40.0,0.0
18130,1,8130,[318 427 515 588  79],716,5,36512,4.490468577050793,40.0,0.0
18131,1,8131,[318 427 515 588  79],807,5,36517,4.4905312346286275,40.0,0.0
18132,1,8132,[318 427 515 588  79],18,5,36522,4.490593876798229,40.0,0.0
18133,1,8133,[318 427 515 588  79],18,5,36527,4.4906565035652815,40.0,0.0
18134,1,8134,[318 427 515 588  79],18,5,36532,4.490719114935464,40.0,0.0
18135,1,8135,[318 427 515 588  79],716,5,36537,4.4907817109144545,40.0,0.0
18136,1,8136,[318 427 515 588  79],18,5,36542,4.490844291507927,40.0,0.0
18137,1,8137,[318 427 515 588  79],18,5,36547,4.490906856721553,40.0,0.0
18138,1,8138,[202 111 186   9 135],269,2,36549,4.490600810910431,0.0,0.0
18139,1,8139,[318 427 515 588  79],716,5,36554,4.490663390663391,40.0,0.0
18140,1,8140,[318 427 515 588  79],716,5,36559,4.490725955042378,40.0,0.0
18141,1,8141,[318 427 515 588  79],807,5,36564,4.490788504053058,40.0,0.0
18142,1,8142,[318 427 515 588  79],18,5,36569,4.490851037701093,40.0,0.0
18143,1,8143,[318 427 515 588  79],716,5,36574,4.490913555992141,40.0,0.0
18144,1,8144,[238 483  25 275  89],450,3,36577,4.49073050951504,0.0,20.0
18145,1,8145,[ 50 238  79  70   4],593,5,36582,4.490793027252639,0.0,20.0
18146,1,8146,[318 427 515 588  79],716,5,36587,4.490855529642813,40.0,0.0
18147,1,8147,[318 427 515 588  79],807,5,36592,4.490918016691213,40.0,0.0
18148,1,8148,[318 427 515 588  79],807,5,36597,4.490980488403485,40.0,0.0
18149,1,8149,[423 258 403 318  70],457,5,36602,4.491042944785276,20.0,0.0
18150,1,8150,[318 427 515 588  79],807,5,36607,4.491105385842228,40.0,0.0
18151,1,8151,[318 427 515 588  79],716,5,36612,4.49116781157998,40.0,0.0
18152,1,8152,[318 427 515 588  79],18,5,36617,4.49123022200417,40.0,0.0
18153,1,8153,[125 294 200 174 118],504,3,36620,4.491047338729458,0.0,0.0
18154,1,8154,[318 427 515 588  79],807,5,36625,4.491109748620478,40.0,0.0
18155,1,8155,[181  88  95 588 216],280,3,36628,4.490926924963217,0.0,0.0
18156,1,8156,[318 427 515 588  79],807,5,36633,4.490989334314086,40.0,0.0
18157,1,8157,[273 200 301 187 568],655,3,36636,4.490806570237804,0.0,0.0
18158,1,8158,[318 427 515 588  79],18,5,36641,4.490868979041549,40.0,0.0
18159,1,8159,[318 427 515 588  79],18,5,36646,4.49093137254902,40.0,0.0
18160,1,8160,[318 427 515 588  79],716,5,36651,4.4909937507658375,40.0,0.0
18161,1,8161,[318 427 515 588  79],18,5,36656,4.491056113697623,40.0,0.0
18162,1,8162,[318 427 515 588  79],18,5,36661,4.491118461349994,40.0,0.0
18163,1,8163,[ 96 176 405 271 135],72,2,36663,4.490813326800588,0.0,0.0
18164,1,8164,[ 15 496  98   8  64],796,5,36668,4.4908756889161054,40.0,0.0
18165,1,8165,[318 427 515 588  79],18,5,36673,4.490938035758021,40.0,0.0
18166,1,8166,[318 427 515 588  79],807,5,36678,4.491000367331946,40.0,0.0
18167,1,8167,[318 427 515 588  79],807,5,36683,4.491062683643487,40.0,0.0
18168,1,8168,[ 11  96 257 135 100],655,1,36684,4.490635328681601,0.0,20.0
18169,1,8169,[318 427 515 588  79],716,5,36689,4.4906976744186045,40.0,0.0
18170,1,8170,[238   8 153 234  56],18,4,36693,4.4906376208542405,0.0,0.0
18171,1,8171,[ 69 181 174 427 185],655,2,36695,4.490332843857073,20.0,0.0
18172,1,8172,[318 427 515 588  79],716,5,36700,4.490395203719564,40.0,0.0
18173,1,8173,[318 427 515 588  79],18,5,36705,4.490457548323954,40.0,0.0
18174,1,8174,[318 427 515 588  79],807,5,36710,4.490519877675841,40.0,0.0
18175,1,8175,[318 427 515 588  79],807,5,36715,4.490582191780822,40.0,0.0
18176,1,8176,[318 427 515 588  79],18,5,36720,4.490644490644491,40.0,0.0
18177,1,8177,[161 121  98 100 300],655,1,36721,4.490217657128882,0.0,20.0
18178,1,8178,[318 427 515 588  79],807,5,36726,4.4902799853282795,40.0,0.0
18179,1,8179,[318 427 515 588  79],18,5,36731,4.490342298288509,40.0,0.0
18180,1,8180,[427 135 328 196 153],151,3,36734,4.490160127123824,20.0,0.0
18181,1,8181,[318 427 515 588  79],18,5,36739,4.490222439501345,40.0,0.0
18182,1,8182,[427 200  25 111 143],450,3,36742,4.4900403275082486,20.0,0.0
18183,1,8183,[318 427 515 588  79],807,5,36747,4.490102639296188,40.0,0.0
18184,1,8184,[318 427 515 588  79],18,5,36752,4.490164935858277,40.0,0.0
18185,1,8185,[318 427 515 588  79],807,5,36757,4.490227217200098,40.0,0.0
18186,1,8186,[180 471  11  79  95],716,3,36760,4.4900451935996095,0.0,0.0
18187,1,8187,[  1 275 202 195 423],786,5,36765,4.490107474352711,0.0,20.0
18188,1,8188,[318 427 515 588  79],807,5,36770,4.490169739894981,40.0,0.0
18189,1,8189,[318 427 515 588  79],807,5,36775,4.49023199023199,40.0,0.0
18190,1,8190,[318 427 515 588  79],18,5,36780,4.490294225369308,40.0,0.0
18191,1,8191,[318 427 515 588  79],807,5,36785,4.4903564453125,40.0,0.0
18192,1,8192,[318 427 515 588  79],716,5,36790,4.490418650067131,40.0,0.0
18193,1,8193,[318 427 515 588  79],807,5,36795,4.49048083963876,40.0,0.0
18194,1,8194,[318 427 515 588  79],18,5,36800,4.490543014032947,40.0,0.0
18195,1,8195,[318 427 515 588  79],807,5,36805,4.490605173255246,40.0,0.0
18196,1,8196,[ 22 111 191 271 265],655,1,36806,4.490179333902647,0.0,0.0
18197,1,8197,[187 269 282 300 215],796,4,36810,4.490119541351549,0.0,0.0
18198,1,8198,[318 427 515 588  79],716,5,36815,4.490181729479205,40.0,0.0
18199,1,8199,[318 427 515 588  79],18,5,36820,4.490243902439024,40.0,0.0
18200,1,8200,[385  95 172   4 276],280,3,36823,4.490062187538105,0.0,0.0
18201,1,8201,[179 318 204  69 168],450,5,36828,4.490124359912216,20.0,0.0
18202,1,8202,[318 427 515 588  79],18,5,36833,4.49018651712788,40.0,0.0
18203,1,8203,[176 222 318 200 195],457,5,36838,4.490248659190638,20.0,0.0
18204,1,8204,[181 179 196 655 546],786,5,36843,4.490310786106033,0.0,0.0
18205,1,8205,[318 427 515 588  79],716,5,36848,4.490372897879601,40.0,0.0
18206,1,8206,[237 273 286 235 588],344,2,36850,4.490069452906056,0.0,20.0
18207,1,8207,[179 117 185 237   7],655,2,36852,4.489766081871345,0.0,0.0
18208,1,8208,[318 427 515 588  79],18,5,36857,4.489828237300523,40.0,0.0
18209,1,8209,[318 427 515 588  79],807,5,36862,4.489890377588307,40.0,0.0
18210,1,8210,[318 427 515 588  79],807,5,36867,4.489952502740227,40.0,0.0
18211,1,8211,[318 427 515 588  79],18,5,36872,4.490014612761812,40.0,0.0
18212,1,8212,[318 427 515 588  79],807,5,36877,4.49007670765859,40.0,0.0
18213,1,8213,[318 427 515 588  79],807,5,36882,4.490138787436084,40.0,0.0
18214,1,8214,[318 427 515 588  79],18,5,36887,4.490200852099817,40.0,0.0
18215,1,8215,[318 427 515 588  79],18,5,36892,4.490262901655306,40.0,0.0
18216,1,8216,[200  56 234   9 183],593,3,36895,4.49008153827431,0.0,0.0
18217,1,8217,[318 427 515 588  79],807,5,36900,4.4901435872475055,40.0,0.0
18218,1,8218,[318 427 515 588  79],18,5,36905,4.490205621121791,40.0,0.0
18219,1,8219,[318 427 515 588  79],18,5,36910,4.490267639902676,40.0,0.0
18220,1,8220,[257 111 127 216 200],716,5,36915,4.490329643595669,0.0,20.0
18221,1,8221,[318 427 515 588  79],18,5,36920,4.490391632206276,40.0,0.0
18222,1,8222,[161 427 294   1 508],655,1,36921,4.48996716526815,20.0,0.0
18223,1,8223,[318 427 515 588  79],807,5,36926,4.490029182879377,40.0,0.0
18224,1,8224,[588 183 117 655 121],577,5,36931,4.490091185410335,0.0,0.0
18225,1,8225,[ 96 483   1 234 258],807,2,36933,4.48978847556528,0.0,0.0
18226,1,8226,[318 427 515 588  79],716,5,36938,4.489850492281512,40.0,0.0
18227,1,8227,[318 427 515 588  79],18,5,36943,4.489912493923189,40.0,0.0
18228,1,8228,[318 427 515 588  79],807,5,36948,4.489974480495808,40.0,0.0
18229,1,8229,[238  28 603 202 228],330,5,36953,4.49003645200486,20.0,0.0
18230,1,8230,[318 427 515 588  79],716,5,36958,4.490098408455838,40.0,0.0
18231,1,8231,[318 427 515 588  79],18,5,36963,4.490160349854228,40.0,0.0
18232,1,8232,[318 427 515 588  79],18,5,36968,4.490222276205515,40.0,0.0
18233,1,8233,[318 427 515 588  79],807,5,36973,4.490284187515181,40.0,0.0
18234,1,8234,[318 427 515 588  79],18,5,36978,4.490346083788706,40.0,0.0
18235,1,8235,[318 427 515 588  79],18,5,36983,4.490407965031569,40.0,0.0
18236,1,8236,[318 427 515 588  79],716,5,36988,4.490469831249241,40.0,0.0
18237,1,8237,[318 427 515 588  79],18,5,36993,4.490531682447196,40.0,0.0
18238,1,8238,[318 427 515 588  79],18,5,36998,4.490593518630901,40.0,0.0
18239,1,8239,[318 427 515 588  79],716,5,37003,4.4906553398058255,40.0,0.0
18240,1,8240,[318 427 515 588  79],807,5,37008,4.49071714597743,40.0,0.0
18241,1,8241,[318 427 515 588  79],716,5,37013,4.490778937151177,40.0,0.0
18242,1,8242,[235 275   7 271 286],463,3,37016,4.490598083222128,0.0,40.0
18243,1,8243,[318 427 515 588  79],18,5,37021,4.490659873847647,40.0,0.0
18244,1,8244,[ 50   8 174 135 294],655,2,37023,4.490357792601577,0.0,20.0
18245,1,8245,[118   9 204 269  50],344,4,37027,4.490298326461315,0.0,20.0
18246,1,8246,[318 427 515 588  79],18,5,37032,4.490360130956711,40.0,0.0
18247,1,8247,[318 427 515 588  79],807,5,37037,4.490421920465567,40.0,0.0
18248,1,8248,[318 427 515 588  79],18,5,37042,4.490483694993332,40.0,0.0
18249,1,8249,[187 403 228 748 742],796,4,37046,4.490424242424242,0.0,0.0
18250,1,8250,[216 385 215 742 496],450,5,37051,4.490486001696764,20.0,0.0
18251,1,8251,[568 258 176 135 181],450,4,37055,4.490426563257392,0.0,0.0
18252,1,8252,[318 427 515 588  79],716,5,37060,4.490488307282201,40.0,0.0
18253,1,8253,[318 427 515 588  79],716,5,37065,4.490550036346014,40.0,0.0
18254,1,8254,[153  25 144 508 187],535,3,37068,4.490369473046639,0.0,0.0
18255,1,8255,[318 427 515 588  79],716,5,37073,4.490431201550388,40.0,0.0
18256,1,8256,[318 427 515 588  79],807,5,37078,4.490492915102338,40.0,0.0
18257,1,8257,[ 50 300 111 121   1],796,4,37082,4.490433519011868,0.0,20.0
18258,1,8258,[318 427 515 588  79],18,5,37087,4.490495217338661,40.0,0.0
18259,1,8259,[318 427 515 588  79],18,5,37092,4.490556900726392,40.0,0.0
18260,1,8260,[318 427 515 588  79],716,5,37097,4.490618569180486,40.0,0.0
18261,1,8261,[318 427 515 588  79],18,5,37102,4.4906802227063665,40.0,0.0
18262,1,8262,[318 427 515 588  79],807,5,37107,4.490741861309452,40.0,0.0
18263,1,8263,[318 427 515 588  79],807,5,37112,4.49080348499516,40.0,0.0
18264,1,8264,[191 196 289 288 427],655,2,37114,4.490502117362372,20.0,0.0
18265,1,8265,[195 172 200 423 132],330,4,37118,4.490442777643358,0.0,0.0
18266,1,8266,[318 427 515 588  79],807,5,37123,4.49050441514455,40.0,0.0
18267,1,8267,[318 427 515 588  79],18,5,37128,4.490566037735849,40.0,0.0
18268,1,8268,[ 71 265  64 405 427],796,5,37133,4.490627645422663,40.0,0.0
18269,1,8269,[318 427 515 588  79],18,5,37138,4.490689238210399,40.0,0.0
18270,1,8270,[318 427 515 588  79],807,5,37143,4.490750816104462,40.0,0.0
18271,1,8271,[318 427 515 588  79],18,5,37148,4.490812379110252,40.0,0.0
18272,1,8272,[318 427 515 588  79],807,5,37153,4.490873927233168,40.0,0.0
18273,1,8273,[318 427 515 588  79],807,5,37158,4.490935460478608,40.0,0.0
18274,1,8274,[423 181 471   9 132],786,5,37163,4.490996978851964,0.0,0.0
18275,1,8275,[318 427 515 588  79],716,5,37168,4.4910584823586275,40.0,0.0
18276,1,8276,[318 427 515 588  79],807,5,37173,4.491119971003987,40.0,0.0
18277,1,8277,[234 258 174 496 515],878,2,37175,4.490819038415076,20.0,0.0
18278,1,8278,[318 427 515 588  79],807,5,37180,4.490880541128155,40.0,0.0
18279,1,8279,[318 427 515 588  79],18,5,37185,4.490942028985507,40.0,0.0
18280,1,8280,[210  11 161 183 135],457,5,37190,4.491003501992513,0.0,0.0
18281,1,8281,[318 427 515 588  79],716,5,37195,4.491064960154552,40.0,0.0
18282,1,8282,[318 427 515 588  79],18,5,37200,4.491126403477001,40.0,0.0
18283,1,8283,[318 427 515 588  79],18,5,37205,4.4911878319652345,40.0,0.0
18284,1,8284,[318 427 515 588  79],18,5,37210,4.491249245624623,40.0,0.0
18285,1,8285,[318 427 515 588  79],807,5,37215,4.491310644460536,40.0,0.0
18286,1,8286,[318 427 515 588  79],18,5,37220,4.49137202847834,40.0,0.0
18287,1,8287,[318 427 515 588  79],18,5,37225,4.491433397683398,40.0,0.0
18288,1,8288,[210 197 427 235 176],269,2,37227,4.491132826637712,20.0,0.0
18289,1,8289,[318 427 515 588  79],807,5,37232,4.491194209891435,40.0,0.0
18290,1,8290,[318 427 515 588  79],716,5,37237,4.491255578337957,40.0,0.0
18291,1,8291,[588 200 748  15 197],796,4,37241,4.491196333815726,0.0,0.0
18292,1,8292,[228  11  97 196  50],655,1,37242,4.490775352707103,0.0,20.0
18293,1,8293,[172 183 328 195 181],450,5,37247,4.490836749457439,0.0,0.0
18294,1,8294,[318 427 515 588  79],807,5,37252,4.49089813140446,40.0,0.0
18295,1,8295,[318 427 515 588  79],716,5,37257,4.4909594985535195,40.0,0.0
18296,1,8296,[318 427 515 588  79],716,5,37262,4.491020850909967,40.0,0.0
18297,1,8297,[318 427 515 588  79],807,5,37267,4.491082188479152,40.0,0.0
18298,1,8298,[318 427 515 588  79],716,5,37272,4.491143511266418,40.0,0.0
18299,1,8299,[234  28 215 125 328],655,0,37272,4.490602409638554,0.0,0.0
18300,1,8300,[318 427 515 588  79],807,5,37277,4.490663775448741,40.0,0.0
18301,1,8301,[197 403 323 655 125],280,0,37277,4.490122861960973,0.0,0.0
18302,1,8302,[318 427 515 588  79],807,5,37282,4.490184270745513,40.0,0.0
18303,1,8303,[318 427 515 588  79],18,5,37287,4.490245664739884,40.0,0.0
18304,1,8304,[318 427 515 588  79],716,5,37292,4.490307043949428,40.0,0.0
18305,1,8305,[318 427 515 588  79],18,5,37297,4.490368408379485,40.0,0.0
18306,1,8306,[318 427 515 588  79],807,5,37302,4.490429758035392,40.0,0.0
18307,1,8307,[269   1 215  50 204],18,3,37305,4.490250361097737,0.0,20.0
18308,1,8308,[318 427 515 588  79],18,5,37310,4.490311710193766,40.0,0.0
18309,1,8309,[318 427 515 588  79],18,5,37315,4.490373044524669,40.0,0.0
18310,1,8310,[318 427 515 588  79],807,5,37320,4.490434364095777,40.0,0.0
18311,1,8311,[318 427 515 588  79],716,5,37325,4.490495668912415,40.0,0.0
18312,1,8312,[ 50 588 228 204  70],786,5,37330,4.490556958979911,0.0,20.0
18313,1,8313,[318 427 515 588  79],716,5,37335,4.490618234303584,40.0,0.0
18314,1,8314,[318 427 515 588  79],807,5,37340,4.490679494888755,40.0,0.0
18315,1,8315,[318 427 515 588  79],18,5,37345,4.4907407407407405,40.0,0.0
18316,1,8316,[318 427 515 588  79],807,5,37350,4.4908019718648555,40.0,0.0
18317,1,8317,[318 427 515 588  79],18,5,37355,4.4908631882664105,40.0,0.0
18318,1,8318,[318 427 515 588  79],807,5,37360,4.490924389950715,40.0,0.0
18319,1,8319,[318 427 515 588  79],807,5,37365,4.490985576923077,40.0,0.0
18320,1,8320,[318 427 515 588  79],716,5,37370,4.4910467491888,40.0,0.0
18321,1,8321,[318 427 515 588  79],18,5,37375,4.491107906753184,40.0,0.0
18322,1,8322,[318 427 515 588  79],716,5,37380,4.491169049621531,40.0,0.0
18323,1,8323,[ 56 127 197 132 202],655,1,37381,4.4907496395963475,0.0,20.0
18324,1,8324,[318 427 515 588  79],18,5,37386,4.490810810810811,40.0,0.0
18325,1,8325,[318 427 515 588  79],716,5,37391,4.490871967331252,40.0,0.0
18326,1,8326,[161 515 187 235   1],716,2,37393,4.49057283535487,0.0,0.0
18327,1,8327,[318 427 515 588  79],807,5,37398,4.490634005763689,40.0,0.0
18328,1,8328,[318 427 515 588  79],807,5,37403,4.490695161483972,40.0,0.0
18329,1,8329,[318 427 515 588  79],716,5,37408,4.490756302521008,40.0,0.0
18330,1,8330,[318 427 515 588  79],18,5,37413,4.490817428880087,40.0,0.0
18331,1,8331,[318 427 515 588  79],18,5,37418,4.490878540566491,40.0,0.0
18332,1,8332,[318 427 515 588  79],18,5,37423,4.4909396375855035,40.0,0.0
18333,1,8333,[318 427 515 588  79],807,5,37428,4.491000719942405,40.0,0.0
18334,1,8334,[318 427 515 588  79],716,5,37433,4.491061787642471,40.0,0.0
18335,1,8335,[174 318 435 180   8],535,5,37438,4.491122840690979,20.0,0.0
18336,1,8336,[318 427 515 588  79],716,5,37443,4.491183879093199,40.0,0.0
18337,1,8337,[318 427 515 588  79],716,5,37448,4.491244902854402,40.0,0.0
18338,1,8338,[183 202 603 118 151],796,5,37453,4.491305911979854,20.0,0.0
18339,1,8339,[318 427 515 588  79],18,5,37458,4.49136690647482,40.0,0.0
18340,1,8340,[318 427 515 588  79],807,5,37463,4.491427886344563,40.0,0.0
18341,1,8341,[318 427 515 588  79],18,5,37468,4.491488851594342,40.0,0.0
18342,1,8342,[318 427 515 588  79],716,5,37473,4.491549802229414,40.0,0.0
18343,1,8343,[318 427 515 588  79],716,5,37478,4.491610738255034,40.0,0.0
18344,1,8344,[318 427 515 588  79],807,5,37483,4.491671659676453,40.0,0.0
18345,1,8345,[  9 300  56 174 132],655,0,37483,4.4911334771147855,0.0,0.0
18346,1,8346,[318 427 515 588  79],18,5,37488,4.491194441116569,40.0,0.0
18347,1,8347,[318 427 515 588  79],807,5,37493,4.4912553905126975,40.0,0.0
18348,1,8348,[ 69 202 282 597 748],796,5,37498,4.4913163253084205,0.0,0.0
18349,1,8349,[313 215 471 423 100],577,4,37502,4.49125748502994,0.0,20.0
18350,1,8350,[318 427 515 588  79],18,5,37507,4.491318404981439,40.0,0.0
18351,1,8351,[125 176  82 161 405],786,5,37512,4.491379310344827,0.0,0.0
18352,1,8352,[318 427 515 588  79],807,5,37517,4.491440201125344,40.0,0.0
18353,1,8353,[318 427 515 588  79],807,5,37522,4.491501077328226,40.0,0.0
18354,1,8354,[318 427 515 588  79],807,5,37527,4.491561938958707,40.0,0.0
18355,1,8355,[318 427 515 588  79],807,5,37532,4.49162278602202,40.0,0.0
18356,1,8356,[318 427 515 588  79],807,5,37537,4.4916836185233935,40.0,0.0
18357,1,8357,[318 427 515 588  79],807,5,37542,4.491744436468054,40.0,0.0
18358,1,8358,[ 22 195 237 182 238],18,3,37545,4.491565976791482,0.0,0.0
18359,1,8359,[318 427 515 588  79],18,5,37550,4.491626794258373,40.0,0.0
18360,1,8360,[  7 471  12  79 132],450,5,37555,4.491687597177371,0.0,0.0
18361,1,8361,[318 427 515 588  79],807,5,37560,4.491748385553695,40.0,0.0
18362,1,8362,[318 427 515 588  79],18,5,37565,4.491809159392562,40.0,0.0
18363,1,8363,[318 427 515 588  79],18,5,37570,4.491869918699187,40.0,0.0
18364,1,8364,[204 197  12 182 302],655,2,37572,4.49157202630006,0.0,0.0
18365,1,8365,[286   4  98 328  50],629,3,37575,4.4913937365527135,0.0,40.0
18366,1,8366,[318 427 515 588  79],807,5,37580,4.491454523724155,40.0,0.0
18367,1,8367,[328 471 172 300 161],450,5,37585,4.491515296367113,0.0,0.0
18368,1,8368,[318 427 515 588  79],716,5,37590,4.491576054486797,40.0,0.0
18369,1,8369,[318 427 515 588  79],18,5,37595,4.491636798088411,40.0,0.0
18370,1,8370,[  8 196 568 100  50],655,1,37596,4.491219687014693,0.0,40.0
18371,1,8371,[  1 183 176 423  95],577,5,37601,4.491280458671763,0.0,0.0
18372,1,8372,[318 427 515 588  79],807,5,37606,4.4913412158127315,40.0,0.0
18373,1,8373,[172 289 234 132 238],786,4,37610,4.491282541198949,0.0,0.0
18374,1,8374,[  7 174 318 195  15],269,1,37611,4.490865671641791,20.0,0.0
18375,1,8375,[318 427 515 588  79],18,5,37616,4.490926456542502,40.0,0.0
18376,1,8376,[318 427 515 588  79],716,5,37621,4.490987226930883,40.0,0.0
18377,1,8377,[234  22  95 173 176],280,2,37623,4.490689902124612,0.0,0.0
18378,1,8378,[318 427 515 588  79],18,5,37628,4.490750686239408,40.0,0.0
18379,1,8379,[151 265 204  89 194],450,5,37633,4.490811455847255,0.0,0.0
18380,1,8380,[318 427 515 588  79],18,5,37638,4.490872210953347,40.0,0.0
18381,1,8381,[318 427 515 588  79],18,5,37643,4.490932951562873,40.0,0.0
18382,1,8382,[195 191 294 282   1],655,1,37644,4.490516521531672,0.0,0.0
18383,1,8383,[ 98 174  25 173 204],344,5,37649,4.490577290076335,0.0,0.0
18384,1,8384,[318 427 515 588  79],18,5,37654,4.490638044126416,40.0,0.0
18385,1,8385,[318 427 515 588  79],18,5,37659,4.4906987836870975,40.0,0.0
18386,1,8386,[200 216   1 144  98],5,1,37660,4.490282580183617,0.0,0.0
18387,1,8387,[318 427 515 588  79],716,5,37665,4.490343347639485,40.0,0.0
18388,1,8388,[ 25 161 237 181 144],450,4,37669,4.490284896888783,0.0,0.0
18389,1,8389,[508 125  28 275 215],655,1,37670,4.489868891537545,0.0,20.0
18390,1,8390,[318 427 515 588  79],18,5,37675,4.489929686568943,40.0,0.0
18391,1,8391,[318 427 515 588  79],18,5,37680,4.489990467111535,40.0,0.0
18392,1,8392,[ 71 172 289 174 180],786,5,37685,4.490051233170499,0.0,0.0
18393,1,8393,[318 427 515 588  79],716,5,37690,4.490111984751013,40.0,0.0
18394,1,8394,[403  71 202 195 405],796,5,37695,4.490172721858249,0.0,0.0
18395,1,8395,[318 427 515 588  79],807,5,37700,4.490233444497379,40.0,0.0
18396,1,8396,[318 427 515 588  79],807,5,37705,4.490294152673574,40.0,0.0
18397,1,8397,[318 427 515 588  79],18,5,37710,4.490354846391998,40.0,0.0
18398,1,8398,[318 427 515 588  79],807,5,37715,4.490415525657816,40.0,0.0
18399,1,8399,[318 427 515 588  79],716,5,37720,4.4904761904761905,40.0,0.0
18400,1,8400,[318 427 515 588  79],18,5,37725,4.49053684085228,40.0,0.0
18401,1,8401,[318 427 515 588  79],807,5,37730,4.49059747679124,40.0,0.0
18402,1,8402,[318 427 515 588  79],807,5,37735,4.490658098298227,40.0,0.0
18403,1,8403,[318 427 515 588  79],807,5,37740,4.4907187053783915,40.0,0.0
18404,1,8404,[121   1 210  70 153],655,0,37740,4.490184414039263,0.0,0.0
18405,1,8405,[318 427 515 588  79],807,5,37745,4.490245063050202,40.0,0.0
18406,1,8406,[318 427 515 588  79],807,5,37750,4.490305697632925,40.0,0.0
18407,1,8407,[318 427 515 588  79],18,5,37755,4.490366317792579,40.0,0.0
18408,1,8408,[318 427 515 588  79],18,5,37760,4.490426923534309,40.0,0.0
18409,1,8409,[475 111 237 508   1],655,0,37760,4.4898929845422115,0.0,0.0
18410,1,8410,[318 427 515 588  79],716,5,37765,4.489953632148377,40.0,0.0
18411,1,8411,[318 427 515 588  79],18,5,37770,4.490014265335235,40.0,0.0
18412,1,8412,[318 427 515 588  79],716,5,37775,4.490074884107928,40.0,0.0
18413,1,8413,[318 427 515 588  79],716,5,37780,4.490135488471595,40.0,0.0
18414,1,8414,[318 427 515 588  79],716,5,37785,4.490196078431373,40.0,0.0
18415,1,8415,[  9 275   4 121 111],593,3,37788,4.490019011406844,0.0,20.0
18416,1,8416,[318 427 515 588  79],807,5,37793,4.4900796008078885,40.0,0.0
18417,1,8417,[318 427 515 588  79],716,5,37798,4.490140175813733,40.0,0.0
18418,1,8418,[318 427 515 588  79],18,5,37803,4.490200736429505,40.0,0.0
18419,1,8419,[318 427 515 588  79],807,5,37808,4.490261282660333,40.0,0.0
18420,1,8420,[318 427 515 588  79],18,5,37813,4.490321814511341,40.0,0.0
18421,1,8421,[318 427 515 588  79],18,5,37818,4.490382331987651,40.0,0.0
18422,1,8422,[318 427 515 588  79],18,5,37823,4.490442835094385,40.0,0.0
18423,1,8423,[318 427 515 588  79],716,5,37828,4.490503323836657,40.0,0.0
18424,1,8424,[318 427 515 588  79],807,5,37833,4.4905637982195845,40.0,0.0
18425,1,8425,[215 423 183 174   4],280,1,37834,4.490149537146926,0.0,0.0
18426,1,8426,[318 427 515 588  79],18,5,37839,4.490210039159844,40.0,0.0
18427,1,8427,[210 603 197 143 191],401,5,37844,4.490270526815378,20.0,0.0
18428,1,8428,[323  22  25  15 568],256,5,37849,4.490331000118638,0.0,0.0
18429,1,8429,[300 204 216 282 496],450,5,37854,4.490391459074733,20.0,0.0
18430,1,8430,[318 427 515 588  79],716,5,37859,4.490451903688768,40.0,0.0
18431,1,8431,[ 12 273 176 748  28],450,4,37863,4.490393738140417,0.0,0.0
18432,1,8432,[282 435 144 210   1],401,3,37866,4.4902170046246885,0.0,0.0
18433,1,8433,[318 427 515 588  79],807,5,37871,4.49027744842305,40.0,0.0
18434,1,8434,[194 211 238 216 204],11,1,37872,4.489863663307647,0.0,0.0
18435,1,8435,[318 427 515 588  79],807,5,37877,4.489924134660977,40.0,0.0
18436,1,8436,[403 111 286 318 176],280,3,37880,4.4897475405949985,20.0,20.0
18437,1,8437,[238 200 100   7 282],450,4,37884,4.4896894998814885,0.0,20.0
18438,1,8438,[318 427 515 588  79],18,5,37889,4.4897499703756365,40.0,0.0
18439,1,8439,[318 427 515 588  79],716,5,37894,4.489810426540284,40.0,0.0
18440,1,8440,[318 427 515 588  79],807,5,37899,4.489870868380524,40.0,0.0
18441,1,8441,[318 427 515 588  79],716,5,37904,4.489931295901445,40.0,0.0
18442,1,8442,[318 427 515 588  79],807,5,37909,4.4899917091081365,40.0,0.0
18443,1,8443,[135 211 313  15 172],236,2,37911,4.489696826148744,0.0,0.0
18444,1,8444,[194 197 121 234  70],504,2,37913,4.489402013025459,0.0,0.0
18445,1,8445,[318 427 515 588  79],18,5,37918,4.489462467440209,40.0,0.0
18446,1,8446,[322 117 588 275 357],344,3,37921,4.489286137090091,0.0,20.0
18447,1,8447,[318 427 515 588  79],716,5,37926,4.489346590909091,40.0,0.0
18448,1,8448,[318 427 515 588  79],807,5,37931,4.489407030417801,40.0,0.0
18449,1,8449,[496 603 132  28 216],716,5,37936,4.489467455621302,40.0,0.0
18450,1,8450,[179  96 742 183  12],655,2,37938,4.489172878949237,0.0,0.0
18451,1,8451,[318 427 515 588  79],807,5,37943,4.489233317557974,40.0,0.0
18452,1,8452,[318 427 515 588  79],807,5,37948,4.489293741866793,40.0,0.0
18453,1,8453,[318 427 515 588  79],807,5,37953,4.489354151880766,40.0,0.0
18454,1,8454,[282 655 588 183 153],716,3,37956,4.489178001182732,0.0,0.0
18455,1,8455,[288 200 144 496  88],280,3,37959,4.489001892147588,20.0,0.0
18456,1,8456,[318 427 515 588  79],716,5,37964,4.489062315241812,40.0,0.0
18457,1,8457,[568 294  88 173 172],577,3,37967,4.488886261527548,0.0,0.0
18458,1,8458,[318 427 515 588  79],18,5,37972,4.488946684005201,40.0,0.0
18459,1,8459,[318 427 515 588  79],18,5,37977,4.489007092198581,40.0,0.0
18460,1,8460,[318 427 515 588  79],807,5,37982,4.489067486112752,40.0,0.0
18461,1,8461,[  4 237  28 216 282],450,4,37986,4.4890096903805246,0.0,0.0
18462,1,8462,[318 427 515 588  79],18,5,37991,4.489070069715231,40.0,0.0
18463,1,8463,[318 427 515 588  79],18,5,37996,4.489130434782608,40.0,0.0
18464,1,8464,[202  11  15 125  69],457,5,38001,4.489190785587714,0.0,0.0
18465,1,8465,[ 71 185 176 435 471],389,5,38006,4.4892511221356015,0.0,0.0
18466,1,8466,[318 427 515 588  79],807,5,38011,4.489311444431322,40.0,0.0
18467,1,8467,[200 135  64 195 300],629,5,38016,4.489371752479925,20.0,0.0
18468,1,8468,[ 50 125  56   9  97],796,3,38019,4.48919589089621,0.0,20.0
18469,1,8469,[202  70 427 258 185],655,2,38021,4.4889020070838255,20.0,0.0
18470,1,8470,[318 427 515 588  79],18,5,38026,4.48896234210837,40.0,0.0
18471,1,8471,[318 427 515 588  79],807,5,38031,4.489022662889519,40.0,0.0
18472,1,8472,[318 427 515 588  79],18,5,38036,4.489082969432315,40.0,0.0
18473,1,8473,[435 143 194 546  89],151,4,38040,4.489025253717252,0.0,0.0
18474,1,8474,[222 568 597 202  25],256,4,38044,4.488967551622419,0.0,0.0
18475,1,8475,[748 235 181 125 423],280,2,38046,4.488673902784332,0.0,0.0
18476,1,8476,[471 568 742 546 161],593,3,38049,4.488498289489206,0.0,0.0
18477,1,8477,[318 427 515 588  79],807,5,38054,4.488558622316584,40.0,0.0
18478,1,8478,[318 427 515 588  79],18,5,38059,4.488618940912843,40.0,0.0
18479,1,8479,[318 427 515 588  79],807,5,38064,4.488679245283019,40.0,0.0
18480,1,8480,[318 427 515 588  79],716,5,38069,4.488739535432143,40.0,0.0
18481,1,8481,[318 427 515 588  79],807,5,38074,4.488799811365244,40.0,0.0
18482,1,8482,[318 427 515 588  79],716,5,38079,4.488860073087351,40.0,0.0
18483,1,8483,[318 427 515 588  79],716,5,38084,4.488920320603489,40.0,0.0
18484,1,8484,[318 427 515 588  79],807,5,38089,4.4889805539186804,40.0,0.0
18485,1,8485,[318 427 515 588  79],716,5,38094,4.489040773037945,40.0,0.0
18486,1,8486,[318 427 515 588  79],18,5,38099,4.489100977966301,40.0,0.0
18487,1,8487,[318 427 515 588  79],18,5,38104,4.489161168708765,40.0,0.0
18488,1,8488,[318 427 515 588  79],18,5,38109,4.48922134527035,40.0,0.0
18489,1,8489,[318 427 515 588  79],716,5,38114,4.489281507656066,40.0,0.0
18490,1,8490,[318 427 515 588  79],18,5,38119,4.4893416558709225,40.0,0.0
18491,1,8491,[318 427 515 588  79],807,5,38124,4.489401789919925,40.0,0.0
18492,1,8492,[318 427 515 588  79],716,5,38129,4.489461909808077,40.0,0.0
18493,1,8493,[ 95 132 196 111   1],786,5,38134,4.489522015540381,0.0,0.0
18494,1,8494,[135 100 185 215 195],450,4,38138,4.489464390818128,0.0,20.0
18495,1,8495,[151 276 588 471 216],401,3,38141,4.489289077212806,0.0,0.0
18496,1,8496,[318 427 515 588  79],716,5,38146,4.489349182064258,40.0,0.0
18497,1,8497,[111 405 127  71 508],401,1,38147,4.488938573782066,0.0,20.0
18498,1,8498,[ 69 238 200 161   4],457,5,38152,4.4889987057300855,0.0,0.0
18499,1,8499,[318 427 515 588  79],716,5,38157,4.489058823529412,40.0,0.0
18500,1,8500,[273 195 191 197  28],450,4,38161,4.489001293965416,0.0,0.0
18501,1,8501,[318 427 515 588  79],716,5,38166,4.489061397318278,40.0,0.0
18502,1,8502,[318 427 515 588  79],807,5,38171,4.489121486534164,40.0,0.0
18503,1,8503,[318 427 515 588  79],807,5,38176,4.489181561618062,40.0,0.0
18504,1,8504,[318 427 515 588  79],807,5,38181,4.489241622574956,40.0,0.0
18505,1,8505,[318 427 515 588  79],18,5,38186,4.489301669409828,40.0,0.0
18506,1,8506,[318 427 515 588  79],807,5,38191,4.48936170212766,40.0,0.0
18507,1,8507,[265 195 180  82 210],457,5,38196,4.489421720733428,0.0,0.0
18508,1,8508,[318 427 515 588  79],716,5,38201,4.489481725232107,40.0,0.0
18509,1,8509,[318 427 515 588  79],18,5,38206,4.489541715628672,40.0,0.0
18510,1,8510,[318 427 515 588  79],18,5,38211,4.489601691928093,40.0,0.0
18511,1,8511,[271 117 289  64 568],655,1,38212,4.489191729323308,20.0,0.0
18512,1,8512,[318 427 515 588  79],18,5,38217,4.489251732644191,40.0,0.0
18513,1,8513,[318 427 515 588  79],716,5,38222,4.4893117218698615,40.0,0.0
18514,1,8514,[318 427 515 588  79],18,5,38227,4.489371697005285,40.0,0.0
18515,1,8515,[313  50 288 153 117],280,3,38230,4.489196806012212,0.0,20.0
18516,1,8516,[ 12  98 318 143 471],693,4,38234,4.489139368322179,20.0,0.0
18517,1,8517,[151  69  11 508  70],401,1,38235,4.488729748767316,0.0,0.0
18518,1,8518,[318 427 515 588  79],18,5,38240,4.488789764056814,40.0,0.0
18519,1,8519,[748 174 483 143 194],796,5,38245,4.488849765258216,0.0,0.0
18520,1,8520,[144 117 313 471 196],655,1,38246,4.488440323905645,0.0,0.0
18521,1,8521,[318 427 515 588  79],18,5,38251,4.48850035203004,40.0,0.0
18522,1,8522,[318 427 515 588  79],18,5,38256,4.488560366068286,40.0,0.0
18523,1,8523,[318 427 515 588  79],807,5,38261,4.48862036602534,40.0,0.0
18524,1,8524,[318 427 515 588  79],18,5,38266,4.488680351906158,40.0,0.0
18525,1,8525,[318 427 515 588  79],18,5,38271,4.488740323715693,40.0,0.0
18526,1,8526,[132 187 269 294 423],629,3,38274,4.4885657323795005,0.0,0.0
18527,1,8527,[318 427 515 588  79],18,5,38279,4.488625703564728,40.0,0.0
18528,1,8528,[ 95 197  82 357 132],18,4,38283,4.488568413647555,0.0,0.0
18529,1,8529,[318 427 515 588  79],716,5,38288,4.48862837045721,40.0,0.0
18530,1,8530,[318 427 515 588  79],716,5,38293,4.488688313210644,40.0,0.0
18531,1,8531,[333 127 568  22   9],655,1,38294,4.4882794186591655,0.0,20.0
18532,1,8532,[318 427 515 588  79],18,5,38299,4.488339388257354,40.0,0.0
18533,1,8533,[318 427 515 588  79],716,5,38304,4.488399343801266,40.0,0.0
18534,1,8534,[318 427 515 588  79],18,5,38309,4.488459285295841,40.0,0.0
18535,1,8535,[318 427 515 588  79],807,5,38314,4.4885192127460165,40.0,0.0
18536,1,8536,[423 235 568 435 197],269,2,38316,4.48822771465386,0.0,0.0
18537,1,8537,[318 427 515 588  79],18,5,38321,4.488287655188569,40.0,0.0
18538,1,8538,[318 427 515 588  79],807,5,38326,4.488347581684038,40.0,0.0
18539,1,8539,[318 427 515 588  79],716,5,38331,4.488407494145199,40.0,0.0
18540,1,8540,[318 427 515 588  79],716,5,38336,4.488467392576982,40.0,0.0
18541,1,8541,[318 427 515 588  79],807,5,38341,4.488527276984313,40.0,0.0
18542,1,8542,[318 427 515 588  79],716,5,38346,4.488587147372118,40.0,0.0
18543,1,8543,[318 427 515 588  79],18,5,38351,4.488647003745318,40.0,0.0
18544,1,8544,[318 427 515 588  79],716,5,38356,4.488706846108836,40.0,0.0
18545,1,8545,[121 322 588 195  98],796,4,38360,4.4886496606599575,0.0,0.0
18546,1,8546,[294 200 222 568 357],716,5,38365,4.488709488709489,0.0,0.0
18547,1,8547,[471 222 187 215 197],716,3,38368,4.488535329901731,0.0,0.0
18548,1,8548,[195 200 333 269 100],655,1,38369,4.488127266346941,0.0,20.0
18549,1,8549,[318 427 515 588  79],18,5,38374,4.488187134502924,40.0,0.0
18550,1,8550,[318 427 515 588  79],807,5,38379,4.4882469886562975,40.0,0.0
18551,1,8551,[318 427 515 588  79],18,5,38384,4.488306828811973,40.0,0.0
18552,1,8552,[318 427 515 588  79],807,5,38389,4.488366654974863,40.0,0.0
18553,1,8553,[318 427 515 588  79],18,5,38394,4.488426467149871,40.0,0.0
18554,1,8554,[186 153 174  69 483],18,4,38398,4.488369374634717,0.0,0.0
18555,1,8555,[318 427 515 588  79],807,5,38403,4.488429172510519,40.0,0.0
18556,1,8556,[196 496 111  71 161],786,5,38408,4.488488956409957,20.0,0.0
18557,1,8557,[ 28 195 125 423   1],457,5,38413,4.488548726337929,0.0,0.0
18558,1,8558,[318 427 515 588  79],18,5,38418,4.488608482299334,40.0,0.0
18559,1,8559,[318 427 515 588  79],716,5,38423,4.488668224299065,40.0,0.0
18560,1,8560,[318 427 515 588  79],807,5,38428,4.488727952342016,40.0,0.0
18561,1,8561,[318 427 515 588  79],18,5,38433,4.488787666433076,40.0,0.0
18562,1,8562,[318 427 515 588  79],716,5,38438,4.488847366577134,40.0,0.0
18563,1,8563,[318 427 515 588  79],18,5,38443,4.4889070527790755,40.0,0.0
18564,1,8564,[318 427 515 588  79],716,5,38448,4.488966725043783,40.0,0.0
18565,1,8565,[318 427 515 588  79],716,5,38453,4.489026383376138,40.0,0.0
18566,1,8566,[318 427 515 588  79],807,5,38458,4.4890860277810205,40.0,0.0
18567,1,8567,[603   8  15 234 204],796,4,38462,4.489028944911298,20.0,0.0
18568,1,8568,[ 15 175 357  56 302],269,3,38465,4.488855175633096,0.0,0.0
18569,1,8569,[318 427 515 588  79],807,5,38470,4.4889148191365225,40.0,0.0
18570,1,8570,[318 427 515 588  79],18,5,38475,4.488974448722436,40.0,0.0
18571,1,8571,[318 427 515 588  79],18,5,38480,4.489034064395707,40.0,0.0
18572,1,8572,[318 427 515 588  79],807,5,38485,4.489093666161204,40.0,0.0
18573,1,8573,[318 427 515 588  79],18,5,38490,4.489153254023793,40.0,0.0
18574,1,8574,[318 427 515 588  79],18,5,38495,4.4892128279883385,40.0,0.0
18575,1,8575,[318 427 515 588  79],18,5,38500,4.489272388059701,40.0,0.0
18576,1,8576,[125 322 423  28  11],224,2,38502,4.488982161594963,0.0,0.0
18577,1,8577,[318 427 515 588  79],716,5,38507,4.489041734670086,40.0,0.0
18578,1,8578,[318 427 515 588  79],18,5,38512,4.489101293857093,40.0,0.0
18579,1,8579,[318 427 515 588  79],807,5,38517,4.4891608391608395,40.0,0.0
18580,1,8580,[318 427 515 588  79],18,5,38522,4.489220370586179,40.0,0.0
18581,1,8581,[318 427 515 588  79],807,5,38527,4.489279888137963,40.0,0.0
18582,1,8582,[655 168 222 238 125],151,5,38532,4.489339391821042,0.0,0.0
18583,1,8583,[318 427 515 588  79],807,5,38537,4.489398881640261,40.0,0.0
18584,1,8584,[427 111 153 275 245],796,4,38541,4.489341875364007,20.0,20.0
18585,1,8585,[318 427 515 588  79],807,5,38546,4.489401351036571,40.0,0.0
18586,1,8586,[  4 144 235 117 603],716,2,38548,4.489111447536975,20.0,0.0
18587,1,8587,[318 427 515 588  79],807,5,38553,4.489170936190033,40.0,0.0
18588,1,8588,[ 70 175 435 204 238],151,5,38558,4.489230410990802,0.0,0.0
18589,1,8589,[318 427 515 588  79],716,5,38563,4.489289871944121,40.0,0.0
18590,1,8590,[318 427 515 588  79],807,5,38568,4.489349319054825,40.0,0.0
18591,1,8591,[318 427 515 588  79],716,5,38573,4.489408752327747,40.0,0.0
18592,1,8592,[318 427 515 588  79],807,5,38578,4.489468171767718,40.0,0.0
18593,1,8593,[318 427 515 588  79],18,5,38583,4.489527577379567,40.0,0.0
18594,1,8594,[568 143  28 118 289],693,2,38585,4.489237929028505,0.0,0.0
18595,1,8595,[196 742  56 125 427],796,4,38589,4.489181014425314,20.0,0.0
18596,1,8596,[318 427 515 588  79],807,5,38594,4.489240432709084,40.0,0.0
18597,1,8597,[318 427 515 588  79],716,5,38599,4.489299837171435,40.0,0.0
18598,1,8598,[318 427 515 588  79],807,5,38604,4.489359227817188,40.0,0.0
18599,1,8599,[318 427 515 588  79],807,5,38609,4.489418604651163,40.0,0.0
18600,1,8600,[143 172 183 245 210],796,3,38612,4.489245436577142,0.0,0.0
18601,1,8601,[318 427 515 588  79],716,5,38617,4.489304812834225,40.0,0.0
18602,1,8602,[318 427 515 588  79],807,5,38622,4.48936417528769,40.0,0.0
18603,1,8603,[318 427 515 588  79],807,5,38627,4.489423523942352,40.0,0.0
18604,1,8604,[318 427 515 588  79],18,5,38632,4.489482858803021,40.0,0.0
18605,1,8605,[318 427 515 588  79],716,5,38637,4.4895421798745065,40.0,0.0
18606,1,8606,[318 427 515 588  79],716,5,38642,4.489601487161613,40.0,0.0
18607,1,8607,[185 210 197 238 357],796,2,38644,4.489312267657993,0.0,0.0
18608,1,8608,[318 427 515 588  79],716,5,38649,4.489371587873156,40.0,0.0
18609,1,8609,[318 427 515 588  79],807,5,38654,4.489430894308943,40.0,0.0
18610,1,8610,[318 427 515 588  79],18,5,38659,4.489490186970155,40.0,0.0
18611,1,8611,[318 427 515 588  79],716,5,38664,4.489549465861589,40.0,0.0
18612,1,8612,[174 195 197 185 357],796,4,38668,4.489492627423662,0.0,0.0
18613,1,8613,[318 427 515 588  79],18,5,38673,4.4895518922684,40.0,0.0
18614,1,8614,[318 427 515 588  79],18,5,38678,4.489611143354614,40.0,0.0
18615,1,8615,[195  96  79 215 197],457,5,38683,4.489670380687094,0.0,0.0
18616,1,8616,[117 215 546 143 196],693,3,38686,4.489497504932111,0.0,0.0
18617,1,8617,[202 100 180 748 271],796,3,38689,4.4893246692968205,0.0,20.0
18618,1,8618,[318 427 515 588  79],716,5,38694,4.489383919248173,40.0,0.0
18619,1,8619,[318 427 515 588  79],18,5,38699,4.489443155452436,40.0,0.0
18620,1,8620,[  7 435 197 135 269],535,4,38703,4.489386382090244,0.0,0.0
18621,1,8621,[153 286 181 168 655],151,4,38707,4.489329621897472,0.0,20.0
18622,1,8622,[318 427 515 588  79],18,5,38712,4.489388843789865,40.0,0.0
18623,1,8623,[318 427 515 588  79],18,5,38717,4.4894480519480515,40.0,0.0
18624,1,8624,[318 427 515 588  79],18,5,38722,4.489507246376812,40.0,0.0
18625,1,8625,[318 427 515 588  79],716,5,38727,4.489566427080918,40.0,0.0
18626,1,8626,[ 82  56 168 196 471],389,4,38731,4.489509678915034,0.0,0.0
18627,1,8627,[269 313 185 742 143],450,5,38736,4.489568845618916,0.0,0.0
18628,1,8628,[318 427 515 588  79],716,5,38741,4.489627998609341,40.0,0.0
18629,1,8629,[318 427 515 588  79],716,5,38746,4.489687137891077,40.0,0.0
18630,1,8630,[318 427 515 588  79],716,5,38751,4.489746263468891,40.0,0.0
18631,1,8631,[318 427 515 588  79],18,5,38756,4.489805375347544,40.0,0.0
18632,1,8632,[475 143 238   1 427],389,4,38760,4.489748638943588,20.0,0.0
18633,1,8633,[180 301 182 211 179],535,4,38764,4.489691915682187,0.0,0.0
18634,1,8634,[127   7  79 180 173],292,4,38768,4.4896352055587725,0.0,20.0
18635,1,8635,[144 655 435 568 265],655,0,38768,4.489115331171839,0.0,0.0
18636,1,8636,[318 427 515 588  79],807,5,38773,4.489174481880283,40.0,0.0
18637,1,8637,[318 427 515 588  79],807,5,38778,4.4892336188932624,40.0,0.0
18638,1,8638,[318 427 515 588  79],807,5,38783,4.489292742215534,40.0,0.0
18639,1,8639,[318 427 515 588  79],716,5,38788,4.489351851851852,40.0,0.0
18640,1,8640,[318 427 515 588  79],716,5,38793,4.489410947806967,40.0,0.0
18641,1,8641,[318 427 515 588  79],807,5,38798,4.489470030085628,40.0,0.0
18642,1,8642,[186  82 200   8 405],457,5,38803,4.489529098692584,0.0,0.0
18643,1,8643,[318 427 515 588  79],18,5,38808,4.489588153632577,40.0,0.0
18644,1,8644,[ 28 257 210 118 174],807,5,38813,4.4896471949103525,0.0,0.0
18645,1,8645,[313 275 269 210 121],503,4,38817,4.489590562109646,0.0,20.0
18646,1,8646,[318 427 515 588  79],807,5,38822,4.4896495894529895,40.0,0.0
18647,1,8647,[237 322 678 294  15],224,2,38824,4.48936170212766,0.0,0.0
18648,1,8648,[405   7  71 265 100],450,4,38828,4.489305121979419,0.0,20.0
18649,1,8649,[318 427 515 588  79],716,5,38833,4.489364161849711,40.0,0.0
18650,1,8650,[318 427 515 588  79],18,5,38838,4.489423188070743,40.0,0.0
18651,1,8651,[318 427 515 588  79],716,5,38843,4.489482200647249,40.0,0.0
18652,1,8652,[318 427 515 588  79],18,5,38848,4.489541199583959,40.0,0.0
18653,1,8653,[235 161 357 515 174],401,3,38851,4.48936907788306,0.0,0.0
18654,1,8654,[181 196 301 300 405],450,5,38856,4.489428076256499,0.0,0.0
18655,1,8655,[318 427 515 588  79],18,5,38861,4.489487060998152,40.0,0.0
18656,1,8656,[ 98 185   1 655 143],151,5,38866,4.489546032112741,0.0,0.0
18657,1,8657,[318 427 515 588  79],807,5,38871,4.48960498960499,40.0,0.0
18658,1,8658,[318 427 515 588  79],18,5,38876,4.4896639334796165,40.0,0.0
18659,1,8659,[318 427 515 588  79],18,5,38881,4.489722863741339,40.0,0.0
18660,1,8660,[318 427 515 588  79],807,5,38886,4.489781780394874,40.0,0.0
18661,1,8661,[127 161 597  28  98],450,5,38891,4.489840683444932,0.0,20.0
18662,1,8662,[515 268 435 153   1],296,5,38896,4.489899572896225,0.0,0.0
18663,1,8663,[318 427 515 588  79],18,5,38901,4.4899584487534625,40.0,0.0
18664,1,8664,[318 427 515 588  79],18,5,38906,4.49001731102135,40.0,0.0
18665,1,8665,[318 427 515 588  79],807,5,38911,4.490076159704593,40.0,0.0
18666,1,8666,[257 276 328 174 216],401,4,38915,4.4900196146302065,0.0,0.0
18667,1,8667,[318 427 515 588  79],807,5,38920,4.490078449469312,40.0,0.0
18668,1,8668,[111 237  12  56 216],280,4,38924,4.490021917176145,0.0,0.0
18669,1,8669,[318 427 515 588  79],18,5,38929,4.490080738177624,40.0,0.0
18670,1,8670,[318 427 515 588  79],807,5,38934,4.490139545611809,40.0,0.0
18671,1,8671,[318 427 515 588  79],18,5,38939,4.490198339483395,40.0,0.0
18672,1,8672,[318 427 515 588  79],18,5,38944,4.4902571197970715,40.0,0.0
18673,1,8673,[ 28 181 235 180 153],292,4,38948,4.490200599492737,0.0,0.0
18674,1,8674,[100 121 202 161 204],457,5,38953,4.490259365994237,0.0,20.0
18675,1,8675,[318 427 515 588  79],807,5,38958,4.490318118948824,40.0,0.0
18676,1,8676,[318 427 515 588  79],807,5,38963,4.490376858361185,40.0,0.0
18677,1,8677,[318 427 515 588  79],807,5,38968,4.490435584235999,40.0,0.0
18678,1,8678,[318 427 515 588  79],18,5,38973,4.490494296577947,40.0,0.0
18679,1,8679,[318 427 515 588  79],807,5,38978,4.490552995391705,40.0,0.0
18680,1,8680,[318 427 515 588  79],807,5,38983,4.490611680681949,40.0,0.0
18681,1,8681,[318 427 515 588  79],807,5,38988,4.4906703524533516,40.0,0.0
18682,1,8682,[318 427 515 588  79],18,5,38993,4.4907290107105835,40.0,0.0
18683,1,8683,[318 427 515 588  79],716,5,38998,4.490787655458314,40.0,0.0
18684,1,8684,[318 427 515 588  79],716,5,39003,4.490846286701209,40.0,0.0
18685,1,8685,[ 64 179  70 237 471],65,3,39006,4.490674648860235,20.0,0.0
18686,1,8686,[318 427 515 588  79],716,5,39011,4.490733279613215,40.0,0.0
18687,1,8687,[318 427 515 588  79],716,5,39016,4.490791896869245,40.0,0.0
18688,1,8688,[318 427 515 588  79],716,5,39021,4.490850500632984,40.0,0.0
18689,1,8689,[318 427 515 588  79],18,5,39026,4.490909090909091,40.0,0.0
18690,1,8690,[318 427 515 588  79],807,5,39031,4.490967667702221,40.0,0.0
18691,1,8691,[121 144 496 118 127],807,4,39035,4.490911182696733,20.0,20.0
18692,1,8692,[318 427 515 588  79],716,5,39040,4.49096974577246,40.0,0.0
18693,1,8693,[318 427 515 588  79],716,5,39045,4.491028295376122,40.0,0.0
18694,1,8694,[318 427 515 588  79],807,5,39050,4.491086831512363,40.0,0.0
18695,1,8695,[318 427 515 588  79],18,5,39055,4.491145354185832,40.0,0.0
18696,1,8696,[318 427 515 588  79],807,5,39060,4.491203863401172,40.0,0.0
18697,1,8697,[318 427 515 588  79],716,5,39065,4.491262359163026,40.0,0.0
18698,1,8698,[318 427 515 588  79],807,5,39070,4.491320841476032,40.0,0.0
18699,1,8699,[318 427 515 588  79],18,5,39075,4.491379310344827,40.0,0.0
18700,1,8700,[318 427 515 588  79],18,5,39080,4.491437765774049,40.0,0.0
18701,1,8701,[318 427 515 588  79],716,5,39085,4.491496207768329,40.0,0.0
18702,1,8702,[204 174   8  97 100],330,5,39090,4.4915546363323,0.0,20.0
18703,1,8703,[302 471 258 215  79],344,2,39092,4.491268382352941,0.0,0.0
18704,1,8704,[318 427 515 588  79],18,5,39097,4.4913268236645605,40.0,0.0
18705,1,8705,[258  82 118 405 300],807,4,39101,4.4912703882379965,0.0,0.0
18706,1,8706,[435   4 179 191 181],18,3,39104,4.491099115654071,0.0,0.0
18707,1,8707,[318 427 515 588  79],716,5,39109,4.491157556270096,40.0,0.0
18708,1,8708,[318 427 515 588  79],807,5,39114,4.491215983465381,40.0,0.0
18709,1,8709,[ 50  89 181 357  97],151,5,39119,4.491274397244546,0.0,20.0
18710,1,8710,[168 265 176 210   9],151,4,39123,4.491218000229595,0.0,0.0
18711,1,8711,[318 427 515 588  79],18,5,39128,4.491276400367309,40.0,0.0
18712,1,8712,[318 427 515 588  79],18,5,39133,4.491334787099736,40.0,0.0
18713,1,8713,[318 427 515 588  79],716,5,39138,4.49139316043149,40.0,0.0
18714,1,8714,[318 427 515 588  79],716,5,39143,4.491451520367183,40.0,0.0
18715,1,8715,[318 427 515 588  79],18,5,39148,4.491509866911427,40.0,0.0
18716,1,8716,[318 427 515 588  79],716,5,39153,4.491568200068831,40.0,0.0
18717,1,8717,[318 427 515 588  79],18,5,39158,4.491626519844001,40.0,0.0
18718,1,8718,[318 427 515 588  79],18,5,39163,4.491684826241541,40.0,0.0
18719,1,8719,[318 427 515 588  79],807,5,39168,4.491743119266055,40.0,0.0
18720,1,8720,[318 427 515 588  79],807,5,39173,4.491801398922142,40.0,0.0
18721,1,8721,[318 427 515 588  79],18,5,39178,4.491859665214401,40.0,0.0
18722,1,8722,[318 427 515 588  79],807,5,39183,4.4919179181474265,40.0,0.0
18723,1,8723,[423 258 405  70 118],457,5,39188,4.491976157725814,0.0,0.0
18724,1,8724,[318 427 515 588  79],807,5,39193,4.492034383954155,40.0,0.0
18725,1,8725,[132 385 195  98  15],330,4,39197,4.491977996791198,0.0,0.0
18726,1,8726,[318 427 515 588  79],716,5,39202,4.492036209464879,40.0,0.0
18727,1,8727,[318 427 515 588  79],716,5,39207,4.492094408799267,40.0,0.0
18728,1,8728,[318 427 515 588  79],716,5,39212,4.492152594798946,40.0,0.0
18729,1,8729,[318 427 515 588  79],716,5,39217,4.4922107674684995,40.0,0.0
18730,1,8730,[318 427 515 588  79],807,5,39222,4.492268926812507,40.0,0.0
18731,1,8731,[318 427 515 588  79],716,5,39227,4.492327072835548,40.0,0.0
18732,1,8732,[318 427 515 588  79],18,5,39232,4.492385205542196,40.0,0.0
18733,1,8733,[318 427 515 588  79],18,5,39237,4.492443324937028,40.0,0.0
18734,1,8734,[318 427 515 588  79],18,5,39242,4.492501431024613,40.0,0.0
18735,1,8735,[318 427 515 588  79],18,5,39247,4.492559523809524,40.0,0.0
18736,1,8736,[318 427 515 588  79],716,5,39252,4.492617603296326,40.0,0.0
18737,1,8737,[318 427 515 588  79],18,5,39257,4.492675669489586,40.0,0.0
18738,1,8738,[318 427 515 588  79],18,5,39262,4.492733722393867,40.0,0.0
18739,1,8739,[318 427 515 588  79],807,5,39267,4.49279176201373,40.0,0.0
18740,1,8740,[318 427 515 588  79],18,5,39272,4.492849788353735,40.0,0.0
18741,1,8741,[318 427 515 588  79],807,5,39277,4.49290780141844,40.0,0.0
18742,1,8742,[210 238 135  82  96],457,5,39282,4.4929658012123985,0.0,0.0
18743,1,8743,[318 427 515 588  79],18,5,39287,4.493023787740165,40.0,0.0
18744,1,8744,[ 70 385 174 185 211],151,4,39291,4.492967409948542,0.0,0.0
18745,1,8745,[318 427 515 588  79],807,5,39296,4.4930253830322435,40.0,0.0
18746,1,8746,[318 427 515 588  79],716,5,39301,4.493083342860409,40.0,0.0
18747,1,8747,[318 427 515 588  79],18,5,39306,4.4931412894375855,40.0,0.0
18748,1,8748,[318 427 515 588  79],716,5,39311,4.493199222768316,40.0,0.0
18749,1,8749,[318 427 515 588  79],18,5,39316,4.493257142857143,40.0,0.0
18750,1,8750,[318 427 515 588  79],716,5,39321,4.493315049708604,40.0,0.0
18751,1,8751,[318 427 515 588  79],716,5,39326,4.493372943327239,40.0,0.0
18752,1,8752,[318 427 515 588  79],18,5,39331,4.493430823717582,40.0,0.0
18753,1,8753,[269 161 301 597 245],450,5,39336,4.493488690884167,0.0,0.0
18754,1,8754,[318 427 515 588  79],807,5,39341,4.493546544831525,40.0,0.0
18755,1,8755,[318 427 515 588  79],807,5,39346,4.4936043855641845,40.0,0.0
18756,1,8756,[318 427 515 588  79],807,5,39351,4.493662213086673,40.0,0.0
18757,1,8757,[ 79 265  95 269 333],796,4,39355,4.493605846083581,0.0,0.0
18758,1,8758,[318 427 515 588  79],18,5,39360,4.493663660235186,40.0,0.0
18759,1,8759,[318 427 515 588  79],716,5,39365,4.4937214611872145,40.0,0.0
18760,1,8760,[318 427 515 588  79],807,5,39370,4.493779248944184,40.0,0.0
18761,1,8761,[318 427 515 588  79],18,5,39375,4.493837023510614,40.0,0.0
18762,1,8762,[318 427 515 588  79],18,5,39380,4.493894784891019,40.0,0.0
18763,1,8763,[318 427 515 588  79],18,5,39385,4.493952533089914,40.0,0.0
18764,1,8764,[318 427 515 588  79],716,5,39390,4.494010268111809,40.0,0.0
18765,1,8765,[318 427 515 588  79],18,5,39395,4.494067989961214,40.0,0.0
18766,1,8766,[318 427 515 588  79],18,5,39400,4.4941256986426374,40.0,0.0
18767,1,8767,[318 427 515 588  79],716,5,39405,4.494183394160584,40.0,0.0
18768,1,8768,[318 427 515 588  79],716,5,39410,4.4942410765195575,40.0,0.0
18769,1,8769,[318 427 515 588  79],716,5,39415,4.494298745724059,40.0,0.0
18770,1,8770,[318 427 515 588  79],807,5,39420,4.494356401778589,40.0,0.0
18771,1,8771,[318 427 515 588  79],18,5,39425,4.494414044687643,40.0,0.0
18772,1,8772,[ 70 175 127  98 179],457,5,39430,4.494471674455716,0.0,20.0
18773,1,8773,[318 427 515 588  79],807,5,39435,4.494529291087304,40.0,0.0
18774,1,8774,[174 135 111  25 202],151,5,39440,4.494586894586894,0.0,0.0
18775,1,8775,[174 271 403  64 318],796,5,39445,4.494644484958979,40.0,0.0
18776,1,8776,[318 427 515 588  79],807,5,39450,4.494702062208043,40.0,0.0
18777,1,8777,[318 427 515 588  79],716,5,39455,4.494759626338574,40.0,0.0
18778,1,8778,[196  88  28 118 234],457,5,39460,4.494817177355052,0.0,0.0
18779,1,8779,[318 427 515 588  79],807,5,39465,4.494874715261959,40.0,0.0
18780,1,8780,[318 427 515 588  79],716,5,39470,4.494932240063774,40.0,0.0
18781,1,8781,[294 483   4 210 265],655,1,39471,4.494534274652699,0.0,0.0
18782,1,8782,[318 427 515 588  79],807,5,39476,4.494591825116703,40.0,0.0
18783,1,8783,[318 427 515 588  79],716,5,39481,4.494649362477231,40.0,0.0
18784,1,8784,[318 427 515 588  79],18,5,39486,4.49470688673876,40.0,0.0
18785,1,8785,[318 427 515 588  79],18,5,39491,4.494764397905759,40.0,0.0
18786,1,8786,[318 427 515 588  79],18,5,39496,4.494821895982701,40.0,0.0
18787,1,8787,[318 427 515 588  79],18,5,39501,4.494879380974056,40.0,0.0
18788,1,8788,[318 427 515 588  79],716,5,39506,4.494936852884287,40.0,0.0
18789,1,8789,[318 427 515 588  79],807,5,39511,4.4949943117178615,40.0,0.0
18790,1,8790,[ 64 196 210 144 357],655,2,39513,4.49471049937436,20.0,0.0
18791,1,8791,[318 427 515 588  79],18,5,39518,4.494767970882621,40.0,0.0
18792,1,8792,[318 427 515 588  79],716,5,39523,4.494825429318777,40.0,0.0
18793,1,8793,[318 427 515 588  79],716,5,39528,4.494882874687287,40.0,0.0
18794,1,8794,[117 216 111  12 211],655,1,39529,4.494485503126777,0.0,0.0
18795,1,8795,[318 427 515 588  79],807,5,39534,4.494542974079127,40.0,0.0
18796,1,8796,[175 294  97 508   4],655,0,39534,4.494032056382858,0.0,0.0
18797,1,8797,[238 186 742 403 318],655,1,39535,4.493634917026597,20.0,0.0
18798,1,8798,[196 288 423 182  11],593,4,39539,4.49357881577452,0.0,0.0
18799,1,8799,[318 427 515 588  79],18,5,39544,4.493636363636363,40.0,0.0
18800,1,8800,[ 56  71   1 143 187],18,5,39549,4.493693898420634,0.0,0.0
18801,1,8801,[318 427 515 588  79],716,5,39554,4.4937514201317885,40.0,0.0
18802,1,8802,[318 144 273 333 183],655,3,39557,4.493581733499943,20.0,0.0
18803,1,8803,[318 427 515 588  79],807,5,39562,4.493639254884144,40.0,0.0
18804,1,8804,[318 427 515 588  79],716,5,39567,4.493696763202726,40.0,0.0
18805,1,8805,[318 427 515 588  79],716,5,39572,4.49375425846014,40.0,0.0
18806,1,8806,[318 427 515 588  79],807,5,39577,4.4938117406608376,40.0,0.0
18807,1,8807,[318 427 515 588  79],716,5,39582,4.493869209809264,40.0,0.0
18808,1,8808,[318 427 515 588  79],18,5,39587,4.493926665909865,40.0,0.0
18809,1,8809,[318 427 515 588  79],18,5,39592,4.493984108967083,40.0,0.0
18810,1,8810,[ 22 546 294 357  88],796,4,39596,4.493928044489842,0.0,0.0
18811,1,8811,[318 427 515 588  79],807,5,39601,4.493985474353154,40.0,0.0
18812,1,8812,[318 427 515 588  79],716,5,39606,4.494042891183479,40.0,0.0
18813,1,8813,[318 427 515 588  79],716,5,39611,4.494100294985251,40.0,0.0
18814,1,8814,[204 603   7 135 111],269,2,39613,4.493817356778219,20.0,0.0
18815,1,8815,[597  97  79 588  70],457,4,39617,4.493761343012705,0.0,0.0
18816,1,8816,[318 427 515 588  79],807,5,39622,4.493818759215152,40.0,0.0
18817,1,8817,[318 427 515 588  79],807,5,39627,4.493876162395101,40.0,0.0
18818,1,8818,[318 427 515 588  79],716,5,39632,4.493933552556979,40.0,0.0
18819,1,8819,[318 427 515 588  79],18,5,39637,4.493990929705215,40.0,0.0
18820,1,8820,[135 288 173 258 127],629,5,39642,4.494048293844235,0.0,20.0
18821,1,8821,[318 427 515 588  79],716,5,39647,4.494105644978463,40.0,0.0
18822,1,8822,[276 405 180 655  28],457,5,39652,4.49416298311232,0.0,0.0
18823,1,8823,[ 88  50   7 151 174],450,5,39657,4.494220308250227,0.0,20.0
18824,1,8824,[318 427 515 588  79],18,5,39662,4.4942776203966,40.0,0.0
18825,1,8825,[313 216  98 237 182],655,4,39666,4.494221617946975,0.0,0.0
18826,1,8826,[318 427 515 588  79],807,5,39671,4.494278916959329,40.0,0.0
18827,1,8827,[318 427 515 588  79],807,5,39676,4.4943362029904845,40.0,0.0
18828,1,8828,[318 427 515 588  79],807,5,39681,4.494393476044852,40.0,0.0
18829,1,8829,[ 71 423 118  96 194],796,5,39686,4.49445073612684,0.0,0.0
18830,1,8830,[ 95 127 179 286 318],786,5,39691,4.494507983240856,20.0,40.0
18831,1,8831,[318 427 515 588  79],807,5,39696,4.494565217391305,40.0,0.0
18832,1,8832,[318 427 515 588  79],716,5,39701,4.494622438582588,40.0,0.0
18833,1,8833,[318 427 515 588  79],807,5,39706,4.494679646819108,40.0,0.0
18834,1,8834,[318 427 515 588  79],716,5,39711,4.494736842105263,40.0,0.0
18835,1,8835,[318 427 515 588  79],807,5,39716,4.494794024445451,40.0,0.0
18836,1,8836,[318 427 515 588  79],807,5,39721,4.494851193844065,40.0,0.0
18837,1,8837,[318 427 515 588  79],18,5,39726,4.494908350305499,40.0,0.0
18838,1,8838,[318 427 515 588  79],18,5,39731,4.494965493834144,40.0,0.0
18839,1,8839,[318 427 515 588  79],716,5,39736,4.495022624434389,40.0,0.0
18840,1,8840,[  8 546  97   7  96],344,3,39739,4.4948535233570865,0.0,0.0
18841,1,8841,[318 427 515 588  79],807,5,39744,4.494910653698258,40.0,0.0
18842,1,8842,[318 427 515 588  79],716,5,39749,4.494967771118398,40.0,0.0
18843,1,8843,[318 427 515 588  79],18,5,39754,4.4950248756218905,40.0,0.0
18844,1,8844,[318 427 515 588  79],716,5,39759,4.495081967213115,40.0,0.0
18845,1,8845,[ 22 300 427   9 161],796,4,39763,4.495026000452182,20.0,0.0
18846,1,8846,[328 238 271 228   1],796,3,39766,4.494857013676953,0.0,0.0
18847,1,8847,[180 191  88 588  98],450,5,39771,4.49491410488246,0.0,0.0
18848,1,8848,[318 427 515 588  79],807,5,39776,4.494971183184541,40.0,0.0
18849,1,8849,[318 427 515 588  79],18,5,39781,4.4950282485875706,40.0,0.0
18850,1,8850,[ 71 176 185 405 222],796,5,39786,4.495085301095921,0.0,0.0
18851,1,8851,[228 175  89 655 427],655,2,39788,4.494803434252146,20.0,0.0
18852,1,8852,[318 125 742  25 515],655,2,39790,4.494521631085508,20.0,0.0
18853,1,8853,[318 427 515 588  79],807,5,39795,4.494578721481816,40.0,0.0
18854,1,8854,[318 427 515 588  79],807,5,39800,4.494635798983625,40.0,0.0
18855,1,8855,[318 427 515 588  79],716,5,39805,4.4946928635953025,40.0,0.0
18856,1,8856,[318 427 515 588  79],807,5,39810,4.494749915321215,40.0,0.0
18857,1,8857,[318 427 515 588  79],716,5,39815,4.494806954165726,40.0,0.0
18858,1,8858,[194 475  98 655 268],269,5,39820,4.494863980133198,0.0,0.0
18859,1,8859,[318 427 515 588  79],18,5,39825,4.494920993227991,40.0,0.0
18860,1,8860,[318 427 515 588  79],18,5,39830,4.494977993454463,40.0,0.0
18861,1,8861,[318 427 515 588  79],716,5,39835,4.495034980816971,40.0,0.0
18862,1,8862,[318 427 515 588  79],18,5,39840,4.495091955319869,40.0,0.0
18863,1,8863,[269 204  50 153 286],796,3,39843,4.494923285198556,0.0,40.0
18864,1,8864,[318 427 515 588  79],807,5,39848,4.4949802594472645,40.0,0.0
18865,1,8865,[235  11  69 403 228],280,3,39851,4.49481163997293,0.0,0.0
18866,1,8866,[318 427 515 588  79],18,5,39856,4.494868613961881,40.0,0.0
18867,1,8867,[185 294  12 200 471],655,2,39858,4.494587280108254,0.0,0.0
18868,1,8868,[546 234 515 423 265],716,4,39862,4.494531514263164,0.0,0.0
18869,1,8869,[ 69 151 183 742 125],577,5,39867,4.494588500563698,0.0,0.0
18870,1,8870,[318 427 515 588  79],18,5,39872,4.494645474016458,40.0,0.0
18871,1,8871,[210 318  56 204 161],450,4,39876,4.494589720468891,20.0,0.0
18872,1,8872,[ 79 257 125 742 597],457,3,39879,4.494421278034487,0.0,0.0
18873,1,8873,[ 95  50 275 204   1],902,4,39883,4.49436556231688,0.0,40.0
18874,1,8874,[172 385 568 222 301],796,4,39887,4.49430985915493,0.0,0.0
18875,1,8875,[179 269  97 313 318],655,3,39890,4.494141505182514,20.0,0.0
18876,1,8876,[318 427 515 588  79],716,5,39895,4.494198490481018,40.0,0.0
18877,1,8877,[318 427 515 588  79],18,5,39900,4.494255462942104,40.0,0.0
18878,1,8878,[318 427 515 588  79],807,5,39905,4.494312422570109,40.0,0.0
18879,1,8879,[318 427 515 588  79],716,5,39910,4.49436936936937,40.0,0.0
18880,1,8880,[318 427 515 588  79],716,5,39915,4.494426303344218,40.0,0.0
18881,1,8881,[318 427 515 588  79],807,5,39920,4.494483224498986,40.0,0.0
18882,1,8882,[318 427 515 588  79],18,5,39925,4.494540132838005,40.0,0.0
18883,1,8883,[318 427 515 588  79],807,5,39930,4.494597028365601,40.0,0.0
18884,1,8884,[318 427 515 588  79],18,5,39935,4.4946539110861,40.0,0.0
18885,1,8885,[603 211 179 273 385],450,4,39939,4.494598244429439,20.0,0.0
18886,1,8886,[318 427 515 588  79],716,5,39944,4.49465511421177,40.0,0.0
18887,1,8887,[318 427 515 588  79],18,5,39949,4.49471197119712,40.0,0.0
18888,1,8888,[318 427 515 588  79],716,5,39954,4.494768815389808,40.0,0.0
18889,1,8889,[318 427 515 588  79],807,5,39959,4.49482564679415,40.0,0.0
18890,1,8890,[318 427 515 588  79],716,5,39964,4.494882465414464,40.0,0.0
18891,1,8891,[318 427 515 588  79],807,5,39969,4.494939271255061,40.0,0.0
18892,1,8892,[143 603 168  64 183],796,5,39974,4.494996064320252,40.0,0.0
18893,1,8893,[318 427 515 588  79],807,5,39979,4.495052844614347,40.0,0.0
18894,1,8894,[318 427 515 588  79],807,5,39984,4.495109612141652,40.0,0.0
18895,1,8895,[318 427 515 588  79],716,5,39989,4.495166366906475,40.0,0.0
18896,1,8896,[318 427 515 588  79],18,5,39994,4.495223108913117,40.0,0.0
18897,1,8897,[318 427 515 588  79],716,5,39999,4.49527983816588,40.0,0.0
18898,1,8898,[318 427 515 588  79],807,5,40004,4.495336554669064,40.0,0.0
18899,1,8899,[318 427 515 588  79],18,5,40009,4.495393258426966,40.0,0.0
18900,1,8900,[318 427 515 588  79],716,5,40014,4.495449949443882,40.0,0.0
18901,1,8901,[318 427 515 588  79],716,5,40019,4.495506627724107,40.0,0.0
18902,1,8902,[318 427 515 588  79],716,5,40024,4.495563293271931,40.0,0.0
18903,1,8903,[318 427 515 588  79],18,5,40029,4.495619946091645,40.0,0.0
18904,1,8904,[286 173 222  98 180],786,5,40034,4.495676586187535,0.0,20.0
18905,1,8905,[200 111 313 100 405],280,2,40036,4.495396362003144,0.0,20.0
18906,1,8906,[318 427 515 588  79],716,5,40041,4.495453014482991,40.0,0.0
18907,1,8907,[318 427 515 588  79],807,5,40046,4.495509654243377,40.0,0.0
18908,1,8908,[318 427 515 588  79],18,5,40051,4.495566281288585,40.0,0.0
18909,1,8909,[318 427 515 588  79],807,5,40056,4.495622895622896,40.0,0.0
18910,1,8910,[318 427 515 588  79],716,5,40061,4.495679497250589,40.0,0.0
18911,1,8911,[318 427 515 588  79],18,5,40066,4.495736086175943,40.0,0.0
18912,1,8912,[  8 168 180  71  98],796,4,40070,4.495680466733984,0.0,0.0
18913,1,8913,[318 427 515 588  79],716,5,40075,4.495737042853937,40.0,0.0
18914,1,8914,[318 427 515 588  79],807,5,40080,4.495793606281548,40.0,0.0
18915,1,8915,[195  28 603 191 282],796,4,40084,4.495737999102737,20.0,0.0
18916,1,8916,[318 427 515 588  79],18,5,40089,4.495794549736458,40.0,0.0
18917,1,8917,[211 143   8 196 151],796,4,40093,4.495738954922628,0.0,0.0
18918,1,8918,[318 427 515 588  79],18,5,40098,4.495795492768248,40.0,0.0
18919,1,8919,[ 70 238 222 125 197],450,4,40102,4.495739910313901,0.0,0.0
18920,1,8920,[318 427 515 588  79],716,5,40107,4.4957964353771995,40.0,0.0
18921,1,8921,[ 71 222 191  89  70],450,3,40110,4.495628782784129,0.0,0.0
18922,1,8922,[318 427 515 588  79],18,5,40115,4.4956853076319625,40.0,0.0
18923,1,8923,[318 427 515 588  79],807,5,40120,4.495741819811744,40.0,0.0
18924,1,8924,[318 427 515 588  79],716,5,40125,4.495798319327731,40.0,0.0
18925,1,8925,[318 427 515 588  79],716,5,40130,4.495854806184181,40.0,0.0
18926,1,8926,[275  97 196 385 161],796,4,40134,4.495799260669878,0.0,20.0
18927,1,8927,[195 197 357 302 202],655,2,40136,4.495519713261649,0.0,0.0
18928,1,8928,[210 742 483 269 322],796,1,40137,4.495128233844776,0.0,0.0
18929,1,8929,[318 427 515 588  79],716,5,40142,4.4951847704367305,40.0,0.0
18930,1,8930,[318 427 515 588  79],716,5,40147,4.495241294367932,40.0,0.0
18931,1,8931,[318 427 515 588  79],18,5,40152,4.495297805642633,40.0,0.0
18932,1,8932,[318 427 515 588  79],18,5,40157,4.495354304265084,40.0,0.0
18933,1,8933,[318 427 515 588  79],807,5,40162,4.495410790239534,40.0,0.0
18934,1,8934,[318 427 515 588  79],716,5,40167,4.495467263570229,40.0,0.0
18935,1,8935,[ 70 423 195 655  96],72,5,40172,4.495523724261415,0.0,0.0
18936,1,8936,[318 427 515 588  79],716,5,40177,4.495580172317332,40.0,0.0
18937,1,8937,[318 427 515 588  79],807,5,40182,4.495636607742224,40.0,0.0
18938,1,8938,[257 234 151 135 153],5,3,40185,4.495469291867099,0.0,0.0
18939,1,8939,[318 427 515 588  79],807,5,40190,4.495525727069351,40.0,0.0
18940,1,8940,[318 427 515 588  79],18,5,40195,4.49558214964769,40.0,0.0
18941,1,8941,[318 427 515 588  79],807,5,40200,4.495638559606352,40.0,0.0
18942,1,8942,[318 427 515 588  79],807,5,40205,4.49569495694957,40.0,0.0
18943,1,8943,[318 427 515 588  79],716,5,40210,4.495751341681574,40.0,0.0
18944,1,8944,[318 427 515 588  79],807,5,40215,4.495807713806596,40.0,0.0
18945,1,8945,[318 427 515 588  79],18,5,40220,4.495864073328862,40.0,0.0
18946,1,8946,[318 427 515 588  79],716,5,40225,4.495920420252599,40.0,0.0
18947,1,8947,[385  25 216 357   1],151,4,40229,4.495864997764864,0.0,0.0
18948,1,8948,[ 15 405  28  88 121],11,2,40231,4.495586099005475,0.0,0.0
18949,1,8949,[318 427 515 588  79],807,5,40236,4.4956424581005585,40.0,0.0
18950,1,8950,[318 427 515 588  79],18,5,40241,4.495698804602838,40.0,0.0
18951,1,8951,[318 427 515 588  79],18,5,40246,4.495755138516532,40.0,0.0
18952,1,8952,[144 182  56 161 301],450,5,40251,4.495811459845862,0.0,0.0
18953,1,8953,[318 427 515 588  79],716,5,40256,4.4958677685950414,40.0,0.0
18954,1,8954,[318 427 515 588  79],716,5,40261,4.495924064768285,40.0,0.0
18955,1,8955,[318 427 515 588  79],807,5,40266,4.495980348369808,40.0,0.0
18956,1,8956,[318 427 515 588  79],18,5,40271,4.496036619403818,40.0,0.0
18957,1,8957,[318 427 515 588  79],807,5,40276,4.496092877874526,40.0,0.0
18958,1,8958,[318 427 515 588  79],807,5,40281,4.496149123786137,40.0,0.0
18959,1,8959,[318 427 515 588  79],807,5,40286,4.496205357142857,40.0,0.0
18960,1,8960,[318 427 515 588  79],807,5,40291,4.496261577948889,40.0,0.0
18961,1,8961,[318 427 515 588  79],18,5,40296,4.496317786208436,40.0,0.0
18962,1,8962,[318 427 515 588  79],807,5,40301,4.496373981925695,40.0,0.0
18963,1,8963,[ 70 282 235  11  64],401,1,40302,4.495983935742972,20.0,0.0
18964,1,8964,[318 427 515 588  79],716,5,40307,4.496040156162856,40.0,0.0
18965,1,8965,[318 427 515 588  79],18,5,40312,4.496096364041936,40.0,0.0
18966,1,8966,[318 427 515 588  79],807,5,40317,4.496152559384409,40.0,0.0
18967,1,8967,[318 427 515 588  79],807,5,40322,4.49620874219447,40.0,0.0
18968,1,8968,[318 427 515 588  79],18,5,40327,4.496264912476307,40.0,0.0
18969,1,8969,[202  15 100  25 427],655,1,40328,4.495875139353401,20.0,20.0
18970,1,8970,[197  15 216 143  89],18,4,40332,4.495819864006243,0.0,0.0
18971,1,8971,[318 427 515 588  79],807,5,40337,4.495876058849754,40.0,0.0
18972,1,8972,[168 186 265 313 427],577,5,40342,4.4959322411679485,20.0,0.0
18973,1,8973,[318 427 515 588  79],716,5,40347,4.49598841096501,40.0,0.0
18974,1,8974,[318 427 515 588  79],807,5,40352,4.496044568245125,40.0,0.0
18975,1,8975,[318 427 515 588  79],807,5,40357,4.496100713012478,40.0,0.0
18976,1,8976,[318 427 515 588  79],807,5,40362,4.496156845271249,40.0,0.0
18977,1,8977,[318 427 515 588  79],716,5,40367,4.496212965025618,40.0,0.0
18978,1,8978,[318 427 515 588  79],716,5,40372,4.496269072279764,40.0,0.0
18979,1,8979,[318 427 515 588  79],716,5,40377,4.496325167037862,40.0,0.0
18980,1,8980,[318 427 515 588  79],18,5,40382,4.496381249304086,40.0,0.0
18981,1,8981,[143 357 173   4  95],786,5,40387,4.4964373190826095,0.0,0.0
18982,1,8982,[318 427 515 588  79],18,5,40392,4.496493376377602,40.0,0.0
18983,1,8983,[318 427 515 588  79],18,5,40397,4.496549421193232,40.0,0.0
18984,1,8984,[215   1  98  12 161],796,4,40401,4.496494156928214,0.0,0.0
18985,1,8985,[318 427 515 588  79],716,5,40406,4.496550189183174,40.0,0.0
18986,1,8986,[237 117 200 483 258],655,2,40408,4.496272393457216,0.0,0.0
18987,1,8987,[318 427 515 588  79],716,5,40413,4.496328437917223,40.0,0.0
18988,1,8988,[318 427 515 588  79],18,5,40418,4.496384469907665,40.0,0.0
18989,1,8989,[318 173  11 197 286],535,4,40422,4.496329254727475,20.0,20.0
18990,1,8990,[318 427 515 588  79],807,5,40427,4.496385274163052,40.0,0.0
18991,1,8991,[318 427 515 588  79],18,5,40432,4.49644128113879,40.0,0.0
18992,1,8992,[496 655 273 185 294],236,1,40433,4.496052485266318,20.0,0.0
18993,1,8993,[318 427 515 588  79],716,5,40438,4.49610851678897,40.0,0.0
18994,1,8994,[318 427 515 588  79],807,5,40443,4.496164535853252,40.0,0.0
18995,1,8995,[318 427 515 588  79],807,5,40448,4.496220542463317,40.0,0.0
18996,1,8996,[318 427 515 588  79],807,5,40453,4.496276536623319,40.0,0.0
18997,1,8997,[318 427 515 588  79],18,5,40458,4.496332518337408,40.0,0.0
18998,1,8998,[286 276 435 288   1],424,1,40459,4.495943993777086,0.0,20.0
18999,1,8999,[294 185 153 483 238],655,2,40461,4.495666666666667,0.0,0.0
19000,1,9000,[318 427 515 588  79],807,5,40466,4.495722697478058,40.0,0.0
19001,1,9001,[318 427 515 588  79],807,5,40471,4.495778715840924,40.0,0.0
19002,1,9002,[318 427 515 588  79],716,5,40476,4.4958347217594135,40.0,0.0
19003,1,9003,[ 95 748 265 228 222],798,3,40479,4.495668591737005,0.0,0.0
19004,1,9004,[237  95  97 215 195],796,4,40483,4.495613548028873,0.0,0.0
19005,1,9005,[322 275 191  89 405],151,2,40485,4.495336442371753,0.0,20.0
19006,1,9006,[318 427 515 588  79],18,5,40490,4.495392472521372,40.0,0.0
19007,1,9007,[318 427 515 588  79],807,5,40495,4.495448490230906,40.0,0.0
19008,1,9008,[ 96 185 238  28 435],655,1,40496,4.495060495060495,0.0,0.0
19009,1,9009,[318 427 515 588  79],716,5,40501,4.49511653718091,40.0,0.0
19010,1,9010,[318 427 515 588  79],18,5,40506,4.495172566862723,40.0,0.0
19011,1,9011,[318 427 515 588  79],716,5,40511,4.495228584110076,40.0,0.0
19012,1,9012,[318 427 515 588  79],18,5,40516,4.495284588927105,40.0,0.0
19013,1,9013,[195 603 215   9 403],18,1,40517,4.4948968271577545,20.0,0.0
19014,1,9014,[318 427 515 588  79],18,5,40522,4.494952856350527,40.0,0.0
19015,1,9015,[318 427 515 588  79],18,5,40527,4.495008873114463,40.0,0.0
19016,1,9016,[151 179   4 216 186],457,5,40532,4.495064877453698,0.0,0.0
19017,1,9017,[318 427 515 588  79],716,5,40537,4.495120869372366,40.0,0.0
19018,1,9018,[322  12  15  50 603],450,4,40541,4.495065971837232,20.0,20.0
19019,1,9019,[318 427 515 588  79],807,5,40546,4.495121951219512,40.0,0.0
19020,1,9020,[196 195 385 222  97],344,3,40549,4.494956213280124,0.0,0.0
19021,1,9021,[289 210 268 275 216],655,2,40551,4.494679671913102,0.0,20.0
19022,1,9022,[196 179 475 257 176],655,1,40552,4.494292363958772,0.0,0.0
19023,1,9023,[318 427 515 588  79],18,5,40557,4.4943484042553195,40.0,0.0
19024,1,9024,[100 742 289 471 300],938,1,40558,4.493961218836565,0.0,20.0
19025,1,9025,[ 95 300 204 195 403],807,4,40562,4.493906492355418,0.0,0.0
19026,1,9026,[318 427 515 588  79],716,5,40567,4.493962556774122,40.0,0.0
19027,1,9027,[228 357 235 182  97],457,4,40571,4.493907842268498,0.0,0.0
19028,1,9028,[318 427 515 588  79],716,5,40576,4.49396389411895,40.0,0.0
19029,1,9029,[318 427 515 588  79],18,5,40581,4.494019933554817,40.0,0.0
19030,1,9030,[318 427 515 588  79],716,5,40586,4.494075960580224,40.0,0.0
19031,1,9031,[318 427 515 588  79],807,5,40591,4.494131975199291,40.0,0.0
19032,1,9032,[318 423 117 121 235],807,4,40595,4.494077272224067,20.0,0.0
19033,1,9033,[318 427 515 588  79],716,5,40600,4.494133274297099,40.0,0.0
19034,1,9034,[318 427 515 588  79],18,5,40605,4.494189263973436,40.0,0.0
19035,1,9035,[269 143 302 172  70],450,5,40610,4.494245241257193,0.0,0.0
19036,1,9036,[234 228 144 153  95],450,3,40613,4.494079893770056,0.0,0.0
19037,1,9037,[228 161 183 210 427],577,3,40616,4.493914582872317,20.0,0.0
19038,1,9038,[318 427 515 588  79],807,5,40621,4.493970571965925,40.0,0.0
19039,1,9039,[318 427 515 588  79],18,5,40626,4.494026548672567,40.0,0.0
19040,1,9040,[318 427 515 588  79],807,5,40631,4.49408251299635,40.0,0.0
19041,1,9041,[318 427 515 588  79],807,5,40636,4.4941384649413845,40.0,0.0
19042,1,9042,[318 427 515 588  79],18,5,40641,4.494194404511777,40.0,0.0
19043,1,9043,[288 195 200  56 235],280,4,40645,4.494139761167625,0.0,0.0
19044,1,9044,[318 427 515 588  79],807,5,40650,4.494195688225539,40.0,0.0
19045,1,9045,[318 427 515 588  79],807,5,40655,4.494251602918417,40.0,0.0
19046,1,9046,[318 427 515 588  79],807,5,40660,4.494307505250359,40.0,0.0
19047,1,9047,[318 427 515 588  79],807,5,40665,4.494363395225464,40.0,0.0
19048,1,9048,[318 427 515 588  79],807,5,40670,4.4944192728478285,40.0,0.0
19049,1,9049,[318 427 515 588  79],807,5,40675,4.494475138121547,40.0,0.0
19050,1,9050,[318 427 515 588  79],807,5,40680,4.494530991050713,40.0,0.0
19051,1,9051,[204 318 197  88   9],504,3,40683,4.494365885992046,20.0,0.0
19052,1,9052,[318 427 515 588  79],18,5,40688,4.494421738650171,40.0,0.0
19053,1,9053,[318 427 515 588  79],807,5,40693,4.494477578970621,40.0,0.0
19054,1,9054,[100 265 300 483 202],450,4,40697,4.494422970734401,0.0,20.0
19055,1,9055,[318 427 515 588  79],18,5,40702,4.494478798586573,40.0,0.0
19056,1,9056,[318 427 515 588  79],18,5,40707,4.494534614110632,40.0,0.0
19057,1,9057,[318 427 515 588  79],716,5,40712,4.494590417310665,40.0,0.0
19058,1,9058,[176 211 125 191 237],450,5,40717,4.4946462081907494,0.0,0.0
19059,1,9059,[318 427 515 588  79],807,5,40722,4.494701986754967,40.0,0.0
19060,1,9060,[318 427 515 588  79],716,5,40727,4.494757753007394,40.0,0.0
19061,1,9061,[405  96 276 132 191],269,3,40730,4.494592805120282,0.0,0.0
19062,1,9062,[318 427 515 588  79],716,5,40735,4.494648571113318,40.0,0.0
19063,1,9063,[294 222  56 153 300],716,5,40740,4.494704324801412,0.0,0.0
19064,1,9064,[318 427 515 588  79],716,5,40745,4.494760066188638,40.0,0.0
19065,1,9065,[318 427 515 588  79],18,5,40750,4.494815795279065,40.0,0.0
19066,1,9066,[318 427 515 588  79],807,5,40755,4.494871512076762,40.0,0.0
19067,1,9067,[318 427 515 588  79],18,5,40760,4.494927216585796,40.0,0.0
19068,1,9068,[318 427 515 588  79],807,5,40765,4.494982908810233,40.0,0.0
19069,1,9069,[318 427 515 588  79],716,5,40770,4.495038588754134,40.0,0.0
19070,1,9070,[318 427 515 588  79],716,5,40775,4.495094256421563,40.0,0.0
19071,1,9071,[195 475 186  69 597],269,1,40776,4.494708994708994,0.0,0.0
19072,1,9072,[318 427 515 588  79],807,5,40781,4.494764686432272,40.0,0.0
19073,1,9073,[318 427 515 588  79],807,5,40786,4.494820365880538,40.0,0.0
19074,1,9074,[318 427 515 588  79],716,5,40791,4.494876033057851,40.0,0.0
19075,1,9075,[ 28 202 211 183 195],716,3,40794,4.494711326575584,0.0,0.0
19076,1,9076,[318 427 515 588  79],18,5,40799,4.494766993500055,40.0,0.0
19077,1,9077,[318 427 515 588  79],807,5,40804,4.494822648160388,40.0,0.0
19078,1,9078,[318 427 515 588  79],807,5,40809,4.494878290560634,40.0,0.0
19079,1,9079,[318 427 515 588  79],18,5,40814,4.494933920704846,40.0,0.0
19080,1,9080,[318 427 515 588  79],18,5,40819,4.49498953859707,40.0,0.0
19081,1,9081,[202 132 222 143  96],716,4,40823,4.494935036335609,0.0,0.0
19082,1,9082,[318 427 515 588  79],18,5,40828,4.494990641858417,40.0,0.0
19083,1,9083,[318 427 515 588  79],716,5,40833,4.495046235138705,40.0,0.0
19084,1,9084,[318 427 515 588  79],807,5,40838,4.495101816180517,40.0,0.0
19085,1,9085,[318 427 515 588  79],18,5,40843,4.495157384987894,40.0,0.0
19086,1,9086,[318 427 515 588  79],807,5,40848,4.495212941564873,40.0,0.0
19087,1,9087,[ 79  15  56 302 742],450,4,40852,4.495158450704225,0.0,0.0
19088,1,9088,[318 427 515 588  79],18,5,40857,4.495213994938937,40.0,0.0
19089,1,9089,[318 427 515 588  79],716,5,40862,4.495269526952695,40.0,0.0
19090,1,9090,[318 427 515 588  79],807,5,40867,4.4953250467495325,40.0,0.0
19091,1,9091,[318 427 515 588  79],18,5,40872,4.49538055433348,40.0,0.0
19092,1,9092,[318 427 515 588  79],18,5,40877,4.495436049708567,40.0,0.0
19093,1,9093,[318 427 515 588  79],716,5,40882,4.495491532878821,40.0,0.0
19094,1,9094,[318 427 515 588  79],716,5,40887,4.4955470038482686,40.0,0.0
19095,1,9095,[174  12 322 268   1],344,2,40889,4.495272647317502,0.0,0.0
19096,1,9096,[318 427 515 588  79],18,5,40894,4.495328130152798,40.0,0.0
19097,1,9097,[ 25  56 153 200 195],18,2,40896,4.495053857990767,0.0,0.0
19098,1,9098,[318 427 515 588  79],807,5,40901,4.495109352676118,40.0,0.0
19099,1,9099,[ 64 172 182 238 471],655,3,40904,4.494945054945055,20.0,0.0
19100,1,9100,[318 427 515 588  79],716,5,40909,4.495000549390177,40.0,0.0
19101,1,9101,[ 22  97  50 187 235],256,3,40912,4.494836299714349,0.0,20.0
19102,1,9102,[318 427 515 588  79],18,5,40917,4.494891793914094,40.0,0.0
19103,1,9103,[132 300  97  98   4],655,1,40918,4.494507908611599,0.0,0.0
19104,1,9104,[318 427 515 588  79],807,5,40923,4.494563426688632,40.0,0.0
19105,1,9105,[174  50   9 176  98],693,2,40925,4.49428947946409,0.0,20.0
19106,1,9106,[318 427 515 588  79],807,5,40930,4.49434500933348,40.0,0.0
19107,1,9107,[318 427 515 588  79],716,5,40935,4.494400527009223,40.0,0.0
19108,1,9108,[318 427 515 588  79],716,5,40940,4.494456032495334,40.0,0.0
19109,1,9109,[318 427 515 588  79],807,5,40945,4.494511525795828,40.0,0.0
19110,1,9110,[318 427 515 588  79],807,5,40950,4.4945670069147186,40.0,0.0
19111,1,9111,[121 100 194 210 216],401,4,40954,4.4945127304653205,0.0,20.0
19112,1,9112,[318 427 515 588  79],807,5,40959,4.49456819927576,40.0,0.0
19113,1,9113,[318 427 515 588  79],18,5,40964,4.494623655913978,40.0,0.0
19114,1,9114,[318 427 515 588  79],18,5,40969,4.4946791003839826,40.0,0.0
19115,1,9115,[318 427 515 588  79],18,5,40974,4.494734532689776,40.0,0.0
19116,1,9116,[300  15 268  22 508],655,0,40974,4.4942415268180325,0.0,0.0
19117,1,9117,[318 427 515 588  79],18,5,40979,4.494296994955034,40.0,0.0
19118,1,9118,[318 427 515 588  79],18,5,40984,4.494352450926637,40.0,0.0
19119,1,9119,[318  69 191 483  28],18,3,40987,4.494188596491228,20.0,0.0
19120,1,9120,[318 427 515 588  79],716,5,40992,4.49424405218726,40.0,0.0
19121,1,9121,[318 427 515 588  79],18,5,40997,4.494299495724622,40.0,0.0
19122,1,9122,[318 427 515 588  79],18,5,41002,4.494354927107311,40.0,0.0
19123,1,9123,[318 427 515 588  79],807,5,41007,4.494410346339325,40.0,0.0
19124,1,9124,[318 427 515 588  79],18,5,41012,4.494465753424658,40.0,0.0
19125,1,9125,[ 64 301 182 427  28],655,3,41015,4.494301994301995,40.0,0.0
19126,1,9126,[318 427 515 588  79],807,5,41020,4.494357401117563,40.0,0.0
19127,1,9127,[318 427 515 588  79],807,5,41025,4.494412795793164,40.0,0.0
19128,1,9128,[318 427 515 588  79],18,5,41030,4.494468178332785,40.0,0.0
19129,1,9129,[318 427 515 588  79],716,5,41035,4.494523548740416,40.0,0.0
19130,1,9130,[282 318 195 655 204],655,1,41036,4.494140838900449,20.0,0.0
19131,1,9131,[318 427 515 588  79],716,5,41041,4.494196233026719,40.0,0.0
19132,1,9132,[ 69 202 655  56 423],450,5,41046,4.494251615022446,0.0,0.0
19133,1,9133,[318 427 515 588  79],807,5,41051,4.4943069848916135,40.0,0.0
19134,1,9134,[318 427 515 588  79],716,5,41056,4.494362342638205,40.0,0.0
19135,1,9135,[318 427 515 588  79],807,5,41061,4.4944176882662,40.0,0.0
19136,1,9136,[121   1 195 172  22],330,4,41065,4.494363576666302,0.0,0.0
19137,1,9137,[  1 258  50 144 191],450,5,41070,4.494418910045962,0.0,20.0
19138,1,9138,[318 427 515 588  79],716,5,41075,4.494474231316336,40.0,0.0
19139,1,9139,[318 427 515 588  79],18,5,41080,4.4945295404814,40.0,0.0
19140,1,9140,[301 202 216 258 288],344,4,41084,4.494475440323816,0.0,0.0
19141,1,9141,[588 202  15 258  88],796,5,41089,4.494530737256618,0.0,0.0
19142,1,9142,[318 427 515 588  79],716,5,41094,4.494586022093404,40.0,0.0
19143,1,9143,[318 427 515 588  79],807,5,41099,4.494641294838146,40.0,0.0
19144,1,9144,[ 64 269 286 276 515],655,3,41102,4.494477856752324,20.0,20.0
19145,1,9145,[318 427 515 588  79],18,5,41107,4.4945331292368245,40.0,0.0
19146,1,9146,[318 427 515 588  79],807,5,41112,4.494588389635946,40.0,0.0
19147,1,9147,[318 427 515 588  79],807,5,41117,4.494643637953651,40.0,0.0
19148,1,9148,[333 385  88 118 234],796,4,41121,4.494589572630889,0.0,0.0
19149,1,9149,[318 427 515 588  79],18,5,41126,4.494644808743169,40.0,0.0
19150,1,9150,[318 427 515 588  79],716,5,41131,4.494700032783302,40.0,0.0
19151,1,9151,[237 313 423  50 215],835,5,41136,4.494755244755245,0.0,20.0
19152,1,9152,[318 427 515 588  79],18,5,41141,4.494810444662952,40.0,0.0
19153,1,9153,[318 427 515 588  79],18,5,41146,4.494865632510378,40.0,0.0
19154,1,9154,[ 64  98 132 200 143],151,4,41150,4.494811578372474,20.0,0.0
19155,1,9155,[318 427 515 588  79],716,5,41155,4.494866754041066,40.0,0.0
19156,1,9156,[318 427 515 588  79],807,5,41160,4.494921917658622,40.0,0.0
19157,1,9157,[318 427 515 588  79],716,5,41165,4.49497706922909,40.0,0.0
19158,1,9158,[318 427 515 588  79],807,5,41170,4.495032208756414,40.0,0.0
19159,1,9159,[318 427 515 588  79],716,5,41175,4.495087336244541,40.0,0.0
19160,1,9160,[318 427 515 588  79],18,5,41180,4.495142451697413,40.0,0.0
19161,1,9161,[318 427 515 588  79],807,5,41185,4.49519755511897,40.0,0.0
19162,1,9162,[318 427 515 588  79],18,5,41190,4.49525264651315,40.0,0.0
19163,1,9163,[121  50  12 742 216],457,5,41195,4.495307725883894,0.0,20.0
19164,1,9164,[318 427 515 588  79],716,5,41200,4.495362793235134,40.0,0.0
19165,1,9165,[318 427 515 588  79],18,5,41205,4.495417848570805,40.0,0.0
19166,1,9166,[194 313 323 496 322],796,3,41208,4.495254718010254,20.0,0.0
19167,1,9167,[318 427 515 588  79],807,5,41213,4.49530977312391,40.0,0.0
19168,1,9168,[318 427 515 588  79],716,5,41218,4.495364816228596,40.0,0.0
19169,1,9169,[405 125   8  89 216],655,2,41220,4.495092693565976,0.0,0.0
19170,1,9170,[ 11 357 204  50 143],330,5,41225,4.49514774833715,0.0,20.0
19171,1,9171,[318 427 515 588  79],18,5,41230,4.495202791103358,40.0,0.0
19172,1,9172,[318 427 515 588  79],18,5,41235,4.4952578218685275,40.0,0.0
19173,1,9173,[318 427 515 588  79],807,5,41240,4.495312840636582,40.0,0.0
19174,1,9174,[318 427 515 588  79],807,5,41245,4.495367847411444,40.0,0.0
19175,1,9175,[318 427 515 588  79],18,5,41250,4.495422842197036,40.0,0.0
19176,1,9176,[318 427 515 588  79],716,5,41255,4.495477824997276,40.0,0.0
19177,1,9177,[318 427 515 588  79],716,5,41260,4.495532795816082,40.0,0.0
19178,1,9178,[271 603 323 258 215],796,4,41264,4.495478810327922,20.0,0.0
19179,1,9179,[318 427 515 588  79],807,5,41269,4.495533769063181,40.0,0.0
19180,1,9180,[318 427 515 588  79],807,5,41274,4.4955887158261625,40.0,0.0
19181,1,9181,[318 427 515 588  79],716,5,41279,4.49564365062078,40.0,0.0
19182,1,9182,[318 427 515 588  79],18,5,41284,4.495698573450942,40.0,0.0
19183,1,9183,[215 322 111 275 196],344,3,41287,4.495535714285714,0.0,20.0
19184,1,9184,[318 427 515 588  79],807,5,41292,4.495590636908002,40.0,0.0
19185,1,9185,[ 70  96 423  28 168],457,5,41297,4.495645547572392,0.0,0.0
19186,1,9186,[403 275 471 215  96],457,5,41302,4.4957004462827905,0.0,20.0
19187,1,9187,[318 427 515 588  79],807,5,41307,4.4957553330431,40.0,0.0
19188,1,9188,[318 427 515 588  79],807,5,41312,4.495810207857221,40.0,0.0
19189,1,9189,[318 427 515 588  79],716,5,41317,4.495865070729053,40.0,0.0
19190,1,9190,[318 427 515 588  79],807,5,41322,4.495919921662496,40.0,0.0
19191,1,9191,[318 427 515 588  79],18,5,41327,4.495974760661444,40.0,0.0
19192,1,9192,[318 427 515 588  79],716,5,41332,4.496029587729795,40.0,0.0
19193,1,9193,[318 427 515 588  79],18,5,41337,4.496084402871438,40.0,0.0
19194,1,9194,[318 427 515 588  79],716,5,41342,4.496139206090266,40.0,0.0
19195,1,9195,[318 427 515 588  79],716,5,41347,4.4961939973901695,40.0,0.0
19196,1,9196,[318 427 515 588  79],18,5,41352,4.496248776775035,40.0,0.0
19197,1,9197,[318 427 515 588  79],716,5,41357,4.496303544248749,40.0,0.0
19198,1,9198,[318 427 515 588  79],807,5,41362,4.496358299815197,40.0,0.0
19199,1,9199,[318 427 515 588  79],18,5,41367,4.4964130434782605,40.0,0.0
19200,1,9200,[405 258 144 127  82],807,3,41370,4.496250407564395,0.0,20.0
19201,1,9201,[197 269 234  64 118],796,2,41372,4.495979134970659,20.0,0.0
19202,1,9202,[318 427 515 588  79],18,5,41377,4.496033901988482,40.0,0.0
19203,1,9203,[222 597 265 132 121],450,3,41380,4.49587136027814,0.0,0.0
19204,1,9204,[318 427 515 588  79],18,5,41385,4.495926127104834,40.0,0.0
19205,1,9205,[318 427 515 588  79],18,5,41390,4.495980882033456,40.0,0.0
19206,1,9206,[318 427 515 588  79],18,5,41395,4.496035625067883,40.0,0.0
19207,1,9207,[318 427 515 588  79],716,5,41400,4.496090356211989,40.0,0.0
19208,1,9208,[144 385 187 200 153],450,4,41404,4.496036486046259,0.0,0.0
19209,1,9209,[318 427 515 588  79],18,5,41409,4.496091205211727,40.0,0.0
19210,1,9210,[318 427 515 588  79],716,5,41414,4.496145912495929,40.0,0.0
19211,1,9211,[318 427 515 588  79],18,5,41419,4.496200607902735,40.0,0.0
19212,1,9212,[185 282 143 179 210],504,4,41423,4.496146749158798,0.0,0.0
19213,1,9213,[318 427 515 588  79],807,5,41428,4.496201432602561,40.0,0.0
19214,1,9214,[318 427 515 588  79],18,5,41433,4.496256104177971,40.0,0.0
19215,1,9215,[313 216 301 153 197],796,3,41436,4.49609375,0.0,0.0
19216,1,9216,[318 427 515 588  79],18,5,41441,4.496148421395248,40.0,0.0
19217,1,9217,[100  12 423 496 288],450,4,41445,4.496094597526579,20.0,20.0
19218,1,9218,[318 427 515 588  79],716,5,41450,4.496149256969303,40.0,0.0
19219,1,9219,[318 427 515 588  79],716,5,41455,4.496203904555315,40.0,0.0
19220,1,9220,[121 187 568 204 222],655,1,41456,4.4958247478581495,0.0,0.0
19221,1,9221,[210 322 117 186   9],786,4,41460,4.495770982433312,0.0,0.0
19222,1,9222,[318 427 515 588  79],18,5,41465,4.495825653258159,40.0,0.0
19223,1,9223,[318 427 515 588  79],807,5,41470,4.495880312228968,40.0,0.0
19224,1,9224,[318 427 515 588  79],807,5,41475,4.495934959349594,40.0,0.0
19225,1,9225,[318 427 515 588  79],807,5,41480,4.495989594623889,40.0,0.0
19226,1,9226,[318 427 515 588  79],716,5,41485,4.496044218055706,40.0,0.0
19227,1,9227,[ 11  50  79 515 211],716,5,41490,4.496098829648894,0.0,20.0
19228,1,9228,[318 427 515 588  79],18,5,41495,4.496153429407303,40.0,0.0
19229,1,9229,[318 427 515 588  79],807,5,41500,4.496208017334778,40.0,0.0
19230,1,9230,[318 427 515 588  79],807,5,41505,4.496262593435164,40.0,0.0
19231,1,9231,[318 427 515 588  79],807,5,41510,4.496317157712305,40.0,0.0
19232,1,9232,[195 197  98  11 127],292,5,41515,4.496371710170043,0.0,20.0
19233,1,9233,[318 427 515 588  79],807,5,41520,4.496426250812216,40.0,0.0
19234,1,9234,[318 427 515 588  79],18,5,41525,4.496480779642663,40.0,0.0
19235,1,9235,[318 427 515 588  79],807,5,41530,4.496535296665223,40.0,0.0
19236,1,9236,[318 427 515 588  79],807,5,41535,4.4965898018837285,40.0,0.0
19237,1,9237,[318 427 515 588  79],807,5,41540,4.496644295302014,40.0,0.0
19238,1,9238,[318 427 515 588  79],716,5,41545,4.4966987769239095,40.0,0.0
19239,1,9239,[318 427 515 588  79],716,5,41550,4.496753246753247,40.0,0.0
19240,1,9240,[ 97 111 180 435 588],450,5,41555,4.496807704793853,0.0,0.0
19241,1,9241,[318 427 515 588  79],807,5,41560,4.496862151049556,40.0,0.0
19242,1,9242,[222   1 191 200 216],457,5,41565,4.496916585524181,0.0,0.0
19243,1,9243,[ 8 96  1  7 88],457,5,41570,4.496971008221549,0.0,0.0
19244,1,9244,[318 427 515 588  79],18,5,41575,4.497025419145484,40.0,0.0
19245,1,9245,[318 427 515 588  79],716,5,41580,4.497079818299805,40.0,0.0
19246,1,9246,[318 427 515 588  79],807,5,41585,4.497134205688331,40.0,0.0
19247,1,9247,[318 427 515 588  79],807,5,41590,4.497188581314879,40.0,0.0
19248,1,9248,[275 271 234 187  82],796,3,41593,4.497026705589794,0.0,20.0
19249,1,9249,[318 427 515 588  79],807,5,41598,4.497081081081081,40.0,0.0
19250,1,9250,[318 427 515 588  79],18,5,41603,4.497135444816776,40.0,0.0
19251,1,9251,[318 427 515 588  79],807,5,41608,4.497189796800692,40.0,0.0
19252,1,9252,[318 427 515 588  79],18,5,41613,4.4972441370366365,40.0,0.0
19253,1,9253,[318 427 515 588  79],716,5,41618,4.49729846552842,40.0,0.0
19254,1,9254,[153 288 183 282 195],292,4,41622,4.497244732576985,0.0,0.0
19255,1,9255,[318 427 515 588  79],18,5,41627,4.497299049265341,40.0,0.0
19256,1,9256,[318 427 515 588  79],716,5,41632,4.497353354218429,40.0,0.0
19257,1,9257,[423  82 187 405 300],796,4,41636,4.497299632750054,0.0,0.0
19258,1,9258,[318 427 515 588  79],716,5,41641,4.497353925909925,40.0,0.0
19259,1,9259,[318 427 515 588  79],716,5,41646,4.497408207343413,40.0,0.0
19260,1,9260,[318 427 515 588  79],716,5,41651,4.497462477054314,40.0,0.0
19261,1,9261,[318 427 515 588  79],716,5,41656,4.4975167350464265,40.0,0.0
19262,1,9262,[318 427 515 588  79],807,5,41661,4.497570981323546,40.0,0.0
19263,1,9263,[275  15 191 127  71],450,3,41664,4.4974093264248705,0.0,40.0
19264,1,9264,[245 200  79   1 322],796,2,41666,4.497139773340529,0.0,0.0
19265,1,9265,[318 427 515 588  79],18,5,41671,4.497194042736887,40.0,0.0
19266,1,9266,[318 427 515 588  79],716,5,41676,4.497248300420848,40.0,0.0
19267,1,9267,[318 427 515 588  79],716,5,41681,4.497302546396202,40.0,0.0
19268,1,9268,[318 427 515 588  79],716,5,41686,4.497356780666738,40.0,0.0
19269,1,9269,[  7 194 175  79 423],421,2,41688,4.497087378640777,0.0,0.0
19270,1,9270,[318 427 515 588  79],716,5,41693,4.497141624420236,40.0,0.0
19271,1,9271,[318 427 515 588  79],716,5,41698,4.4971958584987055,40.0,0.0
19272,1,9272,[318 427 515 588  79],18,5,41703,4.497250080879974,40.0,0.0
19273,1,9273,[318 427 515 588  79],716,5,41708,4.497304291567824,40.0,0.0
19274,1,9274,[275 173 151 204 172],716,5,41713,4.497358490566038,0.0,20.0
19275,1,9275,[318 427 515 588  79],807,5,41718,4.497412677878396,40.0,0.0
19276,1,9276,[ 25 185 196 174   4],18,1,41719,4.497035679637814,0.0,0.0
19277,1,9277,[318 427 515 588  79],18,5,41724,4.497089890062513,40.0,0.0
19278,1,9278,[655 238 191 194 187],629,4,41728,4.497036318568811,0.0,0.0
19279,1,9279,[318 427 515 588  79],18,5,41733,4.4970905172413795,40.0,0.0
19280,1,9280,[318 427 515 588  79],716,5,41738,4.497144704234458,40.0,0.0
19281,1,9281,[318 427 515 588  79],807,5,41743,4.497198879551821,40.0,0.0
19282,1,9282,[318 427 515 588  79],807,5,41748,4.497253043197242,40.0,0.0
19283,1,9283,[318 427 515 588  79],18,5,41753,4.497307195174494,40.0,0.0
19284,1,9284,[318 427 515 588  79],807,5,41758,4.497361335487345,40.0,0.0
19285,1,9285,[125  15 228 183 238],457,5,41763,4.497415464139565,0.0,0.0
19286,1,9286,[318 427 515 588  79],18,5,41768,4.4974695811349195,40.0,0.0
19287,1,9287,[194  11 187   8 597],269,2,41770,4.497200689061154,0.0,0.0
19288,1,9288,[118 286 179 197 276],655,2,41772,4.496931854882119,0.0,20.0
19289,1,9289,[318 427 515 588  79],18,5,41777,4.496986006458558,40.0,0.0
19290,1,9290,[191 235 168 151  96],457,4,41781,4.4969325153374236,0.0,0.0
19291,1,9291,[318 427 515 588  79],18,5,41786,4.496986655187258,40.0,0.0
19292,1,9292,[423  79 546  11 144],450,5,41791,4.497040783385343,0.0,0.0
19293,1,9293,[286 125   9 258  98],11,4,41795,4.496987303636755,0.0,20.0
19294,1,9294,[318 427 515 588  79],18,5,41800,4.497041420118343,40.0,0.0
19295,1,9295,[318 427 515 588  79],716,5,41805,4.497095524956971,40.0,0.0
19296,1,9296,[294 172  22 100  15],796,3,41808,4.496934494998387,0.0,20.0
19297,1,9297,[204 153 405 194 328],450,5,41813,4.49698859969886,0.0,0.0
19298,1,9298,[318 427 515 588  79],18,5,41818,4.497042692762663,40.0,0.0
19299,1,9299,[179 655 234 238 403],457,5,41823,4.497096774193548,0.0,0.0
19300,1,9300,[318 427 515 588  79],716,5,41828,4.49715084399527,40.0,0.0
19301,1,9301,[318 427 515 588  79],716,5,41833,4.497204902171576,40.0,0.0
19302,1,9302,[ 28 286 742 202 228],796,2,41835,4.496936472105772,0.0,20.0
19303,1,9303,[132 216 153 423 111],716,5,41840,4.496990541702494,0.0,0.0
19304,1,9304,[318 427 515 588  79],18,5,41845,4.497044599677593,40.0,0.0
19305,1,9305,[318 427 515 588  79],807,5,41850,4.497098646034816,40.0,0.0
19306,1,9306,[318 427 515 588  79],18,5,41855,4.497152680777909,40.0,0.0
19307,1,9307,[318 427 515 588  79],18,5,41860,4.4972067039106145,40.0,0.0
19308,1,9308,[318 427 515 588  79],807,5,41865,4.497260715436674,40.0,0.0
19309,1,9309,[318 427 515 588  79],18,5,41870,4.4973147153598285,40.0,0.0
19310,1,9310,[318 427 515 588  79],18,5,41875,4.497368703683815,40.0,0.0
19311,1,9311,[318 427 515 588  79],18,5,41880,4.497422680412371,40.0,0.0
19312,1,9312,[185  69 333 322 151],796,4,41884,4.497369268764094,0.0,0.0
19313,1,9313,[318 427 515 588  79],807,5,41889,4.497423233841529,40.0,0.0
19314,1,9314,[186 121  64 318 196],577,5,41894,4.49747718733226,40.0,0.0
19315,1,9315,[ 25 187 151 269 172],450,4,41898,4.497423787033061,0.0,0.0
19316,1,9316,[196 176  79 742 186],577,5,41903,4.4974777288826875,0.0,0.0
19317,1,9317,[318 427 515 588  79],807,5,41908,4.497531659154325,40.0,0.0
19318,1,9318,[318 427 515 588  79],18,5,41913,4.497585577851701,40.0,0.0
19319,1,9319,[318 427 515 588  79],716,5,41918,4.49763948497854,40.0,0.0
19320,1,9320,[318 427 515 588  79],18,5,41923,4.497693380538569,40.0,0.0
19321,1,9321,[318 427 515 588  79],807,5,41928,4.497747264535508,40.0,0.0
19322,1,9322,[318 427 515 588  79],18,5,41933,4.497801136973077,40.0,0.0
19323,1,9323,[318 427 515 588  79],18,5,41938,4.497854997854998,40.0,0.0
19324,1,9324,[318 427 515 588  79],807,5,41943,4.497908847184987,40.0,0.0
19325,1,9325,[483  56 111 173 210],151,5,41948,4.49796268496676,0.0,0.0
19326,1,9326,[318 427 515 588  79],716,5,41953,4.498016511204031,40.0,0.0
19327,1,9327,[318 427 515 588  79],807,5,41958,4.498070325900515,40.0,0.0
19328,1,9328,[318 427 515 588  79],807,5,41963,4.498124129059921,40.0,0.0
19329,1,9329,[318 427 515 588  79],716,5,41968,4.49817792068596,40.0,0.0
19330,1,9330,[318 427 515 588  79],18,5,41973,4.4982317007823385,40.0,0.0
19331,1,9331,[318 427 515 588  79],716,5,41978,4.498285469352765,40.0,0.0
19332,1,9332,[318 427 515 588  79],807,5,41983,4.498339226400943,40.0,0.0
19333,1,9333,[318 427 515 588  79],807,5,41988,4.498392971930576,40.0,0.0
19334,1,9334,[318 427 515 588  79],807,5,41993,4.4984467059453666,40.0,0.0
19335,1,9335,[318 427 515 588  79],716,5,41998,4.498500428449015,40.0,0.0
19336,1,9336,[318 427 515 588  79],18,5,42003,4.4985541394452175,40.0,0.0
19337,1,9337,[318 427 515 588  79],807,5,42008,4.498607838937674,40.0,0.0
19338,1,9338,[318 427 515 588  79],716,5,42013,4.4986615269300785,40.0,0.0
19339,1,9339,[  7 275   4 238 180],535,4,42017,4.498608137044968,0.0,20.0
19340,1,9340,[318 427 515 588  79],807,5,42022,4.4986618135103305,40.0,0.0
19341,1,9341,[237 204  88 153 286],152,5,42027,4.4987154784842645,0.0,20.0
19342,1,9342,[302  28  79 143 496],389,4,42031,4.49866209996789,20.0,0.0
19343,1,9343,[318 427 515 588  79],18,5,42036,4.498715753424658,40.0,0.0
19344,1,9344,[318 427 515 588  79],807,5,42041,4.498769395398609,40.0,0.0
19345,1,9345,[ 88 318 302 204  25],151,4,42045,4.498716028247379,20.0,0.0
19346,1,9346,[318 427 515 588  79],807,5,42050,4.498769658714026,40.0,0.0
19347,1,9347,[318 427 515 588  79],716,5,42055,4.498823277706461,40.0,0.0
19348,1,9348,[318 546 245 195 117],450,5,42060,4.498876885228366,20.0,0.0
19349,1,9349,[318 427 515 588  79],18,5,42065,4.4989304812834225,40.0,0.0
19350,1,9350,[318 427 515 588  79],807,5,42070,4.498984065875307,40.0,0.0
19351,1,9351,[ 64  28 328 144 276],292,4,42074,4.498930710008555,20.0,0.0
19352,1,9352,[318 427 515 588  79],807,5,42079,4.498984283117716,40.0,0.0
19353,1,9353,[318 427 515 588  79],716,5,42084,4.49903784477229,40.0,0.0
19354,1,9354,[318 427 515 588  79],18,5,42089,4.499091394975949,40.0,0.0
19355,1,9355,[318 427 515 588  79],18,5,42094,4.499144933732365,40.0,0.0
19356,1,9356,[318 427 515 588  79],18,5,42099,4.499198461045207,40.0,0.0
19357,1,9357,[318 427 515 588  79],807,5,42104,4.499251976918145,40.0,0.0
19358,1,9358,[318 427 515 588  79],18,5,42109,4.499305481354845,40.0,0.0
19359,1,9359,[318 427 515 588  79],18,5,42114,4.499358974358974,40.0,0.0
19360,1,9360,[318 427 515 588  79],18,5,42119,4.499412455934195,40.0,0.0
19361,1,9361,[568  95 211 237 194],716,5,42124,4.49946592608417,0.0,0.0
19362,1,9362,[318 427 515 588  79],18,5,42129,4.49951938481256,40.0,0.0
19363,1,9363,[318 427 515 588  79],807,5,42134,4.499572832123024,40.0,0.0
19364,1,9364,[237 187 294 483 475],655,2,42136,4.4993059263214095,0.0,0.0
19365,1,9365,[318 427 515 588  79],807,5,42141,4.499359385009609,40.0,0.0
19366,1,9366,[ 11 175 515 197 282],716,3,42144,4.4991993167502935,0.0,0.0
19367,1,9367,[143 228 546 179 153],450,5,42149,4.499252775405636,0.0,0.0
19368,1,9368,[318 427 515 588  79],716,5,42154,4.499306222649162,40.0,0.0
19369,1,9369,[186 258 176 118 181],450,3,42157,4.4991462113127,0.0,0.0
19370,1,9370,[318 427 515 588  79],18,5,42162,4.499199658520969,40.0,0.0
19371,1,9371,[318 427 515 588  79],18,5,42167,4.4992530943235165,40.0,0.0
19372,1,9372,[318 427 515 588  79],18,5,42172,4.499306518723994,40.0,0.0
19373,1,9373,[318 427 515 588  79],807,5,42177,4.499359931726051,40.0,0.0
19374,1,9374,[546 196  64 269 174],450,5,42182,4.499413333333333,20.0,0.0
19375,1,9375,[318 427 515 588  79],716,5,42187,4.499466723549488,40.0,0.0
19376,1,9376,[318 427 515 588  79],716,5,42192,4.49952010237816,40.0,0.0
19377,1,9377,[318 427 515 588  79],807,5,42197,4.49957346982299,40.0,0.0
19378,1,9378,[318 427 515 588  79],807,5,42202,4.4996268258876215,40.0,0.0
19379,1,9379,[318 427 515 588  79],807,5,42207,4.499680170575693,40.0,0.0
19380,1,9380,[111   1  69 181  28],786,5,42212,4.499733503890843,0.0,0.0
19381,1,9381,[333  50 265 603 168],796,5,42217,4.499786825836709,20.0,20.0
19382,1,9382,[313 176 191 405 200],577,3,42220,4.499626984972823,0.0,0.0
19383,1,9383,[318 427 515 588  79],807,5,42225,4.499680306905371,40.0,0.0
19384,1,9384,[318 427 515 588  79],18,5,42230,4.499733617474694,40.0,0.0
19385,1,9385,[318 427 515 588  79],18,5,42235,4.499786916684424,40.0,0.0
19386,1,9386,[318 427 515 588  79],807,5,42240,4.499840204538192,40.0,0.0
19387,1,9387,[318 427 515 588  79],807,5,42245,4.499893481039625,40.0,0.0
19388,1,9388,[ 56 118 197 161 173],562,2,42247,4.49962722334647,0.0,0.0
19389,1,9389,[318 427 515 588  79],716,5,42252,4.499680511182109,40.0,0.0
19390,1,9390,[318 427 515 588  79],807,5,42257,4.499733787669045,40.0,0.0
19391,1,9391,[318 427 515 588  79],18,5,42262,4.499787052810903,40.0,0.0
19392,1,9392,[318 427 515 588  79],716,5,42267,4.499840306611306,40.0,0.0
19393,1,9393,[172 301  69  25  70],655,1,42268,4.499467745369385,0.0,0.0
19394,1,9394,[235 204 117 300 275],716,4,42272,4.4994145822245875,0.0,20.0
19395,1,9395,[318 427 515 588  79],716,5,42277,4.499467858663261,40.0,0.0
19396,1,9396,[318 427 515 588  79],18,5,42282,4.499521123762903,40.0,0.0
19397,1,9397,[496 403 423 276 588],280,4,42286,4.499467971908917,20.0,0.0
19398,1,9398,[471 186  97 238 153],716,3,42289,4.499308437067773,0.0,0.0
19399,1,9399,[318 427 515 588  79],716,5,42294,4.4993617021276595,40.0,0.0
19400,1,9400,[318 427 515 588  79],807,5,42299,4.49941495585576,40.0,0.0
19401,1,9401,[318 427 515 588  79],18,5,42304,4.49946819825569,40.0,0.0
19402,1,9402,[318 427 515 588  79],807,5,42309,4.499521429331065,40.0,0.0
19403,1,9403,[202 172 318 215  22],878,3,42312,4.499361973628243,20.0,0.0
19404,1,9404,[318 427 515 588  79],716,5,42317,4.499415204678362,40.0,0.0
19405,1,9405,[318 427 515 588  79],18,5,42322,4.499468424409951,40.0,0.0
19406,1,9406,[318 427 515 588  79],807,5,42327,4.499521632826618,40.0,0.0
19407,1,9407,[318 427 515 588  79],716,5,42332,4.499574829931973,40.0,0.0
19408,1,9408,[318 427 515 588  79],807,5,42337,4.499628015729621,40.0,0.0
19409,1,9409,[318 427 515 588  79],18,5,42342,4.499681190223167,40.0,0.0
19410,1,9410,[318 427 515 588  79],807,5,42347,4.499734353416215,40.0,0.0
19411,1,9411,[191 301 273  50 132],655,3,42350,4.499575010624734,0.0,20.0
19412,1,9412,[318 427 515 588  79],716,5,42355,4.499628173802188,40.0,0.0
19413,1,9413,[318 427 515 588  79],716,5,42360,4.49968132568515,40.0,0.0
19414,1,9414,[  1   4  69 191 496],151,4,42364,4.499628252788104,20.0,0.0
19415,1,9415,[318 427 515 588  79],807,5,42369,4.499681393372982,40.0,0.0
19416,1,9416,[318 427 515 588  79],807,5,42374,4.499734522671764,40.0,0.0
19417,1,9417,[318 427 515 588  79],716,5,42379,4.499787640688044,40.0,0.0
19418,1,9418,[318 427 515 588  79],18,5,42384,4.4998407474254165,40.0,0.0
19419,1,9419,[ 79 483 174 144  98],535,2,42386,4.499575371549894,0.0,0.0
19420,1,9420,[258   9  50 216  25],65,4,42390,4.499522343700244,0.0,20.0
19421,1,9421,[318 427 515 588  79],807,5,42395,4.499575461685417,40.0,0.0
19422,1,9422,[202  15 215 182 301],450,4,42399,4.499522445081184,0.0,0.0
19423,1,9423,[318 427 515 588  79],807,5,42404,4.499575551782683,40.0,0.0
19424,1,9424,[318 427 515 588  79],18,5,42409,4.499628647214854,40.0,0.0
19425,1,9425,[222  96 238 183 655],450,4,42413,4.499575641841714,0.0,0.0
19426,1,9426,[318 427 515 588  79],807,5,42418,4.499628725999788,40.0,0.0
19427,1,9427,[318 427 515 588  79],807,5,42423,4.499681798896903,40.0,0.0
19428,1,9428,[318 427 515 588  79],716,5,42428,4.499734860536642,40.0,0.0
19429,1,9429,[318 427 515 588  79],716,5,42433,4.499787910922588,40.0,0.0
19430,1,9430,[318 427 515 588  79],18,5,42438,4.499840950058318,40.0,0.0
19431,1,9431,[318 427 515 588  79],807,5,42443,4.499893977947413,40.0,0.0
19432,1,9432,[318 427 515 588  79],807,5,42448,4.499946994593449,40.0,0.0
19433,1,9433,[ 97 172 742  70 100],593,5,42453,4.5,0.0,20.0
19434,1,9434,[318 427 515 588  79],18,5,42458,4.500052994170641,40.0,0.0
19435,1,9435,[318 427 515 588  79],18,5,42463,4.500105977108944,40.0,0.0
19436,1,9436,[318 427 515 588  79],807,5,42468,4.5001589488184806,40.0,0.0
19437,1,9437,[  8 273  97 257 211],655,1,42469,4.499788090697182,0.0,0.0
19438,1,9438,[318 427 515 588  79],18,5,42474,4.499841084860685,40.0,0.0
19439,1,9439,[318 427 515 588  79],807,5,42479,4.49989406779661,40.0,0.0
19440,1,9440,[318 427 515 588  79],716,5,42484,4.499947039508527,40.0,0.0
19441,1,9441,[174 100 195 258   9],629,5,42489,4.5,0.0,20.0
19442,1,9442,[195 568  69  56 191],269,2,42491,4.499735253627025,0.0,0.0
19443,1,9443,[197 597 318  50 237],457,4,42495,4.499682337992376,20.0,20.0
19444,1,9444,[200 202   7 186  98],269,2,42497,4.499417681312864,0.0,0.0
19445,1,9445,[210  95   7 125  56],450,3,42500,4.499258945585433,0.0,0.0
19446,1,9446,[318 427 515 588  79],807,5,42505,4.499311950883879,40.0,0.0
19447,1,9447,[ 11 275 180 202 318],450,5,42510,4.499364944961897,20.0,20.0
19448,1,9448,[318 427 515 588  79],807,5,42515,4.49941792782305,40.0,0.0
19449,1,9449,[318 427 515 588  79],807,5,42520,4.499470899470899,40.0,0.0
19450,1,9450,[603 322 313 181 257],796,4,42524,4.4994180509998944,20.0,0.0
19451,1,9451,[ 64 289 143   4  56],655,2,42526,4.499153618281845,20.0,0.0
19452,1,9452,[318 427 515 588  79],807,5,42531,4.499206601079022,40.0,0.0
19453,1,9453,[318 427 515 588  79],18,5,42536,4.499259572667654,40.0,0.0
19454,1,9454,[318 427 515 588  79],18,5,42541,4.499312533051295,40.0,0.0
19455,1,9455,[318 427 515 588  79],807,5,42546,4.499365482233503,40.0,0.0
19456,1,9456,[175 211 132 276 144],655,1,42547,4.498995453103521,0.0,0.0
19457,1,9457,[302 322 196 678  89],344,3,42550,4.4988369634172125,0.0,0.0
19458,1,9458,[318 427 515 588  79],716,5,42555,4.498889946083096,40.0,0.0
19459,1,9459,[318 427 515 588  79],716,5,42560,4.498942917547569,40.0,0.0
19460,1,9460,[318 427 515 588  79],716,5,42565,4.498995877814185,40.0,0.0
19461,1,9461,[ 69 187 286 588 237],835,3,42568,4.498837455083492,0.0,20.0
19462,1,9462,[318 427 515 588  79],807,5,42573,4.498890415301702,40.0,0.0
19463,1,9463,[318 427 515 588  79],807,5,42578,4.49894336432798,40.0,0.0
19464,1,9464,[318 427 515 588  79],18,5,42583,4.4989963021658745,40.0,0.0
19465,1,9465,[318 427 515 588  79],18,5,42588,4.499049228818931,40.0,0.0
19466,1,9466,[318 427 515 588  79],807,5,42593,4.499102144290694,40.0,0.0
19467,1,9467,[318 427 515 588  79],807,5,42598,4.499155048584706,40.0,0.0
19468,1,9468,[318 427 515 588  79],18,5,42603,4.499207941704509,40.0,0.0
19469,1,9469,[318 427 515 588  79],18,5,42608,4.499260823653643,40.0,0.0
19470,1,9470,[318 427 515 588  79],716,5,42613,4.499313694435646,40.0,0.0
19471,1,9471,[318 427 515 588  79],807,5,42618,4.499366554054054,40.0,0.0
19472,1,9472,[318 427 515 588  79],807,5,42623,4.4994194025124035,40.0,0.0
19473,1,9473,[318 427 515 588  79],716,5,42628,4.499472239814229,40.0,0.0
19474,1,9474,[179 276 118 143 323],504,2,42630,4.499208443271768,0.0,0.0
19475,1,9475,[318 427 515 588  79],807,5,42635,4.499261291684255,40.0,0.0
19476,1,9476,[318 427 515 588  79],716,5,42640,4.499314128943759,40.0,0.0
19477,1,9477,[318 427 515 588  79],716,5,42645,4.499366955053809,40.0,0.0
19478,1,9478,[318 427 515 588  79],807,5,42650,4.499419770017934,40.0,0.0
19479,1,9479,[318 427 515 588  79],716,5,42655,4.499472573839663,40.0,0.0
19480,1,9480,[191 286  98 172 275],786,5,42660,4.499525366522518,0.0,40.0
19481,1,9481,[121 135  15   7 173],269,1,42661,4.499156296140055,0.0,0.0
19482,1,9482,[318 427 515 588  79],18,5,42666,4.49920911104081,40.0,0.0
19483,1,9483,[318 427 515 588  79],716,5,42671,4.49926191480388,40.0,0.0
19484,1,9484,[318 427 515 588  79],716,5,42676,4.499314707432789,40.0,0.0
19485,1,9485,[  9   7 175 269 121],655,0,42676,4.498840396373603,0.0,0.0
19486,1,9486,[318 427 515 588  79],18,5,42681,4.498893222304206,40.0,0.0
19487,1,9487,[318 427 515 588  79],716,5,42686,4.498946037099494,40.0,0.0
19488,1,9488,[318 427 515 588  79],807,5,42691,4.498998840762988,40.0,0.0
19489,1,9489,[237 265 173  70 435],535,4,42695,4.498946259220232,0.0,0.0
19490,1,9490,[471 288  96 174 228],457,5,42700,4.498999051733221,0.0,0.0
19491,1,9491,[318 427 515 588  79],807,5,42705,4.499051833122629,40.0,0.0
19492,1,9492,[204 186  50 228 176],655,1,42706,4.498683240282313,0.0,20.0
19493,1,9493,[318 427 515 588  79],807,5,42711,4.498736043817147,40.0,0.0
19494,1,9494,[471 282 237 215 127],450,5,42716,4.498788836229594,0.0,20.0
19495,1,9495,[318 427 515 588  79],807,5,42721,4.498841617523167,40.0,0.0
19496,1,9496,[135 185 153   1  56],18,3,42724,4.498683794882594,0.0,0.0
19497,1,9497,[318 427 515 588  79],807,5,42729,4.4987365761212885,40.0,0.0
19498,1,9498,[151 597 196  11 655],450,5,42734,4.498789346246974,0.0,0.0
19499,1,9499,[318 427 515 588  79],18,5,42739,4.498842105263158,40.0,0.0
19500,1,9500,[275 597 313 151 423],796,5,42744,4.498894853173351,0.0,20.0
19501,1,9501,[318 427 515 588  79],716,5,42749,4.498947589981056,40.0,0.0
19502,1,9502,[318 427 515 588  79],716,5,42754,4.499000315689782,40.0,0.0
19503,1,9503,[318 427 515 588  79],716,5,42759,4.49905303030303,40.0,0.0
19504,1,9504,[196 322 597 405 588],344,2,42761,4.498790110468175,0.0,0.0
19505,1,9505,[318 427 515 588  79],716,5,42766,4.498842836103513,40.0,0.0
19506,1,9506,[318 427 515 588  79],807,5,42771,4.498895550646892,40.0,0.0
19507,1,9507,[318 427 515 588  79],18,5,42776,4.498948254101809,40.0,0.0
19508,1,9508,[318 427 515 588  79],807,5,42781,4.499000946471764,40.0,0.0
19509,1,9509,[234 132  95 174  79],450,3,42784,4.498843322818086,0.0,0.0
19510,1,9510,[ 11 597 405 273  95],450,3,42787,4.498685732309957,0.0,0.0
19511,1,9511,[121 435 127  11 179],655,2,42789,4.498423044575273,0.0,20.0
19512,1,9512,[ 11 153 172  79 194],535,3,42792,4.498265531378114,0.0,0.0
19513,1,9513,[318 427 515 588  79],716,5,42797,4.498318267815851,40.0,0.0
19514,1,9514,[318 427 515 588  79],807,5,42802,4.498370993168681,40.0,0.0
19515,1,9515,[318 427 515 588  79],18,5,42807,4.498423707440101,40.0,0.0
19516,1,9516,[318 427 515 588  79],716,5,42812,4.498476410633603,40.0,0.0
19517,1,9517,[318 427 515 588  79],807,5,42817,4.498529102752679,40.0,0.0
19518,1,9518,[288 313 435   9  79],655,2,42819,4.498266624645446,0.0,0.0
19519,1,9519,[318 427 515 588  79],716,5,42824,4.498319327731092,40.0,0.0
19520,1,9520,[318 427 515 588  79],807,5,42829,4.498372019745825,40.0,0.0
19521,1,9521,[318 427 515 588  79],716,5,42834,4.498424700693132,40.0,0.0
19522,1,9522,[318 427 515 588  79],18,5,42839,4.498477370576499,40.0,0.0
19523,1,9523,[185 172 161 405 282],401,1,42840,4.498110037799244,0.0,0.0
19524,1,9524,[174 435 234 258 423],151,5,42845,4.498162729658793,0.0,0.0
19525,1,9525,[318 427 515 588  79],807,5,42850,4.498215410455595,40.0,0.0
19526,1,9526,[211 286  98  71 143],18,5,42855,4.498268080193135,0.0,20.0
19527,1,9527,[318 427 515 588  79],18,5,42860,4.498320738874895,40.0,0.0
19528,1,9528,[318 427 515 588  79],18,5,42865,4.498373386504355,40.0,0.0
19529,1,9529,[403 216 294 257  70],457,3,42868,4.4982161594963275,0.0,0.0
19530,1,9530,[318 427 515 588  79],18,5,42873,4.498268807050676,40.0,0.0
19531,1,9531,[318 427 515 588  79],18,5,42878,4.49832144355854,40.0,0.0
19532,1,9532,[318 427 515 588  79],18,5,42883,4.498374069023392,40.0,0.0
19533,1,9533,[215 204  88 257 301],655,0,42883,4.49790224459828,0.0,0.0
19534,1,9534,[318 427 515 588  79],716,5,42888,4.497954902988988,40.0,0.0
19535,1,9535,[245 265 194 323 187],796,3,42891,4.4977978187919465,0.0,0.0
19536,1,9536,[318 282 258 322 200],504,5,42896,4.497850477089232,20.0,0.0
19537,1,9537,[318 427 515 588  79],716,5,42901,4.4979031243447265,40.0,0.0
19538,1,9538,[423 265 204 357 276],535,2,42903,4.497641262186812,0.0,0.0
19539,1,9539,[318 427 515 588  79],807,5,42908,4.49769392033543,40.0,0.0
19540,1,9540,[173 222  97  89   4],151,5,42913,4.497746567445761,0.0,0.0
19541,1,9541,[318 427 515 588  79],18,5,42918,4.497799203521274,40.0,0.0
19542,1,9542,[ 89 182 276  64 179],269,4,42922,4.497747039714974,20.0,0.0
19543,1,9543,[318 427 515 588  79],807,5,42927,4.497799664710813,40.0,0.0
19544,1,9544,[313 471 195 288  50],450,4,42931,4.497747511786276,0.0,20.0
19545,1,9545,[318 427 515 588  79],716,5,42936,4.497800125707102,40.0,0.0
19546,1,9546,[168 318 121  96 196],457,5,42941,4.497852728605845,20.0,0.0
19547,1,9547,[318 427 515 588  79],18,5,42946,4.497905320485966,40.0,0.0
19548,1,9548,[318 427 515 588  79],807,5,42951,4.497957901350927,40.0,0.0
19549,1,9549,[318 427 515 588  79],18,5,42956,4.498010471204188,40.0,0.0
19550,1,9550,[318 427 515 588  79],716,5,42961,4.4980630300492095,40.0,0.0
19551,1,9551,[318 427 515 588  79],18,5,42966,4.498115577889447,40.0,0.0
19552,1,9552,[318 427 515 588  79],807,5,42971,4.498168114728357,40.0,0.0
19553,1,9553,[742 508 228  11 202],655,0,42971,4.497697299560394,0.0,0.0
19554,1,9554,[ 28 228  96 117 385],450,5,42976,4.497749869178441,0.0,0.0
19555,1,9555,[153 187 111   9  88],18,3,42979,4.497593135203013,0.0,0.0
19556,1,9556,[318 427 515 588  79],807,5,42984,4.497645704719054,40.0,0.0
19557,1,9557,[318 427 515 588  79],18,5,42989,4.4976982632349864,40.0,0.0
19558,1,9558,[ 50 276 288 125  25],593,3,42992,4.497541583847683,0.0,20.0
19559,1,9559,[318 427 515 588  79],18,5,42997,4.497594142259414,40.0,0.0
19560,1,9560,[176 265 204  15 322],796,4,43001,4.4975420981068925,0.0,0.0
19561,1,9561,[318 427 515 588  79],18,5,43006,4.497594645471659,40.0,0.0
19562,1,9562,[318 427 515 588  79],716,5,43011,4.497647181846701,40.0,0.0
19563,1,9563,[318 427 515 588  79],807,5,43016,4.4976997072354665,40.0,0.0
19564,1,9564,[318 427 515 588  79],716,5,43021,4.4977522216414005,40.0,0.0
19565,1,9565,[318 427 515 588  79],807,5,43026,4.497804725067949,40.0,0.0
19566,1,9566,[318 427 515 588  79],18,5,43031,4.497857217518553,40.0,0.0
19567,1,9567,[318 427 515 588  79],807,5,43036,4.497909698996655,40.0,0.0
19568,1,9568,[318 427 515 588  79],807,5,43041,4.497962169505695,40.0,0.0
19569,1,9569,[318 427 515 588  79],18,5,43046,4.498014629049112,40.0,0.0
19570,1,9570,[204 286 182 265 238],450,5,43051,4.498067077630342,0.0,20.0
19571,1,9571,[268 144 172 328 197],629,4,43055,4.498015043877977,0.0,0.0
19572,1,9572,[318 427 515 588  79],18,5,43060,4.498067481458268,40.0,0.0
19573,1,9573,[318 427 515 588  79],807,5,43065,4.498119908084395,40.0,0.0
19574,1,9574,[318 427 515 588  79],18,5,43070,4.498172323759791,40.0,0.0
19575,1,9575,[271  50 483 216 568],655,3,43073,4.498015873015873,0.0,20.0
19576,1,9576,[318 427 515 588  79],18,5,43078,4.498068288608124,40.0,0.0
19577,1,9577,[318 427 515 588  79],716,5,43083,4.498120693255377,40.0,0.0
19578,1,9578,[318 427 515 588  79],807,5,43088,4.498173086961061,40.0,0.0
19579,1,9579,[132 179 210 294 258],504,3,43091,4.498016701461378,0.0,0.0
19580,1,9580,[127 273  79 176 200],450,3,43094,4.4978603486066175,0.0,20.0
19581,1,9581,[318 427 515 588  79],807,5,43099,4.4979127530786895,40.0,0.0
19582,1,9582,[318 427 515 588  79],807,5,43104,4.4979651466137955,40.0,0.0
19583,1,9583,[191 202  15  79 288],457,5,43109,4.498017529215359,0.0,0.0
19584,1,9584,[318 427 515 588  79],18,5,43114,4.498069900886803,40.0,0.0
19585,1,9585,[ 98 176 191 132 258],796,5,43119,4.498122261631546,0.0,0.0
19586,1,9586,[318 427 515 588  79],716,5,43124,4.49817461145301,40.0,0.0
19587,1,9587,[318 427 515 588  79],716,5,43129,4.49822695035461,40.0,0.0
19588,1,9588,[318 427 515 588  79],18,5,43134,4.498279278339765,40.0,0.0
19589,1,9589,[318 427 515 588  79],807,5,43139,4.498331595411887,40.0,0.0
19590,1,9590,[318 427 515 588  79],716,5,43144,4.4983839015743925,40.0,0.0
19591,1,9591,[318 427 515 588  79],807,5,43149,4.498436196830692,40.0,0.0
19592,1,9592,[282 174 294 191 275],401,3,43152,4.498279995830293,0.0,20.0
19593,1,9593,[168 357 118 318   7],457,5,43157,4.498332291015218,20.0,0.0
19594,1,9594,[318 427 515 588  79],807,5,43162,4.498384575299635,40.0,0.0
19595,1,9595,[202   4 200 153  70],264,5,43167,4.498436848686953,0.0,0.0
19596,1,9596,[318 427 515 588  79],716,5,43172,4.498489111180577,40.0,0.0
19597,1,9597,[318 427 515 588  79],18,5,43177,4.4985413627839135,40.0,0.0
19598,1,9598,[318 427 515 588  79],18,5,43182,4.498593603500365,40.0,0.0
19599,1,9599,[318 427 515 588  79],807,5,43187,4.498645833333334,40.0,0.0
19600,1,9600,[588 191 202 483 176],796,5,43192,4.49869805228622,0.0,0.0
19601,1,9601,[180  97 174 121 323],504,5,43197,4.498750260362424,0.0,0.0
19602,1,9602,[318 427 515 588  79],716,5,43202,4.498802457565344,40.0,0.0
19603,1,9603,[318 427 515 588  79],807,5,43207,4.498854643898376,40.0,0.0
19604,1,9604,[318 427 515 588  79],807,5,43212,4.498906819364914,40.0,0.0
19605,1,9605,[318 427 515 588  79],716,5,43217,4.498958983968353,40.0,0.0
19606,1,9606,[318 427 515 588  79],18,5,43222,4.499011137712085,40.0,0.0
19607,1,9607,[318 427 515 588  79],18,5,43227,4.499063280599501,40.0,0.0
19608,1,9608,[318 427 515 588  79],18,5,43232,4.499115412633989,40.0,0.0
19609,1,9609,[318 427 515 588  79],807,5,43237,4.499167533818938,40.0,0.0
19610,1,9610,[318 427 515 588  79],807,5,43242,4.499219644157736,40.0,0.0
19611,1,9611,[318 427 515 588  79],807,5,43247,4.499271743653766,40.0,0.0
19612,1,9612,[318 427 515 588  79],807,5,43252,4.499323832310413,40.0,0.0
19613,1,9613,[117  97  56 568  82],457,5,43257,4.499375910131059,0.0,0.0
19614,1,9614,[ 96  98 257 161  22],655,1,43258,4.499011960478419,0.0,0.0
19615,1,9615,[318 427 515 588  79],18,5,43263,4.499064059900166,40.0,0.0
19616,1,9616,[318 427 515 588  79],18,5,43268,4.4991161484870545,40.0,0.0
19617,1,9617,[318 427 515 588  79],716,5,43273,4.499168226242462,40.0,0.0
19618,1,9618,[318 427 515 588  79],18,5,43278,4.499220293169768,40.0,0.0
19619,1,9619,[216   1  50  11 655],716,5,43283,4.499272349272349,0.0,20.0
19620,1,9620,[111 265 483 405 204],796,5,43288,4.499324394553581,0.0,0.0
19621,1,9621,[318 427 515 588  79],716,5,43293,4.499376429016836,40.0,0.0
19622,1,9622,[318 427 515 588  79],807,5,43298,4.499428452665489,40.0,0.0
19623,1,9623,[215  88 132 194 357],23,2,43300,4.499168744804655,0.0,0.0
19624,1,9624,[318 427 515 588  79],807,5,43305,4.499220779220779,40.0,0.0
19625,1,9625,[318 427 515 588  79],18,5,43310,4.49927280282568,40.0,0.0
19626,1,9626,[318 427 515 588  79],807,5,43315,4.499324815622728,40.0,0.0
19627,1,9627,[318 427 515 588  79],807,5,43320,4.499376817615289,40.0,0.0
19628,1,9628,[168 238 286   4 127],18,3,43323,4.499221102918268,0.0,40.0
19629,1,9629,[318 427 515 588  79],18,5,43328,4.499273104880581,40.0,0.0
19630,1,9630,[318 427 515 588  79],18,5,43333,4.499325096044024,40.0,0.0
19631,1,9631,[318 427 515 588  79],18,5,43338,4.49937707641196,40.0,0.0
19632,1,9632,[ 88 300 216 125 118],450,4,43342,4.4993252361673415,0.0,0.0
19633,1,9633,[318 427 515 588  79],18,5,43347,4.499377205729707,40.0,0.0
19634,1,9634,[318 427 515 588  79],716,5,43352,4.499429164504411,40.0,0.0
19635,1,9635,[318 427 515 588  79],807,5,43357,4.499481112494811,40.0,0.0
19636,1,9636,[318 427 515 588  79],716,5,43362,4.499533049704265,40.0,0.0
19637,1,9637,[318 427 515 588  79],807,5,43367,4.499584976136128,40.0,0.0
19638,1,9638,[318 427 515 588  79],18,5,43372,4.499636891793754,40.0,0.0
19639,1,9639,[318 427 515 588  79],18,5,43377,4.4996887966804975,40.0,0.0
19640,1,9640,[318 427 515 588  79],807,5,43382,4.49974069079971,40.0,0.0
19641,1,9641,[318 427 515 588  79],807,5,43387,4.49979257415474,40.0,0.0
19642,1,9642,[318 427 515 588  79],716,5,43392,4.499844446748937,40.0,0.0
19643,1,9643,[ 28 172 405 471 194],577,3,43395,4.4996889257569475,0.0,0.0
19644,1,9644,[318 427 515 588  79],18,5,43400,4.49974079834111,40.0,0.0
19645,1,9645,[318 427 515 588  79],807,5,43405,4.499792660170018,40.0,0.0
19646,1,9646,[318 427 515 588  79],807,5,43410,4.49984451124702,40.0,0.0
19647,1,9647,[211 168 597 176 301],796,3,43413,4.499689054726368,0.0,0.0
19648,1,9648,[318 427 515 588  79],807,5,43418,4.499740905793346,40.0,0.0
19649,1,9649,[318 427 515 588  79],807,5,43423,4.4997927461139895,40.0,0.0
19650,1,9650,[318 427 515 588  79],18,5,43428,4.499844575691638,40.0,0.0
19651,1,9651,[318 427 515 588  79],716,5,43433,4.499896394529631,40.0,0.0
19652,1,9652,[318 427 515 588  79],18,5,43438,4.499948202631306,40.0,0.0
19653,1,9653,[318 427 515 588  79],807,5,43443,4.5,40.0,0.0
19654,1,9654,[318 427 515 588  79],716,5,43448,4.500051786639047,40.0,0.0
19655,1,9655,[318 427 515 588  79],807,5,43453,4.500103562551781,40.0,0.0
19656,1,9656,[318 427 515 588  79],807,5,43458,4.500155327741535,40.0,0.0
19657,1,9657,[318 427 515 588  79],716,5,43463,4.500207082211638,40.0,0.0
19658,1,9658,[100 125  50 748 216],280,1,43464,4.499844704420748,0.0,40.0
19659,1,9659,[318 427 515 588  79],807,5,43469,4.499896480331263,40.0,0.0
19660,1,9660,[318 427 515 588  79],18,5,43474,4.499948245523238,40.0,0.0
19661,1,9661,[318 427 515 588  79],18,5,43479,4.5,40.0,0.0
19662,1,9662,[ 56 275 496  98 515],716,5,43484,4.500051743764876,20.0,20.0
19663,1,9663,[318 427 515 588  79],716,5,43489,4.5001034768211925,40.0,0.0
19664,1,9664,[318 427 515 588  79],716,5,43494,4.500155199172271,40.0,0.0
19665,1,9665,[318 427 515 588  79],18,5,43499,4.5002069108214355,40.0,0.0
19666,1,9666,[318 427 515 588  79],716,5,43504,4.500258611772008,40.0,0.0
19667,1,9667,[318 427 515 588  79],807,5,43509,4.500310302027307,40.0,0.0
19668,1,9668,[318 427 515 588  79],807,5,43514,4.50036198159065,40.0,0.0
19669,1,9669,[568  96 273 313 235],450,3,43517,4.500206825232678,0.0,0.0
19670,1,9670,[318 427 515 588  79],807,5,43522,4.50025850480819,40.0,0.0
19671,1,9671,[318 427 515 588  79],807,5,43527,4.500310173697271,40.0,0.0
19672,1,9672,[ 11 496 405 185 228],330,5,43532,4.500361831903236,20.0,0.0
19673,1,9673,[185   7 265 405  50],151,4,43536,4.500310109572049,0.0,20.0
19674,1,9674,[318 427 515 588  79],18,5,43541,4.500361757105943,40.0,0.0
19675,1,9675,[318 427 515 588  79],716,5,43546,4.500413393964448,40.0,0.0
19676,1,9676,[318 427 515 588  79],807,5,43551,4.500465020150873,40.0,0.0
19677,1,9677,[318 427 515 588  79],716,5,43556,4.500516635668527,40.0,0.0
19678,1,9678,[318 427 515 588  79],807,5,43561,4.500568240520715,40.0,0.0
19679,1,9679,[195 427 300 202 153],151,3,43564,4.500413223140496,20.0,0.0
19680,1,9680,[  4  12 127  25 186],18,3,43567,4.500258237785353,0.0,20.0
19681,1,9681,[318 427 515 588  79],18,5,43572,4.500309853336088,40.0,0.0
19682,1,9682,[318 427 515 588  79],716,5,43577,4.500361458225757,40.0,0.0
19683,1,9683,[318 427 515 588  79],807,5,43582,4.500413052457662,40.0,0.0
19684,1,9684,[318 427 515 588  79],18,5,43587,4.5004646360351055,40.0,0.0
19685,1,9685,[357 172 258 678 300],942,4,43591,4.50041296716911,0.0,0.0
19686,1,9686,[318 427 515 588  79],807,5,43596,4.500464540105296,40.0,0.0
19687,1,9687,[318 427 515 588  79],716,5,43601,4.500516102394715,40.0,0.0
19688,1,9688,[143 100 161 238 237],786,5,43606,4.5005676540406645,0.0,20.0
19689,1,9689,[742 197 508 186 333],655,0,43606,4.500103199174407,0.0,0.0
19690,1,9690,[318 427 515 588  79],18,5,43611,4.500154782788154,40.0,0.0
19691,1,9691,[318 427 515 588  79],807,5,43616,4.500206355757325,40.0,0.0
19692,1,9692,[357  98 168 282 271],796,5,43621,4.500257918085216,0.0,0.0
19693,1,9693,[318 427 515 588  79],18,5,43626,4.500309469775119,40.0,0.0
19694,1,9694,[318 427 515 588  79],716,5,43631,4.500361010830325,40.0,0.0
19695,1,9695,[173 318 153  11 204],401,2,43633,4.500103135313531,20.0,0.0
19696,1,9696,[318 427 515 588  79],807,5,43638,4.500154687016603,40.0,0.0
19697,1,9697,[210 202 182 471 183],655,2,43640,4.4998968859558675,0.0,0.0
19698,1,9698,[265 222  69 313 144],796,5,43645,4.4999484482936385,0.0,0.0
19699,1,9699,[318 427 515 588  79],18,5,43650,4.5,40.0,0.0
19700,1,9700,[318 427 515 588  79],716,5,43655,4.500051541078239,40.0,0.0
19701,1,9701,[187 483 471 318 276],535,3,43658,4.499896928468357,20.0,0.0
19702,1,9702,[318   8 151 196 258],535,5,43663,4.499948469545501,20.0,0.0
19703,1,9703,[ 88 153 328 269 300],655,0,43663,4.499484748557296,0.0,0.0
19704,1,9704,[318 427 515 588  79],807,5,43668,4.499536321483771,40.0,0.0
19705,1,9705,[143 568  11  98   9],693,4,43672,4.499484854729033,0.0,0.0
19706,1,9706,[ 98 135 180 168 265],450,4,43676,4.499433398578345,0.0,0.0
19707,1,9707,[ 82 195 185 235 161],269,1,43677,4.4990729295426455,0.0,0.0
19708,1,9708,[125 423 117 197 228],280,2,43679,4.498815531980637,0.0,0.0
19709,1,9709,[318 427 515 588  79],18,5,43684,4.498867147270855,40.0,0.0
19710,1,9710,[318 427 515 588  79],716,5,43689,4.4989187519308,40.0,0.0
19711,1,9711,[318 427 515 588  79],18,5,43694,4.498970345963756,40.0,0.0
19712,1,9712,[318 427 515 588  79],18,5,43699,4.499021929373005,40.0,0.0
19713,1,9713,[183 471 161 385 234],593,3,43702,4.498867613753346,0.0,0.0
19714,1,9714,[132 568 143 194 210],716,5,43707,4.498919197117859,0.0,0.0
19715,1,9715,[318 427 515 588  79],18,5,43712,4.498970769864141,40.0,0.0
19716,1,9716,[318 427 515 588  79],807,5,43717,4.499022331995472,40.0,0.0
19717,1,9717,[318 427 515 588  79],18,5,43722,4.499073883515127,40.0,0.0
19718,1,9718,[222 742  98 197 185],457,5,43727,4.499125424426381,0.0,0.0
19719,1,9719,[179   7 222 144  98],655,2,43729,4.498868312757201,0.0,0.0
19720,1,9720,[318 427 515 588  79],18,5,43734,4.4989198642115005,40.0,0.0
19721,1,9721,[318 427 515 588  79],18,5,43739,4.498971405060687,40.0,0.0
19722,1,9722,[318 427 515 588  79],807,5,43744,4.499022935308033,40.0,0.0
19723,1,9723,[318 427 515 588  79],716,5,43749,4.499074454956808,40.0,0.0
19724,1,9724,[318 427 515 588  79],18,5,43754,4.4991259640102825,40.0,0.0
19725,1,9725,[318 427 515 588  79],807,5,43759,4.499177462471725,40.0,0.0
19726,1,9726,[318 427 515 588  79],716,5,43764,4.499228950344402,40.0,0.0
19727,1,9727,[318 427 515 588  79],18,5,43769,4.499280427631579,40.0,0.0
19728,1,9728,[318 427 515 588  79],716,5,43774,4.499331894336519,40.0,0.0
19729,1,9729,[318 427 515 588  79],18,5,43779,4.499383350462487,40.0,0.0
19730,1,9730,[318 427 515 588  79],18,5,43784,4.499434796012743,40.0,0.0
19731,1,9731,[318 427 515 588  79],716,5,43789,4.499486230990547,40.0,0.0
19732,1,9732,[318 427 515 588  79],716,5,43794,4.499537655399157,40.0,0.0
19733,1,9733,[318 427 515 588  79],807,5,43799,4.499589069241833,40.0,0.0
19734,1,9734,[318 427 515 588  79],807,5,43804,4.499640472521828,40.0,0.0
19735,1,9735,[742 294 423 200 265],450,4,43808,4.499589153656532,0.0,0.0
19736,1,9736,[318 427 515 588  79],18,5,43813,4.499640546369518,40.0,0.0
19737,1,9737,[180   7  64 742 153],450,5,43818,4.499691928527418,20.0,0.0
19738,1,9738,[318 427 515 588  79],716,5,43823,4.499743300133484,40.0,0.0
19739,1,9739,[318 427 515 588  79],18,5,43828,4.499794661190965,40.0,0.0
19740,1,9740,[318 427 515 588  79],807,5,43833,4.49984601170311,40.0,0.0
19741,1,9741,[318 427 515 588  79],716,5,43838,4.499897351673168,40.0,0.0
19742,1,9742,[318 427 515 588  79],807,5,43843,4.4999486811043825,40.0,0.0
19743,1,9743,[172 405  28 117   7],457,5,43848,4.5,0.0,0.0
19744,1,9744,[318 427 515 588  79],716,5,43853,4.500051308363263,40.0,0.0
19745,1,9745,[318 427 515 588  79],18,5,43858,4.500102606197414,40.0,0.0
19746,1,9746,[276   7   8 228 678],344,4,43862,4.500051297835231,0.0,0.0
19747,1,9747,[179 143 210 405 546],577,0,43862,4.499589659417317,0.0,0.0
19748,1,9748,[275 483 271 423 191],902,4,43866,4.499538414196328,0.0,20.0
19749,1,9749,[318 427 515 588  79],18,5,43871,4.499589743589744,40.0,0.0
19750,1,9750,[318 427 515 588  79],716,5,43876,4.499641062455133,40.0,0.0
19751,1,9751,[222 202  95  70 496],450,3,43879,4.499487284659557,20.0,0.0
19752,1,9752,[318 427 515 588  79],18,5,43884,4.499538603506613,40.0,0.0
19753,1,9753,[318 427 515 588  79],807,5,43889,4.499589911831044,40.0,0.0
19754,1,9754,[318 427 515 588  79],18,5,43894,4.499641209636084,40.0,0.0
19755,1,9755,[200 546 588 385 273],796,4,43898,4.499589995899959,0.0,0.0
19756,1,9756,[318 427 515 588  79],716,5,43903,4.4996412831813055,40.0,0.0
19757,1,9757,[318 427 515 588  79],807,5,43908,4.49969255995081,40.0,0.0
19758,1,9758,[318 427 515 588  79],716,5,43913,4.499743826211702,40.0,0.0
19759,1,9759,[121 180 176  28 423],11,2,43915,4.499487704918033,0.0,0.0
19760,1,9760,[197  69 181  28 202],796,3,43918,4.499334084622477,0.0,0.0
19761,1,9761,[318 427 515 588  79],18,5,43923,4.499385371850031,40.0,0.0
19762,1,9762,[318 427 515 588  79],716,5,43928,4.499436648571136,40.0,0.0
19763,1,9763,[318 427 515 588  79],807,5,43933,4.499487914789021,40.0,0.0
19764,1,9764,[191 174   1 286  89],18,4,43937,4.499436763952893,0.0,20.0
19765,1,9765,[318 427 515 588  79],18,5,43942,4.499488019660045,40.0,0.0
19766,1,9766,[318 204 197  12 183],457,5,43947,4.4995392648715065,20.0,0.0
19767,1,9767,[427 187  71  11 483],450,3,43950,4.499385749385749,20.0,0.0
19768,1,9768,[318 427 515 588  79],18,5,43955,4.499436994574675,40.0,0.0
19769,1,9769,[318 427 515 588  79],716,5,43960,4.499488229273285,40.0,0.0
19770,1,9770,[318 427 515 588  79],716,5,43965,4.499539453484802,40.0,0.0
19771,1,9771,[318 427 515 588  79],18,5,43970,4.499590667212444,40.0,0.0
19772,1,9772,[318 427 515 588  79],716,5,43975,4.499641870459429,40.0,0.0
19773,1,9773,[238 211 111 405 181],151,4,43979,4.499590750971967,0.0,0.0
19774,1,9774,[318 427 515 588  79],807,5,43984,4.499641943734015,40.0,0.0
19775,1,9775,[318 427 515 588  79],18,5,43989,4.499693126022914,40.0,0.0
19776,1,9776,[318 427 515 588  79],18,5,43994,4.499744297841874,40.0,0.0
19777,1,9777,[ 95 237 172 151 180],18,2,43996,4.499488647985273,0.0,0.0
19778,1,9778,[318 427 515 588  79],716,5,44001,4.499539830248492,40.0,0.0
19779,1,9779,[318 427 515 588  79],716,5,44006,4.49959100204499,40.0,0.0
19780,1,9780,[  7 211   9  82 210],151,4,44010,4.4995399243431144,0.0,0.0
19781,1,9781,[318 427 515 588  79],716,5,44015,4.499591085667553,40.0,0.0
19782,1,9782,[318 427 515 588  79],18,5,44020,4.499642236532761,40.0,0.0
19783,1,9783,[ 56 121   7  15 568],256,4,44024,4.499591169255928,0.0,0.0
19784,1,9784,[228 117  79 125 269],655,1,44025,4.499233520694942,0.0,0.0
19785,1,9785,[318 427 515 588  79],716,5,44030,4.499284692417739,40.0,0.0
19786,1,9786,[318 427 515 588  79],716,5,44035,4.499335853683458,40.0,0.0
19787,1,9787,[318 427 515 588  79],18,5,44040,4.499387004495301,40.0,0.0
19788,1,9788,[318 427 515 588  79],18,5,44045,4.499438144856471,40.0,0.0
19789,1,9789,[318 427 515 588  79],807,5,44050,4.499489274770173,40.0,0.0
19790,1,9790,[318 427 515 588  79],807,5,44055,4.499540394239608,40.0,0.0
19791,1,9791,[318 427 515 588  79],807,5,44060,4.499591503267974,40.0,0.0
19792,1,9792,[318 427 515 588  79],807,5,44065,4.49964260185847,40.0,0.0
19793,1,9793,[546  22  28 174 144],796,4,44069,4.499591586685726,0.0,0.0
19794,1,9794,[222  88 237 174 588],450,4,44073,4.499540581929556,0.0,0.0
19795,1,9795,[ 25 100  11 475 282],655,0,44073,4.4990812576561865,0.0,20.0
19796,1,9796,[318 427 515 588  79],807,5,44078,4.499132387465551,40.0,0.0
19797,1,9797,[151 235 180 161 588],450,4,44082,4.499081445192896,0.0,0.0
19798,1,9798,[318 427 515 588  79],716,5,44087,4.499132564547403,40.0,0.0
19799,1,9799,[318 427 515 588  79],807,5,44092,4.499183673469388,40.0,0.0
19800,1,9800,[318 427 515 588  79],716,5,44097,4.499234771962045,40.0,0.0
19801,1,9801,[318 427 515 588  79],18,5,44102,4.499285860028565,40.0,0.0
19802,1,9802,[318 427 515 588  79],18,5,44107,4.499336937672141,40.0,0.0
19803,1,9803,[318 427 515 588  79],18,5,44112,4.499388004895961,40.0,0.0
19804,1,9804,[318 427 515 588  79],716,5,44117,4.499439061703213,40.0,0.0
19805,1,9805,[318 427 515 588  79],716,5,44122,4.499490108097083,40.0,0.0
19806,1,9806,[318 427 515 588  79],18,5,44127,4.499541144080759,40.0,0.0
19807,1,9807,[318 427 515 588  79],807,5,44132,4.499592169657422,40.0,0.0
19808,1,9808,[282 202 121  97 200],457,5,44137,4.499643184830258,0.0,0.0
19809,1,9809,[318 427 515 588  79],18,5,44142,4.4996941896024465,40.0,0.0
19810,1,9810,[318 427 515 588  79],807,5,44147,4.4997451839771685,40.0,0.0
19811,1,9811,[318 427 515 588  79],716,5,44152,4.499796167957603,40.0,0.0
19812,1,9812,[318 427 515 588  79],18,5,44157,4.499847141546928,40.0,0.0
19813,1,9813,[483  12 125  95 269],796,4,44161,4.499796209496638,0.0,0.0
19814,1,9814,[318 427 515 588  79],716,5,44166,4.499847172694855,40.0,0.0
19815,1,9815,[318 427 515 588  79],18,5,44171,4.499898125509373,40.0,0.0
19816,1,9816,[318 427 515 588  79],807,5,44176,4.499949067943364,40.0,0.0
19817,1,9817,[294 180 135 182 168],457,4,44180,4.499898146261968,0.0,0.0
19818,1,9818,[ 98 172   1  96 211],23,5,44185,4.499949078317548,0.0,0.0
19819,1,9819,[121 313 748 322 196],450,4,44189,4.49989816700611,0.0,0.0
19820,1,9820,[318 427 515 588  79],716,5,44194,4.499949088687506,40.0,0.0
19821,1,9821,[ 79 117 132 180 194],292,5,44199,4.5,0.0,0.0
19822,1,9822,[318 427 515 588  79],716,5,44204,4.500050900946758,40.0,0.0
19823,1,9823,[318 427 515 588  79],807,5,44209,4.500101791530945,40.0,0.0
19824,1,9824,[318 427 515 588  79],716,5,44214,4.500152671755725,40.0,0.0
19825,1,9825,[588 235 211 294 117],450,4,44218,4.500101770812131,0.0,0.0
19826,1,9826,[318 427 515 588  79],18,5,44223,4.50015264068383,40.0,0.0
19827,1,9827,[318 427 515 588  79],18,5,44228,4.5002035002035,40.0,0.0
19828,1,9828,[318 427 515 588  79],807,5,44233,4.5002543493743,40.0,0.0
19829,1,9829,[ 82 187   7  89 385],256,4,44237,4.500203458799593,0.0,0.0
19830,1,9830,[318 427 515 588  79],18,5,44242,4.500254297629946,40.0,0.0
19831,1,9831,[318 427 515 588  79],807,5,44247,4.500305126118795,40.0,0.0
19832,1,9832,[318 427 515 588  79],807,5,44252,4.500355944269297,40.0,0.0
19833,1,9833,[318 427 515 588  79],807,5,44257,4.500406752084604,40.0,0.0
19834,1,9834,[318 427 515 588  79],807,5,44262,4.50045754956787,40.0,0.0
19835,1,9835,[318 427 515 588  79],716,5,44267,4.500508336722245,40.0,0.0
19836,1,9836,[318 427 515 588  79],18,5,44272,4.500559113550879,40.0,0.0
19837,1,9837,[318 427 515 588  79],807,5,44277,4.500609880056922,40.0,0.0
19838,1,9838,[318 427 515 588  79],18,5,44282,4.500660636243521,40.0,0.0
19839,1,9839,[318 427 515 588  79],716,5,44287,4.500711382113821,40.0,0.0
19840,1,9840,[318 427 515 588  79],716,5,44292,4.500762117670968,40.0,0.0
19841,1,9841,[ 15  69 121 568 302],269,0,44292,4.50030481609429,0.0,0.0
19842,1,9842,[318 427 515 588  79],807,5,44297,4.5003555826475665,40.0,0.0
19843,1,9843,[403 100 181 235 185],269,2,44299,4.500101584721658,0.0,20.0
19844,1,9844,[318 427 515 588  79],716,5,44304,4.500152361604876,40.0,0.0
19845,1,9845,[210 127 483 180 423],269,3,44307,4.5,0.0,20.0
19846,1,9846,[318 427 515 588  79],716,5,44312,4.500050776886361,40.0,0.0
19847,1,9847,[210 323 183 678 197],280,0,44312,4.499593826157596,0.0,0.0
19848,1,9848,[318 427 515 588  79],18,5,44317,4.499644633972992,40.0,0.0
19849,1,9849,[ 15 175 269 153  64],878,4,44321,4.499593908629442,20.0,0.0
19850,1,9850,[275 483 228   9 210],655,2,44323,4.499340168510811,0.0,20.0
19851,1,9851,[318 427 515 588  79],716,5,44328,4.499390986601705,40.0,0.0
19852,1,9852,[318 427 515 588  79],807,5,44333,4.499441794377347,40.0,0.0
19853,1,9853,[117   9  70  69 175],344,2,44335,4.499188146945403,0.0,0.0
19854,1,9854,[318 427 515 588  79],807,5,44340,4.49923896499239,40.0,0.0
19855,1,9855,[ 50 282 508 275 235],463,3,44343,4.49908685064935,0.0,40.0
19856,1,9856,[318 427 515 588  79],807,5,44348,4.499137668661865,40.0,0.0
19857,1,9857,[318 427 515 588  79],807,5,44353,4.499188476364374,40.0,0.0
19858,1,9858,[ 64   8 204 196 508],269,2,44355,4.498934983264022,20.0,0.0
19859,1,9859,[318 427 515 588  79],716,5,44360,4.498985801217039,40.0,0.0
19860,1,9860,[318 427 515 588  79],807,5,44365,4.499036608863198,40.0,0.0
19861,1,9861,[176  71 403 235 135],280,3,44368,4.498884607584668,0.0,0.0
19862,1,9862,[318 427 515 588  79],716,5,44373,4.498935415188076,40.0,0.0
19863,1,9863,[318 427 515 588  79],18,5,44378,4.4989862124898625,40.0,0.0
19864,1,9864,[318 427 515 588  79],716,5,44383,4.499036999493158,40.0,0.0
19865,1,9865,[318 427 515 588  79],716,5,44388,4.499087776201095,40.0,0.0
19866,1,9866,[318 427 515 588  79],716,5,44393,4.499138542616803,40.0,0.0
19867,1,9867,[318 427 515 588  79],18,5,44398,4.4991892987434134,40.0,0.0
19868,1,9868,[318 427 515 588  79],807,5,44403,4.4992400445840515,40.0,0.0
19869,1,9869,[181  98 403   9 328],655,1,44404,4.498885511651469,0.0,0.0
19870,1,9870,[318 427 515 588  79],807,5,44409,4.49893627798602,40.0,0.0
19871,1,9871,[318 427 515 588  79],807,5,44414,4.498987034035657,40.0,0.0
19872,1,9872,[318 427 515 588  79],807,5,44419,4.499037779803505,40.0,0.0
19873,1,9873,[318 427 515 588  79],716,5,44424,4.499088515292688,40.0,0.0
19874,1,9874,[483 288 196 328 127],655,2,44426,4.498835443037975,0.0,20.0
19875,1,9875,[318 427 515 588  79],807,5,44431,4.49888618874038,40.0,0.0
19876,1,9876,[318 427 515 588  79],807,5,44436,4.498936924167257,40.0,0.0
19877,1,9877,[423 313 174 172 742],593,5,44441,4.498987649321725,0.0,0.0
19878,1,9878,[318 427 515 588  79],18,5,44446,4.499038364206903,40.0,0.0
19879,1,9879,[318 427 515 588  79],716,5,44451,4.499089068825911,40.0,0.0
19880,1,9880,[196 186 273 181 257],796,3,44454,4.498937354518773,0.0,0.0
19881,1,9881,[318 427 515 588  79],716,5,44459,4.498988059097349,40.0,0.0
19882,1,9882,[318 427 515 588  79],716,5,44464,4.499038753414955,40.0,0.0
19883,1,9883,[318 427 515 588  79],18,5,44469,4.499089437474707,40.0,0.0
19884,1,9884,[318 427 515 588  79],807,5,44474,4.499140111279717,40.0,0.0
19885,1,9885,[318 427 515 588  79],18,5,44479,4.499190774833098,40.0,0.0
19886,1,9886,[ 50 234  95 125 302],450,3,44482,4.4990391423080816,0.0,20.0
19887,1,9887,[748 323 294 118 678],280,0,44482,4.498584142394822,0.0,0.0
19888,1,9888,[318 427 515 588  79],807,5,44487,4.498634846799474,40.0,0.0
19889,1,9889,[132  88  79 318  98],151,5,44492,4.498685540950455,20.0,0.0
19890,1,9890,[318 427 515 588  79],807,5,44497,4.498736224850875,40.0,0.0
19891,1,9891,[318 427 515 588  79],18,5,44502,4.498786898503841,40.0,0.0
19892,1,9892,[318 427 515 588  79],807,5,44507,4.498837561912463,40.0,0.0
19893,1,9893,[318 427 515 588  79],716,5,44512,4.498888215079846,40.0,0.0
19894,1,9894,[313 176 318 405 496],577,4,44516,4.498837796867105,40.0,0.0
19895,1,9895,[318 427 515 588  79],716,5,44521,4.498888439773646,40.0,0.0
19896,1,9896,[ 98 181 405 153  56],655,1,44522,4.498534909568556,0.0,0.0
19897,1,9897,[318 427 515 588  79],716,5,44527,4.498585572842998,40.0,0.0
19898,1,9898,[318 427 515 588  79],807,5,44532,4.498636225881402,40.0,0.0
19899,1,9899,[318 427 515 588  79],807,5,44537,4.498686868686868,40.0,0.0
19900,1,9900,[318 427 515 588  79],716,5,44542,4.498737501262498,40.0,0.0
19901,1,9901,[318 427 515 588  79],807,5,44547,4.498788123611392,40.0,0.0
19902,1,9902,[ 89   8  50 111 186],18,3,44550,4.4986367767343225,0.0,20.0
19903,1,9903,[318 427 515 588  79],807,5,44555,4.498687399030695,40.0,0.0
19904,1,9904,[ 15 655 323 172  79],796,3,44558,4.498536092882382,0.0,0.0
19905,1,9905,[318 427 515 588  79],716,5,44563,4.498586715122149,40.0,0.0
19906,1,9906,[222 288 748  98 153],280,3,44566,4.498435449682043,0.0,0.0
19907,1,9907,[318 427 515 588  79],716,5,44571,4.498486071861122,40.0,0.0
19908,1,9908,[318 427 515 588  79],807,5,44576,4.498536683822787,40.0,0.0
19909,1,9909,[318 427 515 588  79],716,5,44581,4.498587285570131,40.0,0.0
19910,1,9910,[318 427 515 588  79],18,5,44586,4.498637877106246,40.0,0.0
19911,1,9911,[318 427 515 588  79],716,5,44591,4.498688458434221,40.0,0.0
19912,1,9912,[125 183 423 194 742],577,5,44596,4.498739029557147,0.0,0.0
19913,1,9913,[318 427 515 588  79],716,5,44601,4.498789590478112,40.0,0.0
19914,1,9914,[125 118 117 603 111],450,4,44605,4.498739283913263,20.0,0.0
19915,1,9915,[318 427 515 588  79],18,5,44610,4.49878983461073,40.0,0.0
19916,1,9916,[318 427 515 588  79],807,5,44615,4.498840375113441,40.0,0.0
19917,1,9917,[318 427 515 588  79],807,5,44620,4.498890905424481,40.0,0.0
19918,1,9918,[  8  12 195 471 322],344,3,44623,4.498739792317774,0.0,0.0
19919,1,9919,[132 222  28 597 182],450,4,44627,4.498689516129033,0.0,0.0
19920,1,9920,[228 183 568 180 202],280,1,44628,4.498336861203508,0.0,0.0
19921,1,9921,[318 427 515 588  79],716,5,44633,4.498387421890748,40.0,0.0
19922,1,9922,[181 742 271  28 302],655,1,44634,4.498034868487353,0.0,0.0
19923,1,9923,[318 427 515 588  79],716,5,44639,4.498085449415559,40.0,0.0
19924,1,9924,[318 427 515 588  79],807,5,44644,4.498136020151134,40.0,0.0
19925,1,9925,[318 427 515 588  79],18,5,44649,4.498186580697159,40.0,0.0
19926,1,9926,[318 427 515 588  79],716,5,44654,4.498237131056714,40.0,0.0
19927,1,9927,[318 427 515 588  79],716,5,44659,4.498287671232877,40.0,0.0
19928,1,9928,[318 427 515 588  79],18,5,44664,4.498338201228724,40.0,0.0
19929,1,9929,[318 427 515 588  79],807,5,44669,4.4983887210473315,40.0,0.0
19930,1,9930,[111 508 275  70 143],655,2,44671,4.498137146309536,0.0,20.0
19931,1,9931,[318 427 515 588  79],18,5,44676,4.498187676198147,40.0,0.0
19932,1,9932,[318 427 515 588  79],807,5,44681,4.498238195912615,40.0,0.0
19933,1,9933,[318 427 515 588  79],807,5,44686,4.49828870545601,40.0,0.0
19934,1,9934,[176 655 125 546 183],504,3,44689,4.49813789632612,0.0,0.0
19935,1,9935,[179  15 211 289 282],655,1,44690,4.497785829307569,0.0,0.0
19936,1,9936,[135 144 204 191 181],401,3,44693,4.497635101137164,0.0,0.0
19937,1,9937,[318 427 515 588  79],18,5,44698,4.497685651036426,40.0,0.0
19938,1,9938,[318 427 515 588  79],716,5,44703,4.497736190763658,40.0,0.0
19939,1,9939,[318 427 515 588  79],716,5,44708,4.4977867203219315,40.0,0.0
19940,1,9940,[318 427 515 588  79],807,5,44713,4.497837239714315,40.0,0.0
19941,1,9941,[318 427 515 588  79],807,5,44718,4.497887748943874,40.0,0.0
19942,1,9942,[168   4 125 143 333],796,5,44723,4.497938248013678,0.0,0.0
19943,1,9943,[318 427 515 588  79],18,5,44728,4.49798873692679,40.0,0.0
19944,1,9944,[318 427 515 588  79],716,5,44733,4.4980392156862745,40.0,0.0
19945,1,9945,[318 427 515 588  79],716,5,44738,4.498089684295194,40.0,0.0
19946,1,9946,[318 427 515 588  79],807,5,44743,4.49814014275661,40.0,0.0
19947,1,9947,[318 427 515 588  79],18,5,44748,4.498190591073582,40.0,0.0
19948,1,9948,[318 427 515 588  79],807,5,44753,4.49824102924917,40.0,0.0
19949,1,9949,[174  88  98 603 185],716,5,44758,4.498291457286432,20.0,0.0
19950,1,9950,[318 427 515 588  79],807,5,44763,4.498341875188423,40.0,0.0
19951,1,9951,[318 427 515 588  79],716,5,44768,4.498392282958199,40.0,0.0
19952,1,9952,[655 151 132  56 153],23,3,44771,4.498241736159952,0.0,0.0
19953,1,9953,[318 427 515 588  79],18,5,44776,4.4982921438617645,40.0,0.0
19954,1,9954,[161  88 173 172 143],450,5,44781,4.498342541436464,0.0,0.0
19955,1,9955,[318 427 515 588  79],807,5,44786,4.498392928887103,40.0,0.0
19956,1,9956,[318 427 515 588  79],807,5,44791,4.498443306216732,40.0,0.0
19957,1,9957,[318 427 515 588  79],807,5,44796,4.498493673428399,40.0,0.0
19958,1,9958,[318 427 515 588  79],716,5,44801,4.498544030525153,40.0,0.0
19959,1,9959,[318 427 515 588  79],18,5,44806,4.49859437751004,40.0,0.0
19960,1,9960,[318 427 515 588  79],18,5,44811,4.4986447143861055,40.0,0.0
19961,1,9961,[  9 187 117  15  79],796,4,44815,4.498594659706886,0.0,0.0
19962,1,9962,[435 597 237  79 144],450,5,44820,4.4986449864498645,0.0,0.0
19963,1,9963,[318 427 515 588  79],807,5,44825,4.498695303091128,40.0,0.0
19964,1,9964,[100 111 181 125 427],296,4,44829,4.498645258404416,20.0,20.0
19965,1,9965,[318 427 515 588  79],18,5,44834,4.49869556492073,40.0,0.0
19966,1,9966,[318 427 515 588  79],716,5,44839,4.49874586134243,40.0,0.0
19967,1,9967,[318 427 515 588  79],807,5,44844,4.498796147672552,40.0,0.0
19968,1,9968,[318 427 515 588  79],716,5,44849,4.4988464239141335,40.0,0.0
19969,1,9969,[318 427 515 588  79],807,5,44854,4.498896690070211,40.0,0.0
19970,1,9970,[318 427 515 588  79],716,5,44859,4.498946946143817,40.0,0.0
19971,1,9971,[318 427 515 588  79],18,5,44864,4.4989971921379865,40.0,0.0
19972,1,9972,[ 70  50 588  25 423],450,4,44868,4.498947157324777,0.0,20.0
19973,1,9973,[318 427 515 588  79],716,5,44873,4.498997393222378,40.0,0.0
19974,1,9974,[318 427 515 588  79],716,5,44878,4.499047619047619,40.0,0.0
19975,1,9975,[318 427 515 588  79],18,5,44883,4.499097834803528,40.0,0.0
19976,1,9976,[318 427 515 588  79],807,5,44888,4.499148040493134,40.0,0.0
19977,1,9977,[318 427 515 588  79],807,5,44893,4.4991982361194625,40.0,0.0
19978,1,9978,[204 179  98 294  28],457,4,44897,4.499148211243612,0.0,0.0
19979,1,9979,[318 427 515 588  79],716,5,44902,4.499198396793587,40.0,0.0
19980,1,9980,[318 427 515 588  79],716,5,44907,4.499248572287346,40.0,0.0
19981,1,9981,[135 179 211 427  15],269,4,44911,4.499198557403326,20.0,0.0
19982,1,9982,[318 427 515 588  79],807,5,44916,4.499248722828809,40.0,0.0
19983,1,9983,[318 427 515 588  79],716,5,44921,4.499298878205129,40.0,0.0
19984,1,9984,[318 427 515 588  79],18,5,44926,4.499349023535303,40.0,0.0
19985,1,9985,[318 427 515 588  79],807,5,44931,4.499399158822351,40.0,0.0
19986,1,9986,[318 427 515 588  79],18,5,44936,4.49944928406929,40.0,0.0
19987,1,9987,[318 427 515 588  79],807,5,44941,4.499499399279135,40.0,0.0
19988,1,9988,[318 427 515 588  79],807,5,44946,4.4995495044549,40.0,0.0
19989,1,9989,[318 427 515 588  79],716,5,44951,4.499599599599599,40.0,0.0
19990,1,9990,[183 204 180 210 197],835,4,44955,4.499549594635171,0.0,0.0
19991,1,9991,[318 427 515 588  79],716,5,44960,4.499599679743795,40.0,0.0
19992,1,9992,[182 174 143  71 318],450,4,44964,4.499549684779345,20.0,0.0
19993,1,9993,[182  98 294  12 234],457,4,44968,4.499499699819892,0.0,0.0
19994,1,9994,[515 200 385 357 269],655,3,44971,4.499349674837418,0.0,0.0
19995,1,9995,[318 427 515 588  79],18,5,44976,4.4993997599039615,40.0,0.0
19996,1,9996,[318 427 515 588  79],716,5,44981,4.499449834950485,40.0,0.0
19997,1,9997,[318 427 515 588  79],18,5,44986,4.499499899979996,40.0,0.0
19998,1,9998,[276 200  64 100 357],655,4,44990,4.4994499449945,20.0,20.0
19999,1,9999,[318 427 515 588  79],18,5,44995,4.4995,40.0,0.0
20000,2,0,[273 286 215  22 301],796,2,2,2.0,0.0,20.0
20001,2,1,[121  22 100  25 471],577,4,6,3.0,0.0,20.0
20002,2,2,[ 25  22 121 100 215],655,0,6,2.0,0.0,20.0
20003,2,3,[ 22  25 121 100 215],577,5,11,2.75,0.0,20.0
20004,2,4,[ 22  25 121 100 215],11,2,13,2.6,0.0,20.0
20005,2,5,[ 22 100  25 121 215],457,5,18,3.0,0.0,20.0
20006,2,6,[ 22 100  25 121 215],450,3,21,3.0,0.0,20.0
20007,2,7,[435 655 173 258 228],450,5,26,3.25,0.0,0.0
20008,2,8,[173 228 435 655 258],450,5,31,3.4444444444444446,0.0,0.0
20009,2,9,[173 228 435 655 258],450,5,36,3.6,0.0,0.0
20010,2,10,[289  50  69  82 204],807,5,41,3.727272727272727,0.0,20.0
20011,2,11,[405 168 435 174 357],151,4,45,3.75,0.0,0.0
20012,2,12,[228 174  50 357 289],693,2,47,3.6153846153846154,0.0,20.0
20013,2,13,[174 357  69 655 435],72,5,52,3.7142857142857144,0.0,0.0
20014,2,14,[174 357  69 655 435],401,3,55,3.6666666666666665,0.0,0.0
20015,2,15,[176  71 313 742 211],450,4,59,3.6875,0.0,0.0
20016,2,16,[235  28 204  97 655],457,4,63,3.7058823529411766,0.0,0.0
20017,2,17,[258 168 173 176  82],151,3,66,3.6666666666666665,0.0,0.0
20018,2,18,[258 357  28 211 168],151,5,71,3.736842105263158,0.0,0.0
20019,2,19,[258 357  28 211 168],504,5,76,3.8,0.0,0.0
20020,2,20,[258 357  28 211 168],151,5,81,3.857142857142857,0.0,0.0
20021,2,21,[258 357  28 211 168],796,3,84,3.8181818181818183,0.0,0.0
20022,2,22,[258 742 168  97 173],796,3,87,3.782608695652174,0.0,0.0
20023,2,23,[168 173 174 435 313],911,4,91,3.7916666666666665,0.0,0.0
20024,2,24,[173 174 435 168 357],316,1,92,3.68,0.0,0.0
20025,2,25,[204   7 186 181  22],269,0,92,3.5384615384615383,0.0,0.0
20026,2,26,[357 258 168 435 173],450,5,97,3.5925925925925926,0.0,0.0
20027,2,27,[357 258 168 435 173],450,5,102,3.642857142857143,0.0,0.0
20028,2,28,[357 258 168 435 173],151,5,107,3.689655172413793,0.0,0.0
20029,2,29,[357 258 168 435 173],450,5,112,3.7333333333333334,0.0,0.0
20030,2,30,[483 222 194 183 180],796,4,116,3.7419354838709675,0.0,0.0
20031,2,31,[357 483 258 183 194],796,5,121,3.78125,0.0,0.0
20032,2,32,[357 483 258 183 194],450,4,125,3.787878787878788,0.0,0.0
20033,2,33,[357 183 258 194 222],796,5,130,3.823529411764706,0.0,0.0
20034,2,34,[357 183 258 194 222],457,5,135,3.857142857142857,0.0,0.0
20035,2,35,[357 183 258 194 222],450,4,139,3.861111111111111,0.0,0.0
20036,2,36,[ 22 471 655  15  95],450,3,142,3.8378378378378377,0.0,0.0
20037,2,37,[357 183 258 194 168],796,5,147,3.8684210526315788,0.0,0.0
20038,2,38,[357 183 258 194 168],450,5,152,3.8974358974358974,0.0,0.0
20039,2,39,[357 183 258 194 168],504,3,155,3.875,0.0,0.0
20040,2,40,[357 258 168 435 173],151,5,160,3.902439024390244,0.0,0.0
20041,2,41,[357 258 168 435 173],11,4,164,3.9047619047619047,0.0,0.0
20042,2,42,[357 258 435 173 183],151,4,168,3.9069767441860463,0.0,0.0
20043,2,43,[121 568 427 546 357],693,3,171,3.8863636363636362,20.0,0.0
20044,2,44,[357 258 568 427 435],450,5,176,3.911111111111111,20.0,0.0
20045,2,45,[357 258 568 427 435],450,5,181,3.9347826086956523,20.0,0.0
20046,2,46,[ 25  15  69 742  64],457,5,186,3.9574468085106385,20.0,0.0
20047,2,47,[742 258 143  79 228],450,5,191,3.9791666666666665,0.0,0.0
20048,2,48,[ 97 183 273 742  95],796,2,193,3.938775510204082,0.0,0.0
20049,2,49,[ 79 427 258 357 568],796,5,198,3.96,20.0,0.0
20050,2,50,[282 496 273 180 176],796,3,201,3.9411764705882355,20.0,0.0
20051,2,51,[111  12 588 176 568],457,4,205,3.9423076923076925,0.0,0.0
20052,2,52,[143 357  79 258 496],450,5,210,3.9622641509433962,20.0,0.0
20053,2,53,[143 357  79 258 496],151,5,215,3.9814814814814814,20.0,0.0
20054,2,54,[143 357  79 258 496],151,5,220,4.0,20.0,0.0
20055,2,55,[143 357  79 258 496],796,5,225,4.017857142857143,20.0,0.0
20056,2,56,[143 357  79 258 496],450,5,230,4.035087719298246,20.0,0.0
20057,2,57,[143 357  79 258 496],151,5,235,4.051724137931035,20.0,0.0
20058,2,58,[143 357  79 258 496],151,5,240,4.067796610169491,20.0,0.0
20059,2,59,[143 357  79 258 496],796,5,245,4.083333333333333,20.0,0.0
20060,2,60,[ 28 180  97  89  56],450,5,250,4.098360655737705,0.0,0.0
20061,2,61,[ 56 357 496 568 258],450,5,255,4.112903225806452,20.0,0.0
20062,2,62,[ 98 196 265 228 180],796,4,259,4.111111111111111,0.0,0.0
20063,2,63,[258 357 496  98 196],535,3,262,4.09375,20.0,0.0
20064,2,64,[258  79 282 588  89],450,5,267,4.107692307692307,0.0,0.0
20065,2,65,[258  79 282 588  89],457,5,272,4.121212121212121,0.0,0.0
20066,2,66,[258  79 282 588  89],796,5,277,4.134328358208955,0.0,0.0
20067,2,67,[258  79 282 588  89],457,5,282,4.147058823529412,0.0,0.0
20068,2,68,[258  79 282 588  89],796,5,287,4.159420289855072,0.0,0.0
20069,2,69,[258  79 282 588  89],457,5,292,4.171428571428572,0.0,0.0
20070,2,70,[127 200 182 187  82],796,4,296,4.169014084507042,0.0,20.0
20071,2,71,[127 282 568  12  79],280,3,299,4.152777777777778,0.0,20.0
20072,2,72,[127 143  12  79 265],457,5,304,4.164383561643835,0.0,20.0
20073,2,73,[127 143  12  79 265],457,5,309,4.175675675675675,0.0,20.0
20074,2,74,[127 143  12  79 265],796,5,314,4.1866666666666665,0.0,20.0
20075,2,75,[127 143  12  79 265],450,5,319,4.197368421052632,0.0,20.0
20076,2,76,[127 143  12  79 265],655,3,322,4.181818181818182,0.0,20.0
20077,2,77,[  4  70 185 302 258],535,3,325,4.166666666666667,0.0,0.0
20078,2,78,[127 258  64 143 187],450,5,330,4.177215189873418,20.0,20.0
20079,2,79,[403 237 121 228   8],796,5,335,4.1875,0.0,0.0
20080,2,80,[127 496 196  70 427],450,5,340,4.197530864197531,40.0,20.0
20081,2,81,[ 97 546 185 211 135],236,3,343,4.182926829268292,0.0,0.0
20082,2,82,[127 496 196  70 427],269,3,346,4.168674698795181,40.0,20.0
20083,2,83,[127 185 427 187  64],18,4,350,4.166666666666667,40.0,20.0
20084,2,84,[180 245 174 276 151],504,4,354,4.1647058823529415,0.0,0.0
20085,2,85,[127 496 245  89 143],796,4,358,4.162790697674419,20.0,20.0
20086,2,86,[483   4 300  28 435],450,3,361,4.149425287356322,0.0,0.0
20087,2,87,[ 64 238 403 100 323],796,2,363,4.125,20.0,20.0
20088,2,88,[127 496  89 143 258],450,5,368,4.134831460674158,20.0,20.0
20089,2,89,[127 496  89 143 258],807,3,371,4.122222222222222,20.0,20.0
20090,2,90,[ 79 427 187 182 496],503,4,375,4.1208791208791204,40.0,0.0
20091,2,91,[ 79   8 187 496 151],535,3,378,4.108695652173913,20.0,0.0
20092,2,92,[  8 427 496 151  64],535,5,383,4.118279569892473,60.0,0.0
20093,2,93,[  8 427 496 151  64],577,5,388,4.127659574468085,60.0,0.0
20094,2,94,[  8 427 496 151  64],535,5,393,4.136842105263158,60.0,0.0
20095,2,95,[  8 427 496 151  64],707,3,396,4.125,60.0,0.0
20096,2,96,[180  82  28 742 200],450,3,399,4.11340206185567,0.0,0.0
20097,2,97,[211 117 125  71  50],786,5,404,4.122448979591836,0.0,20.0
20098,2,98,[151 125 117 300  56],292,4,408,4.121212121212121,0.0,0.0
20099,2,99,[181 427 273 234 202],655,2,410,4.1,20.0,0.0
20100,2,100,[403 588 237 427  89],450,5,415,4.108910891089109,20.0,0.0
20101,2,101,[ 79   1 172 318  25],450,4,419,4.107843137254902,20.0,0.0
20102,2,102,[427   8 151   1 318],330,5,424,4.116504854368932,40.0,0.0
20103,2,103,[427   8 151   1 318],807,5,429,4.125,40.0,0.0
20104,2,104,[216 655 175 183  97],457,5,434,4.133333333333334,0.0,0.0
20105,2,105,[  1 403 318  56 300],655,1,435,4.10377358490566,20.0,0.0
20106,2,106,[151 117 318 216 172],457,5,440,4.11214953271028,20.0,0.0
20107,2,107,[151 117 318 216 172],457,5,445,4.12037037037037,20.0,0.0
20108,2,108,[211 181 228  82 215],655,0,445,4.08256880733945,0.0,0.0
20109,2,109,[151 117 318 216 172],457,5,450,4.090909090909091,20.0,0.0
20110,2,110,[151 117 318 216 172],330,5,455,4.099099099099099,20.0,0.0
20111,2,111,[151 117 318 216 172],577,5,460,4.107142857142857,20.0,0.0
20112,2,112,[151 117 318 216 172],330,5,465,4.115044247787611,20.0,0.0
20113,2,113,[151 117 318 216 172],796,5,470,4.12280701754386,20.0,0.0
20114,2,114,[151 117 318 216 172],796,5,475,4.130434782608695,20.0,0.0
20115,2,115,[151 117 318 216 172],577,5,480,4.137931034482759,20.0,0.0
20116,2,116,[151 117 318 216 172],796,5,485,4.145299145299146,20.0,0.0
20117,2,117,[151 117 318 216 172],450,5,490,4.1525423728813555,20.0,0.0
20118,2,118,[151 117 318 216 172],330,5,495,4.159663865546219,20.0,0.0
20119,2,119,[151 117 318 216 172],457,5,500,4.166666666666667,20.0,0.0
20120,2,120,[151 117 318 216 172],885,3,503,4.1570247933884295,20.0,0.0
20121,2,121,[275 269 276  50 215],878,3,506,4.147540983606557,0.0,40.0
20122,2,122,[117  89 275 588 143],756,4,510,4.146341463414634,0.0,20.0
20123,2,123,[117 269 588 427 237],450,5,515,4.153225806451613,20.0,0.0
20124,2,124,[117 269 588 427 237],450,5,520,4.16,20.0,0.0
20125,2,125,[117 269 588 427 237],450,5,525,4.166666666666667,20.0,0.0
20126,2,126,[132 197 322 195 187],629,4,529,4.165354330708661,0.0,0.0
20127,2,127,[265 237  98 172 508],280,2,531,4.1484375,0.0,0.0
20128,2,128,[269 318 588 427 175],878,3,534,4.1395348837209305,40.0,0.0
20129,2,129,[  8 151  89 143 117],756,5,539,4.1461538461538465,0.0,0.0
20130,2,130,[  8 151  89 143 117],807,5,544,4.152671755725191,0.0,0.0
20131,2,131,[  8 151  89 143 117],756,5,549,4.159090909090909,0.0,0.0
20132,2,132,[  8 151  89 143 117],807,5,554,4.165413533834586,0.0,0.0
20133,2,133,[  8 151  89 143 117],807,5,559,4.1716417910447765,0.0,0.0
20134,2,134,[  8 151  89 143 117],807,5,564,4.177777777777778,0.0,0.0
20135,2,135,[  8 151  89 143 117],756,5,569,4.1838235294117645,0.0,0.0
20136,2,136,[  8 151  89 143 117],756,5,574,4.189781021897811,0.0,0.0
20137,2,137,[  8 151  89 143 117],796,5,579,4.195652173913044,0.0,0.0
20138,2,138,[  8 151  89 143 117],457,5,584,4.201438848920863,0.0,0.0
20139,2,139,[  8 151  89 143 117],457,5,589,4.207142857142857,0.0,0.0
20140,2,140,[187 234 144 748 216],450,4,593,4.205673758865248,0.0,0.0
20141,2,141,[196 185  64 197  56],457,5,598,4.211267605633803,20.0,0.0
20142,2,142,[597 588  95 135 196],450,3,601,4.2027972027972025,0.0,0.0
20143,2,143,[204 269  50 235 117],450,4,605,4.201388888888889,0.0,20.0
20144,2,144,[ 64 357 187 186  89],269,3,608,4.1931034482758625,20.0,0.0
20145,2,145,[269 117 144 143 195],450,5,613,4.198630136986301,0.0,0.0
20146,2,146,[269 117 144 143 195],796,4,617,4.197278911564626,0.0,0.0
20147,2,147,[117   8 195 597 151],796,5,622,4.202702702702703,0.0,0.0
20148,2,148,[181 655   8 196 161],457,5,627,4.208053691275167,0.0,0.0
20149,2,149,[161 143 151 132 597],807,5,632,4.213333333333333,0.0,0.0
20150,2,150,[161 143 151 132 597],796,5,637,4.218543046357616,0.0,0.0
20151,2,151,[161 143 151 132 597],450,5,642,4.223684210526316,0.0,0.0
20152,2,152,[161 143 151 132 597],807,5,647,4.228758169934641,0.0,0.0
20153,2,153,[161 143 151 132 597],457,4,651,4.2272727272727275,0.0,0.0
20154,2,154,[161 143 151 132 195],457,5,656,4.232258064516129,0.0,0.0
20155,2,155,[161 143 151 132 195],23,2,658,4.217948717948718,0.0,0.0
20156,2,156,[597 210 273  15 234],450,1,659,4.197452229299363,0.0,0.0
20157,2,157,[197 132 144 427   8],796,4,663,4.19620253164557,20.0,0.0
20158,2,158,[  8 117 144 195 427],796,5,668,4.20125786163522,20.0,0.0
20159,2,159,[403 597 273 313 100],796,3,671,4.19375,0.0,20.0
20160,2,160,[427 318 195 132 748],151,3,674,4.186335403726708,40.0,0.0
20161,2,161,[318 132 427   8 117],577,5,679,4.191358024691358,40.0,0.0
20162,2,162,[318 132 427   8 117],655,2,681,4.177914110429448,40.0,0.0
20163,2,163,[318 144 427 258 151],450,5,686,4.182926829268292,40.0,0.0
20164,2,164,[385 546 135 215 197],450,4,690,4.181818181818182,0.0,0.0
20165,2,165,[318 427 385 144 258],655,2,692,4.168674698795181,40.0,0.0
20166,2,166,[318 427 151 357 143],269,4,696,4.167664670658683,40.0,0.0
20167,2,167,[318 427 151 357 117],450,5,701,4.1726190476190474,40.0,0.0
20168,2,168,[318 427 151 357 117],450,5,706,4.177514792899408,40.0,0.0
20169,2,169,[318 427 151 357 117],450,5,711,4.182352941176471,40.0,0.0
20170,2,170,[318 427 151 357 117],716,5,716,4.187134502923977,40.0,0.0
20171,2,171,[318 427 151 357 117],330,5,721,4.191860465116279,40.0,0.0
20172,2,172,[318 427 151 357 117],796,5,726,4.196531791907514,40.0,0.0
20173,2,173,[196 235 100  71 194],23,2,728,4.183908045977011,0.0,20.0
20174,2,174,[318 427 151 357 117],330,5,733,4.188571428571429,40.0,0.0
20175,2,175,[318 427 151 357 117],796,5,738,4.193181818181818,40.0,0.0
20176,2,176,[100 127 185 161 238],655,2,740,4.1807909604519775,0.0,40.0
20177,2,177,[318 427 151 357 117],450,5,745,4.185393258426966,40.0,0.0
20178,2,178,[318 427 151 357 117],796,5,750,4.189944134078212,40.0,0.0
20179,2,179,[318 427 151 357 117],796,5,755,4.194444444444445,40.0,0.0
20180,2,180,[318 427 151 357 117],450,5,760,4.198895027624309,40.0,0.0
20181,2,181,[ 88   1 151 423 194],18,2,762,4.186813186813187,0.0,0.0
20182,2,182,[318 423 427 357 117],72,5,767,4.191256830601093,40.0,0.0
20183,2,183,[318 423 427 357 117],942,5,772,4.195652173913044,40.0,0.0
20184,2,184,[318 423 427 357 117],693,4,776,4.194594594594594,40.0,0.0
20185,2,185,[211 403  95 318  88],796,4,780,4.193548387096774,20.0,0.0
20186,2,186,[385 471 483 318 181],450,4,784,4.192513368983957,20.0,0.0
20187,2,187,[318 427 357 117 151],330,5,789,4.196808510638298,40.0,0.0
20188,2,188,[318 427 357 117 151],330,5,794,4.201058201058201,40.0,0.0
20189,2,189,[318 427 357 117 151],450,5,799,4.205263157894737,40.0,0.0
20190,2,190,[118  70 172 508 268],655,1,800,4.18848167539267,0.0,0.0
20191,2,191,[ 89 568 265 237 204],72,3,803,4.182291666666667,0.0,0.0
20192,2,192,[318 427 357 117 151],450,5,808,4.186528497409326,40.0,0.0
20193,2,193,[318 427 357 117 151],716,5,813,4.190721649484536,40.0,0.0
20194,2,194,[318 427 357 117 151],330,5,818,4.194871794871795,40.0,0.0
20195,2,195,[318 427 357 117 151],330,5,823,4.198979591836735,40.0,0.0
20196,2,196,[318 427 357 117 151],796,5,828,4.2030456852791875,40.0,0.0
20197,2,197,[318 427 357 117 151],796,5,833,4.207070707070707,40.0,0.0
20198,2,198,[318 427 357 117 151],716,5,838,4.211055276381909,40.0,0.0
20199,2,199,[235 471 508 322 135],401,1,839,4.195,0.0,0.0
20200,2,200,[318 427 357 117 151],796,5,844,4.199004975124378,40.0,0.0
20201,2,201,[318 427 357 117 151],450,5,849,4.202970297029703,40.0,0.0
20202,2,202,[318 427 357 117 151],450,5,854,4.206896551724138,40.0,0.0
20203,2,203,[318 427 357 117 151],716,5,859,4.21078431372549,40.0,0.0
20204,2,204,[318 427 357 117 151],450,5,864,4.214634146341464,40.0,0.0
20205,2,205,[318 427 357 117 151],450,5,869,4.218446601941747,40.0,0.0
20206,2,206,[318 427 357 117 151],450,5,874,4.222222222222222,40.0,0.0
20207,2,207,[318 427 357 117 151],450,5,879,4.225961538461538,40.0,0.0
20208,2,208,[318 427 357 117 151],796,5,884,4.229665071770335,40.0,0.0
20209,2,209,[318 427 357 117 151],716,5,889,4.233333333333333,40.0,0.0
20210,2,210,[318 427 357 117 151],330,5,894,4.23696682464455,40.0,0.0
20211,2,211,[318 427 357 117 151],330,5,899,4.240566037735849,40.0,0.0
20212,2,212,[237 174 179 200 294],577,3,902,4.234741784037559,0.0,0.0
20213,2,213,[216 273 268 185 161],655,3,905,4.228971962616822,0.0,0.0
20214,2,214,[318 427 294 357 117],450,5,910,4.232558139534884,40.0,0.0
20215,2,215,[318 427 294 357 117],450,5,915,4.236111111111111,40.0,0.0
20216,2,216,[318 427 294 357 117],796,4,919,4.235023041474655,40.0,0.0
20217,2,217,[318 427 357 117 151],796,5,924,4.238532110091743,40.0,0.0
20218,2,218,[318 427 357 117 151],450,5,929,4.242009132420091,40.0,0.0
20219,2,219,[318 427 357 117 151],716,5,934,4.245454545454545,40.0,0.0
20220,2,220,[318 427 357 117 151],716,5,939,4.248868778280543,40.0,0.0
20221,2,221,[318 427 357 117 151],716,5,944,4.252252252252252,40.0,0.0
20222,2,222,[318 427 357 117 151],450,5,949,4.255605381165919,40.0,0.0
20223,2,223,[318 427 357 117 151],450,5,954,4.258928571428571,40.0,0.0
20224,2,224,[318 427 357 117 151],796,5,959,4.262222222222222,40.0,0.0
20225,2,225,[318 427 357 117 151],450,5,964,4.265486725663717,40.0,0.0
20226,2,226,[318 427 357 117 151],330,5,969,4.2687224669603525,40.0,0.0
20227,2,227,[318 427 357 117 151],716,5,974,4.271929824561403,40.0,0.0
20228,2,228,[318 427 357 117 151],716,5,979,4.275109170305677,40.0,0.0
20229,2,229,[185  89 475 403 200],655,3,982,4.269565217391304,0.0,0.0
20230,2,230,[318 427 357 117 151],796,5,987,4.2727272727272725,40.0,0.0
20231,2,231,[318 427 357 117 151],330,5,992,4.275862068965517,40.0,0.0
20232,2,232,[318 427 357 117 151],450,5,997,4.278969957081545,40.0,0.0
20233,2,233,[ 98 265 117 238 258],655,1,998,4.264957264957265,0.0,0.0
20234,2,234,[318 427 357 117 151],450,5,1003,4.268085106382979,40.0,0.0
20235,2,235,[318 427 357 117 151],796,5,1008,4.271186440677966,40.0,0.0
20236,2,236,[318 427 357 117 151],716,5,1013,4.274261603375527,40.0,0.0
20237,2,237,[318 427 357 117 151],796,5,1018,4.277310924369748,40.0,0.0
20238,2,238,[318 427 357 117 151],796,5,1023,4.2803347280334725,40.0,0.0
20239,2,239,[318 427 357 117 151],450,5,1028,4.283333333333333,40.0,0.0
20240,2,240,[318 427 357 117 151],796,5,1033,4.286307053941909,40.0,0.0
20241,2,241,[318 427 357 117 151],450,5,1038,4.289256198347108,40.0,0.0
20242,2,242,[318 427 357 117 151],796,5,1043,4.292181069958848,40.0,0.0
20243,2,243,[318 427 357 117 151],330,5,1048,4.295081967213115,40.0,0.0
20244,2,244,[318 427 357 117 151],796,5,1053,4.297959183673469,40.0,0.0
20245,2,245,[318 427 357 117 151],330,5,1058,4.300813008130081,40.0,0.0
20246,2,246,[234  22 195 143  96],796,4,1062,4.299595141700405,0.0,0.0
20247,2,247,[318  96 427 357 117],450,5,1067,4.30241935483871,40.0,0.0
20248,2,248,[318  96 427 357 117],655,3,1070,4.2971887550200805,40.0,0.0
20249,2,249,[ 56 179 294  28 216],457,4,1074,4.296,0.0,0.0
20250,2,250,[186 197 181  56  70],655,0,1074,4.278884462151394,0.0,0.0
20251,2,251,[318 427 357 151 117],330,5,1079,4.281746031746032,40.0,0.0
20252,2,252,[318 427 357 151 117],450,5,1084,4.284584980237154,40.0,0.0
20253,2,253,[318 427 357 151 117],450,5,1089,4.28740157480315,40.0,0.0
20254,2,254,[318 427 357 151 117],796,5,1094,4.290196078431372,40.0,0.0
20255,2,255,[318 427 357 151 117],330,5,1099,4.29296875,40.0,0.0
20256,2,256,[ 64 427 294   1  12],577,5,1104,4.2957198443579765,40.0,0.0
20257,2,257,[117 318 179  70 276],504,2,1106,4.286821705426356,20.0,0.0
20258,2,258,[323 245  97 405  95],796,2,1108,4.277992277992278,0.0,0.0
20259,2,259,[318 427 357 151 117],716,5,1113,4.280769230769231,40.0,0.0
20260,2,260,[318 427 357 151 117],450,5,1118,4.283524904214559,40.0,0.0
20261,2,261,[318 427 357 151 117],330,5,1123,4.286259541984733,40.0,0.0
20262,2,262,[318 427 357 151 117],450,5,1128,4.2889733840304185,40.0,0.0
20263,2,263,[318 427 357 151 117],330,5,1133,4.291666666666667,40.0,0.0
20264,2,264,[ 97 328 318 216 313],942,3,1136,4.286792452830189,20.0,0.0
20265,2,265,[194 172  64 132  88],389,4,1140,4.285714285714286,20.0,0.0
20266,2,266,[318 427 357 151 117],796,5,1145,4.288389513108614,40.0,0.0
20267,2,267,[318 427 357 151 117],330,5,1150,4.291044776119403,40.0,0.0
20268,2,268,[318 427 357 151 117],796,5,1155,4.29368029739777,40.0,0.0
20269,2,269,[318 427 357 151 117],716,5,1160,4.296296296296297,40.0,0.0
20270,2,270,[  4 182  50 179 603],535,3,1163,4.291512915129151,20.0,20.0
20271,2,271,[318 427 603 357 151],330,5,1168,4.294117647058823,60.0,0.0
20272,2,272,[318 427 603 357 151],330,5,1173,4.2967032967032965,60.0,0.0
20273,2,273,[318 427 603 357 151],151,5,1178,4.299270072992701,60.0,0.0
20274,2,274,[318 427 603 357 151],908,3,1181,4.294545454545455,60.0,0.0
20275,2,275,[318 427 603 357 151],908,3,1184,4.2898550724637685,60.0,0.0
20276,2,276,[318 427 603 357 117],330,5,1189,4.292418772563177,60.0,0.0
20277,2,277,[318 427 603 357 117],716,5,1194,4.294964028776978,60.0,0.0
20278,2,278,[318 427 603 357 117],655,4,1198,4.293906810035843,60.0,0.0
20279,2,279,[318 427 603 357 117],330,5,1203,4.296428571428572,60.0,0.0
20280,2,280,[318 427 603 357 117],716,5,1208,4.298932384341637,60.0,0.0
20281,2,281,[183 403 237 405 121],655,1,1209,4.287234042553192,0.0,0.0
20282,2,282,[318 427 603 357 117],796,5,1214,4.289752650176679,60.0,0.0
20283,2,283,[318 427 603 357 117],716,5,1219,4.292253521126761,60.0,0.0
20284,2,284,[318 427 603 357 117],330,5,1224,4.294736842105263,60.0,0.0
20285,2,285,[318 427 603 357 117],72,5,1229,4.2972027972027975,60.0,0.0
20286,2,286,[117  82 300   1 143],807,5,1234,4.299651567944251,0.0,0.0
20287,2,287,[427 318 603 357 117],330,5,1239,4.302083333333333,60.0,0.0
20288,2,288,[427 318 603 357 117],330,5,1244,4.304498269896194,60.0,0.0
20289,2,289,[427 318 603 357 117],655,4,1248,4.303448275862069,60.0,0.0
20290,2,290,[427 318 603 357 151],269,5,1253,4.305841924398625,60.0,0.0
20291,2,291,[427 318 603 357 151],796,5,1258,4.308219178082192,60.0,0.0
20292,2,292,[427 318 603 357 151],535,4,1262,4.30716723549488,60.0,0.0
20293,2,293,[ 25 282 179  98 423],457,5,1267,4.309523809523809,0.0,0.0
20294,2,294,[603 427 318 357 151],269,5,1272,4.311864406779661,60.0,0.0
20295,2,295,[603 427 318 357 151],535,4,1276,4.3108108108108105,60.0,0.0
20296,2,296,[603 427 318 151 357],908,3,1279,4.306397306397306,60.0,0.0
20297,2,297,[603 427 318 117 151],450,5,1284,4.308724832214765,60.0,0.0
20298,2,298,[603 427 318 117 151],330,5,1289,4.311036789297659,60.0,0.0
20299,2,299,[603 427 318 117 151],450,5,1294,4.3133333333333335,60.0,0.0
20300,2,300,[603 427 318 117 151],716,5,1299,4.3156146179401995,60.0,0.0
20301,2,301,[603 427 318 117 151],450,5,1304,4.317880794701987,60.0,0.0
20302,2,302,[603 427 318 117 151],330,5,1309,4.32013201320132,60.0,0.0
20303,2,303,[603 427 318 117 151],716,5,1314,4.322368421052632,60.0,0.0
20304,2,304,[603 427 318 117 151],716,5,1319,4.324590163934427,60.0,0.0
20305,2,305,[603 427 318 117 151],330,5,1324,4.326797385620915,60.0,0.0
20306,2,306,[603 427 318 117 151],450,5,1329,4.328990228013029,60.0,0.0
20307,2,307,[603 427 318 117 151],716,5,1334,4.3311688311688314,60.0,0.0
20308,2,308,[603 427 318 117 151],450,5,1339,4.333333333333333,60.0,0.0
20309,2,309,[603 427 318 117 151],716,5,1344,4.335483870967742,60.0,0.0
20310,2,310,[603 427 318 117 151],450,5,1349,4.337620578778135,60.0,0.0
20311,2,311,[186 180 111 196 597],796,3,1352,4.333333333333333,0.0,0.0
20312,2,312,[427 603 318 117 151],450,5,1357,4.335463258785943,60.0,0.0
20313,2,313,[182 471 135 186 174],655,2,1359,4.328025477707007,0.0,0.0
20314,2,314,[603 318 427 117 151],716,5,1364,4.33015873015873,60.0,0.0
20315,2,315,[603 318 427 117 151],330,5,1369,4.332278481012659,60.0,0.0
20316,2,316,[546 202 742  88 269],796,3,1372,4.3280757097791795,0.0,0.0
20317,2,317,[603 318 427 117 151],330,5,1377,4.330188679245283,60.0,0.0
20318,2,318,[282  50   7 742  22],457,5,1382,4.332288401253918,0.0,20.0
20319,2,319,[603 318 427 117 151],796,5,1387,4.334375,60.0,0.0
20320,2,320,[603 318 427 117 151],330,5,1392,4.336448598130841,60.0,0.0
20321,2,321,[603 318 427 117 151],330,5,1397,4.338509316770186,60.0,0.0
20322,2,322,[603 318 427 117 151],450,5,1402,4.340557275541796,60.0,0.0
20323,2,323,[603 318 427 117 151],330,5,1407,4.342592592592593,60.0,0.0
20324,2,324,[603 318 427 117 151],716,5,1412,4.344615384615385,60.0,0.0
20325,2,325,[603 318 427 117 151],330,5,1417,4.346625766871166,60.0,0.0
20326,2,326,[125 286  11 151 127],296,4,1421,4.345565749235474,0.0,40.0
20327,2,327,[603 318 427  11 117],450,5,1426,4.347560975609756,60.0,0.0
20328,2,328,[111 173  64 202  56],269,2,1428,4.340425531914893,20.0,0.0
20329,2,329,[288 173 100 168 144],450,4,1432,4.33939393939394,0.0,20.0
20330,2,330,[603 318 427  11 117],450,5,1437,4.341389728096677,60.0,0.0
20331,2,331,[121 483 143 182 176],269,2,1439,4.3343373493975905,0.0,0.0
20332,2,332,[603 427 318  11 117],450,5,1444,4.336336336336337,60.0,0.0
20333,2,333,[603 427 318  11 117],655,3,1447,4.332335329341317,60.0,0.0
20334,2,334,[603 427 318 117 151],330,5,1452,4.334328358208955,60.0,0.0
20335,2,335,[603 427 318 117 151],450,5,1457,4.336309523809524,60.0,0.0
20336,2,336,[ 70 172 603 508 275],535,4,1461,4.335311572700297,20.0,20.0
20337,2,337,[603 427 318 117 151],796,5,1466,4.337278106508876,60.0,0.0
20338,2,338,[603 427 318 117 151],796,5,1471,4.339233038348082,60.0,0.0
20339,2,339,[603 427 318 117 151],716,5,1476,4.341176470588235,60.0,0.0
20340,2,340,[603 427 318 117 151],716,5,1481,4.343108504398827,60.0,0.0
20341,2,341,[603 427 318 117 151],796,5,1486,4.345029239766082,60.0,0.0
20342,2,342,[603 427 318 117 151],716,5,1491,4.346938775510204,60.0,0.0
20343,2,343,[603 427 318 117 151],716,5,1496,4.348837209302325,60.0,0.0
20344,2,344,[175  79 294 197 318],457,4,1500,4.3478260869565215,20.0,0.0
20345,2,345,[603 427 318 117 151],796,5,1505,4.3497109826589595,60.0,0.0
20346,2,346,[603 427 318 117 151],796,5,1510,4.351585014409222,60.0,0.0
20347,2,347,[603 427 318 117 151],330,5,1515,4.353448275862069,60.0,0.0
20348,2,348,[603 427 318 117 151],450,5,1520,4.355300859598854,60.0,0.0
20349,2,349,[215   1   4  64 228],344,3,1523,4.351428571428571,20.0,0.0
20350,2,350,[603 427 318 117 151],796,5,1528,4.353276353276353,60.0,0.0
20351,2,351,[ 88 235 135 357 197],330,4,1532,4.3522727272727275,0.0,0.0
20352,2,352,[508 132 546 197 176],280,2,1534,4.3456090651558075,0.0,0.0
20353,2,353,[603 427 318 117 151],796,5,1539,4.3474576271186445,60.0,0.0
20354,2,354,[603 427 318 117 151],330,5,1544,4.349295774647888,60.0,0.0
20355,2,355,[603 427 318 117 151],796,5,1549,4.351123595505618,60.0,0.0
20356,2,356,[603 427 318 117 151],796,5,1554,4.352941176470588,60.0,0.0
20357,2,357,[496 210 357  96 195],716,3,1557,4.349162011173185,20.0,0.0
20358,2,358,[196  25 100 111  22],344,4,1561,4.348189415041783,0.0,20.0
20359,2,359,[318 603 427 117 151],796,5,1566,4.35,60.0,0.0
20360,2,360,[318 603 427 117 151],450,5,1571,4.351800554016621,60.0,0.0
20361,2,361,[318 603 427 117 151],450,5,1576,4.3535911602209945,60.0,0.0
20362,2,362,[318 603 427 117 151],716,5,1581,4.355371900826446,60.0,0.0
20363,2,363,[318 603 427 117 151],450,5,1586,4.357142857142857,60.0,0.0
20364,2,364,[318 603 427 117 151],796,5,1591,4.358904109589041,60.0,0.0
20365,2,365,[132 161  71  95 318],577,5,1596,4.360655737704918,20.0,0.0
20366,2,366,[318 603 427 117 151],450,5,1601,4.362397820163488,60.0,0.0
20367,2,367,[215 228 121  50 132],151,4,1605,4.361413043478261,0.0,20.0
20368,2,368,[318 603 427 117 151],716,5,1610,4.363143631436315,60.0,0.0
20369,2,369,[318 603 427 117 151],716,5,1615,4.364864864864865,60.0,0.0
20370,2,370,[318 603 427 117 151],716,5,1620,4.366576819407008,60.0,0.0
20371,2,371,[  1 204 135 180 111],18,2,1622,4.360215053763441,0.0,0.0
20372,2,372,[603 427 318 117 151],716,5,1627,4.361930294906166,60.0,0.0
20373,2,373,[603 427 318 117 151],716,5,1632,4.363636363636363,60.0,0.0
20374,2,374,[603 427 318 117 151],796,5,1637,4.365333333333333,60.0,0.0
20375,2,375,[603 427 318 117 151],330,5,1642,4.367021276595745,60.0,0.0
20376,2,376,[603 427 318 117 151],716,5,1647,4.36870026525199,60.0,0.0
20377,2,377,[603 427 318 117 151],716,5,1652,4.37037037037037,60.0,0.0
20378,2,378,[603 427 318 117 151],796,5,1657,4.372031662269129,60.0,0.0
20379,2,379,[603 427 318 117 151],450,5,1662,4.373684210526315,60.0,0.0
20380,2,380,[603 427 318 117 151],450,5,1667,4.375328083989501,60.0,0.0
20381,2,381,[603 427 318 117 151],450,5,1672,4.37696335078534,60.0,0.0
20382,2,382,[603 427 318 117 151],796,5,1677,4.3785900783289815,60.0,0.0
20383,2,383,[191 546 132  95 234],23,2,1679,4.372395833333333,0.0,0.0
20384,2,384,[603 427 318 117 151],330,5,1684,4.374025974025974,60.0,0.0
20385,2,385,[603 427 318 117 151],450,5,1689,4.375647668393782,60.0,0.0
20386,2,386,[603 427 318 117 151],796,5,1694,4.377260981912145,60.0,0.0
20387,2,387,[603 427 318 117 151],796,5,1699,4.378865979381444,60.0,0.0
20388,2,388,[603 427 318 117 151],450,5,1704,4.380462724935732,60.0,0.0
20389,2,389,[603 427 318 117 151],716,5,1709,4.3820512820512825,60.0,0.0
20390,2,390,[742 153 273 182   7],655,2,1711,4.375959079283888,0.0,0.0
20391,2,391,[427  28 216 300 603],716,5,1716,4.377551020408164,40.0,0.0
20392,2,392,[318 427 603 117 151],330,5,1721,4.379134860050891,60.0,0.0
20393,2,393,[318 427 603 117 151],716,5,1726,4.380710659898477,60.0,0.0
20394,2,394,[258 172 301 117 275],296,4,1730,4.379746835443038,0.0,20.0
20395,2,395,[245 151 257 144  50],796,4,1734,4.378787878787879,0.0,20.0
20396,2,396,[318 603 427 257 151],716,5,1739,4.380352644836272,60.0,0.0
20397,2,397,[318 603 427 257 151],796,5,1744,4.381909547738694,60.0,0.0
20398,2,398,[318 603 427 257 151],716,5,1749,4.383458646616542,60.0,0.0
20399,2,399,[318 603 427 257 151],330,5,1754,4.385,60.0,0.0
20400,2,400,[318 603 427 257 151],796,5,1759,4.386533665835412,60.0,0.0
20401,2,401,[318 603 427 257 151],330,5,1764,4.388059701492537,60.0,0.0
20402,2,402,[318 603 427 257 151],330,5,1769,4.389578163771712,60.0,0.0
20403,2,403,[318 603 427 257 151],716,5,1774,4.391089108910891,60.0,0.0
20404,2,404,[318 603 427 257 151],330,5,1779,4.392592592592592,60.0,0.0
20405,2,405,[471 385 427 237 655],655,1,1780,4.384236453201971,20.0,0.0
20406,2,406,[318 427 603 257 151],796,5,1785,4.385749385749386,60.0,0.0
20407,2,407,[318 427 603 257 151],796,5,1790,4.387254901960785,60.0,0.0
20408,2,408,[318 427 603 257 151],330,5,1795,4.388753056234719,60.0,0.0
20409,2,409,[318 427 603 257 151],796,5,1800,4.390243902439025,60.0,0.0
20410,2,410,[318 427 603 257 151],796,5,1805,4.391727493917275,60.0,0.0
20411,2,411,[318 427 603 257 151],716,5,1810,4.393203883495145,60.0,0.0
20412,2,412,[318 427 603 257 151],716,5,1815,4.394673123486683,60.0,0.0
20413,2,413,[318 427 603 257 151],716,5,1820,4.396135265700483,60.0,0.0
20414,2,414,[318 427 603 257 151],796,5,1825,4.397590361445783,60.0,0.0
20415,2,415,[318 427 603 257 151],796,5,1830,4.399038461538462,60.0,0.0
20416,2,416,[318 427 603 257 151],716,5,1835,4.400479616306955,60.0,0.0
20417,2,417,[276 210 195 132 328],655,1,1836,4.392344497607655,0.0,0.0
20418,2,418,[603 318 427 257 151],796,5,1841,4.393794749403341,60.0,0.0
20419,2,419,[603 318 427 257 151],330,5,1846,4.395238095238096,60.0,0.0
20420,2,420,[238  70 288 204 286],593,5,1851,4.396674584323041,0.0,20.0
20421,2,421,[257 318 427 603 151],796,5,1856,4.398104265402844,60.0,0.0
20422,2,422,[257 318 427 603 151],716,5,1861,4.39952718676123,60.0,0.0
20423,2,423,[257 318 427 603 151],716,5,1866,4.400943396226415,60.0,0.0
20424,2,424,[257 318 427 603 151],716,5,1871,4.402352941176471,60.0,0.0
20425,2,425,[  7 175 202 216 235],269,1,1872,4.394366197183099,0.0,0.0
20426,2,426,[318 427 603 257 151],330,5,1877,4.395784543325527,60.0,0.0
20427,2,427,[318 427 603 257 151],716,5,1882,4.397196261682243,60.0,0.0
20428,2,428,[318 427 603 257 151],716,5,1887,4.398601398601398,60.0,0.0
20429,2,429,[318 427 603 257 151],716,5,1892,4.4,60.0,0.0
20430,2,430,[318 427 603 257 151],796,5,1897,4.401392111368909,60.0,0.0
20431,2,431,[318 427 603 257 151],330,5,1902,4.402777777777778,60.0,0.0
20432,2,432,[318 427 603 257 151],716,5,1907,4.404157043879907,60.0,0.0
20433,2,433,[318 427 603 257 151],796,5,1912,4.405529953917051,60.0,0.0
20434,2,434,[222  96 196  28 238],796,3,1915,4.402298850574713,0.0,0.0
20435,2,435,[328 191  82   8  64],796,4,1919,4.401376146788991,20.0,0.0
20436,2,436,[301 111  22  12   4],629,3,1922,4.39816933638444,0.0,0.0
20437,2,437,[603 318 427 257 151],716,5,1927,4.399543378995434,60.0,0.0
20438,2,438,[603 318 427 257 151],330,5,1932,4.400911161731207,60.0,0.0
20439,2,439,[603 318 427 257 151],796,5,1937,4.402272727272727,60.0,0.0
20440,2,440,[603 318 427 257 151],330,5,1942,4.403628117913832,60.0,0.0
20441,2,441,[603 318 427 257 151],716,5,1947,4.404977375565611,60.0,0.0
20442,2,442,[603 318 427 257 151],330,5,1952,4.4063205417607225,60.0,0.0
20443,2,443,[405 275 546   1 121],593,1,1953,4.398648648648648,0.0,20.0
20444,2,444,[603 318 427 257 151],330,5,1958,4.4,60.0,0.0
20445,2,445,[603 318 427 257 151],796,5,1963,4.401345291479821,60.0,0.0
20446,2,446,[197 238  97  96 204],796,2,1965,4.395973154362416,0.0,0.0
20447,2,447,[603 318 427 257 151],330,5,1970,4.397321428571429,60.0,0.0
20448,2,448,[603 318 427 257 151],330,5,1975,4.398663697104677,60.0,0.0
20449,2,449,[603 318 427 257 151],330,5,1980,4.4,60.0,0.0
20450,2,450,[273  70  79 111 318],450,4,1984,4.399113082039912,20.0,0.0
20451,2,451,[257 603 318 427 151],330,5,1989,4.400442477876106,60.0,0.0
20452,2,452,[257 603 318 427 151],716,5,1994,4.401766004415011,60.0,0.0
20453,2,453,[257 603 318 427 151],330,5,1999,4.403083700440528,60.0,0.0
20454,2,454,[200 210 183   1 144],450,3,2002,4.4,0.0,0.0
20455,2,455,[427 318 603 257 151],796,5,2007,4.401315789473684,60.0,0.0
20456,2,456,[238 215 568 405 125],457,5,2012,4.402625820568928,0.0,0.0
20457,2,457,[427 603 257 318 151],716,5,2017,4.403930131004367,60.0,0.0
20458,2,458,[427 603 257 318 151],796,5,2022,4.405228758169935,60.0,0.0
20459,2,459,[427 603 257 318 151],796,5,2027,4.406521739130435,60.0,0.0
20460,2,460,[427 603 257 318 151],330,5,2032,4.407809110629067,60.0,0.0
20461,2,461,[427 603 257 318 151],796,5,2037,4.409090909090909,60.0,0.0
20462,2,462,[427 603 257 318 151],330,5,2042,4.41036717062635,60.0,0.0
20463,2,463,[427 603 257 318 151],716,5,2047,4.411637931034483,60.0,0.0
20464,2,464,[427 603 257 318 151],796,5,2052,4.412903225806452,60.0,0.0
20465,2,465,[427 603 257 318 151],796,5,2057,4.414163090128755,60.0,0.0
20466,2,466,[427 603 257 318 151],796,5,2062,4.415417558886509,60.0,0.0
20467,2,467,[427 603 257 318 151],716,5,2067,4.416666666666667,60.0,0.0
20468,2,468,[427 603 257 318 151],716,5,2072,4.417910447761194,60.0,0.0
20469,2,469,[176  69 202 196 181],504,2,2074,4.412765957446808,0.0,0.0
20470,2,470,[603 318 427 257 151],330,5,2079,4.414012738853503,60.0,0.0
20471,2,471,[286  70 173 483  28],450,4,2083,4.413135593220339,0.0,20.0
20472,2,472,[257 294 180 210 245],796,1,2084,4.405919661733615,0.0,0.0
20473,2,473,[328 181  82 265 176],796,4,2088,4.405063291139241,0.0,0.0
20474,2,474,[603 427 318 257 151],330,5,2093,4.406315789473684,60.0,0.0
20475,2,475,[603 427 318 257 151],796,5,2098,4.407563025210084,60.0,0.0
20476,2,476,[603 427 318 257 151],330,5,2103,4.408805031446541,60.0,0.0
20477,2,477,[603 427 318 257 151],716,5,2108,4.410041841004184,60.0,0.0
20478,2,478,[603 427 318 257 151],330,5,2113,4.411273486430063,60.0,0.0
20479,2,479,[603 427 318 257 151],716,5,2118,4.4125,60.0,0.0
20480,2,480,[603 427 318 257 151],330,5,2123,4.413721413721413,60.0,0.0
20481,2,481,[603 427 318 257 151],796,5,2128,4.4149377593361,60.0,0.0
20482,2,482,[323 228  56 328  69],796,4,2132,4.41407867494824,0.0,0.0
20483,2,483,[603 427 318 257 151],330,5,2137,4.4152892561983474,60.0,0.0
20484,2,484,[603 427 318 257 151],796,5,2142,4.416494845360825,60.0,0.0
20485,2,485,[603 427 318 257 151],796,5,2147,4.417695473251029,60.0,0.0
20486,2,486,[603 427 318 257 151],330,5,2152,4.418891170431212,60.0,0.0
20487,2,487,[603 427 318 257 151],716,5,2157,4.420081967213115,60.0,0.0
20488,2,488,[161 174 173 194 183],269,1,2158,4.413087934560327,0.0,0.0
20489,2,489,[427 603 257 318 151],330,5,2163,4.414285714285715,60.0,0.0
20490,2,490,[427 603 257 318 151],796,5,2168,4.415478615071283,60.0,0.0
20491,2,491,[427 603 257 318 151],330,5,2173,4.416666666666667,60.0,0.0
20492,2,492,[427 603 257 318 151],716,5,2178,4.417849898580122,60.0,0.0
20493,2,493,[ 69 237  97 161  50],593,5,2183,4.419028340080971,0.0,20.0
20494,2,494,[427 603 257 318 151],796,5,2188,4.42020202020202,60.0,0.0
20495,2,495,[427 603 257 318 151],716,5,2193,4.421370967741935,60.0,0.0
20496,2,496,[ 96 196   4 186 603],716,2,2195,4.416498993963783,20.0,0.0
20497,2,497,[427 603 257 318 151],716,5,2200,4.417670682730924,60.0,0.0
20498,2,498,[742 288 181 183 238],457,5,2205,4.4188376753507015,0.0,0.0
20499,2,499,[257 318 427 603 151],796,5,2210,4.42,60.0,0.0
20500,2,500,[257 318 427 603 151],716,5,2215,4.421157684630739,60.0,0.0
20501,2,501,[597 302 161   9  22],269,1,2216,4.414342629482071,0.0,0.0
20502,2,502,[588 175 286 210 322],344,3,2219,4.4115308151093435,0.0,20.0
20503,2,503,[603 257 427 318   9],796,4,2223,4.410714285714286,60.0,0.0
20504,2,504,[318 603 427 257 151],796,5,2228,4.411881188118812,60.0,0.0
20505,2,505,[318 603 427 257 151],796,5,2233,4.413043478260869,60.0,0.0
20506,2,506,[318 603 427 257 151],796,5,2238,4.414201183431953,60.0,0.0
20507,2,507,[318 603 427 257 151],330,5,2243,4.415354330708661,60.0,0.0
20508,2,508,[427 748  22  28  64],796,4,2247,4.414538310412573,40.0,0.0
20509,2,509,[318 603 427 257 151],716,5,2252,4.415686274509804,60.0,0.0
20510,2,510,[318 603 427 257 151],716,5,2257,4.416829745596869,60.0,0.0
20511,2,511,[318 603 427 257 151],716,5,2262,4.41796875,60.0,0.0
20512,2,512,[318 603 427 257 151],796,5,2267,4.419103313840156,60.0,0.0
20513,2,513,[ 71 237 117 151 183],577,5,2272,4.42023346303502,0.0,0.0
20514,2,514,[318 603 427 257 151],330,5,2277,4.421359223300971,60.0,0.0
20515,2,515,[318 603 427 257 151],716,5,2282,4.422480620155039,60.0,0.0
20516,2,516,[318 603 427 257 151],330,5,2287,4.423597678916828,60.0,0.0
20517,2,517,[273 210 357   9 258],629,4,2291,4.422779922779923,0.0,0.0
20518,2,518,[288 322 385 235  22],450,3,2294,4.420038535645472,0.0,0.0
20519,2,519,[183 179 235 196 174],450,4,2298,4.4192307692307695,0.0,0.0
20520,2,520,[603 257 318 427 151],330,5,2303,4.4203454894433785,60.0,0.0
20521,2,521,[603 257 318 427 151],796,5,2308,4.421455938697318,60.0,0.0
20522,2,522,[603 257 318 427 151],716,5,2313,4.422562141491396,60.0,0.0
20523,2,523,[603 257 318 427 151],716,5,2318,4.423664122137405,60.0,0.0
20524,2,524,[603 257 318 427 151],330,5,2323,4.424761904761905,60.0,0.0
20525,2,525,[603 257 318 427 151],796,5,2328,4.425855513307985,60.0,0.0
20526,2,526,[118 202 144 588 328],796,5,2333,4.426944971537002,0.0,0.0
20527,2,527,[318 427 603 257 151],796,5,2338,4.428030303030303,60.0,0.0
20528,2,528,[161 132 181 546 405],450,5,2343,4.429111531190927,0.0,0.0
20529,2,529,[194 286 282 125   9],296,5,2348,4.430188679245283,0.0,20.0
20530,2,530,[127 186 234 385  64],796,3,2351,4.427495291902072,20.0,20.0
20531,2,531,[318 427 603 257 151],330,5,2356,4.428571428571429,60.0,0.0
20532,2,532,[318 427 603 257 151],716,5,2361,4.429643527204503,60.0,0.0
20533,2,533,[318 427 603 257 151],796,5,2366,4.430711610486892,60.0,0.0
20534,2,534,[318 427 603 257 151],796,5,2371,4.43177570093458,60.0,0.0
20535,2,535,[435 210 153   1 313],450,4,2375,4.4309701492537314,0.0,0.0
20536,2,536,[257 427 318 603 151],330,5,2380,4.432029795158287,60.0,0.0
20537,2,537,[257 427 318 603 151],796,5,2385,4.433085501858736,60.0,0.0
20538,2,538,[186 597 211 168 153],796,3,2388,4.430426716141002,0.0,0.0
20539,2,539,[173   7  71 174  96],450,4,2392,4.42962962962963,0.0,0.0
20540,2,540,[323 423 100  71 269],23,2,2394,4.425138632162661,0.0,20.0
20541,2,541,[ 11 179 603 483 328],655,3,2397,4.422509225092251,20.0,0.0
20542,2,542,[427 603 318 257 151],796,5,2402,4.4235727440147325,60.0,0.0
20543,2,543,[427 603 318 257 151],796,5,2407,4.424632352941177,60.0,0.0
20544,2,544,[427 603 318 257 151],796,5,2412,4.425688073394495,60.0,0.0
20545,2,545,[  9 182 257 603 100],796,3,2415,4.423076923076923,20.0,20.0
20546,2,546,[ 28 403 603 197 357],330,5,2420,4.424131627056672,20.0,0.0
20547,2,547,[427 603 318 257 151],330,5,2425,4.425182481751825,60.0,0.0
20548,2,548,[ 64 121 127 195  50],716,4,2429,4.424408014571949,20.0,40.0
20549,2,549,[427 603 318 257 151],796,5,2434,4.425454545454546,60.0,0.0
20550,2,550,[427 603 318 257 151],716,5,2439,4.426497277676951,60.0,0.0
20551,2,551,[427 603 318 257 151],330,5,2444,4.427536231884058,60.0,0.0
20552,2,552,[427 603 318 257 151],716,5,2449,4.428571428571429,60.0,0.0
20553,2,553,[427 603 318 257 151],796,5,2454,4.4296028880866425,60.0,0.0
20554,2,554,[427 603 318 257 151],330,5,2459,4.43063063063063,60.0,0.0
20555,2,555,[144  95 237 294 200],716,4,2463,4.429856115107913,0.0,0.0
20556,2,556,[427 603 318 257 151],716,5,2468,4.430879712746858,60.0,0.0
20557,2,557,[427 603 318 257 151],796,5,2473,4.431899641577061,60.0,0.0
20558,2,558,[427 603 318 257 151],330,5,2478,4.432915921288014,60.0,0.0
20559,2,559,[187 118 222 185 258],796,5,2483,4.433928571428571,0.0,0.0
20560,2,560,[427 603 318 257 151],716,5,2488,4.434937611408199,60.0,0.0
20561,2,561,[ 28 151 385  25 196],151,4,2492,4.434163701067615,0.0,0.0
20562,2,562,[427 603 318 257 151],796,5,2497,4.435168738898756,60.0,0.0
20563,2,563,[ 12 237 269 427 194],503,4,2501,4.434397163120567,20.0,0.0
20564,2,564,[196 742 245 597 173],796,3,2504,4.431858407079646,0.0,0.0
20565,2,565,[427 603 318 257 151],796,5,2509,4.432862190812721,60.0,0.0
20566,2,566,[427 603 318 257 151],796,5,2514,4.4338624338624335,60.0,0.0
20567,2,567,[427 603 318 257 151],796,5,2519,4.434859154929577,60.0,0.0
20568,2,568,[427 603 318 257 151],330,5,2524,4.43585237258348,60.0,0.0
20569,2,569,[125 172 405  15 204],457,5,2529,4.436842105263158,0.0,0.0
20570,2,570,[427 603 318 257 151],716,5,2534,4.437828371278459,60.0,0.0
20571,2,571,[ 15 288 144 185  89],450,3,2537,4.435314685314685,0.0,0.0
20572,2,572,[427 603 318 257 151],716,5,2542,4.43630017452007,60.0,0.0
20573,2,573,[471  97 235 175  96],716,1,2543,4.430313588850174,0.0,0.0
20574,2,574,[603 257 318 427 151],330,5,2548,4.431304347826087,60.0,0.0
20575,2,575,[603 257 318 427 151],330,5,2553,4.432291666666667,60.0,0.0
20576,2,576,[603 257 318 427 151],716,5,2558,4.433275563258232,60.0,0.0
20577,2,577,[603 257 318 427 151],796,5,2563,4.4342560553633215,60.0,0.0
20578,2,578,[210 180  88 202 276],786,4,2567,4.433506044905009,0.0,0.0
20579,2,579,[603 257 318 427 151],330,5,2572,4.43448275862069,60.0,0.0
20580,2,580,[603 257 318 427 151],716,5,2577,4.435456110154905,60.0,0.0
20581,2,581,[ 96 121 228 258 403],457,5,2582,4.436426116838488,0.0,0.0
20582,2,582,[603 257 318 427 151],330,5,2587,4.437392795883362,60.0,0.0
20583,2,583,[603 257 318 427 151],330,5,2592,4.438356164383562,60.0,0.0
20584,2,584,[603 257 318 427 151],330,5,2597,4.4393162393162395,60.0,0.0
20585,2,585,[603 257 318 427 151],796,5,2602,4.440273037542662,60.0,0.0
20586,2,586,[603 257 318 427 151],330,5,2607,4.441226575809199,60.0,0.0
20587,2,587,[603 257 318 427 151],330,5,2612,4.442176870748299,60.0,0.0
20588,2,588,[603 257 318 427 151],716,5,2617,4.443123938879457,60.0,0.0
20589,2,589,[603 257 318 427 151],796,5,2622,4.444067796610169,60.0,0.0
20590,2,590,[603 257 318 427 151],716,5,2627,4.4450084602368864,60.0,0.0
20591,2,591,[603 257 318 427 151],716,5,2632,4.445945945945946,60.0,0.0
20592,2,592,[603 257 318 427 151],796,5,2637,4.4468802698145025,60.0,0.0
20593,2,593,[ 96   7 603 181  98],269,2,2639,4.442760942760943,20.0,0.0
20594,2,594,[603 318 257 427 151],716,5,2644,4.443697478991597,60.0,0.0
20595,2,595,[603 318 257 427 151],796,5,2649,4.444630872483222,60.0,0.0
20596,2,596,[603 318 257 427 151],716,5,2654,4.4455611390284755,60.0,0.0
20597,2,597,[603 318 257 427 151],716,5,2659,4.446488294314381,60.0,0.0
20598,2,598,[603 318 257 427 151],330,5,2664,4.447412353923205,60.0,0.0
20599,2,599,[603 318 257 427 151],716,5,2669,4.448333333333333,60.0,0.0
20600,2,600,[603 318 257 427 151],716,5,2674,4.449251247920133,60.0,0.0
20601,2,601,[174 135   9 125  64],655,2,2676,4.445182724252492,20.0,0.0
20602,2,602,[427 603 318 257 151],330,5,2681,4.446102819237147,60.0,0.0
20603,2,603,[  1 187 175 216  71],18,5,2686,4.447019867549669,0.0,0.0
20604,2,604,[427 603 318 257 151],716,5,2691,4.4479338842975205,60.0,0.0
20605,2,605,[202 268 423 403 127],655,1,2692,4.442244224422442,0.0,20.0
20606,2,606,[ 25  97  22 238 405],11,2,2694,4.438220757825371,0.0,0.0
20607,2,607,[268 135 180 211  56],11,3,2697,4.435855263157895,0.0,0.0
20608,2,608,[ 97 196 268 172 204],344,3,2700,4.433497536945813,0.0,0.0
20609,2,609,[257 318 427 603 151],716,5,2705,4.434426229508197,60.0,0.0
20610,2,610,[257 318 427 603 151],716,5,2710,4.435351882160393,60.0,0.0
20611,2,611,[257 318 427 603 151],330,5,2715,4.436274509803922,60.0,0.0
20612,2,612,[210  12 143 196 282],796,4,2719,4.435562805872757,0.0,0.0
20613,2,613,[257 318 427 603 151],716,5,2724,4.436482084690554,60.0,0.0
20614,2,614,[257 318 427 603 151],330,5,2729,4.43739837398374,60.0,0.0
20615,2,615,[257 318 427 603 151],330,5,2734,4.438311688311688,60.0,0.0
20616,2,616,[153 257  50  56 294],796,4,2738,4.437601296596434,0.0,20.0
20617,2,617,[403  79 235 183  69],457,4,2742,4.436893203883495,0.0,0.0
20618,2,618,[257 318 427 603 151],330,5,2747,4.4378029079159935,60.0,0.0
20619,2,619,[257 318 427 603 151],330,5,2752,4.438709677419355,60.0,0.0
20620,2,620,[ 79 515 195 471 127],716,3,2755,4.436392914653784,0.0,20.0
20621,2,621,[515 318 427 603 257],655,4,2759,4.435691318327974,60.0,0.0
20622,2,622,[568 546 200   4 300],450,3,2762,4.43338683788122,0.0,0.0
20623,2,623,[269 191  69 385   1],796,3,2765,4.431089743589744,0.0,0.0
20624,2,624,[515 318 427 603 257],716,5,2770,4.432,60.0,0.0
20625,2,625,[515 318 427 603 257],655,4,2774,4.431309904153355,60.0,0.0
20626,2,626,[435   9  70 333 187],655,1,2775,4.425837320574162,0.0,0.0
20627,2,627,[515 318 427 603 257],716,5,2780,4.426751592356688,60.0,0.0
20628,2,628,[515 318 427 603 257],655,4,2784,4.4260731319554845,60.0,0.0
20629,2,629,[515 318 427 603 151],716,5,2789,4.426984126984127,60.0,0.0
20630,2,630,[515 318 427 603 151],18,3,2792,4.424722662440571,60.0,0.0
20631,2,631,[153  11 197 181 271],655,0,2792,4.417721518987341,0.0,0.0
20632,2,632,[515 318 427 603 257],655,4,2796,4.4170616113744074,60.0,0.0
20633,2,633,[515 318 427 603 151],908,4,2800,4.416403785488959,60.0,0.0
20634,2,634,[515 318 427 603 151],908,4,2804,4.415748031496063,60.0,0.0
20635,2,635,[515 318 427 603 257],716,5,2809,4.416666666666667,60.0,0.0
20636,2,636,[655 172 180 135 215],693,2,2811,4.41287284144427,0.0,0.0
20637,2,637,[265 127 427 161  98],436,3,2814,4.410658307210031,20.0,20.0
20638,2,638,[515 318 427 603 257],716,5,2819,4.411580594679187,60.0,0.0
20639,2,639,[515 318 427 603 257],655,4,2823,4.4109375,60.0,0.0
20640,2,640,[515 318 427 603 151],18,3,2826,4.408736349453978,60.0,0.0
20641,2,641,[515 318 427 603 151],908,4,2830,4.40809968847352,60.0,0.0
20642,2,642,[515 318 427 603 257],655,4,2834,4.407465007776049,60.0,0.0
20643,2,643,[515 318 427 603 151],716,5,2839,4.408385093167702,60.0,0.0
20644,2,644,[515 318 427 603 151],908,4,2843,4.4077519379844965,60.0,0.0
20645,2,645,[515 318 427 603 151],908,4,2847,4.4071207430340555,60.0,0.0
20646,2,646,[515 318 427 603 117],655,4,2851,4.406491499227203,60.0,0.0
20647,2,647,[515 318 427 603 257],716,5,2856,4.407407407407407,60.0,0.0
20648,2,648,[403 172 194 742 183],577,5,2861,4.408320493066256,0.0,0.0
20649,2,649,[515 318 427 603 257],655,4,2865,4.407692307692308,60.0,0.0
20650,2,650,[515 318 427 603 151],269,5,2870,4.408602150537634,60.0,0.0
20651,2,651,[ 89  11 286 238 185],655,2,2872,4.404907975460123,0.0,20.0
20652,2,652,[515 318 427 603 151],716,5,2877,4.405819295558959,60.0,0.0
20653,2,653,[515 318 427 603 151],716,5,2882,4.4067278287461775,60.0,0.0
20654,2,654,[515 318 427 603 151],908,4,2886,4.406106870229007,60.0,0.0
20655,2,655,[515 318 427 603  79],72,5,2891,4.407012195121951,60.0,0.0
20656,2,656,[515 318 427 603  79],535,3,2894,4.404870624048706,60.0,0.0
20657,2,657,[318 427 603 515 151],18,3,2897,4.40273556231003,60.0,0.0
20658,2,658,[318 427 603 515 117],655,4,2901,4.402124430955994,60.0,0.0
20659,2,659,[318 427 603 515   8],18,4,2905,4.401515151515151,60.0,0.0
20660,2,660,[ 56 215 496  12 655],280,3,2908,4.3993948562783665,20.0,0.0
20661,2,661,[318 427 603 515   8],655,4,2912,4.398791540785498,60.0,0.0
20662,2,662,[111  69 174  28 204],796,4,2916,4.398190045248869,0.0,0.0
20663,2,663,[318 427 603 515 257],655,4,2920,4.397590361445783,60.0,0.0
20664,2,664,[194 215 183 173 275],796,5,2925,4.398496240601504,0.0,20.0
20665,2,665,[318 427 603 515 151],716,5,2930,4.3993993993994,60.0,0.0
20666,2,666,[318 427 603 515 151],269,5,2935,4.400299850074963,60.0,0.0
20667,2,667,[ 88 210 204 172 211],236,0,2935,4.3937125748503,0.0,0.0
20668,2,668,[ 96 237 301 403 603],655,1,2936,4.38863976083707,20.0,0.0
20669,2,669,[318 427 603 515 151],269,5,2941,4.38955223880597,60.0,0.0
20670,2,670,[655 423  88 183  97],655,1,2942,4.384500745156483,0.0,0.0
20671,2,671,[318 427 603 515 151],18,3,2945,4.382440476190476,60.0,0.0
20672,2,672,[301 222 202 204 132],450,4,2949,4.381872213967311,0.0,0.0
20673,2,673,[318 427 603 515 357],18,4,2953,4.381305637982196,60.0,0.0
20674,2,674,[318 427 603 515 357],18,4,2957,4.380740740740741,60.0,0.0
20675,2,675,[318 427 603 515 357],18,4,2961,4.3801775147929,60.0,0.0
20676,2,676,[318 427 515 603 357],269,5,2966,4.38109305760709,60.0,0.0
20677,2,677,[318 427 515 603 357],72,5,2971,4.382005899705015,60.0,0.0
20678,2,678,[318 427 515 603 357],72,5,2976,4.382916053019146,60.0,0.0
20679,2,679,[318 427 515 603 357],269,5,2981,4.383823529411765,60.0,0.0
20680,2,680,[318 427 515 603 357],269,5,2986,4.384728340675477,60.0,0.0
20681,2,681,[318 427 515 603 357],908,4,2990,4.3841642228739,60.0,0.0
20682,2,682,[318 427 515 603 151],908,4,2994,4.383601756954612,60.0,0.0
20683,2,683,[183 132 423 483 151],450,4,2998,4.383040935672515,0.0,0.0
20684,2,684,[318 427 515 603 117],72,5,3003,4.383941605839416,60.0,0.0
20685,2,685,[318 427 515 603 117],655,4,3007,4.38338192419825,60.0,0.0
20686,2,686,[318 427 515 603 496],908,5,3012,4.384279475982533,80.0,0.0
20687,2,687,[318 427 515 603 496],18,4,3016,4.383720930232558,80.0,0.0
20688,2,688,[318 427 515 603 496],269,5,3021,4.384615384615385,80.0,0.0
20689,2,689,[180  28  70 603 282],716,3,3024,4.3826086956521735,20.0,0.0
20690,2,690,[318 427 515 603 496],18,4,3028,4.38205499276411,80.0,0.0
20691,2,691,[318 427 515 603 496],18,4,3032,4.381502890173411,80.0,0.0
20692,2,692,[318 427 515 603 496],269,5,3037,4.382395382395383,80.0,0.0
20693,2,693,[318 427 515 496 603],908,5,3042,4.38328530259366,80.0,0.0
20694,2,694,[318 427 515 496 603],18,4,3046,4.38273381294964,80.0,0.0
20695,2,695,[300 111 328   4  64],655,1,3047,4.377873563218391,20.0,0.0
20696,2,696,[318 427 515 496 603],716,5,3052,4.378766140602583,80.0,0.0
20697,2,697,[318 427 515 496 603],18,4,3056,4.378223495702006,80.0,0.0
20698,2,698,[ 79  98 194 196 202],798,2,3058,4.374821173104435,0.0,0.0
20699,2,699,[151 237 200 403   9],269,3,3061,4.372857142857143,0.0,0.0
20700,2,700,[318 427 515 496 603],269,5,3066,4.373751783166904,80.0,0.0
20701,2,701,[318 427 515 496 603],535,4,3070,4.373219373219373,80.0,0.0
20702,2,702,[ 79 483 313 181 237],236,5,3075,4.374110953058321,0.0,0.0
20703,2,703,[318 427 496 515 603],716,5,3080,4.375,80.0,0.0
20704,2,704,[318 427 496 515 603],535,4,3084,4.374468085106383,80.0,0.0
20705,2,705,[318 427 496 603 151],18,3,3087,4.372521246458923,80.0,0.0
20706,2,706,[318 427 496 603 357],18,4,3091,4.371994342291372,80.0,0.0
20707,2,707,[ 12 215 228 121 282],796,5,3096,4.372881355932203,0.0,0.0
20708,2,708,[318 427 496 357 257],796,5,3101,4.3737658674189,60.0,0.0
20709,2,709,[318 427 496 357 257],330,5,3106,4.374647887323944,60.0,0.0
20710,2,710,[318 427 496 357 257],716,5,3111,4.375527426160337,60.0,0.0
20711,2,711,[  8 288  69 655 175],655,0,3111,4.36938202247191,0.0,0.0
20712,2,712,[318 427 496 357 257],716,5,3116,4.370266479663394,60.0,0.0
20713,2,713,[318 427 496 357 257],796,5,3121,4.371148459383753,60.0,0.0
20714,2,714,[318 427 496 357 257],330,5,3126,4.372027972027972,60.0,0.0
20715,2,715,[318 427 496 357 257],796,5,3131,4.372905027932961,60.0,0.0
20716,2,716,[318 427 496 357 257],796,5,3136,4.373779637377964,60.0,0.0
20717,2,717,[  1 471 268 216   4],655,1,3137,4.36908077994429,0.0,0.0
20718,2,718,[ 69 210 180  98 202],450,4,3141,4.368567454798331,0.0,0.0
20719,2,719,[ 89 216 237 273 496],796,4,3145,4.368055555555555,20.0,0.0
20720,2,720,[318 427 496 357 257],796,5,3150,4.368932038834951,60.0,0.0
20721,2,721,[318 427 496 357 257],330,5,3155,4.369806094182826,60.0,0.0
20722,2,722,[ 25 182 100 210 117],450,3,3158,4.3679114799446745,0.0,20.0
20723,2,723,[318 427 496 357 257],716,5,3163,4.3687845303867405,60.0,0.0
20724,2,724,[204 275 183 508 143],655,3,3166,4.366896551724138,0.0,20.0
20725,2,725,[318 427 496 357 257],796,5,3171,4.367768595041323,60.0,0.0
20726,2,726,[318 427 496 357 257],716,5,3176,4.368638239339752,60.0,0.0
20727,2,727,[318 427 496 357 257],330,5,3181,4.3695054945054945,60.0,0.0
20728,2,728,[318 427 496 357 257],716,5,3186,4.37037037037037,60.0,0.0
20729,2,729,[318 427 496 357 257],716,5,3191,4.3712328767123285,60.0,0.0
20730,2,730,[318 427 496 357 257],716,5,3196,4.372093023255814,60.0,0.0
20731,2,731,[318 427 496 357 257],330,5,3201,4.372950819672131,60.0,0.0
20732,2,732,[117 258 546 471   1],807,4,3205,4.372442019099591,0.0,0.0
20733,2,733,[318 427 496 357 257],330,5,3210,4.3732970027247955,60.0,0.0
20734,2,734,[318 427 496 357 257],796,5,3215,4.374149659863946,60.0,0.0
20735,2,735,[318 427 496 357 257],330,5,3220,4.375,60.0,0.0
20736,2,736,[  1 127 100 258 318],655,2,3222,4.3717774762550885,20.0,40.0
20737,2,737,[318 427 496 357 257],330,5,3227,4.372628726287263,60.0,0.0
20738,2,738,[183 176  25 135 111],151,3,3230,4.370771312584574,0.0,0.0
20739,2,739,[318 427 496 357 257],716,5,3235,4.371621621621622,60.0,0.0
20740,2,740,[318 427 496 357 257],330,5,3240,4.372469635627531,60.0,0.0
20741,2,741,[318 427 496 357 257],330,5,3245,4.373315363881401,60.0,0.0
20742,2,742,[234 132   1 172  64],577,4,3249,4.372812920592194,20.0,0.0
20743,2,743,[318 427 496 357 257],330,5,3254,4.373655913978495,60.0,0.0
20744,2,744,[235  98 471  12 132],280,4,3258,4.373154362416107,0.0,0.0
20745,2,745,[197 435 186 211 153],911,4,3262,4.372654155495979,0.0,0.0
20746,2,746,[318 427 496 357 257],796,5,3267,4.373493975903615,60.0,0.0
20747,2,747,[357  15  88 286 183],593,5,3272,4.374331550802139,0.0,20.0
20748,2,748,[  1  56  11 175 204],457,5,3277,4.37516688918558,0.0,0.0
20749,2,749,[318 427 496 357 257],796,5,3282,4.376,60.0,0.0
20750,2,750,[175 568 182 127  50],269,3,3285,4.374167776298269,0.0,40.0
20751,2,751,[168 546  97 237   9],457,4,3289,4.3736702127659575,0.0,0.0
20752,2,752,[318 427 496 357 257],330,5,3294,4.374501992031872,60.0,0.0
20753,2,753,[318 427 496 357 257],716,5,3299,4.3753315649867375,60.0,0.0
20754,2,754,[318 427 496 357 257],716,5,3304,4.376158940397351,60.0,0.0
20755,2,755,[318 427 496 357 257],716,5,3309,4.376984126984127,60.0,0.0
20756,2,756,[318 427 496 357 257],716,5,3314,4.3778071334214,60.0,0.0
20757,2,757,[318 427 496 357 257],796,5,3319,4.378627968337731,60.0,0.0
20758,2,758,[318 427 496 357 257],330,5,3324,4.379446640316205,60.0,0.0
20759,2,759,[588   8   7 125 228],344,4,3328,4.378947368421053,0.0,0.0
20760,2,760,[318 427 496 357 257],796,5,3333,4.379763469119579,60.0,0.0
20761,2,761,[215  82 405 282 318],280,1,3334,4.375328083989501,20.0,0.0
20762,2,762,[405 403 385 300 204],796,5,3339,4.376146788990826,0.0,0.0
20763,2,763,[ 69  11 186 180 286],450,4,3343,4.37565445026178,0.0,20.0
20764,2,764,[318 427 496 357 257],330,5,3348,4.376470588235295,60.0,0.0
20765,2,765,[318 427 496 357 257],796,5,3353,4.377284595300261,60.0,0.0
20766,2,766,[318 427 496 357 257],716,5,3358,4.378096479791395,60.0,0.0
20767,2,767,[ 82  97 568 191  79],655,2,3360,4.375,0.0,0.0
20768,2,768,[ 79  50  88 125   1],344,2,3362,4.371911573472041,0.0,20.0
20769,2,769,[318 427 496 357 257],716,5,3367,4.372727272727273,60.0,0.0
20770,2,770,[318 427 496 357 257],796,5,3372,4.373540856031128,60.0,0.0
20771,2,771,[318 427 496 357 257],796,5,3377,4.374352331606218,60.0,0.0
20772,2,772,[318 427 496 357 257],796,5,3382,4.3751617076326,60.0,0.0
20773,2,773,[318 427 496 357 257],330,5,3387,4.375968992248062,60.0,0.0
20774,2,774,[318 427 496 357 257],796,5,3392,4.376774193548387,60.0,0.0
20775,2,775,[318 427 496 357 257],330,5,3397,4.377577319587629,60.0,0.0
20776,2,776,[276   8   4 210 173],457,5,3402,4.378378378378378,0.0,0.0
20777,2,777,[ 25 385  82 132 237],716,4,3406,4.377892030848329,0.0,0.0
20778,2,778,[471 151 196 603 183],716,3,3409,4.37612323491656,20.0,0.0
20779,2,779,[318 427 496 357 257],796,5,3414,4.376923076923077,60.0,0.0
20780,2,780,[318 427 496 357 257],716,5,3419,4.377720870678617,60.0,0.0
20781,2,781,[318 427 496 357 257],330,5,3424,4.378516624040921,60.0,0.0
20782,2,782,[318 427 496 357 257],716,5,3429,4.379310344827586,60.0,0.0
20783,2,783,[318 427 496 357 257],330,5,3434,4.380102040816326,60.0,0.0
20784,2,784,[318 427 496 357 257],796,5,3439,4.380891719745223,60.0,0.0
20785,2,785,[318 427 496 357 257],796,5,3444,4.3816793893129775,60.0,0.0
20786,2,786,[318 427 496 357 257],330,5,3449,4.382465057179162,60.0,0.0
20787,2,787,[318 427 496 357 257],716,5,3454,4.383248730964467,60.0,0.0
20788,2,788,[318 427 496 357 257],716,5,3459,4.38403041825095,60.0,0.0
20789,2,789,[496  97 237 127 195],344,3,3462,4.3822784810126585,20.0,20.0
20790,2,790,[318 427 496 357 257],330,5,3467,4.383059418457648,60.0,0.0
20791,2,791,[318 427 496 357 257],716,5,3472,4.383838383838384,60.0,0.0
20792,2,792,[182 197 153 282 275],535,3,3475,4.382093316519546,0.0,20.0
20793,2,793,[318 427 496 357 257],796,5,3480,4.38287153652393,60.0,0.0
20794,2,794,[318 427 496 357 257],330,5,3485,4.383647798742138,60.0,0.0
20795,2,795,[318 427 496 357 257],796,5,3490,4.384422110552764,60.0,0.0
20796,2,796,[318 427 496 357 257],716,5,3495,4.385194479297365,60.0,0.0
20797,2,797,[ 25   8 276   4 191],18,3,3498,4.383458646616542,0.0,0.0
20798,2,798,[318 427 496 357 257],796,5,3503,4.3842302878598245,60.0,0.0
20799,2,799,[318 427 496 357 257],796,5,3508,4.385,60.0,0.0
20800,2,800,[318 427 496 357 257],716,5,3513,4.385767790262173,60.0,0.0
20801,2,801,[318 427 496 357 257],796,5,3518,4.386533665835412,60.0,0.0
20802,2,802,[202 127  69 237 258],655,1,3519,4.382316313823163,0.0,20.0
20803,2,803,[211 121  25 427   8],535,5,3524,4.383084577114428,20.0,0.0
20804,2,804,[318 427 496 357 257],796,5,3529,4.383850931677019,60.0,0.0
20805,2,805,[ 97  64  70 328 483],401,4,3533,4.383374689826303,20.0,0.0
20806,2,806,[318 427 496 357 257],796,5,3538,4.384138785625774,60.0,0.0
20807,2,807,[318 427 496 357 257],330,5,3543,4.38490099009901,60.0,0.0
20808,2,808,[318 427 496 357 257],330,5,3548,4.38566131025958,60.0,0.0
20809,2,809,[318 427 496 357 257],330,5,3553,4.38641975308642,60.0,0.0
20810,2,810,[168 117 176 603 748],450,5,3558,4.387176325524044,20.0,0.0
20811,2,811,[282 196 144 161 117],457,5,3563,4.387931034482759,0.0,0.0
20812,2,812,[508 187 302 182 318],269,4,3567,4.387453874538745,20.0,0.0
20813,2,813,[318 427 496 357 257],716,5,3572,4.388206388206388,60.0,0.0
20814,2,814,[318 427 496 357 257],330,5,3577,4.388957055214724,60.0,0.0
20815,2,815,[318 427 496 357 257],716,5,3582,4.389705882352941,60.0,0.0
20816,2,816,[318 427 496 357 257],330,5,3587,4.3904528763769886,60.0,0.0
20817,2,817,[318 427 496 357 257],796,5,3592,4.39119804400978,60.0,0.0
20818,2,818,[318 427 496 357 257],716,5,3597,4.391941391941392,60.0,0.0
20819,2,819,[318 427 496 357 257],796,5,3602,4.392682926829268,60.0,0.0
20820,2,820,[318 427 496 357 257],330,5,3607,4.393422655298417,60.0,0.0
20821,2,821,[  7 357 181 288 186],450,3,3610,4.391727493917275,0.0,0.0
20822,2,822,[318 427 496 357 257],716,5,3615,4.392466585662212,60.0,0.0
20823,2,823,[135  69 483 222 257],807,5,3620,4.393203883495145,0.0,0.0
20824,2,824,[333 483 210  98 174],236,2,3622,4.390303030303031,0.0,0.0
20825,2,825,[318 427 496 357 257],330,5,3627,4.391041162227603,60.0,0.0
20826,2,826,[318 427 496 357 257],796,5,3632,4.391777509068924,60.0,0.0
20827,2,827,[318 427 496 357 257],330,5,3637,4.392512077294686,60.0,0.0
20828,2,828,[318 427 496 357 257],716,5,3642,4.393244873341375,60.0,0.0
20829,2,829,[318 427 496 357 257],796,5,3647,4.393975903614458,60.0,0.0
20830,2,830,[144 423 313 127   7],450,5,3652,4.394705174488568,0.0,20.0
20831,2,831,[318 427 496 357 257],330,5,3657,4.3954326923076925,60.0,0.0
20832,2,832,[143 174 357 173 276],457,5,3662,4.396158463385354,0.0,0.0
20833,2,833,[318 427 496 357 257],330,5,3667,4.396882494004796,60.0,0.0
20834,2,834,[153 318 273 483 161],401,2,3669,4.394011976047905,20.0,0.0
20835,2,835,[318 427 496 357 257],330,5,3674,4.394736842105263,60.0,0.0
20836,2,836,[318 427 496 357 257],716,5,3679,4.395459976105138,60.0,0.0
20837,2,837,[318 427 496 357 257],716,5,3684,4.39618138424821,60.0,0.0
20838,2,838,[318 427 496 357 257],716,5,3689,4.396901072705602,60.0,0.0
20839,2,839,[318 427 496 357 257],330,5,3694,4.397619047619048,60.0,0.0
20840,2,840,[318 427 496 357 257],796,5,3699,4.39833531510107,60.0,0.0
20841,2,841,[318 427 496 357 257],330,5,3704,4.399049881235155,60.0,0.0
20842,2,842,[357 191  70 234 100],151,3,3707,4.397390272835112,0.0,20.0
20843,2,843,[318 427 496 357 257],330,5,3712,4.398104265402844,60.0,0.0
20844,2,844,[318 427 496 357 257],796,5,3717,4.398816568047337,60.0,0.0
20845,2,845,[269 197  71 423  22],535,4,3721,4.398345153664303,0.0,0.0
20846,2,846,[318 427 496 357 257],716,5,3726,4.399055489964581,60.0,0.0
20847,2,847,[318 427 496 357 257],330,5,3731,4.399764150943396,60.0,0.0
20848,2,848,[546 176 204 181 222],344,3,3734,4.39811542991755,0.0,0.0
20849,2,849,[ 88 603  96 111  89],450,5,3739,4.398823529411764,20.0,0.0
20850,2,850,[276   9 111 313 187],655,3,3742,4.397179788484136,0.0,0.0
20851,2,851,[655 132   1 276  64],457,5,3747,4.397887323943662,20.0,0.0
20852,2,852,[318 427 496 357 257],716,5,3752,4.398593200468933,60.0,0.0
20853,2,853,[318 427 496 357 257],716,5,3757,4.399297423887588,60.0,0.0
20854,2,854,[197 234 180 483 172],269,2,3759,4.396491228070175,0.0,0.0
20855,2,855,[318 427 496 357 257],716,5,3764,4.397196261682243,60.0,0.0
20856,2,856,[318 427 496 357 257],330,5,3769,4.397899649941657,60.0,0.0
20857,2,857,[318 427 496 357 257],716,5,3774,4.398601398601398,60.0,0.0
20858,2,858,[ 28 333 211 257 195],796,3,3777,4.3969732246798605,0.0,0.0
20859,2,859,[471  79 127 228  12],72,4,3781,4.3965116279069765,0.0,20.0
20860,2,860,[318 427 496 357 257],716,5,3786,4.397212543554007,60.0,0.0
20861,2,861,[ 97  11 288 237 118],655,0,3786,4.392111368909513,0.0,0.0
20862,2,862,[ 12 181 423 294 568],577,4,3790,4.391657010428737,0.0,0.0
20863,2,863,[318 427 496 357 257],716,5,3795,4.392361111111111,60.0,0.0
20864,2,864,[318 427 496 357 257],330,5,3800,4.393063583815029,60.0,0.0
20865,2,865,[318 427 496 357 257],330,5,3805,4.393764434180139,60.0,0.0
20866,2,866,[318 427 496 357 257],796,5,3810,4.3944636678200695,60.0,0.0
20867,2,867,[318 427 496 357 257],716,5,3815,4.395161290322581,60.0,0.0
20868,2,868,[ 56  50  98 185 117],457,5,3820,4.395857307249712,0.0,20.0
20869,2,869,[318 427 496 357 257],716,5,3825,4.396551724137931,60.0,0.0
20870,2,870,[423 286 742 288 427],450,4,3829,4.396096440872561,20.0,20.0
20871,2,871,[318 427 496 357 257],330,5,3834,4.396788990825688,60.0,0.0
20872,2,872,[176 282 655 237 202],796,4,3838,4.396334478808706,0.0,0.0
20873,2,873,[318 427 496 357 257],330,5,3843,4.397025171624714,60.0,0.0
20874,2,874,[318 427 496 357 257],330,5,3848,4.397714285714286,60.0,0.0
20875,2,875,[318 427 496 357 257],330,5,3853,4.398401826484018,60.0,0.0
20876,2,876,[318 427 496 357 257],330,5,3858,4.39908779931585,60.0,0.0
20877,2,877,[318 427 496 357 257],796,5,3863,4.399772209567198,60.0,0.0
20878,2,878,[318 427 496 357 257],796,5,3868,4.400455062571104,60.0,0.0
20879,2,879,[318 427 496 357 257],716,5,3873,4.401136363636364,60.0,0.0
20880,2,880,[318 427 496 357 257],716,5,3878,4.401816118047673,60.0,0.0
20881,2,881,[318 427 496 357 257],796,5,3883,4.40249433106576,60.0,0.0
20882,2,882,[269  98 210  95  15],18,5,3888,4.4031710079275195,0.0,0.0
20883,2,883,[318 427 496 357 257],330,5,3893,4.403846153846154,60.0,0.0
20884,2,884,[318 427 496 357 257],716,5,3898,4.404519774011299,60.0,0.0
20885,2,885,[318 427 496 357 257],330,5,3903,4.405191873589165,60.0,0.0
20886,2,886,[318 427 496 357 257],330,5,3908,4.405862457722661,60.0,0.0
20887,2,887,[318 427 496 357 257],716,5,3913,4.406531531531532,60.0,0.0
20888,2,888,[318 427 496 357 257],796,5,3918,4.407199100112486,60.0,0.0
20889,2,889,[ 25 603 216 496 385],716,4,3922,4.406741573033708,40.0,0.0
20890,2,890,[318 427 496 357 257],330,5,3927,4.407407407407407,60.0,0.0
20891,2,891,[318 427 496 357 257],716,5,3932,4.408071748878924,60.0,0.0
20892,2,892,[318 427 496 357 257],716,5,3937,4.408734602463606,60.0,0.0
20893,2,893,[742 204 135 302 228],655,2,3939,4.406040268456376,0.0,0.0
20894,2,894,[318 427 496 357 257],330,5,3944,4.406703910614525,60.0,0.0
20895,2,895,[172 423  28 268 175],655,1,3945,4.402901785714286,0.0,0.0
20896,2,896,[318 427 496 357 257],716,5,3950,4.403567447045708,60.0,0.0
20897,2,897,[318 427 496 357 257],716,5,3955,4.404231625835189,60.0,0.0
20898,2,898,[318 427 496 357 257],330,5,3960,4.404894327030034,60.0,0.0
20899,2,899,[318 427 496 357 257],330,5,3965,4.405555555555556,60.0,0.0
20900,2,900,[318 427 496 357 257],716,5,3970,4.406215316315206,60.0,0.0
20901,2,901,[ 98 121 265 161 222],716,4,3974,4.405764966740577,0.0,0.0
20902,2,902,[318 427 496 357 257],716,5,3979,4.406423034330011,60.0,0.0
20903,2,903,[318 427 496 357 257],330,5,3984,4.407079646017699,60.0,0.0
20904,2,904,[318 427 496 357 257],796,5,3989,4.4077348066298345,60.0,0.0
20905,2,905,[318 427 496 357 257],330,5,3994,4.408388520971302,60.0,0.0
20906,2,906,[318 427 496 357 257],796,5,3999,4.409040793825799,60.0,0.0
20907,2,907,[318 427 496 357 257],796,5,4004,4.409691629955947,60.0,0.0
20908,2,908,[273 471 172  79  50],655,4,4008,4.409240924092409,0.0,20.0
20909,2,909,[ 96  12  98  25 405],344,4,4012,4.408791208791209,0.0,0.0
20910,2,910,[300 294 183  79 117],450,5,4017,4.4094401756311745,0.0,0.0
20911,2,911,[318 427 496 357 257],330,5,4022,4.410087719298246,60.0,0.0
20912,2,912,[143 405 238 496  69],786,5,4027,4.410733844468784,20.0,0.0
20913,2,913,[655 228 237  12  79],450,5,4032,4.411378555798687,0.0,0.0
20914,2,914,[197  98   7 196 194],72,4,4036,4.410928961748634,0.0,0.0
20915,2,915,[318 427 496 357 257],330,5,4041,4.4115720524017465,60.0,0.0
20916,2,916,[603 228 179 568 168],450,5,4046,4.412213740458015,20.0,0.0
20917,2,917,[742 191 200 423 318],577,4,4050,4.411764705882353,20.0,0.0
20918,2,918,[ 69 121  50  82 172],807,5,4055,4.41240478781284,0.0,20.0
20919,2,919,[318 427 496 357 257],330,5,4060,4.413043478260869,60.0,0.0
20920,2,920,[318 427 496 357 257],716,5,4065,4.413680781758957,60.0,0.0
20921,2,921,[318 427 496 357 257],716,5,4070,4.414316702819956,60.0,0.0
20922,2,922,[318 427 496 357 257],716,5,4075,4.414951245937162,60.0,0.0
20923,2,923,[318 427 496 357 257],330,5,4080,4.415584415584416,60.0,0.0
20924,2,924,[318 427 496 357 257],716,5,4085,4.416216216216216,60.0,0.0
20925,2,925,[318 427 496 357 257],796,5,4090,4.416846652267819,60.0,0.0
20926,2,926,[194  88 234 121 318],504,2,4092,4.414239482200648,20.0,0.0
20927,2,927,[597 143 194  89 168],807,5,4097,4.414870689655173,0.0,0.0
20928,2,928,[318 427 496 357 257],796,5,4102,4.4155005382131325,60.0,0.0
20929,2,929,[318 427 496 357 257],716,5,4107,4.416129032258064,60.0,0.0
20930,2,930,[318 427 496 357 257],330,5,4112,4.4167561761546725,60.0,0.0
20931,2,931,[318 427 496 357 257],796,5,4117,4.417381974248927,60.0,0.0
20932,2,932,[318 427 496 357 257],330,5,4122,4.418006430868167,60.0,0.0
20933,2,933,[318 427 496 357 257],716,5,4127,4.418629550321199,60.0,0.0
20934,2,934,[318 427 496 357 257],330,5,4132,4.419251336898395,60.0,0.0
20935,2,935,[318 427 496 357 257],330,5,4137,4.419871794871795,60.0,0.0
20936,2,936,[318 427 496 357 257],796,5,4142,4.420490928495197,60.0,0.0
20937,2,937,[ 71 135 294 132 117],236,1,4143,4.41684434968017,0.0,0.0
20938,2,938,[318 427 496 357 257],796,5,4148,4.4174653887113955,60.0,0.0
20939,2,939,[318 427 496 357 257],716,5,4153,4.4180851063829785,60.0,0.0
20940,2,940,[111 194 483 269 200],707,4,4157,4.417640807651435,0.0,0.0
20941,2,941,[318 427 496 357 257],716,5,4162,4.418259023354564,60.0,0.0
20942,2,942,[318 427 496 357 257],716,5,4167,4.418875927889713,60.0,0.0
20943,2,943,[318 427 496 357 257],796,5,4172,4.419491525423729,60.0,0.0
20944,2,944,[318 427 496 357 257],716,5,4177,4.42010582010582,60.0,0.0
20945,2,945,[318 427 496 357 257],330,5,4182,4.420718816067653,60.0,0.0
20946,2,946,[597  12 132 111 151],450,5,4187,4.421330517423442,0.0,0.0
20947,2,947,[318 427 496 357 257],716,5,4192,4.421940928270042,60.0,0.0
20948,2,948,[318 427 496 357 257],716,5,4197,4.422550052687039,60.0,0.0
20949,2,949,[318 427 496 357 257],796,5,4202,4.423157894736842,60.0,0.0
20950,2,950,[318 427 496 357 257],796,5,4207,4.423764458464774,60.0,0.0
20951,2,951,[222 144 357 195 385],796,5,4212,4.42436974789916,0.0,0.0
20952,2,952,[127 471 483 100 181],457,5,4217,4.424973767051417,0.0,40.0
20953,2,953,[318 427 496 357 257],716,5,4222,4.4255765199161425,60.0,0.0
20954,2,954,[313 195 191 678 471],344,2,4224,4.4230366492146596,0.0,0.0
20955,2,955,[318 427 496 357 257],796,5,4229,4.423640167364017,60.0,0.0
20956,2,956,[318 427 496 357 257],330,5,4234,4.424242424242424,60.0,0.0
20957,2,957,[318 427 496 357 257],716,5,4239,4.424843423799582,60.0,0.0
20958,2,958,[318 427 496 357 257],796,5,4244,4.425443169968718,60.0,0.0
20959,2,959,[ 11 185 153 269  70],450,5,4249,4.426041666666666,0.0,0.0
20960,2,960,[318 427 496 357 257],796,5,4254,4.426638917793965,60.0,0.0
20961,2,961,[151  12 186 655  64],151,5,4259,4.427234927234927,20.0,0.0
20962,2,962,[318 427 496 357 257],796,5,4264,4.427829698857736,60.0,0.0
20963,2,963,[318 427 496 357 257],796,5,4269,4.428423236514523,60.0,0.0
20964,2,964,[318 427 496 357 257],330,5,4274,4.429015544041451,60.0,0.0
20965,2,965,[318 427 496 357 257],796,5,4279,4.429606625258799,60.0,0.0
20966,2,966,[282  56 182 215 196],450,5,4284,4.430196483971044,0.0,0.0
20967,2,967,[ 64 269 211 118 168],450,4,4288,4.429752066115703,20.0,0.0
20968,2,968,[318 427 496 357 257],716,5,4293,4.430340557275541,60.0,0.0
20969,2,969,[318 427 496 357 257],330,5,4298,4.430927835051547,60.0,0.0
20970,2,970,[318 427 496 357 257],796,5,4303,4.4315139031925845,60.0,0.0
20971,2,971,[318 427 496 357 257],330,5,4308,4.432098765432099,60.0,0.0
20972,2,972,[318 427 496 357 257],330,5,4313,4.4326824254881805,60.0,0.0
20973,2,973,[ 97 275 132 127 423],18,5,4318,4.433264887063655,0.0,40.0
20974,2,974,[318 427 496 357 257],330,5,4323,4.4338461538461535,60.0,0.0
20975,2,975,[318 427 496 357 257],330,5,4328,4.434426229508197,60.0,0.0
20976,2,976,[318 427 496 357 257],330,5,4333,4.435005117707267,60.0,0.0
20977,2,977,[318 427 496 357 257],796,5,4338,4.435582822085889,60.0,0.0
20978,2,978,[318 427 496 357 257],716,5,4343,4.4361593462717055,60.0,0.0
20979,2,979,[ 50 210 183 176   1],5,3,4346,4.4346938775510205,0.0,20.0
20980,2,980,[ 82 151 228 161 144],457,5,4351,4.4352701325178385,0.0,0.0
20981,2,981,[318 427 496 357 257],716,5,4356,4.435845213849287,60.0,0.0
20982,2,982,[318 427 496 357 257],796,5,4361,4.436419125127162,60.0,0.0
20983,2,983,[318 427 496 357 257],796,5,4366,4.436991869918699,60.0,0.0
20984,2,984,[318 427 496 357 257],716,5,4371,4.43756345177665,60.0,0.0
20985,2,985,[275 269 195 144 423],796,4,4375,4.4371196754563895,0.0,20.0
20986,2,986,[318 427 496 357 257],716,5,4380,4.437689969604863,60.0,0.0
20987,2,987,[318 427 496 357 257],330,5,4385,4.4382591093117405,60.0,0.0
20988,2,988,[318 427 496 357 257],796,5,4390,4.4388270980788676,60.0,0.0
20989,2,989,[318 427 496 357 257],796,5,4395,4.4393939393939394,60.0,0.0
20990,2,990,[318 427 496 357 257],796,5,4400,4.439959636730575,60.0,0.0
20991,2,991,[318 427 496 357 257],330,5,4405,4.440524193548387,60.0,0.0
20992,2,992,[318 427 496 357 257],716,5,4410,4.4410876132930515,60.0,0.0
20993,2,993,[ 96 357  82 143 483],23,2,4412,4.438631790744467,0.0,0.0
20994,2,994,[318 427 496 257 357],330,5,4417,4.439195979899497,60.0,0.0
20995,2,995,[197 182   1 161 185],450,5,4422,4.4397590361445785,0.0,0.0
20996,2,996,[ 64 179 195 483 269],655,3,4425,4.438314944834503,20.0,0.0
20997,2,997,[195 132  25 181 175],716,3,4428,4.43687374749499,0.0,0.0
20998,2,998,[318 427 496 257 357],796,5,4433,4.4374374374374375,60.0,0.0
20999,2,999,[318 427 496 257 357],716,5,4438,4.438,60.0,0.0
21000,2,1000,[ 11 597 568   8  12],457,4,4442,4.437562437562438,0.0,0.0
21001,2,1001,[318 427 496 257 357],796,5,4447,4.43812375249501,60.0,0.0
21002,2,1002,[185 143 202 435 168],18,2,4449,4.435692921236291,0.0,0.0
21003,2,1003,[318 427 496 257 357],716,5,4454,4.436254980079681,60.0,0.0
21004,2,1004,[318 427 496 257 357],716,5,4459,4.4368159203980095,60.0,0.0
21005,2,1005,[318 427 496 257 357],716,5,4464,4.437375745526839,60.0,0.0
21006,2,1006,[318 427 496 257 357],716,5,4469,4.43793445878848,60.0,0.0
21007,2,1007,[215 288 181 179 176],450,4,4473,4.4375,0.0,0.0
21008,2,1008,[318 427 496 257 357],716,5,4478,4.438057482656095,60.0,0.0
21009,2,1009,[318 427 496 257 357],716,5,4483,4.438613861386139,60.0,0.0
21010,2,1010,[173 100 121  89  22],457,5,4488,4.439169139465875,0.0,20.0
21011,2,1011,[318 427 496 257 357],796,5,4493,4.439723320158103,60.0,0.0
21012,2,1012,[ 98  95 276 238   4],18,4,4497,4.43928923988154,0.0,0.0
21013,2,1013,[318 427 496 257 357],330,5,4502,4.439842209072978,60.0,0.0
21014,2,1014,[181 176 173 118 185],151,3,4505,4.438423645320197,0.0,0.0
21015,2,1015,[197 323 237 273 180],796,1,4506,4.43503937007874,0.0,0.0
21016,2,1016,[153 427  97  12  98],796,4,4510,4.434611602753196,20.0,0.0
21017,2,1017,[318 427 496 257 357],716,5,4515,4.4351669941060905,60.0,0.0
21018,2,1018,[318 427 496 257 357],716,5,4520,4.435721295387635,60.0,0.0
21019,2,1019,[286 153   1 179 187],535,2,4522,4.433333333333334,0.0,20.0
21020,2,1020,[318 427 496 257 357],796,5,4527,4.433888344760039,60.0,0.0
21021,2,1021,[318 427 496 257 357],796,5,4532,4.4344422700587085,60.0,0.0
21022,2,1022,[318 427 496 257 357],716,5,4537,4.434995112414467,60.0,0.0
21023,2,1023,[ 79 289 200 286 333],655,2,4539,4.4326171875,0.0,20.0
21024,2,1024,[318 427 496 257 357],796,5,4544,4.4331707317073175,60.0,0.0
21025,2,1025,[318 427 496 257 357],330,5,4549,4.4337231968810915,60.0,0.0
21026,2,1026,[ 64 588  69 235   9],457,4,4553,4.433300876338851,20.0,0.0
21027,2,1027,[125 204 151 603 118],151,4,4557,4.432879377431907,20.0,0.0
21028,2,1028,[318 427 496 257 357],330,5,4562,4.4334305150631685,60.0,0.0
21029,2,1029,[318 427 496 257 357],716,5,4567,4.4339805825242715,60.0,0.0
21030,2,1030,[318 427 496 257 357],716,5,4572,4.434529582929195,60.0,0.0
21031,2,1031,[301 125  88 258 204],450,5,4577,4.435077519379845,0.0,0.0
21032,2,1032,[318 427 496 257 357],330,5,4582,4.435624394966118,60.0,0.0
21033,2,1033,[318 427 496 257 357],330,5,4587,4.4361702127659575,60.0,0.0
21034,2,1034,[318 427 496 257 357],796,5,4592,4.436714975845411,60.0,0.0
21035,2,1035,[318 427 496 257 357],330,5,4597,4.437258687258687,60.0,0.0
21036,2,1036,[318 427 496 257 357],796,5,4602,4.437801350048216,60.0,0.0
21037,2,1037,[318 427 496 257 357],796,5,4607,4.438342967244702,60.0,0.0
21038,2,1038,[318 427 496 257 357],716,5,4612,4.43888354186718,60.0,0.0
21039,2,1039,[423 132 234 237 143],655,1,4613,4.435576923076923,0.0,0.0
21040,2,1040,[318 427 496 257 357],330,5,4618,4.43611911623439,60.0,0.0
21041,2,1041,[318 427 496 257 357],716,5,4623,4.436660268714012,60.0,0.0
21042,2,1042,[318 427 496 257 357],796,5,4628,4.437200383509109,60.0,0.0
21043,2,1043,[318 427 496 257 357],716,5,4633,4.437739463601533,60.0,0.0
21044,2,1044,[318 427 496 257 357],330,5,4638,4.438277511961722,60.0,0.0
21045,2,1045,[318 427 496 257 357],716,5,4643,4.438814531548757,60.0,0.0
21046,2,1046,[318 427 496 257 357],796,5,4648,4.43935052531041,60.0,0.0
21047,2,1047,[318 427 496 257 357],796,5,4653,4.439885496183206,60.0,0.0
21048,2,1048,[318 427 496 257 357],330,5,4658,4.440419447092469,60.0,0.0
21049,2,1049,[318 427 496 257 357],330,5,4663,4.440952380952381,60.0,0.0
21050,2,1050,[210 196 403  25  56],655,0,4663,4.4367269267364415,0.0,0.0
21051,2,1051,[318 427 496 257 357],716,5,4668,4.437262357414449,60.0,0.0
21052,2,1052,[318 427 496 257 357],796,5,4673,4.437796771130104,60.0,0.0
21053,2,1053,[318 427 496 257 357],796,5,4678,4.438330170777989,60.0,0.0
21054,2,1054,[318 427 496 257 357],796,5,4683,4.438862559241707,60.0,0.0
21055,2,1055,[215 313 357 423 196],693,3,4686,4.4375,0.0,0.0
21056,2,1056,[318 427 496 257 357],796,5,4691,4.438032166508988,60.0,0.0
21057,2,1057,[318 427 496 257 357],716,5,4696,4.438563327032136,60.0,0.0
21058,2,1058,[275   8 286 132 125],344,3,4699,4.437204910292729,0.0,40.0
21059,2,1059,[ 89 125 237  88 210],256,5,4704,4.437735849056604,0.0,0.0
21060,2,1060,[  1 135 197 265 216],457,5,4709,4.438265786993402,0.0,0.0
21061,2,1061,[318 427 496 257 357],796,5,4714,4.43879472693032,60.0,0.0
21062,2,1062,[318 427 496 257 357],796,5,4719,4.439322671683914,60.0,0.0
21063,2,1063,[ 70 174  15 179   1],655,1,4720,4.43609022556391,0.0,0.0
21064,2,1064,[318 427 496 257 357],716,5,4725,4.436619718309859,60.0,0.0
21065,2,1065,[318 427 496 257 357],330,5,4730,4.437148217636023,60.0,0.0
21066,2,1066,[318 427 496 257 357],796,5,4735,4.43767572633552,60.0,0.0
21067,2,1067,[318 427 496 257 357],330,5,4740,4.438202247191011,60.0,0.0
21068,2,1068,[153 237 286 276   1],401,1,4741,4.4349859681945745,0.0,20.0
21069,2,1069,[318 427 496 257 357],716,5,4746,4.435514018691589,60.0,0.0
21070,2,1070,[318 427 496 257 357],330,5,4751,4.436041083099907,60.0,0.0
21071,2,1071,[318 427 496 257 357],330,5,4756,4.436567164179104,60.0,0.0
21072,2,1072,[318 427 496 257 357],796,5,4761,4.437092264678472,60.0,0.0
21073,2,1073,[318 427 496 257 357],716,5,4766,4.437616387337058,60.0,0.0
21074,2,1074,[318 427 496 257 357],330,5,4771,4.438139534883721,60.0,0.0
21075,2,1075,[318 427 496 257 357],330,5,4776,4.438661710037175,60.0,0.0
21076,2,1076,[318 427 496 257 357],796,5,4781,4.439182915506035,60.0,0.0
21077,2,1077,[196 742   4  11  70],593,5,4786,4.4397031539888685,0.0,0.0
21078,2,1078,[318 427 496 257 357],796,5,4791,4.440222428174235,60.0,0.0
21079,2,1079,[318 427 496 257 357],716,5,4796,4.440740740740741,60.0,0.0
21080,2,1080,[318 427 496 257 357],330,5,4801,4.441258094357077,60.0,0.0
21081,2,1081,[318 427 496 257 357],716,5,4806,4.44177449168207,60.0,0.0
21082,2,1082,[318 427 496 257 357],796,5,4811,4.442289935364728,60.0,0.0
21083,2,1083,[318 427 496 257 357],330,5,4816,4.442804428044281,60.0,0.0
21084,2,1084,[318 427 496 257 357],796,5,4821,4.44331797235023,60.0,0.0
21085,2,1085,[318 427 496 257 357],330,5,4826,4.443830570902394,60.0,0.0
21086,2,1086,[118 143 194 288 234],450,2,4828,4.4415823367065315,0.0,0.0
21087,2,1087,[318 427 496 257 357],796,5,4833,4.442095588235294,60.0,0.0
21088,2,1088,[ 71 174 182 100 515],535,3,4836,4.440771349862259,0.0,20.0
21089,2,1089,[143 302  96 405 228],450,5,4841,4.441284403669725,0.0,0.0
21090,2,1090,[318 427 496 257 357],796,5,4846,4.44179651695692,60.0,0.0
21091,2,1091,[318 427 496 257 357],796,5,4851,4.4423076923076925,60.0,0.0
21092,2,1092,[ 97 301 496 118   4],151,4,4855,4.441903019213175,20.0,0.0
21093,2,1093,[318 427 496 257 357],330,5,4860,4.442413162705667,60.0,0.0
21094,2,1094,[318 427 496 257 357],330,5,4865,4.442922374429224,60.0,0.0
21095,2,1095,[125 186 195 200 423],786,5,4870,4.443430656934306,0.0,0.0
21096,2,1096,[318 427 496 257 357],716,5,4875,4.443938012762079,60.0,0.0
21097,2,1097,[318 427 496 257 357],330,5,4880,4.444444444444445,60.0,0.0
21098,2,1098,[318 427 496 257 357],716,5,4885,4.444949954504095,60.0,0.0
21099,2,1099,[318 427 496 257 357],796,5,4890,4.445454545454545,60.0,0.0
21100,2,1100,[318 427 496 257 357],716,5,4895,4.445958219800182,60.0,0.0
21101,2,1101,[ 98   8 245 194 496],796,4,4899,4.445553539019964,20.0,0.0
21102,2,1102,[318 427 496 257 357],716,5,4904,4.446056210335449,60.0,0.0
21103,2,1103,[318 427 496 257 357],330,5,4909,4.446557971014493,60.0,0.0
21104,2,1104,[318 427 496 257 357],330,5,4914,4.447058823529412,60.0,0.0
21105,2,1105,[301 273 182 423 100],796,2,4916,4.444846292947559,0.0,20.0
21106,2,1106,[ 82  97 172   8 111],18,2,4918,4.44263775971093,0.0,0.0
21107,2,1107,[228  98 568 187 143],716,4,4922,4.4422382671480145,0.0,0.0
21108,2,1108,[318 427 496 257 357],716,5,4927,4.442741208295762,60.0,0.0
21109,2,1109,[ 64 182 143 222 748],450,4,4931,4.442342342342342,20.0,0.0
21110,2,1110,[318 427 496 257 357],716,5,4936,4.442844284428443,60.0,0.0
21111,2,1111,[318 427 496 257 357],796,5,4941,4.443345323741007,60.0,0.0
21112,2,1112,[423  71 132  95 100],577,5,4946,4.443845462713387,0.0,20.0
21113,2,1113,[ 70 603 294 597 174],23,2,4948,4.44165170556553,20.0,0.0
21114,2,1114,[318 427 496 257 357],796,5,4953,4.442152466367713,60.0,0.0
21115,2,1115,[318 427 496 257 357],716,5,4958,4.442652329749104,60.0,0.0
21116,2,1116,[318 427 496 257 357],330,5,4963,4.443151298119965,60.0,0.0
21117,2,1117,[318 427 496 257 357],796,5,4968,4.443649373881932,60.0,0.0
21118,2,1118,[125 153 215 238 302],655,1,4969,4.440571939231456,0.0,0.0
21119,2,1119,[318 427 496 257 357],716,5,4974,4.441071428571429,60.0,0.0
21120,2,1120,[318 427 496 257 357],330,5,4979,4.44157002676182,60.0,0.0
21121,2,1121,[  8 228 403 237 191],796,5,4984,4.4420677361853835,0.0,0.0
21122,2,1122,[318 427 496 257 357],330,5,4989,4.442564559216384,60.0,0.0
21123,2,1123,[111 655  12  79 742],457,4,4993,4.442170818505338,0.0,0.0
21124,2,1124,[318 427 496 257 357],716,5,4998,4.442666666666667,60.0,0.0
21125,2,1125,[ 89  64 222  69 118],457,5,5003,4.44316163410302,20.0,0.0
21126,2,1126,[318 427 496 257 357],796,5,5008,4.4436557231588285,60.0,0.0
21127,2,1127,[318 427 496 257 357],330,5,5013,4.444148936170213,60.0,0.0
21128,2,1128,[318 427 496 257 357],716,5,5018,4.444641275465013,60.0,0.0
21129,2,1129,[176 191  79 483 282],457,5,5023,4.445132743362832,0.0,0.0
21130,2,1130,[318 427 496 257 357],796,5,5028,4.445623342175066,60.0,0.0
21131,2,1131,[568 496 174 603 195],450,5,5033,4.446113074204947,40.0,0.0
21132,2,1132,[185 276 258 195 403],457,5,5038,4.446601941747573,0.0,0.0
21133,2,1133,[318 427 496 257 357],796,5,5043,4.447089947089947,60.0,0.0
21134,2,1134,[318 427 496 257 357],330,5,5048,4.447577092511013,60.0,0.0
21135,2,1135,[318 427 496 257 357],796,5,5053,4.44806338028169,60.0,0.0
21136,2,1136,[144 655 186 742  25],450,3,5056,4.44678979771328,0.0,0.0
21137,2,1137,[318 427 496 257 357],796,5,5061,4.447275922671353,60.0,0.0
21138,2,1138,[318 427 496 257 357],796,5,5066,4.447761194029851,60.0,0.0
21139,2,1139,[318 427 496 257 357],716,5,5071,4.448245614035088,60.0,0.0
21140,2,1140,[318 427 496 257 357],796,5,5076,4.4487291849255035,60.0,0.0
21141,2,1141,[318 427 496 257 357],796,5,5081,4.449211908931699,60.0,0.0
21142,2,1142,[318 427 496 257 357],330,5,5086,4.449693788276465,60.0,0.0
21143,2,1143,[318 427 496 257 357],716,5,5091,4.450174825174825,60.0,0.0
21144,2,1144,[318 427 496 257 357],330,5,5096,4.450655021834061,60.0,0.0
21145,2,1145,[318 427 496 257 357],716,5,5101,4.451134380453752,60.0,0.0
21146,2,1146,[318 427 496 257 357],716,5,5106,4.451612903225806,60.0,0.0
21147,2,1147,[318 427 496 257 357],716,5,5111,4.4520905923344944,60.0,0.0
21148,2,1148,[ 15 100 121 423  89],457,5,5116,4.452567449956484,0.0,20.0
21149,2,1149,[318 427 496 257 357],796,5,5121,4.453043478260869,60.0,0.0
21150,2,1150,[318 427 496 257 357],796,5,5126,4.45351867940921,60.0,0.0
21151,2,1151,[  1 318 275 210 197],655,2,5128,4.451388888888889,20.0,20.0
21152,2,1152,[318 427 496 257 357],330,5,5133,4.451864700780573,60.0,0.0
21153,2,1153,[318 427 496 257 357],796,5,5138,4.452339688041595,60.0,0.0
21154,2,1154,[ 70 118  28   1 151],716,4,5142,4.451948051948052,0.0,0.0
21155,2,1155,[318 427 496 257 357],330,5,5147,4.45242214532872,60.0,0.0
21156,2,1156,[318 427 496 257 357],716,5,5152,4.452895419187554,60.0,0.0
21157,2,1157,[318 427 496 257 357],330,5,5157,4.453367875647668,60.0,0.0
21158,2,1158,[318 427 496 257 357],330,5,5162,4.453839516824849,60.0,0.0
21159,2,1159,[318 427 496 257 357],796,5,5167,4.4543103448275865,60.0,0.0
21160,2,1160,[318 427 496 257 357],330,5,5172,4.454780361757106,60.0,0.0
21161,2,1161,[186   4  88  95 211],450,2,5174,4.452667814113597,0.0,0.0
21162,2,1162,[318 427 496 257 357],796,5,5179,4.453138435081685,60.0,0.0
21163,2,1163,[318 427 496 257 357],330,5,5184,4.453608247422681,60.0,0.0
21164,2,1164,[318 427 496 257 357],330,5,5189,4.454077253218884,60.0,0.0
21165,2,1165,[196 238 508  50  64],535,5,5194,4.454545454545454,20.0,20.0
21166,2,1166,[318 427 496 257 357],330,5,5199,4.455012853470437,60.0,0.0
21167,2,1167,[100 313 176 202 237],577,5,5204,4.455479452054795,0.0,20.0
21168,2,1168,[318 427 496 257 357],330,5,5209,4.455945252352438,60.0,0.0
21169,2,1169,[318 427 496 257 357],716,5,5214,4.456410256410257,60.0,0.0
21170,2,1170,[318 427 496 257 357],716,5,5219,4.456874466268147,60.0,0.0
21171,2,1171,[318 427 496 257 357],330,5,5224,4.4573378839590445,60.0,0.0
21172,2,1172,[318 427 496 257 357],330,5,5229,4.457800511508951,60.0,0.0
21173,2,1173,[318 427 496 257 357],330,5,5234,4.458262350936968,60.0,0.0
21174,2,1174,[168  89  22 135 238],18,2,5236,4.456170212765957,0.0,0.0
21175,2,1175,[318 427 496 257 357],796,5,5241,4.456632653061225,60.0,0.0
21176,2,1176,[318 427 496 257 357],330,5,5246,4.457094307561597,60.0,0.0
21177,2,1177,[318 427 496 257 357],716,5,5251,4.457555178268251,60.0,0.0
21178,2,1178,[318 427 496 257 357],330,5,5256,4.458015267175573,60.0,0.0
21179,2,1179,[318 427 496 257 357],716,5,5261,4.458474576271186,60.0,0.0
21180,2,1180,[202  50 194 196 655],457,5,5266,4.458933107535986,0.0,20.0
21181,2,1181,[318 427 496 257 357],330,5,5271,4.459390862944162,60.0,0.0
21182,2,1182,[318 427 496 257 357],716,5,5276,4.459847844463229,60.0,0.0
21183,2,1183,[191 211 100 258   7],23,4,5280,4.45945945945946,0.0,20.0
21184,2,1184,[318 427 496 257 357],796,5,5285,4.459915611814346,60.0,0.0
21185,2,1185,[318 427 496 257 357],716,5,5290,4.460370994940978,60.0,0.0
21186,2,1186,[318 427 496 257 357],796,5,5295,4.460825610783488,60.0,0.0
21187,2,1187,[ 22 275 195  12  88],796,5,5300,4.461279461279461,0.0,20.0
21188,2,1188,[318 427 496 257 357],796,5,5305,4.461732548359967,60.0,0.0
21189,2,1189,[318 427 496 257 357],330,5,5310,4.46218487394958,60.0,0.0
21190,2,1190,[318 427 496 257 357],796,5,5315,4.462636439966415,60.0,0.0
21191,2,1191,[318 427 496 257 357],716,5,5320,4.4630872483221475,60.0,0.0
21192,2,1192,[237 151 176 195  69],269,1,5321,4.460184409052808,0.0,0.0
21193,2,1193,[318 427 496 257 357],796,5,5326,4.460636515912898,60.0,0.0
21194,2,1194,[135 237 603 302  97],655,3,5329,4.459414225941423,20.0,0.0
21195,2,1195,[318 427 496 257 357],796,5,5334,4.459866220735786,60.0,0.0
21196,2,1196,[318 427 496 257 357],796,5,5339,4.4603174603174605,60.0,0.0
21197,2,1197,[318 427 496 257 357],716,5,5344,4.460767946577629,60.0,0.0
21198,2,1198,[ 12 257 357 427 288],655,2,5346,4.458715596330276,20.0,0.0
21199,2,1199,[153 111 196 245  12],796,4,5350,4.458333333333333,0.0,0.0
21200,2,1200,[318 427 496 357 257],330,5,5355,4.458784346378018,60.0,0.0
21201,2,1201,[318 427 496 357 257],716,5,5360,4.4592346089850246,60.0,0.0
21202,2,1202,[322 200 237 318 210],504,4,5364,4.458852867830424,20.0,0.0
21203,2,1203,[318 427 496 357 257],330,5,5369,4.459302325581396,60.0,0.0
21204,2,1204,[318 427 496 357 257],330,5,5374,4.4597510373443985,60.0,0.0
21205,2,1205,[210 125 273  71  12],450,2,5376,4.45771144278607,0.0,0.0
21206,2,1206,[273 215  71 185  96],450,3,5379,4.456503728251864,0.0,0.0
21207,2,1207,[202  97 118 318 215],450,4,5383,4.45612582781457,20.0,0.0
21208,2,1208,[318 427 496 357 257],796,5,5388,4.456575682382134,60.0,0.0
21209,2,1209,[318 427 496 357 257],796,5,5393,4.45702479338843,60.0,0.0
21210,2,1210,[318 427 496 357 257],796,5,5398,4.457473162675475,60.0,0.0
21211,2,1211,[318 427 496 357 257],716,5,5403,4.457920792079208,60.0,0.0
21212,2,1212,[318 427 496 357 257],330,5,5408,4.458367683429514,60.0,0.0
21213,2,1213,[405 125 204 228 655],280,0,5408,4.454695222405272,0.0,0.0
21214,2,1214,[318 427 496 357 257],330,5,5413,4.455144032921811,60.0,0.0
21215,2,1215,[318 427 496 357 257],330,5,5418,4.4555921052631575,60.0,0.0
21216,2,1216,[655  97 275 200  64],450,4,5422,4.4552177485620374,20.0,20.0
21217,2,1217,[318 427 496 357 257],796,5,5427,4.455665024630542,60.0,0.0
21218,2,1218,[318 427 496 357 257],716,5,5432,4.45611156685808,60.0,0.0
21219,2,1219,[318 427 496 357 257],716,5,5437,4.45655737704918,60.0,0.0
21220,2,1220,[318 427 496 357 257],330,5,5442,4.457002457002457,60.0,0.0
21221,2,1221,[588 269 173 168 181],796,4,5446,4.456628477905074,0.0,0.0
21222,2,1222,[546 216 471 288 235],457,3,5449,4.455437448896157,0.0,0.0
21223,2,1223,[318 427 496 357 257],796,5,5454,4.455882352941177,60.0,0.0
21224,2,1224,[318 427 496 357 257],330,5,5459,4.456326530612245,60.0,0.0
21225,2,1225,[318 427 496 357 257],796,5,5464,4.456769983686787,60.0,0.0
21226,2,1226,[318 427 496 357 257],330,5,5469,4.45721271393643,60.0,0.0
21227,2,1227,[318 427 496 357 257],330,5,5474,4.457654723127036,60.0,0.0
21228,2,1228,[318 427 496 357 257],330,5,5479,4.458096013018714,60.0,0.0
21229,2,1229,[318 427 496 357 257],330,5,5484,4.458536585365854,60.0,0.0
21230,2,1230,[318 427 496 357 257],330,5,5489,4.458976441917141,60.0,0.0
21231,2,1231,[318 427 496 357 257],796,5,5494,4.459415584415584,60.0,0.0
21232,2,1232,[655 204   1 300 286],535,2,5496,4.457420924574209,0.0,20.0
21233,2,1233,[318 427 496 357 257],330,5,5501,4.457860615883306,60.0,0.0
21234,2,1234,[294 197   7 195   1],450,5,5506,4.458299595141701,0.0,0.0
21235,2,1235,[318 427 496 357 257],330,5,5511,4.45873786407767,60.0,0.0
21236,2,1236,[318 427 496 357 257],796,5,5516,4.459175424413905,60.0,0.0
21237,2,1237,[318 427 496 357 257],716,5,5521,4.459612277867528,60.0,0.0
21238,2,1238,[318 427 496 357 257],330,5,5526,4.460048426150121,60.0,0.0
21239,2,1239,[318 427 496 357 257],796,5,5531,4.460483870967742,60.0,0.0
21240,2,1240,[318 427 496 357 257],716,5,5536,4.460918614020951,60.0,0.0
21241,2,1241,[318 427 496 357 257],796,5,5541,4.461352657004831,60.0,0.0
21242,2,1242,[427 568 313 100  22],577,4,5545,4.460981496379726,20.0,20.0
21243,2,1243,[318 427 496 357 257],330,5,5550,4.461414790996785,60.0,0.0
21244,2,1244,[318 427 496 357 257],716,5,5555,4.461847389558233,60.0,0.0
21245,2,1245,[318 427 496 357 257],796,5,5560,4.462279293739968,60.0,0.0
21246,2,1246,[132 174  98 204  15],450,4,5564,4.461908580593424,0.0,0.0
21247,2,1247,[318 427 496 357 257],796,5,5569,4.462339743589744,60.0,0.0
21248,2,1248,[318 427 496 357 257],716,5,5574,4.462770216172938,60.0,0.0
21249,2,1249,[172 275  88 655 202],151,5,5579,4.4632,0.0,20.0
21250,2,1250,[318 427 496 357 257],330,5,5584,4.463629096722622,60.0,0.0
21251,2,1251,[318 427 496 357 257],796,5,5589,4.464057507987221,60.0,0.0
21252,2,1252,[318 427 496 357 257],716,5,5594,4.464485235434956,60.0,0.0
21253,2,1253,[ 96 185  79  88 742],256,5,5599,4.464912280701754,0.0,0.0
21254,2,1254,[196 238 237  79  11],535,4,5603,4.4645418326693225,0.0,0.0
21255,2,1255,[318 427 496 357 257],716,5,5608,4.464968152866242,60.0,0.0
21256,2,1256,[318 427 496 357 257],716,5,5613,4.465393794749403,60.0,0.0
21257,2,1257,[318 143 235 427  79],716,4,5617,4.465023847376789,40.0,0.0
21258,2,1258,[318 427 496 357 257],716,5,5622,4.465448768864178,60.0,0.0
21259,2,1259,[318 427 496 357 257],330,5,5627,4.465873015873016,60.0,0.0
21260,2,1260,[318 427 496 357 257],796,5,5632,4.46629659000793,60.0,0.0
21261,2,1261,[318 427 496 357 257],796,5,5637,4.466719492868463,60.0,0.0
21262,2,1262,[318 427 496 357 257],330,5,5642,4.467141726049089,60.0,0.0
21263,2,1263,[318 427 496 357 257],716,5,5647,4.467563291139241,60.0,0.0
21264,2,1264,[318 427 496 357 257],796,5,5652,4.46798418972332,60.0,0.0
21265,2,1265,[318 427 496 357 257],796,5,5657,4.4684044233807265,60.0,0.0
21266,2,1266,[318 427 496 357 257],330,5,5662,4.468823993685872,60.0,0.0
21267,2,1267,[318 427 496 357 257],716,5,5667,4.469242902208202,60.0,0.0
21268,2,1268,[318 427 496 357 257],796,5,5672,4.469661150512215,60.0,0.0
21269,2,1269,[318 427 496 357 257],796,5,5677,4.47007874015748,60.0,0.0
21270,2,1270,[318 427 496 357 257],330,5,5682,4.470495672698663,60.0,0.0
21271,2,1271,[318 427 496 357 257],330,5,5687,4.470911949685535,60.0,0.0
21272,2,1272,[168 588 100 265 118],577,4,5691,4.4705420267085625,0.0,20.0
21273,2,1273,[318 427 496 357 257],716,5,5696,4.470957613814757,60.0,0.0
21274,2,1274,[318 427 496 357 257],330,5,5701,4.471372549019608,60.0,0.0
21275,2,1275,[403  25 204   8 194],457,5,5706,4.471786833855799,0.0,0.0
21276,2,1276,[318 427 496 357 257],716,5,5711,4.472200469851214,60.0,0.0
21277,2,1277,[294  15   1 200 100],655,1,5712,4.469483568075117,0.0,20.0
21278,2,1278,[286 294 202  12   8],655,0,5712,4.465989053948397,0.0,20.0
21279,2,1279,[318 427 496 357 257],330,5,5717,4.46640625,60.0,0.0
21280,2,1280,[185 275 385 515 294],716,4,5721,4.466042154566745,0.0,20.0
21281,2,1281,[318 427 496 357 257],330,5,5726,4.466458658346334,60.0,0.0
21282,2,1282,[483  28 269  96 185],450,4,5730,4.466095089633671,0.0,0.0
21283,2,1283,[210 265 471 183 275],457,5,5735,4.466510903426792,0.0,20.0
21284,2,1284,[173 423 742 216 195],280,3,5738,4.465369649805448,0.0,0.0
21285,2,1285,[318 427 496 357 257],716,5,5743,4.465785381026438,60.0,0.0
21286,2,1286,[117  56  88 168 257],457,4,5747,4.4654234654234655,0.0,0.0
21287,2,1287,[318 427 496 357 257],330,5,5752,4.46583850931677,60.0,0.0
21288,2,1288,[318 427 496 357 257],716,5,5757,4.4662529092319625,60.0,0.0
21289,2,1289,[318 427 496 357 257],796,5,5762,4.466666666666667,60.0,0.0
21290,2,1290,[196  69  97 180 202],796,3,5765,4.465530596436871,0.0,0.0
21291,2,1291,[ 25  64 174  15 118],330,5,5770,4.46594427244582,20.0,0.0
21292,2,1292,[  8 257 185  69  56],796,5,5775,4.466357308584687,0.0,0.0
21293,2,1293,[318 427 496 357 257],796,5,5780,4.466769706336939,60.0,0.0
21294,2,1294,[144  79 186 200  89],5,2,5782,4.464864864864865,0.0,0.0
21295,2,1295,[603   8 195 151 568],330,4,5786,4.464506172839506,20.0,0.0
21296,2,1296,[318 427 496 357 257],796,5,5791,4.464919043947571,60.0,0.0
21297,2,1297,[318 427 496 357 257],796,5,5796,4.465331278890601,60.0,0.0
21298,2,1298,[318 427 496 357 257],716,5,5801,4.465742879137799,60.0,0.0
21299,2,1299,[318 427 496 357 257],796,5,5806,4.466153846153846,60.0,0.0
21300,2,1300,[318 427 496 357 257],716,5,5811,4.466564181398924,60.0,0.0
21301,2,1301,[318 427 496 357 257],716,5,5816,4.466973886328725,60.0,0.0
21302,2,1302,[318 427 496 357 257],330,5,5821,4.467382962394474,60.0,0.0
21303,2,1303,[318 427 496 357 257],796,5,5826,4.467791411042945,60.0,0.0
21304,2,1304,[385  15 121  50 194],450,3,5829,4.466666666666667,0.0,20.0
21305,2,1305,[318 427 496 357 257],796,5,5834,4.467075038284839,60.0,0.0
21306,2,1306,[318 427 496 357 257],330,5,5839,4.467482785003826,60.0,0.0
21307,2,1307,[318 427 496 357 257],796,5,5844,4.467889908256881,60.0,0.0
21308,2,1308,[197 427 318 183   7],693,3,5847,4.466768525592055,40.0,0.0
21309,2,1309,[318 427 496 357 257],716,5,5852,4.467175572519084,60.0,0.0
21310,2,1310,[  7 172  15 211  98],296,4,5856,4.466819221967963,0.0,0.0
21311,2,1311,[318 427 496 357 257],796,5,5861,4.467225609756097,60.0,0.0
21312,2,1312,[318 427 496 357 257],330,5,5866,4.4676313785224675,60.0,0.0
21313,2,1313,[318 427 496 357 257],716,5,5871,4.468036529680365,60.0,0.0
21314,2,1314,[318 427 496 357 257],330,5,5876,4.4684410646387835,60.0,0.0
21315,2,1315,[318 427 496 357 257],330,5,5881,4.468844984802431,60.0,0.0
21316,2,1316,[568 183 216 333 186],655,2,5883,4.466970387243736,0.0,0.0
21317,2,1317,[191 323 748 196 100],796,3,5886,4.4658573596358115,0.0,20.0
21318,2,1318,[318 427 496 357 257],716,5,5891,4.466262319939348,60.0,0.0
21319,2,1319,[318 427 496 357 257],796,5,5896,4.466666666666667,60.0,0.0
21320,2,1320,[ 97  56 172  79 100],236,3,5899,4.46555639666919,0.0,20.0
21321,2,1321,[318 427 496 357 257],330,5,5904,4.465960665658094,60.0,0.0
21322,2,1322,[318 427 496 357 257],796,5,5909,4.466364323507181,60.0,0.0
21323,2,1323,[318 427 496 357 257],330,5,5914,4.466767371601208,60.0,0.0
21324,2,1324,[318 427 496 357 257],330,5,5919,4.467169811320755,60.0,0.0
21325,2,1325,[318 427 496 357 257],330,5,5924,4.467571644042232,60.0,0.0
21326,2,1326,[333 135 187 435  50],655,3,5927,4.46646571213263,0.0,20.0
21327,2,1327,[228 269  50  12 173],344,5,5932,4.466867469879518,0.0,20.0
21328,2,1328,[318 427 496 357 257],330,5,5937,4.467268623024831,60.0,0.0
21329,2,1329,[318 427 496 357 257],796,5,5942,4.467669172932331,60.0,0.0
21330,2,1330,[318 427 496 357 257],330,5,5947,4.468069120961683,60.0,0.0
21331,2,1331,[318 427 496 357 257],330,5,5952,4.468468468468468,60.0,0.0
21332,2,1332,[318 427 496 357 257],330,5,5957,4.468867216804201,60.0,0.0
21333,2,1333,[318 427 496 357 257],796,5,5962,4.469265367316342,60.0,0.0
21334,2,1334,[318 427 496 357 257],330,5,5967,4.4696629213483146,60.0,0.0
21335,2,1335,[318 427 496 357 257],796,5,5972,4.470059880239521,60.0,0.0
21336,2,1336,[183 258 286 181 301],796,3,5975,4.468960359012715,0.0,20.0
21337,2,1337,[318 427 496 357 257],796,5,5980,4.469357249626308,60.0,0.0
21338,2,1338,[318 427 496 357 257],330,5,5985,4.46975354742345,60.0,0.0
21339,2,1339,[318 427 496 357 257],796,5,5990,4.470149253731344,60.0,0.0
21340,2,1340,[318 427 496 357 257],330,5,5995,4.470544369873229,60.0,0.0
21341,2,1341,[318 427 496 357 257],716,5,6000,4.470938897168406,60.0,0.0
21342,2,1342,[318 427 496 357 257],330,5,6005,4.471332836932241,60.0,0.0
21343,2,1343,[318 427 496 357 257],716,5,6010,4.471726190476191,60.0,0.0
21344,2,1344,[318 427 496 357 257],716,5,6015,4.4721189591078065,60.0,0.0
21345,2,1345,[216 196 405 423 427],151,4,6019,4.471768202080238,20.0,0.0
21346,2,1346,[ 11 318 423 286  79],535,3,6022,4.470675575352636,20.0,20.0
21347,2,1347,[318 427 496 357 257],796,5,6027,4.471068249258161,60.0,0.0
21348,2,1348,[121 597  71 302  95],344,2,6029,4.469236471460341,0.0,0.0
21349,2,1349,[318 427 496 357 257],330,5,6034,4.46962962962963,60.0,0.0
21350,2,1350,[237  28 603  70 515],18,2,6036,4.46780162842339,20.0,0.0
21351,2,1351,[ 22 288 748 237 385],280,3,6039,4.466715976331361,0.0,0.0
21352,2,1352,[202 496 172 655  28],450,5,6044,4.467110125646711,20.0,0.0
21353,2,1353,[151 111 175 222   1],151,5,6049,4.467503692762186,0.0,0.0
21354,2,1354,[318 427 496 357 257],716,5,6054,4.46789667896679,60.0,0.0
21355,2,1355,[318 427 496 357 257],716,5,6059,4.468289085545723,60.0,0.0
21356,2,1356,[318 427 496 357 257],330,5,6064,4.468680913780398,60.0,0.0
21357,2,1357,[257 483 132 333 211],655,1,6065,4.4661266568483065,0.0,0.0
21358,2,1358,[603 161 286   1 174],389,3,6068,4.46504782928624,20.0,20.0
21359,2,1359,[318 427 496 357 257],716,5,6073,4.465441176470589,60.0,0.0
21360,2,1360,[318 427 496 357 257],330,5,6078,4.465833945628215,60.0,0.0
21361,2,1361,[318 427 496 357 257],330,5,6083,4.466226138032305,60.0,0.0
21362,2,1362,[318 427 496 357 257],716,5,6088,4.466617754952311,60.0,0.0
21363,2,1363,[318 427 496 357 257],716,5,6093,4.467008797653959,60.0,0.0
21364,2,1364,[318 427 496 357 257],796,5,6098,4.4673992673992675,60.0,0.0
21365,2,1365,[318 427 496 357 257],796,5,6103,4.467789165446559,60.0,0.0
21366,2,1366,[318 427 496 357 257],796,5,6108,4.468178493050475,60.0,0.0
21367,2,1367,[318 427 496 357 257],330,5,6113,4.468567251461988,60.0,0.0
21368,2,1368,[318 427 496 357 257],330,5,6118,4.468955441928415,60.0,0.0
21369,2,1369,[318 427 496 357 257],330,5,6123,4.4693430656934305,60.0,0.0
21370,2,1370,[318 427 496 357 257],796,5,6128,4.469730123997082,60.0,0.0
21371,2,1371,[318 427 496 357 257],716,5,6133,4.470116618075802,60.0,0.0
21372,2,1372,[318 427 496 357 257],716,5,6138,4.470502549162418,60.0,0.0
21373,2,1373,[191 294 127 385 117],655,2,6140,4.468704512372635,0.0,20.0
21374,2,1374,[318 427 496 357 257],796,5,6145,4.469090909090909,60.0,0.0
21375,2,1375,[318 427 496 357 257],796,5,6150,4.469476744186046,60.0,0.0
21376,2,1376,[318 427 496 357 257],796,5,6155,4.469862018881627,60.0,0.0
21377,2,1377,[318 427 496 357 257],716,5,6160,4.470246734397678,60.0,0.0
21378,2,1378,[ 98 427 196 191 603],23,3,6163,4.4691805656272665,40.0,0.0
21379,2,1379,[318 427 496 357 257],330,5,6168,4.469565217391304,60.0,0.0
21380,2,1380,[318 427 496 357 257],716,5,6173,4.4699493120926865,60.0,0.0
21381,2,1381,[132 143   4 175 181],457,5,6178,4.4703328509406655,0.0,0.0
21382,2,1382,[318 427 496 357 257],330,5,6183,4.4707158351409975,60.0,0.0
21383,2,1383,[ 97 655 191 175 132],716,4,6187,4.470375722543353,0.0,0.0
21384,2,1384,[318 427 496 357 257],716,5,6192,4.470758122743682,60.0,0.0
21385,2,1385,[318 427 496 357 257],716,5,6197,4.471139971139971,60.0,0.0
21386,2,1386,[405 245 655  88 216],280,1,6198,4.4686373467916365,0.0,0.0
21387,2,1387,[228 385 273 204 182],655,2,6200,4.46685878962536,0.0,0.0
21388,2,1388,[318 427 496 357 257],716,5,6205,4.467242620590353,60.0,0.0
21389,2,1389,[597 161  71 176 302],450,4,6209,4.466906474820144,0.0,0.0
21390,2,1390,[318 427 496 357 257],796,5,6214,4.4672897196261685,60.0,0.0
21391,2,1391,[318 427 496 357 257],796,5,6219,4.467672413793103,60.0,0.0
21392,2,1392,[318 427 496 357 257],796,5,6224,4.46805455850682,60.0,0.0
21393,2,1393,[318 427 496 357 257],716,5,6229,4.468436154949785,60.0,0.0
21394,2,1394,[318 427 496 357 257],796,5,6234,4.468817204301075,60.0,0.0
21395,2,1395,[318 427 496 357 257],716,5,6239,4.46919770773639,60.0,0.0
21396,2,1396,[318 427 496 357 257],330,5,6244,4.46957766642806,60.0,0.0
21397,2,1397,[161 282 179 172 234],457,5,6249,4.469957081545064,0.0,0.0
21398,2,1398,[318 427 496 357 257],330,5,6254,4.470335954253038,60.0,0.0
21399,2,1399,[318 427 496 357 257],796,5,6259,4.470714285714286,60.0,0.0
21400,2,1400,[318 427 496 357 257],796,5,6264,4.471092077087794,60.0,0.0
21401,2,1401,[  9 151  70   7  69],457,5,6269,4.471469329529244,0.0,0.0
21402,2,1402,[318 427 496 357 257],796,5,6274,4.471846044191019,60.0,0.0
21403,2,1403,[318 427 496 357 257],330,5,6279,4.472222222222222,60.0,0.0
21404,2,1404,[318 427 496 357 257],796,5,6284,4.472597864768684,60.0,0.0
21405,2,1405,[195 483 121  82 127],716,4,6288,4.472261735419631,0.0,20.0
21406,2,1406,[318 427 496 357 257],330,5,6293,4.472636815920398,60.0,0.0
21407,2,1407,[318 427 496 357 257],716,5,6298,4.473011363636363,60.0,0.0
21408,2,1408,[318 427 496 357 257],716,5,6303,4.4733853797019165,60.0,0.0
21409,2,1409,[282 318 269 202 475],655,1,6304,4.470921985815603,20.0,0.0
21410,2,1410,[186 588  28 216 118],796,3,6307,4.469879518072289,0.0,0.0
21411,2,1411,[318 427 496 357 257],796,5,6312,4.470254957507082,60.0,0.0
21412,2,1412,[318 427 496 357 257],330,5,6317,4.470629865534324,60.0,0.0
21413,2,1413,[318 427 496 357 257],330,5,6322,4.471004243281471,60.0,0.0
21414,2,1414,[318 427 496 357 257],716,5,6327,4.471378091872792,60.0,0.0
21415,2,1415,[318 427 496 357 257],330,5,6332,4.471751412429379,60.0,0.0
21416,2,1416,[228 195 161  96   4],796,5,6337,4.47212420606916,0.0,0.0
21417,2,1417,[318 427 496 357 257],330,5,6342,4.4724964739069115,60.0,0.0
21418,2,1418,[318 427 496 357 257],716,5,6347,4.4728682170542635,60.0,0.0
21419,2,1419,[318 427 496 357 257],796,5,6352,4.473239436619719,60.0,0.0
21420,2,1420,[318 427 496 357 257],330,5,6357,4.473610133708656,60.0,0.0
21421,2,1421,[318 427 496 357 257],716,5,6362,4.4739803094233475,60.0,0.0
21422,2,1422,[318 427 496 357 257],796,5,6367,4.474349964862966,60.0,0.0
21423,2,1423,[423 172 238 197 100],655,1,6368,4.47191011235955,0.0,20.0
21424,2,1424,[318 427 496 357 257],796,5,6373,4.472280701754386,60.0,0.0
21425,2,1425,[318 427 496 357 257],716,5,6378,4.4726507713884995,60.0,0.0
21426,2,1426,[318 427 496 357 257],716,5,6383,4.47302032235459,60.0,0.0
21427,2,1427,[265 286 181 204  64],655,1,6384,4.470588235294118,20.0,20.0
21428,2,1428,[318 427 496 357 257],796,5,6389,4.470958712386284,60.0,0.0
21429,2,1429,[318 427 496 357 257],796,5,6394,4.4713286713286715,60.0,0.0
21430,2,1430,[318 427 496 357 257],716,5,6399,4.471698113207547,60.0,0.0
21431,2,1431,[318 427 496 357 257],716,5,6404,4.472067039106145,60.0,0.0
21432,2,1432,[318 427 496 357 257],716,5,6409,4.472435450104675,60.0,0.0
21433,2,1433,[322  96 151 427 318],450,5,6414,4.472803347280335,40.0,0.0
21434,2,1434,[318 427 496 357 257],716,5,6419,4.4731707317073175,60.0,0.0
21435,2,1435,[318 427 496 357 257],796,5,6424,4.4735376044568245,60.0,0.0
21436,2,1436,[ 12 228 423 238  25],450,4,6428,4.473208072373,0.0,0.0
21437,2,1437,[318 427 496 357 257],330,5,6433,4.473574408901252,60.0,0.0
21438,2,1438,[546 237 173  50  98],716,4,6437,4.47324530924253,0.0,20.0
21439,2,1439,[318 427 496 357 257],796,5,6442,4.473611111111111,60.0,0.0
21440,2,1440,[187 258  96 435  69],450,5,6447,4.473976405274115,0.0,0.0
21441,2,1441,[318 427 496 357 257],716,5,6452,4.4743411927877945,60.0,0.0
21442,2,1442,[318 427 496 357 257],330,5,6457,4.474705474705475,60.0,0.0
21443,2,1443,[172  56 742  71 143],450,4,6461,4.474376731301939,0.0,0.0
21444,2,1444,[289 100 655 471 423],786,5,6466,4.4747404844290655,0.0,20.0
21445,2,1445,[300 427 216 161  79],655,3,6469,4.4737206085753805,20.0,0.0
21446,2,1446,[318 427 496 357 257],796,5,6474,4.4740843123704215,60.0,0.0
21447,2,1447,[318 427 496 357 257],796,5,6479,4.474447513812155,60.0,0.0
21448,2,1448,[318 427 496 357 257],716,5,6484,4.474810213940649,60.0,0.0
21449,2,1449,[318 427 496 357 257],716,5,6489,4.4751724137931035,60.0,0.0
21450,2,1450,[318 427 496 357 257],716,5,6494,4.475534114403859,60.0,0.0
21451,2,1451,[318 427 496 357 257],330,5,6499,4.475895316804408,60.0,0.0
21452,2,1452,[318 427 496 357 257],796,5,6504,4.4762560220234,60.0,0.0
21453,2,1453,[318 427 496 357 257],330,5,6509,4.476616231086657,60.0,0.0
21454,2,1454,[318 427 496 357 257],796,5,6514,4.476975945017182,60.0,0.0
21455,2,1455,[318 427 496 357 257],796,5,6519,4.477335164835165,60.0,0.0
21456,2,1456,[318 427 496 357 257],330,5,6524,4.477693891557996,60.0,0.0
21457,2,1457,[289 273 546 222  71],236,3,6527,4.476680384087792,0.0,0.0
21458,2,1458,[318 427 496 357 257],330,5,6532,4.477039067854695,60.0,0.0
21459,2,1459,[318 427 496 357 257],330,5,6537,4.477397260273973,60.0,0.0
21460,2,1460,[318 427 496 357 257],330,5,6542,4.477754962354552,60.0,0.0
21461,2,1461,[ 97 151 211 204 546],236,2,6544,4.476060191518468,0.0,0.0
21462,2,1462,[483 289 200 175 121],655,2,6546,4.4743677375256325,0.0,0.0
21463,2,1463,[318 427 496 357 257],330,5,6551,4.4747267759562845,60.0,0.0
21464,2,1464,[318 427 496 357 257],716,5,6556,4.475085324232082,60.0,0.0
21465,2,1465,[318 427 496 357 257],796,5,6561,4.475443383356071,60.0,0.0
21466,2,1466,[  4 153 597 275 204],450,4,6565,4.475119291070211,0.0,20.0
21467,2,1467,[318 427 496 357 257],716,5,6570,4.475476839237057,60.0,0.0
21468,2,1468,[318 427 496 357 257],796,5,6575,4.4758339006126615,60.0,0.0
21469,2,1469,[318 427 496 357 257],716,5,6580,4.476190476190476,60.0,0.0
21470,2,1470,[318 427 496 357 257],330,5,6585,4.476546566961251,60.0,0.0
21471,2,1471,[318 427 496 357 257],330,5,6590,4.476902173913044,60.0,0.0
21472,2,1472,[318 427 496 357 257],330,5,6595,4.477257298031229,60.0,0.0
21473,2,1473,[318 427 496 357 257],796,5,6600,4.477611940298507,60.0,0.0
21474,2,1474,[318 427 496 357 257],796,5,6605,4.477966101694915,60.0,0.0
21475,2,1475,[204 286 748 655 174],401,2,6607,4.476287262872629,0.0,20.0
21476,2,1476,[318 427 496 357 257],796,5,6612,4.476641841570752,60.0,0.0
21477,2,1477,[318 427 496 357 257],796,5,6617,4.476995940460081,60.0,0.0
21478,2,1478,[318 427 496 357 257],716,5,6622,4.4773495605138605,60.0,0.0
21479,2,1479,[318 427 496 357 257],796,5,6627,4.477702702702703,60.0,0.0
21480,2,1480,[318 427 496 357 257],796,5,6632,4.478055367994598,60.0,0.0
21481,2,1481,[423  25 301 186 151],535,5,6637,4.478407557354926,0.0,0.0
21482,2,1482,[318 427 496 357 257],330,5,6642,4.47875927174646,60.0,0.0
21483,2,1483,[318 427 496 357 257],796,5,6647,4.47911051212938,60.0,0.0
21484,2,1484,[318 427 496 357 257],796,5,6652,4.47946127946128,60.0,0.0
21485,2,1485,[742 100 568 603 118],655,1,6653,4.4771197846567965,20.0,20.0
21486,2,1486,[125  64  56 471  97],457,5,6658,4.477471418964358,20.0,0.0
21487,2,1487,[318 427 496 357 257],796,5,6663,4.477822580645161,60.0,0.0
21488,2,1488,[318 427 496 357 257],330,5,6668,4.478173270651444,60.0,0.0
21489,2,1489,[318 427 496 357 257],716,5,6673,4.478523489932886,60.0,0.0
21490,2,1490,[318 427 496 357 257],796,5,6678,4.47887323943662,60.0,0.0
21491,2,1491,[127 153 423 143 318],716,5,6683,4.479222520107238,20.0,20.0
21492,2,1492,[318 427 496 357 257],330,5,6688,4.479571332886805,60.0,0.0
21493,2,1493,[483 172  88 200 405],151,3,6691,4.478580990629183,0.0,0.0
21494,2,1494,[496 181 183 427 257],796,5,6696,4.478929765886288,40.0,0.0
21495,2,1495,[318 427 496 357 257],716,5,6701,4.47927807486631,60.0,0.0
21496,2,1496,[318 427 496 357 257],716,5,6706,4.479625918503674,60.0,0.0
21497,2,1497,[318 427 496 357 257],330,5,6711,4.479973297730307,60.0,0.0
21498,2,1498,[318 427 496 357 257],330,5,6716,4.48032021347565,60.0,0.0
21499,2,1499,[ 56  22   9 215 322],280,4,6720,4.48,0.0,0.0
21500,2,1500,[318 427 496 357 257],330,5,6725,4.480346435709527,60.0,0.0
21501,2,1501,[318 427 496 357 257],716,5,6730,4.480692410119841,60.0,0.0
21502,2,1502,[ 98 111  50 153  15],236,3,6733,4.479707252162342,0.0,20.0
21503,2,1503,[216 234 168  56  82],577,3,6736,4.4787234042553195,0.0,0.0
21504,2,1504,[318 427 496 357 257],716,5,6741,4.47906976744186,60.0,0.0
21505,2,1505,[318 427 496 357 257],796,5,6746,4.47941567065073,60.0,0.0
21506,2,1506,[318 427 496 357 257],716,5,6751,4.479761114797611,60.0,0.0
21507,2,1507,[111  82  28 179   7],457,4,6755,4.479442970822281,0.0,0.0
21508,2,1508,[318 427 496 357 257],796,5,6760,4.479787939032472,60.0,0.0
21509,2,1509,[197 210  70 211 175],151,5,6765,4.4801324503311255,0.0,0.0
21510,2,1510,[196 435 210 215 237],535,5,6770,4.480476505625414,0.0,0.0
21511,2,1511,[318 301 265 357 322],151,4,6774,4.48015873015873,20.0,0.0
21512,2,1512,[318 427 496 357 257],796,5,6779,4.480502313284864,60.0,0.0
21513,2,1513,[318 427 496 357 257],330,5,6784,4.480845442536328,60.0,0.0
21514,2,1514,[318 427 496 357 257],796,5,6789,4.481188118811882,60.0,0.0
21515,2,1515,[318 427 496 357 257],716,5,6794,4.481530343007916,60.0,0.0
21516,2,1516,[318 427 496 357 257],796,5,6799,4.481872116018457,60.0,0.0
21517,2,1517,[ 22   9 187 185 181],655,2,6801,4.480237154150197,0.0,0.0
21518,2,1518,[ 11 187 179 258 181],450,5,6806,4.480579328505596,0.0,0.0
21519,2,1519,[318 427 496 357 257],716,5,6811,4.480921052631579,60.0,0.0
21520,2,1520,[318 427 496 357 257],796,5,6816,4.481262327416173,60.0,0.0
21521,2,1521,[318 427 496 357 257],716,5,6821,4.4816031537450725,60.0,0.0
21522,2,1522,[318 427 496 357 257],796,5,6826,4.481943532501641,60.0,0.0
21523,2,1523,[111 172  50   4 132],629,4,6830,4.481627296587926,0.0,20.0
21524,2,1524,[318 427 496 357 257],716,5,6835,4.481967213114754,60.0,0.0
21525,2,1525,[318 427 496 357 257],330,5,6840,4.482306684141546,60.0,0.0
21526,2,1526,[318 427 496 357 257],796,5,6845,4.482645710543549,60.0,0.0
21527,2,1527,[318 427 496 357 257],796,5,6850,4.482984293193717,60.0,0.0
21528,2,1528,[ 50 322 238  71 174],504,3,6853,4.482014388489208,0.0,20.0
21529,2,1529,[318 427 496 357 257],716,5,6858,4.482352941176471,60.0,0.0
21530,2,1530,[172 313 179  96 202],655,3,6861,4.481384715871979,0.0,0.0
21531,2,1531,[318 427 496 357 257],330,5,6866,4.481723237597911,60.0,0.0
21532,2,1532,[423  97 483 286 257],655,1,6867,4.47945205479452,0.0,20.0
21533,2,1533,[211 187 118 168 678],504,3,6870,4.4784876140808345,0.0,0.0
21534,2,1534,[273 483  25 204 385],655,2,6872,4.476872964169381,0.0,0.0
21535,2,1535,[318 427 496 357 257],796,5,6877,4.477213541666667,60.0,0.0
21536,2,1536,[318 427 496 357 257],796,5,6882,4.477553675992192,60.0,0.0
21537,2,1537,[234  69 271 515 195],807,2,6884,4.47594278283485,0.0,0.0
21538,2,1538,[318 427 496 357 257],330,5,6889,4.476283300844704,60.0,0.0
21539,2,1539,[318 427 496 357 257],330,5,6894,4.476623376623377,60.0,0.0
21540,2,1540,[318 427 496 357 257],330,5,6899,4.476963011031797,60.0,0.0
21541,2,1541,[318 427 496 357 257],796,5,6904,4.477302204928664,60.0,0.0
21542,2,1542,[318 427 496 357 257],796,5,6909,4.477640959170447,60.0,0.0
21543,2,1543,[318 427 496 357 257],330,5,6914,4.477979274611399,60.0,0.0
21544,2,1544,[318 427 496 357 257],330,5,6919,4.47831715210356,60.0,0.0
21545,2,1545,[318 427 496 357 257],796,5,6924,4.478654592496766,60.0,0.0
21546,2,1546,[318 427 496 357 257],330,5,6929,4.4789915966386555,60.0,0.0
21547,2,1547,[318 427 496 357 257],716,5,6934,4.479328165374677,60.0,0.0
21548,2,1548,[ 70  96 172 405 235],450,4,6938,4.479018721755971,0.0,0.0
21549,2,1549,[318 427 496 357 257],796,5,6943,4.4793548387096775,60.0,0.0
21550,2,1550,[357 245 172   9 111],593,3,6946,4.478401031592521,0.0,0.0
21551,2,1551,[195 174 322  69  12],629,4,6950,4.478092783505154,0.0,0.0
21552,2,1552,[276 121 210 271 181],655,1,6951,4.475853187379266,0.0,0.0
21553,2,1553,[403 202   4  64 245],256,4,6955,4.475546975546975,20.0,0.0
21554,2,1554,[286 187 318 496 257],796,4,6959,4.47524115755627,40.0,20.0
21555,2,1555,[282 568 237 100 742],450,5,6964,4.4755784061696655,0.0,20.0
21556,2,1556,[175 204 597 318   1],457,4,6968,4.475272960822093,20.0,0.0
21557,2,1557,[318 427 496 357 257],716,5,6973,4.475609756097561,60.0,0.0
21558,2,1558,[318 427 496 357 257],796,5,6978,4.475946119307248,60.0,0.0
21559,2,1559,[318 427 496 357 257],330,5,6983,4.476282051282051,60.0,0.0
21560,2,1560,[318 427 496 357 257],716,5,6988,4.476617552850737,60.0,0.0
21561,2,1561,[318 427 496 357 257],796,5,6993,4.4769526248399485,60.0,0.0
21562,2,1562,[318 427 496 357 257],330,5,6998,4.477287268074217,60.0,0.0
21563,2,1563,[302 423 132 216 100],450,5,7003,4.477621483375959,0.0,20.0
21564,2,1564,[568 286  25 294 197],450,4,7007,4.477316293929713,0.0,20.0
21565,2,1565,[196 168 179 328 144],450,5,7012,4.47765006385696,0.0,0.0
21566,2,1566,[318 427 496 357 257],716,5,7017,4.477983407785578,60.0,0.0
21567,2,1567,[318 427 496 357 257],796,5,7022,4.478316326530612,60.0,0.0
21568,2,1568,[318 427 496 357 257],716,5,7027,4.478648820905035,60.0,0.0
21569,2,1569,[179 483   1 185 111],389,4,7031,4.478343949044586,0.0,0.0
21570,2,1570,[318 427 496 357 257],716,5,7036,4.478676002546149,60.0,0.0
21571,2,1571,[ 15 200  70 187 211],269,3,7039,4.477735368956743,0.0,0.0
21572,2,1572,[318 427 496 357 257],330,5,7044,4.478067387158296,60.0,0.0
21573,2,1573,[215 182 238 237  50],450,5,7049,4.478398983481576,0.0,20.0
21574,2,1574,[ 22  70 111 168 183],269,1,7050,4.476190476190476,0.0,0.0
21575,2,1575,[127  28 294 603 322],450,5,7055,4.476522842639594,20.0,20.0
21576,2,1576,[127 200 405 185 211],716,5,7060,4.476854787571338,0.0,20.0
21577,2,1577,[215 423 127 603 181],655,2,7062,4.475285171102661,20.0,20.0
21578,2,1578,[318 427 496 357 257],716,5,7067,4.475617479417353,60.0,0.0
21579,2,1579,[318 427 496 357 257],796,5,7072,4.4759493670886075,60.0,0.0
21580,2,1580,[318 427 496 357 257],716,5,7077,4.476280834914611,60.0,0.0
21581,2,1581,[ 96  28 215 183  64],796,4,7081,4.475979772439949,20.0,0.0
21582,2,1582,[318 427 496 357 257],330,5,7086,4.476310802274163,60.0,0.0
21583,2,1583,[655  97 294 161 237],577,5,7091,4.476641414141414,0.0,0.0
21584,2,1584,[318 427 496 357 257],796,5,7096,4.476971608832808,60.0,0.0
21585,2,1585,[318 427 496 357 257],796,5,7101,4.4773013871374525,60.0,0.0
21586,2,1586,[318 427 496 357 257],716,5,7106,4.47763074984247,60.0,0.0
21587,2,1587,[318 427 496 357 257],330,5,7111,4.477959697732998,60.0,0.0
21588,2,1588,[318 427 496 357 257],796,5,7116,4.478288231592196,60.0,0.0
21589,2,1589,[318 427 496 357 257],330,5,7121,4.478616352201258,60.0,0.0
21590,2,1590,[173 187 204 127 322],796,4,7125,4.478315524827153,0.0,20.0
21591,2,1591,[318 427 496 357 257],796,5,7130,4.478643216080402,60.0,0.0
21592,2,1592,[318 427 496 357 257],716,5,7135,4.478970495919649,60.0,0.0
21593,2,1593,[318 427 496 357 257],796,5,7140,4.479297365119197,60.0,0.0
21594,2,1594,[318 427 496 357 257],330,5,7145,4.47962382445141,60.0,0.0
21595,2,1595,[318 427 496 357 257],796,5,7150,4.479949874686716,60.0,0.0
21596,2,1596,[318 427 496 357 257],716,5,7155,4.480275516593613,60.0,0.0
21597,2,1597,[318 427 496 357 257],716,5,7160,4.480600750938673,60.0,0.0
21598,2,1598,[100 195 318 174 186],269,2,7162,4.4790494058786745,20.0,20.0
21599,2,1599,[318 427 496 357 257],330,5,7167,4.479375,60.0,0.0
21600,2,1600,[318 427 496 357 257],330,5,7172,4.4797001873828854,60.0,0.0
21601,2,1601,[151 357 237  56 204],535,3,7175,4.478776529338327,0.0,0.0
21602,2,1602,[318 427 496 357 257],716,5,7180,4.479101684341859,60.0,0.0
21603,2,1603,[318 427 496 357 257],716,5,7185,4.479426433915212,60.0,0.0
21604,2,1604,[318 427 496 357 257],330,5,7190,4.479750778816199,60.0,0.0
21605,2,1605,[318 427 496 357 257],716,5,7195,4.480074719800747,60.0,0.0
21606,2,1606,[318 427 496 357 257],796,5,7200,4.4803982576229,60.0,0.0
21607,2,1607,[318 427 496 357 257],330,5,7205,4.480721393034826,60.0,0.0
21608,2,1608,[ 95 328 172 483 121],796,5,7210,4.481044126786824,0.0,0.0
21609,2,1609,[318 427 496 357 257],716,5,7215,4.4813664596273295,60.0,0.0
21610,2,1610,[588  50 216 210 181],18,4,7219,4.48106765983861,0.0,20.0
21611,2,1611,[318 427 496 357 257],330,5,7224,4.481389578163772,60.0,0.0
21612,2,1612,[318 427 496 357 257],716,5,7229,4.48171109733416,60.0,0.0
21613,2,1613,[288 237 258  22 238],457,5,7234,4.482032218091698,0.0,0.0
21614,2,1614,[132  28 483 423 176],292,5,7239,4.482352941176471,0.0,0.0
21615,2,1615,[318 427 496 357 257],796,5,7244,4.482673267326732,60.0,0.0
21616,2,1616,[318 427 496 357 257],796,5,7249,4.482993197278912,60.0,0.0
21617,2,1617,[ 79 179 191 211  98],450,5,7254,4.483312731767614,0.0,0.0
21618,2,1618,[183 202  89 245 176],344,4,7258,4.483014206300186,0.0,0.0
21619,2,1619,[318 427 496 357 257],796,5,7263,4.483333333333333,60.0,0.0
21620,2,1620,[318 427 496 357 257],796,5,7268,4.48365206662554,60.0,0.0
21621,2,1621,[318 427 496 357 257],330,5,7273,4.483970406905056,60.0,0.0
21622,2,1622,[318 427 496 357 257],330,5,7278,4.484288354898337,60.0,0.0
21623,2,1623,[318 427 496 357 257],716,5,7283,4.484605911330049,60.0,0.0
21624,2,1624,[748 176 508 180 597],11,1,7284,4.482461538461538,0.0,0.0
21625,2,1625,[ 69 282 245 180 202],450,5,7289,4.482779827798278,0.0,0.0
21626,2,1626,[496 117  89 204   9],796,4,7293,4.482483097725876,20.0,0.0
21627,2,1627,[234  22 135 191 181],655,2,7295,4.4809582309582305,0.0,0.0
21628,2,1628,[328 300 323 302 748],362,2,7297,4.479435236341314,0.0,0.0
21629,2,1629,[215 172 194 121 175],716,4,7301,4.479141104294478,0.0,0.0
21630,2,1630,[318 427 496 357 257],796,5,7306,4.479460453709381,60.0,0.0
21631,2,1631,[318 427 496 357 257],330,5,7311,4.479779411764706,60.0,0.0
21632,2,1632,[204  56 187  97 405],72,4,7315,4.479485609308022,0.0,0.0
21633,2,1633,[318 427 496 357 257],716,5,7320,4.479804161566707,60.0,0.0
21634,2,1634,[318 427 496 357 257],796,5,7325,4.480122324159021,60.0,0.0
21635,2,1635,[194 588 603 496 132],450,5,7330,4.480440097799511,40.0,0.0
21636,2,1636,[ 22 144 427 318 174],807,5,7335,4.4807574832009776,40.0,0.0
21637,2,1637,[318 427 496 357 257],796,5,7340,4.481074481074481,60.0,0.0
21638,2,1638,[318 427 496 357 257],796,5,7345,4.481391092129347,60.0,0.0
21639,2,1639,[318 427 496 357 257],796,5,7350,4.4817073170731705,60.0,0.0
21640,2,1640,[318 427 496 357 257],796,5,7355,4.482023156611822,60.0,0.0
21641,2,1641,[202 742 546 100 111],457,3,7358,4.481120584652863,0.0,20.0
21642,2,1642,[ 25 118 237 302 603],655,2,7360,4.4796104686549,20.0,0.0
21643,2,1643,[318 427 496 357 257],330,5,7365,4.4799270072992705,60.0,0.0
21644,2,1644,[427 197  79   1 186],450,4,7369,4.4796352583586625,20.0,0.0
21645,2,1645,[318 427 496 357 257],796,5,7374,4.479951397326853,60.0,0.0
21646,2,1646,[318 427 496 357 257],716,5,7379,4.4802671523983,60.0,0.0
21647,2,1647,[318 427 496 357 257],716,5,7384,4.480582524271845,60.0,0.0
21648,2,1648,[318 427 496 357 257],330,5,7389,4.480897513644633,60.0,0.0
21649,2,1649,[318 427 496 357 257],330,5,7394,4.481212121212121,60.0,0.0
21650,2,1650,[471 265  15 111 161],786,4,7398,4.480920654149001,0.0,0.0
21651,2,1651,[568 508 176   8  89],269,1,7399,4.478813559322034,0.0,0.0
21652,2,1652,[ 50 322 210 135 191],151,3,7402,4.477918935269208,0.0,20.0
21653,2,1653,[318 427 496 357 257],716,5,7407,4.478234582829504,60.0,0.0
21654,2,1654,[318 427 496 357 257],796,5,7412,4.478549848942598,60.0,0.0
21655,2,1655,[318 427 496 357 257],330,5,7417,4.478864734299517,60.0,0.0
21656,2,1656,[100 597   1 151 174],23,3,7420,4.477972238986119,0.0,20.0
21657,2,1657,[ 22 176 161  56 385],716,2,7422,4.476477683956574,0.0,0.0
21658,2,1658,[318 427 496 357 257],330,5,7427,4.476793248945148,60.0,0.0
21659,2,1659,[ 98 132 180 117   7],450,5,7432,4.47710843373494,0.0,0.0
21660,2,1660,[318 427 496 357 257],796,5,7437,4.477423239012643,60.0,0.0
21661,2,1661,[318 427 496 357 257],796,5,7442,4.477737665463297,60.0,0.0
21662,2,1662,[318 427 496 357 257],796,5,7447,4.478051713770294,60.0,0.0
21663,2,1663,[318 427 496 357 257],796,5,7452,4.478365384615385,60.0,0.0
21664,2,1664,[318 427 496 357 257],716,5,7457,4.478678678678679,60.0,0.0
21665,2,1665,[318 427 496 357 257],796,5,7462,4.4789915966386555,60.0,0.0
21666,2,1666,[ 22 427  88   4   8],796,5,7467,4.479304139172165,20.0,0.0
21667,2,1667,[318 427 496 357 257],796,5,7472,4.479616306954436,60.0,0.0
21668,2,1668,[318 427 496 357 257],796,5,7477,4.479928100659078,60.0,0.0
21669,2,1669,[ 69 742 182 546  71],796,4,7481,4.479640718562874,0.0,0.0
21670,2,1670,[318 427 496 357 257],716,5,7486,4.479952124476362,60.0,0.0
21671,2,1671,[  9  50 100 204 197],878,3,7489,4.479066985645933,0.0,40.0
21672,2,1672,[318 427 496 357 257],796,5,7494,4.47937836222355,60.0,0.0
21673,2,1673,[318 427 496 357 257],796,5,7499,4.479689366786141,60.0,0.0
21674,2,1674,[318 427 496 357 257],796,5,7504,4.48,60.0,0.0
21675,2,1675,[318 427 496 357 257],330,5,7509,4.480310262529833,60.0,0.0
21676,2,1676,[127 269 161 655  25],655,1,7510,4.4782349433512225,0.0,20.0
21677,2,1677,[ 96 678  56   1 216],256,4,7514,4.477949940405244,0.0,0.0
21678,2,1678,[288  82 195  79 234],280,2,7516,4.476474091721263,0.0,0.0
21679,2,1679,[318 427 496 357 257],330,5,7521,4.476785714285715,60.0,0.0
21680,2,1680,[318 427 496 357 257],330,5,7526,4.4770969660916125,60.0,0.0
21681,2,1681,[257 655 286   1 195],796,2,7528,4.475624256837099,0.0,20.0
21682,2,1682,[182  97  71 275 269],796,3,7531,4.474747474747475,0.0,20.0
21683,2,1683,[318 427 496 357 257],330,5,7536,4.475059382422803,60.0,0.0
21684,2,1684,[196 276 216 655 427],269,3,7539,4.474183976261128,20.0,0.0
21685,2,1685,[318 427 496 357 257],796,5,7544,4.474495848161329,60.0,0.0
21686,2,1686,[318 427 496 357 257],796,5,7549,4.474807350326023,60.0,0.0
21687,2,1687,[ 56   4 121 161  79],577,4,7553,4.474526066350711,0.0,0.0
21688,2,1688,[318 427 496 357 257],796,5,7558,4.474837181764357,60.0,0.0
21689,2,1689,[187 191  70 175 215],716,3,7561,4.47396449704142,0.0,0.0
21690,2,1690,[318 427 496 357 257],796,5,7566,4.4742755765819044,60.0,0.0
21691,2,1691,[318 427 496 357 257],796,5,7571,4.474586288416075,60.0,0.0
21692,2,1692,[318 427 496 357 257],796,5,7576,4.474896633195511,60.0,0.0
21693,2,1693,[357 318 182 427 100],450,5,7581,4.475206611570248,40.0,20.0
21694,2,1694,[318 427 496 357 257],796,5,7586,4.475516224188791,60.0,0.0
21695,2,1695,[318 427 496 357 257],330,5,7591,4.475825471698113,60.0,0.0
21696,2,1696,[196   8 257  71  88],796,5,7596,4.476134354743666,0.0,0.0
21697,2,1697,[286 302 435 496  69],450,5,7601,4.476442873969376,20.0,20.0
21698,2,1698,[318 427 496 357 257],716,5,7606,4.476751030017658,60.0,0.0
21699,2,1699,[318 427 496 357 257],796,5,7611,4.477058823529412,60.0,0.0
21700,2,1700,[318 427 496 357 257],330,5,7616,4.477366255144033,60.0,0.0
21701,2,1701,[318 427 496 357 257],716,5,7621,4.4776733254994125,60.0,0.0
21702,2,1702,[318 427 496 357 257],796,5,7626,4.477980035231943,60.0,0.0
21703,2,1703,[318 427 496 357 257],716,5,7631,4.478286384976526,60.0,0.0
21704,2,1704,[742   7 475 294 273],655,1,7632,4.476246334310851,0.0,0.0
21705,2,1705,[318 427 496 357 257],716,5,7637,4.476553341148886,60.0,0.0
21706,2,1706,[318 427 496 357 257],796,5,7642,4.476859988283539,60.0,0.0
21707,2,1707,[318 427 496 357 257],330,5,7647,4.477166276346604,60.0,0.0
21708,2,1708,[301   7 238 153 245],450,5,7652,4.477472205968403,0.0,0.0
21709,2,1709,[318 427 496 357 257],716,5,7657,4.477777777777778,60.0,0.0
21710,2,1710,[318 427 496 357 257],330,5,7662,4.478082992402104,60.0,0.0
21711,2,1711,[318 427 496 357 257],796,5,7667,4.47838785046729,60.0,0.0
21712,2,1712,[318 427 496 357 257],796,5,7672,4.478692352597782,60.0,0.0
21713,2,1713,[318 427 496 357 257],716,5,7677,4.47899649941657,60.0,0.0
21714,2,1714,[318 427 496 357 257],330,5,7682,4.479300291545189,60.0,0.0
21715,2,1715,[318 427 496 357 257],330,5,7687,4.479603729603729,60.0,0.0
21716,2,1716,[275  64 238   7 258],535,5,7692,4.479906814210833,20.0,20.0
21717,2,1717,[318 427 496 357 257],330,5,7697,4.480209545983702,60.0,0.0
21718,2,1718,[318 427 496 357 257],716,5,7702,4.480511925538104,60.0,0.0
21719,2,1719,[568 204  56 186 300],885,4,7706,4.480232558139535,0.0,0.0
21720,2,1720,[318 427 496 357 257],796,5,7711,4.4805345729227195,60.0,0.0
21721,2,1721,[318 427 496 357 257],716,5,7716,4.480836236933798,60.0,0.0
21722,2,1722,[ 88 211 496 183  50],151,4,7720,4.480557167730702,20.0,20.0
21723,2,1723,[318 427 496 357 257],330,5,7725,4.480858468677495,60.0,0.0
21724,2,1724,[318 427 496 357 257],330,5,7730,4.481159420289855,60.0,0.0
21725,2,1725,[238 655 211 121 210],504,4,7734,4.480880648899189,0.0,0.0
21726,2,1726,[318 427 496 357 257],716,5,7739,4.481181239143023,60.0,0.0
21727,2,1727,[318 427 496 357 257],796,5,7744,4.481481481481482,60.0,0.0
21728,2,1728,[318 427 496 357 257],716,5,7749,4.481781376518219,60.0,0.0
21729,2,1729,[318 427 496 357 257],716,5,7754,4.482080924855492,60.0,0.0
21730,2,1730,[318 427 496 357 257],796,5,7759,4.4823801270941654,60.0,0.0
21731,2,1731,[318 427 496 357 257],796,5,7764,4.482678983833718,60.0,0.0
21732,2,1732,[318 427 496 357 257],716,5,7769,4.482977495672245,60.0,0.0
21733,2,1733,[318 427 496 357 257],796,5,7774,4.483275663206459,60.0,0.0
21734,2,1734,[357  97 216 313  50],655,4,7778,4.48299711815562,0.0,20.0
21735,2,1735,[318 427 496 357 257],330,5,7783,4.483294930875576,60.0,0.0
21736,2,1736,[318 427 496 357 257],796,5,7788,4.4835924006908465,60.0,0.0
21737,2,1737,[269 125 405 427 181],450,5,7793,4.483889528193326,20.0,0.0
21738,2,1738,[318 427 496 357 257],796,5,7798,4.484186313973548,60.0,0.0
21739,2,1739,[187 179 180 302 471],450,5,7803,4.48448275862069,0.0,0.0
21740,2,1740,[282 173 144 333 403],796,5,7808,4.484778862722573,0.0,0.0
21741,2,1741,[318 427 496 357 257],716,5,7813,4.485074626865671,60.0,0.0
21742,2,1742,[318 427 496 357 257],716,5,7818,4.485370051635112,60.0,0.0
21743,2,1743,[265  70 121  98 568],457,5,7823,4.485665137614679,0.0,0.0
21744,2,1744,[318 427 496 357 257],796,5,7828,4.485959885386819,60.0,0.0
21745,2,1745,[318 427 496 357 257],330,5,7833,4.486254295532646,60.0,0.0
21746,2,1746,[318 427 496 357 257],330,5,7838,4.48654836863194,60.0,0.0
21747,2,1747,[318 427 496 357 257],716,5,7843,4.4868421052631575,60.0,0.0
21748,2,1748,[318 427 496 357 257],716,5,7848,4.487135506003431,60.0,0.0
21749,2,1749,[603 276 196 265  56],655,2,7850,4.485714285714286,20.0,0.0
21750,2,1750,[ 22 204 423 143 318],796,5,7855,4.486007995431182,20.0,0.0
21751,2,1751,[318 427 496 357 257],796,5,7860,4.486301369863014,60.0,0.0
21752,2,1752,[237 238   1 215 234],716,5,7865,4.486594409583571,0.0,0.0
21753,2,1753,[318 427 496 357 257],330,5,7870,4.486887115165336,60.0,0.0
21754,2,1754,[318 427 496 357 257],330,5,7875,4.487179487179487,60.0,0.0
21755,2,1755,[318 427 496 357 257],716,5,7880,4.4874715261958995,60.0,0.0
21756,2,1756,[318 427 496 357 257],330,5,7885,4.487763232783153,60.0,0.0
21757,2,1757,[318 427 496 357 257],716,5,7890,4.488054607508532,60.0,0.0
21758,2,1758,[204 195 168 210 328],450,4,7894,4.487777146105742,0.0,0.0
21759,2,1759,[318 427 496 357 257],330,5,7899,4.488068181818182,60.0,0.0
21760,2,1760,[ 97 238 294 197  89],796,1,7900,4.486087450312323,0.0,0.0
21761,2,1761,[ 82 475 111  89 427],269,2,7902,4.484676503972758,20.0,0.0
21762,2,1762,[196 183  69 200 471],655,2,7904,4.4832671582529775,0.0,0.0
21763,2,1763,[496 195  71 153 211],796,4,7908,4.482993197278912,20.0,0.0
21764,2,1764,[318 427 496 357 257],330,5,7913,4.48328611898017,60.0,0.0
21765,2,1765,[  9 318 228 191 300],11,3,7916,4.482446206115515,20.0,0.0
21766,2,1766,[318 427 496 357 257],716,5,7921,4.482739105829089,60.0,0.0
21767,2,1767,[318 427 496 357 257],796,5,7926,4.483031674208145,60.0,0.0
21768,2,1768,[318 427 496 357 257],716,5,7931,4.483323911814584,60.0,0.0
21769,2,1769,[588 196 182 143  12],796,5,7936,4.48361581920904,0.0,0.0
21770,2,1770,[318 427 496 357 257],716,5,7941,4.483907396950875,60.0,0.0
21771,2,1771,[318 427 496 357 257],330,5,7946,4.484198645598194,60.0,0.0
21772,2,1772,[318 427 496 357 257],716,5,7951,4.48448956570784,60.0,0.0
21773,2,1773,[318 427 496 357 257],330,5,7956,4.4847801578354005,60.0,0.0
21774,2,1774,[318 427 496 357 257],330,5,7961,4.485070422535212,60.0,0.0
21775,2,1775,[ 11 144 200 127 405],655,2,7963,4.483671171171171,0.0,20.0
21776,2,1776,[318 427 496 357 257],330,5,7968,4.4839617332583,60.0,0.0
21777,2,1777,[318 427 496 357 257],796,5,7973,4.484251968503937,60.0,0.0
21778,2,1778,[318 427 496 357 257],716,5,7978,4.484541877459247,60.0,0.0
21779,2,1779,[318 427 496 357 257],796,5,7983,4.484831460674157,60.0,0.0
21780,2,1780,[117 286 181 546 174],786,5,7988,4.485120718697361,0.0,20.0
21781,2,1781,[318 427 496 357 257],330,5,7993,4.485409652076319,60.0,0.0
21782,2,1782,[318 427 496 357 257],330,5,7998,4.485698261357263,60.0,0.0
21783,2,1783,[318 427 496 357 257],796,5,8003,4.485986547085202,60.0,0.0
21784,2,1784,[318 427 496 357 257],796,5,8008,4.486274509803922,60.0,0.0
21785,2,1785,[318 427 496 357 257],796,5,8013,4.486562150055991,60.0,0.0
21786,2,1786,[318 427 496 357 257],796,5,8018,4.486849468382764,60.0,0.0
21787,2,1787,[318 427 496 357 257],796,5,8023,4.487136465324385,60.0,0.0
21788,2,1788,[196 216 405  71 269],23,3,8026,4.48630519843488,0.0,0.0
21789,2,1789,[318 427 496 357 257],716,5,8031,4.48659217877095,60.0,0.0
21790,2,1790,[318 427 496 357 257],330,5,8036,4.486878838637633,60.0,0.0
21791,2,1791,[318 427 496 357 257],796,5,8041,4.487165178571429,60.0,0.0
21792,2,1792,[318 427 496 357 257],716,5,8046,4.487451199107641,60.0,0.0
21793,2,1793,[135  82  88 183 179],457,5,8051,4.487736900780379,0.0,0.0
21794,2,1794,[318 427 496 357 257],330,5,8056,4.488022284122563,60.0,0.0
21795,2,1795,[318 427 496 357 257],716,5,8061,4.4883073496659245,60.0,0.0
21796,2,1796,[318 427 496 357 257],716,5,8066,4.488592097941013,60.0,0.0
21797,2,1797,[318 427 496 357 257],716,5,8071,4.488876529477197,60.0,0.0
21798,2,1798,[318 427 496 357 257],716,5,8076,4.489160644802668,60.0,0.0
21799,2,1799,[318 427 496 357 257],330,5,8081,4.489444444444445,60.0,0.0
21800,2,1800,[185 515  56 175 268],655,2,8083,4.488062187673514,0.0,0.0
21801,2,1801,[318 427 496 357 257],330,5,8088,4.48834628190899,60.0,0.0
21802,2,1802,[318 427 496 357 257],796,5,8093,4.488630061009428,60.0,0.0
21803,2,1803,[318 427 496 357 257],796,5,8098,4.488913525498892,60.0,0.0
21804,2,1804,[318 427 496 357 257],796,5,8103,4.489196675900277,60.0,0.0
21805,2,1805,[318 427 496 357 257],716,5,8108,4.489479512735326,60.0,0.0
21806,2,1806,[234 357  98  15 597],269,2,8110,4.488101826231323,0.0,0.0
21807,2,1807,[318 427 496 357 257],716,5,8115,4.488384955752212,60.0,0.0
21808,2,1808,[ 15 318 161 245 127],450,4,8119,4.488114980652294,20.0,20.0
21809,2,1809,[318 427 496 357 257],330,5,8124,4.488397790055249,60.0,0.0
21810,2,1810,[546 172 121 143 187],796,5,8129,4.48868028713418,0.0,0.0
21811,2,1811,[318 427 496 357 257],716,5,8134,4.488962472406181,60.0,0.0
21812,2,1812,[508 318 172   9 423],535,4,8138,4.48869277440706,20.0,0.0
21813,2,1813,[318 427 496 357 257],796,5,8143,4.4889746416758545,60.0,0.0
21814,2,1814,[318 427 496 357 257],796,5,8148,4.489256198347108,60.0,0.0
21815,2,1815,[282 127 234 161 288],693,2,8150,4.487885462555066,0.0,20.0
21816,2,1816,[318 427 496 357 257],330,5,8155,4.488167308750688,60.0,0.0
21817,2,1817,[318 427 496 357 257],716,5,8160,4.488448844884489,60.0,0.0
21818,2,1818,[ 28 121 127 118 237],716,4,8164,4.488180318856514,0.0,20.0
21819,2,1819,[318 427 496 357 257],796,5,8169,4.4884615384615385,60.0,0.0
21820,2,1820,[318 427 496 357 257],796,5,8174,4.488742449203734,60.0,0.0
21821,2,1821,[318 427 496 357 257],330,5,8179,4.489023051591658,60.0,0.0
21822,2,1822,[117 403 197 235   8],280,3,8182,4.488206253428415,0.0,0.0
21823,2,1823,[ 98 483 471  25 202],450,3,8185,4.487390350877193,0.0,0.0
21824,2,1824,[318 427 496 357 257],716,5,8190,4.487671232876712,60.0,0.0
21825,2,1825,[318 427 496 357 257],796,5,8195,4.4879518072289155,60.0,0.0
21826,2,1826,[  1 186 185 111  25],655,1,8196,4.486042692939245,0.0,0.0
21827,2,1827,[318 427 496 357 257],796,5,8201,4.486323851203501,60.0,0.0
21828,2,1828,[318 427 496 357 257],716,5,8206,4.486604702022963,60.0,0.0
21829,2,1829,[121 323 143  88 191],796,4,8210,4.4863387978142075,0.0,0.0
21830,2,1830,[179  50 143 175   4],655,3,8213,4.485527034407427,0.0,20.0
21831,2,1831,[318 427 496 357 257],330,5,8218,4.485807860262009,60.0,0.0
21832,2,1832,[301 185 475 182 328],655,2,8220,4.484451718494272,0.0,0.0
21833,2,1833,[151  50  88  70 118],716,4,8224,4.484187568157034,0.0,20.0
21834,2,1834,[318 427 496 357 257],330,5,8229,4.484468664850136,60.0,0.0
21835,2,1835,[318 427 496 357 257],716,5,8234,4.484749455337691,60.0,0.0
21836,2,1836,[318 427 496 357 257],330,5,8239,4.485029940119761,60.0,0.0
21837,2,1837,[318 427 496 357 257],716,5,8244,4.485310119695321,60.0,0.0
21838,2,1838,[200 210  22 216 179],450,3,8247,4.484502446982056,0.0,0.0
21839,2,1839,[318 427 496 357 257],330,5,8252,4.484782608695652,60.0,0.0
21840,2,1840,[318 427 496 357 257],330,5,8257,4.485062466051059,60.0,0.0
21841,2,1841,[318 427 496 357 257],330,5,8262,4.485342019543974,60.0,0.0
21842,2,1842,[318 427 496 357 257],716,5,8267,4.485621269669018,60.0,0.0
21843,2,1843,[318 427 496 357 257],330,5,8272,4.48590021691974,60.0,0.0
21844,2,1844,[289  88 222 132 191],236,4,8276,4.485636856368564,0.0,0.0
21845,2,1845,[318 427 496 357 257],796,5,8281,4.485915492957746,60.0,0.0
21846,2,1846,[318 427 496 357 257],796,5,8286,4.486193827828912,60.0,0.0
21847,2,1847,[318 427 496 357 257],716,5,8291,4.486471861471862,60.0,0.0
21848,2,1848,[318 427 496 357 257],330,5,8296,4.486749594375338,60.0,0.0
21849,2,1849,[318 427 496 357 257],330,5,8301,4.487027027027027,60.0,0.0
21850,2,1850,[318 427 496 357 257],716,5,8306,4.487304159913561,60.0,0.0
21851,2,1851,[ 56 196 182  69  79],18,3,8309,4.486501079913607,0.0,0.0
21852,2,1852,[318 427 496 357 257],330,5,8314,4.486778197517539,60.0,0.0
21853,2,1853,[318 427 496 357 257],716,5,8319,4.4870550161812295,60.0,0.0
21854,2,1854,[318 427 496 357 257],330,5,8324,4.48733153638814,60.0,0.0
21855,2,1855,[318 427 496 357 257],716,5,8329,4.4876077586206895,60.0,0.0
21856,2,1856,[318 427 496 357 257],716,5,8334,4.487883683360258,60.0,0.0
21857,2,1857,[318 427 496 357 257],716,5,8339,4.48815931108719,60.0,0.0
21858,2,1858,[318 427 496 357 257],330,5,8344,4.488434642280796,60.0,0.0
21859,2,1859,[318 427 496 357 257],796,5,8349,4.4887096774193544,60.0,0.0
21860,2,1860,[318 427 496 357 257],796,5,8354,4.488984416980118,60.0,0.0
21861,2,1861,[435 176 265  64 748],151,3,8357,4.488184747583244,20.0,0.0
21862,2,1862,[318 427 496 357 257],716,5,8362,4.488459473966721,60.0,0.0
21863,2,1863,[318 427 496 357 257],330,5,8367,4.488733905579399,60.0,0.0
21864,2,1864,[286 475  97  12  15],655,0,8367,4.4863270777479896,0.0,20.0
21865,2,1865,[318 427 496 357 257],330,5,8372,4.486602357984995,60.0,0.0
21866,2,1866,[318 427 496 357 257],796,5,8377,4.486877343331548,60.0,0.0
21867,2,1867,[318 427 496 357 257],796,5,8382,4.487152034261242,60.0,0.0
21868,2,1868,[318 427 496 357 257],716,5,8387,4.487426431246656,60.0,0.0
21869,2,1869,[318 427 496 357 257],330,5,8392,4.487700534759358,60.0,0.0
21870,2,1870,[435 172 216 302 151],389,4,8396,4.48743987172635,0.0,0.0
21871,2,1871,[ 95 427 318  96 168],450,4,8400,4.487179487179487,40.0,0.0
21872,2,1872,[318 427 496 357 257],716,5,8405,4.487453283502402,60.0,0.0
21873,2,1873,[318 427 496 357 257],796,5,8410,4.487726787620064,60.0,0.0
21874,2,1874,[117  28 135 144 202],457,5,8415,4.488,0.0,0.0
21875,2,1875,[318 427 496 357 257],716,5,8420,4.488272921108742,60.0,0.0
21876,2,1876,[318 427 496 357 257],330,5,8425,4.4885455514118275,60.0,0.0
21877,2,1877,[318 427 496 357 257],330,5,8430,4.4888178913738015,60.0,0.0
21878,2,1878,[ 28  82  96 568 483],655,1,8431,4.486961149547632,0.0,0.0
21879,2,1879,[258 742 197 204 143],655,1,8432,4.485106382978723,0.0,0.0
21880,2,1880,[318 427 496 357 257],716,5,8437,4.485380116959064,60.0,0.0
21881,2,1881,[318 427 496 357 257],330,5,8442,4.485653560042508,60.0,0.0
21882,2,1882,[185 151 197 588 143],450,5,8447,4.485926712692512,0.0,0.0
21883,2,1883,[318 427 496 357 257],716,5,8452,4.48619957537155,60.0,0.0
21884,2,1884,[318 427 496 357 257],716,5,8457,4.486472148541114,60.0,0.0
21885,2,1885,[318 427 496 357 257],330,5,8462,4.486744432661718,60.0,0.0
21886,2,1886,[301 286 135 748 117],450,4,8466,4.486486486486487,0.0,20.0
21887,2,1887,[318 427 496 357 257],330,5,8471,4.486758474576271,60.0,0.0
21888,2,1888,[318 427 496 357 257],716,5,8476,4.487030174695606,60.0,0.0
21889,2,1889,[318 427 496 357 257],796,5,8481,4.487301587301587,60.0,0.0
21890,2,1890,[318 427 496 357 257],716,5,8486,4.487572712850343,60.0,0.0
21891,2,1891,[118 471   4 183 228],344,3,8489,4.486786469344609,0.0,0.0
21892,2,1892,[168 238  97 202  98],151,5,8494,4.4870575805599575,0.0,0.0
21893,2,1893,[ 82  50 197 196  96],450,4,8498,4.486800422386484,0.0,20.0
21894,2,1894,[318 427 496 357 257],796,5,8503,4.487071240105541,60.0,0.0
21895,2,1895,[318 427 496 357 257],716,5,8508,4.487341772151899,60.0,0.0
21896,2,1896,[318 427 496 357 257],716,5,8513,4.487612018977333,60.0,0.0
21897,2,1897,[318 427 496 357 257],716,5,8518,4.487881981032666,60.0,0.0
21898,2,1898,[210  56 228 435 403],655,0,8518,4.4855186940494995,0.0,0.0
21899,2,1899,[318 427 496 357 257],796,5,8523,4.4857894736842105,60.0,0.0
21900,2,1900,[318 427 496 357 257],716,5,8528,4.486059968437664,60.0,0.0
21901,2,1901,[318 427 496 357 257],796,5,8533,4.486330178759201,60.0,0.0
21902,2,1902,[258 423 211 475 403],655,0,8533,4.48397267472412,0.0,0.0
21903,2,1903,[318 427 496 357 257],330,5,8538,4.484243697478991,60.0,0.0
21904,2,1904,[318 427 496 357 257],330,5,8543,4.484514435695538,60.0,0.0
21905,2,1905,[318 427 496 357 257],796,5,8548,4.484784889821616,60.0,0.0
21906,2,1906,[318 427 496 357 257],716,5,8553,4.485055060304143,60.0,0.0
21907,2,1907,[318 427 496 357 257],716,5,8558,4.485324947589098,60.0,0.0
21908,2,1908,[318 427 496 357 257],330,5,8563,4.48559455212153,60.0,0.0
21909,2,1909,[318 427 496 357 257],716,5,8568,4.48586387434555,60.0,0.0
21910,2,1910,[318 427 496 357 257],330,5,8573,4.486132914704343,60.0,0.0
21911,2,1911,[318 427 496 357 257],716,5,8578,4.4864016736401675,60.0,0.0
21912,2,1912,[318 427 496 357 257],330,5,8583,4.486670151594354,60.0,0.0
21913,2,1913,[238 179 100  15  25],450,3,8586,4.4858934169279,0.0,20.0
21914,2,1914,[318 427 496 357 257],330,5,8591,4.486161879895561,60.0,0.0
21915,2,1915,[318 427 496 357 257],330,5,8596,4.48643006263048,60.0,0.0
21916,2,1916,[318 427 496 357 257],330,5,8601,4.486697965571205,60.0,0.0
21917,2,1917,[318 427 496 357 257],796,5,8606,4.48696558915537,60.0,0.0
21918,2,1918,[318 427 496 357 257],330,5,8611,4.487232933819698,60.0,0.0
21919,2,1919,[318 427 496 357 257],796,5,8616,4.4875,60.0,0.0
21920,2,1920,[318 427 496 357 257],330,5,8621,4.487766788131181,60.0,0.0
21921,2,1921,[318 427 496 357 257],796,5,8626,4.488033298647243,60.0,0.0
21922,2,1922,[132 118 265 125 144],796,5,8631,4.488299531981279,0.0,0.0
21923,2,1923,[318 427 496 357 257],330,5,8636,4.488565488565489,60.0,0.0
21924,2,1924,[318 427 496 357 257],716,5,8641,4.488831168831169,60.0,0.0
21925,2,1925,[318 427 496 357 257],330,5,8646,4.489096573208723,60.0,0.0
21926,2,1926,[258 471 144 318 172],807,4,8650,4.4888427607680335,20.0,0.0
21927,2,1927,[318 427 496 357 257],716,5,8655,4.489107883817427,60.0,0.0
21928,2,1928,[318 427 496 357 257],330,5,8660,4.489372731985485,60.0,0.0
21929,2,1929,[318 427 496 357 257],716,5,8665,4.489637305699482,60.0,0.0
21930,2,1930,[318 427 496 357 257],796,5,8670,4.4899016053858105,60.0,0.0
21931,2,1931,[318 427 496 357 257],330,5,8675,4.49016563146998,60.0,0.0
21932,2,1932,[318 427 496 357 257],330,5,8680,4.4904293843766165,60.0,0.0
21933,2,1933,[ 98 174 196  97  25],450,4,8684,4.490175801447776,0.0,0.0
21934,2,1934,[ 56 132 742  69  89],450,5,8689,4.490439276485788,0.0,0.0
21935,2,1935,[318 427 496 357 257],716,5,8694,4.490702479338843,60.0,0.0
21936,2,1936,[318 427 496 357 257],796,5,8699,4.4909654104284975,60.0,0.0
21937,2,1937,[191 237 318 211 275],786,5,8704,4.491228070175438,20.0,20.0
21938,2,1938,[318 427 496 357 257],796,5,8709,4.491490458999484,60.0,0.0
21939,2,1939,[ 96 186   8 258  89],807,3,8712,4.490721649484536,0.0,0.0
21940,2,1940,[318 427 496 357 257],330,5,8717,4.490984028851107,60.0,0.0
21941,2,1941,[318 427 496 357 257],330,5,8722,4.49124613800206,60.0,0.0
21942,2,1942,[318 427 496 357 257],716,5,8727,4.4915079773546065,60.0,0.0
21943,2,1943,[318 427 496 357 257],716,5,8732,4.491769547325103,60.0,0.0
21944,2,1944,[197  64 318 435 427],18,5,8737,4.4920308483290485,60.0,0.0
21945,2,1945,[318 427 496 357 257],716,5,8742,4.49229188078109,60.0,0.0
21946,2,1946,[318 427 496 357 257],796,5,8747,4.492552645095018,60.0,0.0
21947,2,1947,[318 427 496 357 257],796,5,8752,4.492813141683778,60.0,0.0
21948,2,1948,[ 15 222 173 180  97],11,3,8755,4.492047203694202,0.0,0.0
21949,2,1949,[318 427 496 357 257],796,5,8760,4.492307692307692,60.0,0.0
21950,2,1950,[318 427 496 357 257],796,5,8765,4.492567913890313,60.0,0.0
21951,2,1951,[318 427 496 357 257],330,5,8770,4.492827868852459,60.0,0.0
21952,2,1952,[318 427 496 357 257],330,5,8775,4.493087557603687,60.0,0.0
21953,2,1953,[318 427 496 357 257],796,5,8780,4.493346980552713,60.0,0.0
21954,2,1954,[191 603 655 238  89],151,4,8784,4.49309462915601,20.0,0.0
21955,2,1955,[ 79 127 546 237 181],280,3,8787,4.492331288343558,0.0,20.0
21956,2,1956,[318 427 496 357 257],716,5,8792,4.492590700051099,60.0,0.0
21957,2,1957,[318 427 496 357 257],716,5,8797,4.492849846782431,60.0,0.0
21958,2,1958,[318 427 496 357 257],796,5,8802,4.493108728943338,60.0,0.0
21959,2,1959,[318 427 496 357 257],330,5,8807,4.493367346938776,60.0,0.0
21960,2,1960,[237  69 427 323  12],796,4,8811,4.4931157572667,20.0,0.0
21961,2,1961,[318 427 496 357 257],716,5,8816,4.493374108053007,60.0,0.0
21962,2,1962,[196 238  97 153 276],18,4,8820,4.4931227712684665,0.0,0.0
21963,2,1963,[318 427 496 357 257],716,5,8825,4.493380855397149,60.0,0.0
21964,2,1964,[318 427 496 357 257],330,5,8830,4.493638676844784,60.0,0.0
21965,2,1965,[318 427 496 357 257],330,5,8835,4.4938962360122074,60.0,0.0
21966,2,1966,[318 427 496 357 257],330,5,8840,4.494153533299441,60.0,0.0
21967,2,1967,[318 427 496 357 257],796,5,8845,4.494410569105691,60.0,0.0
21968,2,1968,[318 427 496 357 257],796,5,8850,4.494667343829355,60.0,0.0
21969,2,1969,[318 427 496 357 257],330,5,8855,4.49492385786802,60.0,0.0
21970,2,1970,[427  79 173 471  82],450,4,8859,4.494672754946728,20.0,0.0
21971,2,1971,[318 427 496 357 257],716,5,8864,4.494929006085193,60.0,0.0
21972,2,1972,[318 427 496 357 257],796,5,8869,4.495184997465788,60.0,0.0
21973,2,1973,[187 275 313 508 144],655,3,8872,4.494427558257345,0.0,20.0
21974,2,1974,[318 427 496 357 257],716,5,8877,4.494683544303798,60.0,0.0
21975,2,1975,[318 427 496 357 257],796,5,8882,4.494939271255061,60.0,0.0
21976,2,1976,[318 427 496 357 257],330,5,8887,4.495194739504299,60.0,0.0
21977,2,1977,[318 427 496 357 257],716,5,8892,4.495449949443882,60.0,0.0
21978,2,1978,[318 427 496 357 257],330,5,8897,4.495704901465387,60.0,0.0
21979,2,1979,[318 427 496 357 257],796,5,8902,4.495959595959596,60.0,0.0
21980,2,1980,[143 471  98  25 357],457,5,8907,4.496214033316507,0.0,0.0
21981,2,1981,[318 427 496 357 257],716,5,8912,4.496468213925328,60.0,0.0
21982,2,1982,[173 143 174 200 228],450,4,8916,4.496217851739789,0.0,0.0
21983,2,1983,[318 427 496 357 257],716,5,8921,4.496471774193548,60.0,0.0
21984,2,1984,[318 427 496 357 257],330,5,8926,4.4967254408060455,60.0,0.0
21985,2,1985,[318 427 496 357 257],716,5,8931,4.496978851963746,60.0,0.0
21986,2,1986,[318 427 496 357 257],716,5,8936,4.4972320080523405,60.0,0.0
21987,2,1987,[318 427 496 357 257],796,5,8941,4.49748490945674,60.0,0.0
21988,2,1988,[318 427 496 357 257],330,5,8946,4.497737556561086,60.0,0.0
21989,2,1989,[318 427 496 357 257],796,5,8951,4.497989949748744,60.0,0.0
21990,2,1990,[ 89 282 546 294  12],256,3,8954,4.497237569060774,0.0,0.0
21991,2,1991,[318 427 496 357 257],716,5,8959,4.497489959839357,60.0,0.0
21992,2,1992,[ 69   1 742 117 597],450,5,8964,4.4977420973406925,0.0,0.0
21993,2,1993,[318 427 496 357 257],330,5,8969,4.497993981945838,60.0,0.0
21994,2,1994,[191 423 200 187 135],629,4,8973,4.497744360902256,0.0,0.0
21995,2,1995,[318 427 496 357 257],716,5,8978,4.497995991983968,60.0,0.0
21996,2,1996,[318 427 496 357 257],330,5,8983,4.498247371056585,60.0,0.0
21997,2,1997,[318 427 496 357 257],330,5,8988,4.498498498498498,60.0,0.0
21998,2,1998,[318 427 496 357 257],716,5,8993,4.4987493746873435,60.0,0.0
21999,2,1999,[ 50 483 175 300  64],655,3,8996,4.498,20.0,20.0
22000,2,2000,[318 427 496 357 257],716,5,9001,4.498250874562719,60.0,0.0
22001,2,2001,[318 427 496 357 257],716,5,9006,4.498501498501499,60.0,0.0
22002,2,2002,[318 427 496 357 257],716,5,9011,4.498751872191712,60.0,0.0
22003,2,2003,[318 427 496 357 257],330,5,9016,4.499001996007984,60.0,0.0
22004,2,2004,[318 427 496 357 257],716,5,9021,4.49925187032419,60.0,0.0
22005,2,2005,[168  97  11   9 180],535,5,9026,4.49950149551346,0.0,0.0
22006,2,2006,[318 427 496 357 257],716,5,9031,4.499750871948182,60.0,0.0
22007,2,2007,[318 427 496 357 257],716,5,9036,4.5,60.0,0.0
22008,2,2008,[318 427 496 357 257],796,5,9041,4.500248880039821,60.0,0.0
22009,2,2009,[318 427 496 357 257],716,5,9046,4.500497512437811,60.0,0.0
22010,2,2010,[318 427 496 357 257],716,5,9051,4.500745897563402,60.0,0.0
22011,2,2011,[286  89 313 191 181],655,3,9054,4.5,0.0,20.0
22012,2,2012,[318 427 496 357 257],330,5,9059,4.500248385494287,60.0,0.0
22013,2,2013,[318 427 496 357 257],796,5,9064,4.500496524329692,60.0,0.0
22014,2,2014,[288 678 174 385  25],256,5,9069,4.500744416873449,0.0,0.0
22015,2,2015,[318 427 496 357 257],716,5,9074,4.500992063492063,60.0,0.0
22016,2,2016,[318 427 496 357 257],330,5,9079,4.501239464551314,60.0,0.0
22017,2,2017,[318 427 496 357 257],796,5,9084,4.501486620416253,60.0,0.0
22018,2,2018,[318 427 496 357 257],796,5,9089,4.5017335314512135,60.0,0.0
22019,2,2019,[196 385 173 357 202],457,5,9094,4.501980198019802,0.0,0.0
22020,2,2020,[318 427 496 357 257],796,5,9099,4.502226620484908,60.0,0.0
22021,2,2021,[318 427 496 357 257],716,5,9104,4.502472799208705,60.0,0.0
22022,2,2022,[385  69 322 294 257],796,3,9107,4.501730103806229,0.0,0.0
22023,2,2023,[318 427 496 357 257],716,5,9112,4.5019762845849804,60.0,0.0
22024,2,2024,[318 427 496 357 257],716,5,9117,4.502222222222223,60.0,0.0
22025,2,2025,[318 427 496 357 257],716,5,9122,4.502467917077986,60.0,0.0
22026,2,2026,[211 100 186  28 202],389,4,9126,4.5022200296003945,0.0,20.0
22027,2,2027,[318 427 496 357 257],796,5,9131,4.502465483234714,60.0,0.0
22028,2,2028,[318 427 496 357 257],330,5,9136,4.502710694923608,60.0,0.0
22029,2,2029,[318 427 496 357 257],716,5,9141,4.502955665024631,60.0,0.0
22030,2,2030,[318 427 496 357 257],796,5,9146,4.503200393894633,60.0,0.0
22031,2,2031,[318 427 496 357 257],716,5,9151,4.503444881889764,60.0,0.0
22032,2,2032,[318 427 496 357 257],716,5,9156,4.50368912936547,60.0,0.0
22033,2,2033,[318 427 496 357 257],796,5,9161,4.503933136676499,60.0,0.0
22034,2,2034,[318 427 496 357 257],796,5,9166,4.504176904176904,60.0,0.0
22035,2,2035,[273 237  28 245 294],796,1,9167,4.5024557956777995,0.0,0.0
22036,2,2036,[318 427 496 357 257],796,5,9172,4.502700049091802,60.0,0.0
22037,2,2037,[318 427 496 357 257],716,5,9177,4.502944062806673,60.0,0.0
22038,2,2038,[318 427 496 357 257],716,5,9182,4.503187837175086,60.0,0.0
22039,2,2039,[318 427 496 357 257],716,5,9187,4.50343137254902,60.0,0.0
22040,2,2040,[318 427 496 357 257],796,5,9192,4.503674669279765,60.0,0.0
22041,2,2041,[318 427 496 357 257],796,5,9197,4.503917727717924,60.0,0.0
22042,2,2042,[318 427 496 357 257],796,5,9202,4.504160548213411,60.0,0.0
22043,2,2043,[403 143 655  11 121],450,4,9206,4.503913894324853,0.0,0.0
22044,2,2044,[318 427 496 357 257],716,5,9211,4.504156479217604,60.0,0.0
22045,2,2045,[318 427 496 357 257],716,5,9216,4.504398826979473,60.0,0.0
22046,2,2046,[318 427 496 357 257],330,5,9221,4.504640937957987,60.0,0.0
22047,2,2047,[318 427 496 357 257],330,5,9226,4.5048828125,60.0,0.0
22048,2,2048,[318 427 496 357 257],330,5,9231,4.5051244509516835,60.0,0.0
22049,2,2049,[318 427 496 357 257],796,5,9236,4.505365853658536,60.0,0.0
22050,2,2050,[318 427 496 357 257],330,5,9241,4.505607020965383,60.0,0.0
22051,2,2051,[318 427 496 357 257],716,5,9246,4.505847953216374,60.0,0.0
22052,2,2052,[318 427 496 357 257],796,5,9251,4.506088650754993,60.0,0.0
22053,2,2053,[318 427 496 357 257],330,5,9256,4.506329113924051,60.0,0.0
22054,2,2054,[318 427 496 357 257],716,5,9261,4.506569343065693,60.0,0.0
22055,2,2055,[318 427 496 357 257],716,5,9266,4.506809338521401,60.0,0.0
22056,2,2056,[318 427 496 357 257],330,5,9271,4.507049100631988,60.0,0.0
22057,2,2057,[ 70 172 318 228 302],655,3,9274,4.506316812439262,20.0,0.0
22058,2,2058,[196  11 135 405 403],655,1,9275,4.504613890237979,0.0,0.0
22059,2,2059,[318 427 496 357 257],716,5,9280,4.504854368932039,60.0,0.0
22060,2,2060,[318 427 496 357 257],330,5,9285,4.5050946142649195,60.0,0.0
22061,2,2061,[318 427 496 357 257],796,5,9290,4.50533462657614,60.0,0.0
22062,2,2062,[318 427 496 357 257],716,5,9295,4.505574406204556,60.0,0.0
22063,2,2063,[318 427 496 357 257],716,5,9300,4.505813953488372,60.0,0.0
22064,2,2064,[318 427 496 357 257],330,5,9305,4.506053268765133,60.0,0.0
22065,2,2065,[318 427 496 357 257],716,5,9310,4.506292352371733,60.0,0.0
22066,2,2066,[318 427 496 357 257],716,5,9315,4.506531204644412,60.0,0.0
22067,2,2067,[318 427 496 357 257],330,5,9320,4.506769825918762,60.0,0.0
22068,2,2068,[357 144  15 282  50],593,5,9325,4.507008216529725,0.0,20.0
22069,2,2069,[318 427 496 357 257],330,5,9330,4.507246376811594,60.0,0.0
22070,2,2070,[318 427 496 357 257],716,5,9335,4.507484307098021,60.0,0.0
22071,2,2071,[318 427 496 357 257],796,5,9340,4.507722007722008,60.0,0.0
22072,2,2072,[132 357 471  71 288],344,3,9343,4.506994693680656,0.0,0.0
22073,2,2073,[318 427 496 357 257],796,5,9348,4.507232401157184,60.0,0.0
22074,2,2074,[288 328  64 322 273],450,3,9351,4.506506024096385,20.0,0.0
22075,2,2075,[318 427 496 357 257],796,5,9356,4.506743737957611,60.0,0.0
22076,2,2076,[318 427 496 357 257],330,5,9361,4.50698122291767,60.0,0.0
22077,2,2077,[127 269 275 216 132],503,5,9366,4.507218479307026,0.0,40.0
22078,2,2078,[318 427 496 357 257],716,5,9371,4.507455507455507,60.0,0.0
22079,2,2079,[318 427 496 357 257],796,5,9376,4.507692307692308,60.0,0.0
22080,2,2080,[ 96 204 423 234  79],450,4,9380,4.5074483421432,0.0,0.0
22081,2,2081,[318 427 496 357 257],796,5,9385,4.507684918347743,60.0,0.0
22082,2,2082,[118 269 185   1  98],450,4,9389,4.5074411905904945,0.0,0.0
22083,2,2083,[318 427 496 357 257],330,5,9394,4.507677543186181,60.0,0.0
22084,2,2084,[318 427 496 357 257],796,5,9399,4.507913669064748,60.0,0.0
22085,2,2085,[318 427 496 357 257],716,5,9404,4.508149568552253,60.0,0.0
22086,2,2086,[174 185  70 127 204],655,2,9406,4.506947771921419,0.0,20.0
22087,2,2087,[318 427 496 357 257],330,5,9411,4.507183908045977,60.0,0.0
22088,2,2088,[318 427 496 357 257],330,5,9416,4.507419818094782,60.0,0.0
22089,2,2089,[318 427 496 357 257],716,5,9421,4.507655502392344,60.0,0.0
22090,2,2090,[318 427 496 357 257],330,5,9426,4.507890961262554,60.0,0.0
22091,2,2091,[118 742 180 508 200],280,3,9429,4.50717017208413,0.0,0.0
22092,2,2092,[318 427 496 357 257],716,5,9434,4.507405637840421,60.0,0.0
22093,2,2093,[318 427 496 357 257],716,5,9439,4.507640878701051,60.0,0.0
22094,2,2094,[318 427 496 357 257],330,5,9444,4.507875894988067,60.0,0.0
22095,2,2095,[318 427 496 357 257],716,5,9449,4.508110687022901,60.0,0.0
22096,2,2096,[237 186 197 265  25],716,4,9453,4.5078683834048645,0.0,0.0
22097,2,2097,[318 427 496 357 257],796,5,9458,4.508102955195424,60.0,0.0
22098,2,2098,[318 427 496 357 257],330,5,9463,4.5083373034778464,60.0,0.0
22099,2,2099,[318 427 496 357 257],796,5,9468,4.508571428571429,60.0,0.0
22100,2,2100,[318 427 496 357 257],330,5,9473,4.50880533079486,60.0,0.0
22101,2,2101,[318 427 496 357 257],796,5,9478,4.509039010466223,60.0,0.0
22102,2,2102,[318 427 496 357 257],716,5,9483,4.509272467902996,60.0,0.0
22103,2,2103,[318 427 496 357 257],330,5,9488,4.509505703422053,60.0,0.0
22104,2,2104,[318 427 496 357 257],796,5,9493,4.509738717339667,60.0,0.0
22105,2,2105,[318 427 496 357 257],796,5,9498,4.50997150997151,60.0,0.0
22106,2,2106,[515 186 197   9 132],269,4,9502,4.509729473184622,0.0,0.0
22107,2,2107,[318 427 496 357 257],796,5,9507,4.509962049335863,60.0,0.0
22108,2,2108,[318 427 496 357 257],716,5,9512,4.510194404931247,60.0,0.0
22109,2,2109,[318 427 496 357 257],330,5,9517,4.51042654028436,60.0,0.0
22110,2,2110,[318 427 496 357 257],330,5,9522,4.510658455708195,60.0,0.0
22111,2,2111,[222  95 257 282 603],796,5,9527,4.510890151515151,20.0,0.0
22112,2,2112,[742 496 235  50  22],280,4,9531,4.510648367250355,20.0,20.0
22113,2,2113,[ 25   9 127 655 210],655,1,9532,4.508987701040681,0.0,20.0
22114,2,2114,[318 427 496 357 257],796,5,9537,4.509219858156029,60.0,0.0
22115,2,2115,[269  98  22 268   1],344,2,9539,4.508034026465029,0.0,0.0
22116,2,2116,[318 427 496 357 257],716,5,9544,4.508266414737837,60.0,0.0
22117,2,2117,[318 427 496 357 257],796,5,9549,4.508498583569405,60.0,0.0
22118,2,2118,[ 25 111 237 168 132],716,5,9554,4.508730533270411,0.0,0.0
22119,2,2119,[318 427 496 357 257],796,5,9559,4.508962264150943,60.0,0.0
22120,2,2120,[318 427 496 357 257],330,5,9564,4.509193776520509,60.0,0.0
22121,2,2121,[318 427 496 357 257],796,5,9569,4.50942507068803,60.0,0.0
22122,2,2122,[318 427 496 357 257],716,5,9574,4.509656146961847,60.0,0.0
22123,2,2123,[318 427 496 357 257],796,5,9579,4.509887005649717,60.0,0.0
22124,2,2124,[318 427 496 357 257],330,5,9584,4.510117647058824,60.0,0.0
22125,2,2125,[318 427 496 357 257],796,5,9589,4.510348071495767,60.0,0.0
22126,2,2126,[318 427 496 357 257],796,5,9594,4.510578279266572,60.0,0.0
22127,2,2127,[318 427 496 357 257],330,5,9599,4.510808270676692,60.0,0.0
22128,2,2128,[318 427 496 357 257],330,5,9604,4.5110380460310004,60.0,0.0
22129,2,2129,[318 427 496 357 257],716,5,9609,4.511267605633803,60.0,0.0
22130,2,2130,[318 427 496 357 257],716,5,9614,4.511496949788832,60.0,0.0
22131,2,2131,[318 427 496 357 257],796,5,9619,4.511726078799249,60.0,0.0
22132,2,2132,[202  50  82 118  28],504,2,9621,4.510548523206751,0.0,20.0
22133,2,2133,[318 427 496 357 257],716,5,9626,4.510777881911903,60.0,0.0
22134,2,2134,[318 427 496 357 257],716,5,9631,4.511007025761124,60.0,0.0
22135,2,2135,[318 427 496 357 257],796,5,9636,4.51123595505618,60.0,0.0
22136,2,2136,[182 742 153 202 313],655,2,9638,4.5100608329433785,0.0,0.0
22137,2,2137,[318 427 496 357 257],796,5,9643,4.510289990645463,60.0,0.0
22138,2,2138,[318 427 496 357 257],796,5,9648,4.510518934081347,60.0,0.0
22139,2,2139,[318 427 496 357 257],330,5,9653,4.510747663551402,60.0,0.0
22140,2,2140,[318 427 496 357 257],330,5,9658,4.510976179355441,60.0,0.0
22141,2,2141,[237  56 328 435  96],450,5,9663,4.511204481792717,0.0,0.0
22142,2,2142,[318 427 496 357 257],796,5,9668,4.511432571161922,60.0,0.0
22143,2,2143,[318 427 496 357 257],716,5,9673,4.511660447761194,60.0,0.0
22144,2,2144,[318 427 496 357 257],716,5,9678,4.511888111888112,60.0,0.0
22145,2,2145,[403 257  88 111 172],798,4,9682,4.511649580615098,0.0,0.0
22146,2,2146,[318 427 496 357 257],330,5,9687,4.511877037727061,60.0,0.0
22147,2,2147,[318 427 496 357 257],716,5,9692,4.512104283054004,60.0,0.0
22148,2,2148,[ 56  64 175 144 135],655,2,9694,4.510935318752908,20.0,0.0
22149,2,2149,[318 427 496 357 257],796,5,9699,4.511162790697674,60.0,0.0
22150,2,2150,[318 427 496 357 257],716,5,9704,4.5113900511390055,60.0,0.0
22151,2,2151,[318 427 496 357 257],796,5,9709,4.511617100371748,60.0,0.0
22152,2,2152,[ 79 153   1 211 471],593,3,9712,4.510915002322341,0.0,0.0
22153,2,2153,[322 405 222  88 655],450,4,9716,4.510677808727948,0.0,0.0
22154,2,2154,[318 427 496 357 257],796,5,9721,4.5109048723897915,60.0,0.0
22155,2,2155,[318 427 496 357 257],796,5,9726,4.51113172541744,60.0,0.0
22156,2,2156,[318 427 496 357 257],716,5,9731,4.511358368103848,60.0,0.0
22157,2,2157,[318 427 496 357 257],796,5,9736,4.511584800741427,60.0,0.0
22158,2,2158,[318 427 496 357 257],716,5,9741,4.511811023622047,60.0,0.0
22159,2,2159,[182 195 180 275 210],535,4,9745,4.511574074074074,0.0,20.0
22160,2,2160,[181 215  95 173   4],344,3,9748,4.510874595094863,0.0,0.0
22161,2,2161,[655 288 301 435 271],629,4,9752,4.51063829787234,0.0,0.0
22162,2,2162,[318 427 496 357 257],330,5,9757,4.510864539990753,60.0,0.0
22163,2,2163,[318 427 496 357 257],330,5,9762,4.511090573012939,60.0,0.0
22164,2,2164,[318 427 496 357 257],796,5,9767,4.511316397228637,60.0,0.0
22165,2,2165,[ 96 174 195 403 235],450,4,9771,4.511080332409972,0.0,0.0
22166,2,2166,[  9 100 748 197  64],796,2,9773,4.509921550530688,20.0,20.0
22167,2,2167,[318 427 496 357 257],716,5,9778,4.510147601476015,60.0,0.0
22168,2,2168,[318 427 496 357 257],716,5,9783,4.5103734439834025,60.0,0.0
22169,2,2169,[318 427 496 357 257],330,5,9788,4.510599078341014,60.0,0.0
22170,2,2170,[318 427 496 357 257],796,5,9793,4.510824504836481,60.0,0.0
22171,2,2171,[318 427 496 357 257],716,5,9798,4.511049723756906,60.0,0.0
22172,2,2172,[318 427 496 357 257],330,5,9803,4.511274735388863,60.0,0.0
22173,2,2173,[318 427 496 357 257],796,5,9808,4.5114995400183995,60.0,0.0
22174,2,2174,[318 427 496 357 257],716,5,9813,4.511724137931035,60.0,0.0
22175,2,2175,[318 427 496 357 257],716,5,9818,4.5119485294117645,60.0,0.0
22176,2,2176,[318 427 496 357 257],330,5,9823,4.512172714745062,60.0,0.0
22177,2,2177,[144  97 655 403   1],457,5,9828,4.512396694214876,0.0,0.0
22178,2,2178,[318 427 496 357 257],716,5,9833,4.512620468104635,60.0,0.0
22179,2,2179,[318 427 496 357 257],796,5,9838,4.512844036697247,60.0,0.0
22180,2,2180,[318 427 496 357 257],796,5,9843,4.513067400275103,60.0,0.0
22181,2,2181,[182 300 196 191 275],389,3,9846,4.512373968835931,0.0,20.0
22182,2,2182,[318 427 496 357 257],716,5,9851,4.512597343105818,60.0,0.0
22183,2,2183,[318 427 496 357 257],716,5,9856,4.512820512820513,60.0,0.0
22184,2,2184,[318 427 496 357 257],330,5,9861,4.51304347826087,60.0,0.0
22185,2,2185,[318 427 496 357 257],716,5,9866,4.513266239707228,60.0,0.0
22186,2,2186,[168 496 132 427 234],503,5,9871,4.513488797439415,40.0,0.0
22187,2,2187,[318 427 496 357 257],330,5,9876,4.513711151736746,60.0,0.0
22188,2,2188,[318 427 496 357 257],796,5,9881,4.513933302878026,60.0,0.0
22189,2,2189,[318 427 496 357 257],716,5,9886,4.514155251141553,60.0,0.0
22190,2,2190,[318 427 496 357 257],330,5,9891,4.514376996805112,60.0,0.0
22191,2,2191,[318 427 496 357 257],330,5,9896,4.514598540145985,60.0,0.0
22192,2,2192,[318 427 496 357 257],796,5,9901,4.514819881440949,60.0,0.0
22193,2,2193,[318 427 496 357 257],716,5,9906,4.5150410209662715,60.0,0.0
22194,2,2194,[318   7 546 435 210],450,4,9910,4.514806378132119,20.0,0.0
22195,2,2195,[144 196 403 257  15],457,4,9914,4.514571948998179,0.0,0.0
22196,2,2196,[318 427 496 357 257],796,5,9919,4.514792899408284,60.0,0.0
22197,2,2197,[318 427 496 357 257],796,5,9924,4.51501364877161,60.0,0.0
22198,2,2198,[318 427 496 357 257],796,5,9929,4.515234197362437,60.0,0.0
22199,2,2199,[318 427 496 357 257],716,5,9934,4.515454545454546,60.0,0.0
22200,2,2200,[318 427 496 357 257],716,5,9939,4.515674693321218,60.0,0.0
22201,2,2201,[318 427 496 357 257],716,5,9944,4.51589464123524,60.0,0.0
22202,2,2202,[318 427 496 357 257],330,5,9949,4.516114389468906,60.0,0.0
22203,2,2203,[238 173 322 357 161],786,4,9953,4.515880217785844,0.0,0.0
22204,2,2204,[318 427 496 357 257],330,5,9958,4.5160997732426305,60.0,0.0
22205,2,2205,[318 427 496 357 257],796,5,9963,4.516319129646419,60.0,0.0
22206,2,2206,[117 301 118  96 471],344,2,9965,4.515178975985501,0.0,0.0
22207,2,2207,[318 427 496 357 257],716,5,9970,4.515398550724638,60.0,0.0
22208,2,2208,[318 427 496 357 257],330,5,9975,4.515617926663649,60.0,0.0
22209,2,2209,[180 132  25 200 181],450,3,9978,4.5149321266968325,0.0,0.0
22210,2,2210,[318 427 496 357 257],796,5,9983,4.515151515151516,60.0,0.0
22211,2,2211,[318 427 496 357 257],796,5,9988,4.5153707052441225,60.0,0.0
22212,2,2212,[318 427 496 357 257],796,5,9993,4.515589697243561,60.0,0.0
22213,2,2213,[ 89 100 111 237 238],786,5,9998,4.515808491418247,0.0,20.0
22214,2,2214,[318 427 496 357 257],330,5,10003,4.516027088036117,60.0,0.0
22215,2,2215,[318 427 496 357 257],716,5,10008,4.516245487364621,60.0,0.0
22216,2,2216,[318 427 496 357 257],330,5,10013,4.516463689670727,60.0,0.0
22217,2,2217,[318 427 496 357 257],716,5,10018,4.51668169522092,60.0,0.0
22218,2,2218,[318 427 496 357 257],716,5,10023,4.5168995042812075,60.0,0.0
22219,2,2219,[318 427 496 357 257],330,5,10028,4.517117117117117,60.0,0.0
22220,2,2220,[318 427 496 357 257],796,5,10033,4.517334533993696,60.0,0.0
22221,2,2221,[318 427 496 357 257],330,5,10038,4.517551755175518,60.0,0.0
22222,2,2222,[318 427 496 357 257],796,5,10043,4.5177687809266756,60.0,0.0
22223,2,2223,[318 427 496 357 257],330,5,10048,4.517985611510792,60.0,0.0
22224,2,2224,[117 222 153 195 385],450,4,10052,4.517752808988764,0.0,0.0
22225,2,2225,[181 276 301 237 111],296,4,10056,4.517520215633423,0.0,0.0
22226,2,2226,[318 427 496 357 257],330,5,10061,4.517736865738662,60.0,0.0
22227,2,2227,[318 427 496 357 257],796,5,10066,4.517953321364453,60.0,0.0
22228,2,2228,[ 97 546 132 282 403],504,4,10070,4.517720951099148,0.0,0.0
22229,2,2229,[318 427 496 357 257],796,5,10075,4.517937219730942,60.0,0.0
22230,2,2230,[271 215 742 200 273],655,2,10077,4.5168086060062755,0.0,0.0
22231,2,2231,[318 427 496 357 257],796,5,10082,4.517025089605735,60.0,0.0
22232,2,2232,[318 427 496 357 257],330,5,10087,4.517241379310345,60.0,0.0
22233,2,2233,[318 427 496 357 257],716,5,10092,4.517457475380484,60.0,0.0
22234,2,2234,[318 427 496 357 257],796,5,10097,4.517673378076062,60.0,0.0
22235,2,2235,[385 496 216 176 195],151,2,10099,4.51654740608229,20.0,0.0
22236,2,2236,[195 603 245 496 185],450,5,10104,4.516763522574877,40.0,0.0
22237,2,2237,[300 471 180 100 275],535,4,10108,4.516532618409294,0.0,40.0
22238,2,2238,[318 427 496 357 257],330,5,10113,4.516748548459134,60.0,0.0
22239,2,2239,[318 427 496 357 257],716,5,10118,4.516964285714286,60.0,0.0
22240,2,2240,[318 427 496 357 257],716,5,10123,4.517179830432842,60.0,0.0
22241,2,2241,[318 427 496 357 257],796,5,10128,4.517395182872435,60.0,0.0
22242,2,2242,[318 427 496 357 257],330,5,10133,4.517610343290237,60.0,0.0
22243,2,2243,[125  97 546 276 294],457,3,10136,4.516934046345811,0.0,0.0
22244,2,2244,[318 427 496 357 257],796,5,10141,4.517149220489978,60.0,0.0
22245,2,2245,[318 427 496 357 257],796,5,10146,4.517364203027604,60.0,0.0
22246,2,2246,[318 427 496 357 257],796,5,10151,4.517578994214508,60.0,0.0
22247,2,2247,[318 427 496 357 257],330,5,10156,4.51779359430605,60.0,0.0
22248,2,2248,[318 427 496 357 257],716,5,10161,4.518008003557137,60.0,0.0
22249,2,2249,[286 300 385  15 185],151,4,10165,4.517777777777778,0.0,20.0
22250,2,2250,[318 427 496 357 257],796,5,10170,4.517992003553976,60.0,0.0
22251,2,2251,[318 427 496 357 257],796,5,10175,4.518206039076377,60.0,0.0
22252,2,2252,[  1 200 427 135  95],716,4,10179,4.5179760319573905,20.0,0.0
22253,2,2253,[174 301 265 132  50],655,1,10180,4.516415261756877,0.0,20.0
22254,2,2254,[318 427 496 357 257],796,5,10185,4.516629711751663,60.0,0.0
22255,2,2255,[318 427 496 357 257],716,5,10190,4.516843971631205,60.0,0.0
22256,2,2256,[318 427 496 357 257],796,5,10195,4.517058041648205,60.0,0.0
22257,2,2257,[588   1 333 186 655],796,2,10197,4.515943312666076,0.0,0.0
22258,2,2258,[318 427 496 357 257],330,5,10202,4.516157591854803,60.0,0.0
22259,2,2259,[216  89 100 286 197],18,4,10206,4.515929203539823,0.0,40.0
22260,2,2260,[318 427 496 357 257],796,5,10211,4.516143299425033,60.0,0.0
22261,2,2261,[318 427 496 357 257],796,5,10216,4.516357206012378,60.0,0.0
22262,2,2262,[318 427 496 357 257],796,5,10221,4.516570923552806,60.0,0.0
22263,2,2263,[318 427 496 357 257],796,5,10226,4.51678445229682,60.0,0.0
22264,2,2264,[318 427 496 357 257],716,5,10231,4.5169977924944815,60.0,0.0
22265,2,2265,[318 427 496 357 257],716,5,10236,4.51721094439541,60.0,0.0
22266,2,2266,[318 427 496 357 257],796,5,10241,4.517423908248787,60.0,0.0
22267,2,2267,[318 427 496 357 257],330,5,10246,4.517636684303351,60.0,0.0
22268,2,2268,[318 427 496 357 257],796,5,10251,4.517849272807404,60.0,0.0
22269,2,2269,[318 427 496 357 257],716,5,10256,4.518061674008811,60.0,0.0
22270,2,2270,[318 427 496 357 257],330,5,10261,4.518273888154998,60.0,0.0
22271,2,2271,[318 427 496 357 257],330,5,10266,4.518485915492958,60.0,0.0
22272,2,2272,[546 483 100 172  22],450,4,10270,4.518257809062913,0.0,20.0
22273,2,2273,[ 88 176 127 118 405],344,2,10272,4.517150395778364,0.0,20.0
22274,2,2274,[318 427 496 357 257],330,5,10277,4.517362637362638,60.0,0.0
22275,2,2275,[318 427 496 357 257],796,5,10282,4.517574692442882,60.0,0.0
22276,2,2276,[318 427 496 357 257],796,5,10287,4.517786561264822,60.0,0.0
22277,2,2277,[318 427 496 357 257],330,5,10292,4.517998244073749,60.0,0.0
22278,2,2278,[318 427 496 357 257],716,5,10297,4.518209741114524,60.0,0.0
22279,2,2279,[ 56 195 435 172 144],450,5,10302,4.518421052631579,0.0,0.0
22280,2,2280,[318 427 496 357 257],330,5,10307,4.518632178868917,60.0,0.0
22281,2,2281,[318 427 496 357 257],716,5,10312,4.518843120070114,60.0,0.0
22282,2,2282,[318 427 496 357 257],796,5,10317,4.519053876478318,60.0,0.0
22283,2,2283,[603 222  98 111 237],450,4,10321,4.518826619964973,20.0,0.0
22284,2,2284,[318 427 496 357 257],796,5,10326,4.5190371991247265,60.0,0.0
22285,2,2285,[318 427 496 357 257],330,5,10331,4.519247594050744,60.0,0.0
22286,2,2286,[318 427 496 357 257],716,5,10336,4.519457804984696,60.0,0.0
22287,2,2287,[318 427 496 357 257],796,5,10341,4.5196678321678325,60.0,0.0
22288,2,2288,[ 50 275   8 196 423],655,2,10343,4.518567059851463,0.0,40.0
22289,2,2289,[215 132 222   9 403],693,2,10345,4.5174672489082965,0.0,0.0
22290,2,2290,[318 427 496 357 257],716,5,10350,4.517677869925796,60.0,0.0
22291,2,2291,[  7 191 228 197 471],72,3,10353,4.517015706806283,0.0,0.0
22292,2,2292,[318 427 496 357 257],330,5,10358,4.517226341037942,60.0,0.0
22293,2,2293,[318 427 496 357 257],716,5,10363,4.51743679163034,60.0,0.0
22294,2,2294,[318 427 496 357 257],796,5,10368,4.517647058823529,60.0,0.0
22295,2,2295,[318 427 496 357 257],716,5,10373,4.517857142857143,60.0,0.0
22296,2,2296,[318 427 496 357 257],330,5,10378,4.5180670439703965,60.0,0.0
22297,2,2297,[496 385 403 238 215],796,4,10382,4.517841601392515,20.0,0.0
22298,2,2298,[318 427 496 357 257],330,5,10387,4.518051326663767,60.0,0.0
22299,2,2299,[318 427 496 357 257],330,5,10392,4.518260869565218,60.0,0.0
22300,2,2300,[318 427 496 357 257],330,5,10397,4.518470230334637,60.0,0.0
22301,2,2301,[318 427 496 357 257],716,5,10402,4.518679409209383,60.0,0.0
22302,2,2302,[318 427 496 357 257],716,5,10407,4.5188884064264006,60.0,0.0
22303,2,2303,[318 427 496 357 257],796,5,10412,4.519097222222222,60.0,0.0
22304,2,2304,[ 25  11  50  70 191],716,5,10417,4.519305856832972,0.0,20.0
22305,2,2305,[318 427 496 357 257],796,5,10422,4.519514310494363,60.0,0.0
22306,2,2306,[318 427 496 357 257],796,5,10427,4.519722583441699,60.0,0.0
22307,2,2307,[216 210 174 100  69],401,4,10431,4.51949740034662,0.0,20.0
22308,2,2308,[271 568 257 403  89],796,5,10436,4.519705500216544,0.0,0.0
22309,2,2309,[318 427 496 357 257],330,5,10441,4.51991341991342,60.0,0.0
22310,2,2310,[318 427 496 357 257],796,5,10446,4.520121159671138,60.0,0.0
22311,2,2311,[235 588 172  69  95],280,4,10450,4.519896193771626,0.0,0.0
22312,2,2312,[318 427 496 357 257],330,5,10455,4.5201037613488975,60.0,0.0
22313,2,2313,[ 82 125 216  97 286],655,1,10456,4.518582541054451,0.0,20.0
22314,2,2314,[318 427 496 357 257],330,5,10461,4.518790496760259,60.0,0.0
22315,2,2315,[318 427 496 357 257],330,5,10466,4.518998272884283,60.0,0.0
22316,2,2316,[318 427 496 357 257],796,5,10471,4.519205869659042,60.0,0.0
22317,2,2317,[  1 269 125 172 475],296,5,10476,4.519413287316652,0.0,0.0
22318,2,2318,[183 174 118 748 403],796,5,10481,4.519620526088832,0.0,0.0
22319,2,2319,[318 427 496 357 257],716,5,10486,4.519827586206897,60.0,0.0
22320,2,2320,[357  22 135 187 385],716,2,10488,4.518741921585524,0.0,0.0
22321,2,2321,[318 427 496 357 257],796,5,10493,4.518949181739879,60.0,0.0
22322,2,2322,[318 427 496 357 257],796,5,10498,4.519156263452432,60.0,0.0
22323,2,2323,[318 427 496 357 257],796,5,10503,4.519363166953529,60.0,0.0
22324,2,2324,[318 427 496 357 257],716,5,10508,4.519569892473118,60.0,0.0
22325,2,2325,[318 427 496 357 257],716,5,10513,4.519776440240757,60.0,0.0
22326,2,2326,[318 427 496 357 257],330,5,10518,4.519982810485604,60.0,0.0
22327,2,2327,[318 427 496 357 257],330,5,10523,4.5201890034364265,60.0,0.0
22328,2,2328,[197 282 111 748 117],292,4,10527,4.519965650493774,0.0,0.0
22329,2,2329,[318 427 496 357 257],796,5,10532,4.520171673819743,60.0,0.0
22330,2,2330,[318 427 496 357 257],330,5,10537,4.5203775203775205,60.0,0.0
22331,2,2331,[318 427 496 357 257],330,5,10542,4.520583190394511,60.0,0.0
22332,2,2332,[318 427 496 357 257],330,5,10547,4.520788684097728,60.0,0.0
22333,2,2333,[318 427 496 357 257],796,5,10552,4.520994001713796,60.0,0.0
22334,2,2334,[300 238 173 151 301],450,5,10557,4.521199143468951,0.0,0.0
22335,2,2335,[435 603 215  97 273],450,4,10561,4.520976027397261,20.0,0.0
22336,2,2336,[318 427 496 357 257],796,5,10566,4.521181001283697,60.0,0.0
22337,2,2337,[ 95 405   4 385 183],786,5,10571,4.521385799828914,0.0,0.0
22338,2,2338,[258  79 210 143 215],655,2,10573,4.520307823856349,0.0,0.0
22339,2,2339,[318 427 496 357 257],716,5,10578,4.52051282051282,60.0,0.0
22340,2,2340,[183 182 197   8 168],796,4,10582,4.520290474156344,0.0,0.0
22341,2,2341,[318 427 496 357 257],330,5,10587,4.520495303159692,60.0,0.0
22342,2,2342,[318 427 496 357 257],716,5,10592,4.5206999573196756,60.0,0.0
22343,2,2343,[318 427 496 357 257],716,5,10597,4.520904436860068,60.0,0.0
22344,2,2344,[235   1 132 427 172],716,4,10601,4.5206823027718555,20.0,0.0
22345,2,2345,[318 427 496 357 257],330,5,10606,4.520886615515772,60.0,0.0
22346,2,2346,[318 427 496 357 257],330,5,10611,4.5210907541542396,60.0,0.0
22347,2,2347,[318 427 496 357 257],716,5,10616,4.521294718909711,60.0,0.0
22348,2,2348,[200 289 655  97 143],236,3,10619,4.520647083865475,0.0,0.0
22349,2,2349,[318 427 496 357 257],330,5,10624,4.520851063829787,60.0,0.0
22350,2,2350,[257 216  96  69   7],457,4,10628,4.5206295193534665,0.0,0.0
22351,2,2351,[ 98 282  56  95 161],716,3,10631,4.519982993197279,0.0,0.0
22352,2,2352,[318 427 496 357 257],330,5,10636,4.520186995325117,60.0,0.0
22353,2,2353,[318 427 496 357 257],330,5,10641,4.520390824129142,60.0,0.0
22354,2,2354,[318 427 496 357 257],330,5,10646,4.520594479830149,60.0,0.0
22355,2,2355,[318 427 496 357 257],716,5,10651,4.520797962648557,60.0,0.0
22356,2,2356,[318 427 496 357 257],796,5,10656,4.521001272804412,60.0,0.0
22357,2,2357,[318 427 496 357 257],330,5,10661,4.521204410517387,60.0,0.0
22358,2,2358,[546 144  22  96 357],450,5,10666,4.521407376006782,0.0,0.0
22359,2,2359,[318 427 496 357 257],716,5,10671,4.521610169491526,60.0,0.0
22360,2,2360,[318 427 496 357 257],716,5,10676,4.5218127911901735,60.0,0.0
22361,2,2361,[318 427 496 357 257],716,5,10681,4.522015241320914,60.0,0.0
22362,2,2362,[318 427 496 357 257],330,5,10686,4.522217520101566,60.0,0.0
22363,2,2363,[318 427 496 357 257],716,5,10691,4.522419627749577,60.0,0.0
22364,2,2364,[318 427 496 357 257],330,5,10696,4.52262156448203,60.0,0.0
22365,2,2365,[265 435  64 127 276],629,5,10701,4.522823330515638,20.0,20.0
22366,2,2366,[237 185 238  12 289],655,1,10702,4.521335023236164,0.0,0.0
22367,2,2367,[191   9  28  64 328],796,3,10705,4.5206925675675675,20.0,0.0
22368,2,2368,[318 427 496 357 257],796,5,10710,4.520894892359645,60.0,0.0
22369,2,2369,[318 427 496 357 257],330,5,10715,4.5210970464135025,60.0,0.0
22370,2,2370,[483  89 275 118 273],655,4,10719,4.520877266975959,0.0,20.0
22371,2,2371,[318 427 496 357 257],330,5,10724,4.5210792580101185,60.0,0.0
22372,2,2372,[318 427 496 357 257],796,5,10729,4.521281078803202,60.0,0.0
22373,2,2373,[172  50 300 385 202],151,4,10733,4.52106149957877,0.0,20.0
22374,2,2374,[318 427 496 357 257],330,5,10738,4.521263157894737,60.0,0.0
22375,2,2375,[200  98 323   9 125],796,3,10741,4.520622895622895,0.0,0.0
22376,2,2376,[403 176 257  64 515],655,2,10743,4.519562473706353,20.0,0.0
22377,2,2377,[322 427 174 196 328],450,5,10748,4.519764507989907,20.0,0.0
22378,2,2378,[318 427 496 357 257],716,5,10753,4.5199663724253885,60.0,0.0
22379,2,2379,[748 132 211 258 202],796,4,10757,4.519747899159664,0.0,0.0
22380,2,2380,[318 427 496 357 257],716,5,10762,4.51994960100798,60.0,0.0
22381,2,2381,[186  28   7 143  70],151,5,10767,4.520151133501259,0.0,0.0
22382,2,2382,[318 427 496 357 257],716,5,10772,4.5203524968527065,60.0,0.0
22383,2,2383,[318 427 496 357 257],796,5,10777,4.520553691275167,60.0,0.0
22384,2,2384,[318 427 496 357 257],796,5,10782,4.520754716981132,60.0,0.0
22385,2,2385,[318 427 496 357 257],716,5,10787,4.520955574182732,60.0,0.0
22386,2,2386,[318 427 496 357 257],796,5,10792,4.521156263091747,60.0,0.0
22387,2,2387,[318 427 496 357 257],330,5,10797,4.521356783919598,60.0,0.0
22388,2,2388,[318 427 496 357 257],796,5,10802,4.521557136877354,60.0,0.0
22389,2,2389,[318 427 496 357 257],796,5,10807,4.521757322175732,60.0,0.0
22390,2,2390,[318 427 496 357 257],330,5,10812,4.521957340025094,60.0,0.0
22391,2,2391,[318 427 496 357 257],796,5,10817,4.522157190635451,60.0,0.0
22392,2,2392,[318 427 496 357 257],796,5,10822,4.522356874216465,60.0,0.0
22393,2,2393,[143 196 161 216   1],401,3,10825,4.52172096908939,0.0,0.0
22394,2,2394,[318 427 496 357 257],716,5,10830,4.521920668058455,60.0,0.0
22395,2,2395,[318 427 496 357 257],796,5,10835,4.52212020033389,60.0,0.0
22396,2,2396,[405  25 153 151  98],450,4,10839,4.521902377972466,0.0,0.0
22397,2,2397,[318 427 496 357 257],716,5,10844,4.52210175145955,60.0,0.0
22398,2,2398,[318 427 496 357 257],716,5,10849,4.522300958732806,60.0,0.0
22399,2,2399,[318 427 496 357 257],330,5,10854,4.5225,60.0,0.0
22400,2,2400,[318 427 496 357 257],796,5,10859,4.522698875468555,60.0,0.0
22401,2,2401,[405 655 269 144 302],450,5,10864,4.522897585345546,0.0,0.0
22402,2,2402,[318 427 496 357 257],796,5,10869,4.523096129837703,60.0,0.0
22403,2,2403,[318 427 496 357 257],330,5,10874,4.523294509151414,60.0,0.0
22404,2,2404,[318 427 496 357 257],796,5,10879,4.523492723492724,60.0,0.0
22405,2,2405,[318 427 496 357 257],716,5,10884,4.523690773067331,60.0,0.0
22406,2,2406,[318 427 496 357 257],716,5,10889,4.523888658080598,60.0,0.0
22407,2,2407,[121 237  98 282 151],296,4,10893,4.523671096345515,0.0,0.0
22408,2,2408,[  1 423 515 282 333],655,1,10894,4.522208385222084,0.0,0.0
22409,2,2409,[318 427 496 357 257],796,5,10899,4.522406639004149,60.0,0.0
22410,2,2410,[318 427 496 357 257],330,5,10904,4.522604728328495,60.0,0.0
22411,2,2411,[318 427 496 357 257],716,5,10909,4.522802653399668,60.0,0.0
22412,2,2412,[144 496 200 237 215],450,4,10913,4.522585992540406,20.0,0.0
22413,2,2413,[318 427 496 357 257],716,5,10918,4.522783761391881,60.0,0.0
22414,2,2414,[318 427 496 357 257],330,5,10923,4.522981366459628,60.0,0.0
22415,2,2415,[318 427 496 357 257],796,5,10928,4.52317880794702,60.0,0.0
22416,2,2416,[318 427 496 357 257],796,5,10933,4.5233760860570955,60.0,0.0
22417,2,2417,[318 427 496 357 257],330,5,10938,4.523573200992556,60.0,0.0
22418,2,2418,[318 427 496 357 257],716,5,10943,4.523770152955767,60.0,0.0
22419,2,2419,[286 180 176 121 182],796,3,10946,4.523140495867769,0.0,20.0
22420,2,2420,[144  70 222 318  15],450,3,10949,4.522511358942586,20.0,0.0
22421,2,2421,[318 427 496 357 257],716,5,10954,4.522708505367465,60.0,0.0
22422,2,2422,[318 427 496 357 257],716,5,10959,4.522905489063145,60.0,0.0
22423,2,2423,[318 427 496 357 257],796,5,10964,4.523102310231023,60.0,0.0
22424,2,2424,[318 427 496 357 257],716,5,10969,4.523298969072165,60.0,0.0
22425,2,2425,[318 427 496 357 257],330,5,10974,4.523495465787304,60.0,0.0
22426,2,2426,[405  82 288 403 237],655,0,10974,4.521631644004945,0.0,0.0
22427,2,2427,[333 405 215  12 180],796,4,10978,4.521416803953872,0.0,0.0
22428,2,2428,[318 427 496 357 257],330,5,10983,4.521613832853026,60.0,0.0
22429,2,2429,[318 427 496 357 257],330,5,10988,4.521810699588477,60.0,0.0
22430,2,2430,[194  69 153 483 427],389,4,10992,4.5215960510078155,20.0,0.0
22431,2,2431,[318 427 496 357 257],716,5,10997,4.521792763157895,60.0,0.0
22432,2,2432,[318 427 496 357 257],796,5,11002,4.521989313604603,60.0,0.0
22433,2,2433,[318 427 496 357 257],796,5,11007,4.522185702547247,60.0,0.0
22434,2,2434,[318 427 496 357 257],716,5,11012,4.522381930184805,60.0,0.0
22435,2,2435,[318 427 496 357 257],330,5,11017,4.522577996715928,60.0,0.0
22436,2,2436,[318 427 496 357 257],716,5,11022,4.522773902338941,60.0,0.0
22437,2,2437,[318 427 496 357 257],716,5,11027,4.522969647251846,60.0,0.0
22438,2,2438,[318 427 496 357 257],716,5,11032,4.5231652316523165,60.0,0.0
22439,2,2439,[318 427 496 357 257],716,5,11037,4.523360655737705,60.0,0.0
22440,2,2440,[318 427 496 357 257],330,5,11042,4.523555919705039,60.0,0.0
22441,2,2441,[ 97  50 180 273 282],796,2,11044,4.5225225225225225,0.0,20.0
22442,2,2442,[318 427 496 357 257],716,5,11049,4.522717969709373,60.0,0.0
22443,2,2443,[181  98 496 187 238],269,4,11053,4.522504091653028,20.0,0.0
22444,2,2444,[318 427 496 357 257],716,5,11058,4.522699386503067,60.0,0.0
22445,2,2445,[318 427 496 357 257],796,5,11063,4.52289452166803,60.0,0.0
22446,2,2446,[318 427 496 357 257],330,5,11068,4.523089497343686,60.0,0.0
22447,2,2447,[ 56 180 435 269 357],535,3,11071,4.522467320261438,0.0,0.0
22448,2,2448,[318 427 496 357 257],330,5,11076,4.522662311147407,60.0,0.0
22449,2,2449,[318 427 496 357 257],330,5,11081,4.522857142857143,60.0,0.0
22450,2,2450,[318 427 496 357 257],796,5,11086,4.523051815585475,60.0,0.0
22451,2,2451,[318 427 496 357 257],796,5,11091,4.523246329526917,60.0,0.0
22452,2,2452,[318 427 496 357 257],330,5,11096,4.523440684875663,60.0,0.0
22453,2,2453,[318 427 496 357 257],716,5,11101,4.523634881825591,60.0,0.0
22454,2,2454,[318 427 496 357 257],330,5,11106,4.523828920570264,60.0,0.0
22455,2,2455,[318 427 496 357 257],796,5,11111,4.524022801302932,60.0,0.0
22456,2,2456,[153 216   9 118   8],593,3,11114,4.523402523402523,0.0,0.0
22457,2,2457,[197   1  82 173 174],280,1,11115,4.521969080553295,0.0,0.0
22458,2,2458,[318 427 496 357 257],330,5,11120,4.522163481089874,60.0,0.0
22459,2,2459,[318 427 496 357 257],330,5,11125,4.522357723577236,60.0,0.0
22460,2,2460,[318 427 496 357 257],330,5,11130,4.522551808208045,60.0,0.0
22461,2,2461,[318 427 496 357 257],330,5,11135,4.522745735174655,60.0,0.0
22462,2,2462,[318 427 496 357 257],796,5,11140,4.522939504669103,60.0,0.0
22463,2,2463,[282 174 328 186 215],450,4,11144,4.5227272727272725,0.0,0.0
22464,2,2464,[318 427 496 357 257],796,5,11149,4.522920892494929,60.0,0.0
22465,2,2465,[318 427 496 357 257],330,5,11154,4.523114355231144,60.0,0.0
22466,2,2466,[318 427 496 357 257],716,5,11159,4.523307661126875,60.0,0.0
22467,2,2467,[ 96 742  79  69 125],796,4,11163,4.523095623987034,0.0,0.0
22468,2,2468,[318 427 496 357 257],716,5,11168,4.5232887808829485,60.0,0.0
22469,2,2469,[318 427 496 357 257],716,5,11173,4.5234817813765185,60.0,0.0
22470,2,2470,[318 427 496 357 257],796,5,11178,4.523674625657629,60.0,0.0
22471,2,2471,[318 427 496 357 257],330,5,11183,4.523867313915858,60.0,0.0
22472,2,2472,[118  64 181  56 508],693,1,11184,4.522442377678932,20.0,0.0
22473,2,2473,[318 427 496 357 257],330,5,11189,4.522635408245756,60.0,0.0
22474,2,2474,[318 427 496 357 257],796,5,11194,4.522828282828283,60.0,0.0
22475,2,2475,[318 427 496 357 257],330,5,11199,4.523021001615509,60.0,0.0
22476,2,2476,[318 427 496 357 257],796,5,11204,4.523213564796125,60.0,0.0
22477,2,2477,[318 427 496 357 257],330,5,11209,4.523405972558515,60.0,0.0
22478,2,2478,[  1 151  89 127  15],256,5,11214,4.523598225090763,0.0,20.0
22479,2,2479,[318 427 496 357 257],716,5,11219,4.523790322580645,60.0,0.0
22480,2,2480,[210 603 294 328 127],401,3,11222,4.523176138653769,20.0,20.0
22481,2,2481,[318 427 496 357 257],716,5,11227,4.523368251410153,60.0,0.0
22482,2,2482,[318 427 496 357 257],330,5,11232,4.523560209424084,60.0,0.0
22483,2,2483,[318 427 496 357 257],330,5,11237,4.523752012882448,60.0,0.0
22484,2,2484,[318 427 496 357 257],796,5,11242,4.523943661971831,60.0,0.0
22485,2,2485,[318 427 496 357 257],330,5,11247,4.524135156878519,60.0,0.0
22486,2,2486,[ 50 125  82 132 515],655,2,11249,4.523120225170889,0.0,20.0
22487,2,2487,[176 200 210   4 286],796,3,11252,4.522508038585209,0.0,20.0
22488,2,2488,[322 210 234  50  89],256,5,11257,4.522699879469666,0.0,20.0
22489,2,2489,[318 427 496 357 257],716,5,11262,4.52289156626506,60.0,0.0
22490,2,2490,[588  50 210 423  79],796,4,11266,4.522681653954235,0.0,20.0
22491,2,2491,[318 427 496 357 257],716,5,11271,4.522873194221509,60.0,0.0
22492,2,2492,[318 427 496 357 257],330,5,11276,4.523064580826314,60.0,0.0
22493,2,2493,[318 427 496 357 257],716,5,11281,4.523255813953488,60.0,0.0
22494,2,2494,[318 427 496 357 257],330,5,11286,4.523446893787575,60.0,0.0
22495,2,2495,[546 187 176 117  96],716,1,11287,4.522035256410256,0.0,0.0
22496,2,2496,[318 427 496 357 257],716,5,11292,4.522226672006408,60.0,0.0
22497,2,2497,[318 427 496 357 257],330,5,11297,4.522417934347478,60.0,0.0
22498,2,2498,[318 427 496 357 257],716,5,11302,4.522609043617447,60.0,0.0
22499,2,2499,[318 427 496 357 257],330,5,11307,4.5228,60.0,0.0
22500,2,2500,[ 50 568 258 135  97],693,4,11311,4.5225909636145545,0.0,20.0
22501,2,2501,[318 427 496 357 257],796,5,11316,4.522781774580336,60.0,0.0
22502,2,2502,[318 427 496 357 257],330,5,11321,4.522972433080303,60.0,0.0
22503,2,2503,[318 427 496 357 257],330,5,11326,4.523162939297125,60.0,0.0
22504,2,2504,[318 427 496 357 257],796,5,11331,4.523353293413174,60.0,0.0
22505,2,2505,[423  56 135 143   7],655,2,11333,4.522346368715084,0.0,0.0
22506,2,2506,[318 427 496 357 257],716,5,11338,4.52253689668927,60.0,0.0
22507,2,2507,[318 427 496 357 257],330,5,11343,4.5227272727272725,60.0,0.0
22508,2,2508,[318 427 496 357 257],716,5,11348,4.522917497010761,60.0,0.0
22509,2,2509,[318 427 496 357 257],330,5,11353,4.523107569721115,60.0,0.0
22510,2,2510,[318 427 496 357 257],330,5,11358,4.523297491039426,60.0,0.0
22511,2,2511,[318 427 496 357 257],716,5,11363,4.523487261146497,60.0,0.0
22512,2,2512,[194 125  12 483 357],151,5,11368,4.523676880222841,0.0,0.0
22513,2,2513,[318 427 496 357 257],796,5,11373,4.523866348448688,60.0,0.0
22514,2,2514,[318 427 496 357 257],330,5,11378,4.524055666003976,60.0,0.0
22515,2,2515,[318 427 496 357 257],796,5,11383,4.524244833068362,60.0,0.0
22516,2,2516,[318 427 496 357 257],716,5,11388,4.524433849821215,60.0,0.0
22517,2,2517,[318 427 496 357 257],330,5,11393,4.524622716441621,60.0,0.0
22518,2,2518,[318 427 496 357 257],796,5,11398,4.524811433108376,60.0,0.0
22519,2,2519,[318 427 496 357 257],716,5,11403,4.525,60.0,0.0
22520,2,2520,[ 89 546  96 222 496],344,4,11407,4.524791749305831,20.0,0.0
22521,2,2521,[318 427 496 357 257],796,5,11412,4.5249801744647105,60.0,0.0
22522,2,2522,[174 181 546 204 289],807,5,11417,4.52516845025763,0.0,0.0
22523,2,2523,[318 427 496 357 257],796,5,11422,4.525356576862124,60.0,0.0
22524,2,2524,[318 427 496 357 257],716,5,11427,4.525544554455445,60.0,0.0
22525,2,2525,[318 427 496 357 257],796,5,11432,4.525732383214568,60.0,0.0
22526,2,2526,[318 427 496 357 257],716,5,11437,4.525920063316185,60.0,0.0
22527,2,2527,[318 427 496 357 257],796,5,11442,4.5261075949367084,60.0,0.0
22528,2,2528,[318 427 496 357 257],330,5,11447,4.526294978252274,60.0,0.0
22529,2,2529,[186   4 161  69 181],504,3,11450,4.525691699604743,0.0,0.0
22530,2,2530,[153 181  22 245  15],450,4,11454,4.525483998419597,0.0,0.0
22531,2,2531,[318 427 496 357 257],330,5,11459,4.52567140600316,60.0,0.0
22532,2,2532,[655 204 588  79 294],796,3,11462,4.5250690880379,0.0,0.0
22533,2,2533,[318 427 496 357 257],716,5,11467,4.525256511444357,60.0,0.0
22534,2,2534,[318 427 496 357 257],716,5,11472,4.525443786982248,60.0,0.0
22535,2,2535,[318 427 496 357 257],330,5,11477,4.525630914826499,60.0,0.0
22536,2,2536,[318 427 496 357 257],330,5,11482,4.5258178951517545,60.0,0.0
22537,2,2537,[318 427 496 357 257],796,5,11487,4.526004728132388,60.0,0.0
22538,2,2538,[318 427 496 357 257],330,5,11492,4.526191413942497,60.0,0.0
22539,2,2539,[318 427 496 357 257],716,5,11497,4.526377952755905,60.0,0.0
22540,2,2540,[568 238 211 197 174],655,0,11497,4.524596615505707,0.0,0.0
22541,2,2541,[318 427 496 357 257],716,5,11502,4.524783634933123,60.0,0.0
22542,2,2542,[132 153 275 196 323],23,3,11505,4.524184034604797,0.0,20.0
22543,2,2543,[318 427 496 357 257],796,5,11510,4.52437106918239,60.0,0.0
22544,2,2544,[318 427 496 357 257],796,5,11515,4.524557956777996,60.0,0.0
22545,2,2545,[ 79 603 300  64 117],450,5,11520,4.524744697564808,40.0,0.0
22546,2,2546,[234 174  25 318 135],457,5,11525,4.524931291715744,20.0,0.0
22547,2,2547,[318 427 496 357 257],716,5,11530,4.525117739403454,60.0,0.0
22548,2,2548,[318 427 496 357 257],796,5,11535,4.525304040800314,60.0,0.0
22549,2,2549,[318 427 496 357 257],330,5,11540,4.525490196078431,60.0,0.0
22550,2,2550,[318 427 496 357 257],796,5,11545,4.525676205409643,60.0,0.0
22551,2,2551,[318 427 496 357 257],330,5,11550,4.525862068965517,60.0,0.0
22552,2,2552,[318 427 496 357 257],796,5,11555,4.526047786917352,60.0,0.0
22553,2,2553,[318 427 496 357 257],716,5,11560,4.526233359436178,60.0,0.0
22554,2,2554,[318 427 496 357 257],330,5,11565,4.526418786692759,60.0,0.0
22555,2,2555,[318 427 496 357 257],716,5,11570,4.52660406885759,60.0,0.0
22556,2,2556,[318 427 496 357 257],716,5,11575,4.5267892061009,60.0,0.0
22557,2,2557,[174 427 200 197 183],942,4,11579,4.526583268178264,20.0,0.0
22558,2,2558,[318 427 496 357 257],716,5,11584,4.5267682688550215,60.0,0.0
22559,2,2559,[174 275 471  69 313],593,3,11587,4.526171875,0.0,20.0
22560,2,2560,[318 427 496 357 257],796,5,11592,4.526356891839125,60.0,0.0
22561,2,2561,[127   1 187 143 257],835,3,11595,4.52576112412178,0.0,20.0
22562,2,2562,[318 427 496 357 257],716,5,11600,4.525946156847445,60.0,0.0
22563,2,2563,[318 427 496 357 257],796,5,11605,4.52613104524181,60.0,0.0
22564,2,2564,[194 603 202 357  97],731,4,11609,4.525925925925926,20.0,0.0
22565,2,2565,[318 427 496 357 257],796,5,11614,4.526110678098207,60.0,0.0
22566,2,2566,[318 427 496 357 257],796,5,11619,4.526295286326451,60.0,0.0
22567,2,2567,[265 403 546 202 125],457,4,11623,4.526090342679128,0.0,0.0
22568,2,2568,[318 427 496 357 257],330,5,11628,4.526274815103153,60.0,0.0
22569,2,2569,[318 427 496 357 257],716,5,11633,4.5264591439688715,60.0,0.0
22570,2,2570,[318 427 496 357 257],330,5,11638,4.526643329443796,60.0,0.0
22571,2,2571,[ 82  95 405 196   1],450,3,11641,4.526049766718507,0.0,0.0
22572,2,2572,[318 427 496 357 257],330,5,11646,4.526233968130587,60.0,0.0
22573,2,2573,[405  89 121 258 100],457,5,11651,4.5264180264180265,0.0,20.0
22574,2,2574,[318 427 496 357 257],330,5,11656,4.526601941747573,60.0,0.0
22575,2,2575,[483 194 200  50 172],450,3,11659,4.526009316770186,0.0,20.0
22576,2,2576,[301 179 268 234 185],655,2,11661,4.525029103608848,0.0,0.0
22577,2,2577,[318 427 496 357 257],330,5,11666,4.525213343677269,60.0,0.0
22578,2,2578,[318 427 496 357 257],330,5,11671,4.525397440868554,60.0,0.0
22579,2,2579,[318 427 496 357 257],796,5,11676,4.525581395348837,60.0,0.0
22580,2,2580,[ 69 273 204 258  28],450,4,11680,4.525377760557923,0.0,0.0
22581,2,2581,[318 427 496 357 257],796,5,11685,4.52556158017041,60.0,0.0
22582,2,2582,[318 427 496 357 257],796,5,11690,4.5257452574525745,60.0,0.0
22583,2,2583,[318 427 496 357 257],796,5,11695,4.525928792569659,60.0,0.0
22584,2,2584,[318 427 496 357 257],330,5,11700,4.526112185686654,60.0,0.0
22585,2,2585,[318 427 496 357 257],716,5,11705,4.526295436968291,60.0,0.0
22586,2,2586,[111 173 168 176 282],450,5,11710,4.526478546579049,0.0,0.0
22587,2,2587,[318 427 496 357 257],796,5,11715,4.526661514683153,60.0,0.0
22588,2,2588,[318 427 496 357 257],796,5,11720,4.526844341444574,60.0,0.0
22589,2,2589,[228 475  70   9 111],655,0,11720,4.525096525096525,0.0,0.0
22590,2,2590,[318 427 496 357 257],330,5,11725,4.525279814743342,60.0,0.0
22591,2,2591,[318 427 496 357 257],796,5,11730,4.525462962962963,60.0,0.0
22592,2,2592,[269 546 237  56 180],796,3,11733,4.524874662553027,0.0,0.0
22593,2,2593,[318 427 496 357 257],716,5,11738,4.525057825751735,60.0,0.0
22594,2,2594,[655 204 181 197 117],457,5,11743,4.5252408477842,0.0,0.0
22595,2,2595,[318 427 496 357 257],796,5,11748,4.52542372881356,60.0,0.0
22596,2,2596,[357 265 234 427 121],151,5,11753,4.525606469002695,20.0,0.0
22597,2,2597,[318 427 496 357 257],716,5,11758,4.525789068514242,60.0,0.0
22598,2,2598,[318 427 496 357 257],716,5,11763,4.525971527510581,60.0,0.0
22599,2,2599,[318 427 496 357 257],330,5,11768,4.526153846153846,60.0,0.0
22600,2,2600,[318 427 496 357 257],330,5,11773,4.5263360246059205,60.0,0.0
22601,2,2601,[318 427 496 357 257],716,5,11778,4.52651806302844,60.0,0.0
22602,2,2602,[318 427 496 357 257],796,5,11783,4.526699961582789,60.0,0.0
22603,2,2603,[318 427 496 357 257],716,5,11788,4.526881720430108,60.0,0.0
22604,2,2604,[318 427 496 357 257],330,5,11793,4.527063339731286,60.0,0.0
22605,2,2605,[318 427 496 357 257],716,5,11798,4.527244819646969,60.0,0.0
22606,2,2606,[318 427 496 357 257],796,5,11803,4.527426160337553,60.0,0.0
22607,2,2607,[318 427 496 357 257],330,5,11808,4.52760736196319,60.0,0.0
22608,2,2608,[318 427 496 357 257],796,5,11813,4.527788424683787,60.0,0.0
22609,2,2609,[318 427 496 357 257],716,5,11818,4.527969348659004,60.0,0.0
22610,2,2610,[318 427 496 357 257],796,5,11823,4.528150134048257,60.0,0.0
22611,2,2611,[318 427 496 357 257],716,5,11828,4.52833078101072,60.0,0.0
22612,2,2612,[210 181 235  98 269],344,3,11831,4.527745885954841,0.0,0.0
22613,2,2613,[180 211 357 588 153],796,3,11834,4.527161438408569,0.0,0.0
22614,2,2614,[318 427 496 357 257],796,5,11839,4.527342256214149,60.0,0.0
22615,2,2615,[318 427 496 357 257],330,5,11844,4.527522935779817,60.0,0.0
22616,2,2616,[318 427 496 357 257],330,5,11849,4.527703477264043,60.0,0.0
22617,2,2617,[318 427 496 357 257],330,5,11854,4.527883880825057,60.0,0.0
22618,2,2618,[318 427 496 357 257],716,5,11859,4.5280641466208476,60.0,0.0
22619,2,2619,[318 427 496 357 257],330,5,11864,4.52824427480916,60.0,0.0
22620,2,2620,[318 427 496 357 257],796,5,11869,4.528424265547501,60.0,0.0
22621,2,2621,[313 276 237  71   4],280,2,11871,4.52745995423341,0.0,0.0
22622,2,2622,[194  71 151  96 183],504,3,11874,4.526877621044606,0.0,0.0
22623,2,2623,[318 427 496 357 257],716,5,11879,4.5270579268292686,60.0,0.0
22624,2,2624,[ 22 678 127 471 185],256,5,11884,4.527238095238095,0.0,20.0
22625,2,2625,[318 427 496 357 257],330,5,11889,4.527418126428027,60.0,0.0
22626,2,2626,[ 15 234 195  79  69],72,5,11894,4.527598020555767,0.0,0.0
22627,2,2627,[318 427 496 357 257],330,5,11899,4.527777777777778,60.0,0.0
22628,2,2628,[318 427 496 357 257],716,5,11904,4.527957398250285,60.0,0.0
22629,2,2629,[318 427 496 357 257],796,5,11909,4.528136882129278,60.0,0.0
22630,2,2630,[318 427 496 357 257],330,5,11914,4.528316229570506,60.0,0.0
22631,2,2631,[318 427 496 357 257],796,5,11919,4.5284954407294835,60.0,0.0
22632,2,2632,[318 427 496 357 257],330,5,11924,4.528674515761489,60.0,0.0
22633,2,2633,[318 427 496 357 257],716,5,11929,4.528853454821564,60.0,0.0
22634,2,2634,[318 427 496 357 257],716,5,11934,4.529032258064516,60.0,0.0
22635,2,2635,[318 427 496 357 257],716,5,11939,4.529210925644916,60.0,0.0
22636,2,2636,[318 427 496 357 257],330,5,11944,4.5293894577171026,60.0,0.0
22637,2,2637,[742 153  88 258 135],450,4,11948,4.529188779378317,0.0,0.0
22638,2,2638,[318 427 496 357 257],716,5,11953,4.529367184539598,60.0,0.0
22639,2,2639,[318 427 496 357 257],330,5,11958,4.529545454545454,60.0,0.0
22640,2,2640,[318 427 496 357 257],796,5,11963,4.5297235895494135,60.0,0.0
22641,2,2641,[135 546  70 301 168],151,4,11967,4.529523088569266,0.0,0.0
22642,2,2642,[318 427 496 357 257],796,5,11972,4.529701097237987,60.0,0.0
22643,2,2643,[318 427 496 357 257],716,5,11977,4.529878971255673,60.0,0.0
22644,2,2644,[125  11 182 742 127],436,5,11982,4.530056710775047,0.0,20.0
22645,2,2645,[318 427 496 357 257],716,5,11987,4.530234315948602,60.0,0.0
22646,2,2646,[318 427 496 357 257],330,5,11992,4.530411786928599,60.0,0.0
22647,2,2647,[318 427 496 357 257],716,5,11997,4.5305891238670695,60.0,0.0
22648,2,2648,[197 496 300  64 195],151,4,12001,4.530388825972065,40.0,0.0
22649,2,2649,[318 427 496 357 257],330,5,12006,4.530566037735849,60.0,0.0
22650,2,2650,[151 196 238 127 118],716,4,12010,4.530365899660506,0.0,20.0
22651,2,2651,[318 427 496 357 257],330,5,12015,4.530542986425339,60.0,0.0
22652,2,2652,[318 427 496 357 257],796,5,12020,4.530719939690916,60.0,0.0
22653,2,2653,[678 235  88 228 508],280,1,12021,4.5293896006028636,0.0,0.0
22654,2,2654,[318 427 496 357 257],330,5,12026,4.529566854990584,60.0,0.0
22655,2,2655,[318 427 496 357 257],330,5,12031,4.529743975903615,60.0,0.0
22656,2,2656,[318 427 496 357 257],716,5,12036,4.5299209634926605,60.0,0.0
22657,2,2657,[318 427 496 357 257],330,5,12041,4.530097817908202,60.0,0.0
22658,2,2658,[318 427 496 357 257],330,5,12046,4.530274539300489,60.0,0.0
22659,2,2659,[318 427 496 357 257],716,5,12051,4.530451127819549,60.0,0.0
22660,2,2660,[318 427 496 357 257],330,5,12056,4.530627583615182,60.0,0.0
22661,2,2661,[168 204 175  50 435],18,3,12059,4.530052592036063,0.0,20.0
22662,2,2662,[ 69  88 211 385 276],655,1,12060,4.528726999624483,0.0,0.0
22663,2,2663,[318 427 496 357 257],796,5,12065,4.528903903903904,60.0,0.0
22664,2,2664,[318 427 496 357 257],716,5,12070,4.529080675422139,60.0,0.0
22665,2,2665,[318 427 496 357 257],330,5,12075,4.529257314328582,60.0,0.0
22666,2,2666,[318 427 496 357 257],716,5,12080,4.529433820772404,60.0,0.0
22667,2,2667,[197 172  96 200  88],450,4,12084,4.529235382308846,0.0,0.0
22668,2,2668,[318 427 496 357 257],796,5,12089,4.529411764705882,60.0,0.0
22669,2,2669,[318 427 496 357 257],330,5,12094,4.5295880149812735,60.0,0.0
22670,2,2670,[318 427 496 357 257],330,5,12099,4.529764133283415,60.0,0.0
22671,2,2671,[318 427 496 357 257],716,5,12104,4.529940119760479,60.0,0.0
22672,2,2672,[318 427 496 357 257],330,5,12109,4.530115974560419,60.0,0.0
22673,2,2673,[318 427 496 357 257],330,5,12114,4.530291697830965,60.0,0.0
22674,2,2674,[318 427 496 357 257],330,5,12119,4.530467289719626,60.0,0.0
22675,2,2675,[318 427 496 357 257],330,5,12124,4.530642750373692,60.0,0.0
22676,2,2676,[318 427 496 357 257],716,5,12129,4.530818079940231,60.0,0.0
22677,2,2677,[318 427 496 357 257],796,5,12134,4.530993278566094,60.0,0.0
22678,2,2678,[318 427 496 357 257],716,5,12139,4.5311683463979096,60.0,0.0
22679,2,2679,[318 427 496 357 257],330,5,12144,4.53134328358209,60.0,0.0
22680,2,2680,[282 385  70  11  50],655,1,12145,4.530026109660574,0.0,20.0
22681,2,2681,[655 357 546 195 172],23,2,12147,4.529082774049217,0.0,0.0
22682,2,2682,[168 185  70  79 176],5,1,12148,4.527767424524786,0.0,0.0
22683,2,2683,[318 427 496 357 257],796,5,12153,4.5279433681073025,60.0,0.0
22684,2,2684,[318 427 496 357 257],716,5,12158,4.528119180633147,60.0,0.0
22685,2,2685,[318 427 496 357 257],330,5,12163,4.528294862248697,60.0,0.0
22686,2,2686,[318 427 496 357 257],796,5,12168,4.528470413100112,60.0,0.0
22687,2,2687,[318 427 496 357 257],330,5,12173,4.528645833333333,60.0,0.0
22688,2,2688,[318 427 496 357 257],330,5,12178,4.528821123094087,60.0,0.0
22689,2,2689,[318 427 496 357 257],796,5,12183,4.528996282527881,60.0,0.0
22690,2,2690,[318 427 496 357 257],796,5,12188,4.529171311780008,60.0,0.0
22691,2,2691,[318 427 496 357 257],330,5,12193,4.529346210995542,60.0,0.0
22692,2,2692,[318 427 496 357 257],330,5,12198,4.529520980319346,60.0,0.0
22693,2,2693,[168 748 423 153  12],151,3,12201,4.528953229398664,0.0,0.0
22694,2,2694,[318 427 496 357 257],330,5,12206,4.529128014842301,60.0,0.0
22695,2,2695,[215 204 180 237 211],716,4,12210,4.528931750741839,0.0,0.0
22696,2,2696,[318 427 496 357 257],716,5,12215,4.5291064145346684,60.0,0.0
22697,2,2697,[318 427 496 357 257],716,5,12220,4.529280948851,60.0,0.0
22698,2,2698,[318 427 496 357 257],716,5,12225,4.529455353834754,60.0,0.0
22699,2,2699,[216 200 172 174 603],716,5,12230,4.529629629629629,20.0,0.0
22700,2,2700,[153  98 195  56  22],655,1,12231,4.5283228433913365,0.0,0.0
22701,2,2701,[216  70 111 265 132],716,5,12236,4.528497409326425,0.0,0.0
22702,2,2702,[318 427 496 357 257],796,5,12241,4.5286718460969295,60.0,0.0
22703,2,2703,[318 427 496 357 257],330,5,12246,4.528846153846154,60.0,0.0
22704,2,2704,[318 427 496 357 257],796,5,12251,4.529020332717191,60.0,0.0
22705,2,2705,[318 427 496 357 257],330,5,12256,4.5291943828529195,60.0,0.0
22706,2,2706,[ 56 143 144 423 168],796,5,12261,4.5293683043960105,0.0,0.0
22707,2,2707,[318 427 496 357 257],796,5,12266,4.529542097488922,60.0,0.0
22708,2,2708,[546 183 515 318 228],716,3,12269,4.528977482465854,20.0,0.0
22709,2,2709,[318 427 496 357 257],716,5,12274,4.529151291512915,60.0,0.0
22710,2,2710,[318 427 496 357 257],716,5,12279,4.529324972334932,60.0,0.0
22711,2,2711,[173 237  15  88 144],450,4,12283,4.529129793510324,0.0,0.0
22712,2,2712,[318 427 496 357 257],796,5,12288,4.529303354220421,60.0,0.0
22713,2,2713,[318 427 496 357 257],330,5,12293,4.529476787030213,60.0,0.0
22714,2,2714,[318 427 496 357 257],330,5,12298,4.529650092081031,60.0,0.0
22715,2,2715,[318 427 496 357 257],330,5,12303,4.529823269513991,60.0,0.0
22716,2,2716,[318 427 496 357 257],796,5,12308,4.529996319470004,60.0,0.0
22717,2,2717,[318 427 496 357 257],796,5,12313,4.530169242089772,60.0,0.0
22718,2,2718,[282 276 483 269 215],535,3,12316,4.529606472968003,0.0,0.0
22719,2,2719,[269   4 215 235 275],450,3,12319,4.529044117647059,0.0,20.0
22720,2,2720,[318 427 496 357 257],716,5,12324,4.529217199558985,60.0,0.0
22721,2,2721,[ 22 265   7 588 742],457,5,12329,4.52939015429831,0.0,0.0
22722,2,2722,[318 427 496 357 257],796,5,12334,4.5295629820051415,60.0,0.0
22723,2,2723,[318 427 496 357 257],796,5,12339,4.529735682819383,60.0,0.0
22724,2,2724,[318 427 496 357 257],796,5,12344,4.529908256880734,60.0,0.0
22725,2,2725,[318 427 496 357 257],796,5,12349,4.530080704328687,60.0,0.0
22726,2,2726,[318 427 496 357 257],716,5,12354,4.53025302530253,60.0,0.0
22727,2,2727,[318 427 496 357 257],330,5,12359,4.530425219941349,60.0,0.0
22728,2,2728,[275 228 211 234 265],796,3,12362,4.529864419201172,0.0,20.0
22729,2,2729,[318 427 496 357 257],796,5,12367,4.53003663003663,60.0,0.0
22730,2,2730,[318 427 496 357 257],330,5,12372,4.530208714756499,60.0,0.0
22731,2,2731,[318 427 496 357 257],330,5,12377,4.530380673499268,60.0,0.0
22732,2,2732,[318 427 496 357 257],330,5,12382,4.53055250640322,60.0,0.0
22733,2,2733,[318 427 496 357 257],796,5,12387,4.530724213606438,60.0,0.0
22734,2,2734,[ 12 195 210 111 132],18,3,12390,4.530164533820841,0.0,0.0
22735,2,2735,[318 427 496 357 257],796,5,12395,4.5303362573099415,60.0,0.0
22736,2,2736,[200 215  95 265 185],450,3,12398,4.529777128242602,0.0,0.0
22737,2,2737,[318 427 496 357 257],796,5,12403,4.529948867786706,60.0,0.0
22738,2,2738,[318 427 496 357 257],796,5,12408,4.530120481927711,60.0,0.0
22739,2,2739,[318 427 496 357 257],716,5,12413,4.53029197080292,60.0,0.0
22740,2,2740,[318 427 496 357 257],796,5,12418,4.5304633345494345,60.0,0.0
22741,2,2741,[318 427 496 357 257],330,5,12423,4.530634573304158,60.0,0.0
22742,2,2742,[318 427 496 357 257],330,5,12428,4.530805687203792,60.0,0.0
22743,2,2743,[318 427 496 357 257],796,5,12433,4.53097667638484,60.0,0.0
22744,2,2744,[318 427 496 357 257],796,5,12438,4.531147540983606,60.0,0.0
22745,2,2745,[318 427 496 357 257],796,5,12443,4.5313182811361985,60.0,0.0
22746,2,2746,[151 742 322 237 187],450,5,12448,4.531488896978522,0.0,0.0
22747,2,2747,[318 427 496 357 257],716,5,12453,4.531659388646288,60.0,0.0
22748,2,2748,[  4 588 234 405 483],457,5,12458,4.531829756275009,0.0,0.0
22749,2,2749,[546 117  79 210 194],457,4,12462,4.5316363636363635,0.0,0.0
22750,2,2750,[318 427 496 357 257],796,5,12467,4.531806615776081,60.0,0.0
22751,2,2751,[318 427 496 357 257],330,5,12472,4.531976744186046,60.0,0.0
22752,2,2752,[318 427 496 357 257],716,5,12477,4.53214674900109,60.0,0.0
22753,2,2753,[228 471  70  56  95],280,3,12480,4.531590413943355,0.0,0.0
22754,2,2754,[318 427 496 357 257],330,5,12485,4.531760435571688,60.0,0.0
22755,2,2755,[385 117 111 742 603],450,5,12490,4.531930333817126,20.0,0.0
22756,2,2756,[215 275 269 144 151],23,2,12492,4.5310119695321,0.0,20.0
22757,2,2757,[182 197 300 655 257],796,3,12495,4.530456852791878,0.0,0.0
22758,2,2758,[ 95 132 197 222 423],786,4,12499,4.5302645886190644,0.0,0.0
22759,2,2759,[508 191 423 742  11],11,3,12502,4.529710144927536,0.0,0.0
22760,2,2760,[234  50 286  82 546],280,2,12504,4.528793915248099,0.0,40.0
22761,2,2761,[318 427 496 357 257],716,5,12509,4.52896451846488,60.0,0.0
22762,2,2762,[125  15 173 228   1],786,4,12513,4.528773072747014,0.0,0.0
22763,2,2763,[  4 222 179 228  70],457,5,12518,4.528943560057887,0.0,0.0
22764,2,2764,[597  79  89 222   4],457,4,12522,4.52875226039783,0.0,0.0
22765,2,2765,[318 427 496 357 257],716,5,12527,4.528922631959508,60.0,0.0
22766,2,2766,[318 427 496 357 257],716,5,12532,4.529092880375858,60.0,0.0
22767,2,2767,[318 427 496 357 257],716,5,12537,4.529263005780347,60.0,0.0
22768,2,2768,[318 427 496 357 257],716,5,12542,4.529433008306248,60.0,0.0
22769,2,2769,[204 318  12 301 183],151,4,12546,4.529241877256318,20.0,0.0
22770,2,2770,[318 427 496 357 257],716,5,12551,4.529411764705882,60.0,0.0
22771,2,2771,[318 427 496 357 257],330,5,12556,4.529581529581529,60.0,0.0
22772,2,2772,[318 427 496 357 257],330,5,12561,4.529751172015867,60.0,0.0
22773,2,2773,[318 427 496 357 257],330,5,12566,4.529920692141312,60.0,0.0
22774,2,2774,[288   7   1 174 195],457,5,12571,4.5300900900900904,0.0,0.0
22775,2,2775,[318 427 496 357 257],330,5,12576,4.530259365994237,60.0,0.0
22776,2,2776,[318 427 496 357 257],796,5,12581,4.530428519985596,60.0,0.0
22777,2,2777,[333  89 427 385 405],796,5,12586,4.530597552195824,20.0,0.0
22778,2,2778,[318 427 496 357 257],796,5,12591,4.530766462756387,60.0,0.0
22779,2,2779,[318 427 496 357 257],796,5,12596,4.530935251798561,60.0,0.0
22780,2,2780,[318 427 496 357 257],330,5,12601,4.531103919453434,60.0,0.0
22781,2,2781,[144 216 174 200 181],457,5,12606,4.531272465851905,0.0,0.0
22782,2,2782,[ 89 118  98   1 200],655,3,12609,4.530722242184693,0.0,0.0
22783,2,2783,[318 427 496 357 257],796,5,12614,4.530890804597701,60.0,0.0
22784,2,2784,[318 427 496 357 257],330,5,12619,4.531059245960503,60.0,0.0
22785,2,2785,[318 427 496 357 257],796,5,12624,4.531227566403445,60.0,0.0
22786,2,2786,[ 96 135 118 183 186],693,2,12626,4.530319339791891,0.0,0.0
22787,2,2787,[318 427 496 357 257],330,5,12631,4.530487804878049,60.0,0.0
22788,2,2788,[318 427 496 357 257],716,5,12636,4.530656149157404,60.0,0.0
22789,2,2789,[655  22  28 186 222],796,2,12638,4.5297491039426525,0.0,0.0
22790,2,2790,[318 427 496 357 257],330,5,12643,4.529917592260839,60.0,0.0
22791,2,2791,[318 427 496 357 257],330,5,12648,4.530085959885387,60.0,0.0
22792,2,2792,[318 427 496 357 257],796,5,12653,4.530254206945936,60.0,0.0
22793,2,2793,[318 427 496 357 257],796,5,12658,4.53042233357194,60.0,0.0
22794,2,2794,[597 143 127 135 588],450,4,12662,4.530232558139535,0.0,20.0
22795,2,2795,[318 427 496 357 257],330,5,12667,4.530400572246066,60.0,0.0
22796,2,2796,[132 405 313  89 655],655,2,12669,4.529495888451913,0.0,0.0
22797,2,2797,[ 82 385 117 258 257],655,0,12669,4.527877055039314,0.0,0.0
22798,2,2798,[318 427 496 357 257],796,5,12674,4.528045730618078,60.0,0.0
22799,2,2799,[318 427 496 357 257],716,5,12679,4.528214285714285,60.0,0.0
22800,2,2800,[216 191 496 423 405],151,3,12682,4.52766868975366,20.0,0.0
22801,2,2801,[318 427 496 357 257],796,5,12687,4.527837259100642,60.0,0.0
22802,2,2802,[318 427 496 357 257],796,5,12692,4.528005708169818,60.0,0.0
22803,2,2803,[318 427 496 357 257],796,5,12697,4.5281740370898715,60.0,0.0
22804,2,2804,[176 265 195 174 483],236,1,12698,4.5269162210338685,0.0,0.0
22805,2,2805,[318 427 496 357 257],716,5,12703,4.527084818246615,60.0,0.0
22806,2,2806,[ 89   8 143 195 286],18,3,12706,4.526540790879943,0.0,20.0
22807,2,2807,[318 427 496 357 257],716,5,12711,4.526709401709402,60.0,0.0
22808,2,2808,[ 56 215  98  89 196],450,5,12716,4.52687789248843,0.0,0.0
22809,2,2809,[318 427 496 357 257],330,5,12721,4.527046263345196,60.0,0.0
22810,2,2810,[318 427 496 357 257],330,5,12726,4.527214514407684,60.0,0.0
22811,2,2811,[318 427 496 357 257],716,5,12731,4.527382645803699,60.0,0.0
22812,2,2812,[318 427 496 357 257],716,5,12736,4.527550657660861,60.0,0.0
22813,2,2813,[318 427 496 357 257],330,5,12741,4.52771855010661,60.0,0.0
22814,2,2814,[127 258  15 181   9],655,1,12742,4.5264653641207815,0.0,20.0
22815,2,2815,[318 427 496 357 257],330,5,12747,4.5266335227272725,60.0,0.0
22816,2,2816,[318 427 496 357 257],796,5,12752,4.526801561945332,60.0,0.0
22817,2,2817,[318 427 496 357 257],716,5,12757,4.526969481902058,60.0,0.0
22818,2,2818,[318 427 496 357 257],716,5,12762,4.527137282724371,60.0,0.0
22819,2,2819,[202 179 568  64 183],577,3,12765,4.526595744680851,20.0,0.0
22820,2,2820,[318 427 496 357 257],716,5,12770,4.5267635590216235,60.0,0.0
22821,2,2821,[318 427 496 357 257],716,5,12775,4.526931254429483,60.0,0.0
22822,2,2822,[318 427 496 357 257],716,5,12780,4.527098831030818,60.0,0.0
22823,2,2823,[318 427 496 357 257],330,5,12785,4.527266288951841,60.0,0.0
22824,2,2824,[132 275 234  95   4],796,4,12789,4.527079646017699,0.0,20.0
22825,2,2825,[ 96 357 100 275 313],296,5,12794,4.5272469922151455,0.0,40.0
22826,2,2826,[318 427 496 357 257],716,5,12799,4.527414220021224,60.0,0.0
22827,2,2827,[318 427 496 357 257],796,5,12804,4.527581329561528,60.0,0.0
22828,2,2828,[318 427 496 357 257],716,5,12809,4.527748320961471,60.0,0.0
22829,2,2829,[318 427 496 357 257],796,5,12814,4.527915194346289,60.0,0.0
22830,2,2830,[318 427 496 357 257],330,5,12819,4.528081949841045,60.0,0.0
22831,2,2831,[196 118 313 111 471],450,4,12823,4.527895480225989,0.0,0.0
22832,2,2832,[318 427 496 357 257],716,5,12828,4.528062124955877,60.0,0.0
22833,2,2833,[655 187 288 127 204],629,5,12833,4.528228652081863,0.0,20.0
22834,2,2834,[118 235  98 173  64],344,3,12836,4.527689594356261,20.0,0.0
22835,2,2835,[318 427 496 357 257],330,5,12841,4.527856135401975,60.0,0.0
22836,2,2836,[318 427 496 357 257],330,5,12846,4.528022559041241,60.0,0.0
22837,2,2837,[197 168 172 195 357],457,5,12851,4.5281888653981675,0.0,0.0
22838,2,2838,[588 216 603 168 196],18,2,12853,4.5272983444874955,20.0,0.0
22839,2,2839,[176  70 132 187 496],450,5,12858,4.527464788732394,20.0,0.0
22840,2,2840,[180 655 322  79 269],450,5,12863,4.527631115804295,0.0,0.0
22841,2,2841,[318 427 496 357 257],796,5,12868,4.527797325826882,60.0,0.0
22842,2,2842,[318 427 496 357 257],330,5,12873,4.527963418923672,60.0,0.0
22843,2,2843,[318 427 496 357 257],716,5,12878,4.528129395218003,60.0,0.0
22844,2,2844,[318 427 496 357 257],716,5,12883,4.528295254833041,60.0,0.0
22845,2,2845,[318 427 496 357 257],716,5,12888,4.528460997891778,60.0,0.0
22846,2,2846,[318 427 496 357 257],716,5,12893,4.5286266245170355,60.0,0.0
22847,2,2847,[318 427 496 357 257],716,5,12898,4.528792134831461,60.0,0.0
22848,2,2848,[ 28 238 234  50 195],151,4,12902,4.528606528606528,0.0,20.0
22849,2,2849,[318 427 496 357 257],796,5,12907,4.528771929824561,60.0,0.0
22850,2,2850,[318 427 496 357 257],330,5,12912,4.528937215012276,60.0,0.0
22851,2,2851,[174 268 127 289 385],655,1,12913,4.527699859747545,0.0,20.0
22852,2,2852,[318 427 496 357 257],330,5,12918,4.527865404837014,60.0,0.0
22853,2,2853,[ 22 271 180 174  50],796,4,12922,4.527680448493343,0.0,20.0
22854,2,2854,[318 427 496 357 257],716,5,12927,4.52784588441331,60.0,0.0
22855,2,2855,[318 427 496 357 257],796,5,12932,4.528011204481793,60.0,0.0
22856,2,2856,[200  50 427 183   7],577,3,12935,4.527476373818691,20.0,20.0
22857,2,2857,[328 322 496 294 135],450,4,12939,4.527291812456263,20.0,0.0
22858,2,2858,[318 427 496 357 257],796,5,12944,4.527457152850647,60.0,0.0
22859,2,2859,[318 427 496 357 257],796,5,12949,4.527622377622378,60.0,0.0
22860,2,2860,[286  71 216 125 300],796,4,12953,4.52743795875568,0.0,20.0
22861,2,2861,[318 427 496 357 257],330,5,12958,4.527603074772886,60.0,0.0
22862,2,2862,[318 427 496 357 257],716,5,12963,4.527768075445337,60.0,0.0
22863,2,2863,[318 427 496 357 257],330,5,12968,4.527932960893855,60.0,0.0
22864,2,2864,[318 427 496 357 257],716,5,12973,4.528097731239092,60.0,0.0
22865,2,2865,[318 427 496 357 257],330,5,12978,4.5282623866015355,60.0,0.0
22866,2,2866,[318 427 496 357 257],330,5,12983,4.5284269271015,60.0,0.0
22867,2,2867,[318 427 496 357 257],796,5,12988,4.528591352859135,60.0,0.0
22868,2,2868,[318 427 496 357 257],796,5,12993,4.528755663994423,60.0,0.0
22869,2,2869,[318 427 496 357 257],330,5,12998,4.528919860627178,60.0,0.0
22870,2,2870,[135 174 211 183   4],655,2,13000,4.528039010797632,0.0,0.0
22871,2,2871,[318 427 496 357 257],330,5,13005,4.528203342618385,60.0,0.0
22872,2,2872,[318 427 496 357 257],796,5,13010,4.528367560041768,60.0,0.0
22873,2,2873,[ 70 483  56 235   1],450,3,13013,4.527835768963118,0.0,0.0
22874,2,2874,[318 427 496 357 257],796,5,13018,4.528,60.0,0.0
22875,2,2875,[ 69 186  28 200 678],504,4,13022,4.527816411682893,0.0,0.0
22876,2,2876,[318 427 496 357 257],330,5,13027,4.527980535279806,60.0,0.0
22877,2,2877,[318 427 496 357 257],716,5,13032,4.528144544822793,60.0,0.0
22878,2,2878,[318 427 496 357 257],330,5,13037,4.528308440430705,60.0,0.0
22879,2,2879,[318 427 496 357 257],796,5,13042,4.528472222222222,60.0,0.0
22880,2,2880,[318 427 496 357 257],716,5,13047,4.528635890315862,60.0,0.0
22881,2,2881,[318 427 496 357 257],716,5,13052,4.528799444829979,60.0,0.0
22882,2,2882,[318 427 496 357 257],330,5,13057,4.528962885882761,60.0,0.0
22883,2,2883,[318 427 496 357 257],716,5,13062,4.529126213592233,60.0,0.0
22884,2,2884,[318 427 496 357 257],330,5,13067,4.529289428076257,60.0,0.0
22885,2,2885,[228 211 144 117  11],716,4,13071,4.529106029106029,0.0,0.0
22886,2,2886,[318 427 496 357 257],796,5,13076,4.52926913751299,60.0,0.0
22887,2,2887,[318 427 496 357 257],330,5,13081,4.529432132963989,60.0,0.0
22888,2,2888,[318 427 496 357 257],716,5,13086,4.529595015576324,60.0,0.0
22889,2,2889,[282 216  15 180 546],457,4,13090,4.529411764705882,0.0,0.0
22890,2,2890,[318 427 496 357 257],330,5,13095,4.529574541681079,60.0,0.0
22891,2,2891,[318 427 496 357 257],330,5,13100,4.529737206085754,60.0,0.0
22892,2,2892,[313 273 508 125  64],344,3,13103,4.5292084341514,20.0,0.0
22893,2,2893,[318 427 496 357 257],796,5,13108,4.529371112646856,60.0,0.0
22894,2,2894,[318 427 496 357 257],716,5,13113,4.529533678756477,60.0,0.0
22895,2,2895,[125 508  79 265 185],655,2,13115,4.5286602209944755,0.0,0.0
22896,2,2896,[318 427 496 357 257],796,5,13120,4.52882292026234,60.0,0.0
22897,2,2897,[180  56 515 238 286],535,2,13122,4.527950310559007,0.0,20.0
22898,2,2898,[318 427 496 357 257],330,5,13127,4.528113142462918,60.0,0.0
22899,2,2899,[237 144 187 269 313],655,2,13129,4.527241379310345,0.0,0.0
22900,2,2900,[318 427 496 357 257],716,5,13134,4.527404343329886,60.0,0.0
22901,2,2901,[483 282 301 496 187],450,4,13138,4.527222605099931,20.0,0.0
22902,2,2902,[318 427 496 357 257],330,5,13143,4.527385463313813,60.0,0.0
22903,2,2903,[318 427 496 357 257],716,5,13148,4.527548209366391,60.0,0.0
22904,2,2904,[194 300 282 222  69],450,4,13152,4.5273666092943206,0.0,0.0
22905,2,2905,[318 427 496 357 257],796,5,13157,4.527529249827942,60.0,0.0
22906,2,2906,[318 427 496 357 257],796,5,13162,4.527691778465773,60.0,0.0
22907,2,2907,[318 427 496 357 257],796,5,13167,4.527854195323246,60.0,0.0
22908,2,2908,[318 427 496 357 257],796,5,13172,4.528016500515641,60.0,0.0
22909,2,2909,[568 196 173   9 405],269,1,13173,4.52680412371134,0.0,0.0
22910,2,2910,[200 423  11 403 125],577,3,13176,4.526279628993473,0.0,0.0
22911,2,2911,[ 88 515 427 174 265],878,3,13179,4.5257554945054945,20.0,0.0
22912,2,2912,[186 265  15 222 286],786,4,13183,4.5255750085822175,0.0,20.0
22913,2,2913,[318 427 496 357 257],716,5,13188,4.525737817433082,60.0,0.0
22914,2,2914,[318 427 496 357 257],796,5,13193,4.52590051457976,60.0,0.0
22915,2,2915,[318 427 496 357 257],716,5,13198,4.526063100137174,60.0,0.0
22916,2,2916,[318 427 496 357 257],330,5,13203,4.526225574220089,60.0,0.0
22917,2,2917,[318 427 496 357 257],796,5,13208,4.526387936943112,60.0,0.0
22918,2,2918,[318 427 496 357 257],796,5,13213,4.526550188420692,60.0,0.0
22919,2,2919,[318 427 496 357 257],716,5,13218,4.526712328767124,60.0,0.0
22920,2,2920,[222   9  70 269  22],344,3,13221,4.526189661074974,0.0,0.0
22921,2,2921,[168 197  15 195 302],450,4,13225,4.526009582477755,0.0,0.0
22922,2,2922,[318 427 496 357 257],330,5,13230,4.5261717413616145,60.0,0.0
22923,2,2923,[318 427 496 357 257],330,5,13235,4.526333789329685,60.0,0.0
22924,2,2924,[318 427 496 357 257],796,5,13240,4.526495726495726,60.0,0.0
22925,2,2925,[318 427 496 357 257],330,5,13245,4.526657552973343,60.0,0.0
22926,2,2926,[318 427 496 357 257],796,5,13250,4.5268192688759825,60.0,0.0
22927,2,2927,[197 302 195 423 185],535,4,13254,4.526639344262295,0.0,0.0
22928,2,2928,[318 427 496 357 257],716,5,13259,4.526800955957665,60.0,0.0
22929,2,2929,[318 427 496 357 257],796,5,13264,4.526962457337884,60.0,0.0
22930,2,2930,[ 79 228  11 483 237],296,5,13269,4.527123848515865,0.0,0.0
22931,2,2931,[132 275 423  82   9],655,1,13270,4.525920873124147,0.0,20.0
22932,2,2932,[132 237 222 385 127],344,3,13273,4.525400613706103,0.0,20.0
22933,2,2933,[318 427 496 357 257],796,5,13278,4.525562372188139,60.0,0.0
22934,2,2934,[471 125 273 313 127],655,3,13281,4.5250425894378195,0.0,20.0
22935,2,2935,[318 427 496 357 257],330,5,13286,4.525204359673024,60.0,0.0
22936,2,2936,[318 427 496 357 257],796,5,13291,4.525366019748042,60.0,0.0
22937,2,2937,[318 427 496 357 257],796,5,13296,4.525527569775357,60.0,0.0
22938,2,2938,[318 427 496 357 257],716,5,13301,4.5256890098673015,60.0,0.0
22939,2,2939,[318 427 496 357 257],330,5,13306,4.525850340136055,60.0,0.0
22940,2,2940,[318 427 496 357 257],796,5,13311,4.526011560693641,60.0,0.0
22941,2,2941,[318 427 496 357 257],796,5,13316,4.5261726716519375,60.0,0.0
22942,2,2942,[318 427 496 357 257],716,5,13321,4.5263336731226635,60.0,0.0
22943,2,2943,[318 427 496 357 257],716,5,13326,4.526494565217392,60.0,0.0
22944,2,2944,[318 427 496 357 257],716,5,13331,4.526655348047538,60.0,0.0
22945,2,2945,[318 427 496 357 257],796,5,13336,4.526816021724372,60.0,0.0
22946,2,2946,[603 196 127 546  79],796,5,13341,4.526976586359009,20.0,20.0
22947,2,2947,[153  28 181  50 282],236,3,13344,4.526458616010855,0.0,20.0
22948,2,2948,[318 427 496 357 257],330,5,13349,4.526619192946762,60.0,0.0
22949,2,2949,[318 427 496 357 257],716,5,13354,4.526779661016949,60.0,0.0
22950,2,2950,[318 427 496 357 257],716,5,13359,4.52694002033209,60.0,0.0
22951,2,2951,[151 179 195 132 655],457,5,13364,4.52710027100271,0.0,0.0
22952,2,2952,[318 427 496 357 257],796,5,13369,4.527260413139181,60.0,0.0
22953,2,2953,[318 427 496 357 257],796,5,13374,4.5274204468517265,60.0,0.0
22954,2,2954,[318 427 496 357 257],796,5,13379,4.527580372250423,60.0,0.0
22955,2,2955,[318 427 496 357 257],796,5,13384,4.527740189445196,60.0,0.0
22956,2,2956,[318 427 496 357 257],330,5,13389,4.527899898545823,60.0,0.0
22957,2,2957,[318 427 496 357 257],330,5,13394,4.528059499661934,60.0,0.0
22958,2,2958,[318 427 496 357 257],330,5,13399,4.528218992903008,60.0,0.0
22959,2,2959,[318 427 496 357 257],796,5,13404,4.528378378378378,60.0,0.0
22960,2,2960,[318 427 496 357 257],716,5,13409,4.528537656197231,60.0,0.0
22961,2,2961,[318 427 496 357 257],330,5,13414,4.528696826468602,60.0,0.0
22962,2,2962,[318 427 496 357 257],716,5,13419,4.528855889301384,60.0,0.0
22963,2,2963,[186 127 655 132 301],655,1,13420,4.527665317139001,0.0,20.0
22964,2,2964,[318 427 496 357 257],330,5,13425,4.527824620573356,60.0,0.0
22965,2,2965,[318 427 496 357 257],796,5,13430,4.527983816587997,60.0,0.0
22966,2,2966,[132 405 182 173 191],269,3,13433,4.527468823727671,0.0,0.0
22967,2,2967,[318 427 496 357 257],716,5,13438,4.527628032345014,60.0,0.0
22968,2,2968,[318 427 496 357 257],716,5,13443,4.527787133715056,60.0,0.0
22969,2,2969,[318 427 496 357 257],330,5,13448,4.527946127946128,60.0,0.0
22970,2,2970,[ 88 276 313 186  25],655,2,13450,4.527095254123191,0.0,0.0
22971,2,2971,[238  28 111 210  79],457,4,13454,4.5269179004037685,0.0,0.0
22972,2,2972,[318 427 496 357 257],330,5,13459,4.527077026572486,60.0,0.0
22973,2,2973,[ 88   8 234   1 269],655,0,13459,4.525554808338938,0.0,0.0
22974,2,2974,[318 427 496 357 257],716,5,13464,4.525714285714286,60.0,0.0
22975,2,2975,[187 185 228   1 151],796,4,13468,4.525537634408602,0.0,0.0
22976,2,2976,[318 427 496 357 257],716,5,13473,4.525697010413167,60.0,0.0
22977,2,2977,[ 12 275 144 273 197],796,3,13476,4.5251846877098725,0.0,20.0
22978,2,2978,[289 655 275 211 195],236,1,13477,4.52400134273246,0.0,20.0
22979,2,2979,[125 191 111 597 117],344,2,13479,4.523154362416108,0.0,0.0
22980,2,2980,[318 427 496 357 257],330,5,13484,4.523314324052332,60.0,0.0
22981,2,2981,[161 174  69 483 210],796,4,13488,4.523138832997988,0.0,0.0
22982,2,2982,[318 427 496 357 257],330,5,13493,4.523298692591351,60.0,0.0
22983,2,2983,[742 435   8 135 118],655,1,13494,4.522117962466488,0.0,0.0
22984,2,2984,[176 186  89 286  82],796,2,13496,4.521273031825795,0.0,20.0
22985,2,2985,[318 427 496 357 257],796,5,13501,4.521433355659745,60.0,0.0
22986,2,2986,[186 215  71 742 197],504,4,13505,4.5212587880816875,0.0,0.0
22987,2,2987,[318 427 496 357 257],796,5,13510,4.521419009370817,60.0,0.0
22988,2,2988,[318 427 496 357 257],716,5,13515,4.52157912345266,60.0,0.0
22989,2,2989,[318 427 496 357 257],716,5,13520,4.521739130434782,60.0,0.0
22990,2,2990,[318 427 496 357 257],796,5,13525,4.521899030424607,60.0,0.0
22991,2,2991,[318 427 496 357 257],716,5,13530,4.522058823529412,60.0,0.0
22992,2,2992,[318 427 496 357 257],716,5,13535,4.522218509856331,60.0,0.0
22993,2,2993,[237 211 100 132 200],655,1,13536,4.521042084168337,0.0,20.0
22994,2,2994,[318 427 496 357 257],330,5,13541,4.521202003338898,60.0,0.0
22995,2,2995,[318 427 496 357 257],796,5,13546,4.521361815754339,60.0,0.0
22996,2,2996,[ 79 238 597 568 234],796,3,13549,4.520854187520854,0.0,0.0
22997,2,2997,[273 288 135 100 197],629,4,13553,4.520680453635757,0.0,20.0
22998,2,2998,[318 427 496 357 257],330,5,13558,4.520840280093364,60.0,0.0
22999,2,2999,[301 121 196 181 117],655,0,13558,4.519333333333333,0.0,0.0
23000,2,3000,[318 427 496 357 257],716,5,13563,4.519493502165945,60.0,0.0
23001,2,3001,[179 385 742 185 588],450,5,13568,4.519653564290473,0.0,0.0
23002,2,3002,[318 427 496 357 257],330,5,13573,4.519813519813519,60.0,0.0
23003,2,3003,[318 427 496 357 257],330,5,13578,4.519973368841544,60.0,0.0
23004,2,3004,[318 427 496 357 257],796,5,13583,4.520133111480865,60.0,0.0
23005,2,3005,[ 22 132  64 179  11],577,3,13586,4.519627411842981,20.0,0.0
23006,2,3006,[318 427 496 357 257],796,5,13591,4.519787163285667,60.0,0.0
23007,2,3007,[318 427 496 357 257],330,5,13596,4.519946808510638,60.0,0.0
23008,2,3008,[  1 313 196  97 286],796,2,13598,4.519109338650715,0.0,20.0
23009,2,3009,[318 427 496 357 257],796,5,13603,4.519269102990033,60.0,0.0
23010,2,3010,[318 427 496 357 257],796,5,13608,4.519428761208901,60.0,0.0
23011,2,3011,[318 427 496 357 257],716,5,13613,4.519588313413014,60.0,0.0
23012,2,3012,[318 427 496 357 257],330,5,13618,4.519747759707932,60.0,0.0
23013,2,3013,[318 427 496 357 257],796,5,13623,4.519907100199071,60.0,0.0
23014,2,3014,[318 427 496 357 257],796,5,13628,4.520066334991708,60.0,0.0
23015,2,3015,[318 427 496 357 257],716,5,13633,4.520225464190982,60.0,0.0
23016,2,3016,[318 427 496 357 257],716,5,13638,4.5203844879018895,60.0,0.0
23017,2,3017,[318 427 496 357 257],716,5,13643,4.520543406229291,60.0,0.0
23018,2,3018,[172 211 204  25 215],535,4,13647,4.52037098376946,0.0,0.0
23019,2,3019,[210  97 132 174 195],504,5,13652,4.520529801324503,0.0,0.0
23020,2,3020,[318 427 496 357 257],716,5,13657,4.5206885137371735,60.0,0.0
23021,2,3021,[318 427 496 357 257],330,5,13662,4.520847121111847,60.0,0.0
23022,2,3022,[258 222  70  89 237],655,1,13663,4.519682434667549,0.0,0.0
23023,2,3023,[318 427 496 357 257],716,5,13668,4.51984126984127,60.0,0.0
23024,2,3024,[125 546 197 202 655],457,4,13672,4.519669421487603,0.0,0.0
23025,2,3025,[153 238 357 237 186],716,4,13676,4.519497686715136,0.0,0.0
23026,2,3026,[318 427 496 357 257],796,5,13681,4.519656425503799,60.0,0.0
23027,2,3027,[318 427 496 357 257],716,5,13686,4.519815059445178,60.0,0.0
23028,2,3028,[318 427 496 357 257],716,5,13691,4.519973588643117,60.0,0.0
23029,2,3029,[318 427 496 357 257],796,5,13696,4.52013201320132,60.0,0.0
23030,2,3030,[318 427 496 357 257],796,5,13701,4.520290333223358,60.0,0.0
23031,2,3031,[318 427 496 357 257],716,5,13706,4.520448548812665,60.0,0.0
23032,2,3032,[318 427 496 357 257],716,5,13711,4.520606660072535,60.0,0.0
23033,2,3033,[318 427 496 357 257],330,5,13716,4.52076466710613,60.0,0.0
23034,2,3034,[318 427 496 357 257],796,5,13721,4.520922570016475,60.0,0.0
23035,2,3035,[318 427 496 357 257],330,5,13726,4.521080368906456,60.0,0.0
23036,2,3036,[318 427 496 357 257],330,5,13731,4.521238063878828,60.0,0.0
23037,2,3037,[318 427 496 357 257],716,5,13736,4.521395655036208,60.0,0.0
23038,2,3038,[318 427 496 357 257],330,5,13741,4.521553142481079,60.0,0.0
23039,2,3039,[294 186  70   4 273],450,2,13743,4.520723684210527,0.0,0.0
23040,2,3040,[318 427 496 357 257],716,5,13748,4.520881289049655,60.0,0.0
23041,2,3041,[318 427 496 357 257],330,5,13753,4.52103879026956,60.0,0.0
23042,2,3042,[318 204  70 228 100],72,4,13757,4.520867564903056,20.0,20.0
23043,2,3043,[318 427 496 357 257],796,5,13762,4.521024967148489,60.0,0.0
23044,2,3044,[471 483 187 603 269],450,4,13766,4.520853858784894,20.0,0.0
23045,2,3045,[237  25  28 132 313],655,1,13767,4.5196979645436635,0.0,0.0
23046,2,3046,[318 427 496 357 257],796,5,13772,4.51985559566787,60.0,0.0
23047,2,3047,[318 427 496 357 257],796,5,13777,4.52001312335958,60.0,0.0
23048,2,3048,[318 427 496 357 257],716,5,13782,4.520170547720564,60.0,0.0
23049,2,3049,[318 427 496 357 257],796,5,13787,4.520327868852459,60.0,0.0
23050,2,3050,[357  96 276 405   9],344,4,13791,4.52015732546706,0.0,0.0
23051,2,3051,[318 427 496 357 257],330,5,13796,4.520314547837484,60.0,0.0
23052,2,3052,[215  89 222 238  98],450,4,13800,4.520144120537177,0.0,0.0
23053,2,3053,[318 427 496 357 257],330,5,13805,4.5203012442698105,60.0,0.0
23054,2,3054,[318 427 496 357 257],330,5,13810,4.5204582651391165,60.0,0.0
23055,2,3055,[318 427 496 357 257],716,5,13815,4.520615183246074,60.0,0.0
23056,2,3056,[197 471 204 222 742],655,0,13815,4.519136408243376,0.0,0.0
23057,2,3057,[ 69 202 238 210 172],629,5,13820,4.5192936559843035,0.0,0.0
23058,2,3058,[318 427 496 357 257],796,5,13825,4.519450800915332,60.0,0.0
23059,2,3059,[318 427 496 357 257],796,5,13830,4.519607843137255,60.0,0.0
23060,2,3060,[318 427 496 357 257],716,5,13835,4.519764782750735,60.0,0.0
23061,2,3061,[318 427 496 357 257],796,5,13840,4.519921619856303,60.0,0.0
23062,2,3062,[318 427 496 357 257],796,5,13845,4.520078354554358,60.0,0.0
23063,2,3063,[318 427 496 357 257],716,5,13850,4.5202349869451695,60.0,0.0
23064,2,3064,[318 427 496 357 257],796,5,13855,4.520391517128874,60.0,0.0
23065,2,3065,[318 427 496 357 257],330,5,13860,4.52054794520548,60.0,0.0
23066,2,3066,[603 204 403 174 173],796,5,13865,4.5207042712748615,20.0,0.0
23067,2,3067,[  1 172 211 294 121],296,4,13869,4.520534550195567,0.0,0.0
23068,2,3068,[318 427 496 357 257],716,5,13874,4.520690778755295,60.0,0.0
23069,2,3069,[318 427 496 357 257],796,5,13879,4.520846905537459,60.0,0.0
23070,2,3070,[318 427 496 357 257],330,5,13884,4.521002930641485,60.0,0.0
23071,2,3071,[318 427 496 357 257],716,5,13889,4.521158854166667,60.0,0.0
23072,2,3072,[318 427 496 357 257],796,5,13894,4.52131467621217,60.0,0.0
23073,2,3073,[318 427 496 357 257],716,5,13899,4.521470396877033,60.0,0.0
23074,2,3074,[427 300 204 132  15],796,5,13904,4.5216260162601625,20.0,0.0
23075,2,3075,[423  96 385  28 323],504,5,13909,4.521781534460338,0.0,0.0
23076,2,3076,[318 427 496 357 257],796,5,13914,4.521936951576211,60.0,0.0
23077,2,3077,[318 427 496 357 257],716,5,13919,4.522092267706303,60.0,0.0
23078,2,3078,[318 427 496 357 257],330,5,13924,4.52224748294901,60.0,0.0
23079,2,3079,[173  97 168 153 202],796,4,13928,4.522077922077922,0.0,0.0
23080,2,3080,[318 427 496 357 257],330,5,13933,4.522233041220383,60.0,0.0
23081,2,3081,[318 427 496 357 257],716,5,13938,4.522388059701493,60.0,0.0
23082,2,3082,[282 265 546 328  97],450,5,13943,4.522542977619202,0.0,0.0
23083,2,3083,[ 15 179 216   8 288],593,4,13947,4.522373540856031,0.0,0.0
23084,2,3084,[258 176 187 405 435],655,1,13948,4.521231766612642,0.0,0.0
23085,2,3085,[318 427 496 357 257],796,5,13953,4.521386908619572,60.0,0.0
23086,2,3086,[318 427 496 357 257],716,5,13958,4.521541950113379,60.0,0.0
23087,2,3087,[318 427 496 357 257],716,5,13963,4.52169689119171,60.0,0.0
23088,2,3088,[318 427 496 357 257],330,5,13968,4.521851731952088,60.0,0.0
23089,2,3089,[318 427 496 357 257],796,5,13973,4.52200647249191,60.0,0.0
23090,2,3090,[318 427 496 357 257],330,5,13978,4.522161112908444,60.0,0.0
23091,2,3091,[318 427 496 357 257],330,5,13983,4.522315653298835,60.0,0.0
23092,2,3092,[318 427 496 357 257],796,5,13988,4.522470093760104,60.0,0.0
23093,2,3093,[271 191  11 100  96],655,1,13989,4.521331609566904,0.0,20.0
23094,2,3094,[318 427 496 357 257],796,5,13994,4.521486268174475,60.0,0.0
23095,2,3095,[318 427 496 357 257],330,5,13999,4.521640826873385,60.0,0.0
23096,2,3096,[318 427 496 357 257],796,5,14004,4.521795285760414,60.0,0.0
23097,2,3097,[318 427 496 357 257],716,5,14009,4.5219496449322145,60.0,0.0
23098,2,3098,[427 588  71 322 568],450,4,14013,4.521781219748306,20.0,0.0
23099,2,3099,[318 427 496 357 257],330,5,14018,4.521935483870967,60.0,0.0
23100,2,3100,[318 427 496 357 257],330,5,14023,4.522089648500484,60.0,0.0
23101,2,3101,[508 216 215   9 118],280,2,14025,4.5212765957446805,0.0,0.0
23102,2,3102,[318 427 496 357 257],330,5,14030,4.521430873348373,60.0,0.0
23103,2,3103,[318 427 496 357 257],330,5,14035,4.521585051546392,60.0,0.0
23104,2,3104,[318 427 496 357 257],716,5,14040,4.521739130434782,60.0,0.0
23105,2,3105,[228 423 191 234 135],457,5,14045,4.521893110109466,0.0,0.0
23106,2,3106,[204 318  70  11 222],450,4,14049,4.521725136787898,20.0,0.0
23107,2,3107,[273 215 180 196  64],450,4,14053,4.521557271557271,20.0,0.0
23108,2,3108,[318 427 496 357 257],330,5,14058,4.521711161145062,60.0,0.0
23109,2,3109,[318 427 496 357 257],796,5,14063,4.521864951768489,60.0,0.0
23110,2,3110,[318 427 496 357 257],716,5,14068,4.5220186435229826,60.0,0.0
23111,2,3111,[318 427 496 357 257],330,5,14073,4.522172236503856,60.0,0.0
23112,2,3112,[318 427 496 357 257],796,5,14078,4.522325730806296,60.0,0.0
23113,2,3113,[318 427 496 357 257],796,5,14083,4.522479126525369,60.0,0.0
23114,2,3114,[318 427 496 357 257],796,5,14088,4.522632423756019,60.0,0.0
23115,2,3115,[318 427 496 357 257],716,5,14093,4.522785622593068,60.0,0.0
23116,2,3116,[318 179 111 405  50],885,3,14096,4.522297080526147,20.0,20.0
23117,2,3117,[183 228 496 655 210],151,4,14100,4.522129570237332,20.0,0.0
23118,2,3118,[318 427 496 357 257],796,5,14105,4.522282782943251,60.0,0.0
23119,2,3119,[318 427 496 357 257],716,5,14110,4.522435897435898,60.0,0.0
23120,2,3120,[597 258 282 125 191],450,5,14115,4.522588913809677,0.0,0.0
23121,2,3121,[318 427 496 357 257],330,5,14120,4.522741832158872,60.0,0.0
23122,2,3122,[117 196  95 471 151],577,4,14124,4.522574447646494,0.0,0.0
23123,2,3123,[318 427 496 357 257],796,5,14129,4.5227272727272725,60.0,0.0
23124,2,3124,[318 427 496 357 257],330,5,14134,4.52288,60.0,0.0
23125,2,3125,[318 427 496 357 257],796,5,14139,4.523032629558541,60.0,0.0
23126,2,3126,[ 89 187   1 125 121],655,2,14141,4.522225775503678,0.0,0.0
23127,2,3127,[318 427 496 357 257],330,5,14146,4.522378516624041,60.0,0.0
23128,2,3128,[135 300 100 546 318],450,4,14150,4.522211569191435,20.0,20.0
23129,2,3129,[234 117  70 385 179],786,4,14154,4.522044728434505,0.0,0.0
23130,2,3130,[318 427 496 357 257],716,5,14159,4.522197381028425,60.0,0.0
23131,2,3131,[234 182  56 127 211],450,4,14163,4.522030651340996,0.0,20.0
23132,2,3132,[318 427 496 357 257],330,5,14168,4.522183210979891,60.0,0.0
23133,2,3133,[318 427 496 357 257],330,5,14173,4.522335673261009,60.0,0.0
23134,2,3134,[  9  71 117 144 215],280,3,14176,4.521850079744817,0.0,0.0
23135,2,3135,[318 427 496 357 257],330,5,14181,4.5220025510204085,60.0,0.0
23136,2,3136,[ 97  50  11  89 181],256,5,14186,4.522154925087664,0.0,20.0
23137,2,3137,[118 222   7 289 172],693,1,14187,4.5210325047801145,0.0,0.0
23138,2,3138,[318 427 496 357 257],796,5,14192,4.521185090793246,60.0,0.0
23139,2,3139,[318 427 496 357 257],796,5,14197,4.521337579617835,60.0,0.0
23140,2,3140,[318 427 496 357 257],796,5,14202,4.521489971346705,60.0,0.0
23141,2,3141,[318 427 496 357 257],796,5,14207,4.521642266072565,60.0,0.0
23142,2,3142,[318 427 496 357 257],796,5,14212,4.521794463888005,60.0,0.0
23143,2,3143,[271 568 328 237  64],796,5,14217,4.521946564885496,20.0,0.0
23144,2,3144,[318 427 496 357 257],796,5,14222,4.522098569157393,60.0,0.0
23145,2,3145,[318 427 496 357 257],716,5,14227,4.522250476795931,60.0,0.0
23146,2,3146,[318 427 496 357 257],716,5,14232,4.5224022878932315,60.0,0.0
23147,2,3147,[318 427 496 357 257],796,5,14237,4.5225540025412965,60.0,0.0
23148,2,3148,[ 11 471 357 318 135],401,3,14240,4.522070498570975,20.0,0.0
23149,2,3149,[318 427 496 357 257],796,5,14245,4.522222222222222,60.0,0.0
23150,2,3150,[210 118 143  12 132],174,3,14248,4.521739130434782,0.0,0.0
23151,2,3151,[269 423 204  88   8],503,4,14252,4.521573604060913,0.0,0.0
23152,2,3152,[318 427 496 357 257],796,5,14257,4.521725340945132,60.0,0.0
23153,2,3153,[318 427 496 357 257],796,5,14262,4.521876981610653,60.0,0.0
23154,2,3154,[318 427 496 357 257],330,5,14267,4.52202852614897,60.0,0.0
23155,2,3155,[318 427 496 357 257],716,5,14272,4.522179974651458,60.0,0.0
23156,2,3156,[318 427 496 357 257],330,5,14277,4.522331327209376,60.0,0.0
23157,2,3157,[318 427 496 357 257],330,5,14282,4.522482583913869,60.0,0.0
23158,2,3158,[318 427 496 357 257],796,5,14287,4.522633744855967,60.0,0.0
23159,2,3159,[301  22 144 111 204],629,4,14291,4.52246835443038,0.0,0.0
23160,2,3160,[318 427 496 357 257],796,5,14296,4.522619424232838,60.0,0.0
23161,2,3161,[318 427 496 357 257],796,5,14301,4.522770398481973,60.0,0.0
23162,2,3162,[318 427 496 357 257],330,5,14306,4.522921277268416,60.0,0.0
23163,2,3163,[318 427 496 357 257],330,5,14311,4.52307206068268,60.0,0.0
23164,2,3164,[318 427 496 357 257],796,5,14316,4.523222748815166,60.0,0.0
23165,2,3165,[318 427 496 357 257],796,5,14321,4.523373341756159,60.0,0.0
23166,2,3166,[318 427 496 357 257],716,5,14326,4.523523839595832,60.0,0.0
23167,2,3167,[318 427 496 357 257],716,5,14331,4.523674242424242,60.0,0.0
23168,2,3168,[318 427 496 357 257],796,5,14336,4.523824550331335,60.0,0.0
23169,2,3169,[  1 405 204 294 423],280,2,14338,4.523028391167192,0.0,0.0
23170,2,3170,[318 427 496 357 257],796,5,14343,4.52317880794702,60.0,0.0
23171,2,3171,[435  96  82 427 195],716,3,14346,4.5226986128625475,20.0,0.0
23172,2,3172,[174 294 271  98 197],655,1,14347,4.521588402143082,0.0,0.0
23173,2,3173,[318 427 496 357 257],716,5,14352,4.521739130434782,60.0,0.0
23174,2,3174,[185 318 300 678 176],504,4,14356,4.521574803149607,20.0,0.0
23175,2,3175,[318 427 496 357 257],796,5,14361,4.521725440806045,60.0,0.0
23176,2,3176,[288 678 121 237 588],344,2,14363,4.52093169656909,0.0,0.0
23177,2,3177,[318 427 496 357 257],796,5,14368,4.5210824417872875,60.0,0.0
23178,2,3178,[318 427 496 357 257],796,5,14373,4.521233092167348,60.0,0.0
23179,2,3179,[588 269 742 302 405],186,1,14374,4.520125786163522,0.0,0.0
23180,2,3180,[318 427 496 357 257],796,5,14379,4.520276642565231,60.0,0.0
23181,2,3181,[318 427 496 357 257],796,5,14384,4.520427404148334,60.0,0.0
23182,2,3182,[318 427 496 357 257],330,5,14389,4.520578071002199,60.0,0.0
23183,2,3183,[111 385 151 265 405],577,4,14393,4.520414572864322,0.0,0.0
23184,2,3184,[ 71 258 322 196 496],450,4,14397,4.520251177394035,20.0,0.0
23185,2,3185,[318 427 496 357 257],716,5,14402,4.520401757689894,60.0,0.0
23186,2,3186,[318 427 496 357 257],330,5,14407,4.520552243489175,60.0,0.0
23187,2,3187,[111 191 655 196   8],269,2,14409,4.519761606022585,0.0,0.0
23188,2,3188,[318 427 496 357 257],716,5,14414,4.519912198181248,60.0,0.0
23189,2,3189,[318 427 496 357 257],716,5,14419,4.520062695924765,60.0,0.0
23190,2,3190,[318 427 496 357 257],716,5,14424,4.520213099341899,60.0,0.0
23191,2,3191,[132 127 191 180  98],18,5,14429,4.520363408521304,0.0,20.0
23192,2,3192,[181 176 121 423 135],72,2,14431,4.51957406827435,0.0,0.0
23193,2,3193,[427 118  82 127 185],450,3,14434,4.519098309329994,20.0,20.0
23194,2,3194,[318 427 496 357 257],796,5,14439,4.51924882629108,60.0,0.0
23195,2,3195,[127  50  28   4 111],389,4,14443,4.519086357947434,0.0,40.0
23196,2,3196,[286 282 151 568 245],796,3,14446,4.518611197998124,0.0,20.0
23197,2,3197,[318 427 496 357 257],330,5,14451,4.518761726078799,60.0,0.0
23198,2,3198,[100 180 222 245  50],796,2,14453,4.517974366989685,0.0,40.0
23199,2,3199,[228 174 183 483 100],280,1,14454,4.516875,0.0,20.0
23200,2,3200,[318 427 496 357 257],330,5,14459,4.517025929397064,60.0,0.0
23201,2,3201,[318 427 496 357 257],716,5,14464,4.517176764522174,60.0,0.0
23202,2,3202,[318 427 496 357 257],330,5,14469,4.517327505463628,60.0,0.0
23203,2,3203,[318 427 496 357 257],716,5,14474,4.517478152309613,60.0,0.0
23204,2,3204,[275  97 276 186 172],18,4,14478,4.517316692667706,0.0,20.0
23205,2,3205,[318 427 496 357 257],330,5,14483,4.5174672489082965,60.0,0.0
23206,2,3206,[318 427 496 357 257],330,5,14488,4.5176177112566265,60.0,0.0
23207,2,3207,[318 427 496 357 257],796,5,14493,4.517768079800499,60.0,0.0
23208,2,3208,[318 427 496 357 257],716,5,14498,4.51791835462761,60.0,0.0
23209,2,3209,[318 427 496 357 257],330,5,14503,4.518068535825545,60.0,0.0
23210,2,3210,[318 427 496 357 257],716,5,14508,4.518218623481781,60.0,0.0
23211,2,3211,[318 427 496 357 257],796,5,14513,4.518368617683686,60.0,0.0
23212,2,3212,[194 118 202  89 186],151,4,14517,4.518207282913165,0.0,0.0
23213,2,3213,[318 427 496 357 257],330,5,14522,4.518357187305538,60.0,0.0
23214,2,3214,[318 427 496 357 257],716,5,14527,4.51850699844479,60.0,0.0
23215,2,3215,[318 427 496 357 257],716,5,14532,4.518656716417911,60.0,0.0
23216,2,3216,[318 427 496 357 257],796,5,14537,4.518806341311781,60.0,0.0
23217,2,3217,[483   7   4 176  28],151,4,14541,4.518645121193288,0.0,0.0
23218,2,3218,[234  25  69 180 196],716,4,14545,4.518484001242622,0.0,0.0
23219,2,3219,[318 427 496 357 257],716,5,14550,4.5186335403726705,60.0,0.0
23220,2,3220,[318 427 496 357 257],716,5,14555,4.518782986650109,60.0,0.0
23221,2,3221,[655   7  96 185 222],693,3,14558,4.518311607697083,0.0,0.0
23222,2,3222,[228 508 273 427 234],655,2,14560,4.5175302513186475,20.0,0.0
23223,2,3223,[318 427 496 357 257],330,5,14565,4.517679900744417,60.0,0.0
23224,2,3224,[228  11 301 238 222],11,1,14566,4.516589147286822,0.0,0.0
23225,2,3225,[318 427 496 357 257],716,5,14571,4.51673899566026,60.0,0.0
23226,2,3226,[318 427 496 357 257],716,5,14576,4.51688875116207,60.0,0.0
23227,2,3227,[318 427 496 357 257],716,5,14581,4.517038413878563,60.0,0.0
23228,2,3228,[318 427 496 357 257],330,5,14586,4.517187983895943,60.0,0.0
23229,2,3229,[318 427 496 357 257],796,5,14591,4.517337461300309,60.0,0.0
23230,2,3230,[318 427 496 357 257],330,5,14596,4.517486846177654,60.0,0.0
23231,2,3231,[318 427 496 357 257],330,5,14601,4.517636138613861,60.0,0.0
23232,2,3232,[322 655 180 121 301],450,4,14605,4.517476028456542,0.0,0.0
23233,2,3233,[318 427 496 357 257],716,5,14610,4.517625231910946,60.0,0.0
23234,2,3234,[318 427 496 357 257],796,5,14615,4.517774343122102,60.0,0.0
23235,2,3235,[318 427 496 357 257],716,5,14620,4.517923362175526,60.0,0.0
23236,2,3236,[215 328 172 204 111],655,1,14621,4.516836577077541,0.0,0.0
23237,2,3237,[187  64  79  95 175],18,5,14626,4.516985793699814,20.0,0.0
23238,2,3238,[185  22 153 237 181],450,5,14631,4.517134918184625,0.0,0.0
23239,2,3239,[318 427 496 357 257],796,5,14636,4.517283950617284,60.0,0.0
23240,2,3240,[318 427 496 357 257],716,5,14641,4.517432891082999,60.0,0.0
23241,2,3241,[318 427 496 357 257],716,5,14646,4.5175817396668725,60.0,0.0
23242,2,3242,[318 427 496 357 257],330,5,14651,4.5177304964539005,60.0,0.0
23243,2,3243,[318 427 496 357 257],796,5,14656,4.517879161528977,60.0,0.0
23244,2,3244,[302 174  25 294 197],655,1,14657,4.516795069337443,0.0,0.0
23245,2,3245,[318 427 496 357 257],330,5,14662,4.5169439309919905,60.0,0.0
23246,2,3246,[ 98 204 265  28 174],450,5,14667,4.517092700954727,0.0,0.0
23247,2,3247,[ 89 151 211 508 268],296,4,14671,4.516933497536946,0.0,0.0
23248,2,3248,[318 427 496 357 257],796,5,14676,4.517082179132041,60.0,0.0
23249,2,3249,[423 588  71 216  28],18,4,14680,4.516923076923077,0.0,0.0
23250,2,3250,[318 427 496 357 257],796,5,14685,4.517071670255306,60.0,0.0
23251,2,3251,[318 427 496 357 257],796,5,14690,4.517220172201722,60.0,0.0
23252,2,3252,[  4 403  11 269 197],450,4,14694,4.517061174300646,0.0,0.0
23253,2,3253,[194 603 210 471 265],716,4,14698,4.5169022741241545,20.0,0.0
23254,2,3254,[318 427 496 357 257],796,5,14703,4.51705069124424,60.0,0.0
23255,2,3255,[318 427 496 357 257],716,5,14708,4.517199017199017,60.0,0.0
23256,2,3256,[318 427 496 357 257],716,5,14713,4.517347252072459,60.0,0.0
23257,2,3257,[318 427 496 357 257],330,5,14718,4.517495395948434,60.0,0.0
23258,2,3258,[318 427 496 357 257],330,5,14723,4.517643448910709,60.0,0.0
23259,2,3259,[161 132 286 185  25],450,4,14727,4.517484662576687,0.0,20.0
23260,2,3260,[318 427 496 357 257],330,5,14732,4.517632628028212,60.0,0.0
23261,2,3261,[318 427 496 357 257],796,5,14737,4.517780502759043,60.0,0.0
23262,2,3262,[318 427 496 357 257],716,5,14742,4.51792828685259,60.0,0.0
23263,2,3263,[200 172   8 175 121],269,2,14744,4.517156862745098,0.0,0.0
23264,2,3264,[276 597 357 405 275],344,3,14747,4.516692189892803,0.0,20.0
23265,2,3265,[318 427 496 357 257],796,5,14752,4.516840171463564,60.0,0.0
23266,2,3266,[286  95 196   7 588],450,4,14756,4.516681971227426,0.0,20.0
23267,2,3267,[318 427 496 357 257],716,5,14761,4.5168298653610774,60.0,0.0
23268,2,3268,[191  28 202 318 195],716,4,14765,4.5166717650657695,20.0,0.0
23269,2,3269,[318 427 496 357 257],330,5,14770,4.516819571865444,60.0,0.0
23270,2,3270,[318 427 496 357 257],796,5,14775,4.516967288291043,60.0,0.0
23271,2,3271,[318 427 496 357 257],330,5,14780,4.517114914425428,60.0,0.0
23272,2,3272,[204  89  22   4  50],796,5,14785,4.517262450351359,0.0,20.0
23273,2,3273,[318 427 496 357 257],796,5,14790,4.517409896151497,60.0,0.0
23274,2,3274,[318 427 496 357 257],330,5,14795,4.517557251908397,60.0,0.0
23275,2,3275,[318 427 496 357 257],330,5,14800,4.517704517704518,60.0,0.0
23276,2,3276,[318 427 496 357 257],796,5,14805,4.517851693622215,60.0,0.0
23277,2,3277,[318 427 496 357 257],330,5,14810,4.517998779743746,60.0,0.0
23278,2,3278,[318 427 496 357 257],716,5,14815,4.518145776151266,60.0,0.0
23279,2,3279,[318 427 496 357 257],330,5,14820,4.5182926829268295,60.0,0.0
23280,2,3280,[222  25 286 568 546],344,3,14823,4.517829929899421,0.0,20.0
23281,2,3281,[318 427 496 357 257],796,5,14828,4.517976843388178,60.0,0.0
23282,2,3282,[318 427 496 357 257],330,5,14833,4.518123667377399,60.0,0.0
23283,2,3283,[318 427 496 357 257],796,5,14838,4.518270401948842,60.0,0.0
23284,2,3284,[318 427 496 357 257],330,5,14843,4.518417047184171,60.0,0.0
23285,2,3285,[132 238  96  50 195],716,3,14846,4.517954960438223,0.0,20.0
23286,2,3286,[318 427 496 357 257],796,5,14851,4.518101612412535,60.0,0.0
23287,2,3287,[318 427 496 357 257],330,5,14856,4.518248175182482,60.0,0.0
23288,2,3288,[318 427 496 357 257],716,5,14861,4.518394648829432,60.0,0.0
23289,2,3289,[318 427 496 357 257],796,5,14866,4.5185410334346505,60.0,0.0
23290,2,3290,[286 742 117  22 405],796,3,14869,4.518079611060468,0.0,20.0
23291,2,3291,[318 427 496 357 257],330,5,14874,4.518226002430134,60.0,0.0
23292,2,3292,[318 427 496 357 257],330,5,14879,4.518372304889159,60.0,0.0
23293,2,3293,[ 71  28 423 357 655],450,4,14883,4.518214936247723,0.0,0.0
23294,2,3294,[318 427 496 357 257],330,5,14888,4.518361153262519,60.0,0.0
23295,2,3295,[  4  28  56 245  97],504,4,14892,4.518203883495145,0.0,0.0
23296,2,3296,[318 427 496 357 257],796,5,14897,4.518350015165302,60.0,0.0
23297,2,3297,[318 427 496 357 257],796,5,14902,4.518496058217101,60.0,0.0
23298,2,3298,[318 427 496 357 257],330,5,14907,4.518642012731131,60.0,0.0
23299,2,3299,[318 427 496 357 257],716,5,14912,4.518787878787879,60.0,0.0
23300,2,3300,[228 100 216 385 118],655,1,14913,4.517721902453802,0.0,20.0
23301,2,3301,[318 427 496 357 257],330,5,14918,4.5178679588128405,60.0,0.0
23302,2,3302,[597 271 385 546 265],807,4,14922,4.517711171662126,0.0,0.0
23303,2,3303,[318 427 496 357 257],330,5,14927,4.517857142857143,60.0,0.0
23304,2,3304,[318 427 496 357 257],796,5,14932,4.518003025718608,60.0,0.0
23305,2,3305,[318 427 496 357 257],330,5,14937,4.518148820326679,60.0,0.0
23306,2,3306,[318 427 496 357 257],796,5,14942,4.518294526761415,60.0,0.0
23307,2,3307,[289 127 318 276  28],655,3,14945,4.5178355501813785,20.0,20.0
23308,2,3308,[318 427 496 357 257],796,5,14950,4.517981263221517,60.0,0.0
23309,2,3309,[318 427 496 357 257],796,5,14955,4.518126888217522,60.0,0.0
23310,2,3310,[  9 121 173  98 238],786,4,14959,4.517970401691332,0.0,0.0
23311,2,3311,[318 427 496 357 257],796,5,14964,4.518115942028985,60.0,0.0
23312,2,3312,[318 427 496 357 257],716,5,14969,4.51826139450649,60.0,0.0
23313,2,3313,[588  64 405 179 186],577,3,14972,4.51780325890163,20.0,0.0
23314,2,3314,[318 427 496 357 257],716,5,14977,4.517948717948718,60.0,0.0
23315,2,3315,[318 427 496 357 257],330,5,14982,4.518094089264173,60.0,0.0
23316,2,3316,[318 427 496 357 257],330,5,14987,4.518239372927344,60.0,0.0
23317,2,3317,[318 427 496 357 257],716,5,14992,4.51838456901748,60.0,0.0
23318,2,3318,[318 427 496 357 257],716,5,14997,4.518529677613739,60.0,0.0
23319,2,3319,[318 427 496 357 257],716,5,15002,4.518674698795181,60.0,0.0
23320,2,3320,[318 427 496 357 257],716,5,15007,4.518819632640771,60.0,0.0
23321,2,3321,[318 427 496 357 257],330,5,15012,4.51896447922938,60.0,0.0
23322,2,3322,[328 333 132   9 300],655,0,15012,4.517604574179958,0.0,0.0
23323,2,3323,[318 427 496 357 257],330,5,15017,4.517749699157641,60.0,0.0
23324,2,3324,[151 318 286   9 300],535,3,15020,4.5172932330827065,20.0,20.0
23325,2,3325,[318 427 496 357 257],716,5,15025,4.517438364401683,60.0,0.0
23326,2,3326,[318 427 496 357 257],330,5,15030,4.517583408476105,60.0,0.0
23327,2,3327,[318 427 496 357 257],330,5,15035,4.517728365384615,60.0,0.0
23328,2,3328,[200 300  71 496   4],450,2,15037,4.516972063682788,20.0,0.0
23329,2,3329,[318 427 496 357 257],330,5,15042,4.517117117117117,60.0,0.0
23330,2,3330,[180  70 238 318 357],786,5,15047,4.517262083458421,20.0,0.0
23331,2,3331,[742 294 678 182  79],280,2,15049,4.516506602641057,0.0,0.0
23332,2,3332,[318 427 496 357 257],716,5,15054,4.516651665166517,60.0,0.0
23333,2,3333,[318 427 496 357 257],796,5,15059,4.516796640671866,60.0,0.0
23334,2,3334,[318 427 496 357 257],716,5,15064,4.516941529235383,60.0,0.0
23335,2,3335,[ 88 546  98  50 483],457,4,15068,4.516786570743405,0.0,20.0
23336,2,3336,[318 427 496 357 257],716,5,15073,4.516931375486965,60.0,0.0
23337,2,3337,[496  12 258 180 153],796,4,15077,4.5167765128819655,20.0,0.0
23338,2,3338,[318 427 496 357 257],330,5,15082,4.516921233902366,60.0,0.0
23339,2,3339,[318 427 496 357 257],330,5,15087,4.517065868263473,60.0,0.0
23340,2,3340,[318 427 496 357 257],796,5,15092,4.517210416043101,60.0,0.0
23341,2,3341,[318 427 496 357 257],330,5,15097,4.5173548773189705,60.0,0.0
23342,2,3342,[318 427 496 357 257],716,5,15102,4.517499252168711,60.0,0.0
23343,2,3343,[318 427 496 357 257],796,5,15107,4.517643540669856,60.0,0.0
23344,2,3344,[318 427 496 357 257],716,5,15112,4.51778774289985,60.0,0.0
23345,2,3345,[282 546 568  97  71],450,4,15116,4.517632994620442,0.0,0.0
23346,2,3346,[318 427 496 357 257],796,5,15121,4.517777113833284,60.0,0.0
23347,2,3347,[187  98  25 294 748],256,3,15124,4.5173237753882916,0.0,0.0
23348,2,3348,[318 427 496 357 257],716,5,15129,4.51746790086593,60.0,0.0
23349,2,3349,[318 427 496 357 257],330,5,15134,4.517611940298507,60.0,0.0
23350,2,3350,[318 427 496 357 257],716,5,15139,4.517755893763056,60.0,0.0
23351,2,3351,[318 427 496 357 257],716,5,15144,4.5178997613365155,60.0,0.0
23352,2,3352,[318 427 496 357 257],796,5,15149,4.518043543095735,60.0,0.0
23353,2,3353,[318 427 496 357 257],330,5,15154,4.518187239117472,60.0,0.0
23354,2,3354,[318 427 496 357 257],796,5,15159,4.5183308494783905,60.0,0.0
23355,2,3355,[135 183 300  50   7],450,4,15163,4.518176400476758,0.0,20.0
23356,2,3356,[423 172 204   8 222],457,5,15168,4.518319928507596,0.0,0.0
23357,2,3357,[318 427 496 357 257],716,5,15173,4.518463371054199,60.0,0.0
23358,2,3358,[318 427 496 357 257],716,5,15178,4.518606728192915,60.0,0.0
23359,2,3359,[318 427 496 357 257],796,5,15183,4.51875,60.0,0.0
23360,2,3360,[318 427 496 357 257],716,5,15188,4.5188931865516215,60.0,0.0
23361,2,3361,[318 427 496 357 257],330,5,15193,4.519036287923855,60.0,0.0
23362,2,3362,[118 135  12  98 174],457,5,15198,4.5191793041926855,0.0,0.0
23363,2,3363,[318 427 496 357 257],796,5,15203,4.519322235434007,60.0,0.0
23364,2,3364,[318 427 496 357 257],716,5,15208,4.5194650817236255,60.0,0.0
23365,2,3365,[318 427 496 357 257],796,5,15213,4.519607843137255,60.0,0.0
23366,2,3366,[202  82 237 245  97],256,4,15217,4.51945351945352,0.0,0.0
23367,2,3367,[318 427 496 357 257],330,5,15222,4.5195961995249405,60.0,0.0
23368,2,3368,[121 118 222 271 289],655,0,15222,4.518254674977738,0.0,0.0
23369,2,3369,[288   1 286 289 111],655,0,15222,4.516913946587537,0.0,20.0
23370,2,3370,[318 427 496 357 257],716,5,15227,4.51705725304064,60.0,0.0
23371,2,3371,[318 427 496 357 257],330,5,15232,4.517200474495848,60.0,0.0
23372,2,3372,[318 427 496 357 257],796,5,15237,4.517343611028758,60.0,0.0
23373,2,3373,[318 427 496 357 257],716,5,15242,4.517486662714878,60.0,0.0
23374,2,3374,[318 427 496 357 257],330,5,15247,4.51762962962963,60.0,0.0
23375,2,3375,[318 427 496 357 257],716,5,15252,4.517772511848341,60.0,0.0
23376,2,3376,[496 238  64   1  15],151,5,15257,4.517915309446254,40.0,0.0
23377,2,3377,[318 427 496 357 257],716,5,15262,4.518058022498519,60.0,0.0
23378,2,3378,[318 427 496 357 257],330,5,15267,4.5182006510802015,60.0,0.0
23379,2,3379,[318 427 496 357 257],330,5,15272,4.518343195266272,60.0,0.0
23380,2,3380,[318 427 496 357 257],796,5,15277,4.5184856551316175,60.0,0.0
23381,2,3381,[318 427 496 357 257],796,5,15282,4.518628030751035,60.0,0.0
23382,2,3382,[318 427 496 357 257],796,5,15287,4.518770322199232,60.0,0.0
23383,2,3383,[568 191 222 173  69],344,4,15291,4.5186170212765955,0.0,0.0
23384,2,3384,[222 176 294  70 603],716,4,15295,4.518463810930576,20.0,0.0
23385,2,3385,[318 427 496 357 257],716,5,15300,4.518606024808033,60.0,0.0
23386,2,3386,[318 427 496 357 257],796,5,15305,4.518748154709182,60.0,0.0
23387,2,3387,[318 427 496 357 257],330,5,15310,4.518890200708382,60.0,0.0
23388,2,3388,[318 427 496 357 257],330,5,15315,4.519032162879905,60.0,0.0
23389,2,3389,[318 427 496 357 257],796,5,15320,4.519174041297935,60.0,0.0
23390,2,3390,[588 185 197  79 132],457,5,15325,4.519315836036568,0.0,0.0
23391,2,3391,[  7 197  15  97 258],457,5,15330,4.519457547169812,0.0,0.0
23392,2,3392,[318 427 496 357 257],330,5,15335,4.519599174771589,60.0,0.0
23393,2,3393,[318 427 496 357 257],716,5,15340,4.519740718915734,60.0,0.0
23394,2,3394,[748 742   4 265  79],256,5,15345,4.519882179675994,0.0,0.0
23395,2,3395,[318 427 496 357 257],796,5,15350,4.520023557126031,60.0,0.0
23396,2,3396,[318 427 496 357 257],796,5,15355,4.520164851339417,60.0,0.0
23397,2,3397,[318 427 496 357 257],716,5,15360,4.520306062389641,60.0,0.0
23398,2,3398,[318 427 496 357 257],716,5,15365,4.520447190350103,60.0,0.0
23399,2,3399,[323 202  12  64 742],256,4,15369,4.520294117647059,20.0,0.0
23400,2,3400,[318 427 496 357 257],716,5,15374,4.520435166127609,60.0,0.0
23401,2,3401,[318 427 496 357 257],796,5,15379,4.520576131687243,60.0,0.0
23402,2,3402,[318 427 496 357 257],330,5,15384,4.52071701439906,60.0,0.0
23403,2,3403,[318 427 496 357 257],330,5,15389,4.520857814336075,60.0,0.0
23404,2,3404,[318 427 496 357 257],716,5,15394,4.520998531571219,60.0,0.0
23405,2,3405,[ 11 118 153 173 202],716,4,15398,4.520845566647093,0.0,0.0
23406,2,3406,[318 427 496 357 257],330,5,15403,4.5209862048723215,60.0,0.0
23407,2,3407,[151 186 185  50 235],457,4,15407,4.520833333333333,0.0,20.0
23408,2,3408,[318 427 496 357 257],716,5,15412,4.520973892637137,60.0,0.0
23409,2,3409,[318 427 496 357 257],330,5,15417,4.521114369501467,60.0,0.0
23410,2,3410,[318 427 496 357 257],716,5,15422,4.521254763998828,60.0,0.0
23411,2,3411,[318 427 496 357 257],796,5,15427,4.5213950762016415,60.0,0.0
23412,2,3412,[318 427 496 357 257],716,5,15432,4.521535306182244,60.0,0.0
23413,2,3413,[318 427 496 357 257],716,5,15437,4.521675454012888,60.0,0.0
23414,2,3414,[318 427 496 357 257],716,5,15442,4.521815519765739,60.0,0.0
23415,2,3415,[318 427 496 357 257],796,5,15447,4.5219555035128804,60.0,0.0
23416,2,3416,[318 427 496 357 257],716,5,15452,4.52209540532631,60.0,0.0
23417,2,3417,[318 427 496 357 257],716,5,15457,4.5222352252779405,60.0,0.0
23418,2,3418,[318 427 496 357 257],716,5,15462,4.522374963439602,60.0,0.0
23419,2,3419,[318 427 496 357 257],716,5,15467,4.522514619883041,60.0,0.0
23420,2,3420,[318 427 496 357 257],330,5,15472,4.522654194679919,60.0,0.0
23421,2,3421,[318 427 496 357 257],330,5,15477,4.522793687901812,60.0,0.0
23422,2,3422,[318 427 496 357 257],330,5,15482,4.522933099620216,60.0,0.0
23423,2,3423,[318 427 496 357 257],716,5,15487,4.523072429906542,60.0,0.0
23424,2,3424,[318 427 496 357 257],330,5,15492,4.523211678832117,60.0,0.0
23425,2,3425,[181 238 172 204  82],330,5,15497,4.523350846468184,0.0,0.0
23426,2,3426,[318 427 496 357 257],796,5,15502,4.523489932885906,60.0,0.0
23427,2,3427,[318 427 496 357 257],796,5,15507,4.523628938156359,60.0,0.0
23428,2,3428,[318 427 496 357 257],796,5,15512,4.52376786235054,60.0,0.0
23429,2,3429,[318 427 496 357 257],330,5,15517,4.523906705539359,60.0,0.0
23430,2,3430,[318 427 496 357 257],716,5,15522,4.524045467793647,60.0,0.0
23431,2,3431,[318 427 496 357 257],796,5,15527,4.5241841491841495,60.0,0.0
23432,2,3432,[318 427 496 357 257],796,5,15532,4.524322749781533,60.0,0.0
23433,2,3433,[238  25 125 328 235],450,3,15535,4.523878858474083,0.0,0.0
23434,2,3434,[318 427 496 357 257],716,5,15540,4.524017467248909,60.0,0.0
23435,2,3435,[318 427 496 357 257],716,5,15545,4.524155995343422,60.0,0.0
23436,2,3436,[235 546 265 194 302],450,4,15549,4.524003491416933,0.0,0.0
23437,2,3437,[318 427 496 357 257],330,5,15554,4.52414194299011,60.0,0.0
23438,2,3438,[318 427 496 357 257],716,5,15559,4.5242803140447805,60.0,0.0
23439,2,3439,[318 427 496 357 257],716,5,15564,4.524418604651163,60.0,0.0
23440,2,3440,[318 427 496 357 257],330,5,15569,4.5245568148793955,60.0,0.0
23441,2,3441,[748 435 181  79 258],151,4,15573,4.5244044160371875,0.0,0.0
23442,2,3442,[318 427 496 357 257],330,5,15578,4.524542550101655,60.0,0.0
23443,2,3443,[237 318 125 143  50],593,5,15583,4.524680603948896,20.0,20.0
23444,2,3444,[318 427 496 357 257],716,5,15588,4.524818577648766,60.0,0.0
23445,2,3445,[318 427 496 357 257],330,5,15593,4.524956471271039,60.0,0.0
23446,2,3446,[318 427 496 357 257],716,5,15598,4.525094284885408,60.0,0.0
23447,2,3447,[318 427 496 357 257],796,5,15603,4.525232018561485,60.0,0.0
23448,2,3448,[318 427 496 357 257],796,5,15608,4.525369672368803,60.0,0.0
23449,2,3449,[318 427 496 357 257],796,5,15613,4.525507246376812,60.0,0.0
23450,2,3450,[318 427 496 357 257],716,5,15618,4.525644740654883,60.0,0.0
23451,2,3451,[318 427 496 357 257],330,5,15623,4.525782155272306,60.0,0.0
23452,2,3452,[318 427 496 357 257],716,5,15628,4.525919490298292,60.0,0.0
23453,2,3453,[318 427 496 357 257],330,5,15633,4.526056745801969,60.0,0.0
23454,2,3454,[302 268 174  88 197],269,2,15635,4.525325615050651,0.0,0.0
23455,2,3455,[318 427 496 357 257],330,5,15640,4.525462962962963,60.0,0.0
23456,2,3456,[318 427 496 357 257],796,5,15645,4.525600231414521,60.0,0.0
23457,2,3457,[318 427 496 357 257],796,5,15650,4.525737420474263,60.0,0.0
23458,2,3458,[318 427 496 357 257],330,5,15655,4.525874530211044,60.0,0.0
23459,2,3459,[318 427 496 357 257],716,5,15660,4.526011560693641,60.0,0.0
23460,2,3460,[318 427 496 357 257],330,5,15665,4.526148511990754,60.0,0.0
23461,2,3461,[318 427 496 357 257],796,5,15670,4.526285384171,60.0,0.0
23462,2,3462,[318 427 496 357 257],330,5,15675,4.5264221773029165,60.0,0.0
23463,2,3463,[318 427 496 357 257],716,5,15680,4.5265588914549655,60.0,0.0
23464,2,3464,[168 313  88 185 100],707,1,15681,4.5255411255411255,0.0,20.0
23465,2,3465,[318 427 496 357 257],716,5,15686,4.525678015002885,60.0,0.0
23466,2,3466,[318 427 496 357 257],716,5,15691,4.525814825497548,60.0,0.0
23467,2,3467,[357 215 427 269 237],796,4,15695,4.525663206459054,20.0,0.0
23468,2,3468,[318 427 496 357 257],796,5,15700,4.525799942346498,60.0,0.0
23469,2,3469,[ 95  28 748 153 135],450,3,15703,4.52536023054755,0.0,0.0
23470,2,3470,[98 71 96  7  8],344,4,15707,4.52520887352348,0.0,0.0
23471,2,3471,[318 427 496 357 257],330,5,15712,4.525345622119816,60.0,0.0
23472,2,3472,[ 97 234 678 275  22],316,3,15715,4.524906420961704,0.0,20.0
23473,2,3473,[318 427 496 357 257],796,5,15720,4.525043177892919,60.0,0.0
23474,2,3474,[568 215  15 435 176],655,0,15720,4.5237410071942445,0.0,0.0
23475,2,3475,[318 427 496 357 257],716,5,15725,4.523878020713464,60.0,0.0
23476,2,3476,[318 427 496 357 257],796,5,15730,4.5240149554213405,60.0,0.0
23477,2,3477,[515 215 121  28 234],72,4,15734,4.523864289821737,0.0,0.0
23478,2,3478,[357 194  11 471 275],450,5,15739,4.524001149755677,0.0,20.0
23479,2,3479,[318 427 496 357 257],716,5,15744,4.524137931034483,60.0,0.0
23480,2,3480,[318 427 496 357 257],796,5,15749,4.524274633725941,60.0,0.0
23481,2,3481,[318 427 496 357 257],330,5,15754,4.52441125789776,60.0,0.0
23482,2,3482,[181 235  56  11 132],292,4,15758,4.52426069480333,0.0,0.0
23483,2,3483,[ 56   1  97 238  79],535,2,15760,4.52353616532721,0.0,0.0
23484,2,3484,[318 427 496 357 257],796,5,15765,4.523672883787661,60.0,0.0
23485,2,3485,[318 427 496 357 257],330,5,15770,4.523809523809524,60.0,0.0
23486,2,3486,[318 427 496 357 257],716,5,15775,4.523946085460281,60.0,0.0
23487,2,3487,[318 427 496 357 257],796,5,15780,4.52408256880734,60.0,0.0
23488,2,3488,[318 427 496 357 257],716,5,15785,4.524218973918028,60.0,0.0
23489,2,3489,[318 427 496 357 257],330,5,15790,4.5243553008595985,60.0,0.0
23490,2,3490,[318 427 496 357 257],716,5,15795,4.524491549699227,60.0,0.0
23491,2,3491,[318 427 496 357 257],716,5,15800,4.524627720504009,60.0,0.0
23492,2,3492,[318 427 496 357 257],330,5,15805,4.524763813340968,60.0,0.0
23493,2,3493,[318 427 496 357 257],796,5,15810,4.5248998282770465,60.0,0.0
23494,2,3494,[228 403 185   4 286],450,4,15814,4.524749642346209,0.0,20.0
23495,2,3495,[318 427 496 357 257],330,5,15819,4.524885583524028,60.0,0.0
23496,2,3496,[318 427 496 357 257],330,5,15824,4.525021446954533,60.0,0.0
23497,2,3497,[118 328 210  82  50],450,2,15826,4.524299599771298,0.0,20.0
23498,2,3498,[318 427 496 357 257],716,5,15831,4.524435553015147,60.0,0.0
23499,2,3499,[318 427 496 357 257],330,5,15836,4.524571428571429,60.0,0.0
23500,2,3500,[318 427 496 357 257],716,5,15841,4.524707226506712,60.0,0.0
23501,2,3501,[237 172 328  96 215],450,5,15846,4.5248429468874924,0.0,0.0
23502,2,3502,[318 427 496 357 257],796,5,15851,4.524978589780188,60.0,0.0
23503,2,3503,[318 427 496 357 257],716,5,15856,4.525114155251141,60.0,0.0
23504,2,3504,[318 427 496 357 257],796,5,15861,4.525249643366619,60.0,0.0
23505,2,3505,[318 427 496 357 257],796,5,15866,4.525385054192812,60.0,0.0
23506,2,3506,[597 385  89 546 173],23,3,15869,4.5249500998003995,0.0,0.0
23507,2,3507,[318 427 496 357 257],716,5,15874,4.525085518814139,60.0,0.0
23508,2,3508,[318 427 496 357 257],716,5,15879,4.525220860644058,60.0,0.0
23509,2,3509,[318 427 496 357 257],716,5,15884,4.525356125356125,60.0,0.0
23510,2,3510,[318 427 496 357 257],796,5,15889,4.525491313016235,60.0,0.0
23511,2,3511,[318 427 496 357 257],796,5,15894,4.525626423690205,60.0,0.0
23512,2,3512,[186 132   4 204 183],504,2,15896,4.524907486478793,0.0,0.0
23513,2,3513,[194   9  96  56 185],796,4,15900,4.524758110415481,0.0,0.0
23514,2,3514,[318 427 496 357 257],796,5,15905,4.524893314366999,60.0,0.0
23515,2,3515,[318 427 496 357 257],330,5,15910,4.525028441410694,60.0,0.0
23516,2,3516,[318 427 496 357 257],716,5,15915,4.52516349161217,60.0,0.0
23517,2,3517,[318 427 496 357 257],330,5,15920,4.525298465036953,60.0,0.0
23518,2,3518,[318 427 496 357 257],796,5,15925,4.525433361750498,60.0,0.0
23519,2,3519,[318 427 496 357 257],796,5,15930,4.525568181818182,60.0,0.0
23520,2,3520,[273 135  96 191 121],655,3,15933,4.525134904856575,0.0,0.0
23521,2,3521,[318 427 496 357 257],330,5,15938,4.52526973310619,60.0,0.0
23522,2,3522,[318 427 496 357 257],716,5,15943,4.525404484814079,60.0,0.0
23523,2,3523,[  8 273 118 151 215],796,4,15947,4.525255391600454,0.0,0.0
23524,2,3524,[318 427 496 357 257],330,5,15952,4.525390070921985,60.0,0.0
23525,2,3525,[318 427 496 357 257],796,5,15957,4.52552467385139,60.0,0.0
23526,2,3526,[318 427 496 357 257],716,5,15962,4.525659200453643,60.0,0.0
23527,2,3527,[318 427 496 357 257],716,5,15967,4.525793650793651,60.0,0.0
23528,2,3528,[318 427 496 357 257],330,5,15972,4.525928024936243,60.0,0.0
23529,2,3529,[318 427 496 357 257],716,5,15977,4.526062322946176,60.0,0.0
23530,2,3530,[ 69 385 238 200 174],450,4,15981,4.5259133389974515,0.0,0.0
23531,2,3531,[318 427 496 357 257],716,5,15986,4.526047565118913,60.0,0.0
23532,2,3532,[  1 237 121 100 181],457,5,15991,4.526181715256156,0.0,20.0
23533,2,3533,[245 403 568 117 471],450,5,15996,4.526315789473684,0.0,0.0
23534,2,3534,[318 427 496 357 257],796,5,16001,4.526449787835927,60.0,0.0
23535,2,3535,[318 427 496 357 257],330,5,16006,4.52658371040724,60.0,0.0
23536,2,3536,[318 427 496 357 257],796,5,16011,4.526717557251908,60.0,0.0
23537,2,3537,[191 161 117 195 196],796,5,16016,4.526851328434144,0.0,0.0
23538,2,3538,[172 176  69 127 216],716,4,16020,4.52670245832156,0.0,20.0
23539,2,3539,[318 427 496 357 257],796,5,16025,4.52683615819209,60.0,0.0
23540,2,3540,[318 427 496 357 257],716,5,16030,4.526969782547303,60.0,0.0
23541,2,3541,[318 427 496 357 257],716,5,16035,4.5271033314511575,60.0,0.0
23542,2,3542,[318 427 496 357 257],716,5,16040,4.527236804967542,60.0,0.0
23543,2,3543,[318 427 496 357 257],796,5,16045,4.527370203160271,60.0,0.0
23544,2,3544,[318 427 496 357 257],716,5,16050,4.5275035260930885,60.0,0.0
23545,2,3545,[318 427 496 357 257],330,5,16055,4.527636773829667,60.0,0.0
23546,2,3546,[318 427 496 357 257],716,5,16060,4.527769946433606,60.0,0.0
23547,2,3547,[318 427 496 357 257],716,5,16065,4.527903043968433,60.0,0.0
23548,2,3548,[318 427 496 357 257],716,5,16070,4.528036066497605,60.0,0.0
23549,2,3549,[318 427 496 357 257],796,5,16075,4.528169014084507,60.0,0.0
23550,2,3550,[181 405 568 132 168],269,2,16077,4.527457054350887,0.0,0.0
23551,2,3551,[471 234 222  98   9],256,5,16082,4.52759009009009,0.0,0.0
23552,2,3552,[318 427 496 357 257],330,5,16087,4.527723050942865,60.0,0.0
23553,2,3553,[100 143 603  88 185],796,4,16091,4.527574563871694,20.0,20.0
23554,2,3554,[318 427 496 357 257],796,5,16096,4.527707454289732,60.0,0.0
23555,2,3555,[318 427 496 357 257],330,5,16101,4.527840269966254,60.0,0.0
23556,2,3556,[318 427 496 357 257],330,5,16106,4.5279730109642955,60.0,0.0
23557,2,3557,[318 427 496 357 257],330,5,16111,4.528105677346824,60.0,0.0
23558,2,3558,[318 427 496 357 257],796,5,16116,4.528238269176735,60.0,0.0
23559,2,3559,[200 135 496 435 121],450,2,16118,4.527528089887641,20.0,0.0
23560,2,3560,[ 50 471  70  11   1],401,2,16120,4.526818309463634,0.0,20.0
23561,2,3561,[181 423 151 265 121],796,5,16125,4.526951151038742,0.0,0.0
23562,2,3562,[318 427 496 357 257],796,5,16130,4.52708391804659,60.0,0.0
23563,2,3563,[194 125 568  28 258],796,4,16134,4.526936026936027,0.0,0.0
23564,2,3564,[318 427 496 357 257],330,5,16139,4.527068723702665,60.0,0.0
23565,2,3565,[742  22 125 237  56],256,4,16143,4.526920919798093,0.0,0.0
23566,2,3566,[318 427 496 357 257],330,5,16148,4.527053546397533,60.0,0.0
23567,2,3567,[318 257 181 328 568],796,5,16153,4.527186098654709,20.0,0.0
23568,2,3568,[318 427 496 357 257],716,5,16158,4.52731857663211,60.0,0.0
23569,2,3569,[318 427 496 357 257],716,5,16163,4.527450980392157,60.0,0.0
23570,2,3570,[318 427 496 357 257],796,5,16168,4.527583309997199,60.0,0.0
23571,2,3571,[318 427 496 357 257],330,5,16173,4.527715565509518,60.0,0.0
23572,2,3572,[318 427 496 357 257],330,5,16178,4.527847746991323,60.0,0.0
23573,2,3573,[318 427 496 357 257],796,5,16183,4.527979854504757,60.0,0.0
23574,2,3574,[ 88 471 405  70 275],786,5,16188,4.528111888111888,0.0,20.0
23575,2,3575,[318 427 496 357 257],330,5,16193,4.5282438478747205,60.0,0.0
23576,2,3576,[318 427 496 357 257],796,5,16198,4.528375733855186,60.0,0.0
23577,2,3577,[318 427 496 357 257],796,5,16203,4.528507546115148,60.0,0.0
23578,2,3578,[318 427 496 357 257],716,5,16208,4.528639284716402,60.0,0.0
23579,2,3579,[273 588 117 175 322],344,3,16211,4.528212290502793,0.0,0.0
23580,2,3580,[318 427 496 357 257],716,5,16216,4.5283440379782185,60.0,0.0
23581,2,3581,[318 427 496 357 257],716,5,16221,4.528475711892797,60.0,0.0
23582,2,3582,[318 427 496 357 257],716,5,16226,4.528607312308122,60.0,0.0
23583,2,3583,[318 427 496 357 257],716,5,16231,4.528738839285714,60.0,0.0
23584,2,3584,[269  12 748 195 235],450,4,16235,4.528591352859135,0.0,0.0
23585,2,3585,[ 56 117 173  22  82],577,4,16239,4.528443948689348,0.0,0.0
23586,2,3586,[318 427 496 357 257],716,5,16244,4.528575411207137,60.0,0.0
23587,2,3587,[  7  88 143 196 603],23,2,16246,4.527870680044593,20.0,0.0
23588,2,3588,[318 427 496 357 257],330,5,16251,4.528002229033157,60.0,0.0
23589,2,3589,[318 427 496 357 257],796,5,16256,4.528133704735376,60.0,0.0
23590,2,3590,[318 427 496 357 257],796,5,16261,4.5282651072124755,60.0,0.0
23591,2,3591,[235 288 196  70 435],450,3,16264,4.527839643652562,0.0,0.0
23592,2,3592,[318 427 496 357 257],330,5,16269,4.527971054828834,60.0,0.0
23593,2,3593,[318 427 496 357 257],330,5,16274,4.528102392877018,60.0,0.0
23594,2,3594,[318 427 496 357 257],796,5,16279,4.528233657858136,60.0,0.0
23595,2,3595,[174  88 185 200 180],716,4,16283,4.528086763070078,0.0,0.0
23596,2,3596,[318 427 496 357 257],796,5,16288,4.52821795941062,60.0,0.0
23597,2,3597,[318 427 496 357 257],716,5,16293,4.528349082823791,60.0,0.0
23598,2,3598,[132 215 301   7  56],151,4,16297,4.52820227841067,0.0,0.0
23599,2,3599,[318 427 496 357 257],330,5,16302,4.528333333333333,60.0,0.0
23600,2,3600,[318 427 496 357 257],796,5,16307,4.528464315467925,60.0,0.0
23601,2,3601,[318 427 496 357 257],330,5,16312,4.52859522487507,60.0,0.0
23602,2,3602,[182 302 121 132 186],450,3,16315,4.528170968637247,0.0,0.0
23603,2,3603,[318 427 496 357 257],796,5,16320,4.528301886792453,60.0,0.0
23604,2,3604,[318 427 496 357 257],716,5,16325,4.528432732316228,60.0,0.0
23605,2,3605,[318 427 496 357 257],796,5,16330,4.5285635052689965,60.0,0.0
23606,2,3606,[318 427 496 357 257],796,5,16335,4.528694205711117,60.0,0.0
23607,2,3607,[318 427 496 357 257],330,5,16340,4.528824833702883,60.0,0.0
23608,2,3608,[135 322 121 265 127],450,3,16343,4.528401219174286,0.0,20.0
23609,2,3609,[318 427 496 357 257],716,5,16348,4.528531855955679,60.0,0.0
23610,2,3610,[318 427 496 357 257],796,5,16353,4.528662420382165,60.0,0.0
23611,2,3611,[318 427 496 357 257],330,5,16358,4.528792912513842,60.0,0.0
23612,2,3612,[318 427 496 357 257],796,5,16363,4.528923332410739,60.0,0.0
23613,2,3613,[318 427 496 357 257],330,5,16368,4.529053680132817,60.0,0.0
23614,2,3614,[318 427 496 357 257],796,5,16373,4.529183955739972,60.0,0.0
23615,2,3615,[318 427 496 357 257],330,5,16378,4.529314159292035,60.0,0.0
23616,2,3616,[318 427 496 357 257],796,5,16383,4.52944429084877,60.0,0.0
23617,2,3617,[  8 275 282 111  88],457,4,16387,4.529297954671089,0.0,20.0
23618,2,3618,[318 427 496 357 257],330,5,16392,4.529428018789721,60.0,0.0
23619,2,3619,[318 427 496 357 257],796,5,16397,4.5295580110497236,60.0,0.0
23620,2,3620,[508 483  69 273 275],401,2,16399,4.528859431096382,0.0,20.0
23621,2,3621,[318 427 496 357 257],716,5,16404,4.528989508558808,60.0,0.0
23622,2,3622,[318 427 496 357 257],796,5,16409,4.529119514214739,60.0,0.0
23623,2,3623,[182 194 174   1 100],535,3,16412,4.52869757174393,0.0,20.0
23624,2,3624,[318 427 496 357 257],330,5,16417,4.528827586206897,60.0,0.0
23625,2,3625,[318 427 496 357 257],796,5,16422,4.528957528957529,60.0,0.0
23626,2,3626,[318 427 496 357 257],330,5,16427,4.529087400055142,60.0,0.0
23627,2,3627,[318 427 496 357 257],330,5,16432,4.529217199558985,60.0,0.0
23628,2,3628,[143  96 546 195 185],796,5,16437,4.529346927528245,0.0,0.0
23629,2,3629,[234 273 117 174 196],450,3,16440,4.528925619834711,0.0,0.0
23630,2,3630,[318 427 496 357 257],330,5,16445,4.52905535665106,60.0,0.0
23631,2,3631,[318 427 496 357 257],716,5,16450,4.529185022026431,60.0,0.0
23632,2,3632,[318 427 496 357 257],330,5,16455,4.5293146160198186,60.0,0.0
23633,2,3633,[318 427 496 357 257],796,5,16460,4.529444138690149,60.0,0.0
23634,2,3634,[318 427 496 357 257],330,5,16465,4.529573590096286,60.0,0.0
23635,2,3635,[318 427 496 357 257],330,5,16470,4.52970297029703,60.0,0.0
23636,2,3636,[318 427 496 357 257],330,5,16475,4.529832279351114,60.0,0.0
23637,2,3637,[318 427 496 357 257],796,5,16480,4.529961517317207,60.0,0.0
23638,2,3638,[318 427 496 357 257],796,5,16485,4.530090684253916,60.0,0.0
23639,2,3639,[185 238 237 258 269],796,3,16488,4.52967032967033,0.0,0.0
23640,2,3640,[588 121 275 176 742],457,5,16493,4.529799505630321,0.0,20.0
23641,2,3641,[405  96  79 546 483],716,3,16496,4.529379461834157,0.0,0.0
23642,2,3642,[318 427 496 357 257],796,5,16501,4.529508646719736,60.0,0.0
23643,2,3643,[427 423  79 135 237],72,4,16505,4.529363336992316,20.0,0.0
23644,2,3644,[ 56 197 210  64  70],716,5,16510,4.5294924554183815,20.0,0.0
23645,2,3645,[318 427 496 357 257],716,5,16515,4.529621503017005,60.0,0.0
23646,2,3646,[318 427 496 357 257],716,5,16520,4.529750479846449,60.0,0.0
23647,2,3647,[318 427 496 357 257],330,5,16525,4.529879385964913,60.0,0.0
23648,2,3648,[318 427 496 357 257],716,5,16530,4.530008221430529,60.0,0.0
23649,2,3649,[318 427 496 357 257],716,5,16535,4.53013698630137,60.0,0.0
23650,2,3650,[183 195 403 496 678],280,1,16536,4.529170090386196,20.0,0.0
23651,2,3651,[318 427 496 357 257],796,5,16541,4.529299014238774,60.0,0.0
23652,2,3652,[318 427 496 357 257],796,5,16546,4.5294278675061594,60.0,0.0
23653,2,3653,[318 427 496 357 257],330,5,16551,4.529556650246305,60.0,0.0
23654,2,3654,[318 427 496 357 257],330,5,16556,4.5296853625171,60.0,0.0
23655,2,3655,[185 471 216 275 202],401,5,16561,4.529814004376368,0.0,20.0
23656,2,3656,[318 427 496 357 257],330,5,16566,4.52994257588187,60.0,0.0
23657,2,3657,[318 427 496 357 257],716,5,16571,4.530071077091307,60.0,0.0
23658,2,3658,[ 64 471 100  82 197],655,1,16572,4.5291063132003275,20.0,20.0
23659,2,3659,[318 427 496 357 257],716,5,16577,4.529234972677596,60.0,0.0
23660,2,3660,[318 427 496 357 257],330,5,16582,4.529363561868342,60.0,0.0
23661,2,3661,[318 427 496 357 257],330,5,16587,4.529492080830147,60.0,0.0
23662,2,3662,[194  50 200 211  79],450,4,16591,4.529347529347529,0.0,20.0
23663,2,3663,[318 427 496 357 257],330,5,16596,4.529475982532751,60.0,0.0
23664,2,3664,[318 427 496 357 257],716,5,16601,4.529604365620736,60.0,0.0
23665,2,3665,[318 427 496 357 257],796,5,16606,4.529732678668849,60.0,0.0
23666,2,3666,[318 427 496 357 257],330,5,16611,4.529860921734388,60.0,0.0
23667,2,3667,[318 427 496 357 257],330,5,16616,4.529989094874591,60.0,0.0
23668,2,3668,[318 427 496 357 257],716,5,16621,4.530117198146634,60.0,0.0
23669,2,3669,[222  15  89 235 121],450,1,16622,4.529155313351499,0.0,0.0
23670,2,3670,[318 427 496 357 257],330,5,16627,4.5292835739580495,60.0,0.0
23671,2,3671,[196 301 603 423 258],796,4,16631,4.529139433551198,20.0,0.0
23672,2,3672,[318 427 496 357 257],716,5,16636,4.5292676286414375,60.0,0.0
23673,2,3673,[318 427 496 357 257],716,5,16641,4.529395753946652,60.0,0.0
23674,2,3674,[318 427 496 357 257],716,5,16646,4.52952380952381,60.0,0.0
23675,2,3675,[318 427 496 357 257],716,5,16651,4.529651795429815,60.0,0.0
23676,2,3676,[318 427 496 357 257],330,5,16656,4.529779711721512,60.0,0.0
23677,2,3677,[318 427 496 357 257],716,5,16661,4.529907558455682,60.0,0.0
23678,2,3678,[127 183 100 200 322],450,4,16665,4.529763522696385,0.0,40.0
23679,2,3679,[318 427 496 357 257],796,5,16670,4.529891304347826,60.0,0.0
23680,2,3680,[182 234  64 185  89],457,5,16675,4.5300190165715835,20.0,0.0
23681,2,3681,[318 427 496 357 257],796,5,16680,4.530146659424226,60.0,0.0
23682,2,3682,[318 427 496 357 257],330,5,16685,4.530274232962259,60.0,0.0
23683,2,3683,[318 427 496 357 257],796,5,16690,4.530401737242128,60.0,0.0
23684,2,3684,[318 427 496 357 257],330,5,16695,4.530529172320217,60.0,0.0
23685,2,3685,[318 427 496 357 257],716,5,16700,4.530656538252849,60.0,0.0
23686,2,3686,[318 427 496 357 257],716,5,16705,4.530783835096284,60.0,0.0
23687,2,3687,[173 238 153 603 111],389,2,16707,4.530097613882863,20.0,0.0
23688,2,3688,[302 258 423 172  96],450,5,16712,4.530224993223095,0.0,0.0
23689,2,3689,[318 427 496 357 257],796,5,16717,4.530352303523035,60.0,0.0
23690,2,3690,[318 427 496 357 257],330,5,16722,4.530479544838797,60.0,0.0
23691,2,3691,[318 427 496 357 257],716,5,16727,4.530606717226435,60.0,0.0
23692,2,3692,[302 151 357 237  97],401,2,16729,4.5299214730571356,0.0,0.0
23693,2,3693,[318 427 496 357 257],796,5,16734,4.530048727666486,60.0,0.0
23694,2,3694,[318 427 496 357 257],716,5,16739,4.530175913396482,60.0,0.0
23695,2,3695,[318 427 496 357 257],716,5,16744,4.53030303030303,60.0,0.0
23696,2,3696,[183 215  56 269  82],23,2,16746,4.529618609683527,0.0,0.0
23697,2,3697,[318 427 496 357 257],796,5,16751,4.52974580854516,60.0,0.0
23698,2,3698,[313 191   4 210 176],655,2,16753,4.5290619086239525,0.0,0.0
23699,2,3699,[318 427 496 357 257],330,5,16758,4.529189189189189,60.0,0.0
23700,2,3700,[318 427 496 357 257],716,5,16763,4.52931640097271,60.0,0.0
23701,2,3701,[318 427 496 357 257],330,5,16768,4.529443544030254,60.0,0.0
23702,2,3702,[318 427 496 357 257],330,5,16773,4.529570618417499,60.0,0.0
23703,2,3703,[318 427 496 357 257],796,5,16778,4.529697624190065,60.0,0.0
23704,2,3704,[172 202 173  95 117],450,4,16782,4.529554655870445,0.0,0.0
23705,2,3705,[144 210 172 175  64],716,3,16785,4.529141932002159,20.0,0.0
23706,2,3706,[318 427 496 357 257],796,5,16790,4.529268950633936,60.0,0.0
23707,2,3707,[ 98  56 483 275 144],796,5,16795,4.529395900755124,0.0,20.0
23708,2,3708,[204 678 269 151 357],344,4,16799,4.529253167969803,0.0,0.0
23709,2,3709,[318 427 496 357 257],716,5,16804,4.529380053908356,60.0,0.0
23710,2,3710,[318 427 496 357 257],330,5,16809,4.529506871463218,60.0,0.0
23711,2,3711,[483 197 588 153 515],18,5,16814,4.529633620689655,0.0,0.0
23712,2,3712,[318 427 496 357 257],716,5,16819,4.5297603016428765,60.0,0.0
23713,2,3713,[318 427 496 357 257],330,5,16824,4.529886914378029,60.0,0.0
23714,2,3714,[318 427 496 357 257],330,5,16829,4.530013458950202,60.0,0.0
23715,2,3715,[318 427 496 357 257],716,5,16834,4.530139935414424,60.0,0.0
23716,2,3716,[318 427 496 357 257],330,5,16839,4.530266343825666,60.0,0.0
23717,2,3717,[ 28 238 318 328  89],450,5,16844,4.530392684238838,20.0,0.0
23718,2,3718,[318 427 496 357 257],796,5,16849,4.530518956708793,60.0,0.0
23719,2,3719,[111 302 655 300  50],655,2,16851,4.52983870967742,0.0,20.0
23720,2,3720,[318 427 496 357 257],330,5,16856,4.529965063155066,60.0,0.0
23721,2,3721,[204 175 234 195  28],151,4,16860,4.529822675980656,0.0,0.0
23722,2,3722,[318 427 496 357 257],796,5,16865,4.5299489658877246,60.0,0.0
23723,2,3723,[318 427 496 357 257],716,5,16870,4.530075187969925,60.0,0.0
23724,2,3724,[318 427 496 357 257],716,5,16875,4.530201342281879,60.0,0.0
23725,2,3725,[318 427 496 357 257],796,5,16880,4.530327428878153,60.0,0.0
23726,2,3726,[318 427 496 357 257],796,5,16885,4.5304534478132545,60.0,0.0
23727,2,3727,[318 427 496 357 257],796,5,16890,4.530579399141631,60.0,0.0
23728,2,3728,[318 427 496 357 257],716,5,16895,4.530705282917673,60.0,0.0
23729,2,3729,[318 427 496 357 257],796,5,16900,4.53083109919571,60.0,0.0
23730,2,3730,[318 427 496 357 257],796,5,16905,4.530956848030018,60.0,0.0
23731,2,3731,[318 427 496 357 257],716,5,16910,4.531082529474812,60.0,0.0
23732,2,3732,[318 427 496 357 257],716,5,16915,4.531208143584249,60.0,0.0
23733,2,3733,[318 427 496 357 257],330,5,16920,4.531333690412426,60.0,0.0
23734,2,3734,[318 427 496 357 257],330,5,16925,4.531459170013387,60.0,0.0
23735,2,3735,[318 427 496 357 257],330,5,16930,4.531584582441114,60.0,0.0
23736,2,3736,[  1 183 427 275 265],716,4,16934,4.5314423334225316,20.0,20.0
23737,2,3737,[318 427 496 357 257],330,5,16939,4.531567683253076,60.0,0.0
23738,2,3738,[318 427 496 357 257],330,5,16944,4.531692966033699,60.0,0.0
23739,2,3739,[328 100 111 268 275],629,4,16948,4.531550802139037,0.0,40.0
23740,2,3740,[318 427 496 357 257],796,5,16953,4.5316760224538895,60.0,0.0
23741,2,3741,[318 427 496 357 257],796,5,16958,4.531801175841796,60.0,0.0
23742,2,3742,[318 427 496 357 257],716,5,16963,4.531926262356398,60.0,0.0
23743,2,3743,[318 427 496 357 257],330,5,16968,4.532051282051282,60.0,0.0
23744,2,3744,[318 427 496 357 257],796,5,16973,4.532176234979973,60.0,0.0
23745,2,3745,[318 427 496 357 257],796,5,16978,4.5323011211959425,60.0,0.0
23746,2,3746,[318 427 496 357 257],716,5,16983,4.532425940752602,60.0,0.0
23747,2,3747,[318 427 496 357 257],330,5,16988,4.532550693703309,60.0,0.0
23748,2,3748,[318 427 496 357 257],330,5,16993,4.53267538010136,60.0,0.0
23749,2,3749,[125   9 153  50 282],292,4,16997,4.532533333333333,0.0,20.0
23750,2,3750,[318 427 496 357 257],330,5,17002,4.532657957877899,60.0,0.0
23751,2,3751,[318 427 496 357 257],716,5,17007,4.532782515991471,60.0,0.0
23752,2,3752,[318 427 496 357 257],716,5,17012,4.532907007727152,60.0,0.0
23753,2,3753,[191 196 175 423 228],655,1,17013,4.5319659030367605,0.0,0.0
23754,2,3754,[318 427 496 357 257],330,5,17018,4.532090545938749,60.0,0.0
23755,2,3755,[210 151 286  82 185],796,2,17020,4.531416400425985,0.0,20.0
23756,2,3756,[318 427 496 357 257],716,5,17025,4.531541123236625,60.0,0.0
23757,2,3757,[318 427 496 357 257],716,5,17030,4.531665779670037,60.0,0.0
23758,2,3758,[228 234 202   1 568],457,5,17035,4.531790369779197,0.0,0.0
23759,2,3759,[318 427 496 357 257],330,5,17040,4.531914893617022,60.0,0.0
23760,2,3760,[ 70  89 318 546 483],450,4,17044,4.531773464504122,20.0,0.0
23761,2,3761,[318 427 496 357 257],796,5,17049,4.531897926634769,60.0,0.0
23762,2,3762,[403  96 202 211  22],796,4,17053,4.531756577199043,0.0,0.0
23763,2,3763,[ 98 176 313 328  25],450,4,17057,4.531615302869288,0.0,0.0
23764,2,3764,[135 333  56 273 215],693,3,17060,4.53120849933599,0.0,0.0
23765,2,3765,[318 427 496 357 257],796,5,17065,4.531332979288369,60.0,0.0
23766,2,3766,[318 427 496 357 257],330,5,17070,4.531457393151048,60.0,0.0
23767,2,3767,[318 427 496 357 257],716,5,17075,4.5315817409766455,60.0,0.0
23768,2,3768,[318 427 496 357 257],716,5,17080,4.5317060228177235,60.0,0.0
23769,2,3769,[318 427 496 357 257],716,5,17085,4.531830238726791,60.0,0.0
23770,2,3770,[318 427 496 357 257],716,5,17090,4.531954388756298,60.0,0.0
23771,2,3771,[318 427 496 357 257],796,5,17095,4.532078472958642,60.0,0.0
23772,2,3772,[ 97  88   9  71 234],504,3,17098,4.53167240922343,0.0,0.0
23773,2,3773,[318 427 496 357 257],796,5,17103,4.531796502384737,60.0,0.0
23774,2,3774,[318 427 496 357 257],330,5,17108,4.531920529801324,60.0,0.0
23775,2,3775,[318 427 496 357 257],330,5,17113,4.532044491525424,60.0,0.0
23776,2,3776,[318 427 496 357 257],716,5,17118,4.532168387609214,60.0,0.0
23777,2,3777,[183  25   7 234 568],693,3,17121,4.531762837480148,0.0,0.0
23778,2,3778,[568 197 168  95   1],796,3,17124,4.531357501984652,0.0,0.0
23779,2,3779,[318 427 496 357 257],330,5,17129,4.531481481481482,60.0,0.0
23780,2,3780,[318 427 496 357 257],330,5,17134,4.531605395398043,60.0,0.0
23781,2,3781,[655 222  98 289 197],786,4,17138,4.53146483342147,0.0,0.0
23782,2,3782,[318 427 496 357 257],330,5,17143,4.531588686227861,60.0,0.0
23783,2,3783,[ 98 211 127 483 234],450,3,17146,4.531183932346723,0.0,20.0
23784,2,3784,[318 427 496 357 257],330,5,17151,4.531307793923382,60.0,0.0
23785,2,3785,[318 427 496 357 257],716,5,17156,4.531431590068674,60.0,0.0
23786,2,3786,[ 15  71 185 483 153],389,3,17159,4.531027198310008,0.0,0.0
23787,2,3787,[182 318 237 176 173],269,2,17161,4.5303590285110875,20.0,0.0
23788,2,3788,[318 427 496 357 257],716,5,17166,4.530482977038797,60.0,0.0
23789,2,3789,[  4 202 568 179 318],577,3,17169,4.530079155672823,20.0,0.0
23790,2,3790,[258 125 742 294 173],450,5,17174,4.5302031126351885,0.0,0.0
23791,2,3791,[318 427 496 357 257],796,5,17179,4.5303270042194095,60.0,0.0
23792,2,3792,[210 211 427  97 181],450,4,17183,4.53018718692328,20.0,0.0
23793,2,3793,[318 427 496 357 257],716,5,17188,4.5303110173958885,60.0,0.0
23794,2,3794,[168 143 191 588 194],716,5,17193,4.530434782608696,0.0,0.0
23795,2,3795,[318 427 496 357 257],330,5,17198,4.530558482613277,60.0,0.0
23796,2,3796,[318 427 496 357 257],716,5,17203,4.530682117461153,60.0,0.0
23797,2,3797,[111 172 153  64 313],236,3,17206,4.530279094260137,20.0,0.0
23798,2,3798,[318 427 496 357 257],796,5,17211,4.530402737562516,60.0,0.0
23799,2,3799,[318 427 496 357 257],796,5,17216,4.530526315789474,60.0,0.0
23800,2,3800,[318 427 496 357 257],716,5,17221,4.53064982899237,60.0,0.0
23801,2,3801,[318 427 496 357 257],796,5,17226,4.530773277222514,60.0,0.0
23802,2,3802,[121 135   4 265  56],716,3,17229,4.530370759926374,0.0,0.0
23803,2,3803,[318 427 496 357 257],796,5,17234,4.53049421661409,60.0,0.0
23804,2,3804,[318 427 496 357 257],796,5,17239,4.530617608409987,60.0,0.0
23805,2,3805,[318 427 496 357 257],330,5,17244,4.530740935365213,60.0,0.0
23806,2,3806,[318 427 496 357 257],330,5,17249,4.530864197530864,60.0,0.0
23807,2,3807,[318 427 496 357 257],796,5,17254,4.530987394957983,60.0,0.0
23808,2,3808,[318 427 496 357 257],796,5,17259,4.5311105276975585,60.0,0.0
23809,2,3809,[318 427 496 357 257],796,5,17264,4.531233595800525,60.0,0.0
23810,2,3810,[318 427 496 357 257],330,5,17269,4.531356599317764,60.0,0.0
23811,2,3811,[318 427 496 357 257],330,5,17274,4.531479538300105,60.0,0.0
23812,2,3812,[318 427 496 357 257],796,5,17279,4.531602412798321,60.0,0.0
23813,2,3813,[318 427 496 357 257],716,5,17284,4.531725222863136,60.0,0.0
23814,2,3814,[318 427 496 357 257],716,5,17289,4.531847968545216,60.0,0.0
23815,2,3815,[318 427 496 357 257],796,5,17294,4.531970649895178,60.0,0.0
23816,2,3816,[318 427 496 357 257],330,5,17299,4.532093266963584,60.0,0.0
23817,2,3817,[318 427 496 357 257],796,5,17304,4.532215819800943,60.0,0.0
23818,2,3818,[318 427 496 357 257],330,5,17309,4.532338308457711,60.0,0.0
23819,2,3819,[318 427 496 357 257],330,5,17314,4.532460732984293,60.0,0.0
23820,2,3820,[318 427 496 357 257],796,5,17319,4.532583093431039,60.0,0.0
23821,2,3821,[318 427 496 357 257],330,5,17324,4.532705389848247,60.0,0.0
23822,2,3822,[179 173 182 228 200],450,4,17328,4.532566047606592,0.0,0.0
23823,2,3823,[318 427 496 357 257],796,5,17333,4.532688284518828,60.0,0.0
23824,2,3824,[588 313 161 257 121],807,5,17338,4.53281045751634,0.0,0.0
23825,2,3825,[210 328 515 471 185],655,2,17340,4.532148457919498,0.0,0.0
23826,2,3826,[318 427 496 357 257],716,5,17345,4.53227070812647,60.0,0.0
23827,2,3827,[235 294  71 273 275],450,2,17347,4.531609195402299,0.0,20.0
23828,2,3828,[318 427 496 357 257],330,5,17352,4.531731522590754,60.0,0.0
23829,2,3829,[179 202 197 174 183],457,5,17357,4.5318537859007835,0.0,0.0
23830,2,3830,[318 427 496 357 257],716,5,17362,4.531975985382407,60.0,0.0
23831,2,3831,[318 427 496 357 257],330,5,17367,4.532098121085595,60.0,0.0
23832,2,3832,[318 427 496 357 257],796,5,17372,4.532220193060266,60.0,0.0
23833,2,3833,[318 427 496 357 257],330,5,17377,4.532342201356286,60.0,0.0
23834,2,3834,[318 427 496 357 257],330,5,17382,4.532464146023468,60.0,0.0
23835,2,3835,[318 427 496 357 257],796,5,17387,4.5325860271115745,60.0,0.0
23836,2,3836,[318 427 496 357 257],796,5,17392,4.532707844670315,60.0,0.0
23837,2,3837,[245 111 200 186 282],450,3,17395,4.532308494007295,0.0,0.0
23838,2,3838,[318 427 496 357 257],716,5,17400,4.532430320395936,60.0,0.0
23839,2,3839,[118  96 172 748 179],450,4,17404,4.532291666666667,0.0,0.0
23840,2,3840,[318 427 496 357 257],716,5,17409,4.532413434001562,60.0,0.0
23841,2,3841,[318 427 496 357 257],796,5,17414,4.532535137948985,60.0,0.0
23842,2,3842,[144 603 127 403 483],796,5,17419,4.532656778558418,20.0,20.0
23843,2,3843,[318 427 496 357 257],330,5,17424,4.532778355879293,60.0,0.0
23844,2,3844,[318 427 496 357 257],716,5,17429,4.532899869960988,60.0,0.0
23845,2,3845,[318 427 496 357 257],716,5,17434,4.533021320852834,60.0,0.0
23846,2,3846,[318 427 496 357 257],796,5,17439,4.533142708604107,60.0,0.0
23847,2,3847,[318 427 496 357 257],716,5,17444,4.533264033264033,60.0,0.0
23848,2,3848,[318 427 496 357 257],330,5,17449,4.533385294881787,60.0,0.0
23849,2,3849,[318 427 496 357 257],796,5,17454,4.5335064935064935,60.0,0.0
23850,2,3850,[318 427 496 357 257],716,5,17459,4.533627629187224,60.0,0.0
23851,2,3851,[742 179  98  56 196],593,5,17464,4.533748701973001,0.0,0.0
23852,2,3852,[318 427 496 357 257],796,5,17469,4.5338697119127955,60.0,0.0
23853,2,3853,[318 427 496 357 257],330,5,17474,4.533990659055527,60.0,0.0
23854,2,3854,[318 427 496 357 257],716,5,17479,4.534111543450065,60.0,0.0
23855,2,3855,[318 427 496 357 257],796,5,17484,4.534232365145228,60.0,0.0
23856,2,3856,[318 427 496 357 257],330,5,17489,4.534353124189785,60.0,0.0
23857,2,3857,[318 427 496 357 257],796,5,17494,4.534473820632452,60.0,0.0
23858,2,3858,[275 186  15 427 173],389,2,17496,4.533817051049494,20.0,20.0
23859,2,3859,[143 238  96 742 168],436,2,17498,4.533160621761658,0.0,0.0
23860,2,3860,[318 427 496 357 257],796,5,17503,4.533281533281533,60.0,0.0
23861,2,3861,[318 427 496 357 257],796,5,17508,4.533402382185396,60.0,0.0
23862,2,3862,[318 204   9 276 435],18,4,17512,4.533264302355682,20.0,0.0
23863,2,3863,[318 427 496 357 257],796,5,17517,4.533385093167702,60.0,0.0
23864,2,3864,[318 427 496 357 257],716,5,17522,4.533505821474773,60.0,0.0
23865,2,3865,[318 427 496 357 257],716,5,17527,4.533626487325401,60.0,0.0
23866,2,3866,[318 427 496 357 257],796,5,17532,4.5337470907680375,60.0,0.0
23867,2,3867,[318 427 496 357 257],716,5,17537,4.533867631851086,60.0,0.0
23868,2,3868,[180 195 403 385 405],457,5,17542,4.5339881106229,0.0,0.0
23869,2,3869,[318 427 496 357 257],796,5,17547,4.534108527131783,60.0,0.0
23870,2,3870,[318 427 496 357 257],330,5,17552,4.534228881425988,60.0,0.0
23871,2,3871,[318 427 496 357 257],716,5,17557,4.534349173553719,60.0,0.0
23872,2,3872,[318 427 496 357 257],716,5,17562,4.534469403563129,60.0,0.0
23873,2,3873,[318 427 496 357 257],716,5,17567,4.534589571502323,60.0,0.0
23874,2,3874,[238 186  98 276  11],535,3,17570,4.534193548387097,0.0,0.0
23875,2,3875,[318 427 496 357 257],716,5,17575,4.534313725490196,60.0,0.0
23876,2,3876,[318 427 496 357 257],716,5,17580,4.534433840598401,60.0,0.0
23877,2,3877,[318 427 496 357 257],796,5,17585,4.53455389375967,60.0,0.0
23878,2,3878,[546 151  79 423 655],450,5,17590,4.534673885021913,0.0,0.0
23879,2,3879,[546 294 191 301 127],450,5,17595,4.53479381443299,0.0,20.0
23880,2,3880,[318 427 496 357 257],716,5,17600,4.534913682040711,60.0,0.0
23881,2,3881,[191  56 282 294   9],796,3,17603,4.534518289541474,0.0,0.0
23882,2,3882,[  4  28 282 172 271],796,4,17607,4.534380633530775,0.0,0.0
23883,2,3883,[318 427 496 357 257],796,5,17612,4.534500514933058,60.0,0.0
23884,2,3884,[318 427 496 357 257],796,5,17617,4.534620334620334,60.0,0.0
23885,2,3885,[318 427 496 357 257],796,5,17622,4.534740092640247,60.0,0.0
23886,2,3886,[ 28  98 234 180 121],796,2,17624,4.534087985593002,0.0,0.0
23887,2,3887,[195 603 237  79 282],655,2,17626,4.533436213991769,20.0,0.0
23888,2,3888,[318 427 496 357 257],330,5,17631,4.533556184109026,60.0,0.0
23889,2,3889,[318 427 496 357 257],716,5,17636,4.5336760925449875,60.0,0.0
23890,2,3890,[318 427 496 357 257],330,5,17641,4.533795939347211,60.0,0.0
23891,2,3891,[151 282  56 202 405],450,5,17646,4.533915724563206,0.0,0.0
23892,2,3892,[318 427 496 357 257],796,5,17651,4.534035448240432,60.0,0.0
23893,2,3893,[125 195 121  88 289],655,0,17651,4.5328710837185415,0.0,0.0
23894,2,3894,[318 427 496 357 257],716,5,17656,4.532991014120667,60.0,0.0
23895,2,3895,[275 546 174 210 191],457,4,17660,4.532854209445585,0.0,20.0
23896,2,3896,[318 427 496 357 257],330,5,17665,4.532974082627662,60.0,0.0
23897,2,3897,[318 427 496 357 257],330,5,17670,4.533093894304772,60.0,0.0
23898,2,3898,[318 427 496 357 257],796,5,17675,4.533213644524237,60.0,0.0
23899,2,3899,[318 427 496 357 257],716,5,17680,4.533333333333333,60.0,0.0
23900,2,3900,[197 568  50 603 228],450,5,17685,4.533452960779288,20.0,20.0
23901,2,3901,[318 427 496 357 257],330,5,17690,4.5335725269092775,60.0,0.0
23902,2,3902,[318 427 496 357 257],716,5,17695,4.533692031770433,60.0,0.0
23903,2,3903,[318 427 496 357 257],796,5,17700,4.533811475409836,60.0,0.0
23904,2,3904,[174 144 483 603  50],716,4,17704,4.533674775928297,20.0,20.0
23905,2,3905,[204 471 181  79 127],716,4,17708,4.533538146441372,0.0,20.0
23906,2,3906,[318 427 496 357 257],330,5,17713,4.5336575377527515,60.0,0.0
23907,2,3907,[265 215 196 234 174],577,4,17717,4.5335209825997955,0.0,0.0
23908,2,3908,[496 125  12  28   7],151,5,17722,4.53364031721668,20.0,0.0
23909,2,3909,[318 427 496 357 257],330,5,17727,4.5337595907928385,60.0,0.0
23910,2,3910,[318 427 496 357 257],330,5,17732,4.533878803375096,60.0,0.0
23911,2,3911,[318 427 496 357 257],716,5,17737,4.533997955010225,60.0,0.0
23912,2,3912,[318 427 496 357 257],796,5,17742,4.534117045744953,60.0,0.0
23913,2,3913,[318 427 496 357 257],796,5,17747,4.534236075625958,60.0,0.0
23914,2,3914,[ 79  97 183 496 678],344,3,17750,4.533844189016603,20.0,0.0
23915,2,3915,[135 597 435  79 258],807,3,17753,4.533452502553626,0.0,0.0
23916,2,3916,[318 427 496 357 257],716,5,17758,4.53357161092673,60.0,0.0
23917,2,3917,[318 427 496 357 257],330,5,17763,4.533690658499235,60.0,0.0
23918,2,3918,[318 427 496 357 257],796,5,17768,4.5338096453176835,60.0,0.0
23919,2,3919,[318 427 496 357 257],330,5,17773,4.5339285714285715,60.0,0.0
23920,2,3920,[318 427 496 357 257],716,5,17778,4.534047436878347,60.0,0.0
23921,2,3921,[318 427 496 357 257],796,5,17783,4.534166241713412,60.0,0.0
23922,2,3922,[ 15 435  70 588 186],18,5,17788,4.5342849859801175,0.0,0.0
23923,2,3923,[318 427 496 357 257],796,5,17793,4.534403669724771,60.0,0.0
23924,2,3924,[318 427 496 357 257],330,5,17798,4.53452229299363,60.0,0.0
23925,2,3925,[318 427 496 357 257],716,5,17803,4.534640855832909,60.0,0.0
23926,2,3926,[  8 496 191 237  69],344,3,17806,4.534250063661829,20.0,0.0
23927,2,3927,[318 427 496 357 257],716,5,17811,4.534368635437882,60.0,0.0
23928,2,3928,[318 427 496 357 257],330,5,17816,4.534487146856707,60.0,0.0
23929,2,3929,[318 427 496 357 257],330,5,17821,4.534605597964377,60.0,0.0
23930,2,3930,[318 427 496 357 257],330,5,17826,4.5347239888069195,60.0,0.0
23931,2,3931,[318 427 496 357 257],796,5,17831,4.534842319430315,60.0,0.0
23932,2,3932,[318 427 496 357 257],796,5,17836,4.534960589880498,60.0,0.0
23933,2,3933,[118   1 151 100  69],457,5,17841,4.5350788002033555,0.0,20.0
23934,2,3934,[318 427 496 357 257],330,5,17846,4.5351969504447265,60.0,0.0
23935,2,3935,[318 427 496 357 257],796,5,17851,4.535315040650406,60.0,0.0
23936,2,3936,[318 427 496 357 257],330,5,17856,4.535433070866142,60.0,0.0
23937,2,3937,[318 427 496 357 257],716,5,17861,4.535551041137634,60.0,0.0
23938,2,3938,[318 427 496 357 257],330,5,17866,4.5356689515105355,60.0,0.0
23939,2,3939,[318 427 496 357 257],330,5,17871,4.535786802030457,60.0,0.0
23940,2,3940,[318 427 496 357 257],716,5,17876,4.535904592742958,60.0,0.0
23941,2,3941,[318 427 496 357 257],716,5,17881,4.536022323693556,60.0,0.0
23942,2,3942,[318 427 496 357 257],716,5,17886,4.53613999492772,60.0,0.0
23943,2,3943,[ 70 288 185  96 125],457,5,17891,4.536257606490873,0.0,0.0
23944,2,3944,[318 427 496 357 257],796,5,17896,4.53637515842839,60.0,0.0
23945,2,3945,[302 151 111 132 237],344,4,17900,4.536239229599595,0.0,0.0
23946,2,3946,[ 97   9 191 204 286],655,1,17901,4.535343298707879,0.0,20.0
23947,2,3947,[318 427 496 357 257],330,5,17906,4.535460992907802,60.0,0.0
23948,2,3948,[318 427 496 357 257],716,5,17911,4.535578627500633,60.0,0.0
23949,2,3949,[318 427 496 357 257],716,5,17916,4.535696202531645,60.0,0.0
23950,2,3950,[318 427 496 357 257],716,5,17921,4.5358137180460645,60.0,0.0
23951,2,3951,[318 427 496 357 257],330,5,17926,4.535931174089069,60.0,0.0
23952,2,3952,[175  22  69 276 216],655,2,17928,4.5352896534277765,0.0,0.0
23953,2,3953,[318 427 496 357 257],716,5,17933,4.535407182599899,60.0,0.0
23954,2,3954,[318 427 496 357 257],796,5,17938,4.535524652338812,60.0,0.0
23955,2,3955,[313 176 357 483 508],693,2,17940,4.534883720930233,0.0,0.0
23956,2,3956,[318 427 496 357 257],716,5,17945,4.535001263583523,60.0,0.0
23957,2,3957,[318 427 496 357 257],796,5,17950,4.53511874684184,60.0,0.0
23958,2,3958,[151 546 182 174 216],450,5,17955,4.535236170750189,0.0,0.0
23959,2,3959,[318 427 496 357 257],330,5,17960,4.5353535353535355,60.0,0.0
23960,2,3960,[318 427 496 357 257],796,5,17965,4.535470840696794,60.0,0.0
23961,2,3961,[286 127 269  82 172],878,4,17969,4.535335689045937,0.0,40.0
23962,2,3962,[318 427 496 357 257],330,5,17974,4.535452939692153,60.0,0.0
23963,2,3963,[318 427 496 357 257],796,5,17979,4.535570131180625,60.0,0.0
23964,2,3964,[318 427 496 357 257],330,5,17984,4.535687263556116,60.0,0.0
23965,2,3965,[318 427 496 357 257],330,5,17989,4.535804336863339,60.0,0.0
23966,2,3966,[318 427 496 357 257],330,5,17994,4.535921351146962,60.0,0.0
23967,2,3967,[318 427 496 357 257],716,5,17999,4.536038306451613,60.0,0.0
23968,2,3968,[318 427 496 357 257],796,5,18004,4.5361552028218695,60.0,0.0
23969,2,3969,[318 427 496 357 257],330,5,18009,4.536272040302267,60.0,0.0
23970,2,3970,[318 427 496 357 257],330,5,18014,4.536388818937295,60.0,0.0
23971,2,3971,[318 427 496 357 257],716,5,18019,4.5365055387714,60.0,0.0
23972,2,3972,[318 427 496 357 257],716,5,18024,4.53662219984898,60.0,0.0
23973,2,3973,[318 427 496 357 257],330,5,18029,4.536738802214393,60.0,0.0
23974,2,3974,[318 427 496 357 257],796,5,18034,4.53685534591195,60.0,0.0
23975,2,3975,[318 427 496 357 257],716,5,18039,4.536971830985915,60.0,0.0
23976,2,3976,[204   7 318 276 268],655,2,18041,4.5363339200402315,20.0,0.0
23977,2,3977,[100 318 127   8 121],269,3,18044,4.5359477124183005,20.0,40.0
23978,2,3978,[143 132 186  15 176],389,2,18046,4.535310379492334,0.0,0.0
23979,2,3979,[318 427 496 357 257],716,5,18051,4.535427135678392,60.0,0.0
23980,2,3980,[318 427 496 357 257],330,5,18056,4.535543833207737,60.0,0.0
23981,2,3981,[318 427 496 357 257],716,5,18061,4.535660472124561,60.0,0.0
23982,2,3982,[204 423 181 117 185],236,3,18064,4.535274918403213,0.0,0.0
23983,2,3983,[318 427 496 357 257],716,5,18069,4.53539156626506,60.0,0.0
23984,2,3984,[318 427 496 357 257],330,5,18074,4.535508155583438,60.0,0.0
23985,2,3985,[125 191 288 237 111],457,4,18078,4.535373808329152,0.0,0.0
23986,2,3986,[318 427 496 357 257],716,5,18083,4.535490343616755,60.0,0.0
23987,2,3987,[234 742   1 235   4],280,3,18086,4.535105315947844,0.0,0.0
23988,2,3988,[318 427 496 357 257],330,5,18091,4.535221860115317,60.0,0.0
23989,2,3989,[ 98 121 288 385 357],655,2,18093,4.534586466165414,0.0,0.0
23990,2,3990,[118 196 328   4 237],796,5,18098,4.534703081934352,0.0,0.0
23991,2,3991,[318 427 496 357 257],330,5,18103,4.534819639278557,60.0,0.0
23992,2,3992,[318 427 496 357 257],796,5,18108,4.534936138241924,60.0,0.0
23993,2,3993,[588 357 176 234 385],786,4,18112,4.534802203304958,0.0,0.0
23994,2,3994,[318 427 496 357 257],796,5,18117,4.534918648310388,60.0,0.0
23995,2,3995,[318 427 496 357 257],796,5,18122,4.535035035035035,60.0,0.0
23996,2,3996,[210  97 118 215 161],693,2,18124,4.534400800600451,0.0,0.0
23997,2,3997,[318 427 496 357 257],330,5,18129,4.5345172586293145,60.0,0.0
23998,2,3998,[318 427 496 357 257],330,5,18134,4.534633658414604,60.0,0.0
23999,2,3999,[318 427 496 357 257],716,5,18139,4.53475,60.0,0.0
24000,2,4000,[318 427 496 357 257],796,5,18144,4.534866283429142,60.0,0.0
24001,2,4001,[318 427 496 357 257],330,5,18149,4.534982508745627,60.0,0.0
24002,2,4002,[216 301 328 100  64],450,5,18154,4.535098675993005,20.0,20.0
24003,2,4003,[318 427 496 357 257],330,5,18159,4.5352147852147855,60.0,0.0
24004,2,4004,[318 427 496 357 257],716,5,18164,4.535330836454432,60.0,0.0
24005,2,4005,[318 427 496 357 257],330,5,18169,4.535446829755367,60.0,0.0
24006,2,4006,[100 194  56 191 405],450,5,18174,4.535562765160968,0.0,20.0
24007,2,4007,[318 427 496 357 257],716,5,18179,4.535678642714571,60.0,0.0
24008,2,4008,[318 427 496 357 257],716,5,18184,4.535794462459466,60.0,0.0
24009,2,4009,[ 82 568 471 181 144],280,0,18184,4.534663341645885,0.0,0.0
24010,2,4010,[318 427 496 357 257],796,5,18189,4.534779356768886,60.0,0.0
24011,2,4011,[318 427 496 357 257],796,5,18194,4.5348953140578265,60.0,0.0
24012,2,4012,[318 427 496 357 257],330,5,18199,4.5350112135559435,60.0,0.0
24013,2,4013,[318 427 496 357 257],796,5,18204,4.535127055306427,60.0,0.0
24014,2,4014,[318 427 496 357 257],330,5,18209,4.535242839352429,60.0,0.0
24015,2,4015,[318 427 496 357 257],796,5,18214,4.535358565737051,60.0,0.0
24016,2,4016,[ 50 276 151 234 143],18,3,18217,4.534976350510331,0.0,20.0
24017,2,4017,[318 427 496 357 257],330,5,18222,4.535092085614734,60.0,0.0
24018,2,4018,[318 427 496 357 257],330,5,18227,4.535207763125156,60.0,0.0
24019,2,4019,[318 427 496 357 257],716,5,18232,4.535323383084577,60.0,0.0
24020,2,4020,[318 427 496 357 257],330,5,18237,4.535438945535937,60.0,0.0
24021,2,4021,[238 211 268 183 195],655,1,18238,4.5345599204375935,0.0,0.0
24022,2,4022,[318 427 496 357 257],716,5,18243,4.534675615212528,60.0,0.0
24023,2,4023,[318 427 496 357 257],330,5,18248,4.534791252485089,60.0,0.0
24024,2,4024,[318 427 496 357 257],330,5,18253,4.5349068322981365,60.0,0.0
24025,2,4025,[ 97 603 118 403  82],72,2,18255,4.534277198211624,20.0,0.0
24026,2,4026,[ 79 515  64  98  71],18,5,18260,4.534392848274149,20.0,0.0
24027,2,4027,[318 427 496 357 257],796,5,18265,4.534508440913605,60.0,0.0
24028,2,4028,[318 427 496 357 257],796,5,18270,4.534623976172748,60.0,0.0
24029,2,4029,[318 427 496 357 257],796,5,18275,4.534739454094293,60.0,0.0
24030,2,4030,[318 427 496 357 257],716,5,18280,4.534854874720913,60.0,0.0
24031,2,4031,[318 427 496 357 257],716,5,18285,4.534970238095238,60.0,0.0
24032,2,4032,[176 357 202 210 237],269,1,18286,4.534093726754278,0.0,0.0
24033,2,4033,[318 427 496 357 257],796,5,18291,4.534209221616262,60.0,0.0
24034,2,4034,[318 427 496 357 257],716,5,18296,4.534324659231722,60.0,0.0
24035,2,4035,[318 427 496 357 257],330,5,18301,4.534440039643211,60.0,0.0
24036,2,4036,[  9  64 135 288 257],655,2,18303,4.533812236809512,20.0,0.0
24037,2,4037,[318 427 496 357 257],716,5,18308,4.533927686973749,60.0,0.0
24038,2,4038,[132 181 258 186 195],457,5,18313,4.5340430799702895,0.0,0.0
24039,2,4039,[588 385  69 318  98],716,4,18317,4.533910891089109,20.0,0.0
24040,2,4040,[318 427 496 357 257],716,5,18322,4.534026231130908,60.0,0.0
24041,2,4041,[318 427 496 357 257],796,5,18327,4.53414151410193,60.0,0.0
24042,2,4042,[318 427 496 357 257],796,5,18332,4.534256740044522,60.0,0.0
24043,2,4043,[496 483  97 215 385],796,4,18336,4.534124629080119,20.0,0.0
24044,2,4044,[318 427 496 357 257],330,5,18341,4.5342398022249695,60.0,0.0
24045,2,4045,[273 742 117 237  98],655,2,18343,4.533613445378151,0.0,0.0
24046,2,4046,[237 151 427  64 168],577,5,18348,4.533728687916976,40.0,0.0
24047,2,4047,[318 427 496 357 257],796,5,18353,4.533843873517786,60.0,0.0
24048,2,4048,[135 185 187 195   1],450,4,18357,4.533712027661151,0.0,0.0
24049,2,4049,[318 427 496 357 257],330,5,18362,4.533827160493827,60.0,0.0
24050,2,4050,[748 742 300 496 216],796,4,18366,4.5336953838558385,20.0,0.0
24051,2,4051,[318 427 496 357 257],330,5,18371,4.53381046396841,60.0,0.0
24052,2,4052,[100 268 121 597 286],463,3,18374,4.533432025660005,0.0,40.0
24053,2,4053,[318 427 496 357 257],796,5,18379,4.53354711396152,60.0,0.0
24054,2,4054,[318 427 496 357 257],330,5,18384,4.533662145499384,60.0,0.0
24055,2,4055,[318 427 496 357 257],330,5,18389,4.533777120315582,60.0,0.0
24056,2,4056,[318 427 496 357 257],716,5,18394,4.533892038452058,60.0,0.0
24057,2,4057,[318 427 496 357 257],796,5,18399,4.534006899950715,60.0,0.0
24058,2,4058,[318 427 496 357 257],330,5,18404,4.534121704853412,60.0,0.0
24059,2,4059,[318 427 496 357 257],330,5,18409,4.53423645320197,60.0,0.0
24060,2,4060,[237  50   7 471 546],786,5,18414,4.534351145038168,0.0,20.0
24061,2,4061,[318 546  50  79 222],796,5,18419,4.534465780403742,20.0,20.0
24062,2,4062,[318 427 496 357 257],716,5,18424,4.534580359340389,60.0,0.0
24063,2,4063,[257 175 194 427 127],716,4,18428,4.534448818897638,20.0,20.0
24064,2,4064,[318 427 496 357 257],796,5,18433,4.534563345633456,60.0,0.0
24065,2,4065,[ 98 100 144  64  11],535,3,18436,4.534185932120019,20.0,20.0
24066,2,4066,[318 427 496 357 257],796,5,18441,4.5343004671748215,60.0,0.0
24067,2,4067,[318 427 496 357 257],330,5,18446,4.53441494591937,60.0,0.0
24068,2,4068,[318 427 496 357 257],330,5,18451,4.534529368395183,60.0,0.0
24069,2,4069,[483 597 143 678 181],807,4,18455,4.534398034398034,0.0,0.0
24070,2,4070,[318 471 200  64 603],655,4,18459,4.534266764922624,60.0,0.0
24071,2,4071,[318 427 496 357 257],796,5,18464,4.534381139489194,60.0,0.0
24072,2,4072,[318 427 496 357 257],796,5,18469,4.534495457893445,60.0,0.0
24073,2,4073,[318 427 496 357 257],716,5,18474,4.53460972017673,60.0,0.0
24074,2,4074,[318 427 496 357 257],716,5,18479,4.5347239263803685,60.0,0.0
24075,2,4075,[318 427 496 357 257],716,5,18484,4.534838076545633,60.0,0.0
24076,2,4076,[ 56 186 127 135 211],693,3,18487,4.534461613931812,0.0,20.0
24077,2,4077,[186  69 282 197  64],457,5,18492,4.53457577243747,20.0,0.0
24078,2,4078,[318 427 496 357 257],796,5,18497,4.534689874969355,60.0,0.0
24079,2,4079,[318 427 496 357 257],716,5,18502,4.534803921568628,60.0,0.0
24080,2,4080,[174 121 237 210 175],457,5,18507,4.534917912276403,0.0,0.0
24081,2,4081,[318 427 496 357 257],716,5,18512,4.535031847133758,60.0,0.0
24082,2,4082,[318 427 496 357 257],330,5,18517,4.535145726181729,60.0,0.0
24083,2,4083,[318 427 496 357 257],796,5,18522,4.535259549461313,60.0,0.0
24084,2,4084,[318 427 496 357 257],330,5,18527,4.535373317013464,60.0,0.0
24085,2,4085,[318 427 496 357 257],716,5,18532,4.535487028879099,60.0,0.0
24086,2,4086,[318 427 496 357 257],330,5,18537,4.535600685099094,60.0,0.0
24087,2,4087,[318 427 496 357 257],716,5,18542,4.535714285714286,60.0,0.0
24088,2,4088,[318 427 496 357 257],796,5,18547,4.535827830765468,60.0,0.0
24089,2,4089,[471   8 318 174  71],593,3,18550,4.5354523227383865,20.0,0.0
24090,2,4090,[318 427 496 357 257],796,5,18555,4.53556587631386,60.0,0.0
24091,2,4091,[318 427 496 357 257],796,5,18560,4.535679374389052,60.0,0.0
24092,2,4092,[475 181 228 258 257],296,5,18565,4.535792817004642,0.0,0.0
24093,2,4093,[318 427 496 357 257],796,5,18570,4.53590620420127,60.0,0.0
24094,2,4094,[276 234  97 121 191],655,2,18572,4.535286935286935,0.0,0.0
24095,2,4095,[318 427 496 357 257],330,5,18577,4.535400390625,60.0,0.0
24096,2,4096,[385 118 322  15 655],450,3,18580,4.535025628508665,0.0,0.0
24097,2,4097,[318 427 496 357 257],330,5,18585,4.535139092240117,60.0,0.0
24098,2,4098,[318 427 496 357 257],716,5,18590,4.5352525006099045,60.0,0.0
24099,2,4099,[403 483 282  69 117],280,3,18593,4.534878048780488,0.0,0.0
24100,2,4100,[318 427 496 357 257],330,5,18598,4.53499146549622,60.0,0.0
24101,2,4101,[318 427 496 357 257],716,5,18603,4.535104826913701,60.0,0.0
24102,2,4102,[318 568 237  70 435],655,1,18604,4.534243236656105,20.0,0.0
24103,2,4103,[318 427 496 357 257],796,5,18609,4.534356725146199,60.0,0.0
24104,2,4104,[318 427 496 357 257],796,5,18614,4.534470158343484,60.0,0.0
24105,2,4105,[318 427 496 357 257],330,5,18619,4.534583536288358,60.0,0.0
24106,2,4106,[318 427 496 357 257],796,5,18624,4.534696859021183,60.0,0.0
24107,2,4107,[318 427 496 357 257],796,5,18629,4.534810126582278,60.0,0.0
24108,2,4108,[603 427 496 174 318],18,4,18633,4.534679970795814,80.0,0.0
24109,2,4109,[318 427 496 357 257],796,5,18638,4.5347931873479315,60.0,0.0
24110,2,4110,[186 210  98 471  97],655,1,18639,4.533933349549988,0.0,0.0
24111,2,4111,[318 427 496 357 257],716,5,18644,4.534046692607004,60.0,0.0
24112,2,4112,[318 427 496 357 257],796,5,18649,4.534159980549477,60.0,0.0
24113,2,4113,[318 427 496 357 257],716,5,18654,4.534273213417598,60.0,0.0
24114,2,4114,[318 427 496 357 257],330,5,18659,4.534386391251519,60.0,0.0
24115,2,4115,[318 427 496 357 257],330,5,18664,4.534499514091351,60.0,0.0
24116,2,4116,[175 121 228  82 174],655,0,18664,4.533398105416565,0.0,0.0
24117,2,4117,[  9 475 196 655 245],629,4,18668,4.533268576979116,0.0,0.0
24118,2,4118,[318 427 496 357 257],796,5,18673,4.533381888807963,60.0,0.0
24119,2,4119,[318 427 496 357 257],716,5,18678,4.533495145631068,60.0,0.0
24120,2,4120,[318 427 496 357 257],330,5,18683,4.533608347488474,60.0,0.0
24121,2,4121,[318 427 496 357 257],330,5,18688,4.533721494420185,60.0,0.0
24122,2,4122,[318 427 496 357 257],796,5,18693,4.533834586466165,60.0,0.0
24123,2,4123,[318 427 496 357 257],330,5,18698,4.533947623666343,60.0,0.0
24124,2,4124,[318 427 496 357 257],716,5,18703,4.534060606060606,60.0,0.0
24125,2,4125,[318 427 496 357 257],796,5,18708,4.5341735336888025,60.0,0.0
24126,2,4126,[318 427 496 357 257],716,5,18713,4.534286406590744,60.0,0.0
24127,2,4127,[318 427 496 357 257],716,5,18718,4.534399224806202,60.0,0.0
24128,2,4128,[118 185 268 211 181],655,1,18719,4.53354323080649,0.0,0.0
24129,2,4129,[318 427 496 357 257],796,5,18724,4.533656174334141,60.0,0.0
24130,2,4130,[318 427 496 357 257],330,5,18729,4.533769063180828,60.0,0.0
24131,2,4131,[245 151  71 328 168],450,4,18733,4.533639883833494,0.0,0.0
24132,2,4132,[318 427 496 357 257],716,5,18738,4.533752721993709,60.0,0.0
24133,2,4133,[269 427   4 271 127],655,2,18740,4.533139816158684,20.0,20.0
24134,2,4134,[  1  88 546 121 135],450,3,18743,4.532769044740024,0.0,0.0
24135,2,4135,[318 427 496 357 257],796,5,18748,4.532882011605416,60.0,0.0
24136,2,4136,[318 427 496 357 257],796,5,18753,4.532994923857868,60.0,0.0
24137,2,4137,[318 427 496 357 257],330,5,18758,4.533107781536974,60.0,0.0
24138,2,4138,[ 25 197 172  98 195],151,4,18762,4.532978980430055,0.0,0.0
24139,2,4139,[322  15 328 197 655],796,2,18764,4.532367149758454,0.0,0.0
24140,2,4140,[318 427 496 357 257],796,5,18769,4.53248007727602,60.0,0.0
24141,2,4141,[318 427 496 357 257],716,5,18774,4.532592950265572,60.0,0.0
24142,2,4142,[318 427 496 357 257],330,5,18779,4.532705768766594,60.0,0.0
24143,2,4143,[318 427 496 357 257],330,5,18784,4.532818532818533,60.0,0.0
24144,2,4144,[318 427 496 357 257],796,5,18789,4.532931242460796,60.0,0.0
24145,2,4145,[318 427 496 357 257],330,5,18794,4.533043897732754,60.0,0.0
24146,2,4146,[318 427 496 357 257],716,5,18799,4.5331564986737405,60.0,0.0
24147,2,4147,[318 427 496 357 257],330,5,18804,4.533269045323047,60.0,0.0
24148,2,4148,[181 655  56 427 204],577,4,18808,4.533140515786936,20.0,0.0
24149,2,4149,[318 427 496 357 257],716,5,18813,4.533253012048193,60.0,0.0
24150,2,4150,[318 427 496 357 257],330,5,18818,4.533365454107444,60.0,0.0
24151,2,4151,[318 427 496 357 257],716,5,18823,4.533477842003854,60.0,0.0
24152,2,4152,[318 427 496 357 257],716,5,18828,4.533590175776547,60.0,0.0
24153,2,4153,[318 427 496 357 257],796,5,18833,4.533702455464613,60.0,0.0
24154,2,4154,[161 153  11 173 196],401,1,18834,4.532851985559566,0.0,0.0
24155,2,4155,[318 427 496 357 257],796,5,18839,4.532964388835419,60.0,0.0
24156,2,4156,[318 427 496 357 257],716,5,18844,4.533076738032235,60.0,0.0
24157,2,4157,[318 427 496 357 257],330,5,18849,4.533189033189033,60.0,0.0
24158,2,4158,[318 427 496 357 257],330,5,18854,4.533301274344795,60.0,0.0
24159,2,4159,[318 427 496 357 257],330,5,18859,4.533413461538461,60.0,0.0
24160,2,4160,[318 427 496 357 257],716,5,18864,4.53352559480894,60.0,0.0
24161,2,4161,[318 427 496 357 257],796,5,18869,4.5336376741950986,60.0,0.0
24162,2,4162,[318 427 496 357 257],796,5,18874,4.533749699735767,60.0,0.0
24163,2,4163,[318 427 496 357 257],716,5,18879,4.533861671469741,60.0,0.0
24164,2,4164,[318 427 496 357 257],716,5,18884,4.533973589435774,60.0,0.0
24165,2,4165,[318 427 496 357 257],716,5,18889,4.534085453672588,60.0,0.0
24166,2,4166,[318 427 496 357 257],330,5,18894,4.534197264218863,60.0,0.0
24167,2,4167,[318 427 496 357 257],796,5,18899,4.534309021113244,60.0,0.0
24168,2,4168,[318 427 496 357 257],330,5,18904,4.534420724394339,60.0,0.0
24169,2,4169,[318 427 496 357 257],330,5,18909,4.53453237410072,60.0,0.0
24170,2,4170,[318 427 496 357 257],796,5,18914,4.534643970270918,60.0,0.0
24171,2,4171,[318 427 496 357 257],796,5,18919,4.534755512943432,60.0,0.0
24172,2,4172,[318 427 496 357 257],716,5,18924,4.534867002156722,60.0,0.0
24173,2,4173,[318 427 496 357 257],796,5,18929,4.534978437949209,60.0,0.0
24174,2,4174,[318 427 496 357 257],330,5,18934,4.535089820359281,60.0,0.0
24175,2,4175,[318 427 496 357 257],716,5,18939,4.535201149425287,60.0,0.0
24176,2,4176,[318 427 496 357 257],330,5,18944,4.5353124251855395,60.0,0.0
24177,2,4177,[ 95 168 597 186  22],807,5,18949,4.535423647678315,0.0,0.0
24178,2,4178,[117 546  82  69  11],716,4,18953,4.535295525245274,0.0,0.0
24179,2,4179,[423 100 228 748 286],151,3,18956,4.534928229665072,0.0,40.0
24180,2,4180,[318 427 496 357 257],796,5,18961,4.535039464243004,60.0,0.0
24181,2,4181,[318 427 496 357 257],796,5,18966,4.535150645624103,60.0,0.0
24182,2,4182,[318 427 496 357 257],330,5,18971,4.535261773846521,60.0,0.0
24183,2,4183,[318 427 496 357 257],796,5,18976,4.5353728489483744,60.0,0.0
24184,2,4184,[100 515  98 197 403],72,4,18980,4.535244922341697,0.0,20.0
24185,2,4185,[265 603 121  28 328],655,1,18981,4.534400382226469,20.0,0.0
24186,2,4186,[318 427 496 357 257],716,5,18986,4.5345115834726535,60.0,0.0
24187,2,4187,[318 427 496 357 257],716,5,18991,4.534622731614135,60.0,0.0
24188,2,4188,[318 427 496 357 257],716,5,18996,4.534733826688948,60.0,0.0
24189,2,4189,[435  96 568 195 423],655,0,18996,4.533651551312649,0.0,0.0
24190,2,4190,[286   7 144 273 197],629,3,18999,4.53328561202577,0.0,20.0
24191,2,4191,[318 427 496 357 257],330,5,19004,4.533396946564886,60.0,0.0
24192,2,4192,[318 427 496 357 257],330,5,19009,4.533508227999046,60.0,0.0
24193,2,4193,[318 427 496 357 257],796,5,19014,4.533619456366237,60.0,0.0
24194,2,4194,[318 427 496 357 257],796,5,19019,4.53373063170441,60.0,0.0
24195,2,4195,[322 405 286 196 496],450,5,19024,4.533841754051478,20.0,20.0
24196,2,4196,[318 427 496 357 257],330,5,19029,4.533952823445318,60.0,0.0
24197,2,4197,[318 427 496 357 257],716,5,19034,4.534063839923773,60.0,0.0
24198,2,4198,[318 427 496 357 257],330,5,19039,4.534174803524649,60.0,0.0
24199,2,4199,[318 427 496 357 257],796,5,19044,4.534285714285715,60.0,0.0
24200,2,4200,[318 427 496 357 257],796,5,19049,4.534396572244703,60.0,0.0
24201,2,4201,[318 427 496 357 257],716,5,19054,4.534507377439315,60.0,0.0
24202,2,4202,[318 427 496 357 257],330,5,19059,4.5346181299072095,60.0,0.0
24203,2,4203,[318 427 496 357 257],330,5,19064,4.5347288296860135,60.0,0.0
24204,2,4204,[318 427 496 357 257],716,5,19069,4.534839476813318,60.0,0.0
24205,2,4205,[318 427 496 357 257],716,5,19074,4.534950071326676,60.0,0.0
24206,2,4206,[318 427 496 357 257],330,5,19079,4.535060613263608,60.0,0.0
24207,2,4207,[237 132 275 174 302],655,2,19081,4.534458174904943,0.0,20.0
24208,2,4208,[318 427 496 357 257],330,5,19086,4.534568781183179,60.0,0.0
24209,2,4209,[318 427 496 357 257],716,5,19091,4.534679334916865,60.0,0.0
24210,2,4210,[318 427 496 357 257],330,5,19096,4.534789836143434,60.0,0.0
24211,2,4211,[318 427 496 357 257],716,5,19101,4.534900284900285,60.0,0.0
24212,2,4212,[333 265 143 180  22],796,4,19105,4.534773320674104,0.0,0.0
24213,2,4213,[318 427 496 357 257],716,5,19110,4.534883720930233,60.0,0.0
24214,2,4214,[318 427 496 357 257],716,5,19115,4.534994068801898,60.0,0.0
24215,2,4215,[318 427 496 357 257],330,5,19120,4.535104364326376,60.0,0.0
24216,2,4216,[181 655 294 186 132],504,2,19122,4.534503201327959,0.0,0.0
24217,2,4217,[318 427 496 357 257],716,5,19127,4.53461356092935,60.0,0.0
24218,2,4218,[211 153 135 111 423],18,3,19130,4.5342498222327565,0.0,0.0
24219,2,4219,[318 427 496 357 257],796,5,19135,4.5343601895734595,60.0,0.0
24220,2,4220,[318 427 496 357 257],330,5,19140,4.534470504619758,60.0,0.0
24221,2,4221,[318 427 496 357 257],330,5,19145,4.534580767408811,60.0,0.0
24222,2,4222,[318 427 496 357 257],716,5,19150,4.534690977977741,60.0,0.0
24223,2,4223,[318 427 496 357 257],796,5,19155,4.534801136363637,60.0,0.0
24224,2,4224,[318 427 496 357 257],330,5,19160,4.534911242603551,60.0,0.0
24225,2,4225,[318 427 496 357 257],716,5,19165,4.5350212967345005,60.0,0.0
24226,2,4226,[  1  98 273 196  25],655,2,19167,4.5344215755855215,0.0,0.0
24227,2,4227,[318 427 496 357 257],796,5,19172,4.534531693472091,60.0,0.0
24228,2,4228,[318 427 496 357 257],330,5,19177,4.534641759281154,60.0,0.0
24229,2,4229,[151 180 100 597 187],450,5,19182,4.534751773049646,0.0,20.0
24230,2,4230,[318 427 496 357 257],796,5,19187,4.534861734814465,60.0,0.0
24231,2,4231,[100 435 322 191 275],629,3,19190,4.534499054820416,0.0,40.0
24232,2,4232,[318 427 496 357 257],716,5,19195,4.5346090243326245,60.0,0.0
24233,2,4233,[318 427 496 357 257],330,5,19200,4.534718941898913,60.0,0.0
24234,2,4234,[603  89 333 385 210],796,4,19204,4.534592680047226,20.0,0.0
24235,2,4235,[318 427 496 357 257],796,5,19209,4.534702549575071,60.0,0.0
24236,2,4236,[318 427 496 357 257],330,5,19214,4.534812367240972,60.0,0.0
24237,2,4237,[318 427 496 357 257],796,5,19219,4.5349221330816425,60.0,0.0
24238,2,4238,[318 427 496 357 257],716,5,19224,4.535031847133758,60.0,0.0
24239,2,4239,[ 25 405 161 197 435],716,4,19228,4.534905660377358,0.0,0.0
24240,2,4240,[318 427 496 357 257],330,5,19233,4.535015326573921,60.0,0.0
24241,2,4241,[318 427 496 357 257],330,5,19238,4.535124941065535,60.0,0.0
24242,2,4242,[318 427 496 357 257],330,5,19243,4.535234503888758,60.0,0.0
24243,2,4243,[216 204 238 196 385],151,4,19247,4.535108388312913,0.0,0.0
24244,2,4244,[318 427 496 357 257],796,5,19252,4.535217903415783,60.0,0.0
24245,2,4245,[179 132 237 135 748],450,4,19256,4.535091851154028,0.0,0.0
24246,2,4246,[318 427 496 357 257],796,5,19261,4.53520131857782,60.0,0.0
24247,2,4247,[318 427 496 357 257],796,5,19266,4.535310734463277,60.0,0.0
24248,2,4248,[318 427 496 357 257],716,5,19271,4.535420098846788,60.0,0.0
24249,2,4249,[318 427 496 357 257],330,5,19276,4.535529411764706,60.0,0.0
24250,2,4250,[748 161 191 238 196],796,4,19280,4.535403434486003,0.0,0.0
24251,2,4251,[318 427 496 357 257],796,5,19285,4.535512699905927,60.0,0.0
24252,2,4252,[318 427 496 357 257],716,5,19290,4.535621913943099,60.0,0.0
24253,2,4253,[318 427 496 357 257],716,5,19295,4.535731076633756,60.0,0.0
24254,2,4254,[318 427 496 357 257],330,5,19300,4.5358401880141015,60.0,0.0
24255,2,4255,[318 427 496 357 257],330,5,19305,4.535949248120301,60.0,0.0
24256,2,4256,[197   7 195 276 597],457,4,19309,4.535823349776838,0.0,0.0
24257,2,4257,[257 546 222 588  71],796,5,19314,4.535932362611555,0.0,0.0
24258,2,4258,[423   8  11 215  70],330,5,19319,4.53604132425452,0.0,0.0
24259,2,4259,[318 427 496 357 257],716,5,19324,4.536150234741784,60.0,0.0
24260,2,4260,[318 427 496 357 257],796,5,19329,4.536259094109364,60.0,0.0
24261,2,4261,[318 427 496 357 257],796,5,19334,4.536367902393242,60.0,0.0
24262,2,4262,[318 427 496 357 257],330,5,19339,4.536476659629369,60.0,0.0
24263,2,4263,[318 427 496 357 257],796,5,19344,4.536585365853658,60.0,0.0
24264,2,4264,[318 427 496 357 257],716,5,19349,4.536694021101993,60.0,0.0
24265,2,4265,[318 427 496 357 257],330,5,19354,4.53680262541022,60.0,0.0
24266,2,4266,[174 204 196 144 182],655,1,19355,4.535973752050621,0.0,0.0
24267,2,4267,[318 427 496 357 257],716,5,19360,4.536082474226804,60.0,0.0
24268,2,4268,[318 427 496 357 257],796,5,19365,4.536191145467322,60.0,0.0
24269,2,4269,[300  69 237 322 228],450,5,19370,4.5362997658079625,0.0,0.0
24270,2,4270,[ 97   4 234   7 173],577,3,19373,4.5359400608756735,0.0,0.0
24271,2,4271,[318 427 496 357 257],716,5,19378,4.5360486891385765,60.0,0.0
24272,2,4272,[318 427 496 357 257],796,5,19383,4.536157266557454,60.0,0.0
24273,2,4273,[318 427 496 357 257],330,5,19388,4.536265793167993,60.0,0.0
24274,2,4274,[318 427 496 357 257],716,5,19393,4.536374269005848,60.0,0.0
24275,2,4275,[655   8 194 132  89],269,3,19396,4.536014967259121,0.0,0.0
24276,2,4276,[318 427 496 357 257],796,5,19401,4.536123451017068,60.0,0.0
24277,2,4277,[318 427 496 357 257],330,5,19406,4.536231884057971,60.0,0.0
24278,2,4278,[318 427 496 357 257],796,5,19411,4.536340266417387,60.0,0.0
24279,2,4279,[318 427 496 357 257],796,5,19416,4.536448598130841,60.0,0.0
24280,2,4280,[318 427 496 357 257],716,5,19421,4.536556879233824,60.0,0.0
24281,2,4281,[294 271 245 183 125],796,3,19424,4.53619803829986,0.0,0.0
24282,2,4282,[318 427 496 357 257],330,5,19429,4.536306327340649,60.0,0.0
24283,2,4283,[318 427 496 357 257],716,5,19434,4.53641456582633,60.0,0.0
24284,2,4284,[194 196 132 204 111],450,5,19439,4.5365227537922985,0.0,0.0
24285,2,4285,[318 427 496 357 257],796,5,19444,4.536630891273915,60.0,0.0
24286,2,4286,[318 427 496 357 257],330,5,19449,4.536738978306508,60.0,0.0
24287,2,4287,[118 186 161  64 172],796,4,19453,4.536613805970149,20.0,0.0
24288,2,4288,[318 427 496 357 257],330,5,19458,4.536721846584285,60.0,0.0
24289,2,4289,[318 427 496 357 257],796,5,19463,4.5368298368298365,60.0,0.0
24290,2,4290,[183 215 216 385 161],457,5,19468,4.536937776742018,0.0,0.0
24291,2,4291,[202 427   7  25 603],450,4,19472,4.536812674743709,40.0,0.0
24292,2,4292,[318 427 496 357 257],330,5,19477,4.536920568367109,60.0,0.0
24293,2,4293,[318 427 496 357 257],330,5,19482,4.537028411737308,60.0,0.0
24294,2,4294,[318 427 496 357 257],796,5,19487,4.537136204889406,60.0,0.0
24295,2,4295,[318 427 496 357 257],716,5,19492,4.537243947858473,60.0,0.0
24296,2,4296,[318 427 496 357 257],330,5,19497,4.537351640679544,60.0,0.0
24297,2,4297,[318 427 496 357 257],796,5,19502,4.537459283387622,60.0,0.0
24298,2,4298,[318 427 496 357 257],716,5,19507,4.537566876017679,60.0,0.0
24299,2,4299,[294 202 546 182 234],796,3,19510,4.537209302325581,0.0,0.0
24300,2,4300,[194 118  79 173 144],292,4,19514,4.537084398976982,0.0,0.0
24301,2,4301,[ 89 180 471  70 258],457,5,19519,4.5371920037192,0.0,0.0
24302,2,4302,[318 427 496 357 257],796,5,19524,4.537299558447595,60.0,0.0
24303,2,4303,[318 427 496 357 257],796,5,19529,4.537407063197026,60.0,0.0
24304,2,4304,[318 427 496 357 257],796,5,19534,4.537514518002323,60.0,0.0
24305,2,4305,[318 427 496 357 257],330,5,19539,4.537621922898281,60.0,0.0
24306,2,4306,[318 427 496 357 257],330,5,19544,4.537729277919666,60.0,0.0
24307,2,4307,[ 64  82 144 111 125],457,4,19548,4.537604456824512,20.0,0.0
24308,2,4308,[318 427 496 357 257],796,5,19553,4.5377117660710145,60.0,0.0
24309,2,4309,[ 82 265 228 238 483],151,4,19557,4.537587006960557,0.0,0.0
24310,2,4310,[318 427 496 357 257],716,5,19562,4.5376942704708885,60.0,0.0
24311,2,4311,[655  88 195 294 161],457,4,19566,4.537569573283859,0.0,0.0
24312,2,4312,[318 427 496 357 257],796,5,19571,4.537676791096684,60.0,0.0
24313,2,4313,[318 427 496 357 257],330,5,19576,4.537783959202597,60.0,0.0
24314,2,4314,[135 200 125 655  69],450,3,19579,4.537427578215527,0.0,0.0
24315,2,4315,[ 97 175 185 294 273],655,2,19581,4.536839666357738,0.0,0.0
24316,2,4316,[318 427 496 357 257],716,5,19586,4.536946953903174,60.0,0.0
24317,2,4317,[318 427 496 357 257],796,5,19591,4.537054191755442,60.0,0.0
24318,2,4318,[ 28 202 175  79 496],716,4,19595,4.536929844871498,20.0,0.0
24319,2,4319,[318 427 496 357 257],330,5,19600,4.537037037037037,60.0,0.0
24320,2,4320,[318 427 496 357 257],330,5,19605,4.537144179588059,60.0,0.0
24321,2,4321,[181  69 202 172 265],450,5,19610,4.537251272559001,0.0,0.0
24322,2,4322,[318 427 496 357 257],796,5,19615,4.53735831598427,60.0,0.0
24323,2,4323,[318 427 496 357 257],796,5,19620,4.537465309898242,60.0,0.0
24324,2,4324,[144 322 176 423 211],450,5,19625,4.53757225433526,0.0,0.0
24325,2,4325,[318 427 496 357 257],330,5,19630,4.537679149329635,60.0,0.0
24326,2,4326,[318 427 496 357 257],330,5,19635,4.537785994915646,60.0,0.0
24327,2,4327,[132 127 176 215 301],344,4,19639,4.537661737523106,0.0,20.0
24328,2,4328,[318 427 496 357 257],796,5,19644,4.537768537768538,60.0,0.0
24329,2,4329,[318 427 496 357 257],330,5,19649,4.537875288683603,60.0,0.0
24330,2,4330,[318 427 496 357 257],716,5,19654,4.5379819903024705,60.0,0.0
24331,2,4331,[318 427 496 357 257],330,5,19659,4.53808864265928,60.0,0.0
24332,2,4332,[318 427 496 357 257],796,5,19664,4.538195245788137,60.0,0.0
24333,2,4333,[180 228 748 172 403],796,4,19668,4.538071065989848,0.0,0.0
24334,2,4334,[ 25 172  70 423 210],72,4,19672,4.537946943483275,0.0,0.0
24335,2,4335,[234   4 655 172 151],796,3,19675,4.5375922509225095,0.0,0.0
24336,2,4336,[ 98   8 234  64 168],389,5,19680,4.537698870186765,20.0,0.0
24337,2,4337,[ 96 168 186 132 237],450,4,19684,4.537574919317658,0.0,0.0
24338,2,4338,[318 427 496 357 257],330,5,19689,4.537681493431666,60.0,0.0
24339,2,4339,[318 427 496 357 257],796,5,19694,4.537788018433179,60.0,0.0
24340,2,4340,[ 22   9  64  71 515],878,4,19698,4.53766413268832,20.0,0.0
24341,2,4341,[318 427 496 357 257],716,5,19703,4.537770612620912,60.0,0.0
24342,2,4342,[ 50 183  64  69  70],655,3,19706,4.5374165323509095,20.0,20.0
24343,2,4343,[318 427 496 357 257],796,5,19711,4.537523020257827,60.0,0.0
24344,2,4344,[100 132  22 313 125],280,2,19713,4.536939010356732,0.0,20.0
24345,2,4345,[318 427 496 357 257],716,5,19718,4.537045559134836,60.0,0.0
24346,2,4346,[117 275 237 127 182],457,5,19723,4.5371520588911896,0.0,40.0
24347,2,4347,[318 427 496 357 257],796,5,19728,4.537258509659614,60.0,0.0
24348,2,4348,[318 427 496 357 257],330,5,19733,4.537364911473902,60.0,0.0
24349,2,4349,[318 427 496 357 257],716,5,19738,4.537471264367816,60.0,0.0
24350,2,4350,[318 427 496 357 257],796,5,19743,4.537577568375086,60.0,0.0
24351,2,4351,[318 427 496 357 257],716,5,19748,4.537683823529412,60.0,0.0
24352,2,4352,[318 427 496 357 257],330,5,19753,4.537790029864461,60.0,0.0
24353,2,4353,[237 100 132 194 196],577,5,19758,4.537896187413872,0.0,20.0
24354,2,4354,[318 427 496 357 257],330,5,19763,4.538002296211252,60.0,0.0
24355,2,4355,[318 427 496 357 257],796,5,19768,4.5381083562901745,60.0,0.0
24356,2,4356,[318 427 496 357 257],796,5,19773,4.538214367684186,60.0,0.0
24357,2,4357,[318 427 496 357 257],716,5,19778,4.538320330426801,60.0,0.0
24358,2,4358,[318 427 496 357 257],796,5,19783,4.538426244551503,60.0,0.0
24359,2,4359,[318 427 496 357 257],330,5,19788,4.538532110091743,60.0,0.0
24360,2,4360,[318 427 496 357 257],796,5,19793,4.538637927080945,60.0,0.0
24361,2,4361,[318 427 496 357 257],330,5,19798,4.5387436955524985,60.0,0.0
24362,2,4362,[318 427 496 357 257],330,5,19803,4.538849415539766,60.0,0.0
24363,2,4363,[ 15 215 271 385  22],655,0,19803,4.537809349220899,0.0,0.0
24364,2,4364,[748 195 655 194 191],450,5,19808,4.537915234822451,0.0,0.0
24365,2,4365,[318 427 496 357 257],330,5,19813,4.538021071919377,60.0,0.0
24366,2,4366,[318 427 496 357 257],716,5,19818,4.538126860544996,60.0,0.0
24367,2,4367,[318 427 496 357 257],716,5,19823,4.5382326007326,60.0,0.0
24368,2,4368,[508 215 228 111 282],655,0,19823,4.537193865873197,0.0,0.0
24369,2,4369,[318 427 496 357 257],796,5,19828,4.537299771167048,60.0,0.0
24370,2,4370,[318 427 496 357 257],796,5,19833,4.5374056280027455,60.0,0.0
24371,2,4371,[318 427 496 357 257],716,5,19838,4.537511436413541,60.0,0.0
24372,2,4372,[318 427 496 357 257],796,5,19843,4.537617196432655,60.0,0.0
24373,2,4373,[318 427 496 357 257],330,5,19848,4.537722908093278,60.0,0.0
24374,2,4374,[318 427 496 357 257],796,5,19853,4.537828571428571,60.0,0.0
24375,2,4375,[318 427 496 357 257],330,5,19858,4.537934186471664,60.0,0.0
24376,2,4376,[318 427 496 357 257],330,5,19863,4.538039753255655,60.0,0.0
24377,2,4377,[318 427 496 357 257],796,5,19868,4.5381452718136135,60.0,0.0
24378,2,4378,[403   8   4 568 132],577,4,19872,4.538022379538708,0.0,0.0
24379,2,4379,[318 427 496 357 257],796,5,19877,4.538127853881279,60.0,0.0
24380,2,4380,[195 176 210 204 153],236,0,19877,4.537091988130563,0.0,0.0
24381,2,4381,[318 427 496 357 257],716,5,19882,4.537197626654495,60.0,0.0
24382,2,4382,[318 427 496 357 257],796,5,19887,4.537303216974675,60.0,0.0
24383,2,4383,[197  64 175 405 194],457,5,19892,4.537408759124087,20.0,0.0
24384,2,4384,[ 89 151 196 235 172],344,4,19896,4.537286202964652,0.0,0.0
24385,2,4385,[318 427 496 357 257],716,5,19901,4.537391700866393,60.0,0.0
24386,2,4386,[318 427 496 357 257],330,5,19906,4.537497150672441,60.0,0.0
24387,2,4387,[318 427 496 357 257],330,5,19911,4.537602552415679,60.0,0.0
24388,2,4388,[186   8 483 172   4],18,3,19914,4.537252221462748,0.0,0.0
24389,2,4389,[318 427 496 357 257],330,5,19919,4.537357630979499,60.0,0.0
24390,2,4390,[318 427 496 357 257],330,5,19924,4.5374629924846275,60.0,0.0
24391,2,4391,[318 427 496 357 257],796,5,19929,4.537568306010929,60.0,0.0
24392,2,4392,[276 197 100  15 333],629,5,19934,4.537673571591168,0.0,20.0
24393,2,4393,[318 427 496 357 257],796,5,19939,4.537778789258079,60.0,0.0
24394,2,4394,[  1 597 271   8 269],796,3,19942,4.537428896473265,0.0,0.0
24395,2,4395,[318 427 496 357 257],796,5,19947,4.537534121929027,60.0,0.0
24396,2,4396,[318 427 496 357 257],716,5,19952,4.537639299522402,60.0,0.0
24397,2,4397,[318 427 496 357 257],796,5,19957,4.537744429286039,60.0,0.0
24398,2,4398,[318 427 496 357 257],796,5,19962,4.537849511252557,60.0,0.0
24399,2,4399,[318 427 496 357 257],330,5,19967,4.537954545454546,60.0,0.0
24400,2,4400,[318 427 496 357 257],796,5,19972,4.538059531924563,60.0,0.0
24401,2,4401,[318 427 496 357 257],330,5,19977,4.538164470695139,60.0,0.0
24402,2,4402,[ 88 385 127  22 228],655,1,19978,4.537360890302066,0.0,20.0
24403,2,4403,[318 427 496 357 257],330,5,19983,4.537465940054496,60.0,0.0
24404,2,4404,[286 357 183  15 180],786,4,19987,4.537343927355278,0.0,20.0
24405,2,4405,[318 427 496 357 257],330,5,19992,4.53744893327281,60.0,0.0
24406,2,4406,[237  70 405 288 655],457,5,19997,4.537553891536192,0.0,0.0
24407,2,4407,[318 427 496 357 257],716,5,20002,4.537658802177859,60.0,0.0
24408,2,4408,[318 427 496 357 257],716,5,20007,4.537763665230211,60.0,0.0
24409,2,4409,[318 427 496 357 257],796,5,20012,4.537868480725623,60.0,0.0
24410,2,4410,[318 427 496 357 257],716,5,20017,4.53797324869644,60.0,0.0
24411,2,4411,[318 427 496 357 257],330,5,20022,4.538077969174977,60.0,0.0
24412,2,4412,[191 197 174 655  69],655,1,20023,4.5372762293224564,0.0,0.0
24413,2,4413,[318 427 496 357 257],330,5,20028,4.5373810602628,60.0,0.0
24414,2,4414,[318 427 496 357 257],716,5,20033,4.5374858437146095,60.0,0.0
24415,2,4415,[318 427 496 357 257],330,5,20038,4.537590579710145,60.0,0.0
24416,2,4416,[318 427 496 357 257],330,5,20043,4.537695268281639,60.0,0.0
24417,2,4417,[318 427 496 357 257],330,5,20048,4.537799909461294,60.0,0.0
24418,2,4418,[318 427 496 357 257],716,5,20053,4.537904503281285,60.0,0.0
24419,2,4419,[181 151 144 427 258],535,4,20057,4.537782805429864,20.0,0.0
24420,2,4420,[318 427 496 357 257],330,5,20062,4.537887355801855,60.0,0.0
24421,2,4421,[318 427 496 357 257],796,5,20067,4.5379918588873815,60.0,0.0
24422,2,4422,[318 427 496 357 257],716,5,20072,4.5380963147185165,60.0,0.0
24423,2,4423,[125   4  71 286  82],450,2,20074,4.5375226039783,0.0,20.0
24424,2,4424,[318 427 496 357 257],716,5,20079,4.5376271186440675,60.0,0.0
24425,2,4425,[318 427 496 357 257],796,5,20084,4.537731586082241,60.0,0.0
24426,2,4426,[318 427 496 357 257],716,5,20089,4.537836006324825,60.0,0.0
24427,2,4427,[318 427 496 357 257],796,5,20094,4.5379403794037945,60.0,0.0
24428,2,4428,[318 427 496 357 257],716,5,20099,4.538044705351095,60.0,0.0
24429,2,4429,[318 427 496 357 257],716,5,20104,4.538148984198646,60.0,0.0
24430,2,4430,[318 427 496 357 257],716,5,20109,4.538253215978335,60.0,0.0
24431,2,4431,[318 427 496 357 257],330,5,20114,4.538357400722021,60.0,0.0
24432,2,4432,[ 98 328 427 215  50],450,5,20119,4.538461538461538,20.0,20.0
24433,2,4433,[318 427 496 357 257],796,5,20124,4.538565629228687,60.0,0.0
24434,2,4434,[318 427 496 357 257],716,5,20129,4.538669673055242,60.0,0.0
24435,2,4435,[385 211  12  25 742],450,4,20133,4.538548241659153,0.0,0.0
24436,2,4436,[318 427 496 357 257],796,5,20138,4.538652242506198,60.0,0.0
24437,2,4437,[318 427 496 357 257],716,5,20143,4.538756196484903,60.0,0.0
24438,2,4438,[405 153 588 286 200],330,5,20148,4.538860103626943,0.0,20.0
24439,2,4439,[318 427 496 357 257],716,5,20153,4.538963963963964,60.0,0.0
24440,2,4440,[318 427 496 357 257],796,5,20158,4.539067777527584,60.0,0.0
24441,2,4441,[318 427 496 357 257],796,5,20163,4.539171544349392,60.0,0.0
24442,2,4442,[318 427 496 357 257],796,5,20168,4.53927526446095,60.0,0.0
24443,2,4443,[318 427 496 357 257],796,5,20173,4.539378937893789,60.0,0.0
24444,2,4444,[318 427 496 357 257],330,5,20178,4.539482564679415,60.0,0.0
24445,2,4445,[318 427 496 357 257],796,5,20183,4.539586144849303,60.0,0.0
24446,2,4446,[318 427 496 357 257],796,5,20188,4.5396896784349,60.0,0.0
24447,2,4447,[318 427 496 357 257],796,5,20193,4.539793165467626,60.0,0.0
24448,2,4448,[276 385 215   9 143],655,2,20195,4.539222297145426,0.0,0.0
24449,2,4449,[111 300 202 276 200],655,2,20197,4.538651685393258,0.0,0.0
24450,2,4450,[318 427 496 357 257],796,5,20202,4.538755335879578,60.0,0.0
24451,2,4451,[318 427 496 357 257],796,5,20207,4.538858939802336,60.0,0.0
24452,2,4452,[ 11 273 195 275  22],655,2,20209,4.538288794071413,0.0,20.0
24453,2,4453,[ 69 117  64  15 496],330,5,20214,4.538392456219129,40.0,0.0
24454,2,4454,[ 64 215  69 222  12],344,3,20217,4.538047138047138,20.0,0.0
24455,2,4455,[273  97 471  88 127],401,3,20220,4.53770197486535,0.0,20.0
24456,2,4456,[318 427 496 357 257],716,5,20225,4.5378056989006055,60.0,0.0
24457,2,4457,[318 427 496 357 257],796,5,20230,4.537909376401974,60.0,0.0
24458,2,4458,[318 427 496 357 257],716,5,20235,4.538013007400762,60.0,0.0
24459,2,4459,[318 427 496 357 257],796,5,20240,4.538116591928251,60.0,0.0
24460,2,4460,[318 427 496 357 257],796,5,20245,4.5382201300156915,60.0,0.0
24461,2,4461,[318 427 496 357 257],330,5,20250,4.538323621694308,60.0,0.0
24462,2,4462,[318 427 496 357 257],330,5,20255,4.538427066995295,60.0,0.0
24463,2,4463,[318 427 496 357 257],330,5,20260,4.538530465949821,60.0,0.0
24464,2,4464,[187 269 180 204 597],796,3,20263,4.538185890257559,0.0,0.0
24465,2,4465,[318 427 496 357 257],716,5,20268,4.538289296909986,60.0,0.0
24466,2,4466,[318 427 496 357 257],796,5,20273,4.538392657264383,60.0,0.0
24467,2,4467,[323 185 187  69 275],316,1,20274,4.5376007162041185,0.0,20.0
24468,2,4468,[318 427 496 357 257],330,5,20279,4.537704184381293,60.0,0.0
24469,2,4469,[318 427 496 357 257],330,5,20284,4.537807606263982,60.0,0.0
24470,2,4470,[318 427 496 357 257],716,5,20289,4.537910981883248,60.0,0.0
24471,2,4471,[318 427 496 357 257],716,5,20294,4.538014311270126,60.0,0.0
24472,2,4472,[318 427 496 357 257],796,5,20299,4.538117594455622,60.0,0.0
24473,2,4473,[100 288  98   4 313],450,3,20302,4.537773804202057,0.0,20.0
24474,2,4474,[318 427 496 357 257],796,5,20307,4.5378770949720675,60.0,0.0
24475,2,4475,[318 427 496 357 257],716,5,20312,4.537980339588919,60.0,0.0
24476,2,4476,[318 427 496 357 257],330,5,20317,4.538083538083538,60.0,0.0
24477,2,4477,[318 427 496 357 257],796,5,20322,4.538186690486825,60.0,0.0
24478,2,4478,[318 427 496 357 257],796,5,20327,4.538289796829649,60.0,0.0
24479,2,4479,[ 89 132  69 161 603],655,2,20329,4.537723214285714,20.0,0.0
24480,2,4480,[318 427 496 357 257],716,5,20334,4.537826378040616,60.0,0.0
24481,2,4481,[318 427 496 357 257],716,5,20339,4.537929495760821,60.0,0.0
24482,2,4482,[318 427 496 357 257],330,5,20344,4.538032567477136,60.0,0.0
24483,2,4483,[318 427 496 357 257],796,5,20349,4.538135593220339,60.0,0.0
24484,2,4484,[318 427 496 357 257],330,5,20354,4.538238573021181,60.0,0.0
24485,2,4485,[318 427 496 357 257],330,5,20359,4.538341506910388,60.0,0.0
24486,2,4486,[318 427 496 357 257],716,5,20364,4.5384443949186535,60.0,0.0
24487,2,4487,[318 427 496 357 257],796,5,20369,4.538547237076648,60.0,0.0
24488,2,4488,[318 427 496 357 257],716,5,20374,4.538650033415014,60.0,0.0
24489,2,4489,[318 427 496 357 257],716,5,20379,4.538752783964365,60.0,0.0
24490,2,4490,[100 228  50  97 172],786,5,20384,4.5388554887552885,0.0,40.0
24491,2,4491,[318 427 496 357 257],796,5,20389,4.538958147818343,60.0,0.0
24492,2,4492,[318 427 496 357 257],716,5,20394,4.539060761184064,60.0,0.0
24493,2,4493,[143 318 191 302  79],151,3,20397,4.53871829105474,20.0,0.0
24494,2,4494,[318 427 496 357 257],796,5,20402,4.538820912124583,60.0,0.0
24495,2,4495,[265 118 742 603  82],450,3,20405,4.538478647686833,20.0,0.0
24496,2,4496,[181 172 471   9  25],655,1,20406,4.537691794529686,0.0,0.0
24497,2,4497,[318 427 496 357 257],716,5,20411,4.53779457536683,60.0,0.0
24498,2,4498,[318 427 496 357 257],716,5,20416,4.537897310513447,60.0,0.0
24499,2,4499,[318 427 496 357 257],716,5,20421,4.538,60.0,0.0
24500,2,4500,[318 427 496 357 257],716,5,20426,4.538102643856921,60.0,0.0
24501,2,4501,[597 153 173  97 191],796,4,20430,4.537983118613949,0.0,0.0
24502,2,4502,[301 385 132 197 588],450,5,20435,4.538085720630691,0.0,0.0
24503,2,4503,[546 183 211 143 111],716,3,20438,4.537744227353463,0.0,0.0
24504,2,4504,[318 427 496 357 257],330,5,20443,4.5378468368479465,60.0,0.0
24505,2,4505,[318 427 496 357 257],330,5,20448,4.537949400798935,60.0,0.0
24506,2,4506,[318 427 496 357 257],796,5,20453,4.538051919236743,60.0,0.0
24507,2,4507,[318 427 496 357 257],796,5,20458,4.538154392191659,60.0,0.0
24508,2,4508,[318 427 496 357 257],796,5,20463,4.538256819693945,60.0,0.0
24509,2,4509,[318 427 496 357 257],330,5,20468,4.538359201773836,60.0,0.0
24510,2,4510,[318 427 496 357 257],796,5,20473,4.538461538461538,60.0,0.0
24511,2,4511,[318 427 496 357 257],796,5,20478,4.538563829787234,60.0,0.0
24512,2,4512,[318 427 496 357 257],716,5,20483,4.538666075781077,60.0,0.0
24513,2,4513,[471 742  69   9 328],655,0,20483,4.537660611431103,0.0,0.0
24514,2,4514,[318 427 496 357 257],716,5,20488,4.537763012181617,60.0,0.0
24515,2,4515,[318 427 496 357 257],716,5,20493,4.537865367581931,60.0,0.0
24516,2,4516,[318 427 496 357 257],796,5,20498,4.537967677662166,60.0,0.0
24517,2,4517,[318 427 496 357 257],716,5,20503,4.538069942452412,60.0,0.0
24518,2,4518,[318 427 496 357 257],330,5,20508,4.5381721619827395,60.0,0.0
24519,2,4519,[318 427 496 357 257],796,5,20513,4.538274336283186,60.0,0.0
24520,2,4520,[318 427 496 357 257],796,5,20518,4.538376465383765,60.0,0.0
24521,2,4521,[318 427 496 357 257],330,5,20523,4.538478549314463,60.0,0.0
24522,2,4522,[318 427 496 357 257],796,5,20528,4.53858058810524,60.0,0.0
24523,2,4523,[318 427 496 357 257],330,5,20533,4.53868258178603,60.0,0.0
24524,2,4524,[423 179 187 275 181],535,4,20537,4.538563535911602,0.0,20.0
24525,2,4525,[427  82   1 175  28],23,3,20540,4.538223596995139,20.0,0.0
24526,2,4526,[318 427 496 357 257],796,5,20545,4.5383256019438925,60.0,0.0
24527,2,4527,[318 427 496 357 257],796,5,20550,4.538427561837456,60.0,0.0
24528,2,4528,[318 427 496 357 257],796,5,20555,4.5385294767056745,60.0,0.0
24529,2,4529,[318 427 496 357 257],796,5,20560,4.5386313465783665,60.0,0.0
24530,2,4530,[318 427 496 357 257],716,5,20565,4.538733171485323,60.0,0.0
24531,2,4531,[318 427 496 357 257],716,5,20570,4.538834951456311,60.0,0.0
24532,2,4532,[ 64 200 143  15 385],330,5,20575,4.538936686521068,20.0,0.0
24533,2,4533,[238  69 185 235  98],457,4,20579,4.53881782090869,0.0,0.0
24534,2,4534,[318 427 496 357 257],796,5,20584,4.538919514884234,60.0,0.0
24535,2,4535,[318 427 496 357 257],796,5,20589,4.539021164021164,60.0,0.0
24536,2,4536,[318 427 496 357 257],716,5,20594,4.539122768349129,60.0,0.0
24537,2,4537,[318 427 496 357 257],330,5,20599,4.539224327897752,60.0,0.0
24538,2,4538,[318 427 496 357 257],716,5,20604,4.53932584269663,60.0,0.0
24539,2,4539,[318 427 496 357 257],796,5,20609,4.53942731277533,60.0,0.0
24540,2,4540,[282  56   4 597 423],457,4,20613,4.539308522351905,0.0,0.0
24541,2,4541,[318 427 496 357 257],796,5,20618,4.539409951563188,60.0,0.0
24542,2,4542,[ 12 322 568 100 323],280,2,20620,4.538850979528946,0.0,20.0
24543,2,4543,[318 427 496 357 257],330,5,20625,4.538952464788732,60.0,0.0
24544,2,4544,[318 427 496 357 257],796,5,20630,4.539053905390539,60.0,0.0
24545,2,4545,[603  71 215 423  64],450,4,20634,4.538935327760669,40.0,0.0
24546,2,4546,[318 427 496 357 257],796,5,20639,4.539036727512646,60.0,0.0
24547,2,4547,[318 427 496 357 257],796,5,20644,4.539138082673703,60.0,0.0
24548,2,4548,[318 427 496 357 257],330,5,20649,4.539239393273247,60.0,0.0
24549,2,4549,[318 427 496 357 257],796,5,20654,4.53934065934066,60.0,0.0
24550,2,4550,[678 288 245 286 118],280,2,20656,4.538782685124149,0.0,20.0
24551,2,4551,[318 427 496 357 257],796,5,20661,4.538884007029877,60.0,0.0
24552,2,4552,[318 427 496 357 257],716,5,20666,4.5389852844278495,60.0,0.0
24553,2,4553,[318 427 496 357 257],796,5,20671,4.539086517347387,60.0,0.0
24554,2,4554,[318 427 496 357 257],796,5,20676,4.539187705817783,60.0,0.0
24555,2,4555,[228 568 185 385 427],796,5,20681,4.5392888498683055,20.0,0.0
24556,2,4556,[357 333 568 423  12],655,1,20682,4.538512179065174,0.0,0.0
24557,2,4557,[173 276 588 185  25],457,5,20687,4.538613426941641,0.0,0.0
24558,2,4558,[318 427 496 357 257],330,5,20692,4.538714630401404,60.0,0.0
24559,2,4559,[333 228 186 265 216],796,4,20696,4.53859649122807,0.0,0.0
24560,2,4560,[318 427 496 357 257],716,5,20701,4.538697654023241,60.0,0.0
24561,2,4561,[318 427 496 357 257],330,5,20706,4.5387987724682155,60.0,0.0
24562,2,4562,[132  22 282 271 185],655,1,20707,4.538023230330922,0.0,0.0
24563,2,4563,[318 427 496 357 257],716,5,20712,4.538124452234881,60.0,0.0
24564,2,4564,[318 427 496 357 257],796,5,20717,4.538225629791895,60.0,0.0
24565,2,4565,[318 427 496 357 257],330,5,20722,4.538326763031099,60.0,0.0
24566,2,4566,[118  88 742 144  82],280,1,20723,4.537552003503394,0.0,0.0
24567,2,4567,[301  15 175 181 286],151,5,20728,4.537653239929948,0.0,20.0
24568,2,4568,[318 427 496 357 257],330,5,20733,4.537754432042022,60.0,0.0
24569,2,4569,[238 269  64 234 174],796,2,20735,4.537199124726477,20.0,0.0
24570,2,4570,[318 427 496 357 257],330,5,20740,4.537300371909867,60.0,0.0
24571,2,4571,[423 197 216 174 385],280,3,20743,4.536964129483814,0.0,0.0
24572,2,4572,[151  69  22  98 180],457,5,20748,4.537065383774328,0.0,0.0
24573,2,4573,[318 427 496 357 257],330,5,20753,4.537166593790992,60.0,0.0
24574,2,4574,[318 427 496 357 257],330,5,20758,4.537267759562842,60.0,0.0
24575,2,4575,[318 427 496 357 257],330,5,20763,4.537368881118881,60.0,0.0
24576,2,4576,[318 427 496 357 257],330,5,20768,4.537469958488092,60.0,0.0
24577,2,4577,[318 427 496 357 257],330,5,20773,4.5375709916994325,60.0,0.0
24578,2,4578,[153  12 333 282 405],655,0,20773,4.536580039309893,0.0,0.0
24579,2,4579,[318 427 496 357 257],796,5,20778,4.536681222707424,60.0,0.0
24580,2,4580,[318 427 496 357 257],796,5,20783,4.53678236192971,60.0,0.0
24581,2,4581,[655 423 186 180 179],450,4,20787,4.536665211697948,0.0,0.0
24582,2,4582,[385 100 111 265 144],655,0,20787,4.535675321841588,0.0,20.0
24583,2,4583,[318 427 496 357 257],330,5,20792,4.535776614310646,60.0,0.0
24584,2,4584,[186 597 588 265  69],796,4,20796,4.535659760087241,0.0,0.0
24585,2,4585,[496 121 172 194 322],450,4,20800,4.53554295682512,20.0,0.0
24586,2,4586,[318 427 496 357 257],330,5,20805,4.535644211903205,60.0,0.0
24587,2,4587,[318 427 496 357 257],330,5,20810,4.535745422842197,60.0,0.0
24588,2,4588,[318 427 496 357 257],716,5,20815,4.535846589670952,60.0,0.0
24589,2,4589,[748 333 204  88 427],796,5,20820,4.5359477124183005,20.0,0.0
24590,2,4590,[318 427 496 357 257],716,5,20825,4.536048791113047,60.0,0.0
24591,2,4591,[318 427 496 357 257],796,5,20830,4.536149825783972,60.0,0.0
24592,2,4592,[318 427 496 357 257],796,5,20835,4.53625081645983,60.0,0.0
24593,2,4593,[318 427 496 357 257],716,5,20840,4.5363517631693515,60.0,0.0
24594,2,4594,[318 427 496 357 257],330,5,20845,4.5364526659412405,60.0,0.0
24595,2,4595,[318 427 496 357 257],716,5,20850,4.5365535248041775,60.0,0.0
24596,2,4596,[318 427 496 357 257],330,5,20855,4.536654339786818,60.0,0.0
24597,2,4597,[318 427 496 357 257],716,5,20860,4.53675511091779,60.0,0.0
24598,2,4598,[318 427 496 357 257],716,5,20865,4.536855838225701,60.0,0.0
24599,2,4599,[318 427 496 357 257],330,5,20870,4.53695652173913,60.0,0.0
24600,2,4600,[318 427 496 357 257],330,5,20875,4.537057161486634,60.0,0.0
24601,2,4601,[143 191 275  89 174],450,5,20880,4.5371577574967406,0.0,20.0
24602,2,4602,[318 427 496 357 257],716,5,20885,4.5372583097979575,60.0,0.0
24603,2,4603,[318 427 496 357 257],330,5,20890,4.537358818418766,60.0,0.0
24604,2,4604,[318 427 496 357 257],796,5,20895,4.537459283387622,60.0,0.0
24605,2,4605,[318 427 496 357 257],716,5,20900,4.537559704732957,60.0,0.0
24606,2,4606,[318 427 496 357 257],716,5,20905,4.537660082483177,60.0,0.0
24607,2,4607,[318 427 496 357 257],330,5,20910,4.537760416666667,60.0,0.0
24608,2,4608,[  1 257 196 143 216],389,1,20911,4.536992840095466,0.0,0.0
24609,2,4609,[318 427 496 357 257],330,5,20916,4.537093275488069,60.0,0.0
24610,2,4610,[318 427 496 357 257],716,5,20921,4.537193667317284,60.0,0.0
24611,2,4611,[318 427 496 357 257],716,5,20926,4.537294015611448,60.0,0.0
24612,2,4612,[318 427 496 357 257],796,5,20931,4.537394320398873,60.0,0.0
24613,2,4613,[318 427 496 357 257],330,5,20936,4.537494581707846,60.0,0.0
24614,2,4614,[318 427 496 357 257],330,5,20941,4.53759479956663,60.0,0.0
24615,2,4615,[318 427 496 357 257],716,5,20946,4.537694974003466,60.0,0.0
24616,2,4616,[318 427 496 357 257],796,5,20951,4.537795105046567,60.0,0.0
24617,2,4617,[318 427 496 357 257],796,5,20956,4.537895192724123,60.0,0.0
24618,2,4618,[588 202 275 197 168],450,5,20961,4.537995237064299,0.0,20.0
24619,2,4619,[546 258  88  70   4],344,1,20962,4.5372294372294375,0.0,0.0
24620,2,4620,[318 427 496 357 257],330,5,20967,4.537329582341484,60.0,0.0
24621,2,4621,[471 403 196 194 423],577,4,20971,4.537213327563825,0.0,0.0
24622,2,4622,[318 427 496 357 257],716,5,20976,4.537313432835821,60.0,0.0
24623,2,4623,[318 427 496 357 257],330,5,20981,4.537413494809688,60.0,0.0
24624,2,4624,[318 427 496 357 257],796,5,20986,4.537513513513513,60.0,0.0
24625,2,4625,[216  95 185 403 100],5,2,20988,4.536964980544747,0.0,20.0
24626,2,4626,[121 423 127 135 294],716,4,20992,4.536848930192349,0.0,20.0
24627,2,4627,[318 427 496 357 257],796,5,20997,4.53694900605013,60.0,0.0
24628,2,4628,[318 427 496 357 257],330,5,21002,4.5370490386692595,60.0,0.0
24629,2,4629,[318 427 496 357 257],716,5,21007,4.537149028077754,60.0,0.0
24630,2,4630,[318 427 496 357 257],796,5,21012,4.537248974303606,60.0,0.0
24631,2,4631,[318 427 496 357 257],796,5,21017,4.537348877374784,60.0,0.0
24632,2,4632,[597 216 111 275 144],593,3,21020,4.537017051586445,0.0,20.0
24633,2,4633,[181 403 127 135  89],450,4,21024,4.536901165299957,0.0,20.0
24634,2,4634,[318 427 496 357 257],330,5,21029,4.537001078748651,60.0,0.0
24635,2,4635,[318 427 496 357 257],716,5,21034,4.537100949094047,60.0,0.0
24636,2,4636,[318  56 269 197 603],535,4,21038,4.536985119689454,40.0,0.0
24637,2,4637,[515 135 200 195 151],269,4,21042,4.536869340232859,0.0,0.0
24638,2,4638,[318 427 496 357 257],716,5,21047,4.536969174391032,60.0,0.0
24639,2,4639,[ 12  79 238 197 405],457,5,21052,4.537068965517242,0.0,0.0
24640,2,4640,[318 427 496 357 257],330,5,21057,4.537168713639302,60.0,0.0
24641,2,4641,[318 427 496 357 257],330,5,21062,4.537268418785007,60.0,0.0
24642,2,4642,[385 111 173   8 127],280,4,21066,4.537152702993754,0.0,20.0
24643,2,4643,[318 427 496 357 257],796,5,21071,4.537252368647717,60.0,0.0
24644,2,4644,[318 427 496 357 257],716,5,21076,4.53735199138859,60.0,0.0
24645,2,4645,[ 82 194 176 118 655],504,2,21078,4.5368058544984935,0.0,0.0
24646,2,4646,[318 427 496 357 257],330,5,21083,4.5369055304497525,60.0,0.0
24647,2,4647,[ 28 173 234 471 125],577,3,21086,4.5365748709122204,0.0,0.0
24648,2,4648,[  1 269  95 191  64],344,4,21090,4.5364594536459455,20.0,0.0
24649,2,4649,[318 427 496 357 257],796,5,21095,4.536559139784946,60.0,0.0
24650,2,4650,[318 427 496 357 257],716,5,21100,4.536658783057407,60.0,0.0
24651,2,4651,[  7 245 196 172 117],450,5,21105,4.536758383490971,0.0,0.0
24652,2,4652,[318 427 496 357 257],796,5,21110,4.536857941113261,60.0,0.0
24653,2,4653,[245 435 313 286 191],450,5,21115,4.536957455951869,0.0,20.0
24654,2,4654,[318 427 496 357 257],716,5,21120,4.537056928034372,60.0,0.0
24655,2,4655,[318 427 496 357 257],796,5,21125,4.537156357388316,60.0,0.0
24656,2,4656,[318 427 496 357 257],716,5,21130,4.537255744041229,60.0,0.0
24657,2,4657,[238  70   8 276 313],655,2,21132,4.536711034778875,0.0,0.0
24658,2,4658,[318 427 496 357 257],330,5,21137,4.536810474350719,60.0,0.0
24659,2,4659,[318 427 496 357 257],330,5,21142,4.536909871244635,60.0,0.0
24660,2,4660,[318 427 496 357 257],330,5,21147,4.5370092254880925,60.0,0.0
24661,2,4661,[318 427 496 357 257],716,5,21152,4.537108537108537,60.0,0.0
24662,2,4662,[318 427 496 357 257],796,5,21157,4.537207806133391,60.0,0.0
24663,2,4663,[318 427 496 357 257],716,5,21162,4.537307032590052,60.0,0.0
24664,2,4664,[318 427 496 357 257],330,5,21167,4.537406216505895,60.0,0.0
24665,2,4665,[313 118 143 300 175],655,2,21169,4.536862408915559,0.0,0.0
24666,2,4666,[ 50 191  71  98 289],798,2,21171,4.5363188343689735,0.0,20.0
24667,2,4667,[228  50 546 471 151],450,5,21176,4.536418166238217,0.0,20.0
24668,2,4668,[318 427 496 357 257],716,5,21181,4.536517455557935,60.0,0.0
24669,2,4669,[111 200 655 423 161],450,4,21185,4.536402569593148,0.0,0.0
24670,2,4670,[318 427 496 357 257],716,5,21190,4.536501819738814,60.0,0.0
24671,2,4671,[318 427 496 357 257],716,5,21195,4.536601027397261,60.0,0.0
24672,2,4672,[318 427 496 357 257],330,5,21200,4.536700192595763,60.0,0.0
24673,2,4673,[483  28 403 385 546],457,4,21204,4.536585365853658,0.0,0.0
24674,2,4674,[318 427 496 357 257],330,5,21209,4.53668449197861,60.0,0.0
24675,2,4675,[318 427 496 357 257],796,5,21214,4.536783575705732,60.0,0.0
24676,2,4676,[318 427 496 357 257],330,5,21219,4.536882617062219,60.0,0.0
24677,2,4677,[318 427 496 357 257],330,5,21224,4.536981616075246,60.0,0.0
24678,2,4678,[318 427 496 357 257],330,5,21229,4.53708057277196,60.0,0.0
24679,2,4679,[318 427 496 357 257],330,5,21234,4.537179487179487,60.0,0.0
24680,2,4680,[ 79  15 496 187 423],450,4,21238,4.537064729758598,20.0,0.0
24681,2,4681,[318 427 496 357 257],796,5,21243,4.537163605296882,60.0,0.0
24682,2,4682,[176 237 186 282 196],655,0,21243,4.5361947469570785,0.0,0.0
24683,2,4683,[318 427 496 357 257],716,5,21248,4.536293766011956,60.0,0.0
24684,2,4684,[318 427 496 357 257],716,5,21253,4.536392742796158,60.0,0.0
24685,2,4685,[318 427 496 357 257],796,5,21258,4.536491677336747,60.0,0.0
24686,2,4686,[318 427 496 357 257],796,5,21263,4.536590569660764,60.0,0.0
24687,2,4687,[323 121   1 111  71],756,2,21265,4.536049488054608,0.0,0.0
24688,2,4688,[288 546 222 435 202],450,3,21268,4.53572190232459,0.0,0.0
24689,2,4689,[318 427 496 357 257],796,5,21273,4.535820895522388,60.0,0.0
24690,2,4690,[318 427 496 357 257],716,5,21278,4.535919846514602,60.0,0.0
24691,2,4691,[318 427 496 357 257],796,5,21283,4.536018755328218,60.0,0.0
24692,2,4692,[318 427 496 357 257],796,5,21288,4.536117621990198,60.0,0.0
24693,2,4693,[655 269 268 258 132],535,4,21292,4.536003408606732,0.0,0.0
24694,2,4694,[318 427 496 357 257],716,5,21297,4.536102236421725,60.0,0.0
24695,2,4695,[318 427 496 357 257],330,5,21302,4.536201022146508,60.0,0.0
24696,2,4696,[ 96 603 181 204  56],796,5,21307,4.5362997658079625,20.0,0.0
24697,2,4697,[318 427 496 357 257],330,5,21312,4.53639846743295,60.0,0.0
24698,2,4698,[318 427 496 357 257],716,5,21317,4.5364971270483085,60.0,0.0
24699,2,4699,[318 427 496 357 257],330,5,21322,4.536595744680851,60.0,0.0
24700,2,4700,[318 427 496 357 257],796,5,21327,4.536694320357371,60.0,0.0
24701,2,4701,[318 427 496 357 257],796,5,21332,4.536792854104636,60.0,0.0
24702,2,4702,[318 427 496 357 257],716,5,21337,4.536891345949394,60.0,0.0
24703,2,4703,[ 22 196  69 181 300],796,5,21342,4.536989795918367,0.0,0.0
24704,2,4704,[385 111 211 237  50],716,4,21346,4.536875664187035,0.0,20.0
24705,2,4705,[210  69 200  97 655],655,1,21347,4.536124096897577,0.0,0.0
24706,2,4706,[318 427 496 357 257],716,5,21352,4.536222647121309,60.0,0.0
24707,2,4707,[318 427 496 357 257],796,5,21357,4.536321155480034,60.0,0.0
24708,2,4708,[318 427 496 357 257],796,5,21362,4.536419622000425,60.0,0.0
24709,2,4709,[318 427 496 357 257],716,5,21367,4.53651804670913,60.0,0.0
24710,2,4710,[286 187 125 172 475],655,2,21369,4.5359796221609,0.0,20.0
24711,2,4711,[318 427 496 357 257],716,5,21374,4.536078098471987,60.0,0.0
24712,2,4712,[318 427 496 357 257],330,5,21379,4.536176532993847,60.0,0.0
24713,2,4713,[318 427 496 357 257],796,5,21384,4.536274925753076,60.0,0.0
24714,2,4714,[204 323   7 172  98],23,3,21387,4.535949098621421,0.0,0.0
24715,2,4715,[318 427 496 357 257],796,5,21392,4.536047497879559,60.0,0.0
24716,2,4716,[471 603 302  71 405],401,2,21394,4.535509857960568,20.0,0.0
24717,2,4717,[ 82 202 216 210   1],151,4,21398,4.535396354387452,0.0,0.0
24718,2,4718,[197 288 143 318 127],655,3,21401,4.535070989616444,20.0,20.0
24719,2,4719,[ 56 275 125 655 328],796,4,21405,4.5349576271186445,0.0,20.0
24720,2,4720,[135  98 603 111 483],292,5,21410,4.535056132175386,20.0,0.0
24721,2,4721,[318 427 496 357 257],330,5,21415,4.535154595510377,60.0,0.0
24722,2,4722,[403 179 333  96  56],655,1,21416,4.534406097819183,0.0,0.0
24723,2,4723,[ 11  95 187 121 182],450,3,21419,4.534081287044877,0.0,0.0
24724,2,4724,[318 427 496 357 257],796,5,21424,4.5341798941798945,60.0,0.0
24725,2,4725,[318 427 496 357 257],330,5,21429,4.5342784595852725,60.0,0.0
24726,2,4726,[237 173 210 273  79],796,3,21432,4.533953881954728,0.0,0.0
24727,2,4727,[318 427 496 357 257],716,5,21437,4.534052453468697,60.0,0.0
24728,2,4728,[215 508 117 121 172],344,2,21439,4.533516599703955,0.0,0.0
24729,2,4729,[318 427 496 357 257],796,5,21444,4.533615221987315,60.0,0.0
24730,2,4730,[ 28 385 202 121  22],330,5,21449,4.533713802578736,0.0,0.0
24731,2,4731,[318 427 496 357 257],330,5,21454,4.53381234150465,60.0,0.0
24732,2,4732,[318 427 496 357 257],716,5,21459,4.533910838791464,60.0,0.0
24733,2,4733,[318 427 496 357 257],716,5,21464,4.5340092944655686,60.0,0.0
24734,2,4734,[318 427 496 357 257],330,5,21469,4.534107708553326,60.0,0.0
24735,2,4735,[  8 196  82  95 191],389,3,21472,4.533783783783784,0.0,0.0
24736,2,4736,[318 427 496 357 257],330,5,21477,4.533882203926535,60.0,0.0
24737,2,4737,[195  11 187  15  82],256,4,21481,4.533769523005487,0.0,0.0
24738,2,4738,[318 427 496 357 257],330,5,21486,4.5338679046212285,60.0,0.0
24739,2,4739,[318 427 496 357 257],716,5,21491,4.533966244725739,60.0,0.0
24740,2,4740,[100 257 546 210 385],457,3,21494,4.533642691415313,0.0,20.0
24741,2,4741,[318 427 496 357 257],716,5,21499,4.533741037536904,60.0,0.0
24742,2,4742,[ 82  56 132  71  50],796,4,21503,4.533628505165507,0.0,20.0
24743,2,4743,[191  28 748 228 597],11,2,21505,4.533094435075886,0.0,0.0
24744,2,4744,[286   4 176 127  69],796,4,21509,4.532982086406744,0.0,40.0
24745,2,4745,[318 427 496 357 257],330,5,21514,4.533080488832701,60.0,0.0
24746,2,4746,[318 210 204 405 423],835,3,21517,4.5327575310722565,20.0,0.0
24747,2,4747,[318 427 496 357 257],330,5,21522,4.532855939342881,60.0,0.0
24748,2,4748,[151  64 144 211 180],796,3,21525,4.532533164876816,20.0,0.0
24749,2,4749,[318 427 496 357 257],796,5,21530,4.532631578947369,60.0,0.0
24750,2,4750,[318 427 496 357 257],716,5,21535,4.532729951589139,60.0,0.0
24751,2,4751,[318 427 496 357 257],796,5,21540,4.532828282828283,60.0,0.0
24752,2,4752,[427  89 215  12 269],655,2,21542,4.532295392383758,20.0,0.0
24753,2,4753,[318 427 496 357 257],796,5,21547,4.532393773664283,60.0,0.0
24754,2,4754,[168 234 423 742  56],450,4,21551,4.5322818086225025,0.0,0.0
24755,2,4755,[318 427 496 357 257],796,5,21556,4.532380151387721,60.0,0.0
24756,2,4756,[318 427 496 357 257],330,5,21561,4.532478452806391,60.0,0.0
24757,2,4757,[318 427 496 357 257],330,5,21566,4.532576712904582,60.0,0.0
24758,2,4758,[318 427 496 357 257],796,5,21571,4.532674931708342,60.0,0.0
24759,2,4759,[471 195 174 176 385],280,1,21572,4.531932773109244,0.0,0.0
24760,2,4760,[318 427 496 357 257],330,5,21577,4.532031085906322,60.0,0.0
24761,2,4761,[318 427 496 357 257],330,5,21582,4.532129357412852,60.0,0.0
24762,2,4762,[405  69 257 185  79],457,4,21586,4.532017635943733,0.0,0.0
24763,2,4763,[318 427 496 357 257],330,5,21591,4.532115869017632,60.0,0.0
24764,2,4764,[135 288 258 191 172],693,2,21593,4.5315844700944385,0.0,0.0
24765,2,4765,[286 483  82  98 245],450,3,21596,4.531263113722199,0.0,20.0
24766,2,4766,[318 427 496 357 257],796,5,21601,4.531361443255716,60.0,0.0
24767,2,4767,[318 427 496 357 257],716,5,21606,4.531459731543624,60.0,0.0
24768,2,4768,[183 483  88 143 238],457,5,21611,4.531557978611868,0.0,0.0
24769,2,4769,[ 89 111 161 179 603],450,5,21616,4.531656184486373,20.0,0.0
24770,2,4770,[ 28  88 237 185 127],450,5,21621,4.531754349193041,0.0,20.0
24771,2,4771,[318 427 496 357 257],716,5,21626,4.531852472757754,60.0,0.0
24772,2,4772,[318 427 496 357 257],330,5,21631,4.531950555206369,60.0,0.0
24773,2,4773,[318 427 496 357 257],716,5,21636,4.532048596564725,60.0,0.0
24774,2,4774,[318 427 496 357 257],330,5,21641,4.532146596858639,60.0,0.0
24775,2,4775,[318 427 496 357 257],716,5,21646,4.532244556113903,60.0,0.0
24776,2,4776,[318 427 496 357 257],796,5,21651,4.53234247435629,60.0,0.0
24777,2,4777,[318 427 496 357 257],796,5,21656,4.532440351611553,60.0,0.0
24778,2,4778,[318 427 496 357 257],330,5,21661,4.53253818790542,60.0,0.0
24779,2,4779,[318 427 496 357 257],796,5,21666,4.5326359832635985,60.0,0.0
24780,2,4780,[ 98 357 210 568 172],796,4,21670,4.532524576448441,0.0,0.0
24781,2,4781,[286  82 318  79 196],151,4,21674,4.5324132162275195,20.0,20.0
24782,2,4782,[318 427 496 357 257],716,5,21679,4.5325109763746605,60.0,0.0
24783,2,4783,[318 427 496 357 257],330,5,21684,4.532608695652174,60.0,0.0
24784,2,4784,[ 69  64 282 265 546],236,4,21688,4.532497387669801,20.0,0.0
24785,2,4785,[546 118 237  70 471],450,4,21692,4.532386126201421,0.0,0.0
24786,2,4786,[318 427 496 357 257],796,5,21697,4.532483810319616,60.0,0.0
24787,2,4787,[258  88 228 197 186],450,4,21701,4.5323725981620715,0.0,0.0
24788,2,4788,[ 97 181 202 237 568],457,5,21706,4.532470244309877,0.0,0.0
24789,2,4789,[318 427 496 357 257],796,5,21711,4.532567849686847,60.0,0.0
24790,2,4790,[318 427 496 357 257],796,5,21716,4.532665414318513,60.0,0.0
24791,2,4791,[127 496 427 318 210],18,5,21721,4.532762938230384,60.0,20.0
24792,2,4792,[318 427 496 357 257],716,5,21726,4.532860421447945,60.0,0.0
24793,2,4793,[318 427 496 357 257],716,5,21731,4.532957863996662,60.0,0.0
24794,2,4794,[318 427 496 357 257],796,5,21736,4.533055265901981,60.0,0.0
24795,2,4795,[318 427 496 357 257],330,5,21741,4.533152627189325,60.0,0.0
24796,2,4796,[172 286   4 117 238],786,5,21746,4.533249947884094,0.0,20.0
24797,2,4797,[318 427 496 357 257],716,5,21751,4.533347228011672,60.0,0.0
24798,2,4798,[318 427 496 357 257],716,5,21756,4.533444467597416,60.0,0.0
24799,2,4799,[318 427 496 357 257],796,5,21761,4.533541666666666,60.0,0.0
24800,2,4800,[216 210 385 202 135],151,4,21765,4.533430535305145,0.0,0.0
24801,2,4801,[216 176 196 194 185],450,5,21770,4.533527696793003,0.0,0.0
24802,2,4802,[194  89 181 204 202],796,5,21775,4.5336248178221945,0.0,0.0
24803,2,4803,[405 187 127  64 258],655,3,21778,4.53330557868443,20.0,20.0
24804,2,4804,[238 153 127 195 185],269,3,21781,4.532986472424557,0.0,20.0
24805,2,4805,[318 427 496 357 257],330,5,21786,4.533083645443196,60.0,0.0
24806,2,4806,[216 318 483   9   8],457,5,21791,4.533180778032037,20.0,0.0
24807,2,4807,[117  11 174 435 234],716,5,21796,4.533277870216306,0.0,0.0
24808,2,4808,[318 427 496 357 257],330,5,21801,4.53337492202121,60.0,0.0
24809,2,4809,[318 427 496 357 257],716,5,21806,4.533471933471933,60.0,0.0
24810,2,4810,[318 427 496 357 257],716,5,21811,4.53356890459364,60.0,0.0
24811,2,4811,[318 427 496 357 257],330,5,21816,4.533665835411472,60.0,0.0
24812,2,4812,[318 427 496 357 257],796,5,21821,4.533762725950551,60.0,0.0
24813,2,4813,[318 427 496 357 257],716,5,21826,4.533859576235979,60.0,0.0
24814,2,4814,[318 427 496 357 257],716,5,21831,4.533956386292835,60.0,0.0
24815,2,4815,[318 427 496 357 257],796,5,21836,4.53405315614618,60.0,0.0
24816,2,4816,[202 215 301 273 323],796,2,21838,4.5335270915507575,0.0,0.0
24817,2,4817,[318  22 357  11 144],716,4,21842,4.533416355334164,20.0,0.0
24818,2,4818,[318 427 496 357 257],716,5,21847,4.533513177007678,60.0,0.0
24819,2,4819,[318 427 496 357 257],716,5,21852,4.533609958506224,60.0,0.0
24820,2,4820,[318 427 496 357 257],716,5,21857,4.533706699854802,60.0,0.0
24821,2,4821,[318 427 496 357 257],716,5,21862,4.533803401078391,60.0,0.0
24822,2,4822,[318 427 496 357 257],716,5,21867,4.533900062201949,60.0,0.0
24823,2,4823,[318 427 496 357 257],796,5,21872,4.533996683250415,60.0,0.0
24824,2,4824,[153 121 118 186 301],796,3,21875,4.533678756476684,0.0,0.0
24825,2,4825,[318 427 496 357 257],716,5,21880,4.533775383340241,60.0,0.0
24826,2,4826,[194 151 588 282 204],796,5,21885,4.533871970167806,0.0,0.0
24827,2,4827,[  9 121 282 176 172],796,4,21889,4.533761391880696,0.0,0.0
24828,2,4828,[318 427 496 357 257],330,5,21894,4.533857941602816,60.0,0.0
24829,2,4829,[318 427 496 357 257],796,5,21899,4.533954451345756,60.0,0.0
24830,2,4830,[318 427 496 357 257],330,5,21904,4.534050921134341,60.0,0.0
24831,2,4831,[318 427 496 357 257],796,5,21909,4.534147350993377,60.0,0.0
24832,2,4832,[318 427 496 357 257],716,5,21914,4.534243740947652,60.0,0.0
24833,2,4833,[318 427 496 357 257],330,5,21919,4.534340091021928,60.0,0.0
24834,2,4834,[  7 161  50 121 588],450,4,21923,4.534229576008273,0.0,20.0
24835,2,4835,[318 427 496 357 257],796,5,21928,4.534325889164599,60.0,0.0
24836,2,4836,[318 427 496 357 257],796,5,21933,4.534422162497416,60.0,0.0
24837,2,4837,[318 427 496 357 257],796,5,21938,4.534518396031418,60.0,0.0
24838,2,4838,[471 496 196   4   7],450,4,21942,4.534407935523869,20.0,0.0
24839,2,4839,[318 427 496 357 257],716,5,21947,4.534504132231405,60.0,0.0
24840,2,4840,[318 427 496 357 257],796,5,21952,4.534600289196447,60.0,0.0
24841,2,4841,[318 427 496 357 257],716,5,21957,4.534696406443619,60.0,0.0
24842,2,4842,[153  79  82 234 333],655,1,21958,4.5339665496593025,0.0,0.0
24843,2,4843,[194  97 187  28 143],716,4,21962,4.533856317093312,0.0,0.0
24844,2,4844,[318 427 496 357 257],796,5,21967,4.533952528379773,60.0,0.0
24845,2,4845,[121 655 508 357 237],535,4,21971,4.533842344201403,0.0,0.0
24846,2,4846,[318 427 496 357 257],330,5,21976,4.533938518671343,60.0,0.0
24847,2,4847,[318 427 496 357 257],330,5,21981,4.534034653465347,60.0,0.0
24848,2,4848,[318 427 496 357 257],716,5,21986,4.534130748607961,60.0,0.0
24849,2,4849,[318 427 496 357 257],330,5,21991,4.534226804123711,60.0,0.0
24850,2,4850,[318 427 496 357 257],330,5,21996,4.534322820037106,60.0,0.0
24851,2,4851,[318 427 496 357 257],716,5,22001,4.53441879637263,60.0,0.0
24852,2,4852,[318 427 496 357 257],716,5,22006,4.53451473315475,60.0,0.0
24853,2,4853,[318 427 496 357 257],796,5,22011,4.534610630407911,60.0,0.0
24854,2,4854,[318 427 496 357 257],330,5,22016,4.53470648815654,60.0,0.0
24855,2,4855,[318 427 496 357 257],330,5,22021,4.534802306425041,60.0,0.0
24856,2,4856,[318 427 496 357 257],716,5,22026,4.534898085237801,60.0,0.0
24857,2,4857,[318 427 496 357 257],796,5,22031,4.5349938246191845,60.0,0.0
24858,2,4858,[318 427 496 357 257],330,5,22036,4.535089524593538,60.0,0.0
24859,2,4859,[153 210 195 271 483],655,1,22037,4.534362139917696,0.0,0.0
24860,2,4860,[405 144 427 185 195],796,5,22042,4.534457930466982,20.0,0.0
24861,2,4861,[222 144 313 357   9],693,3,22045,4.534142328259976,0.0,0.0
24862,2,4862,[385 127  88  97  98],655,2,22047,4.53362122146823,0.0,20.0
24863,2,4863,[258 100 118 161  70],450,4,22051,4.533511513157895,0.0,20.0
24864,2,4864,[318 427 496 357 257],796,5,22056,4.53360739979445,60.0,0.0
24865,2,4865,[318 427 496 357 257],796,5,22061,4.5337032470201395,60.0,0.0
24866,2,4866,[318 427 496 357 257],330,5,22066,4.533799054859256,60.0,0.0
24867,2,4867,[318 427 496 357 257],330,5,22071,4.533894823336072,60.0,0.0
24868,2,4868,[318 427 496 357 257],330,5,22076,4.533990552474841,60.0,0.0
24869,2,4869,[318 427 496 357 257],796,5,22081,4.534086242299795,60.0,0.0
24870,2,4870,[318 427 496 357 257],796,5,22086,4.5341818928351465,60.0,0.0
24871,2,4871,[174 333 118   8 125],655,0,22086,4.533251231527093,0.0,0.0
24872,2,4872,[215 357 144 185 427],693,5,22091,4.533347014159656,20.0,0.0
24873,2,4873,[318 427 496 357 257],716,5,22096,4.533442757488715,60.0,0.0
24874,2,4874,[385  96  71 235  11],344,1,22097,4.5327179487179485,0.0,0.0
24875,2,4875,[172 313 403 234  98],450,4,22101,4.532608695652174,0.0,0.0
24876,2,4876,[318 427 496 357 257],796,5,22106,4.532704531474267,60.0,0.0
24877,2,4877,[318 427 496 357 257],796,5,22111,4.5328003280032805,60.0,0.0
24878,2,4878,[318 427 496 357 257],796,5,22116,4.532896085263373,60.0,0.0
24879,2,4879,[318 427 496 357 257],716,5,22121,4.532991803278689,60.0,0.0
24880,2,4880,[318 427 496 357 257],796,5,22126,4.533087482073346,60.0,0.0
24881,2,4881,[318 427 496 357 257],330,5,22131,4.533183121671446,60.0,0.0
24882,2,4882,[357 234  56 186  15],151,5,22136,4.533278722097071,0.0,0.0
24883,2,4883,[318 427 496 357 257],796,5,22141,4.533374283374283,60.0,0.0
24884,2,4884,[318 427 496 357 257],330,5,22146,4.533469805527123,60.0,0.0
24885,2,4885,[318 427 496 357 257],330,5,22151,4.533565288579616,60.0,0.0
24886,2,4886,[318 427 496 357 257],796,5,22156,4.53366073255576,60.0,0.0
24887,2,4887,[318 427 496 357 257],330,5,22161,4.533756137479542,60.0,0.0
24888,2,4888,[143 496 322 301 313],593,4,22165,4.5336469625690325,20.0,0.0
24889,2,4889,[215 194  22 211 151],18,2,22167,4.5331288343558285,0.0,0.0
24890,2,4890,[318 427 496 357 257],330,5,22172,4.533224289511347,60.0,0.0
24891,2,4891,[ 56  12 276  50 403],256,3,22175,4.532910874897793,0.0,20.0
24892,2,4892,[318 427 496 357 257],716,5,22180,4.533006335581443,60.0,0.0
24893,2,4893,[318 427 496 357 257],330,5,22185,4.53310175725378,60.0,0.0
24894,2,4894,[318 427 496 357 257],330,5,22190,4.5331971399387125,60.0,0.0
24895,2,4895,[318 427 496 357 257],716,5,22195,4.533292483660131,60.0,0.0
24896,2,4896,[483 288 202 496  70],280,4,22199,4.533183581784766,20.0,0.0
24897,2,4897,[288 100 302 125 196],655,1,22200,4.532462229481421,0.0,20.0
24898,2,4898,[318 427 496 357 257],716,5,22205,4.532557664829557,60.0,0.0
24899,2,4899,[318 427 496 357 257],796,5,22210,4.53265306122449,60.0,0.0
24900,2,4900,[151 202  25 228 235],344,4,22214,4.5325443786982245,0.0,0.0
24901,2,4901,[180 121  12 273 603],450,3,22217,4.532231742146063,20.0,0.0
24902,2,4902,[ 12 597 181 202  22],796,5,22222,4.532327146644911,0.0,0.0
24903,2,4903,[318 427 496 357 257],330,5,22227,4.53242251223491,60.0,0.0
24904,2,4904,[385 151 168 237 318],716,4,22231,4.532313965341488,20.0,0.0
24905,2,4905,[385 200 168 286 173],450,4,22235,4.5322054626987365,0.0,20.0
24906,2,4906,[318 427 496 357 257],330,5,22240,4.532300794782963,60.0,0.0
24907,2,4907,[318 427 496 357 257],796,5,22245,4.53239608801956,60.0,0.0
24908,2,4908,[ 56 176 603 423 173],23,3,22248,4.532083927480138,20.0,0.0
24909,2,4909,[318 427 496 357 257],796,5,22253,4.532179226069246,60.0,0.0
24910,2,4910,[318 427 496 357 257],330,5,22258,4.532274485848096,60.0,0.0
24911,2,4911,[318 427 496 357 257],796,5,22263,4.532369706840391,60.0,0.0
24912,2,4912,[318 427 496 357 257],716,5,22268,4.532464889069815,60.0,0.0
24913,2,4913,[318 427 496 357 257],796,5,22273,4.532560032560032,60.0,0.0
24914,2,4914,[228 588 200 265 258],457,5,22278,4.5326551373346895,0.0,0.0
24915,2,4915,[318 427 496 357 257],796,5,22283,4.532750203417413,60.0,0.0
24916,2,4916,[318 427 496 357 257],796,5,22288,4.532845230831808,60.0,0.0
24917,2,4917,[318 427 496 357 257],716,5,22293,4.532940219601464,60.0,0.0
24918,2,4918,[318 427 496 357 257],716,5,22298,4.533035169749949,60.0,0.0
24919,2,4919,[318 427 496 357 257],716,5,22303,4.533130081300813,60.0,0.0
24920,2,4920,[318 427 496 357 257],330,5,22308,4.5332249542775855,60.0,0.0
24921,2,4921,[210  28  22 222 186],450,2,22310,4.5327102803738315,0.0,0.0
24922,2,4922,[ 97 568  64 181 403],256,5,22315,4.532805200081251,20.0,0.0
24923,2,4923,[318 427 496 357 257],330,5,22320,4.532900081234769,60.0,0.0
24924,2,4924,[318 427 496 357 257],796,5,22325,4.532994923857868,60.0,0.0
24925,2,4925,[318 427 496 357 257],796,5,22330,4.533089727974016,60.0,0.0
24926,2,4926,[405 121 197 187  28],796,3,22333,4.532778567079359,0.0,0.0
24927,2,4927,[144 181 403 173 742],450,5,22338,4.532873376623376,0.0,0.0
24928,2,4928,[318 427 496 357 257],330,5,22343,4.532968147697302,60.0,0.0
24929,2,4929,[135 269 181 144 151],535,3,22346,4.532657200811359,0.0,0.0
24930,2,4930,[318 427 496 357 257],716,5,22351,4.532751977286554,60.0,0.0
24931,2,4931,[318 427 496 357 257],716,5,22356,4.532846715328467,60.0,0.0
24932,2,4932,[318 427 496 357 257],796,5,22361,4.5329414149604705,60.0,0.0
24933,2,4933,[318 427 496 357 257],716,5,22366,4.533036076205918,60.0,0.0
24934,2,4934,[318 427 496 357 257],330,5,22371,4.5331306990881455,60.0,0.0
24935,2,4935,[318 427 496 357 257],716,5,22376,4.53322528363047,60.0,0.0
24936,2,4936,[496   4   7 187  88],786,5,22381,4.533319829856188,20.0,0.0
24937,2,4937,[318 427 496 357 257],716,5,22386,4.533414337788578,60.0,0.0
24938,2,4938,[172 191 117   9 273],236,2,22388,4.532901397043936,0.0,0.0
24939,2,4939,[318 427 496 357 257],796,5,22393,4.532995951417004,60.0,0.0
24940,2,4940,[194 172 403 427 588],18,2,22395,4.532483302975106,20.0,0.0
24941,2,4941,[318 427 496 357 257],796,5,22400,4.53257790368272,60.0,0.0
24942,2,4942,[318 427 496 357 257],330,5,22405,4.532672466113696,60.0,0.0
24943,2,4943,[318 427 496 357 257],796,5,22410,4.532766990291262,60.0,0.0
24944,2,4944,[ 98 144  88 127 216],450,5,22415,4.532861476238625,0.0,20.0
24945,2,4945,[200 300 357 234  89],796,4,22419,4.53275374039628,0.0,0.0
24946,2,4946,[174  79 748  22  71],280,3,22422,4.53244390539721,0.0,0.0
24947,2,4947,[318 427 496 357 257],796,5,22427,4.532538399353274,60.0,0.0
24948,2,4948,[318 427 496 357 257],796,5,22432,4.532632855122247,60.0,0.0
24949,2,4949,[318 427 496 357 257],796,5,22437,4.532727272727273,60.0,0.0
24950,2,4950,[318 427 496 357 257],716,5,22442,4.532821652191476,60.0,0.0
24951,2,4951,[318 427 496 357 257],330,5,22447,4.532915993537965,60.0,0.0
24952,2,4952,[318 427 496 357 257],796,5,22452,4.533010296789825,60.0,0.0
24953,2,4953,[423 286 100   8 222],280,3,22455,4.532700847799758,0.0,40.0
24954,2,4954,[318 427 496 357 257],716,5,22460,4.532795156407669,60.0,0.0
24955,2,4955,[ 79 273 200 275 174],796,4,22464,4.532687651331719,0.0,20.0
24956,2,4956,[ 56 215 318 186  50],18,4,22468,4.532580189630825,20.0,20.0
24957,2,4957,[ 71   7 496 228 183],577,3,22471,4.532271077047197,20.0,0.0
24958,2,4958,[258 328 191   4 202],655,1,22472,4.531558782012502,0.0,0.0
24959,2,4959,[185 742 257   1 182],655,2,22474,4.531048387096774,0.0,0.0
24960,2,4960,[318 427 496 357 257],330,5,22479,4.531142914734932,60.0,0.0
24961,2,4961,[ 69 288 222 294 100],457,4,22483,4.531035872632003,0.0,20.0
24962,2,4962,[318 427 496 357 257],716,5,22488,4.531130364698771,60.0,0.0
24963,2,4963,[318 427 496 357 257],330,5,22493,4.531224818694601,60.0,0.0
24964,2,4964,[318 427 496 357 257],796,5,22498,4.531319234642497,60.0,0.0
24965,2,4965,[ 89 302   1 186 245],450,4,22502,4.531212243254128,0.0,0.0
24966,2,4966,[302 228  88 588  64],450,5,22507,4.531306623716529,20.0,0.0
24967,2,4967,[318 427 496 357 257],796,5,22512,4.531400966183575,60.0,0.0
24968,2,4968,[318 427 496 357 257],716,5,22517,4.531495270678205,60.0,0.0
24969,2,4969,[318 427 496 357 257],716,5,22522,4.53158953722334,60.0,0.0
24970,2,4970,[144 300  82 135 301],655,1,22523,4.530879098772883,0.0,0.0
24971,2,4971,[271 161 135  82   8],655,1,22524,4.53016894609815,0.0,0.0
24972,2,4972,[234 175 151  11 179],457,5,22529,4.5302634224814,0.0,0.0
24973,2,4973,[318 427 496 357 257],716,5,22534,4.530357860876558,60.0,0.0
24974,2,4974,[318 427 496 357 257],796,5,22539,4.530452261306532,60.0,0.0
24975,2,4975,[  9  56 180 234 168],269,3,22542,4.530144694533762,0.0,0.0
24976,2,4976,[ 82  15 117 161 132],796,4,22546,4.530038175607796,0.0,0.0
24977,2,4977,[318 427 496 357 257],716,5,22551,4.530132583366814,60.0,0.0
24978,2,4978,[318 427 496 357 257],716,5,22556,4.530226953203455,60.0,0.0
24979,2,4979,[405 200 183 471 202],716,3,22559,4.529919678714859,0.0,0.0
24980,2,4980,[318 427 496 357 257],330,5,22564,4.530014053402931,60.0,0.0
24981,2,4981,[318 427 496 357 257],716,5,22569,4.530108390204737,60.0,0.0
24982,2,4982,[318 427 496 357 257],716,5,22574,4.530202689143087,60.0,0.0
24983,2,4983,[273 181 288 471 127],344,3,22577,4.529895666131621,0.0,20.0
24984,2,4984,[318 427 496 357 257],716,5,22582,4.529989969909729,60.0,0.0
24985,2,4985,[318 427 496 357 257],716,5,22587,4.530084235860409,60.0,0.0
24986,2,4986,[318 427 496 357 257],796,5,22592,4.530178464006417,60.0,0.0
24987,2,4987,[318 427 496 357 257],796,5,22597,4.530272654370489,60.0,0.0
24988,2,4988,[318 427 496 357 257],796,5,22602,4.530366806975346,60.0,0.0
24989,2,4989,[318 427 496 357 257],796,5,22607,4.530460921843687,60.0,0.0
24990,2,4990,[318 427 496 357 257],330,5,22612,4.530554998998197,60.0,0.0
24991,2,4991,[ 98 182 603 204 181],269,3,22615,4.530248397435898,20.0,0.0
24992,2,4992,[328 289 216   7  25],655,1,22616,4.529541357901062,0.0,0.0
24993,2,4993,[318 427 496 357 257],330,5,22621,4.52963556267521,60.0,0.0
24994,2,4994,[435  89  28  56 269],450,5,22626,4.52972972972973,0.0,0.0
24995,2,4995,[318 427 496 357 257],330,5,22631,4.52982385908727,60.0,0.0
24996,2,4996,[ 98   4 210 603  79],796,4,22635,4.529717830698419,20.0,0.0
24997,2,4997,[  1 100 202  97  98],577,5,22640,4.529811924769908,0.0,20.0
24998,2,4998,[318 427 496 357 257],796,5,22645,4.529905981196239,60.0,0.0
24999,2,4999,[318 427 496 357 257],716,5,22650,4.53,60.0,0.0
25000,2,5000,[215 237 180 174 210],457,5,22655,4.530093981203759,0.0,0.0
25001,2,5001,[318 427 496 357 257],330,5,22660,4.530187924830068,60.0,0.0
25002,2,5002,[318 427 496 357 257],716,5,22665,4.530281830901459,60.0,0.0
25003,2,5003,[318 427 496 357 257],716,5,22670,4.530375699440448,60.0,0.0
25004,2,5004,[318 427 496 357 257],796,5,22675,4.530469530469531,60.0,0.0
25005,2,5005,[318 427 496 357 257],330,5,22680,4.530563324011187,60.0,0.0
25006,2,5006,[318 427 496 357 257],330,5,22685,4.530657080087877,60.0,0.0
25007,2,5007,[318 427 496 357 257],330,5,22690,4.530750798722044,60.0,0.0
25008,2,5008,[318 427 496 357 257],330,5,22695,4.530844479936115,60.0,0.0
25009,2,5009,[216 210 118  98 603],716,4,22699,4.530738522954092,20.0,0.0
25010,2,5010,[ 89  96 237 179 151],296,4,22703,4.530632608261824,0.0,0.0
25011,2,5011,[135 151 235  11  28],330,4,22707,4.530526735833998,0.0,0.0
25012,2,5012,[238  98   7 269 183],421,3,22710,4.530221424296828,0.0,0.0
25013,2,5013,[ 28 186 172 405 179],457,5,22715,4.530315117670523,0.0,0.0
25014,2,5014,[318 427 496 357 257],330,5,22720,4.530408773678963,60.0,0.0
25015,2,5015,[182   1 245  12 322],450,5,22725,4.530502392344498,0.0,0.0
25016,2,5016,[265 174 238 435 483],450,4,22729,4.53039665138529,0.0,0.0
25017,2,5017,[318 427 496 357 257],716,5,22734,4.530490235153447,60.0,0.0
25018,2,5018,[318 427 496 357 257],796,5,22739,4.530583781629807,60.0,0.0
25019,2,5019,[200 161 546 183 483],796,5,22744,4.530677290836653,0.0,0.0
25020,2,5020,[186 273 385 173 271],796,3,22747,4.530372435769767,0.0,0.0
25021,2,5021,[318 427 496 357 257],796,5,22752,4.530465949820789,60.0,0.0
25022,2,5022,[117 483 357   8 435],655,2,22754,4.529962173999602,0.0,0.0
25023,2,5023,[318 427 496 357 257],796,5,22759,4.530055732484076,60.0,0.0
25024,2,5024,[318 427 496 357 257],796,5,22764,4.530149253731343,60.0,0.0
25025,2,5025,[318 427 496 357 257],716,5,22769,4.530242737763629,60.0,0.0
25026,2,5026,[318 427 496 357 257],716,5,22774,4.530336184603143,60.0,0.0
25027,2,5027,[318 427 496 357 257],330,5,22779,4.530429594272077,60.0,0.0
25028,2,5028,[318 427 496 357 257],330,5,22784,4.530522966792603,60.0,0.0
25029,2,5029,[318 427 496 357 257],796,5,22789,4.530616302186878,60.0,0.0
25030,2,5030,[  9 195  25  69 273],693,2,22791,4.530113297555158,0.0,0.0
25031,2,5031,[318 427 496 357 257],330,5,22796,4.530206677265501,60.0,0.0
25032,2,5032,[318 427 496 357 257],330,5,22801,4.530300019868865,60.0,0.0
25033,2,5033,[318 427 496 357 257],330,5,22806,4.530393325387366,60.0,0.0
25034,2,5034,[318 427 496 357 257],330,5,22811,4.530486593843098,60.0,0.0
25035,2,5035,[202 117 313 168  28],450,5,22816,4.530579825258141,0.0,0.0
25036,2,5036,[318 427 496 357 257],796,5,22821,4.530673019654556,60.0,0.0
25037,2,5037,[  1 313   7 603 172],450,5,22826,4.530766177054387,20.0,0.0
25038,2,5038,[318 427 496 357 257],796,5,22831,4.530859297479659,60.0,0.0
25039,2,5039,[318 427 496 357 257],330,5,22836,4.530952380952381,60.0,0.0
25040,2,5040,[318 427 496 357 257],796,5,22841,4.531045427494544,60.0,0.0
25041,2,5041,[318 427 496 357 257],796,5,22846,4.531138437128123,60.0,0.0
25042,2,5042,[318 427 496 357 257],330,5,22851,4.531231409875074,60.0,0.0
25043,2,5043,[318 427 496 357 257],330,5,22856,4.531324345757335,60.0,0.0
25044,2,5044,[318 427 496 357 257],796,5,22861,4.531417244796828,60.0,0.0
25045,2,5045,[318 427 496 357 257],796,5,22866,4.531510107015458,60.0,0.0
25046,2,5046,[318 427 496 357 257],330,5,22871,4.53160293243511,60.0,0.0
25047,2,5047,[144 313 257 234 423],796,4,22875,4.531497622820919,0.0,0.0
25048,2,5048,[318 427 496 357 257],716,5,22880,4.531590413943355,60.0,0.0
25049,2,5049,[200 357  98 127 173],786,5,22885,4.531683168316832,0.0,20.0
25050,2,5050,[318 427 496 357 257],330,5,22890,4.531775885963175,60.0,0.0
25051,2,5051,[318 275 228  88 185],330,5,22895,4.531868566904197,20.0,20.0
25052,2,5052,[318 427 496 357 257],716,5,22900,4.531961211161686,60.0,0.0
25053,2,5053,[318 427 496 357 257],330,5,22905,4.5320538187574195,60.0,0.0
25054,2,5054,[318 427 496 357 257],716,5,22910,4.532146389713155,60.0,0.0
25055,2,5055,[318 427 496 357 257],796,5,22915,4.532238924050633,60.0,0.0
25056,2,5056,[197  88  15 118   8],457,5,22920,4.532331421791576,0.0,0.0
25057,2,5057,[235 175 222 257 181],23,3,22923,4.532028469750889,0.0,0.0
25058,2,5058,[318 427 496 357 257],716,5,22928,4.532120972524214,60.0,0.0
25059,2,5059,[318 427 496 357 257],330,5,22933,4.532213438735178,60.0,0.0
25060,2,5060,[318 427 496 357 257],330,5,22938,4.532305868405453,60.0,0.0
25061,2,5061,[318 427 496 357 257],716,5,22943,4.532398261556697,60.0,0.0
25062,2,5062,[318 427 496 357 257],330,5,22948,4.532490618210547,60.0,0.0
25063,2,5063,[202 237   1 200  97],796,3,22951,4.532187993680885,0.0,0.0
25064,2,5064,[318 427 496 357 257],716,5,22956,4.532280355380059,60.0,0.0
25065,2,5065,[318 427 496 357 257],796,5,22961,4.532372680615871,60.0,0.0
25066,2,5066,[318 427 496 357 257],796,5,22966,4.532464969409907,60.0,0.0
25067,2,5067,[318 427 496 357 257],330,5,22971,4.532557221783741,60.0,0.0
25068,2,5068,[318 427 496 357 257],716,5,22976,4.532649437758927,60.0,0.0
25069,2,5069,[179  56 127 568  95],389,3,22979,4.532347140039448,0.0,20.0
25070,2,5070,[ 98 216  25 333 405],655,2,22981,4.531847761782686,0.0,0.0
25071,2,5071,[318 427 496 357 257],330,5,22986,4.531940063091483,60.0,0.0
25072,2,5072,[186   1  71  12 173],577,5,22991,4.532032328011039,0.0,0.0
25073,2,5073,[318 427 496 357 257],796,5,22996,4.532124556562869,60.0,0.0
25074,2,5074,[318 427 496 357 257],716,5,23001,4.532216748768473,60.0,0.0
25075,2,5075,[172 191  50  82 143],786,5,23006,4.53230890464933,0.0,20.0
25076,2,5076,[318 427 496 357 257],330,5,23011,4.532401024226906,60.0,0.0
25077,2,5077,[318 427 496 357 257],716,5,23016,4.5324931075226464,60.0,0.0
25078,2,5078,[318 427 496 357 257],330,5,23021,4.532585154557984,60.0,0.0
25079,2,5079,[318 427 496 357 257],796,5,23026,4.532677165354331,60.0,0.0
25080,2,5080,[318 427 496 357 257],796,5,23031,4.532769139933084,60.0,0.0
25081,2,5081,[318 427 496 357 257],716,5,23036,4.532861078315624,60.0,0.0
25082,2,5082,[ 82 132 197  98 202],796,3,23039,4.532559512099154,0.0,0.0
25083,2,5083,[318 427 496 357 257],716,5,23044,4.532651455546813,60.0,0.0
25084,2,5084,[318 427 496 357 257],716,5,23049,4.532743362831859,60.0,0.0
25085,2,5085,[318 427 496 357 257],716,5,23054,4.53283523397562,60.0,0.0
25086,2,5086,[  4 294   7  11 546],577,2,23056,4.532337330450167,0.0,0.0
25087,2,5087,[318 427 496 357 257],330,5,23061,4.532429245283019,60.0,0.0
25088,2,5088,[318 427 496 357 257],796,5,23066,4.532521123992926,60.0,0.0
25089,2,5089,[318 427 496 357 257],796,5,23071,4.532612966601179,60.0,0.0
25090,2,5090,[318 427 496 357 257],796,5,23076,4.532704773129051,60.0,0.0
25091,2,5091,[238 269 174  88 282],796,3,23079,4.532403770620581,0.0,0.0
25092,2,5092,[318 427 496 357 257],330,5,23084,4.532495582171608,60.0,0.0
25093,2,5093,[282 183 742 245 496],796,3,23087,4.53219473890852,20.0,0.0
25094,2,5094,[  8 318 597 265 197],796,4,23091,4.532090284592738,20.0,0.0
25095,2,5095,[318 427 496 357 257],330,5,23096,4.532182103610675,60.0,0.0
25096,2,5096,[181 127 483 655 216],280,3,23099,4.531881498920934,0.0,20.0
25097,2,5097,[172 200  56   9 235],280,4,23103,4.531777167516673,0.0,0.0
25098,2,5098,[318 427 496 357 257],796,5,23108,4.5318689939203765,60.0,0.0
25099,2,5099,[318 427 496 357 257],796,5,23113,4.531960784313726,60.0,0.0
25100,2,5100,[318 427 496 357 257],330,5,23118,4.532052538717898,60.0,0.0
25101,2,5101,[318 427 496 357 257],796,5,23123,4.532144257154057,60.0,0.0
25102,2,5102,[ 82 202  96 471 187],716,2,23125,4.531648050166568,0.0,0.0
25103,2,5103,[318 427 496 357 257],330,5,23130,4.531739811912225,60.0,0.0
25104,2,5104,[318 427 496 357 257],796,5,23135,4.531831537708129,60.0,0.0
25105,2,5105,[ 88 174  50 496  64],330,5,23140,4.531923227575401,40.0,20.0
25106,2,5106,[318 427 496 357 257],716,5,23145,4.532014881535148,60.0,0.0
25107,2,5107,[318 427 496 357 257],330,5,23150,4.5321064996084575,60.0,0.0
25108,2,5108,[318 427 496 357 257],796,5,23155,4.532198081816403,60.0,0.0
25109,2,5109,[318 427 496 357 257],716,5,23160,4.532289628180039,60.0,0.0
25110,2,5110,[318 427 496 357 257],716,5,23165,4.532381138720407,60.0,0.0
25111,2,5111,[318 427 496 357 257],716,5,23170,4.532472613458529,60.0,0.0
25112,2,5112,[318 427 496 357 257],716,5,23175,4.532564052415411,60.0,0.0
25113,2,5113,[318 427 496 357 257],716,5,23180,4.532655455612045,60.0,0.0
25114,2,5114,[318 427 496 357 257],796,5,23185,4.532746823069404,60.0,0.0
25115,2,5115,[318 427 496 357 257],716,5,23190,4.532838154808444,60.0,0.0
25116,2,5116,[161 483  25 271 515],655,2,23192,4.53234316982607,0.0,0.0
25117,2,5117,[588  25 483  28 187],450,3,23195,4.532043767096522,0.0,0.0
25118,2,5118,[318 427 496 357 257],716,5,23200,4.532135182652862,60.0,0.0
25119,2,5119,[197 313 161  22 174],655,1,23201,4.5314453125,0.0,0.0
25120,2,5120,[318 427 496 357 257],716,5,23206,4.5315368092169495,60.0,0.0
25121,2,5121,[318 427 496 357 257],330,5,23211,4.531628270206951,60.0,0.0
25122,2,5122,[318 427 496 357 257],330,5,23216,4.531719695490923,60.0,0.0
25123,2,5123,[318 427 496 357 257],330,5,23221,4.531811085089774,60.0,0.0
25124,2,5124,[318 427 496 357 257],796,5,23226,4.53190243902439,60.0,0.0
25125,2,5125,[318 427 496 357 257],330,5,23231,4.531993757315646,60.0,0.0
25126,2,5126,[318 427 496 357 257],716,5,23236,4.532085039984397,60.0,0.0
25127,2,5127,[318 427 496 357 257],330,5,23241,4.532176287051482,60.0,0.0
25128,2,5128,[318 427 496 357 257],716,5,23246,4.532267498537727,60.0,0.0
25129,2,5129,[318 427 496 357 257],796,5,23251,4.5323586744639375,60.0,0.0
25130,2,5130,[546 172 210 405 238],716,4,23255,4.532254921068018,0.0,0.0
25131,2,5131,[318 427 496 357 257],796,5,23260,4.532346063912705,60.0,0.0
25132,2,5132,[318 427 496 357 257],796,5,23265,4.532437171244886,60.0,0.0
25133,2,5133,[318 427 496 357 257],716,5,23270,4.532528243085314,60.0,0.0
25134,2,5134,[318 427 496 357 257],716,5,23275,4.532619279454723,60.0,0.0
25135,2,5135,[235 196 568 111 125],344,3,23278,4.532320872274143,0.0,0.0
25136,2,5136,[318 427 496 357 257],716,5,23283,4.532411913568231,60.0,0.0
25137,2,5137,[423  25  50 471 222],457,5,23288,4.532502919423901,0.0,20.0
25138,2,5138,[151 405 568 265  88],450,5,23293,4.5325938898618405,0.0,0.0
25139,2,5139,[318 427 496 357 257],796,5,23298,4.532684824902724,60.0,0.0
25140,2,5140,[200 161 204 234 118],457,5,23303,4.5327757245672045,0.0,0.0
25141,2,5141,[237 191 234 182 195],655,2,23305,4.532283158304161,0.0,0.0
25142,2,5142,[318 427 496 357 257],330,5,23310,4.532374100719425,60.0,0.0
25143,2,5143,[176 121 143 483  64],457,5,23315,4.532465007776049,20.0,0.0
25144,2,5144,[318 427 496 357 257],330,5,23320,4.532555879494655,60.0,0.0
25145,2,5145,[318 427 496 357 257],330,5,23325,4.532646715895841,60.0,0.0
25146,2,5146,[318 427 496 357 257],330,5,23330,4.532737517000195,60.0,0.0
25147,2,5147,[655 117 222 127  79],457,5,23335,4.532828282828283,0.0,20.0
25148,2,5148,[318 427 496 357 257],716,5,23340,4.532919013400661,60.0,0.0
25149,2,5149,[318 427 496 357 257],330,5,23345,4.533009708737864,60.0,0.0
25150,2,5150,[318 427 496 357 257],796,5,23350,4.533100368860415,60.0,0.0
25151,2,5151,[210 237  28 204 172],885,4,23354,4.532996894409938,0.0,0.0
25152,2,5152,[318 427 496 357 257],716,5,23359,4.533087521831942,60.0,0.0
25153,2,5153,[ 97 135 117  79 197],457,5,23364,4.533178114086147,0.0,0.0
25154,2,5154,[318 427 496 357 257],796,5,23369,4.533268671193016,60.0,0.0
25155,2,5155,[318 427 496 357 257],330,5,23374,4.533359193173002,60.0,0.0
25156,2,5156,[318 427 496 357 257],796,5,23379,4.533449680046538,60.0,0.0
25157,2,5157,[318 427 496 357 257],716,5,23384,4.5335401318340445,60.0,0.0
25158,2,5158,[318 427 496 357 257],796,5,23389,4.533630548555922,60.0,0.0
25159,2,5159,[318 427 496 357 257],716,5,23394,4.533720930232558,60.0,0.0
25160,2,5160,[318 427 496 357 257],796,5,23399,4.533811276884324,60.0,0.0
25161,2,5161,[318 427 496 357 257],330,5,23404,4.5339015885315765,60.0,0.0
25162,2,5162,[318 427 496 357 257],330,5,23409,4.533991865194654,60.0,0.0
25163,2,5163,[318 427 496 357 257],716,5,23414,4.534082106893881,60.0,0.0
25164,2,5164,[318 427 496 357 257],330,5,23419,4.534172313649564,60.0,0.0
25165,2,5165,[318 427 496 357 257],330,5,23424,4.534262485481998,60.0,0.0
25166,2,5166,[318 427 496 357 257],330,5,23429,4.534352622411458,60.0,0.0
25167,2,5167,[318 427 496 357 257],716,5,23434,4.534442724458204,60.0,0.0
25168,2,5168,[318 427 496 357 257],796,5,23439,4.5345327916424845,60.0,0.0
25169,2,5169,[200 180 195 181 222],450,3,23442,4.5342359767891685,0.0,0.0
25170,2,5170,[318 427 496 357 257],796,5,23447,4.534326049120093,60.0,0.0
25171,2,5171,[318 427 496 357 257],716,5,23452,4.534416086620263,60.0,0.0
25172,2,5172,[318 427 496 357 257],330,5,23457,4.534506089309878,60.0,0.0
25173,2,5173,[318 427 496 357 257],796,5,23462,4.534596057209122,60.0,0.0
25174,2,5174,[318 427 496 357 257],796,5,23467,4.534685990338164,60.0,0.0
25175,2,5175,[318 427 496 357 257],796,5,23472,4.5347758887171565,60.0,0.0
25176,2,5176,[ 96 172 121   7 435],72,2,23474,4.534286266177323,0.0,0.0
25177,2,5177,[318 427 496 357 257],796,5,23479,4.534376207029741,60.0,0.0
25178,2,5178,[318 427 496 357 257],330,5,23484,4.534466113149256,60.0,0.0
25179,2,5179,[318 427 496 357 257],796,5,23489,4.534555984555984,60.0,0.0
25180,2,5180,[318 427 496 357 257],330,5,23494,4.534645821270025,60.0,0.0
25181,2,5181,[318 427 496 357 257],330,5,23499,4.534735623311462,60.0,0.0
25182,2,5182,[234 181 151 427 143],577,3,23502,4.5344395137951,20.0,0.0
25183,2,5183,[603 678 515 151 508],401,2,23504,4.533950617283951,20.0,0.0
25184,2,5184,[318 427 496 357 257],716,5,23509,4.53404050144648,60.0,0.0
25185,2,5185,[318 427 496 357 257],330,5,23514,4.534130350944851,60.0,0.0
25186,2,5186,[318 427 496 357 257],716,5,23519,4.5342201657991135,60.0,0.0
25187,2,5187,[318 427 496 357 257],330,5,23524,4.534309946029299,60.0,0.0
25188,2,5188,[318 427 496 357 257],330,5,23529,4.534399691655425,60.0,0.0
25189,2,5189,[318 427 496 357 257],796,5,23534,4.534489402697496,60.0,0.0
25190,2,5190,[ 88 185  11 151  25],457,5,23539,4.534579079175496,0.0,0.0
25191,2,5191,[318 210 197 568  88],280,1,23540,4.533898305084746,20.0,0.0
25192,2,5192,[318 427 496 357 257],796,5,23545,4.533988060851145,60.0,0.0
25193,2,5193,[318 427 496 357 257],716,5,23550,4.534077782056219,60.0,0.0
25194,2,5194,[318 328 294 121 234],450,3,23553,4.533782483156882,20.0,0.0
25195,2,5195,[196 222 197 191 258],796,4,23557,4.533679753656659,0.0,0.0
25196,2,5196,[172   1  69 403 168],796,4,23561,4.533577063690591,0.0,0.0
25197,2,5197,[318 427 496 357 257],716,5,23566,4.533666794921124,60.0,0.0
25198,2,5198,[318 427 496 357 257],716,5,23571,4.533756491633007,60.0,0.0
25199,2,5199,[318 427 496 357 257],330,5,23576,4.533846153846154,60.0,0.0
25200,2,5200,[435 257 265 210 597],807,4,23580,4.533743510863295,0.0,0.0
25201,2,5201,[318 427 496 357 257],330,5,23585,4.533833141099577,60.0,0.0
25202,2,5202,[318 427 496 357 257],716,5,23590,4.533922736882568,60.0,0.0
25203,2,5203,[318 427 496 357 257],796,5,23595,4.534012298232129,60.0,0.0
25204,2,5204,[286  69 181 197 168],450,5,23600,4.534101825168108,0.0,20.0
25205,2,5205,[237 405  98 222 143],457,5,23605,4.534191317710334,0.0,0.0
25206,2,5206,[237   7 196 333 222],655,0,23605,4.533320530055694,0.0,0.0
25207,2,5207,[318 427 496 357 257],330,5,23610,4.533410138248848,60.0,0.0
25208,2,5208,[180  28  69 135   4],716,2,23612,4.532923785755424,0.0,0.0
25209,2,5209,[318 427 496 357 257],330,5,23617,4.533013435700576,60.0,0.0
25210,2,5210,[318 427 496 357 257],796,5,23622,4.533103051237767,60.0,0.0
25211,2,5211,[318 427 496 357 257],716,5,23627,4.5331926323867995,60.0,0.0
25212,2,5212,[187 515 216 268 179],269,4,23631,4.533090351045463,0.0,0.0
25213,2,5213,[318 427 496 357 257],716,5,23636,4.533179900268508,60.0,0.0
25214,2,5214,[318 427 496 357 257],330,5,23641,4.5332694151486095,60.0,0.0
25215,2,5215,[318 427 496 357 257],330,5,23646,4.533358895705521,60.0,0.0
25216,2,5216,[318 427 496 357 257],796,5,23651,4.53344834195898,60.0,0.0
25217,2,5217,[318 427 496 357 257],796,5,23656,4.533537753928709,60.0,0.0
25218,2,5218,[318 427 496 357 257],330,5,23661,4.533627131634413,60.0,0.0
25219,2,5219,[318 427 496 357 257],716,5,23666,4.533716475095785,60.0,0.0
25220,2,5220,[357 173  22  11  15],629,4,23670,4.533614250143651,0.0,0.0
25221,2,5221,[318 427 496 357 257],716,5,23675,4.533703561853696,60.0,0.0
25222,2,5222,[318 202 357 172 385],330,5,23680,4.53379283936435,20.0,0.0
25223,2,5223,[318 427 496 357 257],330,5,23685,4.533882082695253,60.0,0.0
25224,2,5224,[318 427 496 357 257],330,5,23690,4.533971291866028,60.0,0.0
25225,2,5225,[318 427 496 357 257],716,5,23695,4.534060466896288,60.0,0.0
25226,2,5226,[318 427 496 357 257],716,5,23700,4.534149607805625,60.0,0.0
25227,2,5227,[318 427 496 357 257],796,5,23705,4.534238714613619,60.0,0.0
25228,2,5228,[176 196 194   9 186],457,5,23710,4.534327787339835,0.0,0.0
25229,2,5229,[151 655  56 204 111],174,4,23714,4.534225621414914,0.0,0.0
25230,2,5230,[655 333 385  56 143],655,1,23715,4.533549990441598,0.0,0.0
25231,2,5231,[318 427 496 357 257],796,5,23720,4.533639143730887,60.0,0.0
25232,2,5232,[318 427 496 357 257],716,5,23725,4.533728262946685,60.0,0.0
25233,2,5233,[318 427 496 357 257],716,5,23730,4.5338173481085215,60.0,0.0
25234,2,5234,[318 427 496 357 257],796,5,23735,4.533906399235912,60.0,0.0
25235,2,5235,[127  22   1 222 328],655,1,23736,4.533231474407945,0.0,20.0
25236,2,5236,[204 678 100 471 191],344,3,23739,4.532938705365668,0.0,20.0
25237,2,5237,[318 427 496 357 257],796,5,23744,4.533027873234059,60.0,0.0
25238,2,5238,[318 427 496 357 257],716,5,23749,4.533117007062416,60.0,0.0
25239,2,5239,[318 427 496 357 257],330,5,23754,4.533206106870229,60.0,0.0
25240,2,5240,[318 427 496 357 257],716,5,23759,4.53329517267697,60.0,0.0
25241,2,5241,[318 427 496 357 257],796,5,23764,4.533384204502099,60.0,0.0
25242,2,5242,[318 427 496 357 257],330,5,23769,4.533473202365058,60.0,0.0
25243,2,5243,[228 318 216  82 186],655,2,23771,4.532990083905416,20.0,0.0
25244,2,5244,[194 603  96 153  71],23,4,23775,4.532888465204957,20.0,0.0
25245,2,5245,[318 427 496 357 257],796,5,23780,4.53297750667175,60.0,0.0
25246,2,5246,[245 194 546 127 168],450,5,23785,4.533066514198589,0.0,20.0
25247,2,5247,[ 64 568 258 742 181],344,2,23787,4.532583841463414,20.0,0.0
25248,2,5248,[318 427 496 357 257],716,5,23792,4.5326728900743,60.0,0.0
25249,2,5249,[318 427 496 357 257],330,5,23797,4.532761904761904,60.0,0.0
25250,2,5250,[318 427 496 357 257],330,5,23802,4.53285088554561,60.0,0.0
25251,2,5251,[318 427 496 357 257],796,5,23807,4.532939832444783,60.0,0.0
25252,2,5252,[318 427 496 357 257],330,5,23812,4.533028745478774,60.0,0.0
25253,2,5253,[318 427 496 357 257],716,5,23817,4.533117624666921,60.0,0.0
25254,2,5254,[318 427 496 357 257],796,5,23822,4.533206470028544,60.0,0.0
25255,2,5255,[318 427 496 357 257],796,5,23827,4.533295281582953,60.0,0.0
25256,2,5256,[318 427 496 357 257],796,5,23832,4.533384059349439,60.0,0.0
25257,2,5257,[318 427 496 357 257],716,5,23837,4.53347280334728,60.0,0.0
25258,2,5258,[318 427 496 357 257],330,5,23842,4.533561513595741,60.0,0.0
25259,2,5259,[318 427 496 357 257],330,5,23847,4.533650190114068,60.0,0.0
25260,2,5260,[210 588 168 172 118],807,5,23852,4.533738832921498,0.0,0.0
25261,2,5261,[318 427 496 357 257],330,5,23857,4.533827442037248,60.0,0.0
25262,2,5262,[ 97 273 435 515 125],655,2,23859,4.5333460003800115,0.0,0.0
25263,2,5263,[288   7  82 238  98],457,5,23864,4.533434650455927,0.0,0.0
25264,2,5264,[318 427 496 357 257],330,5,23869,4.533523266856601,60.0,0.0
25265,2,5265,[318 427 496 357 257],796,5,23874,4.533611849601216,60.0,0.0
25266,2,5266,[318 427 496 357 257],796,5,23879,4.533700398708943,60.0,0.0
25267,2,5267,[318 427 496 357 257],796,5,23884,4.533788914198937,60.0,0.0
25268,2,5268,[211   4 294 228 276],655,1,23885,4.533118238754982,0.0,0.0
25269,2,5269,[318 427 496 357 257],796,5,23890,4.533206831119545,60.0,0.0
25270,2,5270,[318 427 496 357 257],716,5,23895,4.533295389869095,60.0,0.0
25271,2,5271,[187 204 186 257  88],716,3,23898,4.533004552352049,0.0,0.0
25272,2,5272,[318 427 496 357 257],796,5,23903,4.533093115873317,60.0,0.0
25273,2,5273,[318 427 496 357 257],330,5,23908,4.533181645809632,60.0,0.0
25274,2,5274,[318 427 496 357 257],716,5,23913,4.533270142180095,60.0,0.0
25275,2,5275,[318 427 496 357 257],796,5,23918,4.533358605003791,60.0,0.0
25276,2,5276,[318 427 496 357 257],796,5,23923,4.533447034299791,60.0,0.0
25277,2,5277,[318 427 496 357 257],330,5,23928,4.533535430087154,60.0,0.0
25278,2,5278,[655 234  71 168  50],504,3,23931,4.533244932752416,0.0,20.0
25279,2,5279,[318 427 496 357 257],716,5,23936,4.533333333333333,60.0,0.0
25280,2,5280,[318 427 496 357 257],330,5,23941,4.5334217004355235,60.0,0.0
25281,2,5281,[318 427 496 357 257],796,5,23946,4.533510034078001,60.0,0.0
25282,2,5282,[318 427 496 357 257],796,5,23951,4.533598334279765,60.0,0.0
25283,2,5283,[322 211 245  89   4],450,4,23955,4.533497350492051,0.0,0.0
25284,2,5284,[742 100 427 200 405],577,3,23958,4.533207190160833,20.0,20.0
25285,2,5285,[318 427 496 357 257],796,5,23963,4.533295497540673,60.0,0.0
25286,2,5286,[318 427 496 357 257],330,5,23968,4.5333837715150365,60.0,0.0
25287,2,5287,[318 427 496 357 257],796,5,23973,4.533472012102875,60.0,0.0
25288,2,5288,[318 427 496 357 257],716,5,23978,4.533560219323124,60.0,0.0
25289,2,5289,[318 427 496 357 257],330,5,23983,4.533648393194707,60.0,0.0
25290,2,5290,[318 427 496 357 257],716,5,23988,4.533736533736533,60.0,0.0
25291,2,5291,[318 427 496 357 257],796,5,23993,4.533824640967498,60.0,0.0
25292,2,5292,[318 427 496 357 257],796,5,23998,4.533912714906481,60.0,0.0
25293,2,5293,[318 427 496 357 257],796,5,24003,4.534000755572346,60.0,0.0
25294,2,5294,[ 71 183 568   7 174],450,4,24007,4.533899905571293,0.0,0.0
25295,2,5295,[318 427 496 357 257],716,5,24012,4.533987915407855,60.0,0.0
25296,2,5296,[318 427 496 357 257],796,5,24017,4.534075892014347,60.0,0.0
25297,2,5297,[318 427 496 357 257],716,5,24022,4.534163835409588,60.0,0.0
25298,2,5298,[197 568 179 235 185],450,4,24026,4.534063030760521,0.0,0.0
25299,2,5299,[318 427 496 357 257],796,5,24031,4.534150943396226,60.0,0.0
25300,2,5300,[318 427 496 357 257],330,5,24036,4.53423882286361,60.0,0.0
25301,2,5301,[ 98   1 183 228   7],151,4,24040,4.534138061109015,0.0,0.0
25302,2,5302,[161 318 588  28 423],796,4,24044,4.534037337356214,20.0,0.0
25303,2,5303,[318 427 496 357 257],796,5,24049,4.534125188536954,60.0,0.0
25304,2,5304,[ 50 597   4 179 117],593,4,24053,4.534024505183789,0.0,20.0
25305,2,5305,[161  15  22 211 118],796,4,24057,4.533923859781379,0.0,0.0
25306,2,5306,[237 568 268  96 286],344,2,24059,4.53344639155832,0.0,20.0
25307,2,5307,[118  56 215 210 302],655,1,24060,4.532780708364733,0.0,0.0
25308,2,5308,[318 427 496 357 257],330,5,24065,4.532868713505368,60.0,0.0
25309,2,5309,[318 427 496 357 257],716,5,24070,4.532956685499058,60.0,0.0
25310,2,5310,[318 427 496 357 257],796,5,24075,4.533044624364527,60.0,0.0
25311,2,5311,[318 427 496 357 257],716,5,24080,4.533132530120482,60.0,0.0
25312,2,5312,[318 427 496 357 257],716,5,24085,4.53322040278562,60.0,0.0
25313,2,5313,[318 427 496 357 257],796,5,24090,4.533308242378623,60.0,0.0
25314,2,5314,[318 427 496 357 257],330,5,24095,4.533396048918156,60.0,0.0
25315,2,5315,[385 276 245 403 118],280,2,24097,4.532919488337096,0.0,0.0
25316,2,5316,[200 546 197 111 258],151,3,24100,4.532631182997931,0.0,0.0
25317,2,5317,[118   4 302  89 234],450,2,24102,4.532154945468221,0.0,0.0
25318,2,5318,[318 427 496 357 257],796,5,24107,4.532242902801278,60.0,0.0
25319,2,5319,[318 427 496 357 257],330,5,24112,4.532330827067669,60.0,0.0
25320,2,5320,[ 96 194 172 195 161],72,4,24116,4.532230783687277,0.0,0.0
25321,2,5321,[318 427 496 357 257],796,5,24121,4.532318677189027,60.0,0.0
25322,2,5322,[196 197 181 258 323],504,4,24125,4.532218673680256,0.0,0.0
25323,2,5323,[318 427 496 357 257],330,5,24130,4.532306536438768,60.0,0.0
25324,2,5324,[  8  56 125 173  22],11,5,24135,4.532394366197183,0.0,0.0
25325,2,5325,[318 427 496 357 257],330,5,24140,4.532482162974089,60.0,0.0
25326,2,5326,[318 427 496 357 257],330,5,24145,4.532569926788061,60.0,0.0
25327,2,5327,[318 427 496 357 257],716,5,24150,4.532657657657658,60.0,0.0
25328,2,5328,[318 427 496 357 257],716,5,24155,4.532745355601426,60.0,0.0
25329,2,5329,[318 427 496 357 257],796,5,24160,4.532833020637899,60.0,0.0
25330,2,5330,[238 187 168  28 237],716,4,24164,4.5327330707184394,0.0,0.0
25331,2,5331,[ 70 179  88 423  15],593,5,24169,4.532820705176294,0.0,0.0
25332,2,5332,[318 427 496 357 257],330,5,24174,4.532908306769173,60.0,0.0
25333,2,5333,[318 427 496 357 257],716,5,24179,4.53299587551556,60.0,0.0
25334,2,5334,[318 427 496 357 257],716,5,24184,4.5330834114339265,60.0,0.0
25335,2,5335,[318 427 496 357 257],796,5,24189,4.533170914542729,60.0,0.0
25336,2,5336,[318 427 496 357 257],716,5,24194,4.533258384860408,60.0,0.0
25337,2,5337,[318 427 496 357 257],796,5,24199,4.533345822405395,60.0,0.0
25338,2,5338,[318 427 496 357 257],716,5,24204,4.533433227196104,60.0,0.0
25339,2,5339,[318 427 496 357 257],796,5,24209,4.533520599250936,60.0,0.0
25340,2,5340,[318 427 496 357 257],796,5,24214,4.533607938588279,60.0,0.0
25341,2,5341,[318 427 496 357 257],716,5,24219,4.533695245226507,60.0,0.0
25342,2,5342,[318 427 496 357 257],716,5,24224,4.533782519183979,60.0,0.0
25343,2,5343,[176  50  88 313 318],280,1,24225,4.53312125748503,20.0,20.0
25344,2,5344,[318 427 496 357 257],796,5,24230,4.533208606173995,60.0,0.0
25345,2,5345,[603  82 187 194  95],18,2,24232,4.532734754956977,20.0,0.0
25346,2,5346,[318 427 496 357 257],796,5,24237,4.532822143257902,60.0,0.0
25347,2,5347,[318 427 496 357 257],330,5,24242,4.532909498878086,60.0,0.0
25348,2,5348,[318 427 496 357 257],330,5,24247,4.532996821835857,60.0,0.0
25349,2,5349,[318 427 496 357 257],330,5,24252,4.533084112149533,60.0,0.0
25350,2,5350,[318 427 496 357 257],796,5,24257,4.533171369837413,60.0,0.0
25351,2,5351,[318 427 496 357 257],330,5,24262,4.533258594917788,60.0,0.0
25352,2,5352,[318 427 496 357 257],796,5,24267,4.53334578740893,60.0,0.0
25353,2,5353,[318 427 496 357 257],716,5,24272,4.5334329473291,60.0,0.0
25354,2,5354,[318 427 496 357 257],330,5,24277,4.533520074696545,60.0,0.0
25355,2,5355,[318 427 496 357 257],796,5,24282,4.5336071695295,60.0,0.0
25356,2,5356,[318 427 496 357 257],716,5,24287,4.533694231846183,60.0,0.0
25357,2,5357,[588   8 471   4  88],344,3,24290,4.533407988055244,0.0,0.0
25358,2,5358,[318 427 496 357 257],330,5,24295,4.533495055047584,60.0,0.0
25359,2,5359,[318 427 496 357 257],330,5,24300,4.5335820895522385,60.0,0.0
25360,2,5360,[318 427 496 357 257],796,5,24305,4.533669091587391,60.0,0.0
25361,2,5361,[  4 275 273 194 294],629,2,24307,4.53319656844461,0.0,20.0
25362,2,5362,[318 427 496 357 257],796,5,24312,4.533283609919821,60.0,0.0
25363,2,5363,[318 427 496 357 257],330,5,24317,4.533370618941089,60.0,0.0
25364,2,5364,[318 427 496 357 257],716,5,24322,4.533457595526561,60.0,0.0
25365,2,5365,[318 427 496 357 257],330,5,24327,4.533544539694372,60.0,0.0
25366,2,5366,[318 427 496 357 257],330,5,24332,4.533631451462642,60.0,0.0
25367,2,5367,[318 427 496 357 257],716,5,24337,4.533718330849478,60.0,0.0
25368,2,5368,[318 427 496 357 257],716,5,24342,4.533805177872974,60.0,0.0
25369,2,5369,[318 427 496 357 257],796,5,24347,4.533891992551211,60.0,0.0
25370,2,5370,[161  12 228 202 204],457,5,24352,4.533978774902253,0.0,0.0
25371,2,5371,[318 427 496 357 257],716,5,24357,4.534065524944155,60.0,0.0
25372,2,5372,[151   4  96 153 125],450,4,24361,4.5339661269309515,0.0,0.0
25373,2,5373,[318 427 496 357 257],716,5,24366,4.53405284704131,60.0,0.0
25374,2,5374,[318 427 496 357 257],796,5,24371,4.534139534883721,60.0,0.0
25375,2,5375,[318 427 496 357 257],796,5,24376,4.534226190476191,60.0,0.0
25376,2,5376,[191 202 508 172 143],269,2,24378,4.533754881904407,0.0,0.0
25377,2,5377,[318 427 496 357 257],330,5,24383,4.533841576794347,60.0,0.0
25378,2,5378,[323 271 403 202 187],796,4,24387,4.533742331288344,0.0,0.0
25379,2,5379,[742 127  28 403  98],655,2,24389,4.533271375464684,0.0,20.0
25380,2,5380,[222  69 185 318  97],716,5,24394,4.533358111875116,20.0,0.0
25381,2,5381,[318 427 496 357 257],796,5,24399,4.533444816053512,60.0,0.0
25382,2,5382,[318 427 496 357 257],330,5,24404,4.533531488017834,60.0,0.0
25383,2,5383,[318 427 496 357 257],716,5,24409,4.533618127786033,60.0,0.0
25384,2,5384,[318 427 496 357 257],716,5,24414,4.533704735376045,60.0,0.0
25385,2,5385,[318 427 496 357 257],796,5,24419,4.533791310805793,60.0,0.0
25386,2,5386,[222 427  89 161   1],796,4,24423,4.533692222015964,20.0,0.0
25387,2,5387,[318 427 496 357 257],330,5,24428,4.533778767631774,60.0,0.0
25388,2,5388,[318 427 496 357 257],716,5,24433,4.533865281128224,60.0,0.0
25389,2,5389,[318 427 496 357 257],330,5,24438,4.533951762523191,60.0,0.0
25390,2,5390,[318 427 496 357 257],330,5,24443,4.534038211834539,60.0,0.0
25391,2,5391,[318 427 496 357 257],716,5,24448,4.534124629080119,60.0,0.0
25392,2,5392,[318 427 496 357 257],716,5,24453,4.534211014277767,60.0,0.0
25393,2,5393,[318 427 496 357 257],716,5,24458,4.534297367445309,60.0,0.0
25394,2,5394,[318 427 496 357 257],330,5,24463,4.534383688600556,60.0,0.0
25395,2,5395,[286 197 143 144 125],796,3,24466,4.53409933283914,0.0,20.0
25396,2,5396,[318 427 496 357 257],330,5,24471,4.534185658699277,60.0,0.0
25397,2,5397,[427  11 204 269 185],535,5,24476,4.534271952575028,20.0,0.0
25398,2,5398,[196 742 301 328 568],450,5,24481,4.534358214484164,0.0,0.0
25399,2,5399,[318 427 496 357 257],330,5,24486,4.5344444444444445,60.0,0.0
25400,2,5400,[742   1 191 135 215],457,5,24491,4.534530642473616,0.0,0.0
25401,2,5401,[318 427 496 357 257],796,5,24496,4.534616808589411,60.0,0.0
25402,2,5402,[ 79 403 282  70 265],280,3,24499,4.534332778086249,0.0,0.0
25403,2,5403,[318 427 496 357 257],716,5,24504,4.534418948926721,60.0,0.0
25404,2,5404,[318 427 496 357 257],330,5,24509,4.534505087881591,60.0,0.0
25405,2,5405,[496 161 185  96 183],269,2,24511,4.534036256011839,20.0,0.0
25406,2,5406,[318 427 496 357 257],330,5,24516,4.534122433882005,60.0,0.0
25407,2,5407,[318 427 496 357 257],796,5,24521,4.534208579881657,60.0,0.0
25408,2,5408,[318 427 496 357 257],716,5,24526,4.534294694028471,60.0,0.0
25409,2,5409,[318 427 496 357 257],330,5,24531,4.534380776340111,60.0,0.0
25410,2,5410,[318 427 496 357 257],796,5,24536,4.534466826834227,60.0,0.0
25411,2,5411,[318 427 496 357 257],330,5,24541,4.534552845528455,60.0,0.0
25412,2,5412,[318 427 496 357 257],716,5,24546,4.534638832440422,60.0,0.0
25413,2,5413,[318 427 496 357 257],716,5,24551,4.534724787587735,60.0,0.0
25414,2,5414,[318 427 496 357 257],330,5,24556,4.534810710987997,60.0,0.0
25415,2,5415,[318 427 496 357 257],796,5,24561,4.5348966026587885,60.0,0.0
25416,2,5416,[318 427 496 357 257],796,5,24566,4.534982462617685,60.0,0.0
25417,2,5417,[318 427 496 357 257],330,5,24571,4.535068290882244,60.0,0.0
25418,2,5418,[318 427 496 357 257],330,5,24576,4.535154087470013,60.0,0.0
25419,2,5419,[318 427 496 357 257],330,5,24581,4.535239852398524,60.0,0.0
25420,2,5420,[ 88  95 168 176 185],450,4,24585,4.535141117874931,0.0,0.0
25421,2,5421,[318 427 496 357 257],716,5,24590,4.535226853559572,60.0,0.0
25422,2,5422,[318 427 496 357 257],330,5,24595,4.5353125576249305,60.0,0.0
25423,2,5423,[ 97   4 210 127 143],716,4,24599,4.535213864306785,0.0,20.0
25424,2,5424,[318 427 496 357 257],796,5,24604,4.535299539170507,60.0,0.0
25425,2,5425,[135 294 143   7  25],655,2,24606,4.53483228897899,0.0,0.0
25426,2,5426,[318 427 496 357 257],330,5,24611,4.534918002579694,60.0,0.0
25427,2,5427,[127 435 568 210  56],450,4,24615,4.53481945467944,0.0,20.0
25428,2,5428,[318 427 496 357 257],330,5,24620,4.534905139067968,60.0,0.0
25429,2,5429,[318 427 496 357 257],330,5,24625,4.5349907918968695,60.0,0.0
25430,2,5430,[318 427 496 357 257],330,5,24630,4.5350764131835755,60.0,0.0
25431,2,5431,[318 427 496 357 257],330,5,24635,4.535162002945508,60.0,0.0
25432,2,5432,[318 427 496 357 257],330,5,24640,4.535247561200074,60.0,0.0
25433,2,5433,[161 742 237 357  82],796,3,24643,4.534965034965035,0.0,0.0
25434,2,5434,[475 100 300 265 328],292,4,24647,4.534866605335787,0.0,20.0
25435,2,5435,[151  69 180  82 100],796,2,24649,4.534400294334069,0.0,20.0
25436,2,5436,[318 427 496 357 257],330,5,24654,4.534485929740666,60.0,0.0
25437,2,5437,[191 333 268 234 603],655,2,24656,4.534019860242736,20.0,0.0
25438,2,5438,[222   4 117  79 597],450,3,24659,4.533737819452105,0.0,0.0
25439,2,5439,[318 427 496 357 257],796,5,24664,4.533823529411765,60.0,0.0
25440,2,5440,[318 427 496 357 257],330,5,24669,4.533909207866201,60.0,0.0
25441,2,5441,[318 427 496 357 257],330,5,24674,4.533994854832782,60.0,0.0
25442,2,5442,[318 427 496 357 257],716,5,24679,4.534080470328862,60.0,0.0
25443,2,5443,[318 427 496 357 257],796,5,24684,4.534166054371785,60.0,0.0
25444,2,5444,[  8 161 269 202 191],23,2,24686,4.533700642791552,0.0,0.0
25445,2,5445,[143 748 194 186 135],151,4,24690,4.53360264414249,0.0,0.0
25446,2,5446,[318 427 496 357 257],330,5,24695,4.533688268771801,60.0,0.0
25447,2,5447,[318 427 496 357 257],716,5,24700,4.533773861967695,60.0,0.0
25448,2,5448,[318 427 496 357 257],716,5,24705,4.533859423747477,60.0,0.0
25449,2,5449,[318 427 496 357 257],796,5,24710,4.53394495412844,60.0,0.0
25450,2,5450,[275 197  98  25 234],18,3,24713,4.533663547972849,0.0,20.0
25451,2,5451,[318 427 496 357 257],716,5,24718,4.533749082905356,60.0,0.0
25452,2,5452,[318 427 496 357 257],716,5,24723,4.533834586466165,60.0,0.0
25453,2,5453,[318 427 496 357 257],796,5,24728,4.533920058672534,60.0,0.0
25454,2,5454,[318 427 496 357 257],330,5,24733,4.5340054995417045,60.0,0.0
25455,2,5455,[318 427 496 357 257],796,5,24738,4.534090909090909,60.0,0.0
25456,2,5456,[ 82  64 403 496 181],796,4,24742,4.533993036466923,40.0,0.0
25457,2,5457,[318 427 496 357 257],716,5,24747,4.534078417002565,60.0,0.0
25458,2,5458,[318 427 496 357 257],330,5,24752,4.5341637662575565,60.0,0.0
25459,2,5459,[318 427 496 357 257],796,5,24757,4.534249084249084,60.0,0.0
25460,2,5460,[318 427 496 357 257],716,5,24762,4.534334370994324,60.0,0.0
25461,2,5461,[597  71 288  82 196],450,2,24764,4.533870377151227,0.0,0.0
25462,2,5462,[318 427 496 357 257],716,5,24769,4.53395570199524,60.0,0.0
25463,2,5463,[ 71  12 202 118 655],796,4,24773,4.533857979502196,0.0,0.0
25464,2,5464,[276 182 234 197  96],269,3,24776,4.533577310155535,0.0,0.0
25465,2,5465,[318 427 496 357 257],330,5,24781,4.533662641785583,60.0,0.0
25466,2,5466,[318 427 496 357 257],796,5,24786,4.533747942198646,60.0,0.0
25467,2,5467,[318 427 496 357 257],716,5,24791,4.533833211411851,60.0,0.0
25468,2,5468,[318 427 496 357 257],330,5,24796,4.533918449442311,60.0,0.0
25469,2,5469,[194   9 168 153 187],269,4,24800,4.53382084095064,0.0,0.0
25470,2,5470,[183 258 423 742   7],655,1,24801,4.533174922317675,0.0,0.0
25471,2,5471,[318 427 496 357 257],330,5,24806,4.533260233918129,60.0,0.0
25472,2,5472,[318 427 496 357 257],796,5,24811,4.533345514343139,60.0,0.0
25473,2,5473,[318 427 496 357 257],796,5,24816,4.5334307636097915,60.0,0.0
25474,2,5474,[318 427 496 357 257],796,5,24821,4.53351598173516,60.0,0.0
25475,2,5475,[318 427 496 357 257],796,5,24826,4.533601168736304,60.0,0.0
25476,2,5476,[318 427 496 357 257],796,5,24831,4.533686324630272,60.0,0.0
25477,2,5477,[318 427 496 357 257],796,5,24836,4.5337714494341,60.0,0.0
25478,2,5478,[318 427 496 357 257],716,5,24841,4.533856543164811,60.0,0.0
25479,2,5479,[318 427 496 357 257],796,5,24846,4.533941605839416,60.0,0.0
25480,2,5480,[318 427 496 357 257],796,5,24851,4.534026637474914,60.0,0.0
25481,2,5481,[318 427 496 357 257],716,5,24856,4.534111638088289,60.0,0.0
25482,2,5482,[318 427 496 357 257],796,5,24861,4.534196607696517,60.0,0.0
25483,2,5483,[  1 144 403  69 200],655,1,24862,4.533552151714077,0.0,0.0
25484,2,5484,[318 427 496 357 257],330,5,24867,4.533637192342753,60.0,0.0
25485,2,5485,[318 427 496 357 257],716,5,24872,4.533722201968647,60.0,0.0
25486,2,5486,[318 427 496 357 257],796,5,24877,4.5338071806087115,60.0,0.0
25487,2,5487,[216 153 222  69 132],716,5,24882,4.533892128279883,0.0,0.0
25488,2,5488,[318 427 496 357 257],716,5,24887,4.533977044999089,60.0,0.0
25489,2,5489,[318 427 496 357 257],716,5,24892,4.534061930783242,60.0,0.0
25490,2,5490,[318 427 496 357 257],796,5,24897,4.534146785649244,60.0,0.0
25491,2,5491,[318 427 496 357 257],330,5,24902,4.534231609613984,60.0,0.0
25492,2,5492,[194 405  15 427 173],796,5,24907,4.534316402694338,20.0,0.0
25493,2,5493,[318 427 496 357 257],716,5,24912,4.534401164907171,60.0,0.0
25494,2,5494,[318 427 496 357 257],716,5,24917,4.534485896269336,60.0,0.0
25495,2,5495,[318 427 496 357 257],330,5,24922,4.534570596797671,60.0,0.0
25496,2,5496,[318 427 496 357 257],716,5,24927,4.534655266509005,60.0,0.0
25497,2,5497,[318 427 496 357 257],796,5,24932,4.534739905420153,60.0,0.0
25498,2,5498,[318 427 496 357 257],796,5,24937,4.5348245135479175,60.0,0.0
25499,2,5499,[318 427 496 357 257],330,5,24942,4.534909090909091,60.0,0.0
25500,2,5500,[318 427 496 357 257],796,5,24947,4.534993637520451,60.0,0.0
25501,2,5501,[132 182 245 181 174],796,4,24951,4.5348964013086155,0.0,0.0
25502,2,5502,[234   9 195  88   7],269,1,24952,4.5342540432491365,0.0,0.0
25503,2,5503,[181 423  50 268 153],269,2,24954,4.533793604651163,0.0,20.0
25504,2,5504,[318 427 496 357 257],330,5,24959,4.533878292461399,60.0,0.0
25505,2,5505,[235 100  15 143 385],450,3,24962,4.533599709407919,0.0,20.0
25506,2,5506,[200 322   4 210 191],796,3,24965,4.5333212275286,0.0,0.0
25507,2,5507,[245 322  88 180 222],450,4,24969,4.533224400871459,0.0,0.0
25508,2,5508,[318 427 496 357 257],716,5,24974,4.533309130513705,60.0,0.0
25509,2,5509,[318 427 496 357 257],330,5,24979,4.533393829401089,60.0,0.0
25510,2,5510,[318 427 496 357 257],796,5,24984,4.5334784975503535,60.0,0.0
25511,2,5511,[318 427 496 357 257],796,5,24989,4.5335631349782295,60.0,0.0
25512,2,5512,[546 143 423 318 127],796,5,24994,4.533647741701433,20.0,20.0
25513,2,5513,[318 427 496 357 257],716,5,24999,4.53373231773667,60.0,0.0
25514,2,5514,[286  70 186 318  69],151,5,25004,4.533816863100634,20.0,20.0
25515,2,5515,[125 318 405   4 235],450,3,25007,4.533538796229151,20.0,0.0
25516,2,5516,[318 427 496 357 257],796,5,25012,4.533623346021389,60.0,0.0
25517,2,5517,[318 427 496 357 257],330,5,25017,4.533707865168539,60.0,0.0
25518,2,5518,[318 427 496 357 257],796,5,25022,4.533792353687262,60.0,0.0
25519,2,5519,[318 427 496 357 257],716,5,25027,4.533876811594203,60.0,0.0
25520,2,5520,[187 216   8  88  70],503,5,25032,4.533961238905995,0.0,0.0
25521,2,5521,[318 427 496 357 257],716,5,25037,4.534045635639261,60.0,0.0
25522,2,5522,[318 427 496 357 257],796,5,25042,4.5341300018106105,60.0,0.0
25523,2,5523,[318 427 496 357 257],330,5,25047,4.53421433743664,60.0,0.0
25524,2,5524,[172  11 204 173 195],716,4,25051,4.534117647058824,0.0,0.0
25525,2,5525,[318 427 496 357 257],796,5,25056,4.534201954397394,60.0,0.0
25526,2,5526,[318 427 496 357 257],716,5,25061,4.534286231228514,60.0,0.0
25527,2,5527,[318 427 496 357 257],716,5,25066,4.534370477568741,60.0,0.0
25528,2,5528,[318 427 496 357 257],330,5,25071,4.5344546934346175,60.0,0.0
25529,2,5529,[318 427 496 357 257],716,5,25076,4.534538878842676,60.0,0.0
25530,2,5530,[318 427 496 357 257],796,5,25081,4.534623033809438,60.0,0.0
25531,2,5531,[318 427 496 357 257],796,5,25086,4.53470715835141,60.0,0.0
25532,2,5532,[318 427 496 357 257],796,5,25091,4.534791252485089,60.0,0.0
25533,2,5533,[318 427 496 357 257],716,5,25096,4.534875316226961,60.0,0.0
25534,2,5534,[318 427 496 357 257],716,5,25101,4.534959349593496,60.0,0.0
25535,2,5535,[318 427 496 357 257],330,5,25106,4.535043352601156,60.0,0.0
25536,2,5536,[318 427 496 357 257],330,5,25111,4.53512732526639,60.0,0.0
25537,2,5537,[318 427 496 357 257],716,5,25116,4.535211267605634,60.0,0.0
25538,2,5538,[135 546   4 125 173],280,2,25118,4.534753565625564,0.0,0.0
25539,2,5539,[318 427 496 357 257],330,5,25123,4.534837545126353,60.0,0.0
25540,2,5540,[294 403  70 195 313],655,1,25124,4.534199602959754,0.0,0.0
25541,2,5541,[318 427 496 357 257],330,5,25129,4.534283652111151,60.0,0.0
25542,2,5542,[318 427 496 357 257],330,5,25134,4.534367670936316,60.0,0.0
25543,2,5543,[318 427 496 357 257],716,5,25139,4.534451659451659,60.0,0.0
25544,2,5544,[318 427 496 357 257],330,5,25144,4.53453561767358,60.0,0.0
25545,2,5545,[318 427 496 357 257],716,5,25149,4.5346195456184635,60.0,0.0
25546,2,5546,[318 427 496 357 257],796,5,25154,4.5347034433026865,60.0,0.0
25547,2,5547,[318 427 496 357 257],716,5,25159,4.53478731074261,60.0,0.0
25548,2,5548,[318 427 496 357 257],330,5,25164,4.534871147954586,60.0,0.0
25549,2,5549,[ 88 204 475  71 185],389,4,25168,4.534774774774775,0.0,0.0
25550,2,5550,[301 273  12  96 125],655,1,25169,4.534137993154387,0.0,0.0
25551,2,5551,[318 427 496 357 257],716,5,25174,4.534221902017291,60.0,0.0
25552,2,5552,[318 427 496 357 257],330,5,25179,4.534305780659103,60.0,0.0
25553,2,5553,[318 427 496 357 257],330,5,25184,4.534389629096147,60.0,0.0
25554,2,5554,[318 427 496 357 257],330,5,25189,4.534473447344735,60.0,0.0
25555,2,5555,[318 427 496 357 257],796,5,25194,4.5345572354211665,60.0,0.0
25556,2,5556,[318 427 496 357 257],716,5,25199,4.534640993341731,60.0,0.0
25557,2,5557,[318 427 496 357 257],716,5,25204,4.534724721122706,60.0,0.0
25558,2,5558,[318 427 496 357 257],716,5,25209,4.534808418780356,60.0,0.0
25559,2,5559,[318 427 496 357 257],716,5,25214,4.534892086330935,60.0,0.0
25560,2,5560,[318 427 496 357 257],330,5,25219,4.534975723790685,60.0,0.0
25561,2,5561,[238  15 187  95   4],796,4,25223,4.534879539733908,0.0,0.0
25562,2,5562,[318 427 496 357 257],796,5,25228,4.534963149379831,60.0,0.0
25563,2,5563,[318 427 496 357 257],716,5,25233,4.535046728971962,60.0,0.0
25564,2,5564,[  4 742 100 200 132],577,4,25237,4.534950584007188,0.0,20.0
25565,2,5565,[ 64  98  11 234 515],269,3,25240,4.534674811354654,20.0,0.0
25566,2,5566,[318 427 496 357 257],330,5,25245,4.534758397700736,60.0,0.0
25567,2,5567,[318 427 496 357 257],330,5,25250,4.534841954022989,60.0,0.0
25568,2,5568,[318 427 496 357 257],796,5,25255,4.534925480337583,60.0,0.0
25569,2,5569,[318 427 496 357 257],796,5,25260,4.5350089766606825,60.0,0.0
25570,2,5570,[318 427 496 357 257],330,5,25265,4.535092443008437,60.0,0.0
25571,2,5571,[318 427 496 357 257],330,5,25270,4.535175879396985,60.0,0.0
25572,2,5572,[322  56 245 271 328],796,3,25273,4.5349004127041095,0.0,0.0
25573,2,5573,[318 427 496 357 257],330,5,25278,4.534983853606028,60.0,0.0
25574,2,5574,[318 427 496 357 257],796,5,25283,4.535067264573991,60.0,0.0
25575,2,5575,[318 427 496 357 257],330,5,25288,4.535150645624103,60.0,0.0
25576,2,5576,[318 427 496 357 257],796,5,25293,4.535233996772458,60.0,0.0
25577,2,5577,[318 427 496 357 257],796,5,25298,4.535317318035138,60.0,0.0
25578,2,5578,[318 427 496 357 257],716,5,25303,4.535400609428213,60.0,0.0
25579,2,5579,[318 427 496 357 257],796,5,25308,4.535483870967742,60.0,0.0
25580,2,5580,[318 427 496 357 257],330,5,25313,4.535567102669773,60.0,0.0
25581,2,5581,[318 427 496 357 257],716,5,25318,4.53565030455034,60.0,0.0
25582,2,5582,[318 427 496 357 257],330,5,25323,4.53573347662547,60.0,0.0
25583,2,5583,[318 427 496 357 257],716,5,25328,4.535816618911174,60.0,0.0
25584,2,5584,[318 427 496 357 257],330,5,25333,4.535899731423456,60.0,0.0
25585,2,5585,[318 427 496 357 257],796,5,25338,4.535982814178303,60.0,0.0
25586,2,5586,[318 427 496 357 257],716,5,25343,4.536065867191695,60.0,0.0
25587,2,5587,[385 322 265   4 216],256,5,25348,4.536148890479599,0.0,0.0
25588,2,5588,[318 427 496 357 257],716,5,25353,4.536231884057971,60.0,0.0
25589,2,5589,[318 427 496 357 257],796,5,25358,4.536314847942755,60.0,0.0
25590,2,5590,[174 194 200 100 197],269,4,25362,4.536218923269541,0.0,20.0
25591,2,5591,[318 427 496 357 257],796,5,25367,4.536301859799714,60.0,0.0
25592,2,5592,[318 427 496 357 257],330,5,25372,4.536384766672627,60.0,0.0
25593,2,5593,[318 427 496 357 257],716,5,25377,4.536467643904183,60.0,0.0
25594,2,5594,[  7 357  12 118 385],344,3,25380,4.536193029490617,0.0,0.0
25595,2,5595,[ 98 195  28 678 161],504,5,25385,4.536275911365261,0.0,0.0
25596,2,5596,[318 427 496 357 257],330,5,25390,4.53635876362337,60.0,0.0
25597,2,5597,[318 427 496 357 257],716,5,25395,4.536441586280815,60.0,0.0
25598,2,5598,[318 427 496 357 257],716,5,25400,4.536524379353456,60.0,0.0
25599,2,5599,[174 655 385 228 172],151,4,25404,4.536428571428571,0.0,0.0
25600,2,5600,[132 151  12  22 496],577,5,25409,4.536511337261203,20.0,0.0
25601,2,5601,[318 427 496 357 257],796,5,25414,4.536594073545163,60.0,0.0
25602,2,5602,[ 28  82 204  96 294],577,5,25419,4.53667678029627,0.0,0.0
25603,2,5603,[318 427 496 357 257],796,5,25424,4.536759457530335,60.0,0.0
25604,2,5604,[318 427 496 357 257],716,5,25429,4.536842105263158,60.0,0.0
25605,2,5605,[318 427 496 357 257],330,5,25434,4.536924723510524,60.0,0.0
25606,2,5606,[318 427 496 357 257],716,5,25439,4.537007312288211,60.0,0.0
25607,2,5607,[318 427 496 357 257],796,5,25444,4.5370898716119825,60.0,0.0
25608,2,5608,[176 135 546 172 302],450,4,25448,4.536994116598324,0.0,0.0
25609,2,5609,[318 427 496 357 257],796,5,25453,4.537076648841355,60.0,0.0
25610,2,5610,[125 275 172  56 286],18,3,25456,4.536802708964534,0.0,40.0
25611,2,5611,[318 427 496 357 257],796,5,25461,4.536885245901639,60.0,0.0
25612,2,5612,[318 427 496 357 257],796,5,25466,4.536967753429539,60.0,0.0
25613,2,5613,[318 427 496 357 257],796,5,25471,4.537050231563947,60.0,0.0
25614,2,5614,[403 471 215 508 197],655,0,25471,4.536242208370436,0.0,0.0
25615,2,5615,[318 427 496 357 257],330,5,25476,4.536324786324786,60.0,0.0
25616,2,5616,[318 427 496 357 257],716,5,25481,4.536407334876269,60.0,0.0
25617,2,5617,[318 427 496 357 257],796,5,25486,4.536489854040584,60.0,0.0
25618,2,5618,[318 427 496 357 257],330,5,25491,4.536572343833423,60.0,0.0
25619,2,5619,[318 427 496 357 257],716,5,25496,4.536654804270462,60.0,0.0
25620,2,5620,[318 427 496 357 257],716,5,25501,4.536737235367372,60.0,0.0
25621,2,5621,[318 427 496 357 257],716,5,25506,4.536819637139808,60.0,0.0
25622,2,5622,[483  70 301 228 172],655,2,25508,4.536368486573004,0.0,0.0
25623,2,5623,[423  56 742  28 269],796,2,25510,4.535917496443812,0.0,0.0
25624,2,5624,[318 427 496 357 257],796,5,25515,4.536,60.0,0.0
25625,2,5625,[187 568 182 282 405],655,2,25517,4.535549235691432,0.0,0.0
25626,2,5626,[318 427 496 357 257],716,5,25522,4.535631775368758,60.0,0.0
25627,2,5627,[318 427 496 357 257],796,5,25527,4.535714285714286,60.0,0.0
25628,2,5628,[318 427 496 357 257],796,5,25532,4.535796766743649,60.0,0.0
25629,2,5629,[318 427 496 357 257],716,5,25537,4.535879218472469,60.0,0.0
25630,2,5630,[318 427 496 357 257],330,5,25542,4.535961640916356,60.0,0.0
25631,2,5631,[318 427 496 357 257],796,5,25547,4.536044034090909,60.0,0.0
25632,2,5632,[318 427 496 357 257],796,5,25552,4.536126398011716,60.0,0.0
25633,2,5633,[318 427 496 357 257],330,5,25557,4.536208732694356,60.0,0.0
25634,2,5634,[318 427 496 357 257],716,5,25562,4.536291038154392,60.0,0.0
25635,2,5635,[318 427 496 357 257],716,5,25567,4.536373314407381,60.0,0.0
25636,2,5636,[318 427 496 357 257],796,5,25572,4.536455561468866,60.0,0.0
25637,2,5637,[318 427 496 357 257],796,5,25577,4.536537779354381,60.0,0.0
25638,2,5638,[318 427 496 357 257],330,5,25582,4.536619968079447,60.0,0.0
25639,2,5639,[222 427 423 301 597],450,4,25586,4.536524822695036,20.0,0.0
25640,2,5640,[318 427 496 357 257],796,5,25591,4.536606984577203,60.0,0.0
25641,2,5641,[318 427 496 357 257],796,5,25596,4.536689117334278,60.0,0.0
25642,2,5642,[318 427 496 357 257],716,5,25601,4.5367712209817475,60.0,0.0
25643,2,5643,[302 127 185 405 181],269,2,25603,4.53632175761871,0.0,20.0
25644,2,5644,[318 427 496 357 257],330,5,25608,4.536403897254207,60.0,0.0
25645,2,5645,[318 427 496 357 257],716,5,25613,4.536486007793128,60.0,0.0
25646,2,5646,[318 427 496 357 257],796,5,25618,4.53656808925093,60.0,0.0
25647,2,5647,[318 427 496 357 257],796,5,25623,4.53665014164306,60.0,0.0
25648,2,5648,[  4 197 496  82 215],450,3,25626,4.536378120021243,20.0,0.0
25649,2,5649,[318 427 496 357 257],796,5,25631,4.536460176991151,60.0,0.0
25650,2,5650,[ 98 268 385 496 202],344,3,25634,4.5361882852592466,20.0,0.0
25651,2,5651,[655 210  82 153 215],716,5,25639,4.536270346779901,0.0,0.0
25652,2,5652,[276   7   9 471 222],280,3,25642,4.535998584822218,0.0,0.0
25653,2,5653,[403 202   1 118 275],450,4,25646,4.535903784931023,0.0,20.0
25654,2,5654,[ 15 588 748  79  64],796,5,25651,4.535985853227232,20.0,0.0
25655,2,5655,[153 191 238 216 186],151,3,25654,4.535714285714286,0.0,0.0
25656,2,5656,[318 427 496 357 257],796,5,25659,4.535796358493902,60.0,0.0
25657,2,5657,[288 127 655 357  50],693,2,25661,4.535348179568752,0.0,40.0
25658,2,5658,[318 427 496 357 257],330,5,25666,4.535430288036755,60.0,0.0
25659,2,5659,[318 427 496 357 257],796,5,25671,4.535512367491166,60.0,0.0
25660,2,5660,[318 427 496 357 257],330,5,25676,4.535594417947359,60.0,0.0
25661,2,5661,[ 82 238 258 508 135],655,1,25677,4.5349699752737545,0.0,0.0
25662,2,5662,[100  89 179 132  69],655,2,25679,4.534522337983401,0.0,20.0
25663,2,5663,[174 405 118 435  79],807,4,25683,4.534427966101695,0.0,0.0
25664,2,5664,[216 118 423 187  82],716,3,25686,4.534157105030891,0.0,0.0
25665,2,5665,[318 427 496 357 257],796,5,25691,4.5342393222732085,60.0,0.0
25666,2,5666,[195 191 405 313 258],655,2,25693,4.533792129874714,0.0,0.0
25667,2,5667,[318 427 496 357 257],796,5,25698,4.533874382498236,60.0,0.0
25668,2,5668,[275 508 200 172 313],655,4,25702,4.533780208149586,0.0,20.0
25669,2,5669,[318 427 496 357 257],330,5,25707,4.533862433862434,60.0,0.0
25670,2,5670,[318 427 496 357 257],716,5,25712,4.533944630576618,60.0,0.0
25671,2,5671,[318 427 496 357 257],330,5,25717,4.534026798307475,60.0,0.0
25672,2,5672,[  9  28 100 234 423],151,4,25721,4.533932663493743,0.0,20.0
25673,2,5673,[318 427 496 357 257],330,5,25726,4.534014804370814,60.0,0.0
25674,2,5674,[144 182  69 268 435],655,1,25727,4.533392070484582,0.0,0.0
25675,2,5675,[318 427 496 357 257],796,5,25732,4.533474277660324,60.0,0.0
25676,2,5676,[318 427 496 357 257],330,5,25737,4.533556455874582,60.0,0.0
25677,2,5677,[318 427 496 357 257],330,5,25742,4.533638605142656,60.0,0.0
25678,2,5678,[318 427 496 357 257],330,5,25747,4.533720725479838,60.0,0.0
25679,2,5679,[318 427 496 357 257],330,5,25752,4.533802816901408,60.0,0.0
25680,2,5680,[318 427 496 357 257],796,5,25757,4.5338848794226365,60.0,0.0
25681,2,5681,[318 427 496 357 257],716,5,25762,4.533966913058782,60.0,0.0
25682,2,5682,[153 318 222 269 403],796,4,25766,4.53387295442548,20.0,0.0
25683,2,5683,[318 427 496 357 257],796,5,25771,4.533954961294863,60.0,0.0
25684,2,5684,[496  88 742  56 234],593,4,25775,4.533861037818822,20.0,0.0
25685,2,5685,[318 427 496 357 257],796,5,25780,4.533943017938797,60.0,0.0
25686,2,5686,[318 427 496 357 257],716,5,25785,4.534024969228064,60.0,0.0
25687,2,5687,[318 427 496 357 257],796,5,25790,4.534106891701828,60.0,0.0
25688,2,5688,[318 427 496 357 257],796,5,25795,4.534188785375286,60.0,0.0
25689,2,5689,[118 222 173 215 471],716,3,25798,4.533919156414763,0.0,0.0
25690,2,5690,[318 427 496 357 257],330,5,25803,4.534001054296257,60.0,0.0
25691,2,5691,[318 427 496 357 257],330,5,25808,4.5340829234012645,60.0,0.0
25692,2,5692,[318 427 496 357 257],796,5,25813,4.53416476374495,60.0,0.0
25693,2,5693,[318 427 496 357 257],330,5,25818,4.534246575342466,60.0,0.0
25694,2,5694,[182 655 423   4 282],535,2,25820,4.533801580333626,0.0,0.0
25695,2,5695,[318 427 496 357 257],330,5,25825,4.533883426966292,60.0,0.0
25696,2,5696,[318 427 496 357 257],330,5,25830,4.533965244865719,60.0,0.0
25697,2,5697,[318 427 496 357 257],330,5,25835,4.534047034047034,60.0,0.0
25698,2,5698,[318 427 496 357 257],716,5,25840,4.534128794525356,60.0,0.0
25699,2,5699,[265 655 211 168 222],716,5,25845,4.53421052631579,0.0,0.0
25700,2,5700,[210 151 111  11 427],577,3,25848,4.533941413787055,20.0,0.0
25701,2,5701,[318 427 496 357 257],796,5,25853,4.53402314977201,60.0,0.0
25702,2,5702,[318 427 496 357 257],330,5,25858,4.534104857092758,60.0,0.0
25703,2,5703,[318 427 496 357 257],330,5,25863,4.534186535764376,60.0,0.0
25704,2,5704,[318 427 496 357 257],796,5,25868,4.5342681858019285,60.0,0.0
25705,2,5705,[237  22 194 318 215],577,5,25873,4.53434980722047,20.0,0.0
25706,2,5706,[318 427 496 357 257],330,5,25878,4.534431400035045,60.0,0.0
25707,2,5707,[318 427 496 357 257],716,5,25883,4.534512964260687,60.0,0.0
25708,2,5708,[234  56 187 182 475],269,4,25887,4.534419337887546,0.0,0.0
25709,2,5709,[318 427 496 357 257],796,5,25892,4.534500875656742,60.0,0.0
25710,2,5710,[ 64 168 588   4 748],450,4,25896,4.534407284188409,20.0,0.0
25711,2,5711,[204 265 175  70 655],878,0,25896,4.533613445378151,0.0,0.0
25712,2,5712,[  8  50 168  69 237],796,5,25901,4.533695081393313,0.0,20.0
25713,2,5713,[318 427 496 357 257],796,5,25906,4.5337766888344415,60.0,0.0
25714,2,5714,[318 427 496 357 257],796,5,25911,4.5338582677165356,60.0,0.0
25715,2,5715,[597 117  56  50 238],593,4,25915,4.533764870538838,0.0,20.0
25716,2,5716,[318 427 496 357 257],716,5,25920,4.533846422949099,60.0,0.0
25717,2,5717,[318 427 496 357 257],796,5,25925,4.533927946834558,60.0,0.0
25718,2,5718,[318 427 496 357 257],796,5,25930,4.534009442210176,60.0,0.0
25719,2,5719,[423  89  15 127 405],796,5,25935,4.534090909090909,0.0,20.0
25720,2,5720,[318 427 496 357 257],796,5,25940,4.5341723474916975,60.0,0.0
25721,2,5721,[  4 275 286 210 271],655,1,25941,4.5335547011534425,0.0,40.0
25722,2,5722,[318 427 496 357 257],716,5,25946,4.533636204787698,60.0,0.0
25723,2,5723,[318 427 496 357 257],716,5,25951,4.533717679944095,60.0,0.0
25724,2,5724,[318 427 496 357 257],796,5,25956,4.533799126637555,60.0,0.0
25725,2,5725,[318 427 496 357 257],796,5,25961,4.53388054488299,60.0,0.0
25726,2,5726,[181 483 427 111 496],908,3,25964,4.533612711716431,40.0,0.0
25727,2,5727,[318 427 496 357 257],716,5,25969,4.533694134078212,60.0,0.0
25728,2,5728,[427 174 202  25 197],716,5,25974,4.533775528015361,20.0,0.0
25729,2,5729,[318 427 496 357 257],796,5,25979,4.533856893542757,60.0,0.0
25730,2,5730,[318 427 496 357 257],330,5,25984,4.5339382306752745,60.0,0.0
25731,2,5731,[318 427 496 357 257],796,5,25989,4.534019539427774,60.0,0.0
25732,2,5732,[318 427 496 357 257],716,5,25994,4.534100819815105,60.0,0.0
25733,2,5733,[222 289 179 322 423],786,4,25998,4.534007673526334,0.0,0.0
25734,2,5734,[318 427 496 357 257],796,5,26003,4.534088927637315,60.0,0.0
25735,2,5735,[211 186  50 238 111],296,3,26006,4.533821478382148,0.0,20.0
25736,2,5736,[318 427 496 357 257],330,5,26011,4.533902736621928,60.0,0.0
25737,2,5737,[318 427 496 357 257],330,5,26016,4.533983966538864,60.0,0.0
25738,2,5738,[186  88 238 210 200],796,2,26018,4.533542428994599,0.0,0.0
25739,2,5739,[318 427 496 357 257],796,5,26023,4.533623693379791,60.0,0.0
25740,2,5740,[546 181 204 403 118],577,3,26026,4.533356558090925,0.0,0.0
25741,2,5741,[318 427 496 357 257],716,5,26031,4.533437826541275,60.0,0.0
25742,2,5742,[318 427 496 357 257],330,5,26036,4.533519066689883,60.0,0.0
25743,2,5743,[318 427 496 357 257],330,5,26041,4.533600278551532,60.0,0.0
25744,2,5744,[318 427 496 357 257],330,5,26046,4.533681462140992,60.0,0.0
25745,2,5745,[318 427 496 357 257],330,5,26051,4.533762617473025,60.0,0.0
25746,2,5746,[318 427 496 357 257],716,5,26056,4.533843744562381,60.0,0.0
25747,2,5747,[318 427 496 357 257],716,5,26061,4.5339248434238,60.0,0.0
25748,2,5748,[318 427 496 357 257],716,5,26066,4.534005914072012,60.0,0.0
25749,2,5749,[318 427 496 357 257],716,5,26071,4.534086956521739,60.0,0.0
25750,2,5750,[318 427 496 357 257],716,5,26076,4.534167970787689,60.0,0.0
25751,2,5751,[742  88  12 357 471],450,5,26081,4.534248956884562,0.0,0.0
25752,2,5752,[273  12   4 282  28],655,1,26082,4.533634625412828,0.0,0.0
25753,2,5753,[318 427 496 357 257],716,5,26087,4.533715676051442,60.0,0.0
25754,2,5754,[318 427 496 357 257],330,5,26092,4.533796698523023,60.0,0.0
25755,2,5755,[318 427 496 357 257],796,5,26097,4.5338776928422515,60.0,0.0
25756,2,5756,[318 427 496 357 257],796,5,26102,4.5339586590237975,60.0,0.0
25757,2,5757,[318 427 496 357 257],716,5,26107,4.53403959708232,60.0,0.0
25758,2,5758,[ 89 265 195 294 135],655,2,26109,4.533599583260983,0.0,0.0
25759,2,5759,[318 427 496 357 257],796,5,26114,4.533680555555556,60.0,0.0
25760,2,5760,[318 427 496 357 257],796,5,26119,4.5337614997396285,60.0,0.0
25761,2,5761,[  7 300 276 435 117],655,1,26120,4.533148212426241,0.0,0.0
25762,2,5762,[ 98 385 111 245 273],450,4,26124,4.533055700156169,0.0,0.0
25763,2,5763,[318 427 496 357 257],716,5,26129,4.533136710617627,60.0,0.0
25764,2,5764,[318 427 496 357 257],330,5,26134,4.533217692974848,60.0,0.0
25765,2,5765,[ 98 258 655 151 301],450,5,26139,4.5332986472424555,0.0,0.0
25766,2,5766,[132 318  96 176 568],655,1,26140,4.532685971909138,20.0,0.0
25767,2,5767,[318 427 496 357 257],330,5,26145,4.532766990291262,60.0,0.0
25768,2,5768,[210 200 294 275 186],450,2,26147,4.532327959785058,0.0,20.0
25769,2,5769,[318 427 496 357 257],330,5,26152,4.5324090121317155,60.0,0.0
25770,2,5770,[174 748  50  88 172],450,5,26157,4.5324900363888405,0.0,20.0
25771,2,5771,[318 427 496 357 257],330,5,26162,4.532571032571033,60.0,0.0
25772,2,5772,[318 427 496 357 257],330,5,26167,4.532652000692881,60.0,0.0
25773,2,5773,[318 427 496 357 257],330,5,26172,4.532732940768964,60.0,0.0
25774,2,5774,[318 427 496 357 257],716,5,26177,4.532813852813852,60.0,0.0
25775,2,5775,[  7 216 125 318 168],151,5,26182,4.532894736842105,20.0,0.0
25776,2,5776,[318 427 496 357 257],796,5,26187,4.5329755928682705,60.0,0.0
25777,2,5777,[318 427 496 357 257],796,5,26192,4.533056420906888,60.0,0.0
25778,2,5778,[161 172  89 328 143],796,5,26197,4.5331372209724865,0.0,0.0
25779,2,5779,[318 427 496 357 257],796,5,26202,4.533217993079584,60.0,0.0
25780,2,5780,[318 427 496 357 257],796,5,26207,4.533298737242691,60.0,0.0
25781,2,5781,[318 427 496 357 257],796,5,26212,4.533379453476305,60.0,0.0
25782,2,5782,[182 215 286 496  89],18,3,26215,4.533114300536054,20.0,20.0
25783,2,5783,[318 427 496 357 257],796,5,26220,4.533195020746888,60.0,0.0
25784,2,5784,[187 125  96  50 182],256,4,26224,4.533102852203976,0.0,20.0
25785,2,5785,[302  25 588 135  50],401,1,26225,4.532492222606291,0.0,20.0
25786,2,5786,[318 427 496 357 257],796,5,26230,4.532573008467254,60.0,0.0
25787,2,5787,[318 427 496 357 257],796,5,26235,4.532653766413269,60.0,0.0
25788,2,5788,[318 427 496 357 257],716,5,26240,4.532734496458801,60.0,0.0
25789,2,5789,[ 50 237   1 286 174],503,4,26244,4.532642487046632,0.0,40.0
25790,2,5790,[318 427 496 357 257],716,5,26249,4.532723191158695,60.0,0.0
25791,2,5791,[194 125 185  97  50],796,4,26253,4.532631215469613,0.0,20.0
25792,2,5792,[318 427 496 357 257],330,5,26258,4.532711893664768,60.0,0.0
25793,2,5793,[318 427 496 357 257],716,5,26263,4.532792544011046,60.0,0.0
25794,2,5794,[318 427 496 357 257],716,5,26268,4.532873166522864,60.0,0.0
25795,2,5795,[202  79 234 210 222],256,4,26272,4.532781228433402,0.0,0.0
25796,2,5796,[313 357 748 405 183],450,5,26277,4.532861825081939,0.0,0.0
25797,2,5797,[174  79 286 568 191],344,4,26281,4.532769920662298,0.0,20.0
25798,2,5798,[405 181 196 215  89],151,3,26284,4.532505604414554,0.0,0.0
25799,2,5799,[318 427 496 357 257],796,5,26289,4.532586206896552,60.0,0.0
25800,2,5800,[180   4  98 655 135],457,5,26294,4.5326667815893815,0.0,0.0
25801,2,5801,[318 427 496 357 257],796,5,26299,4.532747328507411,60.0,0.0
25802,2,5802,[318 427 496 357 257],716,5,26304,4.532827847665001,60.0,0.0
25803,2,5803,[318 427 496 357 257],716,5,26309,4.532908339076499,60.0,0.0
25804,2,5804,[318 427 496 357 257],796,5,26314,4.532988802756245,60.0,0.0
25805,2,5805,[318 427 496 357 257],330,5,26319,4.533069238718567,60.0,0.0
25806,2,5806,[318 427 496 357 257],716,5,26324,4.533149646977785,60.0,0.0
25807,2,5807,[318 427 496 357 257],796,5,26329,4.53323002754821,60.0,0.0
25808,2,5808,[  8 179 100 294 216],577,4,26333,4.533138233775176,0.0,20.0
25809,2,5809,[318 427 496 357 257],796,5,26338,4.533218588640276,60.0,0.0
25810,2,5810,[318 427 496 357 257],716,5,26343,4.533298915849252,60.0,0.0
25811,2,5811,[318 328 435 508   1],401,3,26346,4.533035099793531,20.0,0.0
25812,2,5812,[318 427 496 357 257],716,5,26351,4.533115430930673,60.0,0.0
25813,2,5813,[318 427 496 357 257],330,5,26356,4.533195734434124,60.0,0.0
25814,2,5814,[ 50 215 423 357  15],450,4,26360,4.533104041272571,0.0,20.0
25815,2,5815,[ 97 182 202 210 180],457,5,26365,4.53318431911967,0.0,0.0
25816,2,5816,[318 427 496 357 257],796,5,26370,4.533264569365652,60.0,0.0
25817,2,5817,[318 427 496 357 257],330,5,26375,4.533344792024751,60.0,0.0
25818,2,5818,[318 427 496 357 257],330,5,26380,4.533424987111188,60.0,0.0
25819,2,5819,[318 427 496 357 257],330,5,26385,4.533505154639175,60.0,0.0
25820,2,5820,[ 11 597  28 200 655],457,4,26389,4.533413502834565,0.0,0.0
25821,2,5821,[318 427 496 357 257],716,5,26394,4.533493644795603,60.0,0.0
25822,2,5822,[318 427 496 357 257],796,5,26399,4.533573759230637,60.0,0.0
25823,2,5823,[318 427 496 357 257],330,5,26404,4.533653846153846,60.0,0.0
25824,2,5824,[318 427 496 357 257],716,5,26409,4.533733905579399,60.0,0.0
25825,2,5825,[318 427 496 357 257],330,5,26414,4.5338139375214555,60.0,0.0
25826,2,5826,[318 427 496 357 257],796,5,26419,4.533893941994165,60.0,0.0
25827,2,5827,[318 427 496 357 257],796,5,26424,4.533973919011668,60.0,0.0
25828,2,5828,[318 427 496 357 257],330,5,26429,4.534053868588094,60.0,0.0
25829,2,5829,[  4 302 153 294 237],450,4,26433,4.533962264150944,0.0,0.0
25830,2,5830,[318 427 496 357 257],330,5,26438,4.534042188303893,60.0,0.0
25831,2,5831,[ 64  70 175  88  56],18,4,26442,4.533950617283951,20.0,0.0
25832,2,5832,[318 427 496 357 257],796,5,26447,4.534030516029487,60.0,0.0
25833,2,5833,[318 427 496 357 257],716,5,26452,4.534110387384299,60.0,0.0
25834,2,5834,[318 427 496 357 257],330,5,26457,4.534190231362468,60.0,0.0
25835,2,5835,[318 427 496 357 257],716,5,26462,4.534270047978067,60.0,0.0
25836,2,5836,[318 427 496 357 257],796,5,26467,4.53434983724516,60.0,0.0
25837,2,5837,[515 180  98 435  97],316,4,26471,4.534258307639603,0.0,0.0
25838,2,5838,[200 183 185  69 288],450,3,26474,4.5339955471827365,0.0,0.0
25839,2,5839,[403 117 143 216 282],457,5,26479,4.534075342465753,0.0,0.0
25840,2,5840,[173  97 191   8 196],457,5,26484,4.534155110426297,0.0,0.0
25841,2,5841,[187 269  28  69 597],796,3,26487,4.533892502567614,0.0,0.0
25842,2,5842,[318 427 496 357 257],716,5,26492,4.533972274516516,60.0,0.0
25843,2,5843,[318 427 496 357 257],716,5,26497,4.534052019164956,60.0,0.0
25844,2,5844,[318 427 496 357 257],716,5,26502,4.5341317365269465,60.0,0.0
25845,2,5845,[318 427 496 357 257],796,5,26507,4.53421142661649,60.0,0.0
25846,2,5846,[318 427 496 357 257],796,5,26512,4.53429108944758,60.0,0.0
25847,2,5847,[318 427 496 357 257],716,5,26517,4.5343707250342,60.0,0.0
25848,2,5848,[318 427 496 357 257],716,5,26522,4.534450333390323,60.0,0.0
25849,2,5849,[143  50  22 151 200],450,4,26526,4.534358974358974,0.0,20.0
25850,2,5850,[318 427 496 357 257],796,5,26531,4.534438557511536,60.0,0.0
25851,2,5851,[318 427 496 357 257],716,5,26536,4.534518113465482,60.0,0.0
25852,2,5852,[318 427 496 357 257],716,5,26541,4.534597642234751,60.0,0.0
25853,2,5853,[179 200 168  79 153],450,4,26545,4.534506320464639,0.0,0.0
25854,2,5854,[318 427 496 357 257],716,5,26550,4.534585824081981,60.0,0.0
25855,2,5855,[318 427 496 357 257],716,5,26555,4.534665300546448,60.0,0.0
25856,2,5856,[  4 471  96 202 282],280,1,26556,4.534061806385521,0.0,0.0
25857,2,5857,[318 427 496 357 257],716,5,26561,4.534141345169,60.0,0.0
25858,2,5858,[318 427 496 357 257],330,5,26566,4.534220856801502,60.0,0.0
25859,2,5859,[318 427 496 357 257],796,5,26571,4.5343003412969285,60.0,0.0
25860,2,5860,[191  28 174  82 215],72,4,26575,4.534209179320935,0.0,0.0
25861,2,5861,[405 153  64 288 238],450,4,26579,4.5341180484476284,20.0,0.0
25862,2,5862,[385 173 471 655  95],450,4,26583,4.534026948661095,0.0,0.0
25863,2,5863,[318 427 496 357 257],796,5,26588,4.534106412005457,60.0,0.0
25864,2,5864,[318 427 496 357 257],796,5,26593,4.534185848252345,60.0,0.0
25865,2,5865,[318 427 496 357 257],330,5,26598,4.5342652574156155,60.0,0.0
25866,2,5866,[318 427 496 357 257],796,5,26603,4.5343446395091185,60.0,0.0
25867,2,5867,[318 427 496 357 257],796,5,26608,4.534423994546694,60.0,0.0
25868,2,5868,[186 515 127 121 475],296,4,26612,4.534332935764184,0.0,20.0
25869,2,5869,[182 197 196 132 174],18,4,26616,4.534241908006814,0.0,0.0
25870,2,5870,[ 88 483 286 202 174],796,4,26620,4.534150911258729,0.0,20.0
25871,2,5871,[318 427 496 357 257],716,5,26625,4.5342302452316074,60.0,0.0
25872,2,5872,[318 427 496 357 257],330,5,26630,4.534309552187979,60.0,0.0
25873,2,5873,[318 427 496 357 257],330,5,26635,4.534388832141641,60.0,0.0
25874,2,5874,[318 427 496 357 257],330,5,26640,4.534468085106383,60.0,0.0
25875,2,5875,[546 173 588 435  50],450,5,26645,4.5345473110959835,0.0,20.0
25876,2,5876,[318 427 496 357 257],716,5,26650,4.534626510124213,60.0,0.0
25877,2,5877,[180 194 179  70  71],18,4,26654,4.5345355563116705,0.0,0.0
25878,2,5878,[318 427 496 357 257],796,5,26659,4.534614730396326,60.0,0.0
25879,2,5879,[318 427 496 357 257],330,5,26664,4.53469387755102,60.0,0.0
25880,2,5880,[111  50  11 471 269],344,3,26667,4.534432919571501,0.0,20.0
25881,2,5881,[318 427 496 357 257],716,5,26672,4.534512070724244,60.0,0.0
25882,2,5882,[318 427 496 357 257],330,5,26677,4.534591194968553,60.0,0.0
25883,2,5883,[318 427 496 357 257],716,5,26682,4.534670292318151,60.0,0.0
25884,2,5884,[546 423 333 385  69],796,5,26687,4.534749362786746,0.0,0.0
25885,2,5885,[318 427 496 357 257],796,5,26692,4.53482840638804,60.0,0.0
25886,2,5886,[301 117 508 357 216],344,4,26696,4.534737557329709,0.0,0.0
25887,2,5887,[318 427 496 357 257],330,5,26701,4.534816576086956,60.0,0.0
25888,2,5888,[318 427 496 357 257],330,5,26706,4.53489556800815,60.0,0.0
25889,2,5889,[197 195 176  88 151],756,2,26708,4.53446519524618,0.0,0.0
25890,2,5890,[318 427 496 357 257],716,5,26713,4.534544219996605,60.0,0.0
25891,2,5891,[318 427 496 357 257],796,5,26718,4.534623217922607,60.0,0.0
25892,2,5892,[318 427 496 357 257],330,5,26723,4.534702189037842,60.0,0.0
25893,2,5893,[ 22 118 143 333 515],655,2,26725,4.5342721411605025,0.0,0.0
25894,2,5894,[318 427 496 357 257],796,5,26730,4.534351145038168,60.0,0.0
25895,2,5895,[318 427 496 357 257],330,5,26735,4.53443012211669,60.0,0.0
25896,2,5896,[318 427 496 357 257],330,5,26740,4.5345090724096995,60.0,0.0
25897,2,5897,[318 427 496 357 257],796,5,26745,4.534587995930824,60.0,0.0
25898,2,5898,[318 427 496 357 257],716,5,26750,4.534666892693677,60.0,0.0
25899,2,5899,[655  70 423 603 181],535,5,26755,4.534745762711864,20.0,0.0
25900,2,5900,[301   1 121 282 275],450,4,26759,4.534655143196068,0.0,20.0
25901,2,5901,[318 427 496 357 257],330,5,26764,4.534733988478482,60.0,0.0
25902,2,5902,[318 427 496 357 257],330,5,26769,4.534812807047264,60.0,0.0
25903,2,5903,[318 427 496 357 257],330,5,26774,4.534891598915989,60.0,0.0
25904,2,5904,[318 427 496 357 257],796,5,26779,4.534970364098222,60.0,0.0
25905,2,5905,[318 427 496 357 257],716,5,26784,4.535049102607518,60.0,0.0
25906,2,5906,[318 427 496 357 257],796,5,26789,4.535127814457423,60.0,0.0
25907,2,5907,[318 427 496 357 257],796,5,26794,4.535206499661476,60.0,0.0
25908,2,5908,[318 427 496 357 257],796,5,26799,4.535285158233203,60.0,0.0
25909,2,5909,[ 82 322 234  97 385],151,2,26801,4.534856175972927,0.0,0.0
25910,2,5910,[318 427 496 357 257],796,5,26806,4.5349348671967515,60.0,0.0
25911,2,5911,[318 427 496 357 257],796,5,26811,4.53501353179973,60.0,0.0
25912,2,5912,[318 427 496 357 257],716,5,26816,4.535092169795366,60.0,0.0
25913,2,5913,[161  50  69 322 385],504,4,26820,4.535001690902942,0.0,20.0
25914,2,5914,[318 427 496 357 257],330,5,26825,4.535080304311074,60.0,0.0
25915,2,5915,[318 427 496 357 257],716,5,26830,4.535158891142664,60.0,0.0
25916,2,5916,[211 515  11   4 185],655,2,26832,4.5347304377218185,0.0,0.0
25917,2,5917,[318 427 496 357 257],330,5,26837,4.53480905711389,60.0,0.0
25918,2,5918,[318 427 496 357 257],796,5,26842,4.534887649940869,60.0,0.0
25919,2,5919,[318 427 496 357 257],796,5,26847,4.534966216216216,60.0,0.0
25920,2,5920,[318 427 496 357 257],716,5,26852,4.535044755953386,60.0,0.0
25921,2,5921,[318 427 496 357 257],330,5,26857,4.5351232691658225,60.0,0.0
25922,2,5922,[ 64 483 403 111 216],450,4,26861,4.535032922505487,20.0,0.0
25923,2,5923,[265 215  79 483 197],457,5,26866,4.535111411208643,0.0,0.0
25924,2,5924,[318 427 496 357 257],330,5,26871,4.535189873417721,60.0,0.0
25925,2,5925,[318 427 496 357 257],796,5,26876,4.535268309146136,60.0,0.0
25926,2,5926,[318 427 496 357 257],330,5,26881,4.535346718407289,60.0,0.0
25927,2,5927,[318 427 496 357 257],796,5,26886,4.5354251012145745,60.0,0.0
25928,2,5928,[318 427 496 357 257],330,5,26891,4.535503457581379,60.0,0.0
25929,2,5929,[286 135 515 238  98],18,4,26895,4.535413153456998,0.0,20.0
25930,2,5930,[238  15  79   1 191],450,4,26899,4.535322879784185,0.0,0.0
25931,2,5931,[318 427 496 357 257],330,5,26904,4.5354012137559,60.0,0.0
25932,2,5932,[318 427 496 357 257],716,5,26909,4.535479521321423,60.0,0.0
25933,2,5933,[318 427 496 357 257],716,5,26914,4.535557802494102,60.0,0.0
25934,2,5934,[318 427 496 357 257],796,5,26919,4.535636057287279,60.0,0.0
25935,2,5935,[318 427 496 357 257],716,5,26924,4.535714285714286,60.0,0.0
25936,2,5936,[318 427 496 357 257],796,5,26929,4.535792487788445,60.0,0.0
25937,2,5937,[318 427 496 357 257],716,5,26934,4.535870663523072,60.0,0.0
25938,2,5938,[318 427 496 357 257],330,5,26939,4.53594881293147,60.0,0.0
25939,2,5939,[318 427 496 357 257],796,5,26944,4.536026936026936,60.0,0.0
25940,2,5940,[318 427 496 357 257],716,5,26949,4.536105032822757,60.0,0.0
25941,2,5941,[  7 172 496  98  89],786,5,26954,4.5361831033322115,20.0,0.0
25942,2,5942,[318 427 496 357 257],330,5,26959,4.536261147568568,60.0,0.0
25943,2,5943,[318 427 496 357 257],716,5,26964,4.536339165545088,60.0,0.0
25944,2,5944,[318 427 496 357 257],796,5,26969,4.536417157275021,60.0,0.0
25945,2,5945,[318 427 496 357 257],796,5,26974,4.536495122771611,60.0,0.0
25946,2,5946,[318 427 496 357 257],330,5,26979,4.536573062048092,60.0,0.0
25947,2,5947,[318 427 496 357 257],716,5,26984,4.536650975117687,60.0,0.0
25948,2,5948,[318 427 496 357 257],716,5,26989,4.536728861993613,60.0,0.0
25949,2,5949,[318 427 496 357 257],796,5,26994,4.536806722689076,60.0,0.0
25950,2,5950,[180   7  88 222 568],450,4,26998,4.53671651823223,0.0,0.0
25951,2,5951,[318 427 496 357 257],716,5,27003,4.53679435483871,60.0,0.0
25952,2,5952,[318 427 496 357 257],796,5,27008,4.53687216529481,60.0,0.0
25953,2,5953,[318 427 496 357 257],330,5,27013,4.536949949613705,60.0,0.0
25954,2,5954,[318 427 496 357 257],330,5,27018,4.537027707808564,60.0,0.0
25955,2,5955,[318 427 496 357 257],796,5,27023,4.537105439892545,60.0,0.0
25956,2,5956,[318 427 496 357 257],716,5,27028,4.537183145878798,60.0,0.0
25957,2,5957,[318 427 496 357 257],330,5,27033,4.537260825780463,60.0,0.0
25958,2,5958,[ 71 117 235 403 427],807,4,27037,4.537170666219164,20.0,0.0
25959,2,5959,[234 294 185 268 568],655,1,27038,4.536577181208053,0.0,0.0
25960,2,5960,[318 427 496 357 257],796,5,27043,4.536654923670525,60.0,0.0
25961,2,5961,[318 427 496 357 257],716,5,27048,4.536732640053673,60.0,0.0
25962,2,5962,[318 427 496 357 257],330,5,27053,4.536810330370619,60.0,0.0
25963,2,5963,[318 427 496 357 257],716,5,27058,4.536887994634474,60.0,0.0
25964,2,5964,[423  28  15 216 132],796,4,27062,4.536797988264879,0.0,0.0
25965,2,5965,[318 427 496 357 257],796,5,27067,4.536875628561851,60.0,0.0
25966,2,5966,[318 427 496 357 257],796,5,27072,4.536953242835596,60.0,0.0
25967,2,5967,[318 427 496 357 257],716,5,27077,4.537030831099195,60.0,0.0
25968,2,5968,[275 143 483 197  82],716,5,27082,4.537108393365723,0.0,20.0
25969,2,5969,[318 427 496 357 257],330,5,27087,4.537185929648241,60.0,0.0
25970,2,5970,[318 427 496 357 257],796,5,27092,4.537263439959806,60.0,0.0
25971,2,5971,[318 427 496 357 257],796,5,27097,4.537340924313463,60.0,0.0
25972,2,5972,[318 427 496 357 257],330,5,27102,4.53741838272225,60.0,0.0
25973,2,5973,[318 427 496 357 257],330,5,27107,4.537495815199197,60.0,0.0
25974,2,5974,[127 269 180 403 294],450,5,27112,4.537573221757322,0.0,20.0
25975,2,5975,[357 211  88 282 403],504,3,27115,4.537315930388219,0.0,0.0
25976,2,5976,[ 22   8 237 121  11],457,5,27120,4.5373933411410405,0.0,0.0
25977,2,5977,[210  79 328   7  28],151,4,27124,4.5373034459685515,0.0,0.0
25978,2,5978,[172  98   4  69 182],457,5,27129,4.537380832915203,0.0,0.0
25979,2,5979,[318 427 496 357 257],796,5,27134,4.537458193979933,60.0,0.0
25980,2,5980,[318 427 496 357 257],796,5,27139,4.537535529175723,60.0,0.0
25981,2,5981,[318 483 678 161 132],807,4,27143,4.537445670344367,20.0,0.0
25982,2,5982,[237 176 196 117 483],655,1,27144,4.5368544208591,0.0,0.0
25983,2,5983,[318 427 496 357 257],330,5,27149,4.536931818181818,60.0,0.0
25984,2,5984,[318 427 496 357 257],796,5,27154,4.537009189640768,60.0,0.0
25985,2,5985,[ 15  50 111 121 301],296,3,27157,4.536752422318743,0.0,20.0
25986,2,5986,[318 427 496 357 257],796,5,27162,4.53682979789544,60.0,0.0
25987,2,5987,[318 427 496 357 257],796,5,27167,4.5369071476285905,60.0,0.0
25988,2,5988,[180 125 143  69 185],796,4,27171,4.536817498747704,0.0,0.0
25989,2,5989,[318 427 496 357 257],796,5,27176,4.536894824707846,60.0,0.0
25990,2,5990,[318 427 496 357 257],796,5,27181,4.536972124853947,60.0,0.0
25991,2,5991,[318 427 496 357 257],716,5,27186,4.537049399198932,60.0,0.0
25992,2,5992,[318 427 496 357 257],716,5,27191,4.537126647755715,60.0,0.0
25993,2,5993,[318 427 496 357 257],716,5,27196,4.537203870537204,60.0,0.0
25994,2,5994,[318 427 496 357 257],716,5,27201,4.537281067556297,60.0,0.0
25995,2,5995,[318 427 496 357 257],330,5,27206,4.537358238825884,60.0,0.0
25996,2,5996,[ 56 181 302   1 202],389,5,27211,4.537435384358846,0.0,0.0
25997,2,5997,[318 427 496 357 257],716,5,27216,4.537512504168056,60.0,0.0
25998,2,5998,[318 427 496 357 257],330,5,27221,4.537589598266377,60.0,0.0
25999,2,5999,[318 427 496 357 257],796,5,27226,4.5376666666666665,60.0,0.0
26000,2,6000,[257 194 210 588 275],796,4,27230,4.537577070488252,0.0,20.0
26001,2,6001,[121 185 282 176 423],504,4,27234,4.537487504165278,0.0,0.0
26002,2,6002,[318 427 496 357 257],796,5,27239,4.537564551057804,60.0,0.0
26003,2,6003,[318 427 496 357 257],330,5,27244,4.5376415722851435,60.0,0.0
26004,2,6004,[318 427 496 357 257],716,5,27249,4.537718567860116,60.0,0.0
26005,2,6005,[318 427 496 357 257],330,5,27254,4.537795537795538,60.0,0.0
26006,2,6006,[318 427 496 357 257],796,5,27259,4.537872482104212,60.0,0.0
26007,2,6007,[318 427 496 357 257],330,5,27264,4.537949400798935,60.0,0.0
26008,2,6008,[318 427 496 357 257],330,5,27269,4.538026293892495,60.0,0.0
26009,2,6009,[ 22 204 176 135 132],450,4,27273,4.537936772046589,0.0,0.0
26010,2,6010,[318 183 111 174  98],593,5,27278,4.5380136416569625,20.0,0.0
26011,2,6011,[318 427 496 357 257],330,5,27283,4.538090485695276,60.0,0.0
26012,2,6012,[318 427 496 357 257],330,5,27288,4.538167304174289,60.0,0.0
26013,2,6013,[318 427 496 357 257],796,5,27293,4.538244097106751,60.0,0.0
26014,2,6014,[318 427 496 357 257],796,5,27298,4.538320864505403,60.0,0.0
26015,2,6015,[257 742   7  15 181],730,3,27301,4.538065159574468,0.0,0.0
26016,2,6016,[318 427 496 357 257],796,5,27306,4.538141931194947,60.0,0.0
26017,2,6017,[237 182 318  64 211],18,4,27310,4.5380525091392485,40.0,0.0
26018,2,6018,[222   8 215  50 318],280,2,27312,4.537630835686991,20.0,20.0
26019,2,6019,[318 427 496 357 257],716,5,27317,4.537707641196013,60.0,0.0
26020,2,6020,[318 427 496 357 257],330,5,27322,4.537784421192493,60.0,0.0
26021,2,6021,[403 173 210 294 215],450,4,27326,4.53769511790103,0.0,0.0
26022,2,6022,[318 427 496 357 257],716,5,27331,4.537771874481155,60.0,0.0
26023,2,6023,[318 427 496 357 257],716,5,27336,4.53784860557769,60.0,0.0
26024,2,6024,[ 89  50   7 423 202],786,5,27341,4.5379253112033195,0.0,20.0
26025,2,6025,[318 427 496 357 257],330,5,27346,4.538001991370727,60.0,0.0
26026,2,6026,[318 427 496 357 257],330,5,27351,4.5380786460925835,60.0,0.0
26027,2,6027,[  8 195  50   4 276],655,2,27353,4.537657597876576,0.0,20.0
26028,2,6028,[196  79 144 172 294],450,5,27358,4.537734284292585,0.0,0.0
26029,2,6029,[168  96 127 238 357],450,5,27363,4.537810945273632,0.0,20.0
26030,2,6030,[318 427 496 357 257],330,5,27368,4.537887580832366,60.0,0.0
26031,2,6031,[ 95 161 144 678  50],807,4,27372,4.537798408488063,0.0,20.0
26032,2,6032,[318 427 496 357 257],796,5,27377,4.537875020719377,60.0,0.0
26033,2,6033,[318 427 496 357 257],796,5,27382,4.537951607557176,60.0,0.0
26034,2,6034,[318 427 496 357 257],796,5,27387,4.538028169014084,60.0,0.0
26035,2,6035,[186 273 235 191 423],450,2,27389,4.537607687210073,0.0,0.0
26036,2,6036,[318 427 496 357 257],330,5,27394,4.537684280271658,60.0,0.0
26037,2,6037,[211  64  12 174 125],450,5,27399,4.537760847962901,20.0,0.0
26038,2,6038,[318 427 496 357 257],716,5,27404,4.537837390296406,60.0,0.0
26039,2,6039,[318 427 496 357 257],330,5,27409,4.537913907284768,60.0,0.0
26040,2,6040,[ 71 403 423 427 471],577,4,27413,4.537824863433206,20.0,0.0
26041,2,6041,[318 427 496 357 257],796,5,27418,4.5379013571665014,60.0,0.0
26042,2,6042,[318 427 496 357 257],716,5,27423,4.53797782558332,60.0,0.0
26043,2,6043,[318 427 496 357 257],796,5,27428,4.538054268696228,60.0,0.0
26044,2,6044,[318 427 496 357 257],716,5,27433,4.538130686517784,60.0,0.0
26045,2,6045,[318 427 496 357 257],796,5,27438,4.538207079060536,60.0,0.0
26046,2,6046,[318 427 496 357 257],716,5,27443,4.538283446337027,60.0,0.0
26047,2,6047,[318 427 496 357 257],716,5,27448,4.538359788359788,60.0,0.0
26048,2,6048,[318 427 496 357 257],716,5,27453,4.538436105141345,60.0,0.0
26049,2,6049,[328  79 300  70 202],655,1,27454,4.537851239669421,0.0,0.0
26050,2,6050,[318 427 496 357 257],796,5,27459,4.5379276152702035,60.0,0.0
26051,2,6051,[200  71 151 234  50],18,2,27461,4.537508261731659,0.0,20.0
26052,2,6052,[318 427 496 357 257],330,5,27466,4.537584668759293,60.0,0.0
26053,2,6053,[143  15  89 195 269],655,2,27468,4.537165510406343,0.0,0.0
26054,2,6054,[322 323 172  64 228],256,3,27471,4.536911643270025,20.0,0.0
26055,2,6055,[318 427 496 357 257],330,5,27476,4.536988110964333,60.0,0.0
26056,2,6056,[318 427 496 357 257],796,5,27481,4.537064553409278,60.0,0.0
26057,2,6057,[483 181 180 204 185],269,2,27483,4.5366457576758,0.0,0.0
26058,2,6058,[318 427 496 357 257],796,5,27488,4.536722231391319,60.0,0.0
26059,2,6059,[ 88 180 196 515 132],716,4,27492,4.536633663366336,0.0,0.0
26060,2,6060,[318 427 496 357 257],330,5,27497,4.5367101138426005,60.0,0.0
26061,2,6061,[318 427 496 357 257],716,5,27502,4.536786539096008,60.0,0.0
26062,2,6062,[318 427 496 357 257],330,5,27507,4.5368629391390405,60.0,0.0
26063,2,6063,[318 427 496 357 257],796,5,27512,4.536939313984169,60.0,0.0
26064,2,6064,[318 427 496 357 257],716,5,27517,4.537015663643858,60.0,0.0
26065,2,6065,[318 427 496 357 257],330,5,27522,4.537091988130563,60.0,0.0
26066,2,6066,[318 427 496 357 257],796,5,27527,4.537168287456733,60.0,0.0
26067,2,6067,[318 427 496 357 257],716,5,27532,4.537244561634806,60.0,0.0
26068,2,6068,[318 427 496 357 257],716,5,27537,4.537320810677212,60.0,0.0
26069,2,6069,[318 427 496 357 257],796,5,27542,4.537397034596376,60.0,0.0
26070,2,6070,[323 180 403  50 245],796,2,27544,4.536979080876297,0.0,20.0
26071,2,6071,[117 546 111 200 186],796,4,27548,4.536890645586298,0.0,0.0
26072,2,6072,[318 427 496 357 257],796,5,27553,4.536966902684012,60.0,0.0
26073,2,6073,[318 427 496 357 257],796,5,27558,4.537043134672374,60.0,0.0
26074,2,6074,[173 471 175 483  82],457,5,27563,4.537119341563786,0.0,0.0
26075,2,6075,[318 427 496 357 257],330,5,27568,4.537195523370639,60.0,0.0
26076,2,6076,[318 427 496 357 257],330,5,27573,4.537271680105315,60.0,0.0
26077,2,6077,[318 427 496 357 257],716,5,27578,4.537347811780191,60.0,0.0
26078,2,6078,[318 427 496 357 257],330,5,27583,4.537423918407633,60.0,0.0
26079,2,6079,[318 427 496 357 257],796,5,27588,4.5375,60.0,0.0
26080,2,6080,[234 269 275 228 202],23,3,27591,4.53724716329551,0.0,20.0
26081,2,6081,[318 427 496 357 257],796,5,27596,4.537323248931273,60.0,0.0
26082,2,6082,[185  69 302 357 496],269,3,27599,4.537070524412297,20.0,0.0
26083,2,6083,[  1 153 603 183 237],796,4,27603,4.53698224852071,20.0,0.0
26084,2,6084,[318 427 496 357 257],330,5,27608,4.5370583401807725,60.0,0.0
26085,2,6085,[318 427 496 357 257],796,5,27613,4.53713440683536,60.0,0.0
26086,2,6086,[318 427 496 357 257],796,5,27618,4.537210448496796,60.0,0.0
26087,2,6087,[318 427 496 357 257],796,5,27623,4.537286465177398,60.0,0.0
26088,2,6088,[318 427 496 357 257],330,5,27628,4.537362456889473,60.0,0.0
26089,2,6089,[318 427 496 357 257],716,5,27633,4.5374384236453205,60.0,0.0
26090,2,6090,[318 427 496 357 257],330,5,27638,4.537514365457232,60.0,0.0
26091,2,6091,[234 385  50 168 194],151,4,27642,4.5374261326329615,0.0,20.0
26092,2,6092,[318 427 496 357 257],716,5,27647,4.537502051534548,60.0,0.0
26093,2,6093,[318 427 496 357 257],330,5,27652,4.537577945520184,60.0,0.0
26094,2,6094,[ 70 234 655  12 257],655,0,27652,4.536833470057424,0.0,0.0
26095,2,6095,[100  69 333 286 204],655,0,27652,4.536089238845144,0.0,40.0
26096,2,6096,[597 323   9 288 237],938,1,27653,4.53550926685255,0.0,0.0
26097,2,6097,[318 427 496 357 257],330,5,27658,4.535585437848475,60.0,0.0
26098,2,6098,[318 427 496 357 257],330,5,27663,4.535661583866208,60.0,0.0
26099,2,6099,[318 427 496 357 257],716,5,27668,4.5357377049180325,60.0,0.0
26100,2,6100,[318 427 496 357 257],796,5,27673,4.535813801016227,60.0,0.0
26101,2,6101,[318 427 496 357 257],716,5,27678,4.535889872173058,60.0,0.0
26102,2,6102,[318 427 496 357 257],796,5,27683,4.535965918400787,60.0,0.0
26103,2,6103,[318 427 496 357 257],716,5,27688,4.536041939711665,60.0,0.0
26104,2,6104,[318 427 496 357 257],796,5,27693,4.536117936117936,60.0,0.0
26105,2,6105,[318 427 496 357 257],796,5,27698,4.536193907631837,60.0,0.0
26106,2,6106,[318 427 496 357 257],716,5,27703,4.536269854265597,60.0,0.0
26107,2,6107,[318 427 496 357 257],716,5,27708,4.5363457760314345,60.0,0.0
26108,2,6108,[318 427 496 357 257],796,5,27713,4.536421672941562,60.0,0.0
26109,2,6109,[176 144 288  71  28],450,3,27716,4.536170212765957,0.0,0.0
26110,2,6110,[318 427 496 357 257],330,5,27721,4.536246113565701,60.0,0.0
26111,2,6111,[265 172  12   4 423],450,4,27725,4.536158376963351,0.0,0.0
26112,2,6112,[318 427 496 357 257],716,5,27730,4.536234254866677,60.0,0.0
26113,2,6113,[318 427 496 357 257],330,5,27735,4.536310107948969,60.0,0.0
26114,2,6114,[318 427 496 357 257],330,5,27740,4.536385936222404,60.0,0.0
26115,2,6115,[318 427 496 357 257],716,5,27745,4.53646173969915,60.0,0.0
26116,2,6116,[318 427 496 357 257],330,5,27750,4.536537518391368,60.0,0.0
26117,2,6117,[318 427 496 357 257],796,5,27755,4.536613272311213,60.0,0.0
26118,2,6118,[318 427 496 357 257],716,5,27760,4.536689001470829,60.0,0.0
26119,2,6119,[318 427 496 357 257],330,5,27765,4.536764705882353,60.0,0.0
26120,2,6120,[318 427 496 357 257],716,5,27770,4.536840385557915,60.0,0.0
26121,2,6121,[318 427 496 357 257],796,5,27775,4.536916040509637,60.0,0.0
26122,2,6122,[318 427 496 357 257],716,5,27780,4.536991670749632,60.0,0.0
26123,2,6123,[318 427 496 357 257],716,5,27785,4.537067276290006,60.0,0.0
26124,2,6124,[318 427 496 357 257],330,5,27790,4.537142857142857,60.0,0.0
26125,2,6125,[318 427 496 357 257],796,5,27795,4.537218413320274,60.0,0.0
26126,2,6126,[318 427 496 357 257],716,5,27800,4.53729394483434,60.0,0.0
26127,2,6127,[318 427 496 357 257],716,5,27805,4.537369451697128,60.0,0.0
26128,2,6128,[318 427 496 357 257],796,5,27810,4.537444933920705,60.0,0.0
26129,2,6129,[228  28 235 204   7],450,4,27814,4.537357259380098,0.0,0.0
26130,2,6130,[ 70 161  28 210 204],655,0,27814,4.536617191322786,0.0,0.0
26131,2,6131,[318 427 496 357 257],716,5,27819,4.536692759295499,60.0,0.0
26132,2,6132,[318 427 496 357 257],716,5,27824,4.536768302625143,60.0,0.0
26133,2,6133,[318 427 496 357 257],716,5,27829,4.536843821323769,60.0,0.0
26134,2,6134,[318 427 496 357 257],796,5,27834,4.536919315403423,60.0,0.0
26135,2,6135,[238 111  89   9  97],796,2,27836,4.536505867014341,0.0,0.0
26136,2,6136,[318 427 496 357 257],796,5,27841,4.536581391559394,60.0,0.0
26137,2,6137,[174 385 143 161 197],786,4,27845,4.536493971977843,0.0,0.0
26138,2,6138,[435 211 301  50 183],151,4,27849,4.536406580876364,0.0,20.0
26139,2,6139,[318 427 496 357 257],716,5,27854,4.536482084690554,60.0,0.0
26140,2,6140,[318 427 496 357 257],796,5,27859,4.536557563914672,60.0,0.0
26141,2,6141,[286 403 427 183 301],450,5,27864,4.536633018560729,20.0,20.0
26142,2,6142,[318 427 496 357 257],716,5,27869,4.536708448640729,60.0,0.0
26143,2,6143,[318 427 496 357 257],716,5,27874,4.536783854166667,60.0,0.0
26144,2,6144,[318 427 496 357 257],716,5,27879,4.536859235150529,60.0,0.0
26145,2,6145,[318 427 496 357 257],796,5,27884,4.536934591604296,60.0,0.0
26146,2,6146,[748 202 111 245 294],450,5,27889,4.537009923539938,0.0,0.0
26147,2,6147,[ 56  28 194 300 135],450,4,27893,4.536922576447625,0.0,0.0
26148,2,6148,[125 202  71 194  88],798,2,27895,4.53651000162628,0.0,0.0
26149,2,6149,[211 222  64 215  97],151,4,27899,4.536422764227642,20.0,0.0
26150,2,6150,[742  15  79 313 228],655,2,27901,4.536010404812226,0.0,0.0
26151,2,6151,[318 427 496 357 257],796,5,27906,4.536085825747724,60.0,0.0
26152,2,6152,[318 427 496 357 257],796,5,27911,4.536161222168048,60.0,0.0
26153,2,6153,[318 427 496 357 257],796,5,27916,4.536236594085148,60.0,0.0
26154,2,6154,[318 427 496 357 257],330,5,27921,4.5363119415109665,60.0,0.0
26155,2,6155,[496 302   1  50 427],389,5,27926,4.53638726445744,40.0,20.0
26156,2,6156,[318 427 496 357 257],330,5,27931,4.536462562936495,60.0,0.0
26157,2,6157,[318 427 496 357 257],716,5,27936,4.5365378369600515,60.0,0.0
26158,2,6158,[318 427 496 357 257],796,5,27941,4.536613086540023,60.0,0.0
26159,2,6159,[318 427 496 357 257],330,5,27946,4.536688311688311,60.0,0.0
26160,2,6160,[318 427 496 357 257],716,5,27951,4.536763512416815,60.0,0.0
26161,2,6161,[318 427 496 357 257],716,5,27956,4.536838688737423,60.0,0.0
26162,2,6162,[318 427 496 357 257],330,5,27961,4.536913840662015,60.0,0.0
26163,2,6163,[318 427 496 357 257],330,5,27966,4.536988968202466,60.0,0.0
26164,2,6164,[318 427 496 357 257],796,5,27971,4.537064071370641,60.0,0.0
26165,2,6165,[318 427 496 357 257],716,5,27976,4.5371391501783975,60.0,0.0
26166,2,6166,[496 179 273 185 546],236,2,27978,4.536727744446246,20.0,0.0
26167,2,6167,[318 427 496 357 257],330,5,27983,4.536802853437095,60.0,0.0
26168,2,6168,[318 427 496 357 257],716,5,27988,4.536877938077485,60.0,0.0
26169,2,6169,[318 427 496 357 257],796,5,27993,4.536952998379254,60.0,0.0
26170,2,6170,[318 427 496 357 257],716,5,27998,4.537028034354238,60.0,0.0
26171,2,6171,[180 588  82 742  89],796,2,28000,4.536616979909268,0.0,0.0
26172,2,6172,[318 427 496 357 257],796,5,28005,4.536692046006804,60.0,0.0
26173,2,6173,[318 427 496 357 257],330,5,28010,4.536767087787496,60.0,0.0
26174,2,6174,[313  56 174 210 161],280,2,28012,4.5363562753036435,0.0,0.0
26175,2,6175,[318 427 496 357 257],796,5,28017,4.536431347150259,60.0,0.0
26176,2,6176,[318 427 496 357 257],796,5,28022,4.536506394689979,60.0,0.0
26177,2,6177,[318 427 496 357 257],330,5,28027,4.536581417934607,60.0,0.0
26178,2,6178,[318 427 496 357 257],796,5,28032,4.536656416895938,60.0,0.0
26179,2,6179,[318 427 496 357 257],330,5,28037,4.536731391585761,60.0,0.0
26180,2,6180,[318 427 496 357 257],796,5,28042,4.536806342015855,60.0,0.0
26181,2,6181,[318 427 496 357 257],796,5,28047,4.536881268197994,60.0,0.0
26182,2,6182,[435 748 546 210 185],151,3,28050,4.536632702571567,0.0,0.0
26183,2,6183,[318 427 496 357 257],330,5,28055,4.536707632600259,60.0,0.0
26184,2,6184,[176 301 483 238 191],655,2,28057,4.536297493936944,0.0,0.0
26185,2,6185,[318 427 496 357 257],716,5,28062,4.536372453928225,60.0,0.0
26186,2,6186,[435  88 269 328 471],450,5,28067,4.536447389688056,0.0,0.0
26187,2,6187,[318 427 496 357 257],716,5,28072,4.5365223012281835,60.0,0.0
26188,2,6188,[318 427 496 357 257],716,5,28077,4.536597188560349,60.0,0.0
26189,2,6189,[ 28 471 328 302  50],450,5,28082,4.536672051696284,0.0,20.0
26190,2,6190,[318 427 496 357 257],716,5,28087,4.536746890647715,60.0,0.0
26191,2,6191,[318 427 496 357 257],716,5,28092,4.536821705426356,60.0,0.0
26192,2,6192,[210  69 286 546 196],236,3,28095,4.536573550783142,0.0,20.0
26193,2,6193,[125 286 257   8 234],655,0,28095,4.535841136583791,0.0,20.0
26194,2,6194,[318 427 496 357 257],796,5,28100,4.53591606133979,60.0,0.0
26195,2,6195,[318 427 496 357 257],716,5,28105,4.53599096191091,60.0,0.0
26196,2,6196,[318 427 496 357 257],716,5,28110,4.5360658383088595,60.0,0.0
26197,2,6197,[318 427 496 357 257],330,5,28115,4.536140690545337,60.0,0.0
26198,2,6198,[ 12 135   1 210 238],457,5,28120,4.536215518632037,0.0,0.0
26199,2,6199,[318 427 496 357 257],796,5,28125,4.536290322580645,60.0,0.0
26200,2,6200,[318 427 496 357 257],716,5,28130,4.536365102402838,60.0,0.0
26201,2,6201,[318 427 496 357 257],716,5,28135,4.536439858110287,60.0,0.0
26202,2,6202,[318 427 496 357 257],716,5,28140,4.536514589714654,60.0,0.0
26203,2,6203,[427 196 125  98 588],796,5,28145,4.536589297227595,20.0,0.0
26204,2,6204,[318 427 496 357 257],330,5,28150,4.536663980660758,60.0,0.0
26205,2,6205,[318 427 496 357 257],796,5,28155,4.536738640025781,60.0,0.0
26206,2,6206,[318 427 496 357 257],330,5,28160,4.5368132753343,60.0,0.0
26207,2,6207,[318 427 496 357 257],716,5,28165,4.536887886597938,60.0,0.0
26208,2,6208,[294 357  98 127 132],796,4,28169,4.536801417297472,0.0,20.0
26209,2,6209,[117 181  97  11 228],655,0,28169,4.536070853462157,0.0,0.0
26210,2,6210,[318 427 496 357 257],330,5,28174,4.536145548220898,60.0,0.0
26211,2,6211,[194  28 269 423 210],796,2,28176,4.535737282678687,0.0,0.0
26212,2,6212,[111 183  89 568 191],450,5,28181,4.535812007081925,0.0,0.0
26213,2,6213,[318 427 496 357 257],716,5,28186,4.535886707434825,60.0,0.0
26214,2,6214,[ 71 423 175 100 195],23,3,28189,4.535639581657281,0.0,20.0
26215,2,6215,[125 181 185  82 357],457,5,28194,4.535714285714286,0.0,0.0
26216,2,6216,[318 427 496 357 257],330,5,28199,4.535788965739102,60.0,0.0
26217,2,6217,[ 12  22 215 258 202],457,5,28204,4.535863621743326,0.0,0.0
26218,2,6218,[318 427 496 357 257],796,5,28209,4.535938253738543,60.0,0.0
26219,2,6219,[318 427 496 357 257],716,5,28214,4.536012861736334,60.0,0.0
26220,2,6220,[318 427 496 357 257],330,5,28219,4.536087445748272,60.0,0.0
26221,2,6221,[318 427 496 357 257],716,5,28224,4.536162005785921,60.0,0.0
26222,2,6222,[318 427 496 357 257],796,5,28229,4.536236541860839,60.0,0.0
26223,2,6223,[597 286 216 588  79],450,5,28234,4.5363110539845755,0.0,20.0
26224,2,6224,[318 427 496 357 257],796,5,28239,4.5363855421686745,60.0,0.0
26225,2,6225,[318 427 496 357 257],716,5,28244,4.5364600064246705,60.0,0.0
26226,2,6226,[318 427 496 357 257],330,5,28249,4.536534446764092,60.0,0.0
26227,2,6227,[265 197 403 183 211],655,1,28250,4.535966602440591,0.0,0.0
26228,2,6228,[286  95 496   1  97],344,2,28252,4.535559479852304,20.0,20.0
26229,2,6229,[ 50 117 471   9 228],693,1,28253,4.534991974317817,0.0,20.0
26230,2,6230,[318 427 496 357 257],330,5,28258,4.535066602471513,60.0,0.0
26231,2,6231,[ 22 322 405 151 197],450,5,28263,4.535141206675225,0.0,0.0
26232,2,6232,[318 427 496 357 257],796,5,28268,4.535215786940478,60.0,0.0
26233,2,6233,[318 427 496 357 257],330,5,28273,4.535290343278794,60.0,0.0
26234,2,6234,[173 144  71  79 483],535,3,28276,4.53504410585405,0.0,0.0
26235,2,6235,[318 427 496 357 257],330,5,28281,4.535118665811417,60.0,0.0
26236,2,6236,[318 427 496 357 257],796,5,28286,4.535193201859869,60.0,0.0
26237,2,6237,[318 427 496 357 257],796,5,28291,4.535267714010901,60.0,0.0
26238,2,6238,[318 427 496 357 257],796,5,28296,4.535342202276006,60.0,0.0
26239,2,6239,[286 515 182 300  56],535,0,28296,4.5346153846153845,0.0,20.0
26240,2,6240,[603 183 175 111 238],655,2,28298,4.534209261336325,20.0,0.0
26241,2,6241,[597 153 268 235 210],269,1,28299,4.5336430631207945,0.0,0.0
26242,2,6242,[318 427 496 357 257],716,5,28304,4.533717763895563,60.0,0.0
26243,2,6243,[318 427 496 357 257],796,5,28309,4.533792440743113,60.0,0.0
26244,2,6244,[597 111  12 161 294],457,2,28311,4.533386709367494,0.0,0.0
26245,2,6245,[318 427 496 357 257],330,5,28316,4.533461415305796,60.0,0.0
26246,2,6246,[318 427 496 357 257],716,5,28321,4.533536097326717,60.0,0.0
26247,2,6247,[318 427 496 357 257],796,5,28326,4.5336107554417415,60.0,0.0
26248,2,6248,[151 100  28 176 427],450,5,28331,4.533685389662346,20.0,20.0
26249,2,6249,[174  64 289 328  88],236,3,28334,4.53344,20.0,0.0
26250,2,6250,[ 79 655 257 181  70],457,4,28338,4.5333546632538795,0.0,0.0
26251,2,6251,[318 427 496 357 257],330,5,28343,4.53342930262316,60.0,0.0
26252,2,6252,[257 265 135  64 282],716,3,28346,4.53318407164561,20.0,0.0
26253,2,6253,[318 427 496 357 257],716,5,28351,4.53325871442277,60.0,0.0
26254,2,6254,[318 427 496 357 257],716,5,28356,4.533333333333333,60.0,0.0
26255,2,6255,[318 427 496 357 257],716,5,28361,4.533407928388747,60.0,0.0
26256,2,6256,[318 427 496 357 257],796,5,28366,4.5334824996004475,60.0,0.0
26257,2,6257,[318 427 496 357 257],796,5,28371,4.533557046979865,60.0,0.0
26258,2,6258,[174 405 294 200 180],457,4,28375,4.533471800607126,0.0,0.0
26259,2,6259,[318 427 496 357 257],796,5,28380,4.533546325878595,60.0,0.0
26260,2,6260,[318 427 496 357 257],716,5,28385,4.533620827343875,60.0,0.0
26261,2,6261,[ 79 435  50   7  11],655,2,28387,4.5332162248482915,0.0,20.0
26262,2,6262,[318 427 496 357 257],330,5,28392,4.533290755229124,60.0,0.0
26263,2,6263,[318 427 496 357 257],716,5,28397,4.533365261813538,60.0,0.0
26264,2,6264,[318 427 496 357 257],796,5,28402,4.533439744612929,60.0,0.0
26265,2,6265,[318 427 496 357 257],330,5,28407,4.533514203638685,60.0,0.0
26266,2,6266,[318 427 496 357 257],796,5,28412,4.533588638902186,60.0,0.0
26267,2,6267,[318 427 496 357 257],716,5,28417,4.533663050414805,60.0,0.0
26268,2,6268,[268  12 194 405 181],503,3,28420,4.53341840803956,0.0,0.0
26269,2,6269,[318 427 496 357 257],716,5,28425,4.533492822966507,60.0,0.0
26270,2,6270,[318 427 496 357 257],716,5,28430,4.533567214160421,60.0,0.0
26271,2,6271,[318 427 496 357 257],330,5,28435,4.533641581632653,60.0,0.0
26272,2,6272,[318 427 496 357 257],330,5,28440,4.5337159253945485,60.0,0.0
26273,2,6273,[318 427 496 357 257],796,5,28445,4.5337902454574435,60.0,0.0
26274,2,6274,[ 88   4  70 117  28],504,3,28448,4.533545816733068,0.0,0.0
26275,2,6275,[ 28 238 118 185 197],716,4,28452,4.533460803059273,0.0,0.0
26276,2,6276,[318 427 496 357 257],330,5,28457,4.533535128245977,60.0,0.0
26277,2,6277,[318 427 496 357 257],796,5,28462,4.533609429754699,60.0,0.0
26278,2,6278,[318 427 496 357 257],716,5,28467,4.533683707596751,60.0,0.0
26279,2,6279,[435 655 313 258 427],655,2,28469,4.53328025477707,20.0,0.0
26280,2,6280,[318 427 496 357 257],716,5,28474,4.533354561375577,60.0,0.0
26281,2,6281,[318 427 496 357 257],330,5,28479,4.533428844317096,60.0,0.0
26282,2,6282,[318 427 496 357 257],796,5,28484,4.533503103612924,60.0,0.0
26283,2,6283,[318 427 496 357 257],330,5,28489,4.5335773392743475,60.0,0.0
26284,2,6284,[318 427 496 357 257],796,5,28494,4.533651551312649,60.0,0.0
26285,2,6285,[151  69 187 245 385],504,4,28498,4.5335666560610886,0.0,0.0
26286,2,6286,[318 427 496 357 257],330,5,28503,4.5336408461905515,60.0,0.0
26287,2,6287,[286  28 161 204  97],796,2,28505,4.533237913486005,0.0,20.0
26288,2,6288,[318 427 496 357 257],330,5,28510,4.5333121322944825,60.0,0.0
26289,2,6289,[318 427 496 357 257],716,5,28515,4.533386327503974,60.0,0.0
26290,2,6290,[ 22 121  12  88 237],256,5,28520,4.533460499125735,0.0,0.0
26291,2,6291,[318 427 496 357 257],716,5,28525,4.5335346471710105,60.0,0.0
26292,2,6292,[176  97  98  12 143],577,4,28529,4.5334498649292865,0.0,0.0
26293,2,6293,[318 427 496 357 257],330,5,28534,4.533523991102637,60.0,0.0
26294,2,6294,[318 427 496 357 257],716,5,28539,4.533598093725178,60.0,0.0
26295,2,6295,[318 427 496 357 257],716,5,28544,4.533672172808132,60.0,0.0
26296,2,6296,[318 427 496 357 257],330,5,28549,4.533746228362713,60.0,0.0
26297,2,6297,[318 427 496 357 257],796,5,28554,4.533820260400127,60.0,0.0
26298,2,6298,[ 70  96 132  98 357],344,4,28558,4.533735513573583,0.0,0.0
26299,2,6299,[318 427 496 357 257],796,5,28563,4.5338095238095235,60.0,0.0
26300,2,6300,[135 143  56 179  22],655,3,28566,4.533566100618949,0.0,0.0
26301,2,6301,[318 427 496 357 257],716,5,28571,4.533640114249445,60.0,0.0
26302,2,6302,[318 427 496 357 257],796,5,28576,4.533714104394733,60.0,0.0
26303,2,6303,[318 427 496 357 257],716,5,28581,4.53378807106599,60.0,0.0
26304,2,6304,[318 427 496 357 257],330,5,28586,4.533862014274385,60.0,0.0
26305,2,6305,[318 427 496 357 257],330,5,28591,4.533935934031081,60.0,0.0
26306,2,6306,[318 427 496 357 257],796,5,28596,4.534009830347233,60.0,0.0
26307,2,6307,[318 427 496 357 257],716,5,28601,4.534083703233988,60.0,0.0
26308,2,6308,[318 427 496 357 257],796,5,28606,4.534157552702489,60.0,0.0
26309,2,6309,[ 50 427 235  95 172],23,4,28610,4.5340729001584785,20.0,20.0
26310,2,6310,[318 427 496 357 257],330,5,28615,4.534146727935351,60.0,0.0
26311,2,6311,[318 427 496 357 257],330,5,28620,4.534220532319392,60.0,0.0
26312,2,6312,[318 427 496 357 257],330,5,28625,4.534294313321717,60.0,0.0
26313,2,6313,[237  89  96 273   4],796,4,28629,4.534209692746278,0.0,0.0
26314,2,6314,[318 427 496 357 257],796,5,28634,4.534283452098179,60.0,0.0
26315,2,6315,[318 427 496 357 257],716,5,28639,4.53435718809373,60.0,0.0
26316,2,6316,[318 427 496 357 257],330,5,28644,4.534430900744024,60.0,0.0
26317,2,6317,[318 427 496 357 257],796,5,28649,4.534504590060146,60.0,0.0
26318,2,6318,[318 427 496 357 257],716,5,28654,4.534578256053173,60.0,0.0
26319,2,6319,[318 427 496 357 257],716,5,28659,4.534651898734177,60.0,0.0
26320,2,6320,[318 427 496 357 257],796,5,28664,4.5347255181142225,60.0,0.0
26321,2,6321,[357 195   1 275 483],457,5,28669,4.5347991142043655,0.0,20.0
26322,2,6322,[318 427 496 357 257],716,5,28674,4.534872687015657,60.0,0.0
26323,2,6323,[318 427 496 357 257],796,5,28679,4.53494623655914,60.0,0.0
26324,2,6324,[318 427 496 357 257],716,5,28684,4.53501976284585,60.0,0.0
26325,2,6325,[318 427 496 357 257],330,5,28689,4.535093265886816,60.0,0.0
26326,2,6326,[318 427 496 357 257],330,5,28694,4.535166745693061,60.0,0.0
26327,2,6327,[ 97 403 748 257 483],796,4,28698,4.535082174462706,0.0,0.0
26328,2,6328,[318 427 496 357 257],330,5,28703,4.5351556328013904,60.0,0.0
26329,2,6329,[135 204 318 294 273],401,2,28705,4.534755134281201,20.0,0.0
26330,2,6330,[318 427 496 357 257],330,5,28710,4.534828621070921,60.0,0.0
26331,2,6331,[135   9   4 286 175],18,3,28713,4.534586228679722,0.0,20.0
26332,2,6332,[318 427 496 357 257],716,5,28718,4.534659718932575,60.0,0.0
26333,2,6333,[318 427 496 357 257],796,5,28723,4.534733185980423,60.0,0.0
26334,2,6334,[318 427 496 357 257],330,5,28728,4.534806629834254,60.0,0.0
26335,2,6335,[318 427 496 357 257],796,5,28733,4.53488005050505,60.0,0.0
26336,2,6336,[318 427 496 357 257],330,5,28738,4.534953448003788,60.0,0.0
26337,2,6337,[318 427 496 357 257],716,5,28743,4.5350268223414325,60.0,0.0
26338,2,6338,[318 427 496 357 257],330,5,28748,4.535100173528948,60.0,0.0
26339,2,6339,[318 427 496 357 257],330,5,28753,4.535173501577287,60.0,0.0
26340,2,6340,[318 427 496 357 257],716,5,28758,4.535246806497398,60.0,0.0
26341,2,6341,[318 427 496 357 257],796,5,28763,4.535320088300221,60.0,0.0
26342,2,6342,[118 172 121 179 183],450,3,28766,4.535078038782911,0.0,0.0
26343,2,6343,[183 423 282 357 216],457,5,28771,4.53515132408575,0.0,0.0
26344,2,6344,[318 427 496 357 257],796,5,28776,4.535224586288416,60.0,0.0
26345,2,6345,[318 427 496 357 257],330,5,28781,4.535297825401828,60.0,0.0
26346,2,6346,[318 427 496 357 257],796,5,28786,4.5353710414369,60.0,0.0
26347,2,6347,[318 427 496 357 257],796,5,28791,4.535444234404537,60.0,0.0
26348,2,6348,[318 427 496 357 257],716,5,28796,4.53551740431564,60.0,0.0
26349,2,6349,[245 186 191 234  64],450,3,28799,4.535275590551181,20.0,0.0
26350,2,6350,[288  50 186  95 204],450,2,28801,4.5348763974177295,0.0,20.0
26351,2,6351,[318 427 496 357 257],796,5,28806,4.534949622166247,60.0,0.0
26352,2,6352,[318 427 496 357 257],716,5,28811,4.535022823862742,60.0,0.0
26353,2,6353,[172 328 282 435 175],655,1,28812,4.534466477809254,0.0,0.0
26354,2,6354,[318 427 496 357 257],796,5,28817,4.534539732494099,60.0,0.0
26355,2,6355,[318 427 496 357 257],716,5,28822,4.5346129641283826,60.0,0.0
26356,2,6356,[318 427 496 357 257],796,5,28827,4.534686172722982,60.0,0.0
26357,2,6357,[318 427 496 357 257],716,5,28832,4.53475935828877,60.0,0.0
26358,2,6358,[318 427 496 357 257],796,5,28837,4.534832520836609,60.0,0.0
26359,2,6359,[318 427 496 357 257],716,5,28842,4.534905660377358,60.0,0.0
26360,2,6360,[597 655 182 143 222],457,4,28846,4.534821568935702,0.0,0.0
26361,2,6361,[318 427 496 357 257],330,5,28851,4.5348946872052815,60.0,0.0
26362,2,6362,[318 427 496 357 257],796,5,28856,4.534967782492535,60.0,0.0
26363,2,6363,[318 427 496 357 257],330,5,28861,4.5350408548082966,60.0,0.0
26364,2,6364,[318 427 496 357 257],716,5,28866,4.535113904163394,60.0,0.0
26365,2,6365,[237 282  25 197 118],716,3,28869,4.534872761545712,0.0,0.0
26366,2,6366,[318 427 496 357 257],796,5,28874,4.534945814355269,60.0,0.0
26367,2,6367,[318 427 496 357 257],796,5,28879,4.5350188442211055,60.0,0.0
26368,2,6368,[318 427 496 357 257],330,5,28884,4.535091851154028,60.0,0.0
26369,2,6369,[318 427 496 357 257],796,5,28889,4.535164835164835,60.0,0.0
26370,2,6370,[318 427 496 357 257],796,5,28894,4.535237796264322,60.0,0.0
26371,2,6371,[318 427 496 357 257],796,5,28899,4.535310734463277,60.0,0.0
26372,2,6372,[168 182 197   8  69],269,3,28902,4.53506982582771,0.0,0.0
26373,2,6373,[318 427 496 357 257],716,5,28907,4.53514276749294,60.0,0.0
26374,2,6374,[318 427 496 357 257],716,5,28912,4.53521568627451,60.0,0.0
26375,2,6375,[318 427 496 357 257],796,5,28917,4.5352885821831865,60.0,0.0
26376,2,6376,[318 427 496 357 257],330,5,28922,4.535361455229732,60.0,0.0
26377,2,6377,[318 427 496 357 257],796,5,28927,4.535434305424898,60.0,0.0
26378,2,6378,[318 427 496 357 257],330,5,28932,4.535507132779433,60.0,0.0
26379,2,6379,[318 427 496 357 257],716,5,28937,4.5355799373040755,60.0,0.0
26380,2,6380,[ 11 216 153 300 176],450,5,28942,4.535652719009559,0.0,0.0
26381,2,6381,[318 427 496 357 257],796,5,28947,4.535725477906612,60.0,0.0
26382,2,6382,[151 187 185 385  88],450,5,28952,4.535798214005953,0.0,0.0
26383,2,6383,[318 427 496 357 257],796,5,28957,4.535870927318296,60.0,0.0
26384,2,6384,[318 427 496 357 257],330,5,28962,4.535943617854346,60.0,0.0
26385,2,6385,[742 313 333  88 195],693,2,28964,4.53554650798622,0.0,0.0
26386,2,6386,[471 268 403 282 228],655,0,28964,4.5348363864098955,0.0,0.0
26387,2,6387,[204 211 245  88 328],796,3,28967,4.534596117720726,0.0,0.0
26388,2,6388,[508 235  22 176 132],269,2,28969,4.534199405227735,0.0,0.0
26389,2,6389,[318 427 496 357 257],716,5,28974,4.534272300469484,60.0,0.0
26390,2,6390,[318 427 496 357 257],796,5,28979,4.53434517289939,60.0,0.0
26391,2,6391,[318 427 496 357 257],796,5,28984,4.53441802252816,60.0,0.0
26392,2,6392,[318 427 496 357 257],796,5,28989,4.534490849366494,60.0,0.0
26393,2,6393,[161 288 183 238 182],655,2,28991,4.534094463559587,0.0,0.0
26394,2,6394,[318 427 496 357 257],716,5,28996,4.534167318217357,60.0,0.0
26395,2,6395,[100 111  71 197 191],878,4,29000,4.534083802376485,0.0,20.0
26396,2,6396,[121 187 194 180 182],72,4,29004,4.534000312646553,0.0,0.0
26397,2,6397,[318 385 204 181 125],786,5,29009,4.534073147858706,20.0,0.0
26398,2,6398,[318 427 496 357 257],330,5,29014,4.534145960306298,60.0,0.0
26399,2,6399,[318 427 496 357 257],716,5,29019,4.53421875,60.0,0.0
26400,2,6400,[181  82 286 196  15],796,3,29022,4.533979065770973,0.0,20.0
26401,2,6401,[423 322   4 258 269],629,2,29024,4.53358325523274,0.0,0.0
26402,2,6402,[318 427 496 357 257],796,5,29029,4.533656098703733,60.0,0.0
26403,2,6403,[318 427 496 357 257],330,5,29034,4.533728919425359,60.0,0.0
26404,2,6404,[318 427 496 357 257],716,5,29039,4.5338017174082745,60.0,0.0
26405,2,6405,[318 427 496 357 257],330,5,29044,4.533874492663128,60.0,0.0
26406,2,6406,[318 427 496 357 257],330,5,29049,4.533947245200562,60.0,0.0
26407,2,6407,[318 427 496 357 257],330,5,29054,4.534019975031211,60.0,0.0
26408,2,6408,[318 427 496 357 257],330,5,29059,4.534092682165705,60.0,0.0
26409,2,6409,[318 427 496 357 257],716,5,29064,4.534165366614665,60.0,0.0
26410,2,6410,[210 333 271 117 423],629,5,29069,4.534238028388707,0.0,0.0
26411,2,6411,[318 427 496 357 257],330,5,29074,4.53431066749844,60.0,0.0
26412,2,6412,[318 427 496 357 257],330,5,29079,4.534383283954467,60.0,0.0
26413,2,6413,[318 427 496 357 257],716,5,29084,4.534455877767384,60.0,0.0
26414,2,6414,[318 427 496 357 257],330,5,29089,4.534528448947778,60.0,0.0
26415,2,6415,[318 427 496 357 257],796,5,29094,4.534600997506234,60.0,0.0
26416,2,6416,[318 427 496 357 257],796,5,29099,4.5346735234533275,60.0,0.0
26417,2,6417,[318 427 496 357 257],796,5,29104,4.534746026799626,60.0,0.0
26418,2,6418,[  4 202   1 191 132],716,4,29108,4.534662720049852,0.0,0.0
26419,2,6419,[318 427 496 357 257],796,5,29113,4.534735202492212,60.0,0.0
26420,2,6420,[216   1 228   9 597],344,3,29116,4.534496184394954,0.0,0.0
26421,2,6421,[318 427 496 357 257],330,5,29121,4.534568670196201,60.0,0.0
26422,2,6422,[318 427 496 357 257],716,5,29126,4.534641133426748,60.0,0.0
26423,2,6423,[318 427 496 357 257],796,5,29131,4.534713574097136,60.0,0.0
26424,2,6424,[318 427 496 357 257],330,5,29136,4.534785992217899,60.0,0.0
26425,2,6425,[357 118 301 258 194],796,4,29140,4.534702769996888,0.0,0.0
26426,2,6426,[318 427 496 357 257],796,5,29145,4.534775167263109,60.0,0.0
26427,2,6427,[95  1 96 28 70],450,4,29149,4.534691972619789,0.0,0.0
26428,2,6428,[318 427 496 357 257],796,5,29154,4.534764349043397,60.0,0.0
26429,2,6429,[318 427 496 357 257],330,5,29159,4.534836702954899,60.0,0.0
26430,2,6430,[318 427 496 357 257],330,5,29164,4.534909034364795,60.0,0.0
26431,2,6431,[318 427 496 357 257],796,5,29169,4.534981343283582,60.0,0.0
26432,2,6432,[318 427 496 357 257],330,5,29174,4.535053629721747,60.0,0.0
26433,2,6433,[318 427 496 357 257],716,5,29179,4.535125893689773,60.0,0.0
26434,2,6434,[318 427 496 357 257],330,5,29184,4.535198135198136,60.0,0.0
26435,2,6435,[318 427 496 357 257],716,5,29189,4.535270354257302,60.0,0.0
26436,2,6436,[318 427 496 357 257],330,5,29194,4.535342550877738,60.0,0.0
26437,2,6437,[318 427 496 357 257],330,5,29199,4.535414725069898,60.0,0.0
26438,2,6438,[318 427 496 357 257],716,5,29204,4.535486876844231,60.0,0.0
26439,2,6439,[318 427 496 357 257],716,5,29209,4.53555900621118,60.0,0.0
26440,2,6440,[318 427 496 357 257],330,5,29214,4.535631113181183,60.0,0.0
26441,2,6441,[275 143 187 333 546],236,2,29216,4.535237503880782,0.0,20.0
26442,2,6442,[318 427 496 357 257],330,5,29221,4.53530963836722,60.0,0.0
26443,2,6443,[318 427 496 357 257],796,5,29226,4.535381750465549,60.0,0.0
26444,2,6444,[ 97 210  69 204  25],450,3,29229,4.535143522110163,0.0,0.0
26445,2,6445,[318 427 496 357 257],796,5,29234,4.535215637604716,60.0,0.0
26446,2,6446,[318 427 496 357 257],330,5,29239,4.53528773072747,60.0,0.0
26447,2,6447,[318 427 496 357 257],330,5,29244,4.535359801488834,60.0,0.0
26448,2,6448,[318 427 496 357 257],796,5,29249,4.535431849899209,60.0,0.0
26449,2,6449,[318 427 496 357 257],716,5,29254,4.535503875968992,60.0,0.0
26450,2,6450,[318 427 496 357 257],330,5,29259,4.535575879708572,60.0,0.0
26451,2,6451,[215 597 275 269 202],450,5,29264,4.535647861128332,0.0,20.0
26452,2,6452,[318 427 496 357 257],330,5,29269,4.535719820238649,60.0,0.0
26453,2,6453,[318 427 496 357 257],330,5,29274,4.535791757049892,60.0,0.0
26454,2,6454,[294  11 508 210 318],280,2,29276,4.535398915569326,20.0,0.0
26455,2,6455,[318 427 496 357 257],796,5,29281,4.535470879801735,60.0,0.0
26456,2,6456,[318 427 496 357 257],330,5,29286,4.535542821743844,60.0,0.0
26457,2,6457,[318 427 496 357 257],330,5,29291,4.535614741406008,60.0,0.0
26458,2,6458,[318 427 496 357 257],796,5,29296,4.535686638798576,60.0,0.0
26459,2,6459,[318 427 496 357 257],330,5,29301,4.535758513931889,60.0,0.0
26460,2,6460,[216   1 174 228 194],577,4,29305,4.53567559201362,0.0,0.0
26461,2,6461,[318 427 496 357 257],330,5,29310,4.535747446610956,60.0,0.0
26462,2,6462,[318 427 496 357 257],796,5,29315,4.535819278972613,60.0,0.0
26463,2,6463,[127  28 182 275 215],450,5,29320,4.535891089108911,0.0,40.0
26464,2,6464,[318 427 496 357 257],796,5,29325,4.535962877030163,60.0,0.0
26465,2,6465,[318 427 496 357 257],330,5,29330,4.536034642746675,60.0,0.0
26466,2,6466,[318 427 496 357 257],796,5,29335,4.536106386268749,60.0,0.0
26467,2,6467,[275 151 300 237 187],716,4,29339,4.536023500309215,0.0,20.0
26468,2,6468,[318 427 496 357 257],716,5,29344,4.536095223373009,60.0,0.0
26469,2,6469,[318 427 496 357 257],716,5,29349,4.536166924265842,60.0,0.0
26470,2,6470,[318 427 496 357 257],796,5,29354,4.536238602997991,60.0,0.0
26471,2,6471,[318 427 496 357 257],330,5,29359,4.536310259579728,60.0,0.0
26472,2,6472,[318 427 496 357 257],716,5,29364,4.53638189402132,60.0,0.0
26473,2,6473,[202 182 195 216 132],269,2,29366,4.535990114303368,0.0,0.0
26474,2,6474,[318 427 496 357 257],796,5,29371,4.536061776061776,60.0,0.0
26475,2,6475,[143 286 405 216 161],796,4,29375,4.535978999382335,0.0,20.0
26476,2,6476,[318 427 496 357 257],330,5,29380,4.536050640728733,60.0,0.0
26477,2,6477,[318 427 496 357 257],716,5,29385,4.536122259956777,60.0,0.0
26478,2,6478,[228 183 215 496  82],716,4,29389,4.5360395122704125,20.0,0.0
26479,2,6479,[318 427 496 357 257],796,5,29394,4.536111111111111,60.0,0.0
26480,2,6480,[318 427 496 357 257],716,5,29399,4.536182687856813,60.0,0.0
26481,2,6481,[318 427 496 357 257],330,5,29404,4.5362542425177415,60.0,0.0
26482,2,6482,[318 427 496 357 257],330,5,29409,4.536325775104118,60.0,0.0
26483,2,6483,[186 204  56 483 143],457,5,29414,4.5363972856261565,0.0,0.0
26484,2,6484,[318 427 496 357 257],796,5,29419,4.536468774094063,60.0,0.0
26485,2,6485,[318 427 496 357 257],330,5,29424,4.536540240518039,60.0,0.0
26486,2,6486,[403 175 423 202 191],269,3,29427,4.536303375982735,0.0,0.0
26487,2,6487,[318 427 496 357 257],716,5,29432,4.536374845869297,60.0,0.0
26488,2,6488,[318 427 496 357 257],796,5,29437,4.536446293727847,60.0,0.0
26489,2,6489,[127 496   7  22 196],269,2,29439,4.536055469953775,20.0,20.0
26490,2,6490,[318 427 496 357 257],716,5,29444,4.53612694500077,60.0,0.0
26491,2,6491,[197   8  82 100 403],796,2,29446,4.53573629081947,0.0,20.0
26492,2,6492,[ 22 117 172 210  79],655,2,29448,4.535345756969043,0.0,0.0
26493,2,6493,[318 427 496 357 257],716,5,29453,4.53541730828457,60.0,0.0
26494,2,6494,[318 427 496 357 257],716,5,29458,4.535488837567359,60.0,0.0
26495,2,6495,[318 427 496 357 257],716,5,29463,4.535560344827586,60.0,0.0
26496,2,6496,[318 427 496 357 257],330,5,29468,4.5356318300754195,60.0,0.0
26497,2,6497,[318 427 496 357 257],796,5,29473,4.5357032933210215,60.0,0.0
26498,2,6498,[318 427 496 357 257],796,5,29478,4.53577473457455,60.0,0.0
26499,2,6499,[742 174 202 294 204],504,2,29480,4.535384615384616,0.0,0.0
26500,2,6500,[318 427 496 357 257],716,5,29485,4.535456083679434,60.0,0.0
26501,2,6501,[318 427 496 357 257],796,5,29490,4.535527529990772,60.0,0.0
26502,2,6502,[257 197 357 508 161],401,2,29492,4.535137628786714,0.0,0.0
26503,2,6503,[ 69 655 300 100 181],151,4,29496,4.535055350553505,0.0,20.0
26504,2,6504,[318 427 496 357 257],716,5,29501,4.535126825518832,60.0,0.0
26505,2,6505,[318 427 496 357 257],330,5,29506,4.5351982785121425,60.0,0.0
26506,2,6506,[282 357 588 234 385],450,4,29510,4.535116028891962,0.0,0.0
26507,2,6507,[100 179 289 191   7],296,4,29514,4.535033804548248,0.0,20.0
26508,2,6508,[318 427 496 357 257],330,5,29519,4.535105238899985,60.0,0.0
26509,2,6509,[318 427 496 357 257],796,5,29524,4.535176651305684,60.0,0.0
26510,2,6510,[318 427 496 357 257],716,5,29529,4.535248041775457,60.0,0.0
26511,2,6511,[211 322 117 271 127],796,3,29532,4.535012285012285,0.0,20.0
26512,2,6512,[318 427 496 357 257],716,5,29537,4.535083678796254,60.0,0.0
26513,2,6513,[  9 216   1 118  56],796,3,29540,4.534848019649985,0.0,0.0
26514,2,6514,[318 427 496 357 257],330,5,29545,4.534919416730622,60.0,0.0
26515,2,6515,[742 222 385 210 197],796,2,29547,4.5345303867403315,0.0,0.0
26516,2,6516,[318 427 496 357 257],716,5,29552,4.534601810649072,60.0,0.0
26517,2,6517,[187 276 228  98 211],296,5,29557,4.5346732126419145,0.0,0.0
26518,2,6518,[748 153 210  95  88],280,2,29559,4.534284399447768,0.0,0.0
26519,2,6519,[318 427 496 357 257],796,5,29564,4.534355828220859,60.0,0.0
26520,2,6520,[ 28 117 228 435 234],807,3,29567,4.534120533660482,0.0,0.0
26521,2,6521,[318 427 496 357 257],716,5,29572,4.534191965654707,60.0,0.0
26522,2,6522,[ 96  22  28 508 172],655,1,29573,4.53365016096888,0.0,0.0
26523,2,6523,[318 427 496 357 257],330,5,29578,4.5337216431637035,60.0,0.0
26524,2,6524,[318 427 496 357 257],796,5,29583,4.533793103448276,60.0,0.0
26525,2,6525,[318 427 496 357 257],330,5,29588,4.53386454183267,60.0,0.0
26526,2,6526,[258 603 508 435 185],655,2,29590,4.533476329094531,20.0,0.0
26527,2,6527,[318 427 496 357 257],796,5,29595,4.533547794117647,60.0,0.0
26528,2,6528,[318 427 496 357 257],330,5,29600,4.533619237249196,60.0,0.0
26529,2,6529,[318 427 496 357 257],796,5,29605,4.533690658499235,60.0,0.0
26530,2,6530,[  8 508 125 210  64],344,4,29609,4.533608941969071,20.0,0.0
26531,2,6531,[196 125 132 269 117],344,3,29612,4.533374157991426,0.0,0.0
26532,2,6532,[318 427 496 357 257],716,5,29617,4.533445583958366,60.0,0.0
26533,2,6533,[174 185 143  71  64],796,5,29622,4.533516988062442,20.0,0.0
26534,2,6534,[ 96 273 176 302 135],655,3,29625,4.533282325937261,0.0,0.0
26535,2,6535,[ 98 144 245 200 742],280,3,29628,4.533047735618115,0.0,0.0
26536,2,6536,[168 515   9 300 180],535,3,29631,4.532813217072051,0.0,0.0
26537,2,6537,[318 427 496 357 257],330,5,29636,4.532884674212298,60.0,0.0
26538,2,6538,[318 427 496 357 257],796,5,29641,4.532956109496865,60.0,0.0
26539,2,6539,[318 427 496 357 257],796,5,29646,4.53302752293578,60.0,0.0
26540,2,6540,[318 427 496 357 257],716,5,29651,4.533098914539061,60.0,0.0
26541,2,6541,[100  88 269 588 143],18,4,29655,4.53301742586365,0.0,20.0
26542,2,6542,[318 427 496 357 257],716,5,29660,4.533088797187834,60.0,0.0
26543,2,6543,[318 427 496 357 257],330,5,29665,4.533160146699267,60.0,0.0
26544,2,6544,[318 427 496 357 257],330,5,29670,4.533231474407945,60.0,0.0
26545,2,6545,[318 427 496 357 257],330,5,29675,4.5333027803238615,60.0,0.0
26546,2,6546,[318 427 496 357 257],330,5,29680,4.5333740644570035,60.0,0.0
26547,2,6547,[318 427 496 357 257],330,5,29685,4.533445326817349,60.0,0.0
26548,2,6548,[318 427 496 357 257],330,5,29690,4.533516567414872,60.0,0.0
26549,2,6549,[318 427 496 357 257],716,5,29695,4.533587786259542,60.0,0.0
26550,2,6550,[318 427 496 357 257],716,5,29700,4.533658983361319,60.0,0.0
26551,2,6551,[318 427 496 357 257],330,5,29705,4.533730158730159,60.0,0.0
26552,2,6552,[318 427 496 357 257],330,5,29710,4.533801312376011,60.0,0.0
26553,2,6553,[318 427 496 357 257],796,5,29715,4.533872444308819,60.0,0.0
26554,2,6554,[318 427 496 357 257],796,5,29720,4.53394355453852,60.0,0.0
26555,2,6555,[318 427 496 357 257],330,5,29725,4.534014643075046,60.0,0.0
26556,2,6556,[318 427 496 357 257],796,5,29730,4.534085709928321,60.0,0.0
26557,2,6557,[318 427 496 357 257],716,5,29735,4.534156755108265,60.0,0.0
26558,2,6558,[318 427 496 357 257],796,5,29740,4.53422777862479,60.0,0.0
26559,2,6559,[127 228 322 222 288],280,3,29743,4.533993902439025,0.0,20.0
26560,2,6560,[318 427 496 357 257],796,5,29748,4.534064929126657,60.0,0.0
26561,2,6561,[318 427 496 357 257],796,5,29753,4.534135934166413,60.0,0.0
26562,2,6562,[318 427 496 357 257],716,5,29758,4.534206917568185,60.0,0.0
26563,2,6563,[318 427 496 357 257],796,5,29763,4.5342778793418645,60.0,0.0
26564,2,6564,[ 70 357 174  71 302],401,3,29766,4.534044173648134,0.0,0.0
26565,2,6565,[318 427 496 357 257],796,5,29771,4.5341151385927505,60.0,0.0
26566,2,6566,[318 427 496 357 257],716,5,29776,4.5341860819247755,60.0,0.0
26567,2,6567,[403 603 168 180 322],450,5,29781,4.534257003654081,20.0,0.0
26568,2,6568,[546 568 597 180 282],796,4,29785,4.5341756736185115,0.0,0.0
26569,2,6569,[318 427 496 357 257],716,5,29790,4.534246575342466,60.0,0.0
26570,2,6570,[318 427 496 357 257],716,5,29795,4.534317455486227,60.0,0.0
26571,2,6571,[318 427 496 357 257],716,5,29800,4.534388314059647,60.0,0.0
26572,2,6572,[222   8 173 211 118],807,4,29804,4.53430701354024,0.0,0.0
26573,2,6573,[194 405 265   9 323],796,3,29807,4.534073623364771,0.0,0.0
26574,2,6574,[257 742 186 185  98],796,3,29810,4.53384030418251,0.0,0.0
26575,2,6575,[222  50 153 180 245],280,2,29812,4.53345498783455,0.0,20.0
26576,2,6576,[318 427 496 357 257],330,5,29817,4.533525923673407,60.0,0.0
26577,2,6577,[  8 496  98  50 204],577,5,29822,4.533596837944664,20.0,20.0
26578,2,6578,[ 95 204  25 176 318],716,4,29826,4.533515731874145,20.0,0.0
26579,2,6579,[117 403 265 603 173],796,5,29831,4.533586626139818,20.0,0.0
26580,2,6580,[318 427 496 357 257],796,5,29836,4.5336574988603555,60.0,0.0
26581,2,6581,[318 427 496 357 257],716,5,29841,4.533728350045579,60.0,0.0
26582,2,6582,[318 427 496 357 257],716,5,29846,4.533799179705301,60.0,0.0
26583,2,6583,[318 427 496 357 257],330,5,29851,4.533869987849331,60.0,0.0
26584,2,6584,[ 89 678 435  50 427],807,3,29854,4.533637053910402,20.0,20.0
26585,2,6585,[132 135 195 202 180],457,5,29859,4.533707865168539,0.0,0.0
26586,2,6586,[318 427 496 357 257],796,5,29864,4.53377865492637,60.0,0.0
26587,2,6587,[333  69 143 273 197],693,1,29865,4.533242258652095,0.0,0.0
26588,2,6588,[318 427 496 357 257],330,5,29870,4.533313097586888,60.0,0.0
26589,2,6589,[289 301 132  96  98],655,1,29871,4.532776934749621,0.0,0.0
26590,2,6590,[302  12 172 185  97],450,5,29876,4.532847822788651,0.0,0.0
26591,2,6591,[318 427 496 357 257],796,5,29881,4.532918689320389,60.0,0.0
26592,2,6592,[515  88 210 172 742],655,2,29883,4.532534506294555,0.0,0.0
26593,2,6593,[318 427 496 357 257],716,5,29888,4.532605398847437,60.0,0.0
26594,2,6594,[403 168 216 678 257],504,4,29892,4.532524639878696,0.0,0.0
26595,2,6595,[318 427 496 357 257],796,5,29897,4.532595512431777,60.0,0.0
26596,2,6596,[271  64 597 216 186],796,4,29901,4.5325147794452025,20.0,0.0
26597,2,6597,[471 597  97 197 202],457,4,29905,4.532434070930585,0.0,0.0
26598,2,6598,[423 275 655 265 161],716,4,29909,4.5323533868768,0.0,20.0
26599,2,6599,[318 427 496 357 257],716,5,29914,4.532424242424242,60.0,0.0
26600,2,6600,[318 427 496 357 257],796,5,29919,4.53249507650356,60.0,0.0
26601,2,6601,[258 515 288 742 135],655,2,29921,4.532111481369282,0.0,0.0
26602,2,6602,[286 588 282 235  71],280,4,29925,4.532030895047706,0.0,20.0
26603,2,6603,[546 235 222  71  98],23,2,29927,4.531647486371896,0.0,0.0
26604,2,6604,[318 427 496 357 257],716,5,29932,4.531718395155186,60.0,0.0
26605,2,6605,[195 385 181 127  22],807,3,29935,4.531486527399334,0.0,20.0
26606,2,6606,[318 427 496 357 257],330,5,29940,4.531557439079764,60.0,0.0
26607,2,6607,[318 427 496 357 257],330,5,29945,4.531628329297821,60.0,0.0
26608,2,6608,[ 89 427 515 186  15],18,4,29949,4.531547889241943,20.0,0.0
26609,2,6609,[238 276 111  97  56],18,4,29953,4.5314674735249625,0.0,0.0
26610,2,6610,[ 25   7  96 194 385],457,5,29958,4.531538345182272,0.0,0.0
26611,2,6611,[318 427 496 357 257],716,5,29963,4.531609195402299,60.0,0.0
26612,2,6612,[423 168 185 200 211],504,5,29968,4.531680024194768,0.0,0.0
26613,2,6613,[318 427 496 357 257],796,5,29973,4.531750831569398,60.0,0.0
26614,2,6614,[318 427 496 357 257],330,5,29978,4.531821617535903,60.0,0.0
26615,2,6615,[245 210 121 185  79],796,3,29981,4.531590084643289,0.0,0.0
26616,2,6616,[318 427 496 357 257],796,5,29986,4.531660873507632,60.0,0.0
26617,2,6617,[318 427 496 357 257],330,5,29991,4.531731640979148,60.0,0.0
26618,2,6618,[318 427 496 357 257],330,5,29996,4.531802387067533,60.0,0.0
26619,2,6619,[318 427 496 357 257],330,5,30001,4.5318731117824775,60.0,0.0
26620,2,6620,[318 427 496 357 257],796,5,30006,4.5319438151336655,60.0,0.0
26621,2,6621,[496  95 294 132  69],577,5,30011,4.532014497130776,20.0,0.0
26622,2,6622,[318 427 496 357 257],330,5,30016,4.532085157783482,60.0,0.0
26623,2,6623,[318 427 496 357 257],796,5,30021,4.532155797101449,60.0,0.0
26624,2,6624,[318 427 496 357 257],330,5,30026,4.53222641509434,60.0,0.0
26625,2,6625,[318 427 496 357 257],796,5,30031,4.532297011771808,60.0,0.0
26626,2,6626,[282 215 238 328   1],655,0,30031,4.531613097932699,0.0,0.0
26627,2,6627,[ 89 200 286 265 216],655,3,30034,4.531382015691007,0.0,20.0
26628,2,6628,[318 427 496 357 257],716,5,30039,4.5314527077990645,60.0,0.0
26629,2,6629,[318 427 496 357 257],796,5,30044,4.531523378582202,60.0,0.0
26630,2,6630,[318 427 496 357 257],330,5,30049,4.531594028050068,60.0,0.0
26631,2,6631,[318 427 496 357 257],330,5,30054,4.531664656212304,60.0,0.0
26632,2,6632,[318 427 496 357 257],716,5,30059,4.531735263078547,60.0,0.0
26633,2,6633,[318 427 496 357 257],716,5,30064,4.5318058486584265,60.0,0.0
26634,2,6634,[318 427 496 357 257],716,5,30069,4.531876412961568,60.0,0.0
26635,2,6635,[318 427 496 357 257],330,5,30074,4.531946955997589,60.0,0.0
26636,2,6636,[  7   4 117 185 181],655,1,30075,4.531414795841495,0.0,0.0
26637,2,6637,[318 427 496 357 257],330,5,30080,4.531485387164809,60.0,0.0
26638,2,6638,[318 427 496 357 257],716,5,30085,4.531555957222473,60.0,0.0
26639,2,6639,[318 427 496 357 257],796,5,30090,4.531626506024097,60.0,0.0
26640,2,6640,[385 405  56  95 427],450,4,30094,4.531546453847312,20.0,0.0
26641,2,6641,[318 427 496 357 257],330,5,30099,4.531616982836495,60.0,0.0
26642,2,6642,[ 82  11 195 318 132],655,1,30100,4.531085353003161,20.0,0.0
26643,2,6643,[286 313 275 322  89],796,3,30103,4.5308549066827215,0.0,40.0
26644,2,6644,[318 427 496 357 257],716,5,30108,4.530925507900677,60.0,0.0
26645,2,6645,[318 427 496 357 257],330,5,30113,4.5309960878724045,60.0,0.0
26646,2,6646,[318 427 496 357 257],330,5,30118,4.531066646607492,60.0,0.0
26647,2,6647,[318 427 496 357 257],796,5,30123,4.531137184115524,60.0,0.0
26648,2,6648,[318 427 496 357 257],330,5,30128,4.5312077004060765,60.0,0.0
26649,2,6649,[318 427 496 357 257],330,5,30133,4.531278195488722,60.0,0.0
26650,2,6650,[173 245 215 168 174],796,4,30137,4.5311983160427,0.0,0.0
26651,2,6651,[318 427 496 357 257],330,5,30142,4.53126879134095,60.0,0.0
26652,2,6652,[143 357 196 204   4],18,2,30144,4.530888321058169,0.0,0.0
26653,2,6653,[282 186 210 118 121],450,1,30145,4.530357679591224,0.0,0.0
26654,2,6654,[181 238 180   1 172],457,5,30150,4.530428249436514,0.0,0.0
26655,2,6655,[318 427 496 357 257],330,5,30155,4.530498798076923,60.0,0.0
26656,2,6656,[ 89 172  95  22 144],807,5,30160,4.5305693255220065,0.0,0.0
26657,2,6657,[318 427 496 357 257],796,5,30165,4.530639831781316,60.0,0.0
26658,2,6658,[318 427 496 357 257],330,5,30170,4.530710316864394,60.0,0.0
26659,2,6659,[318 427 496 357 257],330,5,30175,4.5307807807807805,60.0,0.0
26660,2,6660,[185  97 196  28  11],11,4,30179,4.5307010959315415,0.0,0.0
26661,2,6661,[318 427 496 357 257],330,5,30184,4.530771540078055,60.0,0.0
26662,2,6662,[318 427 496 357 257],716,5,30189,4.530841963079694,60.0,0.0
26663,2,6663,[257  25 515 302  11],401,2,30191,4.53046218487395,0.0,0.0
26664,2,6664,[318 427 496 357 257],330,5,30196,4.530532633158289,60.0,0.0
26665,2,6665,[318 427 496 357 257],330,5,30201,4.5306030603060305,60.0,0.0
26666,2,6666,[318 427 496 357 257],716,5,30206,4.530673466326684,60.0,0.0
26667,2,6667,[  9  71 496 265 222],236,2,30208,4.530293941211758,20.0,0.0
26668,2,6668,[318 427 496 357 257],330,5,30213,4.530364372469635,60.0,0.0
26669,2,6669,[318 427 496 357 257],796,5,30218,4.530434782608696,60.0,0.0
26670,2,6670,[318 427 496 357 257],330,5,30223,4.530505171638435,60.0,0.0
26671,2,6671,[318 427 496 357 257],330,5,30228,4.530575539568345,60.0,0.0
26672,2,6672,[238  69 111  50  82],655,1,30229,4.530046455866926,0.0,20.0
26673,2,6673,[ 97 202   7 143 245],450,5,30234,4.530116871441415,0.0,0.0
26674,2,6674,[ 70 127 204 235  79],344,3,30237,4.529887640449438,0.0,20.0
26675,2,6675,[318 427 496 357 257],716,5,30242,4.529958058717795,60.0,0.0
26676,2,6676,[ 79  70 186  69 318],716,4,30246,4.529878688033548,20.0,0.0
26677,2,6677,[318 427 496 357 257],716,5,30251,4.52994908655286,60.0,0.0
26678,2,6678,[318 427 496 357 257],796,5,30256,4.530019463991615,60.0,0.0
26679,2,6679,[318 427 496 357 257],716,5,30261,4.530089820359281,60.0,0.0
26680,2,6680,[234   8 288 181 742],593,3,30264,4.529860799281544,0.0,0.0
26681,2,6681,[318 427 496 357 257],716,5,30269,4.5299311583358275,60.0,0.0
26682,2,6682,[ 98   8 197  22 222],655,1,30270,4.529402962741284,0.0,0.0
26683,2,6683,[318 427 496 357 257],716,5,30275,4.529473369239976,60.0,0.0
26684,2,6684,[318 427 496 357 257],330,5,30280,4.529543754674645,60.0,0.0
26685,2,6685,[318 427 496 357 257],796,5,30285,4.529614119054742,60.0,0.0
26686,2,6686,[318 427 496 357 257],330,5,30290,4.529684462389711,60.0,0.0
26687,2,6687,[318 427 496 357 257],796,5,30295,4.529754784688995,60.0,0.0
26688,2,6688,[318 427 496 357 257],330,5,30300,4.5298250859620275,60.0,0.0
26689,2,6689,[318 427 496 357 257],796,5,30305,4.529895366218236,60.0,0.0
26690,2,6690,[318 427 496 357 257],796,5,30310,4.529965625467045,60.0,0.0
26691,2,6691,[318 427 496 357 257],330,5,30315,4.530035863717872,60.0,0.0
26692,2,6692,[ 89 161 121 118  11],256,5,30320,4.530106080980128,0.0,0.0
26693,2,6693,[508 187 289 125 181],655,1,30321,4.5295787272184045,0.0,0.0
26694,2,6694,[173  56 180  79  97],716,4,30325,4.529499626587005,0.0,0.0
26695,2,6695,[172 748 185 655 197],450,5,30330,4.529569892473118,0.0,0.0
26696,2,6696,[186 273  69 181 588],450,3,30333,4.529341496192325,0.0,0.0
26697,2,6697,[151 174  98 234 186],504,3,30336,4.529113168109884,0.0,0.0
26698,2,6698,[318 427 496 357 257],716,5,30341,4.529183460217943,60.0,0.0
26699,2,6699,[318 427 496 357 257],330,5,30346,4.5292537313432835,60.0,0.0
26700,2,6700,[258 301 182  71 222],796,4,30350,4.529174750037308,0.0,0.0
26701,2,6701,[318 427 496 357 257],796,5,30355,4.529245001492092,60.0,0.0
26702,2,6702,[318 427 496 357 257],796,5,30360,4.529315231985678,60.0,0.0
26703,2,6703,[ 25 597 742 197 127],450,4,30364,4.529236276849642,0.0,20.0
26704,2,6704,[318 427 496 357 257],796,5,30369,4.52930648769575,60.0,0.0
26705,2,6705,[318 427 496 357 257],330,5,30374,4.529376677602147,60.0,0.0
26706,2,6706,[ 28  71 151 222  79],807,5,30379,4.529446846578202,0.0,0.0
26707,2,6707,[118  89 210 195 471],655,1,30380,4.52892069171139,0.0,0.0
26708,2,6708,[318 427 496 357 257],716,5,30385,4.528990907735877,60.0,0.0
26709,2,6709,[318 427 496 357 257],796,5,30390,4.529061102831594,60.0,0.0
26710,2,6710,[282 161 172  12  64],655,2,30392,4.528684249739234,20.0,0.0
26711,2,6711,[318 427 496 357 257],716,5,30397,4.528754469606675,60.0,0.0
26712,2,6712,[  7 471 222 144 196],450,4,30401,4.528675703858186,0.0,0.0
26713,2,6713,[318 427 496 357 257],330,5,30406,4.528745904081025,60.0,0.0
26714,2,6714,[655 222   9  98  25],72,4,30410,4.528667163067759,0.0,0.0
26715,2,6715,[318 427 496 357 257],330,5,30415,4.528737343656939,60.0,0.0
26716,2,6716,[318 427 496 357 257],330,5,30420,4.52880750334971,60.0,0.0
26717,2,6717,[318 427 496 357 257],716,5,30425,4.528877642155403,60.0,0.0
26718,2,6718,[173  96 153 328 655],796,4,30429,4.528798928411966,0.0,0.0
26719,2,6719,[275 300 187  95 143],389,2,30431,4.528422619047619,0.0,20.0
26720,2,6720,[742  28 135 235 151],457,4,30435,4.528343996429103,0.0,0.0
26721,2,6721,[318 427 496 357 257],330,5,30440,4.528414162451651,60.0,0.0
26722,2,6722,[318 427 496 357 257],796,5,30445,4.528484307600773,60.0,0.0
26723,2,6723,[318 427 496 357 257],716,5,30450,4.528554431885782,60.0,0.0
26724,2,6724,[318 427 496 357 257],330,5,30455,4.528624535315985,60.0,0.0
26725,2,6725,[318 427 496 357 257],796,5,30460,4.528694617900684,60.0,0.0
26726,2,6726,[655 127 196 238 204],655,1,30461,4.528170060948417,0.0,20.0
26727,2,6727,[318 427 496 357 257],330,5,30466,4.5282401902497025,60.0,0.0
26728,2,6728,[318 427 496 357 257],330,5,30471,4.528310298707089,60.0,0.0
26729,2,6729,[318 427 496 357 257],796,5,30476,4.528380386329866,60.0,0.0
26730,2,6730,[318 427 496 357 257],716,5,30481,4.528450453127322,60.0,0.0
26731,2,6731,[318 427 496 357 257],330,5,30486,4.528520499108734,60.0,0.0
26732,2,6732,[318 427 496 357 257],330,5,30491,4.528590524283381,60.0,0.0
26733,2,6733,[318 427 496 357 257],796,5,30496,4.528660528660529,60.0,0.0
26734,2,6734,[318 427 496 357 257],330,5,30501,4.528730512249443,60.0,0.0
26735,2,6735,[197 121 210 222 161],457,5,30506,4.528800475059382,0.0,0.0
26736,2,6736,[318 427 496 357 257],330,5,30511,4.528870417099599,60.0,0.0
26737,2,6737,[318 427 496 357 257],330,5,30516,4.528940338379341,60.0,0.0
26738,2,6738,[318 427 496 357 257],796,5,30521,4.5290102389078495,60.0,0.0
26739,2,6739,[318 427 496 357 257],716,5,30526,4.529080118694362,60.0,0.0
26740,2,6740,[318 427 496 357 257],796,5,30531,4.529149977748109,60.0,0.0
26741,2,6741,[318 427 496 357 257],716,5,30536,4.5292198160783155,60.0,0.0
26742,2,6742,[318 427 496 357 257],330,5,30541,4.5292896336942015,60.0,0.0
26743,2,6743,[318 427 496 357 257],716,5,30546,4.529359430604982,60.0,0.0
26744,2,6744,[318 427 496 357 257],716,5,30551,4.5294292068198665,60.0,0.0
26745,2,6745,[222  70 135 269 100],450,3,30554,4.529202490364661,0.0,20.0
26746,2,6746,[318 427 496 357 257],796,5,30559,4.529272269156662,60.0,0.0
26747,2,6747,[282  82 182  11 181],457,5,30564,4.529342027267338,0.0,0.0
26748,2,6748,[318 427 496 357 257],796,5,30569,4.529411764705882,60.0,0.0
26749,2,6749,[301 471  28  15 153],655,0,30569,4.528740740740741,0.0,0.0
26750,2,6750,[  1 168 173 385 180],450,5,30574,4.528810546585691,0.0,0.0
26751,2,6751,[318 427 496 357 257],716,5,30579,4.528880331753554,60.0,0.0
26752,2,6752,[318 427 496 357 257],330,5,30584,4.528950096253517,60.0,0.0
26753,2,6753,[ 56 318 143 210 195],716,4,30588,4.528871779686112,20.0,0.0
26754,2,6754,[ 79 125 182 176  25],655,2,30590,4.528497409326425,0.0,0.0
26755,2,6755,[ 25  28 121 153 258],504,4,30594,4.5284191829484906,0.0,0.0
26756,2,6756,[318 427 496 357 257],796,5,30599,4.528488974396922,60.0,0.0
26757,2,6757,[318 427 496 357 257],330,5,30604,4.528558745190885,60.0,0.0
26758,2,6758,[318 427 496 357 257],716,5,30609,4.5286284953395475,60.0,0.0
26759,2,6759,[318 427 496 357 257],330,5,30614,4.528698224852071,60.0,0.0
26760,2,6760,[318 427 496 357 257],330,5,30619,4.528767933737613,60.0,0.0
26761,2,6761,[318 427 496 357 257],796,5,30624,4.528837622005324,60.0,0.0
26762,2,6762,[216 357 508  96 742],344,4,30628,4.528759426290108,0.0,0.0
26763,2,6763,[ 11 423 182   8 196],655,1,30629,4.5282377291543465,0.0,0.0
26764,2,6764,[182 197 483 118  22],457,5,30634,4.528307464892831,0.0,0.0
26765,2,6765,[318 427 496 357 257],716,5,30639,4.528377180017736,60.0,0.0
26766,2,6766,[748 111 318  98 427],11,3,30642,4.528151322594946,40.0,0.0
26767,2,6767,[318 427 496 357 257],716,5,30647,4.528221040189125,60.0,0.0
26768,2,6768,[318 427 496 357 257],716,5,30652,4.528290737184222,60.0,0.0
26769,2,6769,[318 427 496 357 257],716,5,30657,4.528360413589365,60.0,0.0
26770,2,6770,[318 427 496 357 257],796,5,30662,4.528430069413676,60.0,0.0
26771,2,6771,[318 427 496 357 257],330,5,30667,4.528499704666273,60.0,0.0
26772,2,6772,[318 427 496 357 257],330,5,30672,4.528569319356268,60.0,0.0
26773,2,6773,[318 427 496 357 257],796,5,30677,4.528638913492767,60.0,0.0
26774,2,6774,[318 427 496 357 257],796,5,30682,4.528708487084871,60.0,0.0
26775,2,6775,[318 427 496 357 257],716,5,30687,4.528778040141677,60.0,0.0
26776,2,6776,[204  25 318 427 127],503,4,30691,4.528700014755792,40.0,20.0
26777,2,6777,[318 427 496 357 257],716,5,30696,4.528769548539392,60.0,0.0
26778,2,6778,[603 143 132 215 588],716,5,30701,4.528839061808526,20.0,0.0
26779,2,6779,[318 427 496 357 257],716,5,30706,4.528908554572271,60.0,0.0
26780,2,6780,[318 427 496 357 257],330,5,30711,4.528978026839699,60.0,0.0
26781,2,6781,[318 427 496 357 257],330,5,30716,4.529047478619876,60.0,0.0
26782,2,6782,[318 427 496 357 257],716,5,30721,4.529116909921863,60.0,0.0
26783,2,6783,[318 427 496 357 257],796,5,30726,4.529186320754717,60.0,0.0
26784,2,6784,[318 427 496 357 257],796,5,30731,4.529255711127487,60.0,0.0
26785,2,6785,[318 427 496 357 257],716,5,30736,4.529325081049219,60.0,0.0
26786,2,6786,[ 82  70 179 121 185],457,5,30741,4.529394430528953,0.0,0.0
26787,2,6787,[318 427 496 357 257],796,5,30746,4.529463759575722,60.0,0.0
26788,2,6788,[318 427 496 357 257],330,5,30751,4.529533068198557,60.0,0.0
26789,2,6789,[318 427 496 357 257],330,5,30756,4.52960235640648,60.0,0.0
26790,2,6790,[318 427 496 357 257],796,5,30761,4.529671624208511,60.0,0.0
26791,2,6791,[318 427 496 357 257],716,5,30766,4.529740871613663,60.0,0.0
26792,2,6792,[318 427 496 357 257],796,5,30771,4.529810098630944,60.0,0.0
26793,2,6793,[655 172   8 132 546],457,4,30775,4.529732116573447,0.0,0.0
26794,2,6794,[318 427 496 357 257],716,5,30780,4.529801324503311,60.0,0.0
26795,2,6795,[210 118  71  96 313],344,2,30782,4.529429075927016,0.0,0.0
26796,2,6796,[318 427 496 357 257],796,5,30787,4.529498308077093,60.0,0.0
26797,2,6797,[238 200 288 172 161],457,5,30792,4.529567519858782,0.0,0.0
26798,2,6798,[211 173 182 427 181],796,4,30796,4.5294896308280626,20.0,0.0
26799,2,6799,[318 427 496 357 257],796,5,30801,4.5295588235294115,60.0,0.0
26800,2,6800,[318 427 496 357 257],330,5,30806,4.529627995882958,60.0,0.0
26801,2,6801,[318 427 496 357 257],716,5,30811,4.529697147897677,60.0,0.0
26802,2,6802,[318 427 496 357 257],716,5,30816,4.529766279582537,60.0,0.0
26803,2,6803,[  7 655 125 197 200],450,4,30820,4.529688418577307,0.0,0.0
26804,2,6804,[318 427 496 357 257],330,5,30825,4.529757531227039,60.0,0.0
26805,2,6805,[318 427 496 357 257],330,5,30830,4.52982662356744,60.0,0.0
26806,2,6806,[318 427 496 357 257],330,5,30835,4.529895695607463,60.0,0.0
26807,2,6807,[318 427 496 357 257],330,5,30840,4.529964747356051,60.0,0.0
26808,2,6808,[318 427 496 357 257],330,5,30845,4.530033778822147,60.0,0.0
26809,2,6809,[318 427 496 357 257],716,5,30850,4.530102790014684,60.0,0.0
26810,2,6810,[318 403   1  88  70],457,5,30855,4.5301717809425925,20.0,0.0
26811,2,6811,[318 427 496 357 257],330,5,30860,4.530240751614797,60.0,0.0
26812,2,6812,[318 427 496 357 257],330,5,30865,4.530309702040217,60.0,0.0
26813,2,6813,[318 427 496 357 257],330,5,30870,4.530378632227766,60.0,0.0
26814,2,6814,[318 427 496 357 257],716,5,30875,4.530447542186353,60.0,0.0
26815,2,6815,[318 427 496 357 257],796,5,30880,4.530516431924883,60.0,0.0
26816,2,6816,[318 427 496 357 257],330,5,30885,4.530585301452252,60.0,0.0
26817,2,6817,[318 427 496 357 257],330,5,30890,4.530654150777354,60.0,0.0
26818,2,6818,[318 427 496 357 257],796,5,30895,4.530722979909077,60.0,0.0
26819,2,6819,[318 427 496 357 257],330,5,30900,4.530791788856305,60.0,0.0
26820,2,6820,[318 427 496 357 257],330,5,30905,4.530860577627914,60.0,0.0
26821,2,6821,[318 427 496 357 257],716,5,30910,4.530929346232776,60.0,0.0
26822,2,6822,[318 427 496 357 257],330,5,30915,4.5309980946797594,60.0,0.0
26823,2,6823,[318 427 496 357 257],796,5,30920,4.531066822977726,60.0,0.0
26824,2,6824,[318 427 496 357 257],716,5,30925,4.531135531135531,60.0,0.0
26825,2,6825,[318 427 496 357 257],716,5,30930,4.531204219162028,60.0,0.0
26826,2,6826,[135 127 288 153 269],629,4,30934,4.531126409843269,0.0,20.0
26827,2,6827,[318 427 496 357 257],796,5,30939,4.531195079086116,60.0,0.0
26828,2,6828,[318 427 496 357 257],716,5,30944,4.531263728217894,60.0,0.0
26829,2,6829,[235 175 135 144  11],457,4,30948,4.531185944363104,0.0,0.0
26830,2,6830,[318 427 496 357 257],796,5,30953,4.531254574732835,60.0,0.0
26831,2,6831,[318 427 496 357 257],796,5,30958,4.5313231850117095,60.0,0.0
26832,2,6832,[742 300 187 603 588],796,4,30962,4.531245426606176,20.0,0.0
26833,2,6833,[318 427 496 357 257],796,5,30967,4.531314018144571,60.0,0.0
26834,2,6834,[318 427 496 357 257],796,5,30972,4.5313825896122895,60.0,0.0
26835,2,6835,[483 153 215 286 181],535,4,30976,4.53130485664131,0.0,20.0
26836,2,6836,[318 427 496 357 257],796,5,30981,4.531373409390083,60.0,0.0
26837,2,6837,[318 427 496 357 257],716,5,30986,4.53144194208833,60.0,0.0
26838,2,6838,[318 427 496 357 257],716,5,30991,4.531510454744846,60.0,0.0
26839,2,6839,[125 173 405 121 132],577,4,30995,4.531432748538012,0.0,0.0
26840,2,6840,[318 427 496 357 257],716,5,31000,4.531501242508405,60.0,0.0
26841,2,6841,[318 427 496 357 257],716,5,31005,4.531569716457176,60.0,0.0
26842,2,6842,[318 427 496 357 257],716,5,31010,4.531638170393102,60.0,0.0
26843,2,6843,[318 427 496 357 257],330,5,31015,4.531706604324956,60.0,0.0
26844,2,6844,[318 427 496 357 257],330,5,31020,4.531775018261505,60.0,0.0
26845,2,6845,[318 427 496 357 257],796,5,31025,4.5318434122115105,60.0,0.0
26846,2,6846,[318 427 496 357 257],796,5,31030,4.53191178618373,60.0,0.0
26847,2,6847,[181   4 135 405  50],280,1,31031,4.531396028037383,0.0,20.0
26848,2,6848,[318 427 496 357 257],330,5,31036,4.531464447364579,60.0,0.0
26849,2,6849,[161 245  70 202 288],280,3,31039,4.531240875912409,0.0,0.0
26850,2,6850,[318 427 496 357 257],796,5,31044,4.531309297912713,60.0,0.0
26851,2,6851,[318 427 496 357 257],330,5,31049,4.531377699941623,60.0,0.0
26852,2,6852,[318 427 496 357 257],796,5,31054,4.5314460820078795,60.0,0.0
26853,2,6853,[318 427 496 357 257],796,5,31059,4.531514444120222,60.0,0.0
26854,2,6854,[135 127 100 216 181],280,3,31062,4.53129102844639,0.0,40.0
26855,2,6855,[318 427 496 357 257],796,5,31067,4.531359393232205,60.0,0.0
26856,2,6856,[318 427 496 357 257],796,5,31072,4.531427738077877,60.0,0.0
26857,2,6857,[318 427 496 357 257],796,5,31077,4.531496062992126,60.0,0.0
26858,2,6858,[318 427 496 357 257],330,5,31082,4.5315643679836715,60.0,0.0
26859,2,6859,[318 427 496 357 257],716,5,31087,4.531632653061225,60.0,0.0
26860,2,6860,[318 427 496 357 257],796,5,31092,4.5317009182334935,60.0,0.0
26861,2,6861,[318 427 496 357 257],330,5,31097,4.531769163509181,60.0,0.0
26862,2,6862,[318 427 496 357 257],716,5,31102,4.531837388896983,60.0,0.0
26863,2,6863,[237 135  69 180 168],18,1,31103,4.531322843822844,0.0,0.0
26864,2,6864,[234  96 403 302  56],450,4,31107,4.531245447924253,0.0,0.0
26865,2,6865,[318 427 496 357 257],716,5,31112,4.531313719778619,60.0,0.0
26866,2,6866,[318 427 496 357 257],716,5,31117,4.531381971748944,60.0,0.0
26867,2,6867,[318 427 496 357 257],796,5,31122,4.531450203843914,60.0,0.0
26868,2,6868,[318 427 496 357 257],796,5,31127,4.531518416072209,60.0,0.0
26869,2,6869,[318 427 496 357 257],796,5,31132,4.531586608442503,60.0,0.0
26870,2,6870,[318 427 496 357 257],796,5,31137,4.5316547809634695,60.0,0.0
26871,2,6871,[318 427 496 357 257],716,5,31142,4.531722933643771,60.0,0.0
26872,2,6872,[318 427 496 357 257],330,5,31147,4.531791066492071,60.0,0.0
26873,2,6873,[318 427 496 357 257],796,5,31152,4.531859179517021,60.0,0.0
26874,2,6874,[318 427 496 357 257],796,5,31157,4.531927272727272,60.0,0.0
26875,2,6875,[100 200 258 181   4],504,4,31161,4.531849912739965,0.0,20.0
26876,2,6876,[275 204 117 515 127],716,5,31166,4.531917987494547,0.0,40.0
26877,2,6877,[318 427 496 357 257],796,5,31171,4.531986042454202,60.0,0.0
26878,2,6878,[318 427 496 357 257],796,5,31176,4.532054077627562,60.0,0.0
26879,2,6879,[318 427 496 357 257],716,5,31181,4.532122093023256,60.0,0.0
26880,2,6880,[318 427 496 357 257],330,5,31186,4.532190088649905,60.0,0.0
26881,2,6881,[  1 153 111 271 328],655,0,31186,4.531531531531532,0.0,0.0
26882,2,6882,[196 748 180 237 597],450,5,31191,4.53159959320064,0.0,0.0
26883,2,6883,[132 168 181 237 216],457,5,31196,4.531667635095874,0.0,0.0
26884,2,6884,[238 200 153  79 405],655,2,31198,4.531299927378359,0.0,0.0
26885,2,6885,[318 427 496 357 257],796,5,31203,4.531367993029335,60.0,0.0
26886,2,6886,[318 427 496 357 257],716,5,31208,4.5314360389138955,60.0,0.0
26887,2,6887,[318 427 496 357 257],330,5,31213,4.53150406504065,60.0,0.0
26888,2,6888,[318 427 496 357 257],716,5,31218,4.531572071418203,60.0,0.0
26889,2,6889,[318 427 496 357 257],330,5,31223,4.531640058055152,60.0,0.0
26890,2,6890,[276 168 196  11 496],535,4,31227,4.531562908141053,20.0,0.0
26891,2,6891,[318 427 496 357 257],796,5,31232,4.53163087637841,60.0,0.0
26892,2,6892,[318 427 496 357 257],716,5,31237,4.5316988248948205,60.0,0.0
26893,2,6893,[318 427 496 357 257],716,5,31242,4.531766753698869,60.0,0.0
26894,2,6894,[318 427 496 357 257],716,5,31247,4.53183466279913,60.0,0.0
26895,2,6895,[258  89   1 143 228],450,5,31252,4.531902552204176,0.0,0.0
26896,2,6896,[ 97 210 588 269 288],344,4,31256,4.531825431346962,0.0,0.0
26897,2,6897,[318 427 496 357 257],330,5,31261,4.531893302406495,60.0,0.0
26898,2,6898,[318 427 496 357 257],796,5,31266,4.531961153790404,60.0,0.0
26899,2,6899,[318 427 496 357 257],716,5,31271,4.532028985507246,60.0,0.0
26900,2,6900,[318 427 496 357 257],716,5,31276,4.53209679756557,60.0,0.0
26901,2,6901,[318 427 496 357 257],796,5,31281,4.53216458997392,60.0,0.0
26902,2,6902,[318 427 496 357 257],716,5,31286,4.532232362740837,60.0,0.0
26903,2,6903,[318 427 496 357 257],716,5,31291,4.532300115874855,60.0,0.0
26904,2,6904,[318 427 496 357 257],716,5,31296,4.532367849384504,60.0,0.0
26905,2,6905,[318 427 496 357 257],796,5,31301,4.532435563278309,60.0,0.0
26906,2,6906,[318 427 496 357 257],330,5,31306,4.532503257564789,60.0,0.0
26907,2,6907,[318 427 496 357 257],716,5,31311,4.532570932252461,60.0,0.0
26908,2,6908,[318 427 496 357 257],796,5,31316,4.532638587349833,60.0,0.0
26909,2,6909,[318 427 496 357 257],716,5,31321,4.5327062228654125,60.0,0.0
26910,2,6910,[318 427 496 357 257],330,5,31326,4.532773838807698,60.0,0.0
26911,2,6911,[318 427 496 357 257],716,5,31331,4.532841435185185,60.0,0.0
26912,2,6912,[318 427 496 357 257],330,5,31336,4.532909012006365,60.0,0.0
26913,2,6913,[318 427 496 357 257],330,5,31341,4.532976569279723,60.0,0.0
26914,2,6914,[144 385 257 135  96],807,4,31345,4.53289949385394,0.0,0.0
26915,2,6915,[318 427 496 357 257],716,5,31350,4.532967032967033,60.0,0.0
26916,2,6916,[318 427 496 357 257],796,5,31355,4.533034552551684,60.0,0.0
26917,2,6917,[ 25 286   8 301 269],535,4,31359,4.532957502168257,0.0,20.0
26918,2,6918,[318 427 496 357 257],716,5,31364,4.533025003613239,60.0,0.0
26919,2,6919,[318 427 496 357 257],796,5,31369,4.533092485549133,60.0,0.0
26920,2,6920,[318 427 496 357 257],796,5,31374,4.533159947984395,60.0,0.0
26921,2,6921,[318 427 496 357 257],796,5,31379,4.533227390927477,60.0,0.0
26922,2,6922,[318 427 496 357 257],716,5,31384,4.533294814386826,60.0,0.0
26923,2,6923,[318 427 496 357 257],330,5,31389,4.5333622183708835,60.0,0.0
26924,2,6924,[ 15 117   1 238  89],450,4,31393,4.533285198555957,0.0,0.0
26925,2,6925,[318 427 496 357 257],716,5,31398,4.533352584464337,60.0,0.0
26926,2,6926,[318 427 496 357 257],330,5,31403,4.533419950916703,60.0,0.0
26927,2,6927,[318 427 496 357 257],796,5,31408,4.533487297921478,60.0,0.0
26928,2,6928,[196 186 118   7 357],457,5,31413,4.533554625487083,0.0,0.0
26929,2,6929,[318 427 496 357 257],796,5,31418,4.533621933621934,60.0,0.0
26930,2,6930,[318 427 496 357 257],716,5,31423,4.53368922233444,60.0,0.0
26931,2,6931,[318 427 496 357 257],796,5,31428,4.533756491633007,60.0,0.0
26932,2,6932,[318 427 496 357 257],330,5,31433,4.533823741526035,60.0,0.0
26933,2,6933,[318 427 496 357 257],796,5,31438,4.533890972021921,60.0,0.0
26934,2,6934,[318 427 496 357 257],330,5,31443,4.533958183129055,60.0,0.0
26935,2,6935,[276 125 245  70 322],224,0,31443,4.533304498269896,0.0,0.0
26936,2,6936,[318 427 496 357 257],716,5,31448,4.533371774542309,60.0,0.0
26937,2,6937,[318 427 496 357 257],330,5,31453,4.533439031421159,60.0,0.0
26938,2,6938,[483 132 546 194  69],807,5,31458,4.533506268914829,0.0,0.0
26939,2,6939,[318 427 496 357 257],330,5,31463,4.5335734870317,60.0,0.0
26940,2,6940,[318 427 496 357 257],330,5,31468,4.533640685780147,60.0,0.0
26941,2,6941,[186 289  98 288 121],693,1,31469,4.533131662345146,0.0,0.0
26942,2,6942,[215 300  97 197 135],693,3,31472,4.532910845455855,0.0,0.0
26943,2,6943,[403 385 182 427  22],450,5,31477,4.532978110599078,20.0,0.0
26944,2,6944,[318 427 496 357 257],796,5,31482,4.53304535637149,60.0,0.0
26945,2,6945,[318 427 496 357 257],796,5,31487,4.533112582781457,60.0,0.0
26946,2,6946,[318 427 496 357 257],330,5,31492,4.53317978983734,60.0,0.0
26947,2,6947,[318 427 496 357 257],716,5,31497,4.5332469775474955,60.0,0.0
26948,2,6948,[318 427 496 357 257],330,5,31502,4.533314145920277,60.0,0.0
26949,2,6949,[318 427 496 357 257],796,5,31507,4.533381294964029,60.0,0.0
26950,2,6950,[182 271 313 258 742],796,4,31511,4.5333045604948925,0.0,0.0
26951,2,6951,[318 427 496 357 257],330,5,31516,4.53337169159954,60.0,0.0
26952,2,6952,[195  97 257 175 215],655,0,31516,4.53271968934273,0.0,0.0
26953,2,6953,[318 427 496 357 257],796,5,31521,4.532786885245901,60.0,0.0
26954,2,6954,[318 427 496 357 257],796,5,31526,4.532854061826025,60.0,0.0
26955,2,6955,[318 427 496 357 257],716,5,31531,4.532921219091432,60.0,0.0
26956,2,6956,[318 427 496 357 257],796,5,31536,4.532988357050453,60.0,0.0
26957,2,6957,[318 427 496 357 257],716,5,31541,4.533055475711412,60.0,0.0
26958,2,6958,[318 427 496 357 257],716,5,31546,4.5331225750826265,60.0,0.0
26959,2,6959,[318 427 496 357 257],716,5,31551,4.533189655172414,60.0,0.0
26960,2,6960,[286 427  22 313   9],655,2,31553,4.532825743427669,20.0,20.0
26961,2,6961,[318 427 496 357 257],330,5,31558,4.53289284688308,60.0,0.0
26962,2,6962,[318 427 496 357 257],716,5,31563,4.532959931064196,60.0,0.0
26963,2,6963,[318 427 496 357 257],330,5,31568,4.533026995979323,60.0,0.0
26964,2,6964,[318 427 496 357 257],330,5,31573,4.5330940416367556,60.0,0.0
26965,2,6965,[318 427 496 357 257],796,5,31578,4.533161068044789,60.0,0.0
26966,2,6966,[294 168  56  98   7],264,4,31582,4.533084541409502,0.0,0.0
26967,2,6967,[127 174 168  25  69],18,2,31584,4.532721010332951,0.0,20.0
26968,2,6968,[318 427 496 357 257],330,5,31589,4.532788061414837,60.0,0.0
26969,2,6969,[ 22   8 313 328  71],796,5,31594,4.532855093256815,0.0,0.0
26970,2,6970,[132   4 515 187 197],655,2,31596,4.532491751542103,0.0,0.0
26971,2,6971,[435  79 186 187 100],450,4,31600,4.53241537578887,0.0,20.0
26972,2,6972,[174 196 427 282 222],716,4,31604,4.532339021941776,20.0,0.0
26973,2,6973,[282  28 318 174 276],655,2,31606,4.531975910524807,20.0,0.0
26974,2,6974,[318 427 496 357 257],796,5,31611,4.532043010752688,60.0,0.0
26975,2,6975,[318 427 496 357 257],330,5,31616,4.532110091743119,60.0,0.0
26976,2,6976,[318 427 496 357 257],796,5,31621,4.532177153504372,60.0,0.0
26977,2,6977,[100 568 143 200 496],269,3,31624,4.531957580968759,20.0,20.0
26978,2,6978,[318 427 496 357 257],330,5,31629,4.5320246453646655,60.0,0.0
26979,2,6979,[237 100  50 195 238],504,2,31631,4.531661891117478,0.0,40.0
26980,2,6980,[318 427 496 357 257],716,5,31636,4.531728978656353,60.0,0.0
26981,2,6981,[597 313 168 294 215],450,5,31641,4.531796046977943,0.0,0.0
26982,2,6982,[318 427 496 357 257],796,5,31646,4.531863096090506,60.0,0.0
26983,2,6983,[318 427 496 357 257],796,5,31651,4.531930126002291,60.0,0.0
26984,2,6984,[318 427 496 357 257],796,5,31656,4.531997136721547,60.0,0.0
26985,2,6985,[318 427 496 357 257],330,5,31661,4.532064128256513,60.0,0.0
26986,2,6986,[318 427 496 357 257],716,5,31666,4.532131100615429,60.0,0.0
26987,2,6987,[318 427 496 357 257],796,5,31671,4.532198053806526,60.0,0.0
26988,2,6988,[318 427 496 357 257],796,5,31676,4.5322649878380314,60.0,0.0
26989,2,6989,[200 323 183 215 151],796,4,31680,4.532188841201717,0.0,0.0
26990,2,6990,[318 427 496 357 257],796,5,31685,4.532255757402375,60.0,0.0
26991,2,6991,[121  25 427 238 294],65,4,31689,4.532179633867277,20.0,0.0
26992,2,6992,[318 427 496 357 257],796,5,31694,4.532246532246532,60.0,0.0
26993,2,6993,[318 427 496 357 257],796,5,31699,4.532313411495568,60.0,0.0
26994,2,6994,[318 427 496 357 257],330,5,31704,4.532380271622587,60.0,0.0
26995,2,6995,[318 427 496 357 257],796,5,31709,4.532447112635792,60.0,0.0
26996,2,6996,[234  97 222   4 118],450,1,31710,4.531942260968987,0.0,0.0
26997,2,6997,[318 427 496 357 257],716,5,31715,4.532009145470134,60.0,0.0
26998,2,6998,[318 427 496 357 257],796,5,31720,4.532076010858694,60.0,0.0
26999,2,6999,[318 427 496 357 257],330,5,31725,4.5321428571428575,60.0,0.0
27000,2,7000,[294 174 176 385 200],504,3,31728,4.531924010855592,0.0,0.0
27001,2,7001,[318 427 496 357 257],796,5,31733,4.531990859754356,60.0,0.0
27002,2,7002,[318 427 496 357 257],330,5,31738,4.532057689561617,60.0,0.0
27003,2,7003,[318 427 496 357 257],330,5,31743,4.532124500285551,60.0,0.0
27004,2,7004,[318 427 496 357 257],796,5,31748,4.532191291934333,60.0,0.0
27005,2,7005,[603 269 222 182 273],655,3,31751,4.531972594918641,20.0,0.0
27006,2,7006,[318 427 496 357 257],716,5,31756,4.532039389182247,60.0,0.0
27007,2,7007,[318 427 496 357 257],330,5,31761,4.532106164383562,60.0,0.0
27008,2,7008,[318 427 496 357 257],330,5,31766,4.532172920530746,60.0,0.0
27009,2,7009,[318 427 496 357 257],716,5,31771,4.532239657631954,60.0,0.0
27010,2,7010,[318 427 496 357 257],796,5,31776,4.532306375695336,60.0,0.0
27011,2,7011,[318 427 496 357 257],716,5,31781,4.532373074729036,60.0,0.0
27012,2,7012,[195 161  70 238 121],450,4,31785,4.532297162412662,0.0,0.0
27013,2,7013,[318 427 496 357 257],330,5,31790,4.53236384374109,60.0,0.0
27014,2,7014,[318 427 496 357 257],796,5,31795,4.532430506058446,60.0,0.0
27015,2,7015,[318 427 496 357 257],716,5,31800,4.532497149372862,60.0,0.0
27016,2,7016,[318 427 496 357 257],716,5,31805,4.532563773692461,60.0,0.0
27017,2,7017,[318 427 496 357 257],330,5,31810,4.532630379025363,60.0,0.0
27018,2,7018,[318 427 496 357 257],716,5,31815,4.532696965379683,60.0,0.0
27019,2,7019,[403 168 357 118  71],504,3,31818,4.532478632478632,0.0,0.0
27020,2,7020,[318 427 496 357 257],716,5,31823,4.532545221478422,60.0,0.0
27021,2,7021,[318 427 496 357 257],330,5,31828,4.53261179151239,60.0,0.0
27022,2,7022,[318 427 496 357 257],716,5,31833,4.532678342588637,60.0,0.0
27023,2,7023,[318 427 496 357 257],716,5,31838,4.532744874715262,60.0,0.0
27024,2,7024,[318 427 496 357 257],330,5,31843,4.532811387900356,60.0,0.0
27025,2,7025,[135  12 322  71 427],450,3,31846,4.532593225163677,20.0,0.0
27026,2,7026,[  4 568  98 143 288],593,5,31851,4.532659740999004,0.0,0.0
27027,2,7027,[318 427 496 357 257],330,5,31856,4.53272623790552,60.0,0.0
27028,2,7028,[318 427 496 357 257],716,5,31861,4.532792715891308,60.0,0.0
27029,2,7029,[318 427 496 357 257],796,5,31866,4.532859174964438,60.0,0.0
27030,2,7030,[265  98 204   8 215],655,1,31867,4.5323567060162135,0.0,0.0
27031,2,7031,[318 427 496 357 257],796,5,31872,4.532423208191126,60.0,0.0
27032,2,7032,[318 427 496 357 257],796,5,31877,4.532489691454571,60.0,0.0
27033,2,7033,[ 98 182 508  11 655],655,2,31879,4.532129655956782,0.0,0.0
27034,2,7034,[318 427 496 357 257],796,5,31884,4.532196162046908,60.0,0.0
27035,2,7035,[318 427 496 357 257],716,5,31889,4.532262649232519,60.0,0.0
27036,2,7036,[318 427 496 357 257],330,5,31894,4.532329117521671,60.0,0.0
27037,2,7037,[ 22 118  69 423  97],655,0,31894,4.531685137823246,0.0,0.0
27038,2,7038,[182 194 257   1 215],796,4,31898,4.5316096036368805,0.0,0.0
27039,2,7039,[100 275 191   1 202],151,3,31901,4.531392045454545,0.0,40.0
27040,2,7040,[ 88 173 258 228  98],450,5,31906,4.531458599630734,0.0,0.0
27041,2,7041,[318 427 496 357 257],716,5,31911,4.531525134904856,60.0,0.0
27042,2,7042,[318 427 496 357 257],716,5,31916,4.531591651284963,60.0,0.0
27043,2,7043,[318 427 496 357 257],330,5,31921,4.531658148779103,60.0,0.0
27044,2,7044,[318 427 496 357 257],330,5,31926,4.531724627395316,60.0,0.0
27045,2,7045,[318 427 496 357 257],330,5,31931,4.531791087141641,60.0,0.0
27046,2,7046,[151 194  79 268 508],535,3,31934,4.531573719313183,0.0,0.0
27047,2,7047,[318 427 496 357 257],330,5,31939,4.531640181611805,60.0,0.0
27048,2,7048,[318 427 496 357 257],330,5,31944,4.531706625053199,60.0,0.0
27049,2,7049,[318 427 496 357 257],330,5,31949,4.53177304964539,60.0,0.0
27050,2,7050,[234 289 302  79 300],655,2,31951,4.53141398383208,0.0,0.0
27051,2,7051,[318 427 496 357 257],716,5,31956,4.531480431083381,60.0,0.0
27052,2,7052,[318 427 496 357 257],716,5,31961,4.531546859492415,60.0,0.0
27053,2,7053,[318 427 496 357 257],330,5,31966,4.531613269067196,60.0,0.0
27054,2,7054,[318 427 496 357 257],716,5,31971,4.531679659815733,60.0,0.0
27055,2,7055,[318 427 496 357 257],716,5,31976,4.531746031746032,60.0,0.0
27056,2,7056,[288 179 286 186 153],264,4,31980,4.531670681592745,0.0,20.0
27057,2,7057,[210 385 121 245 222],256,5,31985,4.531737035987532,0.0,0.0
27058,2,7058,[318 427 496 357 257],796,5,31990,4.531803371582377,60.0,0.0
27059,2,7059,[318 427 496 357 257],330,5,31995,4.531869688385269,60.0,0.0
27060,2,7060,[318 427 496 357 257],330,5,32000,4.531935986404192,60.0,0.0
27061,2,7061,[318 427 496 357 257],796,5,32005,4.532002265647125,60.0,0.0
27062,2,7062,[405 318 111 385 176],450,5,32010,4.532068526122044,20.0,0.0
27063,2,7063,[318 427 496 357 257],796,5,32015,4.5321347678369195,60.0,0.0
27064,2,7064,[318 427 496 357 257],716,5,32020,4.5322009907997165,60.0,0.0
27065,2,7065,[318 427 496 357 257],330,5,32025,4.532267195018398,60.0,0.0
27066,2,7066,[318 427 496 357 257],716,5,32030,4.53233338050092,60.0,0.0
27067,2,7067,[ 79 179 175 286 194],18,4,32034,4.532258064516129,0.0,20.0
27068,2,7068,[318 427 496 357 257],796,5,32039,4.5323242325647195,60.0,0.0
27069,2,7069,[318 427 496 357 257],716,5,32044,4.532390381895333,60.0,0.0
27070,2,7070,[318 427 496 357 257],796,5,32049,4.53245651251591,60.0,0.0
27071,2,7071,[318 427 496 357 257],330,5,32054,4.532522624434389,60.0,0.0
27072,2,7072,[318 427 496 357 257],716,5,32059,4.532588717658702,60.0,0.0
27073,2,7073,[318 427 496 357 257],330,5,32064,4.532654792196777,60.0,0.0
27074,2,7074,[318 427 496 357 257],716,5,32069,4.532720848056537,60.0,0.0
27075,2,7075,[318 427 496 357 257],716,5,32074,4.532786885245901,60.0,0.0
27076,2,7076,[318 427 496 357 257],796,5,32079,4.532852903772785,60.0,0.0
27077,2,7077,[127 318 748 151  71],450,4,32083,4.5327776207968355,20.0,20.0
27078,2,7078,[318 427 496 357 257],716,5,32088,4.532843621980506,60.0,0.0
27079,2,7079,[318 427 496 357 257],330,5,32093,4.532909604519774,60.0,0.0
27080,2,7080,[318 427 496 357 257],796,5,32098,4.532975568422539,60.0,0.0
27081,2,7081,[318 427 496 357 257],330,5,32103,4.533041513696696,60.0,0.0
27082,2,7082,[318 427 496 357 257],330,5,32108,4.533107440350134,60.0,0.0
27083,2,7083,[318 427 496 357 257],796,5,32113,4.53317334839074,60.0,0.0
27084,2,7084,[742 204 111 117 597],593,4,32117,4.533098094565984,0.0,0.0
27085,2,7085,[318 427 496 357 257],716,5,32122,4.533163985323172,60.0,0.0
27086,2,7086,[318 427 496 357 257],796,5,32127,4.533229857485537,60.0,0.0
27087,2,7087,[318 427 496 357 257],716,5,32132,4.533295711060948,60.0,0.0
27088,2,7088,[318 427 496 357 257],796,5,32137,4.533361546057272,60.0,0.0
27089,2,7089,[318 427 496 357 257],330,5,32142,4.533427362482369,60.0,0.0
27090,2,7090,[318 427 496 357 257],796,5,32147,4.533493160344098,60.0,0.0
27091,2,7091,[318 427 496 357 257],716,5,32152,4.533558939650311,60.0,0.0
27092,2,7092,[318 427 496 357 257],716,5,32157,4.533624700408854,60.0,0.0
27093,2,7093,[318 427 496 357 257],330,5,32162,4.533690442627573,60.0,0.0
27094,2,7094,[423 222 180 748 144],796,4,32166,4.533615221987315,0.0,0.0
27095,2,7095,[318 427 496 357 257],796,5,32171,4.533680947012401,60.0,0.0
27096,2,7096,[151 197  12 215 471],174,4,32175,4.5336057489079895,0.0,0.0
27097,2,7097,[318 427 496 357 257],796,5,32180,4.53367145674838,60.0,0.0
27098,2,7098,[318 427 496 357 257],796,5,32185,4.533737146076912,60.0,0.0
27099,2,7099,[318 427 496 357 257],330,5,32190,4.533802816901408,60.0,0.0
27100,2,7100,[186 118 405 318  79],151,3,32193,4.533586818757922,20.0,0.0
27101,2,7101,[202 301 117 196 143],796,4,32197,4.533511686848775,0.0,0.0
27102,2,7102,[318 427 496 357 257],330,5,32202,4.533577361678164,60.0,0.0
27103,2,7103,[318 427 496 357 257],796,5,32207,4.533643018018018,60.0,0.0
27104,2,7104,[318 427 496 357 257],796,5,32212,4.5337086558761435,60.0,0.0
27105,2,7105,[318 427 496 357 257],330,5,32217,4.533774275260344,60.0,0.0
27106,2,7106,[318 322 175  69 143],151,4,32221,4.533699169832559,20.0,0.0
27107,2,7107,[132 185 427 234 215],450,4,32225,4.533624085537423,20.0,0.0
27108,2,7108,[175 180 237   4 172],716,2,32227,4.533267688845126,0.0,0.0
27109,2,7109,[322  25 301 300 111],151,4,32231,4.533192686357244,0.0,0.0
27110,2,7110,[318 427 496 357 257],796,5,32236,4.53325833216144,60.0,0.0
27111,2,7111,[144 168 228 275 185],796,5,32241,4.533323959505062,0.0,20.0
27112,2,7112,[318 427 496 357 257],796,5,32246,4.5333895683958945,60.0,0.0
27113,2,7113,[318 427 496 357 257],330,5,32251,4.53345515884172,60.0,0.0
27114,2,7114,[427 121 132 161 111],450,4,32255,4.5333801827125795,20.0,0.0
27115,2,7115,[318 427 496 357 257],796,5,32260,4.53344575604272,60.0,0.0
27116,2,7116,[ 70 187 288 180 168],450,4,32264,4.533370802304342,0.0,0.0
27117,2,7117,[144  96 151 294 202],23,1,32265,4.532874402922169,0.0,0.0
27118,2,7118,[318 427 496 357 257],716,5,32270,4.532940019665683,60.0,0.0
27119,2,7119,[288 185 357 121 168],504,5,32275,4.533005617977528,0.0,0.0
27120,2,7120,[ 97  50 125 127 143],401,2,32277,4.5326499087206855,0.0,40.0
27121,2,7121,[318 427 496 357 257],716,5,32282,4.5327155293456896,60.0,0.0
27122,2,7122,[318 427 496 357 257],796,5,32287,4.532781131545697,60.0,0.0
27123,2,7123,[318 427 496 357 257],330,5,32292,4.532846715328467,60.0,0.0
27124,2,7124,[318 427 496 357 257],330,5,32297,4.532912280701755,60.0,0.0
27125,2,7125,[318 427 496 357 257],796,5,32302,4.532977827673309,60.0,0.0
27126,2,7126,[318 427 496 357 257],796,5,32307,4.533043356250877,60.0,0.0
27127,2,7127,[318 427 496 357 257],796,5,32312,4.5331088664422,60.0,0.0
27128,2,7128,[211  97 117 276 215],655,1,32313,4.532613269743302,0.0,0.0
27129,2,7129,[318 427 496 357 257],330,5,32318,4.532678821879383,60.0,0.0
27130,2,7130,[  8 174  22 302 181],655,1,32319,4.532183424484645,0.0,0.0
27131,2,7131,[318 427 496 357 257],796,5,32324,4.532249018508132,60.0,0.0
27132,2,7132,[318 427 496 357 257],330,5,32329,4.532314594139913,60.0,0.0
27133,2,7133,[318 427 496 357 257],330,5,32334,4.532380151387721,60.0,0.0
27134,2,7134,[257  82 180 237 357],504,4,32338,4.532305536089699,0.0,0.0
27135,2,7135,[ 12 357  15  50  88],796,5,32343,4.532371076233184,0.0,20.0
27136,2,7136,[318 427 496 357 257],716,5,32348,4.532436598010369,60.0,0.0
27137,2,7137,[318 427 496 357 257],330,5,32353,4.532502101428972,60.0,0.0
27138,2,7138,[318 427 496 357 257],796,5,32358,4.532567586496708,60.0,0.0
27139,2,7139,[318 427 496 357 257],796,5,32363,4.532633053221288,60.0,0.0
27140,2,7140,[ 98 405 286 508   1],280,3,32366,4.532418428791486,0.0,20.0
27141,2,7141,[405 161 302 273 168],401,0,32366,4.531783814057687,0.0,0.0
27142,2,7142,[318 427 496 357 257],330,5,32371,4.53184936301274,60.0,0.0
27143,2,7143,[197 195 475 174 302],655,1,32372,4.531354983202688,0.0,0.0
27144,2,7144,[742 328 100 132 496],450,5,32377,4.531420573827852,20.0,20.0
27145,2,7145,[318 427 496 357 257],716,5,32382,4.531486146095718,60.0,0.0
27146,2,7146,[318 427 496 357 257],330,5,32387,4.531551700013992,60.0,0.0
27147,2,7147,[318 427 496 357 257],796,5,32392,4.5316172355903745,60.0,0.0
27148,2,7148,[318 427 496 357 257],716,5,32397,4.531682752832564,60.0,0.0
27149,2,7149,[405 197 211  25 125],503,3,32400,4.531468531468532,0.0,0.0
27150,2,7150,[318 427 496 357 257],330,5,32405,4.531534051181653,60.0,0.0
27151,2,7151,[318 427 496 357 257],796,5,32410,4.531599552572707,60.0,0.0
27152,2,7152,[121 200  97 302 161],450,3,32413,4.531385432685586,0.0,0.0
27153,2,7153,[318 427 496 357 257],716,5,32418,4.531450936538999,60.0,0.0
27154,2,7154,[318 427 496 357 257],716,5,32423,4.5315164220824595,60.0,0.0
27155,2,7155,[318 427 496 357 257],796,5,32428,4.531581889323644,60.0,0.0
27156,2,7156,[318 427 496 357 257],716,5,32433,4.531647338270225,60.0,0.0
27157,2,7157,[318 427 496 357 257],796,5,32438,4.531712768929869,60.0,0.0
27158,2,7158,[588 275 135 185 423],389,4,32442,4.531638496996787,0.0,20.0
27159,2,7159,[318 427 496 357 257],716,5,32447,4.531703910614525,60.0,0.0
27160,2,7160,[318 427 496 357 257],330,5,32452,4.531769305962855,60.0,0.0
27161,2,7161,[318 427 496 357 257],796,5,32457,4.531834683049428,60.0,0.0
27162,2,7162,[318 427 496 357 257],716,5,32462,4.531900041881893,60.0,0.0
27163,2,7163,[318 427 496 357 257],716,5,32467,4.531965382467895,60.0,0.0
27164,2,7164,[318 427 496 357 257],716,5,32472,4.532030704815074,60.0,0.0
27165,2,7165,[318 427 496 357 257],796,5,32477,4.532096008931063,60.0,0.0
27166,2,7166,[ 96 403 172 385 143],796,5,32482,4.532161294823497,0.0,0.0
27167,2,7167,[318 427 496 357 257],330,5,32487,4.5322265625,60.0,0.0
27168,2,7168,[318 427 496 357 257],716,5,32492,4.5322918119681965,60.0,0.0
27169,2,7169,[318 427 496 357 257],716,5,32497,4.532357043235704,60.0,0.0
27170,2,7170,[742 202  89 427 496],450,5,32502,4.532422256310138,40.0,0.0
27171,2,7171,[318 427 496 357 257],796,5,32507,4.532487451199108,60.0,0.0
27172,2,7172,[288  89 180 568 238],450,4,32511,4.5324132162275195,0.0,0.0
27173,2,7173,[318 427 496 357 257],716,5,32516,4.5324783942012825,60.0,0.0
27174,2,7174,[318 427 496 357 257],716,5,32521,4.532543554006969,60.0,0.0
27175,2,7175,[204   8 483 186 194],535,5,32526,4.532608695652174,0.0,0.0
27176,2,7176,[318 427 496 357 257],716,5,32531,4.532673819144489,60.0,0.0
27177,2,7177,[318 427 496 357 257],796,5,32536,4.532738924491502,60.0,0.0
27178,2,7178,[ 82 196 237  22 144],655,0,32536,4.532107535868505,0.0,0.0
27179,2,7179,[168  50 191 215 748],151,2,32538,4.531754874651811,0.0,20.0
27180,2,7180,[318 427 496 357 257],330,5,32543,4.5318200807686955,60.0,0.0
27181,2,7181,[318 427 496 357 257],716,5,32548,4.531885268727374,60.0,0.0
27182,2,7182,[655 181 288  89 257],655,1,32549,4.531393568147013,0.0,0.0
27183,2,7183,[318 427 496 357 257],330,5,32554,4.531458797327394,60.0,0.0
27184,2,7184,[318 427 496 357 257],330,5,32559,4.531524008350731,60.0,0.0
27185,2,7185,[318 427 496 357 257],796,5,32564,4.5315892012246035,60.0,0.0
27186,2,7186,[318 427 496 357 257],796,5,32569,4.531654375956588,60.0,0.0
27187,2,7187,[222 174  28 237 172],72,2,32571,4.531302170283807,0.0,0.0
27188,2,7188,[318 427 496 357 257],796,5,32576,4.531367366810405,60.0,0.0
27189,2,7189,[318 427 496 357 257],330,5,32581,4.531432545201669,60.0,0.0
27190,2,7190,[318 427 496 357 257],716,5,32586,4.531497705465164,60.0,0.0
27191,2,7191,[318 427 496 357 257],330,5,32591,4.531562847608454,60.0,0.0
27192,2,7192,[265 405 423  56 276],280,4,32595,4.531488947587933,0.0,0.0
27193,2,7193,[318 427 496 357 257],796,5,32600,4.531554072838476,60.0,0.0
27194,2,7194,[302  56 222 161 118],450,3,32603,4.5313412091730365,0.0,0.0
27195,2,7195,[182  79 111 301 200],450,4,32607,4.531267370761534,0.0,0.0
27196,2,7196,[318 427 496 357 257],716,5,32612,4.531332499652633,60.0,0.0
27197,2,7197,[144  70 204 273 127],450,4,32616,4.531258682967491,0.0,20.0
27198,2,7198,[318 427 496 357 257],330,5,32621,4.531323794971524,60.0,0.0
27199,2,7199,[318 427 496 357 257],796,5,32626,4.5313888888888885,60.0,0.0
27200,2,7200,[186   4 238 179   8],535,4,32630,4.531315095125677,0.0,0.0
27201,2,7201,[318 427 496 357 257],796,5,32635,4.531380172174396,60.0,0.0
27202,2,7202,[318 427 496 357 257],796,5,32640,4.531445231153686,60.0,0.0
27203,2,7203,[318 427 496 357 257],716,5,32645,4.531510272071071,60.0,0.0
27204,2,7204,[ 88 151 125 234 194],577,3,32648,4.531297709923664,0.0,0.0
27205,2,7205,[318 427 496 357 257],796,5,32653,4.531362753261171,60.0,0.0
27206,2,7206,[318 427 496 357 257],796,5,32658,4.531427778548633,60.0,0.0
27207,2,7207,[318 427 496 357 257],796,5,32663,4.531492785793563,60.0,0.0
27208,2,7208,[318 427 496 357 257],716,5,32668,4.531557775003468,60.0,0.0
27209,2,7209,[234 568 333 196 508],655,0,32668,4.530929264909847,0.0,0.0
27210,2,7210,[318 427 496 357 257],716,5,32673,4.53099431424213,60.0,0.0
27211,2,7211,[318 427 496 357 257],796,5,32678,4.531059345535219,60.0,0.0
27212,2,7212,[318 427 496 357 257],796,5,32683,4.5311243587966175,60.0,0.0
27213,2,7213,[318 427 496 357 257],330,5,32688,4.531189354033823,60.0,0.0
27214,2,7214,[ 88 271 185 268 405],655,1,32689,4.530699930699931,0.0,0.0
27215,2,7215,[318 427 496 357 257],716,5,32694,4.530764966740577,60.0,0.0
27216,2,7216,[318 427 496 357 257],330,5,32699,4.53082998475821,60.0,0.0
27217,2,7217,[174 289  70  79 210],655,1,32700,4.530340814630091,0.0,0.0
27218,2,7218,[318 427 496 357 257],716,5,32705,4.530405873389666,60.0,0.0
27219,2,7219,[318 427 496 357 257],716,5,32710,4.530470914127424,60.0,0.0
27220,2,7220,[318 427 496 357 257],716,5,32715,4.5305359368508515,60.0,0.0
27221,2,7221,[172 235 245  50 423],450,4,32719,4.530462475768485,0.0,20.0
27222,2,7222,[333 210  88 318 275],796,4,32723,4.530389035026997,20.0,20.0
27223,2,7223,[318 427 496 357 257],330,5,32728,4.530454042081949,60.0,0.0
27224,2,7224,[318 427 496 357 257],716,5,32733,4.530519031141869,60.0,0.0
27225,2,7225,[318 427 496 357 257],796,5,32738,4.530584002214226,60.0,0.0
27226,2,7226,[318 427 496 357 257],330,5,32743,4.530648955306489,60.0,0.0
27227,2,7227,[318 427 496 357 257],796,5,32748,4.530713890426121,60.0,0.0
27228,2,7228,[318 427 496 357 257],330,5,32753,4.530778807580578,60.0,0.0
27229,2,7229,[318 427 496 357 257],330,5,32758,4.530843706777317,60.0,0.0
27230,2,7230,[318 427 496 357 257],796,5,32763,4.530908588023786,60.0,0.0
27231,2,7231,[318 427 496 357 257],330,5,32768,4.530973451327434,60.0,0.0
27232,2,7232,[318 427 496 357 257],796,5,32773,4.531038296695701,60.0,0.0
27233,2,7233,[318 427 496 357 257],796,5,32778,4.531103124136024,60.0,0.0
27234,2,7234,[318 427 496 357 257],330,5,32783,4.53116793365584,60.0,0.0
27235,2,7235,[318 427 496 357 257],796,5,32788,4.531232725262576,60.0,0.0
27236,2,7236,[271 118 300 187 423],796,5,32793,4.531297498963659,0.0,0.0
27237,2,7237,[183 111 222 235 300],450,3,32796,4.531085935341254,0.0,0.0
27238,2,7238,[318 427 496 357 257],796,5,32801,4.53115071142423,60.0,0.0
27239,2,7239,[318 427 496 357 257],796,5,32806,4.53121546961326,60.0,0.0
27240,2,7240,[174 300 143 210  69],796,4,32810,4.531142107443723,0.0,0.0
27241,2,7241,[318 427 496 357 257],796,5,32815,4.531206848936757,60.0,0.0
27242,2,7242,[318 427 496 357 257],330,5,32820,4.53127157255281,60.0,0.0
27243,2,7243,[318 427 496 357 257],330,5,32825,4.531336278299282,60.0,0.0
27244,2,7244,[235 483 385 286 173],280,4,32829,4.531262939958592,0.0,20.0
27245,2,7245,[234 237   1 125 286],280,2,32831,4.53091360750759,0.0,20.0
27246,2,7246,[318 427 496 357 257],716,5,32836,4.530978335863116,60.0,0.0
27247,2,7247,[121 194 235 588 216],450,3,32839,4.530767108167771,0.0,0.0
27248,2,7248,[ 96 603 318 197 202],450,5,32844,4.530831838874327,40.0,0.0
27249,2,7249,[318 427 496 357 257],330,5,32849,4.530896551724138,60.0,0.0
27250,2,7250,[ 11 742 237  50 181],280,2,32851,4.530547510688181,0.0,20.0
27251,2,7251,[318 427 496 357 257],330,5,32856,4.530612244897959,60.0,0.0
27252,2,7252,[318 427 496 357 257],330,5,32861,4.530676961257411,60.0,0.0
27253,2,7253,[318 427 496 357 257],716,5,32866,4.530741659773918,60.0,0.0
27254,2,7254,[318 427 496 357 257],716,5,32871,4.530806340454859,60.0,0.0
27255,2,7255,[318 427 496 357 257],716,5,32876,4.530871003307608,60.0,0.0
27256,2,7256,[318 427 496 357 257],330,5,32881,4.530935648339534,60.0,0.0
27257,2,7257,[318 427 496 357 257],796,5,32886,4.5310002755580046,60.0,0.0
27258,2,7258,[318 427 496 357 257],330,5,32891,4.531064884970381,60.0,0.0
27259,2,7259,[318 427 496 357 257],330,5,32896,4.531129476584022,60.0,0.0
27260,2,7260,[318 427 496 357 257],330,5,32901,4.53119405040628,60.0,0.0
27261,2,7261,[318 427 496 357 257],330,5,32906,4.5312586064445055,60.0,0.0
27262,2,7262,[318 427 496 357 257],330,5,32911,4.531323144706044,60.0,0.0
27263,2,7263,[  9 427 179 182  15],18,5,32916,4.531387665198238,20.0,0.0
27264,2,7264,[318 427 496 357 257],330,5,32921,4.531452167928424,60.0,0.0
27265,2,7265,[173   4 125 385 228],344,3,32924,4.531241398293421,0.0,0.0
27266,2,7266,[318 427 496 357 257],716,5,32929,4.531305903398927,60.0,0.0
27267,2,7267,[275 111 174 143 173],798,4,32933,4.531232801320859,0.0,20.0
27268,2,7268,[210   9   7 282  12],655,0,32933,4.5306094373366355,0.0,0.0
27269,2,7269,[318 427 496 357 257],330,5,32938,4.530674002751032,60.0,0.0
27270,2,7270,[318 427 496 357 257],796,5,32943,4.530738550405721,60.0,0.0
27271,2,7271,[318 427 496 357 257],330,5,32948,4.530803080308031,60.0,0.0
27272,2,7272,[318 427 496 357 257],716,5,32953,4.530867592465283,60.0,0.0
27273,2,7273,[357 276 471 286 269],535,2,32955,4.530519659059665,0.0,20.0
27274,2,7274,[318 427 496 357 257],796,5,32960,4.530584192439862,60.0,0.0
27275,2,7275,[318 427 496 357 257],330,5,32965,4.5306487080813636,60.0,0.0
27276,2,7276,[318 427 496 357 257],796,5,32970,4.53071320599148,60.0,0.0
27277,2,7277,[318 427 496 357 257],330,5,32975,4.5307776861775215,60.0,0.0
27278,2,7278,[  1 357 204 286 194],494,4,32979,4.530704767138343,0.0,20.0
27279,2,7279,[318 427 496 357 257],716,5,32984,4.530769230769231,60.0,0.0
27280,2,7280,[ 11 483 275  98 385],450,4,32988,4.530696332921302,0.0,20.0
27281,2,7281,[318 427 496 357 257],716,5,32993,4.530760780005493,60.0,0.0
27282,2,7282,[318 427 496 357 257],716,5,32998,4.530825209391734,60.0,0.0
27283,2,7283,[318 427 496 357 257],330,5,33003,4.530889621087315,60.0,0.0
27284,2,7284,[318 427 496 357 257],330,5,33008,4.530954015099519,60.0,0.0
27285,2,7285,[318 427 496 357 257],796,5,33013,4.53101839143563,60.0,0.0
27286,2,7286,[318 427 496 357 257],716,5,33018,4.531082750102923,60.0,0.0
27287,2,7287,[318 427 496 357 257],716,5,33023,4.5311470911086715,60.0,0.0
27288,2,7288,[318 427 496 357 257],796,5,33028,4.531211414460145,60.0,0.0
27289,2,7289,[318 427 496 357 257],716,5,33033,4.531275720164609,60.0,0.0
27290,2,7290,[  1 588 143 204  89],807,5,33038,4.531340008229324,0.0,0.0
27291,2,7291,[318 427 496 357 257],716,5,33043,4.5314042786615465,60.0,0.0
27292,2,7292,[313 245 471 183 282],280,0,33043,4.530782942547648,0.0,0.0
27293,2,7293,[318 427 496 357 257],796,5,33048,4.530847271730189,60.0,0.0
27294,2,7294,[318 427 496 357 257],330,5,33053,4.530911583276216,60.0,0.0
27295,2,7295,[318 427 496 357 257],796,5,33058,4.530975877192983,60.0,0.0
27296,2,7296,[200 257  22 385  82],457,4,33062,4.53090311086748,0.0,0.0
27297,2,7297,[271 172 176 471  11],655,1,33063,4.530419292956974,0.0,0.0
27298,2,7298,[318 427 496 357 257],796,5,33068,4.530483627894232,60.0,0.0
27299,2,7299,[318 427 496 357 257],716,5,33073,4.5305479452054795,60.0,0.0
27300,2,7300,[153 132 265 234  79],280,4,33077,4.530475277359266,0.0,0.0
27301,2,7301,[318 427 496 357 257],716,5,33082,4.530539578197754,60.0,0.0
27302,2,7302,[318 427 496 357 257],330,5,33087,4.530603861426811,60.0,0.0
27303,2,7303,[318 427 496 357 257],796,5,33092,4.530668127053669,60.0,0.0
27304,2,7304,[318 427 496 357 257],330,5,33097,4.530732375085558,60.0,0.0
27305,2,7305,[  8 483 475 127 471],389,5,33102,4.5307966055297015,0.0,20.0
27306,2,7306,[100  96 172 118  98],280,2,33104,4.53045025318188,0.0,20.0
27307,2,7307,[318 427 496 357 257],330,5,33109,4.5305145046524355,60.0,0.0
27308,2,7308,[318 427 496 357 257],330,5,33114,4.530578738541524,60.0,0.0
27309,2,7309,[318 427 496 357 257],330,5,33119,4.530642954856361,60.0,0.0
27310,2,7310,[318 427 496 357 257],330,5,33124,4.530707153604158,60.0,0.0
27311,2,7311,[318 427 496 357 257],716,5,33129,4.530771334792123,60.0,0.0
27312,2,7312,[318 427 496 357 257],330,5,33134,4.530835498427458,60.0,0.0
27313,2,7313,[427 191  22 180 174],18,5,33139,4.530899644517364,20.0,0.0
27314,2,7314,[179 173  88  15 228],786,4,33143,4.530827067669173,0.0,0.0
27315,2,7315,[318 427 496 357 257],330,5,33148,4.530891197375615,60.0,0.0
27316,2,7316,[318 427 496 357 257],796,5,33153,4.530955309553096,60.0,0.0
27317,2,7317,[318 427 496 357 257],796,5,33158,4.5310194042088,60.0,0.0
27318,2,7318,[318 427 496 357 257],716,5,33163,4.531083481349911,60.0,0.0
27319,2,7319,[318 427 496 357 257],330,5,33168,4.531147540983606,60.0,0.0
27320,2,7320,[ 82 196 423 161 405],885,4,33172,4.531074989755498,0.0,0.0
27321,2,7321,[318 427 496 357 257],716,5,33177,4.531139033051079,60.0,0.0
27322,2,7322,[385 132 234  28 181],796,3,33180,4.530929946743138,0.0,0.0
27323,2,7323,[597 258 238  98 405],450,5,33185,4.530993992353905,0.0,0.0
27324,2,7324,[318 427 496 357 257],796,5,33190,4.531058020477816,60.0,0.0
27325,2,7325,[179 125 195  11  50],655,2,33192,4.530712530712531,0.0,20.0
27326,2,7326,[318 427 496 357 257],330,5,33197,4.53077657977344,60.0,0.0
27327,2,7327,[318 427 496 357 257],330,5,33202,4.530840611353712,60.0,0.0
27328,2,7328,[318 427 496 357 257],716,5,33207,4.530904625460499,60.0,0.0
27329,2,7329,[ 12 185 161 202 111],450,5,33212,4.530968622100955,0.0,0.0
27330,2,7330,[ 70 118 748 483 186],151,3,33215,4.53075978720502,0.0,0.0
27331,2,7331,[318 427 496 357 257],716,5,33220,4.5308237861429355,60.0,0.0
27332,2,7332,[180 546 181  89  56],457,4,33224,4.530751397790809,0.0,0.0
27333,2,7333,[748 187 211  79 258],796,4,33228,4.530679029179166,0.0,0.0
27334,2,7334,[318 427 496 357 257],796,5,33233,4.530743012951602,60.0,0.0
27335,2,7335,[ 71  22 197  69 200],18,3,33236,4.530534351145038,0.0,0.0
27336,2,7336,[318 427 496 357 257],330,5,33241,4.5305983371950385,60.0,0.0
27337,2,7337,[234 181 405  98 403],450,4,33245,4.530526028890706,0.0,0.0
27338,2,7338,[318 427 496 357 257],330,5,33250,4.530589998637416,60.0,0.0
27339,2,7339,[318 427 496 357 257],796,5,33255,4.5306539509536785,60.0,0.0
27340,2,7340,[ 82 210 117   4 183],716,3,33258,4.530445443400081,0.0,0.0
27341,2,7341,[  4 496  95   1  79],280,4,33262,4.5303731953146285,20.0,0.0
27342,2,7342,[318 427 496 357 257],716,5,33267,4.53043715102819,60.0,0.0
27343,2,7343,[318 427 496 357 257],796,5,33272,4.530501089324619,60.0,0.0
27344,2,7344,[172 181  98 187 197],786,4,33276,4.530428863172226,0.0,0.0
27345,2,7345,[318 427 496 357 257],796,5,33281,4.530492785189218,60.0,0.0
27346,2,7346,[318 427 496 357 257],716,5,33286,4.530556689805363,60.0,0.0
27347,2,7347,[318 427 496 357 257],716,5,33291,4.530620577027762,60.0,0.0
27348,2,7348,[318 427 496 357 257],716,5,33296,4.530684446863519,60.0,0.0
27349,2,7349,[318 427 496 357 257],796,5,33301,4.530748299319728,60.0,0.0
27350,2,7350,[318 427 496 357 257],796,5,33306,4.530812134403482,60.0,0.0
27351,2,7351,[318 427 496 357 257],716,5,33311,4.530875952121872,60.0,0.0
27352,2,7352,[318 427 496 357 257],716,5,33316,4.53093975248198,60.0,0.0
27353,2,7353,[132 204 161 496 423],786,5,33321,4.531003535490889,20.0,0.0
27354,2,7354,[318 427 496 357 257],330,5,33326,4.531067301155677,60.0,0.0
27355,2,7355,[318 427 496 357 257],796,5,33331,4.531131049483415,60.0,0.0
27356,2,7356,[318 427 496 357 257],716,5,33336,4.531194780481174,60.0,0.0
27357,2,7357,[  9 546   4 222 181],796,4,33340,4.531122587659691,0.0,0.0
27358,2,7358,[174 322 191  25  82],151,2,33342,4.530778638401957,0.0,0.0
27359,2,7359,[318 427 496 357 257],796,5,33347,4.530842391304348,60.0,0.0
27360,2,7360,[318 427 496 357 257],716,5,33352,4.530906126884934,60.0,0.0
27361,2,7361,[216  11 135 211 117],716,4,33356,4.530834012496604,0.0,0.0
27362,2,7362,[318 427 496 357 257],330,5,33361,4.5308977319027575,60.0,0.0
27363,2,7363,[125 323  88 202 276],174,4,33365,4.530825638240087,0.0,0.0
27364,2,7364,[318 427 496 357 257],796,5,33370,4.5308893414799725,60.0,0.0
27365,2,7365,[318 427 496 357 257],796,5,33375,4.530953027423296,60.0,0.0
27366,2,7366,[318 427 496 357 257],716,5,33380,4.531016696077101,60.0,0.0
27367,2,7367,[318 427 496 357 257],716,5,33385,4.531080347448426,60.0,0.0
27368,2,7368,[318 427 496 357 257],716,5,33390,4.531143981544307,60.0,0.0
27369,2,7369,[ 28 597  82 742 196],450,4,33394,4.531071913161465,0.0,0.0
27370,2,7370,[318 427 496 357 257],330,5,33399,4.531135531135531,60.0,0.0
27371,2,7371,[318 427 496 357 257],716,5,33404,4.5311991318502445,60.0,0.0
27372,2,7372,[202 210 121 257 546],716,4,33408,4.531127085311271,0.0,0.0
27373,2,7373,[318 427 496 357 257],796,5,33413,4.531190669921346,60.0,0.0
27374,2,7374,[135  28 483  15 143],457,5,33418,4.5312542372881355,0.0,0.0
27375,2,7375,[318 427 496 357 257],330,5,33423,4.531317787418655,60.0,0.0
27376,2,7376,[318 427 496 357 257],796,5,33428,4.531381320319913,60.0,0.0
27377,2,7377,[318 427 496 357 257],716,5,33433,4.531444835998916,60.0,0.0
27378,2,7378,[508 294 265 132  64],655,1,33434,4.530966255590188,20.0,0.0
27379,2,7379,[318 427 496 357 257],716,5,33439,4.531029810298103,60.0,0.0
27380,2,7380,[318 427 496 357 257],716,5,33444,4.531093347784853,60.0,0.0
27381,2,7381,[191 435  96 194 238],269,3,33447,4.530885938769981,0.0,0.0
27382,2,7382,[ 82  22 483 271  88],796,4,33451,4.5308140322362185,0.0,0.0
27383,2,7383,[318 427 496 357 257],796,5,33456,4.530877573131094,60.0,0.0
27384,2,7384,[318 427 496 357 257],330,5,33461,4.530941096817874,60.0,0.0
27385,2,7385,[318 427 496 357 257],716,5,33466,4.531004603303547,60.0,0.0
27386,2,7386,[ 97 357 121  88 597],344,1,33467,4.530526600785163,0.0,0.0
27387,2,7387,[475 179 127 118  25],389,3,33470,4.530319436924743,0.0,20.0
27388,2,7388,[318 427 496 357 257],716,5,33475,4.530383001759372,60.0,0.0
27389,2,7389,[318 427 496 357 257],716,5,33480,4.530446549391069,60.0,0.0
27390,2,7390,[328 483 271 196 318],655,2,33482,4.530104180760384,20.0,0.0
27391,2,7391,[318 427 496 357 257],330,5,33487,4.530167748917749,60.0,0.0
27392,2,7392,[318 427 496 357 257],796,5,33492,4.530231299878263,60.0,0.0
27393,2,7393,[318 427 496 357 257],796,5,33497,4.530294833648904,60.0,0.0
27394,2,7394,[318 427 496 357 257],796,5,33502,4.5303583502366465,60.0,0.0
27395,2,7395,[318 427 496 357 257],330,5,33507,4.530421849648459,60.0,0.0
27396,2,7396,[318 427 496 357 257],330,5,33512,4.530485331891307,60.0,0.0
27397,2,7397,[318 427 496 357 257],796,5,33517,4.5305487969721545,60.0,0.0
27398,2,7398,[318 427 496 357 257],796,5,33522,4.530612244897959,60.0,0.0
27399,2,7399,[597 265 222 483 357],450,3,33525,4.530405405405405,0.0,0.0
27400,2,7400,[174 182 496  64 195],450,5,33530,4.530468855560059,40.0,0.0
27401,2,7401,[ 97 237  88 276 194],457,5,33535,4.530532288570656,0.0,0.0
27402,2,7402,[125 471 186 276  25],457,5,33540,4.530595704444144,0.0,0.0
27403,2,7403,[318 427 496 357 257],716,5,33545,4.530659103187467,60.0,0.0
27404,2,7404,[238 288 161 423 215],504,4,33549,4.530587440918298,0.0,0.0
27405,2,7405,[318 427 496 357 257],796,5,33554,4.530650823656495,60.0,0.0
27406,2,7406,[117 294 121   8 568],796,4,33558,4.530579181855002,0.0,0.0
27407,2,7407,[318 427 496 357 257],330,5,33563,4.530642548596112,60.0,0.0
27408,2,7408,[318 427 496 357 257],330,5,33568,4.53070589823188,60.0,0.0
27409,2,7409,[ 82 172   1 288 235],457,4,33572,4.530634278002699,0.0,0.0
27410,2,7410,[318 427 496 357 257],716,5,33577,4.530697611658345,60.0,0.0
27411,2,7411,[318 427 496 357 257],796,5,33582,4.530760928224501,60.0,0.0
27412,2,7412,[172 173 235 175 568],716,3,33585,4.53055443140429,0.0,0.0
27413,2,7413,[318 427 496 357 257],796,5,33590,4.53061775020232,60.0,0.0
27414,2,7414,[174  69 257  25 385],330,5,33595,4.53068105192178,0.0,0.0
27415,2,7415,[318 427 496 357 257],796,5,33600,4.53074433656958,60.0,0.0
27416,2,7416,[322 151  12  15 182],256,5,33605,4.530807604152622,0.0,0.0
27417,2,7417,[471 357 173 153 111],401,3,33608,4.530601240226476,0.0,0.0
27418,2,7418,[ 98   1 194  88 111],450,5,33613,4.530664510041785,0.0,0.0
27419,2,7419,[161  22 118  56 204],457,5,33618,4.5307277628032345,0.0,0.0
27420,2,7420,[318 427 496 357 257],330,5,33623,4.53079099851772,60.0,0.0
27421,2,7421,[318 427 496 357 257],330,5,33628,4.5308542171921316,60.0,0.0
27422,2,7422,[318 427 496 357 257],716,5,33633,4.530917418833356,60.0,0.0
27423,2,7423,[318 427 496 357 257],796,5,33638,4.530980603448276,60.0,0.0
27424,2,7424,[496 100 216 175 211],151,4,33642,4.530909090909091,20.0,20.0
27425,2,7425,[100 301 300 228 183],796,3,33645,4.530702935631565,0.0,20.0
27426,2,7426,[318 427 496 357 257],716,5,33650,4.53076612360307,60.0,0.0
27427,2,7427,[318 427 496 357 257],716,5,33655,4.53082929456112,60.0,0.0
27428,2,7428,[318 427 496 357 257],796,5,33660,4.530892448512586,60.0,0.0
27429,2,7429,[173  69 496 678 405],344,2,33662,4.530551816958277,20.0,0.0
27430,2,7430,[318 427 496 357 257],716,5,33667,4.530614991252859,60.0,0.0
27431,2,7431,[318 427 496 357 257],716,5,33672,4.530678148546825,60.0,0.0
27432,2,7432,[318 427 496 357 257],330,5,33677,4.530741288847033,60.0,0.0
27433,2,7433,[318 427 496 357 257],330,5,33682,4.530804412160345,60.0,0.0
27434,2,7434,[318 427 496 357 257],796,5,33687,4.530867518493611,60.0,0.0
27435,2,7435,[318 427 496 357 257],716,5,33692,4.530930607853684,60.0,0.0
27436,2,7436,[318 427 496 357 257],716,5,33697,4.530993680247412,60.0,0.0
27437,2,7437,[318 427 496 357 257],330,5,33702,4.531056735681635,60.0,0.0
27438,2,7438,[318 427 496 357 257],716,5,33707,4.531119774163194,60.0,0.0
27439,2,7439,[318 427 496 357 257],796,5,33712,4.531182795698925,60.0,0.0
27440,2,7440,[100 238  56  82 597],796,2,33714,4.530842628678941,0.0,20.0
27441,2,7441,[318 427 496 357 257],796,5,33719,4.530905670518678,60.0,0.0
27442,2,7442,[318 427 496 357 257],716,5,33724,4.530968695418514,60.0,0.0
27443,2,7443,[318 427 496 357 257],330,5,33729,4.531031703385277,60.0,0.0
27444,2,7444,[318 427 496 357 257],796,5,33734,4.531094694425789,60.0,0.0
27445,2,7445,[318 427 496 357 257],796,5,33739,4.531157668546871,60.0,0.0
27446,2,7446,[318 427 496 357 257],330,5,33744,4.531220625755338,60.0,0.0
27447,2,7447,[318 427 496 357 257],716,5,33749,4.531283566058002,60.0,0.0
27448,2,7448,[204 182 496  50  70],280,2,33751,4.530943750839039,20.0,20.0
27449,2,7449,[333  70 182 234 318],655,2,33753,4.530604026845638,20.0,0.0
27450,2,7450,[318 427 496 357 257],796,5,33758,4.530667024560461,60.0,0.0
27451,2,7451,[318 427 496 357 257],716,5,33763,4.530730005367687,60.0,0.0
27452,2,7452,[318 427 496 357 257],796,5,33768,4.530792969274118,60.0,0.0
27453,2,7453,[276 273 173  97 181],401,2,33770,4.5304534478132545,0.0,0.0
27454,2,7454,[318 427 496 357 257],716,5,33775,4.530516431924883,60.0,0.0
27455,2,7455,[318 427 496 357 257],796,5,33780,4.530579399141631,60.0,0.0
27456,2,7456,[318 427 496 357 257],330,5,33785,4.5306423494702965,60.0,0.0
27457,2,7457,[318 427 496 357 257],716,5,33790,4.530705282917673,60.0,0.0
27458,2,7458,[235  11   9  98 748],292,3,33793,4.530500067033114,0.0,0.0
27459,2,7459,[318 427 496 357 257],716,5,33798,4.530563002680966,60.0,0.0
27460,2,7460,[273 237  69 197 288],450,3,33801,4.530357860876558,0.0,0.0
27461,2,7461,[318 427 496 357 257],796,5,33806,4.5304207987134815,60.0,0.0
27462,2,7462,[318 427 496 357 257],330,5,33811,4.530483719683773,60.0,0.0
27463,2,7463,[318 427 496 357 257],330,5,33816,4.530546623794212,60.0,0.0
27464,2,7464,[318 427 496 357 257],796,5,33821,4.530609511051574,60.0,0.0
27465,2,7465,[318 427 496 357 257],716,5,33826,4.53067238146263,60.0,0.0
27466,2,7466,[427  28  11 288  50],655,2,33828,4.530333467255926,20.0,20.0
27467,2,7467,[318 427 496 357 257],716,5,33833,4.530396357793252,60.0,0.0
27468,2,7468,[318 427 496 357 257],796,5,33838,4.530459231490159,60.0,0.0
27469,2,7469,[111 173 191 194  22],577,5,33843,4.530522088353414,0.0,0.0
27470,2,7470,[318 427 496 357 257],716,5,33848,4.530584928389774,60.0,0.0
27471,2,7471,[318 427 496 357 257],796,5,33853,4.530647751605995,60.0,0.0
27472,2,7472,[318 427 496 357 257],796,5,33858,4.530710558008832,60.0,0.0
27473,2,7473,[357 234 185 288 121],457,5,33863,4.530773347605031,0.0,0.0
27474,2,7474,[318 427 496 357 257],330,5,33868,4.530836120401338,60.0,0.0
27475,2,7475,[318 427 496 357 257],330,5,33873,4.530898876404494,60.0,0.0
27476,2,7476,[172  82 423 215  56],796,4,33877,4.530827872141233,0.0,0.0
27477,2,7477,[318 427 496 357 257],716,5,33882,4.530890612463225,60.0,0.0
27478,2,7478,[318 427 496 357 257],716,5,33887,4.530953336007488,60.0,0.0
27479,2,7479,[318 427 496 357 257],796,5,33892,4.531016042780749,60.0,0.0
27480,2,7480,[ 50 191 294  89 210],796,3,33895,4.530811388851758,0.0,20.0
27481,2,7481,[318 427 496 357 257],796,5,33900,4.530874097834803,60.0,0.0
27482,2,7482,[172 144 125 118  98],796,5,33905,4.5309367900574635,0.0,0.0
27483,2,7483,[318 427 496 357 257],716,5,33910,4.530999465526456,60.0,0.0
27484,2,7484,[318 427 496 357 257],330,5,33915,4.531062124248497,60.0,0.0
27485,2,7485,[195 597 655 235 282],450,4,33919,4.530991183542613,0.0,0.0
27486,2,7486,[318 427 496 357 257],796,5,33924,4.531053826632831,60.0,0.0
27487,2,7487,[318 427 496 357 257],796,5,33929,4.531116452991453,60.0,0.0
27488,2,7488,[282 403 180  96 588],280,3,33932,4.530912004272934,0.0,0.0
27489,2,7489,[323   8 275 144  71],23,2,33934,4.530574098798398,0.0,20.0
27490,2,7490,[318 427 496 357 257],716,5,33939,4.530636764116941,60.0,0.0
27491,2,7491,[318 427 496 357 257],796,5,33944,4.530699412706888,60.0,0.0
27492,2,7492,[318 427 496 357 257],716,5,33949,4.530762044574937,60.0,0.0
27493,2,7493,[318 427 496 357 257],796,5,33954,4.530824659727783,60.0,0.0
27494,2,7494,[186 161   8 118  71],389,2,33956,4.530486991327551,0.0,0.0
27495,2,7495,[318 427 496 357 257],796,5,33961,4.530549626467449,60.0,0.0
27496,2,7496,[318 427 496 357 257],796,5,33966,4.530612244897959,60.0,0.0
27497,2,7497,[318 427 496 357 257],716,5,33971,4.530674846625767,60.0,0.0
27498,2,7498,[318 427 496 357 257],716,5,33976,4.530737431657554,60.0,0.0
27499,2,7499,[318 427 496 357 257],796,5,33981,4.5308,60.0,0.0
27500,2,7500,[194 121 286 118  71],450,2,33983,4.530462604986002,0.0,20.0
27501,2,7501,[ 82 111 302 216 222],450,3,33986,4.530258597707278,0.0,0.0
27502,2,7502,[318 427 496 357 257],796,5,33991,4.530321204851393,60.0,0.0
27503,2,7503,[318 427 496 357 257],716,5,33996,4.530383795309168,60.0,0.0
27504,2,7504,[318 427 496 357 257],796,5,34001,4.530446369087275,60.0,0.0
27505,2,7505,[269 185 385 173 435],503,3,34004,4.530242472688516,0.0,0.0
27506,2,7506,[318 427 496 357 257],796,5,34009,4.530305048621287,60.0,0.0
27507,2,7507,[318 427 496 357 257],330,5,34014,4.530367607884923,60.0,0.0
27508,2,7508,[318 427 496 357 257],796,5,34019,4.530430150486083,60.0,0.0
27509,2,7509,[318 427 496 357 257],330,5,34024,4.530492676431424,60.0,0.0
27510,2,7510,[318 427 496 357 257],330,5,34029,4.530555185727599,60.0,0.0
27511,2,7511,[318 427 496 357 257],330,5,34034,4.530617678381256,60.0,0.0
27512,2,7512,[318 427 496 357 257],330,5,34039,4.530680154399041,60.0,0.0
27513,2,7513,[318 427 496 357 257],796,5,34044,4.530742613787597,60.0,0.0
27514,2,7514,[318 427 496 357 257],330,5,34049,4.530805056553559,60.0,0.0
27515,2,7515,[282 144   4  11 161],457,5,34054,4.530867482703566,0.0,0.0
27516,2,7516,[318 427 496 357 257],796,5,34059,4.530929892244246,60.0,0.0
27517,2,7517,[318 427 496 357 257],796,5,34064,4.530992285182229,60.0,0.0
27518,2,7518,[318 427 496 357 257],330,5,34069,4.531054661524139,60.0,0.0
27519,2,7519,[318 427 496 357 257],716,5,34074,4.531117021276596,60.0,0.0
27520,2,7520,[318 427 496 357 257],796,5,34079,4.531179364446217,60.0,0.0
27521,2,7521,[318 427 496 357 257],330,5,34084,4.531241691039617,60.0,0.0
27522,2,7522,[318 427 496 357 257],330,5,34089,4.531304001063406,60.0,0.0
27523,2,7523,[196 216 151 483  95],18,3,34092,4.5311004784688995,0.0,0.0
27524,2,7524,[318 427 496 357 257],330,5,34097,4.531162790697675,60.0,0.0
27525,2,7525,[318 427 496 357 257],796,5,34102,4.53122508636726,60.0,0.0
27526,2,7526,[318 427 496 357 257],796,5,34107,4.531287365484257,60.0,0.0
27527,2,7527,[357 202 286 179  71],786,5,34112,4.531349628055261,0.0,20.0
27528,2,7528,[318 427 496 357 257],716,5,34117,4.5314118740868645,60.0,0.0
27529,2,7529,[318 427 496 357 257],330,5,34122,4.531474103585658,60.0,0.0
27530,2,7530,[180 197  88 191 121],796,3,34125,4.531270747576683,0.0,0.0
27531,2,7531,[215 118  11  25 294],716,4,34129,4.531200212426978,0.0,0.0
27532,2,7532,[318 427 496 357 257],330,5,34134,4.53126244524094,60.0,0.0
27533,2,7533,[135 151 282 174  50],450,4,34138,4.531191929917706,0.0,20.0
27534,2,7534,[318 427 496 357 257],330,5,34143,4.531254147312541,60.0,0.0
27535,2,7535,[318 427 496 357 257],796,5,34148,4.531316348195329,60.0,0.0
27536,2,7536,[318 427 496 357 257],716,5,34153,4.531378532572641,60.0,0.0
27537,2,7537,[318 427 496 357 257],330,5,34158,4.531440700451048,60.0,0.0
27538,2,7538,[318 427 496 357 257],716,5,34163,4.531502851837113,60.0,0.0
27539,2,7539,[318 427 496 357 257],330,5,34168,4.531564986737401,60.0,0.0
27540,2,7540,[318 427 496 357 257],716,5,34173,4.531627105158467,60.0,0.0
27541,2,7541,[318 427 496 357 257],796,5,34178,4.531689207106869,60.0,0.0
27542,2,7542,[318 427 496 357 257],330,5,34183,4.531751292589155,60.0,0.0
27543,2,7543,[222 168 215 286  69],450,4,34187,4.531680805938494,0.0,20.0
27544,2,7544,[318 427 496 357 257],716,5,34192,4.531742876076872,60.0,0.0
27545,2,7545,[318 427 496 357 257],796,5,34197,4.531804929764114,60.0,0.0
27546,2,7546,[318 427 496 357 257],330,5,34202,4.531866967006757,60.0,0.0
27547,2,7547,[ 64 235 273 286 132],450,3,34205,4.531664016958135,20.0,20.0
27548,2,7548,[318 427 496 357 257],716,5,34210,4.5317260564313155,60.0,0.0
27549,2,7549,[318 427 496 357 257],716,5,34215,4.531788079470199,60.0,0.0
27550,2,7550,[603 471 301 275  15],655,2,34217,4.531452787710237,20.0,20.0
27551,2,7551,[318 427 496 357 257],796,5,34222,4.531514830508475,60.0,0.0
27552,2,7552,[318 427 496 357 257],716,5,34227,4.531576856878062,60.0,0.0
27553,2,7553,[318 427 496 357 257],330,5,34232,4.5316388668255225,60.0,0.0
27554,2,7554,[403 204 211  64  98],269,3,34235,4.531436135009927,20.0,0.0
27555,2,7555,[318 427 496 357 257],716,5,34240,4.531498147167814,60.0,0.0
27556,2,7556,[318 427 496 357 257],330,5,34245,4.531560142913855,60.0,0.0
27557,2,7557,[318 427 496 357 257],796,5,34250,4.531622122254564,60.0,0.0
27558,2,7558,[318 427 496 357 257],716,5,34255,4.531684085196455,60.0,0.0
27559,2,7559,[135 403 185   7 655],450,4,34259,4.531613756613757,0.0,0.0
27560,2,7560,[318 427 496 357 257],330,5,34264,4.531675704271922,60.0,0.0
27561,2,7561,[318 427 496 357 257],796,5,34269,4.531737635546151,60.0,0.0
27562,2,7562,[318 427 496 357 257],330,5,34274,4.531799550442946,60.0,0.0
27563,2,7563,[318 427 496 357 257],796,5,34279,4.531861448968799,60.0,0.0
27564,2,7564,[318 427 496 357 257],796,5,34284,4.531923331130205,60.0,0.0
27565,2,7565,[161 597 282 121 568],593,4,34288,4.531853026698387,0.0,0.0
27566,2,7566,[318 427 496 357 257],716,5,34293,4.531914893617022,60.0,0.0
27567,2,7567,[318 427 496 357 257],796,5,34298,4.531976744186046,60.0,0.0
27568,2,7568,[318 427 496 357 257],716,5,34303,4.532038578411943,60.0,0.0
27569,2,7569,[318 427 496 357 257],330,5,34308,4.532100396301189,60.0,0.0
27570,2,7570,[318 427 496 357 257],330,5,34313,4.532162197860257,60.0,0.0
27571,2,7571,[318 427 496 357 257],796,5,34318,4.532223983095616,60.0,0.0
27572,2,7572,[318 427 496 357 257],330,5,34323,4.532285752013733,60.0,0.0
27573,2,7573,[318 427 496 357 257],716,5,34328,4.532347504621072,60.0,0.0
27574,2,7574,[318 427 496 357 257],330,5,34333,4.532409240924093,60.0,0.0
27575,2,7575,[318 427 496 357 257],330,5,34338,4.53247096092925,60.0,0.0
27576,2,7576,[ 64 286  12 289  98],655,2,34340,4.532136729576349,20.0,20.0
27577,2,7577,[318 427 496 357 257],796,5,34345,4.532198469253101,60.0,0.0
27578,2,7578,[318 427 496 357 257],330,5,34350,4.532260192637551,60.0,0.0
27579,2,7579,[271  71  56 202  64],796,5,34355,4.532321899736147,20.0,0.0
27580,2,7580,[117 603 238 257  96],796,4,34359,4.532251681836169,20.0,0.0
27581,2,7581,[318 427 496 357 257],716,5,34364,4.532313373780005,60.0,0.0
27582,2,7582,[286 111 125 176 435],450,5,34369,4.532375049452723,0.0,20.0
27583,2,7583,[318 427 496 357 257],716,5,34374,4.532436708860759,60.0,0.0
27584,2,7584,[318 427 496 357 257],716,5,34379,4.532498352010547,60.0,0.0
27585,2,7585,[318 427 496 357 257],330,5,34384,4.532559978908516,60.0,0.0
27586,2,7586,[318 427 496 357 257],796,5,34389,4.532621589561091,60.0,0.0
27587,2,7587,[318 427 496 357 257],716,5,34394,4.532683183974697,60.0,0.0
27588,2,7588,[318 427 496 357 257],330,5,34399,4.532744762155752,60.0,0.0
27589,2,7589,[318 427 496 357 257],330,5,34404,4.5328063241106715,60.0,0.0
27590,2,7590,[423  28 194  50 313],835,5,34409,4.53286786984587,0.0,20.0
27591,2,7591,[318 427 496 357 257],796,5,34414,4.532929399367756,60.0,0.0
27592,2,7592,[318 427 496 357 257],330,5,34419,4.532990912682734,60.0,0.0
27593,2,7593,[318 427 496 357 257],796,5,34424,4.533052409797208,60.0,0.0
27594,2,7594,[318 427 496 357 257],716,5,34429,4.533113890717577,60.0,0.0
27595,2,7595,[318 427 496 357 257],716,5,34434,4.533175355450237,60.0,0.0
27596,2,7596,[ 98 195  50 313 286],450,5,34439,4.53323680400158,0.0,40.0
27597,2,7597,[318 427 496 357 257],796,5,34444,4.533298236377994,60.0,0.0
27598,2,7598,[318 427 496 357 257],330,5,34449,4.533359652585866,60.0,0.0
27599,2,7599,[258 496 117 202 269],450,5,34454,4.533421052631579,20.0,0.0
27600,2,7600,[318 427 496 357 257],796,5,34459,4.533482436521511,60.0,0.0
27601,2,7601,[318 427 496 357 257],796,5,34464,4.533543804262036,60.0,0.0
27602,2,7602,[318 427 496 357 257],716,5,34469,4.533605155859529,60.0,0.0
27603,2,7603,[318 427 496 357 257],796,5,34474,4.533666491320358,60.0,0.0
27604,2,7604,[318 427 496 357 257],716,5,34479,4.533727810650888,60.0,0.0
27605,2,7605,[318 427 496 357 257],330,5,34484,4.533789113857481,60.0,0.0
27606,2,7606,[238 111 405 288 237],655,0,34484,4.53319311160773,0.0,0.0
27607,2,7607,[318 427 496 357 257],330,5,34489,4.533254468980021,60.0,0.0
27608,2,7608,[181 655  79  11 748],450,5,34494,4.5333158102247335,0.0,0.0
27609,2,7609,[187 423 234 588 496],786,4,34498,4.533245729303548,20.0,0.0
27610,2,7610,[318 427 496 357 257],716,5,34503,4.5333070555774535,60.0,0.0
27611,2,7611,[318 427 496 357 257],716,5,34508,4.533368365738308,60.0,0.0
27612,2,7612,[318 427 496 357 257],716,5,34513,4.533429659792461,60.0,0.0
27613,2,7613,[318 427 496 357 257],716,5,34518,4.533490937746257,60.0,0.0
27614,2,7614,[318 427 496 357 257],330,5,34523,4.53355219960604,60.0,0.0
27615,2,7615,[172  28  22   1 515],716,5,34528,4.533613445378151,0.0,0.0
27616,2,7616,[318 427 496 357 257],796,5,34533,4.533674675068925,60.0,0.0
27617,2,7617,[318 427 496 357 257],330,5,34538,4.533735888684694,60.0,0.0
27618,2,7618,[174 286 269  22 185],18,4,34542,4.533665835411472,0.0,20.0
27619,2,7619,[210 175 228 238 471],457,5,34547,4.5337270341207345,0.0,0.0
27620,2,7620,[187 357  97 423 210],716,4,34551,4.533657000393649,0.0,0.0
27621,2,7621,[318 427 496 357 257],796,5,34556,4.533718184203621,60.0,0.0
27622,2,7622,[204 172 125 275 118],796,5,34561,4.53377935196117,0.0,20.0
27623,2,7623,[318 427 496 357 257],330,5,34566,4.533840503672613,60.0,0.0
27624,2,7624,[275 202 742 282 200],457,5,34571,4.533901639344262,0.0,20.0
27625,2,7625,[318 427 496 357 257],330,5,34576,4.533962758982429,60.0,0.0
27626,2,7626,[318 427 496 357 257],796,5,34581,4.534023862593418,60.0,0.0
27627,2,7627,[302  97 276 161 588],401,2,34583,4.5336916622968015,0.0,0.0
27628,2,7628,[318 427 496 357 257],330,5,34588,4.53375278542404,60.0,0.0
27629,2,7629,[318 427 496 357 257],330,5,34593,4.533813892529489,60.0,0.0
27630,2,7630,[318 427 496 357 257],716,5,34598,4.533874983619447,60.0,0.0
27631,2,7631,[318 427 496 357 257],716,5,34603,4.53393605870021,60.0,0.0
27632,2,7632,[318 427 496 357 257],796,5,34608,4.533997117778069,60.0,0.0
27633,2,7633,[183 127 275 288 173],450,4,34612,4.533927167932932,0.0,40.0
27634,2,7634,[385 265 117 318 216],577,5,34617,4.533988212180747,20.0,0.0
27635,2,7635,[483 202  97 204 655],457,5,34622,4.534049240440021,0.0,0.0
27636,2,7636,[  7 125  25   1 300],518,3,34625,4.533848369778709,0.0,0.0
27637,2,7637,[318 427 496 357 257],796,5,34630,4.533909400366588,60.0,0.0
27638,2,7638,[ 98 318   7 196 182],535,3,34633,4.533708600602173,20.0,0.0
27639,2,7639,[318 427 496 357 257],796,5,34638,4.533769633507854,60.0,0.0
27640,2,7640,[318 427 496 357 257],796,5,34643,4.533830650438424,60.0,0.0
27641,2,7641,[318 427 496 357 257],330,5,34648,4.533891651400157,60.0,0.0
27642,2,7642,[318 427 496 357 257],796,5,34653,4.533952636399319,60.0,0.0
27643,2,7643,[318 427 496 357 257],330,5,34658,4.534013605442177,60.0,0.0
27644,2,7644,[318 427 496 357 257],716,5,34663,4.53407455853499,60.0,0.0
27645,2,7645,[318 427 496 357 257],796,5,34668,4.534135495684017,60.0,0.0
27646,2,7646,[216 118 405 257 271],796,5,34673,4.534196416895514,0.0,0.0
27647,2,7647,[318 427 496 357 257],796,5,34678,4.5342573221757325,60.0,0.0
27648,2,7648,[318 427 496 357 257],716,5,34683,4.534318211530919,60.0,0.0
27649,2,7649,[318 427 496 357 257],716,5,34688,4.534379084967321,60.0,0.0
27650,2,7650,[318 427 496 357 257],716,5,34693,4.534439942491177,60.0,0.0
27651,2,7651,[196 121 435  15 111],655,0,34693,4.533847360167276,0.0,0.0
27652,2,7652,[318 427 496 357 257],716,5,34698,4.53390827126617,60.0,0.0
27653,2,7653,[318 427 496 357 257],796,5,34703,4.533969166448916,60.0,0.0
27654,2,7654,[318 427 496 357 257],330,5,34708,4.53403004572175,60.0,0.0
27655,2,7655,[318 427 496 357 257],796,5,34713,4.534090909090909,60.0,0.0
27656,2,7656,[318 427 496 357 257],330,5,34718,4.534151756562623,60.0,0.0
27657,2,7657,[318 427 496 357 257],716,5,34723,4.534212588143118,60.0,0.0
27658,2,7658,[318 427 496 357 257],330,5,34728,4.534273403838621,60.0,0.0
27659,2,7659,[318 427 496 357 257],796,5,34733,4.5343342036553524,60.0,0.0
27660,2,7660,[318 427 496 357 257],716,5,34738,4.53439498759953,60.0,0.0
27661,2,7661,[318 427 496 357 257],330,5,34743,4.534455755677369,60.0,0.0
27662,2,7662,[423 403 175 202 289],655,0,34743,4.533864021923528,0.0,0.0
27663,2,7663,[195 235 185 323   4],256,4,34747,4.533794363256785,0.0,0.0
27664,2,7664,[546 211  70  12 357],151,4,34751,4.533724722765819,0.0,0.0
27665,2,7665,[318 427 496 357 257],796,5,34756,4.533785546569267,60.0,0.0
27666,2,7666,[318 427 496 357 257],716,5,34761,4.533846354506326,60.0,0.0
27667,2,7667,[322 195  82 118   9],796,2,34763,4.533515910276473,0.0,0.0
27668,2,7668,[  1 427 508 403 313],655,2,34765,4.5331855522232365,20.0,0.0
27669,2,7669,[318 427 496 357 257],716,5,34770,4.533246414602347,60.0,0.0
27670,2,7670,[300 742 357 508  22],11,3,34773,4.533046538912789,0.0,0.0
27671,2,7671,[318 427 496 357 257],330,5,34778,4.53310740354536,60.0,0.0
27672,2,7672,[ 82 268 318  98  88],269,3,34781,4.532907598071159,20.0,0.0
27673,2,7673,[546 258 385 286 655],151,3,34784,4.532707844670315,0.0,20.0
27674,2,7674,[ 69 181  56 403   4],18,1,34785,4.532247557003258,0.0,0.0
27675,2,7675,[508 655 144 222  96],280,1,34786,4.531787389265243,0.0,0.0
27676,2,7676,[318 427 496 357 257],330,5,34791,4.5318483782727625,60.0,0.0
27677,2,7677,[318 427 496 357 257],796,5,34796,4.531909351393592,60.0,0.0
27678,2,7678,[742 405 222 597  98],256,5,34801,4.5319703086339365,0.0,0.0
27679,2,7679,[318 427 496 357 257],330,5,34806,4.53203125,60.0,0.0
27680,2,7680,[318 427 496 357 257],796,5,34811,4.532092175497982,60.0,0.0
27681,2,7681,[318 427 496 357 257],796,5,34816,4.532153085134079,60.0,0.0
27682,2,7682,[318 427 496 357 257],716,5,34821,4.532213978914487,60.0,0.0
27683,2,7683,[318 427 496 357 257],796,5,34826,4.532274856845393,60.0,0.0
27684,2,7684,[318 427 496 357 257],796,5,34831,4.532335718932987,60.0,0.0
27685,2,7685,[318 427 496 357 257],716,5,34836,4.532396565183451,60.0,0.0
27686,2,7686,[318 427 496 357 257],796,5,34841,4.532457395602966,60.0,0.0
27687,2,7687,[318 427 496 357 257],330,5,34846,4.53251821019771,60.0,0.0
27688,2,7688,[ 50   7 238 132 182],535,4,34850,4.532448953049811,0.0,20.0
27689,2,7689,[181 286 271   8 328],796,4,34854,4.532379713914175,0.0,20.0
27690,2,7690,[318 427 496 357 257],796,5,34859,4.532440514887531,60.0,0.0
27691,2,7691,[215 168  88 173  82],151,3,34862,4.532241289651586,0.0,0.0
27692,2,7692,[318 427 496 357 257],330,5,34867,4.532302092811647,60.0,0.0
27693,2,7693,[318 427 496 357 257],330,5,34872,4.532362880166364,60.0,0.0
27694,2,7694,[318 427 496 357 257],796,5,34877,4.532423651721897,60.0,0.0
27695,2,7695,[318 427 496 357 257],796,5,34882,4.532484407484407,60.0,0.0
27696,2,7696,[318 423 515  69 403],72,4,34886,4.532415226711706,20.0,0.0
27697,2,7697,[318 427 496 357 257],796,5,34891,4.5324759677838395,60.0,0.0
27698,2,7698,[318 427 496 357 257],716,5,34896,4.532536693077023,60.0,0.0
27699,2,7699,[318 427 496 357 257],330,5,34901,4.5325974025974025,60.0,0.0
27700,2,7700,[318 427 496 357 257],796,5,34906,4.532658096351123,60.0,0.0
27701,2,7701,[237 191 269 238 273],655,2,34908,4.5323292651259415,0.0,0.0
27702,2,7702,[318 427 496 357 257],716,5,34913,4.532389977930676,60.0,0.0
27703,2,7703,[318 427 496 357 257],716,5,34918,4.532450674974039,60.0,0.0
27704,2,7704,[318 427 496 357 257],796,5,34923,4.532511356262168,60.0,0.0
27705,2,7705,[318 427 496 357 257],330,5,34928,4.532572021801194,60.0,0.0
27706,2,7706,[318 427 496 357 257],330,5,34933,4.532632671597249,60.0,0.0
27707,2,7707,[318 427 496 357 257],716,5,34938,4.532693305656461,60.0,0.0
27708,2,7708,[318 427 496 357 257],716,5,34943,4.532753923984953,60.0,0.0
27709,2,7709,[318 427 496 357 257],716,5,34948,4.5328145265888455,60.0,0.0
27710,2,7710,[318 427 496 357 257],330,5,34953,4.532875113474257,60.0,0.0
27711,2,7711,[318 427 496 357 257],796,5,34958,4.532935684647303,60.0,0.0
27712,2,7712,[204 176 121  22   7],450,4,34962,4.532866588875923,0.0,0.0
27713,2,7713,[318 427 496 357 257],330,5,34967,4.532927145449832,60.0,0.0
27714,2,7714,[318 427 496 357 257],796,5,34972,4.53298768632534,60.0,0.0
27715,2,7715,[318 427 496 357 257],796,5,34977,4.533048211508554,60.0,0.0
27716,2,7716,[471 427 286 568 234],389,3,34980,4.532849552935079,20.0,20.0
27717,2,7717,[318 427 496 357 257],330,5,34985,4.532910080331692,60.0,0.0
27718,2,7718,[318 427 496 357 257],330,5,34990,4.532970592045602,60.0,0.0
27719,2,7719,[161 435 135 181 313],450,4,34994,4.532901554404145,0.0,0.0
27720,2,7720,[ 88   4 385 222 216],344,3,34997,4.532703017743816,0.0,0.0
27721,2,7721,[318 427 496 357 257],330,5,35002,4.532763532763533,60.0,0.0
27722,2,7722,[318 427 496 357 257],796,5,35007,4.532824032111874,60.0,0.0
27723,2,7723,[318 427 496 357 257],716,5,35012,4.532884515794925,60.0,0.0
27724,2,7724,[318 427 496 357 257],330,5,35017,4.53294498381877,60.0,0.0
27725,2,7725,[318 427 496 357 257],796,5,35022,4.53300543618949,60.0,0.0
27726,2,7726,[318 427 496 357 257],716,5,35027,4.533065872913162,60.0,0.0
27727,2,7727,[318 427 496 357 257],716,5,35032,4.533126293995859,60.0,0.0
27728,2,7728,[318 427 496 357 257],330,5,35037,4.533186699443654,60.0,0.0
27729,2,7729,[318 427 496 357 257],796,5,35042,4.5332470892626135,60.0,0.0
27730,2,7730,[168  97  25  11  56],716,5,35047,4.533307463458803,0.0,0.0
27731,2,7731,[318 427 496 357 257],716,5,35052,4.533367822038282,60.0,0.0
27732,2,7732,[318 427 496 357 257],796,5,35057,4.533428165007113,60.0,0.0
27733,2,7733,[318 427 496 357 257],330,5,35062,4.533488492371347,60.0,0.0
27734,2,7734,[257 135 333 423 508],655,1,35063,4.533031674208145,0.0,0.0
27735,2,7735,[318 427 496 357 257],330,5,35068,4.533092037228542,60.0,0.0
27736,2,7736,[318 427 496 357 257],330,5,35073,4.533152384645211,60.0,0.0
27737,2,7737,[318 427 496 357 257],796,5,35078,4.533212716464202,60.0,0.0
27738,2,7738,[318 427 496 357 257],716,5,35083,4.533273032691562,60.0,0.0
27739,2,7739,[318 427 496 357 257],330,5,35088,4.533333333333333,60.0,0.0
27740,2,7740,[318 427 496 357 257],330,5,35093,4.533393618395556,60.0,0.0
27741,2,7741,[318 427 496 357 257],716,5,35098,4.533453887884268,60.0,0.0
27742,2,7742,[496 423 176 202 180],716,3,35101,4.533255843988118,20.0,0.0
27743,2,7743,[143 132  97   7  96],693,5,35106,4.53331611570248,0.0,0.0
27744,2,7744,[546 197 181 127 215],504,4,35110,4.533247256294383,0.0,20.0
27745,2,7745,[318 427 496 357 257],330,5,35115,4.533307513555384,60.0,0.0
27746,2,7746,[318 427 496 357 257],330,5,35120,4.533367755260101,60.0,0.0
27747,2,7747,[318 427 496 357 257],796,5,35125,4.533427981414558,60.0,0.0
27748,2,7748,[318 427 496 357 257],716,5,35130,4.533488192024778,60.0,0.0
27749,2,7749,[318 427 496 357 257],796,5,35135,4.533548387096774,60.0,0.0
27750,2,7750,[318 427 496 357 257],330,5,35140,4.533608566636563,60.0,0.0
27751,2,7751,[ 50 496 237 174  89],269,1,35141,4.533152734778122,20.0,20.0
27752,2,7752,[318 427 496 357 257],796,5,35146,4.533212949825874,60.0,0.0
27753,2,7753,[318 427 496 357 257],796,5,35151,4.533273149342275,60.0,0.0
27754,2,7754,[588 194 186 204 496],20,2,35153,4.532946486137975,20.0,0.0
27755,2,7755,[318 427 496 357 257],796,5,35158,4.533006704486849,60.0,0.0
27756,2,7756,[318 427 496 357 257],330,5,35163,4.533066907309527,60.0,0.0
27757,2,7757,[282 318  15   4  25],593,4,35167,4.532998195411189,20.0,0.0
27758,2,7758,[742 195 508 301  22],344,3,35170,4.532800618636422,0.0,0.0
27759,2,7759,[318 427 496 357 257],796,5,35175,4.532860824742268,60.0,0.0
27760,2,7760,[318 427 496 357 257],796,5,35180,4.532921015333075,60.0,0.0
27761,2,7761,[318 427 496 357 257],716,5,35185,4.532981190414842,60.0,0.0
27762,2,7762,[318 427 496 357 257],330,5,35190,4.533041349993559,60.0,0.0
27763,2,7763,[ 22 273 515 196 127],655,3,35193,4.532843894899536,0.0,20.0
27764,2,7764,[204 235 546 568 228],457,3,35196,4.532646490663232,0.0,0.0
27765,2,7765,[318 427 496 357 257],330,5,35201,4.5327066701004375,60.0,0.0
27766,2,7766,[318 427 496 357 257],796,5,35206,4.532766834041458,60.0,0.0
27767,2,7767,[318 427 496 357 257],716,5,35211,4.532826982492276,60.0,0.0
27768,2,7768,[318 427 496 357 257],330,5,35216,4.532887115458875,60.0,0.0
27769,2,7769,[318 427 496 357 257],330,5,35221,4.532947232947233,60.0,0.0
27770,2,7770,[318 427 496 357 257],716,5,35226,4.533007334963325,60.0,0.0
27771,2,7771,[318 427 496 357 257],716,5,35231,4.533067421513124,60.0,0.0
27772,2,7772,[318 427 496 357 257],716,5,35236,4.533127492602599,60.0,0.0
27773,2,7773,[318 427 496 357 257],716,5,35241,4.5331875482377155,60.0,0.0
27774,2,7774,[ 22 385 234  28 197],457,5,35246,4.533247588424437,0.0,0.0
27775,2,7775,[318 427 496 357 257],330,5,35251,4.533307613168724,60.0,0.0
27776,2,7776,[228   4 151 234 238],450,3,35254,4.533110453902533,0.0,0.0
27777,2,7777,[258 161 234 748 173],807,2,35256,4.532784777577784,0.0,0.0
27778,2,7778,[318 427 496 357 257],796,5,35261,4.532844838668209,60.0,0.0
27779,2,7779,[318 427 496 357 257],796,5,35266,4.532904884318766,60.0,0.0
27780,2,7780,[318 427 496 357 257],796,5,35271,4.532964914535407,60.0,0.0
27781,2,7781,[318 427 496 357 257],330,5,35276,4.533024929324081,60.0,0.0
27782,2,7782,[318 427 496 357 257],716,5,35281,4.533084928690736,60.0,0.0
27783,2,7783,[318 427 496 357 257],716,5,35286,4.5331449126413155,60.0,0.0
27784,2,7784,[318 427 496 357 257],330,5,35291,4.53320488118176,60.0,0.0
27785,2,7785,[318 427 496 357 257],330,5,35296,4.533264834318007,60.0,0.0
27786,2,7786,[318 427 496 357 257],716,5,35301,4.533324772055991,60.0,0.0
27787,2,7787,[318 427 496 357 257],716,5,35306,4.533384694401644,60.0,0.0
27788,2,7788,[318 427 496 357 257],330,5,35311,4.533444601360894,60.0,0.0
27789,2,7789,[318 427 496 357 257],330,5,35316,4.533504492939667,60.0,0.0
27790,2,7790,[ 50 302 100 222 328],450,4,35320,4.5334360159158,0.0,40.0
27791,2,7791,[318 427 496 357 257],330,5,35325,4.53349589322382,60.0,0.0
27792,2,7792,[  4 181 118 403 168],796,5,35330,4.533555755164891,0.0,0.0
27793,2,7793,[318 427 496 357 257],330,5,35335,4.533615601744932,60.0,0.0
27794,2,7794,[318 427 496 357 257],330,5,35340,4.5336754329698525,60.0,0.0
27795,2,7795,[318 427 496 357 257],796,5,35345,4.533735248845562,60.0,0.0
27796,2,7796,[ 88 655 245 176 282],796,3,35348,4.533538540464281,0.0,0.0
27797,2,7797,[318 427 496 357 257],716,5,35353,4.533598358553475,60.0,0.0
27798,2,7798,[471 427 196 289  82],655,1,35354,4.5331452750352605,20.0,0.0
27799,2,7799,[318 427 496 357 257],330,5,35359,4.533205128205128,60.0,0.0
27800,2,7800,[318 427 496 357 257],796,5,35364,4.533264966029996,60.0,0.0
27801,2,7801,[318 427 496 357 257],796,5,35369,4.533324788515765,60.0,0.0
27802,2,7802,[215 202 475  89 176],655,1,35370,4.532871972318339,0.0,0.0
27803,2,7803,[318 427 496 357 257],716,5,35375,4.532931829830856,60.0,0.0
27804,2,7804,[318 427 496 357 257],796,5,35380,4.532991672005125,60.0,0.0
27805,2,7805,[318 427 496 357 257],330,5,35385,4.5330514988470405,60.0,0.0
27806,2,7806,[318 427 496 357 257],796,5,35390,4.533111310362496,60.0,0.0
27807,2,7807,[318 427 496 357 257],716,5,35395,4.533171106557377,60.0,0.0
27808,2,7808,[228 268 265 135   7],655,1,35396,4.532718657958766,0.0,0.0
27809,2,7809,[318 427 496 357 257],796,5,35401,4.5327784891165175,60.0,0.0
27810,2,7810,[127  12 186 423   7],450,4,35405,4.5327102803738315,0.0,20.0
27811,2,7811,[318 427 496 357 257],716,5,35410,4.532770097286226,60.0,0.0
27812,2,7812,[318 427 496 357 257],796,5,35415,4.5328298988864715,60.0,0.0
27813,2,7813,[318 427 496 357 257],796,5,35420,4.532889685180446,60.0,0.0
27814,2,7814,[318 427 496 357 257],330,5,35425,4.532949456174024,60.0,0.0
27815,2,7815,[ 25 475 125 195 118],655,0,35425,4.532369498464687,0.0,0.0
27816,2,7816,[318 427 496 357 257],796,5,35430,4.5324293207112705,60.0,0.0
27817,2,7817,[318 427 496 357 257],330,5,35435,4.532489127654132,60.0,0.0
27818,2,7818,[318 427 496 357 257],716,5,35440,4.532548919299143,60.0,0.0
27819,2,7819,[318 427 496 357 257],330,5,35445,4.532608695652174,60.0,0.0
27820,2,7820,[318 427 496 357 257],330,5,35450,4.532668456719089,60.0,0.0
27821,2,7821,[318 427 496 357 257],796,5,35455,4.532728202505753,60.0,0.0
27822,2,7822,[318 427 496 357 257],330,5,35460,4.532787933018024,60.0,0.0
27823,2,7823,[  9 294 588 161 546],457,3,35463,4.532592024539877,0.0,0.0
27824,2,7824,[318 427 496 357 257],716,5,35468,4.532651757188498,60.0,0.0
27825,2,7825,[678  25 111 257 546],15,2,35470,4.5323281369793,0.0,0.0
27826,2,7826,[318 427 496 357 257],330,5,35475,4.532387888079724,60.0,0.0
27827,2,7827,[318 427 496 357 257],796,5,35480,4.5324476239141545,60.0,0.0
27828,2,7828,[318 427 496 357 257],330,5,35485,4.53250734448844,60.0,0.0
27829,2,7829,[211 385 135  96 186],716,1,35486,4.532056194125159,0.0,0.0
27830,2,7830,[318 427 496 357 257],796,5,35491,4.532115949431746,60.0,0.0
27831,2,7831,[318 427 496 357 257],796,5,35496,4.53217568947906,60.0,0.0
27832,2,7832,[118 180 168 258 496],450,4,35500,4.5321077492659265,20.0,0.0
27833,2,7833,[318 427 496 357 257],796,5,35505,4.532167475108501,60.0,0.0
27834,2,7834,[228  25 153 182 385],655,1,35506,4.531716656030632,0.0,0.0
27835,2,7835,[318 427 496 357 257],796,5,35511,4.53177641653905,60.0,0.0
27836,2,7836,[ 15 405 275 301 216],151,4,35515,4.531708561949726,0.0,20.0
27837,2,7837,[318 427 496 357 257],330,5,35520,4.531768308241898,60.0,0.0
27838,2,7838,[318 427 496 357 257],796,5,35525,4.531828039290726,60.0,0.0
27839,2,7839,[318 427 496 357 257],330,5,35530,4.531887755102041,60.0,0.0
27840,2,7840,[318 427 496 357 257],330,5,35535,4.5319474556816735,60.0,0.0
27841,2,7841,[318 427 496 357 257],716,5,35540,4.53200714103545,60.0,0.0
27842,2,7842,[174 121 258 185 176],796,5,35545,4.532066811169195,0.0,0.0
27843,2,7843,[318 427 496 357 257],330,5,35550,4.53212646608873,60.0,0.0
27844,2,7844,[318 427 496 357 257],716,5,35555,4.532186105799872,60.0,0.0
27845,2,7845,[318 427 496 357 257],330,5,35560,4.532245730308437,60.0,0.0
27846,2,7846,[196  88  56 275 655],236,1,35561,4.531795590671594,0.0,20.0
27847,2,7847,[318 427 496 357 257],716,5,35566,4.531855249745158,60.0,0.0
27848,2,7848,[318 427 496 357 257],330,5,35571,4.531914893617022,60.0,0.0
27849,2,7849,[318 427 496 357 257],796,5,35576,4.531974522292994,60.0,0.0
27850,2,7850,[405 322 597 318 222],450,4,35580,4.531906763469622,20.0,0.0
27851,2,7851,[318 427 496 357 257],796,5,35585,4.531966377992868,60.0,0.0
27852,2,7852,[318 427 496 357 257],796,5,35590,4.532025977333503,60.0,0.0
27853,2,7853,[318 427 496 357 257],796,5,35595,4.532085561497326,60.0,0.0
27854,2,7854,[655 546 282  15 211],593,3,35598,4.531890515595163,0.0,0.0
27855,2,7855,[318 427 496 357 257],796,5,35603,4.531950101832994,60.0,0.0
27856,2,7856,[318 427 496 357 257],330,5,35608,4.532009672903143,60.0,0.0
27857,2,7857,[318 427 496 357 257],716,5,35613,4.532069228811403,60.0,0.0
27858,2,7858,[318 427 496 357 257],716,5,35618,4.532128769563558,60.0,0.0
27859,2,7859,[318 427 496 357 257],716,5,35623,4.532188295165394,60.0,0.0
27860,2,7860,[588 118 185 215 357],450,4,35627,4.532120595344104,0.0,0.0
27861,2,7861,[318 427 496 357 257],716,5,35632,4.532180106843042,60.0,0.0
27862,2,7862,[318 427 496 357 257],716,5,35637,4.532239603204884,60.0,0.0
27863,2,7863,[318 427 496 357 257],716,5,35642,4.532299084435402,60.0,0.0
27864,2,7864,[318 427 496 357 257],716,5,35647,4.532358550540368,60.0,0.0
27865,2,7865,[318 427 496 357 257],330,5,35652,4.532418001525553,60.0,0.0
27866,2,7866,[318 427 496 357 257],716,5,35657,4.532477437396721,60.0,0.0
27867,2,7867,[318 427 496 357 257],330,5,35662,4.532536858159634,60.0,0.0
27868,2,7868,[318 427 496 357 257],796,5,35667,4.532596263820054,60.0,0.0
27869,2,7869,[318 427 496 357 257],796,5,35672,4.532655654383736,60.0,0.0
27870,2,7870,[318 427 496 357 257],330,5,35677,4.532715029856435,60.0,0.0
27871,2,7871,[318 427 496 357 257],796,5,35682,4.532774390243903,60.0,0.0
27872,2,7872,[318 427 496 357 257],330,5,35687,4.532833735551886,60.0,0.0
27873,2,7873,[318 427 496 357 257],796,5,35692,4.532893065786132,60.0,0.0
27874,2,7874,[318 427 496 357 257],330,5,35697,4.532952380952381,60.0,0.0
27875,2,7875,[318 427 496 357 257],796,5,35702,4.533011681056374,60.0,0.0
27876,2,7876,[318 427 496 357 257],716,5,35707,4.533070966103847,60.0,0.0
27877,2,7877,[172  15 301 186 265],151,5,35712,4.533130236100533,0.0,0.0
27878,2,7878,[175 286 276 121 228],655,1,35713,4.532681812412743,0.0,20.0
27879,2,7879,[318 427 496 357 257],716,5,35718,4.532741116751269,60.0,0.0
27880,2,7880,[318 427 496 357 257],330,5,35723,4.532800406039843,60.0,0.0
27881,2,7881,[318 427 496 357 257],716,5,35728,4.532859680284192,60.0,0.0
27882,2,7882,[180 435   9  88  69],18,3,35731,4.532665228973741,0.0,0.0
27883,2,7883,[ 98  88 427 144 132],655,2,35733,4.53234398782344,20.0,0.0
27884,2,7884,[318 427 496 357 257],796,5,35738,4.532403297400127,60.0,0.0
27885,2,7885,[118  11 483  25 172],693,2,35740,4.532082170935836,0.0,0.0
27886,2,7886,[172 275 111  82 176],457,4,35744,4.532014707746925,0.0,20.0
27887,2,7887,[318 427 496 357 257],330,5,35749,4.5320740365111565,60.0,0.0
27888,2,7888,[ 69 210 161 405 135],450,3,35752,4.531879832678413,0.0,0.0
27889,2,7889,[318 427 496 357 257],796,5,35757,4.531939163498099,60.0,0.0
27890,2,7890,[318 427 496 357 257],330,5,35762,4.531998479280193,60.0,0.0
27891,2,7891,[318 427 496 357 257],796,5,35767,4.532057780030411,60.0,0.0
27892,2,7892,[211 186 100 191 286],389,3,35770,4.531863676675536,0.0,40.0
27893,2,7893,[318 427 496 357 257],330,5,35775,4.531922979478084,60.0,0.0
27894,2,7894,[318 427 496 357 257],796,5,35780,4.531982267257758,60.0,0.0
27895,2,7895,[318 427 496 357 257],330,5,35785,4.532041540020264,60.0,0.0
27896,2,7896,[318 427 496 357 257],796,5,35790,4.532100797771306,60.0,0.0
27897,2,7897,[318 427 496 357 257],716,5,35795,4.532160040516587,60.0,0.0
27898,2,7898,[100 313 748 197  89],450,5,35800,4.532219268261805,0.0,20.0
27899,2,7899,[286 483 175 427  56],151,5,35805,4.532278481012658,20.0,20.0
27900,2,7900,[318 427 496 357 257],330,5,35810,4.532337678774839,60.0,0.0
27901,2,7901,[318 427 496 357 257],330,5,35815,4.532396861554037,60.0,0.0
27902,2,7902,[  8 328 185 202 186],655,1,35816,4.5319498924459065,0.0,0.0
27903,2,7903,[318 427 496 357 257],716,5,35821,4.5320091093117405,60.0,0.0
27904,2,7904,[318 427 496 357 257],796,5,35826,4.532068311195446,60.0,0.0
27905,2,7905,[318 427 496 357 257],716,5,35831,4.532127498102707,60.0,0.0
27906,2,7906,[318 427 496 357 257],716,5,35836,4.532186670039206,60.0,0.0
27907,2,7907,[318 427 496 357 257],796,5,35841,4.532245827010622,60.0,0.0
27908,2,7908,[318 427 496 357 257],330,5,35846,4.532304969022633,60.0,0.0
27909,2,7909,[318 427 496 357 257],716,5,35851,4.532364096080911,60.0,0.0
27910,2,7910,[318 427 496 357 257],330,5,35856,4.532423208191126,60.0,0.0
27911,2,7911,[318 427 496 357 257],716,5,35861,4.532482305358949,60.0,0.0
27912,2,7912,[318 427 496 357 257],716,5,35866,4.532541387590042,60.0,0.0
27913,2,7913,[318 427 496 357 257],796,5,35871,4.532600454890068,60.0,0.0
27914,2,7914,[318 427 496 357 257],796,5,35876,4.532659507264687,60.0,0.0
27915,2,7915,[318 427 496 357 257],716,5,35881,4.532718544719556,60.0,0.0
27916,2,7916,[318 427 496 357 257],330,5,35886,4.532777567260326,60.0,0.0
27917,2,7917,[318 427 496 357 257],716,5,35891,4.53283657489265,60.0,0.0
27918,2,7918,[ 12 125 385 143 222],655,1,35892,4.532390453340068,0.0,0.0
27919,2,7919,[318 427 496 357 257],330,5,35897,4.532449494949495,60.0,0.0
27920,2,7920,[318 427 496 357 257],716,5,35902,4.532508521651307,60.0,0.0
27921,2,7921,[318 427 496 357 257],796,5,35907,4.532567533451148,60.0,0.0
27922,2,7922,[318 427 496 357 257],330,5,35912,4.532626530354664,60.0,0.0
27923,2,7923,[546 210 175 172  50],716,3,35915,4.532433114588591,0.0,20.0
27924,2,7924,[318 427 496 357 257],796,5,35920,4.532492113564669,60.0,0.0
27925,2,7925,[318 427 496 357 257],796,5,35925,4.532551097653293,60.0,0.0
27926,2,7926,[ 69  79 211 328 118],151,3,35928,4.5323577646019935,0.0,0.0
27927,2,7927,[318 427 496 357 257],330,5,35933,4.532416750756811,60.0,0.0
27928,2,7928,[318 427 496 357 257],796,5,35938,4.532475722033043,60.0,0.0
27929,2,7929,[405  12 118 187 313],450,4,35942,4.532408575031526,0.0,0.0
27930,2,7930,[318 427 496 357 257],330,5,35947,4.532467532467533,60.0,0.0
27931,2,7931,[318 427 496 357 257],716,5,35952,4.532526475037821,60.0,0.0
27932,2,7932,[318 427 496 357 257],796,5,35957,4.532585402748015,60.0,0.0
27933,2,7933,[204 151 200 111 181],18,0,35957,4.532014116460801,0.0,0.0
27934,2,7934,[318 427 496 357 257],796,5,35962,4.532073093887838,60.0,0.0
27935,2,7935,[318 427 496 357 257],330,5,35967,4.532132056451613,60.0,0.0
27936,2,7936,[318 427 496 357 257],796,5,35972,4.532191004157742,60.0,0.0
27937,2,7937,[318 427 496 357 257],796,5,35977,4.532249937011842,60.0,0.0
27938,2,7938,[318 427 496 357 257],716,5,35982,4.532308855019524,60.0,0.0
27939,2,7939,[318 427 496 357 257],716,5,35987,4.532367758186398,60.0,0.0
27940,2,7940,[318 427 496 357 257],796,5,35992,4.532426646518071,60.0,0.0
27941,2,7941,[318 427 496 357 257],330,5,35997,4.532485520020146,60.0,0.0
27942,2,7942,[318 427 496 357 257],716,5,36002,4.5325443786982245,60.0,0.0
27943,2,7943,[318 427 496 357 257],330,5,36007,4.532603222557905,60.0,0.0
27944,2,7944,[ 69 200  98 111  28],908,2,36009,4.532284455632473,0.0,0.0
27945,2,7945,[318 427 496 357 257],796,5,36014,4.532343317392399,60.0,0.0
27946,2,7946,[318 427 496 357 257],796,5,36019,4.532402164338744,60.0,0.0
27947,2,7947,[318 427 496 357 257],716,5,36024,4.532460996477101,60.0,0.0
27948,2,7948,[318 427 496 357 257],330,5,36029,4.5325198138130585,60.0,0.0
27949,2,7949,[318 427 496 357 257],330,5,36034,4.532578616352201,60.0,0.0
27950,2,7950,[318 427 496 357 257],330,5,36039,4.532637404100114,60.0,0.0
27951,2,7951,[ 64 135 237 121  96],655,2,36041,4.532318913480886,20.0,0.0
27952,2,7952,[318 427 496 357 257],330,5,36046,4.532377719099711,60.0,0.0
27953,2,7953,[318 427 496 357 257],796,5,36051,4.53243650993211,60.0,0.0
27954,2,7954,[245 143 135 288 546],450,3,36054,4.532243871778755,0.0,0.0
27955,2,7955,[318 427 496 357 257],716,5,36059,4.532302664655606,60.0,0.0
27956,2,7956,[318 427 496 357 257],330,5,36064,4.532361442754807,60.0,0.0
27957,2,7957,[286 234 423 187  98],389,4,36068,4.532294546368434,0.0,20.0
27958,2,7958,[318 427 496 357 257],796,5,36073,4.5323533107174265,60.0,0.0
27959,2,7959,[318 427 496 357 257],796,5,36078,4.532412060301508,60.0,0.0
27960,2,7960,[318 427 496 357 257],796,5,36083,4.53247079512624,60.0,0.0
27961,2,7961,[318 427 496 357 257],796,5,36088,4.5325295151971865,60.0,0.0
27962,2,7962,[286 168 144   4 318],535,2,36090,4.532211478086149,20.0,20.0
27963,2,7963,[318 427 496 357 257],330,5,36095,4.532270215971874,60.0,0.0
27964,2,7964,[318 427 496 357 257],716,5,36100,4.5323289391086,60.0,0.0
27965,2,7965,[318 427 496 357 257],796,5,36105,4.532387647501883,60.0,0.0
27966,2,7966,[318 427 496 357 257],716,5,36110,4.532446341157274,60.0,0.0
27967,2,7967,[318 427 496 357 257],716,5,36115,4.532505020080321,60.0,0.0
27968,2,7968,[318 427 496 357 257],330,5,36120,4.532563684276572,60.0,0.0
27969,2,7969,[427 121 161 111 216],577,5,36125,4.5326223337515685,20.0,0.0
27970,2,7970,[181 118 161 294 282],280,1,36126,4.532179149416636,0.0,0.0
27971,2,7971,[ 64 168 313 269  89],450,5,36131,4.532237832413447,20.0,0.0
27972,2,7972,[318 427 496 357 257],716,5,36136,4.532296500689828,60.0,0.0
27973,2,7973,[318 427 496 357 257],330,5,36141,4.5323551542513165,60.0,0.0
27974,2,7974,[216 245 328 176 301],450,5,36146,4.532413793103449,0.0,0.0
27975,2,7975,[318 427 496 357 257],330,5,36151,4.532472417251755,60.0,0.0
27976,2,7976,[318 427 496 357 257],330,5,36156,4.5325310267017676,60.0,0.0
27977,2,7977,[318 427 496 357 257],330,5,36161,4.532589621459012,60.0,0.0
27978,2,7978,[ 88   4  11 294  69],450,4,36165,4.532522872540419,0.0,0.0
27979,2,7979,[318 427 496 357 257],796,5,36170,4.532581453634085,60.0,0.0
27980,2,7980,[318 427 496 357 257],716,5,36175,4.532640020047613,60.0,0.0
27981,2,7981,[318 427 496 357 257],716,5,36180,4.532698571786519,60.0,0.0
27982,2,7982,[318 427 496 357 257],330,5,36185,4.53275710885632,60.0,0.0
27983,2,7983,[202 403 204 135 357],655,2,36187,4.532439879759519,0.0,0.0
27984,2,7984,[318 427 496 357 257],330,5,36192,4.532498434564809,60.0,0.0
27985,2,7985,[318 427 496 357 257],796,5,36197,4.532556974705735,60.0,0.0
27986,2,7986,[318 427 496 357 257],796,5,36202,4.532615500187805,60.0,0.0
27987,2,7987,[318 427 496 357 257],716,5,36207,4.532674011016525,60.0,0.0
27988,2,7988,[245 300 257 258   9],938,2,36209,4.532356990862436,0.0,0.0
27989,2,7989,[100 181 275 183 194],23,4,36213,4.532290362953692,0.0,40.0
27990,2,7990,[318 427 496 357 257],330,5,36218,4.532348892504067,60.0,0.0
27991,2,7991,[318 427 496 357 257],330,5,36223,4.532407407407407,60.0,0.0
27992,2,7992,[318 427 496 357 257],796,5,36228,4.53246590766921,60.0,0.0
27993,2,7993,[318 427 496 357 257],330,5,36233,4.532524393294971,60.0,0.0
27994,2,7994,[318 427 496 357 257],796,5,36238,4.532582864290181,60.0,0.0
27995,2,7995,[318 427 496 357 257],716,5,36243,4.53264132066033,60.0,0.0
27996,2,7996,[318 427 496 357 257],330,5,36248,4.532699762410904,60.0,0.0
27997,2,7997,[318 427 496 357 257],716,5,36253,4.532758189547387,60.0,0.0
27998,2,7998,[496 197 597 111  95],450,4,36257,4.532691586448306,20.0,0.0
27999,2,7999,[318 427 496 357 257],796,5,36262,4.53275,60.0,0.0
28000,2,8000,[603 117 546 143 121],796,5,36267,4.532808398950131,20.0,0.0
28001,2,8001,[318 427 496 357 257],330,5,36272,4.532866783304174,60.0,0.0
28002,2,8002,[318 427 496 357 257],716,5,36277,4.5329251530676,60.0,0.0
28003,2,8003,[318 427 496 357 257],716,5,36282,4.532983508245877,60.0,0.0
28004,2,8004,[318 427 496 357 257],716,5,36287,4.533041848844472,60.0,0.0
28005,2,8005,[318 427 496 357 257],330,5,36292,4.533100174868848,60.0,0.0
28006,2,8006,[318 427 496 357 257],716,5,36297,4.533158486324466,60.0,0.0
28007,2,8007,[318 427 496 357 257],330,5,36302,4.533216783216783,60.0,0.0
28008,2,8008,[318 427 496 357 257],330,5,36307,4.533275065551255,60.0,0.0
28009,2,8009,[318 427 496 357 257],330,5,36312,4.533333333333333,60.0,0.0
28010,2,8010,[603 302 194 515 286],535,2,36314,4.5330171014854574,20.0,20.0
28011,2,8011,[318 427 496 357 257],796,5,36319,4.533075386919621,60.0,0.0
28012,2,8012,[318 427 496 357 257],716,5,36324,4.533133657806065,60.0,0.0
28013,2,8013,[172 403  88  25  97],655,1,36325,4.532692787621662,0.0,0.0
28014,2,8014,[318 427 496 357 257],716,5,36330,4.532751091703057,60.0,0.0
28015,2,8015,[ 11  50  82 180 144],457,5,36335,4.5328093812375245,0.0,20.0
28016,2,8016,[318 427 496 357 257],330,5,36340,4.53286765623051,60.0,0.0
28017,2,8017,[318 427 496 357 257],716,5,36345,4.532925916687454,60.0,0.0
28018,2,8018,[748 216 597 173 176],11,1,36346,4.532485347300162,0.0,0.0
28019,2,8019,[ 89 275 403 237 427],18,2,36348,4.53216957605985,20.0,20.0
28020,2,8020,[318 427 496 357 257],796,5,36353,4.532227901757886,60.0,0.0
28021,2,8021,[318 427 496 357 257],716,5,36358,4.532286212914485,60.0,0.0
28022,2,8022,[318 427 496 357 257],716,5,36363,4.532344509535086,60.0,0.0
28023,2,8023,[318 427 496 357 257],330,5,36368,4.532402791625125,60.0,0.0
28024,2,8024,[318 427 496 357 257],796,5,36373,4.532461059190031,60.0,0.0
28025,2,8025,[ 69 211 215 405 222],450,4,36377,4.5323947171692005,0.0,0.0
28026,2,8026,[318 427 496 357 257],330,5,36382,4.532452971222125,60.0,0.0
28027,2,8027,[318 427 496 357 257],330,5,36387,4.5325112107623315,60.0,0.0
28028,2,8028,[186 194   1 286  98],535,2,36389,4.532195790260307,0.0,20.0
28029,2,8029,[294 118 234  96 588],450,3,36392,4.53200498132005,0.0,0.0
28030,2,8030,[ 95  28 211 423 181],807,5,36397,4.532063254887312,0.0,0.0
28031,2,8031,[318 427 496 357 257],330,5,36402,4.532121513944223,60.0,0.0
28032,2,8032,[318 427 496 357 257],716,5,36407,4.532179758496203,60.0,0.0
28033,2,8033,[318 427 496 357 257],330,5,36412,4.532237988548668,60.0,0.0
28034,2,8034,[318 427 496 357 257],330,5,36417,4.532296204107031,60.0,0.0
28035,2,8035,[318 427 496 357 257],796,5,36422,4.532354405176704,60.0,0.0
28036,2,8036,[100 496 322 294 202],280,2,36424,4.53203931815354,20.0,20.0
28037,2,8037,[483 174 471 282 197],457,5,36429,4.532097536700672,0.0,0.0
28038,2,8038,[265 597   4 182 143],796,5,36434,4.532155740763777,0.0,0.0
28039,2,8039,[318 427 496 357 257],330,5,36439,4.5322139303482585,60.0,0.0
28040,2,8040,[318 427 496 357 257],330,5,36444,4.53227210545952,60.0,0.0
28041,2,8041,[318 427 496 357 257],716,5,36449,4.532330266102959,60.0,0.0
28042,2,8042,[318 427 496 357 257],796,5,36454,4.532388412283973,60.0,0.0
28043,2,8043,[318 427 496 357 257],796,5,36459,4.532446544007956,60.0,0.0
28044,2,8044,[318 427 496 357 257],796,5,36464,4.532504661280298,60.0,0.0
28045,2,8045,[318 427 496 357 257],330,5,36469,4.532562764106388,60.0,0.0
28046,2,8046,[186  89 168  97 100],796,2,36471,4.532248042748851,0.0,20.0
28047,2,8047,[282  28  56 196 257],504,4,36475,4.532181908548708,0.0,0.0
28048,2,8048,[508 742 288 313  71],280,3,36478,4.531991551745558,0.0,0.0
28049,2,8049,[318 427 496 357 257],330,5,36483,4.532049689440994,60.0,0.0
28050,2,8050,[318 427 496 357 257],716,5,36488,4.5321078126940755,60.0,0.0
28051,2,8051,[204 172 143 271 423],655,2,36490,4.531793343268753,0.0,0.0
28052,2,8052,[405 265  25 423  82],655,0,36490,4.531230597292934,0.0,0.0
28053,2,8053,[318 427 496 357 257],716,5,36495,4.531288800595977,60.0,0.0
28054,2,8054,[318 427 496 357 257],716,5,36500,4.531346989447548,60.0,0.0
28055,2,8055,[ 88 111 222 194  12],151,5,36505,4.531405163853028,0.0,0.0
28056,2,8056,[318 427 496 357 257],330,5,36510,4.531463323817798,60.0,0.0
28057,2,8057,[161 222 282 471 238],716,2,36512,4.531149168528171,0.0,0.0
28058,2,8058,[318 427 496 357 257],330,5,36517,4.531207345824544,60.0,0.0
28059,2,8059,[301 271 125 300  82],655,0,36517,4.530645161290322,0.0,0.0
28060,2,8060,[318 427 496 357 257],716,5,36522,4.530703386676591,60.0,0.0
28061,2,8061,[318 427 496 357 257],796,5,36527,4.530761597618457,60.0,0.0
28062,2,8062,[496 588  95 302   8],389,4,36531,4.530695770804911,20.0,0.0
28063,2,8063,[318 427 496 357 257],716,5,36536,4.530753968253968,60.0,0.0
28064,2,8064,[318 427 496 357 257],330,5,36541,4.530812151270924,60.0,0.0
28065,2,8065,[211 275 427 186 403],655,2,36543,4.530498388296554,20.0,20.0
28066,2,8066,[318 427 496 357 257],330,5,36548,4.53055658857072,60.0,0.0
28067,2,8067,[318 427 496 357 257],796,5,36553,4.530614774417452,60.0,0.0
28068,2,8068,[318 427 496 357 257],796,5,36558,4.530672945842112,60.0,0.0
28069,2,8069,[318 427 496 357 257],330,5,36563,4.530731102850062,60.0,0.0
28070,2,8070,[318 427 496 357 257],796,5,36568,4.530789245446661,60.0,0.0
28071,2,8071,[318 427 496 357 257],716,5,36573,4.530847373637265,60.0,0.0
28072,2,8072,[ 22 185   9  69 405],11,3,36576,4.530657748049053,0.0,0.0
28073,2,8073,[435 286 135 173 194],535,3,36579,4.530468169432747,0.0,20.0
28074,2,8074,[318 427 496 357 257],716,5,36584,4.530526315789474,60.0,0.0
28075,2,8075,[318 427 496 357 257],716,5,36589,4.530584447746409,60.0,0.0
28076,2,8076,[222  64 313 286 258],344,2,36591,4.530271140274855,20.0,20.0
28077,2,8077,[318 427 496 357 257],796,5,36596,4.530329289428076,60.0,0.0
28078,2,8078,[318 427 496 357 257],796,5,36601,4.530387424186162,60.0,0.0
28079,2,8079,[318 427 496 357 257],330,5,36606,4.530445544554455,60.0,0.0
28080,2,8080,[111 238 161  96  98],450,5,36611,4.5305036505383,0.0,0.0
28081,2,8081,[132 269 496 176  50],450,5,36616,4.530561742143034,20.0,20.0
28082,2,8082,[318 427 496 357 257],716,5,36621,4.530619819373995,60.0,0.0
28083,2,8083,[216 196 172 195 546],344,4,36625,4.530554181098466,0.0,0.0
28084,2,8084,[318 427 496 357 257],716,5,36630,4.530612244897959,60.0,0.0
28085,2,8085,[143 174  97 210 282],457,5,36635,4.530670294335889,0.0,0.0
28086,2,8086,[318 427 496 357 257],796,5,36640,4.530728329417584,60.0,0.0
28087,2,8087,[318 427 496 357 257],716,5,36645,4.530786350148368,60.0,0.0
28088,2,8088,[318 427 496 357 257],330,5,36650,4.5308443565335645,60.0,0.0
28089,2,8089,[323  50 742   9 125],938,1,36651,4.5304079110012365,0.0,20.0
28090,2,8090,[318 427 496 357 257],330,5,36656,4.530465949820789,60.0,0.0
28091,2,8091,[318 427 496 357 257],330,5,36661,4.5305239742956,60.0,0.0
28092,2,8092,[282 173 191 143 748],450,5,36666,4.53058198443099,0.0,0.0
28093,2,8093,[318 427 496 357 257],330,5,36671,4.530639980232271,60.0,0.0
28094,2,8094,[318 427 496 357 257],330,5,36676,4.530697961704756,60.0,0.0
28095,2,8095,[318 427 496 357 257],330,5,36681,4.530755928853755,60.0,0.0
28096,2,8096,[318 427 496 357 257],716,5,36686,4.530813881684574,60.0,0.0
28097,2,8097,[  4 302 301 197 258],450,4,36690,4.530748332921709,0.0,0.0
28098,2,8098,[318 427 496 357 257],716,5,36695,4.530806272379306,60.0,0.0
28099,2,8099,[318 427 496 357 257],330,5,36700,4.530864197530864,60.0,0.0
28100,2,8100,[151 294  95 144  89],23,2,36702,4.530551783730403,0.0,0.0
28101,2,8101,[313 597  71 235 195],450,3,36705,4.530362873364601,0.0,0.0
28102,2,8102,[318 427 496 357 257],716,5,36710,4.530420831790694,60.0,0.0
28103,2,8103,[318 427 496 357 257],796,5,36715,4.53047877591313,60.0,0.0
28104,2,8104,[678 153  25 100 200],504,4,36719,4.530413325107958,0.0,20.0
28105,2,8105,[210 202 197 211 161],401,4,36723,4.530347890451518,0.0,0.0
28106,2,8106,[318 427 496 357 257],330,5,36728,4.530405822129024,60.0,0.0
28107,2,8107,[234 174   8  98 475],655,1,36729,4.529970399605328,0.0,0.0
28108,2,8108,[318 427 496 357 257],796,5,36734,4.530028363546677,60.0,0.0
28109,2,8109,[318 427 496 357 257],796,5,36739,4.530086313193588,60.0,0.0
28110,2,8110,[318 427 496 357 257],796,5,36744,4.53014424855135,60.0,0.0
28111,2,8111,[318 427 496 357 257],330,5,36749,4.530202169625246,60.0,0.0
28112,2,8112,[318 427 496 357 257],330,5,36754,4.53026007642056,60.0,0.0
28113,2,8113,[ 96 655  15 301 180],450,4,36758,4.530194725166379,0.0,0.0
28114,2,8114,[318 427 496 357 257],330,5,36763,4.530252618607517,60.0,0.0
28115,2,8115,[318 427 496 357 257],716,5,36768,4.530310497782159,60.0,0.0
28116,2,8116,[318 427 496 357 257],716,5,36773,4.530368362695577,60.0,0.0
28117,2,8117,[318 427 496 357 257],716,5,36778,4.530426213353042,60.0,0.0
28118,2,8118,[318 427 496 357 257],330,5,36783,4.530484049759822,60.0,0.0
28119,2,8119,[197  70  69 132 268],503,5,36788,4.530541871921182,0.0,0.0
28120,2,8120,[318 427 496 357 257],716,5,36793,4.530599679842384,60.0,0.0
28121,2,8121,[318 427 496 357 257],796,5,36798,4.530657473528687,60.0,0.0
28122,2,8122,[318 427 496 357 257],796,5,36803,4.53071525298535,60.0,0.0
28123,2,8123,[318 427 496 357 257],716,5,36808,4.5307730182176265,60.0,0.0
28124,2,8124,[ 70 197 265 181 385],457,5,36813,4.53083076923077,0.0,0.0
28125,2,8125,[258 496 117 172 322],796,4,36817,4.530765444253015,20.0,0.0
28126,2,8126,[318 427 496 357 257],330,5,36822,4.530823181985973,60.0,0.0
28127,2,8127,[748  69 403 210  22],796,4,36826,4.530757874015748,0.0,0.0
28128,2,8128,[318 427 496 357 257],796,5,36831,4.5308155984745975,60.0,0.0
28129,2,8129,[318 427 496 357 257],796,5,36836,4.530873308733088,60.0,0.0
28130,2,8130,[228 496 235  71  88],344,2,36838,4.530562046488747,20.0,0.0
28131,2,8131,[318 427 496 357 257],796,5,36843,4.530619773733399,60.0,0.0
28132,2,8132,[318 427 496 357 257],716,5,36848,4.5306774867822455,60.0,0.0
28133,2,8133,[318 427 496 357 257],716,5,36853,4.530735185640522,60.0,0.0
28134,2,8134,[318 427 496 357 257],796,5,36858,4.53079287031346,60.0,0.0
28135,2,8135,[318 427 496 357 257],796,5,36863,4.530850540806293,60.0,0.0
28136,2,8136,[318 427 496 357 257],796,5,36868,4.530908197124247,60.0,0.0
28137,2,8137,[ 69 210 144 237 222],796,4,36872,4.530842958957975,0.0,0.0
28138,2,8138,[318 427 496 357 257],716,5,36877,4.530900602039563,60.0,0.0
28139,2,8139,[318 427 496 357 257],716,5,36882,4.530958230958231,60.0,0.0
28140,2,8140,[318 427 496 357 257],330,5,36887,4.531015845719199,60.0,0.0
28141,2,8141,[318 427 496 357 257],796,5,36892,4.531073446327683,60.0,0.0
28142,2,8142,[318 427 496 357 257],330,5,36897,4.531131032788898,60.0,0.0
28143,2,8143,[318 427 496 357 257],716,5,36902,4.531188605108055,60.0,0.0
28144,2,8144,[318 427 496 357 257],796,5,36907,4.531246163290362,60.0,0.0
28145,2,8145,[200 121 143 471  97],716,4,36911,4.531180947704395,0.0,0.0
28146,2,8146,[318 427 496 357 257],330,5,36916,4.531238492696698,60.0,0.0
28147,2,8147,[318 427 496 357 257],716,5,36921,4.531296023564065,60.0,0.0
28148,2,8148,[318 427 496 357 257],330,5,36926,4.531353540311695,60.0,0.0
28149,2,8149,[268 237 245 258 181],344,0,36926,4.53079754601227,0.0,0.0
28150,2,8150,[318 427 496 357 257],716,5,36931,4.530855109802478,60.0,0.0
28151,2,8151,[318 427 496 357 257],796,5,36936,4.530912659470069,60.0,0.0
28152,2,8152,[ 50  22   8 211 237],655,1,36937,4.530479578069422,0.0,20.0
28153,2,8153,[318 427 496 357 257],716,5,36942,4.530537159676233,60.0,0.0
28154,2,8154,[ 15 211 180 268 742],11,2,36944,4.530226854690374,0.0,0.0
28155,2,8155,[318 427 496 357 257],716,5,36949,4.530284453163316,60.0,0.0
28156,2,8156,[318 427 496 357 257],796,5,36954,4.530342037513792,60.0,0.0
28157,2,8157,[318 427 496 357 257],330,5,36959,4.530399607746997,60.0,0.0
28158,2,8158,[ 56 269 282 655 318],450,5,36964,4.530457163868121,20.0,0.0
28159,2,8159,[210 111  97 301 151],796,2,36966,4.5301470588235295,0.0,0.0
28160,2,8160,[ 15 125 405 403 237],577,3,36969,4.529959563778949,0.0,0.0
28161,2,8161,[318 427 496 357 257],330,5,36974,4.530017152658662,60.0,0.0
28162,2,8162,[  4 234 323 176 174],796,3,36977,4.529829719465883,0.0,0.0
28163,2,8163,[ 71  50 222 174  98],23,4,36981,4.529764821166095,0.0,20.0
28164,2,8164,[132  28 182 187 301],655,2,36983,4.529454990814452,0.0,0.0
28165,2,8165,[ 96 180 275 185 132],796,4,36987,4.52939015429831,0.0,20.0
28166,2,8166,[318 427 496 357 257],796,5,36992,4.529447777641729,60.0,0.0
28167,2,8167,[318 427 496 357 257],330,5,36997,4.529505386875612,60.0,0.0
28168,2,8168,[403 132 302   1 191],655,2,36999,4.529195739992655,0.0,0.0
28169,2,8169,[204 216 127 265 269],796,4,37003,4.529130966952264,0.0,20.0
28170,2,8170,[318 427 496 357 257],330,5,37008,4.529188593807367,60.0,0.0
28171,2,8171,[  8 210 194 132  96],457,5,37013,4.529246206558982,0.0,0.0
28172,2,8172,[318 427 496 357 257],796,5,37018,4.529303805212284,60.0,0.0
28173,2,8173,[427   8  28 215 176],796,4,37022,4.529239050648397,20.0,0.0
28174,2,8174,[318 427 496 357 257],796,5,37027,4.529296636085627,60.0,0.0
28175,2,8175,[181 427 153 161  97],450,5,37032,4.529354207436399,20.0,0.0
28176,2,8176,[318 427 496 357 257],716,5,37037,4.529411764705882,60.0,0.0
28177,2,8177,[318 427 496 357 257],330,5,37042,4.529469307899242,60.0,0.0
28178,2,8178,[318 427 496 357 257],716,5,37047,4.529526837021641,60.0,0.0
28179,2,8179,[132 423 237   8 200],655,1,37048,4.5290953545232275,0.0,0.0
28180,2,8180,[143 191 186 427 176],151,3,37051,4.528908446400195,20.0,0.0
28181,2,8181,[318 427 496 357 257],716,5,37056,4.528966022977267,60.0,0.0
28182,2,8182,[318 427 496 357 257],330,5,37061,4.529023585482097,60.0,0.0
28183,2,8183,[318 427 496 357 257],716,5,37066,4.529081133919844,60.0,0.0
28184,2,8184,[ 11 121  97 215 173],716,5,37071,4.529138668295663,0.0,0.0
28185,2,8185,[318 427 496 357 257],330,5,37076,4.529196188614708,60.0,0.0
28186,2,8186,[318 427 496 357 257],796,5,37081,4.52925369488213,60.0,0.0
28187,2,8187,[318 427 496 357 257],796,5,37086,4.529311187103078,60.0,0.0
28188,2,8188,[318 427 496 357 257],716,5,37091,4.529368665282696,60.0,0.0
28189,2,8189,[273 496 144  64 423],796,4,37095,4.529304029304029,40.0,0.0
28190,2,8190,[318 427 496 357 257],796,5,37100,4.529361494323037,60.0,0.0
28191,2,8191,[318 427 496 357 257],796,5,37105,4.5294189453125,60.0,0.0
28192,2,8192,[318 427 496 357 257],716,5,37110,4.529476382277554,60.0,0.0
28193,2,8193,[318 427 496 357 257],796,5,37115,4.529533805223334,60.0,0.0
28194,2,8194,[427  12  11  96 546],577,3,37118,4.52934716290421,20.0,0.0
28195,2,8195,[288 135  82   7 117],457,5,37123,4.529404587603709,0.0,0.0
28196,2,8196,[318 427 496 357 257],330,5,37128,4.529461998292058,60.0,0.0
28197,2,8197,[318 427 496 357 257],716,5,37133,4.529519394974384,60.0,0.0
28198,2,8198,[318 427 496 357 257],330,5,37138,4.529576777655811,60.0,0.0
28199,2,8199,[318 427 496 357 257],796,5,37143,4.529634146341463,60.0,0.0
28200,2,8200,[318 427 496 357 257],330,5,37148,4.529691501036459,60.0,0.0
28201,2,8201,[318 427 496 357 257],796,5,37153,4.529748841745915,60.0,0.0
28202,2,8202,[318 427 496 357 257],330,5,37158,4.529806168474948,60.0,0.0
28203,2,8203,[318 427 496 357 257],330,5,37163,4.529863481228669,60.0,0.0
28204,2,8204,[318 427 496 357 257],796,5,37168,4.529920780012188,60.0,0.0
28205,2,8205,[318 427 496 357 257],330,5,37173,4.529978064830612,60.0,0.0
28206,2,8206,[483 197 427 546  88],151,4,37177,4.529913488485439,20.0,0.0
28207,2,8207,[318 427 496 357 257],330,5,37182,4.529970760233918,60.0,0.0
28208,2,8208,[196 228 202 302 471],450,5,37187,4.530028018028992,0.0,0.0
28209,2,8209,[318 427 496 357 257],796,5,37192,4.530085261875762,60.0,0.0
28210,2,8210,[ 50 127 301 215 588],796,4,37196,4.530020703933747,0.0,40.0
28211,2,8211,[318 427 496 357 257],716,5,37201,4.530077934729664,60.0,0.0
28212,2,8212,[318 427 496 357 257],330,5,37206,4.5301351515889445,60.0,0.0
28213,2,8213,[318 427 496 357 257],716,5,37211,4.530192354516679,60.0,0.0
28214,2,8214,[ 71 143   4 185  79],796,5,37216,4.530249543517955,0.0,0.0
28215,2,8215,[181 238 276  88  56],457,5,37221,4.530306718597858,0.0,0.0
28216,2,8216,[318 427 496 357 257],796,5,37226,4.53036387976147,60.0,0.0
28217,2,8217,[286 144 655  11 318],593,4,37230,4.530299342905817,20.0,20.0
28218,2,8218,[318 427 496 357 257],796,5,37235,4.530356491057306,60.0,0.0
28219,2,8219,[318 427 496 357 257],330,5,37240,4.530413625304136,60.0,0.0
28220,2,8220,[318 427 496 357 257],330,5,37245,4.530470745651381,60.0,0.0
28221,2,8221,[318 427 496 357 257],716,5,37250,4.530527852104111,60.0,0.0
28222,2,8222,[318 427 496 357 257],330,5,37255,4.530584944667396,60.0,0.0
28223,2,8223,[318 427 496 357 257],796,5,37260,4.530642023346304,60.0,0.0
28224,2,8224,[228 161 301 234 475],655,0,37260,4.530091185410335,0.0,0.0
28225,2,8225,[318 427 496 357 257],716,5,37265,4.5301483102358375,60.0,0.0
28226,2,8226,[318 427 496 357 257],796,5,37270,4.530205421174182,60.0,0.0
28227,2,8227,[318 427 496 357 257],330,5,37275,4.530262518230432,60.0,0.0
28228,2,8228,[318 427 496 357 257],716,5,37280,4.530319601409649,60.0,0.0
28229,2,8229,[318 427 496 357 257],716,5,37285,4.5303766707168895,60.0,0.0
28230,2,8230,[318 427 496 357 257],330,5,37290,4.53043372615721,60.0,0.0
28231,2,8231,[318 427 496 357 257],330,5,37295,4.530490767735666,60.0,0.0
28232,2,8232,[318 427 496 357 257],716,5,37300,4.530547795457306,60.0,0.0
28233,2,8233,[318 427 496 357 257],716,5,37305,4.53060480932718,60.0,0.0
28234,2,8234,[405 168 423 300 427],450,5,37310,4.530661809350334,20.0,0.0
28235,2,8235,[318 427 496 357 257],716,5,37315,4.530718795531811,60.0,0.0
28236,2,8236,[318 427 496 357 257],330,5,37320,4.530775767876654,60.0,0.0
28237,2,8237,[318 427 496 357 257],716,5,37325,4.5308327263899,60.0,0.0
28238,2,8238,[318 427 496 357 257],716,5,37330,4.530889671076587,60.0,0.0
28239,2,8239,[318 427 496 357 257],796,5,37335,4.530946601941747,60.0,0.0
28240,2,8240,[318 427 496 357 257],716,5,37340,4.531003518990413,60.0,0.0
28241,2,8241,[318 427 496 357 257],716,5,37345,4.531060422227615,60.0,0.0
28242,2,8242,[318 427 496 357 257],330,5,37350,4.5311173116583765,60.0,0.0
28243,2,8243,[ 12 144 333 127 195],655,1,37351,4.530688985929161,0.0,20.0
28244,2,8244,[132 211  56 257 185],796,4,37355,4.5306246209824135,0.0,0.0
28245,2,8245,[161  71 191 405 357],450,4,37359,4.530560271646859,0.0,0.0
28246,2,8246,[318 427 496 357 257],716,5,37364,4.5306171941311995,60.0,0.0
28247,2,8247,[318 427 496 357 257],716,5,37369,4.530674102812803,60.0,0.0
28248,2,8248,[301 202 282 423 117],796,4,37373,4.530609770881319,0.0,0.0
28249,2,8249,[187 204 313 268 186],296,4,37377,4.530545454545455,0.0,0.0
28250,2,8250,[318 427 496 357 257],796,5,37382,4.530602351230154,60.0,0.0
28251,2,8251,[318 427 496 357 257],716,5,37387,4.530659234125061,60.0,0.0
28252,2,8252,[318 427 496 357 257],796,5,37392,4.5307161032351875,60.0,0.0
28253,2,8253,[318 427 496 357 257],330,5,37397,4.530772958565544,60.0,0.0
28254,2,8254,[318 427 496 357 257],796,5,37402,4.530829800121139,60.0,0.0
28255,2,8255,[318 427 496 357 257],796,5,37407,4.530886627906977,60.0,0.0
28256,2,8256,[318 427 496 357 257],796,5,37412,4.530943441928061,60.0,0.0
28257,2,8257,[318 427 496 357 257],330,5,37417,4.531000242189392,60.0,0.0
28258,2,8258,[318 427 496 357 257],716,5,37422,4.531057028695968,60.0,0.0
28259,2,8259,[318 427 496 357 257],716,5,37427,4.5311138014527845,60.0,0.0
28260,2,8260,[318 427 496 357 257],330,5,37432,4.531170560464835,60.0,0.0
28261,2,8261,[318 427 496 357 257],716,5,37437,4.53122730573711,60.0,0.0
28262,2,8262,[318 427 496 357 257],330,5,37442,4.531284037274598,60.0,0.0
28263,2,8263,[318 427 496 357 257],796,5,37447,4.531340755082285,60.0,0.0
28264,2,8264,[294 151 211 210 127],296,2,37449,4.531034482758621,0.0,20.0
28265,2,8265,[258 127 301 153  22],296,5,37454,4.531091217033632,0.0,20.0
28266,2,8266,[318 427 496 357 257],330,5,37459,4.531147937583162,60.0,0.0
28267,2,8267,[403  12  95 273   9],796,3,37462,4.53096274794388,0.0,0.0
28268,2,8268,[ 12  97 475 186 275],503,3,37465,4.5307776030959,0.0,20.0
28269,2,8269,[318 427 496 357 257],796,5,37470,4.530834340991536,60.0,0.0
28270,2,8270,[176 234 183  69 300],796,4,37474,4.530770160802805,0.0,0.0
28271,2,8271,[318 427 496 357 257],716,5,37479,4.530826885880077,60.0,0.0
28272,2,8272,[318 427 496 357 257],796,5,37484,4.530883597244047,60.0,0.0
28273,2,8273,[ 64 173 238 174 121],450,4,37488,4.5308194343727335,20.0,0.0
28274,2,8274,[318 427 496 357 257],716,5,37493,4.530876132930514,60.0,0.0
28275,2,8275,[318 427 496 357 257],796,5,37498,4.53093281778637,60.0,0.0
28276,2,8276,[318 427 496 357 257],796,5,37503,4.53098948894527,60.0,0.0
28277,2,8277,[318 427 496 357 257],330,5,37508,4.5310461464121765,60.0,0.0
28278,2,8278,[318 427 496 357 257],716,5,37513,4.531102790192052,60.0,0.0
28279,2,8279,[318 427 496 357 257],330,5,37518,4.531159420289855,60.0,0.0
28280,2,8280,[181 546 678 195 322],344,1,37519,4.530733003260476,0.0,0.0
28281,2,8281,[318 427 496 357 257],330,5,37524,4.5307896643322865,60.0,0.0
28282,2,8282,[318 427 496 357 257],796,5,37529,4.530846311722806,60.0,0.0
28283,2,8283,[318 427 496 357 257],796,5,37534,4.530902945436987,60.0,0.0
28284,2,8284,[168 258 257  88  15],798,5,37539,4.530959565479783,0.0,0.0
28285,2,8285,[318 427 496 357 257],716,5,37544,4.531016171856143,60.0,0.0
28286,2,8286,[318 427 496 357 257],330,5,37549,4.5310727645710145,60.0,0.0
28287,2,8287,[181  69 286   8 282],593,4,37553,4.531008687258687,0.0,20.0
28288,2,8288,[258 194  50  98  15],457,5,37558,4.531065267221619,0.0,20.0
28289,2,8289,[273 603 196   8 568],655,2,37560,4.530759951749095,20.0,0.0
28290,2,8290,[318 427 496 357 257],716,5,37565,4.530816548064166,60.0,0.0
28291,2,8291,[318 427 496 357 257],796,5,37570,4.530873130728413,60.0,0.0
28292,2,8292,[318 427 496 357 257],330,5,37575,4.530929699746775,60.0,0.0
28293,2,8293,[318 427 496 357 257],330,5,37580,4.530986255124186,60.0,0.0
28294,2,8294,[318 427 496 357 257],716,5,37585,4.531042796865582,60.0,0.0
28295,2,8295,[318 427 496 357 257],330,5,37590,4.531099324975892,60.0,0.0
28296,2,8296,[748 588 151  64 273],796,4,37594,4.531035313968904,20.0,0.0
28297,2,8297,[318 427 496 357 257],330,5,37599,4.5310918293564715,60.0,0.0
28298,2,8298,[318 427 496 357 257],716,5,37604,4.531148331124232,60.0,0.0
28299,2,8299,[161 210 204  50  64],655,2,37606,4.530843373493976,20.0,20.0
28300,2,8300,[318 427 496 357 257],716,5,37611,4.5308998915793275,60.0,0.0
28301,2,8301,[318 427 496 357 257],796,5,37616,4.530956396049144,60.0,0.0
28302,2,8302,[318 427 496 357 257],716,5,37621,4.531012886908346,60.0,0.0
28303,2,8303,[318 427 496 357 257],796,5,37626,4.53106936416185,60.0,0.0
28304,2,8304,[318 427 496 357 257],796,5,37631,4.531125827814569,60.0,0.0
28305,2,8305,[318 427 496 357 257],330,5,37636,4.531182277871419,60.0,0.0
28306,2,8306,[318 427 496 357 257],796,5,37641,4.531238714337306,60.0,0.0
28307,2,8307,[318 427 496 357 257],330,5,37646,4.53129513721714,60.0,0.0
28308,2,8308,[318 427 496 357 257],716,5,37651,4.531351546515826,60.0,0.0
28309,2,8309,[357 127 125  25 121],450,3,37654,4.531167268351384,0.0,20.0
28310,2,8310,[435 174 286 302  22],450,5,37659,4.531223679460956,0.0,20.0
28311,2,8311,[318 427 496 357 257],330,5,37664,4.531280076997112,60.0,0.0
28312,2,8312,[318 427 496 357 257],330,5,37669,4.531336460964754,60.0,0.0
28313,2,8313,[200 172 318 204 313],450,4,37673,4.5312725523213855,20.0,0.0
28314,2,8314,[318 427 496 357 257],796,5,37678,4.531328923631991,60.0,0.0
28315,2,8315,[318 427 496 357 257],716,5,37683,4.5313852813852815,60.0,0.0
28316,2,8316,[318 427 496 357 257],796,5,37688,4.531441625586149,60.0,0.0
28317,2,8317,[318 427 496 357 257],796,5,37693,4.53149795623948,60.0,0.0
28318,2,8318,[318 427 496 357 257],716,5,37698,4.531554273350162,60.0,0.0
28319,2,8319,[318 427 496 357 257],330,5,37703,4.531610576923077,60.0,0.0
28320,2,8320,[ 12  50  22 405 194],457,5,37708,4.531666866963105,0.0,20.0
28321,2,8321,[318 427 496 357 257],796,5,37713,4.531723143475126,60.0,0.0
28322,2,8322,[318 427 496 357 257],796,5,37718,4.531779406464016,60.0,0.0
28323,2,8323,[318 427 496 357 257],330,5,37723,4.531835655934647,60.0,0.0
28324,2,8324,[318 427 496 357 257],330,5,37728,4.531891891891892,60.0,0.0
28325,2,8325,[318 427 496 357 257],796,5,37733,4.5319481143406195,60.0,0.0
28326,2,8326,[318 427 496 357 257],796,5,37738,4.5320043232856975,60.0,0.0
28327,2,8327,[ 70  89 508 132 273],344,4,37742,4.531940441882805,0.0,0.0
28328,2,8328,[318 427 496 357 257],796,5,37747,4.531996638251891,60.0,0.0
28329,2,8329,[318 427 496 357 257],330,5,37752,4.532052821128452,60.0,0.0
28330,2,8330,[318 427 496 357 257],716,5,37757,4.532108990517345,60.0,0.0
28331,2,8331,[318 427 496 357 257],796,5,37762,4.532165146423428,60.0,0.0
28332,2,8332,[318 427 496 357 257],796,5,37767,4.532221288851554,60.0,0.0
28333,2,8333,[318 427 496 357 257],796,5,37772,4.532277417806576,60.0,0.0
28334,2,8334,[318 427 496 357 257],716,5,37777,4.532333533293341,60.0,0.0
28335,2,8335,[194 483 191 153  97],796,4,37781,4.532269673704414,0.0,0.0
28336,2,8336,[238 100  82 276 135],269,4,37785,4.532205829435049,0.0,20.0
28337,2,8337,[318 427 496 357 257],330,5,37790,4.532261933317343,60.0,0.0
28338,2,8338,[318 427 496 357 257],796,5,37795,4.532318023743854,60.0,0.0
28339,2,8339,[318 427 496 357 257],796,5,37800,4.532374100719425,60.0,0.0
28340,2,8340,[235 268 191 187 121],269,3,37803,4.532190384845942,0.0,0.0
28341,2,8341,[318 427 496 357 257],716,5,37808,4.532246463677775,60.0,0.0
28342,2,8342,[318 427 496 357 257],330,5,37813,4.532302529066283,60.0,0.0
28343,2,8343,[318 427 496 357 257],330,5,37818,4.532358581016299,60.0,0.0
28344,2,8344,[318 427 496 357 257],330,5,37823,4.532414619532655,60.0,0.0
28345,2,8345,[318 427 496 357 257],796,5,37828,4.532470644620178,60.0,0.0
28346,2,8346,[318 427 496 357 257],796,5,37833,4.532526656283695,60.0,0.0
28347,2,8347,[318 427 496 357 257],330,5,37838,4.5325826545280306,60.0,0.0
28348,2,8348,[318 427 496 357 257],716,5,37843,4.532638639358007,60.0,0.0
28349,2,8349,[357 161 313 172 176],655,3,37846,4.53245508982036,0.0,0.0
28350,2,8350,[318 427 496 357 257],330,5,37851,4.532511076517783,60.0,0.0
28351,2,8351,[301  95 118 197  97],796,2,37853,4.53220785440613,0.0,0.0
28352,2,8352,[318 427 496 357 257],716,5,37858,4.53226385729678,60.0,0.0
28353,2,8353,[471 111 403 204   4],280,1,37859,4.5318410342350965,0.0,0.0
28354,2,8354,[318 427 496 357 257],330,5,37864,4.531897067624177,60.0,0.0
28355,2,8355,[318 427 496 357 257],796,5,37869,4.531953087601723,60.0,0.0
28356,2,8356,[318 427 496 357 257],796,5,37874,4.53200909417255,60.0,0.0
28357,2,8357,[318 427 496 357 257],330,5,37879,4.532065087341469,60.0,0.0
28358,2,8358,[322 385  12 117 216],280,5,37884,4.532121067113291,0.0,0.0
28359,2,8359,[318 427 496 357 257],330,5,37889,4.532177033492823,60.0,0.0
28360,2,8360,[318 427 496 357 257],796,5,37894,4.53223298648487,60.0,0.0
28361,2,8361,[286 302 179  70 111],655,2,37896,4.531930160248744,0.0,20.0
28362,2,8362,[191 174  70 204 173],716,5,37901,4.531986129379409,0.0,0.0
28363,2,8363,[318 427 496 357 257],716,5,37906,4.532042085126734,60.0,0.0
28364,2,8364,[318 427 496 357 257],796,5,37911,4.532098027495517,60.0,0.0
28365,2,8365,[318 427 496 357 257],330,5,37916,4.532153956490557,60.0,0.0
28366,2,8366,[318 427 496 357 257],330,5,37921,4.532209872116649,60.0,0.0
28367,2,8367,[151 588  71 269 173],450,4,37925,4.532146271510516,0.0,0.0
28368,2,8368,[318 427 496 357 257],716,5,37930,4.5322021746923165,60.0,0.0
28369,2,8369,[318 427 496 357 257],330,5,37935,4.532258064516129,60.0,0.0
28370,2,8370,[265 183 588 288 215],450,4,37939,4.532194480946123,0.0,0.0
28371,2,8371,[318 427 496 357 257],716,5,37944,4.532250358337315,60.0,0.0
28372,2,8372,[318 427 496 357 257],330,5,37949,4.5323062223814645,60.0,0.0
28373,2,8373,[265 228  25  56 318],655,1,37950,4.531884404107953,20.0,0.0
28374,2,8374,[318 427 496 357 257],330,5,37955,4.531940298507463,60.0,0.0
28375,2,8375,[318 427 496 357 257],796,5,37960,4.531996179560649,60.0,0.0
28376,2,8376,[318 427 496 357 257],330,5,37965,4.532052047272293,60.0,0.0
28377,2,8377,[318 427 496 357 257],796,5,37970,4.532107901647171,60.0,0.0
28378,2,8378,[ 71 211 176  89 294],796,3,37973,4.531925050722043,0.0,0.0
28379,2,8379,[318 427 496 357 257],716,5,37978,4.531980906921241,60.0,0.0
28380,2,8380,[318 427 496 357 257],796,5,37983,4.532036749791194,60.0,0.0
28381,2,8381,[180 228 181 202 195],716,3,37986,4.531853972798855,0.0,0.0
28382,2,8382,[318 427 496 357 257],330,5,37991,4.531909817487773,60.0,0.0
28383,2,8383,[318 427 496 357 257],716,5,37996,4.531965648854962,60.0,0.0
28384,2,8384,[318 427 496 357 257],330,5,38001,4.532021466905188,60.0,0.0
28385,2,8385,[318 427 496 357 257],716,5,38006,4.532077271643215,60.0,0.0
28386,2,8386,[318 427 496 357 257],716,5,38011,4.532133063073805,60.0,0.0
28387,2,8387,[318 427 496 357 257],716,5,38016,4.532188841201717,60.0,0.0
28388,2,8388,[294  98  12 100 182],450,5,38021,4.532244606031708,0.0,20.0
28389,2,8389,[318 427 496 357 257],796,5,38026,4.532300357568534,60.0,0.0
28390,2,8390,[143 237 121 276 318],504,3,38029,4.532117745203194,20.0,0.0
28391,2,8391,[655 202 182 301   1],796,2,38031,4.5318160152526215,0.0,0.0
28392,2,8392,[318 427 496 357 257],716,5,38036,4.5318717979268435,60.0,0.0
28393,2,8393,[318 427 496 357 257],330,5,38041,4.5319275673099835,60.0,0.0
28394,2,8394,[318 427 496 357 257],330,5,38046,4.53198332340679,60.0,0.0
28395,2,8395,[200 111 234 328 135],151,3,38049,4.5318008575512145,0.0,0.0
28396,2,8396,[496 546 385  71  95],796,5,38054,4.531856615457902,20.0,0.0
28397,2,8397,[318 427 496 357 257],796,5,38059,4.531912360085735,60.0,0.0
28398,2,8398,[318 427 496 357 257],716,5,38064,4.531968091439457,60.0,0.0
28399,2,8399,[603 195 132 210 153],269,2,38066,4.531666666666666,20.0,0.0
28400,2,8400,[318 427 496 357 257],330,5,38071,4.531722413998334,60.0,0.0
28401,2,8401,[318 427 496 357 257],716,5,38076,4.531778148059986,60.0,0.0
28402,2,8402,[318 427 496 357 257],796,5,38081,4.531833868856361,60.0,0.0
28403,2,8403,[515 238 275 118  96],655,2,38083,4.531532603522132,0.0,20.0
28404,2,8404,[318 427 496 357 257],716,5,38088,4.531588340273647,60.0,0.0
28405,2,8405,[318 427 496 357 257],330,5,38093,4.531644063763978,60.0,0.0
28406,2,8406,[318 427 496 357 257],796,5,38098,4.531699773997859,60.0,0.0
28407,2,8407,[318 427 496 357 257],716,5,38103,4.531755470980019,60.0,0.0
28408,2,8408,[318 427 496 357 257],796,5,38108,4.531811154715186,60.0,0.0
28409,2,8409,[318 427 496 357 257],330,5,38113,4.531866825208086,60.0,0.0
28410,2,8410,[318 427 496 357 257],330,5,38118,4.5319224824634405,60.0,0.0
28411,2,8411,[318 427 496 357 257],796,5,38123,4.531978126485972,60.0,0.0
28412,2,8412,[603 204 323 228 117],796,4,38127,4.531914893617022,20.0,0.0
28413,2,8413,[318 427 496 357 257],330,5,38132,4.531970525314951,60.0,0.0
28414,2,8414,[318 427 496 357 257],330,5,38137,4.53202614379085,60.0,0.0
28415,2,8415,[318 427 496 357 257],796,5,38142,4.532081749049429,60.0,0.0
28416,2,8416,[318 427 496 357 257],716,5,38147,4.532137341095402,60.0,0.0
28417,2,8417,[318 427 496 357 257],330,5,38152,4.532192919933476,60.0,0.0
28418,2,8418,[318 427 496 357 257],796,5,38157,4.532248485568357,60.0,0.0
28419,2,8419,[318 427 496 357 257],330,5,38162,4.53230403800475,60.0,0.0
28420,2,8420,[318 427 496 357 257],330,5,38167,4.532359577247358,60.0,0.0
28421,2,8421,[318 427 496 357 257],796,5,38172,4.532415103300878,60.0,0.0
28422,2,8422,[318 427 496 357 257],796,5,38177,4.532470616170011,60.0,0.0
28423,2,8423,[318 427 496 357 257],330,5,38182,4.532526115859449,60.0,0.0
28424,2,8424,[318 427 496 357 257],330,5,38187,4.532581602373887,60.0,0.0
28425,2,8425,[318 427 496 357 257],796,5,38192,4.532637075718016,60.0,0.0
28426,2,8426,[318 427 496 357 257],796,5,38197,4.532692535896523,60.0,0.0
28427,2,8427,[318 427 496 357 257],330,5,38202,4.5327479829140955,60.0,0.0
28428,2,8428,[318 427 496 357 257],716,5,38207,4.532803416775418,60.0,0.0
28429,2,8429,[318 427 496 357 257],796,5,38212,4.532858837485172,60.0,0.0
28430,2,8430,[183 333 568 222 597],796,5,38217,4.532914245048037,0.0,0.0
28431,2,8431,[403 385 200 172 357],796,5,38222,4.532969639468691,0.0,0.0
28432,2,8432,[318 427 496 357 257],796,5,38227,4.533025020751809,60.0,0.0
28433,2,8433,[237 185 568 357 294],457,4,38231,4.532961821199905,0.0,0.0
28434,2,8434,[318 427 496 357 257],330,5,38236,4.533017190278601,60.0,0.0
28435,2,8435,[245  22  70 195 111],280,3,38239,4.532835467045993,0.0,0.0
28436,2,8436,[117 153 257 302 211],401,1,38240,4.532416735806566,0.0,0.0
28437,2,8437,[318 427 496 357 257],716,5,38245,4.53247214979853,60.0,0.0
28438,2,8438,[318 427 496 357 257],796,5,38250,4.532527550657661,60.0,0.0
28439,2,8439,[318 427 496 357 257],716,5,38255,4.532582938388626,60.0,0.0
28440,2,8440,[318 427 496 357 257],716,5,38260,4.532638312996091,60.0,0.0
28441,2,8441,[318 427 496 357 257],796,5,38265,4.532693674484719,60.0,0.0
28442,2,8442,[318 427 496 357 257],716,5,38270,4.532749022859173,60.0,0.0
28443,2,8443,[135 288 597 168 215],450,3,38273,4.532567503552818,0.0,0.0
28444,2,8444,[318 427 496 357 257],796,5,38278,4.532622853759621,60.0,0.0
28445,2,8445,[318 427 496 357 257],796,5,38283,4.532678190859579,60.0,0.0
28446,2,8446,[318 427 496 357 257],796,5,38288,4.5327335148573455,60.0,0.0
28447,2,8447,[588 132  98 153 597],796,5,38293,4.532788825757576,0.0,0.0
28448,2,8448,[318 427 496 357 257],796,5,38298,4.532844123564919,60.0,0.0
28449,2,8449,[117 173 194 153 228],716,5,38303,4.532899408284024,0.0,0.0
28450,2,8450,[318 427 496 357 257],716,5,38308,4.532954679919536,60.0,0.0
28451,2,8451,[318 427 496 357 257],330,5,38313,4.5330099384761,60.0,0.0
28452,2,8452,[ 69 234 210 271 176],72,3,38316,4.5328285815686735,0.0,0.0
28453,2,8453,[318 427 496 357 257],716,5,38321,4.532883841968299,60.0,0.0
28454,2,8454,[318 427 496 357 257],716,5,38326,4.532939089296274,60.0,0.0
28455,2,8455,[318 427 496 357 257],330,5,38331,4.532994323557237,60.0,0.0
28456,2,8456,[318 427 496 357 257],716,5,38336,4.533049544755824,60.0,0.0
28457,2,8457,[318 427 496 357 257],330,5,38341,4.533104752896666,60.0,0.0
28458,2,8458,[318 427 496 357 257],330,5,38346,4.533159947984395,60.0,0.0
28459,2,8459,[  1 603 196 275 357],450,5,38351,4.533215130023641,20.0,20.0
28460,2,8460,[318 427 496 357 257],796,5,38356,4.533270299019028,60.0,0.0
28461,2,8461,[318 427 496 357 257],716,5,38361,4.533325454975183,60.0,0.0
28462,2,8462,[318 427 496 357 257],796,5,38366,4.533380597896727,60.0,0.0
28463,2,8463,[318 427 496 357 257],330,5,38371,4.53343572778828,60.0,0.0
28464,2,8464,[318 427 496 357 257],330,5,38376,4.53349084465446,60.0,0.0
28465,2,8465,[318 427 496 357 257],330,5,38381,4.5335459484998815,60.0,0.0
28466,2,8466,[ 95 183 385  82  11],577,4,38385,4.533482933742766,0.0,0.0
28467,2,8467,[318 427 496 357 257],796,5,38390,4.533538025507794,60.0,0.0
28468,2,8468,[318 427 496 357 257],796,5,38395,4.5335931042626045,60.0,0.0
28469,2,8469,[318 427 496 357 257],330,5,38400,4.533648170011807,60.0,0.0
28470,2,8470,[318 427 496 357 257],330,5,38405,4.533703222760005,60.0,0.0
28471,2,8471,[318 427 496 357 257],716,5,38410,4.533758262511804,60.0,0.0
28472,2,8472,[318 427 496 357 257],716,5,38415,4.533813289271804,60.0,0.0
28473,2,8473,[318 427 496 357 257],330,5,38420,4.533868303044607,60.0,0.0
28474,2,8474,[318 427 496 357 257],330,5,38425,4.533923303834809,60.0,0.0
28475,2,8475,[318 427 496 357 257],796,5,38430,4.533978291647004,60.0,0.0
28476,2,8476,[318 427 496 357 257],796,5,38435,4.534033266485785,60.0,0.0
28477,2,8477,[168   1 603 173  25],401,2,38437,4.533734371313989,20.0,0.0
28478,2,8478,[318 427 496 357 257],796,5,38442,4.533789361953061,60.0,0.0
28479,2,8479,[318 427 496 357 257],716,5,38447,4.533844339622641,60.0,0.0
28480,2,8480,[318 427 496 357 257],796,5,38452,4.53389930432732,60.0,0.0
28481,2,8481,[174  82  71 151 187],796,4,38456,4.53383635934921,0.0,0.0
28482,2,8482,[318 427 496 357 257],716,5,38461,4.533891312035836,60.0,0.0
28483,2,8483,[318 427 496 357 257],716,5,38466,4.533946251768034,60.0,0.0
28484,2,8484,[143 483  71 655 423],236,3,38469,4.533765468473777,0.0,0.0
28485,2,8485,[318 427 496 357 257],330,5,38474,4.533820410087203,60.0,0.0
28486,2,8486,[603   7 191 568  82],269,2,38476,4.5335218569577,20.0,0.0
28487,2,8487,[318 427 496 357 257],796,5,38481,4.533576814326107,60.0,0.0
28488,2,8488,[318 427 496 357 257],330,5,38486,4.533631758746613,60.0,0.0
28489,2,8489,[318 427 496 357 257],796,5,38491,4.533686690223793,60.0,0.0
28490,2,8490,[318 427 496 357 257],716,5,38496,4.533741608762218,60.0,0.0
28491,2,8491,[318 427 496 357 257],716,5,38501,4.533796514366463,60.0,0.0
28492,2,8492,[318 427 496 357 257],330,5,38506,4.533851407041093,60.0,0.0
28493,2,8493,[181 302 322 483 546],450,4,38510,4.533788556628208,0.0,0.0
28494,2,8494,[318 427 496 357 257],330,5,38515,4.533843437316068,60.0,0.0
28495,2,8495,[180 194 172 195  96],796,4,38519,4.533780602636535,0.0,0.0
28496,2,8496,[ 22 238 191 423 333],655,1,38520,4.533364716958927,0.0,0.0
28497,2,8497,[318 427 496 357 257],716,5,38525,4.5334196281478,60.0,0.0
28498,2,8498,[318 427 496 357 257],330,5,38530,4.533474526414873,60.0,0.0
28499,2,8499,[228  96   9   4 423],796,4,38534,4.533411764705883,0.0,0.0
28500,2,8500,[318 427 496 357 257],330,5,38539,4.533466650982238,60.0,0.0
28501,2,8501,[318 427 496 357 257],330,5,38544,4.533521524347212,60.0,0.0
28502,2,8502,[318 427 496 357 257],716,5,38549,4.533576384805363,60.0,0.0
28503,2,8503,[318 427 496 357 257],796,5,38554,4.533631232361242,60.0,0.0
28504,2,8504,[127  56  25 423 288],450,3,38557,4.533450911228689,0.0,20.0
28505,2,8505,[318 427 496 357 257],796,5,38562,4.533505760639549,60.0,0.0
28506,2,8506,[318 427 496 357 257],716,5,38567,4.533560597155284,60.0,0.0
28507,2,8507,[286   1 135 111 132],655,1,38568,4.5331452750352605,0.0,20.0
28508,2,8508,[318 427 496 357 257],330,5,38573,4.533200141027148,60.0,0.0
28509,2,8509,[185 153 405 302  82],151,1,38574,4.532784958871916,0.0,0.0
28510,2,8510,[318 427 496 357 257],716,5,38579,4.532839854306192,60.0,0.0
28511,2,8511,[318 427 496 357 257],796,5,38584,4.532894736842105,60.0,0.0
28512,2,8512,[318 427 496 357 257],796,5,38589,4.532949606484201,60.0,0.0
28513,2,8513,[318 427 496 357 257],716,5,38594,4.533004463237021,60.0,0.0
28514,2,8514,[318 427 496 357 257],330,5,38599,4.533059307105109,60.0,0.0
28515,2,8515,[318 427 496 357 257],330,5,38604,4.533114138093001,60.0,0.0
28516,2,8516,[318 427 496 357 257],716,5,38609,4.533168956205237,60.0,0.0
28517,2,8517,[318 427 496 357 257],796,5,38614,4.533223761446349,60.0,0.0
28518,2,8518,[423 265  96  50 210],450,4,38618,4.533161169151309,0.0,20.0
28519,2,8519,[  9 173  64 275 210],401,2,38620,4.532863849765258,20.0,20.0
28520,2,8520,[318 427 496 357 257],330,5,38625,4.532918671517428,60.0,0.0
28521,2,8521,[318 427 496 357 257],796,5,38630,4.532973480403661,60.0,0.0
28522,2,8522,[318 427 496 357 257],796,5,38635,4.533028276428488,60.0,0.0
28523,2,8523,[483  25  82 191  12],151,3,38638,4.53284842796809,0.0,0.0
28524,2,8524,[318 427 496 357 257],716,5,38643,4.532903225806452,60.0,0.0
28525,2,8525,[318 427 496 357 257],330,5,38648,4.532958010790523,60.0,0.0
28526,2,8526,[271  88 318 179  70],655,2,38650,4.532660959305734,20.0,0.0
28527,2,8527,[318 427 496 357 257],796,5,38655,4.532715759849906,60.0,0.0
28528,2,8528,[318 427 496 357 257],716,5,38660,4.532770547543675,60.0,0.0
28529,2,8529,[423 515 118 302  56],655,2,38662,4.5324736225087925,0.0,0.0
28530,2,8530,[318 427 496 357 257],330,5,38667,4.532528425741414,60.0,0.0
28531,2,8531,[318 427 496 357 257],716,5,38672,4.53258321612752,60.0,0.0
28532,2,8532,[318 427 496 357 257],716,5,38677,4.532637993671628,60.0,0.0
28533,2,8533,[125 301 132 210 302],655,1,38678,4.532224044996485,0.0,0.0
28534,2,8534,[318 427 496 357 257],330,5,38683,4.53227885178676,60.0,0.0
28535,2,8535,[423 191 215  88 200],577,3,38686,4.532099343955014,0.0,0.0
28536,2,8536,[318 427 496 357 257],330,5,38691,4.532154152512592,60.0,0.0
28537,2,8537,[318 427 496 357 257],796,5,38696,4.532208948231436,60.0,0.0
28538,2,8538,[282  64 153   1 161],716,3,38699,4.532029511652419,20.0,0.0
28539,2,8539,[318 427 496 357 257],716,5,38704,4.53208430913349,60.0,0.0
28540,2,8540,[318 427 496 357 257],330,5,38709,4.53213909378293,60.0,0.0
28541,2,8541,[318 427 496 357 257],796,5,38714,4.532193865605245,60.0,0.0
28542,2,8542,[318 427 496 357 257],716,5,38719,4.532248624604939,60.0,0.0
28543,2,8543,[318 427 496 357 257],330,5,38724,4.532303370786517,60.0,0.0
28544,2,8544,[318 427 496 357 257],330,5,38729,4.5323581041544765,60.0,0.0
28545,2,8545,[318 427 496 357 257],716,5,38734,4.532412824713316,60.0,0.0
28546,2,8546,[  7 196  98  64 125],151,5,38739,4.532467532467533,20.0,0.0
28547,2,8547,[496  96  82 313 322],450,4,38743,4.532405240992045,20.0,0.0
28548,2,8548,[318 427 496 357 257],796,5,38748,4.532459936834718,60.0,0.0
28549,2,8549,[496 405  22   4 194],450,4,38752,4.532397660818713,20.0,0.0
28550,2,8550,[ 11 258 175 168   9],11,2,38754,4.532101508595486,0.0,0.0
28551,2,8551,[318 427 496 357 257],796,5,38759,4.532156220767072,60.0,0.0
28552,2,8552,[ 64   1 202 175 568],457,5,38764,4.532210920144978,20.0,0.0
28553,2,8553,[121 211  82 183 323],504,4,38768,4.532148702361468,0.0,0.0
28554,2,8554,[318 427 496 357 257],796,5,38773,4.532203389830508,60.0,0.0
28555,2,8555,[168  95 194 111 118],577,4,38777,4.53214118747078,0.0,0.0
28556,2,8556,[597 748 245 385 275],450,5,38782,4.532195863036111,0.0,20.0
28557,2,8557,[222 405  71  22 117],450,3,38785,4.532016826361299,0.0,0.0
28558,2,8558,[318 427 496 357 257],330,5,38790,4.532071503680337,60.0,0.0
28559,2,8559,[151 185 181  64 173],716,5,38795,4.532126168224299,20.0,0.0
28560,2,8560,[405 301 435 204 276],655,1,38796,4.531713584861581,0.0,0.0
28561,2,8561,[318 427 496 357 257],716,5,38801,4.531768278439617,60.0,0.0
28562,2,8562,[111  22  71 294 385],280,4,38805,4.531706177741445,0.0,0.0
28563,2,8563,[318 427 496 357 257],796,5,38810,4.53176085941149,60.0,0.0
28564,2,8564,[318 427 496 357 257],716,5,38815,4.531815528312901,60.0,0.0
28565,2,8565,[318 427 496 357 257],716,5,38820,4.531870184450152,60.0,0.0
28566,2,8566,[318 427 496 357 257],796,5,38825,4.531924827827711,60.0,0.0
28567,2,8567,[568 313 181  12 301],655,1,38826,4.531512605042017,0.0,0.0
28568,2,8568,[318 427 496 357 257],716,5,38831,4.531567277395262,60.0,0.0
28569,2,8569,[318 427 496 357 257],330,5,38836,4.531621936989498,60.0,0.0
28570,2,8570,[318 427 496 357 257],330,5,38841,4.531676583829191,60.0,0.0
28571,2,8571,[318 427 496 357 257],796,5,38846,4.531731217918805,60.0,0.0
28572,2,8572,[318 427 496 357 257],796,5,38851,4.531785839262802,60.0,0.0
28573,2,8573,[200 318   4 174 180],504,5,38856,4.53184044786564,20.0,0.0
28574,2,8574,[318 427 496 357 257],796,5,38861,4.531895043731779,60.0,0.0
28575,2,8575,[318 427 496 357 257],330,5,38866,4.531949626865671,60.0,0.0
28576,2,8576,[318 427 496 357 257],330,5,38871,4.532004197271774,60.0,0.0
28577,2,8577,[ 11  98 228  15 216],330,5,38876,4.532058754954535,0.0,0.0
28578,2,8578,[289 153   1 301  15],655,0,38876,4.5315304814080895,0.0,0.0
28579,2,8579,[318 427 496 357 257],330,5,38881,4.5315850815850816,60.0,0.0
28580,2,8580,[318 427 496 357 257],716,5,38886,4.531639669036243,60.0,0.0
28581,2,8581,[318 427 496 357 257],330,5,38891,4.5316942437660215,60.0,0.0
28582,2,8582,[318 427 496 357 257],330,5,38896,4.531748805778865,60.0,0.0
28583,2,8583,[  1  98 258  88 181],796,4,38900,4.531686859273067,0.0,0.0
28584,2,8584,[318 427 496 357 257],716,5,38905,4.531741409435061,60.0,0.0
28585,2,8585,[318 427 496 357 257],796,5,38910,4.531795946890287,60.0,0.0
28586,2,8586,[191 357 282 173 234],716,4,38914,4.5317340165366256,0.0,0.0
28587,2,8587,[318 427 496 357 257],716,5,38919,4.53178854215184,60.0,0.0
28588,2,8588,[588 181  88 200 183],716,4,38923,4.5317266270811505,0.0,0.0
28589,2,8589,[179 655 257 265 121],655,1,38924,4.531315483119907,0.0,0.0
28590,2,8590,[318 427 496 357 257],330,5,38929,4.531370038412292,60.0,0.0
28591,2,8591,[318 427 496 357 257],716,5,38934,4.531424581005586,60.0,0.0
28592,2,8592,[318 427 496 357 257],796,5,38939,4.5314791109042245,60.0,0.0
28593,2,8593,[318 427 496 357 257],330,5,38944,4.531533628112637,60.0,0.0
28594,2,8594,[318 427 496 357 257],330,5,38949,4.531588132635253,60.0,0.0
28595,2,8595,[318 427 496 357 257],330,5,38954,4.5316426244765005,60.0,0.0
28596,2,8596,[385 195  98  50 286],450,5,38959,4.531697103640805,0.0,40.0
28597,2,8597,[318 427 496 357 257],796,5,38964,4.531751570132589,60.0,0.0
28598,2,8598,[318 427 496 357 257],796,5,38969,4.531806023956274,60.0,0.0
28599,2,8599,[318 427 496 357 257],330,5,38974,4.531860465116279,60.0,0.0
28600,2,8600,[318 427 496 357 257],716,5,38979,4.531914893617022,60.0,0.0
28601,2,8601,[294 288 183 153  15],450,3,38982,4.531736805394094,0.0,0.0
28602,2,8602,[318 427 496 357 257],330,5,38987,4.531791235615483,60.0,0.0
28603,2,8603,[318 427 496 357 257],716,5,38992,4.531845653184566,60.0,0.0
28604,2,8604,[318 427 496 357 257],716,5,38997,4.5319000581057525,60.0,0.0
28605,2,8605,[202 328  56 237   9],796,4,39001,4.531838252382059,0.0,0.0
28606,2,8606,[318 427 496 357 257],796,5,39006,4.531892645521087,60.0,0.0
28607,2,8607,[318 427 496 357 257],716,5,39011,4.531947026022305,60.0,0.0
28608,2,8608,[318 427 496 357 257],330,5,39016,4.532001393890115,60.0,0.0
28609,2,8609,[318 427 496 357 257],330,5,39021,4.5320557491289195,60.0,0.0
28610,2,8610,[318 427 496 357 257],716,5,39026,4.532110091743119,60.0,0.0
28611,2,8611,[318 427 496 357 257],796,5,39031,4.532164421737111,60.0,0.0
28612,2,8612,[318 427 496 357 257],716,5,39036,4.532218739115291,60.0,0.0
28613,2,8613,[403  82 294  28 237],577,5,39041,4.532273043882053,0.0,0.0
28614,2,8614,[318 427 496 357 257],330,5,39046,4.532327336041788,60.0,0.0
28615,2,8615,[318 427 496 357 257],716,5,39051,4.532381615598886,60.0,0.0
28616,2,8616,[483 257 111   7 183],457,3,39054,4.5322037832192175,0.0,0.0
28617,2,8617,[318 427 496 357 257],716,5,39059,4.532258064516129,60.0,0.0
28618,2,8618,[318 427 496 357 257],716,5,39064,4.532312333217311,60.0,0.0
28619,2,8619,[318 427 496 357 257],716,5,39069,4.532366589327146,60.0,0.0
28620,2,8620,[427 234 195 202  69],151,4,39073,4.532304837025867,20.0,0.0
28621,2,8621,[318 427 496 357 257],716,5,39078,4.532359081419624,60.0,0.0
28622,2,8622,[195 275 328 222 172],655,2,39080,4.532065406471066,0.0,20.0
28623,2,8623,[318 427 496 357 257],330,5,39085,4.532119666048238,60.0,0.0
28624,2,8624,[228  11 294   7 483],655,1,39086,4.531710144927536,0.0,0.0
28625,2,8625,[475 275 742 195  88],655,1,39087,4.531300718757246,0.0,20.0
28626,2,8626,[318 427 496 357 257],330,5,39092,4.531355048104787,60.0,0.0
28627,2,8627,[294 196 275 125 423],796,4,39096,4.531293463143254,0.0,20.0
28628,2,8628,[318 427 496 357 257],330,5,39101,4.531347780739368,60.0,0.0
28629,2,8629,[318 427 496 357 257],796,5,39106,4.531402085747393,60.0,0.0
28630,2,8630,[318 427 496 357 257],330,5,39111,4.531456378171707,60.0,0.0
28631,2,8631,[318 427 496 357 257],330,5,39116,4.531510658016682,60.0,0.0
28632,2,8632,[318 427 496 357 257],330,5,39121,4.53156492528669,60.0,0.0
28633,2,8633,[318 427 496 357 257],716,5,39126,4.531619179986102,60.0,0.0
28634,2,8634,[318 427 496 357 257],330,5,39131,4.531673422119282,60.0,0.0
28635,2,8635,[318 427 496 357 257],796,5,39136,4.5317276516905975,60.0,0.0
28636,2,8636,[318 427 496 357 257],796,5,39141,4.531781868704411,60.0,0.0
28637,2,8637,[211 182 471 301 200],593,3,39144,4.53160453808752,0.0,0.0
28638,2,8638,[318 427 496 357 257],330,5,39149,4.531658756800556,60.0,0.0
28639,2,8639,[318 427 496 357 257],716,5,39154,4.531712962962963,60.0,0.0
28640,2,8640,[318 427 496 357 257],330,5,39159,4.531767156579099,60.0,0.0
28641,2,8641,[318 427 496 357 257],716,5,39164,4.531821337653321,60.0,0.0
28642,2,8642,[318 427 496 357 257],796,5,39169,4.53187550618998,60.0,0.0
28643,2,8643,[318 427 496 357 257],716,5,39174,4.531929662193429,60.0,0.0
28644,2,8644,[318 427 496 357 257],796,5,39179,4.531983805668016,60.0,0.0
28645,2,8645,[318 427 496 357 257],330,5,39184,4.53203793661809,60.0,0.0
28646,2,8646,[172 161 748 273 125],796,4,39188,4.531976408002776,0.0,0.0
28647,2,8647,[318 427 496 357 257],716,5,39193,4.532030527289547,60.0,0.0
28648,2,8648,[ 50  70 282 174 265],535,3,39196,4.531853393455891,0.0,20.0
28649,2,8649,[318 427 496 357 257],330,5,39201,4.531907514450867,60.0,0.0
28650,2,8650,[318 427 496 357 257],796,5,39206,4.531961622933765,60.0,0.0
28651,2,8651,[318 427 496 357 257],716,5,39211,4.532015718908923,60.0,0.0
28652,2,8652,[318 427 496 357 257],716,5,39216,4.532069802380677,60.0,0.0
28653,2,8653,[318 427 496 357 257],796,5,39221,4.532123873353362,60.0,0.0
28654,2,8654,[202 210 172 204 191],655,2,39223,4.531831311380705,0.0,0.0
28655,2,8655,[318 427 496 357 257],716,5,39228,4.5318853974122,60.0,0.0
28656,2,8656,[318 427 496 357 257],796,5,39233,4.531939470948365,60.0,0.0
28657,2,8657,[318 427 496 357 257],796,5,39238,4.531993531993532,60.0,0.0
28658,2,8658,[385  22 405  79 483],457,5,39243,4.532047580552026,0.0,0.0
28659,2,8659,[237 172 215   8  56],577,4,39247,4.531986143187067,0.0,0.0
28660,2,8660,[318 427 496 357 257],330,5,39252,4.532040180117769,60.0,0.0
28661,2,8661,[318 427 496 357 257],330,5,39257,4.532094204571693,60.0,0.0
28662,2,8662,[318 427 496 357 257],716,5,39262,4.532148216553157,60.0,0.0
28663,2,8663,[318 427 496 357 257],716,5,39267,4.532202216066482,60.0,0.0
28664,2,8664,[318 427 496 357 257],330,5,39272,4.532256203115984,60.0,0.0
28665,2,8665,[318 427 496 357 257],796,5,39277,4.532310177705978,60.0,0.0
28666,2,8666,[318 427 496 357 257],796,5,39282,4.532364139840776,60.0,0.0
28667,2,8667,[132  64 183  50 187],693,1,39283,4.531956622058145,20.0,20.0
28668,2,8668,[318 427 496 357 257],796,5,39288,4.5320106125273965,60.0,0.0
28669,2,8669,[318 427 496 357 257],716,5,39293,4.532064590542099,60.0,0.0
28670,2,8670,[318 427 496 357 257],796,5,39298,4.532118556106562,60.0,0.0
28671,2,8671,[153 496 588 200 237],716,5,39303,4.532172509225092,20.0,0.0
28672,2,8672,[318 427 496 357 257],796,5,39308,4.532226449901994,60.0,0.0
28673,2,8673,[515 194 173 210 211],535,4,39312,4.532165091076781,0.0,0.0
28674,2,8674,[318 427 496 357 257],716,5,39317,4.532219020172911,60.0,0.0
28675,2,8675,[318 427 496 357 257],330,5,39322,4.532272936837252,60.0,0.0
28676,2,8676,[181 237  56 588 176],280,2,39324,4.5319810994583385,0.0,0.0
28677,2,8677,[176 333 181 125 496],796,5,39329,4.53203503111316,20.0,0.0
28678,2,8678,[318 427 496 357 257],330,5,39334,4.532088950339901,60.0,0.0
28679,2,8679,[318 427 496 357 257],716,5,39339,4.5321428571428575,60.0,0.0
28680,2,8680,[318 427 496 357 257],796,5,39344,4.532196751526322,60.0,0.0
28681,2,8681,[318 427 496 357 257],716,5,39349,4.532250633494587,60.0,0.0
28682,2,8682,[318 427 496 357 257],796,5,39354,4.53230450305194,60.0,0.0
28683,2,8683,[318 427 496 357 257],716,5,39359,4.532358360202672,60.0,0.0
28684,2,8684,[318 427 496 357 257],716,5,39364,4.532412204951065,60.0,0.0
28685,2,8685,[318 427 496 357 257],330,5,39369,4.532466037301405,60.0,0.0
28686,2,8686,[318 427 496 357 257],796,5,39374,4.532519857257972,60.0,0.0
28687,2,8687,[100 195 268 175 111],655,0,39374,4.531998158379374,0.0,20.0
28688,2,8688,[546   1 216 181 228],716,4,39378,4.53193693175279,0.0,0.0
28689,2,8689,[318 427 496 357 257],330,5,39383,4.53199079401611,60.0,0.0
28690,2,8690,[318 427 496 357 257],716,5,39388,4.532044643884478,60.0,0.0
28691,2,8691,[318 427 496 357 257],330,5,39393,4.532098481362172,60.0,0.0
28692,2,8692,[318 427 496 357 257],330,5,39398,4.532152306453468,60.0,0.0
28693,2,8693,[318 427 496 357 257],330,5,39403,4.532206119162641,60.0,0.0
28694,2,8694,[ 11 603 318 185  71],535,5,39408,4.532259919493962,40.0,0.0
28695,2,8695,[318 427 496 357 257],716,5,39413,4.532313707451702,60.0,0.0
28696,2,8696,[318 427 496 357 257],796,5,39418,4.532367483040129,60.0,0.0
28697,2,8697,[318 427 496 357 257],330,5,39423,4.5324212462635085,60.0,0.0
28698,2,8698,[318 427 496 357 257],796,5,39428,4.532474997126107,60.0,0.0
28699,2,8699,[300 748  22 117 125],796,5,39433,4.532528735632184,0.0,0.0
28700,2,8700,[742 172  96   8 237],796,4,39437,4.532467532467533,0.0,0.0
28701,2,8701,[318 427 496 357 257],716,5,39442,4.532521259480579,60.0,0.0
28702,2,8702,[  1 333 191  98 135],655,3,39445,4.532345168332759,0.0,0.0
28703,2,8703,[318 427 496 357 257],330,5,39450,4.532398897058823,60.0,0.0
28704,2,8704,[318 427 496 357 257],330,5,39455,4.532452613440552,60.0,0.0
28705,2,8705,[318 427 496 357 257],330,5,39460,4.532506317482196,60.0,0.0
28706,2,8706,[318 427 496 357 257],716,5,39465,4.53256000918801,60.0,0.0
28707,2,8707,[318 427 496 357 257],796,5,39470,4.5326136885622414,60.0,0.0
28708,2,8708,[318 427 496 357 257],796,5,39475,4.53266735560914,60.0,0.0
28709,2,8709,[318 427 496 357 257],796,5,39480,4.532721010332951,60.0,0.0
28710,2,8710,[318 427 496 357 257],330,5,39485,4.532774652737918,60.0,0.0
28711,2,8711,[318 427 496 357 257],330,5,39490,4.532828282828283,60.0,0.0
28712,2,8712,[318 427 496 357 257],796,5,39495,4.532881900608286,60.0,0.0
28713,2,8713,[196 257 228 275 132],23,3,39498,4.5327059903603395,0.0,20.0
28714,2,8714,[318 427 496 357 257],796,5,39503,4.532759609868044,60.0,0.0
28715,2,8715,[318 427 496 357 257],330,5,39508,4.532813217072051,60.0,0.0
28716,2,8716,[318 427 496 357 257],716,5,39513,4.532866811976597,60.0,0.0
28717,2,8717,[318 427 496 357 257],330,5,39518,4.532920394585914,60.0,0.0
28718,2,8718,[403 172  69  64 186],655,2,39520,4.532629888748709,20.0,0.0
28719,2,8719,[318 427 496 357 257],330,5,39525,4.532683486238532,60.0,0.0
28720,2,8720,[318 427 496 357 257],796,5,39530,4.532737071436761,60.0,0.0
28721,2,8721,[318 427 496 357 257],716,5,39535,4.532790644347627,60.0,0.0
28722,2,8722,[318 427 496 357 257],796,5,39540,4.532844204975352,60.0,0.0
28723,2,8723,[318 427 496 357 257],330,5,39545,4.532897753324163,60.0,0.0
28724,2,8724,[318 427 496 357 257],796,5,39550,4.532951289398281,60.0,0.0
28725,2,8725,[318 427 496 357 257],330,5,39555,4.533004813201925,60.0,0.0
28726,2,8726,[318 427 496 357 257],796,5,39560,4.533058324739315,60.0,0.0
28727,2,8727,[318 427 496 357 257],796,5,39565,4.533111824014665,60.0,0.0
28728,2,8728,[318 427 496 357 257],796,5,39570,4.5331653110321914,60.0,0.0
28729,2,8729,[318 427 496 357 257],330,5,39575,4.533218785796105,60.0,0.0
28730,2,8730,[318 427 496 357 257],716,5,39580,4.533272248310618,60.0,0.0
28731,2,8731,[318 427 496 357 257],716,5,39585,4.533325698579936,60.0,0.0
28732,2,8732,[ 96 235 471 195 357],457,4,39589,4.533264628420932,0.0,0.0
28733,2,8733,[318 427 496 357 257],330,5,39594,4.533318067323105,60.0,0.0
28734,2,8734,[318 427 496 357 257],330,5,39599,4.533371493989697,60.0,0.0
28735,2,8735,[318 427 496 357 257],796,5,39604,4.533424908424909,60.0,0.0
28736,2,8736,[318 427 496 357 257],716,5,39609,4.53347831063294,60.0,0.0
28737,2,8737,[  4 121  89 405 181],796,5,39614,4.53353170061799,0.0,0.0
28738,2,8738,[318 427 496 357 257],330,5,39619,4.533585078384254,60.0,0.0
28739,2,8739,[181  64 328 144  98],655,2,39621,4.5332951945080096,20.0,0.0
28740,2,8740,[318 427 496 357 257],796,5,39626,4.533348587118179,60.0,0.0
28741,2,8741,[318 427 496 357 257],330,5,39631,4.5334019675131545,60.0,0.0
28742,2,8742,[328  12 196 286   4],796,4,39635,4.53334095848107,0.0,20.0
28743,2,8743,[318 427 496 357 257],330,5,39640,4.5333943275388835,60.0,0.0
28744,2,8744,[318 427 496 357 257],796,5,39645,4.5334476843910805,60.0,0.0
28745,2,8745,[318 427 496 357 257],796,5,39650,4.533501029041847,60.0,0.0
28746,2,8746,[168 313  15  69 357],796,5,39655,4.53355436149537,0.0,0.0
28747,2,8747,[271 186 191  79 301],655,2,39657,4.533264746227709,0.0,0.0
28748,2,8748,[655 496 181 143 135],716,4,39661,4.533203794719396,20.0,0.0
28749,2,8749,[318 427 496 357 257],716,5,39666,4.533257142857143,60.0,0.0
28750,2,8750,[318 427 496 357 257],330,5,39671,4.533310478802423,60.0,0.0
28751,2,8751,[318 427 496 357 257],716,5,39676,4.533363802559415,60.0,0.0
28752,2,8752,[318 427 496 357 257],716,5,39681,4.533417114132297,60.0,0.0
28753,2,8753,[127 234 515 288  56],292,4,39685,4.533356180031985,0.0,20.0
28754,2,8754,[318 427 496 357 257],796,5,39690,4.5334094802969735,60.0,0.0
28755,2,8755,[200 143 423 237 168],716,5,39695,4.533462768387391,0.0,0.0
28756,2,8756,[318 427 496 357 257],796,5,39700,4.533516044307412,60.0,0.0
28757,2,8757,[117 385  82 168 237],457,5,39705,4.533569308061201,0.0,0.0
28758,2,8758,[197 546 228 132 276],280,3,39708,4.533394223084827,0.0,0.0
28759,2,8759,[ 50 475 258  22 289],296,4,39712,4.533333333333333,0.0,20.0
28760,2,8760,[318 427 496 357 257],716,5,39717,4.53338659970323,60.0,0.0
28761,2,8761,[318 427 496 357 257],796,5,39722,4.533439853914631,60.0,0.0
28762,2,8762,[318 427 496 357 257],716,5,39727,4.533493095971699,60.0,0.0
28763,2,8763,[318 427 496 357 257],796,5,39732,4.533546325878595,60.0,0.0
28764,2,8764,[318 427 496 357 257],330,5,39737,4.533599543639475,60.0,0.0
28765,2,8765,[286 313   8 151 111],344,3,39740,4.533424595026238,0.0,20.0
28766,2,8766,[117 483 271 182 289],655,2,39742,4.533135622219687,0.0,0.0
28767,2,8767,[318 427 496 357 257],330,5,39747,4.533188868613139,60.0,0.0
28768,2,8768,[318 427 496 357 257],796,5,39752,4.533242102862356,60.0,0.0
28769,2,8769,[318 427 496 357 257],330,5,39757,4.533295324971494,60.0,0.0
28770,2,8770,[318 427 496 357 257],716,5,39762,4.533348534944704,60.0,0.0
28771,2,8771,[318 427 496 357 257],796,5,39767,4.533401732786138,60.0,0.0
28772,2,8772,[127 237 403  96 200],504,3,39770,4.53322694631255,0.0,20.0
28773,2,8773,[318 427 496 357 257],716,5,39775,4.533280145885571,60.0,0.0
28774,2,8774,[318 427 496 357 257],796,5,39780,4.533333333333333,60.0,0.0
28775,2,8775,[258 187 118 568 135],450,3,39783,4.533158614402917,0.0,0.0
28776,2,8776,[318 427 496 357 257],330,5,39788,4.533211803577532,60.0,0.0
28777,2,8777,[318 427 496 357 257],716,5,39793,4.533264980633402,60.0,0.0
28778,2,8778,[318 427 496 357 257],716,5,39798,4.5333181455746665,60.0,0.0
28779,2,8779,[318 427 496 357 257],796,5,39803,4.533371298405467,60.0,0.0
28780,2,8780,[268 181 269  71 210],535,4,39807,4.533310556884182,0.0,0.0
28781,2,8781,[318 427 496 357 257],796,5,39812,4.533363698474152,60.0,0.0
28782,2,8782,[318 427 496 357 257],796,5,39817,4.53341682796311,60.0,0.0
28783,2,8783,[318 427 496 357 257],330,5,39822,4.533469945355192,60.0,0.0
28784,2,8784,[318 427 496 357 257],796,5,39827,4.533523050654525,60.0,0.0
28785,2,8785,[318 427 496 357 257],796,5,39832,4.53357614386524,60.0,0.0
28786,2,8786,[132 238 143 195 588],716,4,39836,4.533515420507568,0.0,0.0
28787,2,8787,[318 427 496 357 257],796,5,39841,4.533568502503414,60.0,0.0
28788,2,8788,[318 427 496 357 257],330,5,39846,4.533621572420071,60.0,0.0
28789,2,8789,[318 427 496 357 257],330,5,39851,4.533674630261661,60.0,0.0
28790,2,8790,[228   8 202  96 269],23,4,39855,4.533613923330679,0.0,0.0
28791,2,8791,[  9 179 161 196 174],457,5,39860,4.533666969972702,0.0,0.0
28792,2,8792,[318 427 496 357 257],330,5,39865,4.533720004549073,60.0,0.0
28793,2,8793,[318 427 496 357 257],796,5,39870,4.533773027063908,60.0,0.0
28794,2,8794,[318 427 496 357 257],716,5,39875,4.533826037521319,60.0,0.0
28795,2,8795,[318 427 496 357 257],330,5,39880,4.533879035925421,60.0,0.0
28796,2,8796,[318 427 496 357 257],330,5,39885,4.5339320222803225,60.0,0.0
28797,2,8797,[318 427 496 357 257],796,5,39890,4.533984996590134,60.0,0.0
28798,2,8798,[318 427 496 357 257],716,5,39895,4.534037958858962,60.0,0.0
28799,2,8799,[318 427 496 357 257],796,5,39900,4.534090909090909,60.0,0.0
28800,2,8800,[318 427 496 357 257],796,5,39905,4.534143847290081,60.0,0.0
28801,2,8801,[318 427 496 357 257],330,5,39910,4.534196773460577,60.0,0.0
28802,2,8802,[318 427 496 357 257],330,5,39915,4.534249687606498,60.0,0.0
28803,2,8803,[318 427 496 357 257],716,5,39920,4.53430258973194,60.0,0.0
28804,2,8804,[161 385 269 200 238],655,1,39921,4.533901192504259,0.0,0.0
28805,2,8805,[318 427 496 357 257],716,5,39926,4.533954122189416,60.0,0.0
28806,2,8806,[318 427 496 357 257],796,5,39931,4.534007039854661,60.0,0.0
28807,2,8807,[258  12  96 496 215],796,5,39936,4.5340599455040875,20.0,0.0
28808,2,8808,[357 132 200   9 313],796,4,39940,4.53399931887842,0.0,0.0
28809,2,8809,[ 69 405 132 427 568],716,5,39945,4.5340522133938705,20.0,0.0
28810,2,8810,[318 427 496 357 257],330,5,39950,4.534105095902849,60.0,0.0
28811,2,8811,[318 427 496 357 257],716,5,39955,4.534157966409442,60.0,0.0
28812,2,8812,[318 427 496 357 257],330,5,39960,4.534210824917735,60.0,0.0
28813,2,8813,[318 427 496 357 257],330,5,39965,4.534263671431813,60.0,0.0
28814,2,8814,[ 56 385 173 568 168],577,3,39968,4.534089619965967,0.0,0.0
28815,2,8815,[318 427 496 357 257],330,5,39973,4.534142468239565,60.0,0.0
28816,2,8816,[111 174 185 427  50],796,5,39978,4.5341953045253485,20.0,20.0
28817,2,8817,[234 172 588 197 483],457,5,39983,4.534248128827398,0.0,0.0
28818,2,8818,[318 427 496 357 257],330,5,39988,4.53430094114979,60.0,0.0
28819,2,8819,[318 427 496 357 257],796,5,39993,4.534353741496599,60.0,0.0
28820,2,8820,[318 427 496 357 257],330,5,39998,4.534406529871896,60.0,0.0
28821,2,8821,[588 185 153 216 100],23,5,40003,4.534459306279755,0.0,20.0
28822,2,8822,[318 427 496 357 257],796,5,40008,4.534512070724244,60.0,0.0
28823,2,8823,[318 427 496 357 257],716,5,40013,4.534564823209429,60.0,0.0
28824,2,8824,[ 11 127 151 180  98],292,5,40018,4.534617563739377,0.0,20.0
28825,2,8825,[318 427 496 357 257],796,5,40023,4.534670292318151,60.0,0.0
28826,2,8826,[318 427 496 357 257],716,5,40028,4.534723008949813,60.0,0.0
28827,2,8827,[318 427 496 357 257],716,5,40033,4.534775713638423,60.0,0.0
28828,2,8828,[318 427 496 357 257],796,5,40038,4.53482840638804,60.0,0.0
28829,2,8829,[210  96 603 237 118],72,3,40041,4.534654586636466,20.0,0.0
28830,2,8830,[318 427 496 357 257],796,5,40046,4.53470728116861,60.0,0.0
28831,2,8831,[161 153 179  69 211],450,5,40051,4.534759963768116,0.0,0.0
28832,2,8832,[ 96 135   8 496 742],280,5,40056,4.534812634439035,20.0,0.0
28833,2,8833,[318 427 496 357 257],796,5,40061,4.53486529318542,60.0,0.0
28834,2,8834,[121 197 215  15 289],655,0,40061,4.534352009054896,0.0,0.0
28835,2,8835,[318 427 496 357 257],330,5,40066,4.5344047080126755,60.0,0.0
28836,2,8836,[ 56 286 100 301 313],860,4,40070,4.534344234468711,0.0,40.0
28837,2,8837,[172 182 153 546 211],796,4,40074,4.53428377460964,0.0,0.0
28838,2,8838,[318 427 496 357 257],330,5,40079,4.534336463400837,60.0,0.0
28839,2,8839,[161   8 235  69 405],807,4,40083,4.534276018099548,0.0,0.0
28840,2,8840,[318 427 496 357 257],796,5,40088,4.5343286958488855,60.0,0.0
28841,2,8841,[ 89 234 275 174  25],151,5,40093,4.534381361682877,0.0,20.0
28842,2,8842,[318 427 496 357 257],330,5,40098,4.534434015605564,60.0,0.0
28843,2,8843,[318 427 496 357 257],716,5,40103,4.534486657620986,60.0,0.0
28844,2,8844,[318 427 496 357 257],330,5,40108,4.534539287733183,60.0,0.0
28845,2,8845,[187 294 237 496 228],450,5,40113,4.534591905946191,20.0,0.0
28846,2,8846,[318 427 496 357 257],716,5,40118,4.534644512264045,60.0,0.0
28847,2,8847,[471  64 313 210  56],693,2,40120,4.5343580470162745,20.0,0.0
28848,2,8848,[318 427 496 357 257],716,5,40125,4.534410667872076,60.0,0.0
28849,2,8849,[405 403  50 234 173],577,3,40128,4.534237288135593,0.0,20.0
28850,2,8850,[318 427 496 357 257],796,5,40133,4.5342899107445485,60.0,0.0
28851,2,8851,[318 427 496 357 257],716,5,40138,4.534342521464076,60.0,0.0
28852,2,8852,[228 202 288 273 655],655,1,40139,4.533943296057833,0.0,0.0
28853,2,8853,[318 427 496 357 257],796,5,40144,4.533995934041111,60.0,0.0
28854,2,8854,[185   8 182 127 186],18,4,40148,4.533935629587804,0.0,20.0
28855,2,8855,[318 427 496 357 257],716,5,40153,4.533988256549232,60.0,0.0
28856,2,8856,[197  56 168 153 100],269,4,40157,4.533927966580106,0.0,20.0
28857,2,8857,[318 427 496 357 257],330,5,40162,4.533980582524272,60.0,0.0
28858,2,8858,[318 427 496 357 257],330,5,40167,4.534033186589909,60.0,0.0
28859,2,8859,[318 427 496 357 257],330,5,40172,4.534085778781038,60.0,0.0
28860,2,8860,[168 275 269 179 181],878,4,40176,4.534025505022006,0.0,20.0
28861,2,8861,[ 89 118 328   9 210],796,3,40179,4.53385240352065,0.0,0.0
28862,2,8862,[318 427 496 357 257],716,5,40184,4.5339049983075705,60.0,0.0
28863,2,8863,[ 69 435 186 132 181],18,3,40187,4.533731949458484,0.0,0.0
28864,2,8864,[318 427 496 357 257],796,5,40192,4.533784545967287,60.0,0.0
28865,2,8865,[ 88 202 603 210 117],655,1,40193,4.5333859688698395,20.0,0.0
28866,2,8866,[318 427 496 357 257],716,5,40198,4.533438592534115,60.0,0.0
28867,2,8867,[  1 135  28 228 276],655,2,40200,4.533152909336942,0.0,0.0
28868,2,8868,[318 427 496 357 257],330,5,40205,4.533205547412335,60.0,0.0
28869,2,8869,[318 427 496 357 257],716,5,40210,4.533258173618941,60.0,0.0
28870,2,8870,[318 427 496 357 257],716,5,40215,4.5333107879607715,60.0,0.0
28871,2,8871,[318 427 496 357 257],716,5,40220,4.533363390441839,60.0,0.0
28872,2,8872,[318 427 496 357 257],796,5,40225,4.533415981066156,60.0,0.0
28873,2,8873,[ 71 301 423 288 200],593,5,40230,4.533468559837728,0.0,0.0
28874,2,8874,[318 427 496 357 257],796,5,40235,4.533521126760563,60.0,0.0
28875,2,8875,[ 79 265  88 597 546],256,5,40240,4.533573681838666,0.0,0.0
28876,2,8876,[318 427 496 357 257],796,5,40245,4.5336262250760395,60.0,0.0
28877,2,8877,[318 427 496 357 257],716,5,40250,4.533678756476684,60.0,0.0
28878,2,8878,[318 427 496 357 257],330,5,40255,4.5337312760446,60.0,0.0
28879,2,8879,[318 427 496 357 257],716,5,40260,4.533783783783784,60.0,0.0
28880,2,8880,[318 427 496 357 257],330,5,40265,4.5338362796982326,60.0,0.0
28881,2,8881,[318 427 496 357 257],330,5,40270,4.533888763791939,60.0,0.0
28882,2,8882,[144 187   9  22 515],296,5,40275,4.5339412360688955,0.0,0.0
28883,2,8883,[318 427 496 357 257],716,5,40280,4.533993696533093,60.0,0.0
28884,2,8884,[  9 174   8 185 269],655,1,40281,4.533595948227349,0.0,0.0
28885,2,8885,[318 427 496 357 257],330,5,40286,4.5336484357416165,60.0,0.0
28886,2,8886,[318 427 496 357 257],716,5,40291,4.533700911443682,60.0,0.0
28887,2,8887,[318 427 496 357 257],330,5,40296,4.533753375337533,60.0,0.0
28888,2,8888,[202 275 135 125  89],18,1,40297,4.533355833052087,0.0,20.0
28889,2,8889,[211 153   9 100 357],655,1,40298,4.532958380202475,0.0,20.0
28890,2,8890,[475 204 286 275 195],655,1,40299,4.53256101675852,0.0,40.0
28891,2,8891,[318 427 496 357 257],796,5,40304,4.532613585245164,60.0,0.0
28892,2,8892,[318 427 496 357 257],716,5,40309,4.532666141909367,60.0,0.0
28893,2,8893,[318 427 496 357 257],796,5,40314,4.532718686755116,60.0,0.0
28894,2,8894,[318 427 496 357 257],716,5,40319,4.5327712197863965,60.0,0.0
28895,2,8895,[318 427 496 357 257],716,5,40324,4.532823741007194,60.0,0.0
28896,2,8896,[318 427 496 357 257],330,5,40329,4.532876250421491,60.0,0.0
28897,2,8897,[318 427 496 357 257],796,5,40334,4.532928748033266,60.0,0.0
28898,2,8898,[318 427 496 357 257],796,5,40339,4.5329812338465,60.0,0.0
28899,2,8899,[  9  11 282 176 318],280,3,40342,4.532808988764045,20.0,0.0
28900,2,8900,[318 427 496 357 257],716,5,40347,4.532861476238625,60.0,0.0
28901,2,8901,[318 427 496 357 257],330,5,40352,4.532913951920917,60.0,0.0
28902,2,8902,[318 427 496 357 257],330,5,40357,4.532966415814894,60.0,0.0
28903,2,8903,[318 427 496 357 257],796,5,40362,4.533018867924528,60.0,0.0
28904,2,8904,[222 180 258 132 234],693,2,40364,4.532734418865806,0.0,0.0
28905,2,8905,[257  98  97 333 300],796,4,40368,4.53267460139232,0.0,0.0
28906,2,8906,[318 427 496 357 257],796,5,40373,4.532727068597732,60.0,0.0
28907,2,8907,[318 427 496 357 257],716,5,40378,4.53277952402335,60.0,0.0
28908,2,8908,[318 427 496 357 257],796,5,40383,4.53283196767314,60.0,0.0
28909,2,8909,[318 427 496 357 257],716,5,40388,4.532884399551066,60.0,0.0
28910,2,8910,[318 427 496 357 257],796,5,40393,4.532936819661093,60.0,0.0
28911,2,8911,[318 427 496 357 257],716,5,40398,4.532989228007182,60.0,0.0
28912,2,8912,[318 427 496 357 257],796,5,40403,4.533041624593291,60.0,0.0
28913,2,8913,[318 427 496 357 257],796,5,40408,4.533094009423379,60.0,0.0
28914,2,8914,[318 427 496 357 257],716,5,40413,4.5331463825014024,60.0,0.0
28915,2,8915,[318 427 496 357 257],716,5,40418,4.533198743831314,60.0,0.0
28916,2,8916,[597 202 173 216 258],344,3,40421,4.533026802736346,0.0,0.0
28917,2,8917,[318 427 496 357 257],796,5,40426,4.533079165732227,60.0,0.0
28918,2,8918,[318 427 496 357 257],330,5,40431,4.533131516986209,60.0,0.0
28919,2,8919,[210  12 197 204 151],796,3,40434,4.532959641255605,0.0,0.0
28920,2,8920,[318 427 496 357 257],716,5,40439,4.533011994171057,60.0,0.0
28921,2,8921,[318 427 496 357 257],716,5,40444,4.533064335350818,60.0,0.0
28922,2,8922,[322 179 282 125 194],450,5,40449,4.533116664798834,0.0,0.0
28923,2,8923,[318 427 496 357 257],796,5,40454,4.53316898251905,60.0,0.0
28924,2,8924,[ 69 288  56  11 655],629,4,40458,4.533109243697479,0.0,0.0
28925,2,8925,[603 117   9 300 228],796,4,40462,4.533049518261259,20.0,0.0
28926,2,8926,[318 427 496 357 257],716,5,40467,4.533101825921362,60.0,0.0
28927,2,8927,[318 427 496 357 257],330,5,40472,4.5331541218638,60.0,0.0
28928,2,8928,[318 427 496 357 257],330,5,40477,4.533206406092508,60.0,0.0
28929,2,8929,[318 427 496 357 257],330,5,40482,4.533258678611422,60.0,0.0
28930,2,8930,[161 135 471 483 127],807,4,40486,4.533198969880193,0.0,20.0
28931,2,8931,[318 427 496 357 257],330,5,40491,4.533251231527093,60.0,0.0
28932,2,8932,[597 385  97 275 568],593,3,40494,4.5330795925221095,0.0,20.0
28933,2,8933,[318 427 496 357 257],330,5,40499,4.5331318558316545,60.0,0.0
28934,2,8934,[318 427 496 357 257],330,5,40504,4.533184107442641,60.0,0.0
28935,2,8935,[318 427 496 357 257],330,5,40509,4.533236347358997,60.0,0.0
28936,2,8936,[385 111 125 235 161],401,1,40510,4.532840998097796,0.0,0.0
28937,2,8937,[318 427 496 357 257],716,5,40515,4.532893264712464,60.0,0.0
28938,2,8938,[151 288  79  22 273],450,3,40518,4.532721780959839,0.0,0.0
28939,2,8939,[496 216 143 515  25],18,4,40522,4.532662192393736,20.0,0.0
28940,2,8940,[318 427 496 357 257],716,5,40527,4.532714461469634,60.0,0.0
28941,2,8941,[318 427 496 357 257],330,5,40532,4.532766718854842,60.0,0.0
28942,2,8942,[318 427 496 357 257],716,5,40537,4.5328189645532815,60.0,0.0
28943,2,8943,[318 427 496 357 257],796,5,40542,4.5328711985688726,60.0,0.0
28944,2,8944,[318 427 496 357 257],796,5,40547,4.532923420905534,60.0,0.0
28945,2,8945,[318 427 496 357 257],796,5,40552,4.532975631567181,60.0,0.0
28946,2,8946,[ 56 496 200 435   8],18,4,40556,4.532916061249581,20.0,0.0
28947,2,8947,[318 427 496 357 257],796,5,40561,4.532968261063925,60.0,0.0
28948,2,8948,[318 427 496 357 257],796,5,40566,4.533020449212202,60.0,0.0
28949,2,8949,[318 427 496 357 257],796,5,40571,4.533072625698324,60.0,0.0
28950,2,8950,[318 427 496 357 257],796,5,40576,4.533124790526198,60.0,0.0
28951,2,8951,[237 286  12 132 515],18,4,40580,4.533065236818588,0.0,20.0
28952,2,8952,[318 427 496 357 257],330,5,40585,4.53311739081872,60.0,0.0
28953,2,8953,[318 427 496 357 257],330,5,40590,4.533169533169533,60.0,0.0
28954,2,8954,[318 427 496 357 257],330,5,40595,4.53322166387493,60.0,0.0
28955,2,8955,[143 179  69 111 132],457,4,40599,4.533162125949085,0.0,0.0
28956,2,8956,[318 427 496 357 257],796,5,40604,4.533214245841242,60.0,0.0
28957,2,8957,[318 427 496 357 257],330,5,40609,4.533266354096897,60.0,0.0
28958,2,8958,[318 427 496 357 257],796,5,40614,4.533318450719946,60.0,0.0
28959,2,8959,[151 179 211  15 475],389,4,40618,4.533258928571429,0.0,0.0
28960,2,8960,[318 427 496 357 257],796,5,40623,4.533311014395715,60.0,0.0
28961,2,8961,[215 228  88  22 143],457,5,40628,4.533363088596295,0.0,0.0
28962,2,8962,[127 515 234 211 174],18,4,40632,4.533303581390159,0.0,20.0
28963,2,8963,[318 427 496 357 257],716,5,40637,4.533355644801428,60.0,0.0
28964,2,8964,[318 427 496 357 257],796,5,40642,4.53340769659788,60.0,0.0
28965,2,8965,[  8 175 403 181  98],269,2,40644,4.53312513941557,0.0,0.0
28966,2,8966,[318 427 496 357 257],796,5,40649,4.533177205308353,60.0,0.0
28967,2,8967,[318 427 496 357 257],796,5,40654,4.533229259589652,60.0,0.0
28968,2,8968,[318 427 496 357 257],716,5,40659,4.533281302263352,60.0,0.0
28969,2,8969,[318 427 496 357 257],330,5,40664,4.533333333333333,60.0,0.0
28970,2,8970,[318 427 496 357 257],330,5,40669,4.533385352803478,60.0,0.0
28971,2,8971,[ 88 182 515 289 475],655,2,40671,4.533102987070887,0.0,0.0
28972,2,8972,[318 427 496 357 257],330,5,40676,4.533155020617408,60.0,0.0
28973,2,8973,[318 427 496 357 257],796,5,40681,4.533207042567417,60.0,0.0
28974,2,8974,[318 427 496 357 257],330,5,40686,4.533259052924791,60.0,0.0
28975,2,8975,[318 427 496 357 257],716,5,40691,4.5333110516934045,60.0,0.0
28976,2,8976,[318 427 496 357 257],796,5,40696,4.53336303887713,60.0,0.0
28977,2,8977,[318 427 496 357 257],796,5,40701,4.533415014479839,60.0,0.0
28978,2,8978,[318 427 496 357 257],330,5,40706,4.533466978505402,60.0,0.0
28979,2,8979,[318 427 496 357 257],796,5,40711,4.533518930957683,60.0,0.0
28980,2,8980,[318 427 496 357 257],796,5,40716,4.533570871840552,60.0,0.0
28981,2,8981,[318 427 496 357 257],716,5,40721,4.533622801157871,60.0,0.0
28982,2,8982,[318 427 496 357 257],330,5,40726,4.533674718913503,60.0,0.0
28983,2,8983,[318 427 496 357 257],796,5,40731,4.533726625111309,60.0,0.0
28984,2,8984,[318 427 496 357 257],796,5,40736,4.533778519755147,60.0,0.0
28985,2,8985,[318 427 496 357 257],796,5,40741,4.533830402848876,60.0,0.0
28986,2,8986,[318 427 496 357 257],330,5,40746,4.53388227439635,60.0,0.0
28987,2,8987,[318 427 496 357 257],796,5,40751,4.533934134401425,60.0,0.0
28988,2,8988,[318 427 496 357 257],796,5,40756,4.53398598286795,60.0,0.0
28989,2,8989,[318 427 496 357 257],716,5,40761,4.534037819799778,60.0,0.0
28990,2,8990,[318 427 496 357 257],330,5,40766,4.534089645200757,60.0,0.0
28991,2,8991,[318 427 496 357 257],330,5,40771,4.534141459074733,60.0,0.0
28992,2,8992,[318 427 496 357 257],716,5,40776,4.534193261425553,60.0,0.0
28993,2,8993,[318 427 496 357 257],716,5,40781,4.53424505225706,60.0,0.0
28994,2,8994,[318 427 496 357 257],796,5,40786,4.534296831573096,60.0,0.0
28995,2,8995,[143 215  98 161  96],796,5,40791,4.534348599377501,0.0,0.0
28996,2,8996,[174  50 132 204 143],436,2,40793,4.53406691119262,0.0,20.0
28997,2,8997,[318 427 496 357 257],716,5,40798,4.534118693042898,60.0,0.0
28998,2,8998,[  8 423 194 427 185],535,5,40803,4.534170463384821,20.0,0.0
28999,2,8999,[318 427 496 357 257],330,5,40808,4.534222222222223,60.0,0.0
29000,2,9000,[318 427 496 357 257],330,5,40813,4.534273969558938,60.0,0.0
29001,2,9001,[318 427 496 357 257],716,5,40818,4.534325705398801,60.0,0.0
29002,2,9002,[318 427 496 357 257],330,5,40823,4.53437742974564,60.0,0.0
29003,2,9003,[ 97  56 195  22  70],457,5,40828,4.534429142603288,0.0,0.0
29004,2,9004,[318 427 496 357 257],796,5,40833,4.534480843975569,60.0,0.0
29005,2,9005,[318 427 496 357 257],716,5,40838,4.534532533866312,60.0,0.0
29006,2,9006,[318 427 496 357 257],796,5,40843,4.534584212279339,60.0,0.0
29007,2,9007,[318 427 496 357 257],330,5,40848,4.534635879218473,60.0,0.0
29008,2,9008,[318 427 496 357 257],330,5,40853,4.534687534687535,60.0,0.0
29009,2,9009,[318 427 496 357 257],796,5,40858,4.534739178690344,60.0,0.0
29010,2,9010,[318 427 496 357 257],716,5,40863,4.534790811230718,60.0,0.0
29011,2,9011,[318 427 496 357 257],796,5,40868,4.534842432312472,60.0,0.0
29012,2,9012,[318 427 496 357 257],330,5,40873,4.534894041939421,60.0,0.0
29013,2,9013,[318 427 496 357 257],796,5,40878,4.534945640115376,60.0,0.0
29014,2,9014,[318 427 496 357 257],330,5,40883,4.5349972268441485,60.0,0.0
29015,2,9015,[187 135 286 328 176],450,4,40887,4.534937888198757,0.0,20.0
29016,2,9016,[153 197 597 210 168],269,2,40889,4.534656759454364,0.0,0.0
29017,2,9017,[318 427 496 357 257],716,5,40894,4.534708361055666,60.0,0.0
29018,2,9018,[318 427 496 357 257],796,5,40899,4.534759951214103,60.0,0.0
29019,2,9019,[318 427 496 357 257],330,5,40904,4.5348115299334815,60.0,0.0
29020,2,9020,[318 427 496 357 257],796,5,40909,4.534863097217603,60.0,0.0
29021,2,9021,[195   7 322 117 245],344,2,40911,4.534582132564841,0.0,0.0
29022,2,9022,[318 427 496 357 257],796,5,40916,4.534633713842402,60.0,0.0
29023,2,9023,[318 427 496 357 257],716,5,40921,4.534685283687943,60.0,0.0
29024,2,9024,[228 222 121 357 100],11,2,40923,4.534404432132964,0.0,20.0
29025,2,9025,[ 70 173 210 135 143],401,3,40926,4.534234433857744,0.0,0.0
29026,2,9026,[318 427 496 357 257],330,5,40931,4.534286030796499,60.0,0.0
29027,2,9027,[318 427 496 357 257],716,5,40936,4.534337616304829,60.0,0.0
29028,2,9028,[318 427 496 357 257],796,5,40941,4.534389190386532,60.0,0.0
29029,2,9029,[237 194 228 151  88],457,5,40946,4.534440753045404,0.0,0.0
29030,2,9030,[322 588 196 245 385],344,2,40948,4.5341601151588975,0.0,0.0
29031,2,9031,[318 427 496 357 257],796,5,40953,4.534211691762621,60.0,0.0
29032,2,9032,[318 427 496 357 257],716,5,40958,4.534263256946751,60.0,0.0
29033,2,9033,[318 427 496 357 257],796,5,40963,4.534314810715077,60.0,0.0
29034,2,9034,[318 427 496 357 257],796,5,40968,4.534366353071389,60.0,0.0
29035,2,9035,[318 427 496 357 257],716,5,40973,4.5344178840194775,60.0,0.0
29036,2,9036,[245 423 655 186 294],796,1,40974,4.534026778798274,0.0,0.0
29037,2,9037,[200 678 211 117 245],504,5,40979,4.534078335915026,0.0,0.0
29038,2,9038,[318 427 496 357 257],716,5,40984,4.534129881624073,60.0,0.0
29039,2,9039,[318 427 496 357 257],796,5,40989,4.534181415929203,60.0,0.0
29040,2,9040,[318 427 496 357 257],716,5,40994,4.5342329388342,60.0,0.0
29041,2,9041,[318 427 496 357 257],796,5,40999,4.534284450342844,60.0,0.0
29042,2,9042,[318 427 496 357 257],796,5,41004,4.534335950458918,60.0,0.0
29043,2,9043,[318 427 496 357 257],330,5,41009,4.534387439186201,60.0,0.0
29044,2,9044,[471 258 385   4 168],450,4,41013,4.534328358208955,0.0,0.0
29045,2,9045,[318 427 496 357 257],716,5,41018,4.534379836391776,60.0,0.0
29046,2,9046,[318 427 496 357 257],716,5,41023,4.534431303194429,60.0,0.0
29047,2,9047,[181  98 117 121 200],655,2,41025,4.534151193633952,0.0,0.0
29048,2,9048,[318 427 496 357 257],796,5,41030,4.534202674328655,60.0,0.0
29049,2,9049,[427   9  15  69  11],655,1,41031,4.5338121546961325,20.0,0.0
29050,2,9050,[318 427 496 357 257],796,5,41036,4.5338636614738705,60.0,0.0
29051,2,9051,[328 301 403  56 435],655,0,41036,4.533362792752983,0.0,0.0
29052,2,9052,[318 427 496 357 257],796,5,41041,4.533414337788578,60.0,0.0
29053,2,9053,[318 427 496 357 257],796,5,41046,4.533465871438039,60.0,0.0
29054,2,9054,[318 427 496 357 257],716,5,41051,4.533517393705135,60.0,0.0
29055,2,9055,[405 237 143 568  97],330,5,41056,4.53356890459364,0.0,0.0
29056,2,9056,[318 427 496 357 257],796,5,41061,4.53362040410732,60.0,0.0
29057,2,9057,[286 173 151 222 181],450,4,41065,4.533561492603224,0.0,20.0
29058,2,9058,[235 172 228  56 322],450,4,41069,4.533502594105309,0.0,0.0
29059,2,9059,[318 427 496 357 257],716,5,41074,4.5335540838852095,60.0,0.0
29060,2,9060,[318 427 496 357 257],716,5,41079,4.533605562299967,60.0,0.0
29061,2,9061,[318 427 496 357 257],716,5,41084,4.533657029353344,60.0,0.0
29062,2,9062,[318 427 496 357 257],716,5,41089,4.533708485049101,60.0,0.0
29063,2,9063,[318 427 496 357 257],330,5,41094,4.533759929390997,60.0,0.0
29064,2,9064,[161 403 742   4  64],457,5,41099,4.533811362382791,20.0,0.0
29065,2,9065,[318 427 496 357 257],330,5,41104,4.533862784028237,60.0,0.0
29066,2,9066,[318 427 496 357 257],796,5,41109,4.533914194331091,60.0,0.0
29067,2,9067,[318 427 496 357 257],716,5,41114,4.533965593295104,60.0,0.0
29068,2,9068,[318 427 496 357 257],796,5,41119,4.534016980924027,60.0,0.0
29069,2,9069,[ 25 403 211 180 143],693,2,41121,4.533737596471886,0.0,0.0
29070,2,9070,[603 210  56  50  89],18,3,41124,4.533568515047955,20.0,20.0
29071,2,9071,[132 546 322 144 183],796,4,41128,4.533509700176367,0.0,0.0
29072,2,9072,[318 427 496 357 257],796,5,41133,4.533561115397332,60.0,0.0
29073,2,9073,[318 427 496 357 257],330,5,41138,4.533612519285872,60.0,0.0
29074,2,9074,[318 427 496 357 257],330,5,41143,4.53366391184573,60.0,0.0
29075,2,9075,[ 96 176 118 202  97],716,2,41145,4.533384750991626,0.0,0.0
29076,2,9076,[318 427 496 357 257],330,5,41150,4.5334361573207005,60.0,0.0
29077,2,9077,[318 427 496 357 257],796,5,41155,4.5334875523243,60.0,0.0
29078,2,9078,[318 427 496 357 257],716,5,41160,4.533538936006168,60.0,0.0
29079,2,9079,[318 427 496 357 257],330,5,41165,4.533590308370044,60.0,0.0
29080,2,9080,[111 143  98 117 186],577,4,41169,4.533531549388834,0.0,0.0
29081,2,9081,[195 423 300  28 588],450,5,41174,4.533582911253028,0.0,0.0
29082,2,9082,[318 427 496 357 257],330,5,41179,4.533634261807773,60.0,0.0
29083,2,9083,[318 427 496 357 257],716,5,41184,4.533685601056803,60.0,0.0
29084,2,9084,[318 427 496 357 257],716,5,41189,4.533736929003853,60.0,0.0
29085,2,9085,[318 427 496 357 257],796,5,41194,4.533788245652652,60.0,0.0
29086,2,9086,[ 89 235 483 289   1],807,4,41198,4.533729503686585,0.0,0.0
29087,2,9087,[318 427 496 357 257],330,5,41203,4.533780809859155,60.0,0.0
29088,2,9088,[ 50  56 546  79 195],693,3,41206,4.533612058532292,0.0,20.0
29089,2,9089,[318 427 496 357 257],796,5,41211,4.533663366336634,60.0,0.0
29090,2,9090,[568 234  88 515 187],655,2,41213,4.533384666153339,0.0,0.0
29091,2,9091,[318 427 496 357 257],330,5,41218,4.533435987681478,60.0,0.0
29092,2,9092,[405 318 234  98  28],655,2,41220,4.533157373804025,20.0,0.0
29093,2,9093,[318 427 496 357 257],716,5,41225,4.533208709038926,60.0,0.0
29094,2,9094,[318 427 496 357 257],330,5,41230,4.533260032985157,60.0,0.0
29095,2,9095,[318 427 496 357 257],330,5,41235,4.533311345646438,60.0,0.0
29096,2,9096,[318 427 496 357 257],330,5,41240,4.533362647026492,60.0,0.0
29097,2,9097,[318 427 496 357 257],716,5,41245,4.53341393712904,60.0,0.0
29098,2,9098,[318 427 496 357 257],716,5,41250,4.533465215957798,60.0,0.0
29099,2,9099,[318 427 496 357 257],716,5,41255,4.533516483516483,60.0,0.0
29100,2,9100,[318 427 496 357 257],716,5,41260,4.533567739808812,60.0,0.0
29101,2,9101,[318 427 496 357 257],716,5,41265,4.533618984838497,60.0,0.0
29102,2,9102,[ 96 182 483   7  12],457,5,41270,4.53367021860925,0.0,0.0
29103,2,9103,[318 427 496 357 257],330,5,41275,4.53372144112478,60.0,0.0
29104,2,9104,[161   9 237 176 286],786,5,41280,4.533772652388797,0.0,20.0
29105,2,9105,[318 427 496 357 257],330,5,41285,4.533823852405008,60.0,0.0
29106,2,9106,[144  69  64 515 294],716,4,41289,4.533765235533107,20.0,0.0
29107,2,9107,[318 427 496 357 257],330,5,41294,4.533816425120773,60.0,0.0
29108,2,9108,[ 69 202  70  98 185],65,3,41297,4.533648040399605,0.0,0.0
29109,2,9109,[318 427 496 357 257],796,5,41302,4.533699231613611,60.0,0.0
29110,2,9110,[318 427 496 357 257],330,5,41307,4.533750411590385,60.0,0.0
29111,2,9111,[318 427 496 357 257],796,5,41312,4.533801580333626,60.0,0.0
29112,2,9112,[301 435 300 597 186],450,4,41316,4.533743004499067,0.0,0.0
29113,2,9113,[318 427 496 357 257],796,5,41321,4.533794162826421,60.0,0.0
29114,2,9114,[318 427 496 357 257],330,5,41326,4.533845309928689,60.0,0.0
29115,2,9115,[318 427 496 357 257],330,5,41331,4.533896445809566,60.0,0.0
29116,2,9116,[318 427 496 357 257],716,5,41336,4.533947570472743,60.0,0.0
29117,2,9117,[318 427 496 357 257],716,5,41341,4.533998683921912,60.0,0.0
29118,2,9118,[318 427 496 357 257],796,5,41346,4.534049786160764,60.0,0.0
29119,2,9119,[  1 568 328 117 111],796,4,41350,4.5339912280701755,0.0,0.0
29120,2,9120,[318 427 496 357 257],716,5,41355,4.5340423199210615,60.0,0.0
29121,2,9121,[333 471 181 275  25],938,4,41359,4.533983775487831,0.0,20.0
29122,2,9122,[318 427 496 357 257],330,5,41364,4.534034856954949,60.0,0.0
29123,2,9123,[202  95 268  64 546],344,3,41367,4.5338667251205615,20.0,0.0
29124,2,9124,[318 427 496 357 257],330,5,41372,4.5339178082191784,60.0,0.0
29125,2,9125,[318 427 496 357 257],716,5,41377,4.5339688801227265,60.0,0.0
29126,2,9126,[655 286 323 385 403],280,2,41379,4.533691245754355,0.0,20.0
29127,2,9127,[300 269 168 273  79],796,3,41382,4.533523225241017,0.0,0.0
29128,2,9128,[318 427 496 357 257],716,5,41387,4.533574323584182,60.0,0.0
29129,2,9129,[318 427 496 357 257],796,5,41392,4.533625410733844,60.0,0.0
29130,2,9130,[318 427 496 357 257],716,5,41397,4.533676486693681,60.0,0.0
29131,2,9131,[318 427 496 357 257],330,5,41402,4.533727551467368,60.0,0.0
29132,2,9132,[318 427 496 357 257],330,5,41407,4.533778605058579,60.0,0.0
29133,2,9133,[603 100 234 318 211],269,4,41411,4.533720166411211,40.0,20.0
29134,2,9134,[318 427 496 357 257],716,5,41416,4.5337712096332785,60.0,0.0
29135,2,9135,[ 95 215 258 405   7],344,2,41418,4.533493870402802,0.0,0.0
29136,2,9136,[318 427 496 357 257],796,5,41423,4.533544927218999,60.0,0.0
29137,2,9137,[318 427 496 357 257],796,5,41428,4.533595972860582,60.0,0.0
29138,2,9138,[318 427 496 357 257],716,5,41433,4.533647007331218,60.0,0.0
29139,2,9139,[318 427 496 357 257],796,5,41438,4.533698030634573,60.0,0.0
29140,2,9140,[318 427 496 357 257],330,5,41443,4.533749042774313,60.0,0.0
29141,2,9141,[318 427 496 357 257],330,5,41448,4.533800043754102,60.0,0.0
29142,2,9142,[318 427 496 357 257],716,5,41453,4.5338510335776006,60.0,0.0
29143,2,9143,[318 427 496 357 257],796,5,41458,4.533902012248469,60.0,0.0
29144,2,9144,[318 427 496 357 257],716,5,41463,4.533952979770366,60.0,0.0
29145,2,9145,[144 204 117 435 313],655,1,41464,4.533566586485896,0.0,0.0
29146,2,9146,[318 427 496 357 257],716,5,41469,4.5336175795342735,60.0,0.0
29147,2,9147,[318 427 496 357 257],330,5,41474,4.533668561434193,60.0,0.0
29148,2,9148,[318 427 496 357 257],716,5,41479,4.53371953218931,60.0,0.0
29149,2,9149,[318 427 496 357 257],796,5,41484,4.533770491803279,60.0,0.0
29150,2,9150,[318 427 496 357 257],330,5,41489,4.533821440279751,60.0,0.0
29151,2,9151,[318 427 496 357 257],716,5,41494,4.5338723776223775,60.0,0.0
29152,2,9152,[318 427 496 357 257],330,5,41499,4.533923303834809,60.0,0.0
29153,2,9153,[318 427 496 357 257],716,5,41504,4.53397421892069,60.0,0.0
29154,2,9154,[111 204 475 403 318],655,1,41505,4.5335882031676675,20.0,0.0
29155,2,9155,[318 427 496 357 257],330,5,41510,4.533639143730887,60.0,0.0
29156,2,9156,[318 427 496 357 257],796,5,41515,4.533690073168068,60.0,0.0
29157,2,9157,[318 427 496 357 257],716,5,41520,4.533740991482857,60.0,0.0
29158,2,9158,[318 427 496 357 257],330,5,41525,4.533791898678895,60.0,0.0
29159,2,9159,[318 427 496 357 257],796,5,41530,4.533842794759825,60.0,0.0
29160,2,9160,[215 172 180 200  88],716,4,41534,4.533784521340465,0.0,0.0
29161,2,9161,[ 79  98 172  89 222],256,4,41538,4.533726260641782,0.0,0.0
29162,2,9162,[318 427 496 357 257],330,5,41543,4.5337771472225254,60.0,0.0
29163,2,9163,[318 427 496 357 257],716,5,41548,4.533828022697512,60.0,0.0
29164,2,9164,[318 427 496 357 257],796,5,41553,4.533878887070377,60.0,0.0
29165,2,9165,[215 144 483 151 195],796,5,41558,4.533929740344752,0.0,0.0
29166,2,9166,[318 427 496 357 257],796,5,41563,4.533980582524272,60.0,0.0
29167,2,9167,[318 427 496 357 257],330,5,41568,4.534031413612565,60.0,0.0
29168,2,9168,[318 427 496 357 257],796,5,41573,4.534082233613262,60.0,0.0
29169,2,9169,[568 202 182 282 546],256,3,41576,4.53391494002181,0.0,0.0
29170,2,9170,[318 427 496 357 257],796,5,41581,4.533965761639952,60.0,0.0
29171,2,9171,[318 427 496 357 257],716,5,41586,4.5340165721761885,60.0,0.0
29172,2,9172,[318 427 496 357 257],330,5,41591,4.534067371634143,60.0,0.0
29173,2,9173,[318 427 496 357 257],796,5,41596,4.5341181600174405,60.0,0.0
29174,2,9174,[546 322 603 275 168],450,5,41601,4.5341689373297,20.0,20.0
29175,2,9175,[318 427 496 357 257],796,5,41606,4.534219703574542,60.0,0.0
29176,2,9176,[318 427 496 357 257],796,5,41611,4.534270458755585,60.0,0.0
29177,2,9177,[318 427 496 357 257],330,5,41616,4.534321202876444,60.0,0.0
29178,2,9178,[313 216 238 174 127],796,4,41620,4.534262991611286,0.0,20.0
29179,2,9179,[318 427 496 357 257],796,5,41625,4.534313725490196,60.0,0.0
29180,2,9180,[318 427 496 357 257],796,5,41630,4.534364448317177,60.0,0.0
29181,2,9181,[318 427 496 357 257],330,5,41635,4.53441516009584,60.0,0.0
29182,2,9182,[ 79 237 204  70 427],503,4,41639,4.534356963955134,20.0,0.0
29183,2,9183,[127 237  69  70  71],18,3,41642,4.534189895470384,0.0,20.0
29184,2,9184,[318 427 496 357 257],716,5,41647,4.534240609689712,60.0,0.0
29185,2,9185,[318 427 496 357 257],716,5,41652,4.534291312867407,60.0,0.0
29186,2,9186,[318 427 496 357 257],796,5,41657,4.534342005007075,60.0,0.0
29187,2,9187,[318 427 496 357 257],796,5,41662,4.53439268611232,60.0,0.0
29188,2,9188,[318 427 496 357 257],716,5,41667,4.534443356186745,60.0,0.0
29189,2,9189,[318 427 496 357 257],796,5,41672,4.53449401523395,60.0,0.0
29190,2,9190,[318 427 496 357 257],716,5,41677,4.534544663257535,60.0,0.0
29191,2,9191,[318 427 496 357 257],330,5,41682,4.534595300261096,60.0,0.0
29192,2,9192,[318 427 496 357 257],796,5,41687,4.534645926248232,60.0,0.0
29193,2,9193,[318 427 496 357 257],716,5,41692,4.534696541222536,60.0,0.0
29194,2,9194,[318 427 496 357 257],796,5,41697,4.534747145187602,60.0,0.0
29195,2,9195,[237 475 180 173 427],269,2,41699,4.534471509351892,20.0,0.0
29196,2,9196,[318 427 496 357 257],796,5,41704,4.534522126780472,60.0,0.0
29197,2,9197,[318 427 496 357 257],716,5,41709,4.53457273320287,60.0,0.0
29198,2,9198,[318 427 496 357 257],330,5,41714,4.5346233286226765,60.0,0.0
29199,2,9199,[175 273 385 191   1],655,2,41716,4.5343478260869565,0.0,0.0
29200,2,9200,[180 546 265 288 132],457,4,41720,4.5342897511140094,0.0,0.0
29201,2,9201,[318 427 496 357 257],716,5,41725,4.534340360791132,60.0,0.0
29202,2,9202,[318 427 496 357 257],716,5,41730,4.5343909594697385,60.0,0.0
29203,2,9203,[318 427 496 357 257],330,5,41735,4.534441547153412,60.0,0.0
29204,2,9204,[318 427 496 357 257],330,5,41740,4.534492123845736,60.0,0.0
29205,2,9205,[172 222 211 588 286],786,5,41745,4.534542689550293,0.0,20.0
29206,2,9206,[318 427 496 357 257],716,5,41750,4.534593244270663,60.0,0.0
29207,2,9207,[318 427 496 357 257],716,5,41755,4.534643788010426,60.0,0.0
29208,2,9208,[318 427 496 357 257],796,5,41760,4.5346943207731565,60.0,0.0
29209,2,9209,[318 427 496 357 257],796,5,41765,4.534744842562432,60.0,0.0
29210,2,9210,[318 427 496 357 257],330,5,41770,4.534795353381826,60.0,0.0
29211,2,9211,[318 427 496 357 257],330,5,41775,4.534845853234911,60.0,0.0
29212,2,9212,[ 82 172 269 181 385],796,3,41778,4.534679257570824,0.0,0.0
29213,2,9213,[318 427 496 357 257],796,5,41783,4.534729759062296,60.0,0.0
29214,2,9214,[318 427 496 357 257],796,5,41788,4.534780249593055,60.0,0.0
29215,2,9215,[318 427 496 357 257],796,5,41793,4.534830729166667,60.0,0.0
29216,2,9216,[318 427 496 357 257],330,5,41798,4.5348811977866985,60.0,0.0
29217,2,9217,[318 427 496 357 257],796,5,41803,4.534931655456715,60.0,0.0
29218,2,9218,[318 427 496 357 257],330,5,41808,4.53498210218028,60.0,0.0
29219,2,9219,[318 427 496 357 257],330,5,41813,4.535032537960954,60.0,0.0
29220,2,9220,[318 427 496 357 257],796,5,41818,4.535082962802299,60.0,0.0
29221,2,9221,[318 427 496 357 257],796,5,41823,4.535133376707872,60.0,0.0
29222,2,9222,[318 427 496 357 257],330,5,41828,4.5351837796812315,60.0,0.0
29223,2,9223,[318 427 496 357 257],330,5,41833,4.535234171725932,60.0,0.0
29224,2,9224,[318 427 496 357 257],330,5,41838,4.535284552845528,60.0,0.0
29225,2,9225,[ 64 288 276  50  12],344,5,41843,4.535334923043573,20.0,20.0
29226,2,9226,[318 427 496 357 257],716,5,41848,4.535385282323616,60.0,0.0
29227,2,9227,[318 427 496 357 257],796,5,41853,4.535435630689207,60.0,0.0
29228,2,9228,[318 427 496 357 257],716,5,41858,4.535485968143894,60.0,0.0
29229,2,9229,[318 427 496 357 257],796,5,41863,4.535536294691224,60.0,0.0
29230,2,9230,[318 427 496 357 257],716,5,41868,4.535586610334741,60.0,0.0
29231,2,9231,[318 427 496 357 257],330,5,41873,4.53563691507799,60.0,0.0
29232,2,9232,[318 427 496 357 257],330,5,41878,4.53568720892451,60.0,0.0
29233,2,9233,[318 427 496 357 257],716,5,41883,4.535737491877843,60.0,0.0
29234,2,9234,[318 427 496 357 257],716,5,41888,4.535787763941527,60.0,0.0
29235,2,9235,[318 427 496 357 257],330,5,41893,4.535838025119099,60.0,0.0
29236,2,9236,[318 427 496 357 257],330,5,41898,4.535888275414096,60.0,0.0
29237,2,9237,[200 174 265 197 187],655,2,41900,4.535613769214115,0.0,0.0
29238,2,9238,[181 515 194 179 483],535,4,41904,4.535555796081827,0.0,0.0
29239,2,9239,[318 427 496 357 257],716,5,41909,4.53560606060606,60.0,0.0
29240,2,9240,[200 125 237 111  56],655,1,41910,4.53522346066443,0.0,0.0
29241,2,9241,[318 427 496 357 257],716,5,41915,4.5352737502705045,60.0,0.0
29242,2,9242,[318 427 496 357 257],796,5,41920,4.535324028994915,60.0,0.0
29243,2,9243,[357 121  70  88 204],450,4,41924,4.535266118563393,0.0,0.0
29244,2,9244,[318 427 496 357 257],716,5,41929,4.535316387236344,60.0,0.0
29245,2,9245,[318 427 496 357 257],716,5,41934,4.535366645035691,60.0,0.0
29246,2,9246,[318 427 496 357 257],330,5,41939,4.535416891964962,60.0,0.0
29247,2,9247,[318 427 496 357 257],796,5,41944,4.5354671280276815,60.0,0.0
29248,2,9248,[318 427 496 357 257],716,5,41949,4.535517353227376,60.0,0.0
29249,2,9249,[161 168 144 234 258],457,5,41954,4.5355675675675675,0.0,0.0
29250,2,9250,[318 427 496 357 257],330,5,41959,4.535617771051778,60.0,0.0
29251,2,9251,[318 427 496 357 257],716,5,41964,4.535667963683528,60.0,0.0
29252,2,9252,[318 427 496 357 257],716,5,41969,4.535718145466335,60.0,0.0
29253,2,9253,[318 427 496 357 257],716,5,41974,4.5357683164037175,60.0,0.0
29254,2,9254,[318 427 496 357 257],330,5,41979,4.535818476499189,60.0,0.0
29255,2,9255,[ 64  95 423 168 187],796,5,41984,4.535868625756266,20.0,0.0
29256,2,9256,[318 427 496 357 257],716,5,41989,4.53591876417846,60.0,0.0
29257,2,9257,[194  15  79 483 111],389,3,41992,4.535752862389285,0.0,0.0
29258,2,9258,[268 151 172  12 196],344,4,41996,4.5356949994599844,0.0,0.0
29259,2,9259,[318 427 496 357 257],796,5,42001,4.5357451403887685,60.0,0.0
29260,2,9260,[318 427 496 357 257],716,5,42006,4.535795270489148,60.0,0.0
29261,2,9261,[ 70 483 318 357  15],655,3,42009,4.53562945368171,20.0,0.0
29262,2,9262,[318 427 496 357 257],796,5,42014,4.535679585447479,60.0,0.0
29263,2,9263,[228 322  89  56 127],450,5,42019,4.535729706390328,0.0,20.0
29264,2,9264,[318 427 496 357 257],716,5,42024,4.535779816513761,60.0,0.0
29265,2,9265,[471 168 300 258 302],535,3,42027,4.535614072954889,0.0,0.0
29266,2,9266,[318 427 496 357 257],716,5,42032,4.535664184741556,60.0,0.0
29267,2,9267,[182 174 185 181 191],269,3,42035,4.535498489425982,0.0,0.0
29268,2,9268,[318 427 496 357 257],716,5,42040,4.535548602869781,60.0,0.0
29269,2,9269,[318 427 496 357 257],716,5,42045,4.535598705501618,60.0,0.0
29270,2,9270,[318 427 496 357 257],330,5,42050,4.535648797324992,60.0,0.0
29271,2,9271,[318 427 496 357 257],716,5,42055,4.5356988783434,60.0,0.0
29272,2,9272,[258 174 185 118 180],693,3,42058,4.535533268629354,0.0,0.0
29273,2,9273,[318 427 496 357 257],716,5,42063,4.535583351304723,60.0,0.0
29274,2,9274,[318 427 496 357 257],330,5,42068,4.535633423180593,60.0,0.0
29275,2,9275,[318 427 496 357 257],716,5,42073,4.535683484260457,60.0,0.0
29276,2,9276,[318 427 496 357 257],330,5,42078,4.5357335345478065,60.0,0.0
29277,2,9277,[318 427 496 357 257],716,5,42083,4.535783574046131,60.0,0.0
29278,2,9278,[318 427 496 357 257],716,5,42088,4.535833602758918,60.0,0.0
29279,2,9279,[ 88 427 216  96 111],796,5,42093,4.535883620689655,20.0,0.0
29280,2,9280,[318 427 496 357 257],716,5,42098,4.535933627841827,60.0,0.0
29281,2,9281,[111 568 427 405  89],655,2,42100,4.535660418013359,20.0,0.0
29282,2,9282,[318 427 496 357 257],716,5,42105,4.53571043843585,60.0,0.0
29283,2,9283,[318 427 496 357 257],796,5,42110,4.535760448082723,60.0,0.0
29284,2,9284,[318 427 496 357 257],716,5,42115,4.535810446957458,60.0,0.0
29285,2,9285,[318 427 496 357 257],330,5,42120,4.535860435063537,60.0,0.0
29286,2,9286,[318 427 496 357 257],716,5,42125,4.535910412404436,60.0,0.0
29287,2,9287,[275 117 286 294 423],236,2,42127,4.535637381567614,0.0,40.0
29288,2,9288,[318 427 496 357 257],716,5,42132,4.53568737216062,60.0,0.0
29289,2,9289,[ 56  98 181 228 288],693,2,42134,4.5354144241119485,0.0,0.0
29290,2,9290,[318 427 496 357 257],796,5,42139,4.535464427941018,60.0,0.0
29291,2,9291,[318 427 496 357 257],330,5,42144,4.535514421007318,60.0,0.0
29292,2,9292,[168  70 301  79 181],535,4,42148,4.535456795437426,0.0,0.0
29293,2,9293,[318 427 496 357 257],716,5,42153,4.535506778566817,60.0,0.0
29294,2,9294,[318 427 496 357 257],796,5,42158,4.535556750941367,60.0,0.0
29295,2,9295,[318 427 496 357 257],716,5,42163,4.535606712564544,60.0,0.0
29296,2,9296,[318 427 496 357 257],796,5,42168,4.535656663439819,60.0,0.0
29297,2,9297,[318 427 496 357 257],330,5,42173,4.53570660357066,60.0,0.0
29298,2,9298,[318 427 496 357 257],330,5,42178,4.535756532960534,60.0,0.0
29299,2,9299,[318 427 496 357 257],330,5,42183,4.5358064516129035,60.0,0.0
29300,2,9300,[318 427 496 357 257],716,5,42188,4.535856359531233,60.0,0.0
29301,2,9301,[282 172 210 405  82],256,3,42191,4.535691249193722,0.0,0.0
29302,2,9302,[ 64 135  98 286   9],151,5,42196,4.5357411587659895,20.0,20.0
29303,2,9303,[318 427 496 357 257],796,5,42201,4.5357910576096305,60.0,0.0
29304,2,9304,[318 427 496 357 257],796,5,42206,4.535840945728103,60.0,0.0
29305,2,9305,[318 427 496 357 257],330,5,42211,4.535890823124865,60.0,0.0
29306,2,9306,[ 64  71 588 357   9],796,4,42215,4.535833243794993,20.0,0.0
29307,2,9307,[318 427 496 357 257],716,5,42220,4.535883111302105,60.0,0.0
29308,2,9308,[318 427 496 357 257],330,5,42225,4.535932968095391,60.0,0.0
29309,2,9309,[318 427 496 357 257],330,5,42230,4.535982814178303,60.0,0.0
29310,2,9310,[318 427 496 357 257],330,5,42235,4.536032649554291,60.0,0.0
29311,2,9311,[322 144   1 181 153],280,3,42238,4.535867697594502,0.0,0.0
29312,2,9312,[318 427 496 357 257],716,5,42243,4.5359175346290135,60.0,0.0
29313,2,9313,[318 427 496 357 257],716,5,42248,4.535967360961993,60.0,0.0
29314,2,9314,[318 427 496 357 257],716,5,42253,4.536017176596887,60.0,0.0
29315,2,9315,[ 95 181 234 211 496],796,3,42256,4.5358522971232285,20.0,0.0
29316,2,9316,[318 427 496 357 257],330,5,42261,4.535902114414511,60.0,0.0
29317,2,9317,[174 427 191 423  56],151,4,42265,4.53584460184589,20.0,0.0
29318,2,9318,[302 403 405  15 176],450,4,42269,4.535787101620346,0.0,0.0
29319,2,9319,[194 385  95 121 245],450,3,42272,4.535622317596567,0.0,0.0
29320,2,9320,[318 427 496 357 257],796,5,42277,4.535672138182599,60.0,0.0
29321,2,9321,[318 427 496 357 257],330,5,42282,4.535721948079811,60.0,0.0
29322,2,9322,[318 427 496 357 257],330,5,42287,4.535771747291644,60.0,0.0
29323,2,9323,[318 427 496 357 257],716,5,42292,4.535821535821536,60.0,0.0
29324,2,9324,[322  71 111  82 228],796,3,42295,4.535656836461126,0.0,0.0
29325,2,9325,[318 427 496 357 257],716,5,42300,4.535706626635213,60.0,0.0
29326,2,9326,[318 427 496 357 257],330,5,42305,4.535756406132733,60.0,0.0
29327,2,9327,[318 427 496 357 257],716,5,42310,4.535806174957118,60.0,0.0
29328,2,9328,[318 427 496 357 257],796,5,42315,4.535855933111802,60.0,0.0
29329,2,9329,[318 427 496 357 257],796,5,42320,4.535905680600214,60.0,0.0
29330,2,9330,[318 427 496 357 257],330,5,42325,4.535955417425785,60.0,0.0
29331,2,9331,[237 216   7 215  71],719,2,42327,4.535683669095585,0.0,0.0
29332,2,9332,[318 427 496 357 257],796,5,42332,4.53573341905068,60.0,0.0
29333,2,9333,[318 427 496 357 257],796,5,42337,4.535783158345833,60.0,0.0
29334,2,9334,[202 121 286 385  28],151,4,42341,4.535725763256561,0.0,20.0
29335,2,9335,[655 191 200 197 143],450,4,42345,4.535668380462725,0.0,0.0
29336,2,9336,[318 427 496 357 257],716,5,42350,4.535718110742208,60.0,0.0
29337,2,9337,[191 222 483 172 176],151,3,42353,4.5355536517455555,0.0,0.0
29338,2,9338,[238  98 195 273 144],655,2,42355,4.535282150123139,0.0,0.0
29339,2,9339,[318 427 496 357 257],716,5,42360,4.535331905781584,60.0,0.0
29340,2,9340,[318 427 496 357 257],796,5,42365,4.535381650786854,60.0,0.0
29341,2,9341,[318 427 496 357 257],796,5,42370,4.535431385142368,60.0,0.0
29342,2,9342,[318 427 496 357 257],796,5,42375,4.535481108851546,60.0,0.0
29343,2,9343,[318 427 496 357 257],330,5,42380,4.535530821917808,60.0,0.0
29344,2,9344,[318 427 496 357 257],716,5,42385,4.535580524344569,60.0,0.0
29345,2,9345,[318 427 496 357 257],796,5,42390,4.535630216135245,60.0,0.0
29346,2,9346,[655 294 183  98 121],457,4,42394,4.5355729110944685,0.0,0.0
29347,2,9347,[318 427 496 357 257],330,5,42399,4.535622593068036,60.0,0.0
29348,2,9348,[318 427 496 357 257],330,5,42404,4.535672264413306,60.0,0.0
29349,2,9349,[282 168 237 234  25],450,3,42407,4.535508021390374,0.0,0.0
29350,2,9350,[318 427 496 357 257],330,5,42412,4.535557694364239,60.0,0.0
29351,2,9351,[  8  70 211 179 168],18,4,42416,4.535500427715997,0.0,0.0
29352,2,9352,[318 427 496 357 257],330,5,42421,4.535550090879932,60.0,0.0
29353,2,9353,[603 222 210  96 588],796,4,42425,4.53549283728886,20.0,0.0
29354,2,9354,[300 179 118 144   7],450,4,42429,4.535435595938001,0.0,0.0
29355,2,9355,[318 427 496 357 257],796,5,42434,4.535485250106883,60.0,0.0
29356,2,9356,[318 427 496 357 257],330,5,42439,4.535534893662499,60.0,0.0
29357,2,9357,[318 427 496 357 257],716,5,42444,4.5355845266082495,60.0,0.0
29358,2,9358,[265 210  50 200   7],280,3,42447,4.535420450902874,0.0,20.0
29359,2,9359,[318 427 496 357 257],330,5,42452,4.535470085470085,60.0,0.0
29360,2,9360,[318 427 496 357 257],796,5,42457,4.535519709432753,60.0,0.0
29361,2,9361,[322 546  69 111 357],344,2,42459,4.535248878444777,0.0,0.0
29362,2,9362,[ 64 258 322 748 182],450,5,42464,4.535298515433087,20.0,0.0
29363,2,9363,[318 427 496 357 257],796,5,42469,4.5353481418197354,60.0,0.0
29364,2,9364,[318 427 496 357 257],716,5,42474,4.5353977576081155,60.0,0.0
29365,2,9365,[111 135 435 200 187],450,3,42477,4.535233824471493,0.0,0.0
29366,2,9366,[ 89 235 179  25 405],450,3,42480,4.535069926337141,0.0,0.0
29367,2,9367,[318 427 496 357 257],330,5,42485,4.535119555935098,60.0,0.0
29368,2,9368,[ 56  69 194  82 202],450,4,42489,4.5350624399615755,0.0,0.0
29369,2,9369,[318  56 121  28  69],72,4,42493,4.535005336179296,20.0,0.0
29370,2,9370,[318 427 496 357 257],716,5,42498,4.53505495678156,60.0,0.0
29371,2,9371,[318 427 496 357 257],716,5,42503,4.535104566794708,60.0,0.0
29372,2,9372,[202  98 172  82 655],878,3,42506,4.5349407873679715,0.0,0.0
29373,2,9373,[318 427 496 357 257],716,5,42511,4.534990398975891,60.0,0.0
29374,2,9374,[318 427 496 357 257],796,5,42516,4.53504,60.0,0.0
29375,2,9375,[318 427 496 357 257],796,5,42521,4.535089590443686,60.0,0.0
29376,2,9376,[318 427 496 357 257],716,5,42526,4.535139170310334,60.0,0.0
29377,2,9377,[318 427 496 357 257],330,5,42531,4.535188739603327,60.0,0.0
29378,2,9378,[318 427 496 357 257],330,5,42536,4.535238298326048,60.0,0.0
29379,2,9379,[318 427 496 357 257],716,5,42541,4.535287846481876,60.0,0.0
29380,2,9380,[318 427 496 357 257],716,5,42546,4.535337384074192,60.0,0.0
29381,2,9381,[301 269  89 186 132],796,2,42548,4.535067149861437,0.0,0.0
29382,2,9382,[318 427 496 357 257],716,5,42553,4.535116700415645,60.0,0.0
29383,2,9383,[318 427 496 357 257],796,5,42558,4.5351662404092075,60.0,0.0
29384,2,9384,[181 597 186  11 235],269,0,42558,4.534683004794886,0.0,0.0
29385,2,9385,[197 228 546 186 238],716,3,42561,4.534519497123375,0.0,0.0
29386,2,9386,[318 427 496 357 257],796,5,42566,4.534569084904655,60.0,0.0
29387,2,9387,[318 427 496 357 257],716,5,42571,4.534618662121858,60.0,0.0
29388,2,9388,[318 427 496 357 257],330,5,42576,4.534668228778358,60.0,0.0
29389,2,9389,[318 427 496 357 257],796,5,42581,4.534717784877529,60.0,0.0
29390,2,9390,[237 742 202  12  95],280,3,42584,4.534554360557981,0.0,0.0
29391,2,9391,[318 427 496 357 257],796,5,42589,4.53460391822828,60.0,0.0
29392,2,9392,[204 313 180 100  70],450,5,42594,4.534653465346534,0.0,20.0
29393,2,9393,[222 471 186 423 211],786,5,42599,4.5347030019161165,0.0,0.0
29394,2,9394,[588  98 234 546 118],457,4,42603,4.534646088344864,0.0,0.0
29395,2,9395,[318 427 496 357 257],796,5,42608,4.534695615155385,60.0,0.0
29396,2,9396,[318 427 496 357 257],330,5,42613,4.5347451314249225,60.0,0.0
29397,2,9397,[318 427 496 357 257],330,5,42618,4.534794637156842,60.0,0.0
29398,2,9398,[318 427 496 357 257],330,5,42623,4.534844132354506,60.0,0.0
29399,2,9399,[318 427 496 357 257],716,5,42628,4.534893617021277,60.0,0.0
29400,2,9400,[318 427 496 357 257],716,5,42633,4.534943091160515,60.0,0.0
29401,2,9401,[183 385 286 174 161],593,5,42638,4.53499255477558,0.0,20.0
29402,2,9402,[318 427 496 357 257],796,5,42643,4.535042007869829,60.0,0.0
29403,2,9403,[318 427 496 357 257],716,5,42648,4.535091450446618,60.0,0.0
29404,2,9404,[318 427 496 357 257],716,5,42653,4.535140882509303,60.0,0.0
29405,2,9405,[318 427 496 357 257],796,5,42658,4.535190304061238,60.0,0.0
29406,2,9406,[282 196 275 237 238],716,4,42662,4.535133411289466,0.0,20.0
29407,2,9407,[318 427 496 357 257],330,5,42667,4.535182823129252,60.0,0.0
29408,2,9408,[318 427 496 357 257],716,5,42672,4.535232224465937,60.0,0.0
29409,2,9409,[318 427 496 357 257],796,5,42677,4.535281615302869,60.0,0.0
29410,2,9410,[357 282 235  64 210],401,2,42679,4.535012219742854,20.0,0.0
29411,2,9411,[318 427 496 357 257],716,5,42684,4.535061623459414,60.0,0.0
29412,2,9412,[318 427 496 357 257],330,5,42689,4.5351110166790605,60.0,0.0
29413,2,9413,[132 210 176 121 286],796,3,42692,4.534947949861908,0.0,20.0
29414,2,9414,[228 222   9 286 181],344,3,42695,4.534784917684546,0.0,20.0
29415,2,9415,[318 427 496 357 257],330,5,42700,4.534834324553951,60.0,0.0
29416,2,9416,[318 427 496 357 257],796,5,42705,4.534883720930233,60.0,0.0
29417,2,9417,[318 427 496 357 257],330,5,42710,4.534933106816734,60.0,0.0
29418,2,9418,[318 427 496 357 257],716,5,42715,4.534982482216796,60.0,0.0
29419,2,9419,[318 427 496 357 257],796,5,42720,4.535031847133758,60.0,0.0
29420,2,9420,[172 568   9   7  12],344,5,42725,4.535081201570958,0.0,0.0
29421,2,9421,[144 127 195 153 180],450,5,42730,4.535130545531734,0.0,20.0
29422,2,9422,[318 427 496 357 257],330,5,42735,4.53517987901942,60.0,0.0
29423,2,9423,[318 427 496 357 257],330,5,42740,4.5352292020373515,60.0,0.0
29424,2,9424,[228 202  88 144  79],796,5,42745,4.5352785145888594,0.0,0.0
29425,2,9425,[318 427 496 357 257],796,5,42750,4.535327816677276,60.0,0.0
29426,2,9426,[318 427 496 357 257],330,5,42755,4.53537710830593,60.0,0.0
29427,2,9427,[318 427 496 357 257],330,5,42760,4.53542638947815,60.0,0.0
29428,2,9428,[318 427 496 357 257],716,5,42765,4.535475660197264,60.0,0.0
29429,2,9429,[215  22 194 117 144],716,4,42769,4.535418875927889,0.0,0.0
29430,2,9430,[118 234  96 195  11],693,3,42772,4.535256070406107,0.0,0.0
29431,2,9431,[100  82 234 118 161],504,3,42775,4.5350932994062765,0.0,20.0
29432,2,9432,[318 427 496 357 257],330,5,42780,4.535142584543624,60.0,0.0
29433,2,9433,[318 427 496 357 257],716,5,42785,4.535191859232563,60.0,0.0
29434,2,9434,[144 127 237 204 174],280,1,42786,4.534817170111288,0.0,20.0
29435,2,9435,[  1 603  70 300 200],450,4,42790,4.534760491733786,20.0,0.0
29436,2,9436,[ 95 151 173 237 222],344,4,42794,4.534703825368231,0.0,0.0
29437,2,9437,[318 427 496 357 257],716,5,42799,4.534753125662217,60.0,0.0
29438,2,9438,[ 69 435 143  88 202],151,5,42804,4.534802415510118,0.0,0.0
29439,2,9439,[318 427 496 357 257],330,5,42809,4.534851694915254,60.0,0.0
29440,2,9440,[172 483 323 173  96],280,2,42811,4.534583200932104,0.0,0.0
29441,2,9441,[187 742 546 185  50],504,3,42814,4.534420673586105,0.0,20.0
29442,2,9442,[318 427 496 357 257],716,5,42819,4.5344699777613044,60.0,0.0
29443,2,9443,[196  69 496 427  64],796,5,42824,4.534519271495129,60.0,0.0
29444,2,9444,[318 427 496 357 257],330,5,42829,4.534568554790894,60.0,0.0
29445,2,9445,[318 427 496 357 257],796,5,42834,4.534617827651916,60.0,0.0
29446,2,9446,[288 222 186 234 127],693,1,42835,4.534243675240817,0.0,20.0
29447,2,9447,[318 427 496 357 257],796,5,42840,4.534292972057578,60.0,0.0
29448,2,9448,[318 427 496 357 257],716,5,42845,4.534342258440047,60.0,0.0
29449,2,9449,[318 427 496 357 257],330,5,42850,4.534391534391534,60.0,0.0
29450,2,9450,[318 427 496 357 257],796,5,42855,4.534440799915353,60.0,0.0
29451,2,9451,[ 97 435 125 100 135],401,3,42858,4.5342784595852725,0.0,20.0
29452,2,9452,[318 427 496 357 257],716,5,42863,4.534327726647625,60.0,0.0
29453,2,9453,[318 427 496 357 257],796,5,42868,4.534376983287498,60.0,0.0
29454,2,9454,[318 427 496 357 257],330,5,42873,4.534426229508196,60.0,0.0
29455,2,9455,[318 427 496 357 257],716,5,42878,4.534475465313029,60.0,0.0
29456,2,9456,[271   9 357 173  98],796,4,42882,4.534418948926721,0.0,0.0
29457,2,9457,[118 100   1 182   9],457,5,42887,4.534468175089871,0.0,20.0
29458,2,9458,[318 427 496 357 257],796,5,42892,4.534517390844698,60.0,0.0
29459,2,9459,[318 427 496 357 257],716,5,42897,4.534566596194503,60.0,0.0
29460,2,9460,[318 427 496 357 257],796,5,42902,4.534615791142586,60.0,0.0
29461,2,9461,[318 427 496 357 257],330,5,42907,4.534664975692243,60.0,0.0
29462,2,9462,[318 427 496 357 257],330,5,42912,4.534714149846772,60.0,0.0
29463,2,9463,[ 88 483 176 210  15],457,5,42917,4.534763313609467,0.0,0.0
29464,2,9464,[318 427 496 357 257],716,5,42922,4.534812466983624,60.0,0.0
29465,2,9465,[302 144   9 300 471],535,2,42924,4.5345446862455105,0.0,0.0
29466,2,9466,[318 427 496 357 257],716,5,42929,4.534593852329143,60.0,0.0
29467,2,9467,[318 427 496 357 257],716,5,42934,4.534643008027039,60.0,0.0
29468,2,9468,[318 427 496 357 257],716,5,42939,4.534692153342486,60.0,0.0
29469,2,9469,[318 427 496 357 257],330,5,42944,4.534741288278775,60.0,0.0
29470,2,9470,[318 427 496 357 257],716,5,42949,4.534790412839193,60.0,0.0
29471,2,9471,[318 427 496 357 257],330,5,42954,4.534839527027027,60.0,0.0
29472,2,9472,[318 427 496 357 257],330,5,42959,4.534888630845561,60.0,0.0
29473,2,9473,[318 427 496 357 257],796,5,42964,4.534937724298079,60.0,0.0
29474,2,9474,[318 427 496 357 257],330,5,42969,4.534986807387863,60.0,0.0
29475,2,9475,[210 153 200 237  50],280,2,42971,4.534719290840017,0.0,20.0
29476,2,9476,[318 427 496 357 257],716,5,42976,4.534768386620239,60.0,0.0
29477,2,9477,[318 427 496 357 257],796,5,42981,4.5348174720405146,60.0,0.0
29478,2,9478,[ 69 222  12 181 210],796,4,42985,4.534761050743749,0.0,0.0
29479,2,9479,[318 427 496 357 257],796,5,42990,4.534810126582278,60.0,0.0
29480,2,9480,[318 427 496 357 257],716,5,42995,4.534859192068347,60.0,0.0
29481,2,9481,[318 427 496 357 257],330,5,43000,4.534908247205231,60.0,0.0
29482,2,9482,[357 237  12 318 403],655,2,43002,4.5346409364125275,20.0,0.0
29483,2,9483,[483 179 186  88  28],450,3,43005,4.534479122733024,0.0,0.0
29484,2,9484,[318 427 496 357 257],330,5,43010,4.534528202424881,60.0,0.0
29485,2,9485,[318 427 496 357 257],796,5,43015,4.534577271768923,60.0,0.0
29486,2,9486,[318 427 496 357 257],716,5,43020,4.53462633076842,60.0,0.0
29487,2,9487,[318 427 496 357 257],716,5,43025,4.534675379426644,60.0,0.0
29488,2,9488,[318 427 496 357 257],716,5,43030,4.534724417746864,60.0,0.0
29489,2,9489,[568 196 228 471  82],655,0,43030,4.534246575342466,0.0,0.0
29490,2,9490,[318 427 496 357 257],330,5,43035,4.534295648509114,60.0,0.0
29491,2,9491,[423 286 275 245 135],629,4,43039,4.5342393594605985,0.0,40.0
29492,2,9492,[318 427 496 357 257],330,5,43044,4.5342884230485625,60.0,0.0
29493,2,9493,[ 71 286 185   8 313],796,4,43048,4.534232146618917,0.0,20.0
29494,2,9494,[197   7 318 200 194],269,4,43052,4.534175882043181,20.0,0.0
29495,2,9495,[179 265 127 132 197],457,5,43057,4.534224936815502,0.0,20.0
29496,2,9496,[318 427 496 357 257],796,5,43062,4.534273981257239,60.0,0.0
29497,2,9497,[318 427 496 357 257],796,5,43067,4.534323015371657,60.0,0.0
29498,2,9498,[318 427 496 357 257],796,5,43072,4.534372039162017,60.0,0.0
29499,2,9499,[318 427 496 357 257],330,5,43077,4.534421052631579,60.0,0.0
29500,2,9500,[318 427 496 357 257],330,5,43082,4.5344700557836015,60.0,0.0
29501,2,9501,[385 300  96 328   4],655,0,43082,4.5339928436118715,0.0,0.0
29502,2,9502,[318 427 496 357 257],330,5,43087,4.534041881511102,60.0,0.0
29503,2,9503,[318 427 496 357 257],716,5,43092,4.534090909090909,60.0,0.0
29504,2,9504,[318 427 496 357 257],796,5,43097,4.53413992635455,60.0,0.0
29505,2,9505,[318 427 496 357 257],330,5,43102,4.5341889333052805,60.0,0.0
29506,2,9506,[318 427 496 357 257],796,5,43107,4.5342379299463555,60.0,0.0
29507,2,9507,[237 135 286 427  82],18,2,43109,4.533971392511569,20.0,20.0
29508,2,9508,[318 427 496 357 257],796,5,43114,4.534020401724682,60.0,0.0
29509,2,9509,[257  71 181  82  70],23,1,43115,4.533648790746582,0.0,0.0
29510,2,9510,[318 427 496 357 257],716,5,43120,4.533697823572705,60.0,0.0
29511,2,9511,[318 427 496 357 257],330,5,43125,4.533746846089151,60.0,0.0
29512,2,9512,[318 427 496 357 257],796,5,43130,4.53379585829917,60.0,0.0
29513,2,9513,[222 204 187 238 210],655,1,43131,4.533424427159975,0.0,0.0
29514,2,9514,[318 427 496 357 257],796,5,43136,4.533473462953232,60.0,0.0
29515,2,9515,[318 161 174 183 300],655,2,43138,4.533207229928541,20.0,0.0
29516,2,9516,[  4 125 222 183 385],280,1,43139,4.532835977724073,0.0,0.0
29517,2,9517,[318 427 496 357 257],796,5,43144,4.532885059886531,60.0,0.0
29518,2,9518,[318 427 496 357 257],796,5,43149,4.532934131736527,60.0,0.0
29519,2,9519,[318 427 496 357 257],716,5,43154,4.532983193277311,60.0,0.0
29520,2,9520,[318 427 496 357 257],796,5,43159,4.533032244512131,60.0,0.0
29521,2,9521,[318 427 496 357 257],716,5,43164,4.533081285444235,60.0,0.0
29522,2,9522,[318 427 496 357 257],796,5,43169,4.533130316076867,60.0,0.0
29523,2,9523,[121 496 172 215 195],535,4,43173,4.53307433851323,20.0,0.0
29524,2,9524,[294  64 357 215 333],655,2,43175,4.532808398950131,20.0,0.0
29525,2,9525,[318 427 496 357 257],330,5,43180,4.532857442788159,60.0,0.0
29526,2,9526,[  8 282 294  96 603],655,1,43181,4.53248661698331,20.0,0.0
29527,2,9527,[318 427 496 357 257],716,5,43186,4.532535684298908,60.0,0.0
29528,2,9528,[318 427 496 357 257],330,5,43191,4.532584741315983,60.0,0.0
29529,2,9529,[318 427 496 357 257],716,5,43196,4.532633788037775,60.0,0.0
29530,2,9530,[318 427 496 357 257],796,5,43201,4.5326828244675275,60.0,0.0
29531,2,9531,[318 427 496 357 257],330,5,43206,4.532731850608477,60.0,0.0
29532,2,9532,[144 427 235 173 273],450,3,43209,4.532571068918494,20.0,0.0
29533,2,9533,[ 79 172 228  64 186],577,4,43213,4.532515208726663,20.0,0.0
29534,2,9534,[197  28 175 210  50],151,5,43218,4.5325642370215,0.0,20.0
29535,2,9535,[318 427 496 357 257],330,5,43223,4.532613255033557,60.0,0.0
29536,2,9536,[265 228 234  88  11],457,5,43228,4.532662262766069,0.0,0.0
29537,2,9537,[318 427 496 357 257],716,5,43233,4.532711260222269,60.0,0.0
29538,2,9538,[ 89  82 185 286 132],796,3,43236,4.532550581821994,0.0,20.0
29539,2,9539,[286 318 151 427  64],535,4,43240,4.532494758909853,60.0,20.0
29540,2,9540,[318 427 496 357 257],796,5,43245,4.532543758515879,60.0,0.0
29541,2,9541,[238 153 222 143 289],655,1,43246,4.532173548522322,0.0,0.0
29542,2,9542,[  4 655 427 187 175],716,2,43248,4.531908204966991,20.0,0.0
29543,2,9543,[318 427 496 357 257],716,5,43253,4.531957250628667,60.0,0.0
29544,2,9544,[318 427 496 357 257],796,5,43258,4.53200628601362,60.0,0.0
29545,2,9545,[318 427 496 357 257],716,5,43263,4.532055311125078,60.0,0.0
29546,2,9546,[  9 265 318 286 179],786,5,43268,4.532104325966272,20.0,20.0
29547,2,9547,[318 427 496 357 257],330,5,43273,4.532153330540427,60.0,0.0
29548,2,9548,[153 186 546  98  56],151,3,43276,4.53199287883548,0.0,0.0
29549,2,9549,[318 427 496 357 257],330,5,43281,4.532041884816754,60.0,0.0
29550,2,9550,[318 427 496 357 257],716,5,43286,4.532090880536069,60.0,0.0
29551,2,9551,[181 603 191 300 176],450,5,43291,4.53213986599665,20.0,0.0
29552,2,9552,[318 427 496 357 257],330,5,43296,4.532188841201717,60.0,0.0
29553,2,9553,[318 427 496 357 257],330,5,43301,4.53223780615449,60.0,0.0
29554,2,9554,[318 427 496 357 257],330,5,43306,4.53228676085819,60.0,0.0
29555,2,9555,[318 427 496 357 257],716,5,43311,4.532335705316032,60.0,0.0
29556,2,9556,[318 427 496 357 257],796,5,43316,4.532384639531234,60.0,0.0
29557,2,9557,[ 70 257 318 174  89],457,4,43320,4.5323289391086,20.0,0.0
29558,2,9558,[318 427 496 357 257],716,5,43325,4.5323778637932834,60.0,0.0
29559,2,9559,[318 427 496 357 257],796,5,43330,4.5324267782426775,60.0,0.0
29560,2,9560,[318 427 496 357 257],796,5,43335,4.532475682459994,60.0,0.0
29561,2,9561,[318 427 496 357 257],796,5,43340,4.532524576448441,60.0,0.0
29562,2,9562,[318 427 496 357 257],330,5,43345,4.532573460211231,60.0,0.0
29563,2,9563,[318 427 496 357 257],330,5,43350,4.5326223337515685,60.0,0.0
29564,2,9564,[318 427 496 357 257],716,5,43355,4.532671197072661,60.0,0.0
29565,2,9565,[318 427 496 357 257],716,5,43360,4.532720050177713,60.0,0.0
29566,2,9566,[318 427 496 357 257],796,5,43365,4.532768893069928,60.0,0.0
29567,2,9567,[318 427 496 357 257],716,5,43370,4.532817725752508,60.0,0.0
29568,2,9568,[318 427 496 357 257],796,5,43375,4.532866548228655,60.0,0.0
29569,2,9569,[318 427 496 357 257],716,5,43380,4.532915360501567,60.0,0.0
29570,2,9570,[318 427 496 357 257],796,5,43385,4.5329641625744435,60.0,0.0
29571,2,9571,[318 427 496 357 257],716,5,43390,4.533012954450481,60.0,0.0
29572,2,9572,[318 427 496 357 257],796,5,43395,4.533061736132874,60.0,0.0
29573,2,9573,[318 427 496 357 257],716,5,43400,4.5331105076248175,60.0,0.0
29574,2,9574,[318 427 496 357 257],330,5,43405,4.533159268929504,60.0,0.0
29575,2,9575,[318 427 496 357 257],796,5,43410,4.533208020050125,60.0,0.0
29576,2,9576,[318 427 496 357 257],716,5,43415,4.533256760989872,60.0,0.0
29577,2,9577,[318 427 496 357 257],330,5,43420,4.533305491751931,60.0,0.0
29578,2,9578,[302 427 191 168 179],269,4,43424,4.533249817308696,20.0,0.0
29579,2,9579,[318 427 496 357 257],330,5,43429,4.533298538622129,60.0,0.0
29580,2,9580,[318 427 496 357 257],330,5,43434,4.533347249765161,60.0,0.0
29581,2,9581,[ 28 172 273 435 313],655,3,43437,4.533187226048842,0.0,0.0
29582,2,9582,[318 427 496 357 257],716,5,43442,4.533235938641344,60.0,0.0
29583,2,9583,[215 197 117 228  12],655,0,43442,4.532762938230384,0.0,0.0
29584,2,9584,[318 427 496 357 257],796,5,43447,4.532811684924361,60.0,0.0
29585,2,9585,[318 427 496 357 257],796,5,43452,4.532860421447945,60.0,0.0
29586,2,9586,[318 427 496 357 257],796,5,43457,4.532909147804318,60.0,0.0
29587,2,9587,[174 176  64 151 117],577,5,43462,4.532957863996662,20.0,0.0
29588,2,9588,[318 427 496 357 257],330,5,43467,4.533006570028157,60.0,0.0
29589,2,9589,[318 427 496 357 257],330,5,43472,4.533055265901981,60.0,0.0
29590,2,9590,[318 427 496 357 257],716,5,43477,4.533103951621312,60.0,0.0
29591,2,9591,[318 427 496 357 257],330,5,43482,4.533152627189325,60.0,0.0
29592,2,9592,[318 427 496 357 257],330,5,43487,4.533201292609194,60.0,0.0
29593,2,9593,[318 427 496 357 257],716,5,43492,4.533249947884094,60.0,0.0
29594,2,9594,[318 427 496 357 257],716,5,43497,4.5332985930171965,60.0,0.0
29595,2,9595,[ 12 276 496 435 180],18,5,43502,4.533347228011672,20.0,0.0
29596,2,9596,[197 215  56 302 180],450,5,43507,4.533395852870688,0.0,0.0
29597,2,9597,[318 427 496 357 257],716,5,43512,4.533444467597416,60.0,0.0
29598,2,9598,[318 427 496 357 257],330,5,43517,4.533493072195021,60.0,0.0
29599,2,9599,[318 427 496 357 257],796,5,43522,4.533541666666666,60.0,0.0
29600,2,9600,[318 427 496 357 257],716,5,43527,4.533590251015519,60.0,0.0
29601,2,9601,[742 483  56 257 245],796,3,43530,4.533430535305145,0.0,0.0
29602,2,9602,[234 483 174 268 197],269,3,43533,4.5332708528584815,0.0,0.0
29603,2,9603,[318 427 496 357 257],716,5,43538,4.5333194502290715,60.0,0.0
29604,2,9604,[318 427 496 357 257],716,5,43543,4.533368037480479,60.0,0.0
29605,2,9605,[318 427 496 357 257],716,5,43548,4.533416614615865,60.0,0.0
29606,2,9606,[318 427 496 357 257],796,5,43553,4.533465181638388,60.0,0.0
29607,2,9607,[318 427 496 357 257],716,5,43558,4.533513738551207,60.0,0.0
29608,2,9608,[318 427 496 357 257],716,5,43563,4.533562285357477,60.0,0.0
29609,2,9609,[202 276 568  88 135],457,5,43568,4.5336108220603535,0.0,0.0
29610,2,9610,[265 125 181   7   4],655,0,43568,4.5331391114348145,0.0,0.0
29611,2,9611,[183 100 288  95 181],280,2,43570,4.532875572201415,0.0,20.0
29612,2,9612,[210 328 197  97 282],655,0,43570,4.532404036200978,0.0,0.0
29613,2,9613,[423 268 215 168 238],11,2,43572,4.532140628250468,0.0,0.0
29614,2,9614,[318 427 496 357 257],716,5,43577,4.532189287571503,60.0,0.0
29615,2,9615,[ 11 196 471   1  64],716,4,43581,4.53213394342762,20.0,0.0
29616,2,9616,[318 427 496 357 257],796,5,43586,4.532182593324322,60.0,0.0
29617,2,9617,[ 15 195   1 288  82],450,2,43588,4.531919317945519,0.0,0.0
29618,2,9618,[318 427 496 357 257],716,5,43593,4.531967980039505,60.0,0.0
29619,2,9619,[318 427 496 357 257],796,5,43598,4.532016632016632,60.0,0.0
29620,2,9620,[318 427 496 357 257],716,5,43603,4.532065273880054,60.0,0.0
29621,2,9621,[318 427 496 357 257],330,5,43608,4.532113905632925,60.0,0.0
29622,2,9622,[318 427 496 357 257],796,5,43613,4.532162527278396,60.0,0.0
29623,2,9623,[318 427 496 357 257],330,5,43618,4.532211138819617,60.0,0.0
29624,2,9624,[318 427 496 357 257],796,5,43623,4.53225974025974,60.0,0.0
29625,2,9625,[318 427 496 357 257],330,5,43628,4.532308331601912,60.0,0.0
29626,2,9626,[318 427 496 357 257],796,5,43633,4.532356912849278,60.0,0.0
29627,2,9627,[318 427 496 357 257],330,5,43638,4.532405484004985,60.0,0.0
29628,2,9628,[318 427 496 357 257],716,5,43643,4.5324540450721775,60.0,0.0
29629,2,9629,[174 294 288 357 471],655,1,43644,4.53208722741433,0.0,0.0
29630,2,9630,[318 427 496 357 257],716,5,43649,4.532135811442218,60.0,0.0
29631,2,9631,[318 427 496 357 257],330,5,43654,4.53218438538206,60.0,0.0
29632,2,9632,[318 427 496 357 257],330,5,43659,4.532232949236998,60.0,0.0
29633,2,9633,[111 515 194 153 179],269,3,43662,4.5320739049200744,0.0,0.0
29634,2,9634,[318 427 496 357 257],796,5,43667,4.532122470160872,60.0,0.0
29635,2,9635,[313  22 195 568 483],450,4,43671,4.532067247820672,0.0,0.0
29636,2,9636,[301 300 302 195 161],655,1,43672,4.5317007367438,0.0,0.0
29637,2,9637,[318 427 496 357 257],330,5,43677,4.531749325586222,60.0,0.0
29638,2,9638,[318 427 496 357 257],330,5,43682,4.531797904346924,60.0,0.0
29639,2,9639,[318 427 496 357 257],330,5,43687,4.531846473029046,60.0,0.0
29640,2,9640,[318 427 496 357 257],796,5,43692,4.531895031635722,60.0,0.0
29641,2,9641,[318 427 496 357 257],330,5,43697,4.531943580170089,60.0,0.0
29642,2,9642,[318 427 496 357 257],330,5,43702,4.531992118635279,60.0,0.0
29643,2,9643,[318 427 496 357 257],716,5,43707,4.532040647034425,60.0,0.0
29644,2,9644,[318 427 496 357 257],796,5,43712,4.5320891653706585,60.0,0.0
29645,2,9645,[318 427 496 357 257],716,5,43717,4.5321376736471075,60.0,0.0
29646,2,9646,[318 427 496 357 257],716,5,43722,4.532186171866901,60.0,0.0
29647,2,9647,[318 427 496 357 257],796,5,43727,4.5322346600331676,60.0,0.0
29648,2,9648,[318 427 496 357 257],796,5,43732,4.532283138149031,60.0,0.0
29649,2,9649,[318 427 496 357 257],796,5,43737,4.532331606217617,60.0,0.0
29650,2,9650,[318 427 496 357 257],330,5,43742,4.532380064242047,60.0,0.0
29651,2,9651,[318 427 496 357 257],330,5,43747,4.5324285122254455,60.0,0.0
29652,2,9652,[318 427 496 357 257],330,5,43752,4.532476950170931,60.0,0.0
29653,2,9653,[191   1  25 125   9],344,3,43755,4.532318210068365,0.0,0.0
29654,2,9654,[318 427 496 357 257],716,5,43760,4.532366649404453,60.0,0.0
29655,2,9655,[318 427 496 357 257],796,5,43765,4.5324150787075395,60.0,0.0
29656,2,9656,[471   7 271 197 302],655,1,43766,4.53204929066998,0.0,0.0
29657,2,9657,[318 427 496 357 257],716,5,43771,4.532097742803893,60.0,0.0
29658,2,9658,[200 182 234 405 153],655,2,43773,4.531835593746765,0.0,0.0
29659,2,9659,[269   8 265 172  22],796,4,43777,4.531780538302278,0.0,0.0
29660,2,9660,[318 427 496 357 257],716,5,43782,4.531829003208777,60.0,0.0
29661,2,9661,[318 427 496 357 257],716,5,43787,4.531877458083213,60.0,0.0
29662,2,9662,[318 427 496 357 257],330,5,43792,4.531925902928697,60.0,0.0
29663,2,9663,[318 427 496 357 257],796,5,43797,4.531974337748345,60.0,0.0
29664,2,9664,[318 427 496 357 257],330,5,43802,4.5320227625452665,60.0,0.0
29665,2,9665,[318 427 496 357 257],716,5,43807,4.532071177322574,60.0,0.0
29666,2,9666,[318 427 496 357 257],716,5,43812,4.532119582083377,60.0,0.0
29667,2,9667,[200 125 182  56 172],280,2,43814,4.531857674803476,0.0,0.0
29668,2,9668,[318 427 496 357 257],796,5,43819,4.531906091633054,60.0,0.0
29669,2,9669,[318 427 496 357 257],796,5,43824,4.531954498448811,60.0,0.0
29670,2,9670,[318 427 496 357 257],330,5,43829,4.532002895253852,60.0,0.0
29671,2,9671,[186 268   1  97 202],655,0,43829,4.531534325889164,0.0,0.0
29672,2,9672,[111 174  25 144 257],716,4,43833,4.531479375581515,0.0,0.0
29673,2,9673,[318 427 496 357 257],796,5,43838,4.531527806491627,60.0,0.0
29674,2,9674,[318 427 496 357 257],796,5,43843,4.531576227390181,60.0,0.0
29675,2,9675,[318 427 496 357 257],330,5,43848,4.531624638280281,60.0,0.0
29676,2,9676,[318 427 496 357 257],796,5,43853,4.531673039165031,60.0,0.0
29677,2,9677,[318 427 496 357 257],716,5,43858,4.53172143004753,60.0,0.0
29678,2,9678,[318 427 496 357 257],796,5,43863,4.531769810930881,60.0,0.0
29679,2,9679,[357 258 603 300 748],151,4,43867,4.531714876033058,20.0,0.0
29680,2,9680,[  8 508 245 322  11],280,3,43870,4.531556657370106,0.0,0.0
29681,2,9681,[318 427 496 357 257],716,5,43875,4.531605040280934,60.0,0.0
29682,2,9682,[ 22 271 273 301  50],629,3,43878,4.531446865640814,0.0,20.0
29683,2,9683,[318 427 496 357 257],716,5,43883,4.531495249896737,60.0,0.0
29684,2,9684,[318 427 496 357 257],716,5,43888,4.531543624161074,60.0,0.0
29685,2,9685,[318 427 496 357 257],796,5,43893,4.53159198843692,60.0,0.0
29686,2,9686,[ 82  71 597 318 235],450,2,43895,4.531330649323836,20.0,0.0
29687,2,9687,[318 427 496 357 257],330,5,43900,4.531379025598679,60.0,0.0
29688,2,9688,[211 168 161 258 483],796,4,43904,4.531324182062132,0.0,0.0
29689,2,9689,[318 427 496 357 257],716,5,43909,4.531372549019608,60.0,0.0
29690,2,9690,[318 427 496 357 257],796,5,43914,4.531420905995254,60.0,0.0
29691,2,9691,[403 742  79 286   1],796,2,43916,4.53115971935617,0.0,20.0
29692,2,9692,[318 427 496 357 257],796,5,43921,4.5312080883111525,60.0,0.0
29693,2,9693,[318 427 496 357 257],716,5,43926,4.531256447286982,60.0,0.0
29694,2,9694,[318 427 496 357 257],716,5,43931,4.531304796286745,60.0,0.0
29695,2,9695,[318 427 496 357 257],716,5,43936,4.531353135313531,60.0,0.0
29696,2,9696,[318 427 496 357 257],330,5,43941,4.531401464370424,60.0,0.0
29697,2,9697,[318 427 496 357 257],716,5,43946,4.531449783460507,60.0,0.0
29698,2,9698,[318 427 496 357 257],716,5,43951,4.531498092586864,60.0,0.0
29699,2,9699,[282 546 194  69 603],796,5,43956,4.531546391752578,20.0,0.0
29700,2,9700,[318 427 496 357 257],796,5,43961,4.531594680960725,60.0,0.0
29701,2,9701,[318 427 496 357 257],796,5,43966,4.531642960214389,60.0,0.0
29702,2,9702,[318 427 496 357 257],796,5,43971,4.531691229516644,60.0,0.0
29703,2,9703,[318 427 496 357 257],796,5,43976,4.531739488870569,60.0,0.0
29704,2,9704,[318 427 496 357 257],716,5,43981,4.531787738279237,60.0,0.0
29705,2,9705,[237   7 216 144 121],457,5,43986,4.531835977745724,0.0,0.0
29706,2,9706,[318 427 496 357 257],716,5,43991,4.531884207273102,60.0,0.0
29707,2,9707,[318 427 496 357 257],796,5,43996,4.531932426864442,60.0,0.0
29708,2,9708,[318 427 496 357 257],716,5,44001,4.531980636522814,60.0,0.0
29709,2,9709,[318 427 496 357 257],330,5,44006,4.532028836251287,60.0,0.0
29710,2,9710,[318 427 496 357 257],716,5,44011,4.53207702605293,60.0,0.0
29711,2,9711,[318 427 496 357 257],716,5,44016,4.532125205930807,60.0,0.0
29712,2,9712,[318 427 496 357 257],796,5,44021,4.532173375887985,60.0,0.0
29713,2,9713,[144 191 121 111 228],655,1,44022,4.531809759110562,0.0,0.0
29714,2,9714,[318 427 496 357 257],796,5,44027,4.5318579516212045,60.0,0.0
29715,2,9715,[237  28 427 748  88],796,4,44031,4.5318032111980235,20.0,0.0
29716,2,9716,[318 427 496 357 257],330,5,44036,4.531851394463311,60.0,0.0
29717,2,9717,[ 56  70 118  22 288],457,5,44041,4.531899567812307,0.0,0.0
29718,2,9718,[318 427 496 357 257],796,5,44046,4.531947731248071,60.0,0.0
29719,2,9719,[318 427 496 357 257],330,5,44051,4.5319958847736626,60.0,0.0
29720,2,9720,[ 12 597  64   4 568],256,5,44056,4.532044028392141,20.0,0.0
29721,2,9721,[222  89 405  82 216],796,4,44060,4.531989302612631,0.0,0.0
29722,2,9722,[318 427 496 357 257],330,5,44065,4.53203743700504,60.0,0.0
29723,2,9723,[318 427 496 357 257],716,5,44070,4.532085561497326,60.0,0.0
29724,2,9724,[318 427 496 357 257],330,5,44075,4.532133676092545,60.0,0.0
29725,2,9725,[318 427 496 357 257],796,5,44080,4.532181780793748,60.0,0.0
29726,2,9726,[318 427 496 357 257],796,5,44085,4.5322298756039885,60.0,0.0
29727,2,9727,[318 427 496 357 257],330,5,44090,4.532277960526316,60.0,0.0
29728,2,9728,[318 427 496 357 257],796,5,44095,4.532326035563778,60.0,0.0
29729,2,9729,[318 427 496 357 257],796,5,44100,4.532374100719425,60.0,0.0
29730,2,9730,[318 427 496 357 257],716,5,44105,4.532422155996301,60.0,0.0
29731,2,9731,[318 427 496 357 257],330,5,44110,4.532470201397452,60.0,0.0
29732,2,9732,[357 204  98 269 151],23,2,44112,4.5322100071920275,0.0,0.0
29733,2,9733,[546 471 222 202 568],450,4,44116,4.532155331826587,0.0,0.0
29734,2,9734,[318 427 496 357 257],796,5,44121,4.532203389830508,60.0,0.0
29735,2,9735,[318 427 496 357 257],716,5,44126,4.532251437962202,60.0,0.0
29736,2,9736,[597 483  88  22 276],269,2,44128,4.531991373112868,0.0,0.0
29737,2,9737,[153 210 546 216  56],716,4,44132,4.53193674265763,0.0,0.0
29738,2,9738,[191 143 111  79 496],151,4,44136,4.531882123421296,20.0,0.0
29739,2,9739,[ 98 276 357 405 185],457,5,44141,4.531930184804928,0.0,0.0
29740,2,9740,[318 427 496 357 257],716,5,44146,4.531978236320707,60.0,0.0
29741,2,9741,[  7 423 118   4 195],151,3,44149,4.531820981318004,0.0,0.0
29742,2,9742,[318 427 496 357 257],330,5,44154,4.531869034178384,60.0,0.0
29743,2,9743,[318 427 496 357 257],716,5,44159,4.531917077175698,60.0,0.0
29744,2,9744,[318 427 496 357 257],796,5,44164,4.531965110312981,60.0,0.0
29745,2,9745,[318 427 496 357 257],796,5,44169,4.532013133593269,60.0,0.0
29746,2,9746,[318 427 496 357 257],796,5,44174,4.532061147019596,60.0,0.0
29747,2,9747,[318 427 496 357 257],716,5,44179,4.5321091505949935,60.0,0.0
29748,2,9748,[318 427 496 357 257],330,5,44184,4.532157144322495,60.0,0.0
29749,2,9749,[318 427 496 357 257],330,5,44189,4.5322051282051286,60.0,0.0
29750,2,9750,[318 427 496 357 257],796,5,44194,4.532253102245924,60.0,0.0
29751,2,9751,[294 222  96 258 237],450,4,44198,4.53219852337982,0.0,0.0
29752,2,9752,[318 427 496 357 257],716,5,44203,4.532246488260022,60.0,0.0
29753,2,9753,[318 427 496 357 257],796,5,44208,4.532294443305311,60.0,0.0
29754,2,9754,[185 496 215  25  96],716,4,44212,4.532239876986161,20.0,0.0
29755,2,9755,[318 427 496 357 257],796,5,44217,4.532287822878229,60.0,0.0
29756,2,9756,[318 427 496 357 257],796,5,44222,4.532335758942298,60.0,0.0
29757,2,9757,[603 275 301 118 286],655,2,44224,4.532076245132199,20.0,40.0
29758,2,9758,[318 427 496 357 257],330,5,44229,4.532124193052566,60.0,0.0
29759,2,9759,[318 427 496 357 257],796,5,44234,4.532172131147541,60.0,0.0
29760,2,9760,[202 121 176 237  28],796,4,44238,4.532117610900523,0.0,0.0
29761,2,9761,[ 69  79 176 546  25],457,4,44242,4.532063101823397,0.0,0.0
29762,2,9762,[318 427 496 357 257],716,5,44247,4.532111031445252,60.0,0.0
29763,2,9763,[202 655 238 117  88],457,5,44252,4.532158951249488,0.0,0.0
29764,2,9764,[151 173 100 282  50],457,5,44257,4.5322068612391195,0.0,40.0
29765,2,9765,[318 427 496 357 257],796,5,44262,4.532254761417161,60.0,0.0
29766,2,9766,[318 427 496 357 257],716,5,44267,4.532302651786629,60.0,0.0
29767,2,9767,[318 427 496 357 257],716,5,44272,4.532350532350533,60.0,0.0
29768,2,9768,[200 211 222   7 172],655,2,44274,4.532091309243525,0.0,0.0
29769,2,9769,[153 173 135  69  11],629,4,44278,4.532036847492323,0.0,0.0
29770,2,9770,[318 427 496 357 257],330,5,44283,4.532084740558797,60.0,0.0
29771,2,9771,[318 427 496 357 257],716,5,44288,4.532132623823168,60.0,0.0
29772,2,9772,[318 427 496 357 257],796,5,44293,4.532180497288448,60.0,0.0
29773,2,9773,[318 427 496 357 257],796,5,44298,4.532228360957642,60.0,0.0
29774,2,9774,[228 121  69 125 423],450,4,44302,4.532173913043478,0.0,0.0
29775,2,9775,[318 427 496 357 257],330,5,44307,4.532221767594108,60.0,0.0
29776,2,9776,[318 427 496 357 257],716,5,44312,4.532269612355528,60.0,0.0
29777,2,9777,[318 427 496 357 257],716,5,44317,4.532317447330742,60.0,0.0
29778,2,9778,[568 228 181 235  22],457,4,44321,4.532263012577973,0.0,0.0
29779,2,9779,[191  69 313 215 197],796,4,44325,4.532208588957055,0.0,0.0
29780,2,9780,[  1 427 176  22 515],655,2,44327,4.531949698394847,20.0,0.0
29781,2,9781,[318 427 496 357 257],796,5,44332,4.531997546514005,60.0,0.0
29782,2,9782,[318 427 496 357 257],796,5,44337,4.532045384851273,60.0,0.0
29783,2,9783,[318 427 496 357 257],330,5,44342,4.532093213409649,60.0,0.0
29784,2,9784,[496  56 546 276 238],593,3,44345,4.531936637710782,20.0,0.0
29785,2,9785,[117  82 143 742 748],450,4,44349,4.531882280809319,0.0,0.0
29786,2,9786,[318 427 496 357 257],796,5,44354,4.531930111372229,60.0,0.0
29787,2,9787,[ 64  22 405 234 181],450,4,44358,4.531875766244381,20.0,0.0
29788,2,9788,[318 427 496 357 257],716,5,44363,4.53192358770048,60.0,0.0
29789,2,9789,[318 427 496 357 257],796,5,44368,4.53197139938713,60.0,0.0
29790,2,9790,[318 427 496 357 257],716,5,44373,4.532019201307323,60.0,0.0
29791,2,9791,[496 235 385 288  97],450,3,44376,4.5318627450980395,20.0,0.0
29792,2,9792,[ 97 215 234 185 211],655,1,44377,4.531502093331972,0.0,0.0
29793,2,9793,[286 194 153 234 273],796,2,44379,4.531243618541964,0.0,20.0
29794,2,9794,[318 427 496 357 257],716,5,44384,4.531291475242471,60.0,0.0
29795,2,9795,[318 427 496 357 257],796,5,44389,4.5313393221723155,60.0,0.0
29796,2,9796,[318 427 496 357 257],716,5,44394,4.53138715933449,60.0,0.0
29797,2,9797,[318 427 496 357 257],796,5,44399,4.531434986731986,60.0,0.0
29798,2,9798,[318 427 496 357 257],796,5,44404,4.531482804367792,60.0,0.0
29799,2,9799,[318 427 496 357 257],796,5,44409,4.531530612244898,60.0,0.0
29800,2,9800,[318 427 496 357 257],796,5,44414,4.531578410366289,60.0,0.0
29801,2,9801,[318 427 496 357 257],716,5,44419,4.531626198734952,60.0,0.0
29802,2,9802,[318 427 496 357 257],716,5,44424,4.531673977353871,60.0,0.0
29803,2,9803,[318 427 496 357 257],716,5,44429,4.53172174622603,60.0,0.0
29804,2,9804,[174 195  56 182 318],655,2,44431,4.5314635390107085,20.0,0.0
29805,2,9805,[318 427 496 357 257],796,5,44436,4.531511319600245,60.0,0.0
29806,2,9806,[318 427 496 357 257],716,5,44441,4.5315590904456,60.0,0.0
29807,2,9807,[118 238 237 125 328],450,4,44445,4.531504893964111,0.0,0.0
29808,2,9808,[318 427 496 357 257],330,5,44450,4.531552655724335,60.0,0.0
29809,2,9809,[318 427 496 357 257],716,5,44455,4.531600407747197,60.0,0.0
29810,2,9810,[318 427 496 357 257],330,5,44460,4.531648150035674,60.0,0.0
29811,2,9811,[318 427 496 357 257],716,5,44465,4.531695882592744,60.0,0.0
29812,2,9812,[318 427 496 357 257],796,5,44470,4.53174360542138,60.0,0.0
29813,2,9813,[318 427 496 357 257],716,5,44475,4.531791318524557,60.0,0.0
29814,2,9814,[318 427 496 357 257],796,5,44480,4.531839021905247,60.0,0.0
29815,2,9815,[202 215 322  95 597],450,4,44484,4.531784841075795,0.0,0.0
29816,2,9816,[318 427 496 357 257],716,5,44489,4.531832535397779,60.0,0.0
29817,2,9817,[318 427 496 357 257],330,5,44494,4.531880220004074,60.0,0.0
29818,2,9818,[143 210 117 125  28],786,5,44499,4.531927894897647,0.0,0.0
29819,2,9819,[318 427 496 357 257],796,5,44504,4.531975560081467,60.0,0.0
29820,2,9820,[318 427 496 357 257],330,5,44509,4.532023215558497,60.0,0.0
29821,2,9821,[176 200   8 265 288],457,5,44514,4.532070861331705,0.0,0.0
29822,2,9822,[318 427 496 357 257],330,5,44519,4.532118497404052,60.0,0.0
29823,2,9823,[318 427 496 357 257],796,5,44524,4.532166123778501,60.0,0.0
29824,2,9824,[318 427 496 357 257],796,5,44529,4.532213740458015,60.0,0.0
29825,2,9825,[318 427 496 357 257],330,5,44534,4.532261347445552,60.0,0.0
29826,2,9826,[318 427 496 357 257],716,5,44539,4.532308944744073,60.0,0.0
29827,2,9827,[318 427 496 357 257],796,5,44544,4.532356532356532,60.0,0.0
29828,2,9828,[117  96 742 172 588],457,5,44549,4.5324041102858885,0.0,0.0
29829,2,9829,[318 427 496 357 257],796,5,44554,4.532451678535097,60.0,0.0
29830,2,9830,[318 427 496 357 257],330,5,44559,4.5324992371071104,60.0,0.0
29831,2,9831,[194 318 328 282 496],450,5,44564,4.532546786004882,40.0,0.0
29832,2,9832,[151 597 257 275 234],796,4,44568,4.532492626868708,0.0,20.0
29833,2,9833,[174 265 132 237 300],450,5,44573,4.532540166768355,0.0,0.0
29834,2,9834,[318 427 496 357 257],330,5,44578,4.532587697000508,60.0,0.0
29835,2,9835,[318 427 496 357 257],716,5,44583,4.532635217568117,60.0,0.0
29836,2,9836,[318 427 496 357 257],716,5,44588,4.5326827284741285,60.0,0.0
29837,2,9837,[318 427 496 357 257],796,5,44593,4.532730229721488,60.0,0.0
29838,2,9838,[318 427 496 357 257],330,5,44598,4.532777721313142,60.0,0.0
29839,2,9839,[318 427 496 357 257],330,5,44603,4.532825203252033,60.0,0.0
29840,2,9840,[ 50 183  89   8  15],269,0,44603,4.532364597093792,0.0,20.0
29841,2,9841,[318 427 496 357 257],796,5,44608,4.53241211135948,60.0,0.0
29842,2,9842,[318 427 496 357 257],330,5,44613,4.53245961597074,60.0,0.0
29843,2,9843,[318 427 496 357 257],796,5,44618,4.532507110930516,60.0,0.0
29844,2,9844,[318 427 496 357 257],796,5,44623,4.532554596241747,60.0,0.0
29845,2,9845,[318 427 496 357 257],796,5,44628,4.532602071907373,60.0,0.0
29846,2,9846,[ 64 211  28 191  25],18,3,44631,4.532446430384889,20.0,0.0
29847,2,9847,[357 100 181 301 180],296,5,44636,4.532493907392364,0.0,20.0
29848,2,9848,[515  56  22 153 161],655,1,44637,4.532135242156564,0.0,0.0
29849,2,9849,[318 427 496 357 257],330,5,44642,4.532182741116752,60.0,0.0
29850,2,9850,[318 427 496 357 257],716,5,44647,4.532230230433458,60.0,0.0
29851,2,9851,[318 427 496 357 257],330,5,44652,4.532277710109622,60.0,0.0
29852,2,9852,[318 427 496 357 257],330,5,44657,4.532325180148178,60.0,0.0
29853,2,9853,[318 427 496 357 257],330,5,44662,4.53237264055206,60.0,0.0
29854,2,9854,[318 427 496 357 257],796,5,44667,4.532420091324201,60.0,0.0
29855,2,9855,[204 216 200 228 211],450,4,44671,4.532366071428571,0.0,0.0
29856,2,9856,[318 427 496 357 257],330,5,44676,4.532413513239322,60.0,0.0
29857,2,9857,[403 282  89 228 182],256,3,44679,4.532258064516129,0.0,0.0
29858,2,9858,[318 427 496 357 257],716,5,44684,4.532305507657978,60.0,0.0
29859,2,9859,[318 427 496 357 257],330,5,44689,4.5323529411764705,60.0,0.0
29860,2,9860,[318 427 496 357 257],330,5,44694,4.532400365074536,60.0,0.0
29861,2,9861,[318 427 496 357 257],716,5,44699,4.532447779355101,60.0,0.0
29862,2,9862,[186 187 200 245 238],504,2,44701,4.532191016931968,0.0,0.0
29863,2,9863,[318 427 496 357 257],796,5,44706,4.5322384428223845,60.0,0.0
29864,2,9864,[318 427 496 357 257],716,5,44711,4.53228585909782,60.0,0.0
29865,2,9865,[318 427 496 357 257],330,5,44716,4.5323332657612,60.0,0.0
29866,2,9866,[195 515 435 603 568],269,2,44718,4.532076619033141,20.0,0.0
29867,2,9867,[318 427 496 357 257],796,5,44723,4.532124037292258,60.0,0.0
29868,2,9868,[318 427 496 357 257],796,5,44728,4.532171445941838,60.0,0.0
29869,2,9869,[318 427 496 357 257],796,5,44733,4.532218844984802,60.0,0.0
29870,2,9870,[118 175   1  56   8],457,5,44738,4.53226623442407,0.0,0.0
29871,2,9871,[318 427 496 357 257],796,5,44743,4.532313614262561,60.0,0.0
29872,2,9872,[318 427 496 357 257],716,5,44748,4.532360984503191,60.0,0.0
29873,2,9873,[318 427 496 357 257],796,5,44753,4.532408345148876,60.0,0.0
29874,2,9874,[191 405 301 275 200],151,2,44755,4.532151898734178,0.0,20.0
29875,2,9875,[204 403 117 588 257],796,5,44760,4.532199270959903,0.0,0.0
29876,2,9876,[318 427 496 357 257],330,5,44765,4.532246633593196,60.0,0.0
29877,2,9877,[318 427 496 357 257],330,5,44770,4.532293986636971,60.0,0.0
29878,2,9878,[318 427 496 357 257],330,5,44775,4.532341330094139,60.0,0.0
29879,2,9879,[318 427 496 357 257],716,5,44780,4.532388663967612,60.0,0.0
29880,2,9880,[318 427 496 357 257],330,5,44785,4.532435988260297,60.0,0.0
29881,2,9881,[318 427 496 357 257],716,5,44790,4.532483302975106,60.0,0.0
29882,2,9882,[318 427 496 357 257],716,5,44795,4.532530608114945,60.0,0.0
29883,2,9883,[318 427 496 357 257],330,5,44800,4.53257790368272,60.0,0.0
29884,2,9884,[318 427 496 357 257],716,5,44805,4.532625189681335,60.0,0.0
29885,2,9885,[318 427 496 357 257],796,5,44810,4.532672466113696,60.0,0.0
29886,2,9886,[318 427 496 357 257],796,5,44815,4.532719732982705,60.0,0.0
29887,2,9887,[403  28 185 211 194],450,5,44820,4.532766990291262,0.0,0.0
29888,2,9888,[405   1 245 286 135],280,3,44823,4.532611993123672,0.0,20.0
29889,2,9889,[ 25 196 245 161 183],593,3,44826,4.532457027300303,0.0,0.0
29890,2,9890,[655 117 216 172  12],457,5,44831,4.532504296835507,0.0,0.0
29891,2,9891,[318 427 496 357 257],330,5,44836,4.532551556813587,60.0,0.0
29892,2,9892,[318 427 496 357 257],330,5,44841,4.532598807237441,60.0,0.0
29893,2,9893,[318 427 496 357 257],716,5,44846,4.5326460481099655,60.0,0.0
29894,2,9894,[318 427 496 357 257],796,5,44851,4.532693279434057,60.0,0.0
29895,2,9895,[318 427 496 357 257],330,5,44856,4.532740501212611,60.0,0.0
29896,2,9896,[318 427 496 357 257],796,5,44861,4.53278771344852,60.0,0.0
29897,2,9897,[318 427 496 357 257],796,5,44866,4.532834916144676,60.0,0.0
29898,2,9898,[318 427 496 357 257],716,5,44871,4.53288210930397,60.0,0.0
29899,2,9899,[318 427 496 357 257],330,5,44876,4.532929292929293,60.0,0.0
29900,2,9900,[318 427 496 357 257],330,5,44881,4.532976467023533,60.0,0.0
29901,2,9901,[318 427 496 357 257],330,5,44886,4.533023631589578,60.0,0.0
29902,2,9902,[318 427 496 357 257],716,5,44891,4.533070786630314,60.0,0.0
29903,2,9903,[318 427 496 357 257],716,5,44896,4.533117932148627,60.0,0.0
29904,2,9904,[318 427 496 357 257],330,5,44901,4.5331650681474,60.0,0.0
29905,2,9905,[153  96  79 111   7],280,5,44906,4.533212194629518,0.0,0.0
29906,2,9906,[318 427 496 357 257],796,5,44911,4.53325931159786,60.0,0.0
29907,2,9907,[318 427 496 357 257],796,5,44916,4.533306419055309,60.0,0.0
29908,2,9908,[385 143 435 234 195],716,3,44919,4.533151680290645,0.0,0.0
29909,2,9909,[318 427 496 357 257],796,5,44924,4.533198789101918,60.0,0.0
29910,2,9910,[318 427 496 357 257],716,5,44929,4.533245888406821,60.0,0.0
29911,2,9911,[318 427 496 357 257],796,5,44934,4.533292978208232,60.0,0.0
29912,2,9912,[318 427 496 357 257],716,5,44939,4.533340058509029,60.0,0.0
29913,2,9913,[318 427 496 357 257],330,5,44944,4.533387129312084,60.0,0.0
29914,2,9914,[318 427 496 357 257],796,5,44949,4.533434190620272,60.0,0.0
29915,2,9915,[318 427 496 357 257],330,5,44954,4.5334812424364666,60.0,0.0
29916,2,9916,[318 427 496 357 257],716,5,44959,4.533528284763538,60.0,0.0
29917,2,9917,[318 427 496 357 257],330,5,44964,4.533575317604356,60.0,0.0
29918,2,9918,[318 427 496 357 257],796,5,44969,4.533622340961791,60.0,0.0
29919,2,9919,[318 427 496 357 257],330,5,44974,4.533669354838709,60.0,0.0
29920,2,9920,[318 427 496 357 257],716,5,44979,4.53371635923798,60.0,0.0
29921,2,9921,[318 427 496 357 257],716,5,44984,4.533763354162467,60.0,0.0
29922,2,9922,[742 276 515 183  69],655,3,44987,4.53360878766502,0.0,0.0
29923,2,9923,[318 427 496 357 257],330,5,44992,4.533655783958081,60.0,0.0
29924,2,9924,[318 427 496 357 257],330,5,44997,4.533702770780857,60.0,0.0
29925,2,9925,[ 22 427 191 180  88],18,4,45001,4.533649002619383,20.0,0.0
29926,2,9926,[318 427 496 357 257],330,5,45006,4.533695980658809,60.0,0.0
29927,2,9927,[318 427 496 357 257],716,5,45011,4.5337429492344885,60.0,0.0
29928,2,9928,[204 328 132 238 173],151,4,45015,4.533689193272233,0.0,0.0
29929,2,9929,[286 180 222  97 282],450,4,45019,4.533635448136959,0.0,20.0
29930,2,9930,[318 427 496 357 257],796,5,45024,4.533682408619474,60.0,0.0
29931,2,9931,[496 191 176 294 174],796,4,45028,4.533628674989932,20.0,0.0
29932,2,9932,[318 427 496 357 257],330,5,45033,4.533675626698883,60.0,0.0
29933,2,9933,[  9 135  70 197 282],280,3,45036,4.533521240185222,0.0,0.0
29934,2,9934,[318 427 496 357 257],716,5,45041,4.533568193256165,60.0,0.0
29935,2,9935,[318 427 496 357 257],796,5,45046,4.533615136876007,60.0,0.0
29936,2,9936,[318 427 496 357 257],796,5,45051,4.533662071047599,60.0,0.0
29937,2,9937,[318 427 496 357 257],330,5,45056,4.5337089957737975,60.0,0.0
29938,2,9938,[318 427 496 357 257],330,5,45061,4.53375591105745,60.0,0.0
29939,2,9939,[597 228 180 161 385],450,5,45066,4.533802816901408,0.0,0.0
29940,2,9940,[385 405 210 222 195],655,0,45066,4.5333467458002215,0.0,0.0
29941,2,9941,[210 151 186 135  12],151,5,45071,4.533393683363508,0.0,0.0
29942,2,9942,[318 427 496 357 257],716,5,45076,4.533440611485467,60.0,0.0
29943,2,9943,[318 427 496 357 257],716,5,45081,4.533487530168946,60.0,0.0
29944,2,9944,[318  25  28   1 179],457,5,45086,4.533534439416792,20.0,0.0
29945,2,9945,[ 96 603 204 118 135],716,2,45088,4.533279710436356,20.0,0.0
29946,2,9946,[318 427 496 357 257],330,5,45093,4.533326631145069,60.0,0.0
29947,2,9947,[318 427 496 357 257],796,5,45098,4.533373542420587,60.0,0.0
29948,2,9948,[318 427 496 357 257],330,5,45103,4.533420444265755,60.0,0.0
29949,2,9949,[318 427 496 357 257],716,5,45108,4.533467336683417,60.0,0.0
29950,2,9950,[ 71   4 202  69  96],796,5,45113,4.533514219676414,0.0,0.0
29951,2,9951,[ 15 194 143  22 294],457,4,45117,4.533460610932476,0.0,0.0
29952,2,9952,[318 427 496 357 257],330,5,45122,4.533507485180348,60.0,0.0
29953,2,9953,[234  69 125 197 174],280,1,45123,4.533152501506932,0.0,0.0
29954,2,9954,[228  11 117 100 269],296,4,45127,4.533098945253641,0.0,20.0
29955,2,9955,[318 427 496 357 257],796,5,45132,4.5331458417034955,60.0,0.0
29956,2,9956,[318 427 496 357 257],716,5,45137,4.533192728733554,60.0,0.0
29957,2,9957,[174 588 117  22 180],716,4,45141,4.533139184575216,0.0,0.0
29958,2,9958,[153 603 111 197 151],389,3,45144,4.532985239481875,20.0,0.0
29959,2,9959,[318 427 496 357 257],716,5,45149,4.533032128514056,60.0,0.0
29960,2,9960,[  4 211 175  56 294],716,3,45152,4.532878225077804,0.0,0.0
29961,2,9961,[318 427 496 357 257],796,5,45157,4.532925115438667,60.0,0.0
29962,2,9962,[318 427 496 357 257],796,5,45162,4.532971996386631,60.0,0.0
29963,2,9963,[237 121 508 181 257],839,0,45162,4.532517061421116,0.0,0.0
29964,2,9964,[318 427 496 357 257],796,5,45167,4.5325639739086805,60.0,0.0
29965,2,9965,[318 427 496 357 257],716,5,45172,4.532610876981738,60.0,0.0
29966,2,9966,[318 427 496 357 257],330,5,45177,4.532657770643122,60.0,0.0
29967,2,9967,[318 427 496 357 257],796,5,45182,4.532704654895666,60.0,0.0
29968,2,9968,[318 427 496 357 257],796,5,45187,4.5327515297422005,60.0,0.0
29969,2,9969,[318 427 496 357 257],716,5,45192,4.532798395185557,60.0,0.0
29970,2,9970,[318 427 496 357 257],330,5,45197,4.532845251228562,60.0,0.0
29971,2,9971,[318 427 496 357 257],716,5,45202,4.532892097874047,60.0,0.0
29972,2,9972,[211  89 276 475 143],655,3,45205,4.53273839366289,0.0,0.0
29973,2,9973,[318 427 496 357 257],330,5,45210,4.5327852416282335,60.0,0.0
29974,2,9974,[318 427 496 357 257],330,5,45215,4.532832080200501,60.0,0.0
29975,2,9975,[318 427 496 357 257],716,5,45220,4.532878909382518,60.0,0.0
29976,2,9976,[318 427 496 357 257],716,5,45225,4.532925729177108,60.0,0.0
29977,2,9977,[318 427 496 357 257],716,5,45230,4.5329725395870915,60.0,0.0
29978,2,9978,[183  22 202 153  82],796,4,45234,4.532919130173364,0.0,0.0
29979,2,9979,[318 427 496 357 257],716,5,45239,4.532965931863727,60.0,0.0
29980,2,9980,[318 427 496 357 257],330,5,45244,4.533012724175935,60.0,0.0
29981,2,9981,[271 181  95 197 211],796,3,45247,4.532859146463634,0.0,0.0
29982,2,9982,[176 257 288 222 196],457,4,45251,4.532805769808674,0.0,0.0
29983,2,9983,[318 427 496 357 257],330,5,45256,4.532852564102564,60.0,0.0
29984,2,9984,[318 427 496 357 257],330,5,45261,4.532899349023535,60.0,0.0
29985,2,9985,[318 427 496 357 257],330,5,45266,4.532946124574404,60.0,0.0
29986,2,9986,[318 427 496 357 257],796,5,45271,4.532992890757986,60.0,0.0
29987,2,9987,[ 70 111   7 313 483],450,4,45275,4.532939527432919,0.0,0.0
29988,2,9988,[197 153 333  69 405],655,0,45275,4.5324857343077385,0.0,0.0
29989,2,9989,[318 427 496 357 257],796,5,45280,4.5325325325325325,60.0,0.0
29990,2,9990,[318 427 496 357 257],796,5,45285,4.5325793213892505,60.0,0.0
29991,2,9991,[318 427 496 357 257],330,5,45290,4.532626100880704,60.0,0.0
29992,2,9992,[318 427 496 357 257],716,5,45295,4.532672871009707,60.0,0.0
29993,2,9993,[318 427 496 357 257],796,5,45300,4.5327196317790674,60.0,0.0
29994,2,9994,[318 427 496 357 257],796,5,45305,4.532766383191595,60.0,0.0
29995,2,9995,[235 204 588 318  64],330,5,45310,4.5328131252501,40.0,0.0
29996,2,9996,[318 427 496 357 257],330,5,45315,4.532859857957387,60.0,0.0
29997,2,9997,[118  64  70 222 196],344,3,45318,4.5327065413082614,20.0,0.0
29998,2,9998,[318 427 496 357 257],330,5,45323,4.532753275327533,60.0,0.0
29999,2,9999,[655 173 196 357   7],23,2,45325,4.5325,0.0,0.0
30000,3,0,[273 286 215  22 301],450,4,4,4.0,0.0,20.0
30001,3,1,[286 215  22 301 273],655,1,5,2.5,0.0,20.0
30002,3,2,[273 286 215  22 301],655,1,6,2.0,0.0,20.0
30003,3,3,[273 286 215  22 301],655,1,7,1.75,0.0,20.0
30004,3,4,[273 286 215  22 301],450,4,11,2.2,0.0,20.0
30005,3,5,[273 286 215  22 301],796,2,13,2.1666666666666665,0.0,20.0
30006,3,6,[273 215  22 286 301],344,2,15,2.142857142857143,0.0,20.0
30007,3,7,[273 215  22 301 286],796,2,17,2.125,0.0,20.0
30008,3,8,[273 215  22 301 286],796,2,19,2.111111111111111,0.0,20.0
30009,3,9,[215  22 273 301 286],344,2,21,2.1,0.0,20.0
30010,3,10,[273 215  22 301 286],450,4,25,2.272727272727273,0.0,20.0
30011,3,11,[215  22 301 273 286],344,2,27,2.25,0.0,20.0
30012,3,12,[ 11 300 237  56  71],535,3,30,2.3076923076923075,0.0,0.0
30013,3,13,[237  11  71 273 301],450,3,33,2.357142857142857,0.0,0.0
30014,3,14,[  7 173 276 195  15],629,4,37,2.466666666666667,0.0,0.0
30015,3,15,[ 22 282 294 405 235],280,2,39,2.4375,0.0,0.0
30016,3,16,[173  11  15 235 276],269,1,40,2.3529411764705883,0.0,0.0
30017,3,17,[276 237 195  11  22],280,3,43,2.388888888888889,0.0,0.0
30018,3,18,[276  11 237  22 301],655,1,44,2.3157894736842106,0.0,0.0
30019,3,19,[276  11  22 173 301],629,3,47,2.35,0.0,0.0
30020,3,20,[276 173  22  11  15],269,1,48,2.2857142857142856,0.0,0.0
30021,3,21,[276  22 173 235 195],269,1,49,2.227272727272727,0.0,0.0
30022,3,22,[276  22 237  71 215],344,1,50,2.1739130434782608,0.0,0.0
30023,3,23,[276  22 301 273 215],655,2,52,2.1666666666666665,0.0,0.0
30024,3,24,[603 237 175 180 427],18,3,55,2.2,40.0,0.0
30025,3,25,[294  25 237 318 258],450,4,59,2.269230769230769,20.0,0.0
30026,3,26,[276 175 427 180 318],269,4,63,2.3333333333333335,40.0,0.0
30027,3,27,[276 175 427 318 258],655,3,66,2.357142857142857,40.0,0.0
30028,3,28,[276 427 318 175 273],655,4,70,2.413793103448276,40.0,0.0
30029,3,29,[276 427 318 273 175],655,4,74,2.466666666666667,40.0,0.0
30030,3,30,[183 237  89 276 161],786,4,78,2.5161290322580645,0.0,0.0
30031,3,31,[405 195 496 186  88],796,4,82,2.5625,20.0,0.0
30032,3,32,[427 496  89 318 161],796,5,87,2.6363636363636362,60.0,0.0
30033,3,33,[427 496  89 318 161],796,5,92,2.7058823529411766,60.0,0.0
30034,3,34,[151 173 180 144 215],716,3,95,2.7142857142857144,0.0,0.0
30035,3,35,[427 496  89 318 161],450,5,100,2.7777777777777777,60.0,0.0
30036,3,36,[427 496  89 318 161],269,3,103,2.7837837837837838,60.0,0.0
30037,3,37,[427 496 318 183  88],269,3,106,2.789473684210526,60.0,0.0
30038,3,38,[427 496 318 151 276],18,4,110,2.8205128205128207,60.0,0.0
30039,3,39,[427 496 318 276  89],269,4,114,2.85,60.0,0.0
30040,3,40,[427 496 318 276 161],269,4,118,2.8780487804878048,60.0,0.0
30041,3,41,[427 496 318 276  89],18,4,122,2.9047619047619047,60.0,0.0
30042,3,42,[655  25 603 678 328],401,3,125,2.9069767441860463,20.0,0.0
30043,3,43,[211  70 191 132 222],151,4,129,2.9318181818181817,0.0,0.0
30044,3,44,[ 70 211 328 222 427],450,4,133,2.9555555555555557,20.0,0.0
30045,3,45,[385 655 403 435 603],655,1,134,2.9130434782608696,20.0,0.0
30046,3,46,[ 70 211 328 427 318],65,4,138,2.9361702127659575,40.0,0.0
30047,3,47,[211 328 427 318 132],236,4,142,2.9583333333333335,40.0,0.0
30048,3,48,[328 427 318 132 496],450,5,147,3.0,60.0,0.0
30049,3,49,[328 427 318 132 496],151,4,151,3.02,60.0,0.0
30050,3,50,[427 318 132 496 276],535,4,155,3.0392156862745097,60.0,0.0
30051,3,51,[427 318 132 496 276],18,5,160,3.076923076923077,60.0,0.0
30052,3,52,[427 318 132 496 276],18,5,165,3.1132075471698113,60.0,0.0
30053,3,53,[427 318 132 496 276],535,4,169,3.1296296296296298,60.0,0.0
30054,3,54,[385 161 237  56 238],796,4,173,3.1454545454545455,0.0,0.0
30055,3,55,[273 568 195   7 435],450,4,177,3.1607142857142856,0.0,0.0
30056,3,56,[496 132 318 568 427],269,4,181,3.175438596491228,60.0,0.0
30057,3,57,[496 132 318 427 276],269,5,186,3.206896551724138,60.0,0.0
30058,3,58,[196 748 228 323 568],798,3,189,3.2033898305084745,0.0,0.0
30059,3,59,[748 427 318 323 132],796,4,193,3.216666666666667,40.0,0.0
30060,3,60,[748 496 427 318 132],796,5,198,3.2459016393442623,60.0,0.0
30061,3,61,[294  12  79 228 276],280,3,201,3.2419354838709675,0.0,0.0
30062,3,62,[748 427 318 496  79],796,5,206,3.2698412698412698,60.0,0.0
30063,3,63,[748 427 318 496  79],151,4,210,3.28125,60.0,0.0
30064,3,64,[427 318 496  79 132],503,5,215,3.3076923076923075,60.0,0.0
30065,3,65,[427 318 496  79 132],796,5,220,3.3333333333333335,60.0,0.0
30066,3,66,[427 318 496  79 132],151,5,225,3.3582089552238807,60.0,0.0
30067,3,67,[427 318 496  79 132],18,5,230,3.3823529411764706,60.0,0.0
30068,3,68,[496   4  96 111 173],280,3,233,3.3768115942028984,20.0,0.0
30069,3,69,[111  79 132 496  12],450,5,238,3.4,20.0,0.0
30070,3,70,[234 588 483 180 294],450,3,241,3.3943661971830985,0.0,0.0
30071,3,71,[111  79 132 588  12],796,5,246,3.4166666666666665,0.0,0.0
30072,3,72,[678  71 143 300  98],504,5,251,3.4383561643835616,0.0,0.0
30073,3,73,[ 79 111 132 588  98],457,4,255,3.445945945945946,0.0,0.0
30074,3,74,[  7  50 172 276 318],535,3,258,3.44,20.0,20.0
30075,3,75,[ 12 427 496 143 132],151,5,263,3.460526315789474,40.0,0.0
30076,3,76,[ 12 427 496 143 132],450,5,268,3.4805194805194803,40.0,0.0
30077,3,77,[ 12 427 496 143 132],450,5,273,3.5,40.0,0.0
30078,3,78,[ 12 427 496 143 132],450,5,278,3.518987341772152,40.0,0.0
30079,3,79,[ 12 427 496 143 132],796,5,283,3.5375,40.0,0.0
30080,3,80,[ 12 427 496 143 132],796,5,288,3.5555555555555554,40.0,0.0
30081,3,81,[ 12 427 496 143 132],151,5,293,3.573170731707317,40.0,0.0
30082,3,82,[ 12 427 496 143 132],18,5,298,3.5903614457831323,40.0,0.0
30083,3,83,[ 12 427 496 143 132],151,5,303,3.607142857142857,40.0,0.0
30084,3,84,[ 12 427 496 143 132],151,5,308,3.623529411764706,40.0,0.0
30085,3,85,[ 12 427 496 143 132],796,5,313,3.63953488372093,40.0,0.0
30086,3,86,[ 12 427 496 143 132],450,5,318,3.6551724137931036,40.0,0.0
30087,3,87,[ 12 427 496 143 132],450,5,323,3.6704545454545454,40.0,0.0
30088,3,88,[ 12 427 496 143 132],796,5,328,3.6853932584269664,40.0,0.0
30089,3,89,[ 12 427 496 143 132],796,5,333,3.7,40.0,0.0
30090,3,90,[ 12 427 496 143 132],796,5,338,3.7142857142857144,40.0,0.0
30091,3,91,[ 12 427 496 143 132],18,5,343,3.7282608695652173,40.0,0.0
30092,3,92,[ 12 427 496 143 132],18,5,348,3.7419354838709675,40.0,0.0
30093,3,93,[ 12 427 496 143 132],18,5,353,3.75531914893617,40.0,0.0
30094,3,94,[ 12 427 496 143 132],577,4,357,3.7578947368421054,40.0,0.0
30095,3,95,[ 12 427 496 132  79],503,4,361,3.7604166666666665,40.0,0.0
30096,3,96,[318 427 496 132  79],450,5,366,3.7731958762886597,60.0,0.0
30097,3,97,[318 427 496 132  79],535,4,370,3.7755102040816326,60.0,0.0
30098,3,98,[318  50 496 132  98],577,5,375,3.787878787878788,40.0,20.0
30099,3,99,[318  50 496 132  98],503,5,380,3.8,40.0,20.0
30100,3,100,[318  50 496 132  98],786,5,385,3.8118811881188117,40.0,20.0
30101,3,101,[318  50 496 132  98],503,5,390,3.823529411764706,40.0,20.0
30102,3,102,[318  50 496 132  98],786,5,395,3.8349514563106797,40.0,20.0
30103,3,103,[318  50 496 132  98],503,5,400,3.8461538461538463,40.0,20.0
30104,3,104,[318  50 496 132  98],535,4,404,3.8476190476190477,40.0,20.0
30105,3,105,[318  50 496 132 427],503,5,409,3.858490566037736,60.0,20.0
30106,3,106,[318  50 496 132 427],236,3,412,3.850467289719626,60.0,20.0
30107,3,107,[318 427 132  96 588],450,5,417,3.861111111111111,40.0,0.0
30108,3,108,[318 427 132  96 588],807,4,421,3.8623853211009176,40.0,0.0
30109,3,109,[318 427 588 132 496],807,5,426,3.8727272727272726,60.0,0.0
30110,3,110,[471  82 135 323 405],280,1,427,3.8468468468468466,0.0,0.0
30111,3,111,[427 135 588 318 132],716,4,431,3.8482142857142856,40.0,0.0
30112,3,112,[427 588 318 132 496],716,5,436,3.8584070796460175,60.0,0.0
30113,3,113,[427 588 318 132 496],807,5,441,3.8684210526315788,60.0,0.0
30114,3,114,[427 588 318 132 496],18,5,446,3.878260869565217,60.0,0.0
30115,3,115,[427 588 318 132 496],450,5,451,3.8879310344827585,60.0,0.0
30116,3,116,[427 588 318 132 496],450,5,456,3.8974358974358974,60.0,0.0
30117,3,117,[427 588 318 132 496],716,5,461,3.906779661016949,60.0,0.0
30118,3,118,[427 588 318 132 496],807,5,466,3.9159663865546217,60.0,0.0
30119,3,119,[427 588 318 132 496],716,5,471,3.925,60.0,0.0
30120,3,120,[427 588 318 132 496],807,5,476,3.9338842975206614,60.0,0.0
30121,3,121,[427 588 318 132 496],450,5,481,3.942622950819672,60.0,0.0
30122,3,122,[427 588 318 132 496],450,5,486,3.951219512195122,60.0,0.0
30123,3,123,[127 197 186 568  28],450,4,490,3.9516129032258065,0.0,20.0
30124,3,124,[127 318 197 427  28],655,3,493,3.944,40.0,20.0
30125,3,125,[127 132 588 427 318],18,5,498,3.9523809523809526,40.0,20.0
30126,3,126,[127 132 588 427 318],807,4,502,3.952755905511811,40.0,20.0
30127,3,127,[427 588 318 132 496],450,5,507,3.9609375,60.0,0.0
30128,3,128,[427 588 318 132 496],330,5,512,3.9689922480620154,60.0,0.0
30129,3,129,[427 588 318 132 496],577,5,517,3.976923076923077,60.0,0.0
30130,3,130,[427 588 318 132 496],450,5,522,3.984732824427481,60.0,0.0
30131,3,131,[427 588 318 132 496],18,5,527,3.992424242424242,60.0,0.0
30132,3,132,[427 588 318 132 496],330,5,532,4.0,60.0,0.0
30133,3,133,[427 588 318 132 496],807,5,537,4.007462686567164,60.0,0.0
30134,3,134,[427 588 318 132 496],796,5,542,4.014814814814815,60.0,0.0
30135,3,135,[427 588 318 132 496],330,5,547,4.022058823529412,60.0,0.0
30136,3,136,[427 588 318 132 496],450,5,552,4.029197080291971,60.0,0.0
30137,3,137,[427 588 318 132 496],716,5,557,4.036231884057971,60.0,0.0
30138,3,138,[427 588 318 132 496],807,5,562,4.043165467625899,60.0,0.0
30139,3,139,[427 588 318 132 496],450,5,567,4.05,60.0,0.0
30140,3,140,[427 588 318 132 496],807,5,572,4.056737588652482,60.0,0.0
30141,3,141,[427 588 318 132 496],450,5,577,4.063380281690141,60.0,0.0
30142,3,142,[427 588 318 132 496],796,5,582,4.06993006993007,60.0,0.0
30143,3,143,[427 588 318 132 496],330,5,587,4.076388888888889,60.0,0.0
30144,3,144,[427 588 318 132 496],577,5,592,4.082758620689655,60.0,0.0
30145,3,145,[427 588 318 132 496],577,5,597,4.089041095890411,60.0,0.0
30146,3,146,[427 588 318 132 496],807,5,602,4.095238095238095,60.0,0.0
30147,3,147,[427 588 318 132 496],18,5,607,4.101351351351352,60.0,0.0
30148,3,148,[427 588 318 132 496],18,5,612,4.10738255033557,60.0,0.0
30149,3,149,[183 121  82  64 655],457,5,617,4.113333333333333,20.0,0.0
30150,3,150,[427 588 132 121 318],450,4,621,4.112582781456954,40.0,0.0
30151,3,151,[125 282 301 313 174],593,5,626,4.118421052631579,0.0,0.0
30152,3,152,[174 318 588 132  64],796,5,631,4.124183006535947,40.0,0.0
30153,3,153,[174 318 588 132  64],450,5,636,4.12987012987013,40.0,0.0
30154,3,154,[174 318 588 132  64],577,5,641,4.135483870967742,40.0,0.0
30155,3,155,[174 318 588 132  64],577,5,646,4.141025641025641,40.0,0.0
30156,3,156,[174 318 588 132  64],316,3,649,4.13375796178344,40.0,0.0
30157,3,157,[132 318 313  64 427],236,5,654,4.139240506329114,60.0,0.0
30158,3,158,[132 318 313  64 427],796,5,659,4.144654088050315,60.0,0.0
30159,3,159,[ 70 200 294 153  25],450,3,662,4.1375,0.0,0.0
30160,3,160,[318  64 125 153 313],450,5,667,4.142857142857143,40.0,0.0
30161,3,161,[289   9 143 180 318],693,2,669,4.12962962962963,20.0,0.0
30162,3,162,[318  64 125 153 313],450,5,674,4.134969325153374,40.0,0.0
30163,3,163,[483 268 228 211 172],655,2,676,4.121951219512195,0.0,0.0
30164,3,164,[318  64 125 153 313],796,5,681,4.127272727272727,40.0,0.0
30165,3,165,[318  64 125 153 313],450,5,686,4.132530120481928,40.0,0.0
30166,3,166,[318  64 125 153 313],655,3,689,4.125748502994012,40.0,0.0
30167,3,167,[318 132 313  64 427],236,5,694,4.130952380952381,60.0,0.0
30168,3,168,[318 132 313  64 427],655,4,698,4.1301775147929,60.0,0.0
30169,3,169,[318  64 313 427 132],693,4,702,4.129411764705883,60.0,0.0
30170,3,170,[318 313 427 132 496],450,5,707,4.1345029239766085,60.0,0.0
30171,3,171,[318 313 427 132 496],796,5,712,4.1395348837209305,60.0,0.0
30172,3,172,[318 313 427 132 496],236,4,716,4.138728323699422,60.0,0.0
30173,3,173,[318 313 427 132 496],807,5,721,4.14367816091954,60.0,0.0
30174,3,174,[318 313 427 132 496],450,5,726,4.148571428571429,60.0,0.0
30175,3,175,[318 313 427 132 496],796,5,731,4.153409090909091,60.0,0.0
30176,3,176,[318 313 427 132 496],807,5,736,4.15819209039548,60.0,0.0
30177,3,177,[195  22 127 222 132],807,3,739,4.151685393258427,0.0,20.0
30178,3,178,[313 318 427 132 496],503,5,744,4.156424581005586,60.0,0.0
30179,3,179,[313 318 427 132 496],807,5,749,4.161111111111111,60.0,0.0
30180,3,180,[313 318 427 132 496],807,5,754,4.165745856353591,60.0,0.0
30181,3,181,[313 318 427 132 496],236,4,758,4.164835164835165,60.0,0.0
30182,3,182,[313 318 427 132 588],796,5,763,4.169398907103825,40.0,0.0
30183,3,183,[313 318 427 132 588],450,5,768,4.173913043478261,40.0,0.0
30184,3,184,[313 318 427 132 588],807,5,773,4.178378378378379,40.0,0.0
30185,3,185,[313 318 427 132 588],807,5,778,4.182795698924731,40.0,0.0
30186,3,186,[313 318 427 132 588],835,4,782,4.181818181818182,40.0,0.0
30187,3,187,[313 318 427 132 496],503,5,787,4.1861702127659575,60.0,0.0
30188,3,188,[313 318 427 132 496],503,5,792,4.190476190476191,60.0,0.0
30189,3,189,[313 318 427 132 496],450,5,797,4.1947368421052635,60.0,0.0
30190,3,190,[313 318 427 132 496],807,5,802,4.198952879581152,60.0,0.0
30191,3,191,[313 318 427 132 496],796,5,807,4.203125,60.0,0.0
30192,3,192,[313 318 427 132 496],577,5,812,4.2072538860103625,60.0,0.0
30193,3,193,[313 318 427 132 496],236,4,816,4.206185567010309,60.0,0.0
30194,3,194,[ 98 357 186 117  22],796,4,820,4.205128205128205,0.0,0.0
30195,3,195,[117 427 318 313 357],655,4,824,4.204081632653061,40.0,0.0
30196,3,196,[313 318 357 427 132],835,5,829,4.208121827411167,40.0,0.0
30197,3,197,[313 318 357 427 132],693,5,834,4.212121212121212,40.0,0.0
30198,3,198,[313 318 357 427 132],450,5,839,4.21608040201005,40.0,0.0
30199,3,199,[313 318 357 427 132],693,5,844,4.22,40.0,0.0
30200,3,200,[313 318 357 427 132],693,5,849,4.223880597014926,40.0,0.0
30201,3,201,[313 318 357 427 132],655,4,853,4.2227722772277225,40.0,0.0
30202,3,202,[313 318 357 427 132],450,5,858,4.226600985221675,40.0,0.0
30203,3,203,[173 435  79 185  56],535,3,861,4.220588235294118,0.0,0.0
30204,3,204,[357 318 427 185 313],796,5,866,4.224390243902439,40.0,0.0
30205,3,205,[357 318 427 185 313],693,5,871,4.228155339805825,40.0,0.0
30206,3,206,[357 318 427 185 313],693,5,876,4.231884057971015,40.0,0.0
30207,3,207,[357 318 427 185 313],693,5,881,4.235576923076923,40.0,0.0
30208,3,208,[357 318 427 185 313],796,5,886,4.239234449760765,40.0,0.0
30209,3,209,[357 318 427 185 313],450,5,891,4.242857142857143,40.0,0.0
30210,3,210,[357 318 427 185 313],796,5,896,4.246445497630332,40.0,0.0
30211,3,211,[357 318 427 185 313],693,5,901,4.25,40.0,0.0
30212,3,212,[265 403 197 294 161],280,2,903,4.23943661971831,0.0,0.0
30213,3,213,[185 318 357 427 265],316,3,906,4.233644859813084,40.0,0.0
30214,3,214,[210  70 125 471 655],786,5,911,4.2372093023255815,0.0,0.0
30215,3,215,[357 318 427 313 210],942,4,915,4.236111111111111,40.0,0.0
30216,3,216,[357 318 427 210 132],269,4,919,4.235023041474655,40.0,0.0
30217,3,217,[357 318 427 132 313],835,5,924,4.238532110091743,40.0,0.0
30218,3,218,[357 318 427 132 313],693,5,929,4.242009132420091,40.0,0.0
30219,3,219,[357 318 427 132 313],655,4,933,4.240909090909091,40.0,0.0
30220,3,220,[357 318 427 313 132],796,5,938,4.244343891402715,40.0,0.0
30221,3,221,[357 318 427 313 132],655,4,942,4.243243243243243,40.0,0.0
30222,3,222,[357 318 427 313 132],450,5,947,4.246636771300448,40.0,0.0
30223,3,223,[357 318 427 313 132],796,5,952,4.25,40.0,0.0
30224,3,224,[357 318 427 313 132],693,5,957,4.253333333333333,40.0,0.0
30225,3,225,[357 318 427 313 132],693,5,962,4.256637168141593,40.0,0.0
30226,3,226,[357 318 427 313 132],796,5,967,4.259911894273127,40.0,0.0
30227,3,227,[265 385  64  71 176],577,5,972,4.2631578947368425,20.0,0.0
30228,3,228,[176 357 427 318 313],796,5,977,4.2663755458515285,40.0,0.0
30229,3,229,[176 357 427 318 313],835,5,982,4.269565217391304,40.0,0.0
30230,3,230,[228 385   4 405 323],796,4,986,4.268398268398268,0.0,0.0
30231,3,231,[176 318 357 427 313],835,5,991,4.271551724137931,40.0,0.0
30232,3,232,[176 318 357 427 313],693,4,995,4.2703862660944205,40.0,0.0
30233,3,233,[318 427 357 313 132],450,5,1000,4.273504273504273,40.0,0.0
30234,3,234,[318 427 357 313 132],796,5,1005,4.276595744680851,40.0,0.0
30235,3,235,[ 97 237  15 427 172],236,4,1009,4.27542372881356,20.0,0.0
30236,3,236,[357 427 318  97 313],942,4,1013,4.274261603375527,40.0,0.0
30237,3,237,[357 427 318  97 132],796,4,1017,4.273109243697479,40.0,0.0
30238,3,238,[357 427 318 132 313],796,5,1022,4.2761506276150625,40.0,0.0
30239,3,239,[357 427 318 132 313],450,5,1027,4.279166666666667,40.0,0.0
30240,3,240,[357 427 318 132 313],693,5,1032,4.282157676348548,40.0,0.0
30241,3,241,[357 427 318 132 313],450,5,1037,4.285123966942149,40.0,0.0
30242,3,242,[238 117 195 294  88],716,4,1041,4.283950617283951,0.0,0.0
30243,3,243,[318 357 427 132 313],693,5,1046,4.286885245901639,40.0,0.0
30244,3,244,[318 357 427 132 313],655,4,1050,4.285714285714286,40.0,0.0
30245,3,245,[318 357 427 313 132],655,4,1054,4.284552845528455,40.0,0.0
30246,3,246,[318 357 427 313 496],796,5,1059,4.287449392712551,60.0,0.0
30247,3,247,[318 357 427 313 496],796,5,1064,4.290322580645161,60.0,0.0
30248,3,248,[318 357 427 313 496],942,4,1068,4.289156626506024,60.0,0.0
30249,3,249,[318 357 427 496 588],796,5,1073,4.292,60.0,0.0
30250,3,250,[275  56  71 568 313],796,5,1078,4.294820717131474,0.0,20.0
30251,3,251,[275 318 427 357 496],151,5,1083,4.2976190476190474,60.0,20.0
30252,3,252,[275 318 427 357 496],18,5,1088,4.300395256916996,60.0,20.0
30253,3,253,[153 144 271 143 100],796,4,1092,4.299212598425197,0.0,20.0
30254,3,254,[ 12 187 174 172 200],629,5,1097,4.301960784313725,0.0,0.0
30255,3,255,[ 70  15 211 196 204],269,1,1098,4.2890625,0.0,0.0
30256,3,256,[318 357 427 271 187],655,4,1102,4.287937743190661,40.0,0.0
30257,3,257,[275 357 187 318 427],450,5,1107,4.290697674418604,40.0,20.0
30258,3,258,[ 79 234  56 423 405],796,4,1111,4.289575289575289,0.0,0.0
30259,3,259,[275 357 187 427 423],18,5,1116,4.292307692307692,20.0,20.0
30260,3,260,[275 357 187 427 423],796,5,1121,4.295019157088123,20.0,20.0
30261,3,261,[275 357 187 427 423],18,5,1126,4.297709923664122,20.0,20.0
30262,3,262,[275 357 187 427 423],535,3,1129,4.2927756653992395,20.0,20.0
30263,3,263,[275 427 423 318 357],535,4,1133,4.291666666666667,40.0,20.0
30264,3,264,[275 427 423 318 496],796,5,1138,4.29433962264151,60.0,20.0
30265,3,265,[275 427 423 318 496],18,5,1143,4.296992481203008,60.0,20.0
30266,3,266,[275 427 423 318 496],18,5,1148,4.299625468164794,60.0,20.0
30267,3,267,[275 427 423 318 496],330,5,1153,4.302238805970149,60.0,20.0
30268,3,268,[161 603 294 258 423],655,1,1154,4.289962825278811,20.0,0.0
30269,3,269,[282  69 403 127 471],450,5,1159,4.292592592592593,0.0,20.0
30270,3,270,[275 427 318  69 496],450,5,1164,4.295202952029521,60.0,20.0
30271,3,271,[275 427 318  69 496],330,5,1169,4.297794117647059,60.0,20.0
30272,3,272,[275 427 318  69 496],450,5,1174,4.3003663003663,60.0,20.0
30273,3,273,[275 427 318  69 496],236,3,1177,4.295620437956204,60.0,20.0
30274,3,274,[427 318  69 357 588],716,5,1182,4.298181818181818,40.0,0.0
30275,3,275,[427 318  69 357 588],316,3,1185,4.293478260869565,40.0,0.0
30276,3,276,[427 318 357 313 132],796,5,1190,4.296028880866426,40.0,0.0
30277,3,277,[ 50 282 405  82  79],256,4,1194,4.294964028776978,0.0,20.0
30278,3,278,[427 318 357 313 132],450,5,1199,4.297491039426523,40.0,0.0
30279,3,279,[427 318 357 313 132],655,4,1203,4.296428571428572,40.0,0.0
30280,3,280,[427 318 357 313  12],693,5,1208,4.298932384341637,40.0,0.0
30281,3,281,[427 318 357 313  12],655,4,1212,4.297872340425532,40.0,0.0
30282,3,282,[427 318 357 313 496],450,5,1217,4.30035335689046,60.0,0.0
30283,3,283,[427 318 357 313 496],796,5,1222,4.302816901408451,60.0,0.0
30284,3,284,[427 318 357 313 496],796,5,1227,4.3052631578947365,60.0,0.0
30285,3,285,[427 318 357 313 496],450,5,1232,4.3076923076923075,60.0,0.0
30286,3,286,[  1 385  71  89 121],796,4,1236,4.306620209059234,0.0,0.0
30287,3,287,[427 318 357 313 496],796,5,1241,4.309027777777778,60.0,0.0
30288,3,288,[427 318 357 313 496],796,5,1246,4.311418685121107,60.0,0.0
30289,3,289,[427 318 357 313 496],450,5,1251,4.313793103448276,60.0,0.0
30290,3,290,[427 318 357 313 496],942,4,1255,4.312714776632302,60.0,0.0
30291,3,291,[427 318 357 496 313],450,5,1260,4.315068493150685,60.0,0.0
30292,3,292,[427 318 357 496 313],942,4,1264,4.313993174061434,60.0,0.0
30293,3,293,[427 318 357 496 143],269,4,1268,4.312925170068027,60.0,0.0
30294,3,294,[427 318 357 496 132],716,5,1273,4.315254237288135,60.0,0.0
30295,3,295,[427 318 357 496 132],269,5,1278,4.3175675675675675,60.0,0.0
30296,3,296,[427 318 357 496 132],796,5,1283,4.31986531986532,60.0,0.0
30297,3,297,[427 318 357 496 132],151,5,1288,4.322147651006712,60.0,0.0
30298,3,298,[427 318 357 496 132],330,5,1293,4.3244147157190636,60.0,0.0
30299,3,299,[427 318 357 496 132],18,5,1298,4.326666666666667,60.0,0.0
30300,3,300,[427 318 357 496 132],535,4,1302,4.325581395348837,60.0,0.0
30301,3,301,[427 318 496 357 132],18,5,1307,4.327814569536423,60.0,0.0
30302,3,302,[427 318 496 357 132],796,5,1312,4.33003300330033,60.0,0.0
30303,3,303,[427 318 496 357 132],450,5,1317,4.332236842105263,60.0,0.0
30304,3,304,[427 318 496 357 132],716,5,1322,4.334426229508197,60.0,0.0
30305,3,305,[125 161   4 546  15],577,3,1325,4.330065359477124,0.0,0.0
30306,3,306,[427 318 496 357 132],535,4,1329,4.328990228013029,60.0,0.0
30307,3,307,[427 318 496 132 357],716,5,1334,4.3311688311688314,60.0,0.0
30308,3,308,[427 318 496 132 357],535,4,1338,4.330097087378641,60.0,0.0
30309,3,309,[427 318 496 132 313],807,5,1343,4.332258064516129,60.0,0.0
30310,3,310,[427 318 496 132 313],577,5,1348,4.334405144694534,60.0,0.0
30311,3,311,[427 318 496 132 313],807,5,1353,4.336538461538462,60.0,0.0
30312,3,312,[427 318 496 132 313],807,5,1358,4.338658146964856,60.0,0.0
30313,3,313,[427 318 496 132 313],796,5,1363,4.340764331210191,60.0,0.0
30314,3,314,[427 318 496 132 313],577,5,1368,4.3428571428571425,60.0,0.0
30315,3,315,[427 318 496 132 313],450,5,1373,4.344936708860759,60.0,0.0
30316,3,316,[427 318 496 132 313],796,5,1378,4.347003154574132,60.0,0.0
30317,3,317,[427 318 496 132 313],807,5,1383,4.349056603773585,60.0,0.0
30318,3,318,[427 318 496 132 313],503,5,1388,4.351097178683386,60.0,0.0
30319,3,319,[427 318 496 132 313],807,5,1393,4.353125,60.0,0.0
30320,3,320,[302 143  11 172 496],269,1,1394,4.342679127725857,20.0,0.0
30321,3,321,[427 318 496 132 313],796,5,1399,4.34472049689441,60.0,0.0
30322,3,322,[427 318 496 132 313],450,5,1404,4.3467492260061915,60.0,0.0
30323,3,323,[427 318 496 132 313],236,4,1408,4.345679012345679,60.0,0.0
30324,3,324,[174 132 172 234 568],389,4,1412,4.344615384615385,0.0,0.0
30325,3,325,[427 318 496 132 313],503,5,1417,4.346625766871166,60.0,0.0
30326,3,326,[427 318 496 132 313],577,5,1422,4.348623853211009,60.0,0.0
30327,3,327,[238 118 385 301 603],151,3,1425,4.344512195121951,20.0,0.0
30328,3,328,[318 427 496 132 313],796,5,1430,4.3465045592705165,60.0,0.0
30329,3,329,[318 427 496 132 313],796,5,1435,4.348484848484849,60.0,0.0
30330,3,330,[318 427 496 132 313],236,4,1439,4.347432024169184,60.0,0.0
30331,3,331,[318 427 132 496 313],807,5,1444,4.349397590361446,60.0,0.0
30332,3,332,[318 427 132 496 313],503,5,1449,4.351351351351352,60.0,0.0
30333,3,333,[318 427 132 496 313],796,5,1454,4.3532934131736525,60.0,0.0
30334,3,334,[655 143 204 202 228],457,5,1459,4.3552238805970145,0.0,0.0
30335,3,335,[427 318 202 132 496],269,4,1463,4.354166666666667,60.0,0.0
30336,3,336,[427 318 132 496 313],807,5,1468,4.356083086053412,60.0,0.0
30337,3,337,[427 318 132 496 313],503,5,1473,4.3579881656804735,60.0,0.0
30338,3,338,[427 318 132 496 313],807,5,1478,4.359882005899705,60.0,0.0
30339,3,339,[427 318 132 496 313],236,4,1482,4.358823529411764,60.0,0.0
30340,3,340,[427 318 132 313 496],577,5,1487,4.360703812316715,60.0,0.0
30341,3,341,[475 228 210 655  22],655,0,1487,4.347953216374269,0.0,0.0
30342,3,342,[135 546  11 322  22],280,5,1492,4.349854227405248,0.0,0.0
30343,3,343,[322 318 427 132 313],450,5,1497,4.351744186046512,40.0,0.0
30344,3,344,[125 196 121 186 282],504,4,1501,4.350724637681159,0.0,0.0
30345,3,345,[427 318 322 132 313],796,4,1505,4.3497109826589595,40.0,0.0
30346,3,346,[427 318 132 313 496],577,5,1510,4.351585014409222,60.0,0.0
30347,3,347,[427 318 132 313 496],807,5,1515,4.353448275862069,60.0,0.0
30348,3,348,[427 318 132 313 496],450,5,1520,4.355300859598854,60.0,0.0
30349,3,349,[427 318 132 313 496],236,4,1524,4.354285714285714,60.0,0.0
30350,3,350,[427 318 132 313 496],807,5,1529,4.356125356125356,60.0,0.0
30351,3,351,[427 318 132 313 496],236,4,1533,4.355113636363637,60.0,0.0
30352,3,352,[427 318 132 313 588],577,5,1538,4.356940509915014,40.0,0.0
30353,3,353,[427 318 132 313 588],796,5,1543,4.358757062146893,40.0,0.0
30354,3,354,[427 318 132 313 588],450,5,1548,4.3605633802816905,40.0,0.0
30355,3,355,[427 318 132 313 588],796,5,1553,4.362359550561798,40.0,0.0
30356,3,356,[427 318 132 313 588],796,5,1558,4.364145658263305,40.0,0.0
30357,3,357,[427 318 132 313 588],450,5,1563,4.365921787709497,40.0,0.0
30358,3,358,[427 318 132 313 588],796,5,1568,4.367688022284122,40.0,0.0
30359,3,359,[427 318 132 313 588],450,5,1573,4.3694444444444445,40.0,0.0
30360,3,360,[196 222 168 183 100],151,3,1576,4.365650969529086,0.0,20.0
30361,3,361,[168 318 427 132 313],503,5,1581,4.367403314917127,40.0,0.0
30362,3,362,[168 318 427 132 313],807,5,1586,4.369146005509642,40.0,0.0
30363,3,363,[168 318 427 132 313],577,5,1591,4.3708791208791204,40.0,0.0
30364,3,364,[168 318 427 132 313],807,5,1596,4.372602739726028,40.0,0.0
30365,3,365,[508  97 427 271 187],655,2,1598,4.366120218579235,20.0,0.0
30366,3,366,[168 318 427 132 313],807,5,1603,4.367847411444142,40.0,0.0
30367,3,367,[168 318 427 132 313],450,5,1608,4.369565217391305,40.0,0.0
30368,3,368,[168 318 427 132 313],796,5,1613,4.3712737127371275,40.0,0.0
30369,3,369,[546 333   4 216  15],796,5,1618,4.372972972972973,0.0,0.0
30370,3,370,[427 168 318 333 216],796,5,1623,4.37466307277628,40.0,0.0
30371,3,371,[322 597 186 603 435],450,4,1627,4.373655913978495,20.0,0.0
30372,3,372,[168 333 597 216 427],796,5,1632,4.375335120643432,20.0,0.0
30373,3,373,[182 186 282 211  95],450,3,1635,4.371657754010696,0.0,0.0
30374,3,374,[182 357 301 235 288],450,3,1638,4.368,0.0,0.0
30375,3,375,[ 95  69 215 216 127],731,4,1642,4.367021276595745,0.0,20.0
30376,3,376,[215 181 282 153 301],655,0,1642,4.355437665782493,0.0,0.0
30377,3,377,[427 318 333 182 168],796,5,1647,4.357142857142857,40.0,0.0
30378,3,378,[427 318 333 182 168],796,5,1652,4.358839050131926,40.0,0.0
30379,3,379,[427 318 333 182 168],796,5,1657,4.360526315789474,40.0,0.0
30380,3,380,[427 318 333 182 168],796,5,1662,4.362204724409449,40.0,0.0
30381,3,381,[185 273 385  88 161],796,4,1666,4.361256544502618,0.0,0.0
30382,3,382,[ 95 588 237 385 200],577,4,1670,4.360313315926893,0.0,0.0
30383,3,383,[216 187 132 222 655],693,2,1672,4.354166666666667,0.0,0.0
30384,3,384,[182 333 597 168 427],796,5,1677,4.355844155844156,20.0,0.0
30385,3,385,[182 333 597 168 427],796,5,1682,4.357512953367876,20.0,0.0
30386,3,386,[182 333 597 168 427],796,5,1687,4.359173126614987,20.0,0.0
30387,3,387,[179 200 182 176   8],269,3,1690,4.355670103092783,0.0,0.0
30388,3,388,[ 64  56  82 200 258],457,5,1695,4.3573264781491,20.0,0.0
30389,3,389,[  4 125 176 161 496],796,5,1700,4.358974358974359,20.0,0.0
30390,3,390,[357 210 132 161 269],655,1,1701,4.350383631713555,0.0,0.0
30391,3,391,[211 235 237  25 204],450,3,1704,4.346938775510204,0.0,0.0
30392,3,392,[427 179 318 182 168],450,5,1709,4.348600508905853,40.0,0.0
30393,3,393,[427 179 318 182 168],535,4,1713,4.347715736040609,40.0,0.0
30394,3,394,[ 15  22  88 508  89],269,1,1714,4.339240506329114,0.0,0.0
30395,3,395,[174 194 288 204 597],450,4,1718,4.338383838383838,0.0,0.0
30396,3,396,[185 132 405  82 195],716,4,1722,4.337531486146096,0.0,0.0
30397,3,397,[427 179 318 194 168],65,4,1726,4.336683417085427,40.0,0.0
30398,3,398,[333 427 318 194 168],796,5,1731,4.338345864661654,40.0,0.0
30399,3,399,[597 174 173  15 275],593,3,1734,4.335,0.0,20.0
30400,3,400,[216 427 318 194 168],269,4,1738,4.334164588528679,40.0,0.0
30401,3,401,[333 427 318 194 168],796,5,1743,4.335820895522388,40.0,0.0
30402,3,402,[  7 118 174 471 238],457,5,1748,4.337468982630273,0.0,0.0
30403,3,403,[427 318 333 194 168],796,5,1753,4.339108910891089,40.0,0.0
30404,3,404,[ 64 568 357  12 143],450,5,1758,4.340740740740741,20.0,0.0
30405,3,405,[427 222 301 211 210],796,2,1760,4.334975369458128,20.0,0.0
30406,3,406,[195 286 313  71 176],280,2,1762,4.329238329238329,0.0,20.0
30407,3,407,[333 318 168 194 427],796,5,1767,4.330882352941177,40.0,0.0
30408,3,408,[228 121  25  22 185],256,4,1771,4.330073349633252,0.0,0.0
30409,3,409,[ 98 117 234 238 144],450,4,1775,4.329268292682927,0.0,0.0
30410,3,410,[  4 144  95 186  25],716,2,1777,4.32360097323601,0.0,0.0
30411,3,411,[132 183 173 235  82],280,2,1779,4.317961165048544,0.0,0.0
30412,3,412,[ 88 176 288 228 100],280,1,1780,4.309927360774818,0.0,20.0
30413,3,413,[333 318 168 427 194],796,5,1785,4.311594202898551,40.0,0.0
30414,3,414,[678 237 273 215 496],344,2,1787,4.306024096385542,20.0,0.0
30415,3,415,[194 333 427 318 168],796,5,1792,4.3076923076923075,40.0,0.0
30416,3,416,[127 121 427 179 403],269,3,1795,4.304556354916067,20.0,20.0
30417,3,417,[174 215 655 403  79],693,3,1798,4.301435406698564,0.0,0.0
30418,3,418,[168 318 427 194 333],796,5,1803,4.3031026252983295,40.0,0.0
30419,3,419,[168 318 427 194 333],796,5,1808,4.304761904761905,40.0,0.0
30420,3,420,[168 318 427 194 333],796,5,1813,4.306413301662708,40.0,0.0
30421,3,421,[168 318 427 194 333],796,5,1818,4.308056872037914,40.0,0.0
30422,3,422,[168 318 427 194 333],796,5,1823,4.309692671394799,40.0,0.0
30423,3,423,[179 182 423 435 144],436,4,1827,4.308962264150943,0.0,0.0
30424,3,424,[333 168 427 194 318],796,5,1832,4.310588235294118,40.0,0.0
30425,3,425,[185 181 655  96   7],655,1,1833,4.302816901408451,0.0,0.0
30426,3,426,[194 427 168 333 318],796,5,1838,4.304449648711944,40.0,0.0
30427,3,427,[194 427 168 333 318],796,5,1843,4.30607476635514,40.0,0.0
30428,3,428,[185 288 191 234 275],450,3,1846,4.303030303030303,0.0,20.0
30429,3,429,[194 427 168 333 318],796,5,1851,4.304651162790698,40.0,0.0
30430,3,430,[194 427 168 333 318],796,5,1856,4.306264501160093,40.0,0.0
30431,3,431,[194 427 168 333 318],796,5,1861,4.30787037037037,40.0,0.0
30432,3,432,[197 275 174 143 100],338,4,1865,4.30715935334873,0.0,40.0
30433,3,433,[742 174 423  25 357],450,4,1869,4.306451612903226,0.0,0.0
30434,3,434,[ 89 403 132 655 234],269,2,1871,4.301149425287356,0.0,0.0
30435,3,435,[742 318 168 427 333],796,4,1875,4.3004587155963305,40.0,0.0
30436,3,436,[427 168 333 318 194],796,5,1880,4.302059496567506,40.0,0.0
30437,3,437,[427 168 333 318 194],796,5,1885,4.30365296803653,40.0,0.0
30438,3,438,[111 496 234  50  22],716,5,1890,4.305239179954442,20.0,20.0
30439,3,439,[427 168 194 318 333],796,5,1895,4.306818181818182,40.0,0.0
30440,3,440,[427 168 194 318 333],796,5,1900,4.308390022675737,40.0,0.0
30441,3,441,[496 245 238 318 403],796,3,1903,4.3054298642533935,40.0,0.0
30442,3,442,[245  95 273 153 197],450,3,1906,4.302483069977427,0.0,0.0
30443,3,443,[238 245 286 216 117],450,5,1911,4.304054054054054,0.0,20.0
30444,3,444,[588 234  98 546  82],786,4,1915,4.303370786516854,0.0,0.0
30445,3,445,[475 111 269 100 144],629,4,1919,4.302690582959642,0.0,20.0
30446,3,446,[ 98  25 135 153 183],450,3,1922,4.299776286353468,0.0,0.0
30447,3,447,[191 180   9 118 181],72,3,1925,4.296875,0.0,0.0
30448,3,448,[ 50 204 211 328 175],151,4,1929,4.296213808463252,0.0,20.0
30449,3,449,[196 127 313  64 183],693,2,1931,4.291111111111111,20.0,20.0
30450,3,450,[313 275 100 328 135],655,3,1934,4.288248337028825,0.0,40.0
30451,3,451,[168 194 427 318 333],796,5,1939,4.289823008849558,40.0,0.0
30452,3,452,[168 194 427 318 333],796,5,1944,4.291390728476821,40.0,0.0
30453,3,453,[ 88 546 435 257 143],716,4,1948,4.290748898678414,0.0,0.0
30454,3,454,[405 151 185 204 471],716,4,1952,4.29010989010989,0.0,0.0
30455,3,455,[168 194 427 318 257],807,5,1957,4.291666666666667,40.0,0.0
30456,3,456,[168 194 427 318 257],807,5,1962,4.293216630196937,40.0,0.0
30457,3,457,[ 64 210 187 655 121],269,3,1965,4.290393013100437,20.0,0.0
30458,3,458,[ 70 385 257  89 195],23,3,1968,4.287581699346405,0.0,0.0
30459,3,459,[ 22 237 222  11 228],716,5,1973,4.289130434782609,0.0,0.0
30460,3,460,[211 187 258 265  64],655,2,1975,4.2841648590021695,20.0,0.0
30461,3,461,[ 96 183 175 276 228],655,2,1977,4.279220779220779,0.0,0.0
30462,3,462,[194 427 333 168 318],796,5,1982,4.280777537796976,40.0,0.0
30463,3,463,[435 186 118  15 294],655,0,1982,4.271551724137931,0.0,0.0
30464,3,464,[118 318 313  12   8],577,4,1986,4.2709677419354835,20.0,0.0
30465,3,465,[183 111  28 748 117],796,4,1990,4.2703862660944205,0.0,0.0
30466,3,466,[515  64  96 117 603],292,5,1995,4.271948608137045,40.0,0.0
30467,3,467,[597 405 191 258 196],11,3,1998,4.269230769230769,0.0,0.0
30468,3,468,[427 515 194 318 168],716,5,2003,4.270788912579957,40.0,0.0
30469,3,469,[427 515 194 318 168],18,3,2006,4.268085106382979,40.0,0.0
30470,3,470,[172 313  50 328 257],655,3,2009,4.265392781316348,0.0,20.0
30471,3,471,[196 568 100  50 286],344,4,2013,4.264830508474576,0.0,60.0
30472,3,472,[211 174 161 655 423],716,4,2017,4.264270613107822,0.0,0.0
30473,3,473,[405 275 161 286 546],593,2,2019,4.2594936708860756,0.0,40.0
30474,3,474,[ 71 234 423 302 275],389,5,2024,4.261052631578948,0.0,20.0
30475,3,475,[294  98  64 168 200],450,4,2028,4.260504201680672,20.0,0.0
30476,3,476,[ 25 357 302 151 301],450,4,2032,4.259958071278826,0.0,0.0
30477,3,477,[216 496 385 357  70],330,5,2037,4.2615062761506275,20.0,0.0
30478,3,478,[245 748 603 405 183],450,5,2042,4.263048016701461,20.0,0.0
30479,3,479,[ 64  28 194 471 427],450,5,2047,4.264583333333333,40.0,0.0
30480,3,480,[265 508 127 161   4],655,1,2048,4.257796257796258,0.0,20.0
30481,3,481,[194 197  71 125 183],504,3,2051,4.255186721991701,0.0,0.0
30482,3,482,[ 50 234 153 111  97],151,4,2055,4.254658385093168,0.0,20.0
30483,3,483,[ 97 286   9 173 597],796,2,2057,4.25,0.0,20.0
30484,3,484,[180 191 168 234 222],450,3,2060,4.247422680412371,0.0,0.0
30485,3,485,[  7 151  22 405 427],269,2,2062,4.242798353909465,20.0,0.0
30486,3,486,[ 12  88 216 195 286],655,1,2063,4.236139630390143,0.0,20.0
30487,3,487,[ 50 100 153 678 276],401,2,2065,4.23155737704918,0.0,40.0
30488,3,488,[237 195 182 271 211],655,1,2066,4.224948875255624,0.0,0.0
30489,3,489,[ 28   1 181 483 435],807,4,2070,4.224489795918367,0.0,0.0
30490,3,490,[ 22 135 269 187 211],18,4,2074,4.224032586558045,0.0,0.0
30491,3,491,[276 222   9 191 176],786,4,2078,4.223577235772358,0.0,0.0
30492,3,492,[403  64 186 121 234],457,5,2083,4.225152129817444,20.0,0.0
30493,3,493,[125 275 194 508 427],296,5,2088,4.22672064777328,20.0,20.0
30494,3,494,[ 50 174 427 603 235],716,4,2092,4.226262626262626,40.0,20.0
30495,3,495,[176 180 222 197 186],457,5,2097,4.227822580645161,0.0,0.0
30496,3,496,[118 168 234  50 403],807,4,2101,4.227364185110664,0.0,20.0
30497,3,497,[  4  79 125   8 117],577,5,2106,4.228915662650603,0.0,0.0
30498,3,498,[172 496  98 210 234],18,3,2109,4.226452905811623,20.0,0.0
30499,3,499,[273 427 144 301 183],450,4,2113,4.226,20.0,0.0
30500,3,500,[161 273 186  11 546],693,1,2114,4.219560878243513,0.0,0.0
30501,3,501,[322  64 196  89  70],151,4,2118,4.219123505976095,20.0,0.0
30502,3,502,[118 286  98 238 237],450,4,2122,4.21868787276342,0.0,20.0
30503,3,503,[496 211 265 195   8],535,4,2126,4.218253968253968,20.0,0.0
30504,3,504,[302  97  50 328  82],151,2,2128,4.213861386138614,0.0,20.0
30505,3,505,[196  56 423  64 742],796,4,2132,4.213438735177865,20.0,0.0
30506,3,506,[282  50 202  96 328],796,5,2137,4.214990138067061,0.0,20.0
30507,3,507,[100 175 174 385 183],23,4,2141,4.214566929133858,0.0,20.0
30508,3,508,[603 127 153 405  25],450,4,2145,4.214145383104126,20.0,20.0
30509,3,509,[151 210 125 258 294],450,4,2149,4.213725490196079,0.0,0.0
30510,3,510,[153 471  88 655 588],450,5,2154,4.215264187866928,0.0,0.0
30511,3,511,[318 168 132 195 216],18,3,2157,4.212890625,20.0,0.0
30512,3,512,[191 357 258 125 135],450,4,2161,4.212475633528265,0.0,0.0
30513,3,513,[333 318 427 515 132],655,3,2164,4.21011673151751,40.0,0.0
30514,3,514,[204  88 143 678 546],504,3,2167,4.207766990291262,0.0,0.0
30515,3,515,[475   1 568 210 127],389,3,2170,4.205426356589148,0.0,20.0
30516,3,516,[483  69  22  79 742],450,4,2174,4.205029013539652,0.0,0.0
30517,3,517,[176 182 111 180 282],796,4,2178,4.204633204633205,0.0,0.0
30518,3,518,[118 143 187 185 204],504,2,2180,4.200385356454721,0.0,0.0
30519,3,519,[301   1 173  22 288],450,4,2184,4.2,0.0,0.0
30520,3,520,[185 273 234 144 265],655,2,2186,4.1957773512476,0.0,0.0
30521,3,521,[161 546 328 195 216],796,5,2191,4.197318007662835,0.0,0.0
30522,3,522,[216 210 286 211 435],18,5,2196,4.198852772466539,0.0,20.0
30523,3,523,[  8 204 435  64 173],269,1,2197,4.192748091603053,20.0,0.0
30524,3,524,[174 210 300   9 117],629,5,2202,4.194285714285714,0.0,0.0
30525,3,525,[435 175 655 215 185],716,4,2206,4.193916349809886,0.0,0.0
30526,3,526,[187 322 200 237 301],796,3,2209,4.191650853889943,0.0,0.0
30527,3,527,[228  97 588 132 100],457,5,2214,4.193181818181818,0.0,20.0
30528,3,528,[234 210 196 121  69],796,3,2217,4.190926275992439,0.0,0.0
30529,3,529,[173 302 210 328 196],450,4,2221,4.190566037735849,0.0,0.0
30530,3,530,[144 568   7 655 176],457,5,2226,4.192090395480226,0.0,0.0
30531,3,531,[405 204 144  82 143],450,4,2230,4.19172932330827,0.0,0.0
30532,3,532,[496  82   1 153  95],330,5,2235,4.193245778611632,20.0,0.0
30533,3,533,[ 98 289 475 275 483],296,4,2239,4.192883895131086,0.0,20.0
30534,3,534,[228 194 483 257 234],807,4,2243,4.192523364485981,0.0,0.0
30535,3,535,[180 202  22 313 282],280,2,2245,4.188432835820896,0.0,0.0
30536,3,536,[265 475 118   1 742],655,0,2245,4.1806331471135945,0.0,0.0
30537,3,537,[121 471  22 204 288],655,0,2245,4.172862453531598,0.0,0.0
30538,3,538,[ 15 211 200  69   9],151,4,2249,4.172541743970315,0.0,0.0
30539,3,539,[313 173  82 471 135],450,3,2252,4.17037037037037,0.0,0.0
30540,3,540,[271  50 282  22 655],796,4,2256,4.170055452865065,0.0,20.0
30541,3,541,[405 161  64 496 143],577,3,2259,4.167896678966789,40.0,0.0
30542,3,542,[742 288 403  64 143],457,5,2264,4.169429097605893,20.0,0.0
30543,3,543,[143 546  70   7 423],457,4,2268,4.169117647058823,0.0,0.0
30544,3,544,[597 117 222  88 194],796,5,2273,4.170642201834863,0.0,0.0
30545,3,545,[286 313 258 289 328],410,2,2275,4.166666666666667,0.0,20.0
30546,3,546,[100 427 172  50 318],450,5,2280,4.16819012797075,40.0,40.0
30547,3,547,[135  28 216 204 215],330,4,2284,4.1678832116788325,0.0,0.0
30548,3,548,[333 273 300 121 271],796,4,2288,4.167577413479052,0.0,0.0
30549,3,549,[302  70 222 483  25],655,2,2290,4.163636363636364,0.0,0.0
30550,3,550,[ 28  96  56 204 237],72,4,2294,4.163339382940109,0.0,0.0
30551,3,551,[111 234 237 202  12],18,1,2295,4.157608695652174,0.0,0.0
30552,3,552,[286  70 269 385  12],655,0,2295,4.1500904159132,0.0,20.0
30553,3,553,[216 183  50 678 153],504,2,2297,4.146209386281589,0.0,20.0
30554,3,554,[222 294 235 191 172],457,3,2300,4.1441441441441444,0.0,0.0
30555,3,555,[ 88 194 603 100 200],264,4,2304,4.143884892086331,20.0,20.0
30556,3,556,[183 268 508 176 276],344,4,2308,4.143626570915619,0.0,0.0
30557,3,557,[294 265 235 276 318],457,3,2311,4.141577060931899,20.0,0.0
30558,3,558,[427  15  98 357 403],330,5,2316,4.143112701252236,20.0,0.0
30559,3,559,[300 289   9 275  22],655,1,2317,4.1375,0.0,20.0
30560,3,560,[121 234  98 258 185],504,4,2321,4.137254901960785,0.0,0.0
30561,3,561,[ 96 471 323 294 748],280,1,2322,4.131672597864768,0.0,0.0
30562,3,562,[187 186 427  64 204],716,3,2325,4.129662522202486,40.0,0.0
30563,3,563,[161  89 265  88 234],796,4,2329,4.129432624113475,0.0,0.0
30564,3,564,[127 273  71 161  22],450,3,2332,4.127433628318584,0.0,20.0
30565,3,565,[313 603 294 475 111],655,2,2334,4.123674911660777,20.0,0.0
30566,3,566,[286  96 180 568  98],280,4,2338,4.1234567901234565,0.0,20.0
30567,3,567,[121  12 216 173 183],503,3,2341,4.121478873239437,0.0,0.0
30568,3,568,[ 15 204 273 258 144],655,1,2342,4.115992970123023,0.0,0.0
30569,3,569,[ 98 211  96 258 132],693,4,2346,4.11578947368421,0.0,0.0
30570,3,570,[121 181  50 237 655],269,1,2347,4.110332749562172,0.0,20.0
30571,3,571,[143 237 597 100  70],174,4,2351,4.11013986013986,0.0,20.0
30572,3,572,[ 12 127 196 143 568],457,5,2356,4.111692844677138,0.0,20.0
30573,3,573,[ 70 176 181 265 238],655,0,2356,4.104529616724738,0.0,0.0
30574,3,574,[568  96 403  88 385],796,5,2361,4.1060869565217395,0.0,0.0
30575,3,575,[216 135 183 237 210],269,1,2362,4.100694444444445,0.0,0.0
30576,3,576,[121  25 496 245 237],450,3,2365,4.098786828422877,20.0,0.0
30577,3,577,[  9 144 568 286 215],280,2,2367,4.095155709342561,0.0,20.0
30578,3,578,[151  12 288 182 234],450,3,2370,4.0932642487046635,0.0,0.0
30579,3,579,[ 12 118 403 135 328],450,3,2373,4.091379310344828,0.0,0.0
30580,3,580,[ 97 191   9 238   8],457,5,2378,4.0929432013769365,0.0,0.0
30581,3,581,[483 185  64 471  79],389,5,2383,4.094501718213058,20.0,0.0
30582,3,582,[228 183 238 273  56],655,2,2385,4.090909090909091,0.0,0.0
30583,3,583,[ 64 273 655 172 357],401,1,2386,4.085616438356165,20.0,0.0
30584,3,584,[ 95 195 234   1 275],716,4,2390,4.085470085470085,0.0,20.0
30585,3,585,[748 143 588 385  50],450,5,2395,4.087030716723549,0.0,20.0
30586,3,586,[ 89  70 143 286 405],655,2,2397,4.083475298126065,0.0,20.0
30587,3,587,[ 11 200 172 301 186],450,3,2400,4.081632653061225,0.0,0.0
30588,3,588,[ 28 153 385  12  88],655,0,2400,4.074702886247878,0.0,0.0
30589,3,589,[176   1 211 196 117],655,0,2400,4.067796610169491,0.0,0.0
30590,3,590,[483 179 144 168  15],450,3,2403,4.065989847715736,0.0,0.0
30591,3,591,[ 64 151 568 603 403],269,3,2406,4.0641891891891895,40.0,0.0
30592,3,592,[179 196 210 289 111],786,5,2411,4.065767284991568,0.0,0.0
30593,3,593,[475 483 515 655 186],269,4,2415,4.065656565656566,0.0,0.0
30594,3,594,[403 273 172 276 275],655,4,2419,4.065546218487395,0.0,20.0
30595,3,595,[ 69 588 143  28 597],450,5,2424,4.067114093959732,0.0,0.0
30596,3,596,[151  64  15 215 275],18,3,2427,4.065326633165829,20.0,20.0
30597,3,597,[204 286 237 173 185],796,4,2431,4.065217391304348,0.0,20.0
30598,3,598,[202  28  64 302 273],450,4,2435,4.065108514190317,20.0,0.0
30599,3,599,[405 471 215 258 496],450,5,2440,4.066666666666666,20.0,0.0
30600,3,600,[ 15 181 204   7 238],655,0,2440,4.059900166389351,0.0,0.0
30601,3,601,[588  95 181  64 125],796,5,2445,4.061461794019934,20.0,0.0
30602,3,602,[ 50 268 175 215 282],655,1,2446,4.0563847429519075,0.0,20.0
30603,3,603,[186 405  82 318  25],716,4,2450,4.056291390728477,20.0,0.0
30604,3,604,[127 742 194 117 125],450,5,2455,4.0578512396694215,0.0,20.0
30605,3,605,[357  25 151 132 195],330,4,2459,4.057755775577558,0.0,0.0
30606,3,606,[427 238 210 151 742],796,2,2461,4.0543657331136735,20.0,0.0
30607,3,607,[275 172 427 118 328],450,4,2465,4.0542763157894735,20.0,20.0
30608,3,608,[258 228 186 603 655],655,1,2466,4.0492610837438425,20.0,0.0
30609,3,609,[216 271 237   9 238],796,3,2469,4.047540983606558,0.0,0.0
30610,3,610,[  9   4 742 385 151],256,5,2474,4.049099836333879,0.0,0.0
30611,3,611,[204 153  82  79 245],280,2,2476,4.045751633986928,0.0,0.0
30612,3,612,[483 161 318  56 423],450,4,2480,4.045676998368679,20.0,0.0
30613,3,613,[546   4   1 117 496],280,4,2484,4.045602605863192,20.0,0.0
30614,3,614,[405 678 194 471  71],401,2,2486,4.042276422764227,0.0,0.0
30615,3,615,[202 121 118  15 318],655,1,2487,4.037337662337662,20.0,0.0
30616,3,616,[313 568   7 196   4],655,1,2488,4.0324149108589955,0.0,0.0
30617,3,617,[197 357 234 322 132],504,4,2492,4.032362459546926,0.0,0.0
30618,3,618,[ 69 273 191 168 357],450,4,2496,4.032310177705978,0.0,0.0
30619,3,619,[568 257 385 216 234],796,4,2500,4.032258064516129,0.0,0.0
30620,3,620,[118 588 180  22 196],457,5,2505,4.033816425120773,0.0,0.0
30621,3,621,[210 172 197  15 132],450,3,2508,4.032154340836013,0.0,0.0
30622,3,622,[742  98  82 143 216],655,3,2511,4.030497592295345,0.0,0.0
30623,3,623,[197 183 496  64 423],796,4,2515,4.030448717948718,40.0,0.0
30624,3,624,[300 333 483 234 197],655,1,2516,4.0256,0.0,0.0
30625,3,625,[318 515 427 168 132],807,5,2521,4.027156549520766,40.0,0.0
30626,3,626,[318 515 427 168 132],18,4,2525,4.027113237639553,40.0,0.0
30627,3,627,[318 515 427 132 588],316,4,2529,4.027070063694268,40.0,0.0
30628,3,628,[496 655  70 204 191],878,2,2531,4.023847376788553,20.0,0.0
30629,3,629,[318 515 427 132 313],807,5,2536,4.025396825396825,40.0,0.0
30630,3,630,[318 515 427 132 313],807,5,2541,4.0269413629160065,40.0,0.0
30631,3,631,[174  64   4  22 181],18,3,2544,4.025316455696203,20.0,0.0
30632,3,632,[300 742 183   1 257],655,1,2545,4.0205371248025275,0.0,0.0
30633,3,633,[318 515 427 132 313],655,4,2549,4.020504731861199,40.0,0.0
30634,3,634,[ 70 196 100 257 515],655,1,2550,4.015748031496063,0.0,20.0
30635,3,635,[318 515 427 132 313],655,4,2554,4.015723270440252,40.0,0.0
30636,3,636,[185 385 423 127 153],504,4,2558,4.015698587127159,0.0,20.0
30637,3,637,[318 515 427 185 313],655,5,2563,4.017241379310345,40.0,0.0
30638,3,638,[318 515 427 185 313],655,5,2568,4.018779342723005,40.0,0.0
30639,3,639,[275 568 222 185 471],655,2,2570,4.015625,0.0,20.0
30640,3,640,[  7 197 211 187  82],269,3,2573,4.014040561622465,0.0,0.0
30641,3,641,[286  79 276 588   8],344,4,2577,4.014018691588785,0.0,20.0
30642,3,642,[318 515 427 185 313],655,5,2582,4.015552099533437,40.0,0.0
30643,3,643,[483  69  12 180 117],280,5,2587,4.017080745341615,0.0,0.0
30644,3,644,[125 204 237  96 483],296,5,2592,4.018604651162791,0.0,0.0
30645,3,645,[100 273 328 153 210],236,1,2593,4.013931888544891,0.0,20.0
30646,3,646,[318 515 427 185 313],655,5,2598,4.015455950540958,40.0,0.0
30647,3,647,[318 515 427 185 313],655,5,2603,4.0169753086419755,40.0,0.0
30648,3,648,[318 515 427 185 313],655,5,2608,4.01848998459168,40.0,0.0
30649,3,649,[  7 194 117 237  71],450,4,2612,4.018461538461539,0.0,0.0
30650,3,650,[ 69 125 191 215 268],11,3,2615,4.016897081413211,0.0,0.0
30651,3,651,[655 496   9 186 269],535,5,2620,4.0184049079754605,20.0,0.0
30652,3,652,[318 515 427 185 313],655,5,2625,4.019908116385912,40.0,0.0
30653,3,653,[318 515 427 185 313],655,5,2630,4.021406727828746,40.0,0.0
30654,3,654,[318 515 427 185 313],655,5,2635,4.022900763358779,40.0,0.0
30655,3,655,[318 515 427 185 313],655,5,2640,4.024390243902439,40.0,0.0
30656,3,656,[588 385 175 228 168],457,5,2645,4.025875190258752,0.0,0.0
30657,3,657,[176  95 191  88 186],786,5,2650,4.027355623100304,0.0,0.0
30658,3,658,[603  89 403 151  50],796,5,2655,4.0288315629742035,20.0,20.0
30659,3,659,[181  71 357  25 186],450,2,2657,4.025757575757575,0.0,0.0
30660,3,660,[318 515 427 185 313],655,5,2662,4.027231467473525,40.0,0.0
30661,3,661,[318 515 427 185 313],655,5,2667,4.028700906344411,40.0,0.0
30662,3,662,[318 515 427 185 313],655,5,2672,4.030165912518854,40.0,0.0
30663,3,663,[313   4  82 333 111],796,4,2676,4.030120481927711,0.0,0.0
30664,3,664,[748 210 186 271 196],796,3,2679,4.0285714285714285,0.0,0.0
30665,3,665,[318 515 427 185 313],655,5,2684,4.03003003003003,40.0,0.0
30666,3,666,[318 515 427 185 313],655,5,2689,4.031484257871065,40.0,0.0
30667,3,667,[ 79 333 172 182 257],796,5,2694,4.032934131736527,0.0,0.0
30668,3,668,[318 515 427 185 313],655,5,2699,4.034379671150972,40.0,0.0
30669,3,669,[ 97 234 172 179 588],18,3,2702,4.032835820895523,0.0,0.0
30670,3,670,[318 515 427 185 313],655,5,2707,4.034277198211624,40.0,0.0
30671,3,671,[318 515 427 185 313],655,5,2712,4.035714285714286,40.0,0.0
30672,3,672,[318 515 427 185 313],655,5,2717,4.037147102526003,40.0,0.0
30673,3,673,[318 515 427 185 313],655,5,2722,4.0385756676557865,40.0,0.0
30674,3,674,[546  22 194 180 318],457,4,2726,4.038518518518519,20.0,0.0
30675,3,675,[427 515 318 185 313],655,5,2731,4.039940828402367,40.0,0.0
30676,3,676,[151 161  64 427 175],269,4,2735,4.039881831610044,40.0,0.0
30677,3,677,[ 56 216  79  25  98],716,5,2740,4.041297935103245,0.0,0.0
30678,3,678,[313 655  79  82  64],655,3,2743,4.039764359351988,20.0,0.0
30679,3,679,[515 427 318 185 313],655,5,2748,4.041176470588235,40.0,0.0
30680,3,680,[183 111 173  95 216],577,5,2753,4.042584434654919,0.0,0.0
30681,3,681,[515 427 318 185 313],655,5,2758,4.043988269794721,40.0,0.0
30682,3,682,[515 427 318 185 313],655,5,2763,4.045387994143485,40.0,0.0
30683,3,683,[300 182 288 357 483],655,3,2766,4.043859649122807,0.0,0.0
30684,3,684,[515 318 427 185 313],655,5,2771,4.045255474452555,40.0,0.0
30685,3,685,[515 318 427 185 313],655,5,2776,4.0466472303206995,40.0,0.0
30686,3,686,[ 79 211 237 228 174],450,5,2781,4.048034934497816,0.0,0.0
30687,3,687,[515 318 427 185 313],655,5,2786,4.049418604651163,40.0,0.0
30688,3,688,[496 182 111  56 588],18,4,2790,4.049346879535559,20.0,0.0
30689,3,689,[202 568 181 403   8],330,5,2795,4.050724637681159,0.0,0.0
30690,3,690,[515 427 318 185 313],655,5,2800,4.052098408104197,40.0,0.0
30691,3,691,[215 271 294 323 234],796,2,2802,4.0491329479768785,0.0,0.0
30692,3,692,[515 427 318 185 313],655,5,2807,4.05050505050505,40.0,0.0
30693,3,693,[144 742 172 427 546],693,2,2809,4.047550432276657,20.0,0.0
30694,3,694,[ 79 678  12 405 202],256,4,2813,4.047482014388489,0.0,0.0
30695,3,695,[515 427 318 185 313],655,5,2818,4.0488505747126435,40.0,0.0
30696,3,696,[ 50  82   4 215 322],450,3,2821,4.047345767575322,0.0,20.0
30697,3,697,[515 427 318 185 313],655,5,2826,4.048710601719198,40.0,0.0
30698,3,698,[282 117  97 483 423],450,4,2830,4.0486409155937055,0.0,0.0
30699,3,699,[ 70 235 125  79 111],450,4,2834,4.048571428571429,0.0,0.0
30700,3,700,[172 194 197 258  82],796,3,2837,4.0470756062767475,0.0,0.0
30701,3,701,[515 427 318 185 313],655,5,2842,4.048433048433049,40.0,0.0
30702,3,702,[ 50 228  69 234 275],655,2,2844,4.0455192034139404,0.0,40.0
30703,3,703,[183 202 597 195 174],450,5,2849,4.046875,0.0,0.0
30704,3,704,[238 435 328  97  28],151,4,2853,4.046808510638298,0.0,0.0
30705,3,705,[265 183   7 118  98],450,4,2857,4.046742209631728,0.0,0.0
30706,3,706,[515 427 318 185 313],655,5,2862,4.048090523338048,40.0,0.0
30707,3,707,[515 427 318 185 313],655,5,2867,4.049435028248587,40.0,0.0
30708,3,708,[515 427 318 185 313],655,5,2872,4.050775740479549,40.0,0.0
30709,3,709,[515 427 318 185 313],655,5,2877,4.052112676056338,40.0,0.0
30710,3,710,[423 187 276  50 143],504,2,2879,4.049226441631505,0.0,20.0
30711,3,711,[100  28 282 357 748],450,5,2884,4.050561797752809,0.0,20.0
30712,3,712,[258 153  28  96 276],655,1,2885,4.046283309957924,0.0,0.0
30713,3,713,[515 318 427 185 313],655,5,2890,4.0476190476190474,40.0,0.0
30714,3,714,[515 318 427 185 313],655,5,2895,4.048951048951049,40.0,0.0
30715,3,715,[603 197   1 172  98],798,2,2897,4.04608938547486,20.0,0.0
30716,3,716,[ 96 603 357  12  98],908,3,2900,4.044630404463041,20.0,0.0
30717,3,717,[515 318 427 185 313],655,5,2905,4.045961002785515,40.0,0.0
30718,3,718,[515 318 427 185 313],655,5,2910,4.047287899860918,40.0,0.0
30719,3,719,[515 318 427 185 313],655,5,2915,4.048611111111111,40.0,0.0
30720,3,720,[ 96 273 197 597 153],450,4,2919,4.048543689320389,0.0,0.0
30721,3,721,[183 483 185 173 423],457,5,2924,4.049861495844875,0.0,0.0
30722,3,722,[405  88  89 181 197],786,4,2928,4.049792531120332,0.0,0.0
30723,3,723,[276  88 748 183 174],280,1,2929,4.045580110497237,0.0,0.0
30724,3,724,[515 318 427 185 313],655,5,2934,4.046896551724138,40.0,0.0
30725,3,725,[515 318 427 185 313],655,5,2939,4.048209366391185,40.0,0.0
30726,3,726,[515 318 427 185 313],655,5,2944,4.049518569463549,40.0,0.0
30727,3,727,[234 235  69 204 228],280,2,2946,4.0467032967032965,0.0,0.0
30728,3,728,[144  12 125 216 508],655,1,2947,4.042524005486968,0.0,0.0
30729,3,729,[286 289  28 435 211],236,4,2951,4.042465753424658,0.0,20.0
30730,3,730,[515 318 427 185 313],655,5,2956,4.043775649794802,40.0,0.0
30731,3,731,[153  28 200 180 174],504,4,2960,4.043715846994536,0.0,0.0
30732,3,732,[161 475 237 655  97],655,0,2960,4.038199181446112,0.0,0.0
30733,3,733,[196 678 117 210 471],401,3,2963,4.036784741144414,0.0,0.0
30734,3,734,[515 318 427 185 313],655,5,2968,4.038095238095238,40.0,0.0
30735,3,735,[515 318 427 185 313],655,5,2973,4.039402173913044,40.0,0.0
30736,3,736,[568 269 222 289 301],655,0,2973,4.033921302578019,0.0,0.0
30737,3,737,[515 318 427 185 313],655,5,2978,4.035230352303523,40.0,0.0
30738,3,738,[286 181 748 588 202],401,1,2979,4.031123139377537,0.0,20.0
30739,3,739,[118 435 172 357 302],450,4,2983,4.031081081081081,0.0,0.0
30740,3,740,[318 515 427 185 313],655,5,2988,4.032388663967612,40.0,0.0
30741,3,741,[318 515 427 185 313],655,5,2993,4.033692722371968,40.0,0.0
30742,3,742,[318 515 427 185 313],655,5,2998,4.034993270524899,40.0,0.0
30743,3,743,[318 515 427 185 313],655,5,3003,4.036290322580645,40.0,0.0
30744,3,744,[117 568 275 161 276],593,3,3006,4.03489932885906,0.0,20.0
30745,3,745,[318 515 427 185 313],655,5,3011,4.036193029490617,40.0,0.0
30746,3,746,[318 515 427 185 313],655,5,3016,4.037483266398929,40.0,0.0
30747,3,747,[265 127 196  96 471],655,1,3017,4.033422459893048,0.0,20.0
30748,3,748,[318 427 515 185 313],655,5,3022,4.0347129506008015,40.0,0.0
30749,3,749,[322  22 202 118 143],450,4,3026,4.034666666666666,0.0,0.0
30750,3,750,[  9 234 258 322 111],796,2,3028,4.031957390146472,0.0,0.0
30751,3,751,[187  25   1 275 302],389,4,3032,4.031914893617022,0.0,20.0
30752,3,752,[ 56 183 121  12 161],457,5,3037,4.033200531208499,0.0,0.0
30753,3,753,[403 475 200 238 183],655,2,3039,4.030503978779841,0.0,0.0
30754,3,754,[427 515 318 185 313],655,5,3044,4.031788079470199,40.0,0.0
30755,3,755,[196 215 175 300 302],655,1,3045,4.027777777777778,0.0,0.0
30756,3,756,[185 403  98 318 151],269,4,3049,4.027741083223249,20.0,0.0
30757,3,757,[318 427 515 185 313],655,5,3054,4.029023746701847,40.0,0.0
30758,3,758,[318 427 515 185 313],655,5,3059,4.03030303030303,40.0,0.0
30759,3,759,[318 427 515 185 313],655,5,3064,4.031578947368421,40.0,0.0
30760,3,760,[302  79 405 742 204],344,3,3067,4.030223390275952,0.0,0.0
30761,3,761,[427 515 318 185 313],655,5,3072,4.031496062992126,40.0,0.0
30762,3,762,[294 238 323 174 385],796,2,3074,4.028833551769331,0.0,0.0
30763,3,763,[427 515 318 185 313],655,5,3079,4.030104712041885,40.0,0.0
30764,3,764,[385 215 222 151  71],450,3,3082,4.02875816993464,0.0,0.0
30765,3,765,[405  88 200  70   7],457,5,3087,4.030026109660574,0.0,0.0
30766,3,766,[121 151   1 313 275],296,4,3091,4.029986962190352,0.0,20.0
30767,3,767,[153 191 385 211 196],23,3,3094,4.028645833333333,0.0,0.0
30768,3,768,[597 423 182 118 286],450,4,3098,4.028608582574773,0.0,20.0
30769,3,769,[181 144 215 135  98],457,5,3103,4.02987012987013,0.0,0.0
30770,3,770,[515 427 318 185 313],655,5,3108,4.031128404669261,40.0,0.0
30771,3,771,[515 427 318 185 313],655,5,3113,4.032383419689119,40.0,0.0
30772,3,772,[515 427 318 185 313],655,5,3118,4.033635187580853,40.0,0.0
30773,3,773,[100 215 132 151 143],330,5,3123,4.034883720930233,0.0,20.0
30774,3,774,[187 300 515  97   8],535,2,3125,4.032258064516129,0.0,0.0
30775,3,775,[161 655  69 597 194],269,2,3127,4.029639175257732,0.0,0.0
30776,3,776,[318 427 185 515 313],655,5,3132,4.030888030888031,40.0,0.0
30777,3,777,[275  89 423   7 258],655,2,3134,4.02827763496144,0.0,20.0
30778,3,778,[318 427 185 515 313],655,5,3139,4.029525032092426,40.0,0.0
30779,3,779,[318 427 185 515 313],655,5,3144,4.030769230769231,40.0,0.0
30780,3,780,[318 427 185 515 313],655,5,3149,4.032010243277849,40.0,0.0
30781,3,781,[168 176 191 748 742],796,4,3153,4.031969309462916,0.0,0.0
30782,3,782,[427  25 403 100 174],72,4,3157,4.031928480204343,20.0,20.0
30783,3,783,[183 655 132  22 318],655,2,3159,4.029336734693878,20.0,0.0
30784,3,784,[ 79 118 405 161 172],716,3,3162,4.028025477707007,0.0,0.0
30785,3,785,[318 427 185 515 313],655,5,3167,4.029262086513995,40.0,0.0
30786,3,786,[ 88 265 118  70  97],450,4,3171,4.0292249047013975,0.0,0.0
30787,3,787,[181 182 286  50 191],18,4,3175,4.029187817258883,0.0,40.0
30788,3,788,[202 234 286 127 211],18,3,3178,4.02788339670469,0.0,40.0
30789,3,789,[132 196 276 191 568],655,2,3180,4.025316455696203,0.0,0.0
30790,3,790,[132 301  64  97 237],655,1,3181,4.0214917825537295,20.0,0.0
30791,3,791,[216 194 483  22 183],269,2,3183,4.018939393939394,0.0,0.0
30792,3,792,[194 273 173  97 111],796,3,3186,4.01765447667087,0.0,0.0
30793,3,793,[172 179 403  56 496],450,5,3191,4.0188916876574305,20.0,0.0
30794,3,794,[318 427 185 515 313],655,5,3196,4.020125786163522,40.0,0.0
30795,3,795,[318 427 185 515 313],655,5,3201,4.021356783919598,40.0,0.0
30796,3,796,[  8  82 471 185 187],389,5,3206,4.022584692597239,0.0,0.0
30797,3,797,[234 238   7 143  89],23,3,3209,4.021303258145363,0.0,0.0
30798,3,798,[318 427 185 515 313],655,5,3214,4.022528160200251,40.0,0.0
30799,3,799,[318 427 185 515 313],655,5,3219,4.02375,40.0,0.0
30800,3,800,[318 427 185 515 313],655,5,3224,4.024968789013733,40.0,0.0
30801,3,801,[ 28 423 271 181  82],796,3,3227,4.023690773067331,0.0,0.0
30802,3,802,[318 427 185 515 313],655,5,3232,4.024906600249066,40.0,0.0
30803,3,803,[ 64 288 300 273 313],450,3,3235,4.02363184079602,20.0,0.0
30804,3,804,[258 435   4 265 194],629,4,3239,4.0236024844720495,0.0,0.0
30805,3,805,[121 196 135  89  79],151,5,3244,4.024813895781637,0.0,0.0
30806,3,806,[286 182 195 301 302],450,5,3249,4.026022304832714,0.0,20.0
30807,3,807,[318 427 185 515 313],655,5,3254,4.0272277227722775,40.0,0.0
30808,3,808,[200 237 423 183 234],504,2,3256,4.024721878862794,0.0,0.0
30809,3,809,[301 216 435 211  88],389,3,3259,4.023456790123457,0.0,0.0
30810,3,810,[195 127 333 483 175],655,2,3261,4.020961775585697,0.0,20.0
30811,3,811,[427 318 185 515 313],655,5,3266,4.022167487684729,40.0,0.0
30812,3,812,[742 194 471 172 245],450,5,3271,4.023370233702337,0.0,0.0
30813,3,813,[196 483 125 427 174],151,5,3276,4.024570024570025,20.0,0.0
30814,3,814,[427 318 185 515 313],655,5,3281,4.0257668711656445,40.0,0.0
30815,3,815,[ 22   7 202 427 121],655,1,3282,4.022058823529412,20.0,0.0
30816,3,816,[427 318 185 515 313],655,5,3287,4.023255813953488,40.0,0.0
30817,3,817,[186  98 132 405 176],577,4,3291,4.02322738386308,0.0,0.0
30818,3,818,[313 132  22   7 245],450,5,3296,4.024420024420024,0.0,0.0
30819,3,819,[172 111  69  50 742],655,2,3298,4.021951219512195,0.0,20.0
30820,3,820,[603 403 269 234  89],796,3,3301,4.0207064555420216,20.0,0.0
30821,3,821,[427 318 185 515 313],655,5,3306,4.021897810218978,40.0,0.0
30822,3,822,[427 318 185 515 313],655,5,3311,4.023086269744836,40.0,0.0
30823,3,823,[  1 508 289 179 194],296,4,3315,4.023058252427185,0.0,0.0
30824,3,824,[427 318 185 515 313],655,5,3320,4.024242424242424,40.0,0.0
30825,3,825,[322 179  12 275 151],450,5,3325,4.02542372881356,0.0,20.0
30826,3,826,[318 427 185 515 313],655,5,3330,4.026602176541717,40.0,0.0
30827,3,827,[318 427 185 515 313],655,5,3335,4.027777777777778,40.0,0.0
30828,3,828,[318 427 185 515 313],655,5,3340,4.0289505428226775,40.0,0.0
30829,3,829,[318 568 173 168 200],716,5,3345,4.030120481927711,20.0,0.0
30830,3,830,[288 168  12 117 245],450,4,3349,4.030084235860409,0.0,0.0
30831,3,831,[427 318 185 515 313],655,5,3354,4.03125,40.0,0.0
30832,3,832,[ 15 237  98 191 294],236,4,3358,4.031212484993998,0.0,0.0
30833,3,833,[100 265 168 118   4],796,4,3362,4.031175059952038,0.0,20.0
30834,3,834,[427 318 185 515 313],655,5,3367,4.0323353293413176,40.0,0.0
30835,3,835,[322 215 245 282 286],224,2,3369,4.029904306220096,0.0,20.0
30836,3,836,[143 174 268 742 655],655,1,3370,4.026284348864994,0.0,0.0
30837,3,837,[265 194 111 435  82],450,4,3374,4.026252983293556,0.0,0.0
30838,3,838,[183 300 265 288   4],450,3,3377,4.02502979737783,0.0,0.0
30839,3,839,[427 318 185 515 313],655,5,3382,4.026190476190476,40.0,0.0
30840,3,840,[427 318 185 515 313],655,5,3387,4.027348394768133,40.0,0.0
30841,3,841,[ 15 174 195  56 197],269,2,3389,4.024940617577197,0.0,0.0
30842,3,842,[200 196  12 111 191],450,4,3393,4.02491103202847,0.0,0.0
30843,3,843,[427 318 185 515 313],655,5,3398,4.0260663507109005,40.0,0.0
30844,3,844,[508   7 127 289   9],938,3,3401,4.024852071005917,0.0,20.0
30845,3,845,[427 318 185 515 313],655,5,3406,4.026004728132388,40.0,0.0
30846,3,846,[  4  96  50 483 748],450,3,3409,4.024793388429752,0.0,20.0
30847,3,847,[427 318 185 515 313],655,5,3414,4.025943396226415,40.0,0.0
30848,3,848,[118 282 385  56 237],457,5,3419,4.027090694935218,0.0,0.0
30849,3,849,[427 318 185 515 313],655,5,3424,4.028235294117647,40.0,0.0
30850,3,850,[427 318 185 515 313],655,5,3429,4.029377203290247,40.0,0.0
30851,3,851,[132 483 215 121  97],716,5,3434,4.030516431924883,0.0,0.0
30852,3,852,[427 318 185 515 313],655,5,3439,4.031652989449004,40.0,0.0
30853,3,853,[258 405 603 194 282],450,5,3444,4.032786885245901,20.0,0.0
30854,3,854,[ 79 228 301 144 187],296,5,3449,4.033918128654971,0.0,0.0
30855,3,855,[143 202  70 172 748],450,5,3454,4.035046728971962,0.0,0.0
30856,3,856,[ 70  22 385 173 265],280,4,3458,4.035005834305718,0.0,0.0
30857,3,857,[194 216 748 313 183],796,5,3463,4.036130536130536,0.0,0.0
30858,3,858,[318 427 185 515 313],655,5,3468,4.037252619324796,40.0,0.0
30859,3,859,[318 427 185 515 313],655,5,3473,4.038372093023256,40.0,0.0
30860,3,860,[318 427 185 515 313],655,5,3478,4.039488966318235,40.0,0.0
30861,3,861,[237  97 286  69 191],344,1,3479,4.035962877030163,0.0,20.0
30862,3,862,[273 655 286 179 313],236,2,3481,4.033603707995365,0.0,20.0
30863,3,863,[318 427 185 515 313],655,5,3486,4.034722222222222,40.0,0.0
30864,3,864,[ 28 161  95 172 210],330,5,3491,4.035838150289018,0.0,0.0
30865,3,865,[269 117 328 333   4],796,4,3495,4.035796766743649,0.0,0.0
30866,3,866,[318 427 185 515 313],655,5,3500,4.036908881199539,40.0,0.0
30867,3,867,[318 427 185 515 313],655,5,3505,4.038018433179723,40.0,0.0
30868,3,868,[546  12 237 194 318],577,4,3509,4.037974683544304,20.0,0.0
30869,3,869,[135 423  89 185  82],655,3,3512,4.036781609195402,0.0,0.0
30870,3,870,[427 318 185 515 313],655,5,3517,4.03788748564868,40.0,0.0
30871,3,871,[210  97 185   9 258],655,1,3518,4.034403669724771,0.0,0.0
30872,3,872,[427 318 185 515 313],655,5,3523,4.035509736540664,40.0,0.0
30873,3,873,[  4 678 288  25 183],504,4,3527,4.035469107551488,0.0,0.0
30874,3,874,[144 289 182   4 210],655,1,3528,4.032,0.0,0.0
30875,3,875,[  1  98 237 234 568],593,3,3531,4.030821917808219,0.0,0.0
30876,3,876,[471  96   4 282 174],280,1,3532,4.027366020524515,0.0,0.0
30877,3,877,[187 515  28 117 328],655,2,3534,4.0250569476082,0.0,0.0
30878,3,878,[318 435 234 194  56],18,3,3537,4.023890784982935,20.0,0.0
30879,3,879,[568 185 100 197 313],796,3,3540,4.0227272727272725,0.0,20.0
30880,3,880,[318 427 185 515 313],655,5,3545,4.02383654937571,40.0,0.0
30881,3,881,[318 427 185 515 313],655,5,3550,4.024943310657596,40.0,0.0
30882,3,882,[258 176 195  22 215],457,5,3555,4.026047565118913,0.0,0.0
30883,3,883,[318 427 185 515 313],655,5,3560,4.027149321266968,40.0,0.0
30884,3,884,[318 427 185 515 313],655,5,3565,4.028248587570621,40.0,0.0
30885,3,885,[  9  50 275 597  98],796,4,3569,4.028216704288939,0.0,40.0
30886,3,886,[202 496 235 175 125],344,3,3572,4.02705749718151,20.0,0.0
30887,3,887,[175   4 204 403 202],457,5,3577,4.028153153153153,0.0,0.0
30888,3,888,[318 427 185 515 313],655,5,3582,4.029246344206974,40.0,0.0
30889,3,889,[153 275 204 655 173],716,5,3587,4.0303370786516854,0.0,20.0
30890,3,890,[385 228 435 678 257],807,3,3590,4.029180695847362,0.0,0.0
30891,3,891,[275 211   1 403 301],450,5,3595,4.030269058295964,0.0,20.0
30892,3,892,[202  64   9 197 118],655,1,3596,4.026875699888018,20.0,0.0
30893,3,893,[318 427 185 515 313],655,5,3601,4.027964205816555,40.0,0.0
30894,3,894,[202 185  88 191 302],389,4,3605,4.027932960893855,0.0,0.0
30895,3,895,[427 318 185 515 313],655,5,3610,4.029017857142857,40.0,0.0
30896,3,896,[153 191 118  70 742],655,1,3611,4.0256410256410255,0.0,0.0
30897,3,897,[185 237 302  89  56],655,3,3614,4.0244988864142535,0.0,0.0
30898,3,898,[238  88 405 282  56],450,5,3619,4.0255839822024475,0.0,0.0
30899,3,899,[427 318 185 515 313],655,5,3624,4.026666666666666,40.0,0.0
30900,3,900,[ 79 121 258 475 180],296,5,3629,4.027746947835738,0.0,0.0
30901,3,901,[153 125  22 471 238],655,0,3629,4.023281596452328,0.0,0.0
30902,3,902,[200 121 568 187 423],450,3,3632,4.022148394241418,0.0,0.0
30903,3,903,[ 56 258 546  98 211],450,5,3637,4.023230088495575,0.0,0.0
30904,3,904,[286 483  25 153 322],401,2,3639,4.020994475138122,0.0,20.0
30905,3,905,[238 204 742 127 183],655,2,3641,4.018763796909492,0.0,20.0
30906,3,906,[427 318 185 515 313],655,5,3646,4.019845644983462,40.0,0.0
30907,3,907,[357  71 117 173 121],450,3,3649,4.0187224669603525,0.0,0.0
30908,3,908,[215  98  89 210 257],655,2,3651,4.016501650165017,0.0,0.0
30909,3,909,[ 96 282 186 168 322],450,4,3655,4.016483516483516,0.0,0.0
30910,3,910,[427 318 185 515 313],655,5,3660,4.017563117453348,40.0,0.0
30911,3,911,[135 215 118 153 195],151,1,3661,4.014254385964913,0.0,0.0
30912,3,912,[427 318 185 515 313],655,5,3666,4.015334063526835,40.0,0.0
30913,3,913,[427 318 185 515 313],655,5,3671,4.016411378555799,40.0,0.0
30914,3,914,[427 318 185 515 313],655,5,3676,4.017486338797815,40.0,0.0
30915,3,915,[427 318 185 515 313],655,5,3681,4.0185589519650655,40.0,0.0
30916,3,916,[427 318 185 515 313],655,5,3686,4.019629225736096,40.0,0.0
30917,3,917,[ 97 187 132 748 200],450,4,3690,4.019607843137255,0.0,0.0
30918,3,918,[121  96 294 286 301],796,2,3692,4.017410228509249,0.0,20.0
30919,3,919,[427 318 185 515 313],655,5,3697,4.018478260869565,40.0,0.0
30920,3,920,[204 282  64  88 100],236,2,3699,4.01628664495114,20.0,20.0
30921,3,921,[427 318 185 515 313],655,5,3704,4.017353579175705,40.0,0.0
30922,3,922,[427 318 185 515 313],655,5,3709,4.018418201516793,40.0,0.0
30923,3,923,[313  82 144 403 423],280,1,3710,4.015151515151516,0.0,0.0
30924,3,924,[427 318 185 515 313],655,5,3715,4.0162162162162165,40.0,0.0
30925,3,925,[202 265  15 185 172],457,5,3720,4.017278617710583,0.0,0.0
30926,3,926,[186 568  70 294 202],457,4,3724,4.017259978425027,0.0,0.0
30927,3,927,[294  56  69 546 202],796,4,3728,4.017241379310345,0.0,0.0
30928,3,928,[427 318 185 515 313],655,5,3733,4.0182992465016145,40.0,0.0
30929,3,929,[111 234  22  95 496],796,4,3737,4.018279569892473,20.0,0.0
30930,3,930,[427 318 185 515 313],655,5,3742,4.019334049409237,40.0,0.0
30931,3,931,[427 318 185 515 313],655,5,3747,4.0203862660944205,40.0,0.0
30932,3,932,[427 318 185 515 313],655,5,3752,4.021436227224009,40.0,0.0
30933,3,933,[427 318 185 515 313],655,5,3757,4.022483940042827,40.0,0.0
30934,3,934,[427 318 185 515 313],655,5,3762,4.023529411764706,40.0,0.0
30935,3,935,[286  56 200 186 273],450,2,3764,4.021367521367521,0.0,20.0
30936,3,936,[151   9 282   4 268],535,2,3766,4.019210245464247,0.0,0.0
30937,3,937,[427 318 185 515 313],655,5,3771,4.020255863539446,40.0,0.0
30938,3,938,[427 318 185 515 313],655,5,3776,4.021299254526092,40.0,0.0
30939,3,939,[294 186 235 357  97],716,3,3779,4.020212765957447,0.0,0.0
30940,3,940,[427 318 185 515 313],655,5,3784,4.02125398512221,40.0,0.0
30941,3,941,[427 318 185 515 313],655,5,3789,4.022292993630574,40.0,0.0
30942,3,942,[127 228 237 215  56],655,1,3790,4.019088016967126,0.0,20.0
30943,3,943,[ 64 258   7  79 191],655,3,3793,4.018008474576271,20.0,0.0
30944,3,944,[187  69 276 174 153],629,5,3798,4.019047619047619,0.0,0.0
30945,3,945,[427 318 185 515 313],655,5,3803,4.020084566596195,40.0,0.0
30946,3,946,[427 318 185 515 313],655,5,3808,4.021119324181626,40.0,0.0
30947,3,947,[427 318 185 515 313],655,5,3813,4.022151898734177,40.0,0.0
30948,3,948,[265  89 235 234 182],457,4,3817,4.022128556375132,0.0,0.0
30949,3,949,[427 318 185 515 313],655,5,3822,4.023157894736842,40.0,0.0
30950,3,950,[427 318 185 515 313],655,5,3827,4.024185068349106,40.0,0.0
30951,3,951,[423 245  82 385 294],280,2,3829,4.022058823529412,0.0,0.0
30952,3,952,[427 318 185 515 313],655,5,3834,4.02308499475341,40.0,0.0
30953,3,953,[  8  69 322 174 276],593,2,3836,4.020964360587002,0.0,0.0
30954,3,954,[427 318 185 515 313],655,5,3841,4.021989528795811,40.0,0.0
30955,3,955,[  9 100 117 121 197],655,0,3841,4.0177824267782425,0.0,20.0
30956,3,956,[427 318 185 515 313],655,5,3846,4.018808777429467,40.0,0.0
30957,3,957,[  9 182 289 275 196],655,2,3848,4.01670146137787,0.0,20.0
30958,3,958,[301   4  79 111  82],796,3,3851,4.015641293013556,0.0,0.0
30959,3,959,[173  79 187 211 483],796,4,3855,4.015625,0.0,0.0
30960,3,960,[427 318 185 515 313],655,5,3860,4.016649323621228,40.0,0.0
30961,3,961,[313 111 328 273 202],450,4,3864,4.016632016632016,0.0,0.0
30962,3,962,[ 97 179 318 174  82],457,5,3869,4.017653167185878,20.0,0.0
30963,3,963,[234 185 215 546 187],716,3,3872,4.016597510373444,0.0,0.0
30964,3,964,[427 318 185 515 313],655,5,3877,4.0176165803108805,40.0,0.0
30965,3,965,[427 318 185 515 313],655,5,3882,4.0186335403726705,40.0,0.0
30966,3,966,[132 427 300 269 191],796,4,3886,4.018614270941055,20.0,0.0
30967,3,967,[222 265  25  56 237],256,4,3890,4.018595041322314,0.0,0.0
30968,3,968,[179 204 237   8  56],577,3,3893,4.017543859649122,0.0,0.0
30969,3,969,[427 318 185 515 313],655,5,3898,4.018556701030928,40.0,0.0
30970,3,970,[427 318 185 515 313],655,5,3903,4.01956745623069,40.0,0.0
30971,3,971,[423 127 197 318  12],18,5,3908,4.020576131687243,20.0,20.0
30972,3,972,[427 318 185 515 313],655,5,3913,4.0215827338129495,40.0,0.0
30973,3,973,[427 318 185 515 313],655,5,3918,4.02258726899384,40.0,0.0
30974,3,974,[427 318 185 515 313],655,5,3923,4.023589743589744,40.0,0.0
30975,3,975,[215 204 211 235 121],716,4,3927,4.023565573770492,0.0,0.0
30976,3,976,[427 318 185 515 313],655,5,3932,4.024564994882293,40.0,0.0
30977,3,977,[427 318 185 515 313],655,5,3937,4.025562372188139,40.0,0.0
30978,3,978,[182 153 515 204  64],18,4,3941,4.025536261491317,20.0,0.0
30979,3,979,[423 183  96  88  95],756,2,3943,4.023469387755102,0.0,0.0
30980,3,980,[427 318 185 515 313],655,5,3948,4.0244648318042815,40.0,0.0
30981,3,981,[427 318 185 515 313],655,5,3953,4.025458248472505,40.0,0.0
30982,3,982,[588 318  22  82  64],577,5,3958,4.0264496439471005,40.0,0.0
30983,3,983,[357 204 211 222   8],23,3,3961,4.025406504065041,0.0,0.0
30984,3,984,[186  95 197 185 216],389,2,3963,4.023350253807107,0.0,0.0
30985,3,985,[  9 202  64 275 174],151,5,3968,4.024340770791075,20.0,20.0
30986,3,986,[427 318 185 515 313],655,5,3973,4.02532928064843,40.0,0.0
30987,3,987,[ 70 237 180 168 238],457,5,3978,4.026315789473684,0.0,0.0
30988,3,988,[427 318 185 515 313],655,5,3983,4.027300303336704,40.0,0.0
30989,3,989,[427 318 185 515 313],655,5,3988,4.028282828282828,40.0,0.0
30990,3,990,[546 176 222 471 238],450,4,3992,4.028254288597377,0.0,0.0
30991,3,991,[294 121 300 118 215],504,3,3995,4.027217741935484,0.0,0.0
30992,3,992,[427 318 185 515 313],655,5,4000,4.028197381671702,40.0,0.0
30993,3,993,[ 71 568   7 742 216],577,3,4003,4.027162977867203,0.0,0.0
30994,3,994,[294 423 286 301  97],655,0,4003,4.023115577889447,0.0,20.0
30995,3,995,[318 427 185 515 313],655,5,4008,4.024096385542169,40.0,0.0
30996,3,996,[175 180  70 427 151],269,3,4011,4.023069207622869,20.0,0.0
30997,3,997,[186  12 132  25  28],577,5,4016,4.024048096192384,0.0,0.0
30998,3,998,[194 121 168 301 181],796,4,4020,4.024024024024024,0.0,0.0
30999,3,999,[ 71  82 333  97 655],796,2,4022,4.022,0.0,0.0
31000,3,1000,[ 89 275 202  71 385],796,5,4027,4.022977022977023,0.0,20.0
31001,3,1001,[  9  70 322 222 161],786,4,4031,4.022954091816367,0.0,0.0
31002,3,1002,[318 427 185 515 313],655,5,4036,4.023928215353938,40.0,0.0
31003,3,1003,[151  22 546 222 185],796,5,4041,4.024900398406374,0.0,0.0
31004,3,1004,[318 427 185 515 313],655,5,4046,4.025870646766169,40.0,0.0
31005,3,1005,[176 238 322 301 200],796,2,4048,4.023856858846918,0.0,0.0
31006,3,1006,[269 403 118 258  69],796,4,4052,4.023833167825224,0.0,0.0
31007,3,1007,[318 427 185 515 313],655,5,4057,4.024801587301587,40.0,0.0
31008,3,1008,[ 96  82 282 276 121],457,5,4062,4.025768087215065,0.0,0.0
31009,3,1009,[ 56 143  89  12 357],151,5,4067,4.026732673267326,0.0,0.0
31010,3,1010,[318 151 186 269 196],450,4,4071,4.026706231454006,20.0,0.0
31011,3,1011,[ 12 175 187   4 173],421,2,4073,4.024703557312253,0.0,0.0
31012,3,1012,[318 427 185 515 313],655,5,4078,4.025666337611057,40.0,0.0
31013,3,1013,[318 427 185 515 313],655,5,4083,4.0266272189349115,40.0,0.0
31014,3,1014,[216 423 202 182 265],796,5,4088,4.027586206896552,0.0,0.0
31015,3,1015,[318 427 185 515 313],655,5,4093,4.028543307086614,40.0,0.0
31016,3,1016,[318 427 185 515 313],655,5,4098,4.0294985250737465,40.0,0.0
31017,3,1017,[318 427 185 515 313],655,5,4103,4.030451866404715,40.0,0.0
31018,3,1018,[191 237 125 655 423],450,5,4108,4.031403336604514,0.0,0.0
31019,3,1019,[318 427 185 515 313],655,5,4113,4.0323529411764705,40.0,0.0
31020,3,1020,[318 427 185 515 313],655,5,4118,4.0333006856023506,40.0,0.0
31021,3,1021,[135 210 302 125 483],450,2,4120,4.031311154598826,0.0,0.0
31022,3,1022,[173 127 118 300  12],450,4,4124,4.03128054740958,0.0,20.0
31023,3,1023,[318 427 185 515 313],655,5,4129,4.0322265625,40.0,0.0
31024,3,1024,[151 176 385 318 215],457,5,4134,4.033170731707317,20.0,0.0
31025,3,1025,[118  97  12 508 301],344,3,4137,4.0321637426900585,0.0,0.0
31026,3,1026,[318 427 185 515 313],655,5,4142,4.033106134371957,40.0,0.0
31027,3,1027,[318 427 185 515 313],655,5,4147,4.034046692607004,40.0,0.0
31028,3,1028,[237  22  25  50  70],450,4,4151,4.034013605442177,0.0,20.0
31029,3,1029,[ 98 238 100 176  95],450,4,4155,4.033980582524272,0.0,20.0
31030,3,1030,[318 427 185 515 313],655,5,4160,4.034917555771096,40.0,0.0
31031,3,1031,[318 427 185 515 313],655,5,4165,4.035852713178294,40.0,0.0
31032,3,1032,[111 195 496 143 194],716,4,4169,4.035818005808325,20.0,0.0
31033,3,1033,[318 427 185 515 313],655,5,4174,4.036750483558994,40.0,0.0
31034,3,1034,[118  88 257 237 546],504,2,4176,4.034782608695652,0.0,0.0
31035,3,1035,[161  88 196 318 176],655,1,4177,4.031853281853282,20.0,0.0
31036,3,1036,[204 196 405 175 210],344,4,4181,4.031822565091611,0.0,0.0
31037,3,1037,[318 427 185 515 313],655,5,4186,4.032755298651252,40.0,0.0
31038,3,1038,[ 64 191 210 588  50],344,5,4191,4.033686236766122,20.0,20.0
31039,3,1039,[ 79 234 161  50   4],450,3,4194,4.032692307692308,0.0,20.0
31040,3,1040,[318 427 185 515 313],655,5,4199,4.0336215177713735,40.0,0.0
31041,3,1041,[176 603 568 197 313],450,5,4204,4.0345489443378115,20.0,0.0
31042,3,1042,[318 427 185 515 313],655,5,4209,4.035474592521572,40.0,0.0
31043,3,1043,[318 427 185 515 313],655,5,4214,4.03639846743295,40.0,0.0
31044,3,1044,[176 603 318 210 135],450,3,4217,4.035406698564593,40.0,0.0
31045,3,1045,[318 427 185 515 313],655,5,4222,4.036328871892925,40.0,0.0
31046,3,1046,[318 427 185 515 313],655,5,4227,4.037249283667622,40.0,0.0
31047,3,1047,[186 196 742 483  64],693,0,4227,4.033396946564886,20.0,0.0
31048,3,1048,[405 182   4  22  98],450,4,4231,4.0333651096282175,0.0,0.0
31049,3,1049,[245 118  22  96 228],256,4,4235,4.033333333333333,0.0,0.0
31050,3,1050,[318 427 185 515 313],655,5,4240,4.034253092293055,40.0,0.0
31051,3,1051,[318 427 185 515 313],655,5,4245,4.035171102661597,40.0,0.0
31052,3,1052,[258  89   8 286 588],344,3,4248,4.034188034188034,0.0,20.0
31053,3,1053,[318 427 185 515 313],655,5,4253,4.035104364326376,40.0,0.0
31054,3,1054,[185 183 275 603 100],796,4,4257,4.035071090047393,20.0,40.0
31055,3,1055,[318 427 185 515 313],655,5,4262,4.035984848484849,40.0,0.0
31056,3,1056,[182 118 197 222 471],280,0,4262,4.032166508987701,0.0,0.0
31057,3,1057,[318 427 185 515 313],655,5,4267,4.033081285444235,40.0,0.0
31058,3,1058,[318 427 185 515 313],655,5,4272,4.0339943342776206,40.0,0.0
31059,3,1059,[357  28 235 215 127],450,4,4276,4.033962264150944,0.0,20.0
31060,3,1060,[318 427 185 515 313],655,5,4281,4.034872761545712,40.0,0.0
31061,3,1061,[202 234 323 121 288],256,4,4285,4.034839924670433,0.0,0.0
31062,3,1062,[275  70 496 269 143],450,5,4290,4.035747883349012,20.0,20.0
31063,3,1063,[403 655 197 588  98],796,3,4293,4.034774436090226,0.0,0.0
31064,3,1064,[318 427 185 515 313],655,5,4298,4.035680751173709,40.0,0.0
31065,3,1065,[568 405 357  15 265],457,5,4303,4.036585365853658,0.0,0.0
31066,3,1066,[183  64  88 202  70],655,2,4305,4.034676663542643,20.0,0.0
31067,3,1067,[318 427 185 515 313],655,5,4310,4.035580524344569,40.0,0.0
31068,3,1068,[ 64 322 197 168 135],401,1,4311,4.032740879326473,20.0,0.0
31069,3,1069,[275 508 302 121  98],344,4,4315,4.0327102803738315,0.0,20.0
31070,3,1070,[318 427 185 515 313],655,5,4320,4.033613445378151,40.0,0.0
31071,3,1071,[546 423 191 276 143],786,4,4324,4.0335820895522385,0.0,0.0
31072,3,1072,[ 96 286 294 195 183],655,1,4325,4.030754892823858,0.0,20.0
31073,3,1073,[318 427 185 515 313],655,5,4330,4.031657355679702,40.0,0.0
31074,3,1074,[318 427 185 515 313],655,5,4335,4.032558139534884,40.0,0.0
31075,3,1075,[318 427 185 515 313],655,5,4340,4.033457249070632,40.0,0.0
31076,3,1076,[318 427 185 515 313],655,5,4345,4.034354688950789,40.0,0.0
31077,3,1077,[318 427 185 515 313],655,5,4350,4.0352504638218925,40.0,0.0
31078,3,1078,[318 427 185 515 313],655,5,4355,4.036144578313253,40.0,0.0
31079,3,1079,[427 273 143  12 257],655,3,4358,4.035185185185185,20.0,0.0
31080,3,1080,[318 427 185 515 313],655,5,4363,4.036077705827937,40.0,0.0
31081,3,1081,[318 427 185 515 313],655,5,4368,4.036968576709796,40.0,0.0
31082,3,1082,[318 427 185 515 313],655,5,4373,4.0378578024007385,40.0,0.0
31083,3,1083,[318 427 185 515 313],655,5,4378,4.038745387453875,40.0,0.0
31084,3,1084,[427 282 210 127   1],296,4,4382,4.038709677419355,20.0,20.0
31085,3,1085,[318 427 185 515 313],655,5,4387,4.039594843462247,40.0,0.0
31086,3,1086,[742  11 237 196 168],577,4,4391,4.039558417663294,0.0,0.0
31087,3,1087,[318 427 185 515 313],655,5,4396,4.040441176470588,40.0,0.0
31088,3,1088,[197 282 471 210 181],401,3,4399,4.039485766758494,0.0,0.0
31089,3,1089,[318 427 185 515 313],655,5,4404,4.040366972477064,40.0,0.0
31090,3,1090,[294 328  98  50  11],655,2,4406,4.038496791934006,0.0,20.0
31091,3,1091,[286  98 202 258 603],450,5,4411,4.039377289377289,20.0,20.0
31092,3,1092,[ 79 286 427 245 118],796,3,4414,4.038426349496798,20.0,20.0
31093,3,1093,[ 97 211   7  82  98],786,5,4419,4.039305301645339,0.0,0.0
31094,3,1094,[245 234 496 588 117],796,3,4422,4.038356164383561,20.0,0.0
31095,3,1095,[318 427 185 515 313],655,5,4427,4.039233576642336,40.0,0.0
31096,3,1096,[168 179 135  88  25],18,1,4428,4.036463081130355,0.0,0.0
31097,3,1097,[748 385 313  64 194],450,5,4433,4.037340619307832,20.0,0.0
31098,3,1098,[234 238 403 191  88],18,2,4435,4.035486806187443,0.0,0.0
31099,3,1099,[ 22 748 294 269  95],450,4,4439,4.035454545454545,0.0,0.0
31100,3,1100,[ 98 181 144 405  96],716,3,4442,4.034514078110808,0.0,0.0
31101,3,1101,[245 118 282 176 403],796,4,4446,4.0344827586206895,0.0,0.0
31102,3,1102,[318 427 185 515 313],655,5,4451,4.035358114233907,40.0,0.0
31103,3,1103,[318 427 185 515 313],655,5,4456,4.036231884057971,40.0,0.0
31104,3,1104,[185  79 742 100 222],256,5,4461,4.03710407239819,0.0,20.0
31105,3,1105,[191 185 385   8 568],457,5,4466,4.037974683544304,0.0,0.0
31106,3,1106,[186  95 471   1 302],450,3,4469,4.037037037037037,0.0,0.0
31107,3,1107,[294 258  25 265 121],450,3,4472,4.036101083032491,0.0,0.0
31108,3,1108,[238 172  22 300 269],796,3,4475,4.035166816952209,0.0,0.0
31109,3,1109,[427 318 185 515 313],655,5,4480,4.036036036036036,40.0,0.0
31110,3,1110,[427 318 185 515 313],655,5,4485,4.036903690369037,40.0,0.0
31111,3,1111,[275 211 179 234 475],655,2,4487,4.035071942446043,0.0,20.0
31112,3,1112,[275 132 269 176  89],344,5,4492,4.035938903863432,0.0,20.0
31113,3,1113,[427 318 185 515 313],655,5,4497,4.0368043087971275,40.0,0.0
31114,3,1114,[143   9  12 423 186],693,2,4499,4.034977578475337,0.0,0.0
31115,3,1115,[204 100  25 300 216],389,2,4501,4.0331541218638,0.0,20.0
31116,3,1116,[ 98 294 385 357 186],716,3,4504,4.032229185317815,0.0,0.0
31117,3,1117,[237 215 289 143 483],655,2,4506,4.0304114490161,0.0,0.0
31118,3,1118,[191   8  25 185 301],389,4,4510,4.030384271671135,0.0,0.0
31119,3,1119,[237 210 200  56 176],796,4,4514,4.0303571428571425,0.0,0.0
31120,3,1120,[427 318 185 515 313],655,5,4519,4.031222123104371,40.0,0.0
31121,3,1121,[172   8  22 508  70],269,1,4520,4.028520499108734,0.0,0.0
31122,3,1122,[ 11 435  50 161 186],655,1,4521,4.025823686553873,0.0,20.0
31123,3,1123,[427 318 185 515 313],655,5,4526,4.026690391459074,40.0,0.0
31124,3,1124,[ 56  82 143  96 181],457,5,4531,4.027555555555556,0.0,0.0
31125,3,1125,[161 180 181 197 100],280,2,4533,4.025754884547069,0.0,20.0
31126,3,1126,[427 318 185 515 313],655,5,4538,4.026619343389529,40.0,0.0
31127,3,1127,[ 69  50 268 127 385],655,2,4540,4.024822695035461,0.0,40.0
31128,3,1128,[204 403 173 496 153],796,5,4545,4.025686448184234,20.0,0.0
31129,3,1129,[427 318 185 515 313],655,5,4550,4.0265486725663715,40.0,0.0
31130,3,1130,[294 301 143 173 191],450,5,4555,4.027409372236958,0.0,0.0
31131,3,1131,[191 357 176  50 427],835,5,4560,4.028268551236749,20.0,20.0
31132,3,1132,[200  12   8 288  15],655,1,4561,4.025595763459841,0.0,0.0
31133,3,1133,[603 286 258   4 294],796,3,4564,4.0246913580246915,20.0,20.0
31134,3,1134,[258  98   7 172 269],344,4,4568,4.024669603524229,0.0,0.0
31135,3,1135,[427 318 185 515 313],655,5,4573,4.025528169014085,40.0,0.0
31136,3,1136,[427 318 185 515 313],655,5,4578,4.0263852242744065,40.0,0.0
31137,3,1137,[427 318 185 515 313],655,5,4583,4.027240773286468,40.0,0.0
31138,3,1138,[427 318 185 515 313],655,5,4588,4.028094820017559,40.0,0.0
31139,3,1139,[202 588 118 195  95],280,2,4590,4.026315789473684,0.0,0.0
31140,3,1140,[187 168 655  70 483],269,4,4594,4.0262927256792285,0.0,0.0
31141,3,1141,[427 318 185 515 313],655,5,4599,4.027145359019264,40.0,0.0
31142,3,1142,[427 318 185 515 313],655,5,4604,4.027996500437445,40.0,0.0
31143,3,1143,[181 151 100 286 275],878,2,4606,4.026223776223776,0.0,60.0
31144,3,1144,[427 318 185 515 313],655,5,4611,4.02707423580786,40.0,0.0
31145,3,1145,[427 318 185 515 313],655,5,4616,4.027923211169284,40.0,0.0
31146,3,1146,[427 318 185 515 313],655,5,4621,4.028770706190061,40.0,0.0
31147,3,1147,[187 111  89 235   7],269,1,4622,4.026132404181185,0.0,0.0
31148,3,1148,[257 215 186 265  56],716,4,4626,4.026109660574413,0.0,0.0
31149,3,1149,[  9 197 258 508 144],655,0,4626,4.022608695652174,0.0,0.0
31150,3,1150,[427 318 185 515 313],655,5,4631,4.023457862728063,40.0,0.0
31151,3,1151,[111 202 194 328 121],401,4,4635,4.0234375,0.0,0.0
31152,3,1152,[427 318 185 515 313],655,5,4640,4.024284475281873,40.0,0.0
31153,3,1153,[318 222  11 173 238],716,5,4645,4.025129982668977,20.0,0.0
31154,3,1154,[275  97 245 258 185],796,3,4648,4.024242424242424,0.0,20.0
31155,3,1155,[427 318 185 515 313],655,5,4653,4.025086505190312,40.0,0.0
31156,3,1156,[173  88 183 125 288],593,5,4658,4.025929127052723,0.0,0.0
31157,3,1157,[427 318 185 515 313],655,5,4663,4.026770293609672,40.0,0.0
31158,3,1158,[427 318 185 515 313],655,5,4668,4.027610008628128,40.0,0.0
31159,3,1159,[427 318 185 515 313],655,5,4673,4.028448275862069,40.0,0.0
31160,3,1160,[176   8 403 286 127],280,3,4676,4.027562446167098,0.0,40.0
31161,3,1161,[427 318 185 515 313],655,5,4681,4.0283993115318415,40.0,0.0
31162,3,1162,[427 318 185 515 313],655,5,4686,4.029234737747205,40.0,0.0
31163,3,1163,[427 318 185 515 313],655,5,4691,4.030068728522337,40.0,0.0
31164,3,1164,[197 268 172 194 210],269,3,4694,4.0291845493562235,0.0,0.0
31165,3,1165,[196 121 153 181 318],450,4,4698,4.029159519725558,20.0,0.0
31166,3,1166,[427 318 185 515 313],655,5,4703,4.029991431019709,40.0,0.0
31167,3,1167,[427 318 185 515 313],655,5,4708,4.030821917808219,40.0,0.0
31168,3,1168,[427 318 185 515 313],655,5,4713,4.031650983746792,40.0,0.0
31169,3,1169,[211 748  69 427 471],450,5,4718,4.032478632478632,20.0,0.0
31170,3,1170,[427 318 185 515 313],655,5,4723,4.0333048676345005,40.0,0.0
31171,3,1171,[286 211  15 151 655],236,2,4725,4.0315699658703075,0.0,20.0
31172,3,1172,[  7 427 185 153 423],655,2,4727,4.029838022165388,20.0,0.0
31173,3,1173,[427 318 185 515 313],655,5,4732,4.030664395229983,40.0,0.0
31174,3,1174,[196 496 174  82 197],786,4,4736,4.030638297872341,20.0,0.0
31175,3,1175,[197 173   8   1 288],457,5,4741,4.031462585034014,0.0,0.0
31176,3,1176,[180 234 144 603 161],716,2,4743,4.029736618521666,20.0,0.0
31177,3,1177,[210 144 153 235  64],401,2,4745,4.028013582342954,20.0,0.0
31178,3,1178,[ 95 228 194 168 196],798,3,4748,4.027141645462256,0.0,0.0
31179,3,1179,[ 12  69 132 427 111],796,5,4753,4.027966101694915,20.0,0.0
31180,3,1180,[427 318 185 515 313],655,5,4758,4.0287891617273495,40.0,0.0
31181,3,1181,[427 318 185 515 313],655,5,4763,4.029610829103215,40.0,0.0
31182,3,1182,[195 237 197 186 174],655,0,4763,4.026204564666103,0.0,0.0
31183,3,1183,[748   1   4 143 403],450,4,4767,4.0261824324324325,0.0,0.0
31184,3,1184,[215 403 132 197 185],504,4,4771,4.026160337552743,0.0,0.0
31185,3,1185,[257 204 100 238   1],655,0,4771,4.022765598650928,0.0,20.0
31186,3,1186,[427 318 185 515 313],655,5,4776,4.023588879528222,40.0,0.0
31187,3,1187,[427 318 185 515 313],655,5,4781,4.024410774410774,40.0,0.0
31188,3,1188,[471 144 211  56 748],450,5,4786,4.025231286795626,0.0,0.0
31189,3,1189,[385  12 111 228 125],450,5,4791,4.026050420168067,0.0,0.0
31190,3,1190,[427 318 185 515 313],655,5,4796,4.0268681780016795,40.0,0.0
31191,3,1191,[427 318 185 515 313],655,5,4801,4.027684563758389,40.0,0.0
31192,3,1192,[427 318 185 515 313],655,5,4806,4.028499580888516,40.0,0.0
31193,3,1193,[427 318 185 515 313],655,5,4811,4.0293132328308205,40.0,0.0
31194,3,1194,[ 89 318 237  82 172],450,4,4815,4.02928870292887,20.0,0.0
31195,3,1195,[ 82 215 597 385 403],457,4,4819,4.0292642140468224,0.0,0.0
31196,3,1196,[427 318 185 515 313],655,5,4824,4.030075187969925,40.0,0.0
31197,3,1197,[496  97 286 153 143],330,5,4829,4.030884808013355,20.0,20.0
31198,3,1198,[427 318 185 515 313],655,5,4834,4.031693077564637,40.0,0.0
31199,3,1199,[187  88 238 403 111],18,2,4836,4.03,0.0,0.0
31200,3,1200,[211 546 210 185 655],796,2,4838,4.028309741881765,0.0,0.0
31201,3,1201,[655 588   4 204 143],786,5,4843,4.029118136439268,0.0,0.0
31202,3,1202,[427 318 185 515 313],655,5,4848,4.029925187032419,40.0,0.0
31203,3,1203,[427 318 185 515 313],655,5,4853,4.030730897009967,40.0,0.0
31204,3,1204,[ 95 127 385 111 179],786,5,4858,4.0315352697095435,0.0,20.0
31205,3,1205,[427 318 185 515 313],655,5,4863,4.032338308457711,40.0,0.0
31206,3,1206,[427 318 185 515 313],655,5,4868,4.033140016570008,40.0,0.0
31207,3,1207,[302 200   9  98 187],269,4,4872,4.033112582781457,0.0,0.0
31208,3,1208,[196  25 176 127  69],389,3,4875,4.032258064516129,0.0,20.0
31209,3,1209,[427 318 185 515 313],655,5,4880,4.033057851239669,40.0,0.0
31210,3,1210,[427 318 185 515 313],655,5,4885,4.033856317093312,40.0,0.0
31211,3,1211,[117 357 237 228  98],655,2,4887,4.032178217821782,0.0,0.0
31212,3,1212,[ 96 302  25 186 222],655,1,4888,4.029678483099753,0.0,0.0
31213,3,1213,[144 191  95 125 151],450,4,4892,4.029654036243822,0.0,0.0
31214,3,1214,[475 174  22 196 135],629,5,4897,4.030452674897119,0.0,0.0
31215,3,1215,[603 132 286 496  82],330,5,4902,4.03125,40.0,20.0
31216,3,1216,[508 300 286  22 204],535,2,4904,4.029580936729663,0.0,20.0
31217,3,1217,[357 187 211 258 269],796,3,4907,4.028735632183908,0.0,0.0
31218,3,1218,[427 318 185 515 313],655,5,4912,4.029532403609516,40.0,0.0
31219,3,1219,[175  15  56  50 603],151,5,4917,4.030327868852459,20.0,20.0
31220,3,1220,[273 742   1 100 222],655,1,4918,4.027846027846028,0.0,20.0
31221,3,1221,[222 568 318 655 300],450,4,4922,4.027823240589198,20.0,0.0
31222,3,1222,[ 11  96 185   9 196],457,5,4927,4.028618152085037,0.0,0.0
31223,3,1223,[427 318 185 515 313],655,5,4932,4.029411764705882,40.0,0.0
31224,3,1224,[ 70 182 202  82  88],450,4,4936,4.029387755102041,0.0,0.0
31225,3,1225,[427 318 185 515 313],655,5,4941,4.0301794453507345,40.0,0.0
31226,3,1226,[ 56  96   1 210  97],457,5,4946,4.030969845150774,0.0,0.0
31227,3,1227,[427 318 185 515 313],655,5,4951,4.0317589576547235,40.0,0.0
31228,3,1228,[427 318 185 515 313],655,5,4956,4.032546786004882,40.0,0.0
31229,3,1229,[427 318 185 515 313],655,5,4961,4.033333333333333,40.0,0.0
31230,3,1230,[ 12 197 655 127 153],280,3,4964,4.032493907392364,0.0,20.0
31231,3,1231,[210 265 483 313 132],280,3,4967,4.0316558441558445,0.0,0.0
31232,3,1232,[427 318 185 515 313],655,5,4972,4.032441200324412,40.0,0.0
31233,3,1233,[427 318 185 515 313],655,5,4977,4.03322528363047,40.0,0.0
31234,3,1234,[427 318 185 515 313],655,5,4982,4.034008097165992,40.0,0.0
31235,3,1235,[228 191 568  98 132],693,3,4985,4.033171521035599,0.0,0.0
31236,3,1236,[144 235   8 132 238],23,3,4988,4.032336297493937,0.0,0.0
31237,3,1237,[282  25 210  88 294],716,4,4992,4.032310177705978,0.0,0.0
31238,3,1238,[313 496 182  22 100],280,2,4994,4.030669895076675,20.0,20.0
31239,3,1239,[ 98 405 183 471 403],280,1,4995,4.028225806451613,0.0,0.0
31240,3,1240,[181  97   7 121 216],786,4,4999,4.028203062046736,0.0,0.0
31241,3,1241,[471 151  82 127 275],716,4,5003,4.0281803542673105,0.0,40.0
31242,3,1242,[265 288 181 483 603],292,4,5007,4.02815768302494,20.0,0.0
31243,3,1243,[ 56 153   7 257 238],23,4,5011,4.028135048231511,0.0,0.0
31244,3,1244,[176 100  28 222  97],796,2,5013,4.026506024096386,0.0,20.0
31245,3,1245,[427 318 185 515 313],655,5,5018,4.027287319422151,40.0,0.0
31246,3,1246,[196 216   1 318 483],18,4,5022,4.027265437048918,20.0,0.0
31247,3,1247,[282 222 294  69  56],716,4,5026,4.027243589743589,0.0,0.0
31248,3,1248,[196 483 204 427 228],450,4,5030,4.027221777421937,20.0,0.0
31249,3,1249,[168 187 194  69 132],503,5,5035,4.028,0.0,0.0
31250,3,1250,[427 318 185 515 313],655,5,5040,4.028776978417266,40.0,0.0
31251,3,1251,[197 323 125   9 313],280,1,5041,4.026357827476039,0.0,0.0
31252,3,1252,[132  56 405 269 197],796,3,5044,4.025538707102953,0.0,0.0
31253,3,1253,[ 97 237 194 202 187],504,1,5045,4.023125996810207,0.0,0.0
31254,3,1254,[318 427 185 515 313],655,5,5050,4.0239043824701195,40.0,0.0
31255,3,1255,[ 12 216 234  15 200],796,4,5054,4.023885350318471,0.0,0.0
31256,3,1256,[318 427 185 515 313],655,5,5059,4.024661893396977,40.0,0.0
31257,3,1257,[127 258 172 265 100],796,4,5063,4.024642289348172,0.0,40.0
31258,3,1258,[294  97 237 423 742],504,3,5066,4.0238284352660845,0.0,0.0
31259,3,1259,[318 427 185 515 313],655,5,5071,4.0246031746031745,40.0,0.0
31260,3,1260,[318 427 185 515 313],655,5,5076,4.0253766851704995,40.0,0.0
31261,3,1261,[228 161  50 265  56],796,5,5081,4.026148969889065,0.0,20.0
31262,3,1262,[318 427 185 515 313],655,5,5086,4.026920031670626,40.0,0.0
31263,3,1263,[204 176 568 238 187],389,4,5090,4.026898734177215,0.0,0.0
31264,3,1264,[318 427 185 515 313],655,5,5095,4.027667984189724,40.0,0.0
31265,3,1265,[475  64   9 265 100],292,5,5100,4.028436018957346,20.0,20.0
31266,3,1266,[318 427 185 515 313],655,5,5105,4.029202841357537,40.0,0.0
31267,3,1267,[318 427 185 515 313],655,5,5110,4.029968454258675,40.0,0.0
31268,3,1268,[  1 228 588 196 258],796,4,5114,4.029944838455477,0.0,0.0
31269,3,1269,[318 427 185 515 313],655,5,5119,4.030708661417322,40.0,0.0
31270,3,1270,[318 427 185 515 313],655,5,5124,4.03147128245476,40.0,0.0
31271,3,1271,[300 328   7 294 172],655,1,5125,4.029088050314465,0.0,0.0
31272,3,1272,[ 25  79  98  12 117],72,5,5130,4.029850746268656,0.0,0.0
31273,3,1273,[742 286 144  88 211],796,2,5132,4.028257456828886,0.0,20.0
31274,3,1274,[318 427 185 515 313],655,5,5137,4.0290196078431375,40.0,0.0
31275,3,1275,[318 427 185 515 313],655,5,5142,4.029780564263323,40.0,0.0
31276,3,1276,[318 427 185 515 313],655,5,5147,4.0305403288958495,40.0,0.0
31277,3,1277,[318 427 185 515 313],655,5,5152,4.031298904538341,40.0,0.0
31278,3,1278,[245 435 176 161 289],756,2,5154,4.029710711493355,0.0,0.0
31279,3,1279,[471  25  88 100 202],389,3,5157,4.02890625,0.0,20.0
31280,3,1280,[742 234  98 172 678],280,2,5159,4.027322404371585,0.0,0.0
31281,3,1281,[318 427 185 515 313],655,5,5164,4.02808112324493,40.0,0.0
31282,3,1282,[187 268 294   8  79],902,2,5166,4.026500389711614,0.0,0.0
31283,3,1283,[ 15 181  69 405 168],151,4,5170,4.026479750778816,0.0,0.0
31284,3,1284,[228 546 176  79  97],450,5,5175,4.027237354085603,0.0,0.0
31285,3,1285,[301 748 322 328  70],151,2,5177,4.0256609642301715,0.0,0.0
31286,3,1286,[318 427 185 515 313],655,5,5182,4.0264180264180265,40.0,0.0
31287,3,1287,[117  69 210 204 427],236,2,5184,4.024844720496894,20.0,0.0
31288,3,1288,[318 427 185 515 313],655,5,5189,4.025601241272304,40.0,0.0
31289,3,1289,[318 427 185 515 313],655,5,5194,4.026356589147287,40.0,0.0
31290,3,1290,[238 100  64 301  56],389,5,5199,4.0271107668474055,20.0,20.0
31291,3,1291,[ 28 269 144 265 216],655,1,5200,4.024767801857585,0.0,0.0
31292,3,1292,[655 196 186  11 238],450,4,5204,4.0247486465583915,0.0,0.0
31293,3,1293,[318 427 185 515 313],655,5,5209,4.025502318392581,40.0,0.0
31294,3,1294,[ 15 475 471  25 127],389,3,5212,4.024710424710425,0.0,20.0
31295,3,1295,[204 678 211 135 191],401,3,5215,4.02391975308642,0.0,0.0
31296,3,1296,[318 427 185 515 313],655,5,5220,4.024672320740169,40.0,0.0
31297,3,1297,[318 427 185 515 313],655,5,5225,4.02542372881356,40.0,0.0
31298,3,1298,[318 427 185 515 313],655,5,5230,4.026173979984604,40.0,0.0
31299,3,1299,[258  97 144 546   4],457,4,5234,4.026153846153846,0.0,0.0
31300,3,1300,[318 427 185 515 313],655,5,5239,4.026902382782475,40.0,0.0
31301,3,1301,[ 79 175 181 168 215],457,5,5244,4.027649769585254,0.0,0.0
31302,3,1302,[318 427 185 515 313],655,5,5249,4.028396009209517,40.0,0.0
31303,3,1303,[423   1 191 603 588],18,4,5253,4.028374233128834,20.0,0.0
31304,3,1304,[216 546   1 588 210],577,3,5256,4.027586206896552,0.0,0.0
31305,3,1305,[318 427 185 515 313],655,5,5261,4.02833078101072,40.0,0.0
31306,3,1306,[318 427 185 515 313],655,5,5266,4.029074215761286,40.0,0.0
31307,3,1307,[204 182 483  50 135],450,3,5269,4.0282874617737,0.0,20.0
31308,3,1308,[546 568 202  71   8],344,3,5272,4.027501909854851,0.0,0.0
31309,3,1309,[318 427 185 515 313],655,5,5277,4.02824427480916,40.0,0.0
31310,3,1310,[121 282 117  88 238],450,4,5281,4.028222730739893,0.0,0.0
31311,3,1311,[318 427 185 515 313],655,5,5286,4.028963414634147,40.0,0.0
31312,3,1312,[318 427 185 515 313],655,5,5291,4.02970297029703,40.0,0.0
31313,3,1313,[ 22  12 282  98 172],655,2,5293,4.028158295281583,0.0,0.0
31314,3,1314,[318 427 185 515 313],655,5,5298,4.028897338403042,40.0,0.0
31315,3,1315,[322 237  50 568 117],593,4,5302,4.02887537993921,0.0,20.0
31316,3,1316,[423 194 179 172  88],577,3,5305,4.028094153378891,0.0,0.0
31317,3,1317,[318 427 185 515 313],655,5,5310,4.0288315629742035,40.0,0.0
31318,3,1318,[318 427 185 515 313],655,5,5315,4.029567854435178,40.0,0.0
31319,3,1319,[483 127 181  82  69],796,4,5319,4.029545454545454,0.0,20.0
31320,3,1320,[318 427 185 515 313],655,5,5324,4.0302800908402725,40.0,0.0
31321,3,1321,[282 603  50 195 328],450,5,5329,4.031013615733737,20.0,20.0
31322,3,1322,[ 82 143 180 294 161],450,4,5333,4.030990173847317,0.0,0.0
31323,3,1323,[222 181 301 172 210],344,4,5337,4.030966767371601,0.0,0.0
31324,3,1324,[318 427 185 515 313],655,5,5342,4.031698113207547,40.0,0.0
31325,3,1325,[ 25 515 313 318 265],655,3,5345,4.030920060331825,20.0,0.0
31326,3,1326,[318 427 185 515 313],655,5,5350,4.031650339110776,40.0,0.0
31327,3,1327,[318 427 185 515 313],655,5,5355,4.032379518072289,40.0,0.0
31328,3,1328,[318 427 185 515 313],655,5,5360,4.033107599699022,40.0,0.0
31329,3,1329,[318 427 185 515 313],655,5,5365,4.033834586466165,40.0,0.0
31330,3,1330,[100 282 182  96 245],450,5,5370,4.034560480841472,0.0,20.0
31331,3,1331,[286 234  88 185  12],503,3,5373,4.033783783783784,0.0,20.0
31332,3,1332,[318 427 185 515 313],655,5,5378,4.034508627156789,40.0,0.0
31333,3,1333,[318 427 185 515 313],655,5,5383,4.035232383808096,40.0,0.0
31334,3,1334,[318 427 185 515 313],655,5,5388,4.035955056179775,40.0,0.0
31335,3,1335,[ 98 235 132 269  95],23,4,5392,4.0359281437125745,0.0,0.0
31336,3,1336,[ 79 194 257  71   4],389,4,5396,4.0359012715033655,0.0,0.0
31337,3,1337,[318 427 185 515 313],655,5,5401,4.036621823617339,40.0,0.0
31338,3,1338,[ 98 172 127 286  97],796,3,5404,4.035847647498133,0.0,40.0
31339,3,1339,[318 427 185 515 313],655,5,5409,4.036567164179105,40.0,0.0
31340,3,1340,[318 427 185 515 313],655,5,5414,4.037285607755407,40.0,0.0
31341,3,1341,[211 748  82 174 195],151,2,5416,4.0357675111773474,0.0,0.0
31342,3,1342,[ 64 301  79  56  82],151,4,5420,4.035740878629933,20.0,0.0
31343,3,1343,[318 427 185 515 313],655,5,5425,4.036458333333333,40.0,0.0
31344,3,1344,[216  71 181 228  56],450,4,5429,4.036431226765799,0.0,0.0
31345,3,1345,[  7  89 742 300 435],450,5,5434,4.037147102526003,0.0,0.0
31346,3,1346,[357   4 228 742 151],450,4,5438,4.037119524870081,0.0,0.0
31347,3,1347,[318 427 185 515 313],655,5,5443,4.037833827893175,40.0,0.0
31348,3,1348,[  1 234 237  89  56],796,3,5446,4.037064492216457,0.0,0.0
31349,3,1349,[144  88 111  25 318],655,1,5447,4.034814814814815,20.0,0.0
31350,3,1350,[318 427 185 515 313],655,5,5452,4.035529237601777,40.0,0.0
31351,3,1351,[435 302 483 196 269],535,4,5456,4.035502958579881,0.0,0.0
31352,3,1352,[183 204  25  98 125],151,4,5460,4.035476718403547,0.0,0.0
31353,3,1353,[117  96 132 597 655],450,5,5465,4.036189069423929,0.0,0.0
31354,3,1354,[ 28 172 405 423 194],798,4,5469,4.036162361623616,0.0,0.0
31355,3,1355,[273 143  71 216 211],450,3,5472,4.035398230088496,0.0,0.0
31356,3,1356,[318 427 185 515 313],655,5,5477,4.036109064112011,40.0,0.0
31357,3,1357,[161 100 183 111  69],280,3,5480,4.035346097201767,0.0,20.0
31358,3,1358,[200 313  11  70 245],450,4,5484,4.035320088300221,0.0,0.0
31359,3,1359,[318 427 185 515 313],655,5,5489,4.036029411764706,40.0,0.0
31360,3,1360,[318 427 185 515 313],655,5,5494,4.0367376928728875,40.0,0.0
31361,3,1361,[318 427 185 515 313],655,5,5499,4.037444933920705,40.0,0.0
31362,3,1362,[200 496 483 655 210],269,4,5503,4.037417461482025,20.0,0.0
31363,3,1363,[ 69  82 269  50 195],655,1,5504,4.035190615835777,0.0,20.0
31364,3,1364,[318 427 185 515 313],655,5,5509,4.035897435897436,40.0,0.0
31365,3,1365,[318 427 185 515 313],655,5,5514,4.036603221083455,40.0,0.0
31366,3,1366,[318 427 185 515 313],655,5,5519,4.0373079736649595,40.0,0.0
31367,3,1367,[ 82 323   1 168 237],796,2,5521,4.0358187134502925,0.0,0.0
31368,3,1368,[211  96 427 496  71],807,4,5525,4.035792549306063,40.0,0.0
31369,3,1369,[200 276 195 234 235],280,3,5528,4.035036496350365,0.0,0.0
31370,3,1370,[318 427 185 515 313],655,5,5533,4.035740335521517,40.0,0.0
31371,3,1371,[ 82   9 180 187 183],504,3,5536,4.034985422740525,0.0,0.0
31372,3,1372,[204 151 603 185 286],389,4,5540,4.0349599417334305,20.0,20.0
31373,3,1373,[318 427 185 515 313],655,5,5545,4.035662299854439,40.0,0.0
31374,3,1374,[655 238   1 168 275],535,4,5549,4.035636363636364,0.0,20.0
31375,3,1375,[318 427 185 515 313],655,5,5554,4.036337209302325,40.0,0.0
31376,3,1376,[172 275 385 196  79],450,5,5559,4.037037037037037,0.0,20.0
31377,3,1377,[ 88 597 258 173 191],450,5,5564,4.037735849056604,0.0,0.0
31378,3,1378,[300   7  98 172  97],450,5,5569,4.038433647570703,0.0,0.0
31379,3,1379,[318 427 185 515 313],655,5,5574,4.039130434782609,40.0,0.0
31380,3,1380,[318 427 185 515 313],655,5,5579,4.039826212889211,40.0,0.0
31381,3,1381,[318 427 185 515 313],655,5,5584,4.040520984081042,40.0,0.0
31382,3,1382,[191 144 118 403 176],450,4,5588,4.040491684743311,0.0,0.0
31383,3,1383,[202 265 748 125 172],280,1,5589,4.038294797687861,0.0,0.0
31384,3,1384,[423 117 196  96 204],504,4,5593,4.03826714801444,0.0,0.0
31385,3,1385,[282 238 100 200 271],796,3,5596,4.037518037518038,0.0,20.0
31386,3,1386,[ 69  25 318 288 742],450,3,5599,4.036770007209805,20.0,0.0
31387,3,1387,[ 96 435 100 273 234],655,1,5600,4.034582132564841,0.0,20.0
31388,3,1388,[302 179 403 111 173],269,1,5601,4.032397408207343,0.0,0.0
31389,3,1389,[318 427 185 515 313],655,5,5606,4.033093525179856,40.0,0.0
31390,3,1390,[318 427 185 515 313],655,5,5611,4.033788641265277,40.0,0.0
31391,3,1391,[318 427 185 515 313],655,5,5616,4.0344827586206895,40.0,0.0
31392,3,1392,[318 427 185 515 313],655,5,5621,4.035175879396985,40.0,0.0
31393,3,1393,[ 88 174 187 210 546],236,1,5622,4.032998565279771,0.0,0.0
31394,3,1394,[216 318 234 144  64],693,3,5625,4.032258064516129,40.0,0.0
31395,3,1395,[318 427 185 515 313],655,5,5630,4.032951289398281,40.0,0.0
31396,3,1396,[318 427 185 515 313],655,5,5635,4.033643521832499,40.0,0.0
31397,3,1397,[318 427 185 515 313],655,5,5640,4.034334763948498,40.0,0.0
31398,3,1398,[204  22 234 181  56],577,3,5643,4.033595425303789,0.0,0.0
31399,3,1399,[183 197 215 173 385],796,4,5647,4.033571428571428,0.0,0.0
31400,3,1400,[  1 143 182  69  71],389,4,5651,4.033547466095646,0.0,0.0
31401,3,1401,[427 318 185 515 313],655,5,5656,4.034236804564907,40.0,0.0
31402,3,1402,[118 282  64 423 180],693,1,5657,4.032074126870991,20.0,0.0
31403,3,1403,[ 82  15 111  69 143],450,3,5660,4.031339031339031,0.0,0.0
31404,3,1404,[174 237  25 423  79],577,5,5665,4.032028469750889,0.0,0.0
31405,3,1405,[237 117   1  96 168],716,4,5669,4.032005689900426,0.0,0.0
31406,3,1406,[143  71 273 423 183],450,3,5672,4.031272210376688,0.0,0.0
31407,3,1407,[ 71 294 323  12 269],796,2,5674,4.029829545454546,0.0,0.0
31408,3,1408,[427 318 185 515 313],655,5,5679,4.030518097941803,40.0,0.0
31409,3,1409,[427 318 185 515 313],655,5,5684,4.0312056737588655,40.0,0.0
31410,3,1410,[238 151 118 568 237],716,4,5688,4.031183557760453,0.0,0.0
31411,3,1411,[ 95 180 222 655  82],786,5,5693,4.031869688385269,0.0,0.0
31412,3,1412,[427 318 185 515 313],655,5,5698,4.032554847841472,40.0,0.0
31413,3,1413,[427 318 185 515 313],655,5,5703,4.033239038189533,40.0,0.0
31414,3,1414,[427 318 185 515 313],655,5,5708,4.033922261484099,40.0,0.0
31415,3,1415,[237  28 204 276 258],504,2,5710,4.0324858757062145,0.0,0.0
31416,3,1416,[427 318 185 515 313],655,5,5715,4.033168666196189,40.0,0.0
31417,3,1417,[ 89 121 289 271 265],807,4,5719,4.0331452750352605,0.0,0.0
31418,3,1418,[427 318 185 515 313],655,5,5724,4.033826638477802,40.0,0.0
31419,3,1419,[427 318 185 515 313],655,5,5729,4.034507042253521,40.0,0.0
31420,3,1420,[427 318 185 515 313],655,5,5734,4.035186488388459,40.0,0.0
31421,3,1421,[427 318 185 515 313],655,5,5739,4.0358649789029535,40.0,0.0
31422,3,1422,[427 318 185 515 313],655,5,5744,4.036542515811665,40.0,0.0
31423,3,1423,[427 318 185 515 313],655,5,5749,4.037219101123595,40.0,0.0
31424,3,1424,[144 210 288 235  97],450,2,5751,4.03578947368421,0.0,0.0
31425,3,1425,[427 318 185 515 313],655,5,5756,4.036465638148668,40.0,0.0
31426,3,1426,[496 210 222 187  98],716,4,5760,4.036440084092502,20.0,0.0
31427,3,1427,[475 100 748  64 168],292,4,5764,4.03641456582633,20.0,20.0
31428,3,1428,[216 269 100 313  89],450,5,5769,4.037088873337999,0.0,20.0
31429,3,1429,[273  22  12 132 172],796,4,5773,4.037062937062937,0.0,0.0
31430,3,1430,[  9 118  28 282 483],693,1,5774,4.034940600978337,0.0,0.0
31431,3,1431,[427 318 185 515 313],655,5,5779,4.035614525139665,40.0,0.0
31432,3,1432,[427 318 185 515 313],655,5,5784,4.036287508722959,40.0,0.0
31433,3,1433,[427 318 185 515 313],655,5,5789,4.036959553695955,40.0,0.0
31434,3,1434,[121  64 597 135 655],269,3,5792,4.03623693379791,20.0,0.0
31435,3,1435,[427 318 185 515 313],655,5,5797,4.036908077994429,40.0,0.0
31436,3,1436,[427 318 185 515 313],655,5,5802,4.0375782881002085,40.0,0.0
31437,3,1437,[181 435 176 423   8],389,5,5807,4.038247566063978,0.0,0.0
31438,3,1438,[427 318 185 515 313],655,5,5812,4.038915913829048,40.0,0.0
31439,3,1439,[427 318 185 515 313],655,5,5817,4.039583333333334,40.0,0.0
31440,3,1440,[427 318 185 515 313],655,5,5822,4.040249826509369,40.0,0.0
31441,3,1441,[427 318 185 515 313],655,5,5827,4.040915395284327,40.0,0.0
31442,3,1442,[427 318 185 515 313],655,5,5832,4.041580041580041,40.0,0.0
31443,3,1443,[427 318 185 515 313],655,5,5837,4.042243767313019,40.0,0.0
31444,3,1444,[265 210 435 269 508],655,0,5837,4.039446366782007,0.0,0.0
31445,3,1445,[427 318 185 515 313],655,5,5842,4.040110650069156,40.0,0.0
31446,3,1446,[357  96 168  15 238],450,4,5846,4.040082930200414,0.0,0.0
31447,3,1447,[245 385 237  11  69],593,4,5850,4.040055248618785,0.0,0.0
31448,3,1448,[161 273 237 204 288],655,1,5851,4.037957211870255,0.0,0.0
31449,3,1449,[183 385 603 211 748],151,2,5853,4.036551724137931,20.0,0.0
31450,3,1450,[186 111 195   7 135],655,1,5854,4.034458993797381,0.0,0.0
31451,3,1451,[427 318 185 515 313],655,5,5859,4.035123966942149,40.0,0.0
31452,3,1452,[ 79  22 222 300 286],796,4,5863,4.035099793530626,0.0,20.0
31453,3,1453,[427 318 185 515 313],655,5,5868,4.0357634112792296,40.0,0.0
31454,3,1454,[222 186 179 275 200],450,2,5870,4.034364261168385,0.0,20.0
31455,3,1455,[427 318 185 515 313],655,5,5875,4.035027472527473,40.0,0.0
31456,3,1456,[ 22 216   1 603  25],716,5,5880,4.035689773507206,20.0,0.0
31457,3,1457,[ 88 496 153 180 132],450,5,5885,4.036351165980796,20.0,0.0
31458,3,1458,[ 89 216 151  11 471],450,5,5890,4.037011651816313,0.0,0.0
31459,3,1459,[427 318 185 515 313],655,5,5895,4.037671232876712,40.0,0.0
31460,3,1460,[427 318 185 515 313],655,5,5900,4.03832991101985,40.0,0.0
31461,3,1461,[202 215 423 172 195],151,3,5903,4.037619699042407,0.0,0.0
31462,3,1462,[288  79  64 216 195],256,5,5908,4.038277511961723,20.0,0.0
31463,3,1463,[216 144 237 268  28],655,1,5909,4.03620218579235,0.0,0.0
31464,3,1464,[427 318 185 515 313],655,5,5914,4.036860068259386,40.0,0.0
31465,3,1465,[427 318 185 515 313],655,5,5919,4.0375170532060025,40.0,0.0
31466,3,1466,[427 318 185 515 313],655,5,5924,4.038173142467621,40.0,0.0
31467,3,1467,[427 318 185 515 313],655,5,5929,4.0388283378746594,40.0,0.0
31468,3,1468,[427 318 185 515 313],655,5,5934,4.039482641252553,40.0,0.0
31469,3,1469,[237 269 322  71 273],796,2,5936,4.038095238095238,0.0,0.0
31470,3,1470,[427 318 185 515 313],655,5,5941,4.038749150237933,40.0,0.0
31471,3,1471,[ 28 258 127 275 185],796,4,5945,4.038722826086956,0.0,40.0
31472,3,1472,[318 180 228 210 294],457,4,5949,4.038696537678208,20.0,0.0
31473,3,1473,[427 318 185 515 313],655,5,5954,4.039348710990502,40.0,0.0
31474,3,1474,[194 195 168 121 204],796,5,5959,4.04,0.0,0.0
31475,3,1475,[153 546  95  28 257],796,4,5963,4.039972899728998,0.0,0.0
31476,3,1476,[235 135  98 238 168],330,3,5966,4.039268788083954,0.0,0.0
31477,3,1477,[427 318 185 515 313],655,5,5971,4.039918809201624,40.0,0.0
31478,3,1478,[186  98 172 273   4],655,3,5974,4.03921568627451,0.0,0.0
31479,3,1479,[427 318 185 515 313],655,5,5979,4.039864864864865,40.0,0.0
31480,3,1480,[257 144 186 181 215],716,3,5982,4.039162727886563,0.0,0.0
31481,3,1481,[135 318 111 269 174],655,2,5984,4.03778677462888,20.0,0.0
31482,3,1482,[427 318 185 515 313],655,5,5989,4.0384356035064055,40.0,0.0
31483,3,1483,[  4 210 313 196 282],593,4,5993,4.038409703504043,0.0,0.0
31484,3,1484,[427 318 185 515 313],655,5,5998,4.0390572390572395,40.0,0.0
31485,3,1485,[257 216  89 200 195],655,3,6001,4.03835800807537,0.0,0.0
31486,3,1486,[427 318 185 515 313],655,5,6006,4.039004707464694,40.0,0.0
31487,3,1487,[427 318 185 515 313],655,5,6011,4.039650537634409,40.0,0.0
31488,3,1488,[655 588 318 183 235],280,3,6014,4.038952316991269,20.0,0.0
31489,3,1489,[427 318 185 515 313],655,5,6019,4.039597315436241,40.0,0.0
31490,3,1490,[427 318 185 515 313],655,5,6024,4.040241448692153,40.0,0.0
31491,3,1491,[427 318 185 515 313],655,5,6029,4.04088471849866,40.0,0.0
31492,3,1492,[  7  97 597 125 322],450,5,6034,4.041527126590757,0.0,0.0
31493,3,1493,[427 318 185 515 313],655,5,6039,4.042168674698795,40.0,0.0
31494,3,1494,[546   9  50  56 423],693,1,6040,4.040133779264214,0.0,20.0
31495,3,1495,[427 318 185 515 313],655,5,6045,4.040775401069519,40.0,0.0
31496,3,1496,[427 318 185 515 313],655,5,6050,4.041416165664662,40.0,0.0
31497,3,1497,[427 318 185 515 313],655,5,6055,4.042056074766355,40.0,0.0
31498,3,1498,[ 96  82 273 257 275],655,2,6057,4.040693795863909,0.0,20.0
31499,3,1499,[427 318 185 515 313],655,5,6062,4.041333333333333,40.0,0.0
31500,3,1500,[427 318 185 515 313],655,5,6067,4.0419720186542305,40.0,0.0
31501,3,1501,[  8  12 125 282 176],280,2,6069,4.040612516644474,0.0,0.0
31502,3,1502,[427 318 185 515 313],655,5,6074,4.041250831669993,40.0,0.0
31503,3,1503,[603 427 228 322 222],151,4,6078,4.0412234042553195,40.0,0.0
31504,3,1504,[427 318 185 515 313],655,5,6083,4.0418604651162795,40.0,0.0
31505,3,1505,[ 95 234 194 175 144],23,3,6086,4.041168658698539,0.0,0.0
31506,3,1506,[275 180  71 471  97],786,5,6091,4.041804910418049,0.0,20.0
31507,3,1507,[197  50   9  56  96],72,4,6095,4.041777188328912,0.0,20.0
31508,3,1508,[301   1  25 191 200],450,3,6098,4.041086812458582,0.0,0.0
31509,3,1509,[496 195 483 183 748],151,2,6100,4.039735099337748,20.0,0.0
31510,3,1510,[ 79 357 655 238 423],535,3,6103,4.039046988749173,0.0,0.0
31511,3,1511,[427 318 185 515 313],655,5,6108,4.0396825396825395,40.0,0.0
31512,3,1512,[546  11 405 228  82],450,4,6112,4.039656311962988,0.0,0.0
31513,3,1513,[183 257 597  50 655],796,4,6116,4.039630118890357,0.0,20.0
31514,3,1514,[427 318 185 515 313],655,5,6121,4.040264026402641,40.0,0.0
31515,3,1515,[132 151 483 185 200],457,5,6126,4.04089709762533,0.0,0.0
31516,3,1516,[427 318 185 515 313],655,5,6131,4.041529334212261,40.0,0.0
31517,3,1517,[132 176 313  22 183],344,3,6134,4.040843214756258,0.0,0.0
31518,3,1518,[427 318 185 515 313],655,5,6139,4.04147465437788,40.0,0.0
31519,3,1519,[427 318 185 515 313],655,5,6144,4.042105263157895,40.0,0.0
31520,3,1520,[427 318 185 515 313],655,5,6149,4.042735042735043,40.0,0.0
31521,3,1521,[427 318 185 515 313],655,5,6154,4.043363994743758,40.0,0.0
31522,3,1522,[182 204  95 222 215],796,5,6159,4.043992120814183,0.0,0.0
31523,3,1523,[143  97 117 435  96],756,3,6162,4.043307086614173,0.0,0.0
31524,3,1524,[301 475 286 182 196],655,1,6163,4.041311475409836,0.0,20.0
31525,3,1525,[ 70 174 405 483 161],280,3,6166,4.0406290956749675,0.0,0.0
31526,3,1526,[186 496 204   4  70],18,3,6169,4.039947609692207,20.0,0.0
31527,3,1527,[181  64 100 322  56],256,4,6173,4.039921465968586,20.0,20.0
31528,3,1528,[435 301 196  11 194],535,5,6178,4.040549378678875,0.0,0.0
31529,3,1529,[403 202  15  50  95],796,5,6183,4.041176470588235,0.0,20.0
31530,3,1530,[588 288  15 135  22],450,2,6185,4.0398432397126065,0.0,0.0
31531,3,1531,[135  82   1 546  98],450,3,6188,4.039164490861618,0.0,0.0
31532,3,1532,[117  22 234 200 196],716,5,6193,4.039791258969341,0.0,0.0
31533,3,1533,[427 318 185 515 313],655,5,6198,4.040417209908735,40.0,0.0
31534,3,1534,[427 318 185 515 313],655,5,6203,4.041042345276873,40.0,0.0
31535,3,1535,[427 318 185 515 313],655,5,6208,4.041666666666667,40.0,0.0
31536,3,1536,[427 318 185 515 313],655,5,6213,4.042290175666883,40.0,0.0
31537,3,1537,[  7 588 748 161 179],450,5,6218,4.042912873862159,0.0,0.0
31538,3,1538,[427 318 185 515 313],655,5,6223,4.0435347628330085,40.0,0.0
31539,3,1539,[483 588 300 191 496],716,5,6228,4.044155844155844,20.0,0.0
31540,3,1540,[427 318 185 515 313],655,5,6233,4.044776119402985,40.0,0.0
31541,3,1541,[427 318 185 515 313],655,5,6238,4.045395590142672,40.0,0.0
31542,3,1542,[172 357  89 143 508],269,2,6240,4.044069993519119,0.0,0.0
31543,3,1543,[318 427 185 515 313],655,5,6245,4.044689119170984,40.0,0.0
31544,3,1544,[318 427 185 515 313],655,5,6250,4.0453074433656955,40.0,0.0
31545,3,1545,[318 427 185 515 313],655,5,6255,4.045924967658474,40.0,0.0
31546,3,1546,[271 132  79   4  88],655,1,6256,4.043956043956044,0.0,0.0
31547,3,1547,[318 427 185 515 313],655,5,6261,4.044573643410852,40.0,0.0
31548,3,1548,[318 427 185 515 313],655,5,6266,4.045190445448677,40.0,0.0
31549,3,1549,[318 427 185 515 313],655,5,6271,4.045806451612903,40.0,0.0
31550,3,1550,[182 132 111  28 172],389,4,6275,4.045776918117344,0.0,0.0
31551,3,1551,[588 483 678  88 204],280,2,6277,4.044458762886598,0.0,0.0
31552,3,1552,[ 89 435  15 258 175],151,5,6282,4.04507405022537,0.0,0.0
31553,3,1553,[318 427 185 515 313],655,5,6287,4.045688545688546,40.0,0.0
31554,3,1554,[282 180 435 173 216],716,3,6290,4.045016077170418,0.0,0.0
31555,3,1555,[318 427 185 515 313],655,5,6295,4.045629820051414,40.0,0.0
31556,3,1556,[318 427 185 515 313],655,5,6300,4.046242774566474,40.0,0.0
31557,3,1557,[427 176 405  50 127],796,5,6305,4.046854942233633,20.0,40.0
31558,3,1558,[202 302  50 257  28],389,4,6309,4.046824887748556,0.0,20.0
31559,3,1559,[318 427 185 515 313],655,5,6314,4.047435897435897,40.0,0.0
31560,3,1560,[ 82  89 125 258  69],151,4,6318,4.047405509288917,0.0,0.0
31561,3,1561,[318 427 185 515 313],655,5,6323,4.048015364916774,40.0,0.0
31562,3,1562,[318 427 185 515 313],655,5,6328,4.048624440179142,40.0,0.0
31563,3,1563,[161 143 173  89  97],450,5,6333,4.04923273657289,0.0,0.0
31564,3,1564,[  1 135 185  69 111],450,4,6337,4.049201277955271,0.0,0.0
31565,3,1565,[ 89 294 127 121 183],796,4,6341,4.049169859514687,0.0,20.0
31566,3,1566,[318 427 185 515 313],655,5,6346,4.04977664326739,40.0,0.0
31567,3,1567,[ 64  22  69 179 174],18,4,6350,4.049744897959184,20.0,0.0
31568,3,1568,[ 11 172 176 191 235],457,4,6354,4.049713193116634,0.0,0.0
31569,3,1569,[318 427 185 515 313],655,5,6359,4.0503184713375795,40.0,0.0
31570,3,1570,[185  95 245 496 187],450,4,6363,4.0502864417568425,20.0,0.0
31571,3,1571,[ 22  69 471   1 191],716,4,6367,4.050254452926208,0.0,0.0
31572,3,1572,[195 403 151  50 357],450,5,6372,4.050858232676415,0.0,20.0
31573,3,1573,[357 302 515 568  82],655,3,6375,4.050190597204574,0.0,0.0
31574,3,1574,[176 196  28   4 172],786,5,6380,4.050793650793651,0.0,0.0
31575,3,1575,[181 161 423 174 222],23,3,6383,4.050126903553299,0.0,0.0
31576,3,1576,[742 200 515 118 475],655,2,6385,4.048826886493342,0.0,0.0
31577,3,1577,[271  69 423 111 238],629,5,6390,4.0494296577946765,0.0,0.0
31578,3,1578,[318 427 185 515 313],655,5,6395,4.050031665611146,40.0,0.0
31579,3,1579,[ 69 173  97 222 186],457,5,6400,4.050632911392405,0.0,0.0
31580,3,1580,[318 427 185 515 313],655,5,6405,4.05123339658444,40.0,0.0
31581,3,1581,[127 186  25 655  11],716,4,6409,4.051201011378002,0.0,20.0
31582,3,1582,[318 427 185 515 313],655,5,6414,4.0518003790271635,40.0,0.0
31583,3,1583,[ 82  96 313  70 302],450,4,6418,4.0517676767676765,0.0,0.0
31584,3,1584,[ 82  97 197 471 151],716,4,6422,4.051735015772871,0.0,0.0
31585,3,1585,[ 97 202 161 127 265],655,1,6423,4.0498108448928125,0.0,20.0
31586,3,1586,[234 100 403 175   4],655,0,6423,4.047258979206049,0.0,20.0
31587,3,1587,[ 97  88 483 176 111],655,1,6424,4.045340050377834,0.0,0.0
31588,3,1588,[269 234  28 313 427],796,2,6426,4.044052863436123,20.0,0.0
31589,3,1589,[427 318 185 515 313],655,5,6431,4.044654088050314,40.0,0.0
31590,3,1590,[427 318 185 515 313],655,5,6436,4.045254556882464,40.0,0.0
31591,3,1591,[597 176 427  88  50],269,1,6437,4.043341708542713,20.0,20.0
31592,3,1592,[748 194 176 181 328],292,3,6440,4.042686754551161,0.0,0.0
31593,3,1593,[427 318 185 515 313],655,5,6445,4.043287327478042,40.0,0.0
31594,3,1594,[ 98 234   1 185   4],655,2,6447,4.042006269592476,0.0,0.0
31595,3,1595,[237 471 186  69 655],577,4,6451,4.041979949874687,0.0,0.0
31596,3,1596,[427 318 185 515 313],655,5,6456,4.04257983719474,40.0,0.0
31597,3,1597,[427 318 185 515 313],655,5,6461,4.043178973717146,40.0,0.0
31598,3,1598,[427 318 185 515 313],655,5,6466,4.043777360850531,40.0,0.0
31599,3,1599,[427 318 185 515 313],655,5,6471,4.044375,40.0,0.0
31600,3,1600,[ 11 655 132   9 173],280,3,6474,4.043722673329169,0.0,0.0
31601,3,1601,[ 56 185 176 197 275],655,2,6476,4.0424469413233455,0.0,20.0
31602,3,1602,[268 508  64 132  96],344,4,6480,4.0424204616344355,20.0,0.0
31603,3,1603,[215 322 153  70 204],504,2,6482,4.041147132169576,0.0,0.0
31604,3,1604,[318 427 185 515 313],655,5,6487,4.041744548286604,40.0,0.0
31605,3,1605,[180   4   9 204 427],18,3,6490,4.041095890410959,20.0,0.0
31606,3,1606,[  1 471 211 144  71],807,5,6495,4.041692594897325,0.0,0.0
31607,3,1607,[ 50 228 222 182 125],450,4,6499,4.041666666666667,0.0,20.0
31608,3,1608,[318 427 185 515 313],655,5,6504,4.042262274704785,40.0,0.0
31609,3,1609,[215 483 568 546 228],280,2,6506,4.0409937888198755,0.0,0.0
31610,3,1610,[318 211 183 144  70],450,5,6511,4.041589075108628,20.0,0.0
31611,3,1611,[318 427 185 515 313],655,5,6516,4.042183622828784,40.0,0.0
31612,3,1612,[603 125   1   7  89],151,5,6521,4.042777433353999,20.0,0.0
31613,3,1613,[195 182 200  11 100],269,3,6524,4.042131350681537,0.0,20.0
31614,3,1614,[302 294 191 215 603],450,5,6529,4.042724458204335,20.0,0.0
31615,3,1615,[132   4  22 235 118],450,2,6531,4.041460396039604,0.0,0.0
31616,3,1616,[427 318 185 515 313],655,5,6536,4.042053184910328,40.0,0.0
31617,3,1617,[288 385  79 655 268],655,1,6537,4.0401730531520395,0.0,0.0
31618,3,1618,[ 95 151 125 423 265],798,2,6539,4.038912909203212,0.0,0.0
31619,3,1619,[318 427 185 515 313],655,5,6544,4.0395061728395065,40.0,0.0
31620,3,1620,[ 96 173  11  28 111],450,5,6549,4.040098704503393,0.0,0.0
31621,3,1621,[238 204 210  98 269],18,4,6553,4.040073982737361,0.0,0.0
31622,3,1622,[191 603 197 202   1],389,5,6558,4.040665434380776,20.0,0.0
31623,3,1623,[318 427 185 515 313],655,5,6563,4.041256157635468,40.0,0.0
31624,3,1624,[175 187 172 568 427],716,3,6566,4.040615384615385,20.0,0.0
31625,3,1625,[318 427 185 515 313],655,5,6571,4.04120541205412,40.0,0.0
31626,3,1626,[318 427 185 515 313],655,5,6576,4.04179471419791,40.0,0.0
31627,3,1627,[748 117 228   7 234],280,2,6578,4.04054054054054,0.0,0.0
31628,3,1628,[ 95 125 194 202  25],577,5,6583,4.041129527317373,0.0,0.0
31629,3,1629,[294 275 186 234 257],655,1,6584,4.039263803680981,0.0,20.0
31630,3,1630,[318 427 185 515 313],655,5,6589,4.039852851011649,40.0,0.0
31631,3,1631,[ 15 603 483 183  79],655,4,6593,4.039828431372549,20.0,0.0
31632,3,1632,[318 427 185 515 313],655,5,6598,4.040416411512553,40.0,0.0
31633,3,1633,[318 427 185 515 313],655,5,6603,4.041003671970624,40.0,0.0
31634,3,1634,[  8 182 195  69 588],18,3,6606,4.040366972477064,0.0,0.0
31635,3,1635,[318 427 185 515 313],655,5,6611,4.040953545232274,40.0,0.0
31636,3,1636,[318 427 185 515 313],655,5,6616,4.041539401343922,40.0,0.0
31637,3,1637,[318 427 185 515 313],655,5,6621,4.042124542124542,40.0,0.0
31638,3,1638,[168 234 174 228  97],450,4,6625,4.042098840756559,0.0,0.0
31639,3,1639,[318 427 185 515 313],655,5,6630,4.0426829268292686,40.0,0.0
31640,3,1640,[ 96 183 357 603  70],269,2,6632,4.041438147471054,20.0,0.0
31641,3,1641,[  4 655  69 187 271],629,4,6636,4.041412911084044,0.0,0.0
31642,3,1642,[318 427 185 515 313],655,5,6641,4.041996348143639,40.0,0.0
31643,3,1643,[ 89  22 211   4 655],796,3,6644,4.041362530413625,0.0,0.0
31644,3,1644,[318 427 185 515 313],655,5,6649,4.0419452887538,40.0,0.0
31645,3,1645,[ 64 423  82 151 187],450,4,6653,4.041919805589307,20.0,0.0
31646,3,1646,[318 427 185 515 313],655,5,6658,4.042501517911354,40.0,0.0
31647,3,1647,[318 427 185 515 313],655,5,6663,4.043082524271845,40.0,0.0
31648,3,1648,[183 423  28 202   1],655,1,6664,4.041237113402062,0.0,0.0
31649,3,1649,[288 216 185 286  12],450,4,6668,4.041212121212121,0.0,20.0
31650,3,1650,[318 427 185 515 313],655,5,6673,4.041792852816475,40.0,0.0
31651,3,1651,[282  64  12 405  96],457,5,6678,4.0423728813559325,20.0,0.0
31652,3,1652,[185 405  12  56 183],655,2,6680,4.041137326073805,0.0,0.0
31653,3,1653,[318 427 185 515 313],655,5,6685,4.041717049576784,40.0,0.0
31654,3,1654,[318 427 185 515 313],655,5,6690,4.042296072507553,40.0,0.0
31655,3,1655,[300 603 588 211  50],450,5,6695,4.042874396135265,20.0,20.0
31656,3,1656,[172 135 265  70 121],457,5,6700,4.043452021726011,0.0,0.0
31657,3,1657,[318 427 185 515 313],655,5,6705,4.044028950542823,40.0,0.0
31658,3,1658,[ 50 357 197 318   1],716,5,6710,4.0446051838456905,20.0,20.0
31659,3,1659,[568 194 143 603 496],716,5,6715,4.045180722891566,40.0,0.0
31660,3,1660,[222 357 228 471 427],716,4,6719,4.045153521974714,20.0,0.0
31661,3,1661,[568 111  69 216 144],716,4,6723,4.0451263537906135,0.0,0.0
31662,3,1662,[318 427 185 515 313],655,5,6728,4.0457005411906195,40.0,0.0
31663,3,1663,[318 427 185 515 313],655,5,6733,4.046274038461538,40.0,0.0
31664,3,1664,[182 185 200 111 238],18,2,6735,4.045045045045045,0.0,0.0
31665,3,1665,[288 211 187 185  56],450,4,6739,4.045018007202881,0.0,0.0
31666,3,1666,[183  69 286  79 125],796,4,6743,4.04499100179964,0.0,20.0
31667,3,1667,[318 427 515 185 313],655,5,6748,4.045563549160671,40.0,0.0
31668,3,1668,[546 125 385 222 322],280,3,6751,4.044937088076693,0.0,0.0
31669,3,1669,[318 427 515 185 313],655,5,6756,4.045508982035928,40.0,0.0
31670,3,1670,[318 427 515 185 313],655,5,6761,4.046080191502095,40.0,0.0
31671,3,1671,[318 427 515 185 313],655,5,6766,4.04665071770335,40.0,0.0
31672,3,1672,[405  11  97 228  22],457,5,6771,4.047220561864913,0.0,0.0
31673,3,1673,[211 237 151 275 228],450,5,6776,4.04778972520908,0.0,20.0
31674,3,1674,[ 96 183  22 471 168],716,2,6778,4.046567164179105,0.0,0.0
31675,3,1675,[318 427 515 185 313],655,5,6783,4.047136038186157,40.0,0.0
31676,3,1676,[196 483 144  79  50],716,4,6787,4.047107930828861,0.0,20.0
31677,3,1677,[742 546 197 200   7],280,4,6791,4.047079856972586,0.0,0.0
31678,3,1678,[ 28 161 179   9 196],504,4,6795,4.047051816557475,0.0,0.0
31679,3,1679,[318 427 515 185 313],655,5,6800,4.0476190476190474,40.0,0.0
31680,3,1680,[183 385 288  50 175],344,4,6804,4.047590719809637,0.0,20.0
31681,3,1681,[318 427 515 185 313],655,5,6809,4.048156956004756,40.0,0.0
31682,3,1682,[ 89 294 257 238 179],296,4,6813,4.048128342245989,0.0,0.0
31683,3,1683,[222   7 234 515 282],292,3,6816,4.04750593824228,0.0,0.0
31684,3,1684,[318 427 515 185 313],655,5,6821,4.048071216617211,40.0,0.0
31685,3,1685,[427 210 302 168 238],151,4,6825,4.048042704626335,20.0,0.0
31686,3,1686,[211 151 237  50  56],796,4,6829,4.048014226437463,0.0,20.0
31687,3,1687,[318 427 515 185 313],655,5,6834,4.048578199052133,40.0,0.0
31688,3,1688,[318 427 515 185 313],655,5,6839,4.049141503848431,40.0,0.0
31689,3,1689,[ 22 265 678  50 546],280,3,6842,4.048520710059171,0.0,20.0
31690,3,1690,[318 427 515 185 313],655,5,6847,4.049083382613838,40.0,0.0
31691,3,1691,[318 427 515 185 313],655,5,6852,4.049645390070922,40.0,0.0
31692,3,1692,[302 210 471 118  95],389,2,6854,4.048434731246308,0.0,0.0
31693,3,1693,[655 161 603 222 187],72,4,6858,4.04840613931523,20.0,0.0
31694,3,1694,[318 427 515 185 313],655,5,6863,4.048967551622419,40.0,0.0
31695,3,1695,[125   1  69  28 180],457,5,6868,4.0495283018867925,0.0,0.0
31696,3,1696,[288 180 742  56 222],450,3,6871,4.048909840895698,0.0,0.0
31697,3,1697,[496 127 197 172 173],450,5,6876,4.049469964664311,20.0,20.0
31698,3,1698,[318 427 515 185 313],655,5,6881,4.050029429075927,40.0,0.0
31699,3,1699,[318 427 515 185 313],655,5,6886,4.050588235294118,40.0,0.0
31700,3,1700,[318 427 515 185 313],655,5,6891,4.0511463844797175,40.0,0.0
31701,3,1701,[318 427 515 185 313],655,5,6896,4.0517038777908345,40.0,0.0
31702,3,1702,[ 64 300  69  95 273],450,3,6899,4.05108631826189,20.0,0.0
31703,3,1703,[194  64 135 196   4],450,3,6902,4.050469483568075,20.0,0.0
31704,3,1704,[180  70  69 496 182],18,4,6906,4.0504398826979475,20.0,0.0
31705,3,1705,[568 405 172 194 318],72,3,6909,4.049824150058616,20.0,0.0
31706,3,1706,[318 427 515 185 313],655,5,6914,4.050380785002929,40.0,0.0
31707,3,1707,[318 427 515 185 313],655,5,6919,4.0509367681498825,40.0,0.0
31708,3,1708,[318 427 515 185 313],655,5,6924,4.051492100643651,40.0,0.0
31709,3,1709,[100 357 275 121 200],151,3,6927,4.0508771929824565,0.0,40.0
31710,3,1710,[  1 117 161 655   4],593,3,6930,4.050263004091175,0.0,0.0
31711,3,1711,[318 427 515 185 313],655,5,6935,4.050817757009346,40.0,0.0
31712,3,1712,[318 427 515 185 313],655,5,6940,4.051371862230006,40.0,0.0
31713,3,1713,[318 427 515 185 313],655,5,6945,4.051925320886815,40.0,0.0
31714,3,1714,[318 427 515 185 313],655,5,6950,4.052478134110787,40.0,0.0
31715,3,1715,[174 496  70  12   8],707,1,6951,4.050699300699301,20.0,0.0
31716,3,1716,[427 318 515 185 313],655,5,6956,4.0512521840419335,40.0,0.0
31717,3,1717,[144 135 276  70 318],280,4,6960,4.051222351571595,20.0,0.0
31718,3,1718,[202 357 168  96 132],457,5,6965,4.051774287376381,0.0,0.0
31719,3,1719,[ 50 111  89 215 182],18,2,6967,4.050581395348837,0.0,20.0
31720,3,1720,[405   7 276 182   4],280,2,6969,4.0493898895990705,0.0,0.0
31721,3,1721,[174 603 403 187 357],269,3,6972,4.048780487804878,20.0,0.0
31722,3,1722,[245 215 300 153 333],796,4,6976,4.048752176436448,0.0,0.0
31723,3,1723,[318 427 515 185 313],655,5,6981,4.049303944315545,40.0,0.0
31724,3,1724,[275 121 237 180 111],786,4,6985,4.04927536231884,0.0,20.0
31725,3,1725,[318 427 515 185 313],655,5,6990,4.049826187717265,40.0,0.0
31726,3,1726,[269 546 215 427 173],23,3,6993,4.0492182976259405,20.0,0.0
31727,3,1727,[483 135 118 588 282],716,2,6995,4.048032407407407,0.0,0.0
31728,3,1728,[191 423 483 182 286],796,4,6999,4.048004626951996,0.0,20.0
31729,3,1729,[318 427 515 185 313],655,5,7004,4.048554913294797,40.0,0.0
31730,3,1730,[318 427 515 185 313],655,5,7009,4.049104563835933,40.0,0.0
31731,3,1731,[318 427 515 185 313],655,5,7014,4.049653579676674,40.0,0.0
31732,3,1732,[318 427 515 185 313],655,5,7019,4.050201961915753,40.0,0.0
31733,3,1733,[235 318  71 185 125],450,3,7022,4.04959630911188,20.0,0.0
31734,3,1734,[228 265 222 423 111],655,0,7022,4.047262247838617,0.0,0.0
31735,3,1735,[127 286 174 161 144],796,4,7026,4.047235023041475,0.0,40.0
31736,3,1736,[318 427 515 185 313],655,5,7031,4.047783534830167,40.0,0.0
31737,3,1737,[318 427 515 185 313],655,5,7036,4.048331415420023,40.0,0.0
31738,3,1738,[318 427 515 185 313],655,5,7041,4.0488786658999425,40.0,0.0
31739,3,1739,[ 82 215 357 515 603],716,5,7046,4.049425287356322,20.0,0.0
31740,3,1740,[318 427 515 185 313],655,5,7051,4.049971280873061,40.0,0.0
31741,3,1741,[191 276 289 187 183],786,4,7055,4.049942594718714,0.0,0.0
31742,3,1742,[427 318 515 185 313],655,5,7060,4.050487664945496,40.0,0.0
31743,3,1743,[427 318 515 185 313],655,5,7065,4.051032110091743,40.0,0.0
31744,3,1744,[427 318 515 185 313],655,5,7070,4.051575931232092,40.0,0.0
31745,3,1745,[427 318 515 185 313],655,5,7075,4.052119129438717,40.0,0.0
31746,3,1746,[ 96 597  50 211 111],450,5,7080,4.05266170578134,0.0,20.0
31747,3,1747,[427 318 515 185 313],655,5,7085,4.053203661327231,40.0,0.0
31748,3,1748,[427 318 515 185 313],655,5,7090,4.053744997141224,40.0,0.0
31749,3,1749,[427 318 515 185 313],655,5,7095,4.054285714285714,40.0,0.0
31750,3,1750,[235 568 322 546 182],280,3,7098,4.053683609366076,0.0,0.0
31751,3,1751,[427 318 515 185 313],655,5,7103,4.054223744292237,40.0,0.0
31752,3,1752,[216  95 294 271 275],796,4,7107,4.054192812321734,0.0,20.0
31753,3,1753,[427 318 515 185 313],655,5,7112,4.05473204104903,40.0,0.0
31754,3,1754,[196 216 483  82  69],655,2,7114,4.053561253561254,0.0,0.0
31755,3,1755,[427 318 515 185 313],655,5,7119,4.054100227790433,40.0,0.0
31756,3,1756,[313 508 333  98  79],655,3,7122,4.053500284575982,0.0,0.0
31757,3,1757,[427 318 515 185 313],655,5,7127,4.054038680318544,40.0,0.0
31758,3,1758,[427 318 515 185 313],655,5,7132,4.054576463899943,40.0,0.0
31759,3,1759,[427 318 515 185 313],655,5,7137,4.055113636363636,40.0,0.0
31760,3,1760,[313 271 202 210 302],655,2,7139,4.053946621237933,0.0,0.0
31761,3,1761,[427 318 515 185 313],655,5,7144,4.054483541430193,40.0,0.0
31762,3,1762,[427 318 515 185 313],655,5,7149,4.055019852524107,40.0,0.0
31763,3,1763,[ 88  28  82 265  70],457,5,7154,4.055555555555555,0.0,0.0
31764,3,1764,[427 318 515 185 313],655,5,7159,4.0560906515580735,40.0,0.0
31765,3,1765,[215 153 194 282 196],504,3,7162,4.055492638731597,0.0,0.0
31766,3,1766,[427 318 515 185 313],655,5,7167,4.056027164685909,40.0,0.0
31767,3,1767,[196 496 143 435 179],269,2,7169,4.054864253393665,20.0,0.0
31768,3,1768,[427 318 515 185 313],655,5,7174,4.0553985302430755,40.0,0.0
31769,3,1769,[161 286 546 181 187],786,5,7179,4.055932203389831,0.0,20.0
31770,3,1770,[302 568   1 172 483],450,4,7183,4.055900621118012,0.0,0.0
31771,3,1771,[483 200  22 174 286],280,4,7187,4.055869074492099,0.0,20.0
31772,3,1772,[471 121  79 228 508],693,1,7188,4.05414551607445,0.0,0.0
31773,3,1773,[183 121  12 202   8],344,4,7192,4.0541149943630215,0.0,0.0
31774,3,1774,[427 318 515 185 313],655,5,7197,4.054647887323943,40.0,0.0
31775,3,1775,[ 98 143  25 294 588],577,4,7201,4.054617117117117,0.0,0.0
31776,3,1776,[427 318 515 185 313],655,5,7206,4.0551491277433875,40.0,0.0
31777,3,1777,[748 234 186  11 603],450,3,7209,4.0545556805399325,20.0,0.0
31778,3,1778,[127 196 200 216 655],236,2,7211,4.053400786958965,0.0,20.0
31779,3,1779,[357 294 118  28 238],796,2,7213,4.052247191011236,0.0,0.0
31780,3,1780,[191   9  82  89 200],786,5,7218,4.05277933745087,0.0,0.0
31781,3,1781,[427 318 515 185 313],655,5,7223,4.05331088664422,40.0,0.0
31782,3,1782,[168   9 483 204  56],151,5,7228,4.053841839596187,0.0,0.0
31783,3,1783,[238 286 187 268   4],629,4,7232,4.053811659192825,0.0,20.0
31784,3,1784,[  1 588 748 403 286],450,5,7237,4.054341736694678,0.0,20.0
31785,3,1785,[176 118 269 234 313],796,3,7240,4.0537513997760355,0.0,0.0
31786,3,1786,[111 200 222   1 204],280,3,7243,4.053161723559038,0.0,0.0
31787,3,1787,[427 318 515 185 313],655,5,7248,4.053691275167785,40.0,0.0
31788,3,1788,[301  28 302  25 269],655,1,7249,4.051984348798212,0.0,0.0
31789,3,1789,[176 151 313  82 127],450,4,7253,4.05195530726257,0.0,20.0
31790,3,1790,[ 70 135 496  22 515],269,3,7256,4.051367950865438,20.0,0.0
31791,3,1791,[100 202 483 118 405],655,1,7257,4.049665178571429,0.0,20.0
31792,3,1792,[427 318 515 185 313],655,5,7262,4.050195203569436,40.0,0.0
31793,3,1793,[568   7 127 427 271],72,3,7265,4.049609810479375,20.0,20.0
31794,3,1794,[257 222  28 132 210],796,3,7268,4.049025069637883,0.0,0.0
31795,3,1795,[ 22 211 195   1  89],18,3,7271,4.048440979955457,0.0,0.0
31796,3,1796,[215  50   1  25 204],577,5,7276,4.048970506399555,0.0,20.0
31797,3,1797,[  1 265 132 471 180],450,5,7281,4.049499443826474,0.0,0.0
31798,3,1798,[427 318 515 185 313],655,5,7286,4.0500277932184545,40.0,0.0
31799,3,1799,[127 187 423 197 568],693,2,7288,4.0488888888888885,0.0,20.0
31800,3,1800,[ 96 742 405 483 172],655,2,7290,4.047751249305941,0.0,0.0
31801,3,1801,[475   4 186 237 191],655,1,7291,4.046059933407325,0.0,0.0
31802,3,1802,[135 515 435 194 265],807,4,7295,4.046034387132557,0.0,0.0
31803,3,1803,[168  88 748 568 496],796,5,7300,4.046563192904657,20.0,0.0
31804,3,1804,[318 496 121  97 405],503,3,7303,4.045983379501385,40.0,0.0
31805,3,1805,[427 318 515 185 313],655,5,7308,4.046511627906977,40.0,0.0
31806,3,1806,[427 318 515 185 313],655,5,7313,4.047039291643608,40.0,0.0
31807,3,1807,[185   1 210 204 186],151,5,7318,4.047566371681416,0.0,0.0
31808,3,1808,[427 318 515 185 313],655,5,7323,4.048092868988391,40.0,0.0
31809,3,1809,[427 318 515 185 313],655,5,7328,4.048618784530387,40.0,0.0
31810,3,1810,[427 318 515 185 313],655,5,7333,4.049144119271121,40.0,0.0
31811,3,1811,[427 318 515 185 313],655,5,7338,4.049668874172186,40.0,0.0
31812,3,1812,[245 333 385  88 182],796,4,7342,4.049641478212907,0.0,0.0
31813,3,1813,[427 318 515 185 313],655,5,7347,4.050165380374862,40.0,0.0
31814,3,1814,[427 318 515 185 313],655,5,7352,4.05068870523416,40.0,0.0
31815,3,1815,[333 273  79 187 132],796,4,7356,4.0506607929515415,0.0,0.0
31816,3,1816,[597 568 187 196 153],269,1,7357,4.048981838194827,0.0,0.0
31817,3,1817,[427 318 515 185 313],655,5,7362,4.0495049504950495,40.0,0.0
31818,3,1818,[288 357 273 211 202],450,3,7365,4.048927982407917,0.0,0.0
31819,3,1819,[427 173 546 135 174],807,4,7369,4.048901098901099,20.0,0.0
31820,3,1820,[427 318 515 185 313],655,5,7374,4.049423393739703,40.0,0.0
31821,3,1821,[427 318 515 185 313],655,5,7379,4.049945115257958,40.0,0.0
31822,3,1822,[427 318 515 185 313],655,5,7384,4.050466264399342,40.0,0.0
31823,3,1823,[135 194 403 294 245],450,4,7388,4.050438596491228,0.0,0.0
31824,3,1824,[ 88 204 197 185 181],655,1,7389,4.048767123287671,0.0,0.0
31825,3,1825,[174 204  56  88 301],450,5,7394,4.049288061336254,0.0,0.0
31826,3,1826,[ 69 222 175  25 301],344,4,7398,4.0492610837438425,0.0,0.0
31827,3,1827,[195 118  79 322 125],344,2,7400,4.048140043763676,0.0,0.0
31828,3,1828,[204 678 302 235   4],344,3,7403,4.047566976489885,0.0,0.0
31829,3,1829,[  9 597 174  12   1],344,3,7406,4.046994535519126,0.0,0.0
31830,3,1830,[172 238 185 483  22],716,5,7411,4.047515019115237,0.0,0.0
31831,3,1831,[282  82 216  12 435],655,1,7412,4.045851528384279,0.0,0.0
31832,3,1832,[ 56 121 200 194  22],577,3,7415,4.045280960174577,0.0,0.0
31833,3,1833,[427 318 515 185 313],655,5,7420,4.0458015267175576,40.0,0.0
31834,3,1834,[196 276 172 286 202],344,4,7424,4.045776566757493,0.0,20.0
31835,3,1835,[204 483  50 125 173],796,5,7429,4.046296296296297,0.0,20.0
31836,3,1836,[132 175 185 318   7],151,5,7434,4.046815459989113,20.0,0.0
31837,3,1837,[427 318 515 185 313],655,5,7439,4.047334058759521,40.0,0.0
31838,3,1838,[427 318 515 185 313],655,5,7444,4.047852093529092,40.0,0.0
31839,3,1839,[117 180 195 151  79],716,3,7447,4.047282608695652,0.0,0.0
31840,3,1840,[265  82 289 187 181],786,5,7452,4.04780010863661,0.0,0.0
31841,3,1841,[ 79  69 385 186 496],716,3,7455,4.047231270358306,20.0,0.0
31842,3,1842,[269 210 282 180 238],450,4,7459,4.047205642973413,0.0,0.0
31843,3,1843,[210 191  79  98 471],344,4,7463,4.047180043383948,0.0,0.0
31844,3,1844,[202 322 237 603 197],450,5,7468,4.04769647696477,20.0,0.0
31845,3,1845,[427 318 515 185 313],655,5,7473,4.048212351029252,40.0,0.0
31846,3,1846,[258 174 182 191 172],457,5,7478,4.048727666486194,0.0,0.0
31847,3,1847,[ 15  97 318 423 121],11,4,7482,4.048701298701299,20.0,0.0
31848,3,1848,[121 508 153   4 175],655,0,7482,4.046511627906977,0.0,0.0
31849,3,1849,[427 318 515 185 313],655,5,7487,4.047027027027027,40.0,0.0
31850,3,1850,[427 318 515 185 313],655,5,7492,4.0475418692598595,40.0,0.0
31851,3,1851,[427 318 515 185 313],655,5,7497,4.04805615550756,40.0,0.0
31852,3,1852,[176 302 216  50 471],450,5,7502,4.048569886670265,0.0,20.0
31853,3,1853,[ 11  28 216 187  79],655,3,7505,4.048004314994606,0.0,0.0
31854,3,1854,[568 237 235 265 174],280,2,7507,4.046900269541779,0.0,0.0
31855,3,1855,[427 318 515 185 313],655,5,7512,4.047413793103448,40.0,0.0
31856,3,1856,[204  50 118 100 210],344,4,7516,4.047388260635434,0.0,40.0
31857,3,1857,[742 197 238 405 121],655,0,7516,4.045209903121636,0.0,0.0
31858,3,1858,[427 318 515 185 313],655,5,7521,4.045723507261969,40.0,0.0
31859,3,1859,[427 318 515 185 313],655,5,7526,4.046236559139785,40.0,0.0
31860,3,1860,[427 318 515 185 313],655,5,7531,4.046749059645352,40.0,0.0
31861,3,1861,[427 318 515 185 313],655,5,7536,4.047261009667024,40.0,0.0
31862,3,1862,[427 318 515 185 313],655,5,7541,4.047772410091251,40.0,0.0
31863,3,1863,[427 318 515 185 313],655,5,7546,4.048283261802575,40.0,0.0
31864,3,1864,[ 82 385 483 322 121],151,2,7548,4.047184986595174,0.0,0.0
31865,3,1865,[427 318 515 185 313],655,5,7553,4.047695605573419,40.0,0.0
31866,3,1866,[ 98 483 235  70  56],457,4,7557,4.04767005891805,0.0,0.0
31867,3,1867,[322 197 127  70 483],280,4,7561,4.047644539614561,0.0,20.0
31868,3,1868,[  7 276 173  22 183],457,5,7566,4.048154093097914,0.0,0.0
31869,3,1869,[427 318 515 185 313],655,5,7571,4.048663101604278,40.0,0.0
31870,3,1870,[427 318 515 185 313],655,5,7576,4.049171566007483,40.0,0.0
31871,3,1871,[427 318 515 185 313],655,5,7581,4.049679487179487,40.0,0.0
31872,3,1872,[427 318 515 185 313],655,5,7586,4.05018686599039,40.0,0.0
31873,3,1873,[257 235  96 197  11],716,3,7589,4.049626467449306,0.0,0.0
31874,3,1874,[328 125   7  50 257],938,3,7592,4.049066666666667,0.0,20.0
31875,3,1875,[ 96 176 181  28   9],693,1,7593,4.047441364605544,0.0,0.0
31876,3,1876,[427 318 515 185 313],655,5,7598,4.047948854555141,40.0,0.0
31877,3,1877,[318 174 357 194 200],269,4,7602,4.047923322683706,20.0,0.0
31878,3,1878,[132 191 118 127 568],716,4,7606,4.047897817988292,0.0,20.0
31879,3,1879,[183 357  98 257 111],457,3,7609,4.047340425531915,0.0,0.0
31880,3,1880,[588  79 173 234 215],280,2,7611,4.046251993620415,0.0,0.0
31881,3,1881,[182 118  97 294  28],450,4,7615,4.046227417640807,0.0,0.0
31882,3,1882,[603 222 210 211 568],796,3,7618,4.04567180031864,20.0,0.0
31883,3,1883,[742 228   4  28 127],457,5,7623,4.046178343949045,0.0,20.0
31884,3,1884,[269 748 204 302 322],450,5,7628,4.046684350132626,0.0,0.0
31885,3,1885,[276 508   9 211 357],535,3,7631,4.046129374337221,0.0,0.0
31886,3,1886,[483 301 185 269 195],655,2,7633,4.045045045045045,0.0,0.0
31887,3,1887,[118 215  96 168 655],504,4,7637,4.045021186440678,0.0,0.0
31888,3,1888,[301 100  96  98  56],450,5,7642,4.0455267337215455,0.0,20.0
31889,3,1889,[427 318 515 185 313],655,5,7647,4.046031746031746,40.0,0.0
31890,3,1890,[210 228 204 237 216],796,4,7651,4.046007403490217,0.0,0.0
31891,3,1891,[427 318 515 185 313],655,5,7656,4.046511627906977,40.0,0.0
31892,3,1892,[118 204 300 202 210],151,4,7660,4.04648705758056,0.0,0.0
31893,3,1893,[568 748 168 185 174],796,5,7665,4.046990496304118,0.0,0.0
31894,3,1894,[322 195  79 546  25],450,4,7669,4.046965699208443,0.0,0.0
31895,3,1895,[ 50  98  11 204 423],655,2,7671,4.045886075949367,0.0,20.0
31896,3,1896,[427 318 515 185 313],655,5,7676,4.046389035318924,40.0,0.0
31897,3,1897,[655 173 322 111 197],786,3,7679,4.045837723919916,0.0,0.0
31898,3,1898,[100 135 357 172 568],269,3,7682,4.045286993154292,0.0,20.0
31899,3,1899,[ 15  82 186 258 568],457,5,7687,4.04578947368421,0.0,0.0
31900,3,1900,[427 318 515 185 313],655,5,7692,4.046291425565492,40.0,0.0
31901,3,1901,[403   7 185  97 237],457,5,7697,4.0467928496319665,0.0,0.0
31902,3,1902,[132   1  97 294 282],450,5,7702,4.047293746715712,0.0,0.0
31903,3,1903,[143 748 172   8 265],807,5,7707,4.047794117647059,0.0,0.0
31904,3,1904,[427 318 515 185 313],655,5,7712,4.048293963254594,40.0,0.0
31905,3,1905,[211 300 405 237  97],716,5,7717,4.048793284365162,0.0,0.0
31906,3,1906,[655 194 127 275 182],629,5,7722,4.0492920818038804,0.0,40.0
31907,3,1907,[294 182 204 180 237],796,3,7725,4.04874213836478,0.0,0.0
31908,3,1908,[427 318 515 185 313],655,5,7730,4.049240440020953,40.0,0.0
31909,3,1909,[ 11 121  12 282 228],457,5,7735,4.049738219895288,0.0,0.0
31910,3,1910,[194 204 143 187  88],18,2,7737,4.048665620094192,0.0,0.0
31911,3,1911,[127  56 235 143  25],716,4,7741,4.048640167364017,0.0,20.0
31912,3,1912,[427 318 515 185 313],655,5,7746,4.049137480397282,40.0,0.0
31913,3,1913,[427 318 515 185 313],655,5,7751,4.049634273772205,40.0,0.0
31914,3,1914,[427 318 515 185 313],655,5,7756,4.050130548302872,40.0,0.0
31915,3,1915,[ 95 204 183 286 100],280,2,7758,4.049060542797495,0.0,40.0
31916,3,1916,[ 50 176 357 196 121],344,4,7762,4.049034950443401,0.0,20.0
31917,3,1917,[427 318 515 185 313],655,5,7767,4.049530761209593,40.0,0.0
31918,3,1918,[322 182  95 228 215],280,2,7769,4.048462741010943,0.0,0.0
31919,3,1919,[202 405 174 161  22],716,4,7773,4.0484375,0.0,0.0
31920,3,1920,[276 282 179 403  25],457,5,7778,4.048932847475274,0.0,0.0
31921,3,1921,[172 742  12 200 568],577,3,7781,4.048387096774194,0.0,0.0
31922,3,1922,[427 318 515 185 313],655,5,7786,4.048881955278211,40.0,0.0
31923,3,1923,[ 88 588 125 186 100],786,5,7791,4.049376299376299,0.0,20.0
31924,3,1924,[427 318 515 185 313],655,5,7796,4.04987012987013,40.0,0.0
31925,3,1925,[222  71  89  95 175],23,4,7800,4.049844236760125,0.0,0.0
31926,3,1926,[  7 173 182  28 118],450,4,7804,4.049818370524131,0.0,0.0
31927,3,1927,[215 196 322 300 273],796,3,7807,4.049273858921162,0.0,0.0
31928,3,1928,[427 318 515 185 313],655,5,7812,4.049766718506999,40.0,0.0
31929,3,1929,[ 96 471 286 234 496],450,4,7816,4.049740932642487,20.0,20.0
31930,3,1930,[427 318 515 185 313],655,5,7821,4.050233039875712,40.0,0.0
31931,3,1931,[427 318 515 185 313],655,5,7826,4.050724637681159,40.0,0.0
31932,3,1932,[118 174 427 125 100],796,4,7830,4.050698396275219,20.0,20.0
31933,3,1933,[427 318 515 185 313],655,5,7835,4.051189245087901,40.0,0.0
31934,3,1934,[161 318 117 191 588],716,4,7839,4.051162790697674,20.0,0.0
31935,3,1935,[427 318 515 185 313],655,5,7844,4.051652892561983,40.0,0.0
31936,3,1936,[427 318 515 185 313],655,5,7849,4.052142488384099,40.0,0.0
31937,3,1937,[172  50 269  12  97],450,5,7854,4.052631578947368,0.0,20.0
31938,3,1938,[234 186  88 268 471],655,0,7854,4.050541516245487,0.0,0.0
31939,3,1939,[238 471 588 196 143],389,3,7857,4.05,0.0,0.0
31940,3,1940,[  4 125 655 318 195],504,5,7862,4.050489438433797,20.0,0.0
31941,3,1941,[427 318 515 185 313],655,5,7867,4.050978372811534,40.0,0.0
31942,3,1942,[427 318 515 185 313],655,5,7872,4.051466803911477,40.0,0.0
31943,3,1943,[ 69 111 202 172 318],18,1,7873,4.049897119341564,20.0,0.0
31944,3,1944,[508 215 118  97 144],693,3,7876,4.049357326478149,0.0,0.0
31945,3,1945,[215 222 161 172  22],655,1,7877,4.047790339157245,0.0,0.0
31946,3,1946,[ 11 328 173 183 265],292,4,7881,4.047765793528505,0.0,0.0
31947,3,1947,[427 318 515 185 313],655,5,7886,4.0482546201232035,40.0,0.0
31948,3,1948,[427 318 515 185 313],655,5,7891,4.048742945100051,40.0,0.0
31949,3,1949,[286 471 228 603 427],450,5,7896,4.049230769230769,40.0,20.0
31950,3,1950,[427 318 515 185 313],655,5,7901,4.049718093285494,40.0,0.0
31951,3,1951,[237 301 273 427 185],655,3,7904,4.049180327868853,20.0,0.0
31952,3,1952,[204  15 186  98 179],835,4,7908,4.04915514592934,0.0,0.0
31953,3,1953,[196 100 191 127  12],72,5,7913,4.0496417604912995,0.0,40.0
31954,3,1954,[427 318 515 185 313],655,5,7918,4.050127877237852,40.0,0.0
31955,3,1955,[427 318 515 185 313],655,5,7923,4.050613496932515,40.0,0.0
31956,3,1956,[195 588 125 496  82],786,5,7928,4.0510986203372505,20.0,0.0
31957,3,1957,[179 655  82  88  22],878,2,7930,4.050051072522983,0.0,0.0
31958,3,1958,[  1 173  69  88 216],151,5,7935,4.050535987748852,0.0,0.0
31959,3,1959,[427 318 515 185 313],655,5,7940,4.051020408163265,40.0,0.0
31960,3,1960,[427 318 515 185 313],655,5,7945,4.0515043345232025,40.0,0.0
31961,3,1961,[197 276 195 496 318],18,4,7949,4.051478083588175,40.0,0.0
31962,3,1962,[215 100 181 195 111],344,3,7952,4.050942435048396,0.0,20.0
31963,3,1963,[427 318 515 185 313],655,5,7957,4.05142566191446,40.0,0.0
31964,3,1964,[427 318 515 185 313],655,5,7962,4.051908396946565,40.0,0.0
31965,3,1965,[427 318 515 185 313],655,5,7967,4.052390640895219,40.0,0.0
31966,3,1966,[427 318 515 185 313],655,5,7972,4.052872394509405,40.0,0.0
31967,3,1967,[427 318 515 185 313],655,5,7977,4.053353658536586,40.0,0.0
31968,3,1968,[234 194  12 258 238],629,5,7982,4.0538344337227015,0.0,0.0
31969,3,1969,[427 318 515 185 313],655,5,7987,4.054314720812183,40.0,0.0
31970,3,1970,[179 153  15  89 237],18,3,7990,4.053779807204465,0.0,0.0
31971,3,1971,[197 185  25 282 100],457,5,7995,4.054259634888438,0.0,20.0
31972,3,1972,[423 357 125 603 185],450,5,8000,4.054738976178409,20.0,0.0
31973,3,1973,[508 294 603 483  71],401,2,8002,4.053698074974671,20.0,0.0
31974,3,1974,[181 238 228  69  98],450,5,8007,4.054177215189873,0.0,0.0
31975,3,1975,[215  15 151 204 435],18,2,8009,4.053137651821863,0.0,0.0
31976,3,1976,[191 172  56 127 135],450,4,8013,4.053110773899848,0.0,20.0
31977,3,1977,[427 318 515 185 313],655,5,8018,4.0535894843276035,40.0,0.0
31978,3,1978,[161 237 427 546 132],716,3,8021,4.053057099545224,20.0,0.0
31979,3,1979,[  8  28 269 180  12],796,2,8023,4.052020202020202,0.0,0.0
31980,3,1980,[179  88  96 182 215],457,5,8028,4.0524987380111055,0.0,0.0
31981,3,1981,[427 318 515 185 313],655,5,8033,4.052976791120081,40.0,0.0
31982,3,1982,[427 318 515 185 313],655,5,8038,4.05345436207766,40.0,0.0
31983,3,1983,[127 117 118 181 204],796,5,8043,4.053931451612903,0.0,20.0
31984,3,1984,[427 318 515 185 313],655,5,8048,4.0544080604534,40.0,0.0
31985,3,1985,[ 97 202 588 195 161],330,4,8052,4.054380664652568,0.0,0.0
31986,3,1986,[ 79 204 282 179 275],535,3,8055,4.053850025163563,0.0,20.0
31987,3,1987,[427 318 515 185 313],655,5,8060,4.054325955734407,40.0,0.0
31988,3,1988,[117 135 282 286 111],236,3,8063,4.053795877325289,0.0,20.0
31989,3,1989,[  9  89  64 186 121],457,5,8068,4.05427135678392,20.0,0.0
31990,3,1990,[ 88 282 435 187 196],655,1,8069,4.0527373179306885,0.0,0.0
31991,3,1991,[ 25   7 173  15 276],457,5,8074,4.053212851405623,0.0,0.0
31992,3,1992,[ 64  50 195 228 144],292,5,8079,4.053687907676869,20.0,20.0
31993,3,1993,[318 427 515 185 313],655,5,8084,4.054162487462387,40.0,0.0
31994,3,1994,[318 427 515 185 313],655,5,8089,4.054636591478697,40.0,0.0
31995,3,1995,[135 496  95 405  64],450,3,8092,4.054108216432866,40.0,0.0
31996,3,1996,[176 603 238 143 245],796,3,8095,4.053580370555833,20.0,0.0
31997,3,1997,[187 161 197 515 172],72,4,8099,4.053553553553553,0.0,0.0
31998,3,1998,[196 185  50  88 742],693,1,8100,4.052026013006503,0.0,20.0
31999,3,1999,[318 427 515 185 313],655,5,8105,4.0525,40.0,0.0
32000,3,2000,[385 238 273  28 181],796,2,8107,4.051474262868566,0.0,0.0
32001,3,2001,[318 427 515 185 313],655,5,8112,4.0519480519480515,40.0,0.0
32002,3,2002,[318 427 515 185 313],655,5,8117,4.052421367948078,40.0,0.0
32003,3,2003,[196 237 301 405   9],344,3,8120,4.05189620758483,0.0,0.0
32004,3,2004,[  8 180 228 215 182],457,5,8125,4.052369077306733,0.0,0.0
32005,3,2005,[176 328  89  79 496],796,5,8130,4.05284147557328,20.0,0.0
32006,3,2006,[318 427 515 185 313],655,5,8135,4.053313403089188,40.0,0.0
32007,3,2007,[161  82 496  88 195],786,5,8140,4.053784860557769,20.0,0.0
32008,3,2008,[ 97  50 597 127 301],344,3,8143,4.053260328521652,0.0,40.0
32009,3,2009,[318 427 515 185 313],655,5,8148,4.053731343283582,40.0,0.0
32010,3,2010,[318 427 515 185 313],655,5,8153,4.05420188960716,40.0,0.0
32011,3,2011,[318 427 515 185 313],655,5,8158,4.0546719681908545,40.0,0.0
32012,3,2012,[180  79  71 125  50],450,4,8162,4.054644808743169,0.0,20.0
32013,3,2013,[318 427 515 185 313],655,5,8167,4.055114200595829,40.0,0.0
32014,3,2014,[179 204 427 655  56],535,4,8171,4.055086848635236,20.0,0.0
32015,3,2015,[318 427 515 185 313],655,5,8176,4.055555555555555,40.0,0.0
32016,3,2016,[228 194 357 176 588],796,5,8181,4.056023797719385,0.0,0.0
32017,3,2017,[202  56 151  28 121],457,5,8186,4.056491575817641,0.0,0.0
32018,3,2018,[204 328 228 187 302],450,5,8191,4.056958890539871,0.0,0.0
32019,3,2019,[222 179 204  96 211],450,4,8195,4.056930693069307,0.0,0.0
32020,3,2020,[ 50 435 268  69 276],269,2,8197,4.055912914398813,0.0,20.0
32021,3,2021,[318 427 515 185 313],655,5,8202,4.056379821958457,40.0,0.0
32022,3,2022,[318 427 515 185 313],655,5,8207,4.0568462679189325,40.0,0.0
32023,3,2023,[546 258 245 322 185],450,5,8212,4.057312252964427,0.0,0.0
32024,3,2024,[ 79 588   7 132 385],23,5,8217,4.057777777777778,0.0,0.0
32025,3,2025,[ 70 135 168 174 275],639,3,8220,4.057255676209279,0.0,20.0
32026,3,2026,[318 427 515 185 313],655,5,8225,4.0577207696102615,40.0,0.0
32027,3,2027,[ 82  64 197 301 118],450,3,8228,4.057199211045365,20.0,0.0
32028,3,2028,[318 427 515 185 313],655,5,8233,4.057663873829473,40.0,0.0
32029,3,2029,[318 427 515 185 313],655,5,8238,4.058128078817734,40.0,0.0
32030,3,2030,[318 427 515 185 313],655,5,8243,4.058591826686361,40.0,0.0
32031,3,2031,[318 427 515 185 313],655,5,8248,4.059055118110236,40.0,0.0
32032,3,2032,[211  97 405 435 174],503,3,8251,4.05853418593212,0.0,0.0
32033,3,2033,[318 427 515 185 313],655,5,8256,4.058997050147493,40.0,0.0
32034,3,2034,[318 427 515 185 313],655,5,8261,4.059459459459459,40.0,0.0
32035,3,2035,[318 427 515 185 313],655,5,8266,4.0599214145383105,40.0,0.0
32036,3,2036,[483 568 403 186 135],655,2,8268,4.058910162002945,0.0,0.0
32037,3,2037,[151 234 179 204 294],457,4,8272,4.058881256133464,0.0,0.0
32038,3,2038,[ 82   8 748  22 197],280,2,8274,4.057871505640019,0.0,0.0
32039,3,2039,[111 191 185  97 318],450,5,8279,4.058333333333334,20.0,0.0
32040,3,2040,[427 318 515 185 313],655,5,8284,4.0587947084762375,40.0,0.0
32041,3,2041,[427 318 515 185 313],655,5,8289,4.059255631733595,40.0,0.0
32042,3,2042,[245 174  11 173 403],280,1,8290,4.057758198727361,0.0,0.0
32043,3,2043,[427 318 515 185 313],655,5,8295,4.058219178082192,40.0,0.0
32044,3,2044,[427 318 515 185 313],655,5,8300,4.058679706601467,40.0,0.0
32045,3,2045,[ 98  56   4   1 210],280,3,8303,4.058162267839688,0.0,0.0
32046,3,2046,[ 71 568  95 508 234],280,2,8305,4.057156814851002,0.0,0.0
32047,3,2047,[215 234 132 385 257],23,2,8307,4.05615234375,0.0,0.0
32048,3,2048,[ 11 153  64 117 275],330,5,8312,4.056612981942411,20.0,20.0
32049,3,2049,[427 318 515 185 313],655,5,8317,4.057073170731707,40.0,0.0
32050,3,2050,[427 318 515 185 313],655,5,8322,4.057532910775231,40.0,0.0
32051,3,2051,[427 318 515 185 313],655,5,8327,4.057992202729045,40.0,0.0
32052,3,2052,[180 216  64 597  12],457,4,8331,4.057963955187531,20.0,0.0
32053,3,2053,[135 427 265 181 313],236,3,8334,4.05744888023369,20.0,0.0
32054,3,2054,[427 318 515 185 313],655,5,8339,4.057907542579075,40.0,0.0
32055,3,2055,[603 282 211 187 153],655,2,8341,4.0569066147859925,20.0,0.0
32056,3,2056,[427 318 515 185 313],655,5,8346,4.05736509479825,40.0,0.0
32057,3,2057,[ 56 427 234   7 258],151,5,8351,4.057823129251701,20.0,0.0
32058,3,2058,[200 125 228 172 403],796,5,8356,4.058280718795531,0.0,0.0
32059,3,2059,[427 318 515 185 313],655,5,8361,4.05873786407767,40.0,0.0
32060,3,2060,[ 25 204 180 143  15],18,3,8364,4.058224163027656,0.0,0.0
32061,3,2061,[125 508 173 144 176],280,0,8364,4.056256062075655,0.0,0.0
32062,3,2062,[111 174 161 185 288],457,4,8368,4.056228793019874,0.0,0.0
32063,3,2063,[427 318 515 185 313],655,5,8373,4.056686046511628,40.0,0.0
32064,3,2064,[427 318 515 185 313],655,5,8378,4.057142857142857,40.0,0.0
32065,3,2065,[174 655 271 288  64],629,5,8383,4.057599225556631,20.0,0.0
32066,3,2066,[ 50 194 265  95 211],807,5,8388,4.058055152394775,0.0,20.0
32067,3,2067,[ 22  12 174 125 288],256,5,8393,4.058510638297872,0.0,0.0
32068,3,2068,[427 318 515 185 313],655,5,8398,4.058965683905268,40.0,0.0
32069,3,2069,[202 179   9 121 185],457,5,8403,4.059420289855073,0.0,0.0
32070,3,2070,[427 318 515 185 313],655,5,8408,4.059874456784162,40.0,0.0
32071,3,2071,[427 318 515 185 313],655,5,8413,4.060328185328185,40.0,0.0
32072,3,2072,[153 180 132 117 405],796,4,8417,4.060299083453931,0.0,0.0
32073,3,2073,[172  25 427 186 176],655,2,8419,4.059305689488911,20.0,0.0
32074,3,2074,[427 318 515 185 313],655,5,8424,4.059759036144579,40.0,0.0
32075,3,2075,[427 318 515 185 313],655,5,8429,4.060211946050097,40.0,0.0
32076,3,2076,[427 318 515 185 313],655,5,8434,4.060664419836303,40.0,0.0
32077,3,2077,[483 405  12 289 210],655,1,8435,4.059191530317613,0.0,0.0
32078,3,2078,[427 318 515 185 313],655,5,8440,4.05964405964406,40.0,0.0
32079,3,2079,[210 181  56 328 118],450,3,8443,4.0591346153846155,0.0,0.0
32080,3,2080,[238 322 546 655  25],151,3,8446,4.058625660740029,0.0,0.0
32081,3,2081,[286 153 282  56 268],296,5,8451,4.0590778097982705,0.0,20.0
32082,3,2082,[ 97 144 597 496 125],796,4,8455,4.059049447911666,20.0,0.0
32083,3,2083,[  7 655 197  50 127],786,4,8459,4.059021113243762,0.0,40.0
32084,3,2084,[275 174 301 204 655],535,5,8464,4.05947242206235,0.0,20.0
32085,3,2085,[ 12  25 127   7 118],693,4,8468,4.059443911792905,0.0,20.0
32086,3,2086,[427 318 515 185 313],655,5,8473,4.059894585529468,40.0,0.0
32087,3,2087,[286 117   1  97 568],796,2,8475,4.058908045977011,0.0,20.0
32088,3,2088,[191  11 300  69  28],11,2,8477,4.057922450933461,0.0,0.0
32089,3,2089,[427 318 515 185 313],655,5,8482,4.058373205741627,40.0,0.0
32090,3,2090,[258   4 276 568 257],457,4,8486,4.0583452893352465,0.0,0.0
32091,3,2091,[427 318 515 185 313],655,5,8491,4.058795411089866,40.0,0.0
32092,3,2092,[183   1 204 322 258],344,2,8493,4.057811753463928,0.0,0.0
32093,3,2093,[143 257 121 286 210],796,3,8496,4.0573065902578795,0.0,20.0
32094,3,2094,[143 228 215 195  64],716,4,8500,4.05727923627685,20.0,0.0
32095,3,2095,[357  56 328 191   8],796,5,8505,4.057729007633588,0.0,0.0
32096,3,2096,[427 318 515 185 313],655,5,8510,4.0581783500238435,40.0,0.0
32097,3,2097,[427 318 515 185 313],655,5,8515,4.058627264061011,40.0,0.0
32098,3,2098,[275 210 121 100   8],457,5,8520,4.059075750357313,0.0,40.0
32099,3,2099,[ 22  69 588 423 127],280,5,8525,4.059523809523809,0.0,20.0
32100,3,2100,[588 186  56 286 161],389,2,8527,4.058543550690148,0.0,20.0
32101,3,2101,[427 318 515 185 313],655,5,8532,4.058991436726926,40.0,0.0
32102,3,2102,[427 318 515 185 313],655,5,8537,4.0594388968140755,40.0,0.0
32103,3,2103,[ 70 100 132 300 568],450,5,8542,4.059885931558935,0.0,20.0
32104,3,2104,[427 318 515 185 313],655,5,8547,4.060332541567696,40.0,0.0
32105,3,2105,[427 318 515 185 313],655,5,8552,4.060778727445394,40.0,0.0
32106,3,2106,[ 79 135 318   8  28],18,3,8555,4.060275272899857,20.0,0.0
32107,3,2107,[427 318 515 185 313],655,5,8560,4.060721062618596,40.0,0.0
32108,3,2108,[  1 211 100 185 655],535,4,8564,4.060692271218587,0.0,20.0
32109,3,2109,[121 423 196  95 161],577,5,8569,4.061137440758293,0.0,0.0
32110,3,2110,[427 318 515 185 313],655,5,8574,4.061582188536239,40.0,0.0
32111,3,2111,[427 318 515 185 313],655,5,8579,4.062026515151516,40.0,0.0
32112,3,2112,[ 89 179 196 568 161],655,2,8581,4.061050638902035,0.0,0.0
32113,3,2113,[ 89 200  15  69  56],18,2,8583,4.0600756859035005,0.0,0.0
32114,3,2114,[179 318  88  15 275],593,4,8587,4.060047281323877,20.0,20.0
32115,3,2115,[427 318 515 185 313],655,5,8592,4.060491493383743,40.0,0.0
32116,3,2116,[125 568   9  22  50],796,4,8596,4.060462919225319,0.0,20.0
32117,3,2117,[ 50 427 196 301 187],655,3,8599,4.0599622285174695,20.0,20.0
32118,3,2118,[228 328 748 222  89],450,4,8603,4.059933931099575,0.0,0.0
32119,3,2119,[294   9  50 357 300],504,3,8606,4.059433962264151,0.0,20.0
32120,3,2120,[ 96 245 144 132  56],796,4,8610,4.0594059405940595,0.0,0.0
32121,3,2121,[118 435  28  56  96],716,3,8613,4.058906691800188,0.0,0.0
32122,3,2122,[427 318 515 185 313],655,5,8618,4.059349976448422,40.0,0.0
32123,3,2123,[427 318 515 185 313],655,5,8623,4.059792843691149,40.0,0.0
32124,3,2124,[427 318 515 185 313],655,5,8628,4.060235294117647,40.0,0.0
32125,3,2125,[151 195 144 271 168],796,5,8633,4.060677328316086,0.0,0.0
32126,3,2126,[143 483  64 174  12],693,3,8636,4.060178655383169,20.0,0.0
32127,3,2127,[427 318 515 185 313],655,5,8641,4.0606203007518795,40.0,0.0
32128,3,2128,[200 234 125 568 483],796,4,8645,4.0605918271488965,0.0,0.0
32129,3,2129,[204 483 151  79 258],450,4,8649,4.06056338028169,0.0,0.0
32130,3,2130,[435  96 403 182   1],655,1,8650,4.059127170342562,0.0,0.0
32131,3,2131,[427 318 515 185 313],655,5,8655,4.059568480300188,40.0,0.0
32132,3,2132,[196  12 183   4   9],344,5,8660,4.060009376465072,0.0,0.0
32133,3,2133,[427 318 515 185 313],655,5,8665,4.060449859418932,40.0,0.0
32134,3,2134,[265 508  70 385 269],655,0,8665,4.058548009367682,0.0,0.0
32135,3,2135,[194 132 403 197 118],450,4,8669,4.0585205992509366,0.0,0.0
32136,3,2136,[427 318 515 185 313],655,5,8674,4.0589611605053815,40.0,0.0
32137,3,2137,[182 197   7 328 271],629,3,8677,4.058465855940131,0.0,0.0
32138,3,2138,[216 180 195 144  12],450,5,8682,4.05890603085554,0.0,0.0
32139,3,2139,[427 318 515 185 313],655,5,8687,4.059345794392524,40.0,0.0
32140,3,2140,[276 328 173 111 235],401,3,8690,4.058851004203643,0.0,0.0
32141,3,2141,[427 318 515 185 313],655,5,8695,4.059290382819794,40.0,0.0
32142,3,2142,[427 318 515 185 313],655,5,8700,4.059729351376575,40.0,0.0
32143,3,2143,[ 79  96 222 742 508],693,2,8702,4.058768656716418,0.0,0.0
32144,3,2144,[269 268  69 174 508],344,3,8705,4.058275058275059,0.0,0.0
32145,3,2145,[568 125 183  25  82],450,3,8708,4.0577819198508855,0.0,0.0
32146,3,2146,[427 318 515 185 313],655,5,8713,4.058220773171867,40.0,0.0
32147,3,2147,[427 318 515 185 313],655,5,8718,4.058659217877095,40.0,0.0
32148,3,2148,[427 318 515 185 313],655,5,8723,4.059097254536994,40.0,0.0
32149,3,2149,[427 318 515 185 313],655,5,8728,4.05953488372093,40.0,0.0
32150,3,2150,[427 318 515 185 313],655,5,8733,4.05997210599721,40.0,0.0
32151,3,2151,[427 318 515 185 313],655,5,8738,4.060408921933085,40.0,0.0
32152,3,2152,[597  50 678 216  64],344,3,8741,4.0599163957268924,20.0,20.0
32153,3,2153,[427 318 515 185 313],655,5,8746,4.060352831940576,40.0,0.0
32154,3,2154,[183 238  98 258 318],796,4,8750,4.060324825986079,20.0,0.0
32155,3,2155,[180 172 568 265  89],796,4,8754,4.0602968460111315,0.0,0.0
32156,3,2156,[385 288 294 125  56],280,3,8757,4.05980528511822,0.0,0.0
32157,3,2157,[427 318 515 185 313],655,5,8762,4.0602409638554215,40.0,0.0
32158,3,2158,[427 318 515 185 313],655,5,8767,4.060676238999537,40.0,0.0
32159,3,2159,[302  25  70 276 294],655,2,8769,4.059722222222222,0.0,0.0
32160,3,2160,[173 471 318 118 357],716,3,8772,4.059231837112448,20.0,0.0
32161,3,2161,[197 357 176 179  70],655,2,8774,4.058279370952821,0.0,0.0
32162,3,2162,[  8 172   1 132  70],23,4,8778,4.058252427184466,0.0,0.0
32163,3,2163,[427 318 515 185 313],655,5,8783,4.058687615526802,40.0,0.0
32164,3,2164,[275 318 161 234 328],450,4,8787,4.058660508083141,20.0,20.0
32165,3,2165,[215  11 111   8  71],344,2,8789,4.057710064635272,0.0,0.0
32166,3,2166,[742 222 127 185 496],450,4,8793,4.057683433317951,20.0,20.0
32167,3,2167,[271  25 273 328 125],655,1,8794,4.056273062730627,0.0,0.0
32168,3,2168,[405 216  95   4 357],716,4,8798,4.056247118487782,0.0,0.0
32169,3,2169,[427 318 515 185 313],655,5,8803,4.05668202764977,40.0,0.0
32170,3,2170,[427 318 515 185 313],655,5,8808,4.0571165361584525,40.0,0.0
32171,3,2171,[471 313 125  25  98],577,4,8812,4.057090239410681,0.0,0.0
32172,3,2172,[427 318 515 185 313],655,5,8817,4.057524160147262,40.0,0.0
32173,3,2173,[427 318 515 185 313],655,5,8822,4.0579576816927325,40.0,0.0
32174,3,2174,[427 318 515 185 313],655,5,8827,4.0583908045977015,40.0,0.0
32175,3,2175,[197   7 245 135 301],629,2,8829,4.057444852941177,0.0,0.0
32176,3,2176,[427 318 515 185 313],655,5,8834,4.057877813504823,40.0,0.0
32177,3,2177,[282 100 302 144 135],450,4,8838,4.0578512396694215,0.0,20.0
32178,3,2178,[742 471 135   8 117],280,4,8842,4.057824690224874,0.0,0.0
32179,3,2179,[265 181  15 195  56],72,4,8846,4.057798165137615,0.0,0.0
32180,3,2180,[427 318 515 185 313],655,5,8851,4.058230169646951,40.0,0.0
32181,3,2181,[135 111 196 181 172],457,4,8855,4.05820348304308,0.0,0.0
32182,3,2182,[174 196 183 313 294],655,2,8857,4.057260650480989,0.0,0.0
32183,3,2183,[427 318 515 185 313],655,5,8862,4.0576923076923075,40.0,0.0
32184,3,2184,[ 88 275  82  71 655],796,3,8865,4.05720823798627,0.0,20.0
32185,3,2185,[427 318 515 185 313],655,5,8870,4.057639524245197,40.0,0.0
32186,3,2186,[427 318 515 185 313],655,5,8875,4.0580704160951075,40.0,0.0
32187,3,2187,[496 174 234 191  12],450,4,8879,4.0580438756855575,20.0,0.0
32188,3,2188,[427 318 515 185 313],655,5,8884,4.058474189127455,40.0,0.0
32189,3,2189,[427 318 515 185 313],655,5,8889,4.058904109589041,40.0,0.0
32190,3,2190,[427 318 515 185 313],655,5,8894,4.059333637608398,40.0,0.0
32191,3,2191,[427 318 515 185 313],655,5,8899,4.059762773722627,40.0,0.0
32192,3,2192,[427 318 515 185 313],655,5,8904,4.060191518467852,40.0,0.0
32193,3,2193,[294 179 603 238 181],450,5,8909,4.060619872379216,20.0,0.0
32194,3,2194,[118 135  71 405  56],450,2,8911,4.059681093394078,0.0,0.0
32195,3,2195,[515 151 427 235 144],716,3,8914,4.0591985428051,20.0,0.0
32196,3,2196,[427 318 515 185 313],655,5,8919,4.059626763768776,40.0,0.0
32197,3,2197,[483 175 172  82 655],457,5,8924,4.060054595086442,0.0,0.0
32198,3,2198,[180 186 222 118 228],796,3,8927,4.059572532969532,0.0,0.0
32199,3,2199,[194 313 748 323 183],796,4,8931,4.059545454545455,0.0,0.0
32200,3,2200,[427 318 515 185 313],655,5,8936,4.059972739663789,40.0,0.0
32201,3,2201,[427 318 515 185 313],655,5,8941,4.060399636693915,40.0,0.0
32202,3,2202,[195  71 313 588   4],344,3,8944,4.059918293236496,0.0,0.0
32203,3,2203,[427 318 515 185 313],655,5,8949,4.060344827586207,40.0,0.0
32204,3,2204,[427 318 515 185 313],655,5,8954,4.060770975056689,40.0,0.0
32205,3,2205,[427 318 515 185 313],655,5,8959,4.061196736174071,40.0,0.0
32206,3,2206,[ 88  56  28 245 143],796,3,8962,4.060715903942003,0.0,0.0
32207,3,2207,[196 597  98  28 168],450,5,8967,4.061141304347826,0.0,0.0
32208,3,2208,[294 194 191 204 357],716,5,8972,4.06156631960163,0.0,0.0
32209,3,2209,[ 88 216 194  71 403],577,4,8976,4.061538461538461,0.0,0.0
32210,3,2210,[427 318 515 185 313],655,5,8981,4.061962912709181,40.0,0.0
32211,3,2211,[427 318 515 185 313],655,5,8986,4.062386980108499,40.0,0.0
32212,3,2212,[174  22 143 211 215],18,4,8990,4.062358788974243,0.0,0.0
32213,3,2213,[427 318 515 185 313],655,5,8995,4.062782294489612,40.0,0.0
32214,3,2214,[ 64 180  11 235  50],269,1,8996,4.061399548532731,20.0,20.0
32215,3,2215,[111  70 235 151 196],457,3,8999,4.0609205776173285,0.0,0.0
32216,3,2216,[200 275 268 202 286],629,5,9004,4.0613441587731165,0.0,40.0
32217,3,2217,[245  88 202 496 258],450,5,9009,4.0617673579801625,20.0,0.0
32218,3,2218,[135 273  79  95 423],450,2,9011,4.060838215412348,0.0,0.0
32219,3,2219,[204 153  71 175 211],23,3,9014,4.06036036036036,0.0,0.0
32220,3,2220,[427 318 515 185 313],655,5,9019,4.060783430886988,40.0,0.0
32221,3,2221,[318 568  15 100 181],330,5,9024,4.061206120612061,20.0,20.0
32222,3,2222,[427 318 515 185 313],655,5,9029,4.061628430049483,40.0,0.0
32223,3,2223,[427 318 515 185 313],655,5,9034,4.06205035971223,40.0,0.0
32224,3,2224,[ 97  89 258 597 568],457,4,9038,4.062022471910113,0.0,0.0
32225,3,2225,[427 318 515 185 313],655,5,9043,4.062443845462713,40.0,0.0
32226,3,2226,[174 508  70 496 125],280,2,9045,4.0615177368657385,20.0,0.0
32227,3,2227,[135  70 186 132 210],269,2,9047,4.060592459605027,0.0,0.0
32228,3,2228,[144 235  98 215 323],23,1,9048,4.05921938088829,0.0,0.0
32229,3,2229,[ 11   9 405 125 186],457,5,9053,4.059641255605381,0.0,0.0
32230,3,2230,[427 318 515 185 313],655,5,9058,4.06006275212909,40.0,0.0
32231,3,2231,[427 318 515 185 313],655,5,9063,4.060483870967742,40.0,0.0
32232,3,2232,[168  69 100  64 215],151,3,9066,4.06000895656068,20.0,20.0
32233,3,2233,[258  70 245 179 118],450,4,9070,4.0599820948970455,0.0,0.0
32234,3,2234,[427 318 515 185 313],655,5,9075,4.060402684563758,40.0,0.0
32235,3,2235,[276 216  56 202 168],174,4,9079,4.060375670840787,0.0,0.0
32236,3,2236,[427 318 515 185 313],655,5,9084,4.060795708538221,40.0,0.0
32237,3,2237,[228 185 195 265  56],450,5,9089,4.0612153708668455,0.0,0.0
32238,3,2238,[187 275 496 153 176],389,4,9093,4.061188030370701,20.0,20.0
32239,3,2239,[427 318 515 185 313],655,5,9098,4.0616071428571425,40.0,0.0
32240,3,2240,[ 79 127 215 238  95],450,4,9102,4.061579651941098,0.0,20.0
32241,3,2241,[215 204 127 273 200],796,4,9106,4.061552185548617,0.0,20.0
32242,3,2242,[427 318 515 185 313],655,5,9111,4.061970575122603,40.0,0.0
32243,3,2243,[191  22 258 200  12],457,5,9116,4.062388591800357,0.0,0.0
32244,3,2244,[427 318 515 185 313],655,5,9121,4.062806236080178,40.0,0.0
32245,3,2245,[678 143 275 168 100],401,3,9124,4.06233303650935,0.0,40.0
32246,3,2246,[427 318 515 185 313],655,5,9129,4.0627503337783715,40.0,0.0
32247,3,2247,[ 96 215 405 132 135],280,3,9132,4.062277580071174,0.0,0.0
32248,3,2248,[427 318 515 185 313],655,5,9137,4.062694530902624,40.0,0.0
32249,3,2249,[182 603  71  97   8],18,4,9141,4.062666666666667,20.0,0.0
32250,3,2250,[172 357 202 161 200],655,3,9144,4.062194580186584,0.0,0.0
32251,3,2251,[ 12 144 237 186 216],457,5,9149,4.0626110124333925,0.0,0.0
32252,3,2252,[385 215 471  25 151],450,4,9153,4.062583222370173,0.0,0.0
32253,3,2253,[427 318 515 185 313],655,5,9158,4.062999112688554,40.0,0.0
32254,3,2254,[143  11 258  79 195],457,5,9163,4.0634146341463415,0.0,0.0
32255,3,2255,[427 318 515 185 313],655,5,9168,4.0638297872340425,40.0,0.0
32256,3,2256,[174  12 215 603  79],655,2,9170,4.062915374390784,20.0,0.0
32257,3,2257,[427 318 515 185 313],655,5,9175,4.063330380868025,40.0,0.0
32258,3,2258,[427 318 515 185 313],655,5,9180,4.063745019920319,40.0,0.0
32259,3,2259,[427 318 515 185 313],655,5,9185,4.064159292035399,40.0,0.0
32260,3,2260,[294 265  70 357 202],716,5,9190,4.064573197700133,0.0,0.0
32261,3,2261,[427 318 515 185 313],655,5,9195,4.06498673740053,40.0,0.0
32262,3,2262,[300  98 742  70 245],504,4,9199,4.0649580203269995,0.0,0.0
32263,3,2263,[427 318 515 185 313],655,5,9204,4.065371024734982,40.0,0.0
32264,3,2264,[427 318 515 185 313],655,5,9209,4.065783664459161,40.0,0.0
32265,3,2265,[211 483 508 328   8],655,1,9210,4.064430714916152,0.0,0.0
32266,3,2266,[427 318 515 185 313],655,5,9215,4.064843405381562,40.0,0.0
32267,3,2267,[427 318 515 185 313],655,5,9220,4.065255731922399,40.0,0.0
32268,3,2268,[228 301   7 191 118],344,4,9224,4.0652269722344645,0.0,0.0
32269,3,2269,[427 318 515 185 313],655,5,9229,4.0656387665198235,40.0,0.0
32270,3,2270,[427 318 515 185 313],655,5,9234,4.066050198150594,40.0,0.0
32271,3,2271,[435 568 175  69  15],269,1,9235,4.064700704225352,0.0,0.0
32272,3,2272,[427 318 515 185 313],655,5,9240,4.065112186537616,40.0,0.0
32273,3,2273,[403 211 483 125 273],655,2,9242,4.064204045734389,0.0,0.0
32274,3,2274,[423 195 568 200 172],269,2,9244,4.063296703296703,0.0,0.0
32275,3,2275,[427 318 515 185 313],655,5,9249,4.063708260105448,40.0,0.0
32276,3,2276,[427 318 515 185 313],655,5,9254,4.064119455423803,40.0,0.0
32277,3,2277,[427 318 515 185 313],655,5,9259,4.0645302897278315,40.0,0.0
32278,3,2278,[427 318 515 185 313],655,5,9264,4.06494076349276,40.0,0.0
32279,3,2279,[427 318 515 185 313],655,5,9269,4.065350877192983,40.0,0.0
32280,3,2280,[ 88 151 174 132  56],450,5,9274,4.0657606313020604,0.0,0.0
32281,3,2281,[ 70 655 202 228   9],655,0,9274,4.063978965819457,0.0,0.0
32282,3,2282,[427 318 515 185 313],655,5,9279,4.064388961892247,40.0,0.0
32283,3,2283,[427 318 515 185 313],655,5,9284,4.064798598949212,40.0,0.0
32284,3,2284,[427 318 515 185 313],655,5,9289,4.065207877461707,40.0,0.0
32285,3,2285,[546  79 405 568 288],593,3,9292,4.064741907261593,0.0,0.0
32286,3,2286,[  1  25 257 385 197],457,4,9296,4.064713598600787,0.0,0.0
32287,3,2287,[161 200   9 405  22],269,2,9298,4.063811188811189,0.0,0.0
32288,3,2288,[427 318 515 185 313],655,5,9303,4.064220183486238,40.0,0.0
32289,3,2289,[125 288  88 173 234],457,5,9308,4.064628820960698,0.0,0.0
32290,3,2290,[195 655 215   4 282],280,0,9308,4.062854648625055,0.0,0.0
32291,3,2291,[313 546 127 191 265],450,5,9313,4.06326352530541,0.0,20.0
32292,3,2292,[427 318 515 185 313],655,5,9318,4.063672045355429,40.0,0.0
32293,3,2293,[  7 328 588 216 185],450,5,9323,4.064080209241499,0.0,0.0
32294,3,2294,[ 25  28 294 603  79],450,4,9327,4.064052287581699,20.0,0.0
32295,3,2295,[186 237 258 301 508],296,4,9331,4.064024390243903,0.0,0.0
32296,3,2296,[ 50 187 179  79 427],389,5,9336,4.064431867653461,20.0,20.0
32297,3,2297,[427 318 515 185 313],655,5,9341,4.064838990426458,40.0,0.0
32298,3,2298,[427 318 515 185 313],655,5,9346,4.065245759025664,40.0,0.0
32299,3,2299,[294 181 258 282 318],504,3,9349,4.064782608695652,20.0,0.0
32300,3,2300,[427 318 515 185 313],655,5,9354,4.065189048239896,40.0,0.0
32301,3,2301,[427 318 515 185 313],655,5,9359,4.065595134665508,40.0,0.0
32302,3,2302,[118 265 174 172 568],577,3,9362,4.065132435953105,0.0,0.0
32303,3,2303,[427 318 515 185 313],655,5,9367,4.065538194444445,40.0,0.0
32304,3,2304,[427 318 515 185 313],655,5,9372,4.065943600867679,40.0,0.0
32305,3,2305,[597  89 143 269 187],450,5,9377,4.066348655680833,0.0,0.0
32306,3,2306,[603 328 294 471 202],401,4,9381,4.066319895968791,20.0,0.0
32307,3,2307,[427 318 515 185 313],655,5,9386,4.066724436741768,40.0,0.0
32308,3,2308,[427 318 515 185 313],655,5,9391,4.067128627111304,40.0,0.0
32309,3,2309,[427 318 515 185 313],655,5,9396,4.067532467532468,40.0,0.0
32310,3,2310,[186 197   9 161 655],786,4,9400,4.067503245348334,0.0,0.0
32311,3,2311,[427 318 515 185 313],655,5,9405,4.067906574394463,40.0,0.0
32312,3,2312,[427 318 515 185 313],655,5,9410,4.068309554690877,40.0,0.0
32313,3,2313,[135 100 385 172 202],450,4,9414,4.06828003457217,0.0,20.0
32314,3,2314,[427 318 515 185 313],655,5,9419,4.068682505399568,40.0,0.0
32315,3,2315,[427 318 515 185 313],655,5,9424,4.0690846286701206,40.0,0.0
32316,3,2316,[427 318 515 185 313],655,5,9429,4.069486404833837,40.0,0.0
32317,3,2317,[427 318 515 185 313],655,5,9434,4.069887834339948,40.0,0.0
32318,3,2318,[427 318 515 185 313],655,5,9439,4.070288917636913,40.0,0.0
32319,3,2319,[568 200 301 191 186],655,2,9441,4.069396551724138,0.0,0.0
32320,3,2320,[151 228 423 143 222],756,2,9443,4.068504954760879,0.0,0.0
32321,3,2321,[195 237 313 222 265],236,3,9446,4.068044788975022,0.0,0.0
32322,3,2322,[496 603 423  69   1],151,5,9451,4.068445975032286,40.0,0.0
32323,3,2323,[191 183 568 215 483],716,4,9455,4.0684165232358005,0.0,0.0
32324,3,2324,[427 318 515 185 313],655,5,9460,4.068817204301075,40.0,0.0
32325,3,2325,[238 118   4  25  69],151,4,9464,4.068787618228719,0.0,0.0
32326,3,2326,[195 273 135 215 313],655,3,9467,4.068328319724968,0.0,0.0
32327,3,2327,[  8 742  71  95  79],796,4,9471,4.068298969072165,0.0,0.0
32328,3,2328,[427 318 515 185 313],655,5,9476,4.068699012451696,40.0,0.0
32329,3,2329,[427 318 515 185 313],655,5,9481,4.069098712446352,40.0,0.0
32330,3,2330,[427 318 515 185 313],655,5,9486,4.06949806949807,40.0,0.0
32331,3,2331,[200  96 182 183 202],450,4,9490,4.069468267581475,0.0,0.0
32332,3,2332,[186 174 111 173 176],389,2,9492,4.068581225889413,0.0,0.0
32333,3,2333,[427 318 515 185 313],655,5,9497,4.06898029134533,40.0,0.0
32334,3,2334,[496   9 546  69 195],786,5,9502,4.069379014989293,20.0,0.0
32335,3,2335,[427 318 515 185 313],655,5,9507,4.069777397260274,40.0,0.0
32336,3,2336,[172 197 210 176 546],503,5,9512,4.0701754385964914,0.0,0.0
32337,3,2337,[143 191 204 275 194],389,4,9516,4.070145423438837,0.0,20.0
32338,3,2338,[127  98 200   4  79],655,4,9520,4.070115433946131,0.0,20.0
32339,3,2339,[655  64  95 121 185],450,3,9523,4.069658119658119,20.0,0.0
32340,3,2340,[427 318 515 185 313],655,5,9528,4.070055531824007,40.0,0.0
32341,3,2341,[ 28 191 294   7 265],577,4,9532,4.070025619128949,0.0,0.0
32342,3,2342,[302 237 245 191 483],450,4,9536,4.069995731967563,0.0,0.0
32343,3,2343,[427 318 515 185 313],655,5,9541,4.070392491467577,40.0,0.0
32344,3,2344,[568 127 210 100 182],389,3,9544,4.0699360341151385,0.0,40.0
32345,3,2345,[427 318 515 185 313],655,5,9549,4.070332480818414,40.0,0.0
32346,3,2346,[427 318 515 185 313],655,5,9554,4.070728589688964,40.0,0.0
32347,3,2347,[179 333 186  70 385],655,1,9555,4.069420783645656,0.0,0.0
32348,3,2348,[427 318 515 185 313],655,5,9560,4.069816943380162,40.0,0.0
32349,3,2349,[144  15 483 202 187],796,5,9565,4.0702127659574465,0.0,0.0
32350,3,2350,[427 318 515 185 313],655,5,9570,4.070608251807742,40.0,0.0
32351,3,2351,[ 12  97 423 117  82],72,4,9574,4.070578231292517,0.0,0.0
32352,3,2352,[427 318 515 185 313],655,5,9579,4.070973225669358,40.0,0.0
32353,3,2353,[  1 515  98 435  50],535,2,9581,4.070093457943925,0.0,20.0
32354,3,2354,[318 427 185 515 313],655,5,9586,4.0704883227176225,40.0,0.0
32355,3,2355,[318 427 185 515 313],655,5,9591,4.07088285229202,40.0,0.0
32356,3,2356,[318 427 185 515 313],655,5,9596,4.071277047093763,40.0,0.0
32357,3,2357,[318 427 185 515 313],655,5,9601,4.0716709075487705,40.0,0.0
32358,3,2358,[318 427 185 515 313],655,5,9606,4.072064434082238,40.0,0.0
32359,3,2359,[318 427 185 515 313],655,5,9611,4.072457627118644,40.0,0.0
32360,3,2360,[282 483  11 121  56],457,5,9616,4.0728504870817455,0.0,0.0
32361,3,2361,[318 427 185 515 313],655,5,9621,4.073243014394581,40.0,0.0
32362,3,2362,[318 427 185 515 313],655,5,9626,4.073635209479475,40.0,0.0
32363,3,2363,[318 427 185 515 313],655,5,9631,4.074027072758037,40.0,0.0
32364,3,2364,[118 302 257  50 258],655,2,9633,4.073150105708245,0.0,20.0
32365,3,2365,[318 427 185 515 313],655,5,9638,4.073541842772612,40.0,0.0
32366,3,2366,[318 427 185 515 313],655,5,9643,4.073933248838192,40.0,0.0
32367,3,2367,[204 121  25   1 269],503,3,9646,4.07347972972973,0.0,0.0
32368,3,2368,[196 286 202 186 172],389,2,9648,4.072604474461798,0.0,20.0
32369,3,2369,[132  82 265 194 191],796,4,9652,4.072573839662447,0.0,0.0
32370,3,2370,[318 427 185 515 313],655,5,9657,4.072964993673556,40.0,0.0
32371,3,2371,[318 427 185 515 313],655,5,9662,4.0733558178752105,40.0,0.0
32372,3,2372,[318 427 185 515 313],655,5,9667,4.073746312684365,40.0,0.0
32373,3,2373,[748  98   1 100  82],450,4,9671,4.073715248525695,0.0,20.0
32374,3,2374,[318 427 185 515 313],655,5,9676,4.074105263157895,40.0,0.0
32375,3,2375,[ 50 403 423   4  69],504,3,9679,4.073653198653199,0.0,20.0
32376,3,2376,[200 294 269 182 328],629,2,9681,4.072780816154817,0.0,0.0
32377,3,2377,[ 11 135 117 318   1],401,1,9682,4.071488645920942,20.0,0.0
32378,3,2378,[318 427 185 515 313],655,5,9687,4.071878940731399,40.0,0.0
32379,3,2379,[161 197 200 235 405],330,5,9692,4.072268907563025,0.0,0.0
32380,3,2380,[318 427 185 515 313],655,5,9697,4.0726585468290635,40.0,0.0
32381,3,2381,[200  12  11  88 238],655,1,9698,4.071368597816961,0.0,0.0
32382,3,2382,[318 427 185 515 313],655,5,9703,4.07175828787243,40.0,0.0
32383,3,2383,[173 180 405 127 181],796,4,9707,4.071728187919463,0.0,20.0
32384,3,2384,[385 216 318 496 181],577,5,9712,4.0721174004192875,40.0,0.0
32385,3,2385,[318 427 185 515 313],655,5,9717,4.072506286672255,40.0,0.0
32386,3,2386,[318 427 185 515 313],655,5,9722,4.072894847088396,40.0,0.0
32387,3,2387,[385  97  96 294   7],655,0,9722,4.0711892797319935,0.0,0.0
32388,3,2388,[318 427 185 515 313],655,5,9727,4.071578066136459,40.0,0.0
32389,3,2389,[118 153   1 288   8],655,0,9727,4.069874476987447,0.0,0.0
32390,3,2390,[125 748  28 546 655],450,5,9732,4.070263488080301,0.0,0.0
32391,3,2391,[427 318 185 515 313],655,5,9737,4.070652173913044,40.0,0.0
32392,3,2392,[197 181 288 568 210],693,1,9738,4.069368992895947,0.0,0.0
32393,3,2393,[427 318 185 515 313],655,5,9743,4.069757727652465,40.0,0.0
32394,3,2394,[427 318 185 515 313],655,5,9748,4.070146137787057,40.0,0.0
32395,3,2395,[427 318 185 515 313],655,5,9753,4.070534223706177,40.0,0.0
32396,3,2396,[135 568 435 288  88],655,1,9754,4.069253233208177,0.0,0.0
32397,3,2397,[273 301 191 742  22],796,2,9756,4.068390325271059,0.0,0.0
32398,3,2398,[427 318 185 515 313],655,5,9761,4.0687786577740725,40.0,0.0
32399,3,2399,[ 50 546  88  56 228],716,4,9765,4.06875,0.0,20.0
32400,3,2400,[216 276 175 125 197],655,2,9767,4.067888379841732,0.0,0.0
32401,3,2401,[427 318 185 515 313],655,5,9772,4.068276436303081,40.0,0.0
32402,3,2402,[ 12 268 258 385  64],655,1,9773,4.066999583853517,20.0,0.0
32403,3,2403,[427 318 185 515 313],655,5,9778,4.06738768718802,40.0,0.0
32404,3,2404,[427 318 185 515 313],655,5,9783,4.067775467775467,40.0,0.0
32405,3,2405,[427 318 185 515 313],655,5,9788,4.068162926018288,40.0,0.0
32406,3,2406,[151 179 187  69   7],269,3,9791,4.067719152471957,0.0,0.0
32407,3,2407,[427 318 185 515 313],655,5,9796,4.068106312292358,40.0,0.0
32408,3,2408,[179 180 151  12 238],457,5,9801,4.068493150684931,0.0,0.0
32409,3,2409,[215 423 204 181 238],457,5,9806,4.068879668049792,0.0,0.0
32410,3,2410,[427 318 185 515 313],655,5,9811,4.069265864786396,40.0,0.0
32411,3,2411,[ 56 174 176 179 200],450,4,9815,4.069237147595357,0.0,0.0
32412,3,2412,[427 318 185 515 313],655,5,9820,4.069622876087857,40.0,0.0
32413,3,2413,[427 318 185 515 313],655,5,9825,4.070008285004143,40.0,0.0
32414,3,2414,[144 195 111 183  88],655,1,9826,4.068737060041408,0.0,0.0
32415,3,2415,[132 182  79 197  95],280,3,9829,4.068294701986755,0.0,0.0
32416,3,2416,[427 318 185 515 313],655,5,9834,4.068680182043856,40.0,0.0
32417,3,2417,[ 12  79 269 172 194],503,4,9838,4.0686517783291976,0.0,0.0
32418,3,2418,[172 385 289   1 173],807,4,9842,4.068623398098388,0.0,0.0
32419,3,2419,[427 318 185 515 313],655,5,9847,4.06900826446281,40.0,0.0
32420,3,2420,[ 82   8 168  70 475],269,2,9849,4.068153655514251,0.0,0.0
32421,3,2421,[265 185 118 194 181],450,4,9853,4.068125516102395,0.0,0.0
32422,3,2422,[427 318 185 515 313],655,5,9858,4.068510111432109,40.0,0.0
32423,3,2423,[427 318 185 515 313],655,5,9863,4.0688943894389435,40.0,0.0
32424,3,2424,[427 318 185 515 313],655,5,9868,4.0692783505154635,40.0,0.0
32425,3,2425,[427 318 185 515 313],655,5,9873,4.069661995053586,40.0,0.0
32426,3,2426,[211  69 300 318 174],450,5,9878,4.070045323444582,20.0,0.0
32427,3,2427,[427 318 185 515 313],655,5,9883,4.070428336079077,40.0,0.0
32428,3,2428,[427 318 185 515 313],655,5,9888,4.070811033347057,40.0,0.0
32429,3,2429,[191  22 405  89 182],457,5,9893,4.07119341563786,0.0,0.0
32430,3,2430,[176 313 286 191 210],796,3,9896,4.070752776635129,0.0,20.0
32431,3,2431,[427 318 185 515 313],655,5,9901,4.071134868421052,40.0,0.0
32432,3,2432,[427 318 185 515 313],655,5,9906,4.0715166461159065,40.0,0.0
32433,3,2433,[427 318 185 515 313],655,5,9911,4.07189811010682,40.0,0.0
32434,3,2434,[176 423 196  82  96],23,1,9912,4.070636550308008,0.0,0.0
32435,3,2435,[427 318 185 515 313],655,5,9917,4.071018062397373,40.0,0.0
32436,3,2436,[427 318 185 515 313],655,5,9922,4.071399261386951,40.0,0.0
32437,3,2437,[ 50 111   9 275  89],655,3,9925,4.070959803117309,0.0,40.0
32438,3,2438,[111 546   7 174 405],786,5,9930,4.071340713407134,0.0,0.0
32439,3,2439,[ 89   8  50 228 385],796,5,9935,4.07172131147541,0.0,20.0
32440,3,2440,[  4 234 282 216 118],280,1,9936,4.070462925030725,0.0,0.0
32441,3,2441,[427 318 185 515 313],655,5,9941,4.070843570843571,40.0,0.0
32442,3,2442,[ 11  88 172 568 204],280,1,9942,4.0695865738845685,0.0,0.0
32443,3,2443,[427 318 185 515 313],655,5,9947,4.069967266775778,40.0,0.0
32444,3,2444,[427 318 185 515 313],655,5,9952,4.070347648261759,40.0,0.0
32445,3,2445,[427 318 185 515 313],655,5,9957,4.070727718724448,40.0,0.0
32446,3,2446,[ 82 265 742 181 172],655,1,9958,4.069472823865958,0.0,0.0
32447,3,2447,[200  15  12 496 195],450,3,9961,4.069035947712418,20.0,0.0
32448,3,2448,[427 318 185 515 313],655,5,9966,4.069416088199265,40.0,0.0
32449,3,2449,[427 318 185 515 313],655,5,9971,4.069795918367347,40.0,0.0
32450,3,2450,[427 318 185 515 313],655,5,9976,4.0701754385964914,40.0,0.0
32451,3,2451,[427 318 185 515 313],655,5,9981,4.0705546492659055,40.0,0.0
32452,3,2452,[ 69 427 268 597 182],269,3,9984,4.070118222584591,20.0,0.0
32453,3,2453,[427 318 185 515 313],655,5,9989,4.070497147514263,40.0,0.0
32454,3,2454,[427 318 185 515 313],655,5,9994,4.070875763747454,40.0,0.0
32455,3,2455,[427 318 185 515 313],655,5,9999,4.0712540716612375,40.0,0.0
32456,3,2456,[427 318 185 515 313],655,5,10004,4.071632071632072,40.0,0.0
32457,3,2457,[427 318 185 515 313],655,5,10009,4.072009764035801,40.0,0.0
32458,3,2458,[427 318 185 515 313],655,5,10014,4.072387149247661,40.0,0.0
32459,3,2459,[174 216 215 385 204],151,3,10017,4.071951219512195,0.0,0.0
32460,3,2460,[222  50 237 187 143],655,3,10020,4.071515644047135,0.0,20.0
32461,3,2461,[  1  50 172  79 235],450,4,10024,4.071486596263201,0.0,20.0
32462,3,2462,[286 174 191 515 257],655,2,10026,4.070645554202192,0.0,20.0
32463,3,2463,[427 318 185 515 313],655,5,10031,4.0710227272727275,40.0,0.0
32464,3,2464,[427  64  50 174 210],151,5,10036,4.071399594320487,40.0,20.0
32465,3,2465,[427 318 185 515 313],655,5,10041,4.071776155717761,40.0,0.0
32466,3,2466,[427 318 185 515 313],655,5,10046,4.072152411836238,40.0,0.0
32467,3,2467,[427 318 185 515 313],655,5,10051,4.0725283630470015,40.0,0.0
32468,3,2468,[403 328 282   9  11],655,0,10051,4.070878898339409,0.0,0.0
32469,3,2469,[427 318 185 515 313],655,5,10056,4.0712550607287445,40.0,0.0
32470,3,2470,[318 174 135 215   1],280,3,10059,4.070821529745042,20.0,0.0
32471,3,2471,[427 318 185 515 313],655,5,10064,4.0711974110032365,40.0,0.0
32472,3,2472,[427 318 185 515 313],655,5,10069,4.071572988273352,40.0,0.0
32473,3,2473,[427 318 185 515 313],655,5,10074,4.0719482619240095,40.0,0.0
32474,3,2474,[427 318 185 515 313],655,5,10079,4.072323232323233,40.0,0.0
32475,3,2475,[183   9 215 127 258],796,4,10083,4.0722940226171245,0.0,20.0
32476,3,2476,[ 11 168 191  12  69],450,5,10088,4.072668550666128,0.0,0.0
32477,3,2477,[ 69 172  95  98 204],18,2,10090,4.07183212267958,0.0,0.0
32478,3,2478,[234 186 210 216 215],835,5,10095,4.072206534893102,0.0,0.0
32479,3,2479,[191 204  56 168  25],151,4,10099,4.072177419354839,0.0,0.0
32480,3,2480,[ 28 144 186  69 603],716,3,10102,4.071745264006449,20.0,0.0
32481,3,2481,[483 127 181  50 301],296,5,10107,4.072119258662369,0.0,40.0
32482,3,2482,[ 89  96 322 196 427],450,5,10112,4.072492952074104,20.0,0.0
32483,3,2483,[144 427 273 172 216],436,3,10115,4.072061191626409,20.0,0.0
32484,3,2484,[318 427 185 515 313],655,5,10120,4.072434607645875,40.0,0.0
32485,3,2485,[318 427 185 515 313],655,5,10125,4.072807723250201,40.0,0.0
32486,3,2486,[197 179 235 403  98],457,4,10129,4.072778447929232,0.0,0.0
32487,3,2487,[273 427 202 742 483],450,3,10132,4.072347266881029,20.0,0.0
32488,3,2488,[127 228  82 185 286],796,3,10135,4.071916432302129,0.0,40.0
32489,3,2489,[235  88 238 202 100],457,4,10139,4.071887550200803,0.0,20.0
32490,3,2490,[318 427 185 515 313],655,5,10144,4.072260136491369,40.0,0.0
32491,3,2491,[121 483 423 117 194],807,5,10149,4.072632423756019,0.0,0.0
32492,3,2492,[173  82 118 151 216],577,4,10153,4.072603289209788,0.0,0.0
32493,3,2493,[318 427 185 515 313],655,5,10158,4.072975140336808,40.0,0.0
32494,3,2494,[318 427 185 515 313],655,5,10163,4.073346693386774,40.0,0.0
32495,3,2495,[173 238 111  11 655],593,4,10167,4.0733173076923075,0.0,0.0
32496,3,2496,[237 161 118  71 100],450,3,10170,4.072887464957949,0.0,20.0
32497,3,2497,[ 56  96 125  70 322],504,3,10173,4.072457966373099,0.0,0.0
32498,3,2498,[195  98 204 273 427],655,3,10176,4.07202881152461,20.0,0.0
32499,3,2499,[318 427 185 515 313],655,5,10181,4.0724,40.0,0.0
32500,3,2500,[318 427 185 515 313],655,5,10186,4.0727708916433425,40.0,0.0
32501,3,2501,[ 64 271 288 191 182],655,3,10189,4.0723421262989605,20.0,0.0
32502,3,2502,[ 98 322 185 257  25],504,5,10194,4.072712744706353,0.0,0.0
32503,3,2503,[318 427 185 515 313],655,5,10199,4.073083067092652,40.0,0.0
32504,3,2504,[258 286 748  69 197],796,3,10202,4.072654690618762,0.0,20.0
32505,3,2505,[ 88  22 403 127 121],655,1,10203,4.071428571428571,0.0,20.0
32506,3,2506,[318 427 185 515 313],655,5,10208,4.071798962903869,40.0,0.0
32507,3,2507,[237  98  25 175 183],716,3,10211,4.071371610845295,0.0,0.0
32508,3,2508,[318 427 185 515 313],655,5,10216,4.071741729772818,40.0,0.0
32509,3,2509,[121 182 195 427 238],796,4,10220,4.0717131474103585,20.0,0.0
32510,3,2510,[144 174 588 313 273],450,4,10224,4.07168458781362,0.0,0.0
32511,3,2511,[318 427 185 515 313],655,5,10229,4.072054140127388,40.0,0.0
32512,3,2512,[183  50  88 187 333],236,0,10229,4.070433744528452,0.0,20.0
32513,3,2513,[271  71 300 301 228],796,4,10233,4.070405727923628,0.0,0.0
32514,3,2514,[ 88 176 215 222  79],11,1,10234,4.0691848906560635,0.0,0.0
32515,3,2515,[318 427 185 515 313],655,5,10239,4.069554848966614,40.0,0.0
32516,3,2516,[228 121 211 423  11],693,1,10240,4.068335319825189,0.0,0.0
32517,3,2517,[318 427 185 515 313],655,5,10245,4.068705321683876,40.0,0.0
32518,3,2518,[216 405 568 357 143],450,5,10250,4.06907502977372,0.0,0.0
32519,3,2519,[318 427 185 515 313],655,5,10255,4.069444444444445,40.0,0.0
32520,3,2520,[318 427 185 515 313],655,5,10260,4.06981356604522,40.0,0.0
32521,3,2521,[195 234 258 121  70],457,5,10265,4.070182394924663,0.0,0.0
32522,3,2522,[176 125   1 265 180],292,4,10269,4.070154577883472,0.0,0.0
32523,3,2523,[357  69 215 276 268],655,2,10271,4.069334389857369,0.0,0.0
32524,3,2524,[191 100 125 181 258],344,2,10273,4.068514851485149,0.0,20.0
32525,3,2525,[515 603 180 235 151],716,3,10276,4.068091844813935,20.0,0.0
32526,3,2526,[318 427 185 515 313],655,5,10281,4.0684606252473285,40.0,0.0
32527,3,2527,[318 427 185 515 313],655,5,10286,4.068829113924051,40.0,0.0
32528,3,2528,[318 427 185 515 313],655,5,10291,4.069197311190194,40.0,0.0
32529,3,2529,[318 427 185 515 313],655,5,10296,4.069565217391304,40.0,0.0
32530,3,2530,[197 322 235   8 176],280,3,10299,4.069142631370999,0.0,0.0
32531,3,2531,[318 427 185 515 313],655,5,10304,4.069510268562401,40.0,0.0
32532,3,2532,[318 427 185 515 313],655,5,10309,4.06987761547572,40.0,0.0
32533,3,2533,[300 235  50 100 204],450,4,10313,4.069850039463299,0.0,40.0
32534,3,2534,[132 215 385 211 194],504,4,10317,4.0698224852071005,0.0,0.0
32535,3,2535,[ 88 322  69 328 655],401,2,10319,4.069006309148265,0.0,0.0
32536,3,2536,[196 182  98 118   9],457,5,10324,4.0693732755222705,0.0,0.0
32537,3,2537,[143 271 588 125 282],796,5,10329,4.069739952718676,0.0,0.0
32538,3,2538,[318 427 185 515 313],655,5,10334,4.070106341079165,40.0,0.0
32539,3,2539,[175 132 385 265 100],457,5,10339,4.070472440944882,0.0,20.0
32540,3,2540,[318 427 185 515 313],655,5,10344,4.070838252656435,40.0,0.0
32541,3,2541,[117 210 234 194 515],72,5,10349,4.071203776553895,0.0,0.0
32542,3,2542,[318 427 185 515 313],655,5,10354,4.071569012976799,40.0,0.0
32543,3,2543,[748 174 151 173 161],798,3,10357,4.071147798742138,0.0,0.0
32544,3,2544,[318 427 185 515 313],655,5,10362,4.071512770137525,40.0,0.0
32545,3,2545,[ 25 265 742 238 216],450,4,10366,4.071484681853889,0.0,0.0
32546,3,2546,[318 427 185 515 313],655,5,10371,4.071849234393404,40.0,0.0
32547,3,2547,[318 427 185 515 313],655,5,10376,4.07221350078493,40.0,0.0
32548,3,2548,[318 427 185 515 313],655,5,10381,4.072577481365241,40.0,0.0
32549,3,2549,[318 427 185 515 313],655,5,10386,4.0729411764705885,40.0,0.0
32550,3,2550,[405 182 144 286 271],655,1,10387,4.071736573892591,0.0,20.0
32551,3,2551,[258 117 215 234 289],693,3,10390,4.071316614420063,0.0,0.0
32552,3,2552,[318 427 185 515 313],655,5,10395,4.071680376028202,40.0,0.0
32553,3,2553,[405 318 234 300  22],450,4,10399,4.071652310101801,20.0,0.0
32554,3,2554,[318 427 185 515 313],655,5,10404,4.0720156555772995,40.0,0.0
32555,3,2555,[318 427 185 515 313],655,5,10409,4.072378716744914,40.0,0.0
32556,3,2556,[174 403 127 228 186],655,1,10410,4.071177160735236,0.0,20.0
32557,3,2557,[357 183 202  15 172],457,5,10415,4.071540265832682,0.0,0.0
32558,3,2558,[318 427 185 515 313],655,5,10420,4.071903087143415,40.0,0.0
32559,3,2559,[318 427 185 515 313],655,5,10425,4.072265625,40.0,0.0
32560,3,2560,[318 427 185 515 313],655,5,10430,4.072627879734479,40.0,0.0
32561,3,2561,[191 568 496 186 174],716,4,10434,4.072599531615925,20.0,0.0
32562,3,2562,[173  96 194 143 546],716,3,10437,4.072181037846274,0.0,0.0
32563,3,2563,[276   7 313 187  89],296,5,10442,4.072542901716068,0.0,0.0
32564,3,2564,[275 117  70  97 257],655,1,10443,4.071345029239766,0.0,20.0
32565,3,2565,[318 427 185 515 313],655,5,10448,4.071706936866718,40.0,0.0
32566,3,2566,[200 191 403  64 202],18,2,10450,4.070899883132061,20.0,0.0
32567,3,2567,[237 318 185 301 111],796,4,10454,4.070872274143302,20.0,0.0
32568,3,2568,[471 496 405 258 245],450,5,10459,4.071233943168548,20.0,0.0
32569,3,2569,[318 427 185 515 313],655,5,10464,4.071595330739299,40.0,0.0
32570,3,2570,[191 197  28 204 117],786,4,10468,4.071567483469467,0.0,0.0
32571,3,2571,[318 427 185 515 313],655,5,10473,4.071928460342146,40.0,0.0
32572,3,2572,[183 176 294 196 276],655,2,10475,4.071123202487369,0.0,0.0
32573,3,2573,[211 161 245 151 196],796,3,10478,4.070707070707071,0.0,0.0
32574,3,2574,[132 496 222 191 423],786,5,10483,4.071067961165048,20.0,0.0
32575,3,2575,[ 71 282  98 313 173],280,2,10485,4.07026397515528,0.0,0.0
32576,3,2576,[175 179  70 125 200],18,3,10488,4.069848661233993,0.0,0.0
32577,3,2577,[318 427 185 515 313],655,5,10493,4.0702094647013185,40.0,0.0
32578,3,2578,[318 427 185 515 313],655,5,10498,4.070569988367584,40.0,0.0
32579,3,2579,[318 427 185 515 313],655,5,10503,4.07093023255814,40.0,0.0
32580,3,2580,[135 273 191 204   4],655,3,10506,4.07051530414568,0.0,0.0
32581,3,2581,[180 191 121 328  82],450,3,10509,4.070100697134005,0.0,0.0
32582,3,2582,[318 427 185 515 313],655,5,10514,4.070460704607046,40.0,0.0
32583,3,2583,[318 427 185 515 313],655,5,10519,4.070820433436532,40.0,0.0
32584,3,2584,[318 427 185 515 313],655,5,10524,4.071179883945842,40.0,0.0
32585,3,2585,[322 273 655 288 202],450,3,10527,4.0707656612529,0.0,0.0
32586,3,2586,[185  89  64 276 427],269,4,10531,4.070738306919211,40.0,0.0
32587,3,2587,[318 427 185 515 313],655,5,10536,4.071097372488408,40.0,0.0
32588,3,2588,[318 427 185 515 313],655,5,10541,4.071456160679799,40.0,0.0
32589,3,2589,[234  28 143 135 282],655,2,10543,4.070656370656371,0.0,0.0
32590,3,2590,[ 88 118 294  79 174],796,4,10547,4.070629100733307,0.0,0.0
32591,3,2591,[318 427 185 515 313],655,5,10552,4.070987654320987,40.0,0.0
32592,3,2592,[546 191 275 210 496],796,4,10556,4.070960277670652,20.0,20.0
32593,3,2593,[423 603   9  56 228],655,1,10557,4.0697764070932925,20.0,0.0
32594,3,2594,[204 318 228 172 471],807,5,10562,4.070134874759153,20.0,0.0
32595,3,2595,[265   4 161  64  88],450,4,10566,4.070107858243452,20.0,0.0
32596,3,2596,[ 22   1 546 568 588],716,4,10570,4.070080862533692,0.0,0.0
32597,3,2597,[318 427 185 515 313],655,5,10575,4.0704387990762125,40.0,0.0
32598,3,2598,[186 245 238 237 196],504,2,10577,4.06964217006541,0.0,0.0
32599,3,2599,[222 333  79 427 181],796,5,10582,4.07,20.0,0.0
32600,3,2600,[318 427 185 515 313],655,5,10587,4.070357554786621,40.0,0.0
32601,3,2601,[318 427 185 515 313],655,5,10592,4.070714834742506,40.0,0.0
32602,3,2602,[318 427 185 515 313],655,5,10597,4.071071840184403,40.0,0.0
32603,3,2603,[318 427 185 515 313],655,5,10602,4.071428571428571,40.0,0.0
32604,3,2604,[118 357 546 121 318],593,4,10606,4.071401151631478,20.0,0.0
32605,3,2605,[111 238 200 181 132],450,4,10610,4.071373752877974,0.0,0.0
32606,3,2606,[318 427 185 515 313],655,5,10615,4.071729957805907,40.0,0.0
32607,3,2607,[318 427 185 515 313],655,5,10620,4.072085889570552,40.0,0.0
32608,3,2608,[318 427 185 515 313],655,5,10625,4.07244154848601,40.0,0.0
32609,3,2609,[265  97  15  12 117],457,5,10630,4.0727969348659006,0.0,0.0
32610,3,2610,[318 427 185 515 313],655,5,10635,4.073152049023363,40.0,0.0
32611,3,2611,[318 427 185 515 313],655,5,10640,4.073506891271057,40.0,0.0
32612,3,2612,[ 28 238 121 144  69],796,3,10643,4.073096058170685,0.0,0.0
32613,3,2613,[318 427 185 515 313],655,5,10648,4.0734506503442995,40.0,0.0
32614,3,2614,[180 568 135 515 174],269,2,10650,4.072657743785851,0.0,0.0
32615,3,2615,[143 483 185 333 273],693,2,10652,4.071865443425076,0.0,0.0
32616,3,2616,[195 655 546  98 222],786,5,10657,4.072220099350401,0.0,0.0
32617,3,2617,[ 64 588 111 216  98],878,4,10661,4.072192513368984,20.0,0.0
32618,3,2618,[742 568 173 275 328],796,4,10665,4.072164948453608,0.0,20.0
32619,3,2619,[234  25  12 318 258],693,4,10669,4.072137404580153,20.0,0.0
32620,3,2620,[318 427 185 515 313],655,5,10674,4.072491415490271,40.0,0.0
32621,3,2621,[318 427 185 515 313],655,5,10679,4.072845156369183,40.0,0.0
32622,3,2622,[318 427 185 515 313],655,5,10684,4.073198627525734,40.0,0.0
32623,3,2623,[  1 301 742 176 322],344,2,10686,4.072408536585366,0.0,0.0
32624,3,2624,[318 143 151 210 435],269,2,10688,4.0716190476190475,20.0,0.0
32625,3,2625,[318 427 185 515 313],655,5,10693,4.071972581873572,40.0,0.0
32626,3,2626,[ 95 405 127 168 161],807,4,10697,4.071945184621241,0.0,20.0
32627,3,2627,[258   7 302 357 153],535,3,10700,4.071537290715373,0.0,0.0
32628,3,2628,[318 427 185 515 313],655,5,10705,4.071890452643591,40.0,0.0
32629,3,2629,[588 748 172  71 286],796,4,10709,4.0718631178707225,0.0,20.0
32630,3,2630,[275 200 204 202 288],655,2,10711,4.071075636640061,0.0,20.0
32631,3,2631,[318 427 185 515 313],655,5,10716,4.071428571428571,40.0,0.0
32632,3,2632,[235  89 588 197  22],450,4,10720,4.071401443220661,0.0,0.0
32633,3,2633,[318 427 185 515 313],655,5,10725,4.071753986332574,40.0,0.0
32634,3,2634,[318 427 185 515 313],655,5,10730,4.072106261859583,40.0,0.0
32635,3,2635,[318 427 185 515 313],655,5,10735,4.072458270106222,40.0,0.0
32636,3,2636,[ 50 742 216 176 302],655,3,10738,4.072051573758058,0.0,20.0
32637,3,2637,[318 427 185 515 313],655,5,10743,4.072403335860501,40.0,0.0
32638,3,2638,[318 427 185 515 313],655,5,10748,4.072754831375521,40.0,0.0
32639,3,2639,[ 79  25 742 471 237],256,5,10753,4.073106060606061,0.0,0.0
32640,3,2640,[181 483 153 173  22],535,4,10757,4.073078379401742,0.0,0.0
32641,3,2641,[318 427 185 515 313],655,5,10762,4.073429220287661,40.0,0.0
32642,3,2642,[318 427 185 515 313],655,5,10767,4.073779795686719,40.0,0.0
32643,3,2643,[ 56  28  69 300 202],151,5,10772,4.074130105900151,0.0,0.0
32644,3,2644,[318 427 185 515 313],655,5,10777,4.074480151228734,40.0,0.0
32645,3,2645,[318 427 185 515 313],655,5,10782,4.074829931972789,40.0,0.0
32646,3,2646,[318 427 185 515 313],655,5,10787,4.075179448432188,40.0,0.0
32647,3,2647,[ 22   7 121  70  71],344,1,10788,4.074018126888218,0.0,0.0
32648,3,2648,[318 427 185 515 313],655,5,10793,4.074367685919214,40.0,0.0
32649,3,2649,[318 427 185 515 313],655,5,10798,4.074716981132076,40.0,0.0
32650,3,2650,[318 427 185 515 313],655,5,10803,4.075066012825349,40.0,0.0
32651,3,2651,[318 427 185 515 313],655,5,10808,4.075414781297134,40.0,0.0
32652,3,2652,[318 427 185 515 313],655,5,10813,4.075763286845081,40.0,0.0
32653,3,2653,[318 427 185 515 313],655,5,10818,4.076111529766391,40.0,0.0
32654,3,2654,[ 70 151 235 118 127],457,4,10822,4.07608286252354,0.0,20.0
32655,3,2655,[132 238  25 302 333],655,1,10823,4.074924698795181,0.0,0.0
32656,3,2656,[313 181 508 197 235],280,1,10824,4.07376740684983,0.0,0.0
32657,3,2657,[ 15 435  70 132  25],151,5,10829,4.074115876598946,0.0,0.0
32658,3,2658,[427 210 111 174 196],655,1,10830,4.07295975930801,20.0,0.0
32659,3,2659,[ 79 182   1 300 275],389,4,10834,4.072932330827068,0.0,20.0
32660,3,2660,[202  15 100 125 186],577,4,10838,4.072904922961293,0.0,20.0
32661,3,2661,[318 427 185 515 313],655,5,10843,4.073253193087904,40.0,0.0
32662,3,2662,[318 427 185 515 313],655,5,10848,4.073601201652272,40.0,0.0
32663,3,2663,[318 427 185 515 313],655,5,10853,4.073948948948949,40.0,0.0
32664,3,2664,[515  70 181  56 568],716,5,10858,4.074296435272045,0.0,0.0
32665,3,2665,[318 427 185 515 313],655,5,10863,4.074643660915229,40.0,0.0
32666,3,2666,[135 210 186  82 568],269,1,10864,4.073490813648294,0.0,0.0
32667,3,2667,[471 175  79 235   4],716,1,10865,4.072338830584708,0.0,0.0
32668,3,2668,[125 210 216 228 194],577,3,10868,4.071937055076808,0.0,0.0
32669,3,2669,[405 180 144 748 204],280,1,10869,4.070786516853933,0.0,0.0
32670,3,2670,[318 427 185 515 313],655,5,10874,4.071134406589293,40.0,0.0
32671,3,2671,[ 96 322  12 318 237],796,4,10878,4.071107784431137,20.0,0.0
32672,3,2672,[196 185 655 234  82],450,3,10881,4.070707070707071,0.0,0.0
32673,3,2673,[318 427 185 515 313],655,5,10886,4.071054599850411,40.0,0.0
32674,3,2674,[151 288 197 742 161],450,4,10890,4.0710280373831775,0.0,0.0
32675,3,2675,[423 111 508 182 357],269,4,10894,4.071001494768311,0.0,0.0
32676,3,2676,[132 153  79 181 269],535,4,10898,4.0709749719835635,0.0,0.0
32677,3,2677,[318 427 185 515 313],655,5,10903,4.071321882001493,40.0,0.0
32678,3,2678,[181 568 405  79 216],280,2,10905,4.070548712206047,0.0,0.0
32679,3,2679,[318 427 185 515 313],655,5,10910,4.07089552238806,40.0,0.0
32680,3,2680,[385  15 238 180 125],450,4,10914,4.070869078701977,0.0,0.0
32681,3,2681,[ 50 294 235 179  70],450,4,10918,4.070842654735272,0.0,20.0
32682,3,2682,[318 427 185 515 313],655,5,10923,4.071188967573612,40.0,0.0
32683,3,2683,[318 427 185 515 313],655,5,10928,4.071535022354695,40.0,0.0
32684,3,2684,[318 427 185 515 313],655,5,10933,4.071880819366853,40.0,0.0
32685,3,2685,[471 318 210 179  64],457,5,10938,4.072226358897989,40.0,0.0
32686,3,2686,[318 427 185 515 313],655,5,10943,4.072571641235578,40.0,0.0
32687,3,2687,[ 98 275 186 127 187],786,5,10948,4.072916666666667,0.0,40.0
32688,3,2688,[ 70 153 385 176 423],655,0,10948,4.07140200818148,0.0,0.0
32689,3,2689,[318 427 185 515 313],655,5,10953,4.071747211895911,40.0,0.0
32690,3,2690,[318 427 185 515 313],655,5,10958,4.0720921590486805,40.0,0.0
32691,3,2691,[ 15  95 234  12 100],577,3,10961,4.0716939078751855,0.0,20.0
32692,3,2692,[318 427 185 515 313],655,5,10966,4.072038618640921,40.0,0.0
32693,3,2693,[318 427 185 515 313],655,5,10971,4.072383073496659,40.0,0.0
32694,3,2694,[318 427 185 515 313],655,5,10976,4.072727272727272,40.0,0.0
32695,3,2695,[174 135 111 294   8],707,2,10978,4.071958456973293,0.0,0.0
32696,3,2696,[176 302  69  79 210],151,3,10981,4.0715609936967,0.0,0.0
32697,3,2697,[318 427 185 515 313],655,5,10986,4.071905114899926,40.0,0.0
32698,3,2698,[161 180  69 269 318],450,5,10991,4.072248981104113,20.0,0.0
32699,3,2699,[318 427 185 515 313],655,5,10996,4.072592592592593,40.0,0.0
32700,3,2700,[403 143  11 588 597],457,4,11000,4.072565716401333,0.0,0.0
32701,3,2701,[318 427 185 515 313],655,5,11005,4.072908956328646,40.0,0.0
32702,3,2702,[318 427 185 515 313],655,5,11010,4.0732519422863485,40.0,0.0
32703,3,2703,[318 427 185 515 313],655,5,11015,4.073594674556213,40.0,0.0
32704,3,2704,[318 427 185 515 313],655,5,11020,4.073937153419593,40.0,0.0
32705,3,2705,[318 427 185 515 313],655,5,11025,4.074279379157428,40.0,0.0
32706,3,2706,[ 82  88 196 187  56],269,2,11027,4.073513114148504,0.0,0.0
32707,3,2707,[318 427 185 515 313],655,5,11032,4.073855243722305,40.0,0.0
32708,3,2708,[318 427 185 515 313],655,5,11037,4.074197120708749,40.0,0.0
32709,3,2709,[318 427 185 515 313],655,5,11042,4.0745387453874535,40.0,0.0
32710,3,2710,[  8 135 238  69  71],330,4,11046,4.074511250461084,0.0,0.0
32711,3,2711,[144 515 194 132 118],807,5,11051,4.074852507374631,0.0,0.0
32712,3,2712,[318 427 185 515 313],655,5,11056,4.07519351271655,40.0,0.0
32713,3,2713,[ 88 183 153 313 496],796,5,11061,4.075534266764922,20.0,0.0
32714,3,2714,[427 151  98 100 222],5,2,11063,4.074769797421731,20.0,20.0
32715,3,2715,[318 427 185 515 313],655,5,11068,4.075110456553755,40.0,0.0
32716,3,2716,[318 427 185 515 313],655,5,11073,4.075450864924549,40.0,0.0
32717,3,2717,[318 427 185 515 313],655,5,11078,4.075791022810891,40.0,0.0
32718,3,2718,[318 427 185 515 313],655,5,11083,4.076130930489151,40.0,0.0
32719,3,2719,[216 258  15 185 276],457,5,11088,4.076470588235294,0.0,0.0
32720,3,2720,[318 427 185 515 313],655,5,11093,4.07680999632488,40.0,0.0
32721,3,2721,[357 234 191 153  56],716,5,11098,4.077149155033064,0.0,0.0
32722,3,2722,[127 333 185 742 210],655,2,11100,4.0763863385971355,0.0,20.0
32723,3,2723,[195 121 328 333  11],655,0,11100,4.07488986784141,0.0,0.0
32724,3,2724,[318 427 185 515 313],655,5,11105,4.0752293577981655,40.0,0.0
32725,3,2725,[318 427 185 515 313],655,5,11110,4.075568598679384,40.0,0.0
32726,3,2726,[318 427 185 515 313],655,5,11115,4.075907590759076,40.0,0.0
32727,3,2727,[318 427 185 515 313],655,5,11120,4.07624633431085,40.0,0.0
32728,3,2728,[318 427 185 515 313],655,5,11125,4.076584829607915,40.0,0.0
32729,3,2729,[ 12 258 215 216 357],11,2,11127,4.0758241758241756,0.0,0.0
32730,3,2730,[318 427 185 515 313],655,5,11132,4.076162577810326,40.0,0.0
32731,3,2731,[210  97  11 202  12],344,3,11135,4.075768667642753,0.0,0.0
32732,3,2732,[ 79 483 200 271 323],796,4,11139,4.075740944017563,0.0,0.0
32733,3,2733,[318 427 185 515 313],655,5,11144,4.076079005120702,40.0,0.0
32734,3,2734,[318 427 185 515 313],655,5,11149,4.076416819012797,40.0,0.0
32735,3,2735,[185 127  25 216 125],503,4,11153,4.076388888888889,0.0,20.0
32736,3,2736,[318 427 185 515 313],655,5,11158,4.076726342710997,40.0,0.0
32737,3,2737,[168  28 195 228 143],450,5,11163,4.077063550036523,0.0,0.0
32738,3,2738,[588 185 403 181 135],450,4,11167,4.077035414384812,0.0,0.0
32739,3,2739,[  8 289 603 175 202],655,1,11168,4.075912408759124,20.0,0.0
32740,3,2740,[357 111 181   1 135],655,2,11170,4.075155052900401,0.0,0.0
32741,3,2741,[742 187 282   7 234],256,3,11173,4.074762946754194,0.0,0.0
32742,3,2742,[ 28  11 282   4  50],457,5,11178,4.075100255195042,0.0,20.0
32743,3,2743,[172 196 508 195 151],269,2,11180,4.074344023323615,0.0,0.0
32744,3,2744,[318 427 185 515 313],655,5,11185,4.074681238615665,40.0,0.0
32745,3,2745,[294 403 183 423 742],280,2,11187,4.073925710123817,0.0,0.0
32746,3,2746,[ 96 546 228 322   1],256,4,11191,4.07389879868948,0.0,0.0
32747,3,2747,[318 427 185 515 313],655,5,11196,4.074235807860262,40.0,0.0
32748,3,2748,[318 427 185 515 313],655,5,11201,4.074572571844307,40.0,0.0
32749,3,2749,[204 173 211 403 151],269,2,11203,4.073818181818182,0.0,0.0
32750,3,2750,[269 234 174  98  15],878,3,11206,4.073427844420211,0.0,0.0
32751,3,2751,[678 323 300  70 179],504,3,11209,4.073037790697675,0.0,0.0
32752,3,2752,[318 427 185 515 313],655,5,11214,4.07337450054486,40.0,0.0
32753,3,2753,[318 427 185 515 313],655,5,11219,4.0737109658678285,40.0,0.0
32754,3,2754,[318 427 185 515 313],655,5,11224,4.074047186932849,40.0,0.0
32755,3,2755,[ 70 175 286  11 245],344,1,11225,4.072931785195936,0.0,20.0
32756,3,2756,[318 427 185 515 313],655,5,11230,4.073268044976424,40.0,0.0
32757,3,2757,[318 427 185 515 313],655,5,11235,4.073604060913706,40.0,0.0
32758,3,2758,[318 427 185 515 313],655,5,11240,4.073939833272925,40.0,0.0
32759,3,2759,[181  28   1 151 127],18,2,11242,4.073188405797102,0.0,20.0
32760,3,2760,[318 427 185 515 313],655,5,11247,4.073524085476277,40.0,0.0
32761,3,2761,[ 25 276 237   1  64],535,3,11250,4.073135409123823,20.0,0.0
32762,3,2762,[ 15  95 215 187 245],450,3,11253,4.072747014115092,0.0,0.0
32763,3,2763,[100 127  71  56 182],450,4,11257,4.072720694645441,0.0,40.0
32764,3,2764,[176 161 179  56 237],655,1,11258,4.071609403254973,0.0,0.0
32765,3,2765,[186 172 179 385 275],450,4,11262,4.071583514099783,0.0,20.0
32766,3,2766,[ 64 172  28 357 117],716,5,11267,4.071919045898085,20.0,0.0
32767,3,2767,[318 427 185 515 313],655,5,11272,4.072254335260116,40.0,0.0
32768,3,2768,[318 427 185 515 313],655,5,11277,4.0725893824485375,40.0,0.0
32769,3,2769,[195 222 111   1 187],796,4,11281,4.072563176895307,0.0,0.0
32770,3,2770,[183 118   9 357  89],457,5,11286,4.072897870804764,0.0,0.0
32771,3,2771,[568 238 100 301 111],450,5,11291,4.0732323232323235,0.0,20.0
32772,3,2772,[265 323 405 245   4],280,1,11292,4.072124053371799,0.0,0.0
32773,3,2773,[ 70 313 282 172 268],655,2,11294,4.0713770728190335,0.0,0.0
32774,3,2774,[597 127 435  64 302],450,5,11299,4.071711711711711,20.0,20.0
32775,3,2775,[268 273 204 271 197],629,4,11303,4.071685878962536,0.0,0.0
32776,3,2776,[318 427 185 515 313],655,5,11308,4.072020165646381,40.0,0.0
32777,3,2777,[471 286 282 275  64],655,2,11310,4.071274298056156,20.0,40.0
32778,3,2778,[ 25 176 245 301  82],450,3,11313,4.070888808924074,0.0,0.0
32779,3,2779,[ 15 496 588 276 216],786,3,11316,4.070503597122302,20.0,0.0
32780,3,2780,[ 12  79 202 237 294],457,4,11320,4.070478245235527,0.0,0.0
32781,3,2781,[168 196 234  56 222],457,5,11325,4.070812365204889,0.0,0.0
32782,3,2782,[318 427 185 515 313],655,5,11330,4.071146245059288,40.0,0.0
32783,3,2783,[318 427 185 515 313],655,5,11335,4.071479885057471,40.0,0.0
32784,3,2784,[191 151 172  98  89],796,5,11340,4.07181328545781,0.0,0.0
32785,3,2785,[318 427 185 515 313],655,5,11345,4.072146446518306,40.0,0.0
32786,3,2786,[318 427 185 515 313],655,5,11350,4.072479368496591,40.0,0.0
32787,3,2787,[100 234  71 176  97],786,4,11354,4.072453371592539,0.0,20.0
32788,3,2788,[181 111 144 475 748],292,4,11358,4.072427393330943,0.0,0.0
32789,3,2789,[228 588 161 196 403],450,5,11363,4.0727598566308245,0.0,0.0
32790,3,2790,[318 427 185 515 313],655,5,11368,4.07309208169115,40.0,0.0
32791,3,2791,[318 427 185 515 313],655,5,11373,4.073424068767908,40.0,0.0
32792,3,2792,[322  82 191 174 234],151,2,11375,4.072681704260652,0.0,0.0
32793,3,2793,[603 427 588 357 186],911,4,11379,4.072655690765927,40.0,0.0
32794,3,2794,[318 185 515 427 313],655,5,11384,4.07298747763864,40.0,0.0
32795,3,2795,[318 185 515 427 313],655,5,11389,4.073319027181688,40.0,0.0
32796,3,2796,[318 185 515 427 313],655,5,11394,4.073650339649625,40.0,0.0
32797,3,2797,[200 568 185  96 742],450,4,11398,4.073624017155111,0.0,0.0
32798,3,2798,[588 127 222 483 323],796,4,11402,4.073597713469096,0.0,20.0
32799,3,2799,[195 127 180 121  96],72,4,11406,4.073571428571428,0.0,20.0
32800,3,2800,[318 185 515 427 313],655,5,11411,4.073902177793645,40.0,0.0
32801,3,2801,[194 121   1 318  69],577,5,11416,4.074232690935046,20.0,0.0
32802,3,2802,[301  25 546  11 216],344,3,11419,4.073849447021049,0.0,0.0
32803,3,2803,[318 185 515 427 313],655,5,11424,4.074179743223966,40.0,0.0
32804,3,2804,[196 183 180 176 197],835,5,11429,4.074509803921568,0.0,0.0
32805,3,2805,[603 435 483 187 742],655,3,11432,4.074126870990734,20.0,0.0
32806,3,2806,[302 194 181  82 186],151,3,11435,4.073744210901318,0.0,0.0
32807,3,2807,[318 185 515 427 313],655,5,11440,4.074074074074074,40.0,0.0
32808,3,2808,[405 258 471 515 117],733,1,11441,4.072979708081168,0.0,0.0
32809,3,2809,[ 98 238 471  64 655],65,4,11445,4.072953736654804,20.0,0.0
32810,3,2810,[318 185 515 427 313],655,5,11450,4.073283528993241,40.0,0.0
32811,3,2811,[173 237 282 194  22],535,3,11453,4.072901849217638,0.0,0.0
32812,3,2812,[403 195 132 186  70],450,4,11457,4.0728759331674365,0.0,0.0
32813,3,2813,[204 282  50 100 286],535,3,11460,4.072494669509595,0.0,60.0
32814,3,2814,[318 185 515 427 313],655,5,11465,4.072824156305506,40.0,0.0
32815,3,2815,[183 286 603 300 234],151,4,11469,4.072798295454546,20.0,20.0
32816,3,2816,[318 185 515 427 313],655,5,11474,4.073127440539581,40.0,0.0
32817,3,2817,[508 222 678 216 588],280,2,11476,4.072391767210788,0.0,0.0
32818,3,2818,[318 185 515 427 313],655,5,11481,4.0727208229868745,40.0,0.0
32819,3,2819,[161 475   1 237 222],655,0,11481,4.071276595744681,0.0,0.0
32820,3,2820,[318 185 515 427 313],655,5,11486,4.071605813541297,40.0,0.0
32821,3,2821,[318 185 515 427 313],655,5,11491,4.071934798015592,40.0,0.0
32822,3,2822,[ 98  70 471 161 742],593,4,11495,4.071909316330145,0.0,0.0
32823,3,2823,[210 179 161 174 183],450,4,11499,4.071883852691218,0.0,0.0
32824,3,2824,[216  12 135  22  28],457,5,11504,4.072212389380531,0.0,0.0
32825,3,2825,[318 185 515 427 313],655,5,11509,4.072540693559802,40.0,0.0
32826,3,2826,[318 185 515 427 313],655,5,11514,4.07286876547577,40.0,0.0
32827,3,2827,[318 185 515 427 313],655,5,11519,4.073196605374823,40.0,0.0
32828,3,2828,[151 258  70 385 742],504,4,11523,4.073170731707317,0.0,0.0
32829,3,2829,[276 168  98 385 282],504,4,11527,4.073144876325088,0.0,0.0
32830,3,2830,[ 82 405 216 173 143],786,5,11532,4.073472271282232,0.0,0.0
32831,3,2831,[210 258 127 211 276],655,2,11534,4.07274011299435,0.0,20.0
32832,3,2832,[318 185 515 427 313],655,5,11539,4.073067419696435,40.0,0.0
32833,3,2833,[176 117 173 127  64],292,5,11544,4.073394495412844,20.0,20.0
32834,3,2834,[318 185 515 427 313],655,5,11549,4.0737213403880075,40.0,0.0
32835,3,2835,[318 185 515 427 313],655,5,11554,4.074047954866009,40.0,0.0
32836,3,2836,[228 172 196 265  28],151,5,11559,4.074374339090588,0.0,0.0
32837,3,2837,[276 180 183  12  50],457,5,11564,4.074700493305144,0.0,20.0
32838,3,2838,[100 175 174 197  88],151,4,11568,4.074674181049665,0.0,20.0
32839,3,2839,[200 181 143  88  22],655,2,11570,4.073943661971831,0.0,0.0
32840,3,2840,[179 742 174   8  11],457,5,11575,4.074269623372052,0.0,0.0
32841,3,2841,[269  25  15 245 183],450,3,11578,4.073891625615763,0.0,0.0
32842,3,2842,[318 185 515 427 313],655,5,11583,4.074217376011256,40.0,0.0
32843,3,2843,[318 185 515 427 313],655,5,11588,4.074542897327707,40.0,0.0
32844,3,2844,[318 185 515 427 313],655,5,11593,4.074868189806678,40.0,0.0
32845,3,2845,[204 195 588 228 289],786,5,11598,4.075193253689388,0.0,0.0
32846,3,2846,[183 143 161 568 176],457,5,11603,4.075518089216719,0.0,0.0
32847,3,2847,[318 185 515 427 313],655,5,11608,4.075842696629214,40.0,0.0
32848,3,2848,[318 185 515 427 313],655,5,11613,4.076167076167076,40.0,0.0
32849,3,2849,[318 185 515 427 313],655,5,11618,4.076491228070175,40.0,0.0
32850,3,2850,[269 427 275 168 161],796,4,11622,4.0764643984566815,20.0,20.0
32851,3,2851,[318 185 515 427 313],655,5,11627,4.076788218793829,40.0,0.0
32852,3,2852,[237 742  25 405 245],450,4,11631,4.076761303890642,0.0,0.0
32853,3,2853,[318 185 515 427 313],655,5,11636,4.0770847932726,40.0,0.0
32854,3,2854,[135 168 496  98 180],716,3,11639,4.076707530647986,20.0,0.0
32855,3,2855,[655 185  82 195 143],655,2,11641,4.075980392156863,0.0,0.0
32856,3,2856,[151 132 289 496 265],236,2,11643,4.075253762688134,20.0,0.0
32857,3,2857,[173 228 180 216 265],457,5,11648,4.07557732680196,0.0,0.0
32858,3,2858,[182 127 427 211 238],389,5,11653,4.075900664568031,20.0,20.0
32859,3,2859,[423 322 179 385 100],504,4,11657,4.075874125874126,0.0,20.0
32860,3,2860,[197 181 265 187 172],450,5,11662,4.076197133869276,0.0,0.0
32861,3,2861,[210 191 185 132 318],457,5,11667,4.076519916142558,20.0,0.0
32862,3,2862,[588 496  82 435 179],450,4,11671,4.076493188962627,20.0,0.0
32863,3,2863,[318 185 515 427 313],655,5,11676,4.076815642458101,40.0,0.0
32864,3,2864,[318 185 515 427 313],655,5,11681,4.0771378708551484,40.0,0.0
32865,3,2865,[195 186 175  69 568],269,1,11682,4.076064200976972,0.0,0.0
32866,3,2866,[318 185 515 427 313],655,5,11687,4.07638646668992,40.0,0.0
32867,3,2867,[179 182 111  88 427],655,3,11690,4.0760111576011155,20.0,0.0
32868,3,2868,[ 69  50 195 183 222],151,3,11693,4.075636110142907,0.0,20.0
32869,3,2869,[318 185 515 427 313],655,5,11698,4.07595818815331,40.0,0.0
32870,3,2870,[318 185 515 427 313],655,5,11703,4.0762800417972835,40.0,0.0
32871,3,2871,[318 185 515 427 313],655,5,11708,4.076601671309192,40.0,0.0
32872,3,2872,[318 185 515 427 313],655,5,11713,4.076923076923077,40.0,0.0
32873,3,2873,[117 385 179 210 546],450,4,11717,4.0768963117606125,0.0,0.0
32874,3,2874,[127 483 276 187 568],655,4,11721,4.076869565217391,0.0,20.0
32875,3,2875,[191 357 483 286 276],655,4,11725,4.0768428372739915,0.0,20.0
32876,3,2876,[318 185 515 427 313],655,5,11730,4.077163712200209,40.0,0.0
32877,3,2877,[301 161  50 117  95],450,4,11734,4.077136900625434,0.0,20.0
32878,3,2878,[318 185 515 427 313],655,5,11739,4.077457450503647,40.0,0.0
32879,3,2879,[275 176 191 286 100],796,3,11742,4.077083333333333,0.0,60.0
32880,3,2880,[318 185 515 427 313],655,5,11747,4.077403679278029,40.0,0.0
32881,3,2881,[ 28 603 300 151 403],796,4,11751,4.07737682165163,20.0,0.0
32882,3,2882,[318 185 515 427 313],655,5,11756,4.07769684356573,40.0,0.0
32883,3,2883,[318 185 515 427 313],655,5,11761,4.078016643550624,40.0,0.0
32884,3,2884,[176 182 186 196  22],655,1,11762,4.076949740034662,0.0,0.0
32885,3,2885,[318 185 515 427 313],655,5,11767,4.077269577269577,40.0,0.0
32886,3,2886,[318 185 515 427 313],655,5,11772,4.077589192933841,40.0,0.0
32887,3,2887,[318 185 515 427 313],655,5,11777,4.0779085872576175,40.0,0.0
32888,3,2888,[546 471 197 194 183],450,5,11782,4.078227760470751,0.0,0.0
32889,3,2889,[603  79  22 174 210],796,4,11786,4.078200692041523,20.0,0.0
32890,3,2890,[153   8 111 238 318],707,4,11790,4.0781736423382915,20.0,0.0
32891,3,2891,[483 603 202 195 187],655,3,11793,4.077800829875518,20.0,0.0
32892,3,2892,[318 185 515 427 313],655,5,11798,4.078119599032147,40.0,0.0
32893,3,2893,[132   1 185 275 197],18,4,11802,4.078092605390463,0.0,20.0
32894,3,2894,[483  98 405 127 282],655,3,11805,4.077720207253886,0.0,20.0
32895,3,2895,[216  22  11  96 235],256,4,11809,4.077693370165746,0.0,0.0
32896,3,2896,[318 515 427 185 313],655,5,11814,4.078011736278909,40.0,0.0
32897,3,2897,[174  28 435 294 237],716,5,11819,4.078329882677709,0.0,0.0
32898,3,2898,[ 98 276 174 153  56],535,2,11821,4.0776129699896515,0.0,0.0
32899,3,2899,[197 172 176 655 200],786,4,11825,4.077586206896552,0.0,0.0
32900,3,2900,[318 515 427 185 313],655,5,11830,4.0779041709755255,40.0,0.0
32901,3,2901,[318 515 427 185 313],655,5,11835,4.0782219159200555,40.0,0.0
32902,3,2902,[318 127 121 174  98],72,4,11839,4.078194970719945,20.0,20.0
32903,3,2903,[318 515 427 185 313],655,5,11844,4.078512396694215,40.0,0.0
32904,3,2904,[ 79 222  64  70 603],72,4,11848,4.078485370051635,40.0,0.0
32905,3,2905,[194  98 301 275 471],389,5,11853,4.078802477632484,0.0,20.0
32906,3,2906,[222 300 144 182  28],655,1,11854,4.0777433780529755,0.0,0.0
32907,3,2907,[235  11 202 181  82],450,3,11857,4.077372764786795,0.0,0.0
32908,3,2908,[318 515 427 185 313],655,5,11862,4.077689927810244,40.0,0.0
32909,3,2909,[318 515 427 185 313],655,5,11867,4.078006872852233,40.0,0.0
32910,3,2910,[318 515 427 185 313],655,5,11872,4.07832360013741,40.0,0.0
32911,3,2911,[403 655 568 483 228],655,1,11873,4.077266483516484,0.0,0.0
32912,3,2912,[153 135 515 318 471],655,3,11876,4.076896670099554,20.0,0.0
32913,3,2913,[742   1 161  97  89],450,5,11881,4.077213452299245,0.0,0.0
32914,3,2914,[471 405  11 655 588],577,2,11883,4.076500857632933,0.0,0.0
32915,3,2915,[185 318 257 238 275],330,5,11888,4.07681755829904,20.0,20.0
32916,3,2916,[257 179  89 117 211],655,2,11890,4.076105587932807,0.0,0.0
32917,3,2917,[588 186 294 258 742],457,4,11894,4.076079506511309,0.0,0.0
32918,3,2918,[294 228 118 222 161],655,0,11894,4.074683110654334,0.0,0.0
32919,3,2919,[318 515 427 185 313],655,5,11899,4.075,40.0,0.0
32920,3,2920,[ 88  71 405  15 313],593,4,11903,4.074974323861691,0.0,0.0
32921,3,2921,[318 515 427 185 313],655,5,11908,4.075290896646133,40.0,0.0
32922,3,2922,[318 515 427 185 313],655,5,11913,4.075607252822443,40.0,0.0
32923,3,2923,[318 515 427 185 313],655,5,11918,4.075923392612859,40.0,0.0
32924,3,2924,[143  28 186 210 216],389,1,11919,4.074871794871795,0.0,0.0
32925,3,2925,[405  71  15 289 357],786,4,11923,4.074846206425153,0.0,0.0
32926,3,2926,[271 181 144 333 515],902,2,11925,4.074137341988384,0.0,0.0
32927,3,2927,[318 515 427 185 313],655,5,11930,4.074453551912568,40.0,0.0
32928,3,2928,[318 515 427 185 313],655,5,11935,4.074769545920109,40.0,0.0
32929,3,2929,[318 515 427 185 313],655,5,11940,4.075085324232082,40.0,0.0
32930,3,2930,[173 300 174 186  64],716,4,11944,4.075059706584783,20.0,0.0
32931,3,2931,[196 588 258 151  89],344,4,11948,4.075034106412005,0.0,0.0
32932,3,2932,[318 515 427 185 313],655,5,11953,4.075349471530855,40.0,0.0
32933,3,2933,[174  89 144 196  82],23,2,11955,4.074642126789366,0.0,0.0
32934,3,2934,[318 515 427 185 313],655,5,11960,4.07495741056218,40.0,0.0
32935,3,2935,[318 515 427 185 313],655,5,11965,4.075272479564033,40.0,0.0
32936,3,2936,[318 515 427 185 313],655,5,11970,4.0755873340143,40.0,0.0
32937,3,2937,[197 172 118 216 275],796,4,11974,4.075561606535058,0.0,20.0
32938,3,2938,[568 210 302 483   8],655,2,11976,4.074855392990814,0.0,0.0
32939,3,2939,[318 515 427 185 313],655,5,11981,4.0751700680272105,40.0,0.0
32940,3,2940,[215 318 180   4 197],457,5,11986,4.075484529071744,20.0,0.0
32941,3,2941,[216 258 288 222 202],655,1,11987,4.07443915703603,0.0,0.0
32942,3,2942,[546 180 471  56 222],280,3,11990,4.074074074074074,0.0,0.0
32943,3,2943,[318 515 427 185 313],655,5,11995,4.0743885869565215,40.0,0.0
32944,3,2944,[172 258 143 257 222],457,4,11999,4.074363327674024,0.0,0.0
32945,3,2945,[100 195 294 182 181],450,5,12004,4.074677528852682,0.0,20.0
32946,3,2946,[318 515 427 185 313],655,5,12009,4.074991516796742,40.0,0.0
32947,3,2947,[ 98 191 181 268 286],655,2,12011,4.074287652645862,0.0,20.0
32948,3,2948,[194 257 603 405 204],23,3,12014,4.0739233638521535,20.0,0.0
32949,3,2949,[237 257 204  70  64],401,2,12016,4.073220338983051,20.0,0.0
32950,3,2950,[318 403 211   9 172],796,3,12019,4.072856658759743,20.0,0.0
32951,3,2951,[196 403 151 423 118],798,2,12021,4.0721544715447155,0.0,0.0
32952,3,2952,[318 515 427 185 313],655,5,12026,4.07246867592279,40.0,0.0
32953,3,2953,[228 186 117 194 235],716,3,12029,4.072105619498984,0.0,0.0
32954,3,2954,[318 515 427 185 313],655,5,12034,4.072419627749577,40.0,0.0
32955,3,2955,[111  11 471  71 258],450,4,12038,4.072395128552097,0.0,0.0
32956,3,2956,[  4 195 286 118 191],151,2,12040,4.071694284748055,0.0,20.0
32957,3,2957,[ 95  96 748 135 423],280,4,12044,4.071670047329277,0.0,0.0
32958,3,2958,[ 96 176 183 427   1],796,4,12048,4.0716458262926665,20.0,0.0
32959,3,2959,[194 180 237 191 151],296,4,12052,4.071621621621621,0.0,0.0
32960,3,2960,[318 515 427 185 313],655,5,12057,4.07193515704154,40.0,0.0
32961,3,2961,[318 515 427 185 313],655,5,12062,4.072248480756246,40.0,0.0
32962,3,2962,[ 11 405 508 100 471],401,2,12064,4.07154910563618,0.0,20.0
32963,3,2963,[483 186 197 288  56],693,1,12065,4.07051282051282,0.0,0.0
32964,3,2964,[318 515 427 185 313],655,5,12070,4.070826306913997,40.0,0.0
32965,3,2965,[318 515 427 185 313],655,5,12075,4.071139581928524,40.0,0.0
32966,3,2966,[271 210 597 546   8],796,4,12079,4.071115604988203,0.0,0.0
32967,3,2967,[318 515 427 185 313],655,5,12084,4.071428571428571,40.0,0.0
32968,3,2968,[603 288  98 269  64],655,3,12087,4.071067699562142,40.0,0.0
32969,3,2969,[143 318 186 111 496],151,5,12092,4.071380471380471,40.0,0.0
32970,3,2970,[179 211   1 174 333],655,1,12093,4.070346684617974,0.0,0.0
32971,3,2971,[127 257 234 117 181],457,4,12097,4.0703230148048455,0.0,20.0
32972,3,2972,[216   4 196  12 483],450,3,12100,4.069963000336361,0.0,0.0
32973,3,2973,[ 88  25 385  97 275],401,4,12104,4.069939475453934,0.0,20.0
32974,3,2974,[117 111  25 161 318],716,4,12108,4.069915966386555,20.0,0.0
32975,3,2975,[  7 173 144 405 257],457,4,12112,4.06989247311828,0.0,0.0
32976,3,2976,[333 180 151  69 328],796,4,12116,4.069868995633188,0.0,0.0
32977,3,2977,[294  56 546 405 118],716,3,12119,4.0695097380792475,0.0,0.0
32978,3,2978,[ 12 742 597 211 153],450,5,12124,4.069822087948976,0.0,0.0
32979,3,2979,[405 173 125 135  95],450,3,12127,4.069463087248322,0.0,0.0
32980,3,2980,[323  71 546 143  89],796,4,12131,4.069439785306944,0.0,0.0
32981,3,2981,[318 515 427 185 313],655,5,12136,4.069751844399732,40.0,0.0
32982,3,2982,[318 515 427 185 313],655,5,12141,4.070063694267516,40.0,0.0
32983,3,2983,[ 79 173  28 187 385],450,5,12146,4.0703753351206435,0.0,0.0
32984,3,2984,[318 515 427 185 313],655,5,12151,4.070686767169179,40.0,0.0
32985,3,2985,[257 194 181 168 210],5,3,12154,4.07032819825854,0.0,0.0
32986,3,2986,[176  82 496  64 597],796,4,12158,4.070304653498494,40.0,0.0
32987,3,2987,[118 135 403 275 100],457,5,12163,4.070615796519411,0.0,40.0
32988,3,2988,[185 121 234 237   8],655,1,12164,4.069588491134159,0.0,0.0
32989,3,2989,[ 64 191 300 118 144],716,3,12167,4.069230769230769,20.0,0.0
32990,3,2990,[318 515 427 185 313],655,5,12172,4.069541959210966,40.0,0.0
32991,3,2991,[318 515 427 185 313],655,5,12177,4.069852941176471,40.0,0.0
32992,3,2992,[318 515 427 185 313],655,5,12182,4.0701637153357835,40.0,0.0
32993,3,2993,[ 64 143 588 427 127],450,5,12187,4.070474281897128,40.0,20.0
32994,3,2994,[282 435 118 328 515],655,1,12188,4.069449081803005,0.0,0.0
32995,3,2995,[318 515 427 185 313],655,5,12193,4.069759679572764,40.0,0.0
32996,3,2996,[ 82  25   4 185 132],457,5,12198,4.07007007007007,0.0,0.0
32997,3,2997,[318 515 427 185 313],655,5,12203,4.070380253502335,40.0,0.0
32998,3,2998,[289 132 210 265 125],798,3,12206,4.070023341113704,0.0,0.0
32999,3,2999,[288 183 127   9 161],457,5,12211,4.070333333333333,0.0,20.0
33000,3,3000,[181 153 228 144  82],450,4,12215,4.0703098967011,0.0,0.0
33001,3,3001,[318 515 427 185 313],655,5,12220,4.070619586942039,40.0,0.0
33002,3,3002,[318 515 427 185 313],655,5,12225,4.070929070929071,40.0,0.0
33003,3,3003,[318 515 427 185 313],655,5,12230,4.071238348868175,40.0,0.0
33004,3,3004,[385 496 202 546 187],786,5,12235,4.071547420965058,20.0,0.0
33005,3,3005,[181 194 265 210 288],450,3,12238,4.071190951430473,0.0,0.0
33006,3,3006,[275  50  97   9 508],535,5,12243,4.071499833721317,0.0,40.0
33007,3,3007,[318 515 427 185 313],655,5,12248,4.071808510638298,40.0,0.0
33008,3,3008,[471  64 423 127  89],457,5,12253,4.0721169823861745,20.0,20.0
33009,3,3009,[179 282 471 235 748],450,4,12257,4.072093023255814,0.0,0.0
33010,3,3010,[423 132 269 161 597],450,5,12262,4.072401195616075,0.0,0.0
33011,3,3011,[318 515 427 185 313],655,5,12267,4.072709163346613,40.0,0.0
33012,3,3012,[318 515 427 185 313],655,5,12272,4.073016926651178,40.0,0.0
33013,3,3013,[318 515 427 185 313],655,5,12277,4.073324485733245,40.0,0.0
33014,3,3014,[318 515 427 185 313],655,5,12282,4.07363184079602,40.0,0.0
33015,3,3015,[318 515 427 185 313],655,5,12287,4.07393899204244,40.0,0.0
33016,3,3016,[318 515 427 185 313],655,5,12292,4.0742459396751745,40.0,0.0
33017,3,3017,[ 70 294 427 111 194],65,4,12296,4.074221338634858,20.0,0.0
33018,3,3018,[318 515 427 185 313],655,5,12301,4.074527989400464,40.0,0.0
33019,3,3019,[318 515 427 185 313],655,5,12306,4.074834437086093,40.0,0.0
33020,3,3020,[289 179 655 483 216],655,3,12309,4.074478649453823,0.0,0.0
33021,3,3021,[333  50 187   4 204],629,4,12313,4.07445400397088,0.0,20.0
33022,3,3022,[275 257 222 228   4],796,5,12318,4.074760172014555,0.0,20.0
33023,3,3023,[318 515 427 185 313],655,5,12323,4.075066137566138,40.0,0.0
33024,3,3024,[181   1  98 191 100],296,5,12328,4.075371900826446,0.0,20.0
33025,3,3025,[318 515 427 185 313],655,5,12333,4.075677461996034,40.0,0.0
33026,3,3026,[ 69 111 118  22 174],457,4,12337,4.075652461182689,0.0,0.0
33027,3,3027,[333  88 471 742 228],693,0,12337,4.074306472919419,0.0,0.0
33028,3,3028,[678 265  50  22 546],807,4,12341,4.074281941234731,0.0,20.0
33029,3,3029,[318 515 427 185 313],655,5,12346,4.074587458745874,40.0,0.0
33030,3,3030,[318 515 427 185 313],655,5,12351,4.074892774661828,40.0,0.0
33031,3,3031,[174 234 271 197 222],655,0,12351,4.0735488126649075,0.0,0.0
33032,3,3032,[427 234   7 568  96],577,2,12353,4.072865150016486,20.0,0.0
33033,3,3033,[318 515 427 185 313],655,5,12358,4.073170731707317,40.0,0.0
33034,3,3034,[ 71 121 181 125   1],450,3,12361,4.072817133443163,0.0,0.0
33035,3,3035,[318 515 427 185 313],655,5,12366,4.073122529644269,40.0,0.0
33036,3,3036,[ 88 183 301 204 182],796,4,12370,4.073098452420152,0.0,0.0
33037,3,3037,[ 28 333 301 405 234],796,2,12372,4.072416063199474,0.0,0.0
33038,3,3038,[318 515 427 185 313],655,5,12377,4.072721289897993,40.0,0.0
33039,3,3039,[118 174 222  79 204],450,3,12380,4.072368421052632,0.0,0.0
33040,3,3040,[318 515 427 185 313],655,5,12385,4.072673462676751,40.0,0.0
33041,3,3041,[318 515 427 185 313],655,5,12390,4.072978303747535,40.0,0.0
33042,3,3042,[289 204 191 172 300],655,2,12392,4.072297075254683,0.0,0.0
33043,3,3043,[269 546  95 405 235],344,2,12394,4.07161629434954,0.0,0.0
33044,3,3044,[546 183 245  95 318],796,4,12398,4.071592775041051,20.0,0.0
33045,3,3045,[194 204 603 234 238],18,1,12399,4.070584372948129,20.0,0.0
33046,3,3046,[273 183  15 118 385],796,4,12403,4.070561207745324,0.0,0.0
33047,3,3047,[196 405 245 183 111],593,3,12406,4.070209973753281,0.0,0.0
33048,3,3048,[210 200  50 194  22],18,3,12409,4.069858970154149,0.0,20.0
33049,3,3049,[318 515 427 185 313],655,5,12414,4.07016393442623,40.0,0.0
33050,3,3050,[237 151 318 100 215],796,4,12418,4.070140937397575,20.0,20.0
33051,3,3051,[318 515 427 185 313],655,5,12423,4.070445609436435,40.0,0.0
33052,3,3052,[318 515 427 185 313],655,5,12428,4.070750081886668,40.0,0.0
33053,3,3053,[ 79 197   4 238 210],716,4,12432,4.070726915520629,0.0,0.0
33054,3,3054,[318 515 427 185 313],655,5,12437,4.071031096563011,40.0,0.0
33055,3,3055,[282 269 328  64 144],655,1,12438,4.070026178010472,20.0,0.0
33056,3,3056,[546 748 302 187 357],450,5,12443,4.070330389270526,0.0,0.0
33057,3,3057,[318 515 427 185 313],655,5,12448,4.070634401569653,40.0,0.0
33058,3,3058,[173 118 435 195 235],756,0,12448,4.069303694017653,0.0,0.0
33059,3,3059,[318 515 427 185 313],655,5,12453,4.069607843137255,40.0,0.0
33060,3,3060,[318 515 427 185 313],655,5,12458,4.069911793531525,40.0,0.0
33061,3,3061,[318 515 427 185 313],655,5,12463,4.0702155453951665,40.0,0.0
33062,3,3062,[ 97 302 181  28   1],151,4,12467,4.070192621612798,0.0,0.0
33063,3,3063,[238 181 294 282  64],457,4,12471,4.070169712793733,20.0,0.0
33064,3,3064,[318 515 427 185 313],655,5,12476,4.07047308319739,40.0,0.0
33065,3,3065,[318 515 427 185 313],655,5,12481,4.070776255707763,40.0,0.0
33066,3,3066,[318 515 427 185 313],655,5,12486,4.071079230518422,40.0,0.0
33067,3,3067,[318 515 427 185 313],655,5,12491,4.0713820078226854,40.0,0.0
33068,3,3068,[318 515 427 185 313],655,5,12496,4.07168458781362,40.0,0.0
33069,3,3069,[318 515 427 185 313],655,5,12501,4.071986970684039,40.0,0.0
33070,3,3070,[216  88 234 125 313],503,4,12505,4.071963529794855,0.0,0.0
33071,3,3071,[318 515 427 185 313],655,5,12510,4.072265625,40.0,0.0
33072,3,3072,[318 515 427 185 313],655,5,12515,4.07256752359258,40.0,0.0
33073,3,3073,[176 195  88 471 237],786,5,12520,4.072869225764476,0.0,0.0
33074,3,3074,[318 515 427 185 313],655,5,12525,4.073170731707317,40.0,0.0
33075,3,3075,[ 64 333  96 211 174],655,1,12526,4.072171651495449,20.0,0.0
33076,3,3076,[603 197   9 515 204],18,3,12529,4.071823204419889,20.0,0.0
33077,3,3077,[179 245 655 173 200],450,4,12533,4.071799870045484,0.0,0.0
33078,3,3078,[182 135 181 118 125],655,2,12535,4.071126989282234,0.0,0.0
33079,3,3079,[318 515 427 185 313],655,5,12540,4.071428571428571,40.0,0.0
33080,3,3080,[ 97 215   9 194 197],151,4,12544,4.071405387861084,0.0,0.0
33081,3,3081,[318 515 427 185 313],655,5,12549,4.071706683971447,40.0,0.0
33082,3,3082,[ 98 127 302  79 172],389,5,12554,4.072007784625365,0.0,20.0
33083,3,3083,[318 515 427 185 313],655,5,12559,4.07230869001297,40.0,0.0
33084,3,3084,[742  50 183 508 357],693,1,12560,4.071312803889789,0.0,20.0
33085,3,3085,[215 100 496 117 568],577,4,12564,4.071289695398574,20.0,20.0
33086,3,3086,[187 210 215 151  22],796,4,12568,4.071266601878847,0.0,0.0
33087,3,3087,[318 515 427 185 313],655,5,12573,4.071567357512953,40.0,0.0
33088,3,3088,[318 515 427 185 313],655,5,12578,4.0718679184202005,40.0,0.0
33089,3,3089,[ 12  56 269  28 273],655,1,12579,4.070873786407767,0.0,0.0
33090,3,3090,[318 515 427 185 313],655,5,12584,4.0711743772241995,40.0,0.0
33091,3,3091,[318 515 427 185 313],655,5,12589,4.071474773609315,40.0,0.0
33092,3,3092,[318 515 427 185 313],655,5,12594,4.071774975751698,40.0,0.0
33093,3,3093,[200 132 546 179 197],457,4,12598,4.07175177763413,0.0,0.0
33094,3,3094,[318 515 427 185 313],655,5,12603,4.07205169628433,40.0,0.0
33095,3,3095,[301 195 121 194  50],535,5,12608,4.072351421188631,0.0,20.0
33096,3,3096,[318 515 427 185 313],655,5,12613,4.072650952534711,40.0,0.0
33097,3,3097,[318 235 276  11  96],280,5,12618,4.072950290510007,20.0,0.0
33098,3,3098,[403 210 185 182 121],450,3,12621,4.0726040658276865,0.0,0.0
33099,3,3099,[  8 111 135 196 588],457,4,12625,4.07258064516129,0.0,0.0
33100,3,3100,[194 435 175 135 475],269,4,12629,4.072557239600129,0.0,0.0
33101,3,3101,[  4 196  12 655 405],796,4,12633,4.072533849129594,0.0,0.0
33102,3,3102,[318 515 427 185 313],655,5,12638,4.072832742507251,40.0,0.0
33103,3,3103,[228 471  12 197 289],693,1,12639,4.071842783505154,0.0,0.0
33104,3,3104,[423 132 180 215  56],796,4,12643,4.071819645732689,0.0,0.0
33105,3,3105,[191 183 175 204 357],23,1,12644,4.070830650354154,0.0,0.0
33106,3,3106,[183 180 161  96  11],269,0,12644,4.069520437721274,0.0,0.0
33107,3,3107,[357 191 588 202 195],716,4,12648,4.06949806949807,0.0,0.0
33108,3,3108,[282 144 228 265  96],450,5,12653,4.069797362495979,0.0,0.0
33109,3,3109,[168 211 216 175  56],338,3,12656,4.069453376205788,0.0,0.0
33110,3,3110,[318 515 427 185 313],655,5,12661,4.069752491160399,40.0,0.0
33111,3,3111,[111 197 222 318 168],457,4,12665,4.0697300771208225,20.0,0.0
33112,3,3112,[ 82 172 210 211 181],389,4,12669,4.069707677481529,0.0,0.0
33113,3,3113,[318 515 427 185 313],655,5,12674,4.0700064226075785,40.0,0.0
33114,3,3114,[318 515 427 185 313],655,5,12679,4.070304975922953,40.0,0.0
33115,3,3115,[318 515 427 185 313],655,5,12684,4.070603337612323,40.0,0.0
33116,3,3116,[588 125 318 385  96],457,5,12689,4.070901507860122,20.0,0.0
33117,3,3117,[210 427 471 176 603],716,3,12692,4.070558050032072,40.0,0.0
33118,3,3118,[318 515 427 185 313],655,5,12697,4.070856043603719,40.0,0.0
33119,3,3119,[318 515 427 185 313],655,5,12702,4.071153846153846,40.0,0.0
33120,3,3120,[ 22 301 210 288 183],344,4,12706,4.071131047741108,0.0,0.0
33121,3,3121,[318 515 427 185 313],655,5,12711,4.071428571428571,40.0,0.0
33122,3,3122,[423 172  97 282 211],693,2,12713,4.070765289785463,0.0,0.0
33123,3,3123,[271 172  88   9  70],655,1,12714,4.069782330345711,0.0,0.0
33124,3,3124,[318 515 427 185 313],655,5,12719,4.07008,40.0,0.0
33125,3,3125,[ 25 121 125   4 271],655,0,12719,4.068777991042866,0.0,0.0
33126,3,3126,[173 200 405 172   8],796,5,12724,4.069075791493444,0.0,0.0
33127,3,3127,[174  15 173   4 471],786,4,12728,4.069053708439898,0.0,0.0
33128,3,3128,[196 127 186 357 546],796,4,12732,4.069031639501438,0.0,20.0
33129,3,3129,[318 515 427 185 313],655,5,12737,4.069329073482428,40.0,0.0
33130,3,3130,[  7 508  56 186  69],269,2,12739,4.068668157138294,0.0,0.0
33131,3,3131,[318 515 427 185 313],655,5,12744,4.068965517241379,40.0,0.0
33132,3,3132,[234 186 742 174 175],457,5,12749,4.069262687519949,0.0,0.0
33133,3,3133,[318 515 427 185 313],655,5,12754,4.069559668155711,40.0,0.0
33134,3,3134,[318 515 427 185 313],655,5,12759,4.069856459330143,40.0,0.0
33135,3,3135,[ 22 313 265 183 210],796,4,12763,4.0698341836734695,0.0,0.0
33136,3,3136,[181 603 403 588 568],756,3,12766,4.0694931463181385,20.0,0.0
33137,3,3137,[318 515 427 185 313],655,5,12771,4.069789674952199,40.0,0.0
33138,3,3138,[318 515 427 185 313],655,5,12776,4.070086014654349,40.0,0.0
33139,3,3139,[ 82 357 603 143  95],450,3,12779,4.069745222929936,20.0,0.0
33140,3,3140,[318 515 427 185 313],655,5,12784,4.070041388092964,40.0,0.0
33141,3,3141,[135 288  69 161  96],450,3,12787,4.069700827498409,0.0,0.0
33142,3,3142,[318 515 427 185 313],655,5,12792,4.06999681832644,40.0,0.0
33143,3,3143,[313 161 216  88 228],450,5,12797,4.07029262086514,0.0,0.0
33144,3,3144,[153 194  88 286  11],450,5,12802,4.070588235294117,0.0,20.0
33145,3,3145,[288   1 222 568 597],457,4,12806,4.070565797838525,0.0,0.0
33146,3,3146,[196 742 302 508 153],655,1,12807,4.069590085795996,0.0,0.0
33147,3,3147,[496 175  50 132 121],151,5,12812,4.0698856416772555,20.0,20.0
33148,3,3148,[ 82 181 427  96 125],655,1,12813,4.068910765322324,20.0,0.0
33149,3,3149,[318 515 427 185 313],655,5,12818,4.0692063492063495,40.0,0.0
33150,3,3150,[546  25 273  79 265],450,3,12821,4.068867026340844,0.0,0.0
33151,3,3151,[318 515 427 185 313],655,5,12826,4.069162436548224,40.0,0.0
33152,3,3152,[568  89   7 234  12],352,4,12830,4.069140501110054,0.0,0.0
33153,3,3153,[237 357 153 655 100],796,3,12833,4.068801521876981,0.0,20.0
33154,3,3154,[318 515 427 185 313],655,5,12838,4.0690966719492865,40.0,0.0
33155,3,3155,[121 216  28 258  98],450,4,12842,4.069074778200253,0.0,0.0
33156,3,3156,[318 515 427 185 313],655,5,12847,4.0693696547355085,40.0,0.0
33157,3,3157,[302  82 748 125 175],151,2,12849,4.068714376187461,0.0,0.0
33158,3,3158,[179 183 238 294 211],655,2,12851,4.068059512503957,0.0,0.0
33159,3,3159,[238 168 357 322 318],504,4,12855,4.068037974683544,20.0,0.0
33160,3,3160,[318 515 427 185 313],655,5,12860,4.068332806074027,40.0,0.0
33161,3,3161,[568 483  11 496  88],450,4,12864,4.06831119544592,20.0,0.0
33162,3,3162,[  1 197 282 265 234],457,5,12869,4.068605754030983,0.0,0.0
33163,3,3163,[187  12 180   1 168],796,3,12872,4.06826801517067,0.0,0.0
33164,3,3164,[245 117 313 125  69],344,0,12872,4.066982622432859,0.0,0.0
33165,3,3165,[ 71 483  88 273 275],236,1,12873,4.066013897662666,0.0,20.0
33166,3,3166,[ 56 172 235 100  22],450,4,12877,4.065993053362804,0.0,20.0
33167,3,3167,[318 515 427 185 313],655,5,12882,4.066287878787879,40.0,0.0
33168,3,3168,[318 515 427 185 313],655,5,12887,4.066582518144525,40.0,0.0
33169,3,3169,[ 15 121 185 216 423],65,5,12892,4.066876971608833,0.0,0.0
33170,3,3170,[180  96 655 276  70],504,3,12895,4.066540523494166,0.0,0.0
33171,3,3171,[258 216  82 333  89],796,4,12899,4.066519546027743,0.0,0.0
33172,3,3172,[  1  82 603   7 121],151,4,12903,4.066498581783801,20.0,0.0
33173,3,3173,[172  79  25  56 196],591,4,12907,4.0664776307498425,0.0,0.0
33174,3,3174,[ 50  64 153  28 655],716,5,12912,4.066771653543307,20.0,20.0
33175,3,3175,[318 515 427 185 313],655,5,12917,4.067065491183879,40.0,0.0
33176,3,3176,[318 515 427 185 313],655,5,12922,4.067359143846396,40.0,0.0
33177,3,3177,[196 121 135   1 175],655,1,12923,4.066393958464443,0.0,0.0
33178,3,3178,[357 174 153  70 301],593,5,12928,4.066687637621894,0.0,0.0
33179,3,3179,[568 301  98 515 161],655,2,12930,4.066037735849057,0.0,0.0
33180,3,3180,[318 515 427 185 313],655,5,12935,4.066331342345174,40.0,0.0
33181,3,3181,[318 515 427 185 313],655,5,12940,4.066624764299183,40.0,0.0
33182,3,3182,[508 191 196 181 211],401,3,12943,4.066289663839146,0.0,0.0
33183,3,3183,[318 515 427 185 313],655,5,12948,4.066582914572864,40.0,0.0
33184,3,3184,[173  71 200 161  22],577,4,12952,4.066562009419152,0.0,0.0
33185,3,3185,[197 427 174 172 238],796,3,12955,4.066227244193346,20.0,0.0
33186,3,3186,[318 515 427 185 313],655,5,12960,4.0665202384687795,40.0,0.0
33187,3,3187,[197 546 275 210 202],457,4,12964,4.066499372647428,0.0,20.0
33188,3,3188,[181  82 257 144   1],23,2,12966,4.0658513640639695,0.0,0.0
33189,3,3189,[655  25 202 181 237],401,2,12968,4.065203761755486,0.0,0.0
33190,3,3190,[318 515 427 185 313],655,5,12973,4.065496709495456,40.0,0.0
33191,3,3191,[  9 265  82 117 235],457,4,12977,4.065476190476191,0.0,0.0
33192,3,3192,[  9 405 333 161 210],796,3,12980,4.065142499217037,0.0,0.0
33193,3,3193,[318 515 427 185 313],655,5,12985,4.065435190983093,40.0,0.0
33194,3,3194,[318 515 427 185 313],655,5,12990,4.065727699530516,40.0,0.0
33195,3,3195,[  7 143 268 125 302],655,2,12992,4.065081351689612,0.0,0.0
33196,3,3196,[318 515 427 185 313],655,5,12997,4.06537378792618,40.0,0.0
33197,3,3197,[603   9 357 127 276],269,5,13002,4.065666041275797,20.0,20.0
33198,3,3198,[318 515 427 185 313],655,5,13007,4.065958111909972,40.0,0.0
33199,3,3199,[273 186 100 300 403],450,3,13010,4.065625,0.0,20.0
33200,3,3200,[318 515 427 185 313],655,5,13015,4.065916900968447,40.0,0.0
33201,3,3201,[100  22 276 568   7],457,5,13020,4.066208619612742,0.0,20.0
33202,3,3202,[210 132 191 143 215],693,3,13023,4.065875741492351,0.0,0.0
33203,3,3203,[ 97 289  89 546  69],786,5,13028,4.066167290886392,0.0,0.0
33204,3,3204,[ 56 121 144  28 132],457,5,13033,4.066458658346334,0.0,0.0
33205,3,3205,[268 568  12 196  98],655,1,13034,4.065502183406114,0.0,0.0
33206,3,3206,[318 515 427 185 313],655,5,13039,4.065793576551294,40.0,0.0
33207,3,3207,[318 515 427 185 313],655,5,13044,4.066084788029925,40.0,0.0
33208,3,3208,[318 515 427 185 313],655,5,13049,4.066375818011842,40.0,0.0
33209,3,3209,[ 69 423 471   4   7],577,3,13052,4.066043613707165,0.0,0.0
33210,3,3210,[318 515 427 185 313],655,5,13057,4.066334475241358,40.0,0.0
33211,3,3211,[182 186 210 333 282],796,3,13060,4.066002490660025,0.0,0.0
33212,3,3212,[117 173  50 222 427],796,5,13065,4.0662931839402425,20.0,20.0
33213,3,3213,[318 515 427 185 313],655,5,13070,4.066583696328562,40.0,0.0
33214,3,3214,[435  28 181  95 427],389,4,13074,4.0665629860031105,20.0,0.0
33215,3,3215,[ 11 182  97 181  64],450,5,13079,4.066853233830845,20.0,0.0
33216,3,3216,[318 515 427 185 313],655,5,13084,4.06714330121231,40.0,0.0
33217,3,3217,[318 515 427 185 313],655,5,13089,4.067433188315724,40.0,0.0
33218,3,3218,[ 25 211 234  71 196],389,3,13092,4.067101584342963,0.0,0.0
33219,3,3219,[121   1 100  56 258],535,3,13095,4.066770186335404,0.0,20.0
33220,3,3220,[179 475 435  79 182],655,3,13098,4.066438994101211,0.0,0.0
33221,3,3221,[ 69 191  79   1 471],72,5,13103,4.066728739913097,0.0,0.0
33222,3,3222,[  9 135 423 144 238],457,5,13108,4.0670183059261555,0.0,0.0
33223,3,3223,[174 172 496 196 182],389,4,13112,4.066997518610422,20.0,0.0
33224,3,3224,[318 515 427 185 313],655,5,13117,4.0672868217054265,40.0,0.0
33225,3,3225,[318 515 427 185 313],655,5,13122,4.067575945443274,40.0,0.0
33226,3,3226,[237 173 655 183 186],457,5,13127,4.0678648899907035,0.0,0.0
33227,3,3227,[318 515 427 185 313],655,5,13132,4.068153655514251,40.0,0.0
33228,3,3228,[186 301  64 328 118],796,3,13135,4.067822855373181,20.0,0.0
33229,3,3229,[210   7 121 655 302],269,1,13136,4.06687306501548,0.0,0.0
33230,3,3230,[318 515 427 185 313],655,5,13141,4.067161869390282,40.0,0.0
33231,3,3231,[318 515 427 185 313],655,5,13146,4.0674504950495045,40.0,0.0
33232,3,3232,[318 515 427 185 313],655,5,13151,4.067738942158986,40.0,0.0
33233,3,3233,[ 64 174 153  50 508],655,2,13153,4.067099567099567,20.0,20.0
33234,3,3234,[182 508 195 204  70],655,1,13154,4.066151468315302,0.0,0.0
33235,3,3235,[323 265   4 273 173],796,3,13157,4.065822002472188,0.0,0.0
33236,3,3236,[318 515 427 185 313],655,5,13162,4.066110596231078,40.0,0.0
33237,3,3237,[318 515 427 185 313],655,5,13167,4.06639901173564,40.0,0.0
33238,3,3238,[318 515 427 185 313],655,5,13172,4.066687249150973,40.0,0.0
33239,3,3239,[318 515 427 185 313],655,5,13177,4.066975308641975,40.0,0.0
33240,3,3240,[318 515 427 185 313],655,5,13182,4.067263190373342,40.0,0.0
33241,3,3241,[318 515 427 185 313],655,5,13187,4.067550894509562,40.0,0.0
33242,3,3242,[318 515 427 185 313],655,5,13192,4.067838421214924,40.0,0.0
33243,3,3243,[ 79 168 282 403 286],796,4,13196,4.067817509247842,0.0,20.0
33244,3,3244,[132 237 204  25  50],504,2,13198,4.0671802773497685,0.0,20.0
33245,3,3245,[603 597 151  28 435],450,5,13203,4.067467652495379,20.0,0.0
33246,3,3246,[318 515 427 185 313],655,5,13208,4.067754850631352,40.0,0.0
33247,3,3247,[172 301 121 151  64],535,4,13212,4.067733990147783,20.0,0.0
33248,3,3248,[121  25 245   7 405],450,3,13215,4.067405355493998,0.0,0.0
33249,3,3249,[318 515 427 185 313],655,5,13220,4.067692307692307,40.0,0.0
33250,3,3250,[318 515 427 185 313],655,5,13225,4.067979083358966,40.0,0.0
33251,3,3251,[318 515 427 185 313],655,5,13230,4.068265682656826,40.0,0.0
33252,3,3252,[121 275 196 181 168],457,5,13235,4.06855210574854,0.0,20.0
33253,3,3253,[318 515 427 185 313],655,5,13240,4.068838352796558,40.0,0.0
33254,3,3254,[318 515 427 185 313],655,5,13245,4.0691244239631335,40.0,0.0
33255,3,3255,[187 135 151 172  71],535,2,13247,4.068488943488943,0.0,0.0
33256,3,3256,[228  15 194  28 269],450,4,13251,4.068467915259442,0.0,0.0
33257,3,3257,[  8 515 269 294 568],655,1,13252,4.067526089625537,0.0,0.0
33258,3,3258,[234 161 228 121 216],256,4,13256,4.06750536974532,0.0,0.0
33259,3,3259,[318 515 427 185 313],655,5,13261,4.067791411042945,40.0,0.0
33260,3,3260,[318 515 427 185 313],655,5,13266,4.068077276908924,40.0,0.0
33261,3,3261,[318 515 427 185 313],655,5,13271,4.068362967504599,40.0,0.0
33262,3,3262,[568 655   9 132 174],655,0,13271,4.067116150781489,0.0,0.0
33263,3,3263,[318 515 427 185 313],655,5,13276,4.067401960784314,40.0,0.0
33264,3,3264,[318 515 427 185 313],655,5,13281,4.067687595712098,40.0,0.0
33265,3,3265,[546 174  50 216 496],344,4,13285,4.0676668707899575,20.0,20.0
33266,3,3266,[405 748 153 210  71],450,3,13288,4.0673400673400675,0.0,0.0
33267,3,3267,[197 176 151 168  88],504,3,13291,4.067013463892289,0.0,0.0
33268,3,3268,[ 25 222 172  82 197],450,2,13293,4.0663811563169165,0.0,0.0
33269,3,3269,[ 22 265 471  96 125],577,4,13297,4.066360856269113,0.0,0.0
33270,3,3270,[475 333 153 301 245],629,3,13300,4.0660348517273,0.0,0.0
33271,3,3271,[271  11 238 282 275],655,1,13301,4.065097799511002,0.0,20.0
33272,3,3272,[568  82 286 237 204],330,5,13306,4.065383440268866,0.0,20.0
33273,3,3273,[238 174  82 282 179],655,1,13307,4.0644471594379965,0.0,0.0
33274,3,3274,[ 15 195 403 546  89],796,5,13312,4.064732824427481,0.0,0.0
33275,3,3275,[245 357  56 405 144],593,3,13315,4.064407814407814,0.0,0.0
33276,3,3276,[181 403 194 496 423],807,5,13320,4.064693317058285,20.0,0.0
33277,3,3277,[318 515 427 185 313],655,5,13325,4.064978645515558,40.0,0.0
33278,3,3278,[318 515 427 185 313],655,5,13330,4.0652637999390056,40.0,0.0
33279,3,3279,[  1  98 234  88 588],786,4,13334,4.065243902439025,0.0,0.0
33280,3,3280,[318 515 427 185 313],655,5,13339,4.065528802194453,40.0,0.0
33281,3,3281,[174 265 215  64 300],716,5,13344,4.06581352833638,20.0,0.0
33282,3,3282,[271 300 294 196 187],655,1,13345,4.06487968321657,0.0,0.0
33283,3,3283,[318 515 427 185 313],655,5,13350,4.065164433617539,40.0,0.0
33284,3,3284,[427 194 182 100 268],535,3,13353,4.0648401826484015,20.0,20.0
33285,3,3285,[ 82  89 187  15 742],655,2,13355,4.064211807668898,0.0,0.0
33286,3,3286,[318 515 427 185 313],655,5,13360,4.064496501369029,40.0,0.0
33287,3,3287,[655 125  69 135   9],457,5,13365,4.064781021897811,0.0,0.0
33288,3,3288,[318 515 427 185 313],655,5,13370,4.065065369413196,40.0,0.0
33289,3,3289,[318 515 427 185 313],655,5,13375,4.065349544072948,40.0,0.0
33290,3,3290,[318 515 427 185 313],655,5,13380,4.06563354603464,40.0,0.0
33291,3,3291,[234   8 183 216  22],655,2,13382,4.065006075334144,0.0,0.0
33292,3,3292,[265 202 174  97  95],450,4,13386,4.064986334649256,0.0,0.0
33293,3,3293,[318 515 427 185 313],655,5,13391,4.065270188221008,40.0,0.0
33294,3,3294,[318 515 427 185 313],655,5,13396,4.065553869499241,40.0,0.0
33295,3,3295,[318 515 427 185 313],655,5,13401,4.065837378640777,40.0,0.0
33296,3,3296,[427 275 471 238  71],535,5,13406,4.066120715802245,20.0,20.0
33297,3,3297,[603 183 195 186 215],655,2,13408,4.065494238932686,20.0,0.0
33298,3,3298,[318 515 427 185 313],655,5,13413,4.065777508335859,40.0,0.0
33299,3,3299,[301 234 211  25  12],655,0,13413,4.0645454545454545,0.0,0.0
33300,3,3300,[234 117 483 357  11],716,5,13418,4.064828839745531,0.0,0.0
33301,3,3301,[ 95 185 204 196 748],450,4,13422,4.06480920654149,0.0,0.0
33302,3,3302,[318 515 427 185 313],655,5,13427,4.0650923402967,40.0,0.0
33303,3,3303,[ 22 742   4   1 185],450,4,13431,4.065072639225182,0.0,0.0
33304,3,3304,[318 515 427 185 313],655,5,13436,4.06535552193646,40.0,0.0
33305,3,3305,[ 22 301  79 172   8],796,4,13440,4.0653357531760435,0.0,0.0
33306,3,3306,[222 202 257 235 196],716,4,13444,4.065315996371334,0.0,0.0
33307,3,3307,[318 515 427 185 313],655,5,13449,4.065598548972188,40.0,0.0
33308,3,3308,[269 588  25  56 211],18,4,13453,4.065578724690239,0.0,0.0
33309,3,3309,[222  96 118  50 234],655,1,13454,4.0646525679758305,0.0,20.0
33310,3,3310,[ 82 216 132 588  22],280,4,13458,4.064633041377228,0.0,0.0
33311,3,3311,[ 88  12 748 273 182],450,4,13462,4.0646135265700485,0.0,0.0
33312,3,3312,[204 121  89 385 125],457,5,13467,4.064895864775128,0.0,0.0
33313,3,3313,[318 515 427 185 313],655,5,13472,4.065178032589016,40.0,0.0
33314,3,3314,[318 515 427 185 313],655,5,13477,4.065460030165912,40.0,0.0
33315,3,3315,[318 515 427 185 313],655,5,13482,4.065741857659831,40.0,0.0
33316,3,3316,[204 161 194 196  69],504,3,13485,4.065420560747664,0.0,0.0
33317,3,3317,[302  56 655 483 174],450,4,13489,4.065400843881856,0.0,0.0
33318,3,3318,[282  69 181 176 153],450,5,13494,4.065682434468213,0.0,0.0
33319,3,3319,[121 179 282 161 100],457,5,13499,4.065963855421686,0.0,20.0
33320,3,3320,[318 515 427 185 313],655,5,13504,4.066245106895513,40.0,0.0
33321,3,3321,[318 515 427 185 313],655,5,13509,4.0665261890427455,40.0,0.0
33322,3,3322,[318 515 427 185 313],655,5,13514,4.06680710201625,40.0,0.0
33323,3,3323,[276  89 275 191 179],786,4,13518,4.066787003610108,0.0,20.0
33324,3,3324,[294 186 597 215  50],796,3,13521,4.066466165413534,0.0,20.0
33325,3,3325,[234 265  97 132  89],151,5,13526,4.0667468430547205,0.0,0.0
33326,3,3326,[222 273 187 258 294],655,2,13528,4.066125638713555,0.0,0.0
33327,3,3327,[318 515 427 185 313],655,5,13533,4.06640625,40.0,0.0
33328,3,3328,[313 427 121  96  22],655,2,13535,4.0657855211775304,20.0,0.0
33329,3,3329,[202 100   1 385 117],344,2,13537,4.0651651651651655,0.0,20.0
33330,3,3330,[318 515 427 185 313],655,5,13542,4.065445812068448,40.0,0.0
33331,3,3331,[318 515 427 185 313],655,5,13547,4.065726290516206,40.0,0.0
33332,3,3332,[143  69 202 118 194],504,2,13549,4.0651065106510655,0.0,0.0
33333,3,3333,[195 237   9 471   8],280,2,13551,4.064487102579484,0.0,0.0
33334,3,3334,[234 127 265  79 405],450,4,13555,4.064467766116942,0.0,20.0
33335,3,3335,[496 269 191 483  96],796,4,13559,4.064448441247002,20.0,0.0
33336,3,3336,[318 515 427 185 313],655,5,13564,4.064728798321846,40.0,0.0
33337,3,3337,[222 194 168 143 187],716,4,13568,4.0647094068304375,0.0,0.0
33338,3,3338,[318 515 427 185 313],655,5,13573,4.064989517819707,40.0,0.0
33339,3,3339,[318 515 427 185 313],655,5,13578,4.065269461077844,40.0,0.0
33340,3,3340,[182 515 175 588 496],18,5,13583,4.065549236755462,20.0,0.0
33341,3,3341,[186 191  28 385 257],655,1,13584,4.064631956912029,0.0,0.0
33342,3,3342,[276 143  88 118  64],655,3,13587,4.064313490876458,20.0,0.0
33343,3,3343,[271 204 135  69 496],807,4,13591,4.064294258373206,20.0,0.0
33344,3,3344,[318 515 427 185 313],655,5,13596,4.0645739910313905,40.0,0.0
33345,3,3345,[742 423 174  11 322],450,5,13601,4.064853556485356,0.0,0.0
33346,3,3346,[117 385  79   1 742],256,5,13606,4.065132954884971,0.0,0.0
33347,3,3347,[318 515 427 185 313],655,5,13611,4.065412186379929,40.0,0.0
33348,3,3348,[258 597 275 215 235],450,4,13615,4.065392654523738,0.0,20.0
33349,3,3349,[176 196 111 301 245],450,5,13620,4.065671641791044,0.0,0.0
33350,3,3350,[318 515 427 185 313],655,5,13625,4.065950462548493,40.0,0.0
33351,3,3351,[204 603 100 405  28],796,3,13628,4.06563245823389,20.0,20.0
33352,3,3352,[318 515 427 185 313],655,5,13633,4.065911124366239,40.0,0.0
33353,3,3353,[271 118 211   1 176],796,3,13636,4.065593321407275,0.0,0.0
33354,3,3354,[318 515 427 185 313],655,5,13641,4.065871833084948,40.0,0.0
33355,3,3355,[235 161 118 655 265],450,3,13644,4.065554231227652,0.0,0.0
33356,3,3356,[237 257 100 597  15],796,4,13648,4.065534703604409,0.0,20.0
33357,3,3357,[204   4 237  15 202],796,5,13653,4.065812983919,0.0,0.0
33358,3,3358,[ 97 403 471 127 435],450,5,13658,4.066091098541232,0.0,20.0
33359,3,3359,[127 300  69 333 228],796,5,13663,4.066369047619047,0.0,20.0
33360,3,3360,[483 100 234 174 385],23,4,13667,4.066349300803332,0.0,20.0
33361,3,3361,[318 515 427 185 313],655,5,13672,4.066627007733492,40.0,0.0
33362,3,3362,[318 515 427 185 313],655,5,13677,4.066904549509367,40.0,0.0
33363,3,3363,[318 515 427 185 313],655,5,13682,4.0671819262782405,40.0,0.0
33364,3,3364,[357  25   9 125 603],11,4,13686,4.067161961367013,20.0,0.0
33365,3,3365,[318 515 427 185 313],655,5,13691,4.067439096850862,40.0,0.0
33366,3,3366,[ 70 151 276 286  82],174,3,13694,4.067122067122067,0.0,20.0
33367,3,3367,[546 427 204  56 210],577,2,13696,4.066508313539193,20.0,0.0
33368,3,3368,[318 515 427 185 313],655,5,13701,4.066785396260018,40.0,0.0
33369,3,3369,[318 515 427 185 313],655,5,13706,4.06706231454006,40.0,0.0
33370,3,3370,[211 742 322  69  97],450,5,13711,4.06733906852566,0.0,0.0
33371,3,3371,[211 483 403  98 111],655,2,13713,4.066725978647687,0.0,0.0
33372,3,3372,[318 515 427 185 313],655,5,13718,4.06700266824785,40.0,0.0
33373,3,3373,[318 515 427 185 313],655,5,13723,4.06727919383521,40.0,0.0
33374,3,3374,[318 515 427 185 313],655,5,13728,4.067555555555556,40.0,0.0
33375,3,3375,[172   8 318  98 111],593,4,13732,4.067535545023697,20.0,0.0
33376,3,3376,[117  11  88  28 288],457,5,13737,4.067811667160202,0.0,0.0
33377,3,3377,[182 435 228 748 176],450,5,13742,4.0680876258140914,0.0,0.0
33378,3,3378,[318 515 427 185 313],655,5,13747,4.068363421130512,40.0,0.0
33379,3,3379,[153   7   9 427 357],535,4,13751,4.068343195266272,20.0,0.0
33380,3,3380,[318 515 427 185 313],655,5,13756,4.0686187518485655,40.0,0.0
33381,3,3381,[318 515 427 185 313],655,5,13761,4.06889414547605,40.0,0.0
33382,3,3382,[  8 423 151  96 183],796,5,13766,4.069169376293231,0.0,0.0
33383,3,3383,[318 515 427 185 313],655,5,13771,4.069444444444445,40.0,0.0
33384,3,3384,[318 515 427 185 313],655,5,13776,4.069719350073855,40.0,0.0
33385,3,3385,[322 216 546  88 245],280,3,13779,4.069403425871235,0.0,0.0
33386,3,3386,[318 515 427 185 313],655,5,13784,4.06967818128137,40.0,0.0
33387,3,3387,[515 289 117 111 196],655,1,13785,4.068772136953955,0.0,0.0
33388,3,3388,[132 100   9 196 144],796,3,13788,4.068456771909117,0.0,20.0
33389,3,3389,[318 515 427 185 313],655,5,13793,4.068731563421829,40.0,0.0
33390,3,3390,[318 515 427 185 313],655,5,13798,4.069006192863462,40.0,0.0
33391,3,3391,[318 515 427 185 313],655,5,13803,4.069280660377358,40.0,0.0
33392,3,3392,[318 515 427 185 313],655,5,13808,4.06955496610669,40.0,0.0
33393,3,3393,[318 515 427 185 313],655,5,13813,4.069829110194461,40.0,0.0
33394,3,3394,[318 515 427 185 313],655,5,13818,4.070103092783505,40.0,0.0
33395,3,3395,[318 515 427 185 313],655,5,13823,4.07037691401649,40.0,0.0
33396,3,3396,[318 515 427 185 313],655,5,13828,4.0706505740359145,40.0,0.0
33397,3,3397,[318 515 427 185 313],655,5,13833,4.070924072984108,40.0,0.0
33398,3,3398,[483 176 121 125  69],450,3,13836,4.070609002647838,0.0,0.0
33399,3,3399,[318 515 427 185 313],655,5,13841,4.070882352941177,40.0,0.0
33400,3,3400,[318 515 427 185 313],655,5,13846,4.071155542487504,40.0,0.0
33401,3,3401,[318 515 427 185 313],655,5,13851,4.071428571428571,40.0,0.0
33402,3,3402,[143 546 161 427 144],807,5,13856,4.071701439905965,20.0,0.0
33403,3,3403,[385  64 173 179  28],457,5,13861,4.071974148061105,20.0,0.0
33404,3,3404,[ 15  98 357  95 275],796,5,13866,4.072246696035243,0.0,20.0
33405,3,3405,[118  96 483 211 403],450,3,13869,4.0719318849089845,0.0,0.0
33406,3,3406,[268  88  70  89 313],344,1,13870,4.07103023187555,0.0,0.0
33407,3,3407,[318 515 427 185 313],655,5,13875,4.071302816901408,40.0,0.0
33408,3,3408,[191  98 234   7 471],655,2,13877,4.070695218539161,0.0,0.0
33409,3,3409,[318 515 427 185 313],655,5,13882,4.070967741935484,40.0,0.0
33410,3,3410,[273 269  25  98  70],450,3,13885,4.070653767223688,0.0,0.0
33411,3,3411,[318 515 427 185 313],655,5,13890,4.070926143024619,40.0,0.0
33412,3,3412,[318 515 427 185 313],655,5,13895,4.071198359214767,40.0,0.0
33413,3,3413,[196 313  69 117 200],236,2,13897,4.070591681312243,0.0,0.0
33414,3,3414,[318 515 427 185 313],655,5,13902,4.07086383601757,40.0,0.0
33415,3,3415,[318 515 427 185 313],655,5,13907,4.071135831381733,40.0,0.0
33416,3,3416,[318 515 427 185 313],655,5,13912,4.07140766754463,40.0,0.0
33417,3,3417,[318 515 427 185 313],655,5,13917,4.071679344645992,40.0,0.0
33418,3,3418,[289 117  12 269 286],655,0,13917,4.070488446914302,0.0,20.0
33419,3,3419,[ 11  88 748 318 185],11,2,13919,4.0698830409356725,20.0,0.0
33420,3,3420,[301 258  88 742 222],796,3,13922,4.069570301081555,0.0,0.0
33421,3,3421,[ 69  15 286  89 143],786,4,13926,4.069549970777323,0.0,20.0
33422,3,3422,[183 215 204 405 135],655,2,13928,4.068945369558866,0.0,0.0
33423,3,3423,[318 515 427 185 313],655,5,13933,4.069217289719626,40.0,0.0
33424,3,3424,[318 515 427 185 313],655,5,13938,4.069489051094891,40.0,0.0
33425,3,3425,[483  64 508  88 135],269,4,13942,4.0694687682428485,20.0,0.0
33426,3,3426,[195 180 153 245 427],450,5,13947,4.069740297636416,20.0,0.0
33427,3,3427,[318 515 427 185 313],655,5,13952,4.070011668611436,40.0,0.0
33428,3,3428,[318 515 427 185 313],655,5,13957,4.070282881306503,40.0,0.0
33429,3,3429,[318 515 427 185 313],655,5,13962,4.070553935860058,40.0,0.0
33430,3,3430,[216 475 117 173 197],89,5,13967,4.070824832410376,0.0,0.0
33431,3,3431,[508 202 210 427 357],269,3,13970,4.07051282051282,20.0,0.0
33432,3,3432,[ 56   8 181 318 182],535,3,13973,4.070200990387416,20.0,0.0
33433,3,3433,[181   1 257 405 238],655,0,13973,4.069015725101922,0.0,0.0
33434,3,3434,[ 70   1 210 237 161],716,4,13977,4.068995633187773,0.0,0.0
33435,3,3435,[197  69 117 275  25],450,4,13981,4.068975552968568,0.0,20.0
33436,3,3436,[318 515 427 185 313],655,5,13986,4.069246435845214,40.0,0.0
33437,3,3437,[318 515 427 185 313],655,5,13991,4.0695171611401975,40.0,0.0
33438,3,3438,[318 515 427 185 313],655,5,13996,4.069787728990986,40.0,0.0
33439,3,3439,[132 603 194 196 197],269,4,14000,4.069767441860465,20.0,0.0
33440,3,3440,[318 515 427 185 313],655,5,14005,4.070037779715199,40.0,0.0
33441,3,3441,[294 597  69  22 118],457,3,14008,4.069726902963393,0.0,0.0
33442,3,3442,[318 515 427 185 313],655,5,14013,4.069997095556201,40.0,0.0
33443,3,3443,[ 15 318 168 153 597],796,5,14018,4.070267131242741,20.0,0.0
33444,3,3444,[118  97  69 288 195],693,2,14020,4.06966618287373,0.0,0.0
33445,3,3445,[118 117  25 323 235],256,4,14024,4.069645966337783,0.0,0.0
33446,3,3446,[318 515 427 185 313],655,5,14029,4.069915868871482,40.0,0.0
33447,3,3447,[186 496   1 118 302],151,3,14032,4.069605568445476,20.0,0.0
33448,3,3448,[194 385  82 125 655],151,3,14035,4.06929544795593,0.0,0.0
33449,3,3449,[ 88 427  12 144 191],796,5,14040,4.069565217391304,20.0,0.0
33450,3,3450,[318 515 427 185 313],655,5,14045,4.069834830483917,40.0,0.0
33451,3,3451,[318 515 427 185 313],655,5,14050,4.070104287369641,40.0,0.0
33452,3,3452,[318 515 427 185 313],655,5,14055,4.070373588184188,40.0,0.0
33453,3,3453,[318 515 427 185 313],655,5,14060,4.070642733063115,40.0,0.0
33454,3,3454,[318 515 427 185 313],655,5,14065,4.070911722141823,40.0,0.0
33455,3,3455,[318 515 427 185 313],655,5,14070,4.071180555555555,40.0,0.0
33456,3,3456,[288  79 257 174  70],457,4,14074,4.071159965287822,0.0,0.0
33457,3,3457,[318 515 427 185 313],655,5,14079,4.071428571428571,40.0,0.0
33458,3,3458,[318 515 427 185 313],655,5,14084,4.071697022260769,40.0,0.0
33459,3,3459,[318 515 427 185 313],655,5,14089,4.071965317919076,40.0,0.0
33460,3,3460,[318 515 427 185 313],655,5,14094,4.072233458537995,40.0,0.0
33461,3,3461,[276 222   8 215 655],457,5,14099,4.072501444251878,0.0,0.0
33462,3,3462,[318 515 427 185 313],655,5,14104,4.072769275194918,40.0,0.0
33463,3,3463,[318 515 427 185 313],655,5,14109,4.073036951501154,40.0,0.0
33464,3,3464,[318 515 427 185 313],655,5,14114,4.073304473304473,40.0,0.0
33465,3,3465,[318 515 427 185 313],655,5,14119,4.0735718407386035,40.0,0.0
33466,3,3466,[318 515 427 185 313],655,5,14124,4.073839053937122,40.0,0.0
33467,3,3467,[ 70 235 678  12 127],344,2,14126,4.073241061130335,0.0,20.0
33468,3,3468,[742  12 161 405 204],280,3,14129,4.072931680599597,0.0,0.0
33469,3,3469,[318 515 427 185 313],655,5,14134,4.073198847262248,40.0,0.0
33470,3,3470,[211 228 215 186 222],655,0,14134,4.072025352924229,0.0,0.0
33471,3,3471,[191  64 276 742 245],344,3,14137,4.071716589861751,20.0,0.0
33472,3,3472,[568 185 187 186 471],450,4,14141,4.071695940109415,0.0,0.0
33473,3,3473,[  4 204  96 215  12],344,4,14145,4.07167530224525,0.0,0.0
33474,3,3474,[318 515 427 185 313],655,5,14150,4.071942446043166,40.0,0.0
33475,3,3475,[258 546 182 196 237],450,5,14155,4.072209436133487,0.0,0.0
33476,3,3476,[318 515 427 185 313],655,5,14160,4.072476272648835,40.0,0.0
33477,3,3477,[179 222 143  69 185],236,4,14164,4.072455434157562,0.0,0.0
33478,3,3478,[ 28 215 153 269 176],796,3,14167,4.072147168726645,0.0,0.0
33479,3,3479,[ 56  98 568 181 144],280,2,14169,4.071551724137931,0.0,0.0
33480,3,3480,[496  97 273 235   1],344,2,14171,4.070956621660442,20.0,0.0
33481,3,3481,[318 515 427 185 313],655,5,14176,4.071223434807582,40.0,0.0
33482,3,3482,[187 238 228 748  79],796,4,14180,4.071202985931668,0.0,0.0
33483,3,3483,[318 515 427 185 313],655,5,14185,4.0714695752009185,40.0,0.0
33484,3,3484,[181 237  12  79 186],18,3,14188,4.07116212338594,0.0,0.0
33485,3,3485,[318 515 427 185 313],655,5,14193,4.071428571428571,40.0,0.0
33486,3,3486,[318 515 427 185 313],655,5,14198,4.071694866647548,40.0,0.0
33487,3,3487,[318 515 427 185 313],655,5,14203,4.071961009174312,40.0,0.0
33488,3,3488,[235 678  98 245 228],280,2,14205,4.071367153912296,0.0,0.0
33489,3,3489,[202  70 117 222 179],786,5,14210,4.07163323782235,0.0,0.0
33490,3,3490,[ 70 508 127 403  11],280,3,14213,4.071326267545116,0.0,20.0
33491,3,3491,[318 515 427 185 313],655,5,14218,4.071592210767468,40.0,0.0
33492,3,3492,[318 515 427 185 313],655,5,14223,4.071858001717721,40.0,0.0
33493,3,3493,[82 28 70 15 79],151,4,14227,4.071837435603892,0.0,0.0
33494,3,3494,[237 204 117 143 182],655,2,14229,4.071244635193133,0.0,0.0
33495,3,3495,[ 69 405 568  64 181],330,5,14234,4.071510297482837,20.0,0.0
33496,3,3496,[172 191 132  56  82],457,5,14239,4.071775807835287,0.0,0.0
33497,3,3497,[ 56 483 234  11 117],655,1,14240,4.070897655803316,0.0,0.0
33498,3,3498,[318 515 427 185 313],655,5,14245,4.071163189482709,40.0,0.0
33499,3,3499,[228 196 288 132  79],655,1,14246,4.070285714285714,0.0,0.0
33500,3,3500,[187   7 191  88  96],450,5,14251,4.07055127106541,0.0,0.0
33501,3,3501,[275 175 228 151 273],344,5,14256,4.0708166761850375,0.0,20.0
33502,3,3502,[423 132  82   4 748],280,2,14258,4.0702255209820155,0.0,0.0
33503,3,3503,[ 95   1  22 181 168],716,5,14263,4.070490867579909,0.0,0.0
33504,3,3504,[228  64 546 174 275],796,5,14268,4.070756062767475,20.0,20.0
33505,3,3505,[125 328  70 174 235],401,3,14271,4.070450656018254,0.0,0.0
33506,3,3506,[ 12 235 282 742 403],450,4,14275,4.0704305674365555,0.0,0.0
33507,3,3507,[176   4 210 144 282],716,1,14276,4.069555302166477,0.0,0.0
33508,3,3508,[127 288 179 403  79],457,5,14281,4.069820461669991,0.0,20.0
33509,3,3509,[318 515 427 185 313],655,5,14286,4.07008547008547,40.0,0.0
33510,3,3510,[286  11 276 328  69],401,2,14288,4.069495870122473,0.0,20.0
33511,3,3511,[183  82 182 268 132],655,2,14290,4.068906605922551,0.0,0.0
33512,3,3512,[318 515 427 185 313],655,5,14295,4.069171648163962,40.0,0.0
33513,3,3513,[275 357 127 216 181],344,4,14299,4.069151963574274,0.0,40.0
33514,3,3514,[318 515 427 185 313],655,5,14304,4.069416785206259,40.0,0.0
33515,3,3515,[318 515 427 185 313],655,5,14309,4.069681456200228,40.0,0.0
33516,3,3516,[173  96 483  82 111],450,3,14312,4.069377310207563,0.0,0.0
33517,3,3517,[318 515 427 185 313],655,5,14317,4.069641841955657,40.0,0.0
33518,3,3518,[176 181 121 300 196],796,5,14322,4.069906223358909,0.0,0.0
33519,3,3519,[237 100 210 211 328],655,0,14322,4.06875,0.0,20.0
33520,3,3520,[ 15   1 200 313 288],655,2,14324,4.0681624538483385,0.0,0.0
33521,3,3521,[318 515 427 185 313],655,5,14329,4.068427030096536,40.0,0.0
33522,3,3522,[185 427 294  89 173],796,4,14333,4.068407607152994,20.0,0.0
33523,3,3523,[588  97 257 191 132],716,5,14338,4.068671963677639,0.0,0.0
33524,3,3524,[121 211 403 515  56],269,3,14341,4.068368794326241,0.0,0.0
33525,3,3525,[121 258  69 176 216],693,2,14343,4.067782189449802,0.0,0.0
33526,3,3526,[435 483  22 385  25],655,1,14344,4.066912390133258,0.0,0.0
33527,3,3527,[185 168  89 118 121],151,4,14348,4.066893424036281,0.0,0.0
33528,3,3528,[ 15 568 172 185  98],655,3,14351,4.066591102295268,0.0,0.0
33529,3,3529,[318 515 427 185 313],655,5,14356,4.06685552407932,40.0,0.0
33530,3,3530,[318 282 179 222 195],457,5,14361,4.067119796091759,20.0,0.0
33531,3,3531,[546 496 328 318  88],450,5,14366,4.067383918459796,40.0,0.0
33532,3,3532,[197 202 323 322  88],504,3,14369,4.067081800169827,0.0,0.0
33533,3,3533,[318 515 427 185 313],655,5,14374,4.067345783814375,40.0,0.0
33534,3,3534,[318 515 427 185 313],655,5,14379,4.067609618104668,40.0,0.0
33535,3,3535,[748 385  64 597  28],796,4,14383,4.067590497737557,20.0,0.0
33536,3,3536,[215  11 288 194  82],450,3,14386,4.06728866270851,0.0,0.0
33537,3,3537,[318 515 427 185 313],655,5,14391,4.067552289429056,40.0,0.0
33538,3,3538,[318 515 427 185 313],655,5,14396,4.067815767165866,40.0,0.0
33539,3,3539,[318 515 427 185 313],655,5,14401,4.068079096045198,40.0,0.0
33540,3,3540,[174  82 655  15 111],151,4,14405,4.068059870093194,0.0,0.0
33541,3,3541,[318 515 427 185 313],655,5,14410,4.068322981366459,40.0,0.0
33542,3,3542,[276 568 176 508 179],655,2,14412,4.0677392040643525,0.0,0.0
33543,3,3543,[210 597   9 222 200],796,3,14415,4.067437923250564,0.0,0.0
33544,3,3544,[318 515 427 185 313],655,5,14420,4.067700987306065,40.0,0.0
33545,3,3545,[318 515 427 185 313],655,5,14425,4.067963902989284,40.0,0.0
33546,3,3546,[318 515 427 185 313],655,5,14430,4.0682266704257115,40.0,0.0
33547,3,3547,[318 515 427 185 313],655,5,14435,4.068489289740699,40.0,0.0
33548,3,3548,[655 289 742 191 143],693,1,14436,4.067624683009298,0.0,0.0
33549,3,3549,[318 515 427 185 313],655,5,14441,4.067887323943662,40.0,0.0
33550,3,3550,[318 515 427 185 313],655,5,14446,4.068149816952971,40.0,0.0
33551,3,3551,[210  12 265 328 318],450,4,14450,4.06813063063063,20.0,0.0
33552,3,3552,[143   7 423 197 435],655,1,14451,4.067267098226851,0.0,0.0
33553,3,3553,[318 515 427 185 313],655,5,14456,4.067529544175577,40.0,0.0
33554,3,3554,[655 202 200 127 182],450,4,14460,4.067510548523207,0.0,20.0
33555,3,3555,[318 515 427 185 313],655,5,14465,4.067772778402699,40.0,0.0
33556,3,3556,[357 121 235  89   9],344,3,14468,4.067472589260613,0.0,0.0
33557,3,3557,[318 515 427 185 313],655,5,14473,4.067734682405846,40.0,0.0
33558,3,3558,[508 180 121  64 181],535,5,14478,4.067996628266367,20.0,0.0
33559,3,3559,[318 515 427 185 313],655,5,14483,4.068258426966292,40.0,0.0
33560,3,3560,[318 515 427 185 313],655,5,14488,4.068520078629598,40.0,0.0
33561,3,3561,[  1 174 288 173 228],450,4,14492,4.06850084222347,0.0,0.0
33562,3,3562,[318 515 427 185 313],655,5,14497,4.068762278978389,40.0,0.0
33563,3,3563,[318 515 427 185 313],655,5,14502,4.069023569023569,40.0,0.0
33564,3,3564,[318 515 427 185 313],655,5,14507,4.069284712482468,40.0,0.0
33565,3,3565,[237  95   8  28 276],18,3,14510,4.068984856982613,0.0,0.0
33566,3,3566,[318 515 427 185 313],655,5,14515,4.069245864872442,40.0,0.0
33567,3,3567,[318 515 427 185 313],655,5,14520,4.069506726457399,40.0,0.0
33568,3,3568,[318 515 427 185 313],655,5,14525,4.069767441860465,40.0,0.0
33569,3,3569,[318 515 427 185 313],655,5,14530,4.0700280112044815,40.0,0.0
33570,3,3570,[318 515 427 185 313],655,5,14535,4.070288434612153,40.0,0.0
33571,3,3571,[318 515 427 185 313],655,5,14540,4.070548712206047,40.0,0.0
33572,3,3572,[197 234 323   4  22],796,2,14542,4.06996921354604,0.0,0.0
33573,3,3573,[197 237 288  28 222],450,3,14545,4.069669837716844,0.0,0.0
33574,3,3574,[168 181 173  22  82],807,4,14549,4.06965034965035,0.0,0.0
33575,3,3575,[318 515 427 185 313],655,5,14554,4.069910514541387,40.0,0.0
33576,3,3576,[258 282 125 508 288],655,0,14554,4.068772714565278,0.0,0.0
33577,3,3577,[176 237 216 181 546],504,2,14556,4.068194522079374,0.0,0.0
33578,3,3578,[174 294 173 508 144],280,0,14556,4.067057837384744,0.0,0.0
33579,3,3579,[333 328 286 111 268],629,4,14560,4.067039106145251,0.0,20.0
33580,3,3580,[318 515 427 185 313],655,5,14565,4.067299636972913,40.0,0.0
33581,3,3581,[153 273 508 357 135],401,1,14566,4.066443327749861,0.0,0.0
33582,3,3582,[300   1 117  25 125],879,4,14570,4.06642478370081,0.0,0.0
33583,3,3583,[153 588 204 181 318],450,5,14575,4.066685267857143,20.0,0.0
33584,3,3584,[318 515 427 185 313],655,5,14580,4.066945606694561,40.0,0.0
33585,3,3585,[313 748 173 257 168],807,4,14584,4.066926938092582,0.0,0.0
33586,3,3586,[273 175 475 427 118],655,2,14586,4.0663507109004735,20.0,0.0
33587,3,3587,[318 515 427 185 313],655,5,14591,4.066610925306578,40.0,0.0
33588,3,3588,[318 515 427 185 313],655,5,14596,4.066870994706046,40.0,0.0
33589,3,3589,[187 238 300 181 194],450,5,14601,4.067130919220055,0.0,0.0
33590,3,3590,[ 15 135 204 286 197],389,2,14603,4.0665552770815925,0.0,20.0
33591,3,3591,[318 515 427 185 313],655,5,14608,4.066815144766147,40.0,0.0
33592,3,3592,[127  82 228 132 195],450,4,14612,4.066796548844977,0.0,20.0
33593,3,3593,[318 515 427 185 313],655,5,14617,4.067056204785754,40.0,0.0
33594,3,3594,[318 515 427 185 313],655,5,14622,4.067315716272601,40.0,0.0
33595,3,3595,[211 202 245 187 215],450,5,14627,4.067575083426029,0.0,0.0
33596,3,3596,[ 56 143 215  50  89],151,4,14631,4.067556296914095,0.0,20.0
33597,3,3597,[318 515 427 185 313],655,5,14636,4.067815453029461,40.0,0.0
33598,3,3598,[318 515 427 185 313],655,5,14641,4.068074465129203,40.0,0.0
33599,3,3599,[318 515 427 185 313],655,5,14646,4.068333333333333,40.0,0.0
33600,3,3600,[153 100 179 269 318],878,4,14650,4.068314357123022,20.0,20.0
33601,3,3601,[318 515 427 185 313],655,5,14655,4.068573014991672,40.0,0.0
33602,3,3602,[318 515 427 185 313],655,5,14660,4.068831529281154,40.0,0.0
33603,3,3603,[228 237 257 100 245],796,3,14663,4.068534961154273,0.0,20.0
33604,3,3604,[  8 282 471 161 403],457,5,14668,4.068793342579751,0.0,0.0
33605,3,3605,[210 200 313 483 294],280,2,14670,4.068219633943428,0.0,0.0
33606,3,3606,[318 515 427 185 313],655,5,14675,4.0684779595231495,40.0,0.0
33607,3,3607,[318 515 427 185 313],655,5,14680,4.068736141906873,40.0,0.0
33608,3,3608,[302 483 176  69 228],450,4,14684,4.068717096148518,0.0,0.0
33609,3,3609,[318 515 427 185 313],655,5,14689,4.068975069252078,40.0,0.0
33610,3,3610,[  4  25  28 269 405],450,3,14692,4.06867903627804,0.0,0.0
33611,3,3611,[275 210 257 294  50],457,3,14695,4.068383167220377,0.0,40.0
33612,3,3612,[483 289 202 405 257],655,1,14696,4.067533905341821,0.0,0.0
33613,3,3613,[111 118 318 197 300],655,1,14697,4.066685113447703,20.0,0.0
33614,3,3614,[318 515 427 185 313],655,5,14702,4.066943291839557,40.0,0.0
33615,3,3615,[318 515 427 185 313],655,5,14707,4.0672013274336285,40.0,0.0
33616,3,3616,[ 97 588 269 318 176],796,3,14710,4.06690627591927,20.0,0.0
33617,3,3617,[127 210 471  15  69],389,3,14713,4.06661138750691,0.0,20.0
33618,3,3618,[318 515 427 185 313],655,5,14718,4.066869300911854,40.0,0.0
33619,3,3619,[318 515 427 185 313],655,5,14723,4.067127071823204,40.0,0.0
33620,3,3620,[186 168  96 127 153],450,4,14727,4.067108533554267,0.0,20.0
33621,3,3621,[318 515 427 185 313],655,5,14732,4.067366096079514,40.0,0.0
33622,3,3622,[318 515 427 185 313],655,5,14737,4.067623516422854,40.0,0.0
33623,3,3623,[318 515 427 185 313],655,5,14742,4.067880794701987,40.0,0.0
33624,3,3624,[318 515 427 185 313],655,5,14747,4.0681379310344825,40.0,0.0
33625,3,3625,[318 515 427 185 313],655,5,14752,4.068394925537783,40.0,0.0
33626,3,3626,[318 515 427 185 313],655,5,14757,4.0686517783291976,40.0,0.0
33627,3,3627,[403  89 196 222 186],655,1,14758,4.067805953693495,0.0,0.0
33628,3,3628,[318 515 427 185 313],655,5,14763,4.0680628272251305,40.0,0.0
33629,3,3629,[183 180 111 204  89],269,0,14763,4.06694214876033,0.0,0.0
33630,3,3630,[196 144  70 175 174],23,2,14765,4.066372900027541,0.0,0.0
33631,3,3631,[144 655 180 153   7],450,5,14770,4.066629955947136,0.0,0.0
33632,3,3632,[183  96 546 483 111],457,3,14773,4.066336361134049,0.0,0.0
33633,3,3633,[318 515 427 185 313],655,5,14778,4.066593285635663,40.0,0.0
33634,3,3634,[294 318 187 161 180],796,3,14781,4.066299862448418,20.0,0.0
33635,3,3635,[318 515 427 185 313],655,5,14786,4.066556655665567,40.0,0.0
33636,3,3636,[118  82 655 182  12],450,3,14789,4.066263403904316,0.0,0.0
33637,3,3637,[318 515 427 185 313],655,5,14794,4.066520065970313,40.0,0.0
33638,3,3638,[318 515 427 185 313],655,5,14799,4.066776586974443,40.0,0.0
33639,3,3639,[ 96 186  12 423 215],796,4,14803,4.066758241758242,0.0,0.0
33640,3,3640,[135 210 603 182 196],18,2,14805,4.066190606976106,20.0,0.0
33641,3,3641,[ 97 187 471 268  25],655,1,14806,4.065348709500275,0.0,0.0
33642,3,3642,[  9 357 273  28 568],693,2,14808,4.064781773263793,0.0,0.0
33643,3,3643,[318 515 427 185 313],655,5,14813,4.065038419319429,40.0,0.0
33644,3,3644,[318 515 427 185 313],655,5,14818,4.065294924554184,40.0,0.0
33645,3,3645,[257 318 202 204 748],401,3,14821,4.065002742731761,20.0,0.0
33646,3,3646,[161 403 204 153 143],269,0,14821,4.063888127227859,0.0,0.0
33647,3,3647,[318 515 427 185 313],655,5,14826,4.064144736842105,40.0,0.0
33648,3,3648,[121 385  56 423  69],796,5,14831,4.064401205809811,0.0,0.0
33649,3,3649,[111  98 286   1 302],655,2,14833,4.0638356164383564,0.0,20.0
33650,3,3650,[318 515 427 185 313],655,5,14838,4.064092029580936,40.0,0.0
33651,3,3651,[ 12 328 257  25 301],655,0,14838,4.062979189485214,0.0,0.0
33652,3,3652,[588 276 211  70  98],786,4,14842,4.062961949082945,0.0,0.0
33653,3,3653,[318 515 427 185 313],655,5,14847,4.063218390804598,40.0,0.0
33654,3,3654,[  4 546 322  12 655],151,3,14850,4.062927496580027,0.0,0.0
33655,3,3655,[655 273 269   1 423],450,4,14854,4.062910284463895,0.0,0.0
33656,3,3656,[181  89 742 195 294],457,4,14858,4.062893081761007,0.0,0.0
33657,3,3657,[ 97 269 302 132 273],450,4,14862,4.062875888463641,0.0,0.0
33658,3,3658,[302 204  79 435 183],151,3,14865,4.062585405848592,0.0,0.0
33659,3,3659,[318 515 427 185 313],655,5,14870,4.062841530054645,40.0,0.0
33660,3,3660,[127 471 385 151 143],401,2,14872,4.062278066102158,0.0,20.0
33661,3,3661,[275 174 202   7 568],450,5,14877,4.062534134352813,0.0,20.0
33662,3,3662,[318 515 427 185 313],655,5,14882,4.062790062790063,40.0,0.0
33663,3,3663,[318 515 427 185 313],655,5,14887,4.0630458515283845,40.0,0.0
33664,3,3664,[496 191  25 215 111],151,3,14890,4.062755798090041,20.0,0.0
33665,3,3665,[318 515 427 185 313],655,5,14895,4.063011456628478,40.0,0.0
33666,3,3666,[195 143  69 333 435],655,1,14896,4.062176165803109,0.0,0.0
33667,3,3667,[318 515 427 185 313],655,5,14901,4.062431842966194,40.0,0.0
33668,3,3668,[318 515 427 185 313],655,5,14906,4.0626873807576995,40.0,0.0
33669,3,3669,[318 515 427 185 313],655,5,14911,4.062942779291554,40.0,0.0
33670,3,3670,[318 515 427 185 313],655,5,14916,4.063198038681558,40.0,0.0
33671,3,3671,[268 318 182 187  82],269,4,14920,4.06318082788671,20.0,0.0
33672,3,3672,[318 515 427 185 313],655,5,14925,4.063435883474,40.0,0.0
33673,3,3673,[318 515 427 185 313],655,5,14930,4.0636908002177465,40.0,0.0
33674,3,3674,[403 328  64  69 271],655,1,14931,4.062857142857143,20.0,0.0
33675,3,3675,[153 135 176 174  50],655,2,14933,4.062295973884657,0.0,20.0
33676,3,3676,[597  71 210 111 323],796,3,14936,4.062007070981779,0.0,0.0
33677,3,3677,[568 215 191 176  69],72,4,14940,4.061990212071779,0.0,0.0
33678,3,3678,[318 515 427 185 313],655,5,14945,4.06224517531938,40.0,0.0
33679,3,3679,[174  71 173 153 176],23,3,14948,4.0619565217391305,0.0,0.0
33680,3,3680,[318 515 427 185 313],655,5,14953,4.062211355609889,40.0,0.0
33681,3,3681,[318 515 427 185 313],655,5,14958,4.062466051059207,40.0,0.0
33682,3,3682,[318 515 427 185 313],655,5,14963,4.062720608199837,40.0,0.0
33683,3,3683,[483  71 405 302 234],450,2,14965,4.062160694896852,0.0,0.0
33684,3,3684,[235 222 143 196  88],23,1,14966,4.061329715061058,0.0,0.0
33685,3,3685,[117   4 127 194 187],629,4,14970,4.061313076505697,0.0,20.0
33686,3,3686,[143 173  97 100 153],593,5,14975,4.061567670192568,0.0,20.0
33687,3,3687,[318 515 427 185 313],655,5,14980,4.061822125813449,40.0,0.0
33688,3,3688,[294 191 385 161 228],577,4,14984,4.061805367308214,0.0,0.0
33689,3,3689,[318 515 427 185 313],655,5,14989,4.062059620596206,40.0,0.0
33690,3,3690,[ 22 322 173 183 235],344,2,14991,4.061500948252506,0.0,0.0
33691,3,3691,[318 515 427 185 313],655,5,14996,4.061755146262189,40.0,0.0
33692,3,3692,[403 282 153 187 228],450,5,15001,4.062009206607095,0.0,0.0
33693,3,3693,[151 111 258 161 546],457,3,15004,4.061721710882512,0.0,0.0
33694,3,3694,[318 515 427 185 313],655,5,15009,4.061975642760487,40.0,0.0
33695,3,3695,[215 288  28 211 174],450,4,15013,4.061958874458875,0.0,0.0
33696,3,3696,[258 286 111  95 117],796,4,15017,4.061942115228564,0.0,20.0
33697,3,3697,[195 568 546 118 483],716,2,15019,4.061384532179557,0.0,0.0
33698,3,3698,[423  12  97 748 210],151,4,15023,4.061367937280346,0.0,0.0
33699,3,3699,[435 200  25 273 173],450,2,15025,4.0608108108108105,0.0,0.0
33700,3,3700,[179  82 174 111  22],878,2,15027,4.060253985409349,0.0,0.0
33701,3,3701,[318 515 427 185 313],655,5,15032,4.060507833603458,40.0,0.0
33702,3,3702,[318 515 427 185 313],655,5,15037,4.0607615446934915,40.0,0.0
33703,3,3703,[322 258 265  88 313],450,5,15042,4.061015118790497,0.0,0.0
33704,3,3704,[318 515 427 185 313],655,5,15047,4.061268556005398,40.0,0.0
33705,3,3705,[318 515 427 185 313],655,5,15052,4.061521856449001,40.0,0.0
33706,3,3706,[234 328  64 275  69],655,2,15054,4.060965740490963,20.0,20.0
33707,3,3707,[318 515 427 185 313],655,5,15059,4.061218985976268,40.0,0.0
33708,3,3708,[318 515 427 185 313],655,5,15064,4.061472094904287,40.0,0.0
33709,3,3709,[191  79 275 215 228],457,5,15069,4.061725067385445,0.0,20.0
33710,3,3710,[435 546 181 185 111],236,5,15074,4.061977903530046,0.0,0.0
33711,3,3711,[318 515 427 185 313],655,5,15079,4.062230603448276,40.0,0.0
33712,3,3712,[258 161 180 127 143],450,5,15084,4.062483167250202,0.0,20.0
33713,3,3713,[318 515 427 185 313],655,5,15089,4.062735595045773,40.0,0.0
33714,3,3714,[173 196 357 100  15],629,5,15094,4.062987886944819,0.0,20.0
33715,3,3715,[286 187 181 176 597],450,5,15099,4.063240043057051,0.0,20.0
33716,3,3716,[318 515 427 185 313],655,5,15104,4.063492063492063,40.0,0.0
33717,3,3717,[294  25 100 742 172],577,5,15109,4.063743948359333,0.0,20.0
33718,3,3718,[ 70 475 235 161 508],269,2,15111,4.063189029308954,0.0,0.0
33719,3,3719,[265 276 216 508  88],655,2,15113,4.06263440860215,0.0,0.0
33720,3,3720,[121 385 191  22 179],457,5,15118,4.062886320881484,0.0,0.0
33721,3,3721,[318 515 427 185 313],655,5,15123,4.063138097796883,40.0,0.0
33722,3,3722,[258 111 678  15 269],15,3,15126,4.0628525382755845,0.0,0.0
33723,3,3723,[318 515 427 185 313],655,5,15131,4.063104189044038,40.0,0.0
33724,3,3724,[546 748 174 282  12],796,5,15136,4.063355704697987,0.0,0.0
33725,3,3725,[174 471 294  69 168],401,2,15138,4.06280193236715,0.0,0.0
33726,3,3726,[318 515 427 185 313],655,5,15143,4.063053394150791,40.0,0.0
33727,3,3727,[ 95 127 385 588 546],450,4,15147,4.063036480686695,0.0,20.0
33728,3,3728,[318 515 427 185 313],655,5,15152,4.063287744703674,40.0,0.0
33729,3,3729,[174 294 210 186 183],796,2,15154,4.062734584450403,0.0,0.0
33730,3,3730,[222 183 286 333   9],655,1,15155,4.061913696060038,0.0,20.0
33731,3,3731,[318 515 427 185 313],655,5,15160,4.062165058949625,40.0,0.0
33732,3,3732,[211  79  71  98 300],450,4,15164,4.0621484061076885,0.0,0.0
33733,3,3733,[318 515 427 185 313],655,5,15169,4.062399571505089,40.0,0.0
33734,3,3734,[318 515 427 185 313],655,5,15174,4.062650602409638,40.0,0.0
33735,3,3735,[302 135 288 111  97],655,2,15176,4.062098501070664,0.0,0.0
33736,3,3736,[  7 268 194 127 202],629,4,15180,4.062081883864062,0.0,20.0
33737,3,3737,[318 515 427 185 313],655,5,15185,4.062332798287854,40.0,0.0
33738,3,3738,[318 515 427 185 313],655,5,15190,4.062583578496924,40.0,0.0
33739,3,3739,[118  98 202 215 238],457,5,15195,4.06283422459893,0.0,0.0
33740,3,3740,[ 95 117  97 183  12],577,5,15200,4.063084736701417,0.0,0.0
33741,3,3741,[318 515 427 185 313],655,5,15205,4.063335114911812,40.0,0.0
33742,3,3742,[475  98 300 265  64],629,5,15210,4.06358535933743,20.0,0.0
33743,3,3743,[ 79 222 258 194 210],623,5,15215,4.06383547008547,0.0,0.0
33744,3,3744,[ 25 121 100 508 288],655,0,15215,4.0627503337783715,0.0,20.0
33745,3,3745,[588 202  71  12 121],344,3,15218,4.0624666310731445,0.0,0.0
33746,3,3746,[ 96 302   4  79 435],450,4,15222,4.062449959967974,0.0,0.0
33747,3,3747,[318 515 427 185 313],655,5,15227,4.062700106723586,40.0,0.0
33748,3,3748,[318 515 427 185 313],655,5,15232,4.062950120032008,40.0,0.0
33749,3,3749,[237 161 127 111 322],796,4,15236,4.0629333333333335,0.0,20.0
33750,3,3750,[ 98 655   4 237 153],280,2,15238,4.06238336443615,0.0,0.0
33751,3,3751,[318 515 427 185 313],655,5,15243,4.062633262260128,40.0,0.0
33752,3,3752,[423 121 161 172 186],716,3,15246,4.062350119904076,0.0,0.0
33753,3,3753,[121  98 301   1  50],535,3,15249,4.062067128396377,0.0,20.0
33754,3,3754,[ 25 588   4 300 161],450,3,15252,4.061784287616511,0.0,0.0
33755,3,3755,[234 475 194 202 238],264,5,15257,4.062034078807241,0.0,0.0
33756,3,3756,[423  97 655  69 333],693,1,15258,4.0612190577588505,0.0,0.0
33757,3,3757,[318 515 427 185 313],655,5,15263,4.061468866418307,40.0,0.0
33758,3,3758,[318 515 427 185 313],655,5,15268,4.06171854216547,40.0,0.0
33759,3,3759,[144 300 237 427 191],655,2,15270,4.0611702127659575,20.0,0.0
33760,3,3760,[318 515 427 185 313],655,5,15275,4.061419835150226,40.0,0.0
33761,3,3761,[200 286  95 496 173],796,4,15279,4.06140350877193,20.0,20.0
33762,3,3762,[318 515 427 185 313],655,5,15284,4.061652936486846,40.0,0.0
33763,3,3763,[318 515 427 185 313],655,5,15289,4.061902231668438,40.0,0.0
33764,3,3764,[ 97 151 238  56 181],18,3,15292,4.061620185922974,0.0,0.0
33765,3,3765,[318 515 427 185 313],655,5,15297,4.061869357408391,40.0,0.0
33766,3,3766,[194 678 300 403  70],504,2,15299,4.061322006902044,0.0,0.0
33767,3,3767,[328 234 174 161 273],796,3,15302,4.06104033970276,0.0,0.0
33768,3,3768,[204  71 238 187 143],450,4,15306,4.061024144335367,0.0,0.0
33769,3,3769,[144 282 202 483  70],457,5,15311,4.061273209549071,0.0,0.0
33770,3,3770,[121  70 100 191 546],344,2,15313,4.060726597719438,0.0,20.0
33771,3,3771,[318 515 427 185 313],655,5,15318,4.060975609756097,40.0,0.0
33772,3,3772,[318 515 427 185 313],655,5,15323,4.061224489795919,40.0,0.0
33773,3,3773,[194 423 427 186 588],716,4,15327,4.06120826709062,20.0,0.0
33774,3,3774,[234 655 210 168 568],269,2,15329,4.060662251655629,0.0,0.0
33775,3,3775,[282 655 603 515 194],401,3,15332,4.060381355932203,20.0,0.0
33776,3,3776,[318 515 427 185 313],655,5,15337,4.060630129732592,40.0,0.0
33777,3,3777,[318 515 427 185 313],655,5,15342,4.060878771836951,40.0,0.0
33778,3,3778,[318 515 427 185 313],655,5,15347,4.061127282349828,40.0,0.0
33779,3,3779,[318 515 427 185 313],655,5,15352,4.061375661375662,40.0,0.0
33780,3,3780,[318 515 427 185 313],655,5,15357,4.0616239090187785,40.0,0.0
33781,3,3781,[318 515 427 185 313],655,5,15362,4.061872025383395,40.0,0.0
33782,3,3782,[318 515 427 185 313],655,5,15367,4.062120010573619,40.0,0.0
33783,3,3783,[318 515 427 185 313],655,5,15372,4.062367864693446,40.0,0.0
33784,3,3784,[318 515 427 185 313],655,5,15377,4.062615587846763,40.0,0.0
33785,3,3785,[194 181 385 143 216],577,4,15381,4.062599049128368,0.0,0.0
33786,3,3786,[318 515 427 185 313],655,5,15386,4.062846580406655,40.0,0.0
33787,3,3787,[318 515 427 185 313],655,5,15391,4.063093980992608,40.0,0.0
33788,3,3788,[318 515 427 185 313],655,5,15396,4.063341250989707,40.0,0.0
33789,3,3789,[318 515 427 185 313],655,5,15401,4.0635883905013195,40.0,0.0
33790,3,3790,[187  28  64 135 655],716,3,15404,4.0633078343445,20.0,0.0
33791,3,3791,[318 515 427 185 313],655,5,15409,4.063554852320675,40.0,0.0
33792,3,3792,[318 515 427 185 313],655,5,15414,4.063801740047456,40.0,0.0
33793,3,3793,[276 508 174 211 268],655,1,15415,4.062994201370585,0.0,0.0
33794,3,3794,[ 97 118 216  88 269],450,4,15419,4.062977602108037,0.0,0.0
33795,3,3795,[318 515 427 185 313],655,5,15424,4.063224446786091,40.0,0.0
33796,3,3796,[318 515 427 185 313],655,5,15429,4.063471161443244,40.0,0.0
33797,3,3797,[245 117 265   7 427],450,5,15434,4.063717746182201,20.0,0.0
33798,3,3798,[318 515 427 185 313],655,5,15439,4.063964201105554,40.0,0.0
33799,3,3799,[ 22 135 313  82 143],450,3,15442,4.063684210526316,0.0,0.0
33800,3,3800,[318 515 427 185 313],655,5,15447,4.063930544593528,40.0,0.0
33801,3,3801,[168 181  88 182 496],389,4,15451,4.063913729615992,20.0,0.0
33802,3,3802,[318 515 427 185 313],655,5,15456,4.064159873783855,40.0,0.0
33803,3,3803,[318 515 427 185 313],655,5,15461,4.0644058885383805,40.0,0.0
33804,3,3804,[318 515 427 185 313],655,5,15466,4.064651773981603,40.0,0.0
33805,3,3805,[302 195  50 191  12],151,2,15468,4.064109301103521,0.0,20.0
33806,3,3806,[ 97 471 153 235 204],716,3,15471,4.0638297872340425,0.0,0.0
33807,3,3807,[ 79 655 546 237  97],593,3,15474,4.063550420168068,0.0,0.0
33808,3,3808,[318 515 427 185 313],655,5,15479,4.063796271987398,40.0,0.0
33809,3,3809,[318 515 427 185 313],655,5,15484,4.0640419947506565,40.0,0.0
33810,3,3810,[  7 127 228 282 172],296,5,15489,4.064287588559433,0.0,20.0
33811,3,3811,[318 515 427 185 313],655,5,15494,4.064533053515215,40.0,0.0
33812,3,3812,[318 515 427 185 313],655,5,15499,4.064778389719381,40.0,0.0
33813,3,3813,[318 515 427 185 313],655,5,15504,4.065023597273204,40.0,0.0
33814,3,3814,[318 515 427 185 313],655,5,15509,4.06526867627785,40.0,0.0
33815,3,3815,[294 118  95 302 275],450,3,15512,4.064989517819707,0.0,20.0
33816,3,3816,[318 515 427 185 313],655,5,15517,4.065234477338223,40.0,0.0
33817,3,3817,[318 515 427 185 313],655,5,15522,4.065479308538502,40.0,0.0
33818,3,3818,[180 655 153 183 161],796,3,15525,4.065200314218382,0.0,0.0
33819,3,3819,[318 515 427 185 313],655,5,15530,4.06544502617801,40.0,0.0
33820,3,3820,[318 515 427 185 313],655,5,15535,4.065689610049725,40.0,0.0
33821,3,3821,[318 515 427 185 313],655,5,15540,4.065934065934066,40.0,0.0
33822,3,3822,[174 127  22 197 228],716,5,15545,4.066178393931468,0.0,20.0
33823,3,3823,[174 357 172 333 322],629,4,15549,4.066161087866109,0.0,0.0
33824,3,3824,[318 515 427 185 313],655,5,15554,4.06640522875817,40.0,0.0
33825,3,3825,[318 515 427 185 313],655,5,15559,4.066649242028228,40.0,0.0
33826,3,3826,[318 515 427 185 313],655,5,15564,4.066893127776326,40.0,0.0
33827,3,3827,[ 95 132  28 403 655],796,3,15567,4.066614420062696,0.0,0.0
33828,3,3828,[276 202 117 194 357],504,2,15569,4.066074693131366,0.0,0.0
33829,3,3829,[186 427 172 258  79],151,5,15574,4.066318537859008,20.0,0.0
33830,3,3830,[318 515 427 185 313],655,5,15579,4.0665622552858265,40.0,0.0
33831,3,3831,[ 22 318 153  88 742],655,1,15580,4.065762004175365,20.0,0.0
33832,3,3832,[318 515 427 185 313],655,5,15585,4.066005739629533,40.0,0.0
33833,3,3833,[ 70 423 180 200 357],504,4,15589,4.065988523735003,0.0,0.0
33834,3,3834,[276 269 196 111 483],655,2,15591,4.0654498044328555,0.0,0.0
33835,3,3835,[318 515 427 185 313],655,5,15596,4.065693430656935,40.0,0.0
33836,3,3836,[318 515 427 185 313],655,5,15601,4.065936929893145,40.0,0.0
33837,3,3837,[222 655 174  70 546],457,4,15605,4.065919749869724,0.0,0.0
33838,3,3838,[  8 121 475 265 333],655,0,15605,4.064860640791873,0.0,0.0
33839,3,3839,[318 515 427 185 313],655,5,15610,4.065104166666667,40.0,0.0
33840,3,3840,[  7 196 234 132 127],786,4,15614,4.065087216870607,0.0,20.0
33841,3,3841,[318 515 427 185 313],655,5,15619,4.065330557001562,40.0,0.0
33842,3,3842,[127 471  50 427 186],655,3,15622,4.0650533437418686,20.0,40.0
33843,3,3843,[318 515 427 185 313],655,5,15627,4.065296566077003,40.0,0.0
33844,3,3844,[597 435 300 210 118],807,4,15631,4.065279583875163,0.0,0.0
33845,3,3845,[318 515 427 185 313],655,5,15636,4.0655226209048365,40.0,0.0
33846,3,3846,[183 125 191 328 216],655,3,15639,4.065245645957889,0.0,0.0
33847,3,3847,[318 515 427 185 313],655,5,15644,4.0654885654885655,40.0,0.0
33848,3,3848,[318 515 427 185 313],655,5,15649,4.065731358794492,40.0,0.0
33849,3,3849,[318 515 427 185 313],655,5,15654,4.065974025974026,40.0,0.0
33850,3,3850,[186 151 258 100 172],296,3,15657,4.065697221500909,0.0,20.0
33851,3,3851,[318 515 427 185 313],655,5,15662,4.0659397715472485,40.0,0.0
33852,3,3852,[328  64   9 237 215],655,1,15663,4.065144043602388,20.0,0.0
33853,3,3853,[318 515 427 185 313],655,5,15668,4.065386611312921,40.0,0.0
33854,3,3854,[176 655   9  96 127],655,1,15669,4.064591439688716,0.0,20.0
33855,3,3855,[742 294 357  95  56],450,4,15673,4.0645746887966805,0.0,0.0
33856,3,3856,[ 12 179 742  82 125],655,1,15674,4.063780140005186,0.0,0.0
33857,3,3857,[313   8  69 222 318],655,2,15676,4.06324520476931,20.0,0.0
33858,3,3858,[204 173 216 183 282],457,5,15681,4.063487950246178,0.0,0.0
33859,3,3859,[228 153 186 301 132],450,4,15685,4.063471502590674,0.0,0.0
33860,3,3860,[318 515 427 185 313],655,5,15690,4.063714063714063,40.0,0.0
33861,3,3861,[405   8 597 427 216],23,4,15694,4.063697566027964,20.0,0.0
33862,3,3862,[318 515 427 185 313],655,5,15699,4.063939943049443,40.0,0.0
33863,3,3863,[318 515 427 185 313],655,5,15704,4.064182194616977,40.0,0.0
33864,3,3864,[318 515 427 185 313],655,5,15709,4.064424320827943,40.0,0.0
33865,3,3865,[318 515 427 185 313],655,5,15714,4.064666321779617,40.0,0.0
33866,3,3866,[234 195 181 385 357],23,3,15717,4.064391000775795,0.0,0.0
33867,3,3867,[  9 118  89 216  12],655,2,15719,4.063857290589452,0.0,0.0
33868,3,3868,[ 11   7 333  70 161],655,0,15719,4.062806926854484,0.0,0.0
33869,3,3869,[318 515 427 185 313],655,5,15724,4.063049095607235,40.0,0.0
33870,3,3870,[195   8 357  12 288],655,1,15725,4.062257814518213,0.0,0.0
33871,3,3871,[ 15 318 275 483 204],655,3,15728,4.06198347107438,20.0,20.0
33872,3,3872,[403 161 483 191 257],796,5,15733,4.062225664859282,0.0,0.0
33873,3,3873,[318 515 427 185 313],655,5,15738,4.062467733608673,40.0,0.0
33874,3,3874,[  9 234 151 174 216],796,3,15741,4.062193548387096,0.0,0.0
33875,3,3875,[546   4 100 196 235],450,3,15744,4.061919504643963,0.0,20.0
33876,3,3876,[318 515 427 185 313],655,5,15749,4.062161465050297,40.0,0.0
33877,3,3877,[318 515 427 185 313],655,5,15754,4.062403300670448,40.0,0.0
33878,3,3878,[ 69   7 588 228 111],577,3,15757,4.062129414797628,0.0,0.0
33879,3,3879,[245 508 200 125 588],280,2,15759,4.06159793814433,0.0,0.0
33880,3,3880,[ 64  70 200 204 181],151,4,15763,4.061582066477712,20.0,0.0
33881,3,3881,[318 515 427 185 313],655,5,15768,4.061823802163833,40.0,0.0
33882,3,3882,[318 515 427 185 313],655,5,15773,4.062065413340201,40.0,0.0
33883,3,3883,[318 515 427 185 313],655,5,15778,4.062306900102986,40.0,0.0
33884,3,3884,[294 228  88 143 191],716,5,15783,4.062548262548263,0.0,0.0
33885,3,3885,[357  88  28 186 318],786,5,15788,4.062789500772002,20.0,0.0
33886,3,3886,[204 496 202 182 286],18,3,15791,4.062516079238487,20.0,20.0
33887,3,3887,[210 282 143 111  88],796,4,15795,4.0625,0.0,0.0
33888,3,3888,[111 174 216 215 191],151,3,15798,4.0622267935201855,0.0,0.0
33889,3,3889,[100 125 176 318 405],280,1,15799,4.061439588688946,20.0,20.0
33890,3,3890,[318 515 427 185 313],655,5,15804,4.061680801850424,40.0,0.0
33891,3,3891,[187 127 125 258  88],796,5,15809,4.0619218910585815,0.0,20.0
33892,3,3892,[127  25  56  11 200],655,2,15811,4.061392242486514,0.0,20.0
33893,3,3893,[288 294  56 204  64],457,4,15815,4.061376476630714,20.0,0.0
33894,3,3894,[127 197  71 322 546],280,4,15819,4.061360718870347,0.0,20.0
33895,3,3895,[ 89 742  12  22 194],457,5,15824,4.061601642710472,0.0,0.0
33896,3,3896,[318 515 427 185 313],655,5,15829,4.061842442904799,40.0,0.0
33897,3,3897,[210  69 588 282 318],401,2,15831,4.061313494099538,20.0,0.0
33898,3,3898,[318 515 427 185 313],655,5,15836,4.061554244678122,40.0,0.0
33899,3,3899,[318 515 427 185 313],655,5,15841,4.061794871794872,40.0,0.0
33900,3,3900,[ 56  89 403 151 127],256,4,15845,4.061779031017688,0.0,20.0
33901,3,3901,[318 515 427 185 313],655,5,15850,4.062019477191184,40.0,0.0
33902,3,3902,[211 196 144  79 172],23,3,15853,4.061747373815014,0.0,0.0
33903,3,3903,[318 515 427 185 313],655,5,15858,4.061987704918033,40.0,0.0
33904,3,3904,[318 515 427 185 313],655,5,15863,4.062227912932138,40.0,0.0
33905,3,3905,[588  56 211 179 603],450,5,15868,4.0624679979518685,20.0,0.0
33906,3,3906,[228 185 197 300 742],655,1,15869,4.061684156641925,0.0,0.0
33907,3,3907,[ 82 655 186 100 328],151,2,15871,4.061156601842375,0.0,20.0
33908,3,3908,[ 28 185   4 125 118],151,4,15875,4.061140956766437,0.0,0.0
33909,3,3909,[181  70 496 121  15],593,5,15880,4.061381074168798,20.0,0.0
33910,3,3910,[318 515 427 185 313],655,5,15885,4.061621068780363,40.0,0.0
33911,3,3911,[318 515 427 185 313],655,5,15890,4.061860940695296,40.0,0.0
33912,3,3912,[318 515 427 185 313],655,5,15895,4.062100690007667,40.0,0.0
33913,3,3913,[318 515 427 185 313],655,5,15900,4.062340316811446,40.0,0.0
33914,3,3914,[318 515 427 185 313],655,5,15905,4.062579821200511,40.0,0.0
33915,3,3915,[216 748 385  79 172],280,3,15908,4.0623084780388155,0.0,0.0
33916,3,3916,[ 89 121 301 210 111],344,4,15912,4.062292570845035,0.0,0.0
33917,3,3917,[318 515 427 185 313],655,5,15917,4.06253190403267,40.0,0.0
33918,3,3918,[265 168 202 597 282],450,5,15922,4.062771115080378,0.0,0.0
33919,3,3919,[175  56 275 435 132],655,1,15923,4.061989795918367,0.0,20.0
33920,3,3920,[318 515 427 185 313],655,5,15928,4.062229023208365,40.0,0.0
33921,3,3921,[ 50 173 202 168 181],151,5,15933,4.062468128505865,0.0,20.0
33922,3,3922,[186  28 357 265 318],450,4,15937,4.062452204945195,20.0,0.0
33923,3,3923,[318 515 427 185 313],655,5,15942,4.062691131498471,40.0,0.0
33924,3,3924,[318 515 427 185 313],655,5,15947,4.062929936305732,40.0,0.0
33925,3,3925,[318 515 427 185 313],655,5,15952,4.0631686194600105,40.0,0.0
33926,3,3926,[204 187  98 182 210],450,4,15956,4.0631525337407695,0.0,0.0
33927,3,3927,[748 185  89 322   4],450,4,15960,4.063136456211812,0.0,0.0
33928,3,3928,[216 195 496 196 121],786,4,15964,4.0631203868668875,20.0,0.0
33929,3,3929,[318 515 427 185 313],655,5,15969,4.063358778625954,40.0,0.0
33930,3,3930,[275 235 151 322 216],401,2,15971,4.062833884507759,0.0,20.0
33931,3,3931,[318 515 427 185 313],655,5,15976,4.063072227873856,40.0,0.0
33932,3,3932,[318 515 427 185 313],655,5,15981,4.063310450038139,40.0,0.0
33933,3,3933,[275 435 118  95 161],756,0,15981,4.062277580071174,0.0,20.0
33934,3,3934,[318 515 427 185 313],655,5,15986,4.062515883100382,40.0,0.0
33935,3,3935,[318 515 427 185 313],655,5,15991,4.06275406504065,40.0,0.0
33936,3,3936,[168 568 423 202 194],269,3,15994,4.0624841249682495,0.0,0.0
33937,3,3937,[318 515 427 185 313],655,5,15999,4.06272219400711,40.0,0.0
33938,3,3938,[ 69 294 357 127 172],796,4,16003,4.0627062706270625,0.0,20.0
33939,3,3939,[176 300 483 194 143],716,4,16007,4.062690355329949,0.0,0.0
33940,3,3940,[318 515 427 185 313],655,5,16012,4.062928190814514,40.0,0.0
33941,3,3941,[186 161  71 121  69],504,4,16016,4.062912227295789,0.0,0.0
33942,3,3942,[318 515 427 185 313],655,5,16021,4.0631498858737,40.0,0.0
33943,3,3943,[655  56 185 183 197],269,4,16025,4.063133874239351,0.0,0.0
33944,3,3944,[135 174  50 234  79],18,3,16028,4.062864385297845,0.0,20.0
33945,3,3945,[318 515 427 185 313],655,5,16033,4.063101875316777,40.0,0.0
33946,3,3946,[118 294 195 197 228],457,4,16037,4.063085888016215,0.0,0.0
33947,3,3947,[318 515 427 185 313],655,5,16042,4.063323201621074,40.0,0.0
33948,3,3948,[318 515 427 185 313],655,5,16047,4.063560395036718,40.0,0.0
33949,3,3949,[318 515 427 185 313],655,5,16052,4.06379746835443,40.0,0.0
33950,3,3950,[ 50  89 135 403 385],655,3,16055,4.06352822070362,0.0,20.0
33951,3,3951,[313  11 197 282  97],693,4,16059,4.063512145748988,0.0,0.0
33952,3,3952,[318 515 427 185 313],655,5,16064,4.063749051353403,40.0,0.0
33953,3,3953,[318 515 427 185 313],655,5,16069,4.06398583712696,40.0,0.0
33954,3,3954,[427 302 151 423 200],269,4,16073,4.063969658659924,20.0,0.0
33955,3,3955,[200 427 194 174  15],835,5,16078,4.064206268958544,20.0,0.0
33956,3,3956,[318 515 427 185 313],655,5,16083,4.064442759666414,40.0,0.0
33957,3,3957,[187  70 202 127 234],716,4,16087,4.064426478019201,0.0,20.0
33958,3,3958,[318 515 427 185 313],655,5,16092,4.064662793634756,40.0,0.0
33959,3,3959,[318 515 427 185 313],655,5,16097,4.06489898989899,40.0,0.0
33960,3,3960,[318 515 427 185 313],655,5,16102,4.065135066902298,40.0,0.0
33961,3,3961,[318 515 427 185 313],655,5,16107,4.065371024734982,40.0,0.0
33962,3,3962,[435 144 294 168 211],450,5,16112,4.0656068634872575,0.0,0.0
33963,3,3963,[318 515 427 185 313],655,5,16117,4.0658425832492435,40.0,0.0
33964,3,3964,[318 515 427 185 313],655,5,16122,4.066078184110971,40.0,0.0
33965,3,3965,[515 175 427 197 100],269,5,16127,4.06631366616238,20.0,20.0
33966,3,3966,[318 515 427 185 313],655,5,16132,4.06654902949332,40.0,0.0
33967,3,3967,[318 515 427 185 313],655,5,16137,4.066784274193548,40.0,0.0
33968,3,3968,[318 515 427 185 313],655,5,16142,4.067019400352733,40.0,0.0
33969,3,3969,[196 168 172 127 121],796,5,16147,4.067254408060453,0.0,20.0
33970,3,3970,[318 515 427 185 313],655,5,16152,4.067489297406195,40.0,0.0
33971,3,3971,[  7  50  25 271 143],655,2,16154,4.066968781470292,0.0,20.0
33972,3,3972,[318 515 427 185 313],655,5,16159,4.067203624465139,40.0,0.0
33973,3,3973,[ 56 187  22 127  97],655,2,16161,4.0666834423754405,0.0,20.0
33974,3,3974,[318 515 427 185 313],655,5,16166,4.06691823899371,40.0,0.0
33975,3,3975,[318 515 427 185 313],655,5,16171,4.06715291750503,40.0,0.0
33976,3,3976,[ 88  28 211  69 357],504,4,16175,4.067136032185064,0.0,0.0
33977,3,3977,[471 176 161 195 322],786,4,16179,4.067119155354449,0.0,0.0
33978,3,3978,[294 385  95 405 546],716,3,16182,4.066850967579794,0.0,0.0
33979,3,3979,[318 515 427 185 313],655,5,16187,4.067085427135678,40.0,0.0
33980,3,3980,[318 515 427 185 313],655,5,16192,4.067319768902286,40.0,0.0
33981,3,3981,[100 282 153 127 300],292,5,16197,4.0675539929683575,0.0,40.0
33982,3,3982,[318 515 427 185 313],655,5,16202,4.067788099422546,40.0,0.0
33983,3,3983,[282 655  98 135  69],450,4,16206,4.067771084337349,0.0,0.0
33984,3,3984,[111 234  25 215  64],151,4,16210,4.067754077791719,20.0,0.0
33985,3,3985,[265 144 655 300 111],655,0,16210,4.066733567486201,0.0,0.0
33986,3,3986,[301 195 197 483 237],655,1,16211,4.065964384248809,0.0,0.0
33987,3,3987,[313 237 132  28  88],655,1,16212,4.0651955867602805,0.0,0.0
33988,3,3988,[117 238 282  97 168],457,5,16217,4.065429932313863,0.0,0.0
33989,3,3989,[318 515 427 185 313],655,5,16222,4.065664160401003,40.0,0.0
33990,3,3990,[318 515 427 185 313],655,5,16227,4.065898271109997,40.0,0.0
33991,3,3991,[318 515 427 185 313],655,5,16232,4.066132264529058,40.0,0.0
33992,3,3992,[318 515 427 185 313],655,5,16237,4.066366140746306,40.0,0.0
33993,3,3993,[  7 333  50 286  70],655,1,16238,4.0655983975963945,0.0,40.0
33994,3,3994,[202  28 742 313 496],577,5,16243,4.065832290362954,20.0,0.0
33995,3,3995,[ 71 328 172  79  50],796,5,16248,4.066066066066066,0.0,20.0
33996,3,3996,[197 300 427 546  50],796,4,16252,4.066049537152865,20.0,20.0
33997,3,3997,[318 515 427 185 313],655,5,16257,4.066283141570786,40.0,0.0
33998,3,3998,[318 515 427 185 313],655,5,16262,4.066516629157289,40.0,0.0
33999,3,3999,[111 385 275 568 235],457,3,16265,4.06625,0.0,20.0
34000,3,4000,[328 471 435  97 168],401,4,16269,4.06623344163959,0.0,0.0
34001,3,4001,[234 174  64 215   1],72,5,16274,4.066466766616692,20.0,0.0
34002,3,4002,[ 96 237  79 603 275],450,5,16279,4.066699975018736,20.0,20.0
34003,3,4003,[238 385  56  15   4],457,5,16284,4.066933066933067,0.0,0.0
34004,3,4004,[118  88  22 318 275],450,4,16288,4.066916354556804,20.0,20.0
34005,3,4005,[318 515 427 185 313],655,5,16293,4.067149276085871,40.0,0.0
34006,3,4006,[318 515 427 185 313],655,5,16298,4.067382081357624,40.0,0.0
34007,3,4007,[318 515 427 185 313],655,5,16303,4.067614770459082,40.0,0.0
34008,3,4008,[294 257  88 135  69],401,1,16304,4.066849588426042,0.0,0.0
34009,3,4009,[197  98 300 216 655],151,5,16309,4.067082294264339,0.0,0.0
34010,3,4010,[742  96   1 588 179],577,4,16313,4.067065569683371,0.0,0.0
34011,3,4011,[318 515 427 185 313],655,5,16318,4.067298105682951,40.0,0.0
34012,3,4012,[318 515 427 185 313],655,5,16323,4.067530525791178,40.0,0.0
34013,3,4013,[174 313 135  22   1],655,2,16325,4.067015445939213,0.0,0.0
34014,3,4014,[318 515 427 185 313],655,5,16330,4.0672478206724785,40.0,0.0
34015,3,4015,[318 515 427 185 313],655,5,16335,4.067480079681275,40.0,0.0
34016,3,4016,[127 143 427 508 515],655,4,16339,4.067463281055514,20.0,20.0
34017,3,4017,[ 25  56 435 173  71],450,3,16342,4.0671976107516175,0.0,0.0
34018,3,4018,[228 385 191 265 196],655,1,16343,4.066434436426972,0.0,0.0
34019,3,4019,[318 515 427 185 313],655,5,16348,4.066666666666666,40.0,0.0
34020,3,4020,[568 182 186  50 508],655,2,16350,4.066152698333748,0.0,20.0
34021,3,4021,[301 135  82 191 435],450,3,16353,4.065887618100447,0.0,0.0
34022,3,4022,[318 515 427 185 313],655,5,16358,4.066119811086254,40.0,0.0
34023,3,4023,[318 515 427 185 313],655,5,16363,4.066351888667992,40.0,0.0
34024,3,4024,[174  12  79   9 288],256,5,16368,4.066583850931677,0.0,0.0
34025,3,4025,[153  22 127 216 204],18,4,16372,4.066567312468952,0.0,20.0
34026,3,4026,[175 151 183  64  50],457,5,16377,4.066799106034269,20.0,20.0
34027,3,4027,[ 69  50 176 318 151],269,2,16379,4.066285998013902,20.0,20.0
34028,3,4028,[ 70 282   1 508  64],401,1,16380,4.065524944154877,20.0,0.0
34029,3,4029,[318 515 427 185 313],655,5,16385,4.0657568238213395,40.0,0.0
34030,3,4030,[ 64 144 191 197  50],655,3,16388,4.065492433639295,20.0,20.0
34031,3,4031,[385 180 403  88 187],450,5,16393,4.0657242063492065,0.0,0.0
34032,3,4032,[175 215 496 515 546],716,3,16396,4.065459955368212,20.0,0.0
34033,3,4033,[318 515 427 185 313],655,5,16401,4.065691621219633,40.0,0.0
34034,3,4034,[172 546  88  79 200],593,4,16405,4.065675340768277,0.0,0.0
34035,3,4035,[318 515 427 185 313],655,5,16410,4.065906838453915,40.0,0.0
34036,3,4036,[318 515 427 185 313],655,5,16415,4.066138221451573,40.0,0.0
34037,3,4037,[318 515 427 185 313],655,5,16420,4.066369489846458,40.0,0.0
34038,3,4038,[143 515  71 187 111],18,4,16424,4.066353057687547,0.0,0.0
34039,3,4039,[318 515 427 185 313],655,5,16429,4.066584158415842,40.0,0.0
34040,3,4040,[318 515 427 185 313],655,5,16434,4.066815144766147,40.0,0.0
34041,3,4041,[176  69   9  25 121],504,4,16438,4.066798614547253,0.0,0.0
34042,3,4042,[282 151  15  25   7],450,3,16441,4.066534751422211,0.0,0.0
34043,3,4043,[318 515 427 185 313],655,5,16446,4.066765578635015,40.0,0.0
34044,3,4044,[318 515 427 185 313],655,5,16451,4.066996291718171,40.0,0.0
34045,3,4045,[245 546 117 597 143],450,5,16456,4.067226890756302,0.0,0.0
34046,3,4046,[100 144   9 191 275],629,4,16460,4.067210279219175,0.0,40.0
34047,3,4047,[318 515 427 185 313],655,5,16465,4.06744071146245,40.0,0.0
34048,3,4048,[180   1  79 471 153],535,3,16468,4.067177080760682,0.0,0.0
34049,3,4049,[318 515 427 185 313],655,5,16473,4.067407407407408,40.0,0.0
34050,3,4050,[318 515 427 185 313],655,5,16478,4.067637620340657,40.0,0.0
34051,3,4051,[318 515 427 185 313],655,5,16483,4.06786771964462,40.0,0.0
34052,3,4052,[ 89 546 153   1 144],796,4,16487,4.067850974586726,0.0,0.0
34053,3,4053,[318 515 427 185 313],655,5,16492,4.068080907745436,40.0,0.0
34054,3,4054,[318 515 427 185 313],655,5,16497,4.068310727496917,40.0,0.0
34055,3,4055,[125 216 568 186 271],655,1,16498,4.067554240631163,0.0,0.0
34056,3,4056,[318 515 427 185 313],655,5,16503,4.0677840769041165,40.0,0.0
34057,3,4057,[211 118 357 191  82],716,4,16507,4.067767373090192,0.0,0.0
34058,3,4058,[132  97 117 125 588],457,5,16512,4.0679970436068,0.0,0.0
34059,3,4059,[ 69 234  64  96 597],457,4,16516,4.067980295566502,20.0,0.0
34060,3,4060,[403 385   8 546 423],796,5,16521,4.068209800541738,0.0,0.0
34061,3,4061,[318 515 427 185 313],655,5,16526,4.068439192516002,40.0,0.0
34062,3,4062,[318 515 427 185 313],655,5,16531,4.06866847157273,40.0,0.0
34063,3,4063,[318 515 427 185 313],655,5,16536,4.068897637795276,40.0,0.0
34064,3,4064,[318 515 427 185 313],655,5,16541,4.069126691266913,40.0,0.0
34065,3,4065,[318 515 427 185 313],655,5,16546,4.069355632070831,40.0,0.0
34066,3,4066,[318 515 427 185 313],655,5,16551,4.06958446029014,40.0,0.0
34067,3,4067,[135 187 385 403 423],655,2,16553,4.069075712881022,0.0,0.0
34068,3,4068,[132 228 403  50 197],280,1,16554,4.068321454902924,0.0,20.0
34069,3,4069,[318 515 427 185 313],655,5,16559,4.068550368550368,40.0,0.0
34070,3,4070,[237  28 204 187 546],716,3,16562,4.068287889953329,0.0,0.0
34071,3,4071,[318 515 427 185 313],655,5,16567,4.068516699410609,40.0,0.0
34072,3,4072,[385 215 125 127 153],280,3,16570,4.0682543579671,0.0,20.0
34073,3,4073,[318 515 427 185 313],655,5,16575,4.068483063328424,40.0,0.0
34074,3,4074,[318 515 427 185 313],655,5,16580,4.068711656441717,40.0,0.0
34075,3,4075,[216 144 191 211 196],716,4,16584,4.068694798822375,0.0,0.0
34076,3,4076,[318 515 427 185 313],655,5,16589,4.068923227863626,40.0,0.0
34077,3,4077,[197 301 168 403 748],450,5,16594,4.069151544874939,0.0,0.0
34078,3,4078,[318 121 286 111   8],593,4,16598,4.069134591811719,20.0,20.0
34079,3,4079,[ 95 172 183 228 222],796,5,16603,4.069362745098039,0.0,0.0
34080,3,4080,[318 515 427 185 313],655,5,16608,4.0695907865719185,40.0,0.0
34081,3,4081,[ 50 175 197 210 265],151,5,16613,4.069818716315532,0.0,20.0
34082,3,4082,[ 15 301 100 423 143],593,5,16618,4.070046534410972,0.0,20.0
34083,3,4083,[318 515 427 185 313],655,5,16623,4.070274240940255,40.0,0.0
34084,3,4084,[275 423 237  15 153],655,1,16624,4.06952264381885,0.0,20.0
34085,3,4085,[318 515 427 185 313],655,5,16629,4.069750367107195,40.0,0.0
34086,3,4086,[318 515 427 185 313],655,5,16634,4.069977978957671,40.0,0.0
34087,3,4087,[202  97  64  96 196],577,5,16639,4.070205479452055,20.0,0.0
34088,3,4088,[135 318 132 100 322],450,4,16643,4.070188310100269,20.0,20.0
34089,3,4089,[313 275 118 121 204],344,2,16645,4.069682151589242,0.0,20.0
34090,3,4090,[318 515 427 185 313],655,5,16650,4.069909557565388,40.0,0.0
34091,3,4091,[185 210 202 282 588],796,4,16654,4.06989247311828,0.0,0.0
34092,3,4092,[318 515 427 185 313],655,5,16659,4.070119716589299,40.0,0.0
34093,3,4093,[318 515 427 185 313],655,5,16664,4.070346849047387,40.0,0.0
34094,3,4094,[318 515 427 185 313],655,5,16669,4.07057387057387,40.0,0.0
34095,3,4095,[483 222 546 294   4],716,3,16672,4.0703125,0.0,0.0
34096,3,4096,[125 153 405 748  50],280,1,16673,4.069563094947522,0.0,20.0
34097,3,4097,[318 515 427 185 313],655,5,16678,4.069790141532454,40.0,0.0
34098,3,4098,[318 515 427 185 313],655,5,16683,4.070017077335936,40.0,0.0
34099,3,4099,[318 515 427 185 313],655,5,16688,4.0702439024390245,40.0,0.0
34100,3,4100,[318 215 385 186  22],450,4,16692,4.070226773957572,20.0,0.0
34101,3,4101,[ 15 211  98 234 121],151,5,16697,4.070453437347635,0.0,0.0
34102,3,4102,[318 515 427 185 313],655,5,16702,4.070679990251036,40.0,0.0
34103,3,4103,[187 202 127 318 328],450,5,16707,4.070906432748538,20.0,20.0
34104,3,4104,[318 515 427 185 313],655,5,16712,4.071132764920828,40.0,0.0
34105,3,4105,[210  22 135 168 294],450,3,16715,4.070871894788115,0.0,0.0
34106,3,4106,[318 515 427 185 313],655,5,16720,4.071098125152179,40.0,0.0
34107,3,4107,[318 515 427 185 313],655,5,16725,4.071324245374878,40.0,0.0
34108,3,4108,[302 508 132 269  96],344,5,16730,4.071550255536627,0.0,0.0
34109,3,4109,[210  95 186 235 328],450,1,16731,4.070802919708029,0.0,0.0
34110,3,4110,[318 515 427 185 313],655,5,16736,4.07102894672829,40.0,0.0
34111,3,4111,[143  64 222 515 204],655,3,16739,4.070768482490273,20.0,0.0
34112,3,4112,[318 515 427 185 313],655,5,16744,4.070994407974714,40.0,0.0
34113,3,4113,[318 515 427 185 313],655,5,16749,4.071220223626641,40.0,0.0
34114,3,4114,[204 118 237  70   1],280,2,16751,4.070716889428919,0.0,0.0
34115,3,4115,[318 515 427 185 313],655,5,16756,4.070942662779397,40.0,0.0
34116,3,4116,[318 515 427 185 313],655,5,16761,4.0711683264513,40.0,0.0
34117,3,4117,[318 515 427 185 313],655,5,16766,4.071393880524527,40.0,0.0
34118,3,4118,[435 508   7 172  28],655,1,16767,4.070648215586307,0.0,0.0
34119,3,4119,[405 322 275 202 179],786,4,16771,4.070631067961165,0.0,20.0
34120,3,4120,[471  22 655 118 286],450,4,16775,4.0706139286580925,0.0,20.0
34121,3,4121,[318 515 427 185 313],655,5,16780,4.070839398350316,40.0,0.0
34122,3,4122,[ 89 132 508 603  50],655,3,16783,4.070579674993937,20.0,20.0
34123,3,4123,[318 515 427 185 313],655,5,16788,4.070805043646945,40.0,0.0
34124,3,4124,[471 183 322 588 180],450,5,16793,4.071030303030303,0.0,0.0
34125,3,4125,[318 515 427 185 313],655,5,16798,4.071255453223461,40.0,0.0
34126,3,4126,[318 515 427 185 313],655,5,16803,4.071480494305791,40.0,0.0
34127,3,4127,[588 117 204   7 403],280,3,16806,4.071220930232558,0.0,0.0
34128,3,4128,[318 515 427 185 313],655,5,16811,4.071445870670865,40.0,0.0
34129,3,4129,[  9 153  95 181 132],796,4,16815,4.071428571428571,0.0,0.0
34130,3,4130,[98 79 88  1 50],562,4,16819,4.071411280561607,0.0,20.0
34131,3,4131,[742 111  89   8  96],457,4,16823,4.071393998063892,0.0,0.0
34132,3,4132,[318 515 427 185 313],655,5,16828,4.07161867892572,40.0,0.0
34133,3,4133,[423 403 191 427 200],450,4,16832,4.071601354620222,20.0,0.0
34134,3,4134,[318 515 427 185 313],655,5,16837,4.071825876662636,40.0,0.0
34135,3,4135,[172  25 237  64 161],256,4,16841,4.071808510638298,20.0,0.0
34136,3,4136,[197 496  88 100 546],151,3,16844,4.071549431955523,20.0,20.0
34137,3,4137,[318 515 427 185 313],655,5,16849,4.071773803769937,40.0,0.0
34138,3,4138,[568 210 215 286 471],655,0,16849,4.070790045904808,0.0,20.0
34139,3,4139,[318 515 427 185 313],655,5,16854,4.071014492753624,40.0,0.0
34140,3,4140,[132 302 202 318 161],269,2,16856,4.070514368510022,20.0,0.0
34141,3,4141,[318 515 427 185 313],655,5,16861,4.070738773539353,40.0,0.0
34142,3,4142,[318 515 427 185 313],655,5,16866,4.070963070238958,40.0,0.0
34143,3,4143,[318 515 427 185 313],655,5,16871,4.071187258687258,40.0,0.0
34144,3,4144,[318 515 427 185 313],655,5,16876,4.071411338962606,40.0,0.0
34145,3,4145,[ 98 153  50 144 294],450,5,16881,4.071635311143271,0.0,20.0
34146,3,4146,[318 515 427 185 313],655,5,16886,4.071859175307451,40.0,0.0
34147,3,4147,[175 235  28 204  64],716,3,16889,4.071600771456123,20.0,0.0
34148,3,4148,[318 515 427 185 313],655,5,16894,4.071824536032779,40.0,0.0
34149,3,4149,[318 515 427 185 313],655,5,16899,4.072048192771084,40.0,0.0
34150,3,4150,[183 179 483 742 187],450,4,16903,4.0720308359431465,0.0,0.0
34151,3,4151,[132 568 151  28  82],796,3,16906,4.071772639691715,0.0,0.0
34152,3,4152,[ 56 100  97   1 210],885,3,16909,4.071514567782326,0.0,20.0
34153,3,4153,[655 125  69  88 132],151,5,16914,4.071738083774675,0.0,0.0
34154,3,4154,[211 234 515 269 182],655,2,16916,4.071239470517449,0.0,0.0
34155,3,4155,[318 515 427 185 313],655,5,16921,4.071462945139557,40.0,0.0
34156,3,4156,[ 98 385 182  79 118],256,5,16926,4.071686312244407,0.0,0.0
34157,3,4157,[195  69  98 655 597],269,2,16928,4.071188071188071,0.0,0.0
34158,3,4158,[742 210 216   1 180],457,5,16933,4.071411396970426,0.0,0.0
34159,3,4159,[405 132   4 117  25],655,0,16933,4.070432692307692,0.0,0.0
34160,3,4160,[318 515 427 185 313],655,5,16938,4.070656092285509,40.0,0.0
34161,3,4161,[318 515 427 185 313],655,5,16943,4.0708793849111,40.0,0.0
34162,3,4162,[318 515 427 185 313],655,5,16948,4.07110257026183,40.0,0.0
34163,3,4163,[357 435  71 187 100],535,3,16951,4.070845341018251,0.0,20.0
34164,3,4164,[318 515 427 185 313],655,5,16956,4.071068427370949,40.0,0.0
34165,3,4165,[318 515 427 185 313],655,5,16961,4.07129140662506,40.0,0.0
34166,3,4166,[318 515 427 185 313],655,5,16966,4.071514278857691,40.0,0.0
34167,3,4167,[ 98 127 276 237 235],280,4,16970,4.071497120921305,0.0,20.0
34168,3,4168,[186  69 182   1 318],450,4,16974,4.071479971216119,20.0,0.0
34169,3,4169,[151  69  71 183  64],236,2,16976,4.0709832134292565,20.0,0.0
34170,3,4170,[588 118 322 176   8],796,4,16980,4.070966195157037,0.0,0.0
34171,3,4171,[318 515 427 185 313],655,5,16985,4.0711888782358585,40.0,0.0
34172,3,4172,[  7 288   9 216 435],655,1,16986,4.070452911574407,0.0,0.0
34173,3,4173,[258 655 191  97 197],65,4,16990,4.070436032582655,0.0,0.0
34174,3,4174,[318 515 427 185 313],655,5,16995,4.070658682634731,40.0,0.0
34175,3,4175,[318 515 427 185 313],655,5,17000,4.07088122605364,40.0,0.0
34176,3,4176,[127 202 182 405 333],796,5,17005,4.071103662915968,0.0,20.0
34177,3,4177,[318 515 427 185 313],655,5,17010,4.071325993298228,40.0,0.0
34178,3,4178,[191  22 211  96 385],716,3,17013,4.071069633883704,0.0,0.0
34179,3,4179,[172 568 302 191 603],655,4,17017,4.071052631578947,20.0,0.0
34180,3,4180,[222 269  96  89 215],450,4,17021,4.071035637407319,0.0,0.0
34181,3,4181,[161 546 655 238  70],716,3,17024,4.070779531324725,0.0,0.0
34182,3,4182,[318 515 427 185 313],655,5,17029,4.071001673440115,40.0,0.0
34183,3,4183,[318 515 427 185 313],655,5,17034,4.071223709369025,40.0,0.0
34184,3,4184,[ 79 132 385 742 200],796,4,17038,4.071206690561529,0.0,0.0
34185,3,4185,[215 748 405 143 357],151,2,17040,4.070711896798853,0.0,0.0
34186,3,4186,[318 515 427 185 313],655,5,17045,4.070933842846907,40.0,0.0
34187,3,4187,[318 515 427 185 313],655,5,17050,4.071155682903534,40.0,0.0
34188,3,4188,[275   8 435  82 211],655,1,17051,4.070422535211268,0.0,20.0
34189,3,4189,[318 515 427 185 313],655,5,17056,4.0706443914081145,40.0,0.0
34190,3,4190,[ 95   4  98 153 118],389,2,17058,4.070150322118826,0.0,0.0
34191,3,4191,[318 515 427 185 313],655,5,17063,4.07037213740458,40.0,0.0
34192,3,4192,[318 515 427 185 313],655,5,17068,4.07059384688767,40.0,0.0
34193,3,4193,[318 515 427 185 313],655,5,17073,4.070815450643777,40.0,0.0
34194,3,4194,[318 515 427 185 313],655,5,17078,4.07103694874851,40.0,0.0
34195,3,4195,[173  95  96 427 603],23,5,17083,4.0712583412774075,40.0,0.0
34196,3,4196,[173 172 265  82 423],716,5,17088,4.071479628305933,0.0,0.0
34197,3,4197,[318 515 427 185 313],655,5,17093,4.071700809909481,40.0,0.0
34198,3,4198,[318 515 427 185 313],655,5,17098,4.071921886163373,40.0,0.0
34199,3,4199,[204  70 197  97  25],523,5,17103,4.0721428571428575,0.0,0.0
34200,3,4200,[385 100 234 655  70],504,3,17106,4.071887645798619,0.0,20.0
34201,3,4201,[286 258 333 603 265],796,4,17110,4.071870537839124,20.0,20.0
34202,3,4202,[318 515 427 185 313],655,5,17115,4.0720913633119205,40.0,0.0
34203,3,4203,[318 515 427 185 313],655,5,17120,4.0723120837297815,40.0,0.0
34204,3,4204,[318 515 427 185 313],655,5,17125,4.072532699167658,40.0,0.0
34205,3,4205,[318 515 427 185 313],655,5,17130,4.072753209700428,40.0,0.0
34206,3,4206,[ 88 191 179  70  11],457,5,17135,4.0729736154029,0.0,0.0
34207,3,4207,[187 127 196 568 125],450,5,17140,4.07319391634981,0.0,20.0
34208,3,4208,[318 515 427 185 313],655,5,17145,4.073414112615823,40.0,0.0
34209,3,4209,[182 168 318 186 215],450,4,17149,4.073396674584323,20.0,0.0
34210,3,4210,[328 196 211 127 289],655,1,17150,4.072666824982189,0.0,20.0
34211,3,4211,[ 22 275 357  11 121],450,4,17154,4.072649572649572,0.0,20.0
34212,3,4212,[318 515 427 185 313],655,5,17159,4.072869689057678,40.0,0.0
34213,3,4213,[435 222 268  69 183],655,1,17160,4.072140484100617,0.0,0.0
34214,3,4214,[186 546 748  69 597],450,4,17164,4.072123368920522,0.0,0.0
34215,3,4215,[181 471  82  56  22],577,3,17167,4.071869070208729,0.0,0.0
34216,3,4216,[588 176 568 185 191],457,5,17172,4.072089162912023,0.0,0.0
34217,3,4217,[318 515 427 185 313],655,5,17177,4.07230915125652,40.0,0.0
34218,3,4218,[318 515 427 185 313],655,5,17182,4.072529035316426,40.0,0.0
34219,3,4219,[318 515 427 185 313],655,5,17187,4.072748815165877,40.0,0.0
34220,3,4220,[258 196 385 143 174],796,5,17192,4.072968490878939,0.0,0.0
34221,3,4221,[318 515 427 185 313],655,5,17197,4.073188062529606,40.0,0.0
34222,3,4222,[ 28 282 132  70   1],450,5,17202,4.0734075301918065,0.0,0.0
34223,3,4223,[318 515 427 185 313],655,5,17207,4.073626893939394,40.0,0.0
34224,3,4224,[265 322 181 222 234],151,4,17211,4.073609467455621,0.0,0.0
34225,3,4225,[318 515 427 185 313],655,5,17216,4.073828679602461,40.0,0.0
34226,3,4226,[318 515 427 185 313],655,5,17221,4.074047788029335,40.0,0.0
34227,3,4227,[ 15 100  64  11 182],655,2,17223,4.073557237464522,20.0,20.0
34228,3,4228,[318 515 427 185 313],655,5,17228,4.073776306455427,40.0,0.0
34229,3,4229,[100   1   9  98 222],457,5,17233,4.073995271867612,0.0,20.0
34230,3,4230,[318 515 427 185 313],655,5,17238,4.074214133774522,40.0,0.0
34231,3,4231,[  7 588  15  95 127],450,3,17241,4.073960302457467,0.0,20.0
34232,3,4232,[187 194 191 282  28],450,5,17246,4.074179069218049,0.0,0.0
34233,3,4233,[  4 200 234 186  98],655,2,17248,4.0736891828058575,0.0,0.0
34234,3,4234,[318 515 427 185 313],655,5,17253,4.073907910271546,40.0,0.0
34235,3,4235,[ 98 288 179  28 181],504,3,17256,4.073654390934844,0.0,0.0
34236,3,4236,[318 515 427 185 313],655,5,17261,4.073873023365588,40.0,0.0
34237,3,4237,[318 515 427 185 313],655,5,17266,4.07409155261916,40.0,0.0
34238,3,4238,[204   1 187 423 568],716,4,17270,4.074074074074074,0.0,0.0
34239,3,4239,[135 405 403  69  79],450,4,17274,4.074056603773585,0.0,0.0
34240,3,4240,[318 515 427 185 313],655,5,17279,4.074274935156803,40.0,0.0
34241,3,4241,[125 276 173 508 294],280,1,17280,4.073550212164074,0.0,0.0
34242,3,4242,[403 202 237  12 121],655,0,17280,4.072590148479849,0.0,0.0
34243,3,4243,[288  70 143 508 357],655,2,17282,4.072101790763431,0.0,0.0
34244,3,4244,[ 95 483 288 588  88],280,4,17286,4.07208480565371,0.0,0.0
34245,3,4245,[318 515 427 185 313],655,5,17291,4.0723033443240695,40.0,0.0
34246,3,4246,[318 515 427 185 313],655,5,17296,4.072521780080057,40.0,0.0
34247,3,4247,[238  98 496 322   9],151,4,17300,4.072504708097928,20.0,0.0
34248,3,4248,[181 151 403 111 275],756,3,17303,4.0722522946575666,0.0,20.0
34249,3,4249,[742 183 237 151  64],796,4,17307,4.072235294117647,20.0,0.0
34250,3,4250,[ 25   1   8  11 238],593,2,17309,4.0717478240414025,0.0,0.0
34251,3,4251,[197 183  88 294 161],655,1,17310,4.0710253998118535,0.0,0.0
34252,3,4252,[318 515 427 185 313],655,5,17315,4.071243827886198,40.0,0.0
34253,3,4253,[318 515 427 185 313],655,5,17320,4.071462153267513,40.0,0.0
34254,3,4254,[ 28 234 194 111 100],457,4,17324,4.07144535840188,0.0,20.0
34255,3,4255,[318 515 427 185 313],655,5,17329,4.071663533834586,40.0,0.0
34256,3,4256,[318 515 427 185 313],655,5,17334,4.071881606765328,40.0,0.0
34257,3,4257,[471 215 228 403 100],577,3,17337,4.071629873179897,0.0,20.0
34258,3,4258,[318 515 427 185 313],655,5,17342,4.071847851608359,40.0,0.0
34259,3,4259,[132  79  95 302 196],450,4,17346,4.071830985915493,0.0,0.0
34260,3,4260,[318 515 427 185 313],655,5,17351,4.072048814832199,40.0,0.0
34261,3,4261,[286 204 174 289 181],655,0,17351,4.071093383388081,0.0,20.0
34262,3,4262,[318 515 427 185 313],655,5,17356,4.0713112831339435,40.0,0.0
34263,3,4263,[202  71 282 100 182],796,4,17360,4.071294559099437,0.0,20.0
34264,3,4264,[318 515 427 185 313],655,5,17365,4.071512309495897,40.0,0.0
34265,3,4265,[258  50 179   9 100],65,2,17367,4.071026722925457,0.0,40.0
34266,3,4266,[318 515 427 185 313],655,5,17372,4.071244434028592,40.0,0.0
34267,3,4267,[318 515 427 185 313],655,5,17377,4.071462043111528,40.0,0.0
34268,3,4268,[318 515 427 185 313],655,5,17382,4.0716795502459595,40.0,0.0
34269,3,4269,[237 127 603 546 301],450,5,17387,4.0718969555035125,20.0,20.0
34270,3,4270,[258 318 328  98 135],151,4,17391,4.071880121751346,20.0,0.0
34271,3,4271,[318 515 427 185 313],655,5,17396,4.072097378277154,40.0,0.0
34272,3,4272,[ 28 568 173 197 385],796,3,17399,4.071846477884391,0.0,0.0
34273,3,4273,[318 515 427 185 313],655,5,17404,4.072063640617689,40.0,0.0
34274,3,4274,[235  82 603  98 195],269,2,17406,4.071578947368421,20.0,0.0
34275,3,4275,[191 180 143  22 118],450,4,17410,4.07156220767072,0.0,0.0
34276,3,4276,[318 515 427 185 313],655,5,17415,4.071779284545242,40.0,0.0
34277,3,4277,[318 515 427 185 313],655,5,17420,4.071996259934549,40.0,0.0
34278,3,4278,[515 271  96 300 294],655,1,17421,4.0712783360598275,0.0,0.0
34279,3,4279,[318 515 427 185 313],655,5,17426,4.071495327102804,40.0,0.0
34280,3,4280,[ 64 183  11  25 238],457,5,17431,4.0717122167717825,20.0,0.0
34281,3,4281,[ 89 211 196 216  69],786,5,17436,4.071929005137786,0.0,0.0
34282,3,4282,[318 515 427 185 313],655,5,17441,4.072145692271772,40.0,0.0
34283,3,4283,[318 515 427 185 313],655,5,17446,4.072362278244631,40.0,0.0
34284,3,4284,[568 403 588 257 423],330,5,17451,4.072578763127188,0.0,0.0
34285,3,4285,[ 22 197  12 238 588],18,5,17456,4.072795146990201,0.0,0.0
34286,3,4286,[318 515 427 185 313],655,5,17461,4.073011429904362,40.0,0.0
34287,3,4287,[257 357 125 121 196],796,5,17466,4.073227611940299,0.0,0.0
34288,3,4288,[117 403 127 100 273],450,4,17470,4.073210538587083,0.0,40.0
34289,3,4289,[318 515 427 185 313],655,5,17475,4.073426573426573,40.0,0.0
34290,3,4290,[318 515 427 185 313],655,5,17480,4.073642507573992,40.0,0.0
34291,3,4291,[ 15 301 427 271 180],796,3,17483,4.073392357875116,20.0,0.0
34292,3,4292,[471  70  69 275  15],457,5,17488,4.0736081993943625,0.0,20.0
34293,3,4293,[302 275 475 288 191],655,3,17491,4.073358174196553,0.0,20.0
34294,3,4294,[275   1   9   4 276],593,1,17492,4.072642607683353,0.0,20.0
34295,3,4295,[318 515 427 185 313],655,5,17497,4.072858472998138,40.0,0.0
34296,3,4296,[117 180 483 200  98],716,4,17501,4.072841517337677,0.0,0.0
34297,3,4297,[135 195 222 655 211],716,3,17504,4.072591903210796,0.0,0.0
34298,3,4298,[ 82 183 132  12 144],280,2,17506,4.072109792975111,0.0,0.0
34299,3,4299,[318 515 427 185 313],655,5,17511,4.072325581395349,40.0,0.0
34300,3,4300,[301 288 496 222  15],450,2,17513,4.071843757265752,20.0,0.0
34301,3,4301,[ 89 176  98 161 238],269,2,17515,4.071362157136216,0.0,0.0
34302,3,4302,[318 515 427 185 313],655,5,17520,4.071577968858936,40.0,0.0
34303,3,4303,[ 89  95 161 265 144],450,4,17524,4.071561338289963,0.0,0.0
34304,3,4304,[288 276 245 405   4],593,2,17526,4.071080139372822,0.0,0.0
34305,3,4305,[318 515 427 185 313],655,5,17531,4.071295866233163,40.0,0.0
34306,3,4306,[276 172 475  15 194],296,4,17535,4.071279312746691,0.0,0.0
34307,3,4307,[194 118  25   7 423],577,3,17538,4.071030640668524,0.0,0.0
34308,3,4308,[318 515 427 185 313],655,5,17543,4.071246228823393,40.0,0.0
34309,3,4309,[318 515 427 185 313],655,5,17548,4.071461716937355,40.0,0.0
34310,3,4310,[132 187 111 435 282],655,1,17549,4.07074924611459,0.0,0.0
34311,3,4311,[180 275  79 100 294],338,4,17553,4.070732838589981,0.0,40.0
34312,3,4312,[318 515 427 185 313],655,5,17558,4.070948295849757,40.0,0.0
34313,3,4313,[301 176 748  56 568],450,5,17563,4.071163653222068,0.0,0.0
34314,3,4314,[318 515 427 185 313],655,5,17568,4.071378910776361,40.0,0.0
34315,3,4315,[318 515 427 185 313],655,5,17573,4.07159406858202,40.0,0.0
34316,3,4316,[318 515 427 185 313],655,5,17578,4.071809126708362,40.0,0.0
34317,3,4317,[204 161 597 216 153],23,2,17580,4.071329319129227,0.0,0.0
34318,3,4318,[318 515 427 185 313],655,5,17585,4.071544338967353,40.0,0.0
34319,3,4319,[318 515 427 185 313],655,5,17590,4.0717592592592595,40.0,0.0
34320,3,4320,[ 15  96  82  97 143],457,5,17595,4.071974080074057,0.0,0.0
34321,3,4321,[ 12 144 483 385 168],796,5,17600,4.072188801480796,0.0,0.0
34322,3,4322,[318 515 427 185 313],655,5,17605,4.072403423548462,40.0,0.0
34323,3,4323,[ 12   4 183 258 405],796,5,17610,4.072617946345976,0.0,0.0
34324,3,4324,[215   8 200   9 322],280,4,17614,4.072601156069364,0.0,0.0
34325,3,4325,[174 117  28 423 204],885,5,17619,4.072815533980583,0.0,0.0
34326,3,4326,[318 515 427 185 313],655,5,17624,4.073029812803328,40.0,0.0
34327,3,4327,[318 515 427 185 313],655,5,17629,4.073243992606285,40.0,0.0
34328,3,4328,[318 515 427 185 313],655,5,17634,4.073458073458074,40.0,0.0
34329,3,4329,[172 237 176 357  89],655,3,17637,4.073210161662818,0.0,0.0
34330,3,4330,[318 515 427 185 313],655,5,17642,4.073424151466174,40.0,0.0
34331,3,4331,[ 79 151 257 427 568],796,5,17647,4.073638042474608,20.0,0.0
34332,3,4332,[318 515 427 185 313],655,5,17652,4.073851834756519,40.0,0.0
34333,3,4333,[475 121  28 117 182],655,1,17653,4.073142593447162,0.0,0.0
34334,3,4334,[265 172 186 127 483],716,4,17657,4.073125720876586,0.0,20.0
34335,3,4335,[  1 496 125 121 143],593,4,17661,4.073108856088561,20.0,0.0
34336,3,4336,[318 515 427 185 313],655,5,17666,4.073322573207286,40.0,0.0
34337,3,4337,[176 204  69 435  22],269,0,17666,4.072383586906408,0.0,0.0
34338,3,4338,[483  12 197 234 172],151,5,17671,4.072597372666513,0.0,0.0
34339,3,4339,[318 515 427 185 313],655,5,17676,4.072811059907834,40.0,0.0
34340,3,4340,[318 515 427 185 313],655,5,17681,4.073024648698457,40.0,0.0
34341,3,4341,[289 275   9 132 405],786,5,17686,4.073238139106403,0.0,20.0
34342,3,4342,[168  79 318 603 385],450,5,17691,4.073451531199631,40.0,0.0
34343,3,4343,[318 515 427 185 313],655,5,17696,4.07366482504604,40.0,0.0
34344,3,4344,[118 210 132 175  25],344,4,17700,4.073647871116226,0.0,0.0
34345,3,4345,[215  98 185 403 282],796,5,17705,4.073861021629084,0.0,0.0
34346,3,4346,[ 69  11 238 144 276],593,4,17709,4.07384403036577,0.0,0.0
34347,3,4347,[318 515 427 185 313],655,5,17714,4.074057037718491,40.0,0.0
34348,3,4348,[ 50 153  96 181 268],296,5,17719,4.07426994711428,0.0,20.0
34349,3,4349,[318 515 427 185 313],655,5,17724,4.0744827586206895,40.0,0.0
34350,3,4350,[423 210  64  95 202],577,4,17728,4.07446564008274,20.0,0.0
34351,3,4351,[318 515 427 185 313],655,5,17733,4.074678308823529,40.0,0.0
34352,3,4352,[318 515 427 185 313],655,5,17738,4.074890879852975,40.0,0.0
34353,3,4353,[318 515 427 185 313],655,5,17743,4.075103353238402,40.0,0.0
34354,3,4354,[ 50 111 588  22 187],18,4,17747,4.075086107921929,0.0,20.0
34355,3,4355,[318 515 427 185 313],655,5,17752,4.075298438934802,40.0,0.0
34356,3,4356,[318 515 427 185 313],655,5,17757,4.075510672481065,40.0,0.0
34357,3,4357,[318 515 427 185 313],655,5,17762,4.075722808627811,40.0,0.0
34358,3,4358,[318 515 427 185 313],655,5,17767,4.075934847442074,40.0,0.0
34359,3,4359,[318 515 427 185 313],655,5,17772,4.076146788990826,40.0,0.0
34360,3,4360,[318 515 427 185 313],655,5,17777,4.076358633340977,40.0,0.0
34361,3,4361,[568 405 180  50 186],457,5,17782,4.076570380559376,0.0,20.0
34362,3,4362,[318 515 427 185 313],655,5,17787,4.076782030712812,40.0,0.0
34363,3,4363,[403 179 322  22 237],450,5,17792,4.076993583868011,0.0,0.0
34364,3,4364,[269  22 228 202 294],796,3,17795,4.076746849942726,0.0,0.0
34365,3,4365,[568 423 294  69  71],280,3,17798,4.076500229042602,0.0,0.0
34366,3,4366,[318 515 427 185 313],655,5,17803,4.07671170139684,40.0,0.0
34367,3,4367,[161 202 144 183 195],716,1,17804,4.076007326007326,0.0,0.0
34368,3,4368,[202 273 151 222 216],344,5,17809,4.076218814373998,0.0,0.0
34369,3,4369,[435  69 483 182 655],655,2,17811,4.075743707093822,0.0,0.0
34370,3,4370,[318 515 427 185 313],655,5,17816,4.0759551590025165,40.0,0.0
34371,3,4371,[111 191 194  22 211],11,4,17820,4.075937785910338,0.0,0.0
34372,3,4372,[182  69  79 143 357],655,4,17824,4.075920420763778,0.0,0.0
34373,3,4373,[176 435 216 271 172],655,2,17826,4.075445816186557,0.0,0.0
34374,3,4374,[196 286 385 405 172],401,1,17827,4.074742857142857,0.0,20.0
34375,3,4375,[318 515 427 185 313],655,5,17832,4.074954296160877,40.0,0.0
34376,3,4376,[204 100 655 385   1],593,3,17835,4.074708704592187,0.0,20.0
34377,3,4377,[ 97 127 174 180 183],457,5,17840,4.074920054819552,0.0,20.0
34378,3,4378,[318 515 427 185 313],655,5,17845,4.075131308517927,40.0,0.0
34379,3,4379,[318 515 427 185 313],655,5,17850,4.075342465753424,40.0,0.0
34380,3,4380,[318 515 427 185 313],655,5,17855,4.075553526592103,40.0,0.0
34381,3,4381,[ 50  98 127  56 200],796,5,17860,4.075764491099954,0.0,40.0
34382,3,4382,[176 328 238 143 111],151,3,17863,4.075519050878394,0.0,0.0
34383,3,4383,[597 204 180 194  70],11,2,17865,4.075045620437956,0.0,0.0
34384,3,4384,[ 88 546 172 357 187],786,5,17870,4.075256556442417,0.0,0.0
34385,3,4385,[318 515 427 185 313],655,5,17875,4.07546739626083,40.0,0.0
34386,3,4386,[318 515 427 185 313],655,5,17880,4.07567813995897,40.0,0.0
34387,3,4387,[301 204 427 300 215],796,4,17884,4.075660893345487,20.0,0.0
34388,3,4388,[318 515 427 185 313],655,5,17889,4.075871496924129,40.0,0.0
34389,3,4389,[172  15   9 174 603],269,2,17891,4.075398633257403,20.0,0.0
34390,3,4390,[ 97 216 191 603 135],18,3,17894,4.075153723525393,20.0,0.0
34391,3,4391,[117 357 125 118 132],457,5,17899,4.0753642987249545,0.0,0.0
34392,3,4392,[144  56 405 257 603],655,1,17900,4.074664238561348,20.0,0.0
34393,3,4393,[318 515 427 185 313],655,5,17905,4.074874829312699,40.0,0.0
34394,3,4394,[318 515 427 185 313],655,5,17910,4.075085324232082,40.0,0.0
34395,3,4395,[318 515 427 185 313],655,5,17915,4.075295723384896,40.0,0.0
34396,3,4396,[ 97 144 172 483 200],796,4,17919,4.075278599044803,0.0,0.0
34397,3,4397,[ 64 222 302 301  96],655,2,17921,4.074806730331969,20.0,0.0
34398,3,4398,[  1 153 385 748 204],450,5,17926,4.075017049329393,0.0,0.0
34399,3,4399,[191 245 174 179 403],450,5,17931,4.075227272727273,0.0,0.0
34400,3,4400,[294 357 195 211 176],23,2,17933,4.074755737332424,0.0,0.0
34401,3,4401,[318 515 427 185 313],655,5,17938,4.074965924579736,40.0,0.0
34402,3,4402,[222 282 186  11 228],450,3,17941,4.074721780604134,0.0,0.0
34403,3,4403,[318 515 427 185 313],655,5,17946,4.074931880108992,40.0,0.0
34404,3,4404,[318 515 427 185 313],655,5,17951,4.075141884222474,40.0,0.0
34405,3,4405,[318 515 427 185 313],655,5,17956,4.075351793009532,40.0,0.0
34406,3,4406,[318 515 427 185 313],655,5,17961,4.075561606535058,40.0,0.0
34407,3,4407,[318 515 427 185 313],655,5,17966,4.075771324863884,40.0,0.0
34408,3,4408,[318 515 427 185 313],655,5,17971,4.075980948060785,40.0,0.0
34409,3,4409,[318 515 427 185 313],655,5,17976,4.076190476190476,40.0,0.0
34410,3,4410,[ 56  28 357 294 603],796,3,17979,4.075946497392882,20.0,0.0
34411,3,4411,[318 515 427 185 313],655,5,17984,4.076155938349955,40.0,0.0
34412,3,4412,[275 144 174 172 483],655,3,17987,4.075912077951507,0.0,20.0
34413,3,4413,[132 118  12  11 302],655,1,17988,4.075215224286362,0.0,0.0
34414,3,4414,[ 64 173 300 228 204],716,5,17993,4.075424688561721,20.0,0.0
34415,3,4415,[318 515 427 185 313],655,5,17998,4.075634057971015,40.0,0.0
34416,3,4416,[195 357 143 168 132],450,5,18003,4.075843332578673,0.0,0.0
34417,3,4417,[318 515 427 185 313],655,5,18008,4.076052512449072,40.0,0.0
34418,3,4418,[318 515 427 185 313],655,5,18013,4.076261597646527,40.0,0.0
34419,3,4419,[228  88 435 423  28],151,5,18018,4.076470588235294,0.0,0.0
34420,3,4420,[235 204 655  71 211],23,1,18019,4.075774711603709,0.0,0.0
34421,3,4421,[318 515 427 185 313],655,5,18024,4.075983717774762,40.0,0.0
34422,3,4422,[302 187 435 191 176],655,3,18027,4.0757404476599595,0.0,0.0
34423,3,4423,[175 228  11  28 186],457,5,18032,4.075949367088608,0.0,0.0
34424,3,4424,[318 515 427 185 313],655,5,18037,4.0761581920903955,40.0,0.0
34425,3,4425,[300 588 168  69 234],807,4,18041,4.076140985088116,0.0,0.0
34426,3,4426,[ 96 318  50 143 195],504,4,18045,4.076123785859498,20.0,20.0
34427,3,4427,[318 515 427 185 313],655,5,18050,4.076332429990966,40.0,0.0
34428,3,4428,[318 515 427 185 313],655,5,18055,4.076540979905171,40.0,0.0
34429,3,4429,[ 79 603  88 202 196],151,5,18060,4.076749435665914,20.0,0.0
34430,3,4430,[265 275  11 508 496],535,4,18064,4.0767321146468065,20.0,20.0
34431,3,4431,[172  25 237 187 268],655,2,18066,4.076263537906137,0.0,0.0
34432,3,4432,[318 515 427 185 313],655,5,18071,4.0764719151815925,40.0,0.0
34433,3,4433,[318 515 427 185 313],655,5,18076,4.076680198466396,40.0,0.0
34434,3,4434,[161 168 275 118 655],796,4,18080,4.076662908680947,0.0,20.0
34435,3,4435,[ 88   9  50  82 125],280,1,18081,4.075969341749324,0.0,20.0
34436,3,4436,[655 183 475 204 179],269,3,18084,4.075726842461123,0.0,0.0
34437,3,4437,[318 515 427 185 313],655,5,18089,4.07593510590356,40.0,0.0
34438,3,4438,[  4 742 748 237  79],256,5,18094,4.076143275512503,0.0,0.0
34439,3,4439,[204 265 245 172  96],450,5,18099,4.076351351351351,0.0,0.0
34440,3,4440,[655  97 237 118  98],504,3,18102,4.076108984462959,0.0,0.0
34441,3,4441,[196 195 237  98 172],716,4,18106,4.076091850517785,0.0,0.0
34442,3,4442,[313 168 496 655 176],577,5,18111,4.076299797434166,20.0,0.0
34443,3,4443,[318 234 275 174  28],18,3,18114,4.076057605760576,20.0,20.0
34444,3,4444,[318 515 427 185 313],655,5,18119,4.076265466816648,40.0,0.0
34445,3,4445,[318 515 427 185 313],655,5,18124,4.076473234367971,40.0,0.0
34446,3,4446,[318 515 427 185 313],655,5,18129,4.076680908477625,40.0,0.0
34447,3,4447,[318 515 427 185 313],655,5,18134,4.076888489208633,40.0,0.0
34448,3,4448,[318 515 427 185 313],655,5,18139,4.07709597662396,40.0,0.0
34449,3,4449,[ 82  96 215  98 222],23,3,18142,4.07685393258427,0.0,0.0
34450,3,4450,[318 515 427 185 313],655,5,18147,4.077061334531566,40.0,0.0
34451,3,4451,[286 161 211 318 234],655,1,18148,4.076370170709794,20.0,20.0
34452,3,4452,[318 515 427 185 313],655,5,18153,4.0765775881428254,40.0,0.0
34453,3,4453,[ 69  28  50 423 185],457,5,18158,4.076784912438257,0.0,20.0
34454,3,4454,[318 515 427 185 313],655,5,18163,4.07699214365881,40.0,0.0
34455,3,4455,[ 88  11 257 215 294],716,5,18168,4.077199281867146,0.0,0.0
34456,3,4456,[318 515 427 185 313],655,5,18173,4.077406327125869,40.0,0.0
34457,3,4457,[318 515 427 185 313],655,5,18178,4.077613279497532,40.0,0.0
34458,3,4458,[275  98 210 172  50],296,4,18182,4.077595873514241,0.0,40.0
34459,3,4459,[275 121 143 318 435],716,5,18187,4.07780269058296,20.0,20.0
34460,3,4460,[318 515 427 185 313],655,5,18192,4.078009414929388,40.0,0.0
34461,3,4461,[318 515 427 185 313],655,5,18197,4.078216046615867,40.0,0.0
34462,3,4462,[144 173 258 245 210],629,4,18201,4.078198521174098,0.0,0.0
34463,3,4463,[318 515 427 185 313],655,5,18206,4.078405017921147,40.0,0.0
34464,3,4464,[318 515 427 185 313],655,5,18211,4.078611422172452,40.0,0.0
34465,3,4465,[289 204 546 265  28],786,5,18216,4.078817733990148,0.0,0.0
34466,3,4466,[200   8 328  28 568],655,1,18217,4.078128497873293,0.0,0.0
34467,3,4467,[ 69 238 181 202  64],18,2,18219,4.077663384064459,20.0,0.0
34468,3,4468,[318 515 427 185 313],655,5,18224,4.077869769523383,40.0,0.0
34469,3,4469,[318 515 427 185 313],655,5,18229,4.078076062639821,40.0,0.0
34470,3,4470,[237  50 121  89 181],796,5,18234,4.0782822634757325,0.0,20.0
34471,3,4471,[318 515 427 185 313],655,5,18239,4.078488372093023,40.0,0.0
34472,3,4472,[ 64  88  82 282  12],457,5,18244,4.078694388553544,20.0,0.0
34473,3,4473,[302  69 179 183  28],450,5,18249,4.078900312919088,0.0,0.0
34474,3,4474,[318 515 427 185 313],655,5,18254,4.079106145251397,40.0,0.0
34475,3,4475,[125 405 197 144 215],280,0,18254,4.078194816800715,0.0,0.0
34476,3,4476,[318 515 427 185 313],655,5,18259,4.078400714764351,40.0,0.0
34477,3,4477,[318 515 427 185 313],655,5,18264,4.0786065207682,40.0,0.0
34478,3,4478,[742 546 403 245 143],450,5,18269,4.078812234873856,0.0,0.0
34479,3,4479,[313 211 168 655 288],450,4,18273,4.078794642857143,0.0,0.0
34480,3,4480,[ 79 483 286 294 245],450,4,18277,4.078777058692256,0.0,20.0
34481,3,4481,[318 515 427 185 313],655,5,18282,4.078982597054886,40.0,0.0
34482,3,4482,[ 69   4 161 235 127],280,4,18286,4.078964978808833,0.0,20.0
34483,3,4483,[318 515 427 185 313],655,5,18291,4.079170383586084,40.0,0.0
34484,3,4484,[  1 405 151  95 211],450,4,18295,4.079152731326644,0.0,0.0
34485,3,4485,[183 117 655 483  88],280,2,18297,4.078689255461436,0.0,0.0
34486,3,4486,[318 515 427 185 313],655,5,18302,4.078894584354803,40.0,0.0
34487,3,4487,[197 111 100  79 258],655,1,18303,4.0782085561497325,0.0,20.0
34488,3,4488,[ 98 194 288 181 117],450,4,18307,4.078191133882824,0.0,0.0
34489,3,4489,[175   8 151  88 168],457,5,18312,4.078396436525613,0.0,0.0
34490,3,4490,[318 515 427 185 313],655,5,18317,4.078601647739925,40.0,0.0
34491,3,4491,[187 143 234 196 323],796,3,18320,4.078361531611754,0.0,0.0
34492,3,4492,[245 273  25  50 546],938,3,18323,4.078121522368129,0.0,20.0
34493,3,4493,[318 515 427 185 313],655,5,18328,4.07832665776591,40.0,0.0
34494,3,4494,[ 96  28  25  79 238],716,4,18332,4.078309232480534,0.0,0.0
34495,3,4495,[318 515 427 185 313],655,5,18337,4.078514234875445,40.0,0.0
34496,3,4496,[ 71 185 151 125 186],18,2,18339,4.078052034689793,0.0,0.0
34497,3,4497,[318 515 427 185 313],655,5,18344,4.078257003112494,40.0,0.0
34498,3,4498,[423 323  79 143 257],796,4,18348,4.078239608801956,0.0,0.0
34499,3,4499,[ 50 318 153  97 265],796,4,18352,4.078222222222222,20.0,20.0
34500,3,4500,[  8 235 385  89 172],23,4,18356,4.07820484336814,0.0,0.0
34501,3,4501,[144 204 211 275 197],450,5,18361,4.078409595735229,0.0,20.0
34502,3,4502,[318 515 427 185 313],655,5,18366,4.078614257161892,40.0,0.0
34503,3,4503,[121   8 174 508 185],535,5,18371,4.078818827708703,0.0,0.0
34504,3,4504,[234   1 172 196 588],577,4,18375,4.078801331853496,0.0,0.0
34505,3,4505,[318 515 427 185 313],655,5,18380,4.079005770084332,40.0,0.0
34506,3,4506,[318 515 427 185 313],655,5,18385,4.079210117594853,40.0,0.0
34507,3,4507,[276 117 302 427 183],655,4,18389,4.079192546583851,20.0,0.0
34508,3,4508,[318 515 427 185 313],655,5,18394,4.079396762031492,40.0,0.0
34509,3,4509,[ 28 202 118 603  89],796,4,18398,4.079379157427938,20.0,0.0
34510,3,4510,[318 515 427 185 313],655,5,18403,4.079583240966526,40.0,0.0
34511,3,4511,[318 515 427 185 313],655,5,18408,4.079787234042553,40.0,0.0
34512,3,4512,[196  71 194 121 245],796,4,18412,4.079769554619987,0.0,0.0
34513,3,4513,[318 515 427 185 313],655,5,18417,4.07997341603899,40.0,0.0
34514,3,4514,[385  89 151 568 496],450,5,18422,4.080177187153931,20.0,0.0
34515,3,4515,[318 515 427 185 313],655,5,18427,4.0803808680248,40.0,0.0
34516,3,4516,[182   9 237  56  50],593,3,18430,4.0801416869603715,0.0,20.0
34517,3,4517,[318 515 427 185 313],655,5,18435,4.080345285524569,40.0,0.0
34518,3,4518,[ 22 237 118 323 216],796,4,18439,4.080327506085417,0.0,0.0
34519,3,4519,[568 235  22  50  82],756,1,18440,4.079646017699115,0.0,20.0
34520,3,4520,[204 153 176  15 265],450,4,18444,4.079628400796284,0.0,0.0
34521,3,4521,[197 204  22 237 588],18,3,18447,4.079389650597081,0.0,0.0
34522,3,4522,[318 515 427 185 313],655,5,18452,4.07959319036038,40.0,0.0
34523,3,4523,[183 258 742 322 257],796,3,18455,4.079354553492484,0.0,0.0
34524,3,4524,[132 211 483 245 100],450,4,18459,4.079337016574586,0.0,20.0
34525,3,4525,[  1 275  12 121  82],796,3,18462,4.079098541758728,0.0,20.0
34526,3,4526,[196 423 322  97 597],593,3,18465,4.078860172299536,0.0,0.0
34527,3,4527,[742 202 216 196 181],655,1,18466,4.078180212014134,0.0,0.0
34528,3,4528,[318 515 427 185 313],655,5,18471,4.078383749172002,40.0,0.0
34529,3,4529,[318 515 427 185 313],655,5,18476,4.078587196467991,40.0,0.0
34530,3,4530,[318 515 427 185 313],655,5,18481,4.078790553961598,40.0,0.0
34531,3,4531,[168 151  12  50 294],450,5,18486,4.0789938217122685,0.0,20.0
34532,3,4532,[318 515 427 185 313],655,5,18491,4.079196999779396,40.0,0.0
34533,3,4533,[275 200 197 183  70],655,3,18494,4.078958976621085,0.0,20.0
34534,3,4534,[100 175 216   8 300],655,1,18495,4.078280044101433,0.0,20.0
34535,3,4535,[125  71 403  69 151],18,1,18496,4.0776014109347445,0.0,0.0
34536,3,4536,[132 748 121  82 196],796,4,18500,4.077584306810667,0.0,0.0
34537,3,4537,[318 515 427 185 313],655,5,18505,4.077787571617453,40.0,0.0
34538,3,4538,[318 515 427 185 313],655,5,18510,4.077990746860542,40.0,0.0
34539,3,4539,[127   4 496 196   7],786,5,18515,4.078193832599119,20.0,20.0
34540,3,4540,[191 161 403 121 385],577,5,18520,4.0783968288923145,0.0,0.0
34541,3,4541,[318 515 427 185 313],655,5,18525,4.078599735799207,40.0,0.0
34542,3,4542,[215   7 111 282 275],457,4,18529,4.0785824345146375,0.0,20.0
34543,3,4543,[318 515 427 185 313],655,5,18534,4.078785211267606,40.0,0.0
34544,3,4544,[318 515 427 185 313],655,5,18539,4.078987898789879,40.0,0.0
34545,3,4545,[496 276 215 153 238],535,4,18543,4.078970523537175,20.0,0.0
34546,3,4546,[318 515 427 185 313],655,5,18548,4.079173081152408,40.0,0.0
34547,3,4547,[111 183 237 195 403],450,5,18553,4.079375549692172,0.0,0.0
34548,3,4548,[301 471 742 403  12],450,5,18558,4.079577929215212,0.0,0.0
34549,3,4549,[318 515 427 185 313],655,5,18563,4.07978021978022,40.0,0.0
34550,3,4550,[318 515 427 185 313],655,5,18568,4.079982421445836,40.0,0.0
34551,3,4551,[423 237 174 182 742],457,5,18573,4.08018453427065,0.0,0.0
34552,3,4552,[318 515 427 185 313],655,5,18578,4.0803865583132,40.0,0.0
34553,3,4553,[197 144 742 100 200],280,2,18580,4.079929732103645,0.0,20.0
34554,3,4554,[143 222 187  28 117],450,4,18584,4.079912184412733,0.0,0.0
34555,3,4555,[318 515 427 185 313],655,5,18589,4.080114135206322,40.0,0.0
34556,3,4556,[568  70 403  88 471],457,5,18594,4.0803159973666885,0.0,0.0
34557,3,4557,[245 222 132  96 121],796,4,18598,4.080298376480913,0.0,0.0
34558,3,4558,[ 69 117  96 568 234],457,5,18603,4.080500109673174,0.0,0.0
34559,3,4559,[237  95 742  98 172],577,5,18608,4.080701754385965,0.0,0.0
34560,3,4560,[405 168 186 322 603],796,3,18611,4.080464810348608,20.0,0.0
34561,3,4561,[318 515 427 185 313],655,5,18616,4.080666374397194,40.0,0.0
34562,3,4562,[ 70 132 135 289 204],655,1,18617,4.079991233837387,0.0,0.0
34563,3,4563,[318 515 427 185 313],655,5,18622,4.080192813321648,40.0,0.0
34564,3,4564,[318 515 427 185 313],655,5,18627,4.08039430449069,40.0,0.0
34565,3,4565,[ 28 269 302 118 172],450,4,18631,4.080376697328077,0.0,0.0
34566,3,4566,[318 515 427 185 313],655,5,18636,4.080578059995621,40.0,0.0
34567,3,4567,[588 385 185 172 655],23,4,18640,4.080560420315236,0.0,0.0
34568,3,4568,[318 515 427 185 313],655,5,18645,4.080761654629022,40.0,0.0
34569,3,4569,[318 515 427 185 313],655,5,18650,4.080962800875273,40.0,0.0
34570,3,4570,[318 515 427 185 313],655,5,18655,4.081163859111792,40.0,0.0
34571,3,4571,[196   7 183 222 496],450,4,18659,4.081146106736658,20.0,0.0
34572,3,4572,[186  15 117 271 273],796,3,18662,4.080909687294993,0.0,0.0
34573,3,4573,[302 273 655 318 179],450,4,18666,4.0808919982509835,20.0,0.0
34574,3,4574,[ 56 222 286 181  79],236,5,18671,4.081092896174863,0.0,20.0
34575,3,4575,[318 515 427 185 313],655,5,18676,4.081293706293707,40.0,0.0
34576,3,4576,[748  50 197 286 655],450,5,18681,4.0814944286650645,0.0,40.0
34577,3,4577,[318 515 427 185 313],655,5,18686,4.081695063346439,40.0,0.0
34578,3,4578,[204 385 118 228  96],344,3,18689,4.081458833806508,0.0,0.0
34579,3,4579,[333  15  97 135 196],236,2,18691,4.081004366812227,0.0,0.0
34580,3,4580,[323 301 568 357 286],796,2,18693,4.080550098231827,0.0,20.0
34581,3,4581,[588 237 405  64 258],457,5,18698,4.080750763858577,20.0,0.0
34582,3,4582,[318 515 427 185 313],655,5,18703,4.0809513419157755,40.0,0.0
34583,3,4583,[318 515 427 185 313],655,5,18708,4.0811518324607325,40.0,0.0
34584,3,4584,[318 515 427 185 313],655,5,18713,4.081352235550709,40.0,0.0
34585,3,4585,[496 403 111 100 302],450,5,18718,4.081552551242913,20.0,20.0
34586,3,4586,[181 423  25 228 151],330,5,18723,4.081752779594506,0.0,0.0
34587,3,4587,[ 56 228 168 427 200],577,2,18725,4.08129904097646,20.0,0.0
34588,3,4588,[318 515 427 185 313],655,5,18730,4.081499237306603,40.0,0.0
34589,3,4589,[ 69 328  82 742 179],450,4,18734,4.0814814814814815,0.0,0.0
34590,3,4590,[318 515 427 185 313],655,5,18739,4.081681550860379,40.0,0.0
34591,3,4591,[ 88 215 257 271 172],796,5,18744,4.081881533101045,0.0,0.0
34592,3,4592,[318 515 427 185 313],655,5,18749,4.0820814282603965,40.0,0.0
34593,3,4593,[318 515 427 185 313],655,5,18754,4.082281236395298,40.0,0.0
34594,3,4594,[318 515 427 185 313],655,5,18759,4.082480957562568,40.0,0.0
34595,3,4595,[318 515 427 185 313],655,5,18764,4.082680591818973,40.0,0.0
34596,3,4596,[176  97 161 403 216],655,1,18765,4.082010006525995,0.0,0.0
34597,3,4597,[100   7 742 655  82],280,2,18767,4.081557198782079,0.0,20.0
34598,3,4598,[318 515 427 185 313],655,5,18772,4.081756903674712,40.0,0.0
34599,3,4599,[195 258  56 183 288],655,1,18773,4.081086956521739,0.0,0.0
34600,3,4600,[ 88   4 265 173  28],457,5,18778,4.081286676809389,0.0,0.0
34601,3,4601,[318 515 427 185 313],655,5,18783,4.081486310299869,40.0,0.0
34602,3,4602,[427 179 173 515 194],269,4,18787,4.081468607429937,20.0,0.0
34603,3,4603,[318 515 427 185 313],655,5,18792,4.081668114682884,40.0,0.0
34604,3,4604,[318 515 427 185 313],655,5,18797,4.0818675352877305,40.0,0.0
34605,3,4605,[318 515 427 185 313],655,5,18802,4.0820668693009114,40.0,0.0
34606,3,4606,[202 204 435  69   8],389,5,18807,4.082266116778815,0.0,0.0
34607,3,4607,[318 515 427 185 313],655,5,18812,4.082465277777778,40.0,0.0
34608,3,4608,[655 471 234   8 132],577,3,18815,4.082230418745932,0.0,0.0
34609,3,4609,[173  25 385 405 655],151,3,18818,4.081995661605206,0.0,0.0
34610,3,4610,[385 322 215 228 235],450,4,18822,4.081977878985036,0.0,0.0
34611,3,4611,[318 515 427 185 313],655,5,18827,4.082176929748482,40.0,0.0
34612,3,4612,[125 234   7 194 151],292,3,18830,4.081942336874052,0.0,0.0
34613,3,4613,[ 50 197 405 174 200],330,5,18835,4.082141309059384,0.0,20.0
34614,3,4614,[318 515 427 185 313],655,5,18840,4.0823401950162514,40.0,0.0
34615,3,4615,[318 515 427 185 313],655,5,18845,4.082538994800693,40.0,0.0
34616,3,4616,[ 79 568  25 195 196],344,5,18850,4.082737708468702,0.0,0.0
34617,3,4617,[318 515 427 185 313],655,5,18855,4.082936336076224,40.0,0.0
34618,3,4618,[318 515 427 185 313],655,5,18860,4.083134877679151,40.0,0.0
34619,3,4619,[222  98 471   4 245],344,3,18863,4.082900432900433,0.0,0.0
34620,3,4620,[333   1  25 202 475],655,0,18863,4.082016879463319,0.0,0.0
34621,3,4621,[318 515 427 185 313],655,5,18868,4.082215491129381,40.0,0.0
34622,3,4622,[496  95  70 471 118],450,3,18871,4.081981397361021,20.0,0.0
34623,3,4623,[161 195  95 318  25],450,3,18874,4.0817474048442905,20.0,0.0
34624,3,4624,[286 475   8 153  89],655,1,18875,4.081081081081081,0.0,20.0
34625,3,4625,[318 515 427 185 313],655,5,18880,4.081279723303069,40.0,0.0
34626,3,4626,[ 79 176  28  50 144],450,5,18885,4.081478279662848,0.0,20.0
34627,3,4627,[ 15 132  50 118 210],655,1,18886,4.080812445980985,0.0,20.0
34628,3,4628,[215 588 132 385 405],450,5,18891,4.08101101749838,0.0,0.0
34629,3,4629,[318 515 427 185 313],655,5,18896,4.081209503239741,40.0,0.0
34630,3,4630,[174 323 423 202 210],639,1,18897,4.080544158928957,0.0,0.0
34631,3,4631,[403 121 357  71 748],796,5,18902,4.0807426597582035,0.0,0.0
34632,3,4632,[405 546 276  82 125],786,4,18906,4.080725232031082,0.0,0.0
34633,3,4633,[211 273 423 282 301],450,4,18910,4.080707811825636,0.0,0.0
34634,3,4634,[318 515 427 185 313],655,5,18915,4.080906148867314,40.0,0.0
34635,3,4635,[237 211 186 385  97],450,4,18919,4.080888697152718,0.0,0.0
34636,3,4636,[318 515 427 185 313],655,5,18924,4.081086909639853,40.0,0.0
34637,3,4637,[318 515 427 185 313],655,5,18929,4.08128503665373,40.0,0.0
34638,3,4638,[135 117 174 508 132],655,1,18930,4.08062082345333,0.0,0.0
34639,3,4639,[318 515 427 185 313],655,5,18935,4.080818965517241,40.0,0.0
34640,3,4640,[318 515 427 185 313],655,5,18940,4.0810170221934925,40.0,0.0
34641,3,4641,[294 195 588 151  50],796,4,18944,4.080999569151228,0.0,20.0
34642,3,4642,[301 333 135 427  98],655,3,18947,4.080766745638596,20.0,0.0
34643,3,4643,[ 97 174  95 258  71],942,5,18952,4.080964685615848,0.0,0.0
34644,3,4644,[318 515 427 185 313],655,5,18957,4.081162540365985,40.0,0.0
34645,3,4645,[ 88 172  25 118  22],330,5,18962,4.081360309944038,0.0,0.0
34646,3,4646,[282  69 185   4 216],457,5,18967,4.081557994404992,0.0,0.0
34647,3,4647,[318 515 427 185 313],655,5,18972,4.081755593803787,40.0,0.0
34648,3,4648,[318 515 427 185 313],655,5,18977,4.081953108195311,40.0,0.0
34649,3,4649,[ 50 200  89 568 195],796,5,18982,4.0821505376344085,0.0,20.0
34650,3,4650,[318 515 427 185 313],655,5,18987,4.082347882175876,40.0,0.0
34651,3,4651,[132  64 183 117  79],450,5,18992,4.082545141874463,20.0,0.0
34652,3,4652,[318 515 427 185 313],655,5,18997,4.08274231678487,40.0,0.0
34653,3,4653,[318 515 427 185 313],655,5,19002,4.082939406961754,40.0,0.0
34654,3,4654,[282 176 144 546 194],457,4,19006,4.082921589688507,0.0,0.0
34655,3,4655,[  8  82 168 237  25],330,4,19010,4.082903780068729,0.0,0.0
34656,3,4656,[427 215 196  15 175],655,1,19011,4.08224178655787,20.0,0.0
34657,3,4657,[318 515 427 185 313],655,5,19016,4.082438814942035,40.0,0.0
34658,3,4658,[318 515 427 185 313],655,5,19021,4.0826357587465125,40.0,0.0
34659,3,4659,[294 181  98  96 678],256,4,19025,4.082618025751073,0.0,0.0
34660,3,4660,[318 515 427 185 313],655,5,19030,4.082814846599442,40.0,0.0
34661,3,4661,[318 515 427 185 313],655,5,19035,4.083011583011583,40.0,0.0
34662,3,4662,[118   1 288 300 318],450,3,19038,4.0827793266137675,20.0,0.0
34663,3,4663,[318 515 427 185 313],655,5,19043,4.082975986277873,40.0,0.0
34664,3,4664,[194 403 174  79 172],18,2,19045,4.082529474812433,0.0,0.0
34665,3,4665,[318 515 427 185 313],655,5,19050,4.0827261037291045,40.0,0.0
34666,3,4666,[318 515 427 185 313],655,5,19055,4.082922648382258,40.0,0.0
34667,3,4667,[318 515 427 185 313],655,5,19060,4.0831191088260494,40.0,0.0
34668,3,4668,[  1 655 180 603  71],535,4,19064,4.0831013064896124,20.0,0.0
34669,3,4669,[318 515 427 185 313],655,5,19069,4.0832976445396145,40.0,0.0
34670,3,4670,[318 515 427 185 313],655,5,19074,4.0834938985228,40.0,0.0
34671,3,4671,[180 183 568  89  69],796,4,19078,4.083476027397261,0.0,0.0
34672,3,4672,[318 515 427 185 313],655,5,19083,4.083672159212497,40.0,0.0
34673,3,4673,[318 515 427 185 313],655,5,19088,4.083868207103124,40.0,0.0
34674,3,4674,[216 143 265 568 234],655,2,19090,4.083422459893048,0.0,0.0
34675,3,4675,[194 121  79   4 405],151,4,19094,4.083404619332763,0.0,0.0
34676,3,4676,[  9 258 127  79 265],796,4,19098,4.083386786401539,0.0,20.0
34677,3,4677,[175  79   1 427  25],151,5,19103,4.083582727661394,20.0,0.0
34678,3,4678,[318 515 427 185 313],655,5,19108,4.083778585167771,40.0,0.0
34679,3,4679,[ 88 258  56 238 471],65,2,19110,4.083333333333333,0.0,0.0
34680,3,4680,[318 515 427 185 313],655,5,19115,4.083529160435805,40.0,0.0
34681,3,4681,[318 515 427 185 313],655,5,19120,4.083724903887227,40.0,0.0
34682,3,4682,[318 515 427 185 313],655,5,19125,4.0839205637411915,40.0,0.0
34683,3,4683,[222  12  50 185 385],655,2,19127,4.083475661827498,0.0,20.0
34684,3,4684,[318 515 427 185 313],655,5,19132,4.083671291355389,40.0,0.0
34685,3,4685,[196 186  96 194 200],457,5,19137,4.083866837387964,0.0,0.0
34686,3,4686,[318 515 427 185 313],655,5,19142,4.084062299978664,40.0,0.0
34687,3,4687,[197 546 588 357 323],796,3,19145,4.083831058020478,0.0,0.0
34688,3,4688,[318 515 427 185 313],655,5,19150,4.084026444870974,40.0,0.0
34689,3,4689,[228 496 183  88 191],796,5,19155,4.084221748400853,20.0,0.0
34690,3,4690,[318 515 427 185 313],655,5,19160,4.084416968663398,40.0,0.0
34691,3,4691,[318 515 427 185 313],655,5,19165,4.08461210571185,40.0,0.0
34692,3,4692,[301 294  69 202 568],450,5,19170,4.0848071595994035,0.0,0.0
34693,3,4693,[194 151   8 132 235],23,3,19173,4.084576054537708,0.0,0.0
34694,3,4694,[258 385  11 301 742],344,1,19174,4.083919062832801,0.0,0.0
34695,3,4695,[318 515 427 185 313],655,5,19179,4.084114139693356,40.0,0.0
34696,3,4696,[151 302 313   1  69],450,5,19184,4.0843091334894615,0.0,0.0
34697,3,4697,[318 515 427 185 313],655,5,19189,4.084504044274159,40.0,0.0
34698,3,4698,[ 95 172 322 655 173],280,2,19191,4.084060438391147,0.0,0.0
34699,3,4699,[ 12 100 508  11 216],280,3,19194,4.083829787234043,0.0,20.0
34700,3,4700,[194 151 603 235 125],450,4,19198,4.083811954903212,20.0,0.0
34701,3,4701,[185 235  88  56 173],269,2,19200,4.083368779242876,0.0,0.0
34702,3,4702,[318 515 427 185 313],655,5,19205,4.083563682755688,40.0,0.0
34703,3,4703,[318 515 427 185 313],655,5,19210,4.08375850340136,40.0,0.0
34704,3,4704,[318 515 427 185 313],655,5,19215,4.083953241232731,40.0,0.0
34705,3,4705,[318 515 427 185 313],655,5,19220,4.084147896302593,40.0,0.0
34706,3,4706,[288 173  22 125 195],450,4,19224,4.084130019120459,0.0,0.0
34707,3,4707,[405   4  82 496  50],716,4,19228,4.08411214953271,20.0,20.0
34708,3,4708,[318 515 427 185 313],655,5,19233,4.084306646846464,40.0,0.0
34709,3,4709,[  1 237 118 174 268],655,0,19233,4.08343949044586,0.0,0.0
34710,3,4710,[196 238 176 194 294],796,3,19236,4.083209509658246,0.0,0.0
34711,3,4711,[318 515 427 185 313],655,5,19241,4.083404074702886,40.0,0.0
34712,3,4712,[318 515 427 185 313],655,5,19246,4.0835985571822615,40.0,0.0
34713,3,4713,[318 515 427 185 313],655,5,19251,4.083792957148918,40.0,0.0
34714,3,4714,[318 515 427 185 313],655,5,19256,4.083987274655355,40.0,0.0
34715,3,4715,[318 515 427 185 313],655,5,19261,4.084181509754029,40.0,0.0
34716,3,4716,[181 202  97 228 176],457,5,19266,4.08437566249735,0.0,0.0
34717,3,4717,[ 12 174 234 125 471],280,1,19267,4.083721916066129,0.0,0.0
34718,3,4718,[161 288 186 144 234],655,0,19267,4.082856537401992,0.0,0.0
34719,3,4719,[318 515 427 185 313],655,5,19272,4.083050847457627,40.0,0.0
34720,3,4720,[318 515 427 185 313],655,5,19277,4.083245075195933,40.0,0.0
34721,3,4721,[ 79 603 186  89 135],151,5,19282,4.083439220669208,20.0,0.0
34722,3,4722,[318 515 427 185 313],655,5,19287,4.083633283929705,40.0,0.0
34723,3,4723,[ 12 202  15 100 216],256,4,19291,4.083615580016935,0.0,20.0
34724,3,4724,[568 210 357 271  95],796,4,19295,4.083597883597884,0.0,0.0
34725,3,4725,[197 289  11  64 313],693,2,19297,4.083157003808718,20.0,0.0
34726,3,4726,[515 180 121 276  64],269,3,19300,4.082927861222763,20.0,0.0
34727,3,4727,[318 515 427 185 313],655,5,19305,4.083121827411167,40.0,0.0
34728,3,4728,[238 176 301 318  97],11,3,19308,4.0828927891731865,20.0,0.0
34729,3,4729,[318 515 427 185 313],655,5,19313,4.0830866807611,40.0,0.0
34730,3,4730,[100 118 288 286  71],593,5,19318,4.083280490382583,0.0,40.0
34731,3,4731,[121 678  69  70   7],344,1,19319,4.082628909551986,0.0,0.0
34732,3,4732,[318 423 403  79 237],577,5,19324,4.082822733995352,20.0,0.0
34733,3,4733,[111 117 568 313 273],450,4,19328,4.082805238698775,0.0,0.0
34734,3,4734,[288 183 173  28 318],457,5,19333,4.082998944033791,20.0,0.0
34735,3,4735,[318 515 427 185 313],655,5,19338,4.0831925675675675,40.0,0.0
34736,3,4736,[ 98 143  64 300 294],494,5,19343,4.083386109351911,20.0,0.0
34737,3,4737,[322 216 588 161 471],280,4,19347,4.083368509919797,0.0,0.0
34738,3,4738,[161 588  28 185 186],457,5,19352,4.0835619328972355,0.0,0.0
34739,3,4739,[357   7  96 427 195],908,3,19355,4.083333333333333,20.0,0.0
34740,3,4740,[318 515 427 185 313],655,5,19360,4.083526682134571,40.0,0.0
34741,3,4741,[318 515 427 185 313],655,5,19365,4.083719949388444,40.0,0.0
34742,3,4742,[655  22 135  96 186],716,2,19367,4.083280624077588,0.0,0.0
34743,3,4743,[546 234 268 185  97],503,5,19372,4.083473861720067,0.0,0.0
34744,3,4744,[318 515 427 185 313],655,5,19377,4.083667017913593,40.0,0.0
34745,3,4745,[185 210 179 301 286],655,2,19379,4.08322798145807,0.0,20.0
34746,3,4746,[318 515 427 185 313],655,5,19384,4.083421108068253,40.0,0.0
34747,3,4747,[318 515 427 185 313],655,5,19389,4.083614153327717,40.0,0.0
34748,3,4748,[318 515 427 185 313],655,5,19394,4.08380711728785,40.0,0.0
34749,3,4749,[318 515 427 185 313],655,5,19399,4.084,40.0,0.0
34750,3,4750,[318 515 427 185 313],655,5,19404,4.084192801515471,40.0,0.0
34751,3,4751,[588 185 546 237 222],457,4,19408,4.084175084175084,0.0,0.0
34752,3,4752,[153 180 597 200  96],796,4,19412,4.084157374289922,0.0,0.0
34753,3,4753,[286 515 257 210 181],401,2,19414,4.083718973496003,0.0,20.0
34754,3,4754,[318 515 427 185 313],655,5,19419,4.08391167192429,40.0,0.0
34755,3,4755,[196 234   7 117 313],577,3,19422,4.083683767872161,0.0,0.0
34756,3,4756,[318 515 427 185 313],655,5,19427,4.083876392684465,40.0,0.0
34757,3,4757,[269 655   1 121 200],796,2,19429,4.083438419503993,0.0,0.0
34758,3,4758,[318 515 427 185 313],655,5,19434,4.083631014919101,40.0,0.0
34759,3,4759,[282 427 742 100 271],796,3,19437,4.083403361344538,20.0,20.0
34760,3,4760,[  9  97  98 588 172],878,3,19440,4.083175803402646,0.0,0.0
34761,3,4761,[117 100 294 143 174],796,3,19443,4.0829483410331795,0.0,20.0
34762,3,4762,[234 313 132   1 286],280,3,19446,4.082720974175939,0.0,20.0
34763,3,4763,[318 515 427 185 313],655,5,19451,4.082913518052057,40.0,0.0
34764,3,4764,[245  69 742 238 202],504,3,19454,4.082686253934942,0.0,0.0
34765,3,4765,[180  71 496 204 471],450,4,19458,4.082668904741922,20.0,0.0
34766,3,4766,[318 515 427 185 313],655,5,19463,4.082861338367946,40.0,0.0
34767,3,4767,[ 98   1  15 153 228],655,1,19464,4.082214765100671,0.0,0.0
34768,3,4768,[318 515 427 185 313],655,5,19469,4.082407213252254,40.0,0.0
34769,3,4769,[ 56 597  50 234 210],457,4,19473,4.082389937106918,0.0,20.0
34770,3,4770,[318 515 427 185 313],655,5,19478,4.082582267868371,40.0,0.0
34771,3,4771,[318 515 427 185 313],655,5,19483,4.082774518021794,40.0,0.0
34772,3,4772,[318 515 427 185 313],655,5,19488,4.0829666876178505,40.0,0.0
34773,3,4773,[117 181  56 144 318],796,5,19493,4.0831587767071635,20.0,0.0
34774,3,4774,[318 515 427 185 313],655,5,19498,4.083350785340314,40.0,0.0
34775,3,4775,[318 515 427 185 313],655,5,19503,4.083542713567839,40.0,0.0
34776,3,4776,[603 180 168 403 265],796,4,19507,4.083525225036634,20.0,0.0
34777,3,4777,[313 176 234 483 183],450,3,19510,4.0832984512348265,0.0,0.0
34778,3,4778,[200 275 118  88 423],593,4,19514,4.083281021134129,0.0,20.0
34779,3,4779,[294 234 200 237 111],716,5,19519,4.083472803347281,0.0,0.0
34780,3,4780,[318 515 427 185 313],655,5,19524,4.083664505333612,40.0,0.0
34781,3,4781,[318 515 427 185 313],655,5,19529,4.083856127143455,40.0,0.0
34782,3,4782,[318 515 427 185 313],655,5,19534,4.084047668827096,40.0,0.0
34783,3,4783,[318 515 427 185 313],655,5,19539,4.084239130434782,40.0,0.0
34784,3,4784,[318 515 427 185 313],655,5,19544,4.084430512016719,40.0,0.0
34785,3,4785,[508  50 318 483   7],535,5,19549,4.084621813623067,20.0,20.0
34786,3,4786,[268  70 185 181  28],655,1,19550,4.083977438897013,0.0,0.0
34787,3,4787,[ 88 125  15 143  12],655,1,19551,4.083333333333333,0.0,0.0
34788,3,4788,[318 515 427 185 313],655,5,19556,4.083524744205471,40.0,0.0
34789,3,4789,[318 515 427 185 313],655,5,19561,4.083716075156576,40.0,0.0
34790,3,4790,[318 515 427 185 313],655,5,19566,4.083907326236694,40.0,0.0
34791,3,4791,[318 515 427 185 313],655,5,19571,4.084098497495827,40.0,0.0
34792,3,4792,[245 127 185 265 483],450,4,19575,4.08408095138744,0.0,20.0
34793,3,4793,[  7 318 191 655   1],577,4,19579,4.0840634125990825,20.0,0.0
34794,3,4794,[318 515 427 185 313],655,5,19584,4.084254431699687,40.0,0.0
34795,3,4795,[318 515 427 185 313],655,5,19589,4.0844453711426185,40.0,0.0
34796,3,4796,[187 234 111 427  69],716,4,19593,4.084427767354597,20.0,0.0
34797,3,4797,[403 405  96 313 161],280,2,19595,4.083993330554398,0.0,0.0
34798,3,4798,[117 185 483 143  22],450,4,19599,4.083975828297562,0.0,0.0
34799,3,4799,[215  96 597  98 655],457,4,19603,4.083958333333333,0.0,0.0
34800,3,4800,[ 15 172 132 238 118],457,5,19608,4.084149135596751,0.0,0.0
34801,3,4801,[176 483  15 234 238],457,5,19613,4.084339858392337,0.0,0.0
34802,3,4802,[318 515 427 185 313],655,5,19618,4.084530501769727,40.0,0.0
34803,3,4803,[318 515 427 185 313],655,5,19623,4.084721065778518,40.0,0.0
34804,3,4804,[204 234 496 195 181],786,4,19627,4.084703433922997,20.0,0.0
34805,3,4805,[318 515 427 185 313],655,5,19632,4.084893882646692,40.0,0.0
34806,3,4806,[ 89 135 276 179  56],655,4,19636,4.0848762221759936,0.0,0.0
34807,3,4807,[ 88 143 275 172 175],18,3,19639,4.084650582362729,0.0,20.0
34808,3,4808,[318 515 427 185 313],655,5,19644,4.084840923268871,40.0,0.0
34809,3,4809,[245 172  96 215 185],796,4,19648,4.084823284823285,0.0,0.0
34810,3,4810,[318 515 427 185 313],655,5,19653,4.085013510704635,40.0,0.0
34811,3,4811,[ 71  22 294 282 546],280,3,19656,4.084788029925187,0.0,0.0
34812,3,4812,[318 515 427 185 313],655,5,19661,4.08497818408477,40.0,0.0
34813,3,4813,[ 79 234 216 185 182],796,4,19665,4.0849605317823015,0.0,0.0
34814,3,4814,[117 200 403 265 204],280,3,19668,4.084735202492212,0.0,0.0
34815,3,4815,[ 88 202 196 117 135],457,5,19673,4.0849252491694354,0.0,0.0
34816,3,4816,[318 515 427 185 313],655,5,19678,4.085115216940004,40.0,0.0
34817,3,4817,[318 515 427 185 313],655,5,19683,4.085305105853051,40.0,0.0
34818,3,4818,[328 187 222  69  89],796,5,19688,4.085494915957668,0.0,0.0
34819,3,4819,[216 427  69  97   1],731,4,19692,4.085477178423236,20.0,0.0
34820,3,4820,[318 515 427 185 313],655,5,19697,4.085666874092512,40.0,0.0
34821,3,4821,[282 143 185 118 423],457,5,19702,4.085856491082539,0.0,0.0
34822,3,4822,[318 515 427 185 313],655,5,19707,4.086046029442256,40.0,0.0
34823,3,4823,[318 515 427 185 313],655,5,19712,4.086235489220564,40.0,0.0
34824,3,4824,[ 79 234  25  70  50],5,2,19714,4.08580310880829,0.0,20.0
34825,3,4825,[197  64 276 286   9],321,3,19717,4.0855781185246585,20.0,20.0
34826,3,4826,[318 515 427 185 313],655,5,19722,4.085767557489124,40.0,0.0
34827,3,4827,[403 318 271 215 196],72,3,19725,4.085542667771334,20.0,0.0
34828,3,4828,[100 180  96  22 678],280,3,19728,4.085317871194865,0.0,20.0
34829,3,4829,[185 173 151  70  56],535,4,19732,4.085300207039338,0.0,0.0
34830,3,4830,[318 515 427 185 313],655,5,19737,4.085489546677707,40.0,0.0
34831,3,4831,[273 405 175 174  88],655,1,19738,4.084850993377484,0.0,0.0
34832,3,4832,[318 515 427 185 313],655,5,19743,4.08504034761018,40.0,0.0
34833,3,4833,[ 69 215 195   7 151],344,3,19746,4.084815887463798,0.0,0.0
34834,3,4834,[ 22  82 135  25  56],457,5,19751,4.085005170630817,0.0,0.0
34835,3,4835,[151  95 318 187 588],796,5,19756,4.085194375516956,20.0,0.0
34836,3,4836,[318 515 427 185 313],655,5,19761,4.085383502170767,40.0,0.0
34837,3,4837,[318 515 427 185 313],655,5,19766,4.0855725506407605,40.0,0.0
34838,3,4838,[200 275 257 302 403],655,3,19769,4.085348212440587,0.0,20.0
34839,3,4839,[  8 597 191 204 125],796,5,19774,4.085537190082644,0.0,0.0
34840,3,4840,[187  79 117 403 275],450,5,19779,4.0857260896508985,0.0,20.0
34841,3,4841,[318 515 427 185 313],655,5,19784,4.085914911193721,40.0,0.0
34842,3,4842,[183 286 197   7 211],151,4,19788,4.085897171174891,0.0,20.0
34843,3,4843,[318 515 427 185 313],655,5,19793,4.086085879438481,40.0,0.0
34844,3,4844,[237 127 245   1 151],796,3,19796,4.085861713106295,0.0,20.0
34845,3,4845,[143 385 194 196   7],450,5,19801,4.086050350804787,0.0,0.0
34846,3,4846,[318 515 427 185 313],655,5,19806,4.086238910666392,40.0,0.0
34847,3,4847,[318 515 427 185 313],655,5,19811,4.086427392739274,40.0,0.0
34848,3,4848,[318 515 427 185 313],655,5,19816,4.086615797071561,40.0,0.0
34849,3,4849,[180 100 597 174 238],457,4,19820,4.08659793814433,0.0,20.0
34850,3,4850,[204 200  12 173 301],151,4,19824,4.086580086580087,0.0,0.0
34851,3,4851,[143 276 234 257 127],655,3,19827,4.086356141797197,0.0,20.0
34852,3,4852,[318 515 427 185 313],655,5,19832,4.086544405522357,40.0,0.0
34853,3,4853,[318 515 427 185 313],655,5,19837,4.0867325916769675,40.0,0.0
34854,3,4854,[ 15 328 655 333 118],655,0,19837,4.085890834191555,0.0,0.0
34855,3,4855,[318 515 427 185 313],655,5,19842,4.086079077429983,40.0,0.0
34856,3,4856,[183 127  50 603  79],450,5,19847,4.086267243154211,20.0,40.0
34857,3,4857,[318 515 427 185 313],655,5,19852,4.086455331412104,40.0,0.0
34858,3,4858,[318 515 427 185 313],655,5,19857,4.0866433422514925,40.0,0.0
34859,3,4859,[174 228 195  79 153],716,4,19861,4.086625514403292,0.0,0.0
34860,3,4860,[ 88 222 202 275 257],716,5,19866,4.0868134128780085,0.0,20.0
34861,3,4861,[318 515 427 185 313],655,5,19871,4.087001234060057,40.0,0.0
34862,3,4862,[322 127 125 318 269],450,5,19876,4.087188977997121,20.0,20.0
34863,3,4863,[318 515 427 185 313],655,5,19881,4.0873766447368425,40.0,0.0
34864,3,4864,[185 333  15   8 172],655,2,19883,4.0869475847893115,0.0,0.0
34865,3,4865,[294 197 175 144 187],655,1,19884,4.086313193588163,0.0,0.0
34866,3,4866,[318 515 427 185 313],655,5,19889,4.086500924594206,40.0,0.0
34867,3,4867,[117   8 742 125 186],796,3,19892,4.086277732128184,0.0,0.0
34868,3,4868,[318 515 427 185 313],655,5,19897,4.08646539330458,40.0,0.0
34869,3,4869,[ 89 176 234 258 603],151,4,19901,4.086447638603696,20.0,0.0
34870,3,4870,[496  79 286  98 237],236,4,19905,4.086429891192774,20.0,20.0
34871,3,4871,[135  50 118 515 195],807,4,19909,4.086412151067323,0.0,20.0
34872,3,4872,[318 515 427 185 313],655,5,19914,4.086599630617689,40.0,0.0
34873,3,4873,[228 597  71   1 216],23,3,19917,4.086376692654904,0.0,0.0
34874,3,4874,[318 515 427 185 313],655,5,19922,4.086564102564102,40.0,0.0
34875,3,4875,[258 200 405   4  28],151,3,19925,4.086341263330599,0.0,0.0
34876,3,4876,[318 515 427 185 313],655,5,19930,4.086528603649785,40.0,0.0
34877,3,4877,[ 25 258 173 222 238],11,2,19932,4.08610086100861,0.0,0.0
34878,3,4878,[318 515 427 185 313],655,5,19937,4.086288173806108,40.0,0.0
34879,3,4879,[238 100  50 742 143],655,2,19939,4.085860655737705,0.0,40.0
34880,3,4880,[318 515 427 185 313],655,5,19944,4.086047940995698,40.0,0.0
34881,3,4881,[318 515 427 185 313],655,5,19949,4.086235149528882,40.0,0.0
34882,3,4882,[318 515 427 185 313],655,5,19954,4.086422281384395,40.0,0.0
34883,3,4883,[176 202 258 288  97],457,5,19959,4.086609336609337,0.0,0.0
34884,3,4884,[318 515 427 185 313],655,5,19964,4.086796315250767,40.0,0.0
34885,3,4885,[183 215 127 204 111],457,4,19968,4.086778550961932,0.0,20.0
34886,3,4886,[ 15 144 318 568 496],593,5,19973,4.086965418457131,40.0,0.0
34887,3,4887,[318 496 144 333 300],796,5,19978,4.087152209492635,40.0,0.0
34888,3,4888,[ 28  11 125 222 403],450,4,19982,4.08713438330947,0.0,0.0
34889,3,4889,[318 515 427 185 313],655,5,19987,4.087321063394683,40.0,0.0
34890,3,4890,[318 515 427 185 313],655,5,19992,4.087507667143734,40.0,0.0
34891,3,4891,[318 515 427 185 313],655,5,19997,4.087694194603434,40.0,0.0
34892,3,4892,[ 56  89 288  28  79],450,4,20001,4.087676272225629,0.0,0.0
34893,3,4893,[318 515 427 185 313],655,5,20006,4.087862689006947,40.0,0.0
34894,3,4894,[111   7 143 181 265],786,5,20011,4.088049029622064,0.0,0.0
34895,3,4895,[173 228 333  50 196],796,5,20016,4.088235294117647,0.0,20.0
34896,3,4896,[471 173 238 168 427],65,3,20019,4.088013069226057,20.0,0.0
34897,3,4897,[318 515 427 185 313],655,5,20024,4.088199265006125,40.0,0.0
34898,3,4898,[318 515 427 185 313],655,5,20029,4.088385384772402,40.0,0.0
34899,3,4899,[318 515 427 185 313],655,5,20034,4.088571428571429,40.0,0.0
34900,3,4900,[318 515 427 185 313],655,5,20039,4.088757396449704,40.0,0.0
34901,3,4901,[318 515 427 185 313],655,5,20044,4.0889432884536925,40.0,0.0
34902,3,4902,[318 515 427 185 313],655,5,20049,4.089129104629818,40.0,0.0
34903,3,4903,[318 515 427 185 313],655,5,20054,4.08931484502447,40.0,0.0
34904,3,4904,[318 515 427 185 313],655,5,20059,4.089500509683996,40.0,0.0
34905,3,4905,[318 515 427 185 313],655,5,20064,4.089686098654709,40.0,0.0
34906,3,4906,[288 195 183 228 237],457,5,20069,4.089871611982882,0.0,0.0
34907,3,4907,[318 515 427 185 313],655,5,20074,4.090057049714751,40.0,0.0
34908,3,4908,[318 515 427 185 313],655,5,20079,4.090242411896517,40.0,0.0
34909,3,4909,[179 313 237 135 111],639,1,20080,4.089613034623218,0.0,0.0
34910,3,4910,[318 515 427 185 313],655,5,20085,4.089798411728772,40.0,0.0
34911,3,4911,[322 195 135 300 496],450,4,20089,4.08978013029316,20.0,0.0
34912,3,4912,[ 71 423 183 471 127],450,4,20093,4.089761856299614,0.0,20.0
34913,3,4913,[215  64 258 301   4],535,4,20097,4.089743589743589,20.0,0.0
34914,3,4914,[269 235  71  50 111],344,3,20100,4.089521871820956,0.0,20.0
34915,3,4915,[187 568 132  22  64],655,2,20102,4.0890968266883645,20.0,0.0
34916,3,4916,[318 515 427 185 313],655,5,20107,4.089282082570673,40.0,0.0
34917,3,4917,[318 515 427 185 313],655,5,20112,4.089467263115087,40.0,0.0
34918,3,4918,[603  89 215 153 161],655,2,20114,4.089042488310632,20.0,0.0
34919,3,4919,[  9 588 202 403  89],796,4,20118,4.089024390243902,0.0,0.0
34920,3,4920,[176 172   4 269 100],421,3,20121,4.088803088803089,0.0,20.0
34921,3,4921,[318 515 427 185 313],655,5,20126,4.088988216172288,40.0,0.0
34922,3,4922,[ 88 175  28 197 269],655,0,20126,4.088157627462929,0.0,0.0
34923,3,4923,[318 515 427 185 313],655,5,20131,4.088342810722989,40.0,0.0
34924,3,4924,[144 427 357 181  12],908,2,20133,4.087918781725889,20.0,0.0
34925,3,4925,[318 515 427 185 313],655,5,20138,4.088103938286642,40.0,0.0
34926,3,4926,[318 515 427 185 313],655,5,20143,4.088289019687436,40.0,0.0
34927,3,4927,[318 515 427 185 313],655,5,20148,4.088474025974026,40.0,0.0
34928,3,4928,[318 515 427 185 313],655,5,20153,4.088658957192128,40.0,0.0
34929,3,4929,[204 200  79 742 318],577,4,20157,4.088640973630832,20.0,0.0
34930,3,4930,[318 515 427 185 313],655,5,20162,4.0888257959845875,40.0,0.0
34931,3,4931,[318 515 427 185 313],655,5,20167,4.089010543390105,40.0,0.0
34932,3,4932,[471 385 186 135 300],807,5,20172,4.089195215892966,0.0,0.0
34933,3,4933,[318 515 427 185 313],655,5,20177,4.089379813538711,40.0,0.0
34934,3,4934,[318 515 427 185 313],655,5,20182,4.089564336372847,40.0,0.0
34935,3,4935,[496 357   8 301  56],535,3,20185,4.089343598055105,20.0,0.0
34936,3,4936,[318 515 427 185 313],655,5,20190,4.08952805347377,40.0,0.0
34937,3,4937,[197 191 405 186  50],151,3,20193,4.089307411907655,0.0,20.0
34938,3,4938,[427 100  28  97 435],65,4,20197,4.089289329823851,20.0,20.0
34939,3,4939,[275 318 111 125 211],401,4,20201,4.089271255060729,20.0,20.0
34940,3,4940,[357 125 153  15 265],450,4,20205,4.089253187613843,0.0,0.0
34941,3,4941,[318 515 427 185 313],655,5,20210,4.089437474706597,40.0,0.0
34942,3,4942,[318 515 427 185 313],655,5,20215,4.089621687234473,40.0,0.0
34943,3,4943,[318 515 427 185 313],655,5,20220,4.089805825242719,40.0,0.0
34944,3,4944,[318 515 427 185 313],655,5,20225,4.089989888776542,40.0,0.0
34945,3,4945,[318 515 427 185 313],655,5,20230,4.090173877881116,40.0,0.0
34946,3,4946,[268 237 183 117  88],344,1,20231,4.089549221750556,0.0,0.0
34947,3,4947,[328 588 603 215  50],796,5,20236,4.089733225545675,20.0,20.0
34948,3,4948,[195 180 186 168 182],457,5,20241,4.089917154980804,0.0,0.0
34949,3,4949,[318 515 427 185 313],655,5,20246,4.0901010101010105,40.0,0.0
34950,3,4950,[318 515 427 185 313],655,5,20251,4.090284790951323,40.0,0.0
34951,3,4951,[153  56 181   4 228],280,2,20253,4.08986268174475,0.0,0.0
34952,3,4952,[153  22  50  11  97],330,5,20258,4.09004643650313,0.0,20.0
34953,3,4953,[313 228 195 265 172],807,4,20262,4.090028259991926,0.0,0.0
34954,3,4954,[  7  96 357 182 276],655,3,20265,4.089808274470232,0.0,0.0
34955,3,4955,[318 515 427 185 313],655,5,20270,4.08999192897498,40.0,0.0
34956,3,4956,[318 515 427 185 313],655,5,20275,4.090175509380674,40.0,0.0
34957,3,4957,[318 515 427 185 313],655,5,20280,4.09035901573215,40.0,0.0
34958,3,4958,[318 515 427 185 313],655,5,20285,4.090542448074208,40.0,0.0
34959,3,4959,[748  50 265 258  88],151,4,20289,4.090524193548387,0.0,20.0
34960,3,4960,[282 300   1 215 302],655,1,20290,4.089901229590808,0.0,0.0
34961,3,4961,[215  96  82  56 357],23,2,20292,4.0894800483675935,0.0,0.0
34962,3,4962,[135 202  82 471 127],389,4,20296,4.089462018940157,0.0,20.0
34963,3,4963,[318 515 427 185 313],655,5,20301,4.089645447219984,40.0,0.0
34964,3,4964,[318 515 427 185 313],655,5,20306,4.089828801611279,40.0,0.0
34965,3,4965,[ 89 144 117  15   4],450,3,20309,4.089609343536045,0.0,0.0
34966,3,4966,[357 211  64 300 111],450,5,20314,4.089792631367023,20.0,0.0
34967,3,4967,[318 515 427 185 313],655,5,20319,4.089975845410628,40.0,0.0
34968,3,4968,[318 515 427 185 313],655,5,20324,4.090158985711411,40.0,0.0
34969,3,4969,[318 515 427 185 313],655,5,20329,4.090342052313884,40.0,0.0
34970,3,4970,[318 515 427 185 313],655,5,20334,4.090525045262523,40.0,0.0
34971,3,4971,[117 276 603 271 294],655,2,20336,4.090104585679807,20.0,0.0
34972,3,4972,[204 216 238 655 210],269,2,20338,4.089684295194048,0.0,0.0
34973,3,4973,[318 515 427 185 313],655,5,20343,4.089867310012063,40.0,0.0
34974,3,4974,[318 515 427 185 313],655,5,20348,4.090050251256281,40.0,0.0
34975,3,4975,[215 294 403  88  96],457,4,20352,4.090032154340836,0.0,0.0
34976,3,4976,[ 79 173 742 172 322],796,3,20355,4.089813140446052,0.0,0.0
34977,3,4977,[215 423 546 496 269],450,5,20360,4.089995982322217,20.0,0.0
34978,3,4978,[318 515 427 185 313],655,5,20365,4.0901787507531635,40.0,0.0
34979,3,4979,[496 111 181  11 288],280,4,20369,4.0901606425702814,20.0,0.0
34980,3,4980,[318 515 427 185 313],655,5,20374,4.090343304557318,40.0,0.0
34981,3,4981,[273 603 135 301 313],450,3,20377,4.090124448012846,20.0,0.0
34982,3,4982,[318 515 427 185 313],655,5,20382,4.090307043949428,40.0,0.0
34983,3,4983,[318 515 427 185 313],655,5,20387,4.090489566613162,40.0,0.0
34984,3,4984,[174  64 385 200 235],450,3,20390,4.0902708124373115,20.0,0.0
34985,3,4985,[318 515 427 185 313],655,5,20395,4.09045326915363,40.0,0.0
34986,3,4986,[318 515 427 185 313],655,5,20400,4.090635652697012,40.0,0.0
34987,3,4987,[318 515 427 185 313],655,5,20405,4.090817963111467,40.0,0.0
34988,3,4988,[125 210 143 168 333],174,4,20409,4.090799759470836,0.0,0.0
34989,3,4989,[515   9  96 216 174],655,2,20411,4.090380761523046,0.0,0.0
34990,3,4990,[318 515 427 185 313],655,5,20416,4.0905630134241635,40.0,0.0
34991,3,4991,[318 515 427 185 313],655,5,20421,4.0907451923076925,40.0,0.0
34992,3,4992,[ 56  88 496  28 111],389,3,20424,4.0905267374324055,20.0,0.0
34993,3,4993,[318 515 427 185 313],655,5,20429,4.090708850620745,40.0,0.0
34994,3,4994,[318 515 427 185 313],655,5,20434,4.090890890890891,40.0,0.0
34995,3,4995,[546  88 117 202  11],716,4,20438,4.090872698158527,0.0,0.0
34996,3,4996,[435 588  12 403 183],450,5,20443,4.0910546327796675,0.0,0.0
34997,3,4997,[ 89 132 435 427 173],151,5,20448,4.0912364945978394,20.0,0.0
34998,3,4998,[385  56 237  64 568],716,4,20452,4.09121824364873,20.0,0.0
34999,3,4999,[318 196  79 180 257],716,4,20456,4.0912,20.0,0.0
35000,3,5000,[318 515 427 185 313],655,5,20461,4.091381723655269,40.0,0.0
35001,3,5001,[318 515 427 185 313],655,5,20466,4.09156337465014,40.0,0.0
35002,3,5002,[318 515 427 185 313],655,5,20471,4.091744953028183,40.0,0.0
35003,3,5003,[ 70 186 125 271   7],655,0,20471,4.090927258193445,0.0,0.0
35004,3,5004,[276 271  98 118 318],655,3,20474,4.090709290709291,20.0,0.0
35005,3,5005,[318 515 427 185 313],655,5,20479,4.09089093088294,40.0,0.0
35006,3,5006,[318 515 427 185 313],655,5,20484,4.091072498502097,40.0,0.0
35007,3,5007,[318 515 427 185 313],655,5,20489,4.0912539936102235,40.0,0.0
35008,3,5008,[121 210 197 258 427],151,5,20494,4.091435416250748,20.0,0.0
35009,3,5009,[678 288 257 748 125],938,2,20496,4.091017964071856,0.0,0.0
35010,3,5010,[ 12 151 204 546 174],344,4,20500,4.090999800439034,0.0,0.0
35011,3,5011,[181 118  95 318  56],450,3,20503,4.090782122905028,20.0,0.0
35012,3,5012,[318 515 427 185 313],655,5,20508,4.090963494913225,40.0,0.0
35013,3,5013,[318 515 427 185 313],655,5,20513,4.0911447945751895,40.0,0.0
35014,3,5014,[318 515 427 185 313],655,5,20518,4.091326021934197,40.0,0.0
35015,3,5015,[  4 194  79 132 655],577,5,20523,4.091507177033493,0.0,0.0
35016,3,5016,[ 82 269 475 435 204],655,0,20523,4.090691648395455,0.0,0.0
35017,3,5017,[204 597 187 222 318],450,4,20527,4.090673575129534,20.0,0.0
35018,3,5018,[318 515 427 185 313],655,5,20532,4.090854751942618,40.0,0.0
35019,3,5019,[318 515 427 185 313],655,5,20537,4.091035856573705,40.0,0.0
35020,3,5020,[318 515 427 185 313],655,5,20542,4.091216889065923,40.0,0.0
35021,3,5021,[318 515 427 185 313],655,5,20547,4.091397849462366,40.0,0.0
35022,3,5022,[  1 655  25 196 211],716,5,20552,4.091578737806092,0.0,0.0
35023,3,5023,[318 515 427 185 313],655,5,20557,4.091759554140127,40.0,0.0
35024,3,5024,[211 168 186  11 183],269,2,20559,4.0913432835820895,0.0,0.0
35025,3,5025,[546 183 423 195 742],796,4,20563,4.091325109430959,0.0,0.0
35026,3,5026,[318 515 427 185 313],655,5,20568,4.09150586831112,40.0,0.0
35027,3,5027,[151  82 328 655 748],151,2,20570,4.091089896579157,0.0,0.0
35028,3,5028,[318 515 427 185 313],655,5,20575,4.091270630344005,40.0,0.0
35029,3,5029,[ 97  88 655 153   1],885,3,20578,4.091053677932406,0.0,0.0
35030,3,5030,[271 182 655 333 234],655,1,20579,4.090439276485788,0.0,0.0
35031,3,5031,[318 515 427 185 313],655,5,20584,4.090620031796503,40.0,0.0
35032,3,5032,[318 515 427 185 313],655,5,20589,4.0908007152791575,40.0,0.0
35033,3,5033,[318 515 427 185 313],655,5,20594,4.09098132697656,40.0,0.0
35034,3,5034,[318 515 427 185 313],655,5,20599,4.09116186693148,40.0,0.0
35035,3,5035,[318 515 427 185 313],655,5,20604,4.091342335186656,40.0,0.0
35036,3,5036,[318 515 427 185 313],655,5,20609,4.091522731784792,40.0,0.0
35037,3,5037,[318 515 427 185 313],655,5,20614,4.091703056768559,40.0,0.0
35038,3,5038,[318 515 427 185 313],655,5,20619,4.091883310180592,40.0,0.0
35039,3,5039,[234 258  71  98 176],504,3,20622,4.091666666666667,0.0,0.0
35040,3,5040,[  7 515 182 385   9],655,2,20624,4.091251735766713,0.0,0.0
35041,3,5041,[ 98 245  88 271 183],796,4,20628,4.091233637445458,0.0,0.0
35042,3,5042,[258  25 403 294 179],457,4,20632,4.091215546301805,0.0,0.0
35043,3,5043,[318 515 427 185 313],655,5,20637,4.091395717684377,40.0,0.0
35044,3,5044,[202 282 125 471 135],655,1,20638,4.090782953419227,0.0,0.0
35045,3,5045,[ 97 423 276  79 181],457,5,20643,4.090963139120095,0.0,0.0
35046,3,5046,[318 515 427 185 313],655,5,20648,4.091143253417872,40.0,0.0
35047,3,5047,[318 515 427 185 313],655,5,20653,4.091323296354992,40.0,0.0
35048,3,5048,[179 237 204 289 294],296,3,20656,4.0911071499306795,0.0,0.0
35049,3,5049,[183 143  12 172  28],655,3,20659,4.0908910891089105,0.0,0.0
35050,3,5050,[ 25 135  11  70 168],330,3,20662,4.090675113838844,0.0,0.0
35051,3,5051,[322 294 568 211 313],796,2,20664,4.090261282660332,0.0,0.0
35052,3,5052,[318 515 427 185 313],655,5,20669,4.090441321986939,40.0,0.0
35053,3,5053,[ 50 179 161 216  82],450,4,20673,4.090423426988524,0.0,20.0
35054,3,5054,[215 182 228 588   7],450,5,20678,4.090603363006924,0.0,0.0
35055,3,5055,[318 515 427 185 313],655,5,20683,4.090783227848101,40.0,0.0
35056,3,5056,[748 180 427 271 222],796,4,20687,4.09076527585525,20.0,0.0
35057,3,5057,[318 515 427 185 313],655,5,20692,4.090945037564254,40.0,0.0
35058,3,5058,[153 275 216 588 176],796,5,20697,4.091124728207156,0.0,20.0
35059,3,5059,[318 515 427 185 313],655,5,20702,4.091304347826087,40.0,0.0
35060,3,5060,[153 496 127 180 435],716,4,20706,4.091286307053942,20.0,20.0
35061,3,5061,[318 515 427 185 313],655,5,20711,4.091465823785065,40.0,0.0
35062,3,5062,[182 288 204 216  28],457,5,20716,4.091645269603002,0.0,0.0
35063,3,5063,[318 515 427 185 313],655,5,20721,4.091824644549763,40.0,0.0
35064,3,5064,[117 151 318 181 228],796,5,20726,4.092003948667325,20.0,0.0
35065,3,5065,[ 98   8 597 237 118],344,2,20728,4.091590998815634,0.0,0.0
35066,3,5066,[318 515 427 185 313],655,5,20733,4.0917702782711665,40.0,0.0
35067,3,5067,[318 515 427 185 313],655,5,20738,4.091949486977112,40.0,0.0
35068,3,5068,[318 515 427 185 313],655,5,20743,4.092128624975341,40.0,0.0
35069,3,5069,[153 269 185 197 546],450,5,20748,4.092307692307692,0.0,0.0
35070,3,5070,[ 56 194 215 211 118],151,3,20751,4.092092289489252,0.0,0.0
35071,3,5071,[318 515 427 185 313],655,5,20756,4.092271293375394,40.0,0.0
35072,3,5072,[318 515 427 185 313],655,5,20761,4.092450226690321,40.0,0.0
35073,3,5073,[318 515 427 185 313],655,5,20766,4.092629089475759,40.0,0.0
35074,3,5074,[318 515 427 185 313],655,5,20771,4.092807881773399,40.0,0.0
35075,3,5075,[196 603 195 194 118],72,4,20775,4.092789598108747,20.0,0.0
35076,3,5076,[385 748 275 173 483],796,5,20780,4.092968288359267,0.0,20.0
35077,3,5077,[318 515 427 185 313],655,5,20785,4.093146908231588,40.0,0.0
35078,3,5078,[180  97 185 151 237],504,4,20789,4.093128568615869,0.0,0.0
35079,3,5079,[318 515 427 185 313],655,5,20794,4.093307086614173,40.0,0.0
35080,3,5080,[318 515 427 185 313],655,5,20799,4.093485534343633,40.0,0.0
35081,3,5081,[603  56 275 143 222],655,3,20802,4.093270365997639,20.0,20.0
35082,3,5082,[ 12 179 185 269 273],450,4,20806,4.093252016525674,0.0,0.0
35083,3,5083,[313 257 132 655 176],796,4,20810,4.093233674272226,0.0,0.0
35084,3,5084,[318 515 427 185 313],655,5,20815,4.093411996066863,40.0,0.0
35085,3,5085,[318 515 427 185 313],655,5,20820,4.0935902477388915,40.0,0.0
35086,3,5086,[318 515 427 185 313],655,5,20825,4.093768429329664,40.0,0.0
35087,3,5087,[318 515 427 185 313],655,5,20830,4.093946540880503,40.0,0.0
35088,3,5088,[318 515 427 185 313],655,5,20835,4.094124582432698,40.0,0.0
35089,3,5089,[100 121  69 258 385],344,1,20836,4.093516699410609,0.0,20.0
35090,3,5090,[318 515 427 185 313],655,5,20841,4.093694755450795,40.0,0.0
35091,3,5091,[318 515 427 185 313],655,5,20846,4.093872741555381,40.0,0.0
35092,3,5092,[175 211 174  64 568],269,3,20849,4.093657961908502,20.0,0.0
35093,3,5093,[  1 435 161 121 222],655,0,20849,4.092854338437378,0.0,0.0
35094,3,5094,[197 265  56 655 237],535,3,20852,4.092639842983317,0.0,0.0
35095,3,5095,[ 89 183 194 258   7],151,4,20856,4.0926216640502355,0.0,0.0
35096,3,5096,[318 515 427 185 313],655,5,20861,4.092799686089856,40.0,0.0
35097,3,5097,[300  64 100 318 385],796,4,20865,4.092781482934484,40.0,20.0
35098,3,5098,[318 515 427 185 313],655,5,20870,4.0929594038046675,40.0,0.0
35099,3,5099,[313 143 258  11  64],693,4,20874,4.092941176470588,20.0,0.0
35100,3,5100,[265 288  82 483 228],280,3,20877,4.092726916290923,0.0,0.0
35101,3,5101,[588  28  11 144  79],450,5,20882,4.092904743237946,0.0,0.0
35102,3,5102,[202 211 318 151   4],504,4,20886,4.0928865373309815,20.0,0.0
35103,3,5103,[135 423 742 182 194],457,5,20891,4.093064263322884,0.0,0.0
35104,3,5104,[185 144 568  50 286],655,2,20893,4.092654260528893,0.0,40.0
35105,3,5105,[318 515 427 185 313],655,5,20898,4.09283196239718,40.0,0.0
35106,3,5106,[322 245 234 216 215],280,2,20900,4.092422165654983,0.0,0.0
35107,3,5107,[121 357   7 302  97],151,4,20904,4.092404072043853,0.0,0.0
35108,3,5108,[  7 117 322 603  22],450,5,20909,4.092581718535917,20.0,0.0
35109,3,5109,[286 121 275  15 172],330,5,20914,4.092759295499022,0.0,40.0
35110,3,5110,[313  96 588 216  22],280,4,20918,4.092741146546664,0.0,0.0
35111,3,5111,[318 515 427 185 313],655,5,20923,4.092918622848201,40.0,0.0
35112,3,5112,[318 515 427 185 313],655,5,20928,4.093096029728144,40.0,0.0
35113,3,5113,[132 153 222  88 385],23,4,20932,4.093077825576848,0.0,0.0
35114,3,5114,[318 515 427 185 313],655,5,20937,4.093255131964809,40.0,0.0
35115,3,5115,[121 423   8 385 176],577,5,20942,4.093432369038311,0.0,0.0
35116,3,5116,[286 294  64 143 194],236,3,20945,4.093218682821966,20.0,20.0
35117,3,5117,[318 515 427 185 313],655,5,20950,4.093395857756937,40.0,0.0
35118,3,5118,[181 333 151 117 200],236,1,20951,4.092791560851729,0.0,0.0
35119,3,5119,[318 515 427 185 313],655,5,20956,4.09296875,40.0,0.0
35120,3,5120,[234 185 228 125 238],457,5,20961,4.093145869947276,0.0,0.0
35121,3,5121,[196 222  89 265 603],151,5,20966,4.093322920734089,20.0,0.0
35122,3,5122,[  9 181 568 111  96],280,3,20969,4.093109506148741,0.0,0.0
35123,3,5123,[288 265 204  96 333],655,0,20969,4.092310694769711,0.0,0.0
35124,3,5124,[ 12 196 121 318 182],655,2,20971,4.09190243902439,20.0,0.0
35125,3,5125,[172  70 483 234 195],655,2,20973,4.091494342567304,0.0,0.0
35126,3,5126,[175 211 204 144   4],655,0,20973,4.090696313633704,0.0,0.0
35127,3,5127,[258 313  22  71 234],450,3,20976,4.090483619344774,0.0,0.0
35128,3,5128,[245  50   4 286  64],344,3,20979,4.090271007993761,20.0,40.0
35129,3,5129,[318 515 427 185 313],655,5,20984,4.090448343079922,40.0,0.0
35130,3,5130,[175 286  69   9 172],655,1,20985,4.089846033911519,0.0,20.0
35131,3,5131,[318 515 427 185 313],655,5,20990,4.090023382696804,40.0,0.0
35132,3,5132,[318 515 427 185 313],655,5,20995,4.090200662380674,40.0,0.0
35133,3,5133,[483 153 385 185 168],796,5,21000,4.090377873003506,0.0,0.0
35134,3,5134,[  8 121  12 435 175],655,0,21000,4.089581304771178,0.0,0.0
35135,3,5135,[318 515 427 185 313],655,5,21005,4.089758566978193,40.0,0.0
35136,3,5136,[168 234 195  69 125],796,4,21009,4.089741094023749,0.0,0.0
35137,3,5137,[318 515 427 185 313],655,5,21014,4.08991825613079,40.0,0.0
35138,3,5138,[135 172 127 385 678],280,3,21017,4.089706168515275,0.0,20.0
35139,3,5139,[204 118  98 742   4],457,5,21022,4.08988326848249,0.0,0.0
35140,3,5140,[318 515 427 185 313],655,5,21027,4.090060299552616,40.0,0.0
35141,3,5141,[318 515 427 185 313],655,5,21032,4.09023726176585,40.0,0.0
35142,3,5142,[318 515 427 185 313],655,5,21037,4.090414155162357,40.0,0.0
35143,3,5143,[318 515 427 185 313],655,5,21042,4.090590979782271,40.0,0.0
35144,3,5144,[294 195 405   1 228],716,4,21046,4.090573372206025,0.0,0.0
35145,3,5145,[127  50  70 302 546],450,5,21051,4.090750097162845,0.0,40.0
35146,3,5146,[  9  50 144   4 275],655,2,21053,4.090343889644453,0.0,40.0
35147,3,5147,[318 515 427 185 313],655,5,21058,4.09052059052059,40.0,0.0
35148,3,5148,[121 301 515 127 275],296,5,21063,4.090697222761701,0.0,40.0
35149,3,5149,[318 515 427 185 313],655,5,21068,4.090873786407767,40.0,0.0
35150,3,5150,[318 515 427 185 313],655,5,21073,4.091050281498738,40.0,0.0
35151,3,5151,[238 200 222 204 127],716,5,21078,4.091226708074534,0.0,20.0
35152,3,5152,[318 515 427 185 313],655,5,21083,4.091403066175044,40.0,0.0
35153,3,5153,[318 515 427 185 313],655,5,21088,4.091579355840124,40.0,0.0
35154,3,5154,[216 435 121 546 288],450,3,21091,4.091367604267702,0.0,0.0
35155,3,5155,[318 515 427 185 313],655,5,21096,4.091543832428239,40.0,0.0
35156,3,5156,[318 515 427 185 313],655,5,21101,4.0917199922435525,40.0,0.0
35157,3,5157,[ 64 222 183 235 515],292,3,21104,4.0915083365645595,20.0,0.0
35158,3,5158,[ 25 265 282 273 222],655,1,21105,4.090909090909091,0.0,0.0
35159,3,5159,[318 515 427 185 313],655,5,21110,4.091085271317829,40.0,0.0
35160,3,5160,[318 515 427 185 313],655,5,21115,4.091261383452819,40.0,0.0
35161,3,5161,[318 515 427 185 313],655,5,21120,4.091437427353739,40.0,0.0
35162,3,5162,[185 301 496 275 655],450,5,21125,4.0916134030602365,20.0,20.0
35163,3,5163,[194 228 222 181 301],450,4,21129,4.091595662277304,0.0,0.0
35164,3,5164,[318 515 427 185 313],655,5,21134,4.091771539206196,40.0,0.0
35165,3,5165,[196 275 257 211  70],655,1,21135,4.0911730545876885,0.0,20.0
35166,3,5166,[300 496 216  82 127],796,4,21139,4.09115540932843,20.0,20.0
35167,3,5167,[127   7 210 568  12],655,1,21140,4.090557275541796,0.0,20.0
35168,3,5168,[202 174 153 265 328],796,5,21145,4.090733217256723,0.0,0.0
35169,3,5169,[288 515 125 179   4],655,2,21147,4.090328820116055,0.0,0.0
35170,3,5170,[271 603 211 435 655],655,1,21148,4.089731193192806,20.0,0.0
35171,3,5171,[210 118 597 179  97],450,3,21151,4.089520494972931,0.0,0.0
35172,3,5172,[318 515 427 185 313],655,5,21156,4.089696501063213,40.0,0.0
35173,3,5173,[216 508 222 175 204],344,5,21161,4.08987243911867,0.0,0.0
35174,3,5174,[176 282   8 289  28],655,0,21161,4.0890821256038645,0.0,0.0
35175,3,5175,[318 515 427 185 313],655,5,21166,4.089258114374034,40.0,0.0
35176,3,5176,[318 515 427 185 313],655,5,21171,4.089434035155495,40.0,0.0
35177,3,5177,[496 588 483 323 597],796,4,21175,4.089416763229046,20.0,0.0
35178,3,5178,[318 515 427 185 313],655,5,21180,4.0895925854412045,40.0,0.0
35179,3,5179,[318 515 427 185 313],655,5,21185,4.08976833976834,40.0,0.0
35180,3,5180,[318 515 427 185 313],655,5,21190,4.089944026249759,40.0,0.0
35181,3,5181,[318 515 427 185 313],655,5,21195,4.09011964492474,40.0,0.0
35182,3,5182,[121  96 204  69 210],269,0,21195,4.089330503569362,0.0,0.0
35183,3,5183,[318 515 427 185 313],655,5,21200,4.089506172839506,40.0,0.0
35184,3,5184,[318 515 427 185 313],655,5,21205,4.089681774349084,40.0,0.0
35185,3,5185,[423 405 195  22 132],269,2,21207,4.089278827612803,0.0,0.0
35186,3,5186,[257 117 200 228 483],796,5,21212,4.089454405243879,0.0,0.0
35187,3,5187,[318 515 427 185 313],655,5,21217,4.0896299151888975,40.0,0.0
35188,3,5188,[318 515 427 185 313],655,5,21222,4.089805357486992,40.0,0.0
35189,3,5189,[318 515 427 185 313],655,5,21227,4.089980732177264,40.0,0.0
35190,3,5190,[111 238 173 268 194],629,5,21232,4.090156039298787,0.0,0.0
35191,3,5191,[ 12 181 237 405 168],503,3,21235,4.089946070878274,0.0,0.0
35192,3,5192,[318 515 427 185 313],655,5,21240,4.090121317157712,40.0,0.0
35193,3,5193,[197  82 135 196 132],151,4,21244,4.090103966114747,0.0,0.0
35194,3,5194,[318 515 427 185 313],655,5,21249,4.090279114533205,40.0,0.0
35195,3,5195,[318 515 427 185 313],655,5,21254,4.090454195535027,40.0,0.0
35196,3,5196,[742 117   1 302 125],450,5,21259,4.09062920915913,0.0,0.0
35197,3,5197,[318 515 427 185 313],655,5,21264,4.090804155444402,40.0,0.0
35198,3,5198,[318 515 427 185 313],655,5,21269,4.090979034429698,40.0,0.0
35199,3,5199,[318 515 427 185 313],655,5,21274,4.091153846153846,40.0,0.0
35200,3,5200,[318 515 427 185 313],655,5,21279,4.091328590655643,40.0,0.0
35201,3,5201,[318 515 427 185 313],655,5,21284,4.091503267973856,40.0,0.0
35202,3,5202,[546 174 286 265 161],786,5,21289,4.091677878147223,0.0,20.0
35203,3,5203,[153 678  25 151 161],401,1,21290,4.09108378170638,0.0,0.0
35204,3,5204,[200 202 181 172   1],330,5,21295,4.091258405379443,0.0,0.0
35205,3,5205,[318 515 427 185 313],655,5,21300,4.091432961966961,40.0,0.0
35206,3,5206,[318 515 427 185 313],655,5,21305,4.091607451507586,40.0,0.0
35207,3,5207,[ 98 234 265  88 111],457,4,21309,4.091589861751152,0.0,0.0
35208,3,5208,[181 153 174  89 515],18,3,21312,4.091380303321175,0.0,0.0
35209,3,5209,[ 79   8 210 603  25],535,4,21316,4.091362763915547,20.0,0.0
35210,3,5210,[318 515 427 185 313],655,5,21321,4.09153713298791,40.0,0.0
35211,3,5211,[318 515 427 185 313],655,5,21326,4.091711435149655,40.0,0.0
35212,3,5212,[318 515 427 185 313],655,5,21331,4.091885670439287,40.0,0.0
35213,3,5213,[  4 228 742 475 257],655,0,21331,4.091100882240123,0.0,0.0
35214,3,5214,[ 97 322 151 568 118],450,4,21335,4.091083413231064,0.0,0.0
35215,3,5215,[118 176 471 180 195],72,3,21338,4.090874233128834,0.0,0.0
35216,3,5216,[ 50 202 568  12  28],796,4,21342,4.09085681426107,0.0,20.0
35217,3,5217,[268 204 195 100   4],535,3,21345,4.0906477577615945,0.0,20.0
35218,3,5218,[318 515 427 185 313],655,5,21350,4.090821996551063,40.0,0.0
35219,3,5219,[179 168  98 196   8],18,3,21353,4.0906130268199234,0.0,0.0
35220,3,5220,[181 568 132 204 118],796,5,21358,4.090787205516184,0.0,0.0
35221,3,5221,[288 245 228 301 235],344,3,21361,4.090578322481807,0.0,0.0
35222,3,5222,[483 328 471 200 405],655,2,21363,4.090178058587019,0.0,0.0
35223,3,5223,[ 12 210 143 427 125],577,3,21366,4.089969372128637,20.0,0.0
35224,3,5224,[ 28 181 183 204 197],796,3,21369,4.089760765550239,0.0,0.0
35225,3,5225,[318 515 427 185 313],655,5,21374,4.08993494068121,40.0,0.0
35226,3,5226,[318 515 427 185 313],655,5,21379,4.090109049167783,40.0,0.0
35227,3,5227,[318 515 427 185 313],655,5,21384,4.090283091048202,40.0,0.0
35228,3,5228,[603  96 195 597 204],450,5,21389,4.090457066360681,20.0,0.0
35229,3,5229,[ 96  95 173 117 403],450,4,21393,4.090439770554493,0.0,0.0
35230,3,5230,[118  50 216 197  64],457,5,21398,4.090613649397821,20.0,20.0
35231,3,5231,[211 121 655   9 111],655,0,21398,4.089831804281346,0.0,0.0
35232,3,5232,[127 294 427 204 194],296,4,21402,4.0898146378750235,20.0,20.0
35233,3,5233,[318 515 427 185 313],655,5,21407,4.089988536492166,40.0,0.0
35234,3,5234,[471 181 185 302 475],655,2,21409,4.089589302769818,0.0,0.0
35235,3,5235,[118  15  82 403 238],330,5,21414,4.089763177998472,0.0,0.0
35236,3,5236,[228  89 195 271 180],796,4,21418,4.089746037807905,0.0,0.0
35237,3,5237,[318 515 427 185 313],655,5,21423,4.08991981672394,40.0,0.0
35238,3,5238,[181 271 127  79   9],655,2,21425,4.089520900935293,0.0,20.0
35239,3,5239,[318 515 427 185 313],655,5,21430,4.0896946564885495,40.0,0.0
35240,3,5240,[318 515 427 185 313],655,5,21435,4.089868345735547,40.0,0.0
35241,3,5241,[318 515 427 185 313],655,5,21440,4.090041968714231,40.0,0.0
35242,3,5242,[161  71 197 125 357],504,5,21445,4.090215525462521,0.0,0.0
35243,3,5243,[286 483  98 176 423],389,4,21449,4.090198321891686,0.0,20.0
35244,3,5244,[318 515 427 185 313],655,5,21454,4.090371782650143,40.0,0.0
35245,3,5245,[318 515 427 185 313],655,5,21459,4.090545177277926,40.0,0.0
35246,3,5246,[318 515 427 185 313],655,5,21464,4.090718505812846,40.0,0.0
35247,3,5247,[143 151 742  50 118],756,3,21467,4.090510670731708,0.0,20.0
35248,3,5248,[121 235  22  69 403],450,3,21470,4.0903029148409225,0.0,0.0
35249,3,5249,[318 515 427 185 313],655,5,21475,4.09047619047619,40.0,0.0
35250,3,5250,[ 71 153 423  22 655],280,4,21479,4.090458960198058,0.0,0.0
35251,3,5251,[161  11  28 222 483],655,1,21480,4.0898705255140895,0.0,0.0
35252,3,5252,[  7 121 237  95 200],577,3,21483,4.0896630496858934,0.0,0.0
35253,3,5253,[179  88 655   7 196],577,2,21485,4.0892653216596875,0.0,0.0
35254,3,5254,[196 132 195  70 197],504,4,21489,4.089248334919125,0.0,0.0
35255,3,5255,[191  69 204  79 172],18,2,21491,4.088850837138509,0.0,0.0
35256,3,5256,[111 301  22 403 187],655,1,21492,4.088263268023588,0.0,0.0
35257,3,5257,[318 515 427 185 313],655,5,21497,4.088436667934576,40.0,0.0
35258,3,5258,[318 515 427 185 313],655,5,21502,4.088610001901502,40.0,0.0
35259,3,5259,[546 322  70 276  25],593,1,21503,4.088022813688213,0.0,0.0
35260,3,5260,[318 515 427 185 313],655,5,21508,4.088196160425775,40.0,0.0
35261,3,5261,[318 515 427 185 313],655,5,21513,4.088369441277081,40.0,0.0
35262,3,5262,[318 515 427 185 313],655,5,21518,4.088542656279689,40.0,0.0
35263,3,5263,[318 515 427 185 313],655,5,21523,4.088715805471125,40.0,0.0
35264,3,5264,[ 88 276  82 385 286],280,3,21526,4.088509021842355,0.0,20.0
35265,3,5265,[318 515 427 185 313],655,5,21531,4.088682111659704,40.0,0.0
35266,3,5266,[318 515 427 185 313],655,5,21536,4.088855135750902,40.0,0.0
35267,3,5267,[318 515 427 185 313],655,5,21541,4.089028094153379,40.0,0.0
35268,3,5268,[ 88 269 282 655  28],796,2,21543,4.088631618903018,0.0,0.0
35269,3,5269,[ 88 204  96 153 323],280,2,21545,4.088235294117647,0.0,0.0
35270,3,5270,[318 515 427 185 313],655,5,21550,4.088408271675204,40.0,0.0
35271,3,5271,[  8  98 175 318  97],18,5,21555,4.088581183611533,20.0,0.0
35272,3,5272,[153 172  98 135 328],151,3,21558,4.088374739237626,0.0,0.0
35273,3,5273,[275 245 127  11 174],629,3,21561,4.0881683731513085,0.0,40.0
35274,3,5274,[318 515 427 185 313],655,5,21566,4.088341232227489,40.0,0.0
35275,3,5275,[318 515 427 185 313],655,5,21571,4.088514025777104,40.0,0.0
35276,3,5276,[318 515 427 185 313],655,5,21576,4.088686753837408,40.0,0.0
35277,3,5277,[204 568  70 328 546],450,5,21581,4.088859416445623,0.0,0.0
35278,3,5278,[222   8 515 202  79],655,2,21583,4.088463724190188,0.0,0.0
35279,3,5279,[176 202 405 496  25],716,4,21587,4.08844696969697,20.0,0.0
35280,3,5280,[318 515 427 185 313],655,5,21592,4.088619579625071,40.0,0.0
35281,3,5281,[318 515 427 185 313],655,5,21597,4.088792124195381,40.0,0.0
35282,3,5282,[132   8   1  88 427],503,5,21602,4.088964603445012,20.0,0.0
35283,3,5283,[ 22  96 496 215  70],716,4,21606,4.088947766843301,20.0,0.0
35284,3,5284,[318 515 427 185 313],655,5,21611,4.089120151371807,40.0,0.0
35285,3,5285,[568  89 245 282  50],796,4,21615,4.089103291713961,0.0,20.0
35286,3,5286,[318 515 427 185 313],655,5,21620,4.089275581615283,40.0,0.0
35287,3,5287,[318 515 427 185 313],655,5,21625,4.089447806354009,40.0,0.0
35288,3,5288,[211 125 183 748 168],796,4,21629,4.0894308943089435,0.0,0.0
35289,3,5289,[ 15   7 302 196 603],655,2,21631,4.089035916824197,20.0,0.0
35290,3,5290,[  7  56 174  79  98],421,4,21635,4.089019089019089,0.0,0.0
35291,3,5291,[318 515 427 185 313],655,5,21640,4.089191232048375,40.0,0.0
35292,3,5292,[183 471 216 748  88],450,5,21645,4.089363310032118,0.0,0.0
35293,3,5293,[427 161 655 195  11],693,3,21648,4.0891575368341515,20.0,0.0
35294,3,5294,[300  71 742 183 186],796,3,21651,4.088951841359774,0.0,0.0
35295,3,5295,[318 515 427 185 313],655,5,21656,4.089123867069486,40.0,0.0
35296,3,5296,[318 515 427 185 313],655,5,21661,4.089295827827072,40.0,0.0
35297,3,5297,[318 515 427 185 313],655,5,21666,4.089467723669309,40.0,0.0
35298,3,5298,[318 515 427 185 313],655,5,21671,4.089639554632949,40.0,0.0
35299,3,5299,[318 515 427 185 313],655,5,21676,4.089811320754717,40.0,0.0
35300,3,5300,[357 275 215 288  25],344,4,21680,4.089794378419167,0.0,20.0
35301,3,5301,[318 515 427 185 313],655,5,21685,4.0899660505469635,40.0,0.0
35302,3,5302,[318 515 427 185 313],655,5,21690,4.090137657929474,40.0,0.0
35303,3,5303,[655  97  15 357 301],593,4,21694,4.090120663650075,0.0,0.0
35304,3,5304,[175 111 301 173 197],151,5,21699,4.090292177191329,0.0,0.0
35305,3,5305,[318 515 427 185 313],655,5,21704,4.090463626083679,40.0,0.0
35306,3,5306,[187 127 211 405 483],450,4,21708,4.090446579988694,0.0,20.0
35307,3,5307,[ 15 211 202 187 265],655,1,21709,4.089864355689525,0.0,0.0
35308,3,5308,[318 515 427 185 313],655,5,21714,4.090035788284046,40.0,0.0
35309,3,5309,[471 288  88 186 202],450,3,21717,4.089830508474576,0.0,0.0
35310,3,5310,[333 238  82  12 194],796,3,21720,4.089625305968744,0.0,0.0
35311,3,5311,[271 269  79 202 273],655,2,21722,4.089231927710843,0.0,0.0
35312,3,5312,[318 515 427 185 313],655,5,21727,4.0894033502729155,40.0,0.0
35313,3,5313,[435 333 200 144 269],629,4,21731,4.089386526157321,0.0,0.0
35314,3,5314,[318 515 427 185 313],655,5,21736,4.089557855126999,40.0,0.0
35315,3,5315,[235 318 515 357 483],401,4,21740,4.0895410082769,20.0,0.0
35316,3,5316,[318 515 427 185 313],655,5,21745,4.089712243746473,40.0,0.0
35317,3,5317,[318 301  82 269 322],450,4,21749,4.0896953742008275,20.0,0.0
35318,3,5318,[216  28 176   1 197],457,5,21754,4.089866516262456,0.0,0.0
35319,3,5319,[318 515 427 185 313],655,5,21759,4.090037593984962,40.0,0.0
35320,3,5320,[318 515 427 185 313],655,5,21764,4.090208607404623,40.0,0.0
35321,3,5321,[435  64   7 603 216],321,4,21768,4.090191657271703,40.0,0.0
35322,3,5322,[174 172  88  98 742],457,5,21773,4.090362577493894,0.0,0.0
35323,3,5323,[125 210  82  88 245],280,0,21773,4.089594290007513,0.0,0.0
35324,3,5324,[318 515 427 185 313],655,5,21778,4.089765258215962,40.0,0.0
35325,3,5325,[174 237  50 185 215],716,5,21783,4.089936162223057,0.0,20.0
35326,3,5326,[318 515 427 185 313],655,5,21788,4.090107002064952,40.0,0.0
35327,3,5327,[176 173  12 471   1],457,5,21793,4.090277777777778,0.0,0.0
35328,3,5328,[603 127  88 168 151],401,2,21795,4.089885531994746,20.0,20.0
35329,3,5329,[318 515 427 185 313],655,5,21800,4.090056285178236,40.0,0.0
35330,3,5330,[318 515 427 185 313],655,5,21805,4.090226974301257,40.0,0.0
35331,3,5331,[318 515 427 185 313],655,5,21810,4.09039759939985,40.0,0.0
35332,3,5332,[318 515 427 185 313],655,5,21815,4.090568160510032,40.0,0.0
35333,3,5333,[194  97 196 568 385],450,5,21820,4.090738657667791,0.0,0.0
35334,3,5334,[568 204 318   9 385],593,4,21824,4.090721649484536,20.0,0.0
35335,3,5335,[318 515 427 185 313],655,5,21829,4.090892053973014,40.0,0.0
35336,3,5336,[318 515 427 185 313],655,5,21834,4.09106239460371,40.0,0.0
35337,3,5337,[318 515 427 185 313],655,5,21839,4.091232671412514,40.0,0.0
35338,3,5338,[ 15 194 385 588 496],796,5,21844,4.091402884435287,20.0,0.0
35339,3,5339,[318 515 427 185 313],655,5,21849,4.091573033707865,40.0,0.0
35340,3,5340,[318 515 427 185 313],655,5,21854,4.091743119266055,40.0,0.0
35341,3,5341,[318 515 427 185 313],655,5,21859,4.091913141145638,40.0,0.0
35342,3,5342,[276  11 427  96 273],655,3,21862,4.091708777840164,20.0,0.0
35343,3,5343,[ 56 742 202  64 257],796,4,21866,4.091691616766467,20.0,0.0
35344,3,5344,[318 515 427 185 313],655,5,21871,4.091861552853134,40.0,0.0
35345,3,5345,[318 515 427 185 313],655,5,21876,4.092031425364759,40.0,0.0
35346,3,5346,[ 98 196  22 597 175],457,4,21880,4.092014213577707,0.0,0.0
35347,3,5347,[ 79 265 200 222 597],450,3,21883,4.0918100224382945,0.0,0.0
35348,3,5348,[597   1 357  79 288],457,4,21887,4.09179285847822,0.0,0.0
35349,3,5349,[318 515 427 185 313],655,5,21892,4.09196261682243,40.0,0.0
35350,3,5350,[ 70 405 173 186 194],151,4,21896,4.091945430760606,0.0,0.0
35351,3,5351,[ 56 183 202 144   4],655,1,21897,4.091367713004484,0.0,0.0
35352,3,5352,[318 515 427 185 313],655,5,21902,4.091537455632356,40.0,0.0
35353,3,5353,[318 515 427 185 313],655,5,21907,4.091707134852447,40.0,0.0
35354,3,5354,[318 515 427 185 313],655,5,21912,4.09187675070028,40.0,0.0
35355,3,5355,[ 82 333 153 121 496],796,4,21916,4.091859596713966,20.0,0.0
35356,3,5356,[318 515 427 185 313],655,5,21921,4.092029120776554,40.0,0.0
35357,3,5357,[181 234 385 185 323],23,3,21924,4.091825307950728,0.0,0.0
35358,3,5358,[318 515 427 185 313],655,5,21929,4.091994775144617,40.0,0.0
35359,3,5359,[ 79 216 588  56 286],280,5,21934,4.092164179104477,0.0,20.0
35360,3,5360,[318 515 427 185 313],655,5,21939,4.092333519865696,40.0,0.0
35361,3,5361,[318 515 427 185 313],655,5,21944,4.0925027974636325,40.0,0.0
35362,3,5362,[318 515 427 185 313],655,5,21949,4.092672011933619,40.0,0.0
35363,3,5363,[318 515 427 185 313],655,5,21954,4.092841163310962,40.0,0.0
35364,3,5364,[ 88 196 200 257  25],655,1,21955,4.092264678471575,0.0,0.0
35365,3,5365,[ 98 385  96 186 181],450,4,21959,4.092247484159523,0.0,0.0
35366,3,5366,[318 515 427 185 313],655,5,21964,4.092416620085709,40.0,0.0
35367,3,5367,[ 56  96 196   8 427],269,2,21966,4.092026825633383,20.0,0.0
35368,3,5368,[318 515 427 185 313],655,5,21971,4.092195939653567,40.0,0.0
35369,3,5369,[318 515 427 185 313],655,5,21976,4.092364990689013,40.0,0.0
35370,3,5370,[132  69 168 173 234],269,2,21978,4.0919754235710295,0.0,0.0
35371,3,5371,[ 69 185 423  56 405],269,3,21981,4.091772151898734,0.0,0.0
35372,3,5372,[318 515 427 185 313],655,5,21986,4.091941187418574,40.0,0.0
35373,3,5373,[385 127 153  22 288],450,4,21990,4.0919240788983995,0.0,20.0
35374,3,5374,[318 515 427 185 313],655,5,21995,4.092093023255814,40.0,0.0
35375,3,5375,[100 235  70  11 357],401,3,21998,4.091889880952381,0.0,20.0
35376,3,5376,[151 234  95 174 194],716,5,22003,4.092058768830203,0.0,0.0
35377,3,5377,[245 385 125   4 655],504,5,22008,4.092227593901079,0.0,0.0
35378,3,5378,[151 196  50  97 153],796,4,22012,4.092210448038669,0.0,20.0
35379,3,5379,[ 70 121 228 273  88],344,2,22014,4.09182156133829,0.0,0.0
35380,3,5380,[427  56 655 318 237],716,5,22019,4.0919903363687045,40.0,0.0
35381,3,5381,[318 515 427 185 313],655,5,22024,4.092159048680788,40.0,0.0
35382,3,5382,[161  71 357 121 144],593,5,22029,4.092327698309493,0.0,0.0
35383,3,5383,[318 515 427 185 313],655,5,22034,4.092496285289747,40.0,0.0
35384,3,5384,[210 191 357 300 143],151,4,22038,4.092479108635097,0.0,0.0
35385,3,5385,[ 97 258 222   1 182],655,1,22039,4.091904938730041,0.0,0.0
35386,3,5386,[186   1 175 655 435],151,5,22044,4.092073510302581,0.0,0.0
35387,3,5387,[ 56 172 318 357 200],655,4,22048,4.092056421677802,20.0,0.0
35388,3,5388,[318 515 427 185 313],655,5,22053,4.0922249025793285,40.0,0.0
35389,3,5389,[318 515 427 185 313],655,5,22058,4.092393320964749,40.0,0.0
35390,3,5390,[318 515 427 185 313],655,5,22063,4.092561676868855,40.0,0.0
35391,3,5391,[318 515 427 185 313],655,5,22068,4.09272997032641,40.0,0.0
35392,3,5392,[202 603 286  50 197],330,5,22073,4.092898201372149,20.0,40.0
35393,3,5393,[ 50 301 322 111 168],796,3,22076,4.092695587690026,0.0,20.0
35394,3,5394,[318 515 427 185 313],655,5,22081,4.0928637627432805,40.0,0.0
35395,3,5395,[195  97 132 143 185],236,4,22085,4.092846553002224,0.0,0.0
35396,3,5396,[216  79 176 237 302],450,5,22090,4.093014637761719,0.0,0.0
35397,3,5397,[318 515 427 185 313],655,5,22095,4.093182660244535,40.0,0.0
35398,3,5398,[318 515 427 185 313],655,5,22100,4.093350620485275,40.0,0.0
35399,3,5399,[194 313 153 238  50],450,5,22105,4.093518518518518,0.0,20.0
35400,3,5400,[318 515 427 185 313],655,5,22110,4.093686354378819,40.0,0.0
35401,3,5401,[282 228 318  50 144],280,1,22111,4.093113661606813,20.0,20.0
35402,3,5402,[174 132 187 568  64],389,4,22115,4.09309642791042,20.0,0.0
35403,3,5403,[318 515 427 185 313],655,5,22120,4.0932642487046635,40.0,0.0
35404,3,5404,[191 238 276 289 216],786,4,22124,4.093246993524514,0.0,0.0
35405,3,5405,[318 515 427 185 313],655,5,22129,4.0934147243803185,40.0,0.0
35406,3,5406,[318 515 427 185 313],655,5,22134,4.093582393194008,40.0,0.0
35407,3,5407,[ 96 323  71 144 258],796,4,22138,4.093565088757397,0.0,0.0
35408,3,5408,[ 28   8  56  25 173],389,3,22141,4.093362913662414,0.0,0.0
35409,3,5409,[318 515 427 185 313],655,5,22146,4.0935304990757855,40.0,0.0
35410,3,5410,[318 515 427 185 313],655,5,22151,4.093698022546664,40.0,0.0
35411,3,5411,[196   7 269  56 508],535,4,22155,4.093680709534368,0.0,0.0
35412,3,5412,[318 515 427 185 313],655,5,22160,4.093848143358581,40.0,0.0
35413,3,5413,[144  88 181 603  97],450,5,22165,4.094015515330624,20.0,0.0
35414,3,5414,[318 515 427 185 313],655,5,22170,4.094182825484765,40.0,0.0
35415,3,5415,[318 515 427 185 313],655,5,22175,4.094350073855244,40.0,0.0
35416,3,5416,[318 515 427 185 313],655,5,22180,4.0945172604762785,40.0,0.0
35417,3,5417,[318 515 427 185 313],655,5,22185,4.09468438538206,40.0,0.0
35418,3,5418,[185  25 269 603 194],264,5,22190,4.094851448606754,20.0,0.0
35419,3,5419,[483 288  64 328 211],655,2,22192,4.094464944649446,20.0,0.0
35420,3,5420,[322  89  69 423 403],450,5,22197,4.094631986718317,0.0,0.0
35421,3,5421,[216   8 144 125 405],457,5,22202,4.094798967170786,0.0,0.0
35422,3,5422,[318 515 427 185 313],655,5,22207,4.094965886040937,40.0,0.0
35423,3,5423,[ 15 323 121 748 546],938,1,22208,4.094395280235989,0.0,0.0
35424,3,5424,[181 118 211  69 143],716,4,22212,4.094377880184332,0.0,0.0
35425,3,5425,[257 117 187 289  56],655,1,22213,4.093807593070402,0.0,0.0
35426,3,5426,[276  64   1  82  15],18,4,22217,4.093790307720656,20.0,0.0
35427,3,5427,[328  28 143 286 151],450,5,22222,4.093957258658806,0.0,20.0
35428,3,5428,[318 515 427 185 313],655,5,22227,4.094124148093572,40.0,0.0
35429,3,5429,[237  50 194 172 200],450,4,22231,4.094106813996317,0.0,20.0
35430,3,5430,[546 742 301 100  12],796,2,22233,4.0937212299760635,0.0,20.0
35431,3,5431,[318 515 427 185 313],655,5,22238,4.093888070692194,40.0,0.0
35432,3,5432,[496 313 427 269 168],707,2,22240,4.0935026688753915,40.0,0.0
35433,3,5433,[318 515 427 185 313],655,5,22245,4.093669488406331,40.0,0.0
35434,3,5434,[265 211 228 176 269],796,3,22248,4.09346826126955,0.0,0.0
35435,3,5435,[423 127 172 211 655],786,5,22253,4.093635025754231,0.0,20.0
35436,3,5436,[318 515 427 185 313],655,5,22258,4.093801728894611,40.0,0.0
35437,3,5437,[603 427 515 196 237],655,3,22261,4.093600588451636,40.0,0.0
35438,3,5438,[318 515 427 185 313],655,5,22266,4.093767236624379,40.0,0.0
35439,3,5439,[748   4 204 174 228],151,4,22270,4.09375,0.0,0.0
35440,3,5440,[174 655 222 322 403],796,3,22273,4.093548979966918,0.0,0.0
35441,3,5441,[318 515 427 185 313],655,5,22278,4.093715545755237,40.0,0.0
35442,3,5442,[318 195 191 210 237],269,2,22280,4.09333088370384,20.0,0.0
35443,3,5443,[318 515 427 185 313],655,5,22285,4.093497428361499,40.0,0.0
35444,3,5444,[302  97 742  25 174],344,3,22288,4.093296602387512,0.0,0.0
35445,3,5445,[318 515 427 185 313],655,5,22293,4.093463092177745,40.0,0.0
35446,3,5446,[127 603   4 176 197],450,4,22297,4.093445933541399,20.0,20.0
35447,3,5447,[423 678 282 269 435],942,3,22300,4.093245227606461,0.0,0.0
35448,3,5448,[318 515 427 185 313],655,5,22305,4.093411635162415,40.0,0.0
35449,3,5449,[318 515 427 185 313],655,5,22310,4.093577981651376,40.0,0.0
35450,3,5450,[301 195 135 258 265],655,1,22311,4.093010456796918,0.0,0.0
35451,3,5451,[318 515 427 185 313],655,5,22316,4.093176815847396,40.0,0.0
35452,3,5452,[318 515 427 185 313],655,5,22321,4.093343113882266,40.0,0.0
35453,3,5453,[210 161 385 174 405],593,3,22324,4.093142647598093,0.0,0.0
35454,3,5454,[318 515 427 185 313],655,5,22329,4.093308890925756,40.0,0.0
35455,3,5455,[176 111 483  89  82],655,2,22331,4.092925219941349,0.0,0.0
35456,3,5456,[318 515 427 185 313],655,5,22336,4.093091442184351,40.0,0.0
35457,3,5457,[183 318  15 300 216],655,3,22339,4.0928911689263465,20.0,0.0
35458,3,5458,[318 515 427 185 313],655,5,22344,4.093057336508518,40.0,0.0
35459,3,5459,[ 71 237 318 174  56],18,4,22348,4.093040293040293,20.0,0.0
35460,3,5460,[ 56 161 117   4  12],280,4,22352,4.093023255813954,0.0,0.0
35461,3,5461,[237 132 546  15   1],786,4,22356,4.0930062248260715,0.0,0.0
35462,3,5462,[588  69 195  89 265],457,5,22361,4.093172249679663,0.0,0.0
35463,3,5463,[318 515 427 185 313],655,5,22366,4.093338213762811,40.0,0.0
35464,3,5464,[172 211 568 132   7],693,3,22369,4.093138151875571,0.0,0.0
35465,3,5465,[265 183 125 328 194],796,5,22374,4.093304061470911,0.0,0.0
35466,3,5466,[318 515 427 185 313],655,5,22379,4.093469910371319,40.0,0.0
35467,3,5467,[174 258 313  98 257],655,2,22381,4.093087051938552,0.0,0.0
35468,3,5468,[318 515 427 185 313],655,5,22386,4.0932528798683485,40.0,0.0
35469,3,5469,[318 515 427 185 313],655,5,22391,4.093418647166362,40.0,0.0
35470,3,5470,[172 286 405 100  70],401,2,22393,4.0930360080424055,0.0,40.0
35471,3,5471,[318 515 427 185 313],655,5,22398,4.093201754385965,40.0,0.0
35472,3,5472,[318 515 427 185 313],655,5,22403,4.093367440160789,40.0,0.0
35473,3,5473,[318 515 427 185 313],655,5,22408,4.093533065400073,40.0,0.0
35474,3,5474,[237 161   1 196   8],457,5,22413,4.093698630136986,0.0,0.0
35475,3,5475,[318 515 427 185 313],655,5,22418,4.093864134404675,40.0,0.0
35476,3,5476,[328 168 216 603 210],401,4,22422,4.093846996530948,20.0,0.0
35477,3,5477,[318 515 427 185 313],655,5,22427,4.094012413289522,40.0,0.0
35478,3,5478,[318 515 427 185 313],655,5,22432,4.094177769665998,40.0,0.0
35479,3,5479,[197 588 173 275   4],457,5,22437,4.0943430656934305,0.0,20.0
35480,3,5480,[318 515 427 185 313],655,5,22442,4.094508301404853,40.0,0.0
35481,3,5481,[318 515 427 185 313],655,5,22447,4.094673476833273,40.0,0.0
35482,3,5482,[276  97 180 125  70],18,4,22451,4.094656210103958,0.0,0.0
35483,3,5483,[127 172  79 515 471],716,4,22455,4.094638949671772,0.0,20.0
35484,3,5484,[245 211 191 273 427],796,2,22457,4.094257064721969,20.0,0.0
35485,3,5485,[151 202  89 282 111],796,5,22462,4.094422165512213,0.0,0.0
35486,3,5486,[  1  96 197 195 403],280,2,22464,4.094040459267359,0.0,0.0
35487,3,5487,[ 89 313 597 181  69],344,1,22465,4.09347667638484,0.0,0.0
35488,3,5488,[117  95 202 302 153],450,4,22469,4.093459646565859,0.0,0.0
35489,3,5489,[132  98 237 210  69],236,4,22473,4.093442622950819,0.0,0.0
35490,3,5490,[318 515 427 185 313],655,5,22478,4.093607721726461,40.0,0.0
35491,3,5491,[318 515 427 185 313],655,5,22483,4.093772760378733,40.0,0.0
35492,3,5492,[318 515 427 185 313],655,5,22488,4.09393773894047,40.0,0.0
35493,3,5493,[318 515 427 185 313],655,5,22493,4.094102657444485,40.0,0.0
35494,3,5494,[435  50   9 508 286],655,1,22494,4.09353958143767,0.0,40.0
35495,3,5495,[318 515 427 185 313],655,5,22499,4.093704512372635,40.0,0.0
35496,3,5496,[302 471 174 196 258],344,3,22502,4.09350554848099,0.0,0.0
35497,3,5497,[318 515 427 185 313],655,5,22507,4.093670425609313,40.0,0.0
35498,3,5498,[127  96 286 168 186],450,4,22511,4.093653391525732,0.0,40.0
35499,3,5499,[273 182  71 100 202],796,3,22514,4.093454545454545,0.0,20.0
35500,3,5500,[483 187 180   7 100],535,4,22518,4.093437556807853,0.0,20.0
35501,3,5501,[318 515 427 185 313],655,5,22523,4.093602326426754,40.0,0.0
35502,3,5502,[318 515 427 185 313],655,5,22528,4.0937670361620935,40.0,0.0
35503,3,5503,[318 515 427 185 313],655,5,22533,4.093931686046512,40.0,0.0
35504,3,5504,[191  88 483 202 151],401,4,22537,4.093914623069937,0.0,0.0
35505,3,5505,[318 515 427 185 313],655,5,22542,4.094079186342173,40.0,0.0
35506,3,5506,[211 403 204  71  22],796,4,22546,4.094062102778282,0.0,0.0
35507,3,5507,[118 568 357  88 235],344,2,22548,4.093681917211329,0.0,0.0
35508,3,5508,[318 515 427 185 313],655,5,22553,4.093846433109457,40.0,0.0
35509,3,5509,[143 222 234  82 183],716,4,22557,4.09382940108893,0.0,0.0
35510,3,5510,[403 423 655  56 185],693,2,22559,4.09344946470695,0.0,0.0
35511,3,5511,[  7 194  70 211 144],23,3,22562,4.093251088534108,0.0,0.0
35512,3,5512,[153 172 211  97  82],450,4,22566,4.093234173771086,0.0,0.0
35513,3,5513,[318 515 427 185 313],655,5,22571,4.093398621690243,40.0,0.0
35514,3,5514,[ 71 313 403   1 168],807,5,22576,4.093563009972802,0.0,0.0
35515,3,5515,[269 222 496  89 238],796,3,22579,4.093364757070341,20.0,0.0
35516,3,5516,[234 127  22 258 111],878,2,22581,4.092985318107667,0.0,20.0
35517,3,5517,[118 318   7 153  97],151,3,22584,4.092787241754259,20.0,0.0
35518,3,5518,[238 125 300 153   8],655,0,22584,4.0920456604457325,0.0,0.0
35519,3,5519,[265 161 546 588  56],796,5,22589,4.092210144927536,0.0,0.0
35520,3,5520,[318 515 427 185 313],655,5,22594,4.092374569824307,40.0,0.0
35521,3,5521,[276  12  56 173 135],629,5,22599,4.092538935168418,0.0,0.0
35522,3,5522,[318 515 427 185 313],655,5,22604,4.092703240992214,40.0,0.0
35523,3,5523,[318 515 427 185 313],655,5,22609,4.092867487328023,40.0,0.0
35524,3,5524,[121   4 546  12 117],256,5,22614,4.093031674208145,0.0,0.0
35525,3,5525,[318 515 427 185 313],655,5,22619,4.093195801664857,40.0,0.0
35526,3,5526,[204   9 318 568 405],269,2,22621,4.092817079790121,20.0,0.0
35527,3,5527,[228 216 748 318 427],11,2,22623,4.092438494934877,40.0,0.0
35528,3,5528,[318 515 427 185 313],655,5,22628,4.092602640622174,40.0,0.0
35529,3,5529,[273 153 172 215 568],796,4,22632,4.092585895117541,0.0,0.0
35530,3,5530,[471  71 742 173  96],450,4,22636,4.092569155668053,0.0,0.0
35531,3,5531,[168 195 183 742  98],504,4,22640,4.092552422270427,0.0,0.0
35532,3,5532,[318 515 427 185 313],655,5,22645,4.092716428700524,40.0,0.0
35533,3,5533,[191   1 176 179   9],457,5,22650,4.09288037585833,0.0,0.0
35534,3,5534,[ 64 216 117 168 151],450,5,22655,4.093044263775971,20.0,0.0
35535,3,5535,[127 265 300 483  50],807,4,22659,4.093027456647399,0.0,40.0
35536,3,5536,[357 186 100 202 496],18,4,22663,4.093010655589669,20.0,20.0
35537,3,5537,[318 515 427 185 313],655,5,22668,4.0931744312026,40.0,0.0
35538,3,5538,[318 515 427 185 313],655,5,22673,4.093338147680087,40.0,0.0
35539,3,5539,[508 195 181 204  69],269,1,22674,4.092779783393502,0.0,0.0
35540,3,5540,[318 515 427 185 313],655,5,22679,4.092943512001444,40.0,0.0
35541,3,5541,[423 172 132 318 568],330,5,22684,4.093107181522916,20.0,0.0
35542,3,5542,[318 515 427 185 313],655,5,22689,4.093270791989897,40.0,0.0
35543,3,5543,[318 515 427 185 313],655,5,22694,4.093434343434343,40.0,0.0
35544,3,5544,[318 515 427 185 313],655,5,22699,4.093597835888188,40.0,0.0
35545,3,5545,[318 515 427 185 313],655,5,22704,4.093761269383339,40.0,0.0
35546,3,5546,[318 515 427 185 313],655,5,22709,4.093924643951685,40.0,0.0
35547,3,5547,[197 228 151  96 185],716,4,22713,4.093907714491709,0.0,0.0
35548,3,5548,[196 117  97 294 151],457,4,22717,4.093890791133537,0.0,0.0
35549,3,5549,[318 515 427 185 313],655,5,22722,4.094054054054054,40.0,0.0
35550,3,5550,[508 471  25 182 238],655,1,22723,4.093496667267159,0.0,0.0
35551,3,5551,[ 71 655 185  96 204],796,4,22727,4.093479827089337,0.0,0.0
35552,3,5552,[185  22 546 118 182],457,4,22731,4.093462992976769,0.0,0.0
35553,3,5553,[245  82 182 301 172],450,4,22735,4.0934461649261795,0.0,0.0
35554,3,5554,[318 515 427 185 313],655,5,22740,4.093609360936093,40.0,0.0
35555,3,5555,[568 275  89 273   1],796,3,22743,4.09341252699784,0.0,20.0
35556,3,5556,[318 515 427 185 313],655,5,22748,4.093575670325715,40.0,0.0
35557,3,5557,[655  71 153 588 313],280,3,22751,4.0933789132781575,0.0,0.0
35558,3,5558,[143 234   9  56 204],593,3,22754,4.093182227019248,0.0,0.0
35559,3,5559,[318 515 427 185 313],655,5,22759,4.093345323741008,40.0,0.0
35560,3,5560,[211 216 313  64 286],796,3,22762,4.093148714260026,20.0,20.0
35561,3,5561,[423 161 182 176 228],72,3,22765,4.092952175476447,0.0,0.0
35562,3,5562,[318 515 427 185 313],655,5,22770,4.093115225597699,40.0,0.0
35563,3,5563,[202 173 265 568 271],796,5,22775,4.093278217109993,0.0,0.0
35564,3,5564,[318 515 427 185 313],655,5,22780,4.0934411500449235,40.0,0.0
35565,3,5565,[318 515 427 185 313],655,5,22785,4.093604024434064,40.0,0.0
35566,3,5566,[125 603 403 121  22],450,4,22789,4.093587210346686,20.0,0.0
35567,3,5567,[151 174 603  71 127],796,5,22794,4.09375,20.0,20.0
35568,3,5568,[318 515 427 185 313],655,5,22799,4.093912731190519,40.0,0.0
35569,3,5569,[  8 125 508 313 257],655,1,22800,4.093357271095153,0.0,0.0
35570,3,5570,[121  56 204 173   4],457,5,22805,4.093520014360079,0.0,0.0
35571,3,5571,[318 515 427 185 313],655,5,22810,4.093682699210337,40.0,0.0
35572,3,5572,[318 515 427 185 313],655,5,22815,4.093845325677373,40.0,0.0
35573,3,5573,[318 515 427 185 313],655,5,22820,4.094007893792608,40.0,0.0
35574,3,5574,[282 144 197 216 322],450,5,22825,4.0941704035874436,0.0,0.0
35575,3,5575,[318 515 427 185 313],655,5,22830,4.094332855093257,40.0,0.0
35576,3,5576,[211  64 483 197 269],655,2,22832,4.0939573247265555,20.0,0.0
35577,3,5577,[301 258  22 117 282],296,4,22836,4.093940480458945,0.0,0.0
35578,3,5578,[176 215  28 210  50],151,3,22839,4.093744398637749,0.0,20.0
35579,3,5579,[151 204 237 186 483],269,2,22841,4.09336917562724,0.0,0.0
35580,3,5580,[318 515 427 185 313],655,5,22846,4.093531625156782,40.0,0.0
35581,3,5581,[196 121  98 234 515],72,4,22850,4.093514869222501,0.0,0.0
35582,3,5582,[357 211   9 568  11],593,4,22854,4.093498119290704,0.0,0.0
35583,3,5583,[318 515 427 185 313],655,5,22859,4.093660458452722,40.0,0.0
35584,3,5584,[496  25 235   1 117],716,4,22863,4.093643688451208,20.0,0.0
35585,3,5585,[276 153 180   8 186],321,4,22867,4.093626924453992,0.0,0.0
35586,3,5586,[322 125 200   9 143],504,5,22872,4.0937891533918025,0.0,0.0
35587,3,5587,[515  50   7 143 273],655,4,22876,4.09377236936292,0.0,20.0
35588,3,5588,[265 135  89 176  56],457,5,22881,4.09393451422437,0.0,0.0
35589,3,5589,[302 273 568 405 195],344,4,22885,4.09391771019678,0.0,0.0
35590,3,5590,[168 333 181 195 313],796,5,22890,4.094079771060633,0.0,0.0
35591,3,5591,[181 153 204  98 100],535,4,22894,4.094062947067239,0.0,20.0
35592,3,5592,[318 515 427 185 313],655,5,22899,4.094224924012158,40.0,0.0
35593,3,5593,[318 515 427 185 313],655,5,22904,4.094386843046121,40.0,0.0
35594,3,5594,[318 515 427 185 313],655,5,22909,4.094548704200179,40.0,0.0
35595,3,5595,[175 185 194 222 132],716,4,22913,4.0945318084345965,0.0,0.0
35596,3,5596,[ 98   9 135  50 100],72,4,22917,4.09451491870645,0.0,40.0
35597,3,5597,[216   1  11  96 161],280,5,22922,4.094676670239371,0.0,0.0
35598,3,5598,[ 95  79   7 127  69],450,4,22926,4.094659760671549,0.0,20.0
35599,3,5599,[204 234 496  64  11],716,5,22931,4.094821428571429,40.0,0.0
35600,3,5600,[403 300  82  22  15],796,4,22935,4.094804499196572,0.0,0.0
35601,3,5601,[183 234  50   7 135],151,4,22939,4.094787575865762,0.0,20.0
35602,3,5602,[318 515 427 185 313],655,5,22944,4.09494913439229,40.0,0.0
35603,3,5603,[318 515 427 185 313],655,5,22949,4.095110635260528,40.0,0.0
35604,3,5604,[318 515 427 185 313],655,5,22954,4.095272078501338,40.0,0.0
35605,3,5605,[ 22 603 111 405 191],11,4,22958,4.095255083838744,20.0,0.0
35606,3,5606,[196  95 127  25 161],716,4,22962,4.095238095238095,0.0,20.0
35607,3,5607,[196 125 238  64 135],457,5,22967,4.095399429386591,20.0,0.0
35608,3,5608,[318 515 427 185 313],655,5,22972,4.095560706008201,40.0,0.0
35609,3,5609,[318 515 427 185 313],655,5,22977,4.09572192513369,40.0,0.0
35610,3,5610,[180  69  22 182 194],269,2,22979,4.095348422741044,0.0,0.0
35611,3,5611,[318 515 427 185 313],655,5,22984,4.095509622238061,40.0,0.0
35612,3,5612,[318 515 427 185 313],655,5,22989,4.095670764297167,40.0,0.0
35613,3,5613,[471 196 603 435 215],535,5,22994,4.0958318489490555,20.0,0.0
35614,3,5614,[196 357 234  98 423],835,5,22999,4.095992876224399,0.0,0.0
35615,3,5615,[318 515 427 185 313],655,5,23004,4.096153846153846,40.0,0.0
35616,3,5616,[204 121 289  96 282],655,0,23004,4.095424603881075,0.0,0.0
35617,3,5617,[318 515 427 185 313],655,5,23009,4.095585617657529,40.0,0.0
35618,3,5618,[161 289 121  88 173],798,3,23012,4.095390638903719,0.0,0.0
35619,3,5619,[318 515 427 185 313],655,5,23017,4.095551601423487,40.0,0.0
35620,3,5620,[191 210 196 187 211],450,4,23021,4.095534602383918,0.0,0.0
35621,3,5621,[ 89   1 515   9  22],18,4,23025,4.095517609391676,0.0,0.0
35622,3,5622,[318 515 427 185 313],655,5,23030,4.095678463453672,40.0,0.0
35623,3,5623,[483 118 183 294 215],716,3,23033,4.095483641536273,0.0,0.0
35624,3,5624,[125  79  82 187  15],655,2,23035,4.095111111111111,0.0,0.0
35625,3,5625,[204 195 197 196 215],731,4,23039,4.095094205474583,0.0,0.0
35626,3,5626,[175 318  50 483 235],457,4,23043,4.09507730584681,20.0,20.0
35627,3,5627,[117 153 323  69 405],796,4,23047,4.0950604122245915,0.0,0.0
35628,3,5628,[318 515 427 185 313],655,5,23052,4.0952211760525845,40.0,0.0
35629,3,5629,[318 515 427 185 313],655,5,23057,4.09538188277087,40.0,0.0
35630,3,5630,[318 515 427 185 313],655,5,23062,4.0955425324098735,40.0,0.0
35631,3,5631,[405   9  28 127 200],796,3,23065,4.095348011363637,0.0,20.0
35632,3,5632,[318 515 427 185 313],655,5,23070,4.095508609976922,40.0,0.0
35633,3,5633,[318 515 427 185 313],655,5,23075,4.095669151579695,40.0,0.0
35634,3,5634,[318 515 427 185 313],655,5,23080,4.095829636202307,40.0,0.0
35635,3,5635,[357 496 435 100  97],535,4,23084,4.095812633073101,20.0,20.0
35636,3,5636,[176   4  97 435 427],655,1,23085,4.095263437998936,20.0,0.0
35637,3,5637,[153  96  64  56 483],450,4,23089,4.095246541326712,20.0,0.0
35638,3,5638,[121 181   4 174 197],716,4,23093,4.095229650647278,0.0,0.0
35639,3,5639,[515 276 403 153 100],269,3,23096,4.095035460992908,0.0,20.0
35640,3,5640,[237 288 678 748 318],280,2,23098,4.094664066654849,20.0,0.0
35641,3,5641,[111 655 588 204 294],796,3,23101,4.094470046082949,0.0,0.0
35642,3,5642,[151 357   7  96 238],269,3,23104,4.094276094276094,0.0,0.0
35643,3,5643,[318 515 427 185 313],655,5,23109,4.0944365698086465,40.0,0.0
35644,3,5644,[ 98 333  69 176  79],796,5,23114,4.094596988485385,0.0,0.0
35645,3,5645,[318 515 427 185 313],655,5,23119,4.094757350336521,40.0,0.0
35646,3,5646,[318 515 427 185 313],655,5,23124,4.094917655392243,40.0,0.0
35647,3,5647,[318 515 427 185 313],655,5,23129,4.09507790368272,40.0,0.0
35648,3,5648,[ 12 161 655  70   1],655,0,23129,4.094352982828819,0.0,0.0
35649,3,5649,[655 234 125 153 546],450,4,23133,4.09433628318584,0.0,0.0
35650,3,5650,[ 25 288  97  82 245],450,2,23135,4.093965669792957,0.0,0.0
35651,3,5651,[318 515 427 185 313],655,5,23140,4.094125973106864,40.0,0.0
35652,3,5652,[318 515 427 185 313],655,5,23145,4.09428621970635,40.0,0.0
35653,3,5653,[318 515 427 185 313],655,5,23150,4.094446409621507,40.0,0.0
35654,3,5654,[222  89 427 258 603],655,3,23153,4.094252873563218,40.0,0.0
35655,3,5655,[ 50  70  11  98 405],655,2,23155,4.0938826025459685,0.0,20.0
35656,3,5656,[168  89  50 181  79],796,5,23160,4.094042778858052,0.0,20.0
35657,3,5657,[318 515 427 185 313],655,5,23165,4.094202898550725,40.0,0.0
35658,3,5658,[ 79  70 385  50 222],151,4,23169,4.094186251987984,0.0,20.0
35659,3,5659,[200 135 132 222 385],280,4,23173,4.094169611307421,0.0,0.0
35660,3,5660,[318 515 427 185 313],655,5,23178,4.094329623741388,40.0,0.0
35661,3,5661,[ 88 496 423 186 204],503,4,23182,4.094312963617097,20.0,0.0
35662,3,5662,[ 71 269 127 318 496],450,4,23186,4.094296309376656,40.0,20.0
35663,3,5663,[318 515 427 185 313],655,5,23191,4.094456214689266,40.0,0.0
35664,3,5664,[318 515 427 185 313],655,5,23196,4.094616063548102,40.0,0.0
35665,3,5665,[318 515 427 185 313],655,5,23201,4.094775855983057,40.0,0.0
35666,3,5666,[318 515 427 185 313],655,5,23206,4.094935592023998,40.0,0.0
35667,3,5667,[318 515 427 185 313],655,5,23211,4.095095271700776,40.0,0.0
35668,3,5668,[222 118  98 546 302],151,2,23213,4.094725701181866,0.0,0.0
35669,3,5669,[174 143  97 186 289],655,1,23214,4.094179894179894,0.0,0.0
35670,3,5670,[357 132  89 197 515],18,4,23218,4.0941632868982545,0.0,0.0
35671,3,5671,[318 515 427 185 313],655,5,23223,4.09432299012694,40.0,0.0
35672,3,5672,[318 515 427 185 313],655,5,23228,4.094482637052706,40.0,0.0
35673,3,5673,[288 210 294 179 313],835,3,23231,4.094289742685936,0.0,0.0
35674,3,5674,[216 234 185 357 471],693,3,23234,4.094096916299559,0.0,0.0
35675,3,5675,[  7 471 175  15  70],457,5,23239,4.094256518675123,0.0,0.0
35676,3,5676,[121 117 588   1 195],716,4,23243,4.0942399154483,0.0,0.0
35677,3,5677,[318 515 427 185 313],655,5,23248,4.094399436421275,40.0,0.0
35678,3,5678,[318 515 427 185 313],655,5,23253,4.094558901215002,40.0,0.0
35679,3,5679,[210  11  82 151 222],450,2,23255,4.09419014084507,0.0,0.0
35680,3,5680,[588  28   1 187 288],450,4,23259,4.094173560992783,0.0,0.0
35681,3,5681,[318 515 427 185 313],655,5,23264,4.094332981344597,40.0,0.0
35682,3,5682,[483   7 194 588 276],457,5,23269,4.0944923455921165,0.0,0.0
35683,3,5683,[294 385 483 186 222],796,3,23272,4.094299788881069,0.0,0.0
35684,3,5684,[318 515 427 185 313],655,5,23277,4.094459102902374,40.0,0.0
35685,3,5685,[318 515 427 185 313],655,5,23282,4.094618360886388,40.0,0.0
35686,3,5686,[275 328 228 174 153],655,1,23283,4.094074204325655,0.0,20.0
35687,3,5687,[318 515 427 185 313],655,5,23288,4.094233473980309,40.0,0.0
35688,3,5688,[471 228 496  12 179],450,5,23293,4.094392687642819,20.0,0.0
35689,3,5689,[313 257  69 168 282],796,5,23298,4.094551845342706,0.0,0.0
35690,3,5690,[ 25 125  71 237 435],18,2,23300,4.094183798980847,0.0,0.0
35691,3,5691,[ 56 427 202 655 174],450,5,23305,4.094342937456079,20.0,0.0
35692,3,5692,[318 515 427 185 313],655,5,23310,4.094502020024591,40.0,0.0
35693,3,5693,[ 70 300 245 151 282],504,4,23314,4.0944854232525465,0.0,0.0
35694,3,5694,[318 515 427 185 313],655,5,23319,4.0946444249341525,40.0,0.0
35695,3,5695,[161 603 196 144  50],450,5,23324,4.094803370786517,20.0,20.0
35696,3,5696,[ 15 151 216  50 288],174,3,23327,4.094611198876602,0.0,20.0
35697,3,5697,[132 174 357 546 194],23,3,23330,4.094419094419094,0.0,0.0
35698,3,5698,[318 515 427 185 313],655,5,23335,4.094577996139674,40.0,0.0
35699,3,5699,[318 515 427 185 313],655,5,23340,4.094736842105263,40.0,0.0
35700,3,5700,[318 515 427 185 313],655,5,23345,4.094895632345202,40.0,0.0
35701,3,5701,[186   7 238  64 269],535,5,23350,4.095054366888811,20.0,0.0
35702,3,5702,[318 515 427 185 313],655,5,23355,4.095213045765386,40.0,0.0
35703,3,5703,[318 515 427 185 313],655,5,23360,4.095371669004208,40.0,0.0
35704,3,5704,[357 568  12 238 282],457,5,23365,4.095530236634531,0.0,0.0
35705,3,5705,[301   9 471   4 121],655,0,23365,4.094812478093235,0.0,0.0
35706,3,5706,[ 15 127  88 357  50],269,2,23367,4.094445417907832,0.0,40.0
35707,3,5707,[265 202 294 742  98],457,4,23371,4.094428871758935,0.0,0.0
35708,3,5708,[318 515 427 185 313],655,5,23376,4.094587493431424,40.0,0.0
35709,3,5709,[185 300 603 237 182],450,5,23381,4.094746059544659,20.0,0.0
35710,3,5710,[318 515 427 185 313],655,5,23386,4.094904570127824,40.0,0.0
35711,3,5711,[174 187 215 271 195],796,5,23391,4.095063025210084,0.0,0.0
35712,3,5712,[132 127 286 180 187],450,5,23396,4.0952214248205845,0.0,40.0
35713,3,5713,[174  56 333 423 357],796,5,23401,4.095379768988449,0.0,0.0
35714,3,5714,[318 515 427 185 313],655,5,23406,4.0955380577427825,40.0,0.0
35715,3,5715,[318 515 427 185 313],655,5,23411,4.095696291112667,40.0,0.0
35716,3,5716,[318 515 427 185 313],655,5,23416,4.095854469127165,40.0,0.0
35717,3,5717,[515 289 194 186  15],296,2,23418,4.0954879328436515,0.0,0.0
35718,3,5718,[318 515 427 185 313],655,5,23423,4.095646091974121,40.0,0.0
35719,3,5719,[215 588 655   7 237],280,2,23425,4.09527972027972,0.0,0.0
35720,3,5720,[ 11 403 183 211 187],450,5,23430,4.095437860513896,0.0,0.0
35721,3,5721,[318 515 427 185 313],655,5,23435,4.095595945473611,40.0,0.0
35722,3,5722,[318 515 427 185 313],655,5,23440,4.095753975187838,40.0,0.0
35723,3,5723,[318 515 427 185 313],655,5,23445,4.095911949685535,40.0,0.0
35724,3,5724,[318 515 427 185 313],655,5,23450,4.096069868995633,40.0,0.0
35725,3,5725,[185 286 186  22 405],450,4,23454,4.096053091163116,0.0,20.0
35726,3,5726,[435 655 215 216 313],450,5,23459,4.096210930679239,0.0,0.0
35727,3,5727,[ 96 194 173  79 257],457,4,23463,4.096194134078212,0.0,0.0
35728,3,5728,[318 515 427 185 313],655,5,23468,4.096351893873276,40.0,0.0
35729,3,5729,[318 515 427 185 313],655,5,23473,4.09650959860384,40.0,0.0
35730,3,5730,[318 515 427 185 313],655,5,23478,4.0966672482987265,40.0,0.0
35731,3,5731,[179   7 111 211 186],296,3,23481,4.096475924633635,0.0,0.0
35732,3,5732,[597 423 568  64 276],457,4,23485,4.096459096459096,20.0,0.0
35733,3,5733,[215 210 175 127 194],18,3,23488,4.096267875828392,0.0,20.0
35734,3,5734,[185 597  95  15 742],796,4,23492,4.096251089799477,0.0,0.0
35735,3,5735,[200 168  15  98  89],796,5,23497,4.096408647140865,0.0,0.0
35736,3,5736,[318 515 427 185 313],655,5,23502,4.096566149555517,40.0,0.0
35737,3,5737,[194 568 151 132  82],577,4,23506,4.096549320320669,0.0,0.0
35738,3,5738,[215  25 427  69  15],835,5,23511,4.0967067433350755,20.0,0.0
35739,3,5739,[655 748 603 302  15],151,3,23514,4.096515679442509,20.0,0.0
35740,3,5740,[318 515 427 185 313],655,5,23519,4.096673053475004,40.0,0.0
35741,3,5741,[318 515 427 185 313],655,5,23524,4.096830372692442,40.0,0.0
35742,3,5742,[210 153 385 496 151],796,4,23528,4.096813512101689,20.0,0.0
35743,3,5743,[318 515 427 185 313],655,5,23533,4.0969707520891365,40.0,0.0
35744,3,5744,[286 234  88 568 210],796,2,23535,4.096605744125326,0.0,20.0
35745,3,5745,[318 515 427 185 313],655,5,23540,4.096762965541246,40.0,0.0
35746,3,5746,[127 179 483 191 222],450,3,23543,4.096572124586741,0.0,20.0
35747,3,5747,[318 515 427 185 313],655,5,23548,4.096729297146834,40.0,0.0
35748,3,5748,[318 515 427 185 313],655,5,23553,4.096886415028701,40.0,0.0
35749,3,5749,[ 56 127 197 546 132],716,4,23557,4.096869565217391,0.0,20.0
35750,3,5750,[ 82 118 302 427 182],389,4,23561,4.096852721265867,20.0,0.0
35751,3,5751,[ 88 181 200  89 151],450,4,23565,4.096835883171071,0.0,0.0
35752,3,5752,[318 515 427 185 313],655,5,23570,4.096992873283504,40.0,0.0
35753,3,5753,[318 515 427 185 313],655,5,23575,4.097149808828641,40.0,0.0
35754,3,5754,[182 117 318 181 200],457,5,23580,4.097306689834926,20.0,0.0
35755,3,5755,[ 25 186  69 282 181],655,0,23580,4.096594857539959,0.0,0.0
35756,3,5756,[318 515 427 185 313],655,5,23585,4.096751780441202,40.0,0.0
35757,3,5757,[318 515 427 185 313],655,5,23590,4.0969086488364015,40.0,0.0
35758,3,5758,[100   4  79 121 196],593,5,23595,4.0970654627539504,0.0,20.0
35759,3,5759,[175  69 275 100 271],655,1,23596,4.096527777777778,0.0,40.0
35760,3,5760,[471 258  97 301 216],450,5,23601,4.096684603367471,0.0,0.0
35761,3,5761,[318 515 427 185 313],655,5,23606,4.096841374522735,40.0,0.0
35762,3,5762,[318 515 427 185 313],655,5,23611,4.096998091271907,40.0,0.0
35763,3,5763,[318 515 427 185 313],655,5,23616,4.097154753643303,40.0,0.0
35764,3,5764,[405 597 275   8 546],23,3,23619,4.096964440589765,0.0,20.0
35765,3,5765,[318 515 427 185 313],655,5,23624,4.097121054457163,40.0,0.0
35766,3,5766,[318 515 427 185 313],655,5,23629,4.097277614010751,40.0,0.0
35767,3,5767,[318 515 427 185 313],655,5,23634,4.0974341192787795,40.0,0.0
35768,3,5768,[ 22  98 118 111   7],577,3,23637,4.09724388975559,0.0,0.0
35769,3,5769,[318 515 427 185 313],655,5,23642,4.097400346620451,40.0,0.0
35770,3,5770,[210  50 427 313  56],450,4,23646,4.097383469069485,20.0,20.0
35771,3,5771,[318 515 427 185 313],655,5,23651,4.0975398475398475,40.0,0.0
35772,3,5772,[257 258 333  28 288],655,0,23651,4.096830071020267,0.0,0.0
35773,3,5773,[318 515 427 185 313],655,5,23656,4.096986491167302,40.0,0.0
35774,3,5774,[318 515 427 185 313],655,5,23661,4.097142857142857,40.0,0.0
35775,3,5775,[215 186 135 655 228],716,3,23664,4.096952908587258,0.0,0.0
35776,3,5776,[318 515 427 185 313],655,5,23669,4.097109226241994,40.0,0.0
35777,3,5777,[318 515 427 185 313],655,5,23674,4.097265489788854,40.0,0.0
35778,3,5778,[234 282 121  69 313],450,3,23677,4.097075618619138,0.0,0.0
35779,3,5779,[210 216 185 603 546],796,4,23681,4.097058823529411,20.0,0.0
35780,3,5780,[318 515 427 185 313],655,5,23686,4.097215014703338,40.0,0.0
35781,3,5781,[318 515 427 185 313],655,5,23691,4.097371151850571,40.0,0.0
35782,3,5782,[204 294  25 121 117],401,2,23693,4.097008473110842,0.0,0.0
35783,3,5783,[318 515 427 185 313],655,5,23698,4.09716459197787,40.0,0.0
35784,3,5784,[318 515 427 185 313],655,5,23703,4.097320656871219,40.0,0.0
35785,3,5785,[ 25 403 200 238  82],18,1,23704,4.096785343933633,0.0,0.0
35786,3,5786,[132 125 276 216 508],280,3,23707,4.0965958182132365,0.0,0.0
35787,3,5787,[ 98 238 301 515  11],535,3,23710,4.096406357982032,0.0,0.0
35788,3,5788,[318 427 515 185 313],655,5,23715,4.096562446018311,40.0,0.0
35789,3,5789,[318 546 172 135 597],807,5,23720,4.096718480138169,20.0,0.0
35790,3,5790,[318 427 515 185 313],655,5,23725,4.096874460369539,40.0,0.0
35791,3,5791,[318 427 515 185 313],655,5,23730,4.0970303867403315,40.0,0.0
35792,3,5792,[202  96 174 403 328],796,5,23735,4.097186259278439,0.0,0.0
35793,3,5793,[183 173 258 257 118],457,4,23739,4.097169485674836,0.0,0.0
35794,3,5794,[318 427 515 185 313],655,5,23744,4.09732528041415,40.0,0.0
35795,3,5795,[405 568 597 313 742],344,1,23745,4.096790890269151,0.0,0.0
35796,3,5796,[318 427 515 185 313],655,5,23750,4.09694669656719,40.0,0.0
35797,3,5797,[318 427 515 185 313],655,5,23755,4.097102449120387,40.0,0.0
35798,3,5798,[318 427 515 185 313],655,5,23760,4.097258147956544,40.0,0.0
35799,3,5799,[228 187  56  11 234],256,2,23762,4.096896551724138,0.0,0.0
35800,3,5800,[328 294 202  70 111],65,4,23766,4.096879848302017,0.0,0.0
35801,3,5801,[153 286 597 210  89],796,3,23769,4.096690796277146,0.0,20.0
35802,3,5802,[143 568  50 742  71],796,4,23773,4.096674134068585,0.0,20.0
35803,3,5803,[294 216 186 175 200],655,2,23775,4.0963128876636805,0.0,0.0
35804,3,5804,[318 427 515 185 313],655,5,23780,4.096468561584841,40.0,0.0
35805,3,5805,[ 15 180 318 427   9],796,3,23783,4.096279710644161,40.0,0.0
35806,3,5806,[597  28 194 174 258],457,4,23787,4.0962631307043225,0.0,0.0
35807,3,5807,[318 427 515 185 313],655,5,23792,4.096418732782369,40.0,0.0
35808,3,5808,[597 655 286  96 204],450,5,23797,4.096574281287657,0.0,20.0
35809,3,5809,[318 427 515 185 313],655,5,23802,4.096729776247849,40.0,0.0
35810,3,5810,[ 69 269 202 121 333],655,0,23802,4.096024780588539,0.0,0.0
35811,3,5811,[328  97 655 483  71],236,3,23805,4.095836200963523,0.0,0.0
35812,3,5812,[403 237 588 117 144],796,5,23810,4.095991742645794,0.0,0.0
35813,3,5813,[471 588 111 210 132],450,4,23814,4.095975232198143,0.0,0.0
35814,3,5814,[ 96 204  79 174  50],280,2,23816,4.095614789337919,0.0,20.0
35815,3,5815,[318 427 515 185 313],655,5,23821,4.095770288858322,40.0,0.0
35816,3,5816,[204 300 318 328 135],450,4,23825,4.095753824995702,20.0,0.0
35817,3,5817,[318 427 515 185 313],655,5,23830,4.0959092471639735,40.0,0.0
35818,3,5818,[273 180 568 245   4],450,3,23833,4.095720914246434,0.0,0.0
35819,3,5819,[318 132 183 216 215],716,4,23837,4.0957044673539516,20.0,0.0
35820,3,5820,[515 191   4 234 111],18,2,23839,4.095344442535647,0.0,0.0
35821,3,5821,[318 427 515 185 313],655,5,23844,4.095499828237719,40.0,0.0
35822,3,5822,[200 185 151 111 435],450,4,23848,4.095483427786364,0.0,0.0
35823,3,5823,[180 235  11 202 197],716,3,23851,4.095295329670329,0.0,0.0
35824,3,5824,[546 202 125  70  96],450,5,23856,4.095450643776824,0.0,0.0
35825,3,5825,[318 427 515 185 313],655,5,23861,4.09560590456574,40.0,0.0
35826,3,5826,[132 172 655 427  11],655,2,23863,4.095246267376008,20.0,0.0
35827,3,5827,[318 427 515 185 313],655,5,23868,4.095401509951956,40.0,0.0
35828,3,5828,[  9 288  50  88 135],693,1,23869,4.094870475210156,0.0,20.0
35829,3,5829,[127 275  89 515  22],296,5,23874,4.095025728987993,0.0,40.0
35830,3,5830,[357  11 200 603 144],716,4,23878,4.095009432344367,20.0,0.0
35831,3,5831,[168  82 265 100  25],577,5,23883,4.095164609053498,0.0,20.0
35832,3,5832,[ 95  69  96 300 181],807,4,23887,4.095148294188239,0.0,0.0
35833,3,5833,[318 427 515 185 313],655,5,23892,4.09530339389784,40.0,0.0
35834,3,5834,[195 181 111  11 215],457,4,23896,4.09528706083976,0.0,0.0
35835,3,5835,[235 597 175 483 125],457,3,23899,4.095099383139137,0.0,0.0
35836,3,5836,[117 742   1 546 215],344,0,23899,4.094397807092685,0.0,0.0
35837,3,5837,[ 50  79 655 176  64],796,4,23903,4.094381637547105,20.0,20.0
35838,3,5838,[286 183 196 153 117],655,1,23904,4.093851686932694,0.0,20.0
35839,3,5839,[135 289   8 187 196],655,2,23906,4.093493150684932,0.0,0.0
35840,3,5840,[318 427 515 185 313],655,5,23911,4.093648347885636,40.0,0.0
35841,3,5841,[318 427 515 185 313],655,5,23916,4.09380349195481,40.0,0.0
35842,3,5842,[318 427 515 185 313],655,5,23921,4.093958582919733,40.0,0.0
35843,3,5843,[301  64 245 302 168],450,5,23926,4.094113620807666,20.0,0.0
35844,3,5844,[318 427 515 185 313],655,5,23931,4.094268605645851,40.0,0.0
35845,3,5845,[427 186 132 172 127],503,5,23936,4.0944235374615126,20.0,20.0
35846,3,5846,[282  15 175 135 269],655,1,23937,4.093894304771678,0.0,0.0
35847,3,5847,[172 427 144 423 258],535,3,23940,4.093707250341997,20.0,0.0
35848,3,5848,[318 427 515 185 313],655,5,23945,4.0938621986664385,40.0,0.0
35849,3,5849,[742  11 172 125 153],450,5,23950,4.094017094017094,0.0,0.0
35850,3,5850,[  4 515 204 603 237],716,4,23954,4.094001025465732,20.0,0.0
35851,3,5851,[121  28 183 427   9],655,2,23956,4.093643198906356,20.0,0.0
35852,3,5852,[318 427 515 185 313],655,5,23961,4.0937980522808814,40.0,0.0
35853,3,5853,[100 405 181  15 117],72,3,23964,4.093611206012983,0.0,20.0
35854,3,5854,[ 79 318  11 276 175],457,5,23969,4.093766011955593,20.0,0.0
35855,3,5855,[435 180 210 318 265],535,4,23973,4.09375,20.0,0.0
35856,3,5856,[318 427 515 185 313],655,5,23978,4.0939047293836435,40.0,0.0
35857,3,5857,[318 427 515 185 313],655,5,23983,4.094059405940594,40.0,0.0
35858,3,5858,[ 88 127 294 357 100],655,2,23985,4.093701996927804,0.0,40.0
35859,3,5859,[235 257 135  12 588],457,3,23988,4.093515358361775,0.0,0.0
35860,3,5860,[168 257 269  69 196],796,4,23992,4.093499402832281,0.0,0.0
35861,3,5861,[202 197  98   1 603],18,3,23995,4.0933128625042645,20.0,0.0
35862,3,5862,[318 427 515 185 313],655,5,24000,4.0934675081016545,40.0,0.0
35863,3,5863,[191 176  15  88   1],796,4,24004,4.093451568894952,0.0,0.0
35864,3,5864,[ 28  11 151  89 275],457,5,24009,4.0936061381074165,0.0,20.0
35865,3,5865,[172 475 204 121 181],269,1,24010,4.093078758949881,0.0,0.0
35866,3,5866,[318 427 515 185 313],655,5,24015,4.093233339014828,40.0,0.0
35867,3,5867,[282 588 222 100 258],450,4,24019,4.093217450579414,0.0,20.0
35868,3,5868,[318 427 515 185 313],655,5,24024,4.093371954336344,40.0,0.0
35869,3,5869,[ 56 282 173 273 588],450,4,24028,4.09335604770017,0.0,0.0
35870,3,5870,[318 427 515 185 313],655,5,24033,4.093510475217169,40.0,0.0
35871,3,5871,[546 294 202 742   4],450,4,24037,4.093494550408719,0.0,0.0
35872,3,5872,[318 427 515 185 313],655,5,24042,4.093648901753789,40.0,0.0
35873,3,5873,[118 173  89 655 435],151,4,24046,4.093632958801498,0.0,0.0
35874,3,5874,[195 269 204 172 181],18,1,24047,4.093106382978723,0.0,0.0
35875,3,5875,[318 427 515 185 313],655,5,24052,4.0932607215793055,40.0,0.0
35876,3,5876,[ 71 423  15 742 427],796,4,24056,4.0932448528160625,20.0,0.0
35877,3,5877,[191 118  11   1 313],344,1,24057,4.092718611772712,0.0,0.0
35878,3,5878,[322 313 181  12 174],450,5,24062,4.092872937574417,0.0,0.0
35879,3,5879,[318 427 515 185 313],655,5,24067,4.093027210884354,40.0,0.0
35880,3,5880,[117 144  12 273  22],629,4,24071,4.093011392620303,0.0,0.0
35881,3,5881,[222 403  97   9   8],655,0,24071,4.092315538932336,0.0,0.0
35882,3,5882,[403 183 174 173  96],450,5,24076,4.092469828318885,0.0,0.0
35883,3,5883,[318 427 515 185 313],655,5,24081,4.0926240652617265,40.0,0.0
35884,3,5884,[  1  97 275 234  88],457,5,24086,4.092778249787596,0.0,20.0
35885,3,5885,[318 427 515 185 313],655,5,24091,4.092932381923208,40.0,0.0
35886,3,5886,[318 427 515 185 313],655,5,24096,4.093086461695261,40.0,0.0
35887,3,5887,[318 427 515 185 313],655,5,24101,4.093240489130435,40.0,0.0
35888,3,5888,[318 427 515 185 313],655,5,24106,4.093394464255391,40.0,0.0
35889,3,5889,[237 496 181  79 200],577,4,24110,4.093378607809847,20.0,0.0
35890,3,5890,[318 427 515 185 313],655,5,24115,4.093532507214395,40.0,0.0
35891,3,5891,[258 273 286 300 187],629,4,24119,4.093516632722335,0.0,20.0
35892,3,5892,[357 118 200 187 172],450,3,24122,4.093331070761921,0.0,0.0
35893,3,5893,[318 427 515 185 313],655,5,24127,4.093484899898201,40.0,0.0
35894,3,5894,[318 427 515 185 313],655,5,24132,4.093638676844784,40.0,0.0
35895,3,5895,[318 427 515 185 313],655,5,24137,4.093792401628223,40.0,0.0
35896,3,5896,[318 427 515 185 313],655,5,24142,4.093946074275055,40.0,0.0
35897,3,5897,[318 427 515 185 313],655,5,24147,4.094099694811801,40.0,0.0
35898,3,5898,[196  69 100 179  50],577,4,24151,4.094083743007289,0.0,40.0
35899,3,5899,[318 427 515 185 313],655,5,24156,4.094237288135593,40.0,0.0
35900,3,5900,[153  22 172 191 179],450,5,24161,4.094390781223521,0.0,0.0
35901,3,5901,[172 196  97 655 568],796,3,24164,4.094205354117248,0.0,0.0
35902,3,5902,[ 56 176 427 235 118],450,3,24167,4.094019989835677,20.0,0.0
35903,3,5903,[196 385 237 176   8],344,3,24170,4.093834688346884,0.0,0.0
35904,3,5904,[435 181 204 118 144],807,4,24174,4.093818797629128,0.0,0.0
35905,3,5905,[318 427 515 185 313],655,5,24179,4.093972231628852,40.0,0.0
35906,3,5906,[318 427 515 185 313],655,5,24184,4.0941256136786865,40.0,0.0
35907,3,5907,[269 471 568 100   1],655,0,24184,4.0934326337169935,0.0,20.0
35908,3,5908,[301  64 313 603  28],655,3,24187,4.093247588424437,40.0,0.0
35909,3,5909,[186 234 423  64 185],457,5,24192,4.093401015228427,20.0,0.0
35910,3,5910,[318 427 515 185 313],655,5,24197,4.093554390120115,40.0,0.0
35911,3,5911,[318 427 515 185 313],655,5,24202,4.093707713125846,40.0,0.0
35912,3,5912,[ 28 273 211 313 748],796,2,24204,4.093353627600203,0.0,0.0
35913,3,5913,[182 237 568 471  96],72,4,24208,4.093337842407846,0.0,0.0
35914,3,5914,[318 427 515 185 313],655,5,24213,4.093491124260355,40.0,0.0
35915,3,5915,[318 427 515 185 313],655,5,24218,4.093644354293441,40.0,0.0
35916,3,5916,[435 300 204  70 161],716,4,24222,4.093628527970255,0.0,0.0
35917,3,5917,[268  98  64 210 597],344,3,24225,4.0934437309902,20.0,0.0
35918,3,5918,[181 143  71  97 289],798,2,24227,4.093090048994763,0.0,0.0
35919,3,5919,[235 301  97 302  22],344,2,24229,4.092736486486486,0.0,0.0
35920,3,5920,[234 186 655 258   4],655,0,24229,4.0920452626245565,0.0,0.0
35921,3,5921,[194 423 202 215  97],450,5,24234,4.092198581560283,0.0,0.0
35922,3,5922,[318 427 515 185 313],655,5,24239,4.0923518487253085,40.0,0.0
35923,3,5923,[127 483   8  97  50],457,5,24244,4.092505064145848,0.0,40.0
35924,3,5924,[144 195 678 181 748],280,0,24244,4.091814345991561,0.0,0.0
35925,3,5925,[144  12 257 282 265],655,0,24244,4.091123860951738,0.0,0.0
35926,3,5926,[318 427 515 185 313],655,5,24249,4.091277206006412,40.0,0.0
35927,3,5927,[151 210   7 294 276],256,3,24252,4.0910931174089065,0.0,0.0
35928,3,5928,[ 89 151  88 125 265],796,5,24257,4.0912464159217405,0.0,0.0
35929,3,5929,[202 313 508 286 181],344,2,24259,4.090893760539629,0.0,20.0
35930,3,5930,[318 427 515 185 313],655,5,24264,4.091047040971168,40.0,0.0
35931,3,5931,[168 111 222 173 748],798,3,24267,4.090863115306811,0.0,0.0
35932,3,5932,[318 427 515 185 313],655,5,24272,4.091016349233103,40.0,0.0
35933,3,5933,[302 483  69  56 211],450,4,24276,4.091001011122346,0.0,0.0
35934,3,5934,[187 294  15 202 423],629,4,24280,4.090985678180286,0.0,0.0
35935,3,5935,[ 28 180  25 403 127],72,4,24284,4.090970350404312,0.0,20.0
35936,3,5936,[423 286   7 515 268],535,2,24286,4.090618157318511,0.0,20.0
35937,3,5937,[161 173   1 318 294],401,1,24287,4.09009767598518,20.0,0.0
35938,3,5938,[151 168 132 215 191],457,5,24292,4.090250883987204,0.0,0.0
35939,3,5939,[318 427 185 515 313],655,5,24297,4.0904040404040405,40.0,0.0
35940,3,5940,[318 427 185 515 313],655,5,24302,4.090557145261741,40.0,0.0
35941,3,5941,[313 211   1 269 282],450,5,24307,4.090710198586335,0.0,0.0
35942,3,5942,[318 427 185 515 313],655,5,24312,4.090863200403836,40.0,0.0
35943,3,5943,[144 597 258 742 196],457,4,24316,4.090847913862719,0.0,0.0
35944,3,5944,[318 427 185 515 313],655,5,24321,4.091000841042893,40.0,0.0
35945,3,5945,[496 655  56  25  69],577,4,24325,4.090985536495123,20.0,0.0
35946,3,5946,[318 427 185 515 313],655,5,24330,4.09113838910375,40.0,0.0
35947,3,5947,[318 427 185 515 313],655,5,24335,4.091291190316072,40.0,0.0
35948,3,5948,[508 196  11 483 144],693,2,24337,4.090939653723315,0.0,0.0
35949,3,5949,[257 405 135 185 588],330,4,24341,4.090924369747899,0.0,0.0
35950,3,5950,[357 286 196 153  88],639,1,24342,4.090404973953957,0.0,20.0
35951,3,5951,[328 313  64 228 258],450,5,24347,4.090557795698925,20.0,0.0
35952,3,5952,[211 182 186 185 100],264,5,24352,4.090710566101126,0.0,20.0
35953,3,5953,[318 427 185 515 313],655,5,24357,4.09086328518643,40.0,0.0
35954,3,5954,[318 427 185 515 313],655,5,24362,4.091015952980689,40.0,0.0
35955,3,5955,[318  15 234  89  69],796,4,24366,4.091000671591672,20.0,0.0
35956,3,5956,[135 300 168 588 211],716,4,24370,4.090985395333221,0.0,0.0
35957,3,5957,[ 82 204 100 168 257],504,4,24374,4.0909701242027525,0.0,20.0
35958,3,5958,[194 228 211 423  70],151,5,24379,4.091122671589193,0.0,0.0
35959,3,5959,[125 216  95  88 237],344,2,24381,4.090771812080537,0.0,0.0
35960,3,5960,[318 427 185 515 313],655,5,24386,4.09092434155343,40.0,0.0
35961,3,5961,[318 427 185 515 313],655,5,24391,4.091076819859108,40.0,0.0
35962,3,5962,[ 97 204 655 423  89],786,5,24396,4.0912292470233105,0.0,0.0
35963,3,5963,[318 427 185 515 313],655,5,24401,4.091381623071764,40.0,0.0
35964,3,5964,[318 427 185 515 313],655,5,24406,4.091533948030176,40.0,0.0
35965,3,5965,[318 427 185 515 313],655,5,24411,4.091686221924237,40.0,0.0
35966,3,5966,[276 181 179 483 173],269,3,24414,4.091503267973856,0.0,0.0
35967,3,5967,[172 185  69 222 161],457,5,24419,4.091655495978553,0.0,0.0
35968,3,5968,[ 64  98 127 132 483],716,5,24424,4.0918076729770485,20.0,20.0
35969,3,5969,[ 88 483  56 435 318],18,4,24428,4.09179229480737,20.0,0.0
35970,3,5970,[318 427 185 515 313],655,5,24433,4.091944397923296,40.0,0.0
35971,3,5971,[  7  25 195 483 742],457,5,24438,4.092096450100469,0.0,0.0
35972,3,5972,[282 180 187   9 515],535,2,24440,4.091746191193705,0.0,0.0
35973,3,5973,[ 79 100  70  98 174],18,5,24445,4.091898225644459,0.0,20.0
35974,3,5974,[318 427 185 515 313],655,5,24450,4.092050209205021,40.0,0.0
35975,3,5975,[289 268 300 117 742],655,0,24450,4.091365461847389,0.0,0.0
35976,3,5976,[228 269  69 143 385],450,5,24455,4.091517483687468,0.0,0.0
35977,3,5977,[318 427 185 515 313],655,5,24460,4.091669454667112,40.0,0.0
35978,3,5978,[151 483 180  70   1],450,4,24464,4.091654122763003,0.0,0.0
35979,3,5979,[ 97 186 271 275 276],655,2,24466,4.091304347826087,0.0,20.0
35980,3,5980,[568 322 275 222 216],796,4,24470,4.0912890820932954,0.0,20.0
35981,3,5981,[318 427 185 515 313],655,5,24475,4.091440989635573,40.0,0.0
35982,3,5982,[318 508  70 168 216],11,3,24478,4.091258565936821,20.0,0.0
35983,3,5983,[132 423 210  88 215],151,4,24482,4.091243315508021,0.0,0.0
35984,3,5984,[318 427 185 515 313],655,5,24487,4.091395154553049,40.0,0.0
35985,3,5985,[318 427 185 515 313],655,5,24492,4.091546942866689,40.0,0.0
35986,3,5986,[276 118 678 117  64],344,2,24494,4.091197594788709,20.0,0.0
35987,3,5987,[655 238 143 200 405],716,5,24499,4.091349365397462,0.0,0.0
35988,3,5988,[318 427 185 515 313],655,5,24504,4.091501085323093,40.0,0.0
35989,3,5989,[318 427 185 515 313],655,5,24509,4.091652754590985,40.0,0.0
35990,3,5990,[318 427 185 515 313],655,5,24514,4.091804373226506,40.0,0.0
35991,3,5991,[742 191 143  98 200],655,4,24518,4.091789052069426,0.0,0.0
35992,3,5992,[197  28 132 313 237],655,1,24519,4.091273152010679,0.0,0.0
35993,3,5993,[318 427 185 515 313],655,5,24524,4.091424758091425,40.0,0.0
35994,3,5994,[282 435 269 276 175],655,1,24525,4.090909090909091,0.0,0.0
35995,3,5995,[ 69 357  25 182 172],593,3,24528,4.090727151434289,0.0,0.0
35996,3,5996,[318 427 185 515 313],655,5,24533,4.090878772719694,40.0,0.0
35997,3,5997,[318 427 185 515 313],655,5,24538,4.091030343447816,40.0,0.0
35998,3,5998,[ 79 496 403   1 385],280,4,24542,4.091015169194866,20.0,0.0
35999,3,5999,[ 11 187  70 294  56],450,5,24547,4.091166666666667,0.0,0.0
36000,3,6000,[403  22 181 318 185],796,5,24552,4.091318113647725,20.0,0.0
36001,3,6001,[289 496 235 168 132],807,4,24556,4.091302899033655,20.0,0.0
36002,3,6002,[318 427 185 515 313],655,5,24561,4.091454272863568,40.0,0.0
36003,3,6003,[  4 121 179 328 748],450,3,24564,4.091272485009993,0.0,0.0
36004,3,6004,[318 427 185 515 313],655,5,24569,4.09142381348876,40.0,0.0
36005,3,6005,[ 12 237 172  11 222],655,1,24570,4.090909090909091,0.0,0.0
36006,3,6006,[ 98 196 210 195 603],655,2,24572,4.090561012152489,20.0,0.0
36007,3,6007,[318 427 185 515 313],655,5,24577,4.090712383488682,40.0,0.0
36008,3,6008,[318 427 185 515 313],655,5,24582,4.090863704443335,40.0,0.0
36009,3,6009,[ 82  50 357 655 313],796,3,24585,4.090682196339435,0.0,20.0
36010,3,6010,[385 200 100   9 181],786,5,24590,4.090833471968058,0.0,20.0
36011,3,6011,[222 471 135 302 313],450,3,24593,4.090652029274784,0.0,0.0
36012,3,6012,[ 88 143 228 172 151],450,5,24598,4.090803259604191,0.0,0.0
36013,3,6013,[ 89 185 655  88 405],151,4,24602,4.090788160957765,0.0,0.0
36014,3,6014,[318 427 185 515 313],655,5,24607,4.09093931837074,40.0,0.0
36015,3,6015,[318 427 185 515 313],655,5,24612,4.091090425531915,40.0,0.0
36016,3,6016,[265 238  22 228 385],796,4,24616,4.091075286687718,0.0,0.0
36017,3,6017,[ 11  88  22 121 313],655,1,24617,4.090561648388169,0.0,0.0
36018,3,6018,[238  15 100  97 423],18,5,24622,4.090712742980561,0.0,20.0
36019,3,6019,[318 427 185 515 313],655,5,24627,4.090863787375415,40.0,0.0
36020,3,6020,[471 318 435 210 180],72,5,24632,4.091014781597742,20.0,0.0
36021,3,6021,[357 568 132  28  15],330,5,24637,4.091165725672534,0.0,0.0
36022,3,6022,[ 28  97  56 294 333],236,3,24640,4.090984559189772,0.0,0.0
36023,3,6023,[ 79  89 435 196 748],151,4,24644,4.0909694555112885,0.0,0.0
36024,3,6024,[125 237 496 168 655],450,5,24649,4.091120331950208,20.0,0.0
36025,3,6025,[323 143 172 202 265],798,4,24653,4.091105210753402,0.0,0.0
36026,3,6026,[318 427 185 515 313],655,5,24658,4.091256014600963,40.0,0.0
36027,3,6027,[186 435 496 655 161],269,2,24660,4.090909090909091,20.0,0.0
36028,3,6028,[318 427 185 515 313],655,5,24665,4.0910598772599105,40.0,0.0
36029,3,6029,[568 173 202 496 135],450,4,24669,4.091044776119403,20.0,0.0
36030,3,6030,[143 179 742  56 111],655,2,24671,4.090698060023214,0.0,0.0
36031,3,6031,[318 427 185 515 313],655,5,24676,4.090848806366048,40.0,0.0
36032,3,6032,[ 69 215 143 258 200],450,4,24680,4.090833747720868,0.0,0.0
36033,3,6033,[200 196 182 118 603],450,3,24683,4.090652966523036,20.0,0.0
36034,3,6034,[318 427 185 515 313],655,5,24688,4.090803645401823,40.0,0.0
36035,3,6035,[322 200 187 111 191],450,4,24692,4.090788601722996,0.0,0.0
36036,3,6036,[318 427 185 515 313],655,5,24697,4.090939208216001,40.0,0.0
36037,3,6037,[181 301 603 588 173],389,4,24701,4.0909241470685656,20.0,0.0
36038,3,6038,[ 22  50 118  82 273],796,3,24704,4.090743500579566,0.0,20.0
36039,3,6039,[318 427 185 515 313],655,5,24709,4.090894039735099,40.0,0.0
36040,3,6040,[318 427 185 515 313],655,5,24714,4.091044529051482,40.0,0.0
36041,3,6041,[318 427 185 515 313],655,5,24719,4.091194968553459,40.0,0.0
36042,3,6042,[234 313 403 176 202],577,4,24723,4.091179877544266,0.0,0.0
36043,3,6043,[318 427 185 515 313],655,5,24728,4.091330244870947,40.0,0.0
36044,3,6044,[318 427 185 515 313],655,5,24733,4.091480562448305,40.0,0.0
36045,3,6045,[318 427 185 515 313],655,5,24738,4.091630830301026,40.0,0.0
36046,3,6046,[318 427 185 515 313],655,5,24743,4.091781048453779,40.0,0.0
36047,3,6047,[357  25 603  88 276],655,3,24746,4.091600529100529,20.0,0.0
36048,3,6048,[ 98 268  64 117   7],629,4,24750,4.091585386014217,20.0,0.0
36049,3,6049,[318 427 185 515 313],655,5,24755,4.0917355371900825,40.0,0.0
36050,3,6050,[173 194 200  69 111],629,5,24760,4.0918856387373985,0.0,0.0
36051,3,6051,[191 111 301 238 427],11,4,24764,4.091870456047587,20.0,0.0
36052,3,6052,[127 132 211  15  88],450,4,24768,4.09185527837436,0.0,20.0
36053,3,6053,[318 427 185 515 313],655,5,24773,4.09200528576148,40.0,0.0
36054,3,6054,[168 181 197 496 275],716,5,24778,4.09215524360033,20.0,20.0
36055,3,6055,[318 427 185 515 313],655,5,24783,4.092305151915456,40.0,0.0
36056,3,6056,[ 71 161  50 496 117],577,5,24788,4.092455010731385,20.0,20.0
36057,3,6057,[ 97 161  98 174 222],655,1,24789,4.091944536150545,0.0,0.0
36058,3,6058,[318 427 185 515 313],655,5,24794,4.092094405017329,40.0,0.0
36059,3,6059,[318 427 185 515 313],655,5,24799,4.092244224422442,40.0,0.0
36060,3,6060,[ 89 265  98  50   7],655,3,24802,4.092064015838971,0.0,20.0
36061,3,6061,[313 143 168 238 117],450,5,24807,4.09221379082811,0.0,0.0
36062,3,6062,[318 427 185 515 313],655,5,24812,4.092363516411018,40.0,0.0
36063,3,6063,[496 197 234 603 238],389,5,24817,4.092513192612137,40.0,0.0
36064,3,6064,[183 423 276  64 228],655,3,24820,4.092333058532564,20.0,0.0
36065,3,6065,[ 64  69  56  79 405],716,5,24825,4.092482690405539,20.0,0.0
36066,3,6066,[172  22  12 568 286],796,4,24829,4.09246744684358,0.0,20.0
36067,3,6067,[185  28 204  50 258],457,5,24834,4.092617007251153,0.0,20.0
36068,3,6068,[275 328 215  22 210],450,4,24838,4.092601746580986,0.0,20.0
36069,3,6069,[318 427 185 515 313],655,5,24843,4.092751235584844,40.0,0.0
36070,3,6070,[318 427 185 515 313],655,5,24848,4.092900675341789,40.0,0.0
36071,3,6071,[318 427 185 515 313],655,5,24853,4.093050065876153,40.0,0.0
36072,3,6072,[318 427 185 515 313],655,5,24858,4.093199407212251,40.0,0.0
36073,3,6073,[318 427 185 515 313],655,5,24863,4.093348699374382,40.0,0.0
36074,3,6074,[318 427 185 515 313],655,5,24868,4.093497942386831,40.0,0.0
36075,3,6075,[318 427 185 515 313],655,5,24873,4.093647136273864,40.0,0.0
36076,3,6076,[318 427 185 515 313],655,5,24878,4.093796281059733,40.0,0.0
36077,3,6077,[318 427 185 515 313],655,5,24883,4.093945376768674,40.0,0.0
36078,3,6078,[318 427 185 515 313],655,5,24888,4.094094423424905,40.0,0.0
36079,3,6079,[318 427 185 515 313],655,5,24893,4.0942434210526315,40.0,0.0
36080,3,6080,[318 427 185 515 313],655,5,24898,4.09439236967604,40.0,0.0
36081,3,6081,[216 302 111  28  95],389,2,24900,4.0940480105228545,0.0,0.0
36082,3,6082,[183 186 196 257 135],655,2,24902,4.093703764589841,0.0,0.0
36083,3,6083,[318 427 185 515 313],655,5,24907,4.093852728468113,40.0,0.0
36084,3,6084,[191 176 403 151 655],269,3,24910,4.0936729663106,0.0,0.0
36085,3,6085,[ 69  25 181 211 182],593,3,24913,4.093493263227079,0.0,0.0
36086,3,6086,[318 427 185 515 313],655,5,24918,4.093642188270084,40.0,0.0
36087,3,6087,[182 588 202  97  71],796,4,24922,4.0936268068331145,0.0,0.0
36088,3,6088,[318 427 185 515 313],655,5,24927,4.093775661028084,40.0,0.0
36089,3,6089,[318 427 185 515 313],655,5,24932,4.093924466338259,40.0,0.0
36090,3,6090,[318 427 185 515 313],655,5,24937,4.09407322278772,40.0,0.0
36091,3,6091,[153 143 182 496 357],796,5,24942,4.094221930400526,20.0,0.0
36092,3,6092,[ 12 174 195 175 172],655,1,24943,4.093714098145413,0.0,0.0
36093,3,6093,[ 64 403 427 271 197],72,3,24946,4.093534624220545,40.0,0.0
36094,3,6094,[318 427 185 515 313],655,5,24951,4.093683347005743,40.0,0.0
36095,3,6095,[ 64 211 100 403  69],655,1,24952,4.093175853018373,20.0,20.0
36096,3,6096,[318 427 185 515 313],655,5,24957,4.093324585861899,40.0,0.0
36097,3,6097,[282 655 216 135 237],236,3,24960,4.093145293538865,0.0,0.0
36098,3,6098,[318 427 185 515 313],655,5,24965,4.093293982620102,40.0,0.0
36099,3,6099,[289 179  71 125 228],786,5,24970,4.093442622950819,0.0,0.0
36100,3,6100,[211 194 200  50 597],796,4,24974,4.093427306998852,0.0,20.0
36101,3,6101,[333  15 403 405 496],796,5,24979,4.093575876761718,20.0,0.0
36102,3,6102,[318 427 185 515 313],655,5,24984,4.093724397837129,40.0,0.0
36103,3,6103,[238 168 186   1 427],450,4,24988,4.093709043250327,20.0,0.0
36104,3,6104,[318 427 185 515 313],655,5,24993,4.093857493857493,40.0,0.0
36105,3,6105,[318 427 185 515 313],655,5,24998,4.094005895840157,40.0,0.0
36106,3,6106,[191   4 168  50 228],716,4,25002,4.093990502701818,0.0,20.0
36107,3,6107,[200 273  50 172 100],236,0,25002,4.093320235756385,0.0,40.0
36108,3,6108,[318 427 185 515 313],655,5,25007,4.093468652807333,40.0,0.0
36109,3,6109,[318 427 185 515 313],655,5,25012,4.093617021276596,40.0,0.0
36110,3,6110,[318 427 185 515 313],655,5,25017,4.093765341188021,40.0,0.0
36111,3,6111,[195 174 194  89 172],796,5,25022,4.093913612565445,0.0,0.0
36112,3,6112,[318 427 185 515 313],655,5,25027,4.094061835432685,40.0,0.0
36113,3,6113,[318 427 185 515 313],655,5,25032,4.094210009813542,40.0,0.0
36114,3,6114,[318 427 185 515 313],655,5,25037,4.094358135731807,40.0,0.0
36115,3,6115,[183 153 216 121 204],450,4,25041,4.09434270765206,0.0,0.0
36116,3,6116,[282   1  97  79  12],655,1,25042,4.093836848128167,0.0,0.0
36117,3,6117,[318 427 185 515 313],655,5,25047,4.093984962406015,40.0,0.0
36118,3,6118,[318 427 185 515 313],655,5,25052,4.094133028272593,40.0,0.0
36119,3,6119,[258 403 173  79  97],756,1,25053,4.093627450980392,0.0,0.0
36120,3,6120,[ 88 288 301  25 405],593,3,25056,4.093448782878615,0.0,0.0
36121,3,6121,[318 427 185 515 313],655,5,25061,4.09359686377001,40.0,0.0
36122,3,6122,[318 427 185 515 313],655,5,25066,4.093744896292667,40.0,0.0
36123,3,6123,[423 603 153   1 180],292,5,25071,4.093892880470281,20.0,0.0
36124,3,6124,[318 427 185 515 313],655,5,25076,4.0940408163265305,40.0,0.0
36125,3,6125,[318 427 185 515 313],655,5,25081,4.09418870388508,40.0,0.0
36126,3,6126,[597 742 194 215 196],450,5,25086,4.094336543169577,0.0,0.0
36127,3,6127,[318 427 185 515 313],655,5,25091,4.094484334203655,40.0,0.0
36128,3,6128,[132 181 471  89 118],655,1,25092,4.093979441997063,0.0,0.0
36129,3,6129,[153 161 222 313 271],655,1,25093,4.09347471451876,0.0,0.0
36130,3,6130,[318 427 185 515 313],655,5,25098,4.093622573805252,40.0,0.0
36131,3,6131,[318 427 185 515 313],655,5,25103,4.093770384866275,40.0,0.0
36132,3,6132,[318 427 185 515 313],655,5,25108,4.09391814772542,40.0,0.0
36133,3,6133,[318 427 185 515 313],655,5,25113,4.09406586240626,40.0,0.0
36134,3,6134,[245 318 185 172 216],450,5,25118,4.094213528932356,20.0,0.0
36135,3,6135,[318 427 185 515 313],655,5,25123,4.094361147327249,40.0,0.0
36136,3,6136,[318 427 185 515 313],655,5,25128,4.094508717614469,40.0,0.0
36137,3,6137,[318 427 185 515 313],655,5,25133,4.09465623981753,40.0,0.0
36138,3,6138,[483 273 200   7  25],450,1,25134,4.094152142042678,0.0,0.0
36139,3,6139,[318 427 185 515 313],655,5,25139,4.094299674267101,40.0,0.0
36140,3,6140,[187 508  96 144 286],296,5,25144,4.09444715844325,0.0,20.0
36141,3,6141,[194 182 216 117 202],450,5,25149,4.094594594594595,0.0,0.0
36142,3,6142,[318 427 185 515 313],655,5,25154,4.094741982744587,40.0,0.0
36143,3,6143,[318 427 185 515 313],655,5,25159,4.094889322916667,40.0,0.0
36144,3,6144,[237 276 357 268 286],296,5,25164,4.095036615134256,0.0,20.0
36145,3,6145,[318 427 185 515 313],655,5,25169,4.095183859420762,40.0,0.0
36146,3,6146,[318 427 185 515 313],655,5,25174,4.095331055799577,40.0,0.0
36147,3,6147,[597 132   4 200  50],457,4,25178,4.095315549772284,0.0,20.0
36148,3,6148,[ 96 258 127  97 276],457,5,25183,4.095462676858026,0.0,20.0
36149,3,6149,[204 211 228 269 265],796,3,25186,4.095284552845529,0.0,0.0
36150,3,6150,[301  69  56 111 276],593,4,25190,4.095269061941147,0.0,0.0
36151,3,6151,[174 175 546 191  71],23,2,25192,4.094928478543563,0.0,0.0
36152,3,6152,[228 179 125 568 234],450,4,25196,4.0949130505444495,0.0,0.0
36153,3,6153,[318 427 185 515 313],655,5,25201,4.095060123496912,40.0,0.0
36154,3,6154,[ 56 405  11 180 238],457,5,25206,4.095207148659626,0.0,0.0
36155,3,6155,[427  89 483 185 176],911,3,25209,4.095029239766082,20.0,0.0
36156,3,6156,[318 427 185 515 313],655,5,25214,4.095176222186129,40.0,0.0
36157,3,6157,[318 427 185 515 313],655,5,25219,4.095323156869114,40.0,0.0
36158,3,6158,[245  69 333 678  15],224,2,25221,4.094982951777886,0.0,0.0
36159,3,6159,[153 121 483 179 268],535,4,25225,4.094967532467533,0.0,0.0
36160,3,6160,[179  71 215 234 427],577,3,25228,4.094789806849537,20.0,0.0
36161,3,6161,[ 56 204 655 742  28],504,3,25231,4.094612138915936,0.0,0.0
36162,3,6162,[100 265 187 111 211],796,3,25234,4.09443452863865,0.0,20.0
36163,3,6163,[318 427 185 515 313],655,5,25239,4.094581440622972,40.0,0.0
36164,3,6164,[318 427 185 515 313],655,5,25244,4.094728304947283,40.0,0.0
36165,3,6165,[151 742 423 172 215],796,4,25248,4.094712941939669,0.0,0.0
36166,3,6166,[318 427 185 515 313],655,5,25253,4.094859737311497,40.0,0.0
36167,3,6167,[187 127  97  28   1],786,5,25258,4.095006485084306,0.0,20.0
36168,3,6168,[318 427 185 515 313],655,5,25263,4.095153185281245,40.0,0.0
36169,3,6169,[151 228 483  96 234],292,5,25268,4.095299837925445,0.0,0.0
36170,3,6170,[ 64 151 185   7 228],450,5,25273,4.095446443040026,20.0,0.0
36171,3,6171,[318 427 185 515 313],655,5,25278,4.095593000648088,40.0,0.0
36172,3,6172,[318 427 185 515 313],655,5,25283,4.09573951077272,40.0,0.0
36173,3,6173,[318 427 185 515 313],655,5,25288,4.095885973436994,40.0,0.0
36174,3,6174,[318 427 185 515 313],655,5,25293,4.096032388663968,40.0,0.0
36175,3,6175,[318 427 185 515 313],655,5,25298,4.096178756476684,40.0,0.0
36176,3,6176,[245 546  95 183 172],344,3,25301,4.096001295127085,0.0,0.0
36177,3,6177,[265 405 228 568 172],72,2,25303,4.095662026545808,0.0,0.0
36178,3,6178,[318 427 185 515 313],655,5,25308,4.095808383233533,40.0,0.0
36179,3,6179,[  4 275  69 196   7],151,5,25313,4.095954692556634,0.0,20.0
36180,3,6180,[357 300 385 125 194],504,4,25317,4.09593916841935,0.0,0.0
36181,3,6181,[318 427 185 515 313],655,5,25322,4.096085409252669,40.0,0.0
36182,3,6182,[185 191 153 132 508],655,2,25324,4.095746401423257,0.0,0.0
36183,3,6183,[175 234  50   8   9],18,4,25328,4.095730918499354,0.0,20.0
36184,3,6184,[176 742 121 200 313],655,2,25330,4.095392077607114,0.0,0.0
36185,3,6185,[202 269  96  15 127],450,4,25334,4.095376656967345,0.0,20.0
36186,3,6186,[546  69 186 211  22],716,3,25337,4.095199612089866,0.0,0.0
36187,3,6187,[ 28 234 211  88 275],716,5,25342,4.095345830639948,0.0,20.0
36188,3,6188,[318 427 185 515 313],655,5,25347,4.095492001938924,40.0,0.0
36189,3,6189,[275 143 273 302 742],655,4,25351,4.095476575121163,0.0,20.0
36190,3,6190,[318 427 185 515 313],655,5,25356,4.095622678081085,40.0,0.0
36191,3,6191,[ 97 153 200  50 333],236,1,25357,4.0951227390180875,0.0,20.0
36192,3,6192,[748 483 191 655  25],401,3,25360,4.094945906668819,0.0,0.0
36193,3,6193,[318 427 185 515 313],655,5,25365,4.095092024539877,40.0,0.0
36194,3,6194,[435   8 234  22 143],756,2,25367,4.094753833736885,0.0,0.0
36195,3,6195,[174 173 282 318 200],280,2,25369,4.0944157520981275,20.0,0.0
36196,3,6196,[282 318 144  11 197],716,3,25372,4.094239147974826,20.0,0.0
36197,3,6197,[318 427 185 515 313],655,5,25377,4.094385285575992,40.0,0.0
36198,3,6198,[117 173 276 234 588],280,3,25380,4.094208743345701,0.0,0.0
36199,3,6199,[318 427 185 515 313],655,5,25385,4.094354838709678,40.0,0.0
36200,3,6200,[318 427 185 515 313],655,5,25390,4.094500886953717,40.0,0.0
36201,3,6201,[258   1 302 187 196],655,2,25392,4.094163173169945,0.0,0.0
36202,3,6202,[172 403 180 161 176],72,2,25394,4.093825568273416,0.0,0.0
36203,3,6203,[121 405 181 237 183],655,1,25395,4.093326885880077,0.0,0.0
36204,3,6204,[202 100  97  15  98],457,5,25400,4.093473005640613,0.0,20.0
36205,3,6205,[318 427 185 515 313],655,5,25405,4.0936190783113116,40.0,0.0
36206,3,6206,[318 427 185 515 313],655,5,25410,4.093765103914935,40.0,0.0
36207,3,6207,[318 427 185 515 313],655,5,25415,4.093911082474227,40.0,0.0
36208,3,6208,[ 69 546 275 168 238],796,4,25419,4.093895957481076,0.0,20.0
36209,3,6209,[318 427 185 515 313],655,5,25424,4.094041867954911,40.0,0.0
36210,3,6210,[318 427 185 515 313],655,5,25429,4.094187731444212,40.0,0.0
36211,3,6211,[318 427 185 515 313],655,5,25434,4.094333547971668,40.0,0.0
36212,3,6212,[ 88 180 655 403 245],450,5,25439,4.094479317559955,0.0,0.0
36213,3,6213,[ 98 300 191 143 135],389,2,25441,4.094142259414226,0.0,0.0
36214,3,6214,[318 427 185 515 313],655,5,25446,4.0942880128720835,40.0,0.0
36215,3,6215,[ 88 196  70 111 286],11,4,25450,4.094272844272845,0.0,20.0
36216,3,6216,[318 427 185 515 313],655,5,25455,4.094418529837542,40.0,0.0
36217,3,6217,[385 191 423 173 181],151,3,25458,4.094242521711161,0.0,0.0
36218,3,6218,[318 427 185 515 313],655,5,25463,4.094388165299887,40.0,0.0
36219,3,6219,[313 234 258  15 200],450,2,25465,4.094051446945338,0.0,0.0
36220,3,6220,[357 172 191 100 655],72,4,25469,4.094036328564539,0.0,20.0
36221,3,6221,[135 191  89 588 300],450,4,25473,4.094021215043394,0.0,0.0
36222,3,6222,[288 144   8 234 357],457,5,25478,4.094166800578499,0.0,0.0
36223,3,6223,[302 655  82 168 322],151,2,25480,4.093830334190232,0.0,0.0
36224,3,6224,[175 475 318 144  12],655,1,25481,4.093333333333334,20.0,0.0
36225,3,6225,[318 427 185 515 313],655,5,25486,4.093478959203341,40.0,0.0
36226,3,6226,[173 151 174 300 228],292,5,25491,4.093624538300947,0.0,0.0
36227,3,6227,[318 427 185 515 313],655,5,25496,4.0937700706486835,40.0,0.0
36228,3,6228,[318 427 185 515 313],655,5,25501,4.093915556269064,40.0,0.0
36229,3,6229,[318 427 185 515 313],655,5,25506,4.0940609951845905,40.0,0.0
36230,3,6230,[405 125 423 202 111],655,0,25506,4.093403948001926,0.0,0.0
36231,3,6231,[237 294 197 282 200],450,4,25510,4.093388960205392,0.0,0.0
36232,3,6232,[318 427 185 515 313],655,5,25515,4.093534413605005,40.0,0.0
36233,3,6233,[318 427 185 515 313],655,5,25520,4.09367982034007,40.0,0.0
36234,3,6234,[ 98 268 597 588  50],344,3,25523,4.093504410585405,0.0,20.0
36235,3,6235,[ 50 294 257 322 300],504,3,25526,4.093329057087876,0.0,20.0
36236,3,6236,[318 427 185 515 313],655,5,25531,4.09347442680776,40.0,0.0
36237,3,6237,[ 12  98 186 117 211],693,3,25534,4.093299134337929,0.0,0.0
36238,3,6238,[318 427 185 515 313],655,5,25539,4.093444462253566,40.0,0.0
36239,3,6239,[153 215 121 603 742],655,1,25540,4.092948717948718,20.0,0.0
36240,3,6240,[151  98 357 187 328],796,5,25545,4.093094055439833,0.0,0.0
36241,3,6241,[234  69 403 197 143],504,3,25548,4.0929189362383855,0.0,0.0
36242,3,6242,[318 427 185 515 313],655,5,25553,4.093064231939772,40.0,0.0
36243,3,6243,[318 427 185 515 313],655,5,25558,4.093209481101858,40.0,0.0
36244,3,6244,[195 265 153 168 210],450,4,25562,4.093194555644516,0.0,0.0
36245,3,6245,[318 427 185 515 313],655,5,25567,4.093339737431957,40.0,0.0
36246,3,6246,[318 427 185 515 313],655,5,25572,4.093484872738915,40.0,0.0
36247,3,6247,[222 265 313 100 200],236,2,25574,4.09314980793854,0.0,20.0
36248,3,6248,[318 427 185 515 313],655,5,25579,4.09329492718835,40.0,0.0
36249,3,6249,[176 301  95 186 273],450,2,25581,4.09296,0.0,0.0
36250,3,6250,[117 172 216 195 204],885,3,25584,4.0927851543753,0.0,0.0
36251,3,6251,[318 427 185 515 313],655,5,25589,4.092930262316059,40.0,0.0
36252,3,6252,[318 427 185 515 313],655,5,25594,4.0930753238445545,40.0,0.0
36253,3,6253,[237 132  56  28   9],457,5,25599,4.093220338983051,0.0,0.0
36254,3,6254,[  7 180 181 318  98],72,3,25602,4.09304556354916,20.0,0.0
36255,3,6255,[318 427 185 515 313],655,5,25607,4.093190537084399,40.0,0.0
36256,3,6256,[269 174 180 238  56],450,5,25612,4.093335464280006,0.0,0.0
36257,3,6257,[127 173 174 238  95],389,3,25615,4.09316075423458,0.0,20.0
36258,3,6258,[318 427 185 515 313],655,5,25620,4.093305639878575,40.0,0.0
36259,3,6259,[153 176 183 245 275],796,4,25624,4.093290734824281,0.0,20.0
36260,3,6260,[318 427 185 515 313],655,5,25629,4.09343555342597,40.0,0.0
36261,3,6261,[318 427 185 515 313],655,5,25634,4.093580325774513,40.0,0.0
36262,3,6262,[655 125 405 471 237],450,5,25639,4.093725051892065,0.0,0.0
36263,3,6263,[318 427 185 515 313],655,5,25644,4.093869731800766,40.0,0.0
36264,3,6264,[173 143 313 135 127],807,3,25647,4.093695131683958,0.0,20.0
36265,3,6265,[318 427 185 515 313],655,5,25652,4.093839770188318,40.0,0.0
36266,3,6266,[318 427 185 515 313],655,5,25657,4.093984362533908,40.0,0.0
36267,3,6267,[268 300 435 603 125],655,1,25658,4.093490746649649,20.0,0.0
36268,3,6268,[318 427 185 515 313],655,5,25663,4.093635348540437,40.0,0.0
36269,3,6269,[  7 302 195 603 269],450,5,25668,4.09377990430622,20.0,0.0
36270,3,6270,[655 496  88 357 742],450,5,25673,4.093924413969064,20.0,0.0
36271,3,6271,[483 323 195 191 197],796,3,25676,4.09375,0.0,0.0
36272,3,6272,[183 111 483 143 405],655,3,25679,4.093575641638769,0.0,0.0
36273,3,6273,[ 25 168 427 181 597],450,4,25683,4.093560726809053,20.0,0.0
36274,3,6274,[318 427 185 515 313],655,5,25688,4.0937051792828685,40.0,0.0
36275,3,6275,[318 427 185 515 313],655,5,25693,4.09384958572339,40.0,0.0
36276,3,6276,[318 427 185 515 313],655,5,25698,4.0939939461526205,40.0,0.0
36277,3,6277,[ 25 237 100 313  15],463,4,25702,4.093978974195604,0.0,20.0
36278,3,6278,[180  22 269 597 357],796,3,25705,4.093804745978659,0.0,0.0
36279,3,6279,[318 427 185 515 313],655,5,25710,4.093949044585988,40.0,0.0
36280,3,6280,[318 427 185 515 313],655,5,25715,4.094093297245662,40.0,0.0
36281,3,6281,[318 427 185 515 313],655,5,25720,4.094237503979624,40.0,0.0
36282,3,6282,[135 175 405 172 191],151,3,25723,4.094063345535572,0.0,0.0
36283,3,6283,[204 111 403 132  69],577,5,25728,4.094207511139402,0.0,0.0
36284,3,6284,[318 427 185 515 313],655,5,25733,4.094351630867144,40.0,0.0
36285,3,6285,[318 427 185 515 313],655,5,25738,4.094495704740694,40.0,0.0
36286,3,6286,[385 210 175 275  96],716,2,25740,4.09416255765866,0.0,20.0
36287,3,6287,[194 275  95 427 151],796,5,25745,4.094306615776081,20.0,20.0
36288,3,6288,[318 427 185 515 313],655,5,25750,4.094450628080776,40.0,0.0
36289,3,6289,[202 496 118 313 597],450,4,25754,4.094435612082671,20.0,0.0
36290,3,6290,[508 276 423 313 385],280,3,25757,4.094261643617867,0.0,0.0
36291,3,6291,[318 427 185 515 313],655,5,25762,4.094405594405594,40.0,0.0
36292,3,6292,[132  95  11  98   4],577,4,25766,4.094390592722072,0.0,0.0
36293,3,6293,[318 427 185 515 313],655,5,25771,4.094534477279949,40.0,0.0
36294,3,6294,[210 176 196 100   4],151,3,25774,4.094360603653693,0.0,20.0
36295,3,6295,[ 69  25 273  70 742],344,2,25776,4.094027954256671,0.0,0.0
36296,3,6296,[111 118 546 121 216],716,3,25779,4.093854216293473,0.0,0.0
36297,3,6297,[318 427 185 515 313],655,5,25784,4.093998094633217,40.0,0.0
36298,3,6298,[168 185  11  95 269],450,4,25788,4.093983171932052,0.0,0.0
36299,3,6299,[318 427 185 515 313],655,5,25793,4.0941269841269845,40.0,0.0
36300,3,6300,[161   1 173 471   7],450,5,25798,4.094270750674496,0.0,0.0
36301,3,6301,[195 301  70 228 222],450,4,25802,4.094255791812123,0.0,0.0
36302,3,6302,[ 25 655 271 257 179],655,1,25803,4.093764873869586,0.0,0.0
36303,3,6303,[127 210 568 282 235],716,3,25806,4.093591370558376,0.0,20.0
36304,3,6304,[210 127  89 118  70],72,3,25809,4.093417922283901,0.0,20.0
36305,3,6305,[318 427 185 515 313],655,5,25814,4.093561687281953,40.0,0.0
36306,3,6306,[234 172 183 175  28],716,3,25817,4.093388298715713,0.0,0.0
36307,3,6307,[318 427 185 515 313],655,5,25822,4.093532022828155,40.0,0.0
36308,3,6308,[216  89 427 286 111],151,5,25827,4.093675701378983,20.0,20.0
36309,3,6309,[235  22 275  11 161],716,3,25830,4.093502377179081,0.0,20.0
36310,3,6310,[318 427 185 515 313],655,5,25835,4.093646014894628,40.0,0.0
36311,3,6311,[ 70 185 275  12 151],707,2,25837,4.093314321926489,0.0,20.0
36312,3,6312,[195 194 187 294  79],450,5,25842,4.093457943925234,0.0,0.0
36313,3,6313,[234 168 197 185 182],457,5,25847,4.093601520430789,0.0,0.0
36314,3,6314,[318 427 185 515 313],655,5,25852,4.093745051464767,40.0,0.0
36315,3,6315,[318 427 185 515 313],655,5,25857,4.093888537048765,40.0,0.0
36316,3,6316,[318 427 185 515 313],655,5,25862,4.094031977204369,40.0,0.0
36317,3,6317,[318 427 185 515 313],655,5,25867,4.09417537195315,40.0,0.0
36318,3,6318,[318 427 185 515 313],655,5,25872,4.094318721316664,40.0,0.0
36319,3,6319,[318 427 185 515 313],655,5,25877,4.094462025316456,40.0,0.0
36320,3,6320,[318 427 185 515 313],655,5,25882,4.0946052839740545,40.0,0.0
36321,3,6321,[385 597  56 210  97],450,4,25886,4.094590319519139,0.0,0.0
36322,3,6322,[215 161 183 196 257],504,4,25890,4.094575359797564,0.0,0.0
36323,3,6323,[318 427 185 515 313],655,5,25895,4.09471853257432,40.0,0.0
36324,3,6324,[427 132 302 118  28],655,2,25897,4.094387351778656,20.0,0.0
36325,3,6325,[204 403 211 234 195],655,0,25897,4.093740120139109,0.0,0.0
36326,3,6326,[186  88 121 125 273],450,2,25899,4.093409198672356,0.0,0.0
36327,3,6327,[318 427 185 515 313],655,5,25904,4.0935524652338815,40.0,0.0
36328,3,6328,[286 182 100 186 111],18,4,25908,4.093537683678306,0.0,40.0
36329,3,6329,[300 111 423 185 118],450,4,25912,4.093522906793049,0.0,0.0
36330,3,6330,[117 222 183  88  22],756,2,25914,4.093192228715843,0.0,0.0
36331,3,6331,[318 427 185 515 313],655,5,25919,4.093335439039798,40.0,0.0
36332,3,6332,[318 427 185 515 313],655,5,25924,4.09347860413706,40.0,0.0
36333,3,6333,[318 427 185 515 313],655,5,25929,4.09362172402905,40.0,0.0
36334,3,6334,[302  56 357  97 176],151,3,25932,4.09344909234412,0.0,0.0
36335,3,6335,[ 70 423 508  64 151],269,4,25936,4.093434343434343,20.0,0.0
36336,3,6336,[318 427 185 515 313],655,5,25941,4.093577402556415,40.0,0.0
36337,3,6337,[748 546   1 215 294],796,3,25944,4.093404859577154,0.0,0.0
36338,3,6338,[228 117 568 655 181],280,1,25945,4.092916863858653,0.0,0.0
36339,3,6339,[143 515 234 186 483],655,3,25948,4.092744479495268,0.0,0.0
36340,3,6340,[ 25 655 435  50 175],655,1,25949,4.092256741838827,0.0,20.0
36341,3,6341,[318 427 185 515 313],655,5,25954,4.092399873856827,40.0,0.0
36342,3,6342,[234 748 265 515  79],807,4,25958,4.0923853066372375,0.0,0.0
36343,3,6343,[228 237  69 568 172],72,2,25960,4.092055485498109,0.0,0.0
36344,3,6344,[ 98 288 269 185  70],655,2,25962,4.091725768321513,0.0,0.0
36345,3,6345,[187 357 222  88 301],450,4,25966,4.091711314213678,0.0,0.0
36346,3,6346,[318 427 185 515 313],655,5,25971,4.091854419410745,40.0,0.0
36347,3,6347,[ 82 678 385 161 228],280,2,25973,4.091524889729048,0.0,0.0
36348,3,6348,[ 15 289 191 125   7],296,3,25976,4.091352968971491,0.0,0.0
36349,3,6349,[318 427 185 515 313],655,5,25981,4.091496062992126,40.0,0.0
36350,3,6350,[172 228 357 265 185],457,5,25986,4.091639111950874,0.0,0.0
36351,3,6351,[318 427 185 515 313],655,5,25991,4.091782115869018,40.0,0.0
36352,3,6352,[180 568  88 118 111],280,2,25993,4.091452856917991,0.0,0.0
36353,3,6353,[ 79 258 161 185 215],450,5,25998,4.091595845136921,0.0,0.0
36354,3,6354,[318 427 185 515 313],655,5,26003,4.0917387883556255,40.0,0.0
36355,3,6355,[135 423 200 235 161],450,2,26005,4.091409691629956,0.0,0.0
36356,3,6356,[318 427 185 515 313],655,5,26010,4.091552619159981,40.0,0.0
36357,3,6357,[318 427 185 515 313],655,5,26015,4.091695501730104,40.0,0.0
36358,3,6358,[216 318 294   7 435],450,5,26020,4.0918383393615345,20.0,0.0
36359,3,6359,[269 196 313 125 237],655,1,26021,4.091352201257862,0.0,0.0
36360,3,6360,[ 64 172 237 111 197],269,2,26023,4.091023423989939,20.0,0.0
36361,3,6361,[318 427 185 515 313],655,5,26028,4.09116629990569,40.0,0.0
36362,3,6362,[210 195  97 597 423],450,4,26032,4.091151972340091,0.0,0.0
36363,3,6363,[ 97 202 194 568 496],796,4,26036,4.091137649277184,20.0,0.0
36364,3,6364,[ 28  98 127 143 588],389,4,26040,4.091123330714847,0.0,20.0
36365,3,6365,[546 423 265 333  50],796,5,26045,4.091266101162425,0.0,20.0
36366,3,6366,[318 427 185 515 313],655,5,26050,4.091408826762997,40.0,0.0
36367,3,6367,[174 181 135  95 228],330,4,26054,4.091394472361809,0.0,0.0
36368,3,6368,[300  79 427 204 228],716,5,26059,4.09153713298791,20.0,0.0
36369,3,6369,[228  25  11 257 161],330,5,26064,4.091679748822606,0.0,0.0
36370,3,6370,[300 181 173  97 405],716,5,26069,4.091822319886988,0.0,0.0
36371,3,6371,[318 427 185 515 313],655,5,26074,4.091964846202134,40.0,0.0
36372,3,6372,[333 125 222  64 268],655,1,26075,4.091479679899576,20.0,0.0
36373,3,6373,[597 132  69 161 211],796,4,26079,4.091465327894571,0.0,0.0
36374,3,6374,[  4 118 258 742 568],450,3,26082,4.091294117647059,0.0,0.0
36375,3,6375,[318 427 185 515 313],655,5,26087,4.091436637390213,40.0,0.0
36376,3,6376,[385 174 301 175 597],344,3,26090,4.091265485337933,0.0,0.0
36377,3,6377,[172   1 161 301  50],593,4,26094,4.091251175917216,0.0,20.0
36378,3,6378,[222 427 300  71  96],807,4,26098,4.091236870982913,20.0,0.0
36379,3,6379,[215 196 588 301  28],450,5,26103,4.091379310344828,0.0,0.0
36380,3,6380,[ 70 161 269 173 210],450,4,26107,4.091364989813509,0.0,0.0
36381,3,6381,[318 427 185 515 313],655,5,26112,4.091507364462551,40.0,0.0
36382,3,6382,[186   9 151  11  56],457,5,26117,4.091649694501018,0.0,0.0
36383,3,6383,[318 427 185 515 313],655,5,26122,4.091791979949875,40.0,0.0
36384,3,6384,[318 427 185 515 313],655,5,26127,4.091934220830071,40.0,0.0
36385,3,6385,[318 427 185 515 313],655,5,26132,4.092076417162543,40.0,0.0
36386,3,6386,[318 427 185 515 313],655,5,26137,4.0922185689682165,40.0,0.0
36387,3,6387,[318 427 185 515 313],655,5,26142,4.092360676268003,40.0,0.0
36388,3,6388,[269 197 282 215 182],655,1,26143,4.091876663014556,0.0,0.0
36389,3,6389,[179 655 603 271 132],655,2,26145,4.091549295774648,20.0,0.0
36390,3,6390,[318 427 185 515 313],655,5,26150,4.091691441089031,40.0,0.0
36391,3,6391,[202 151  79 197 174],389,5,26155,4.091833541927409,0.0,0.0
36392,3,6392,[318 427 185 515 313],655,5,26160,4.091975598310652,40.0,0.0
36393,3,6393,[200 265 173 435  25],716,5,26165,4.092117610259618,0.0,0.0
36394,3,6394,[318 427 185 515 313],655,5,26170,4.0922595777951525,40.0,0.0
36395,3,6395,[276  82  12   9 568],280,3,26173,4.0920888055034395,0.0,0.0
36396,3,6396,[568 194 234 403   9],269,2,26175,4.091761763326559,0.0,0.0
36397,3,6397,[118 210  70 471   9],655,0,26175,4.09112222569553,0.0,0.0
36398,3,6398,[405 597 204  98 176],269,1,26176,4.09063916236912,0.0,0.0
36399,3,6399,[151   4 191 423  25],716,4,26180,4.090625,0.0,0.0
36400,3,6400,[235 435 118 515 271],807,2,26182,4.090298390876425,0.0,0.0
36401,3,6401,[318 427 185 515 313],655,5,26187,4.090440487347704,40.0,0.0
36402,3,6402,[655 546 132  69 211],786,5,26192,4.0905825394346405,0.0,0.0
36403,3,6403,[ 50 100  56   7 121],655,1,26193,4.090099937539038,0.0,40.0
36404,3,6404,[172 245 568 237 258],796,4,26197,4.0900858704137395,0.0,0.0
36405,3,6405,[187 153  50 204 121],503,2,26199,4.089759600374649,0.0,20.0
36406,3,6406,[238 194 265  64 403],457,5,26204,4.089901670048385,20.0,0.0
36407,3,6407,[423 357 191  69 194],835,5,26209,4.090043695380774,0.0,0.0
36408,3,6408,[186 200 204 182 187],269,3,26212,4.089873615228584,0.0,0.0
36409,3,6409,[187 181 172  50 180],693,0,26212,4.089235569422777,0.0,20.0
36410,3,6410,[191 117  50 588 322],796,4,26216,4.089221650288566,0.0,20.0
36411,3,6411,[271   1 121 515 237],72,2,26218,4.088895820336869,0.0,0.0
36412,3,6412,[318 427 185 515 313],655,5,26223,4.089037891782318,40.0,0.0
36413,3,6413,[318 427 185 515 313],655,5,26228,4.089179918927346,40.0,0.0
36414,3,6414,[318 427 185 515 313],655,5,26233,4.089321901792673,40.0,0.0
36415,3,6415,[275 301 111 435 228],450,5,26238,4.089463840399002,0.0,20.0
36416,3,6416,[318 427 185 515 313],655,5,26243,4.089605734767025,40.0,0.0
36417,3,6417,[144 172  28  12  69],796,4,26247,4.089591773138049,0.0,0.0
36418,3,6418,[174 194 597 195 153],796,5,26252,4.08973360336501,0.0,0.0
36419,3,6419,[318 427 185 515 313],655,5,26257,4.0898753894081,40.0,0.0
36420,3,6420,[318 427 185 515 313],655,5,26262,4.090017131287961,40.0,0.0
36421,3,6421,[318 427 185 515 313],655,5,26267,4.090158829025226,40.0,0.0
36422,3,6422,[ 89   1 111 496 288],344,4,26271,4.0901447921531995,20.0,0.0
36423,3,6423,[423 216  64 196  69],389,3,26274,4.089975093399751,20.0,0.0
36424,3,6424,[202 228 185 275 568],450,5,26279,4.09011673151751,0.0,20.0
36425,3,6425,[ 50 215 276 186 153],504,1,26280,4.089635854341736,0.0,20.0
36426,3,6426,[ 15  88 546 294  22],256,4,26284,4.089621907577408,0.0,0.0
36427,3,6427,[318 427 185 515 313],655,5,26289,4.089763534536403,40.0,0.0
36428,3,6428,[ 98 180 127 197 118],72,4,26293,4.089749572250739,0.0,20.0
36429,3,6429,[515 174   4 268 204],535,2,26295,4.089424572317263,0.0,0.0
36430,3,6430,[318 427 185 515 313],655,5,26300,4.0895661638936405,40.0,0.0
36431,3,6431,[ 97 423 111 603 191],716,5,26305,4.089707711442786,20.0,0.0
36432,3,6432,[276 211 405 161 185],401,3,26308,4.089538318047567,0.0,0.0
36433,3,6433,[216 153 215 197 508],731,3,26311,4.089368977308051,0.0,0.0
36434,3,6434,[196 435 161 153   1],401,2,26313,4.089044289044289,0.0,0.0
36435,3,6435,[196 183 161  98 423],716,3,26316,4.088875077688005,0.0,0.0
36436,3,6436,[318 427 185 515 313],655,5,26321,4.089016622650303,40.0,0.0
36437,3,6437,[318 427 185 515 313],655,5,26326,4.089158123640882,40.0,0.0
36438,3,6438,[ 50  98 216 195  69],655,3,26329,4.088988973443081,0.0,20.0
36439,3,6439,[568  71 118 100 294],796,3,26332,4.088819875776397,0.0,20.0
36440,3,6440,[182 143 294 168 180],796,3,26335,4.088650830616364,0.0,0.0
36441,3,6441,[185 483 181 286 135],535,3,26338,4.088481837938528,0.0,20.0
36442,3,6442,[318 427 185 515 313],655,5,26343,4.088623312121682,40.0,0.0
36443,3,6443,[318 427 185 515 313],655,5,26348,4.088764742396028,40.0,0.0
36444,3,6444,[216 187 318 153 197],503,4,26352,4.088750969743987,20.0,0.0
36445,3,6445,[318 427 185 515 313],655,5,26357,4.088892336332609,40.0,0.0
36446,3,6446,[318 427 185 515 313],655,5,26362,4.089033659066232,40.0,0.0
36447,3,6447,[318 427 185 515 313],655,5,26367,4.089174937965261,40.0,0.0
36448,3,6448,[ 88 143  82  69 237],174,4,26371,4.089161110249651,0.0,0.0
36449,3,6449,[318 427 185 515 313],655,5,26376,4.089302325581396,40.0,0.0
36450,3,6450,[294 273 161  98 265],450,4,26380,4.089288482405829,0.0,0.0
36451,3,6451,[132 238 275  15   1],457,5,26385,4.089429634221947,0.0,20.0
36452,3,6452,[318 427 185 515 313],655,5,26390,4.089570742290408,40.0,0.0
36453,3,6453,[275 318 180 187 496],18,5,26395,4.089711806631547,40.0,20.0
36454,3,6454,[282  64 144  71 318],401,2,26397,4.089388071262587,40.0,0.0
36455,3,6455,[603 132 216  79 568],716,5,26402,4.089529120198265,20.0,0.0
36456,3,6456,[318 427 185 515 313],655,5,26407,4.089670125445253,40.0,0.0
36457,3,6457,[187 228  89 132  88],786,5,26412,4.089811087023846,0.0,0.0
36458,3,6458,[216  82 301 245  79],796,2,26414,4.089487536770398,0.0,0.0
36459,3,6459,[318 427 185 515 313],655,5,26419,4.089628482972136,40.0,0.0
36460,3,6460,[  4 313 210 161  97],450,3,26422,4.089459835938709,0.0,0.0
36461,3,6461,[168 282 185 301   4],450,4,26426,4.089445991952956,0.0,0.0
36462,3,6462,[318 427 185 515 313],655,5,26431,4.0895868791582854,40.0,0.0
36463,3,6463,[  9 286 210  56  70],174,5,26436,4.0897277227722775,0.0,20.0
36464,3,6464,[196 483 186 210 234],389,2,26438,4.089404485692189,0.0,0.0
36465,3,6465,[318 427 185 515 313],655,5,26443,4.089545313949892,40.0,0.0
36466,3,6466,[318 427 185 515 313],655,5,26448,4.089686098654709,40.0,0.0
36467,3,6467,[318 427 185 515 313],655,5,26453,4.08982683982684,40.0,0.0
36468,3,6468,[301  70 237 121  97],593,5,26458,4.089967537486474,0.0,0.0
36469,3,6469,[144  22   1 186 180],296,4,26462,4.089953632148377,0.0,0.0
36470,3,6470,[161 121 143 174 357],457,5,26467,4.090094266728481,0.0,0.0
36471,3,6471,[181 258 168 132 313],807,4,26471,4.090080346106304,0.0,0.0
36472,3,6472,[302 427 423 175 176],151,3,26474,4.08991194191256,20.0,0.0
36473,3,6473,[318 427 185 515 313],655,5,26479,4.090052517763361,40.0,0.0
36474,3,6474,[328 173 196  97  88],401,4,26483,4.09003861003861,0.0,0.0
36475,3,6475,[568 135 275 300 603],756,2,26485,4.089715873996294,20.0,20.0
36476,3,6476,[183 172 234 143 282],655,3,26488,4.089547630075653,0.0,0.0
36477,3,6477,[318 427 185 515 313],655,5,26493,4.089688175362766,40.0,0.0
36478,3,6478,[195 475 286 508 273],655,1,26494,4.089211298039821,0.0,20.0
36479,3,6479,[215 186 238 328 300],655,0,26494,4.088580246913581,0.0,0.0
36480,3,6480,[318 427 185 515 313],655,5,26499,4.088720876407962,40.0,0.0
36481,3,6481,[318 427 185 515 313],655,5,26504,4.088861462511571,40.0,0.0
36482,3,6482,[318 427 185 515 313],655,5,26509,4.0890020052444855,40.0,0.0
36483,3,6483,[271 215 144 191   1],655,1,26510,4.088525601480567,0.0,0.0
36484,3,6484,[318 427 185 515 313],655,5,26515,4.088666152659985,40.0,0.0
36485,3,6485,[216 403  95 245  79],450,4,26519,4.088652482269503,0.0,0.0
36486,3,6486,[318 427 185 515 313],655,5,26524,4.088792970556498,40.0,0.0
36487,3,6487,[318 427 185 515 313],655,5,26529,4.088933415536375,40.0,0.0
36488,3,6488,[288 313 568 483 187],655,3,26532,4.08876560332871,0.0,0.0
36489,3,6489,[318 427 185 515 313],655,5,26537,4.088906009244992,40.0,0.0
36490,3,6490,[318 427 185 515 313],655,5,26542,4.0890463718995536,40.0,0.0
36491,3,6491,[318 427 185 515 313],655,5,26547,4.089186691312385,40.0,0.0
36492,3,6492,[125 282  89 515 117],655,2,26549,4.088864931464654,0.0,0.0
36493,3,6493,[144 186  70 655   4],655,0,26549,4.088235294117647,0.0,0.0
36494,3,6494,[318 427 185 515 313],655,5,26554,4.088375673595073,40.0,0.0
36495,3,6495,[179 175 186  98 211],655,2,26556,4.088054187192118,0.0,0.0
36496,3,6496,[318 427 185 515 313],655,5,26561,4.088194551331384,40.0,0.0
36497,3,6497,[318 427 185 515 313],655,5,26566,4.0883348722683905,40.0,0.0
36498,3,6498,[318 427 185 515 313],655,5,26571,4.08847515002308,40.0,0.0
36499,3,6499,[318 427 185 515 313],655,5,26576,4.088615384615385,40.0,0.0
36500,3,6500,[318 427 185 515 313],655,5,26581,4.08875557606522,40.0,0.0
36501,3,6501,[318 427 185 515 313],655,5,26586,4.088895724392494,40.0,0.0
36502,3,6502,[196 403 258 588 423],796,5,26591,4.089035829617099,0.0,0.0
36503,3,6503,[182 403  96 258 496],796,5,26596,4.089175891758917,20.0,0.0
36504,3,6504,[ 64 301 100 268 265],535,3,26599,4.089008455034588,20.0,20.0
36505,3,6505,[318 427 185 515 313],655,5,26604,4.089148478327697,40.0,0.0
36506,3,6506,[238 269  69 132 655],174,4,26608,4.089134777931458,0.0,0.0
36507,3,6507,[161  97 210  22 132],716,4,26612,4.089121081745544,0.0,0.0
36508,3,6508,[ 50 313 174  95  82],450,3,26615,4.0889537563373795,0.0,20.0
36509,3,6509,[318 427 185 515 313],655,5,26620,4.089093701996928,40.0,0.0
36510,3,6510,[ 88 282  56 318   1],457,5,26625,4.089233604669022,20.0,0.0
36511,3,6511,[288 153  79  89 357],655,3,26628,4.089066339066339,0.0,0.0
36512,3,6512,[427 496 173 118  25],389,2,26630,4.088745585751574,40.0,0.0
36513,3,6513,[185 121 268 318   9],655,2,26632,4.0884249309180225,20.0,0.0
36514,3,6514,[318 427 185 515 313],655,5,26637,4.088564850345357,40.0,0.0
36515,3,6515,[318 427 185 515 313],655,5,26642,4.088704726826274,40.0,0.0
36516,3,6516,[423 204  98 183 603],796,5,26647,4.088844560380543,20.0,0.0
36517,3,6517,[181 191 568 496 515],269,3,26650,4.088677508438171,20.0,0.0
36518,3,6518,[748 471 288  22 403],256,5,26655,4.088817303267373,0.0,0.0
36519,3,6519,[282 234 211 471   7],450,4,26659,4.088803680981595,0.0,0.0
36520,3,6520,[318 427 185 515 313],655,5,26664,4.088943413586873,40.0,0.0
36521,3,6521,[318 588 237  88 132],330,5,26669,4.089083103342533,20.0,0.0
36522,3,6522,[568 111  12 322 269],344,4,26673,4.089069446573663,0.0,0.0
36523,3,6523,[318 427 185 515 313],655,5,26678,4.089209074187615,40.0,0.0
36524,3,6524,[161 111 153 302 180],450,5,26683,4.089348659003831,0.0,0.0
36525,3,6525,[318 427 185 515 313],655,5,26688,4.089488201041986,40.0,0.0
36526,3,6526,[318 427 185 515 313],655,5,26693,4.08962770032174,40.0,0.0
36527,3,6527,[172 228 210  22 748],796,4,26697,4.0896139705882355,0.0,0.0
36528,3,6528,[318 427 185 515 313],655,5,26702,4.089753407872569,40.0,0.0
36529,3,6529,[183  98 200 143  25],655,4,26706,4.089739663093415,0.0,0.0
36530,3,6530,[318 427 185 515 313],655,5,26711,4.089879038432093,40.0,0.0
36531,3,6531,[318 427 185 515 313],655,5,26716,4.090018371096142,40.0,0.0
36532,3,6532,[318 427 185 515 313],655,5,26721,4.090157661105159,40.0,0.0
36533,3,6533,[318 427 185 515 313],655,5,26726,4.090296908478726,40.0,0.0
36534,3,6534,[318 427 185 515 313],655,5,26731,4.090436113236419,40.0,0.0
36535,3,6535,[318 427 185 515 313],655,5,26736,4.090575275397796,40.0,0.0
36536,3,6536,[318 427 185 515 313],655,5,26741,4.090714394982408,40.0,0.0
36537,3,6537,[318 427 185 515 313],655,5,26746,4.090853472009789,40.0,0.0
36538,3,6538,[ 69 275 286 143 125],593,4,26750,4.090839577917112,0.0,40.0
36539,3,6539,[318 427 185 515 313],655,5,26755,4.090978593272172,40.0,0.0
36540,3,6540,[427 288  97 195 127],450,4,26759,4.090964684299037,20.0,20.0
36541,3,6541,[318 427 185 515 313],655,5,26764,4.091103638031183,40.0,0.0
36542,3,6542,[ 98  64 427 328  22],796,5,26769,4.0912425492893165,40.0,0.0
36543,3,6543,[318 427 185 515 313],655,5,26774,4.09138141809291,40.0,0.0
36544,3,6544,[204   1 423 117 655],577,5,26779,4.091520244461421,0.0,0.0
36545,3,6545,[318 427 185 515 313],655,5,26784,4.091659028414298,40.0,0.0
36546,3,6546,[318 427 185 515 313],655,5,26789,4.091797769970979,40.0,0.0
36547,3,6547,[318 427 185 515 313],655,5,26794,4.091936469150886,40.0,0.0
36548,3,6548,[265 300 187 234 216],450,4,26798,4.091922430905481,0.0,0.0
36549,3,6549,[318 427 185 515 313],655,5,26803,4.09206106870229,40.0,0.0
36550,3,6550,[318 427 185 515 313],655,5,26808,4.092199664173409,40.0,0.0
36551,3,6551,[318 427 185 515 313],655,5,26813,4.0923382173382175,40.0,0.0
36552,3,6552,[222  12  82 202   4],280,1,26814,4.091866320769113,0.0,0.0
36553,3,6553,[ 96 282 471 215 151],457,5,26819,4.092004882514495,0.0,0.0
36554,3,6554,[153 216 678 322 117],280,4,26823,4.091990846681922,0.0,0.0
36555,3,6555,[318 427 185 515 313],655,5,26828,4.0921293471629046,40.0,0.0
36556,3,6556,[318 427 185 515 313],655,5,26833,4.09226780539881,40.0,0.0
36557,3,6557,[318 427 185 515 313],655,5,26838,4.092406221408966,40.0,0.0
36558,3,6558,[318 427 185 515 313],655,5,26843,4.092544595212685,40.0,0.0
36559,3,6559,[678  88 318 742 215],504,4,26847,4.092530487804878,20.0,0.0
36560,3,6560,[318 427 185 515 313],655,5,26852,4.092668800487731,40.0,0.0
36561,3,6561,[ 79 118 153 215 288],655,1,26853,4.092197500761963,0.0,0.0
36562,3,6562,[ 82 318  64 286 161],655,2,26855,4.091878714002743,40.0,20.0
36563,3,6563,[318 427 185 515 313],655,5,26860,4.0920170627666055,40.0,0.0
36564,3,6564,[318 427 185 515 313],655,5,26865,4.092155369383092,40.0,0.0
36565,3,6565,[423  79 568  88 161],798,3,26868,4.091989034419738,0.0,0.0
36566,3,6566,[318 427 185 515 313],655,5,26873,4.09212730318258,40.0,0.0
36567,3,6567,[318 427 185 515 313],655,5,26878,4.092265529841656,40.0,0.0
36568,3,6568,[ 11 483   8 187 100],535,4,26882,4.092251484244177,0.0,20.0
36569,3,6569,[318 427 185 515 313],655,5,26887,4.092389649923897,40.0,0.0
36570,3,6570,[427 187 328 385  82],450,4,26891,4.092375589712373,20.0,0.0
36571,3,6571,[197 186   7  70 168],535,5,26896,4.092513694461351,0.0,0.0
36572,3,6572,[318 427 185 515 313],655,5,26901,4.092651757188499,40.0,0.0
36573,3,6573,[496 117  50  56 269],796,4,26905,4.092637663522969,20.0,20.0
36574,3,6574,[  1 127 204 423  96],796,4,26909,4.092623574144486,0.0,20.0
36575,3,6575,[318 427 185 515 313],655,5,26914,4.0927615571776155,40.0,0.0
36576,3,6576,[132  56   8  11 435],535,4,26918,4.092747453246161,0.0,0.0
36577,3,6577,[125 603 508  22 742],655,1,26919,4.092277287929462,20.0,0.0
36578,3,6578,[318 427 185 515 313],655,5,26924,4.092415260677915,40.0,0.0
36579,3,6579,[318 427 185 515 313],655,5,26929,4.092553191489362,40.0,0.0
36580,3,6580,[318 427 185 515 313],655,5,26934,4.09269108038292,40.0,0.0
36581,3,6581,[144  79 173   8 257],807,4,26938,4.092676997872987,0.0,0.0
36582,3,6582,[385 282 153  97 172],593,5,26943,4.092814826067142,0.0,0.0
36583,3,6583,[318 427 185 515 313],655,5,26948,4.092952612393682,40.0,0.0
36584,3,6584,[318 427 185 515 313],655,5,26953,4.093090356871678,40.0,0.0
36585,3,6585,[196 435 202 125 117],401,3,26956,4.0929243850592165,0.0,0.0
36586,3,6586,[202   1 234 257 258],655,0,26956,4.092303021102171,0.0,0.0
36587,3,6587,[318 427 185 515 313],655,5,26961,4.092440801457195,40.0,0.0
36588,3,6588,[318 427 185 515 313],655,5,26966,4.092578539990894,40.0,0.0
36589,3,6589,[423 211  28 191  50],796,3,26969,4.092412746585736,0.0,20.0
36590,3,6590,[318 427 185 515 313],655,5,26974,4.092550447580034,40.0,0.0
36591,3,6591,[318 427 185 515 313],655,5,26979,4.092688106796117,40.0,0.0
36592,3,6592,[483 210 196 176  64],151,4,26983,4.092674048232975,20.0,0.0
36593,3,6593,[318 427 185 515 313],655,5,26988,4.092811646951774,40.0,0.0
36594,3,6594,[144 273  56 588 546],450,4,26992,4.092797573919636,0.0,0.0
36595,3,6595,[515 172  25 238 237],535,3,26995,4.092631898120072,0.0,0.0
36596,3,6596,[211 588 125 117 194],796,4,26999,4.0926178566014855,0.0,0.0
36597,3,6597,[323 100 174 289 127],494,3,27002,4.092452258260079,0.0,40.0
36598,3,6598,[568 234 117 273 100],450,3,27005,4.092286710107592,0.0,20.0
36599,3,6599,[211 357  82  64 257],796,3,27008,4.092121212121212,20.0,0.0
36600,3,6600,[144 125 568 186 121],796,4,27012,4.092107256476291,0.0,0.0
36601,3,6601,[318 427 185 515 313],655,5,27017,4.092244774310815,40.0,0.0
36602,3,6602,[176 258 288 245  28],450,4,27021,4.092230804179918,0.0,0.0
36603,3,6603,[ 28 172 197 204 215],330,5,27026,4.0923682616596,0.0,0.0
36604,3,6604,[318 427 185 515 313],655,5,27031,4.092505677517033,40.0,0.0
36605,3,6605,[ 15 111 238 268 210],269,2,27033,4.092188919164396,0.0,0.0
36606,3,6606,[ 22 176   1 161  56],457,5,27038,4.092326320569093,0.0,0.0
36607,3,6607,[144 111 228 603 182],655,2,27040,4.092009685230024,20.0,0.0
36608,3,6608,[132 300 187 185  96],693,3,27043,4.091844454531699,0.0,0.0
36609,3,6609,[318 427 185 515 313],655,5,27048,4.091981845688351,40.0,0.0
36610,3,6610,[318 427 185 515 313],655,5,27053,4.092119195280593,40.0,0.0
36611,3,6611,[125 174  98 403 427],577,5,27058,4.092256503327284,20.0,0.0
36612,3,6612,[200 655 275 286  28],236,2,27060,4.091940117949494,0.0,40.0
36613,3,6613,[318 427 185 515 313],655,5,27065,4.092077411551255,40.0,0.0
36614,3,6614,[ 70  89 268 427  56],655,2,27067,4.091761148904006,20.0,0.0
36615,3,6615,[742  15  70 301 180],450,4,27071,4.0917472793228535,0.0,0.0
36616,3,6616,[405 211 483 435 215],450,4,27075,4.091733413933807,0.0,0.0
36617,3,6617,[322 257 186 328  82],796,2,27077,4.091417346630402,0.0,0.0
36618,3,6618,[318 427 185 515 313],655,5,27082,4.091554615500831,40.0,0.0
36619,3,6619,[318 427 185 515 313],655,5,27087,4.091691842900302,40.0,0.0
36620,3,6620,[318 427 185 515 313],655,5,27092,4.091829028847606,40.0,0.0
36621,3,6621,[318 427 185 515 313],655,5,27097,4.091966173361522,40.0,0.0
36622,3,6622,[318 427 185 515 313],655,5,27102,4.0921032764608185,40.0,0.0
36623,3,6623,[100  56 588  64 181],18,4,27106,4.092089371980676,20.0,20.0
36624,3,6624,[174 216  50 385  79],593,5,27111,4.0922264150943395,0.0,20.0
36625,3,6625,[ 82 275 196 427 182],18,3,27114,4.092061575611228,20.0,20.0
36626,3,6626,[318 427 185 515 313],655,5,27119,4.092198581560283,40.0,0.0
36627,3,6627,[318 427 185 515 313],655,5,27124,4.0923355461677735,40.0,0.0
36628,3,6628,[282  50 568 216   4],716,3,27127,4.09217076482124,0.0,20.0
36629,3,6629,[318 427 185 515 313],655,5,27132,4.092307692307692,40.0,0.0
36630,3,6630,[318 427 185 515 313],655,5,27137,4.092444578494948,40.0,0.0
36631,3,6631,[318 427 185 515 313],655,5,27142,4.092581423401689,40.0,0.0
36632,3,6632,[318 427 185 515 313],655,5,27147,4.092718227046586,40.0,0.0
36633,3,6633,[318 427 185 515 313],655,5,27152,4.092854989448297,40.0,0.0
36634,3,6634,[318 427 185 515 313],655,5,27157,4.092991710625471,40.0,0.0
36635,3,6635,[161 471 483 176 288],655,1,27158,4.092525617842074,0.0,0.0
36636,3,6636,[ 64 125  15   1 180],796,3,27161,4.092361006478831,20.0,0.0
36637,3,6637,[748 125 403 100 318],280,1,27162,4.091895149141307,20.0,20.0
36638,3,6638,[318 427 185 515 313],655,5,27167,4.092031932519958,40.0,0.0
36639,3,6639,[318 427 185 515 313],655,5,27172,4.0921686746987955,40.0,0.0
36640,3,6640,[276  82 318 121  79],655,3,27175,4.092004216232495,20.0,0.0
36641,3,6641,[318 427 185 515 313],655,5,27180,4.092140921409214,40.0,0.0
36642,3,6642,[318 427 185 515 313],655,5,27185,4.0922775854282705,40.0,0.0
36643,3,6643,[318 427 185 515 313],655,5,27190,4.092414208308248,40.0,0.0
36644,3,6644,[301   7 294 132 435],450,5,27195,4.09255079006772,0.0,0.0
36645,3,6645,[197 403 546  28 275],796,3,27198,4.092386397833283,0.0,20.0
36646,3,6646,[111 237 117 151 187],796,5,27203,4.092522942680909,0.0,0.0
36647,3,6647,[237 333  28 228 302],655,1,27204,4.092057761732852,0.0,0.0
36648,3,6648,[ 64 269 385 483 181],796,4,27208,4.092043916378403,20.0,0.0
36649,3,6649,[318 427 185 515 313],655,5,27213,4.0921804511278195,40.0,0.0
36650,3,6650,[195 182  50 100 603],18,3,27216,4.092016238159675,20.0,40.0
36651,3,6651,[318 427 185 515 313],655,5,27221,4.0921527360192425,40.0,0.0
36652,3,6652,[318 427 185 515 313],655,5,27226,4.092289192845333,40.0,0.0
36653,3,6653,[265 196  96 172 294],716,4,27230,4.092275323113917,0.0,0.0
36654,3,6654,[318 427 185 515 313],655,5,27235,4.092411720510894,40.0,0.0
36655,3,6655,[185 318 127 300 216],719,3,27238,4.092247596153846,20.0,20.0
36656,3,6656,[318 427 185 515 313],655,5,27243,4.092383956737269,40.0,0.0
36657,3,6657,[318 427 185 515 313],655,5,27248,4.092520276359267,40.0,0.0
36658,3,6658,[318 427 185 515 313],655,5,27253,4.092656555038294,40.0,0.0
36659,3,6659,[318 427 185 515 313],655,5,27258,4.0927927927927925,40.0,0.0
36660,3,6660,[ 88 328 282 191 273],450,4,27262,4.092778862032728,0.0,0.0
36661,3,6661,[294 427 748 196 300],450,5,27267,4.09291504052837,20.0,0.0
36662,3,6662,[228 515 181 423   4],655,1,27268,4.092450847966382,0.0,0.0
36663,3,6663,[153 185 427  95 204],18,3,27271,4.092286914765906,20.0,0.0
36664,3,6664,[195 172 183 403 176],280,0,27271,4.091672918229557,0.0,0.0
36665,3,6665,[ 97 204 385  69 427],577,5,27276,4.091809180918092,20.0,0.0
36666,3,6666,[318 427 185 515 313],655,5,27281,4.091945402729864,40.0,0.0
36667,3,6667,[318 427 185 515 313],655,5,27286,4.092081583683263,40.0,0.0
36668,3,6668,[318 427 185 515 313],655,5,27291,4.092217723796671,40.0,0.0
36669,3,6669,[318 427 185 515 313],655,5,27296,4.092353823088456,40.0,0.0
36670,3,6670,[318 427 185 515 313],655,5,27301,4.092489881576975,40.0,0.0
36671,3,6671,[318 427 185 515 313],655,5,27306,4.092625899280575,40.0,0.0
36672,3,6672,[318 427 185 515 313],655,5,27311,4.092761876217593,40.0,0.0
36673,3,6673,[318 427 185 515 313],655,5,27316,4.092897812406353,40.0,0.0
36674,3,6674,[ 82  97 183  98  88],655,2,27318,4.092584269662922,0.0,0.0
36675,3,6675,[318 427 185 515 313],655,5,27323,4.092720191731575,40.0,0.0
36676,3,6676,[222 245 282 234 546],256,4,27327,4.092706305226899,0.0,0.0
36677,3,6677,[318 427 185 515 313],655,5,27332,4.092842168313866,40.0,0.0
36678,3,6678,[403 328  70 273  98],450,4,27336,4.092828267704746,0.0,0.0
36679,3,6679,[318 427 185 515 313],655,5,27341,4.092964071856287,40.0,0.0
36680,3,6680,[  9  56 111  11 257],296,4,27345,4.092950157162101,0.0,0.0
36681,3,6681,[235 186 194  64 405],716,3,27348,4.092786590841065,20.0,0.0
36682,3,6682,[ 71 515 215 196  95],18,3,27351,4.092623073469999,0.0,0.0
36683,3,6683,[127 423  96 318  88],796,5,27356,4.09275882704967,20.0,20.0
36684,3,6684,[179 176 289  69 210],655,1,27357,4.092296185489903,0.0,0.0
36685,3,6685,[496  70 471  25 153],450,4,27361,4.092282381094825,20.0,0.0
36686,3,6686,[318 427 185 515 313],655,5,27366,4.092418124719606,40.0,0.0
36687,3,6687,[318 427 185 515 313],655,5,27371,4.092553827751196,40.0,0.0
36688,3,6688,[200 275 597  12 322],450,4,27375,4.0925399910300495,0.0,20.0
36689,3,6689,[ 69 202 143 153  50],504,2,27377,4.092227204783258,0.0,20.0
36690,3,6690,[100 153 168 603 234],269,3,27380,4.092063966522194,20.0,20.0
36691,3,6691,[197   1 118 568 282],457,5,27385,4.092199641362821,0.0,0.0
36692,3,6692,[168 197 127 182 181],457,5,27390,4.092335275661139,0.0,20.0
36693,3,6693,[318 427 185 515 313],655,5,27395,4.092470869435315,40.0,0.0
36694,3,6694,[196 385 222 269 187],796,4,27399,4.092457057505602,0.0,0.0
36695,3,6695,[318 427 185 515 313],655,5,27404,4.092592592592593,40.0,0.0
36696,3,6696,[496 204   1  97 183],577,5,27409,4.092728087203225,20.0,0.0
36697,3,6697,[318 427 185 515 313],655,5,27414,4.092863541355628,40.0,0.0
36698,3,6698,[125 385 174 216  96],796,5,27419,4.09299895506792,0.0,0.0
36699,3,6699,[  4  98  95   1 322],796,3,27422,4.092835820895522,0.0,0.0
36700,3,6700,[318 427 185 515 313],655,5,27427,4.092971198328607,40.0,0.0
36701,3,6701,[318 427 185 515 313],655,5,27432,4.093106535362578,40.0,0.0
36702,3,6702,[215 273   7 187 216],655,3,27435,4.092943458153066,0.0,0.0
36703,3,6703,[111 144  56 597   8],457,3,27438,4.0927804295942725,0.0,0.0
36704,3,6704,[161 471 204 403 121],457,5,27443,4.092915734526473,0.0,0.0
36705,3,6705,[318 427 185 515 313],655,5,27448,4.093050999105279,40.0,0.0
36706,3,6706,[173 204 172   1 216],450,5,27453,4.09318622334874,0.0,0.0
36707,3,6707,[ 15 273 237  96 385],796,4,27457,4.093172331544425,0.0,0.0
36708,3,6708,[196 216 228 546 135],693,2,27459,4.092860336860933,0.0,0.0
36709,3,6709,[197   7 185 132  28],655,1,27460,4.092399403874814,0.0,0.0
36710,3,6710,[318 427 185 515 313],655,5,27465,4.0925346446133215,40.0,0.0
36711,3,6711,[202  71 275 216 195],450,4,27469,4.092520858164481,0.0,20.0
36712,3,6712,[318 427 185 515 313],655,5,27474,4.092656040518397,40.0,0.0
36713,3,6713,[318 427 185 515 313],655,5,27479,4.092791182603515,40.0,0.0
36714,3,6714,[546 143 273 210 195],796,3,27482,4.092628443782576,0.0,0.0
36715,3,6715,[318 427 185 515 313],655,5,27487,4.092763549731983,40.0,0.0
36716,3,6716,[318 427 185 515 313],655,5,27492,4.092898615453327,40.0,0.0
36717,3,6717,[318 427 185 515 313],655,5,27497,4.093033640964573,40.0,0.0
36718,3,6718,[318 427 185 515 313],655,5,27502,4.093168626283673,40.0,0.0
36719,3,6719,[117 200 286  28 174],655,1,27503,4.092708333333333,0.0,20.0
36720,3,6720,[318 427 185 515 313],655,5,27508,4.09284332688588,40.0,0.0
36721,3,6721,[318 427 185 515 313],655,5,27513,4.092978280273728,40.0,0.0
36722,3,6722,[ 82 222  64 742 597],450,3,27516,4.092815707273538,20.0,0.0
36723,3,6723,[318 427 185 515 313],655,5,27521,4.092950624628197,40.0,0.0
36724,3,6724,[265 210   4  11 423],280,3,27524,4.09278810408922,0.0,0.0
36725,3,6725,[318 427 185 515 313],655,5,27529,4.092922985429676,40.0,0.0
36726,3,6726,[ 71 603 191 286  69],450,4,27533,4.092909171993459,20.0,20.0
36727,3,6727,[168 132 282 238 678],504,4,27537,4.092895362663496,0.0,0.0
36728,3,6728,[186 100 471 228 403],450,4,27541,4.092881557437955,0.0,20.0
36729,3,6729,[318 427 185 515 313],655,5,27546,4.093016344725111,40.0,0.0
36730,3,6730,[318 427 185 515 313],655,5,27551,4.093151091962561,40.0,0.0
36731,3,6731,[357 202 143 405 117],401,3,27554,4.09298871063577,0.0,0.0
36732,3,6732,[181  98 174 268 210],655,1,27555,4.092529333135304,0.0,0.0
36733,3,6733,[ 56 200 183 603 202],796,5,27560,4.0926640926640925,20.0,0.0
36734,3,6734,[318 427 185 515 313],655,5,27565,4.092798812175205,40.0,0.0
36735,3,6735,[135 174 286   4 100],18,3,27568,4.092636579572447,0.0,40.0
36736,3,6736,[318 427 185 515 313],655,5,27573,4.092771263173519,40.0,0.0
36737,3,6737,[318 427 185 515 313],655,5,27578,4.092905906797269,40.0,0.0
36738,3,6738,[318 427 185 515 313],655,5,27583,4.093040510461493,40.0,0.0
36739,3,6739,[318 427 185 515 313],655,5,27588,4.093175074183976,40.0,0.0
36740,3,6740,[318 427 185 515 313],655,5,27593,4.093309597982495,40.0,0.0
36741,3,6741,[118  95  98 215  71],344,2,27595,4.092999110056363,0.0,0.0
36742,3,6742,[153 265 194 176  22],450,5,27600,4.0931336200504225,0.0,0.0
36743,3,6743,[222 117 257 238 294],716,5,27605,4.093268090154211,0.0,0.0
36744,3,6744,[357  25 187 181 546],504,3,27608,4.093106004447739,0.0,0.0
36745,3,6745,[333 423 357   8 211],655,1,27609,4.09264749481174,0.0,0.0
36746,3,6746,[211 197 196  56 179],535,4,27613,4.092633763153994,0.0,0.0
36747,3,6747,[318 427 185 515 313],655,5,27618,4.092768227622999,40.0,0.0
36748,3,6748,[ 97 111 742 216 132],450,5,27623,4.092902652244777,0.0,0.0
36749,3,6749,[318 427 185 515 313],655,5,27628,4.093037037037037,40.0,0.0
36750,3,6750,[282 265 257 300 588],716,4,27632,4.093023255813954,0.0,0.0
36751,3,6751,[211 127 302 135 276],401,2,27634,4.0927132701421804,0.0,20.0
36752,3,6752,[597 546  82 118 153],796,4,27638,4.092699540944765,0.0,0.0
36753,3,6753,[121 127 435  89 655],450,4,27642,4.092685815812851,0.0,20.0
36754,3,6754,[318 427 185 515 313],655,5,27647,4.092820133234641,40.0,0.0
36755,3,6755,[143  50   9 117 135],756,3,27650,4.0926583777383065,0.0,20.0
36756,3,6756,[196 237 427  15 546],577,3,27653,4.092496670119876,20.0,0.0
36757,3,6757,[318 427 185 515 313],655,5,27658,4.092630955904114,40.0,0.0
36758,3,6758,[185 100 294 187   9],256,3,27661,4.092469300192336,0.0,20.0
36759,3,6759,[ 28 238 195 273   9],796,1,27662,4.092011834319527,0.0,0.0
36760,3,6760,[322 125 235 546 127],256,4,27666,4.091998225114628,0.0,20.0
36761,3,6761,[318 427 185 515 313],655,5,27671,4.092132505175983,40.0,0.0
36762,3,6762,[318 427 185 515 313],655,5,27676,4.092266745527133,40.0,0.0
36763,3,6763,[172 496 215 300 204],151,4,27680,4.092253104671792,20.0,0.0
36764,3,6764,[318 427 185 515 313],655,5,27685,4.092387287509239,40.0,0.0
36765,3,6765,[318 427 185 515 313],655,5,27690,4.092521430682826,40.0,0.0
36766,3,6766,[318 427 185 515 313],655,5,27695,4.092655534210137,40.0,0.0
36767,3,6767,[  4 288 268  82   9],655,0,27695,4.092050827423168,0.0,0.0
36768,3,6768,[471  98 475 100 174],389,5,27700,4.092184960850938,0.0,20.0
36769,3,6769,[174 215  50 269 216],942,4,27704,4.092171344165436,0.0,20.0
36770,3,6770,[318 427 185 515 313],655,5,27709,4.092305420174273,40.0,0.0
36771,3,6771,[275 222 286 187 174],450,4,27713,4.0922917897223865,0.0,40.0
36772,3,6772,[197 176 144 282 195],796,4,27717,4.092278163295438,0.0,0.0
36773,3,6773,[ 22 748  64  56 121],796,5,27722,4.092412164157071,20.0,0.0
36774,3,6774,[ 12 269 174  70  96],655,0,27722,4.091808118081181,0.0,0.0
36775,3,6775,[216 222 135 568 181],716,4,27726,4.0917945690672965,0.0,0.0
36776,3,6776,[265 187  22 191  56],450,5,27731,4.091928581968423,0.0,0.0
36777,3,6777,[318 427 185 515 313],655,5,27736,4.092062555326055,40.0,0.0
36778,3,6778,[318 427 185 515 313],655,5,27741,4.0921964891576925,40.0,0.0
36779,3,6779,[318 427 185 515 313],655,5,27746,4.092330383480826,40.0,0.0
36780,3,6780,[318 427 185 515 313],655,5,27751,4.0924642383129335,40.0,0.0
36781,3,6781,[318 427 185 515 313],655,5,27756,4.092598053671483,40.0,0.0
36782,3,6782,[483 151 496 546 143],151,4,27760,4.0925844021819255,20.0,0.0
36783,3,6783,[427  56 211 403 204],796,4,27764,4.092570754716981,20.0,0.0
36784,3,6784,[318 427 185 515 313],655,5,27769,4.092704495210022,40.0,0.0
36785,3,6785,[210  50 174 288 568],20,3,27772,4.0925434718538165,0.0,20.0
36786,3,6786,[318 427 185 515 313],655,5,27777,4.092677176955945,40.0,0.0
36787,3,6787,[328 300 202  98 742],796,4,27781,4.092663523865645,0.0,0.0
36788,3,6788,[294 176 143 286  15],236,3,27784,4.09250257769922,0.0,20.0
36789,3,6789,[187  97  56 202 322],796,3,27787,4.092341678939617,0.0,0.0
36790,3,6790,[405 183 180 234 294],716,3,27790,4.092180827565896,0.0,0.0
36791,3,6791,[655  70 405  89 238],786,5,27795,4.092314487632509,0.0,0.0
36792,3,6792,[427 179 742 546  70],450,5,27800,4.092448108346828,20.0,0.0
36793,3,6793,[282 222 210 180 655],716,3,27803,4.092287312334412,0.0,0.0
36794,3,6794,[318 427 185 515 313],655,5,27808,4.092420897718911,40.0,0.0
36795,3,6795,[318 427 185 515 313],655,5,27813,4.092554443790465,40.0,0.0
36796,3,6796,[100 273 111 300 423],796,3,27816,4.092393703104311,0.0,20.0
36797,3,6797,[318 427 185 515 313],655,5,27821,4.092527213886437,40.0,0.0
36798,3,6798,[318 427 185 515 313],655,5,27826,4.092660685394911,40.0,0.0
36799,3,6799,[318 427 185 515 313],655,5,27831,4.092794117647059,40.0,0.0
36800,3,6800,[216 328 282 185  79],796,5,27836,4.092927510660197,0.0,0.0
36801,3,6801,[318 427 185 515 313],655,5,27841,4.0930608644516315,40.0,0.0
36802,3,6802,[143 180 301 357 125],450,5,27846,4.093194179038659,0.0,0.0
36803,3,6803,[318 427 185 515 313],655,5,27851,4.093327454438565,40.0,0.0
36804,3,6804,[483 210 121 174 258],807,4,27855,4.093313739897135,0.0,0.0
36805,3,6805,[546  11 318 202 216],577,3,27858,4.093153100205701,20.0,0.0
36806,3,6806,[ 79 269  71 127 405],796,4,27862,4.093139415307771,0.0,20.0
36807,3,6807,[318 427 185 515 313],655,5,27867,4.093272620446533,40.0,0.0
36808,3,6808,[318 427 185 515 313],655,5,27872,4.0934057864590985,40.0,0.0
36809,3,6809,[196   4  79  50  97],796,4,27876,4.093392070484581,0.0,20.0
36810,3,6810,[318 427 185 515 313],655,5,27881,4.093525179856115,40.0,0.0
36811,3,6811,[  1 222 172  82 258],457,5,27886,4.0936582501468,0.0,0.0
36812,3,6812,[318 427 185 515 313],655,5,27891,4.093791281373844,40.0,0.0
36813,3,6813,[318 427 185 515 313],655,5,27896,4.093924273554447,40.0,0.0
36814,3,6814,[318 427 185 515 313],655,5,27901,4.094057226705796,40.0,0.0
36815,3,6815,[300 357 471 228 286],655,1,27902,4.093603286384977,0.0,20.0
36816,3,6816,[200 276 237 405  96],457,5,27907,4.0937362476162535,0.0,0.0
36817,3,6817,[ 82   9 100 118 195],72,3,27910,4.093575828688765,0.0,20.0
36818,3,6818,[228 423  97   8 151],457,5,27915,4.0937087549494064,0.0,0.0
36819,3,6819,[318 427 185 515 313],655,5,27920,4.093841642228739,40.0,0.0
36820,3,6820,[228 125 168 135 181],450,4,27924,4.093827884474417,0.0,0.0
36821,3,6821,[423 258 118 181 185],450,4,27928,4.093814130753445,0.0,0.0
36822,3,6822,[318 427 185 515 313],655,5,27933,4.093946944159461,40.0,0.0
36823,3,6823,[313  98   4 111 176],655,2,27935,4.093640093786635,0.0,0.0
36824,3,6824,[215  28 174 204  70],639,2,27937,4.093333333333334,0.0,0.0
36825,3,6825,[153 187 180 210 357],269,2,27939,4.093026662760035,0.0,0.0
36826,3,6826,[318 427 185 515 313],655,5,27944,4.09315951369562,40.0,0.0
36827,3,6827,[ 97  28 568 748  98],450,5,27949,4.093292325717633,0.0,0.0
36828,3,6828,[318 427 185 515 313],655,5,27954,4.093425098843169,40.0,0.0
36829,3,6829,[125 182 237  22 423],18,3,27957,4.093265007320644,0.0,0.0
36830,3,6830,[245 405  50 286 117],796,3,27960,4.09310496267018,0.0,40.0
36831,3,6831,[132 202 496 427 176],577,5,27965,4.093237704918033,40.0,0.0
36832,3,6832,[258 385 286  89 182],796,4,27969,4.09322405971023,0.0,20.0
36833,3,6833,[318 427 185 515 313],655,5,27974,4.093356745683348,40.0,0.0
36834,3,6834,[318 427 185 515 313],655,5,27979,4.0934893928310165,40.0,0.0
36835,3,6835,[ 56  95 546 282   8],796,5,27984,4.093622001170275,0.0,0.0
36836,3,6836,[318 427 185 515 313],655,5,27989,4.0937545707181515,40.0,0.0
36837,3,6837,[318 427 185 515 313],655,5,27994,4.0938871014916645,40.0,0.0
36838,3,6838,[ 82  69  50 423 181],796,4,27998,4.09387337330019,0.0,20.0
36839,3,6839,[318  50 172 185 174],716,5,28003,4.094005847953216,20.0,20.0
36840,3,6840,[294 222 180 210 588],450,3,28006,4.093845928957755,0.0,0.0
36841,3,6841,[318 427 185 515 313],655,5,28011,4.093978368897983,40.0,0.0
36842,3,6842,[318 427 185 515 313],655,5,28016,4.09411077013006,40.0,0.0
36843,3,6843,[318 427 185 515 313],655,5,28021,4.094243132670953,40.0,0.0
36844,3,6844,[194 153 568 196 176],716,4,28025,4.094229364499634,0.0,0.0
36845,3,6845,[  1  50 323 597 546],796,3,28028,4.0940695296523515,0.0,20.0
36846,3,6846,[318 427 185 515 313],655,5,28033,4.094201840221995,40.0,0.0
36847,3,6847,[318 427 185 515 313],655,5,28038,4.094334112149533,40.0,0.0
36848,3,6848,[357 117 179 144  25],593,4,28042,4.0943203387355815,0.0,0.0
36849,3,6849,[175 210 216 151 237],457,5,28047,4.094452554744525,0.0,0.0
36850,3,6850,[318 427 185 515 313],655,5,28052,4.09458473215589,40.0,0.0
36851,3,6851,[  4  69 257 496  82],796,4,28056,4.0945709281961475,20.0,0.0
36852,3,6852,[318 427 185 515 313],655,5,28061,4.09470304975923,40.0,0.0
36853,3,6853,[318 427 185 515 313],655,5,28066,4.094835132769186,40.0,0.0
36854,3,6854,[176  70 180 181 117],786,5,28071,4.094967177242888,0.0,0.0
36855,3,6855,[204 234 483 385 286],280,3,28074,4.094807467911319,0.0,20.0
36856,3,6856,[318 427 185 515 313],655,5,28079,4.09493947790579,40.0,0.0
36857,3,6857,[258 275   4 483 210],450,2,28081,4.094634004082823,0.0,20.0
36858,3,6858,[318 427 185 515 313],655,5,28086,4.094766000874763,40.0,0.0
36859,3,6859,[318 427 185 515 313],655,5,28091,4.094897959183673,40.0,0.0
36860,3,6860,[204  15  71 181 597],593,4,28095,4.094884127678181,0.0,0.0
36861,3,6861,[318 427 185 515 313],655,5,28100,4.095016030311863,40.0,0.0
36862,3,6862,[179 211 180 153 276],504,2,28102,4.094710767885764,0.0,0.0
36863,3,6863,[ 82 200 215 294  12],577,4,28106,4.09469696969697,0.0,0.0
36864,3,6864,[318 427 185 515 313],655,5,28111,4.09482884195193,40.0,0.0
36865,3,6865,[183 174  82   4 276],504,3,28114,4.094669385377221,0.0,0.0
36866,3,6866,[318 427 185 515 313],655,5,28119,4.09480122324159,40.0,0.0
36867,3,6867,[153   7 427 357 181],535,4,28123,4.094787419918463,20.0,0.0
36868,3,6868,[597  82 195 215   1],450,4,28127,4.094773620614355,0.0,0.0
36869,3,6869,[181 216 182 300 328],655,2,28129,4.094468704512373,0.0,0.0
36870,3,6870,[318 427 185 515 313],655,5,28134,4.094600494833357,40.0,0.0
36871,3,6871,[ 64  70  69   7 742],457,5,28139,4.094732246798603,20.0,0.0
36872,3,6872,[318 427 185 515 313],655,5,28144,4.094863960424851,40.0,0.0
36873,3,6873,[318 427 185 515 313],655,5,28149,4.094995635728833,40.0,0.0
36874,3,6874,[471 173 117 597 286],450,5,28154,4.0951272727272725,0.0,20.0
36875,3,6875,[172 237 125  64 216],450,5,28159,4.095258871436882,20.0,0.0
36876,3,6876,[318 427 185 515 313],655,5,28164,4.095390431874364,40.0,0.0
36877,3,6877,[318 427 185 515 313],655,5,28169,4.095521954056411,40.0,0.0
36878,3,6878,[385  69 175  82 174],716,3,28172,4.095362698066579,0.0,0.0
36879,3,6879,[269 385 289 302 172],655,2,28174,4.095058139534884,0.0,0.0
36880,3,6880,[318 427 185 515 313],655,5,28179,4.095189652666764,40.0,0.0
36881,3,6881,[742 273 172  69  70],450,4,28183,4.095175820982273,0.0,0.0
36882,3,6882,[318 427 185 515 313],655,5,28188,4.0953072788028475,40.0,0.0
36883,3,6883,[204 191 195 151 182],796,5,28193,4.095438698431145,0.0,0.0
36884,3,6884,[282 173 237 215 234],450,4,28197,4.095424836601307,0.0,0.0
36885,3,6885,[135 153 568 181 403],655,1,28198,4.094975312227708,0.0,0.0
36886,3,6886,[  4 111  95 179 276],786,4,28202,4.094961521707565,0.0,0.0
36887,3,6887,[322  69 174 357  56],629,4,28206,4.094947735191638,0.0,0.0
36888,3,6888,[318 427 185 515 313],655,5,28211,4.095079111627232,40.0,0.0
36889,3,6889,[318 427 185 515 313],655,5,28216,4.095210449927431,40.0,0.0
36890,3,6890,[546 405 180  79 210],280,3,28219,4.095051516470759,0.0,0.0
36891,3,6891,[318 427 185 515 313],655,5,28224,4.095182820661637,40.0,0.0
36892,3,6892,[181 204 168 546 313],503,4,28228,4.095169012041201,0.0,0.0
36893,3,6893,[318 427 185 515 313],655,5,28233,4.095300261096606,40.0,0.0
36894,3,6894,[ 25 288  88  28 265],450,3,28236,4.095141406816534,0.0,0.0
36895,3,6895,[172 176 257 294 204],902,2,28238,4.09483758700696,0.0,0.0
36896,3,6896,[318 427 185 515 313],655,5,28243,4.094968827026244,40.0,0.0
36897,3,6897,[318 427 185 515 313],655,5,28248,4.095100028993912,40.0,0.0
36898,3,6898,[318 427 185 515 313],655,5,28253,4.095231192926511,40.0,0.0
36899,3,6899,[215  88 222  50  98],151,4,28257,4.095217391304348,0.0,20.0
36900,3,6900,[318 427 185 515 313],655,5,28262,4.0953485002173595,40.0,0.0
36901,3,6901,[301 179   4 257 100],389,4,28266,4.095334685598377,0.0,20.0
36902,3,6902,[318 427 185 515 313],655,5,28271,4.0954657395335365,40.0,0.0
36903,3,6903,[238 302 174   8 161],655,1,28272,4.095017381228273,0.0,0.0
36904,3,6904,[318 427 185 515 313],655,5,28277,4.095148443157132,40.0,0.0
36905,3,6905,[318 427 185 515 313],655,5,28282,4.095279467130032,40.0,0.0
36906,3,6906,[318 427 185 515 313],655,5,28287,4.095410453163457,40.0,0.0
36907,3,6907,[318 427 185 515 313],655,5,28292,4.095541401273885,40.0,0.0
36908,3,6908,[197 172 546 168 275],457,4,28296,4.09552757273122,0.0,20.0
36909,3,6909,[ 70 197 175 288 202],655,0,28296,4.0949348769898695,0.0,0.0
36910,3,6910,[318 427 185 515 313],655,5,28301,4.095065837071336,40.0,0.0
36911,3,6911,[318 427 185 515 313],655,5,28306,4.0951967592592595,40.0,0.0
36912,3,6912,[318 427 185 515 313],655,5,28311,4.095327643570085,40.0,0.0
36913,3,6913,[318 427 185 515 313],655,5,28316,4.095458490020249,40.0,0.0
36914,3,6914,[318 427 185 515 313],655,5,28321,4.095589298626175,40.0,0.0
36915,3,6915,[318 427 185 515 313],655,5,28326,4.09572006940428,40.0,0.0
36916,3,6916,[  1  82 161 176 471],786,5,28331,4.09585080237097,0.0,0.0
36917,3,6917,[318 427 185 515 313],655,5,28336,4.095981497542643,40.0,0.0
36918,3,6918,[318 427 185 515 313],655,5,28341,4.0961121549356845,40.0,0.0
36919,3,6919,[318 427 185 515 313],655,5,28346,4.096242774566474,40.0,0.0
36920,3,6920,[ 96 258 423 435 161],756,1,28347,4.0957954052882535,0.0,0.0
36921,3,6921,[210 405 385 588 197],786,4,28351,4.095781566021381,0.0,0.0
36922,3,6922,[234  95 323 655 588],796,2,28353,4.095478838653762,0.0,0.0
36923,3,6923,[301 176 197 182 742],655,1,28354,4.095031773541305,0.0,0.0
36924,3,6924,[318 180  95 496  22],716,4,28358,4.095018050541516,40.0,0.0
36925,3,6925,[ 95 286 161 197 181],330,5,28363,4.095148714987006,0.0,20.0
36926,3,6926,[318 427 185 515 313],655,5,28368,4.095279341706366,40.0,0.0
36927,3,6927,[132 175  70 210  11],655,0,28368,4.094688221709007,0.0,0.0
36928,3,6928,[318 427 185 515 313],655,5,28373,4.094818877182854,40.0,0.0
36929,3,6929,[ 69 234 403 302 173],450,4,28377,4.094805194805195,0.0,0.0
36930,3,6930,[ 89  95 153 125  64],18,3,28380,4.094647237050931,20.0,0.0
36931,3,6931,[ 25 228 471 185 174],693,3,28383,4.0944893248701675,0.0,0.0
36932,3,6932,[  1 238 282 168 235],716,3,28386,4.094331458243185,0.0,0.0
36933,3,6933,[318 427 185 515 313],655,5,28391,4.094462070954716,40.0,0.0
36934,3,6934,[135 748  96   7  82],280,3,28394,4.094304253785148,0.0,0.0
36935,3,6935,[318 427 185 515 313],655,5,28399,4.094434832756632,40.0,0.0
36936,3,6936,[222 301 276 318 275],655,3,28402,4.094277065013695,20.0,20.0
36937,3,6937,[ 56  98  96 135 655],280,4,28406,4.094263476506198,0.0,0.0
36938,3,6938,[282 496 483 125 180],450,4,28410,4.094249891915261,20.0,0.0
36939,3,6939,[273 515 357  97 269],655,3,28413,4.0940922190201725,0.0,0.0
36940,3,6940,[318 427 185 515 313],655,5,28418,4.0942227344763005,40.0,0.0
36941,3,6941,[313 294  88 194 181],577,4,28422,4.094209161624892,0.0,0.0
36942,3,6942,[216 135 282  88 127],457,5,28427,4.09433962264151,0.0,20.0
36943,3,6943,[318 427 185 515 313],655,5,28432,4.094470046082949,40.0,0.0
36944,3,6944,[318 427 185 515 313],655,5,28437,4.094600431965443,40.0,0.0
36945,3,6945,[ 28 200 385  71  70],450,3,28440,4.0944428448027645,0.0,0.0
36946,3,6946,[318 427 185 515 313],655,5,28445,4.094573197063481,40.0,0.0
36947,3,6947,[288 265  22 174 228],280,3,28448,4.0944156591824985,0.0,0.0
36948,3,6948,[318 427 185 515 313],655,5,28453,4.094545977838538,40.0,0.0
36949,3,6949,[318 427 185 515 313],655,5,28458,4.094676258992806,40.0,0.0
36950,3,6950,[318 427 185 515 313],655,5,28463,4.094806502661488,40.0,0.0
36951,3,6951,[546 187 313  11  98],450,5,28468,4.094936708860759,0.0,0.0
36952,3,6952,[258  89 211  22  69],796,4,28472,4.0949230547964905,0.0,0.0
36953,3,6953,[318 427 185 515 313],655,5,28477,4.09505320678746,40.0,0.0
36954,3,6954,[186 471 174  88 357],693,2,28479,4.094751976994968,0.0,0.0
36955,3,6955,[172 204 286 222 121],450,3,28482,4.094594594594595,0.0,20.0
36956,3,6956,[508  96  98 135 117],693,4,28486,4.094580997556418,0.0,0.0
36957,3,6957,[357 258 151   9 161],504,5,28491,4.094711123886174,0.0,0.0
36958,3,6958,[302 288 238 118 125],450,3,28494,4.094553815203334,0.0,0.0
36959,3,6959,[276   7 172 200 222],655,3,28497,4.094396551724138,0.0,0.0
36960,3,6960,[ 98 196 173  56 385],151,4,28501,4.094382990949576,0.0,0.0
36961,3,6961,[318 427 185 515 313],655,5,28506,4.094513070956622,40.0,0.0
36962,3,6962,[ 98   7 216  97 195],256,5,28511,4.094643113600459,0.0,0.0
36963,3,6963,[181 211 200 127  69],716,5,28516,4.094773118897185,0.0,20.0
36964,3,6964,[318 427 185 515 313],655,5,28521,4.094903086862886,40.0,0.0
36965,3,6965,[318 427 185 515 313],655,5,28526,4.095033017513638,40.0,0.0
36966,3,6966,[  1 195 111 234 603],655,1,28527,4.094588775656667,20.0,0.0
36967,3,6967,[187 742 273 300 238],450,4,28531,4.094575200918484,0.0,0.0
36968,3,6968,[318 427 185 515 313],655,5,28536,4.0947051226861815,40.0,0.0
36969,3,6969,[132 168 257 117 180],716,4,28540,4.094691535150646,0.0,0.0
36970,3,6970,[175 180 228 111 357],11,2,28542,4.0943910486300386,0.0,0.0
36971,3,6971,[300  82 222 191 427],450,3,28545,4.094234079173838,20.0,0.0
36972,3,6972,[ 79 302  25   1 127],344,4,28549,4.0942205650365695,0.0,20.0
36973,3,6973,[318 427 185 515 313],655,5,28554,4.094350444508173,40.0,0.0
36974,3,6974,[515 234 121 546 127],716,4,28558,4.094336917562724,0.0,20.0
36975,3,6975,[172   4 186 655 258],535,3,28561,4.09418004587156,0.0,0.0
36976,3,6976,[173 161 132 483 301],450,4,28565,4.094166547226601,0.0,0.0
36977,3,6977,[ 56   7  11 200 475],269,3,28568,4.094009744912582,0.0,0.0
36978,3,6978,[328  11 204 181  96],655,0,28568,4.093423126522424,0.0,0.0
36979,3,6979,[288 357 294 195  22],457,4,28572,4.093409742120344,0.0,0.0
36980,3,6980,[318 427 185 515 313],655,5,28577,4.093539607506088,40.0,0.0
36981,3,6981,[318 427 185 515 313],655,5,28582,4.093669435691779,40.0,0.0
36982,3,6982,[318 427 185 515 313],655,5,28587,4.093799226693398,40.0,0.0
36983,3,6983,[318 427 185 515 313],655,5,28592,4.093928980526918,40.0,0.0
36984,3,6984,[144 237 423 300 435],716,4,28596,4.093915533285612,0.0,0.0
36985,3,6985,[318 427 185 515 313],655,5,28601,4.09404523332379,40.0,0.0
36986,3,6986,[168 125  28 202  50],151,5,28606,4.094174896235867,0.0,20.0
36987,3,6987,[ 88 174  96 181 151],716,4,28610,4.094161419576417,0.0,0.0
36988,3,6988,[194  15 294 568 183],796,4,28614,4.094147946773501,0.0,0.0
36989,3,6989,[  7  70 186 546 118],151,3,28617,4.093991416309013,0.0,0.0
36990,3,6990,[318 427 185 515 313],655,5,28622,4.094121012730653,40.0,0.0
36991,3,6991,[286 289  98 237  64],236,5,28627,4.09425057208238,20.0,20.0
36992,3,6992,[318 427 185 515 313],655,5,28632,4.094380094380094,40.0,0.0
36993,3,6993,[318 427 185 515 313],655,5,28637,4.094509579639691,40.0,0.0
36994,3,6994,[423 200 568  98 357],457,5,28642,4.094639027877055,0.0,0.0
36995,3,6995,[173 111 182  15  88],450,4,28646,4.094625500285877,0.0,0.0
36996,3,6996,[318 427 185 515 313],655,5,28651,4.09475489495498,40.0,0.0
36997,3,6997,[318 427 185 515 313],655,5,28656,4.094884252643612,40.0,0.0
36998,3,6998,[258 568 210 100 423],655,0,28656,4.094299185597943,0.0,20.0
36999,3,6999,[318 427 185 515 313],655,5,28661,4.094428571428572,40.0,0.0
37000,3,7000,[172 144 748   9 194],401,2,28663,4.094129410084274,0.0,0.0
37001,3,7001,[496 301 144 269 515],535,3,28666,4.09397315052842,20.0,0.0
37002,3,7002,[318 427 185 515 313],655,5,28671,4.09410252748822,40.0,0.0
37003,3,7003,[318 427 185 515 313],655,5,28676,4.094231867504283,40.0,0.0
37004,3,7004,[ 79 186  88 181 143],693,2,28678,4.093932905067809,0.0,0.0
37005,3,7005,[318 427 185 515 313],655,5,28683,4.094062232372252,40.0,0.0
37006,3,7006,[318 427 185 515 313],655,5,28688,4.0941915227629515,40.0,0.0
37007,3,7007,[196 202  50  82 403],269,0,28688,4.093607305936073,0.0,20.0
37008,3,7008,[318 427 185 515 313],655,5,28693,4.093736624340134,40.0,0.0
37009,3,7009,[318 427 185 515 313],655,5,28698,4.093865905848787,40.0,0.0
37010,3,7010,[318 427 185 515 313],655,5,28703,4.093995150477821,40.0,0.0
37011,3,7011,[234  95 117 100 257],796,3,28706,4.093839132915003,0.0,20.0
37012,3,7012,[318 427 185 515 313],655,5,28711,4.0939683445030655,40.0,0.0
37013,3,7013,[ 11 475  89 180 508],269,2,28713,4.093669803250641,0.0,0.0
37014,3,7014,[357 210 471 216  56],450,4,28717,4.093656450463293,0.0,0.0
37015,3,7015,[318 427 185 515 313],655,5,28722,4.093785632839225,40.0,0.0
37016,3,7016,[258 588 176 288 265],457,5,28727,4.093914778395326,0.0,0.0
37017,3,7017,[268 180  70 100 215],11,3,28730,4.093758905671131,0.0,20.0
37018,3,7018,[197 237  88  95  28],716,5,28735,4.093888018236216,0.0,0.0
37019,3,7019,[172  15   4 238 197],151,5,28740,4.094017094017094,0.0,0.0
37020,3,7020,[191 271 328 483 286],655,2,28742,4.093718843469591,0.0,20.0
37021,3,7021,[100 127 151 187 288],256,4,28746,4.093705497009399,0.0,40.0
37022,3,7022,[318 427 185 515 313],655,5,28751,4.093834543642318,40.0,0.0
37023,3,7023,[153 427  95 172 132],23,5,28756,4.0939635535307515,20.0,0.0
37024,3,7024,[186 300  96 228 195],655,0,28756,4.09338078291815,0.0,0.0
37025,3,7025,[179 288 483 597 265],457,4,28760,4.093367492171933,0.0,0.0
37026,3,7026,[211 265 405  25 185],716,5,28765,4.0934965134481285,0.0,0.0
37027,3,7027,[313  79 191 496 597],796,5,28770,4.0936254980079685,20.0,0.0
37028,3,7028,[748 435 245 588   1],450,5,28775,4.093754445867122,0.0,0.0
37029,3,7029,[172 238 300  50 211],716,5,28780,4.093883357041252,0.0,20.0
37030,3,7030,[318 427 185 515 313],655,5,28785,4.09401223154601,40.0,0.0
37031,3,7031,[318 427 185 515 313],655,5,28790,4.094141069397042,40.0,0.0
37032,3,7032,[180 234 237  71 655],796,2,28792,4.0938433101094835,0.0,0.0
37033,3,7033,[318 427 185 515 313],655,5,28797,4.0939721353426215,40.0,0.0
37034,3,7034,[318 427 185 515 313],655,5,28802,4.09410092395167,40.0,0.0
37035,3,7035,[182   8 185 318 237],535,4,28806,4.094087549744173,20.0,0.0
37036,3,7036,[597 179 172 121  69],269,1,28807,4.093647861304533,0.0,0.0
37037,3,7037,[210 182 100 161 172],280,1,28808,4.093208297811878,0.0,20.0
37038,3,7038,[318 427 185 515 313],655,5,28813,4.093337121750249,40.0,0.0
37039,3,7039,[ 11 172 515 132 196],535,3,28816,4.093181818181818,0.0,0.0
37040,3,7040,[  7 294 143 568   8],457,4,28820,4.0931685840079535,0.0,0.0
37041,3,7041,[234 181 294 313  15],577,3,28823,4.093013348480545,0.0,0.0
37042,3,7042,[318 427 185 515 313],655,5,28828,4.093142126934545,40.0,0.0
37043,3,7043,[211 132 121 385 288],450,3,28831,4.0929869392390685,0.0,0.0
37044,3,7044,[423 168 211 234 215],504,4,28835,4.092973740241306,0.0,0.0
37045,3,7045,[288 286  96 125 568],450,4,28839,4.092960544990065,0.0,20.0
37046,3,7046,[318 427 185 515 313],655,5,28844,4.093089257840216,40.0,0.0
37047,3,7047,[268  56 181 257 204],296,5,28849,4.093217934165721,0.0,0.0
37048,3,7048,[318 427 185 515 313],655,5,28854,4.093346573982125,40.0,0.0
37049,3,7049,[144  88 300 603 204],655,1,28855,4.0929078014184395,20.0,0.0
37050,3,7050,[125 483 265 117 176],457,5,28860,4.093036448730676,0.0,0.0
37051,3,7051,[186 118 748 265 234],450,2,28862,4.092739648326716,0.0,0.0
37052,3,7052,[194 173 496 385 168],450,5,28867,4.092868283000142,20.0,0.0
37053,3,7053,[318 427 185 515 313],655,5,28872,4.092996881202155,40.0,0.0
37054,3,7054,[588 132 275 161 181],330,5,28877,4.0931254429482635,0.0,20.0
37055,3,7055,[132  15 288 423  25],450,2,28879,4.092828798185941,0.0,0.0
37056,3,7056,[318 427 185 515 313],655,5,28884,4.092957347314723,40.0,0.0
37057,3,7057,[318 427 185 515 313],655,5,28889,4.093085860017002,40.0,0.0
37058,3,7058,[318 427 185 515 313],655,5,28894,4.093214336308259,40.0,0.0
37059,3,7059,[215 313 183 132 186],835,5,28899,4.093342776203966,0.0,0.0
37060,3,7060,[427  56  96 216 268],655,2,28901,4.093046310720861,20.0,0.0
37061,3,7061,[ 56 118 276 323  11],280,3,28904,4.092891532143868,0.0,0.0
37062,3,7062,[318 427 185 515 313],655,5,28909,4.093019963188447,40.0,0.0
37063,3,7063,[318 427 185 515 313],655,5,28914,4.093148357870895,40.0,0.0
37064,3,7064,[318 427 185 515 313],655,5,28919,4.093276716206653,40.0,0.0
37065,3,7065,[318 427 185 515 313],655,5,28924,4.093405038211152,40.0,0.0
37066,3,7066,[228  50 143 294   9],457,4,28928,4.0933918211405125,0.0,20.0
37067,3,7067,[ 69 172 197 597  50],450,5,28933,4.093520090548953,0.0,20.0
37068,3,7068,[318 427 185 515 313],655,5,28938,4.093648323666714,40.0,0.0
37069,3,7069,[ 50  89 435  56 328],450,5,28943,4.093776520509194,0.0,20.0
37070,3,7070,[318 427 185 515 313],655,5,28948,4.093904681091783,40.0,0.0
37071,3,7071,[234 143 132 196 215],577,3,28951,4.09375,0.0,0.0
37072,3,7072,[174  82 318 496 194],18,3,28954,4.093595362646685,40.0,0.0
37073,3,7073,[318 427 185 515 313],655,5,28959,4.093723494486853,40.0,0.0
37074,3,7074,[118 603 210 215 235],330,5,28964,4.093851590106007,20.0,0.0
37075,3,7075,[215 183  64 568 174],344,4,28968,4.09383832673827,20.0,0.0
37076,3,7076,[ 15 204 318 427 423],11,4,28972,4.093825067118836,40.0,0.0
37077,3,7077,[603 185  98 269 275],264,5,28977,4.093953094094377,20.0,20.0
37078,3,7078,[168 183  82 161 202],577,5,28982,4.094081084898997,0.0,0.0
37079,3,7079,[318 427 185 515 313],655,5,28987,4.094209039548023,40.0,0.0
37080,3,7080,[318 427 185 515 313],655,5,28992,4.094336958056772,40.0,0.0
37081,3,7081,[175  15 187 204 135],655,2,28994,4.094041231290596,0.0,0.0
37082,3,7082,[211  79  28 265  95],450,4,28998,4.094027954256671,0.0,0.0
37083,3,7083,[168 238 322 183  89],450,5,29003,4.0941558441558445,0.0,0.0
37084,3,7084,[318 427 185 515 313],655,5,29008,4.094283697953423,40.0,0.0
37085,3,7085,[318 427 185 515 313],655,5,29013,4.0944115156646905,40.0,0.0
37086,3,7086,[ 15   9 186 183 100],655,1,29014,4.093974883589671,0.0,20.0
37087,3,7087,[323 273 211 118 597],796,2,29016,4.0936794582392775,0.0,0.0
37088,3,7088,[318 427 185 515 313],655,5,29021,4.0938073070955,40.0,0.0
37089,3,7089,[568 172   7 195 210],269,0,29021,4.093229901269393,0.0,0.0
37090,3,7090,[245 655 588  50 288],280,2,29023,4.092934705965308,0.0,20.0
37091,3,7091,[318 427 185 515 313],655,5,29028,4.093062605752961,40.0,0.0
37092,3,7092,[318 427 185 515 313],655,5,29033,4.093190469476949,40.0,0.0
37093,3,7093,[265 196  98 153 187],236,1,29034,4.092754440372145,0.0,0.0
37094,3,7094,[318 427 185 515 313],655,5,29039,4.092882311486963,40.0,0.0
37095,3,7095,[211 135 275 132 655],716,4,29043,4.092869222096956,0.0,20.0
37096,3,7096,[318 427 185 515 313],655,5,29048,4.092997041003241,40.0,0.0
37097,3,7097,[179 655  69 435 135],450,4,29052,4.092983939137786,0.0,0.0
37098,3,7098,[151 183 135 238 180],269,3,29055,4.092829976052966,0.0,0.0
37099,3,7099,[174  79 202 127 143],655,3,29058,4.0926760563380284,0.0,20.0
37100,3,7100,[328 197 423 273 153],629,3,29061,4.092522179974652,0.0,0.0
37101,3,7101,[318 427 185 515 313],655,5,29066,4.092649957758378,40.0,0.0
37102,3,7102,[117 202 269 597 742],344,2,29068,4.092355342812896,0.0,0.0
37103,3,7103,[  1 202 222 275  25],344,4,29072,4.092342342342342,0.0,20.0
37104,3,7104,[265 144   4 313  15],450,3,29075,4.092188599577762,0.0,0.0
37105,3,7105,[ 28 742 216 185 322],450,5,29080,4.092316352378272,0.0,0.0
37106,3,7106,[435 385 286  79 183],450,5,29085,4.092444069227522,0.0,20.0
37107,3,7107,[191  64 100 423 508],655,2,29087,4.092149690489589,20.0,20.0
37108,3,7108,[300 655 288 302  79],450,4,29091,4.092136728091152,0.0,0.0
37109,3,7109,[318 427 185 515 313],655,5,29096,4.092264416315049,40.0,0.0
37110,3,7110,[318 427 185 515 313],655,5,29101,4.092392068626072,40.0,0.0
37111,3,7111,[318 427 185 515 313],655,5,29106,4.09251968503937,40.0,0.0
37112,3,7112,[245 403 265 222 144],280,1,29107,4.092084914944468,0.0,0.0
37113,3,7113,[318 427 185 515 313],655,5,29112,4.092212538656171,40.0,0.0
37114,3,7114,[ 70 427 748 294 153],450,5,29117,4.092340126493324,20.0,0.0
37115,3,7115,[318 427 185 515 313],655,5,29122,4.092467678471051,40.0,0.0
37116,3,7116,[302 318 161 288 168],450,4,29126,4.092454685963187,20.0,0.0
37117,3,7117,[318 427 185 515 313],655,5,29131,4.092582186007306,40.0,0.0
37118,3,7118,[318 427 185 515 313],655,5,29136,4.092709650231774,40.0,0.0
37119,3,7119,[187 300   8 275  88],389,3,29139,4.092556179775281,0.0,20.0
37120,3,7120,[174 117 318 216 180],796,4,29143,4.09254318213734,20.0,0.0
37121,3,7121,[318 427 185 515 313],655,5,29148,4.092670598146588,40.0,0.0
37122,3,7122,[318 427 185 515 313],655,5,29153,4.092797978379896,40.0,0.0
37123,3,7123,[275 181 216  25 228],151,5,29158,4.09292532285233,0.0,20.0
37124,3,7124,[161 135   7 265   1],280,5,29163,4.0930526315789475,0.0,0.0
37125,3,7125,[318 427 185 515 313],655,5,29168,4.0931799045747965,40.0,0.0
37126,3,7126,[318 427 185 515 313],655,5,29173,4.093307141854918,40.0,0.0
37127,3,7127,[ 88 204  89 483 258],151,5,29178,4.093434343434343,0.0,0.0
37128,3,7128,[ 98  50 186 172  96],450,4,29182,4.093421237200168,0.0,20.0
37129,3,7129,[318 427 185 515 313],655,5,29187,4.093548387096774,40.0,0.0
37130,3,7130,[318 427 185 515 313],655,5,29192,4.0936755013322115,40.0,0.0
37131,3,7131,[273 483 117  56 471],655,2,29194,4.0933819405496354,0.0,0.0
37132,3,7132,[318 427 185 515 313],655,5,29199,4.093509042478621,40.0,0.0
37133,3,7133,[318 427 185 515 313],655,5,29204,4.093636108774881,40.0,0.0
37134,3,7134,[318 427 185 515 313],655,5,29209,4.093763139453399,40.0,0.0
37135,3,7135,[318 427 185 515 313],655,5,29214,4.093890134529148,40.0,0.0
37136,3,7136,[ 64 185 118 405 200],655,3,29217,4.093736864228667,20.0,0.0
37137,3,7137,[318 427 185 515 313],655,5,29222,4.093863827402634,40.0,0.0
37138,3,7138,[318 427 185 515 313],655,5,29227,4.093990755007704,40.0,0.0
37139,3,7139,[318 427 185 515 313],655,5,29232,4.094117647058823,40.0,0.0
37140,3,7140,[318 427 185 515 313],655,5,29237,4.094244503570929,40.0,0.0
37141,3,7141,[132 183 427 385  79],450,5,29242,4.0943713245589475,20.0,0.0
37142,3,7142,[318 427 185 515 313],655,5,29247,4.094498110037799,40.0,0.0
37143,3,7143,[200 471 191 275 294],655,3,29250,4.094344904815229,0.0,20.0
37144,3,7144,[475 186 172   1   7],296,4,29254,4.094331700489853,0.0,0.0
37145,3,7145,[318 427 185 515 313],655,5,29259,4.094458438287154,40.0,0.0
37146,3,7146,[318 427 185 515 313],655,5,29264,4.094585140618442,40.0,0.0
37147,3,7147,[318 427 185 515 313],655,5,29269,4.094711807498601,40.0,0.0
37148,3,7148,[318 427 185 515 313],655,5,29274,4.094838438942509,40.0,0.0
37149,3,7149,[318 427 185 515 313],655,5,29279,4.094965034965035,40.0,0.0
37150,3,7150,[ 97 211   4 282 257],655,0,29279,4.094392392672353,0.0,0.0
37151,3,7151,[318 427 185 515 313],655,5,29284,4.094519015659955,40.0,0.0
37152,3,7152,[318 427 185 515 313],655,5,29289,4.094645603243395,40.0,0.0
37153,3,7153,[204  97  22  15 172],457,5,29294,4.094772155437518,0.0,0.0
37154,3,7154,[471 385 357 175 180],716,1,29295,4.09433962264151,0.0,0.0
37155,3,7155,[423 294   9 121 197],65,5,29300,4.094466182224706,0.0,0.0
37156,3,7156,[204 181 215 191 234],450,4,29304,4.094452983093475,0.0,0.0
37157,3,7157,[144 100 597 427 211],23,3,29307,4.094300083822297,20.0,20.0
37158,3,7158,[318 427 185 515 313],655,5,29312,4.094426595893281,40.0,0.0
37159,3,7159,[318 427 185 515 313],655,5,29317,4.094553072625699,40.0,0.0
37160,3,7160,[176 196  95 215 118],796,5,29322,4.094679514034353,0.0,0.0
37161,3,7161,[318 427 185 515 313],655,5,29327,4.094805920134041,40.0,0.0
37162,3,7162,[318 427 185 515 313],655,5,29332,4.094932290939551,40.0,0.0
37163,3,7163,[121 173  50 179 180],457,5,29337,4.095058626465661,0.0,20.0
37164,3,7164,[  1 748 186  79 427],807,5,29342,4.095184926727146,20.0,0.0
37165,3,7165,[135 302 265   4  28],151,4,29346,4.095171643873849,0.0,0.0
37166,3,7166,[211 195 143  28  22],807,4,29350,4.095158364727222,0.0,0.0
37167,3,7167,[318 427 185 515 313],655,5,29355,4.095284598214286,40.0,0.0
37168,3,7168,[318 427 185 515 313],655,5,29360,4.095410796484866,40.0,0.0
37169,3,7169,[  4 125  50 265 282],256,4,29364,4.095397489539749,0.0,20.0
37170,3,7170,[ 64  69 276 135 144],401,2,29366,4.095105285176405,20.0,0.0
37171,3,7171,[318 427 185 515 313],655,5,29371,4.095231455660904,40.0,0.0
37172,3,7172,[318 427 185 515 313],655,5,29376,4.095357590966123,40.0,0.0
37173,3,7173,[275 132 228  82 568],796,4,29380,4.0953442988569835,0.0,20.0
37174,3,7174,[318 427 185 515 313],655,5,29385,4.095470383275261,40.0,0.0
37175,3,7175,[318 427 185 515 313],655,5,29390,4.095596432552954,40.0,0.0
37176,3,7176,[318 427 185 515 313],655,5,29395,4.095722446704752,40.0,0.0
37177,3,7177,[318 427 185 515 313],655,5,29400,4.095848425745333,40.0,0.0
37178,3,7178,[597   4 427  22 182],796,5,29405,4.095974369689372,20.0,0.0
37179,3,7179,[318 427 185 515 313],655,5,29410,4.096100278551532,40.0,0.0
37180,3,7180,[318 427 185 515 313],655,5,29415,4.09622615234647,40.0,0.0
37181,3,7181,[183 174 173 144 100],796,4,29419,4.096212754107491,0.0,20.0
37182,3,7182,[318 427 185 515 313],655,5,29424,4.096338577196158,40.0,0.0
37183,3,7183,[ 50 546 302 179 603],450,5,29429,4.096464365256125,20.0,20.0
37184,3,7184,[191 597  56  22 200],457,4,29433,4.096450939457203,0.0,0.0
37185,3,7185,[258 318  28 175 200],151,4,29437,4.096437517394935,20.0,0.0
37186,3,7186,[568 111 176 211  56],796,4,29441,4.096424099067761,0.0,0.0
37187,3,7187,[318 427 185 515 313],655,5,29446,4.09654980523094,40.0,0.0
37188,3,7188,[318 427 185 515 313],655,5,29451,4.096675476422312,40.0,0.0
37189,3,7189,[318 427 185 515 313],655,5,29456,4.096801112656467,40.0,0.0
37190,3,7190,[318 427 185 515 313],655,5,29461,4.09692671394799,40.0,0.0
37191,3,7191,[471 235  71  95 678],807,3,29464,4.096774193548387,0.0,0.0
37192,3,7192,[318 427 185 515 313],655,5,29469,4.096899763659113,40.0,0.0
37193,3,7193,[435 186  98 427 483],535,4,29473,4.096886294134,20.0,0.0
37194,3,7194,[  4 181 176 234 276],786,3,29476,4.096733842946491,0.0,0.0
37195,3,7195,[318 200 435 135 265],450,3,29479,4.096581434130072,20.0,0.0
37196,3,7196,[185  25 151 125 403],504,4,29483,4.096568014450465,0.0,0.0
37197,3,7197,[318 427 185 515 313],655,5,29488,4.096693525979439,40.0,0.0
37198,3,7198,[180  88  69 176  11],450,5,29493,4.096819002639255,0.0,0.0
37199,3,7199,[655 111 282 143 211],593,4,29497,4.096805555555555,0.0,0.0
37200,3,7200,[318 427 185 515 313],655,5,29502,4.096930981808082,40.0,0.0
37201,3,7201,[215 111 204  70 435],450,5,29507,4.097056373229658,0.0,0.0
37202,3,7202,[318 427 185 515 313],655,5,29512,4.097181729834791,40.0,0.0
37203,3,7203,[313  79 200 318 603],655,5,29517,4.097307051637979,40.0,0.0
37204,3,7204,[179  98  15 265 302],655,3,29520,4.097154753643303,0.0,0.0
37205,3,7205,[210 318 125  25 237],65,5,29525,4.097280044407438,20.0,0.0
37206,3,7206,[121  98 179 186  56],577,3,29528,4.097127792424033,0.0,0.0
37207,3,7207,[ 82 748 179 204 215],450,4,29532,4.097114317425083,0.0,0.0
37208,3,7208,[318 427 185 515 313],655,5,29537,4.097239561659038,40.0,0.0
37209,3,7209,[258 151 322 273 238],796,2,29539,4.096948682385576,0.0,0.0
37210,3,7210,[238 183 427  79 405],716,4,29543,4.096935237831091,20.0,0.0
37211,3,7211,[318 427 185 515 313],655,5,29548,4.0970604547975595,40.0,0.0
37212,3,7212,[318 427 185 515 313],655,5,29553,4.097185637044226,40.0,0.0
37213,3,7213,[ 88 121  15 294 168],450,3,29556,4.097033545883005,0.0,0.0
37214,3,7214,[186 161 181   4 117],655,0,29556,4.096465696465696,0.0,0.0
37215,3,7215,[286  11  88  82   9],174,4,29560,4.096452328159645,0.0,20.0
37216,3,7216,[318 427 185 515 313],655,5,29565,4.096577525287516,40.0,0.0
37217,3,7217,[180  71   9 237 323],504,4,29569,4.096564145192574,0.0,0.0
37218,3,7218,[318 427 185 515 313],655,5,29574,4.096689292145727,40.0,0.0
37219,3,7219,[ 71 173 161 125 234],796,4,29578,4.096675900277008,0.0,0.0
37220,3,7220,[ 50  12  69 186 748],796,4,29582,4.096662512117435,0.0,20.0
37221,3,7221,[318 427 185 515 313],655,5,29587,4.0967875934644145,40.0,0.0
37222,3,7222,[200  97  88 204 483],796,4,29591,4.096774193548387,0.0,0.0
37223,3,7223,[318 427 185 515 313],655,5,29596,4.096899224806202,40.0,0.0
37224,3,7224,[318 427 185 515 313],655,5,29601,4.097024221453287,40.0,0.0
37225,3,7225,[282 742 471 161 216],655,1,29602,4.096595626902851,0.0,0.0
37226,3,7226,[318 427 185 515 313],655,5,29607,4.096720630967206,40.0,0.0
37227,3,7227,[174  56 191 265 161],796,5,29612,4.096845600442723,0.0,0.0
37228,3,7228,[ 64 196 135  15 111],269,2,29614,4.096555540185364,20.0,0.0
37229,3,7229,[603 216 197  11 144],450,5,29619,4.096680497925311,20.0,0.0
37230,3,7230,[318 427 185 515 313],655,5,29624,4.096805421103582,40.0,0.0
37231,3,7231,[318 427 185 515 313],655,5,29629,4.096930309734513,40.0,0.0
37232,3,7232,[546 197  28  97 143],786,4,29633,4.0969169086133,0.0,0.0
37233,3,7233,[318 427 185 515 313],655,5,29638,4.097041747304396,40.0,0.0
37234,3,7234,[318 427 185 515 313],655,5,29643,4.097166551485833,40.0,0.0
37235,3,7235,[318 427 185 515 313],655,5,29648,4.097291321171918,40.0,0.0
37236,3,7236,[318 427 185 515 313],655,5,29653,4.097416056376952,40.0,0.0
37237,3,7237,[  1 216 100 234 496],389,4,29657,4.097402597402597,20.0,20.0
37238,3,7238,[318 427 185 515 313],655,5,29662,4.097527282773863,40.0,0.0
37239,3,7239,[161 191 403 118 222],457,5,29667,4.097651933701657,0.0,0.0
37240,3,7240,[318 427 185 515 313],655,5,29672,4.097776550200249,40.0,0.0
37241,3,7241,[328 161 100 172 294],796,3,29675,4.09762496547915,0.0,20.0
37242,3,7242,[161 385 118  25 258],450,3,29678,4.0974734226149385,0.0,0.0
37243,3,7243,[175 185 202 275  11],716,4,29682,4.097459966869133,0.0,20.0
37244,3,7244,[318 427 185 515 313],655,5,29687,4.097584541062802,40.0,0.0
37245,3,7245,[423 180 125 276 237],18,3,29690,4.097433066519459,0.0,0.0
37246,3,7246,[  9 195  89 176 172],72,2,29692,4.097143645646474,0.0,0.0
37247,3,7247,[318 427 185 515 313],655,5,29697,4.09726821192053,40.0,0.0
37248,3,7248,[318 427 185 515 313],655,5,29702,4.097392743826735,40.0,0.0
37249,3,7249,[435 271 202 118  97],655,0,29702,4.096827586206897,0.0,0.0
37250,3,7250,[546 161 195  95 111],716,2,29704,4.0965384084953795,0.0,0.0
37251,3,7251,[216 289 125 237 403],655,1,29705,4.096111417539989,0.0,0.0
37252,3,7252,[318 427 185 515 313],655,5,29710,4.096236040259203,40.0,0.0
37253,3,7253,[ 64   7 117 258  12],344,3,29713,4.0960849186655635,20.0,0.0
37254,3,7254,[318 427 185 515 313],655,5,29718,4.0962095106822884,40.0,0.0
37255,3,7255,[318 427 185 515 313],655,5,29723,4.096334068357222,40.0,0.0
37256,3,7256,[269 357 282 546 174],450,5,29728,4.096458591704561,0.0,0.0
37257,3,7257,[318 427 185 515 313],655,5,29733,4.096583080738496,40.0,0.0
37258,3,7258,[318 427 185 515 313],655,5,29738,4.096707535473206,40.0,0.0
37259,3,7259,[318 427 185 515 313],655,5,29743,4.096831955922865,40.0,0.0
37260,3,7260,[318 427 185 515 313],655,5,29748,4.096956342101639,40.0,0.0
37261,3,7261,[275 195 423 181 237],450,5,29753,4.097080694023685,0.0,20.0
37262,3,7262,[318 427 185 515 313],655,5,29758,4.097205011703153,40.0,0.0
37263,3,7263,[403 111 405   4 172],450,4,29762,4.097191629955947,0.0,0.0
37264,3,7264,[313 179 357 176 185],450,5,29767,4.097315898141775,0.0,0.0
37265,3,7265,[194 603 161  11 132],450,5,29772,4.097440132122213,20.0,0.0
37266,3,7266,[151 196  15 211 302],269,2,29774,4.097151506811614,0.0,0.0
37267,3,7267,[194 568 435 153 174],716,5,29779,4.097275729223996,0.0,0.0
37268,3,7268,[318 427 185 515 313],655,5,29784,4.097399917457697,40.0,0.0
37269,3,7269,[318 427 185 515 313],655,5,29789,4.097524071526823,40.0,0.0
37270,3,7270,[ 79 483  96 215  98],23,4,29793,4.09751065878146,0.0,0.0
37271,3,7271,[318 427 185 515 313],655,5,29798,4.097634763476347,40.0,0.0
37272,3,7272,[318 427 185 515 313],655,5,29803,4.097758834043724,40.0,0.0
37273,3,7273,[405  15 228 568   4],577,1,29804,4.097332966730822,0.0,0.0
37274,3,7274,[117  28 234 194 121],457,5,29809,4.09745704467354,0.0,0.0
37275,3,7275,[318 427 185 515 313],655,5,29814,4.097581088510171,40.0,0.0
37276,3,7276,[  9 153 111  22 127],269,2,29816,4.097292840456232,0.0,20.0
37277,3,7277,[286  25 100 191 172],18,3,29819,4.097142071997801,0.0,40.0
37278,3,7278,[ 98  64 181 515 173],269,3,29822,4.096991344964968,20.0,0.0
37279,3,7279,[318 427 185 515 313],655,5,29827,4.0971153846153845,40.0,0.0
37280,3,7280,[318 427 185 515 313],655,5,29832,4.097239390193654,40.0,0.0
37281,3,7281,[318 427 185 515 313],655,5,29837,4.097363361713815,40.0,0.0
37282,3,7282,[318 427 185 515 313],655,5,29842,4.097487299189894,40.0,0.0
37283,3,7283,[144 385 161 143 237],655,1,29843,4.097062053816584,0.0,0.0
37284,3,7284,[318 427 185 515 313],655,5,29848,4.0971859986273165,40.0,0.0
37285,3,7285,[318 427 185 515 313],655,5,29853,4.097309909415317,40.0,0.0
37286,3,7286,[318 427 185 515 313],655,5,29858,4.0974337861945935,40.0,0.0
37287,3,7287,[282 276 235  50 483],457,4,29862,4.09742041712404,0.0,20.0
37288,3,7288,[318 427 185 515 313],655,5,29867,4.097544244752367,40.0,0.0
37289,3,7289,[318 427 185 515 313],655,5,29872,4.097668038408779,40.0,0.0
37290,3,7290,[318 427 185 515 313],655,5,29877,4.097791798107256,40.0,0.0
37291,3,7291,[318 427 185 515 313],655,5,29882,4.097915523861766,40.0,0.0
37292,3,7292,[318 427 185 515 313],655,5,29887,4.098039215686274,40.0,0.0
37293,3,7293,[318 427 185 515 313],655,5,29892,4.0981628735947355,40.0,0.0
37294,3,7294,[302 258  11 132 172],655,2,29894,4.09787525702536,0.0,0.0
37295,3,7295,[302 151  79 471 211],535,3,29897,4.097724780701754,0.0,0.0
37296,3,7296,[  1  64 161 173 176],716,3,29900,4.097574345621489,20.0,0.0
37297,3,7297,[100  98 168 215 144],535,3,29903,4.097423951767608,0.0,20.0
37298,3,7298,[301  89 215  70 132],344,3,29906,4.0972735991231675,0.0,0.0
37299,3,7299,[318 427 185 515 313],655,5,29911,4.097397260273973,40.0,0.0
37300,3,7300,[168  15 496   8 475],269,3,29914,4.097246952472264,20.0,0.0
37301,3,7301,[318 427 185 515 313],655,5,29919,4.0973705834018075,40.0,0.0
37302,3,7302,[ 28  96 597 235 172],450,4,29923,4.097357250445023,0.0,0.0
37303,3,7303,[132 111 195 174  12],655,0,29923,4.096796276013143,0.0,0.0
37304,3,7304,[318 427 185 515 313],655,5,29928,4.096919917864477,40.0,0.0
37305,3,7305,[318 427 185 515 313],655,5,29933,4.097043525869148,40.0,0.0
37306,3,7306,[179 175 132 197  69],269,4,29937,4.097030244970576,0.0,0.0
37307,3,7307,[258 423 143 210  98],450,4,29941,4.097016967706623,0.0,0.0
37308,3,7308,[515 168  50 175 435],878,4,29945,4.097003694075797,0.0,20.0
37309,3,7309,[318 427 185 515 313],655,5,29950,4.097127222982216,40.0,0.0
37310,3,7310,[318 427 185 515 313],655,5,29955,4.09725071809602,40.0,0.0
37311,3,7311,[318 427 185 515 313],655,5,29960,4.097374179431072,40.0,0.0
37312,3,7312,[318 427 185 515 313],655,5,29965,4.09749760700123,40.0,0.0
37313,3,7313,[182 185 172 168 173],457,5,29970,4.097621000820345,0.0,0.0
37314,3,7314,[423 117 471  89 118],655,1,29971,4.097197539302803,0.0,0.0
37315,3,7315,[271 173 265 144 194],796,5,29976,4.097320940404592,0.0,0.0
37316,3,7316,[318 427 185 515 313],655,5,29981,4.097444307776411,40.0,0.0
37317,3,7317,[238 144  25 121 471],535,4,29985,4.0974309920743375,0.0,0.0
37318,3,7318,[228 515 301   4   8],655,1,29986,4.097007787949173,0.0,0.0
37319,3,7319,[318 427 185 515 313],655,5,29991,4.097131147540984,40.0,0.0
37320,3,7320,[318 427 185 515 313],655,5,29996,4.097254473432591,40.0,0.0
37321,3,7321,[318 427 185 515 313],655,5,30001,4.097377765637804,40.0,0.0
37322,3,7322,[318 427 185 515 313],655,5,30006,4.097501024170422,40.0,0.0
37323,3,7323,[603 111 471 568 215],450,5,30011,4.097624249044238,20.0,0.0
37324,3,7324,[202 172 302 268 151],344,4,30015,4.0976109215017065,0.0,0.0
37325,3,7325,[318 427 185 515 313],655,5,30020,4.097734097734098,40.0,0.0
37326,3,7326,[318 427 185 515 313],655,5,30025,4.0978572403439335,40.0,0.0
37327,3,7327,[318 427 185 515 313],655,5,30030,4.0979803493449785,40.0,0.0
37328,3,7328,[172 111 603 318  25],716,5,30035,4.098103424750989,40.0,0.0
37329,3,7329,[318 427 185 515 313],655,5,30040,4.098226466575716,40.0,0.0
37330,3,7330,[318 427 185 515 313],655,5,30045,4.098349474832902,40.0,0.0
37331,3,7331,[483 168 151 197 187],389,5,30050,4.098472449536279,0.0,0.0
37332,3,7332,[318 427 185 515 313],655,5,30055,4.098595390699577,40.0,0.0
37333,3,7333,[318 427 185 515 313],655,5,30060,4.0987182983365145,40.0,0.0
37334,3,7334,[ 69 222 153 185 100],151,3,30063,4.098568507157464,0.0,20.0
37335,3,7335,[238 300 286   4 508],655,0,30063,4.098009814612868,0.0,20.0
37336,3,7336,[385  70 237  28 568],716,4,30067,4.097996456317296,0.0,0.0
37337,3,7337,[318 427 185 515 313],655,5,30072,4.098119378577269,40.0,0.0
37338,3,7338,[318 427 185 515 313],655,5,30077,4.0982422673388745,40.0,0.0
37339,3,7339,[215 294 191  12 475],655,1,30078,4.0978201634877385,0.0,0.0
37340,3,7340,[202 197 111 195 204],786,4,30082,4.097806838305408,0.0,0.0
37341,3,7341,[  1 173 204 185 100],401,3,30085,4.097657314083356,0.0,20.0
37342,3,7342,[ 96  56 210 483 313],280,3,30088,4.097507830586953,0.0,0.0
37343,3,7343,[318 427 185 515 313],655,5,30093,4.097630718954249,40.0,0.0
37344,3,7344,[ 25 196 546  12 118],577,3,30096,4.097481279782165,0.0,0.0
37345,3,7345,[265 117 282 294 191],655,1,30097,4.097059624285325,0.0,0.0
37346,3,7346,[318 427 185 515 313],655,5,30102,4.097182523478971,40.0,0.0
37347,3,7347,[318 427 185 515 313],655,5,30107,4.097305389221557,40.0,0.0
37348,3,7348,[405 196 118   7 546],457,4,30111,4.097292148591645,0.0,0.0
37349,3,7349,[234 216 168 265 322],151,4,30115,4.097278911564626,0.0,0.0
37350,3,7350,[318 427 185 515 313],655,5,30120,4.09740171405251,40.0,0.0
37351,3,7351,[111 185 237 302 483],401,3,30123,4.097252448313384,0.0,0.0
37352,3,7352,[318 427 185 515 313],655,5,30128,4.097375220998232,40.0,0.0
37353,3,7353,[318 427 185 515 313],655,5,30133,4.097497960293718,40.0,0.0
37354,3,7354,[318 427 185 515 313],655,5,30138,4.09762066621346,40.0,0.0
37355,3,7355,[318 427 185 515 313],655,5,30143,4.097743338771071,40.0,0.0
37356,3,7356,[175  97  69   9  22],18,4,30147,4.097730053010738,0.0,0.0
37357,3,7357,[318 427 185 515 313],655,5,30152,4.097852677357977,40.0,0.0
37358,3,7358,[257 423  69 186 195],796,4,30156,4.0978393803505915,0.0,0.0
37359,3,7359,[318 427 185 515 313],655,5,30161,4.097961956521739,40.0,0.0
37360,3,7360,[318 427 185 515 313],655,5,30166,4.09808449938867,40.0,0.0
37361,3,7361,[273  88 168 294 385],401,1,30167,4.097663678348275,0.0,0.0
37362,3,7362,[318 427 185 515 313],655,5,30172,4.097786228439495,40.0,0.0
37363,3,7363,[318 427 185 515 313],655,5,30177,4.097908745247148,40.0,0.0
37364,3,7364,[318 427 185 515 313],655,5,30182,4.098031228784793,40.0,0.0
37365,3,7365,[318 427 185 515 313],655,5,30187,4.0981536790659785,40.0,0.0
37366,3,7366,[111 215 117 234 185],655,1,30188,4.097733134247319,0.0,0.0
37367,3,7367,[318 427 185 515 313],655,5,30193,4.0978555917481,40.0,0.0
37368,3,7368,[318 427 185 515 313],655,5,30198,4.097978016013028,40.0,0.0
37369,3,7369,[318 427 185 515 313],655,5,30203,4.098100407055631,40.0,0.0
37370,3,7370,[301 185  70 318 228],151,5,30208,4.098222764889432,20.0,0.0
37371,3,7371,[ 12 276 181 175 117],655,1,30209,4.097802495930548,0.0,0.0
37372,3,7372,[191  64 427  69 403],655,3,30212,4.097653600976536,40.0,0.0
37373,3,7373,[318 427 185 515 313],655,5,30217,4.097775969623,40.0,0.0
37374,3,7374,[318 427 185 515 313],655,5,30222,4.097898305084746,40.0,0.0
37375,3,7375,[265  82 357 423 333],655,1,30223,4.09747830802603,0.0,0.0
37376,3,7376,[204 121 173  97  50],786,4,30227,4.097465094211739,0.0,20.0
37377,3,7377,[216 135 313  25 597],450,3,30230,4.097316345893196,0.0,0.0
37378,3,7378,[318 427 185 515 313],655,5,30235,4.097438677327551,40.0,0.0
37379,3,7379,[318 427 185 515 313],655,5,30240,4.097560975609756,40.0,0.0
37380,3,7380,[318 427 185 515 313],655,5,30245,4.097683240753286,40.0,0.0
37381,3,7381,[ 50   9 196  25 100],72,4,30249,4.097670008127879,0.0,40.0
37382,3,7382,[678 132 286   1 385],344,1,30250,4.097250440200461,0.0,20.0
37383,3,7383,[318 427 185 515 313],655,5,30255,4.09737269772481,40.0,0.0
37384,3,7384,[151 183 273  56 204],236,1,30256,4.096953283683142,0.0,0.0
37385,3,7385,[318 427 185 515 313],655,5,30261,4.097075548334687,40.0,0.0
37386,3,7386,[ 79 182 143 238 228],655,3,30264,4.096927033978611,0.0,0.0
37387,3,7387,[318 427 185 515 313],655,5,30269,4.097049269085002,40.0,0.0
37388,3,7388,[318 427 185 515 313],655,5,30274,4.097171471105698,40.0,0.0
37389,3,7389,[318 427 185 515 313],655,5,30279,4.0972936400541276,40.0,0.0
37390,3,7390,[194 282 182 265 200],796,5,30284,4.097415775943715,0.0,0.0
37391,3,7391,[318 427 185 515 313],655,5,30289,4.097537878787879,40.0,0.0
37392,3,7392,[ 82 258 191 257   8],23,2,30291,4.097254159339916,0.0,0.0
37393,3,7393,[318 427 185 515 313],655,5,30296,4.097376251014336,40.0,0.0
37394,3,7394,[483  71 318 496 597],450,3,30299,4.097227856659905,40.0,0.0
37395,3,7395,[135 127  70 435 196],269,2,30301,4.096944294213088,0.0,20.0
37396,3,7396,[ 15 118 215  82  28],457,5,30306,4.097066378261458,0.0,0.0
37397,3,7397,[222 135 196  97 655],72,4,30310,4.097053257637199,0.0,0.0
37398,3,7398,[318 427 185 515 313],655,5,30315,4.097175293958643,40.0,0.0
37399,3,7399,[318 427 185 515 313],655,5,30320,4.097297297297297,40.0,0.0
37400,3,7400,[318 427 185 515 313],655,5,30325,4.097419267666532,40.0,0.0
37401,3,7401,[204 187 435 313 215],655,2,30327,4.097135909213726,0.0,0.0
37402,3,7402,[318 427 185 515 313],655,5,30332,4.097257868431717,40.0,0.0
37403,3,7403,[748 196 135 153 168],151,3,30335,4.097109670448407,0.0,0.0
37404,3,7404,[318 427 185 515 313],655,5,30340,4.097231600270088,40.0,0.0
37405,3,7405,[318 427 185 515 313],655,5,30345,4.097353497164462,40.0,0.0
37406,3,7406,[216   8 318 161 403],269,1,30346,4.0969353314432295,20.0,0.0
37407,3,7407,[182  97  98 180   1],72,5,30351,4.0970572354211665,0.0,0.0
37408,3,7408,[318 427 185 515 313],655,5,30356,4.097179106492105,40.0,0.0
37409,3,7409,[ 28 269  64  82 153],796,2,30358,4.096896086369771,20.0,0.0
37410,3,7410,[318 427 185 515 313],655,5,30363,4.097017946296046,40.0,0.0
37411,3,7411,[153 318 197 118 151],151,3,30366,4.096869940636805,20.0,0.0
37412,3,7412,[318 427 185 515 313],655,5,30371,4.096991771212735,40.0,0.0
37413,3,7413,[318 427 185 515 313],655,5,30376,4.097113568923658,40.0,0.0
37414,3,7414,[568  89   9 216 385],256,5,30381,4.097235333782873,0.0,0.0
37415,3,7415,[ 28 161 202   1 143],457,5,30386,4.097357065803668,0.0,0.0
37416,3,7416,[318 427 185 515 313],655,5,30391,4.097478764999326,40.0,0.0
37417,3,7417,[289 508 204 216 127],655,2,30393,4.097196009706121,0.0,20.0
37418,3,7418,[318 427 185 515 313],655,5,30398,4.097317697802938,40.0,0.0
37419,3,7419,[318 427 185 515 313],655,5,30403,4.09743935309973,40.0,0.0
37420,3,7420,[318 427 185 515 313],655,5,30408,4.097560975609756,40.0,0.0
37421,3,7421,[186   4  28  15 215],577,4,30412,4.097547830773377,0.0,0.0
37422,3,7422,[318 427 185 515 313],655,5,30417,4.09766940590058,40.0,0.0
37423,3,7423,[179  22 100 161  97],450,5,30422,4.097790948275862,0.0,20.0
37424,3,7424,[318 427 185 515 313],655,5,30427,4.097912457912458,40.0,0.0
37425,3,7425,[546  70 197   4 216],457,4,30431,4.097899272825209,0.0,0.0
37426,3,7426,[318 427 185 515 313],655,5,30436,4.098020735155513,40.0,0.0
37427,3,7427,[318 427 185 515 313],655,5,30441,4.0981421647819065,40.0,0.0
37428,3,7428,[318 427 185 515 313],655,5,30446,4.0982635617175935,40.0,0.0
37429,3,7429,[318 427 185 515 313],655,5,30451,4.098384925975774,40.0,0.0
37430,3,7430,[318 427 185 515 313],655,5,30456,4.098506257569641,40.0,0.0
37431,3,7431,[403 111 172 176 742],280,2,30458,4.098223896663079,0.0,0.0
37432,3,7432,[  4 286 300 655  82],655,0,30458,4.097672541369568,0.0,20.0
37433,3,7433,[  4 271 282 100 471],655,0,30458,4.09712133440947,0.0,20.0
37434,3,7434,[318 427 185 515 313],655,5,30463,4.09724277067922,40.0,0.0
37435,3,7435,[161 235 568  56 175],269,2,30465,4.096960731576116,0.0,0.0
37436,3,7436,[318 427 185 515 313],655,5,30470,4.0970821567836495,40.0,0.0
37437,3,7437,[183 172 603 211 423],269,3,30473,4.096934659854799,20.0,0.0
37438,3,7438,[435 235 168 125 196],450,4,30477,4.096921629251243,0.0,0.0
37439,3,7439,[318 427 185 515 313],655,5,30482,4.097043010752688,40.0,0.0
37440,3,7440,[405 423   1 204 172],330,5,30487,4.097164359629082,0.0,0.0
37441,3,7441,[318 427 185 515 313],655,5,30492,4.097285675893577,40.0,0.0
37442,3,7442,[174 202 181  70 196],23,2,30494,4.097003896278382,0.0,0.0
37443,3,7443,[117 238 100 176 185],655,1,30495,4.096587855991403,0.0,20.0
37444,3,7444,[323 234  95 210 204],796,2,30497,4.096306245802552,0.0,0.0
37445,3,7445,[228 210 496 655 405],280,1,30498,4.095890410958904,20.0,0.0
37446,3,7446,[318 427 185 515 313],655,5,30503,4.096011816838995,40.0,0.0
37447,3,7447,[ 69  50 143 357  28],796,4,30507,4.095998925886144,0.0,20.0
37448,3,7448,[117 204   7 742 357],344,3,30510,4.0958517921868705,0.0,0.0
37449,3,7449,[385 127 191  11  56],450,5,30515,4.095973154362416,0.0,20.0
37450,3,7450,[ 22 282   9  12  96],796,4,30519,4.095960273788753,0.0,0.0
37451,3,7451,[318 427 185 515 313],655,5,30524,4.0960815888352125,40.0,0.0
37452,3,7452,[318 427 185 515 313],655,5,30529,4.096202871326982,40.0,0.0
37453,3,7453,[186 132 204  98 222],786,5,30534,4.096324121277167,0.0,0.0
37454,3,7454,[318 427 185 515 313],655,5,30539,4.09644533869886,40.0,0.0
37455,3,7455,[318 427 185 515 313],655,5,30544,4.0965665236051505,40.0,0.0
37456,3,7456,[200 301  89 118 197],796,3,30547,4.096419471637388,0.0,0.0
37457,3,7457,[318 427 185 515 313],655,5,30552,4.096540627514079,40.0,0.0
37458,3,7458,[318 427 185 515 313],655,5,30557,4.096661750904947,40.0,0.0
37459,3,7459,[197 222  88 181 288],280,1,30558,4.096246648793565,0.0,0.0
37460,3,7460,[ 88 202 185 117   4],716,4,30562,4.096233748827235,0.0,0.0
37461,3,7461,[318 427 185 515 313],655,5,30567,4.096354864647547,40.0,0.0
37462,3,7462,[318 427 185 515 313],655,5,30572,4.096475948010184,40.0,0.0
37463,3,7463,[181  82 174 180  64],269,1,30573,4.096061093247588,20.0,0.0
37464,3,7464,[515 282  28 318 127],716,4,30577,4.096048225050234,20.0,20.0
37465,3,7465,[  7 172 286 181 121],786,4,30581,4.096035360300027,0.0,20.0
37466,3,7466,[204 183 228 196  97],151,4,30585,4.0960224989955805,0.0,0.0
37467,3,7467,[405 100 196  98 471],450,5,30590,4.096143545795393,0.0,20.0
37468,3,7468,[318 427 185 515 313],655,5,30595,4.096264560182086,40.0,0.0
37469,3,7469,[ 70 427  96 245  95],450,4,30599,4.096251673360107,20.0,0.0
37470,3,7470,[318 427 185 515 313],655,5,30604,4.096372640878061,40.0,0.0
37471,3,7471,[ 50 294 328 313 237],655,2,30606,4.096092077087794,0.0,20.0
37472,3,7472,[318 427 185 515 313],655,5,30611,4.096213033587582,40.0,0.0
37473,3,7473,[318 427 185 515 313],655,5,30616,4.096333957720097,40.0,0.0
37474,3,7474,[161 423  56 200 483],457,5,30621,4.096454849498328,0.0,0.0
37475,3,7475,[318 427 185 515 313],655,5,30626,4.0965757089352595,40.0,0.0
37476,3,7476,[546 183  79  69 588],796,5,30631,4.096696536043868,0.0,0.0
37477,3,7477,[318 427 185 515 313],655,5,30636,4.096817330837122,40.0,0.0
37478,3,7478,[ 69 127 423 196 187],389,4,30640,4.09680438561305,0.0,20.0
37479,3,7479,[318 427 185 515 313],655,5,30645,4.096925133689839,40.0,0.0
37480,3,7480,[318 427 185 515 313],655,5,30650,4.0970458494853625,40.0,0.0
37481,3,7481,[742  56 286 215  98],450,5,30655,4.0971665330125635,0.0,20.0
37482,3,7482,[318 427 185 515 313],655,5,30660,4.097287184284378,40.0,0.0
37483,3,7483,[118 568 257 172 471],457,4,30664,4.097274184927846,0.0,0.0
37484,3,7484,[ 69 135 179 172 742],457,5,30669,4.097394789579158,0.0,0.0
37485,3,7485,[117  82 471 175 144],457,5,30674,4.097515362009084,0.0,0.0
37486,3,7486,[301 118 183 125 237],796,4,30678,4.0975023373848005,0.0,0.0
37487,3,7487,[180 403 318 423 118],450,4,30682,4.097489316239316,20.0,0.0
37488,3,7488,[127 313  82 288 318],655,3,30685,4.097342769395113,20.0,20.0
37489,3,7489,[318 427 185 515 313],655,5,30690,4.097463284379172,40.0,0.0
37490,3,7490,[742 427  79  15 328],796,4,30694,4.097450273661727,20.0,0.0
37491,3,7491,[ 82 121  28 238 186],655,0,30694,4.096903363587827,0.0,0.0
37492,3,7492,[258 179 301 181 603],450,5,30699,4.097023888963032,20.0,0.0
37493,3,7493,[135  88   4 181 196],18,0,30699,4.096477181745397,0.0,0.0
37494,3,7494,[318 427 185 515 313],655,5,30704,4.096597731821214,40.0,0.0
37495,3,7495,[318 427 185 515 313],655,5,30709,4.096718249733191,40.0,0.0
37496,3,7496,[318 427 185 515 313],655,5,30714,4.096838735494198,40.0,0.0
37497,3,7497,[181 385 125 234  25],450,3,30717,4.096692451320352,0.0,0.0
37498,3,7498,[318 427 185 515 313],655,5,30722,4.096812908387785,40.0,0.0
37499,3,7499,[508 135 100 127 276],655,3,30725,4.096666666666667,0.0,40.0
37500,3,7500,[276 257 322 151 300],504,4,30729,4.096653779496068,0.0,0.0
37501,3,7501,[275 515 496 175 655],716,4,30733,4.09664089576113,20.0,20.0
37502,3,7502,[179 427 182  88 153],389,3,30736,4.096494735439157,20.0,0.0
37503,3,7503,[245 228 265 127 100],796,3,30739,4.096348614072495,0.0,40.0
37504,3,7504,[ 28 322   9 183 427],151,3,30742,4.096202531645569,20.0,0.0
37505,3,7505,[ 96  25 357 121 323],504,5,30747,4.096322941646683,0.0,0.0
37506,3,7506,[ 28   9 276 168  98],18,3,30750,4.096176901558545,0.0,0.0
37507,3,7507,[151 202 200  88   4],450,3,30753,4.096030900372935,0.0,0.0
37508,3,7508,[  7 121 197 144 168],535,4,30757,4.096018111599414,0.0,0.0
37509,3,7509,[186   9 196 333 403],796,3,30760,4.0958721704394145,0.0,0.0
37510,3,7510,[318 427 185 515 313],655,5,30765,4.095992544268406,40.0,0.0
37511,3,7511,[ 70 258 196 496  22],344,2,30767,4.095713525026624,20.0,0.0
37512,3,7512,[318 427 185 515 313],655,5,30772,4.095833887927592,40.0,0.0
37513,3,7513,[  8  95 215 546 313],280,3,30775,4.095688048975246,0.0,0.0
37514,3,7514,[322 183 100  70 161],280,3,30778,4.095542248835662,0.0,20.0
37515,3,7515,[655 173 132 100 172],269,3,30781,4.095396487493348,0.0,20.0
37516,3,7516,[ 95 117 235 269 144],450,3,30784,4.095250764932819,0.0,0.0
37517,3,7517,[475 238  56 423 153],655,0,30784,4.094706038840117,0.0,0.0
37518,3,7518,[318 427 185 515 313],655,5,30789,4.094826439686129,40.0,0.0
37519,3,7519,[318 427 185 515 313],655,5,30794,4.094946808510638,40.0,0.0
37520,3,7520,[318 427 185 515 313],655,5,30799,4.09506714532642,40.0,0.0
37521,3,7521,[180 483  69 216 132],18,4,30803,4.095054506780111,0.0,0.0
37522,3,7522,[748 435  82  50 168],151,3,30806,4.094908945899243,0.0,20.0
37523,3,7523,[318 427 185 515 313],655,5,30811,4.095029239766082,40.0,0.0
37524,3,7524,[318 427 185 515 313],655,5,30816,4.09514950166113,40.0,0.0
37525,3,7525,[318 427 185 515 313],655,5,30821,4.09526973159713,40.0,0.0
37526,3,7526,[300 182  88  82 222],450,3,30824,4.095124219476551,0.0,0.0
37527,3,7527,[318 427 185 515 313],655,5,30829,4.095244420828905,40.0,0.0
37528,3,7528,[318 427 185 515 313],655,5,30834,4.095364590251029,40.0,0.0
37529,3,7529,[ 22  25 202 182 282],256,3,30837,4.095219123505976,0.0,0.0
37530,3,7530,[211  22 405 222 588],450,4,30841,4.095206479883149,0.0,0.0
37531,3,7531,[200  82 204  88 483],18,1,30842,4.094795539033457,0.0,0.0
37532,3,7532,[318 427 185 515 313],655,5,30847,4.094915704234701,40.0,0.0
37533,3,7533,[318 427 185 515 313],655,5,30852,4.095035837536501,40.0,0.0
37534,3,7534,[568 228 471 288 181],344,3,30855,4.094890510948905,0.0,0.0
37535,3,7535,[318 427 185 515 313],655,5,30860,4.095010615711253,40.0,0.0
37536,3,7536,[176  82 181 144 182],280,0,30860,4.094467294679581,0.0,0.0
37537,3,7537,[515 185 216  69 195],18,2,30862,4.0941894401698065,0.0,0.0
37538,3,7538,[ 25  79  15 111   9],655,1,30863,4.093779015784587,0.0,0.0
37539,3,7539,[ 88  12 168  25 175],151,5,30868,4.093899204244032,0.0,0.0
37540,3,7540,[183  56 210 655 125],151,4,30872,4.0938867524201035,0.0,0.0
37541,3,7541,[318 427 185 515 313],655,5,30877,4.094006894722885,40.0,0.0
37542,3,7542,[186 269 515 210 282],296,3,30880,4.093861858676919,0.0,0.0
37543,3,7543,[265 234 333   4 276],629,4,30884,4.093849416755037,0.0,0.0
37544,3,7544,[ 71 257 153 357  88],401,2,30886,4.093571901921803,0.0,0.0
37545,3,7545,[318  96  89 268 121],655,2,30888,4.093294460641399,20.0,0.0
37546,3,7546,[318 427 185 515 313],655,5,30893,4.093414601828541,40.0,0.0
37547,3,7547,[318 427 185 515 313],655,5,30898,4.09353471118177,40.0,0.0
37548,3,7548,[121 176 269 257 161],796,4,30902,4.093522320837197,0.0,0.0
37549,3,7549,[318 427 185 515 313],655,5,30907,4.09364238410596,40.0,0.0
37550,3,7550,[ 88  11 234 183   9],655,1,30908,4.09323268441266,0.0,0.0
37551,3,7551,[318 427 185 515 313],655,5,30913,4.093352754237288,40.0,0.0
37552,3,7552,[200 183 117 181 286],786,5,30918,4.093472792267973,0.0,20.0
37553,3,7553,[318 427 185 515 313],655,5,30923,4.093592798517342,40.0,0.0
37554,3,7554,[318 427 185 515 313],655,5,30928,4.093712772998015,40.0,0.0
37555,3,7555,[ 71 603 333 318 237],796,5,30933,4.093832715722605,40.0,0.0
37556,3,7556,[318 427 185 515 313],655,5,30938,4.093952626703718,40.0,0.0
37557,3,7557,[318 427 185 515 313],655,5,30943,4.094072505953956,40.0,0.0
37558,3,7558,[318 427 185 515 313],655,5,30948,4.094192353485911,40.0,0.0
37559,3,7559,[318 427 185 515 313],655,5,30953,4.094312169312169,40.0,0.0
37560,3,7560,[  9 271 153   4 174],629,4,30957,4.0942996958074325,0.0,0.0
37561,3,7561,[  9 282 228   1 121],796,3,30960,4.094154985453584,0.0,0.0
37562,3,7562,[318 427 185 515 313],655,5,30965,4.09427475869364,40.0,0.0
37563,3,7563,[258 168 127 111 245],450,5,30970,4.094394500264411,0.0,20.0
37564,3,7564,[318 427 185 515 313],655,5,30975,4.0945142101784535,40.0,0.0
37565,3,7565,[200 655 173 179 111],269,3,30978,4.094369547977795,0.0,0.0
37566,3,7566,[204 151 588  28   8],457,5,30983,4.094489229549359,0.0,0.0
37567,3,7567,[174  98 294 187 471],256,3,30986,4.094344608879493,0.0,0.0
37568,3,7568,[318 427 185 515 313],655,5,30991,4.094464262121813,40.0,0.0
37569,3,7569,[318 427 185 515 313],655,5,30996,4.0945838837516515,40.0,0.0
37570,3,7570,[496  70  64  82 172],269,2,30998,4.0943072249372605,40.0,0.0
37571,3,7571,[153 313 143  12 172],450,5,31003,4.094426835710513,0.0,0.0
37572,3,7572,[318 427 185 515 313],655,5,31008,4.094546414895022,40.0,0.0
37573,3,7573,[318 427 185 515 313],655,5,31013,4.094665962503301,40.0,0.0
37574,3,7574,[318 427 185 515 313],655,5,31018,4.094785478547855,40.0,0.0
37575,3,7575,[318 427 185 515 313],655,5,31023,4.0949049630411825,40.0,0.0
37576,3,7576,[168 195  22 302 179],269,2,31025,4.094628480929128,0.0,0.0
37577,3,7577,[195 121 568  82 222],450,2,31027,4.094352071786751,0.0,0.0
37578,3,7578,[318 427 185 515 313],655,5,31032,4.0944715661696796,40.0,0.0
37579,3,7579,[318 427 185 515 313],655,5,31037,4.094591029023746,40.0,0.0
37580,3,7580,[318 427 185 515 313],655,5,31042,4.09471046036143,40.0,0.0
37581,3,7581,[318 427 185 515 313],655,5,31047,4.094829860195199,40.0,0.0
37582,3,7582,[ 96 258  12 222  69],450,4,31051,4.094817354608994,0.0,0.0
37583,3,7583,[258 483 568 127 185],796,5,31056,4.094936708860759,0.0,20.0
37584,3,7584,[318 427 185 515 313],655,5,31061,4.0950560316413975,40.0,0.0
37585,3,7585,[318 427 185 515 313],655,5,31066,4.095175322963353,40.0,0.0
37586,3,7586,[228 318 144 294 275],796,4,31070,4.0951627784368,20.0,20.0
37587,3,7587,[318 427 185 515 313],655,5,31075,4.095282024248814,40.0,0.0
37588,3,7588,[318 427 185 515 313],655,5,31080,4.095401238634866,40.0,0.0
37589,3,7589,[318 427 185 515 313],655,5,31085,4.095520421607378,40.0,0.0
37590,3,7590,[318 427 185 515 313],655,5,31090,4.095639573178764,40.0,0.0
37591,3,7591,[318 427 185 515 313],655,5,31095,4.095758693361433,40.0,0.0
37592,3,7592,[  4 185 186  97 187],535,3,31098,4.095614381667326,0.0,0.0
37593,3,7593,[318 427 185 515 313],655,5,31103,4.095733473795101,40.0,0.0
37594,3,7594,[318 427 185 515 313],655,5,31108,4.095852534562212,40.0,0.0
37595,3,7595,[322 742  69 328 271],796,3,31111,4.095708267509216,0.0,0.0
37596,3,7596,[237 204 191 405 143],786,5,31116,4.0958273002500984,0.0,0.0
37597,3,7597,[ 11 181 195 423 427],655,1,31117,4.095419847328245,20.0,0.0
37598,3,7598,[318 427 185 515 313],655,5,31122,4.095538886695618,40.0,0.0
37599,3,7599,[318 427 185 515 313],655,5,31127,4.095657894736842,40.0,0.0
37600,3,7600,[174 496 265  28 111],151,5,31132,4.095776871464281,20.0,0.0
37601,3,7601,[ 97 245 111 210 222],756,2,31134,4.095501183898974,0.0,0.0
37602,3,7602,[ 15 180 322 301 405],450,4,31138,4.095488622912009,0.0,0.0
37603,3,7603,[318 427 185 515 313],655,5,31143,4.095607574960547,40.0,0.0
37604,3,7604,[318 427 185 515 313],655,5,31148,4.095726495726495,40.0,0.0
37605,3,7605,[121 175   1  89  11],655,1,31149,4.0953194846174075,0.0,0.0
37606,3,7606,[195 258 300 742 100],450,5,31154,4.095438411988957,0.0,20.0
37607,3,7607,[568  70  64 496 173],716,5,31159,4.0955573080967405,40.0,0.0
37608,3,7608,[318 427 185 515 313],655,5,31164,4.095676172953082,40.0,0.0
37609,3,7609,[111  70  97 385  64],344,2,31166,4.095400788436268,20.0,0.0
37610,3,7610,[197 318 423 174 471],655,1,31167,4.094994087504927,20.0,0.0
37611,3,7611,[318 427 185 515 313],655,5,31172,4.095112979506043,40.0,0.0
37612,3,7612,[222  82 117 200   9],655,1,31173,4.094706423223434,0.0,0.0
37613,3,7613,[ 97 143 180 238 403],796,2,31175,4.094431310743367,0.0,0.0
37614,3,7614,[ 15   9 435 515 655],655,1,31176,4.094024950755089,0.0,0.0
37615,3,7615,[318 427 185 515 313],655,5,31181,4.0941439075630255,40.0,0.0
37616,3,7616,[318 427 185 515 313],655,5,31186,4.094262833136406,40.0,0.0
37617,3,7617,[288 742  95 265 423],436,4,31190,4.094250459438173,0.0,0.0
37618,3,7618,[ 25 211 302 125   7],450,4,31194,4.094238088988056,0.0,0.0
37619,3,7619,[318 427 185 515 313],655,5,31199,4.094356955380578,40.0,0.0
37620,3,7620,[318 427 185 515 313],655,5,31204,4.094475790578664,40.0,0.0
37621,3,7621,[318 427 185 515 313],655,5,31209,4.094594594594595,40.0,0.0
37622,3,7622,[ 98 195 245 318 215],796,4,31213,4.0945821854912765,20.0,0.0
37623,3,7623,[318 427 185 515 313],655,5,31218,4.094700944386149,40.0,0.0
37624,3,7624,[318 427 185 515 313],655,5,31223,4.094819672131147,40.0,0.0
37625,3,7625,[176 357  15 294 202],655,1,31224,4.09441384736428,0.0,0.0
37626,3,7626,[568 271 269 182 300],796,4,31228,4.094401468467288,0.0,0.0
37627,3,7627,[318 427 185 515 313],655,5,31233,4.094520188778185,40.0,0.0
37628,3,7628,[318 427 185 515 313],655,5,31238,4.094638877965657,40.0,0.0
37629,3,7629,[318 427 185 515 313],655,5,31243,4.09475753604194,40.0,0.0
37630,3,7630,[ 98   7 176  25 546],577,3,31246,4.094614074171144,0.0,0.0
37631,3,7631,[185 100 405 357 748],401,3,31249,4.094470649895178,0.0,20.0
37632,3,7632,[194 273 603 202  88],401,4,31253,4.094458273287043,20.0,0.0
37633,3,7633,[318 427 185 515 313],655,5,31258,4.094576892847786,40.0,0.0
37634,3,7634,[318 427 185 515 313],655,5,31263,4.094695481335953,40.0,0.0
37635,3,7635,[318 427 185 515 313],655,5,31268,4.094814038763751,40.0,0.0
37636,3,7636,[742 228 568 265 186],655,0,31268,4.0942778577975645,0.0,0.0
37637,3,7637,[318 427 185 515 313],655,5,31273,4.09439643885834,40.0,0.0
37638,3,7638,[179 216 282 294 151],504,3,31276,4.09425317449928,0.0,0.0
37639,3,7639,[318 427 185 515 313],655,5,31281,4.094371727748691,40.0,0.0
37640,3,7640,[318 234  25 427  79],18,3,31284,4.094228504122497,40.0,0.0
37641,3,7641,[194  69 357 238 318],457,5,31289,4.09434702957341,20.0,0.0
37642,3,7642,[191 265 117  15 508],655,1,31290,4.0939421693052465,0.0,0.0
37643,3,7643,[175 202 195   7 515],269,2,31292,4.09366823652538,0.0,0.0
37644,3,7644,[194   7 257  96 282],296,5,31297,4.093786788750817,0.0,0.0
37645,3,7645,[318 427 185 515 313],655,5,31302,4.093905309965995,40.0,0.0
37646,3,7646,[318 427 185 515 313],655,5,31307,4.094023800183078,40.0,0.0
37647,3,7647,[318 427 185 515 313],655,5,31312,4.094142259414226,40.0,0.0
37648,3,7648,[257 187  22 181 302],655,2,31314,4.093868479539809,0.0,0.0
37649,3,7649,[180  82 588 121   7],786,4,31318,4.093856209150327,0.0,0.0
37650,3,7650,[318 742  12 427 143],450,5,31323,4.093974643837407,40.0,0.0
37651,3,7651,[182 180 483 286  64],796,3,31326,4.093831677992681,20.0,20.0
37652,3,7652,[174   1 237 234 471],716,4,31330,4.093819417222004,0.0,0.0
37653,3,7653,[318 427 185 515 313],655,5,31335,4.09393781029527,40.0,0.0
37654,3,7654,[318 427 185 515 313],655,5,31340,4.094056172436316,40.0,0.0
37655,3,7655,[ 22 196 588  50   4],457,5,31345,4.094174503657262,0.0,20.0
37656,3,7656,[318 427 185 515 313],655,5,31350,4.094292803970223,40.0,0.0
37657,3,7657,[318 427 185 515 313],655,5,31355,4.094411073387308,40.0,0.0
37658,3,7658,[318  96 202 194 135],269,3,31358,4.094268181224703,20.0,0.0
37659,3,7659,[275  70  56  96 174],655,1,31359,4.093864229765013,0.0,20.0
37660,3,7660,[588 181  69 515 100],18,3,31362,4.093721446286386,0.0,20.0
37661,3,7661,[111 228 202 245 187],450,5,31367,4.09383972853041,0.0,0.0
37662,3,7662,[132 210 183  96 191],450,4,31371,4.093827482709122,0.0,0.0
37663,3,7663,[  8 121 597 173 496],269,1,31372,4.093423799582464,20.0,0.0
37664,3,7664,[318 427 185 515 313],655,5,31377,4.0935420743639925,40.0,0.0
37665,3,7665,[168   9 257 215 216],796,4,31381,4.093529872162796,0.0,0.0
37666,3,7666,[318 427 185 515 313],655,5,31386,4.093648102256424,40.0,0.0
37667,3,7667,[  9 186  79 269 483],535,4,31390,4.093635889410537,0.0,0.0
37668,3,7668,[191 245 588 597 210],344,3,31393,4.093493284652497,0.0,0.0
37669,3,7669,[318 427 185 515 313],655,5,31398,4.093611473272491,40.0,0.0
37670,3,7670,[318 427 185 515 313],655,5,31403,4.093729631078086,40.0,0.0
37671,3,7671,[318 427 185 515 313],655,5,31408,4.093847758081335,40.0,0.0
37672,3,7672,[257 357 289 269 121],296,4,31412,4.093835527173205,0.0,0.0
37673,3,7673,[318 427 185 515 313],655,5,31417,4.093953609590826,40.0,0.0
37674,3,7674,[318 427 185 515 313],655,5,31422,4.094071661237785,40.0,0.0
37675,3,7675,[  9  89 195 423  96],72,4,31426,4.094059405940594,0.0,0.0
37676,3,7676,[318 427 185 515 313],655,5,31431,4.094177413051973,40.0,0.0
37677,3,7677,[328  96  89 211 187],796,4,31435,4.094165147173743,0.0,0.0
37678,3,7678,[318 427 185 515 313],655,5,31440,4.094283109779919,40.0,0.0
37679,3,7679,[275  71 427  15 435],389,4,31444,4.094270833333334,20.0,20.0
37680,3,7680,[748 318 216 322 181],401,2,31446,4.093998177320661,20.0,0.0
37681,3,7681,[318 427 185 515 313],655,5,31451,4.094116115594897,40.0,0.0
37682,3,7682,[318 427 185 515 313],655,5,31456,4.094234023168033,40.0,0.0
37683,3,7683,[318 427 185 515 313],655,5,31461,4.0943519000520565,40.0,0.0
37684,3,7684,[318 427 185 515 313],655,5,31466,4.094469746258946,40.0,0.0
37685,3,7685,[191  11 268 175 286],344,2,31468,4.094197241738225,0.0,20.0
37686,3,7686,[318 427 185 515 313],655,5,31473,4.094315077403408,40.0,0.0
37687,3,7687,[318 427 185 515 313],655,5,31478,4.094432882414152,40.0,0.0
37688,3,7688,[588 471 181 273 318],450,4,31482,4.094420600858369,20.0,0.0
37689,3,7689,[318 427 185 515 313],655,5,31487,4.0945383615084525,40.0,0.0
37690,3,7690,[318 427 185 515 313],655,5,31492,4.094656091535561,40.0,0.0
37691,3,7691,[ 79 313 568   7 318],693,5,31497,4.094773790951638,20.0,0.0
37692,3,7692,[318 427 185 515 313],655,5,31502,4.094891459768621,40.0,0.0
37693,3,7693,[196  69   8 210 176],269,0,31502,4.094359240966988,0.0,0.0
37694,3,7694,[181 234 300   8 258],807,3,31505,4.094217024041585,0.0,0.0
37695,3,7695,[265   4  56 423 235],457,4,31509,4.094204781704781,0.0,0.0
37696,3,7696,[318 427 185 515 313],655,5,31514,4.094322463297389,40.0,0.0
37697,3,7697,[275 185   7 135 173],450,4,31518,4.094310210444271,0.0,20.0
37698,3,7698,[ 50 294 235 191   9],457,3,31521,4.094168073775815,0.0,20.0
37699,3,7699,[182 655 228 235 546],457,3,31524,4.094025974025974,0.0,0.0
37700,3,7700,[318 427 185 515 313],655,5,31529,4.094143617711985,40.0,0.0
37701,3,7701,[173 187 111  98 322],629,4,31533,4.094131394443002,0.0,0.0
37702,3,7702,[181 143  12 174 385],151,4,31537,4.094119174347656,0.0,0.0
37703,3,7703,[568 655 471 269 132],655,0,31537,4.09358774662513,0.0,0.0
37704,3,7704,[318 427 185 515 313],655,5,31542,4.093705386112914,40.0,0.0
37705,3,7705,[318 210   4  89 546],450,3,31545,4.093563457046457,20.0,0.0
37706,3,7706,[121  70  71   1  56],535,3,31548,4.0934215648112104,0.0,0.0
37707,3,7707,[318 427 185 515 313],655,5,31553,4.093539180072652,40.0,0.0
37708,3,7708,[132  88 111 257 202],798,3,31556,4.093397327798677,0.0,0.0
37709,3,7709,[318 427 185 515 313],655,5,31561,4.093514915693904,40.0,0.0
37710,3,7710,[318 427 185 515 313],655,5,31566,4.09363247309039,40.0,0.0
37711,3,7711,[181 187 300   1   8],389,4,31570,4.093620331950207,0.0,0.0
37712,3,7712,[318 427 185 515 313],655,5,31575,4.093737845196421,40.0,0.0
37713,3,7713,[318 427 185 515 313],655,5,31580,4.09385532797511,40.0,0.0
37714,3,7714,[ 95 143 204 187 173],716,4,31584,4.093843162670123,0.0,0.0
37715,3,7715,[318 427 185 515 313],655,5,31589,4.093960601347849,40.0,0.0
37716,3,7716,[202  79 588 265 603],796,5,31594,4.094078009589219,20.0,0.0
37717,3,7717,[ 69 275 111 100  88],457,4,31598,4.0940658201606634,0.0,40.0
37718,3,7718,[318 427 185 515 313],655,5,31603,4.094183184350304,40.0,0.0
37719,3,7719,[318 427 185 515 313],655,5,31608,4.094300518134715,40.0,0.0
37720,3,7720,[323 228 678 742 546],256,4,31612,4.0942883046237535,0.0,0.0
37721,3,7721,[318 427 185 515 313],655,5,31617,4.094405594405594,40.0,0.0
37722,3,7722,[318 427 185 515 313],655,5,31622,4.094522853813285,40.0,0.0
37723,3,7723,[655 153 196 202 597],450,5,31627,4.094640082858622,0.0,0.0
37724,3,7724,[546 655 385  50  98],577,4,31631,4.0946278317152105,0.0,20.0
37725,3,7725,[300  11  25 427  56],11,2,31633,4.094356717577012,20.0,0.0
37726,3,7726,[127 238  89 603 185],655,4,31637,4.094344506276692,20.0,20.0
37727,3,7727,[318 427 185 515 313],655,5,31642,4.094461697722568,40.0,0.0
37728,3,7728,[204  79 234 235 515],807,3,31645,4.094320093155647,0.0,0.0
37729,3,7729,[286 237 185 222 357],655,2,31647,4.094049159120311,0.0,20.0
37730,3,7730,[318 427 185 515 313],655,5,31652,4.094166343293235,40.0,0.0
37731,3,7731,[655  70  82 183 215],151,2,31654,4.093895499224004,0.0,0.0
37732,3,7732,[318 427 185 515 313],655,5,31659,4.094012672960042,40.0,0.0
37733,3,7733,[196 173 215 100 179],639,0,31659,4.093483320403413,0.0,20.0
37734,3,7734,[273 186  56 423 238],450,3,31662,4.093341952165481,0.0,0.0
37735,3,7735,[202 185 742 210 546],504,4,31666,4.093329886246122,0.0,0.0
37736,3,7736,[318 100   9 185 588],401,3,31669,4.093188574382836,20.0,20.0
37737,3,7737,[318 427 185 515 313],655,5,31674,4.093305763763246,40.0,0.0
37738,3,7738,[ 88 427 100 235 144],450,4,31678,4.093293707197312,20.0,20.0
37739,3,7739,[318 427 185 515 313],655,5,31683,4.093410852713179,40.0,0.0
37740,3,7740,[318 427 185 515 313],655,5,31688,4.093527967962795,40.0,0.0
37741,3,7741,[318 427 185 515 313],655,5,31693,4.093645052957892,40.0,0.0
37742,3,7742,[ 97 181 210 238 294],504,2,31695,4.093374660984114,0.0,0.0
37743,3,7743,[127 111 135 282 118],292,4,31699,4.093362603305785,0.0,20.0
37744,3,7744,[ 96 483 191 195 655],269,3,31702,4.093221433182698,0.0,0.0
37745,3,7745,[318 427 185 515 313],655,5,31707,4.093338497288923,40.0,0.0
37746,3,7746,[222 483   8 195 180],457,5,31712,4.093455531173357,0.0,0.0
37747,3,7747,[318 427 185 515 313],655,5,31717,4.093572534847703,40.0,0.0
37748,3,7748,[ 82 245 403 405 385],280,1,31718,4.093173312685508,0.0,0.0
37749,3,7749,[191 204 271 174 173],629,4,31722,4.0931612903225805,0.0,0.0
37750,3,7750,[318 427 185 515 313],655,5,31727,4.093278286672687,40.0,0.0
37751,3,7751,[228 194 286 117 151],450,5,31732,4.093395252837977,0.0,20.0
37752,3,7752,[318 427 185 515 313],655,5,31737,4.093512188830131,40.0,0.0
37753,3,7753,[318 427 185 515 313],655,5,31742,4.0936290946608205,40.0,0.0
37754,3,7754,[318 427 185 515 313],655,5,31747,4.093745970341715,40.0,0.0
37755,3,7755,[302   1 300 211  22],535,1,31748,4.09334708612687,0.0,0.0
37756,3,7756,[318 427 185 515 313],655,5,31753,4.093463968028877,40.0,0.0
37757,3,7757,[222 288 183  56 483],292,3,31756,4.093323021397268,0.0,0.0
37758,3,7758,[ 96 235   4 173   7],280,3,31759,4.093182111096791,0.0,0.0
37759,3,7759,[318 427 185 515 313],655,5,31764,4.093298969072165,40.0,0.0
37760,3,7760,[194 268 322  22  50],629,4,31768,4.093286947558305,0.0,20.0
37761,3,7761,[318 427 185 515 313],655,5,31773,4.093403761917032,40.0,0.0
37762,3,7762,[546 161 427  82   8],577,4,31777,4.093391730001288,20.0,0.0
37763,3,7763,[318 427 185 515 313],655,5,31782,4.093508500772797,40.0,0.0
37764,3,7764,[318 427 185 515 313],655,5,31787,4.093625241468126,40.0,0.0
37765,3,7765,[318 427 185 515 313],655,5,31792,4.093741952098893,40.0,0.0
37766,3,7766,[318 427 185 515 313],655,5,31797,4.093858632676709,40.0,0.0
37767,3,7767,[318 427 185 515 313],655,5,31802,4.093975283213182,40.0,0.0
37768,3,7768,[318 427 185 515 313],655,5,31807,4.094091903719913,40.0,0.0
37769,3,7769,[318 427 185 515 313],655,5,31812,4.094208494208495,40.0,0.0
37770,3,7770,[318 427 185 515 313],655,5,31817,4.094325054690516,40.0,0.0
37771,3,7771,[228 194   1  98 187],296,5,31822,4.09444158517756,0.0,0.0
37772,3,7772,[318 427 185 515 313],655,5,31827,4.0945580856812045,40.0,0.0
37773,3,7773,[318 427 185 515 313],655,5,31832,4.094674556213017,40.0,0.0
37774,3,7774,[597 300  82 245 181],450,4,31836,4.094662379421222,0.0,0.0
37775,3,7775,[132 508 302 286 385],344,3,31839,4.094521604938271,0.0,20.0
37776,3,7776,[135 183 742  97 175],457,5,31844,4.094638035232094,0.0,0.0
37777,3,7777,[235 176 385 204 588],344,3,31847,4.0944973000771405,0.0,0.0
37778,3,7778,[318 427 185 515 313],655,5,31852,4.094613703560869,40.0,0.0
37779,3,7779,[153 180  95 186 323],796,2,31854,4.094344473007712,0.0,0.0
37780,3,7780,[318 427 185 515 313],655,5,31859,4.094460866212569,40.0,0.0
37781,3,7781,[276 423  95 182 483],18,5,31864,4.094577229503984,0.0,0.0
37782,3,7782,[318 427 185 515 313],655,5,31869,4.094693562893486,40.0,0.0
37783,3,7783,[143 176 318 211 483],796,4,31873,4.094681397738952,20.0,0.0
37784,3,7784,[322 176 121 204 546],151,2,31875,4.094412331406551,0.0,0.0
37785,3,7785,[161 125 215 357  25],450,4,31879,4.094400205497046,0.0,0.0
37786,3,7786,[ 64 118 405  96 168],292,3,31882,4.0942596635418,20.0,0.0
37787,3,7787,[  4  69  97 405 288],593,4,31886,4.094247560349255,0.0,0.0
37788,3,7788,[ 79  82 143 196 183],716,4,31890,4.094235460264476,0.0,0.0
37789,3,7789,[318 427 185 515 313],655,5,31895,4.094351732991014,40.0,0.0
37790,3,7790,[194 405 568  22 181],450,5,31900,4.094467975869593,0.0,0.0
37791,3,7791,[ 12 215 237   8 202],796,5,31905,4.094584188911704,0.0,0.0
37792,3,7792,[318 427 185 515 313],655,5,31910,4.094700372128834,40.0,0.0
37793,3,7793,[172 181 191 196 403],269,1,31911,4.0943033102386455,0.0,0.0
37794,3,7794,[202 210 265 222 603],151,5,31916,4.094419499679281,20.0,0.0
37795,3,7795,[318 427 185 515 313],655,5,31921,4.094535659312468,40.0,0.0
37796,3,7796,[318 427 185 515 313],655,5,31926,4.0946517891496725,40.0,0.0
37797,3,7797,[ 79 197  69 117 237],72,4,31930,4.0946396511926135,0.0,0.0
37798,3,7798,[187  64 269 234 196],629,4,31934,4.0946275163482495,20.0,0.0
37799,3,7799,[144 568  56 117  71],593,5,31939,4.094743589743589,0.0,0.0
37800,3,7800,[318 427 185 515 313],655,5,31944,4.094859633380336,40.0,0.0
37801,3,7801,[197  56  96 211 257],796,3,31947,4.094719302742886,0.0,0.0
37802,3,7802,[318 427 185 515 313],655,5,31952,4.094835319748815,40.0,0.0
37803,3,7803,[151 300 185 195 318],450,5,31957,4.09495130702204,20.0,0.0
37804,3,7804,[318 427 185 515 313],655,5,31962,4.095067264573991,40.0,0.0
37805,3,7805,[ 88 172 176 357 302],269,1,31963,4.0946707660773765,0.0,0.0
37806,3,7806,[318 427 185 515 313],655,5,31968,4.0947867298578196,40.0,0.0
37807,3,7807,[125 294 143 328 273],655,2,31970,4.094518442622951,0.0,0.0
37808,3,7808,[318 427 185 515 313],655,5,31975,4.094634396209502,40.0,0.0
37809,3,7809,[228  50 187 117 180],796,4,31979,4.094622279129322,0.0,20.0
37810,3,7810,[180  82 182 181 210],450,3,31982,4.09448214057099,0.0,0.0
37811,3,7811,[318 427 185 515 313],655,5,31987,4.094598054275473,40.0,0.0
37812,3,7812,[318 427 185 515 313],655,5,31992,4.094713938307948,40.0,0.0
37813,3,7813,[ 50  97 275 111 197],18,4,31996,4.094701817251088,0.0,40.0
37814,3,7814,[174 191 403 161 748],798,4,32000,4.094689699296225,0.0,0.0
37815,3,7815,[318 427 185 515 313],655,5,32005,4.094805527123849,40.0,0.0
37816,3,7816,[183 216 318 187 269],503,5,32010,4.0949213253166175,20.0,0.0
37817,3,7817,[273 173 181 322 151],344,3,32013,4.0947812739831155,0.0,0.0
37818,3,7818,[318 427 185 515 313],655,5,32018,4.094897045658013,40.0,0.0
37819,3,7819,[318 427 185 515 313],655,5,32023,4.095012787723785,40.0,0.0
37820,3,7820,[318 427 185 515 313],655,5,32028,4.095128500191791,40.0,0.0
37821,3,7821,[318 427 185 515 313],655,5,32033,4.095244183073382,40.0,0.0
37822,3,7822,[  7 222 118  98  12],655,1,32034,4.094848523584303,0.0,0.0
37823,3,7823,[318 427 185 515 313],655,5,32039,4.094964212678937,40.0,0.0
37824,3,7824,[  1 496 269 172 275],450,5,32044,4.095079872204473,20.0,20.0
37825,3,7825,[318 427 185 515 313],655,5,32049,4.095195502172246,40.0,0.0
37826,3,7826,[318 427 185 515 313],655,5,32054,4.095311102593587,40.0,0.0
37827,3,7827,[318 427 185 515 313],655,5,32059,4.095426673479816,40.0,0.0
37828,3,7828,[175 144  98 546 153],23,3,32062,4.095286754374761,0.0,0.0
37829,3,7829,[275 173 294 153  79],23,4,32066,4.095274584929757,0.0,20.0
37830,3,7830,[237 172 357   4  79],535,1,32067,4.094879325756608,0.0,0.0
37831,3,7831,[179 245 125  22  25],450,4,32071,4.094867211440246,0.0,0.0
37832,3,7832,[ 69 185 216 135 118],151,4,32075,4.09485510021703,0.0,0.0
37833,3,7833,[403 211  88 275 181],796,4,32079,4.09484299208578,0.0,20.0
37834,3,7834,[318 427 185 515 313],655,5,32084,4.094958519463944,40.0,0.0
37835,3,7835,[318 427 185 515 313],655,5,32089,4.095074017355794,40.0,0.0
37836,3,7836,[318 427 185 515 313],655,5,32094,4.095189485772617,40.0,0.0
37837,3,7837,[318 427 185 515 313],655,5,32099,4.095304924725696,40.0,0.0
37838,3,7838,[ 15 179 435 483 216],450,3,32102,4.095165199642811,0.0,0.0
37839,3,7839,[257  96 194 238 100],23,4,32106,4.09515306122449,0.0,20.0
37840,3,7840,[ 56 186 234 144   7],457,5,32111,4.095268460655529,0.0,0.0
37841,3,7841,[318 427 185 515 313],655,5,32116,4.095383830655445,40.0,0.0
37842,3,7842,[215 238  70 153 210],655,0,32116,4.094861660079052,0.0,0.0
37843,3,7843,[238 181 237 423 179],457,5,32121,4.094977052524222,0.0,0.0
37844,3,7844,[132 135 405 211 258],450,4,32125,4.0949649458253665,0.0,0.0
37845,3,7845,[273  97 215   8 603],655,2,32127,4.094697935253633,20.0,0.0
37846,3,7846,[588 186 117 403 435],807,4,32131,4.094685867210399,0.0,0.0
37847,3,7847,[318 427 185 515 313],655,5,32136,4.09480122324159,40.0,0.0
37848,3,7848,[313  79 186  88 282],450,4,32140,4.094789145114027,0.0,0.0
37849,3,7849,[211  56 238  70 202],18,4,32144,4.094777070063694,0.0,0.0
37850,3,7850,[546 182 588 222 191],796,5,32149,4.094892370398675,0.0,0.0
37851,3,7851,[210 288   7 265 597],450,3,32152,4.094752929190015,0.0,0.0
37852,3,7852,[257  71 210  88 318],796,4,32156,4.094740863364319,20.0,0.0
37853,3,7853,[197 216 132  97 127],693,4,32160,4.094728800611153,0.0,20.0
37854,3,7854,[318 427 185 515 313],655,5,32165,4.09484404837683,40.0,0.0
37855,3,7855,[318 427 185 515 313],655,5,32170,4.094959266802444,40.0,0.0
37856,3,7856,[318 427 185 515 313],655,5,32175,4.095074455899198,40.0,0.0
37857,3,7857,[ 97 181 385 286 655],796,2,32177,4.094807839144821,0.0,20.0
37858,3,7858,[318 427 185 515 313],655,5,32182,4.094923018195699,40.0,0.0
37859,3,7859,[210 135 111 216 322],401,3,32185,4.094783715012722,0.0,0.0
37860,3,7860,[  1 194 161 175 597],457,4,32189,4.09477165754993,0.0,0.0
37861,3,7861,[174 318 427 286 423],151,5,32194,4.094886797252608,40.0,20.0
37862,3,7862,[ 56  88 265 196 546],236,2,32196,4.094620373903091,0.0,0.0
37863,3,7863,[742  56   1 197 127],280,4,32200,4.094608341810783,0.0,20.0
37864,3,7864,[56 11  4 12 79],256,4,32204,4.094596312778131,0.0,0.0
37865,3,7865,[318 427 185 515 313],655,5,32209,4.094711416221713,40.0,0.0
37866,3,7866,[234 181 197  96 568],655,0,32209,4.094190924113385,0.0,0.0
37867,3,7867,[603  95  82 132 318],18,3,32212,4.094051855617692,40.0,0.0
37868,3,7868,[286 405  64 268 183],344,2,32214,4.093785741517347,20.0,20.0
37869,3,7869,[ 50 288 111 235 202],457,3,32217,4.093646759847522,0.0,20.0
37870,3,7870,[318 427 185 515 313],655,5,32222,4.093761910811841,40.0,0.0
37871,3,7871,[318 427 185 515 313],655,5,32227,4.093877032520325,40.0,0.0
37872,3,7872,[318 427 185 515 313],655,5,32232,4.093992124984123,40.0,0.0
37873,3,7873,[180 427 186 546 655],716,2,32234,4.093726187452375,20.0,0.0
37874,3,7874,[245 132 300 269 275],629,3,32237,4.093587301587301,0.0,20.0
37875,3,7875,[174 286 301  11 568],344,3,32240,4.09344845099035,0.0,20.0
37876,3,7876,[318 427 185 515 313],655,5,32245,4.09356353941856,40.0,0.0
37877,3,7877,[597 144 427  71 322],796,4,32249,4.0935516628585935,20.0,0.0
37878,3,7878,[318 427 185 515 313],655,5,32254,4.09366670897322,40.0,0.0
37879,3,7879,[483 282 117 172 655],716,4,32258,4.093654822335026,0.0,0.0
37880,3,7880,[215 423 328 546 427],450,5,32263,4.093769826164192,20.0,0.0
37881,3,7881,[ 69   1 153 435  97],503,3,32266,4.093631058107079,0.0,0.0
37882,3,7882,[318 427 185 515 313],655,5,32271,4.093746035773183,40.0,0.0
37883,3,7883,[318 427 185 515 313],655,5,32276,4.093860984271943,40.0,0.0
37884,3,7884,[318 427 185 515 313],655,5,32281,4.093975903614457,40.0,0.0
37885,3,7885,[237 216   4 496 204],577,5,32286,4.0940907938118185,20.0,0.0
37886,3,7886,[318 427 185 515 313],655,5,32291,4.094205654875111,40.0,0.0
37887,3,7887,[275  88 168 597 471],450,5,32296,4.094320486815416,0.0,20.0
37888,3,7888,[483 257 186 515 655],655,2,32298,4.094055013309672,0.0,0.0
37889,3,7889,[286 257 179 183 405],835,2,32300,4.093789607097592,0.0,20.0
37890,3,7890,[318 427 185 515 313],655,5,32305,4.0939044481054365,40.0,0.0
37891,3,7891,[172 237 276 204 100],280,1,32306,4.093512417638115,0.0,20.0
37892,3,7892,[318 427 185 515 313],655,5,32311,4.093627264664893,40.0,0.0
37893,3,7893,[318 427 185 515 313],655,5,32316,4.0937420825943756,40.0,0.0
37894,3,7894,[318 427 185 515 313],655,5,32321,4.093856871437619,40.0,0.0
37895,3,7895,[318 427 185 515 313],655,5,32326,4.093971631205674,40.0,0.0
37896,3,7896,[603 211  25 471 111],401,5,32331,4.094086361909586,20.0,0.0
37897,3,7897,[127 302 235  82 276],269,2,32333,4.093821220562168,0.0,20.0
37898,3,7898,[318 427 185 515 313],655,5,32338,4.093935941258387,40.0,0.0
37899,3,7899,[318 427 185 515 313],655,5,32343,4.094050632911393,40.0,0.0
37900,3,7900,[  8 313  22 423 568],796,5,32348,4.094165295532211,0.0,0.0
37901,3,7901,[318 427 185 515 313],655,5,32353,4.094279929131865,40.0,0.0
37902,3,7902,[318 427 185 515 313],655,5,32358,4.094394533721371,40.0,0.0
37903,3,7903,[318  50 515 435 127],716,5,32363,4.0945091093117405,20.0,40.0
37904,3,7904,[176 195 496 423 588],796,5,32368,4.094623655913979,20.0,0.0
37905,3,7905,[515 546 197 234 211],716,4,32372,4.094611687326082,0.0,0.0
37906,3,7906,[318 427 185 515 313],655,5,32377,4.094726191981788,40.0,0.0
37907,3,7907,[175 179 168 234  79],457,5,32382,4.094840667678301,0.0,0.0
37908,3,7908,[483  69 202 143 748],450,4,32386,4.09482867619168,0.0,0.0
37909,3,7909,[318 427 185 515 313],655,5,32391,4.094943109987358,40.0,0.0
37910,3,7910,[318 427 185 515 313],655,5,32396,4.095057514852737,40.0,0.0
37911,3,7911,[125 135   7 204 282],655,1,32397,4.094666329625885,0.0,0.0
37912,3,7912,[318 427 185 515 313],655,5,32402,4.09478074055352,40.0,0.0
37913,3,7913,[301 275 385 655 186],655,1,32403,4.0943896891584535,0.0,20.0
37914,3,7914,[328 288 125 435 111],655,0,32403,4.09387239418825,0.0,0.0
37915,3,7915,[427   9 603 276 268],269,5,32408,4.093986862051541,40.0,0.0
37916,3,7916,[318 427 185 515 313],655,5,32413,4.094101300997853,40.0,0.0
37917,3,7917,[135 118 183 174  11],292,4,32417,4.094089416519323,0.0,0.0
37918,3,7918,[  7  15 357 427 588],450,4,32421,4.094077535042303,20.0,0.0
37919,3,7919,[318 427 185 515 313],655,5,32426,4.094191919191919,40.0,0.0
37920,3,7920,[423 515 202 144 403],655,1,32427,4.093801287716198,0.0,0.0
37921,3,7921,[318 427 185 515 313],655,5,32432,4.093915677859126,40.0,0.0
37922,3,7922,[  1  56 313  70  12],280,4,32436,4.093903824308974,0.0,0.0
37923,3,7923,[258 202 153 197  50],655,1,32437,4.093513377082282,0.0,20.0
37924,3,7924,[318 427 185 515 313],655,5,32442,4.093627760252366,40.0,0.0
37925,3,7925,[471 144 403 127  11],693,3,32445,4.0934897804693415,0.0,20.0
37926,3,7926,[161 228 271  64 427],72,3,32448,4.093351835498928,40.0,0.0
37927,3,7927,[216 181 182 111 183],655,3,32451,4.093213925327952,0.0,0.0
37928,3,7928,[318 427 185 515 313],655,5,32456,4.093328288560978,40.0,0.0
37929,3,7929,[318 427 185 515 313],655,5,32461,4.093442622950819,40.0,0.0
37930,3,7930,[234 475 238 143   4],655,1,32462,4.093052578489472,0.0,0.0
37931,3,7931,[385 144 168  95 135],5,3,32465,4.092914775592536,0.0,0.0
37932,3,7932,[318  98 288 405 568],457,5,32470,4.0930291188705406,20.0,0.0
37933,3,7933,[748  22 568  89 234],796,4,32474,4.0930173934963445,0.0,0.0
37934,3,7934,[174  96 323  15 153],796,4,32478,4.0930056710775045,0.0,0.0
37935,3,7935,[748 328   8 403 427],796,5,32483,4.093119959677419,20.0,0.0
37936,3,7936,[318 427 185 515 313],655,5,32488,4.093234219478393,40.0,0.0
37937,3,7937,[603 742 186 173 175],264,4,32492,4.093222474174855,20.0,0.0
37938,3,7938,[121 258 111  25 286],15,1,32493,4.092832850484948,0.0,20.0
37939,3,7939,[318 427 185 515 313],655,5,32498,4.092947103274559,40.0,0.0
37940,3,7940,[318 427 185 515 313],655,5,32503,4.093061327288755,40.0,0.0
37941,3,7941,[318 427 185 515 313],655,5,32508,4.093175522538403,40.0,0.0
37942,3,7942,[ 71 132 222  25   8],344,4,32512,4.093163792018129,0.0,0.0
37943,3,7943,[258 568  11  15 237],655,0,32512,4.092648539778449,0.0,0.0
37944,3,7944,[118 173 423 276 483],292,4,32516,4.092636878539962,0.0,0.0
37945,3,7945,[318 427 185 515 313],655,5,32521,4.092751069720614,40.0,0.0
37946,3,7946,[423  12 427 176 300],693,2,32523,4.092487731219328,20.0,0.0
37947,3,7947,[318 427 185 515 313],655,5,32528,4.0926019124308,40.0,0.0
37948,3,7948,[216 153 286  89 483],321,4,32532,4.092590262926154,0.0,20.0
37949,3,7949,[151 191  56 215 179],450,5,32537,4.092704402515723,0.0,0.0
37950,3,7950,[181 237   8 216 161],655,1,32538,4.092315432021129,0.0,0.0
37951,3,7951,[568 185 300 111 191],716,5,32543,4.092429577464789,0.0,0.0
37952,3,7952,[318 427 185 515 313],655,5,32548,4.092543694203445,40.0,0.0
37953,3,7953,[483  15  12 238 185],457,5,32553,4.092657782247926,0.0,0.0
37954,3,7954,[302 228  97 174 204],450,5,32558,4.092771841609051,0.0,0.0
37955,3,7955,[185 202 237 173 258],457,5,32563,4.092885872297637,0.0,0.0
37956,3,7956,[ 11  95 161 483 215],716,4,32567,4.0928741988186506,0.0,0.0
37957,3,7957,[180 237 268 173 238],11,3,32570,4.09273686855994,0.0,0.0
37958,3,7958,[318 427 185 515 313],655,5,32575,4.092850860660887,40.0,0.0
37959,3,7959,[678 187 174 125 197],504,4,32579,4.0928391959798995,0.0,0.0
37960,3,7960,[222 100  22 174 288],450,3,32582,4.092701921869112,0.0,20.0
37961,3,7961,[  1 181 118 742 211],593,4,32586,4.092690278824416,0.0,0.0
37962,3,7962,[318 427 185 515 313],655,5,32591,4.092804219515258,40.0,0.0
37963,3,7963,[318 427 185 515 313],655,5,32596,4.092918131592165,40.0,0.0
37964,3,7964,[318 427 185 515 313],655,5,32601,4.093032015065913,40.0,0.0
37965,3,7965,[ 64  69  11 234 742],693,1,32602,4.09264373587748,20.0,0.0
37966,3,7966,[318 427 185 515 313],655,5,32607,4.092757625203967,40.0,0.0
37967,3,7967,[423 265 427 328 216],942,4,32611,4.092745983935743,20.0,0.0
37968,3,7968,[318 427 185 515 313],655,5,32616,4.092859831848412,40.0,0.0
37969,3,7969,[318 427 185 515 313],655,5,32621,4.09297365119197,40.0,0.0
37970,3,7970,[258   1 185 127 172],655,3,32624,4.092836532430059,0.0,20.0
37971,3,7971,[180 173 423 181 215],450,5,32629,4.092950326141495,0.0,0.0
37972,3,7972,[237 174 195 275  97],450,5,32634,4.093064091308165,0.0,20.0
37973,3,7973,[318 427 185 515 313],655,5,32639,4.093177827940807,40.0,0.0
37974,3,7974,[423 357 471 483  98],450,4,32643,4.093166144200627,0.0,0.0
37975,3,7975,[471 515 187 435 318],655,3,32646,4.093029087261785,20.0,0.0
37976,3,7976,[318 427 185 515 313],655,5,32651,4.093142785508337,40.0,0.0
37977,3,7977,[318 427 185 515 313],655,5,32656,4.093256455251943,40.0,0.0
37978,3,7978,[ 11 117 302 182 196],655,2,32658,4.092994109537536,0.0,0.0
37979,3,7979,[318 427 185 515 313],655,5,32663,4.0931077694235585,40.0,0.0
37980,3,7980,[318 427 185 515 313],655,5,32668,4.093221400826964,40.0,0.0
37981,3,7981,[245 125  97  70 328],224,2,32670,4.092959158105738,0.0,0.0
37982,3,7982,[181 151 125 174 183],292,4,32674,4.0929475134661155,0.0,0.0
37983,3,7983,[748 405 282 678  82],280,0,32674,4.092434869739479,0.0,0.0
37984,3,7984,[318 427 185 515 313],655,5,32679,4.09254852849092,40.0,0.0
37985,3,7985,[ 89 471 118 174 435],655,1,32680,4.092161282243927,0.0,0.0
37986,3,7986,[318 427 185 515 313],655,5,32685,4.092274946788532,40.0,0.0
37987,3,7987,[161 194 265 204 117],450,5,32690,4.092388582874311,0.0,0.0
37988,3,7988,[318 427 185 515 313],655,5,32695,4.092502190511954,40.0,0.0
37989,3,7989,[318 427 185 515 313],655,5,32700,4.092615769712141,40.0,0.0
37990,3,7990,[318 427 185 515 313],655,5,32705,4.092729320485546,40.0,0.0
37991,3,7991,[318 427 185 515 313],655,5,32710,4.092842842842843,40.0,0.0
37992,3,7992,[ 25 215 204  79 403],18,1,32711,4.092455898911548,0.0,0.0
37993,3,7993,[200 655 265 195 294],796,3,32714,4.092319239429572,0.0,0.0
37994,3,7994,[318 427 185 515 313],655,5,32719,4.092432770481551,40.0,0.0
37995,3,7995,[318 427 185 515 313],655,5,32724,4.092546273136568,40.0,0.0
37996,3,7996,[318 427 185 515 313],655,5,32729,4.092659747405277,40.0,0.0
37997,3,7997,[117 234  11 200 258],457,5,32734,4.092773193298324,0.0,0.0
37998,3,7998,[200  11  25 275  15],330,5,32739,4.092886610826353,0.0,20.0
37999,3,7999,[318 427 185 515 313],655,5,32744,4.093,40.0,0.0
38000,3,8000,[111   9 125 135 435],401,2,32746,4.092738407699038,0.0,0.0
38001,3,8001,[168 181 151 546 161],504,4,32750,4.092726818295426,0.0,0.0
38002,3,8002,[313  79 483 161   7],693,3,32753,4.092590278645508,0.0,0.0
38003,3,8003,[ 82 265 546 403 185],796,4,32757,4.092578710644678,0.0,0.0
38004,3,8004,[174 200 151 237 185],457,5,32762,4.092692067457839,0.0,0.0
38005,3,8005,[ 69 258 222 294 176],655,0,32762,4.092180864351736,0.0,0.0
38006,3,8006,[187 300 195 603 435],535,3,32765,4.092044461096541,20.0,0.0
38007,3,8007,[318 427 185 515 313],655,5,32770,4.092157842157842,40.0,0.0
38008,3,8008,[ 50 144 603 301 228],796,4,32774,4.092146335372706,20.0,20.0
38009,3,8009,[144 289 216   9 197],655,1,32775,4.091760299625468,0.0,0.0
38010,3,8010,[318 427 185 515 313],655,5,32780,4.0918736736986645,40.0,0.0
38011,3,8011,[318 427 185 515 313],655,5,32785,4.0919870194707935,40.0,0.0
38012,3,8012,[435 173 168 211 204],535,5,32790,4.092100336952452,0.0,0.0
38013,3,8013,[318 427 185 515 313],655,5,32795,4.09221362615423,40.0,0.0
38014,3,8014,[318 204 143 237  69],450,5,32800,4.092326887086712,20.0,0.0
38015,3,8015,[273 210   9  15 238],655,1,32801,4.091941117764471,0.0,0.0
38016,3,8016,[  8 180  70 216 183],269,0,32801,4.091430709741799,0.0,0.0
38017,3,8017,[318 427 185 515 313],655,5,32806,4.091544025941631,40.0,0.0
38018,3,8018,[318 427 185 515 313],655,5,32811,4.091657313879536,40.0,0.0
38019,3,8019,[318 427 185 515 313],655,5,32816,4.091770573566085,40.0,0.0
38020,3,8020,[257 118 117 181 174],457,4,32820,4.091759132277771,0.0,0.0
38021,3,8021,[185 385 204  69 186],503,3,32823,4.091623036649215,0.0,0.0
38022,3,8022,[546 655 210 215 161],796,3,32826,4.091486974947028,0.0,0.0
38023,3,8023,[318 427 185 515 313],655,5,32831,4.091600199401794,40.0,0.0
38024,3,8024,[318 427 185 515 313],655,5,32836,4.091713395638629,40.0,0.0
38025,3,8025,[471  97 258  89 568],655,1,32837,4.091328183403937,0.0,0.0
38026,3,8026,[318 427 185 515 313],655,5,32842,4.091441385324529,40.0,0.0
38027,3,8027,[111 215 748 302 161],450,5,32847,4.091554559043348,0.0,0.0
38028,3,8028,[318 427 185 515 313],655,5,32852,4.091667704570931,40.0,0.0
38029,3,8029,[182  96 268 175 161],655,1,32853,4.091282689912827,0.0,0.0
38030,3,8030,[ 88 172 508 161  56],693,1,32854,4.090897771136845,0.0,0.0
38031,3,8031,[333 135 405 318   1],655,2,32856,4.090637450199203,20.0,0.0
38032,3,8032,[ 64  28 127 204 257],716,5,32861,4.090750653554089,20.0,20.0
38033,3,8033,[318 427 185 515 313],655,5,32866,4.090863828727906,40.0,0.0
38034,3,8034,[318 427 185 515 313],655,5,32871,4.090976975731176,40.0,0.0
38035,3,8035,[265 111 197 471 118],280,2,32873,4.090716774514684,0.0,0.0
38036,3,8036,[185 222 301  50 385],450,4,32877,4.090705487122061,0.0,20.0
38037,3,8037,[318 427 185 515 313],655,5,32882,4.0908186115949245,40.0,0.0
38038,3,8038,[234 187 181 161  25],716,3,32885,4.090682920761289,0.0,0.0
38039,3,8039,[403 180  89 185 175],457,5,32890,4.090796019900497,0.0,0.0
38040,3,8040,[318 427 185 515 313],655,5,32895,4.090909090909091,40.0,0.0
38041,3,8041,[ 82 435  25 228 195],450,3,32898,4.090773439442924,0.0,0.0
38042,3,8042,[323 153 322 215 300],796,3,32901,4.0906378217083175,0.0,0.0
38043,3,8043,[ 82 121 200  97 173],796,3,32904,4.09050223769269,0.0,0.0
38044,3,8044,[318 427 185 515 313],655,5,32909,4.090615288999379,40.0,0.0
38045,3,8045,[318 427 185 515 313],655,5,32914,4.090728312204822,40.0,0.0
38046,3,8046,[318 427 185 515 313],655,5,32919,4.090841307319498,40.0,0.0
38047,3,8047,[318 427 185 515 313],655,5,32924,4.0909542743538765,40.0,0.0
38048,3,8048,[127  15   1 568 475],655,1,32925,4.090570257174805,0.0,20.0
38049,3,8049,[ 69 427 187 568 186],655,2,32927,4.090310559006211,20.0,0.0
38050,3,8050,[318 427 185 515 313],655,5,32932,4.090423549869581,40.0,0.0
38051,3,8051,[318 427 185 515 313],655,5,32937,4.0905365126676605,40.0,0.0
38052,3,8052,[318 427 185 515 313],655,5,32942,4.090649447410903,40.0,0.0
38053,3,8053,[318 427 185 515 313],655,5,32947,4.090762354109759,40.0,0.0
38054,3,8054,[318 427 185 515 313],655,5,32952,4.090875232774674,40.0,0.0
38055,3,8055,[435  69 135 143 191],401,3,32955,4.090739821251241,0.0,0.0
38056,3,8056,[318 427 185 515 313],655,5,32960,4.0908526746928136,40.0,0.0
38057,3,8057,[318 427 185 515 313],655,5,32965,4.0909655001241,40.0,0.0
38058,3,8058,[318 427 185 515 313],655,5,32970,4.091078297555528,40.0,0.0
38059,3,8059,[318 427 185 515 313],655,5,32975,4.091191066997519,40.0,0.0
38060,3,8060,[271 204 282 234 182],655,1,32976,4.09080759211016,0.0,0.0
38061,3,8061,[222 191 185 405 181],655,2,32978,4.0905482510543285,0.0,0.0
38062,3,8062,[153  64 111  79 215],18,3,32981,4.090412997643557,20.0,0.0
38063,3,8063,[185 144 271 191  56],796,5,32986,4.0905257936507935,0.0,0.0
38064,3,8064,[ 11 471 118 127 275],457,5,32991,4.090638561686299,0.0,40.0
38065,3,8065,[318 427 185 515 313],655,5,32996,4.090751301760476,40.0,0.0
38066,3,8066,[135 234  82   1 175],18,2,32998,4.0904921284244455,0.0,0.0
38067,3,8067,[235 183 742 405   1],344,1,32999,4.090109072880516,0.0,0.0
38068,3,8068,[ 50   9 121 202 151],344,4,33003,4.090097905564506,0.0,20.0
38069,3,8069,[318 427 185 515 313],655,5,33008,4.090210656753408,40.0,0.0
38070,3,8070,[ 96 181   9 234 237],457,5,33013,4.090323380002478,0.0,0.0
38071,3,8071,[125 423 197 196   1],796,3,33016,4.090188305252726,0.0,0.0
38072,3,8072,[318  11 276 161  25],457,5,33021,4.090301003344481,20.0,0.0
38073,3,8073,[742  56 237  12 289],655,0,33021,4.089794401783503,0.0,0.0
38074,3,8074,[ 82  25 186 289 238],655,0,33021,4.089287925696595,0.0,0.0
38075,3,8075,[318 427 185 515 313],655,5,33026,4.08940069341258,40.0,0.0
38076,3,8076,[301 125 173  50 245],796,3,33029,4.089265816516034,0.0,20.0
38077,3,8077,[318 427 185 515 313],655,5,33034,4.08937855904927,40.0,0.0
38078,3,8078,[318 427 185 515 313],655,5,33039,4.089491273672484,40.0,0.0
38079,3,8079,[318 427 185 515 313],655,5,33044,4.0896039603960395,40.0,0.0
38080,3,8080,[318 427 185 515 313],655,5,33049,4.089716619230293,40.0,0.0
38081,3,8081,[318 427 185 515 313],655,5,33054,4.0898292501855975,40.0,0.0
38082,3,8082,[132  12  69 204 144],655,0,33054,4.0893232710627245,0.0,0.0
38083,3,8083,[ 15  97 483  82 151],457,5,33059,4.08943592281049,0.0,0.0
38084,3,8084,[318 427 185 515 313],655,5,33064,4.089548546691404,40.0,0.0
38085,3,8085,[318 427 185 515 313],655,5,33069,4.089661142715805,40.0,0.0
38086,3,8086,[318 427 185 515 313],655,5,33074,4.089773710894027,40.0,0.0
38087,3,8087,[318 427 185 515 313],655,5,33079,4.0898862512364,40.0,0.0
38088,3,8088,[318 427 185 515 313],655,5,33084,4.089998763753245,40.0,0.0
38089,3,8089,[173 435 211 186  79],535,4,33088,4.089987639060569,0.0,0.0
38090,3,8090,[318 427 185 515 313],655,5,33093,4.0901001112347055,40.0,0.0
38091,3,8091,[286 135 118 568  69],280,3,33096,4.0899653979238755,0.0,20.0
38092,3,8092,[318 427 185 515 313],655,5,33101,4.090077845051279,40.0,0.0
38093,3,8093,[318 427 185 515 313],655,5,33106,4.090190264393378,40.0,0.0
38094,3,8094,[318 427 185 515 313],655,5,33111,4.090302655960469,40.0,0.0
38095,3,8095,[318 427 185 515 313],655,5,33116,4.090415019762846,40.0,0.0
38096,3,8096,[318 427 185 515 313],655,5,33121,4.090527355810794,40.0,0.0
38097,3,8097,[ 22   4  12 100 185],655,1,33122,4.090145714991356,0.0,20.0
38098,3,8098,[ 64 655 215 301   7],655,1,33123,4.089764168415853,20.0,0.0
38099,3,8099,[ 15  89 228 183 357],796,5,33128,4.0898765432098765,0.0,0.0
38100,3,8100,[ 79 300 168 273  98],450,4,33132,4.089865448710036,0.0,0.0
38101,3,8101,[ 82 475 294 357 121],655,1,33133,4.089484078005431,0.0,0.0
38102,3,8102,[ 97 546 216 427 294],796,3,33136,4.089349623596199,20.0,0.0
38103,3,8103,[174 273  97 234 301],450,3,33139,4.089215202369201,0.0,0.0
38104,3,8104,[318 427 185 515 313],655,5,33144,4.0893275755706355,40.0,0.0
38105,3,8105,[318 427 185 515 313],655,5,33149,4.0894399210461385,40.0,0.0
38106,3,8106,[318  82 111 176  88],450,4,33153,4.089428888614777,20.0,0.0
38107,3,8107,[318 427 185 515 313],655,5,33158,4.089541193882585,40.0,0.0
38108,3,8108,[202 496 100 194   8],269,3,33161,4.089406831915156,20.0,20.0
38109,3,8109,[ 88 265 357  28 301],151,5,33166,4.089519112207151,0.0,0.0
38110,3,8110,[  4  69 435  28 111],151,5,33171,4.089631364813217,0.0,0.0
38111,3,8111,[238 111 210  12 245],450,4,33175,4.089620315581854,0.0,0.0
38112,3,8112,[265 196 210 121 183],655,1,33176,4.089239492173055,0.0,0.0
38113,3,8113,[496  11 185   7 237],535,5,33181,4.089351737737244,20.0,0.0
38114,3,8114,[597 245 181 301  22],796,3,33184,4.089217498459643,0.0,0.0
38115,3,8115,[ 82 275 179 132 385],457,5,33189,4.089329719073435,0.0,20.0
38116,3,8116,[196 603 179 597 132],450,5,33194,4.089441912036467,20.0,0.0
38117,3,8117,[318 427 185 515 313],655,5,33199,4.089554077358955,40.0,0.0
38118,3,8118,[318 427 185 515 313],655,5,33204,4.089666215051115,40.0,0.0
38119,3,8119,[318 204 185 328 235],450,4,33208,4.089655172413793,20.0,0.0
38120,3,8120,[318 427 185 515 313],655,5,33213,4.089767270040635,40.0,0.0
38121,3,8121,[318 427 185 515 313],655,5,33218,4.089879340064024,40.0,0.0
38122,3,8122,[183   1 655 228  89],450,5,33223,4.089991382494152,0.0,0.0
38123,3,8123,[318 427 185 515 313],655,5,33228,4.0901033973412115,40.0,0.0
38124,3,8124,[318 427 185 515 313],655,5,33233,4.090215384615385,40.0,0.0
38125,3,8125,[318 427 185 515 313],655,5,33238,4.090327344326852,40.0,0.0
38126,3,8126,[318 427 185 515 313],655,5,33243,4.090439276485788,40.0,0.0
38127,3,8127,[ 89 234 175   9  15],457,5,33248,4.090551181102362,0.0,0.0
38128,3,8128,[301 200 313 286 186],655,2,33250,4.090294009103211,0.0,20.0
38129,3,8129,[237 180 234 100 228],72,3,33253,4.090159901599016,0.0,20.0
38130,3,8130,[ 71 125 204  12 427],796,5,33258,4.090271799286681,20.0,0.0
38131,3,8131,[271 237 200 234 258],796,4,33262,4.09026069847516,0.0,0.0
38132,3,8132,[318 427 185 515 313],655,5,33267,4.090372556252305,40.0,0.0
38133,3,8133,[471 132 202 135 179],450,4,33271,4.090361445783133,0.0,0.0
38134,3,8134,[318 427 185 515 313],655,5,33276,4.090473263675476,40.0,0.0
38135,3,8135,[318 427 185 515 313],655,5,33281,4.09058505408063,40.0,0.0
38136,3,8136,[  4 273 357 215 222],655,2,33283,4.090328130760723,0.0,0.0
38137,3,8137,[318 427 185 515 313],655,5,33288,4.090439911526174,40.0,0.0
38138,3,8138,[ 89 135 294 265 234],457,4,33292,4.090428799606832,0.0,0.0
38139,3,8139,[ 12 194 172 275 127],503,4,33296,4.0904176904176905,0.0,40.0
38140,3,8140,[318 427 185 515 313],655,5,33301,4.090529418990296,40.0,0.0
38141,3,8141,[100 187 179 211 132],535,4,33305,4.090518300171948,0.0,20.0
38142,3,8142,[318 427 185 515 313],655,5,33310,4.090629988947562,40.0,0.0
38143,3,8143,[318 427 185 515 313],655,5,33315,4.090741650294696,40.0,0.0
38144,3,8144,[318 427 185 515 313],655,5,33320,4.09085328422345,40.0,0.0
38145,3,8145,[318 427 185 515 313],655,5,33325,4.0909648907439236,40.0,0.0
38146,3,8146,[168 245 568 111 385],796,4,33329,4.0909537252976556,0.0,0.0
38147,3,8147,[318 427 185 515 313],655,5,33334,4.09106529209622,40.0,0.0
38148,3,8148,[318 427 185 515 313],655,5,33339,4.091176831513069,40.0,0.0
38149,3,8149,[202 655 222 289 475],655,0,33339,4.090674846625767,0.0,0.0
38150,3,8150,[318 427 185 515 313],655,5,33344,4.09078640657588,40.0,0.0
38151,3,8151,[318 427 185 515 313],655,5,33349,4.090897939156036,40.0,0.0
38152,3,8152,[333 568   4  88 215],796,5,33354,4.091009444376303,0.0,0.0
38153,3,8153,[318 427 185 515 313],655,5,33359,4.09112092224675,40.0,0.0
38154,3,8154,[318 427 185 515 313],655,5,33364,4.091232372777437,40.0,0.0
38155,3,8155,[318 427 185 515 313],655,5,33369,4.091343795978421,40.0,0.0
38156,3,8156,[318 427 185 515 313],655,5,33374,4.091455191859752,40.0,0.0
38157,3,8157,[318 427 185 515 313],655,5,33379,4.091566560431478,40.0,0.0
38158,3,8158,[125 655 202 127 237],280,1,33380,4.091187645544797,0.0,20.0
38159,3,8159,[237 238 265 127  82],796,3,33383,4.091053921568627,0.0,20.0
38160,3,8160,[318 427 185 515 313],655,5,33388,4.0911652983702975,40.0,0.0
38161,3,8161,[187 328 333 237 385],796,5,33393,4.091276647880422,0.0,0.0
38162,3,8162,[269  64 238 111  22],629,4,33397,4.091265466127649,20.0,0.0
38163,3,8163,[ 96 210 132 301 405],344,4,33401,4.091254287114159,0.0,0.0
38164,3,8164,[318 427 185 515 313],655,5,33406,4.091365584813227,40.0,0.0
38165,3,8165,[588  70 202 357 127],18,4,33410,4.091354396277247,0.0,20.0
38166,3,8166,[318 301 237 194 176],11,4,33414,4.091343210481205,20.0,0.0
38167,3,8167,[318 427 185 515 313],655,5,33419,4.0914544564152795,40.0,0.0
38168,3,8168,[603 288 405   7   1],292,2,33421,4.091198433100747,20.0,0.0
38169,3,8169,[742 179  12  15 100],457,5,33426,4.091309669522643,0.0,20.0
38170,3,8170,[318 427 185 515 313],655,5,33431,4.0914208787174156,40.0,0.0
38171,3,8171,[318 427 185 515 313],655,5,33436,4.091532060695056,40.0,0.0
38172,3,8172,[357 197 313 211 300],693,2,33438,4.091276153187324,0.0,0.0
38173,3,8173,[318 427 185 515 313],655,5,33443,4.091387325666748,40.0,0.0
38174,3,8174,[318 427 185 515 313],655,5,33448,4.091498470948013,40.0,0.0
38175,3,8175,[258 135 100 144 302],535,2,33450,4.091242661448141,0.0,20.0
38176,3,8176,[  1 196 161  95 183],577,5,33455,4.09135379723615,0.0,0.0
38177,3,8177,[ 98 471   4 568  95],389,3,33458,4.091220347273172,0.0,0.0
38178,3,8178,[471 202   7 125 318],280,2,33460,4.090964665607043,20.0,0.0
38179,3,8179,[  4 257  96  12 568],796,5,33465,4.091075794621027,0.0,0.0
38180,3,8180,[318 427 185 515 313],655,5,33470,4.091186896467424,40.0,0.0
38181,3,8181,[117 405  11 318  98],280,4,33474,4.091175751649963,20.0,0.0
38182,3,8182,[210 313 118 333 194],796,4,33478,4.091164609556397,0.0,0.0
38183,3,8183,[100 195 210 153 357],330,4,33482,4.091153470185728,0.0,20.0
38184,3,8184,[  9   1  50 179 318],65,3,33485,4.091020158827122,20.0,20.0
38185,3,8185,[  7 200 176  64  69],457,5,33490,4.091131199609089,20.0,0.0
38186,3,8186,[288 211 216 182 318],593,4,33494,4.091120068401124,20.0,0.0
38187,3,8187,[318 427 185 515 313],655,5,33499,4.091231069858329,40.0,0.0
38188,3,8188,[318 427 185 515 313],655,5,33504,4.091342044205642,40.0,0.0
38189,3,8189,[245 182 742 191 117],796,3,33507,4.091208791208791,0.0,0.0
38190,3,8190,[318 427 185 515 313],655,5,33512,4.091319741179343,40.0,0.0
38191,3,8191,[318 427 185 515 313],655,5,33517,4.0914306640625,40.0,0.0
38192,3,8192,[185 195 483 127 357],908,4,33521,4.091419504455023,0.0,20.0
38193,3,8193,[183 196 175 111 117],344,4,33525,4.091408347571393,0.0,0.0
38194,3,8194,[678 174  88 742 204],344,2,33527,4.091153142159854,0.0,0.0
38195,3,8195,[323 117  22 228 471],280,2,33529,4.090897999023914,0.0,0.0
38196,3,8196,[318 427 185 515 313],655,5,33534,4.0910089056972065,40.0,0.0
38197,3,8197,[318 427 185 515 313],655,5,33539,4.0911197853134915,40.0,0.0
38198,3,8198,[ 50 179 153 100 423],504,2,33541,4.090864739602391,0.0,40.0
38199,3,8199,[265 328 173 176 496],796,5,33546,4.090975609756097,20.0,0.0
38200,3,8200,[318 427 185 515 313],655,5,33551,4.091086452871601,40.0,0.0
38201,3,8201,[318 427 185 515 313],655,5,33556,4.0911972689587905,40.0,0.0
38202,3,8202,[318 427 185 515 313],655,5,33561,4.0913080580275505,40.0,0.0
38203,3,8203,[318 100 185 603  98],18,3,33564,4.091175036567528,40.0,20.0
38204,3,8204,[318 427 185 515 313],655,5,33569,4.091285801340646,40.0,0.0
38205,3,8205,[153  98 211 182 405],503,2,33571,4.091030952961248,0.0,0.0
38206,3,8206,[318 427 185 515 313],655,5,33576,4.091141708297795,40.0,0.0
38207,3,8207,[427 471  71 435   7],450,4,33580,4.091130604288499,20.0,0.0
38208,3,8208,[318 427 185 515 313],655,5,33585,4.091241320501888,40.0,0.0
38209,3,8209,[265 471 282 202 191],716,3,33588,4.091108404384896,0.0,0.0
38210,3,8210,[216 313 222 210  98],236,4,33592,4.091097308488613,0.0,0.0
38211,3,8211,[ 11 121 135   8 483],457,5,33597,4.09120798830979,0.0,0.0
38212,3,8212,[318 427 185 515 313],655,5,33602,4.091318641178619,40.0,0.0
38213,3,8213,[318 427 185 515 313],655,5,33607,4.091429267104942,40.0,0.0
38214,3,8214,[  1 405 211 204  25],151,4,33611,4.091418137553256,0.0,0.0
38215,3,8215,[318 427 185 515 313],655,5,33616,4.091528724440117,40.0,0.0
38216,3,8216,[318 427 185 515 313],655,5,33621,4.091639284410369,40.0,0.0
38217,3,8217,[318 427 185 515 313],655,5,33626,4.091749817473838,40.0,0.0
38218,3,8218,[238 288 111 202 271],629,5,33631,4.091860323640345,0.0,0.0
38219,3,8219,[318 427 185 515 313],655,5,33636,4.091970802919708,40.0,0.0
38220,3,8220,[423 196  11 496 301],535,5,33641,4.092081255321737,20.0,0.0
38221,3,8221,[135 118 186 187  96],716,0,33641,4.091583556312333,0.0,0.0
38222,3,8222,[496 144 222 655 196],716,4,33645,4.091572418825247,20.0,0.0
38223,3,8223,[117  97 210   9 742],344,2,33647,4.091318093385214,0.0,0.0
38224,3,8224,[318 427 185 515 313],655,5,33652,4.091428571428572,40.0,0.0
38225,3,8225,[318 427 185 515 313],655,5,33657,4.091539022611233,40.0,0.0
38226,3,8226,[194 238 496   1 191],796,3,33660,4.091406344961712,20.0,0.0
38227,3,8227,[318 427 185 515 313],655,5,33665,4.091516771998055,40.0,0.0
38228,3,8228,[318 427 185 515 313],655,5,33670,4.091627172195893,40.0,0.0
38229,3,8229,[118 183 405 300 483],292,3,33673,4.091494532199271,0.0,0.0
38230,3,8230,[588 176 423   4 200],450,3,33676,4.091361924432025,0.0,0.0
38231,3,8231,[318 427 185 515 313],655,5,33681,4.091472303206997,40.0,0.0
38232,3,8232,[322 597 204  56 385],450,5,33686,4.091582655168225,0.0,0.0
38233,3,8233,[318 427 185 515 313],655,5,33691,4.09169298032548,40.0,0.0
38234,3,8234,[318 427 185 515 313],655,5,33696,4.091803278688524,40.0,0.0
38235,3,8235,[318 182  50   1 196],457,5,33701,4.09191355026712,20.0,20.0
38236,3,8236,[403 286 313   9 153],655,1,33702,4.091538181376714,0.0,20.0
38237,3,8237,[318 427 185 515 313],655,5,33707,4.0916484583636805,40.0,0.0
38238,3,8238,[318 427 185 515 313],655,5,33712,4.091758708581138,40.0,0.0
38239,3,8239,[318 427 185 515 313],655,5,33717,4.091868932038835,40.0,0.0
38240,3,8240,[318 427 185 515 313],655,5,33722,4.0919791287465115,40.0,0.0
38241,3,8241,[318 427 185 515 313],655,5,33727,4.092089298713905,40.0,0.0
38242,3,8242,[245  98 301  97 173],450,5,33732,4.092199441950746,0.0,0.0
38243,3,8243,[318 427 185 515 313],655,5,33737,4.092309558466764,40.0,0.0
38244,3,8244,[318 427 185 515 313],655,5,33742,4.0924196482716795,40.0,0.0
38245,3,8245,[191 200 742 427  96],450,4,33746,4.092408440455979,20.0,0.0
38246,3,8246,[318 427 185 515 313],655,5,33751,4.092518491572693,40.0,0.0
38247,3,8247,[186  95 748 301  28],450,3,33754,4.092386032977692,0.0,0.0
38248,3,8248,[318 427 185 515 313],655,5,33759,4.0924960601285,40.0,0.0
38249,3,8249,[318 427 185 515 313],655,5,33764,4.092606060606061,40.0,0.0
38250,3,8250,[318 427 185 515 313],655,5,33769,4.092716034420071,40.0,0.0
38251,3,8251,[161  22 508 282  70],280,3,33772,4.092583616093068,0.0,0.0
38252,3,8252,[318 427 185 515 313],655,5,33777,4.092693565976009,40.0,0.0
38253,3,8253,[318 427 185 515 313],655,5,33782,4.092803489217349,40.0,0.0
38254,3,8254,[181 603 265 302 179],655,3,33785,4.09267110841914,20.0,0.0
38255,3,8255,[318 427 185 515 313],655,5,33790,4.092781007751938,40.0,0.0
38256,3,8256,[655 237 127 173 271],796,4,33794,4.092769771103306,0.0,20.0
38257,3,8257,[318 427 185 515 313],655,5,33799,4.092879631872124,40.0,0.0
38258,3,8258,[195   1 200 176 423],280,3,33802,4.092747305969246,0.0,0.0
38259,3,8259,[  1 435 111 286 597],450,5,33807,4.0928571428571425,0.0,20.0
38260,3,8260,[151 742 180  98  82],450,4,33811,4.09284590243312,0.0,0.0
38261,3,8261,[318 427 185 515 313],655,5,33816,4.092955700798838,40.0,0.0
38262,3,8262,[135 200 196 187 258],629,5,33821,4.093065472588648,0.0,0.0
38263,3,8263,[318 427 185 515 313],655,5,33826,4.093175217812197,40.0,0.0
38264,3,8264,[318 427 185 515 313],655,5,33831,4.093284936479129,40.0,0.0
38265,3,8265,[222 546 483 515 132],716,4,33835,4.093273651100895,0.0,0.0
38266,3,8266,[318 427 185 515 313],655,5,33840,4.093383331317286,40.0,0.0
38267,3,8267,[318 427 185 515 313],655,5,33845,4.093492985002419,40.0,0.0
38268,3,8268,[234 403 216 176  56],269,1,33846,4.0931188777361225,0.0,0.0
38269,3,8269,[215 111 405 100 191],457,4,33850,4.09310761789601,0.0,20.0
38270,3,8270,[318 427 185 515 313],655,5,33855,4.093217265143272,40.0,0.0
38271,3,8271,[302 268 195 678  96],344,3,33858,4.093085106382978,0.0,0.0
38272,3,8272,[318 427 185 515 313],655,5,33863,4.093194729844071,40.0,0.0
38273,3,8273,[185 132 300 191  82],151,3,33866,4.093062605752961,0.0,0.0
38274,3,8274,[176 435 194   9  69],269,2,33868,4.092809667673716,0.0,0.0
38275,3,8275,[ 96 588   7 269 234],23,4,33872,4.09279845335911,0.0,0.0
38276,3,8276,[271 322 202 172  15],629,4,33876,4.092787241754259,0.0,0.0
38277,3,8277,[318 427 185 515 313],655,5,33881,4.092896834984296,40.0,0.0
38278,3,8278,[181 234 132 496 258],796,4,33885,4.092885614204614,20.0,0.0
38279,3,8279,[204 385  56 127 111],796,5,33890,4.092995169082125,0.0,20.0
38280,3,8280,[318 427 185 515 313],655,5,33895,4.093104697500302,40.0,0.0
38281,3,8281,[318 427 185 515 313],655,5,33900,4.093214199468727,40.0,0.0
38282,3,8282,[237  50 655  64 185],716,5,33905,4.093323674996982,20.0,20.0
38283,3,8283,[245  56 546 235 127],450,4,33909,4.093312409464027,0.0,20.0
38284,3,8284,[318 427 185 515 313],655,5,33914,4.093421846710924,40.0,0.0
38285,3,8285,[318 427 185 515 313],655,5,33919,4.0935312575428435,40.0,0.0
38286,3,8286,[ 15 100   1 748 222],796,3,33922,4.0933993001086035,0.0,20.0
38287,3,8287,[483 515 117 204 228],655,2,33924,4.093146718146718,0.0,0.0
38288,3,8288,[318 427 185 515 313],655,5,33929,4.093256122572083,40.0,0.0
38289,3,8289,[ 70 151  64 161 179],450,5,33934,4.093365500603136,20.0,0.0
38290,3,8290,[318 427 185 515 313],655,5,33939,4.093474852249427,40.0,0.0
38291,3,8291,[168 176  98 318 191],11,2,33941,4.0932223830197785,20.0,0.0
38292,3,8292,[427 546 174 237 172],450,5,33946,4.09333172555167,20.0,0.0
38293,3,8293,[195 172  71   4 245],450,3,33949,4.093199903544731,0.0,0.0
38294,3,8294,[168 210  25  88 174],18,2,33951,4.092947558770343,0.0,0.0
38295,3,8295,[ 12 546  96 318 471],450,5,33956,4.093056894889103,20.0,0.0
38296,3,8296,[318 427 185 515 313],655,5,33961,4.093166204652284,40.0,0.0
38297,3,8297,[318 427 185 515 313],655,5,33966,4.093275488069414,40.0,0.0
38298,3,8298,[ 11 121 385  64 186],655,1,33967,4.092902759368599,20.0,0.0
38299,3,8299,[318 427 185 515 313],655,5,33972,4.093012048192771,40.0,0.0
38300,3,8300,[318 427 185 515 313],655,5,33977,4.09312131068546,40.0,0.0
38301,3,8301,[318 427 185 515 313],655,5,33982,4.093230546856179,40.0,0.0
38302,3,8302,[318 427 185 515 313],655,5,33987,4.093339756714441,40.0,0.0
38303,3,8303,[318 427 185 515 313],655,5,33992,4.09344894026975,40.0,0.0
38304,3,8304,[603 135 175 127 427],269,5,33997,4.0935580975316075,40.0,20.0
38305,3,8305,[127 302 237 204 153],401,1,33998,4.093185648928485,0.0,20.0
38306,3,8306,[318 427 185 515 313],655,5,34003,4.093294811604671,40.0,0.0
38307,3,8307,[176 135   1 238 483],450,3,34006,4.093163216177179,0.0,0.0
38308,3,8308,[143 228 204 200 135],457,5,34011,4.09327235527741,0.0,0.0
38309,3,8309,[318 427 185 515 313],655,5,34016,4.09338146811071,40.0,0.0
38310,3,8310,[ 82 275 181 125 282],796,4,34020,4.093370232222356,0.0,20.0
38311,3,8311,[211  28  50 423  89],23,3,34023,4.093238691049086,0.0,20.0
38312,3,8312,[179 357 427 191  70],655,4,34027,4.093227475039096,20.0,0.0
38313,3,8313,[318 427 185 515 313],655,5,34032,4.093336540774597,40.0,0.0
38314,3,8314,[318 427 185 515 313],655,5,34037,4.093445580276608,40.0,0.0
38315,3,8315,[118 179 172 175 222],655,2,34039,4.093193843193843,0.0,0.0
38316,3,8316,[ 12 265 275 742 197],457,5,34044,4.093302873632319,0.0,20.0
38317,3,8317,[ 82 286  88 742 143],796,2,34046,4.093051214234191,0.0,20.0
38318,3,8318,[172  96   4 313 269],450,4,34050,4.093040028849622,0.0,0.0
38319,3,8319,[318 427 185 515 313],655,5,34055,4.093149038461538,40.0,0.0
38320,3,8320,[ 50 204  69 200 186],18,2,34057,4.0928974882826585,0.0,20.0
38321,3,8321,[318 427 185 515 313],655,5,34062,4.093006488824802,40.0,0.0
38322,3,8322,[135 210  56 200   9],18,3,34065,4.092875165204854,0.0,0.0
38323,3,8323,[288  96 191 258   4],344,4,34069,4.092864007688611,0.0,0.0
38324,3,8324,[318 427 185 515 313],655,5,34074,4.092972972972973,40.0,0.0
38325,3,8325,[483 204 546 748 742],450,4,34078,4.0929618063896225,0.0,0.0
38326,3,8326,[ 95 200 322 176 196],786,4,34082,4.092950642488291,0.0,0.0
38327,3,8327,[318 427 185 515 313],655,5,34087,4.093059558117195,40.0,0.0
38328,3,8328,[318 427 185 515 313],655,5,34092,4.093168447592748,40.0,0.0
38329,3,8329,[318 427 185 515 313],655,5,34097,4.093277310924369,40.0,0.0
38330,3,8330,[318 427 185 515 313],655,5,34102,4.093386148121474,40.0,0.0
38331,3,8331,[ 28 151 168 275 179],389,5,34107,4.093494959193471,0.0,20.0
38332,3,8332,[318 427 185 515 313],655,5,34112,4.093603744149766,40.0,0.0
38333,3,8333,[318 427 185 515 313],655,5,34117,4.09371250299976,40.0,0.0
38334,3,8334,[405 597 748  56 186],796,4,34121,4.09370125974805,0.0,0.0
38335,3,8335,[318 427 185 515 313],655,5,34126,4.093809980806142,40.0,0.0
38336,3,8336,[265 302 655 235 111],450,4,34130,4.093798728559434,0.0,0.0
38337,3,8337,[318 427 185 515 313],655,5,34135,4.093907411849364,40.0,0.0
38338,3,8338,[318 427 185 515 313],655,5,34140,4.094016069073031,40.0,0.0
38339,3,8339,[318 427 185 515 313],655,5,34145,4.094124700239808,40.0,0.0
38340,3,8340,[318 427 185 515 313],655,5,34150,4.09423330535907,40.0,0.0
38341,3,8341,[173 181 172 471  95],389,3,34153,4.094102133780868,0.0,0.0
38342,3,8342,[318 427 185 515 313],655,5,34158,4.094210715569939,40.0,0.0
38343,3,8343,[318 427 185 515 313],655,5,34163,4.094319271332695,40.0,0.0
38344,3,8344,[318 427 185 515 313],655,5,34168,4.09442780107849,40.0,0.0
38345,3,8345,[  9 180  25 271 603],72,4,34172,4.094416486939852,20.0,0.0
38346,3,8346,[318 427 185 515 313],655,5,34177,4.094524979034383,40.0,0.0
38347,3,8347,[273  79 210 483 546],693,1,34178,4.094154288452324,0.0,0.0
38348,3,8348,[318 427 185 515 313],655,5,34183,4.094262785962391,40.0,0.0
38349,3,8349,[318 427 185 515 313],655,5,34188,4.0943712574850295,40.0,0.0
38350,3,8350,[318 427 185 515 313],655,5,34193,4.094479703029577,40.0,0.0
38351,3,8351,[318 427 185 515 313],655,5,34198,4.094588122605364,40.0,0.0
38352,3,8352,[  4 357 202  89  69],655,2,34200,4.094337363821381,0.0,0.0
38353,3,8353,[603 121 197 228 222],151,5,34205,4.094445774479292,20.0,0.0
38354,3,8354,[318 427 185 515 313],655,5,34210,4.094554159186116,40.0,0.0
38355,3,8355,[318 427 185 515 313],655,5,34215,4.094662517951173,40.0,0.0
38356,3,8356,[82 56  4 79 98],352,3,34218,4.094531530453512,0.0,0.0
38357,3,8357,[603   7 245 322 204],450,5,34223,4.09463986599665,20.0,0.0
38358,3,8358,[318 427 185 515 313],655,5,34228,4.0947481756190935,40.0,0.0
38359,3,8359,[ 95 588 117 176 100],280,3,34231,4.094617224880383,0.0,20.0
38360,3,8360,[318 427 185 515 313],655,5,34236,4.094725511302475,40.0,0.0
38361,3,8361,[318 427 185 515 313],655,5,34241,4.094833771824923,40.0,0.0
38362,3,8362,[318 427 185 515 313],655,5,34246,4.094942006457013,40.0,0.0
38363,3,8363,[318 427 185 515 313],655,5,34251,4.095050215208034,40.0,0.0
38364,3,8364,[183 228 265 180 117],457,5,34256,4.095158398087269,0.0,0.0
38365,3,8365,[318 427 185 515 313],655,5,34261,4.095266555103993,40.0,0.0
38366,3,8366,[161 403 258  15 322],796,4,34265,4.0952551691167685,0.0,0.0
38367,3,8367,[ 71 195 179  64 423],18,4,34269,4.095243785850861,20.0,0.0
38368,3,8368,[357 238 222  96 300],450,4,34273,4.0952324053052935,0.0,0.0
38369,3,8369,[196 313   9 210 269],655,1,34274,4.094862604540024,0.0,0.0
38370,3,8370,[403 748  98 423 245],450,5,34279,4.094970732290049,0.0,0.0
38371,3,8371,[ 28 222 275 301 265],796,3,34282,4.09483994266603,0.0,20.0
38372,3,8372,[186 204 265 174 173],796,4,34286,4.094828615788845,0.0,0.0
38373,3,8373,[318 427 185 515 313],655,5,34291,4.094936708860759,40.0,0.0
38374,3,8374,[118 132 328 143   1],450,4,34295,4.094925373134329,0.0,0.0
38375,3,8375,[318 427 185 515 313],655,5,34300,4.095033428844317,40.0,0.0
38376,3,8376,[318 427 185 515 313],655,5,34305,4.095141458756118,40.0,0.0
38377,3,8377,[318 427 185 515 313],655,5,34310,4.095249462878969,40.0,0.0
38378,3,8378,[318 427 185 515 313],655,5,34315,4.095357441222103,40.0,0.0
38379,3,8379,[318 427 185 515 313],655,5,34320,4.09546539379475,40.0,0.0
38380,3,8380,[318 427 185 515 313],655,5,34325,4.095573320606133,40.0,0.0
38381,3,8381,[655 496 427 238 196],535,5,34330,4.095681221665473,40.0,0.0
38382,3,8382,[318 427 185 515 313],655,5,34335,4.095789096981988,40.0,0.0
38383,3,8383,[318 427 185 515 313],655,5,34340,4.095896946564886,40.0,0.0
38384,3,8384,[318 427 185 515 313],655,5,34345,4.0960047704233755,40.0,0.0
38385,3,8385,[318 427 185 515 313],655,5,34350,4.096112568566658,40.0,0.0
38386,3,8386,[197  79  98 174 118],292,4,34354,4.0961011088589485,0.0,0.0
38387,3,8387,[318 427 185 515 313],655,5,34359,4.09620886981402,40.0,0.0
38388,3,8388,[318 427 185 515 313],655,5,34364,4.096316605078078,40.0,0.0
38389,3,8389,[318 427 185 515 313],655,5,34369,4.09642431466031,40.0,0.0
38390,3,8390,[318 427 185 515 313],655,5,34374,4.096531998569897,40.0,0.0
38391,3,8391,[318 427 185 515 313],655,5,34379,4.0966396568160155,40.0,0.0
38392,3,8392,[546 111 423 186 200],450,3,34382,4.096508995591565,0.0,0.0
38393,3,8393,[318 427 185 515 313],655,5,34387,4.096616630926852,40.0,0.0
38394,3,8394,[318 427 185 515 313],655,5,34392,4.096724240619416,40.0,0.0
38395,3,8395,[118 161 265 121   9],655,0,34392,4.0962363030014295,0.0,0.0
38396,3,8396,[318 427 185 515 313],655,5,34397,4.0963439323567945,40.0,0.0
38397,3,8397,[318 427 185 515 313],655,5,34402,4.096451536080019,40.0,0.0
38398,3,8398,[427 100 194 282 143],450,5,34407,4.09655911418026,20.0,20.0
38399,3,8399,[185 182  12 186 282],450,4,34411,4.096547619047619,0.0,0.0
38400,3,8400,[318 427 185 515 313],655,5,34416,4.0966551600999885,40.0,0.0
38401,3,8401,[300 286 313 180  88],450,5,34421,4.09676267555344,0.0,20.0
38402,3,8402,[ 56 117 423 228 127],72,4,34425,4.096751160299893,0.0,20.0
38403,3,8403,[117 496 588 100 234],796,3,34428,4.096620656830081,20.0,20.0
38404,3,8404,[ 89 187 271  96 282],796,5,34433,4.096728138013088,0.0,0.0
38405,3,8405,[318 427 185 515 313],655,5,34438,4.096835593623602,40.0,0.0
38406,3,8406,[318 427 185 515 313],655,5,34443,4.09694302367075,40.0,0.0
38407,3,8407,[118 197 357 172 200],151,3,34446,4.096812559467174,0.0,0.0
38408,3,8408,[318 427 185 515 313],655,5,34451,4.096919966702343,40.0,0.0
38409,3,8409,[318 427 185 515 313],655,5,34456,4.097027348394768,40.0,0.0
38410,3,8410,[748   1 202 300 222],450,4,34460,4.0970158126263225,0.0,0.0
38411,3,8411,[318 427 185 515 313],655,5,34465,4.097123157394199,40.0,0.0
38412,3,8412,[546 143  64 210  28],151,4,34469,4.097111612979912,20.0,0.0
38413,3,8413,[ 71 186 125 286 275],18,4,34473,4.097100071309722,0.0,40.0
38414,3,8414,[294  28 210 121 185],450,3,34476,4.096969696969697,0.0,0.0
38415,3,8415,[257 515   4 175 100],655,1,34477,4.096601711026616,0.0,20.0
38416,3,8416,[655 258 143 403 318],450,5,34482,4.09670904122609,20.0,0.0
38417,3,8417,[318 427 185 515 313],655,5,34487,4.096816345925398,40.0,0.0
38418,3,8418,[318 427 185 515 313],655,5,34492,4.096923625133626,40.0,0.0
38419,3,8419,[ 89 172 135  98  97],72,3,34495,4.096793349168646,0.0,0.0
38420,3,8420,[111 568 597 194 118],450,4,34499,4.096781854886593,0.0,0.0
38421,3,8421,[318 427 185 515 313],655,5,34504,4.096889099976253,40.0,0.0
38422,3,8422,[318 427 185 515 313],655,5,34509,4.096996319601092,40.0,0.0
38423,3,8423,[318 427 185 515 313],655,5,34514,4.097103513770181,40.0,0.0
38424,3,8424,[ 25 222  56 405  15],457,5,34519,4.097210682492582,0.0,0.0
38425,3,8425,[318 427 185 515 313],655,5,34524,4.097317825777356,40.0,0.0
38426,3,8426,[318 427 185 515 313],655,5,34529,4.097424943633559,40.0,0.0
38427,3,8427,[597 568 185 216 496],269,2,34531,4.097176079734219,20.0,0.0
38428,3,8428,[ 97 322 196  56 204],151,4,34535,4.0971645509550365,0.0,0.0
38429,3,8429,[318 427 185 515 313],655,5,34540,4.097271648873073,40.0,0.0
38430,3,8430,[318 427 185 515 313],655,5,34545,4.097378721385364,40.0,0.0
38431,3,8431,[318 427 185 515 313],655,5,34550,4.097485768500949,40.0,0.0
38432,3,8432,[318 427 185 515 313],655,5,34555,4.0975927902288625,40.0,0.0
38433,3,8433,[318 427 185 515 313],655,5,34560,4.097699786578136,40.0,0.0
38434,3,8434,[318 427 185 515 313],655,5,34565,4.0978067575577946,40.0,0.0
38435,3,8435,[483 313 742 196 180],693,1,34566,4.0974395448079655,0.0,0.0
38436,3,8436,[127   4 288 200 195],457,5,34571,4.097546521275335,0.0,20.0
38437,3,8437,[318 427 185 515 313],655,5,34576,4.097653472386821,40.0,0.0
38438,3,8438,[318 427 185 515 313],655,5,34581,4.09776039815144,40.0,0.0
38439,3,8439,[  8 483 151 471   7],457,5,34586,4.097867298578199,0.0,0.0
38440,3,8440,[318 427 185 515 313],655,5,34591,4.097974173676104,40.0,0.0
38441,3,8441,[318 427 185 515 313],655,5,34596,4.098081023454157,40.0,0.0
38442,3,8442,[318 427 185 515 313],655,5,34601,4.098187847921355,40.0,0.0
38443,3,8443,[318 427 185 515 313],655,5,34606,4.098294647086688,40.0,0.0
38444,3,8444,[143  98 186  70 197],655,2,34608,4.0980461811722915,0.0,0.0
38445,3,8445,[222  50  28 144  88],457,5,34613,4.09815297182098,0.0,20.0
38446,3,8446,[318 427 185 515 313],655,5,34618,4.098259737184799,40.0,0.0
38447,3,8447,[180 742 144  96  97],796,2,34620,4.098011363636363,0.0,0.0
38448,3,8448,[318 427 185 515 313],655,5,34625,4.098118120487632,40.0,0.0
38449,3,8449,[211 191  97 300 282],655,1,34626,4.097751479289941,0.0,0.0
38450,3,8450,[318 427 185 515 313],655,5,34631,4.097858241628209,40.0,0.0
38451,3,8451,[ 64 357 151 276 196],344,5,34636,4.097964978703265,20.0,0.0
38452,3,8452,[234 183   9 153 427],269,2,34638,4.097716786939548,20.0,0.0
38453,3,8453,[211 204   4 135 288],450,2,34640,4.0974686538916485,0.0,0.0
38454,3,8454,[197 176 288 405 181],450,4,34644,4.09745712596097,0.0,0.0
38455,3,8455,[ 64 204  71 471 196],389,4,34648,4.097445600756859,20.0,0.0
38456,3,8456,[100 258 245 238 132],504,4,34652,4.097434078278349,0.0,20.0
38457,3,8457,[318 427 185 515 313],655,5,34657,4.097540789784819,40.0,0.0
38458,3,8458,[185 322 234 385 132],151,3,34660,4.097411041494267,0.0,0.0
38459,3,8459,[318 427 185 515 313],655,5,34665,4.097517730496454,40.0,0.0
38460,3,8460,[ 69 475 117 405 153],655,0,34665,4.097033447583028,0.0,0.0
38461,3,8461,[215 323  88 175  50],23,2,34667,4.096785629874734,0.0,20.0
38462,3,8462,[318 427 185 515 313],655,5,34672,4.096892354956871,40.0,0.0
38463,3,8463,[357 144  56 475 275],629,5,34677,4.096999054820416,0.0,20.0
38464,3,8464,[121  64 403 168  88],269,2,34679,4.096751329001772,20.0,0.0
38465,3,8465,[197 174 215  25 200],835,5,34684,4.09685802031656,0.0,0.0
38466,3,8466,[385 111 191 301 427],655,2,34686,4.096610369670485,20.0,0.0
38467,3,8467,[173 215 678  89  88],344,2,34688,4.096362777515352,0.0,0.0
38468,3,8468,[187 174 185 237 568],256,4,34692,4.096351399220687,0.0,0.0
38469,3,8469,[318 427 185 515 313],655,5,34697,4.0964580873671785,40.0,0.0
38470,3,8470,[ 56 237 423 168 286],535,3,34700,4.096328650690592,0.0,20.0
38471,3,8471,[318 427 185 515 313],655,5,34705,4.096435316336166,40.0,0.0
38472,3,8472,[318 427 185 515 313],655,5,34710,4.096541956803965,40.0,0.0
38473,3,8473,[318 427 185 515 313],655,5,34715,4.096648572102903,40.0,0.0
38474,3,8474,[228 174 276 172 168],457,5,34720,4.096755162241888,0.0,0.0
38475,3,8475,[318 427 185 515 313],655,5,34725,4.096861727229825,40.0,0.0
38476,3,8476,[318 427 185 515 313],655,5,34730,4.096968267075616,40.0,0.0
38477,3,8477,[318 313  25   9 423],655,2,34732,4.0967209247464025,20.0,0.0
38478,3,8478,[ 98 121 471 117 216],457,5,34737,4.096827456067933,0.0,0.0
38479,3,8479,[318 427 185 515 313],655,5,34742,4.096933962264151,40.0,0.0
38480,3,8480,[191   7  12 182 222],72,3,34745,4.0968046220964505,0.0,0.0
38481,3,8481,[ 82  56 200 153 258],151,2,34747,4.096557415703844,0.0,0.0
38482,3,8482,[318 427 185 515 313],655,5,34752,4.096663916067429,40.0,0.0
38483,3,8483,[318 427 185 515 313],655,5,34757,4.0967703913248465,40.0,0.0
38484,3,8484,[172 286 655 288  71],450,3,34760,4.096641131408368,0.0,20.0
38485,3,8485,[403 423 211  69   4],18,2,34762,4.096394060806033,0.0,0.0
38486,3,8486,[318 427 185 515 313],655,5,34767,4.096500530222693,40.0,0.0
38487,3,8487,[ 25 301 100 508 423],535,5,34772,4.0966069745523095,0.0,20.0
38488,3,8488,[172 117  79 282 405],593,4,34776,4.0965955942985035,0.0,0.0
38489,3,8489,[318 427 185 515 313],655,5,34781,4.096702002355713,40.0,0.0
38490,3,8490,[179 427 182 288 186],450,3,34784,4.096572841832528,20.0,0.0
38491,3,8491,[318 427 185 515 313],655,5,34789,4.096679227508243,40.0,0.0
38492,3,8492,[655 483  64 135 385],401,1,34790,4.0963146120334395,20.0,0.0
38493,3,8493,[135  82   8 210 742],457,5,34795,4.096421003060985,0.0,0.0
38494,3,8494,[172 655 300   9  98],535,2,34797,4.0961742201294875,0.0,0.0
38495,3,8495,[318 427 185 515 313],655,5,34802,4.096280602636535,40.0,0.0
38496,3,8496,[187 323 597 143 144],796,4,34806,4.096269271507591,0.0,0.0
38497,3,8497,[318 427 185 515 313],655,5,34811,4.096375617792422,40.0,0.0
38498,3,8498,[151 210 423 135  98],535,3,34814,4.096246617249088,0.0,0.0
38499,3,8499,[318 427 185 515 313],655,5,34819,4.0963529411764705,40.0,0.0
38500,3,8500,[318 427 185 515 313],655,5,34824,4.096459240089401,40.0,0.0
38501,3,8501,[318 427 185 515 313],655,5,34829,4.0965655139967065,40.0,0.0
38502,3,8502,[204  70 215  69  82],330,5,34834,4.096671762907209,0.0,0.0
38503,3,8503,[143  88 294 237 125],457,4,34838,4.096660395108184,0.0,0.0
38504,3,8504,[ 12  50 135 423 597],450,4,34842,4.0966490299823635,0.0,20.0
38505,3,8505,[405 161  56 748 200],280,3,34845,4.096520103456384,0.0,0.0
38506,3,8506,[483 258 215 204 655],23,2,34847,4.096273656988362,0.0,0.0
38507,3,8507,[ 28 135 496 185 183],716,3,34850,4.096144804889516,20.0,0.0
38508,3,8508,[318 427 185 515 313],655,5,34855,4.0962510283229525,40.0,0.0
38509,3,8509,[318 427 185 515 313],655,5,34860,4.096357226792009,40.0,0.0
38510,3,8510,[234 515 144 294 174],655,1,34861,4.095993420279638,0.0,0.0
38511,3,8511,[318 427 185 515 313],655,5,34866,4.09609962406015,40.0,0.0
38512,3,8512,[318 427 185 515 313],655,5,34871,4.096205802889698,40.0,0.0
38513,3,8513,[318 427 185 515 313],655,5,34876,4.096311956777073,40.0,0.0
38514,3,8514,[318 427 185 515 313],655,5,34881,4.096418085731063,40.0,0.0
38515,3,8515,[  1  98 172  22 210],296,4,34885,4.096406763738845,0.0,0.0
38516,3,8516,[318 427 185 515 313],655,5,34890,4.096512856639662,40.0,0.0
38517,3,8517,[318 427 185 515 313],655,5,34895,4.096618924630195,40.0,0.0
38518,3,8518,[ 64  82 357 496 168],796,4,34899,4.096607583049654,40.0,0.0
38519,3,8519,[318 427 185 515 313],655,5,34904,4.096713615023474,40.0,0.0
38520,3,8520,[318 427 185 515 313],655,5,34909,4.096819622110081,40.0,0.0
38521,3,8521,[318 427 185 515 313],655,5,34914,4.096925604318235,40.0,0.0
38522,3,8522,[174   9 153 423 173],292,5,34919,4.097031561656694,0.0,0.0
38523,3,8523,[ 28 183 313 196 186],796,3,34922,4.096902862505866,0.0,0.0
38524,3,8524,[269   9 197 194 318],878,5,34927,4.097008797653959,20.0,0.0
38525,3,8525,[318 427 185 515 313],655,5,34932,4.097114707952146,40.0,0.0
38526,3,8526,[318 427 185 515 313],655,5,34937,4.097220593409171,40.0,0.0
38527,3,8527,[179 238 568 282 211],593,5,34942,4.097326454033771,0.0,0.0
38528,3,8528,[318 427 185 515 313],655,5,34947,4.097432289834682,40.0,0.0
38529,3,8529,[100 286 313 328 196],655,1,34948,4.09706916764361,0.0,40.0
38530,3,8530,[216  64   9  89 269],344,5,34953,4.097175008791466,20.0,0.0
38531,3,8531,[318 427 185 515 313],655,5,34958,4.0972808251289266,40.0,0.0
38532,3,8532,[318 427 185 515 313],655,5,34963,4.097386616664713,40.0,0.0
38533,3,8533,[318 427 185 515 313],655,5,34968,4.0974923834075465,40.0,0.0
38534,3,8534,[318 427 185 515 313],655,5,34973,4.097598125366139,40.0,0.0
38535,3,8535,[318 427 185 515 313],655,5,34978,4.097703842549203,40.0,0.0
38536,3,8536,[194 235 588  28 153],23,3,34981,4.097575260630198,0.0,0.0
38537,3,8537,[ 79  25 173   7  69],344,4,34985,4.0975638322792225,0.0,0.0
38538,3,8538,[237 273 302 655  98],450,4,34989,4.097552406604989,0.0,0.0
38539,3,8539,[179  69 216 215 237],655,2,34991,4.097306791569086,0.0,0.0
38540,3,8540,[276 210  22 257  79],655,2,34993,4.097061234047535,0.0,0.0
38541,3,8541,[318  64 181 196 200],450,4,34997,4.097049871224538,40.0,0.0
38542,3,8542,[288  25  88 118 132],655,0,34997,4.096570291466698,0.0,0.0
38543,3,8543,[204  97 423 405 288],450,4,35001,4.096558988764045,0.0,0.0
38544,3,8544,[ 22  12 234 180  28],450,4,35005,4.096547688706846,0.0,0.0
38545,3,8545,[  4 678 323  69  70],280,2,35007,4.096302363678914,0.0,0.0
38546,3,8546,[385 742 423 323 483],280,4,35011,4.096291096291096,0.0,0.0
38547,3,8547,[318 427 185 515 313],655,5,35016,4.096396817969116,40.0,0.0
38548,3,8548,[318 427 185 515 313],655,5,35021,4.096502514914025,40.0,0.0
38549,3,8549,[318 427 185 515 313],655,5,35026,4.096608187134503,40.0,0.0
38550,3,8550,[ 98  88  22 175 435],716,4,35030,4.096596889252719,0.0,0.0
38551,3,8551,[318 427 185 515 313],655,5,35035,4.096702525724977,40.0,0.0
38552,3,8552,[318 427 185 515 313],655,5,35040,4.096808137495616,40.0,0.0
38553,3,8553,[  4 483 427 234 132],389,5,35045,4.096913724573299,20.0,0.0
38554,3,8554,[ 11 222 195 742 174],450,4,35049,4.096902396259497,0.0,0.0
38555,3,8555,[268 288 275 172 483],655,3,35052,4.096774193548387,0.0,20.0
38556,3,8556,[ 71  96 180 597 181],450,4,35056,4.096762884188384,0.0,0.0
38557,3,8557,[318 427 185 515 313],655,5,35061,4.096868427202617,40.0,0.0
38558,3,8558,[318 427 185 515 313],655,5,35066,4.096973945554387,40.0,0.0
38559,3,8559,[144  70 405   9 210],401,3,35069,4.096845794392523,0.0,0.0
38560,3,8560,[191 546 357  82 151],796,4,35073,4.096834481953043,0.0,0.0
38561,3,8561,[322  82  11 235 200],450,2,35075,4.096589581873394,0.0,0.0
38562,3,8562,[  4 237 302 117 357],655,2,35077,4.096344738993343,0.0,0.0
38563,3,8563,[483 318 181 191 204],401,4,35081,4.096333489023821,20.0,0.0
38564,3,8564,[318 427 185 515 313],655,5,35086,4.096438995913602,40.0,0.0
38565,3,8565,[ 15 245 238 275  89],796,3,35089,4.096310996964744,0.0,20.0
38566,3,8566,[318 427 185 515 313],655,5,35094,4.096416481848955,40.0,0.0
38567,3,8567,[318 427 185 515 313],655,5,35099,4.0965219421101775,40.0,0.0
38568,3,8568,[318 427 185 515 313],655,5,35104,4.096627377757031,40.0,0.0
38569,3,8569,[300  15 100 222  88],796,4,35108,4.096616102683781,0.0,20.0
38570,3,8570,[191  95 588 234 173],389,3,35111,4.09648815774122,0.0,0.0
38571,3,8571,[496 117 423  97  70],786,5,35116,4.096593560429305,20.0,0.0
38572,3,8572,[318 427 185 515 313],655,5,35121,4.096698938527936,40.0,0.0
38573,3,8573,[172 185 210  56 202],18,2,35123,4.096454397014229,0.0,0.0
38574,3,8574,[318 427 185 515 313],655,5,35128,4.096559766763848,40.0,0.0
38575,3,8575,[ 28 222  64 215 273],450,3,35131,4.096431902985074,20.0,0.0
38576,3,8576,[132 483 161  97 313],655,2,35133,4.09618747813921,0.0,0.0
38577,3,8577,[318 427 185 515 313],655,5,35138,4.096292842154348,40.0,0.0
38578,3,8578,[318 427 185 515 313],655,5,35143,4.096398181606248,40.0,0.0
38579,3,8579,[204 282 200 228 483],716,4,35147,4.0963869463869464,0.0,0.0
38580,3,8580,[286 186  96 275 655],796,2,35149,4.096142640717865,0.0,40.0
38581,3,8581,[ 22 588 186 200 179],577,3,35152,4.096014914938243,0.0,0.0
38582,3,8582,[318 427 185 515 313],655,5,35157,4.096120237679133,40.0,0.0
38583,3,8583,[318 427 185 515 313],655,5,35162,4.096225535880708,40.0,0.0
38584,3,8584,[ 71 125 202 275 237],344,2,35164,4.095981362842166,0.0,20.0
38585,3,8585,[222 238 100  50 302],450,4,35168,4.095970184020499,0.0,40.0
38586,3,8586,[403 655 289   7 185],693,2,35170,4.095726097589379,0.0,0.0
38587,3,8587,[318 427 185 515 313],655,5,35175,4.0958313926408945,40.0,0.0
38588,3,8588,[318 427 185 515 313],655,5,35180,4.095936663173827,40.0,0.0
38589,3,8589,[  8 186 282  82 403],655,0,35180,4.09545983701979,0.0,0.0
38590,3,8590,[302 222 301 405  50],655,2,35182,4.095215923641019,0.0,20.0
38591,3,8591,[427 216 121 228 186],693,2,35184,4.094972067039106,20.0,0.0
38592,3,8592,[655 268   4  12  98],655,1,35185,4.094611893401606,0.0,0.0
38593,3,8593,[318 427 185 515 313],655,5,35190,4.094717244589249,40.0,0.0
38594,3,8594,[276  28 257 222 175],655,1,35191,4.0943571844095406,0.0,0.0
38595,3,8595,[318 427 185 515 313],655,5,35196,4.094462540716612,40.0,0.0
38596,3,8596,[318 427 185 515 313],655,5,35201,4.094567872513667,40.0,0.0
38597,3,8597,[597 151 235 423 195],23,1,35202,4.094207955338451,0.0,0.0
38598,3,8598,[ 12 234 180 265  97],796,2,35204,4.093964414466798,0.0,0.0
38599,3,8599,[ 89  22 216 237 191],18,3,35207,4.093837209302325,0.0,0.0
38600,3,8600,[318 427 185 515 313],655,5,35212,4.093942564818044,40.0,0.0
38601,3,8601,[471 196 215  88  97],344,1,35213,4.093582887700535,0.0,0.0
38602,3,8602,[235 385 161  79 228],450,4,35217,4.093572009764036,0.0,0.0
38603,3,8603,[318 204   4 238 172],593,5,35222,4.093677359367736,20.0,0.0
38604,3,8604,[132  56 211  97 427],236,4,35226,4.093666472980825,20.0,0.0
38605,3,8605,[276  69 153 302  82],655,2,35228,4.093423193121079,0.0,0.0
38606,3,8606,[143  96 100 172 294],796,3,35231,4.093296154293017,0.0,20.0
38607,3,8607,[318 427 185 515 313],655,5,35236,4.0934014869888475,40.0,0.0
38608,3,8608,[318 427 185 515 313],655,5,35241,4.093506795214311,40.0,0.0
38609,3,8609,[ 96 172 200 234 333],796,4,35245,4.09349593495935,0.0,0.0
38610,3,8610,[174 182 276 173 655],269,3,35248,4.093368946696087,0.0,0.0
38611,3,8611,[318 427 185 515 313],655,5,35253,4.093474222015792,40.0,0.0
38612,3,8612,[318 427 185 515 313],655,5,35258,4.093579472889818,40.0,0.0
38613,3,8613,[318 427 185 515 313],655,5,35263,4.093684699326677,40.0,0.0
38614,3,8614,[275 322 125 546 471],733,0,35263,4.093209518282066,0.0,20.0
38615,3,8615,[  4 237 546 385  82],280,2,35265,4.092966573816156,0.0,0.0
38616,3,8616,[ 96  97 176 655  50],796,3,35268,4.092839735406754,0.0,20.0
38617,3,8617,[318 427 185 515 313],655,5,35273,4.092944998839638,40.0,0.0
38618,3,8618,[318 427 185 515 313],655,5,35278,4.093050237846618,40.0,0.0
38619,3,8619,[196 185   1 655 300],655,1,35279,4.092691415313225,0.0,0.0
38620,3,8620,[153  89 168  82 234],18,1,35280,4.092332676023664,0.0,0.0
38621,3,8621,[318 427 185 515 313],655,5,35285,4.0924379494316865,40.0,0.0
38622,3,8622,[125 678  97 195 294],504,4,35289,4.092427229502493,0.0,0.0
38623,3,8623,[318 427 185 515 313],655,5,35294,4.092532467532467,40.0,0.0
38624,3,8624,[318 427 185 515 313],655,5,35299,4.09263768115942,40.0,0.0
38625,3,8625,[ 15 405 265 182 179],655,2,35301,4.092395084627869,0.0,0.0
38626,3,8626,[ 79 204 655 132 202],151,5,35306,4.092500289787875,0.0,0.0
38627,3,8627,[210 143 118 294 173],577,2,35308,4.092257765414928,0.0,0.0
38628,3,8628,[144   8 173 271 515],807,3,35311,4.092131185537142,0.0,0.0
38629,3,8629,[  7 603 302 125 175],151,4,35315,4.092120509849362,20.0,0.0
38630,3,8630,[181 265  25 748 435],450,4,35319,4.092109836635384,0.0,0.0
38631,3,8631,[318 427 185 515 313],655,5,35324,4.092215013901761,40.0,0.0
38632,3,8632,[318 427 185 515 313],655,5,35329,4.092320166801807,40.0,0.0
38633,3,8633,[294 228 471 202 191],716,4,35333,4.092309474171879,0.0,0.0
38634,3,8634,[385 174 302 286 328],401,2,35335,4.092067168500289,0.0,20.0
38635,3,8635,[318 427 185 515 313],655,5,35340,4.0921723019916625,40.0,0.0
38636,3,8636,[318 427 185 515 313],655,5,35345,4.092277411138126,40.0,0.0
38637,3,8637,[174 588 427 173  28],450,5,35350,4.0923824959481365,20.0,0.0
38638,3,8638,[191 215   9 300 273],693,1,35351,4.0920245398773005,0.0,0.0
38639,3,8639,[172 258  15  88 322],450,4,35355,4.092013888888889,0.0,0.0
38640,3,8640,[265  22  12 183 185],796,5,35360,4.092118967712071,0.0,0.0
38641,3,8641,[265 200  70  11  98],655,2,35362,4.09187688035177,0.0,0.0
38642,3,8642,[318 427 185 515 313],655,5,35367,4.091981950711559,40.0,0.0
38643,3,8643,[125 196 483  15 423],18,3,35370,4.091855622397039,0.0,0.0
38644,3,8644,[161 234 515 121 194],716,4,35374,4.091844997108155,0.0,0.0
38645,3,8645,[318 427 185 515 313],655,5,35379,4.091950034698126,40.0,0.0
38646,3,8646,[483 197  12 322  50],450,4,35383,4.091939400948306,0.0,20.0
38647,3,8647,[318 427 185 515 313],655,5,35388,4.09204440333025,40.0,0.0
38648,3,8648,[318 427 185 515 313],655,5,35393,4.092149381431379,40.0,0.0
38649,3,8649,[318 427 185 515 313],655,5,35398,4.092254335260115,40.0,0.0
38650,3,8650,[318 427 185 515 313],655,5,35403,4.092359264824876,40.0,0.0
38651,3,8651,[245 269 143 294 603],796,2,35405,4.092117429496071,20.0,0.0
38652,3,8652,[318 427 185 515 313],655,5,35410,4.092222350629839,40.0,0.0
38653,3,8653,[423 286 197  97 186],796,1,35411,4.091865033510516,0.0,20.0
38654,3,8654,[318 427 185 515 313],655,5,35416,4.091969959560948,40.0,0.0
38655,3,8655,[568 313  12 195 273],344,4,35420,4.091959334565619,0.0,0.0
38656,3,8656,[318 427 185 515 313],655,5,35425,4.092064225482269,40.0,0.0
38657,3,8657,[318 427 185 515 313],655,5,35430,4.092169092169092,40.0,0.0
38658,3,8658,[318 427 185 515 313],655,5,35435,4.092273934634484,40.0,0.0
38659,3,8659,[191  64 181 603  98],655,4,35439,4.092263279445728,40.0,0.0
38660,3,8660,[185 211 210 195  69],716,4,35443,4.092252626717469,0.0,0.0
38661,3,8661,[ 28 258  15 186 216],457,5,35448,4.092357423227892,0.0,0.0
38662,3,8662,[318 427 185 515 313],655,5,35453,4.092462195544269,40.0,0.0
38663,3,8663,[  1 423 151 174 496],716,5,35458,4.092566943674977,20.0,0.0
38664,3,8664,[121  56 168 202 215],716,5,35463,4.09267166762839,0.0,0.0
38665,3,8665,[318 427 185 515 313],655,5,35468,4.092776367412878,40.0,0.0
38666,3,8666,[ 50 597 211 508 216],269,2,35470,4.09253490250375,0.0,20.0
38667,3,8667,[357 403 475 186 427],269,3,35473,4.092408860175357,20.0,0.0
38668,3,8668,[655 196 181 286 496],535,4,35477,4.092398200484485,20.0,20.0
38669,3,8669,[276 144 588 257 258],457,4,35481,4.092387543252595,0.0,0.0
38670,3,8670,[301 238 471 100 135],389,4,35485,4.092376888478838,0.0,20.0
38671,3,8671,[258 234  69 328  97],796,3,35488,4.092250922509225,0.0,0.0
38672,3,8672,[318 427 185 515 313],655,5,35493,4.092355586302317,40.0,0.0
38673,3,8673,[318 427 185 515 313],655,5,35498,4.092460225962647,40.0,0.0
38674,3,8674,[286 111   1 508  88],401,2,35500,4.0922190201729105,0.0,20.0
38675,3,8675,[ 70 100 172  89 168],5,4,35504,4.092208390963577,0.0,20.0
38676,3,8676,[318 427 185 515 313],655,5,35509,4.092313011409473,40.0,0.0
38677,3,8677,[245 196  28 238 197],796,1,35510,4.09195667204425,0.0,0.0
38678,3,8678,[ 96 151 257 275 117],796,5,35515,4.092061297384491,0.0,20.0
38679,3,8679,[322 153 215  82   9],151,1,35516,4.091705069124424,0.0,0.0
38680,3,8680,[197 427  89 180 215],796,3,35519,4.091579311139269,20.0,0.0
38681,3,8681,[269 210 181  95 318],18,4,35523,4.091568762957844,20.0,0.0
38682,3,8682,[313 211 357 143 195],450,5,35528,4.091673384774848,0.0,0.0
38683,3,8683,[318  95  97   4 222],786,5,35533,4.091777982496545,20.0,0.0
38684,3,8684,[ 56 197 118 237 427],72,3,35536,4.0916522740356935,20.0,0.0
38685,3,8685,[182  96  98 258 748],796,5,35541,4.091756850103615,0.0,0.0
38686,3,8686,[318 427 185 515 313],655,5,35546,4.091861402095085,40.0,0.0
38687,3,8687,[748 423   1 186 546],796,3,35549,4.091735727440147,0.0,0.0
38688,3,8688,[  4 204   8 182 269],796,4,35553,4.091725169754863,0.0,0.0
38689,3,8689,[471 423 603 234 117],72,5,35558,4.091829689298044,20.0,0.0
38690,3,8690,[ 70 323 588 144 195],23,2,35560,4.091589000115062,0.0,0.0
38691,3,8691,[275 276 215 273  79],344,4,35564,4.091578462954441,0.0,20.0
38692,3,8692,[403   1 300 234 258],450,4,35568,4.091567928218106,0.0,0.0
38693,3,8693,[ 88  25 427  70 111],151,5,35573,4.091672417759375,20.0,0.0
38694,3,8694,[ 12  56 403  98  50],280,3,35576,4.091546866014951,0.0,20.0
38695,3,8695,[143  98 294  22 603],450,5,35581,4.0916513339466425,20.0,0.0
38696,3,8696,[318 427 185 515 313],655,5,35586,4.0917557778544325,40.0,0.0
38697,3,8697,[313  89 183 144 302],450,5,35591,4.091860197746608,0.0,0.0
38698,3,8698,[ 64  22 265 318 168],577,5,35596,4.0919645936314515,40.0,0.0
38699,3,8699,[318 427 185 515 313],655,5,35601,4.0920689655172415,40.0,0.0
38700,3,8700,[ 50 222 496   4 258],151,5,35606,4.0921733134122515,20.0,20.0
38701,3,8701,[427  25 127 118 182],72,4,35610,4.092162721213514,20.0,20.0
38702,3,8702,[318 427 185 515 313],655,5,35615,4.092267034355969,40.0,0.0
38703,3,8703,[ 97   8  15 228 182],655,1,35616,4.091911764705882,0.0,0.0
38704,3,8704,[318 427 185 515 313],655,5,35621,4.092016082711085,40.0,0.0
38705,3,8705,[191  12 313 180  71],450,4,35625,4.092005513439007,0.0,0.0
38706,3,8706,[ 11 194 385  15 405],577,2,35627,4.091765246353509,0.0,0.0
38707,3,8707,[144 313  97 257 286],655,1,35628,4.091410197519522,0.0,20.0
38708,3,8708,[318 427 185 515 313],655,5,35633,4.091514525203812,40.0,0.0
38709,3,8709,[196 121 294 323 204],796,3,35636,4.091389207807119,0.0,0.0
38710,3,8710,[423 196  28 216   4],18,2,35638,4.091149121800023,0.0,0.0
38711,3,8711,[318 427 185 515 313],655,5,35643,4.0912534435261705,40.0,0.0
38712,3,8712,[318 427 185 515 313],655,5,35648,4.091357741306094,40.0,0.0
38713,3,8713,[318 427 185 515 313],655,5,35653,4.091462015148037,40.0,0.0
38714,3,8714,[318 427 185 515 313],655,5,35658,4.091566265060241,40.0,0.0
38715,3,8715,[318 427 185 515 313],655,5,35663,4.091670491050941,40.0,0.0
38716,3,8716,[318 427 185 515 313],655,5,35668,4.09177469312837,40.0,0.0
38717,3,8717,[318 427 185 515 313],655,5,35673,4.091878871300757,40.0,0.0
38718,3,8718,[318 427 185 515 313],655,5,35678,4.091983025576328,40.0,0.0
38719,3,8719,[318 202  88 265 210],786,5,35683,4.092087155963303,20.0,0.0
38720,3,8720,[318 427 185 515 313],655,5,35688,4.092191262469901,40.0,0.0
38721,3,8721,[318 427 185 515 313],655,5,35693,4.092295345104334,40.0,0.0
38722,3,8722,[204 258  56 196   1],535,3,35696,4.09217012495701,0.0,0.0
38723,3,8723,[238 180  56 403 151],796,3,35699,4.0920449335167355,0.0,0.0
38724,3,8724,[161 288 333 286 427],655,1,35700,4.091690544412607,20.0,20.0
38725,3,8725,[568  12 161 301  69],450,5,35705,4.091794636717855,0.0,0.0
38726,3,8726,[318 427 185 515 313],655,5,35710,4.0918987051678695,40.0,0.0
38727,3,8727,[323 546  79 568  22],280,3,35713,4.091773602199817,0.0,0.0
38728,3,8728,[161 143  88 127 258],504,4,35717,4.09176308855539,0.0,20.0
38729,3,8729,[318 427 185 515 313],655,5,35722,4.091867124856815,40.0,0.0
38730,3,8730,[318 427 185 515 313],655,5,35727,4.091971137326767,40.0,0.0
38731,3,8731,[318 427 185 515 313],655,5,35732,4.092075125973431,40.0,0.0
38732,3,8732,[127  79  56  98 200],421,4,35736,4.092064582617657,0.0,20.0
38733,3,8733,[222 195 191  56  28],796,4,35740,4.092054041676208,0.0,0.0
38734,3,8734,[ 98  28 179 265  50],655,3,35743,4.091929021179165,0.0,20.0
38735,3,8735,[238 301  56 117 357],296,4,35747,4.091918498168498,0.0,0.0
38736,3,8736,[318 427 185 515 313],655,5,35752,4.092022433329518,40.0,0.0
38737,3,8737,[318 427 185 515 313],655,5,35757,4.092126344701304,40.0,0.0
38738,3,8738,[273 135 181 258 175],655,2,35759,4.091886943586223,0.0,0.0
38739,3,8739,[318 427 185 515 313],655,5,35764,4.091990846681922,40.0,0.0
38740,3,8740,[568  50 117 194  70],716,5,35769,4.092094726003889,0.0,20.0
38741,3,8741,[313 194 423 588 237],450,5,35774,4.092198581560283,0.0,0.0
38742,3,8742,[302   4 143 216 181],655,3,35777,4.092073658927141,0.0,0.0
38743,3,8743,[173 276 265 132 403],457,5,35782,4.092177493138152,0.0,0.0
38744,3,8744,[ 82 180 655 483 161],269,2,35784,4.091938250428816,0.0,0.0
38745,3,8745,[117 195 172 176 183],450,5,35789,4.092042076377773,0.0,0.0
38746,3,8746,[194 568 294 234 151],450,4,35793,4.092031553675546,0.0,0.0
38747,3,8747,[318 427 185 515 313],655,5,35798,4.092135345221765,40.0,0.0
38748,3,8748,[234 271 269 181 216],796,3,35801,4.092010515487484,0.0,0.0
38749,3,8749,[318 427 185 515 313],655,5,35806,4.092114285714286,40.0,0.0
38750,3,8750,[318 427 185 515 313],655,5,35811,4.0922180322248884,40.0,0.0
38751,3,8751,[186 181 313 196  70],655,1,35812,4.091864716636198,0.0,0.0
38752,3,8752,[318 427 185 515 313],655,5,35817,4.091968467953844,40.0,0.0
38753,3,8753,[318 427 185 515 313],655,5,35822,4.092072195567741,40.0,0.0
38754,3,8754,[191 328 300 568 196],655,1,35823,4.091719017704169,0.0,0.0
38755,3,8755,[423 216 289 742 121],719,2,35825,4.0914801279122885,0.0,0.0
38756,3,8756,[318 427 185 515 313],655,5,35830,4.0915838757565375,40.0,0.0
38757,3,8757,[405 100 235  98 222],5,3,35833,4.091459237268783,0.0,20.0
38758,3,8758,[144 125 173 127 210],796,4,35837,4.091448795524603,0.0,20.0
38759,3,8759,[151 228  82 121 588],796,4,35841,4.0914383561643834,0.0,0.0
38760,3,8760,[318 427 185 515 313],655,5,35846,4.091542061408515,40.0,0.0
38761,3,8761,[268  64 288 328 144],629,4,35850,4.091531613786807,20.0,0.0
38762,3,8762,[318 427 185 515 313],655,5,35855,4.091635284719845,40.0,0.0
38763,3,8763,[328 275 210 268 176],655,1,35856,4.091282519397535,0.0,20.0
38764,3,8764,[318 427 185 515 313],655,5,35861,4.091386195094124,40.0,0.0
38765,3,8765,[ 56 172 258  82 132],796,4,35865,4.091375770020534,0.0,0.0
38766,3,8766,[318 427 185 515 313],655,5,35870,4.091479411429224,40.0,0.0
38767,3,8767,[132 211   7 173  56],535,4,35874,4.091468978102189,0.0,0.0
38768,3,8768,[318 427 185 515 313],655,5,35879,4.091572585243472,40.0,0.0
38769,3,8769,[318 427 185 515 313],655,5,35884,4.091676168757126,40.0,0.0
38770,3,8770,[237 183  56  70 191],450,5,35889,4.091779728651237,0.0,0.0
38771,3,8771,[318 427 185 515 313],655,5,35894,4.09188326493388,40.0,0.0
38772,3,8772,[318 427 185 515 313],655,5,35899,4.091986777613132,40.0,0.0
38773,3,8773,[318 427 185 515 313],655,5,35904,4.09209026669706,40.0,0.0
38774,3,8774,[196 655 276 173 161],457,5,35909,4.092193732193732,0.0,0.0
38775,3,8775,[127  96  97 210  82],450,3,35912,4.092069279854147,0.0,20.0
38776,3,8776,[196 655 191  82  96],655,1,35913,4.0917169875811785,0.0,0.0
38777,3,8777,[187  95 275 300 127],716,4,35917,4.09170653907496,0.0,40.0
38778,3,8778,[ 50  12 197 215 269],450,5,35922,4.091810001139082,0.0,20.0
38779,3,8779,[ 28 181 403  22 195],450,5,35927,4.091913439635535,0.0,0.0
38780,3,8780,[318 427 185 515 313],655,5,35932,4.092016854572372,40.0,0.0
38781,3,8781,[ 96  64 423 125 318],796,5,35937,4.0921202459576405,40.0,0.0
38782,3,8782,[318 427 185 515 313],655,5,35942,4.092223613799385,40.0,0.0
38783,3,8783,[318 427 185 515 313],655,5,35947,4.092326958105646,40.0,0.0
38784,3,8784,[318 427 185 515 313],655,5,35952,4.092430278884462,40.0,0.0
38785,3,8785,[318 427 185 515 313],655,5,35957,4.0925335761438655,40.0,0.0
38786,3,8786,[318 427 185 515 313],655,5,35962,4.0926368498918855,40.0,0.0
38787,3,8787,[180 172 245  82 210],280,1,35963,4.092284934000911,0.0,0.0
38788,3,8788,[125 172  15 196 568],655,1,35964,4.09193309819092,0.0,0.0
38789,3,8789,[318 427 185 515 313],655,5,35969,4.092036405005688,40.0,0.0
38790,3,8790,[318 427 185 515 313],655,5,35974,4.092139688317597,40.0,0.0
38791,3,8791,[318 427 185 515 313],655,5,35979,4.092242948134668,40.0,0.0
38792,3,8792,[127 151 435 191 210],450,4,35983,4.092232457636756,0.0,20.0
38793,3,8793,[228 181 191  82 176],577,4,35987,4.092221969524676,0.0,0.0
38794,3,8794,[182 357 168 118  96],457,5,35992,4.0923251847640705,0.0,0.0
38795,3,8795,[ 25 222 172 300 197],693,1,35993,4.091973624374716,0.0,0.0
38796,3,8796,[318 427 185 515 313],655,5,35998,4.092076844378766,40.0,0.0
38797,3,8797,[318 427 185 515 313],655,5,36003,4.09218004091839,40.0,0.0
38798,3,8798,[318 427 185 515 313],655,5,36008,4.092283214001591,40.0,0.0
38799,3,8799,[318 427 185 515 313],655,5,36013,4.092386363636364,40.0,0.0
38800,3,8800,[  4 357 111 117 322],344,3,36016,4.09226224292694,0.0,0.0
38801,3,8801,[318 427 185 515 313],655,5,36021,4.092365371506475,40.0,0.0
38802,3,8802,[483  70 237 194 546],716,4,36025,4.092354879018516,0.0,0.0
38803,3,8803,[318 427 185 515 313],655,5,36030,4.092457973648342,40.0,0.0
38804,3,8804,[318 427 185 515 313],655,5,36035,4.092561044860875,40.0,0.0
38805,3,8805,[318 427 185 515 313],655,5,36040,4.0926640926640925,40.0,0.0
38806,3,8806,[127 265 172   1 496],716,5,36045,4.0927671170659705,20.0,20.0
38807,3,8807,[318 427 185 515 313],655,5,36050,4.092870118074478,40.0,0.0
38808,3,8808,[403 174 196 117 197],72,4,36054,4.092859575434215,0.0,0.0
38809,3,8809,[318 427 185 515 313],655,5,36059,4.0929625425652665,40.0,0.0
38810,3,8810,[135 174 187 100   4],389,4,36063,4.0929519918283965,0.0,20.0
38811,3,8811,[173 235 258 471 118],450,3,36066,4.092827961870177,0.0,0.0
38812,3,8812,[318 427 185 515 313],655,5,36071,4.0929308975377285,40.0,0.0
38813,3,8813,[318 427 185 515 313],655,5,36076,4.093033809847969,40.0,0.0
38814,3,8814,[271   4  50 742 471],655,1,36077,4.092682926829268,0.0,20.0
38815,3,8815,[234 121  12  98 135],72,4,36081,4.092672413793103,0.0,0.0
38816,3,8816,[318 427 185 515 313],655,5,36086,4.092775320403765,40.0,0.0
38817,3,8817,[318 427 185 515 313],655,5,36091,4.092878203674303,40.0,0.0
38818,3,8818,[187 135 210 121   7],655,2,36093,4.092640888989681,0.0,0.0
38819,3,8819,[483 118 742 423  25],693,1,36094,4.092290249433106,0.0,0.0
38820,3,8820,[323 118 117 216  12],280,3,36097,4.092166421040698,0.0,0.0
38821,3,8821,[268  71  97 515 180],535,3,36100,4.092042620720925,0.0,0.0
38822,3,8822,[168 742 121 191 196],450,4,36104,4.092032188597982,0.0,0.0
38823,3,8823,[ 25 475 183 603   7],655,2,36106,4.091795104261106,20.0,0.0
38824,3,8824,[173 210  98 187  88],796,4,36110,4.0917847025495755,0.0,0.0
38825,3,8825,[318 427 185 515 313],655,5,36115,4.091887604803988,40.0,0.0
38826,3,8826,[ 71 183 197 323  88],796,3,36118,4.091763906196896,0.0,0.0
38827,3,8827,[318 427 185 515 313],655,5,36123,4.091866787494336,40.0,0.0
38828,3,8828,[318 427 185 515 313],655,5,36128,4.091969645486465,40.0,0.0
38829,3,8829,[211 275 300 179 276],535,3,36131,4.091845979614949,0.0,20.0
38830,3,8830,[ 11 111 132  88 288],280,4,36135,4.091835579209603,0.0,0.0
38831,3,8831,[197 603  69 204 228],72,4,36139,4.09182518115942,20.0,0.0
38832,3,8832,[ 56  11 211 282 153],655,0,36139,4.091361938186346,0.0,0.0
38833,3,8833,[ 22 127 204 111 173],280,3,36142,4.091238397102106,0.0,20.0
38834,3,8834,[276 471 200 385 282],280,3,36145,4.091114883984154,0.0,0.0
38835,3,8835,[318 427 185 515 313],655,5,36150,4.091217745586238,40.0,0.0
38836,3,8836,[294 742 245 161 186],450,4,36154,4.09120742333371,0.0,0.0
38837,3,8837,[195 385  56 216 245],450,5,36159,4.091310251188052,0.0,0.0
38838,3,8838,[121 273 568 269 111],796,3,36162,4.091186785835502,0.0,0.0
38839,3,8839,[118  69 318 288 228],450,3,36165,4.09106334841629,20.0,0.0
38840,3,8840,[176 111 228 118 197],796,4,36169,4.091053048297704,0.0,0.0
38841,3,8841,[234 151 405 204 174],450,4,36173,4.091042750508935,0.0,0.0
38842,3,8842,[318 427 185 515 313],655,5,36178,4.091145538844284,40.0,0.0
38843,3,8843,[ 88  82 385  50 483],716,4,36182,4.091135232926278,0.0,20.0
38844,3,8844,[318 427 185 515 313],655,5,36187,4.091237987563595,40.0,0.0
38845,3,8845,[318 427 185 515 313],655,5,36192,4.091340718969025,40.0,0.0
38846,3,8846,[ 22 216 286 271 405],655,1,36193,4.090991296484684,0.0,20.0
38847,3,8847,[318 427 185 515 313],655,5,36198,4.091094032549729,40.0,0.0
38848,3,8848,[318 427 185 515 313],655,5,36203,4.09119674539496,40.0,0.0
38849,3,8849,[222  15 151 202 187],256,3,36206,4.091073446327684,0.0,0.0
38850,3,8850,[175  89 483 275 597],23,4,36210,4.091063156705457,0.0,20.0
38851,3,8851,[318 427 185 515 313],655,5,36215,4.091165838228649,40.0,0.0
38852,3,8852,[ 71 202 403 118 678],504,2,36217,4.090929628374562,0.0,0.0
38853,3,8853,[318 111 269  22 238],655,1,36218,4.090580528574655,20.0,0.0
38854,3,8854,[ 70  88   4 210 132],786,5,36223,4.090683229813664,0.0,0.0
38855,3,8855,[318 427 185 515 313],655,5,36228,4.090785907859079,40.0,0.0
38856,3,8856,[318 427 185 515 313],655,5,36233,4.090888562718754,40.0,0.0
38857,3,8857,[286 202 568 546 215],280,2,36235,4.090652517498307,0.0,20.0
38858,3,8858,[318 427 185 515 313],655,5,36240,4.090755164239757,40.0,0.0
38859,3,8859,[318 427 185 515 313],655,5,36245,4.090857787810384,40.0,0.0
38860,3,8860,[ 89 222 403 127 187],256,4,36249,4.090847534138359,0.0,20.0
38861,3,8861,[ 70 471 186 161 496],716,2,36251,4.0906116000902735,20.0,0.0
38862,3,8862,[318 427 185 515 313],655,5,36256,4.090714205122419,40.0,0.0
38863,3,8863,[ 56 403 197 228 427],693,2,36258,4.090478339350181,20.0,0.0
38864,3,8864,[318 427 185 515 313],655,5,36263,4.090580936266216,40.0,0.0
38865,3,8865,[318 427 185 515 313],655,5,36268,4.090683510038349,40.0,0.0
38866,3,8866,[318 427 185 515 313],655,5,36273,4.090786060674411,40.0,0.0
38867,3,8867,[318 427 185 515 313],655,5,36278,4.090888588182228,40.0,0.0
38868,3,8868,[318 357 427 117 132],796,5,36283,4.090991092569625,40.0,0.0
38869,3,8869,[222 238 235 318 276],457,4,36287,4.0909808342728295,20.0,0.0
38870,3,8870,[318 427 185 515 313],655,5,36292,4.091083305151618,40.0,0.0
38871,3,8871,[318 427 185 515 313],655,5,36297,4.091185752930568,40.0,0.0
38872,3,8872,[275 143 185  22 132],457,5,36302,4.091288177617491,0.0,20.0
38873,3,8873,[  8  56 202 194 568],269,2,36304,4.091052512959207,0.0,0.0
38874,3,8874,[ 70  28 191 211 496],716,5,36309,4.091154929577465,20.0,0.0
38875,3,8875,[ 15 179  79 294 403],577,3,36312,4.091031996394772,0.0,0.0
38876,3,8876,[318 427 185 515 313],655,5,36317,4.091134392249634,40.0,0.0
38877,3,8877,[427 496 423 195 405],807,4,36321,4.091124127055643,40.0,0.0
38878,3,8878,[742 568  64 125 151],577,4,36325,4.091113864173893,20.0,0.0
38879,3,8879,[172 183 117  56 121],693,2,36327,4.090878378378378,0.0,0.0
38880,3,8880,[318 427 185 515 313],655,5,36332,4.090980745411553,40.0,0.0
38881,3,8881,[161 197 357 515 132],269,4,36336,4.090970502139158,0.0,0.0
38882,3,8882,[ 79 588 151 222  50],457,5,36341,4.091072835753687,0.0,20.0
38883,3,8883,[318 427 185 515 313],655,5,36346,4.091175146330482,40.0,0.0
38884,3,8884,[318 427 185 515 313],655,5,36351,4.0912774338773215,40.0,0.0
38885,3,8885,[322   4 235 483 742],280,4,36355,4.091267161827594,0.0,0.0
38886,3,8886,[ 28 153 496 186   4],18,3,36358,4.091144368178238,20.0,0.0
38887,3,8887,[318 427 185 515 313],655,5,36363,4.091246624662467,40.0,0.0
38888,3,8888,[257 210 515  96 288],655,1,36364,4.0908988637642025,0.0,0.0
38889,3,8889,[ 98 132 127  64 187],236,4,36368,4.090888638920135,20.0,20.0
38890,3,8890,[318 427 185 515 313],655,5,36373,4.090990889663705,40.0,0.0
38891,3,8891,[423 294 125  96 742],655,0,36373,4.0905308142150245,0.0,0.0
38892,3,8892,[ 70  28 269 603 153],655,1,36374,4.0901832902282695,20.0,0.0
38893,3,8893,[318 427 185 515 313],655,5,36379,4.0902855857881715,40.0,0.0
38894,3,8894,[151  64 183  50  12],577,5,36384,4.090387858347386,20.0,20.0
38895,3,8895,[132  11 173 427 143],716,5,36389,4.090490107913669,20.0,0.0
38896,3,8896,[318 427 185 515 313],655,5,36394,4.090592334494773,40.0,0.0
38897,3,8897,[ 22 182 197 100 273],655,2,36396,4.090357383681726,0.0,20.0
38898,3,8898,[588 118 235  15   9],457,4,36400,4.090347230025846,0.0,0.0
38899,3,8899,[318 427 185 515 313],655,5,36405,4.090449438202247,40.0,0.0
38900,3,8900,[286 211 100 222  88],264,3,36408,4.0903269295584765,0.0,40.0
38901,3,8901,[318 427 185 515 313],655,5,36413,4.090429117052348,40.0,0.0
38902,3,8902,[655   1 237 405 385],280,2,36415,4.0901943165225205,0.0,0.0
38903,3,8903,[237 175 405  22 183],457,5,36420,4.090296495956873,0.0,0.0
38904,3,8904,[ 15  96 117  89 172],450,4,36424,4.090286355979787,0.0,0.0
38905,3,8905,[294 405 597 135 427],450,4,36428,4.090276218279811,20.0,0.0
38906,3,8906,[318 427 185 515 313],655,5,36433,4.090378354103514,40.0,0.0
38907,3,8907,[318 427 185 515 313],655,5,36438,4.090480466995959,40.0,0.0
38908,3,8908,[318 427 185 515 313],655,5,36443,4.090582556964867,40.0,0.0
38909,3,8909,[322 143 546 100   8],593,2,36445,4.090347923681257,0.0,20.0
38910,3,8910,[234 180 186 216   4],457,5,36450,4.090450005611043,0.0,0.0
38911,3,8911,[318 427 185 515 313],655,5,36455,4.090552064631957,40.0,0.0
38912,3,8912,[194 435 423 168 427],65,5,36460,4.090654100751711,20.0,0.0
38913,3,8913,[546 748 153 216 385],450,5,36465,4.090756113978012,0.0,0.0
38914,3,8914,[318 427 185 515 313],655,5,36470,4.090858104318564,40.0,0.0
38915,3,8915,[403 191 268 100 427],655,2,36472,4.090623598026021,20.0,20.0
38916,3,8916,[357 185 175 234  25],18,2,36474,4.090389144331053,0.0,0.0
38917,3,8917,[127 161 228  95 181],716,4,36478,4.090379008746356,0.0,20.0
38918,3,8918,[175 588 257  11 183],457,4,36482,4.090368875434466,0.0,0.0
38919,3,8919,[318 427 185 515 313],655,5,36487,4.090470852017937,40.0,0.0
38920,3,8920,[318 427 185 515 313],655,5,36492,4.090572805739267,40.0,0.0
38921,3,8921,[318 427 185 515 313],655,5,36497,4.090674736606142,40.0,0.0
38922,3,8922,[144  11  64 322 742],450,5,36502,4.090776644626247,20.0,0.0
38923,3,8923,[ 69 568  64 245 175],344,3,36505,4.090654415060511,20.0,0.0
38924,3,8924,[ 98   4 143 211  15],593,5,36510,4.090756302521008,0.0,0.0
38925,3,8925,[318 427 185 515 313],655,5,36515,4.09085816715214,40.0,0.0
38926,3,8926,[318 427 185 515 313],655,5,36520,4.090960008961577,40.0,0.0
38927,3,8927,[318 427 185 515 313],655,5,36525,4.091061827956989,40.0,0.0
38928,3,8928,[234 546 271 182  95],796,4,36529,4.091051629521783,0.0,0.0
38929,3,8929,[172 191 603 508 300],591,3,36532,4.090929451287794,20.0,0.0
38930,3,8930,[185 210  89 238 216],269,2,36534,4.090695330870004,0.0,0.0
38931,3,8931,[318 427 185 515 313],655,5,36539,4.090797133900582,40.0,0.0
38932,3,8932,[318 427 185 515 313],655,5,36544,4.090898914138587,40.0,0.0
38933,3,8933,[276   1   4 655 125],280,2,36546,4.09066487575554,0.0,0.0
38934,3,8934,[403 187 210  70 185],450,4,36550,4.090654728595411,0.0,0.0
38935,3,8935,[ 70 603  25 211 742],450,4,36554,4.090644583706356,20.0,0.0
38936,3,8936,[318 427 185 515 313],655,5,36559,4.090746335459326,40.0,0.0
38937,3,8937,[318 427 185 515 313],655,5,36564,4.090848064443947,40.0,0.0
38938,3,8938,[117 135 144 385 483],450,3,36567,4.09072603199463,0.0,0.0
38939,3,8939,[385 143 185 173 435],450,5,36572,4.09082774049217,0.0,0.0
38940,3,8940,[318 427 185 515 313],655,5,36577,4.0909294262386755,40.0,0.0
38941,3,8941,[318 427 185 515 313],655,5,36582,4.09103108924178,40.0,0.0
38942,3,8942,[318 427 185 515 313],655,5,36587,4.0911327295091136,40.0,0.0
38943,3,8943,[187 403 276 289 286],655,2,36589,4.090898926654741,0.0,20.0
38944,3,8944,[ 96 403 288  12 179],450,4,36593,4.090888764673002,0.0,0.0
38945,3,8945,[118 186 132 282  82],450,2,36595,4.090655041359267,0.0,0.0
38946,3,8946,[286  15 603 211 100],655,1,36596,4.09030960098357,20.0,40.0
38947,3,8947,[333  98 588 301 234],796,3,36599,4.090187751452839,0.0,0.0
38948,3,8948,[318 427 185 515 313],655,5,36604,4.090289417812046,40.0,0.0
38949,3,8949,[185 258 191 182  82],457,5,36609,4.090391061452514,0.0,0.0
38950,3,8950,[153 172 435 427 483],535,4,36613,4.090380963020891,20.0,0.0
38951,3,8951,[318 427 185 515 313],655,5,36618,4.090482573726542,40.0,0.0
38952,3,8952,[  4 258 234 385 173],450,3,36621,4.090360772925276,0.0,0.0
38953,3,8953,[318 427 185 515 313],655,5,36626,4.090462363189636,40.0,0.0
38954,3,8954,[257 202  96  64 288],655,1,36627,4.090117252931323,20.0,0.0
38955,3,8955,[318 427 185 515 313],655,5,36632,4.090218847699866,40.0,0.0
38956,3,8956,[318 427 185 515 313],655,5,36637,4.09032041978341,40.0,0.0
38957,3,8957,[100 181 294   7 197],457,4,36641,4.090310337128823,0.0,20.0
38958,3,8958,[318 427 185 515 313],655,5,36646,4.090411876325483,40.0,0.0
38959,3,8959,[318 427 185 515 313],655,5,36651,4.090513392857143,40.0,0.0
38960,3,8960,[238 222  88 186 211],796,2,36653,4.090280102667113,0.0,0.0
38961,3,8961,[318 427 185 515 313],655,5,36658,4.09038161124749,40.0,0.0
38962,3,8962,[318 427 185 515 313],655,5,36663,4.090483097177285,40.0,0.0
38963,3,8963,[245 237 176  82 144],450,4,36667,4.090473003123606,0.0,0.0
38964,3,8964,[318 427 185 515 313],655,5,36672,4.090574456218628,40.0,0.0
38965,3,8965,[ 25 655 117 403 496],450,4,36676,4.09056435422708,20.0,0.0
38966,3,8966,[ 28 435 191 132 195],716,4,36680,4.090554254488681,0.0,0.0
38967,3,8967,[318 427 185 515 313],655,5,36685,4.090655664585192,40.0,0.0
38968,3,8968,[318 427 185 515 313],655,5,36690,4.090757052068235,40.0,0.0
38969,3,8969,[603  79  28 318 237],450,5,36695,4.090858416945373,40.0,0.0
38970,3,8970,[423 161 288 179 385],655,1,36696,4.0905138780515,0.0,0.0
38971,3,8971,[197  50 132 118   1],174,2,36698,4.090280873829692,0.0,20.0
38972,3,8972,[ 82 211  64 186  12],151,4,36702,4.0902708124373115,20.0,0.0
38973,3,8973,[318 427 185 515 313],655,5,36707,4.090372186316024,40.0,0.0
38974,3,8974,[276 197 117 322 357],629,4,36711,4.090362116991644,0.0,0.0
38975,3,8975,[318 427 185 515 313],655,5,36716,4.090463458110517,40.0,0.0
38976,3,8976,[318 427 185 515 313],655,5,36721,4.090564776651442,40.0,0.0
38977,3,8977,[174 183 202 313 181],450,5,36726,4.090666072621965,0.0,0.0
38978,3,8978,[216 403  97 151 172],457,5,36731,4.090767346029625,0.0,0.0
38979,3,8979,[655 357 322 496 301],151,4,36735,4.09075723830735,20.0,0.0
38980,3,8980,[318 427 185 515 313],655,5,36740,4.090858479011246,40.0,0.0
38981,3,8981,[318 211  95  79 265],450,4,36744,4.090848363393453,20.0,0.0
38982,3,8982,[172 211 111 182 435],450,5,36749,4.0909495714126685,0.0,0.0
38983,3,8983,[318 427 185 515 313],655,5,36754,4.091050756901158,40.0,0.0
38984,3,8984,[318  64  11 117  88],330,5,36759,4.091151919866444,40.0,0.0
38985,3,8985,[568 182 237  96 322],796,4,36763,4.0911417760961495,0.0,0.0
38986,3,8986,[ 56 161  97 235 127],256,3,36766,4.091020362746189,0.0,20.0
38987,3,8987,[258 603 282  88 301],796,4,36770,4.091010235870049,20.0,0.0
38988,3,8988,[423   7 183 111 191],786,5,36775,4.091111358326844,0.0,0.0
38989,3,8989,[508 175  69 333 228],655,0,36775,4.090656284760845,0.0,0.0
38990,3,8990,[180 318 111  56 603],269,3,36778,4.090534979423868,40.0,0.0
38991,3,8991,[318 427 185 515 313],655,5,36783,4.090636120996441,40.0,0.0
38992,3,8992,[318 427 185 515 313],655,5,36788,4.090737240075614,40.0,0.0
38993,3,8993,[318 427 185 515 313],655,5,36793,4.090838336668891,40.0,0.0
38994,3,8994,[182 258   8 238 603],655,2,36795,4.090605892162312,20.0,0.0
38995,3,8995,[318 427 185 515 313],655,5,36800,4.090706980880391,40.0,0.0
38996,3,8996,[318 427 185 515 313],655,5,36805,4.09080804712682,40.0,0.0
38997,3,8997,[318 427 185 515 313],655,5,36810,4.090909090909091,40.0,0.0
38998,3,8998,[318 427 185 515 313],655,5,36815,4.0910101122346925,40.0,0.0
38999,3,8999,[318 427 185 515 313],655,5,36820,4.091111111111111,40.0,0.0
39000,3,9000,[322 222 132 173 197],450,4,36824,4.091100988779025,0.0,0.0
39001,3,9001,[275 187  79 186 200],450,3,36827,4.090979782270606,0.0,20.0
39002,3,9002,[282 286 118 183 200],593,5,36832,4.091080750860824,0.0,20.0
39003,3,9003,[318 427 185 515 313],655,5,36837,4.091181697023545,40.0,0.0
39004,3,9004,[265 194 153 655 211],535,4,36841,4.091171571349251,0.0,0.0
39005,3,9005,[175 181 204 235 132],344,3,36844,4.091050410837219,0.0,0.0
39006,3,9006,[180 423 182 174 597],457,4,36848,4.091040301987343,0.0,0.0
39007,3,9007,[588 265  11 318  97],450,5,36853,4.091141207815276,20.0,0.0
39008,3,9008,[318 427 185 515 313],655,5,36858,4.0912420912420915,40.0,0.0
39009,3,9009,[318 427 185 515 313],655,5,36863,4.09134295227525,40.0,0.0
39010,3,9010,[508 191 273  64 318],401,2,36865,4.091110864498946,40.0,0.0
39011,3,9011,[318 427 185 515 313],655,5,36870,4.0912117177097205,40.0,0.0
39012,3,9012,[ 89 508   9 143 496],269,3,36873,4.0910906468434485,20.0,0.0
39013,3,9013,[318 427 185 515 313],655,5,36878,4.091191479920124,40.0,0.0
39014,3,9014,[318 427 185 515 313],655,5,36883,4.0912922906267335,40.0,0.0
39015,3,9015,[172 161 313 117 333],655,2,36885,4.09106033717835,0.0,0.0
39016,3,9016,[318 427 185 515 313],655,5,36890,4.091161140068759,40.0,0.0
39017,3,9017,[185 322 423 603 228],450,5,36895,4.091261920603238,20.0,0.0
39018,3,9018,[405 186 385 196 202],796,4,36899,4.0912518017518575,0.0,0.0
39019,3,9019,[427 121 403 117  25],450,3,36902,4.091130820399113,20.0,0.0
39020,3,9020,[427 245 286   4 235],450,3,36905,4.0910098658685285,20.0,20.0
39021,3,9021,[302 245 234 328 135],450,3,36908,4.090888938151186,0.0,0.0
39022,3,9022,[318 427 185 515 313],655,5,36913,4.090989693006761,40.0,0.0
39023,3,9023,[318 427 185 515 313],655,5,36918,4.091090425531915,40.0,0.0
39024,3,9024,[318 427 185 515 313],655,5,36923,4.091191135734072,40.0,0.0
39025,3,9025,[318 153  11 286  22],450,5,36928,4.091291823620652,20.0,20.0
39026,3,9026,[403 313 282 655 100],796,3,36931,4.091170931649496,0.0,20.0
39027,3,9027,[318 427 185 515 313],655,5,36936,4.091271599468321,40.0,0.0
39028,3,9028,[748  95 515 257 271],807,4,36940,4.0912614907520215,0.0,0.0
39029,3,9029,[318 427 185 515 313],655,5,36945,4.091362126245847,40.0,0.0
39030,3,9030,[405 294   8 181 179],457,4,36949,4.091352009744214,0.0,0.0
39031,3,9031,[318 427 185 515 313],655,5,36954,4.091452612931798,40.0,0.0
39032,3,9032,[318 427 185 515 313],655,5,36959,4.091553193844791,40.0,0.0
39033,3,9033,[318 427 185 515 313],655,5,36964,4.091653752490591,40.0,0.0
39034,3,9034,[318 427 185 515 313],655,5,36969,4.091754288876591,40.0,0.0
39035,3,9035,[318 427 185 515 313],655,5,36974,4.091854803010182,40.0,0.0
39036,3,9036,[318 427 185 515 313],655,5,36979,4.091955294898749,40.0,0.0
39037,3,9037,[318 427 185 515 313],655,5,36984,4.092055764549679,40.0,0.0
39038,3,9038,[483  15 200  89   7],269,2,36986,4.091824316849209,0.0,0.0
39039,3,9039,[318 427 185 515 313],655,5,36991,4.0919247787610615,40.0,0.0
39040,3,9040,[182  70  50 282 132],450,5,36996,4.092025218449287,0.0,20.0
39041,3,9041,[318 427 185 515 313],655,5,37001,4.092125635921256,40.0,0.0
39042,3,9042,[ 79 288 655   9 216],593,3,37004,4.0920048656419326,0.0,0.0
39043,3,9043,[318 427 185 515 313],655,5,37009,4.092105263157895,40.0,0.0
39044,3,9044,[318 427 185 515 313],655,5,37014,4.0922056384742955,40.0,0.0
39045,3,9045,[  8 423 265 117 182],655,1,37015,4.091863807207606,0.0,0.0
39046,3,9046,[318 427 185 515 313],655,5,37020,4.091964187023323,40.0,0.0
39047,3,9047,[ 64 168  82 588 180],18,3,37023,4.0918435013262595,20.0,0.0
39048,3,9048,[318 427 185 515 313],655,5,37028,4.091943861200132,40.0,0.0
39049,3,9049,[318 427 185 515 313],655,5,37033,4.092044198895028,40.0,0.0
39050,3,9050,[168 200 196  25 185],18,0,37033,4.091592089271904,0.0,0.0
39051,3,9051,[318 427 515 185 313],655,5,37038,4.09169244365886,40.0,0.0
39052,3,9052,[318 427 515 185 313],655,5,37043,4.0917927758754,40.0,0.0
39053,3,9053,[318 427 515 185 313],655,5,37048,4.091893085928871,40.0,0.0
39054,3,9054,[515 111 655 172 318],269,3,37051,4.0917725013804525,20.0,0.0
39055,3,9055,[ 64 187 294 405 186],655,2,37053,4.091541519434629,20.0,0.0
39056,3,9056,[271 237  22 597   4],796,5,37058,4.091641824003533,0.0,0.0
39057,3,9057,[318 427 515 185 313],655,5,37063,4.09174210642526,40.0,0.0
39058,3,9058,[318 427 515 185 313],655,5,37068,4.091842366707142,40.0,0.0
39059,3,9059,[179 568 322 168 273],450,4,37072,4.091832229580574,0.0,0.0
39060,3,9060,[318 427 515 185 313],655,5,37077,4.0919324577861165,40.0,0.0
39061,3,9061,[588 301 111 286  28],389,3,37080,4.0918119620392845,0.0,20.0
39062,3,9062,[174  82 405 318  88],457,5,37085,4.091912170363014,20.0,0.0
39063,3,9063,[117 286 127 191  82],786,5,37090,4.092012356575464,0.0,40.0
39064,3,9064,[318 427 515 185 313],655,5,37095,4.0921125206839495,40.0,0.0
39065,3,9065,[357 182 172 276 302],269,3,37098,4.091992058239576,0.0,0.0
39066,3,9066,[151 144 127 515 175],716,3,37101,4.091871622366825,0.0,20.0
39067,3,9067,[318 427 515 185 313],655,5,37106,4.091971768857521,40.0,0.0
39068,3,9068,[318 427 515 185 313],655,5,37111,4.092071893262763,40.0,0.0
39069,3,9069,[318 427 515 185 313],655,5,37116,4.092171995589856,40.0,0.0
39070,3,9070,[423 471 135 183  28],450,4,37120,4.092161834417374,0.0,0.0
39071,3,9071,[318 427 515 185 313],655,5,37125,4.092261904761905,40.0,0.0
39072,3,9072,[318 427 515 185 313],655,5,37130,4.0923619530475035,40.0,0.0
39073,3,9073,[117   4 405 276 258],344,2,37132,4.092131364337668,0.0,0.0
39074,3,9074,[318 427 515 185 313],655,5,37137,4.092231404958678,40.0,0.0
39075,3,9075,[318 427 515 185 313],655,5,37142,4.0923314235345964,40.0,0.0
39076,3,9076,[228 174  79 323   9],256,4,37146,4.092321251514818,0.0,0.0
39077,3,9077,[318 427 515 185 313],655,5,37151,4.092421238158185,40.0,0.0
39078,3,9078,[318 427 515 185 313],655,5,37156,4.092521202775636,40.0,0.0
39079,3,9079,[318 427 515 185 313],655,5,37161,4.09262114537445,40.0,0.0
39080,3,9080,[318 427 515 185 313],655,5,37166,4.092721065961898,40.0,0.0
39081,3,9081,[318 427 515 185 313],655,5,37171,4.092820964545254,40.0,0.0
39082,3,9082,[318 427 515 185 313],655,5,37176,4.092920841131785,40.0,0.0
39083,3,9083,[318 427 515 185 313],655,5,37181,4.093020695728754,40.0,0.0
39084,3,9084,[318 427 515 185 313],655,5,37186,4.093120528343423,40.0,0.0
39085,3,9085,[318 427 515 185 313],655,5,37191,4.093220338983051,40.0,0.0
39086,3,9086,[318 427 515 185 313],655,5,37196,4.093320127654891,40.0,0.0
39087,3,9087,[300 568  95 121 191],796,5,37201,4.093419894366197,0.0,0.0
39088,3,9088,[318 427 515 185 313],655,5,37206,4.093519639124216,40.0,0.0
39089,3,9089,[ 88 423   1  15 496],18,4,37210,4.0935093509350935,20.0,0.0
39090,3,9090,[318 427 515 185 313],655,5,37215,4.093609063909361,40.0,0.0
39091,3,9091,[269 405  50 196 597],450,5,37220,4.0937087549494064,0.0,20.0
39092,3,9092,[195  25 257 125 210],655,0,37220,4.093258550533378,0.0,0.0
39093,3,9093,[318 427 515 185 313],655,5,37225,4.0933582581922145,40.0,0.0
39094,3,9094,[603 194 172 748 216],796,5,37230,4.093457943925234,20.0,0.0
39095,3,9095,[185 121   1 588  69],450,4,37234,4.093447669305189,0.0,0.0
39096,3,9096,[275 269 111  71 268],344,3,37237,4.093327470594701,0.0,20.0
39097,3,9097,[403  56   4  88 568],450,4,37241,4.093317212574192,0.0,0.0
39098,3,9098,[132 179  96 435 273],436,3,37244,4.093197054621387,0.0,0.0
39099,3,9099,[111 234  25  28  22],18,1,37245,4.0928571428571425,0.0,0.0
39100,3,9100,[173  89  15 385 127],796,5,37250,4.092956817932095,0.0,20.0
39101,3,9101,[546 181 202 568 328],450,5,37255,4.0930564711052515,0.0,0.0
39102,3,9102,[182  88 196  79 111],389,2,37257,4.092826540700868,0.0,0.0
39103,3,9103,[288  88 742  89   4],457,5,37262,4.09292618629174,0.0,0.0
39104,3,9104,[  8 200 180 187  56],796,4,37266,4.092915980230642,0.0,0.0
39105,3,9105,[215 435 204 191 302],151,2,37268,4.09268614100593,0.0,0.0
39106,3,9106,[ 96 153 234 197 183],796,3,37271,4.092566157900516,0.0,0.0
39107,3,9107,[318 427 515 185 313],655,5,37276,4.092665788317962,40.0,0.0
39108,3,9108,[185 153 117  56  50],716,5,37281,4.092765396860248,0.0,20.0
39109,3,9109,[235 385 181 117  22],807,4,37285,4.092755214050494,0.0,0.0
39110,3,9110,[678 234 322  98 182],256,5,37290,4.092854790912084,0.0,0.0
39111,3,9111,[748 385   1 405  82],450,4,37294,4.092844600526778,0.0,0.0
39112,3,9112,[ 28 179 172  97 176],786,5,37299,4.092944145725886,0.0,0.0
39113,3,9113,[282 183 135 100 748],450,4,37303,4.092933947772657,0.0,20.0
39114,3,9114,[318 427 515 185 313],655,5,37308,4.093033461327482,40.0,0.0
39115,3,9115,[318 427 515 185 313],655,5,37313,4.093132953049583,40.0,0.0
39116,3,9116,[181 216 173  79 151],344,4,37317,4.093122737742679,0.0,0.0
39117,3,9117,[742 144 182  12 204],796,4,37321,4.093112524676465,0.0,0.0
39118,3,9118,[318 427 515 185 313],655,5,37326,4.093211974997258,40.0,0.0
39119,3,9119,[318 427 515 185 313],655,5,37331,4.093311403508772,40.0,0.0
39120,3,9120,[318 427 515 185 313],655,5,37336,4.093410810218177,40.0,0.0
39121,3,9121,[318 427 515 185 313],655,5,37341,4.093510195132646,40.0,0.0
39122,3,9122,[318 427 515 185 313],655,5,37346,4.093609558259344,40.0,0.0
39123,3,9123,[318 427 515 185 313],655,5,37351,4.093708899605436,40.0,0.0
39124,3,9124,[238  88 427 181 496],151,5,37356,4.093808219178082,40.0,0.0
39125,3,9125,[ 64 427 210  69 125],577,4,37360,4.093797939951786,40.0,0.0
39126,3,9126,[318 427 515 185 313],655,5,37365,4.0938972280048205,40.0,0.0
39127,3,9127,[237   1 405   7 117],733,0,37365,4.093448729184925,0.0,0.0
39128,3,9128,[  9 174 655 125   4],655,0,37365,4.093000328623069,0.0,0.0
39129,3,9129,[318 427 515 185 313],655,5,37370,4.093099671412925,40.0,0.0
39130,3,9130,[318 427 515 185 313],655,5,37375,4.093198992443325,40.0,0.0
39131,3,9131,[318 427 515 185 313],655,5,37380,4.093298291721419,40.0,0.0
39132,3,9132,[318 427 515 185 313],655,5,37385,4.0933975692543525,40.0,0.0
39133,3,9133,[258 357   4 423  50],450,4,37389,4.09338734398949,0.0,20.0
39134,3,9134,[318 427 515 185 313],655,5,37394,4.093486590038315,40.0,0.0
39135,3,9135,[187 179 127 186 427],296,4,37398,4.093476357267951,20.0,20.0
39136,3,9136,[655 515 172 508 318],535,3,37401,4.093356681624165,20.0,0.0
39137,3,9137,[318 427 185 515 313],655,5,37406,4.09345589844605,40.0,0.0
39138,3,9138,[318 427 185 515 313],655,5,37411,4.093555093555094,40.0,0.0
39139,3,9139,[294 471 237 333 275],655,1,37412,4.093216630196936,0.0,20.0
39140,3,9140,[318 427 185 515 313],655,5,37417,4.093315829777923,40.0,0.0
39141,3,9141,[318 427 185 515 313],655,5,37422,4.093415007656968,40.0,0.0
39142,3,9142,[318 427 185 515 313],655,5,37427,4.09351416384119,40.0,0.0
39143,3,9143,[318 427 185 515 313],655,5,37432,4.093613298337708,40.0,0.0
39144,3,9144,[  8 200 183 185 176],655,3,37435,4.093493712411154,0.0,0.0
39145,3,9145,[179 215 121   7 173],535,5,37440,4.093592827465558,0.0,0.0
39146,3,9146,[318 427 185 515 313],655,5,37445,4.093691920848365,40.0,0.0
39147,3,9147,[238  70  96   4 179],655,1,37446,4.093353738522081,0.0,0.0
39148,3,9148,[ 79  96 234 265 121],450,3,37449,4.093234233249535,0.0,0.0
39149,3,9149,[318 427 185 515 313],655,5,37454,4.093333333333334,40.0,0.0
39150,3,9150,[  7  11  71 195 302],450,4,37458,4.093323134083707,0.0,0.0
39151,3,9151,[318 427 185 515 313],655,5,37463,4.0934222027972025,40.0,0.0
39152,3,9152,[ 71  98 286  11 185],535,3,37466,4.093302742270294,0.0,20.0
39153,3,9153,[318 427 185 515 313],655,5,37471,4.093401791566528,40.0,0.0
39154,3,9154,[143 403 117 385 100],655,1,37472,4.093063899508465,0.0,20.0
39155,3,9155,[195 118 204  79 313],450,4,37476,4.0930537352555705,0.0,0.0
39156,3,9156,[186 313 127 168 173],807,3,37479,4.092934367150813,0.0,20.0
39157,3,9157,[228   1  88 282 405],450,5,37484,4.093033413409041,0.0,0.0
39158,3,9158,[318 427 185 515 313],655,5,37489,4.093132438039087,40.0,0.0
39159,3,9159,[318 427 185 515 313],655,5,37494,4.093231441048035,40.0,0.0
39160,3,9160,[318 427 185 515 313],655,5,37499,4.093330422442965,40.0,0.0
39161,3,9161,[  4 282 269  82 185],655,1,37500,4.092992796332679,0.0,0.0
39162,3,9162,[275 125 180 515 100],296,5,37505,4.093091782167412,0.0,40.0
39163,3,9163,[ 15 180 423 135 234],457,5,37510,4.093190746398952,0.0,0.0
39164,3,9164,[318 427 185 515 313],655,5,37515,4.0932896890343695,40.0,0.0
39165,3,9165,[286  64 237 423  88],18,3,37518,4.093170412393628,20.0,20.0
39166,3,9166,[318 427 185 515 313],655,5,37523,4.093269335660522,40.0,0.0
39167,3,9167,[ 56 186 423 403 210],450,3,37526,4.093150087260035,0.0,0.0
39168,3,9168,[597 318 187 153  97],450,5,37531,4.093248991165885,20.0,0.0
39169,3,9169,[186 204 132 180 357],504,3,37534,4.093129770992366,0.0,0.0
39170,3,9170,[318 427 185 515 313],655,5,37539,4.093228655544651,40.0,0.0
39171,3,9171,[197 117 175 423 195],457,5,37544,4.093327518534671,0.0,0.0
39172,3,9172,[435   1 238  82 228],450,4,37548,4.093317344380246,0.0,0.0
39173,3,9173,[182 202 328 228  56],796,5,37553,4.093416176149989,0.0,0.0
39174,3,9174,[318 427 185 515 313],655,5,37558,4.093514986376022,40.0,0.0
39175,3,9175,[289 318  69 174 403],807,5,37563,4.093613775065388,20.0,0.0
39176,3,9176,[ 79 183 161 182 427],450,5,37568,4.093712542225128,20.0,0.0
39177,3,9177,[318 427 185 515 313],655,5,37573,4.093811287862279,40.0,0.0
39178,3,9178,[210 194 202 211 168],18,2,37575,4.093583178995534,0.0,0.0
39179,3,9179,[153  56 403  96 471],280,3,37578,4.093464052287581,0.0,0.0
39180,3,9180,[318 427 185 515 313],655,5,37583,4.0935627927241045,40.0,0.0
39181,3,9181,[318 427 185 515 313],655,5,37588,4.093661511653234,40.0,0.0
39182,3,9182,[748 144 471 135 655],401,2,37590,4.093433518458021,0.0,0.0
39183,3,9183,[ 96 151 186 313 185],796,4,37594,4.093423344947735,0.0,0.0
39184,3,9184,[405 269 301 597 471],344,2,37596,4.093195427327164,0.0,0.0
39185,3,9185,[174 200 194  64 117],236,1,37597,4.092858698018724,20.0,0.0
39186,3,9186,[ 79 117 228 118 197],280,2,37599,4.0926308914770875,0.0,0.0
39187,3,9187,[ 96 118 173 215 294],577,4,37603,4.092620809751851,0.0,0.0
39188,3,9188,[318 427 185 515 313],655,5,37608,4.0927195559908585,40.0,0.0
39189,3,9189,[318 427 185 515 313],655,5,37613,4.092818280739935,40.0,0.0
39190,3,9190,[ 96 234 125 161 222],450,3,37616,4.092699379828093,0.0,0.0
39191,3,9191,[234 197 132 172 313],450,4,37620,4.092689295039165,0.0,0.0
39192,3,9192,[318 427 185 515 313],655,5,37625,4.092787990862613,40.0,0.0
39193,3,9193,[127 300 191  79 427],655,4,37629,4.092777898629541,20.0,20.0
39194,3,9194,[318 427 185 515 313],655,5,37634,4.0928765633496464,40.0,0.0
39195,3,9195,[318 427 185 515 313],655,5,37639,4.0929752066115705,40.0,0.0
39196,3,9196,[191 121  69 427 475],269,3,37642,4.092856366206371,20.0,0.0
39197,3,9197,[117 515  25 294 151],401,2,37644,4.09262883235486,0.0,0.0
39198,3,9198,[318 427 185 515 313],655,5,37649,4.0927274703772145,40.0,0.0
39199,3,9199,[318 427 185 515 313],655,5,37654,4.092826086956522,40.0,0.0
39200,3,9200,[ 56 427  50 117 216],655,3,37657,4.092707314422346,20.0,20.0
39201,3,9201,[ 70 228 234 161 276],280,3,37660,4.092588567702673,0.0,0.0
39202,3,9202,[  4 294 202 200 197],450,3,37663,4.092469846789091,0.0,0.0
39203,3,9203,[318 427 185 515 313],655,5,37668,4.092568448500652,40.0,0.0
39204,3,9204,[180 200 289 191 210],786,5,37673,4.092667028788702,0.0,0.0
39205,3,9205,[515 483  97 275  70],18,5,37678,4.092765587660222,0.0,20.0
39206,3,9206,[318 427 185 515 313],655,5,37683,4.0928641251221896,40.0,0.0
39207,3,9207,[257 176  70 196 182],655,1,37684,4.092528236316247,0.0,0.0
39208,3,9208,[568 216 588 121 318],716,5,37689,4.092626778151808,20.0,0.0
39209,3,9209,[318 427 185 515 313],655,5,37694,4.0927252985884905,40.0,0.0
39210,3,9210,[318 427 185 515 313],655,5,37699,4.092823797633264,40.0,0.0
39211,3,9211,[143  71 276 216 238],504,3,37702,4.092705167173253,0.0,0.0
39212,3,9212,[318 427 185 515 313],655,5,37707,4.0928036470205145,40.0,0.0
39213,3,9213,[318 427 185 515 313],655,5,37712,4.0929021054916435,40.0,0.0
39214,3,9214,[151 427 588 210 742],796,3,37715,4.092783505154639,20.0,0.0
39215,3,9215,[ 22 257 435   1 179],296,5,37720,4.092881944444445,0.0,0.0
39216,3,9216,[318 427 185 515 313],655,5,37725,4.092980362373875,40.0,0.0
39217,3,9217,[118 258 197 318 546],693,2,37727,4.092753308743762,20.0,0.0
39218,3,9218,[125  28  25  88 111],65,5,37732,4.0928517192754095,0.0,0.0
39219,3,9219,[318 427 185 515 313],655,5,37737,4.09295010845987,40.0,0.0
39220,3,9220,[ 98 196 204 210 186],457,5,37742,4.093048476304088,0.0,0.0
39221,3,9221,[143 385 273   9 333],655,2,37744,4.092821513771416,0.0,0.0
39222,3,9222,[318 427 185 515 313],655,5,37749,4.092919874227475,40.0,0.0
39223,3,9223,[237  69   9  97  25],593,3,37752,4.092801387684302,0.0,0.0
39224,3,9224,[234 427 258 135 121],151,5,37757,4.09289972899729,20.0,0.0
39225,3,9225,[318 427 185 515 313],655,5,37762,4.092998048991979,40.0,0.0
39226,3,9226,[ 15 597 197 286 186],796,2,37764,4.092771214912756,0.0,20.0
39227,3,9227,[655 742 234 257 132],457,4,37768,4.092761161681838,0.0,0.0
39228,3,9228,[186 176 196  22 111],655,0,37768,4.092317694224726,0.0,0.0
39229,3,9229,[286 322 186 181  11],450,4,37772,4.092307692307692,0.0,20.0
39230,3,9230,[318 427 185 515 313],655,5,37777,4.092406023182754,40.0,0.0
39231,3,9231,[318 427 185 515 313],655,5,37782,4.092504332755633,40.0,0.0
39232,3,9232,[318 427 185 515 313],655,5,37787,4.09260262103325,40.0,0.0
39233,3,9233,[318 427 185 515 313],655,5,37792,4.0927008880225255,40.0,0.0
39234,3,9234,[258 742 238 132 135],450,4,37796,4.092690850027071,0.0,0.0
39235,3,9235,[318 427 185 515 313],655,5,37801,4.092789086184496,40.0,0.0
39236,3,9236,[168 121 423 568  95],330,4,37805,4.092779040814117,0.0,0.0
39237,3,9237,[318 427 185 515 313],655,5,37810,4.092877246157177,40.0,0.0
39238,3,9238,[318 427 185 515 313],655,5,37815,4.092975430241368,40.0,0.0
39239,3,9239,[318 427 185 515 313],655,5,37820,4.093073593073593,40.0,0.0
39240,3,9240,[318 427 185 515 313],655,5,37825,4.093171734660751,40.0,0.0
39241,3,9241,[318 427 185 515 313],655,5,37830,4.093269855009738,40.0,0.0
39242,3,9242,[ 70 385  56  28 258],504,3,37833,4.093151574164232,0.0,0.0
39243,3,9243,[318 427 185 515 313],655,5,37838,4.093249675465167,40.0,0.0
39244,3,9244,[318 427 185 515 313],655,5,37843,4.093347755543537,40.0,0.0
39245,3,9245,[318 427 185 515 313],655,5,37848,4.09344581440623,40.0,0.0
39246,3,9246,[318 427 185 515 313],655,5,37853,4.093543852060128,40.0,0.0
39247,3,9247,[318 427 185 515 313],655,5,37858,4.093641868512111,40.0,0.0
39248,3,9248,[ 71  89  69 196  56],450,4,37862,4.093631743972321,0.0,0.0
39249,3,9249,[238 204   8 187 435],269,2,37864,4.093405405405405,0.0,0.0
39250,3,9250,[318 427 185 515 313],655,5,37869,4.093503405037294,40.0,0.0
39251,3,9251,[269 357 195 183 603],655,3,37872,4.093385214007782,20.0,0.0
39252,3,9252,[318 427 185 515 313],655,5,37877,4.093483194639576,40.0,0.0
39253,3,9253,[  8  50  98 191 185],655,4,37881,4.093473092716663,0.0,20.0
39254,3,9254,[  7  15 515 268  50],655,2,37883,4.093246893571043,0.0,20.0
39255,3,9255,[ 56 125 196  69 318],450,5,37888,4.093344857389801,20.0,0.0
39256,3,9256,[318 427 185 515 313],655,5,37893,4.093442800043211,40.0,0.0
39257,3,9257,[ 25 132 300 273 191],450,3,37896,4.093324692158133,0.0,0.0
39258,3,9258,[180 515 269 186 127],296,4,37900,4.093314612809158,0.0,20.0
39259,3,9259,[179 483 211 265 204],236,1,37901,4.092980561555075,0.0,0.0
39260,3,9260,[318 427 185 515 313],655,5,37906,4.0930785012417665,40.0,0.0
39261,3,9261,[318 427 185 515 313],655,5,37911,4.093176419779745,40.0,0.0
39262,3,9262,[ 71 265 742  96 168],577,5,37916,4.093274317175861,0.0,0.0
39263,3,9263,[318 427 185 515 313],655,5,37921,4.09337219343696,40.0,0.0
39264,3,9264,[144 117 322  22 168],796,4,37925,4.0933621154883975,0.0,0.0
39265,3,9265,[318 427 185 515 313],655,5,37930,4.093459961148284,40.0,0.0
39266,3,9266,[121  11 258 273  97],450,3,37933,4.093341966116327,0.0,0.0
39267,3,9267,[318 427 185 515 313],655,5,37938,4.0934397928355635,40.0,0.0
39268,3,9268,[318 427 185 515 313],655,5,37943,4.093537598446434,40.0,0.0
39269,3,9269,[313 245 273 187 143],796,3,37946,4.093419633225459,0.0,0.0
39270,3,9270,[318 427 185 515 313],655,5,37951,4.093517419911552,40.0,0.0
39271,3,9271,[318 427 185 515 313],655,5,37956,4.093615185504746,40.0,0.0
39272,3,9272,[318 427 185 515 313],655,5,37961,4.093712930011862,40.0,0.0
39273,3,9273,[427 603  56  28 174],389,5,37966,4.093810653439724,40.0,0.0
39274,3,9274,[183 294 322 132 323],796,2,37968,4.093584905660378,0.0,0.0
39275,3,9275,[172 234  50 282 151],256,3,37971,4.093467011642949,0.0,20.0
39276,3,9276,[302  98 173 174 471],450,5,37976,4.093564729977364,0.0,0.0
39277,3,9277,[385 222  22 186 405],796,4,37980,4.093554645397715,0.0,0.0
39278,3,9278,[202   1 211 215 496],716,5,37985,4.093652333225563,20.0,0.0
39279,3,9279,[  9  98   8 357 183],269,3,37988,4.093534482758621,0.0,0.0
39280,3,9280,[168 275 655 111   1],457,4,37992,4.09352440469777,0.0,20.0
39281,3,9281,[385 132 322 286  98],344,2,37994,4.09329885800474,0.0,20.0
39282,3,9282,[318 427 185 515 313],655,5,37999,4.093396531293763,40.0,0.0
39283,3,9283,[318 427 185 515 313],655,5,38004,4.093494183541577,40.0,0.0
39284,3,9284,[318 427 185 515 313],655,5,38009,4.093591814754981,40.0,0.0
39285,3,9285,[ 79 423 222  89  95],807,5,38014,4.093689424940771,0.0,0.0
39286,3,9286,[318 427 185 515 313],655,5,38019,4.0937870141057395,40.0,0.0
39287,3,9287,[  7 483 328 655 294],655,1,38020,4.093453919035315,0.0,0.0
39288,3,9288,[174 258  22 153 603],535,4,38024,4.093443858327054,20.0,0.0
39289,3,9289,[132 195 423 273 211],236,2,38026,4.093218514531754,0.0,0.0
39290,3,9290,[318 427 185 515 313],655,5,38031,4.093316112366806,40.0,0.0
39291,3,9291,[405 300 423 186   9],796,3,38034,4.093198450279811,0.0,0.0
39292,3,9292,[288 742 143 191   1],457,5,38039,4.093296029269342,0.0,0.0
39293,3,9293,[183   9 174 328 302],151,2,38041,4.093070798364536,0.0,0.0
39294,3,9294,[132 197 423 144 174],535,4,38045,4.093060785368477,0.0,0.0
39295,3,9295,[195 132 258 603 215],151,3,38048,4.0929432013769365,20.0,0.0
39296,3,9296,[318 427 185 515 313],655,5,38053,4.093040765838443,40.0,0.0
39297,3,9297,[318 427 185 515 313],655,5,38058,4.093138309313831,40.0,0.0
39298,3,9298,[318 427 185 515 313],655,5,38063,4.093235831809872,40.0,0.0
39299,3,9299,[318 427 185 515 313],655,5,38068,4.093333333333334,40.0,0.0
39300,3,9300,[176 197 111 257 185],655,1,38069,4.093000752607247,0.0,0.0
39301,3,9301,[  8 385 173  28  69],807,4,38073,4.092990754676413,0.0,0.0
39302,3,9302,[318 427 185 515 313],655,5,38078,4.093088251101795,40.0,0.0
39303,3,9303,[515 185 183 195 187],269,3,38081,4.092970765262253,0.0,0.0
39304,3,9304,[318 427 185 515 313],655,5,38086,4.093068242880172,40.0,0.0
39305,3,9305,[204  56 423 195 288],908,5,38091,4.0931656995486785,0.0,0.0
39306,3,9306,[568  96 313 237 288],280,2,38093,4.0929407972493825,0.0,0.0
39307,3,9307,[318 427 185 515 313],655,5,38098,4.093038246669532,40.0,0.0
39308,3,9308,[271 204 237   7 265],655,0,38098,4.092598560532818,0.0,0.0
39309,3,9309,[318 427 185 515 313],655,5,38103,4.092696025778732,40.0,0.0
39310,3,9310,[318 427 185 515 313],655,5,38108,4.092793470089142,40.0,0.0
39311,3,9311,[318 427 185 515 313],655,5,38113,4.09289089347079,40.0,0.0
39312,3,9312,[588   1   8 748 174],280,3,38116,4.092773542360142,0.0,0.0
39313,3,9313,[318 427 185 515 313],655,5,38121,4.092870946961563,40.0,0.0
39314,3,9314,[181 196 568 273 294],655,1,38122,4.092538915727322,0.0,0.0
39315,3,9315,[318 427 185 515 313],655,5,38127,4.092636324602834,40.0,0.0
39316,3,9316,[235  70 228 301 143],450,4,38131,4.09262638188258,0.0,0.0
39317,3,9317,[318 427 185 515 313],655,5,38136,4.092723760463619,40.0,0.0
39318,3,9318,[318 427 185 515 313],655,5,38141,4.092821118145724,40.0,0.0
39319,3,9319,[318 427 185 515 313],655,5,38146,4.092918454935623,40.0,0.0
39320,3,9320,[318 427 185 515 313],655,5,38151,4.093015770840038,40.0,0.0
39321,3,9321,[318 427 185 515 313],655,5,38156,4.093113065865694,40.0,0.0
39322,3,9322,[318 427 185 515 313],655,5,38161,4.093210340019307,40.0,0.0
39323,3,9323,[318 427 185 515 313],655,5,38166,4.0933075933075935,40.0,0.0
39324,3,9324,[196 423 234  79 273],796,3,38169,4.093190348525469,0.0,0.0
39325,3,9325,[234 195  22   4  11],280,2,38171,4.09296590177997,0.0,0.0
39326,3,9326,[318 427 185 515 313],655,5,38176,4.093063149994639,40.0,0.0
39327,3,9327,[197 144  28 328  50],450,5,38181,4.09316037735849,0.0,20.0
39328,3,9328,[318 427 185 515 313],655,5,38186,4.093257583878229,40.0,0.0
39329,3,9329,[385 238 161 210 294],457,4,38190,4.093247588424437,0.0,0.0
39330,3,9330,[318 427 185 515 313],655,5,38195,4.0933447647626195,40.0,0.0
39331,3,9331,[742 333  69  98 403],655,1,38196,4.093013287612516,0.0,0.0
39332,3,9332,[144 496  25 202 405],716,4,38200,4.093003321547198,20.0,0.0
39333,3,9333,[318 301 222  12 202],796,4,38204,4.092993357617313,20.0,0.0
39334,3,9334,[318 427 185 515 313],655,5,38209,4.09309051955008,40.0,0.0
39335,3,9335,[318 427 185 515 313],655,5,38214,4.093187660668381,40.0,0.0
39336,3,9336,[318 427 185 515 313],655,5,38219,4.093284780978901,40.0,0.0
39337,3,9337,[318 427 185 515 313],655,5,38224,4.0933818804883275,40.0,0.0
39338,3,9338,[237 195 127 186 191],450,4,38228,4.093371881357747,0.0,20.0
39339,3,9339,[288 294  97 357 125],450,4,38232,4.093361884368308,0.0,0.0
39340,3,9340,[111 269 300 237 322],796,3,38235,4.09324483460015,0.0,0.0
39341,3,9341,[ 96 176 174 191 294],716,3,38238,4.093127809890816,0.0,0.0
39342,3,9342,[ 12  28   8 197 357],655,1,38239,4.092796746227122,0.0,0.0
39343,3,9343,[318 427 185 515 313],655,5,38244,4.092893835616438,40.0,0.0
39344,3,9344,[318 427 185 515 313],655,5,38249,4.092990904226859,40.0,0.0
39345,3,9345,[125 385 265 168 269],796,4,38253,4.092980954419003,0.0,0.0
39346,3,9346,[318 427 185 515 313],655,5,38258,4.093077992938911,40.0,0.0
39347,3,9347,[318 427 185 515 313],655,5,38263,4.093175010697475,40.0,0.0
39348,3,9348,[194 127  12  89   1],796,4,38267,4.0931650443897745,0.0,20.0
39349,3,9349,[276 215  28  98  12],457,5,38272,4.093262032085562,0.0,0.0
39350,3,9350,[318 427 185 515 313],655,5,38277,4.0933589990375365,40.0,0.0
39351,3,9351,[318 427 185 515 313],655,5,38282,4.0934559452523525,40.0,0.0
39352,3,9352,[318 427 185 515 313],655,5,38287,4.093552870736662,40.0,0.0
39353,3,9353,[318 427 185 515 313],655,5,38292,4.093649775497114,40.0,0.0
39354,3,9354,[228 427  98 183 301],796,4,38296,4.093639764831641,20.0,0.0
39355,3,9355,[173   7 187 153   1],450,5,38301,4.093736639589568,0.0,0.0
39356,3,9356,[234 216 427 182 186],503,4,38305,4.093726621780485,20.0,0.0
39357,3,9357,[318 427 185 515 313],655,5,38310,4.093823466552682,40.0,0.0
39358,3,9358,[302 111  56 427 204],269,2,38312,4.093599743562346,20.0,0.0
39359,3,9359,[196 483   9 238 403],457,5,38317,4.093696581196581,0.0,0.0
39360,3,9360,[597 588  70 423 132],450,5,38322,4.093793398141225,0.0,0.0
39361,3,9361,[ 28 483   7 127 195],908,4,38326,4.093783379619739,0.0,20.0
39362,3,9362,[215 268   7 183 302],344,3,38329,4.0936665598632915,0.0,0.0
39363,3,9363,[318 427 185 515 313],655,5,38334,4.093763348996156,40.0,0.0
39364,3,9364,[483 222 423 151 127],716,5,38339,4.093860117458623,0.0,20.0
39365,3,9365,[111  11 182 403  79],450,5,38344,4.093956865257313,0.0,0.0
39366,3,9366,[318 427 185 515 313],655,5,38349,4.094053592398847,40.0,0.0
39367,3,9367,[318 427 185 515 313],655,5,38354,4.094150298889838,40.0,0.0
39368,3,9368,[318 427 185 515 313],655,5,38359,4.094246984736898,40.0,0.0
39369,3,9369,[318 427 185 515 313],655,5,38364,4.094343649946638,40.0,0.0
39370,3,9370,[196 183 185 300 179],655,3,38367,4.094226870131256,0.0,0.0
39371,3,9371,[483   7 318 228  96],450,4,38371,4.094216816047802,20.0,0.0
39372,3,9372,[483 403 234 288   9],693,0,38371,4.093780006401365,0.0,0.0
39373,3,9373,[202 179 204 100  25],389,4,38375,4.093770002133561,0.0,20.0
39374,3,9374,[121 228   1 187  89],296,5,38380,4.093866666666667,0.0,0.0
39375,3,9375,[318 427 185 515 313],655,5,38385,4.093963310580205,40.0,0.0
39376,3,9376,[318 427 185 515 313],655,5,38390,4.094059933880772,40.0,0.0
39377,3,9377,[318 427 185 515 313],655,5,38395,4.094156536574963,40.0,0.0
39378,3,9378,[318 427 185 515 313],655,5,38400,4.094253118669368,40.0,0.0
39379,3,9379,[161 588 195 185 196],796,5,38405,4.094349680170576,0.0,0.0
39380,3,9380,[318 427 185 515 313],655,5,38410,4.094446221085172,40.0,0.0
39381,3,9381,[318 427 185 515 313],655,5,38415,4.0945427414197395,40.0,0.0
39382,3,9382,[483 100  95 135 197],280,3,38418,4.094426089736758,0.0,20.0
39383,3,9383,[176 597 186 435 168],450,4,38422,4.094416027280477,0.0,0.0
39384,3,9384,[318 427 185 515 313],655,5,38427,4.094512519978689,40.0,0.0
39385,3,9385,[215  12   8   1 294],796,3,38430,4.094395908800341,0.0,0.0
39386,3,9386,[588 282 121 176 258],450,4,38434,4.0943858527751145,0.0,0.0
39387,3,9387,[318 427 185 515 313],655,5,38439,4.094482317852577,40.0,0.0
39388,3,9388,[265 318 151 403 176],457,5,38444,4.09457876238151,20.0,0.0
39389,3,9389,[318 427 185 515 313],655,5,38449,4.094675186368477,40.0,0.0
39390,3,9390,[318 427 185 515 313],655,5,38454,4.0947715898200405,40.0,0.0
39391,3,9391,[471  79 289 127 144],655,2,38456,4.0945485519591145,0.0,20.0
39392,3,9392,[216 257  96  50 144],655,2,38458,4.094325561588417,0.0,20.0
39393,3,9393,[127 121  98 228 215],716,5,38463,4.094421971471152,0.0,20.0
39394,3,9394,[ 82 196 483  88 435],18,2,38465,4.09419904204364,0.0,0.0
39395,3,9395,[318 427 185 515 313],655,5,38470,4.094295444870157,40.0,0.0
39396,3,9396,[318 174 222  79  70],72,4,38474,4.09428541023731,20.0,0.0
39397,3,9397,[423 276 151  50 546],174,2,38476,4.094062566503512,0.0,20.0
39398,3,9398,[496 197 405  69  96],269,2,38478,4.093839770188318,20.0,0.0
39399,3,9399,[318 427 185 515 313],655,5,38483,4.093936170212766,40.0,0.0
39400,3,9400,[318 427 185 515 313],655,5,38488,4.094032549728753,40.0,0.0
39401,3,9401,[282 143  28 742  97],450,5,38493,4.094128908742821,0.0,0.0
39402,3,9402,[228 187 180 204  50],796,4,38497,4.094118898223971,0.0,20.0
39403,3,9403,[318 427 185 515 313],655,5,38502,4.0942152275627395,40.0,0.0
39404,3,9404,[318 427 185 515 313],655,5,38507,4.094311536416799,40.0,0.0
39405,3,9405,[318 427 185 515 313],655,5,38512,4.094407824792685,40.0,0.0
39406,3,9406,[385 183 186  70 200],151,2,38514,4.094185181248007,0.0,0.0
39407,3,9407,[144 423 173 100   9],629,5,38519,4.094281462585034,0.0,20.0
39408,3,9408,[318 427 185 515 313],655,5,38524,4.094377723456265,40.0,0.0
39409,3,9409,[302 423 121 265 143],655,2,38526,4.094155154091392,0.0,0.0
39410,3,9410,[318 427 185 515 313],655,5,38531,4.094251407926894,40.0,0.0
39411,3,9411,[318 427 185 515 313],655,5,38536,4.094347641308968,40.0,0.0
39412,3,9412,[405 294 127  98  79],457,4,38540,4.0943376181876125,0.0,20.0
39413,3,9413,[318 427 185 515 313],655,5,38545,4.094433821967283,40.0,0.0
39414,3,9414,[318 427 185 515 313],655,5,38550,4.094530005310674,40.0,0.0
39415,3,9415,[318 427 185 515 313],655,5,38555,4.094626168224299,40.0,0.0
39416,3,9416,[183  79 269  89 323],796,3,38558,4.094509928852076,0.0,0.0
39417,3,9417,[318 427 185 515 313],655,5,38563,4.094606073476322,40.0,0.0
39418,3,9418,[423 173  71 151 238],535,5,38568,4.094702197685529,0.0,0.0
39419,3,9419,[318 427 185 515 313],655,5,38573,4.0947983014861995,40.0,0.0
39420,3,9420,[655  22  88 568 197],450,5,38578,4.094894384884832,0.0,0.0
39421,3,9421,[318 427 185 515 313],655,5,38583,4.0949904478879215,40.0,0.0
39422,3,9422,[318 427 185 515 313],655,5,38588,4.095086490501964,40.0,0.0
39423,3,9423,[318 427 185 515 313],655,5,38593,4.095182512733446,40.0,0.0
39424,3,9424,[318 427 185 515 313],655,5,38598,4.095278514588859,40.0,0.0
39425,3,9425,[ 12 117 546 172   8],457,4,38602,4.095268406535116,0.0,0.0
39426,3,9426,[322 172 301 275 568],450,5,38607,4.095364378911637,0.0,20.0
39427,3,9427,[318 427 185 515 313],655,5,38612,4.095460330929147,40.0,0.0
39428,3,9428,[318 427 185 515 313],655,5,38617,4.095556262594124,40.0,0.0
39429,3,9429,[318 427 185 515 313],655,5,38622,4.095652173913043,40.0,0.0
39430,3,9430,[173  69 121 183 268],344,2,38624,4.0954299650090125,0.0,0.0
39431,3,9431,[655  69 405  11 186],577,3,38627,4.095313825275658,0.0,0.0
39432,3,9432,[318 427 185 515 313],655,5,38632,4.095409731792643,40.0,0.0
39433,3,9433,[313 742 210  69 245],450,4,38636,4.095399618401526,0.0,0.0
39434,3,9434,[318 427 185 515 313],655,5,38641,4.095495495495496,40.0,0.0
39435,3,9435,[127 318 180  69 222],72,4,38645,4.095485375158965,20.0,20.0
39436,3,9436,[318 427 185 515 313],655,5,38650,4.095581222846244,40.0,0.0
39437,3,9437,[318 427 185 515 313],655,5,38655,4.095677050222505,40.0,0.0
39438,3,9438,[237 245 568  96 185],450,5,38660,4.095772857294205,0.0,0.0
39439,3,9439,[318 427 185 515 313],655,5,38665,4.095868644067797,40.0,0.0
39440,3,9440,[471 597 245 276 181],938,1,38666,4.095540726617943,0.0,0.0
39441,3,9441,[546 483  12 286 282],450,4,38670,4.095530607922051,0.0,20.0
39442,3,9442,[318 427 185 515 313],655,5,38675,4.095626389918458,40.0,0.0
39443,3,9443,[318 427 185 515 313],655,5,38680,4.095722151630665,40.0,0.0
39444,3,9444,[ 97 202  82 210 173],577,4,38684,4.09571201694018,0.0,0.0
39445,3,9445,[318 427 185 515 313],655,5,38689,4.095807749311878,40.0,0.0
39446,3,9446,[318 427 185 515 313],655,5,38694,4.095903461416323,40.0,0.0
39447,3,9447,[318 427 185 515 313],655,5,38699,4.09599915325995,40.0,0.0
39448,3,9448,[318 427 185 515 313],655,5,38704,4.096094824849191,40.0,0.0
39449,3,9449,[318 427 185 515 313],655,5,38709,4.096190476190476,40.0,0.0
39450,3,9450,[143 483 427 211 196],18,4,38713,4.096180298381124,20.0,0.0
39451,3,9451,[111 742  95 210 483],280,4,38717,4.096170122725349,0.0,0.0
39452,3,9452,[318 427 185 515 313],655,5,38722,4.096265735745266,40.0,0.0
39453,3,9453,[ 98 237 385 286 483],450,4,38726,4.096255553204992,0.0,20.0
39454,3,9454,[318 427 185 515 313],655,5,38731,4.096351136964569,40.0,0.0
39455,3,9455,[318 427 185 515 313],655,5,38736,4.096446700507614,40.0,0.0
39456,3,9456,[318 427 185 515 313],655,5,38741,4.096542243840541,40.0,0.0
39457,3,9457,[318 427 185 515 313],655,5,38746,4.096637766969761,40.0,0.0
39458,3,9458,[204 100 302 228 195],655,1,38747,4.096310392219051,0.0,20.0
39459,3,9459,[ 25 179 143 125  97],504,4,38751,4.096300211416491,0.0,0.0
39460,3,9460,[318 427 185 515 313],655,5,38756,4.096395729838283,40.0,0.0
39461,3,9461,[111 222 282 179 100],236,3,38759,4.096279856267174,0.0,20.0
39462,3,9462,[318 427 185 515 313],655,5,38764,4.096375356652224,40.0,0.0
39463,3,9463,[318 427 185 515 313],655,5,38769,4.0964708368554525,40.0,0.0
39464,3,9464,[318 427 185 515 313],655,5,38774,4.096566296883254,40.0,0.0
39465,3,9465,[216 191 588  64 483],401,3,38777,4.096450454257342,20.0,0.0
39466,3,9466,[318 427 185 515 313],655,5,38782,4.096545896271258,40.0,0.0
39467,3,9467,[258 186  98   9 228],296,4,38786,4.096535699197296,0.0,0.0
39468,3,9468,[318 427 185 515 313],655,5,38791,4.096631112049847,40.0,0.0
39469,3,9469,[176 323 143 568 186],20,2,38793,4.096409714889123,0.0,0.0
39470,3,9470,[318 427 185 515 313],655,5,38798,4.0965051208953644,40.0,0.0
39471,3,9471,[435 186 200 257 183],655,2,38800,4.096283783783784,0.0,0.0
39472,3,9472,[318 427 185 515 313],655,5,38805,4.09637918294099,40.0,0.0
39473,3,9473,[318 427 185 515 313],655,5,38810,4.096474561959046,40.0,0.0
39474,3,9474,[318 427 185 515 313],655,5,38815,4.096569920844328,40.0,0.0
39475,3,9475,[318 427 185 515 313],655,5,38820,4.096665259603208,40.0,0.0
39476,3,9476,[318 427 185 515 313],655,5,38825,4.096760578242059,40.0,0.0
39477,3,9477,[318 427 185 515 313],655,5,38830,4.0968558767672505,40.0,0.0
39478,3,9478,[318 427 185 515 313],655,5,38835,4.096951155185146,40.0,0.0
39479,3,9479,[200 127 196 135   4],716,3,38838,4.096835443037975,0.0,20.0
39480,3,9480,[318 427 185 515 313],655,5,38843,4.096930703512288,40.0,0.0
39481,3,9481,[ 22 187 185 237 748],796,5,38848,4.097025943893693,0.0,0.0
39482,3,9482,[ 82 496 183 161 200],786,5,38853,4.097121164188548,20.0,0.0
39483,3,9483,[318 427 185 515 313],655,5,38858,4.097216364403206,40.0,0.0
39484,3,9484,[ 79 194 173 185 168],796,5,38863,4.0973115445440165,0.0,0.0
39485,3,9485,[ 88 144  50 258 742],457,5,38868,4.097406704617331,0.0,20.0
39486,3,9486,[ 98 275 195 181 185],18,2,38870,4.097185622430695,0.0,20.0
39487,3,9487,[ 79 508 282 294 111],655,1,38871,4.096859190556493,0.0,0.0
39488,3,9488,[318 427 515 185 313],655,5,38876,4.096954368215829,40.0,0.0
39489,3,9489,[172 515 195 121 603],269,2,38878,4.096733403582719,20.0,0.0
39490,3,9490,[318 427 515 185 313],655,5,38883,4.096828574438942,40.0,0.0
39491,3,9491,[  9 127  70 282 191],401,2,38885,4.096607669616519,0.0,20.0
39492,3,9492,[318 427 515 185 313],655,5,38890,4.096702833666913,40.0,0.0
39493,3,9493,[318 427 515 185 313],655,5,38895,4.096797977670107,40.0,0.0
39494,3,9494,[318 427 515 185 313],655,5,38900,4.096893101632438,40.0,0.0
39495,3,9495,[357  50 237  97  89],457,5,38905,4.096988205560236,0.0,20.0
39496,3,9496,[318 427 515 185 313],655,5,38910,4.097083289459829,40.0,0.0
39497,3,9497,[ 82 204 210 191 211],911,2,38912,4.096862497367867,0.0,0.0
39498,3,9498,[  9 202 403 181 748],256,4,38916,4.096852300242131,0.0,0.0
39499,3,9499,[318 427 515 185 313],655,5,38921,4.096947368421053,40.0,0.0
39500,3,9500,[ 71 265 273 191 588],450,3,38924,4.096831912430271,0.0,0.0
39501,3,9501,[318 427 515 185 313],655,5,38929,4.096926962744686,40.0,0.0
39502,3,9502,[318 427 515 185 313],655,5,38934,4.097021993054825,40.0,0.0
39503,3,9503,[318 427 515 185 313],655,5,38939,4.0971170033670035,40.0,0.0
39504,3,9504,[318 427 515 185 313],655,5,38944,4.097211993687533,40.0,0.0
39505,3,9505,[318 427 515 185 313],655,5,38949,4.097306964022723,40.0,0.0
39506,3,9506,[210 204 222 302 271],655,1,38950,4.096981171768171,0.0,0.0
39507,3,9507,[174  25 181  56 194],535,4,38954,4.09697097181321,0.0,0.0
39508,3,9508,[318 427 515 185 313],655,5,38959,4.0970659375328635,40.0,0.0
39509,3,9509,[318 427 515 185 313],655,5,38964,4.097160883280757,40.0,0.0
39510,3,9510,[288   4  96 568 234],457,5,38969,4.09725580906319,0.0,0.0
39511,3,9511,[318 427 515 185 313],655,5,38974,4.097350714886459,40.0,0.0
39512,3,9512,[318  96 678  50 655],504,4,38978,4.097340481446442,20.0,20.0
39513,3,9513,[273 427 318 275 235],450,3,38981,4.097225141896153,40.0,20.0
39514,3,9514,[ 28 322 100 135 168],151,3,38984,4.0971098265895955,0.0,20.0
39515,3,9515,[318 427 515 185 313],655,5,38989,4.097204707860445,40.0,0.0
39516,3,9516,[318 427 515 185 313],655,5,38994,4.097299569191972,40.0,0.0
39517,3,9517,[318 427 515 185 313],655,5,38999,4.09739441059046,40.0,0.0
39518,3,9518,[197 204 135 180  71],450,3,39002,4.097279125958609,0.0,0.0
39519,3,9519,[318 427 515 185 313],655,5,39007,4.097373949579832,40.0,0.0
39520,3,9520,[ 89 475  50  70 235],269,1,39008,4.097048629345657,0.0,20.0
39521,3,9521,[423  69 275  98 174],593,4,39012,4.0970384373030875,0.0,20.0
39522,3,9522,[318 427 515 185 313],655,5,39017,4.097133256326788,40.0,0.0
39523,3,9523,[181 597 194  97 318],457,4,39021,4.097123057538849,20.0,0.0
39524,3,9524,[ 97  56  28 257 204],457,4,39025,4.097112860892389,0.0,0.0
39525,3,9525,[ 12   4   1 127 187],450,4,39029,4.097102666386731,0.0,20.0
39526,3,9526,[318 427 515 185 313],655,5,39034,4.097197438857982,40.0,0.0
39527,3,9527,[496 588 215  22 117],344,2,39036,4.096977329974811,20.0,0.0
39528,3,9528,[435 117 475 174 191],629,4,39040,4.0969671529016685,0.0,0.0
39529,3,9529,[318 427 515 185 313],655,5,39045,4.097061909758657,40.0,0.0
39530,3,9530,[ 69 318  64 216  28],65,4,39049,4.09705172594691,40.0,0.0
39531,3,9531,[216 186  64 151 238],389,3,39052,4.096936634494335,20.0,0.0
39532,3,9532,[228 118 742 588 427],450,4,39056,4.096926465960348,20.0,0.0
39533,3,9533,[ 95  88 405 125 257],798,4,39060,4.096916299559472,0.0,0.0
39534,3,9534,[318 427 515 185 313],655,5,39065,4.097011012060829,40.0,0.0
39535,3,9535,[144 111 276 135 435],629,5,39070,4.097105704697986,0.0,0.0
39536,3,9536,[185 286 186   4 216],389,2,39072,4.096885813148789,0.0,20.0
39537,3,9537,[318 427 515 185 313],655,5,39077,4.096980499056406,40.0,0.0
39538,3,9538,[742 185 302 471 328],655,2,39079,4.0967606667365555,0.0,0.0
39539,3,9539,[ 64 191  28 121 202],65,5,39084,4.096855345911949,20.0,0.0
39540,3,9540,[286 121 185 423 187],535,3,39087,4.096740383607588,0.0,20.0
39541,3,9541,[318 427 515 185 313],655,5,39092,4.096835045063928,40.0,0.0
39542,3,9542,[385 235 435 294 117],401,1,39093,4.096510531279472,0.0,0.0
39543,3,9543,[121 483 173 216 161],401,2,39095,4.096290863369656,0.0,0.0
39544,3,9544,[100 135 161   8 195],457,5,39100,4.096385542168675,0.0,20.0
39545,3,9545,[153 257  56  69 202],389,3,39103,4.096270689293945,0.0,0.0
39546,3,9546,[ 70 483  11 172 210],269,1,39104,4.095946370587619,0.0,0.0
39547,3,9547,[318 427 515 185 313],655,5,39109,4.096041055718475,40.0,0.0
39548,3,9548,[153 185 161 191 357],23,2,39111,4.095821551994973,0.0,0.0
39549,3,9549,[318 427 515 185 313],655,5,39116,4.095916230366492,40.0,0.0
39550,3,9550,[318 427 515 185 313],655,5,39121,4.096010888912156,40.0,0.0
39551,3,9551,[275 427 197 111 294],655,2,39123,4.095791457286432,20.0,20.0
39552,3,9552,[161 508 475 200 742],655,1,39124,4.095467392442165,0.0,0.0
39553,3,9553,[318 427 515 185 313],655,5,39129,4.095562068243668,40.0,0.0
39554,3,9554,[182  79 216 186 194],796,4,39133,4.0955520669806385,0.0,0.0
39555,3,9555,[318 427 515 185 313],655,5,39138,4.09564671410632,40.0,0.0
39556,3,9556,[  9 269 546 182  12],796,3,39141,4.095532070733494,0.0,0.0
39557,3,9557,[318 427 515 185 313],655,5,39146,4.095626700146474,40.0,0.0
39558,3,9558,[318 427 515 185 313],655,5,39151,4.095721309760435,40.0,0.0
39559,3,9559,[318 427 515 185 313],655,5,39156,4.09581589958159,40.0,0.0
39560,3,9560,[172 496 294 323 597],796,3,39159,4.09570128647631,20.0,0.0
39561,3,9561,[318 427 515 185 313],655,5,39164,4.095795858606986,40.0,0.0
39562,3,9562,[318 427 515 185 313],655,5,39169,4.095890410958904,40.0,0.0
39563,3,9563,[197  12 194  98 185],18,3,39172,4.09577582601422,0.0,0.0
39564,3,9564,[318 427 515 185 313],655,5,39177,4.095870360690015,40.0,0.0
39565,3,9565,[234 191 471 187 748],450,4,39181,4.095860338699561,0.0,0.0
39566,3,9566,[318 427 515 185 313],655,5,39186,4.095954844778928,40.0,0.0
39567,3,9567,[318 427 515 185 313],655,5,39191,4.0960493311036785,40.0,0.0
39568,3,9568,[265 215 288 423 182],450,4,39195,4.096039293552096,0.0,0.0
39569,3,9569,[200 191 294 333 186],655,2,39197,4.09582027168234,0.0,0.0
39570,3,9570,[182 228 273 271 202],655,2,39199,4.0956012955803995,0.0,0.0
39571,3,9571,[318 427 515 185 313],655,5,39204,4.095695779356456,40.0,0.0
39572,3,9572,[183  15 191 195 118],457,5,39209,4.095790243392876,0.0,0.0
39573,3,9573,[318 427 515 185 313],655,5,39214,4.095884687695843,40.0,0.0
39574,3,9574,[318 427 515 185 313],655,5,39219,4.09597911227154,40.0,0.0
39575,3,9575,[318 427 515 185 313],655,5,39224,4.096073517126149,40.0,0.0
39576,3,9576,[318 427 515 185 313],655,5,39229,4.0961679022658455,40.0,0.0
39577,3,9577,[405  95 202 179 222],450,3,39232,4.096053455836292,0.0,0.0
39578,3,9578,[423 275 172 135 403],450,4,39236,4.096043428332812,0.0,20.0
39579,3,9579,[318 427 515 185 313],655,5,39241,4.096137787056367,40.0,0.0
39580,3,9580,[318 427 515 185 313],655,5,39246,4.096232126082873,40.0,0.0
39581,3,9581,[318 427 515 185 313],655,5,39251,4.096326445418493,40.0,0.0
39582,3,9582,[318 427 515 185 313],655,5,39256,4.096420745069394,40.0,0.0
39583,3,9583,[  1 195 135 748 228],450,4,39260,4.096410684474123,0.0,0.0
39584,3,9584,[318 427 515 185 313],655,5,39265,4.096504955659885,40.0,0.0
39585,3,9585,[318 427 515 185 313],655,5,39270,4.0965992071771336,40.0,0.0
39586,3,9586,[318 427 515 185 313],655,5,39275,4.096693439032022,40.0,0.0
39587,3,9587,[318 427 515 185 313],655,5,39280,4.096787651230705,40.0,0.0
39588,3,9588,[215 269 183 187 117],450,5,39285,4.096881843779331,0.0,0.0
39589,3,9589,[191 195 151 176  89],269,2,39287,4.096663190823775,0.0,0.0
39590,3,9590,[655 172 301 200   4],593,4,39291,4.096653112292774,0.0,0.0
39591,3,9591,[318 427 515 185 313],655,5,39296,4.09674728940784,40.0,0.0
39592,3,9592,[318 427 515 185 313],655,5,39301,4.096841446888356,40.0,0.0
39593,3,9593,[318 427 515 185 313],655,5,39306,4.0969355847404625,40.0,0.0
39594,3,9594,[603 322   4 496 258],151,4,39310,4.096925482021886,40.0,0.0
39595,3,9595,[318 427 515 185 313],655,5,39315,4.097019591496457,40.0,0.0
39596,3,9596,[318 427 515 185 313],655,5,39320,4.097113681358758,40.0,0.0
39597,3,9597,[257   4 125 196 181],504,4,39324,4.097103563242342,0.0,0.0
39598,3,9598,[318 427 515 185 313],655,5,39329,4.097197624752578,40.0,0.0
39599,3,9599,[202 185  96 302 168],450,5,39334,4.097291666666667,0.0,0.0
39600,3,9600,[234  96 187 318 111],716,3,39337,4.097177377356525,20.0,0.0
39601,3,9601,[318 427 515 185 313],655,5,39342,4.097271401791294,40.0,0.0
39602,3,9602,[196  50 313 204 234],450,4,39346,4.097261272519004,0.0,20.0
39603,3,9603,[318 427 515 185 313],655,5,39351,4.097355268638068,40.0,0.0
39604,3,9604,[318 427 515 185 313],655,5,39356,4.0974492451848,40.0,0.0
39605,3,9605,[435 168 276 132 475],269,4,39360,4.097439100562148,0.0,0.0
39606,3,9606,[ 50 197 435  64  69],18,4,39364,4.097428958051421,20.0,20.0
39607,3,9607,[215  82 202 151 181],577,5,39369,4.097522897585345,0.0,0.0
39608,3,9608,[318 427 515 185 313],655,5,39374,4.097616817566864,40.0,0.0
39609,3,9609,[318 427 515 185 313],655,5,39379,4.097710718002081,40.0,0.0
39610,3,9610,[100 182 237 496 121],269,3,39382,4.097596504005827,20.0,20.0
39611,3,9611,[181 121 237 423 508],269,2,39384,4.097378277153558,0.0,0.0
39612,3,9612,[318 427 515 185 313],655,5,39389,4.097472173098929,40.0,0.0
39613,3,9613,[ 96 204 216 151  15],450,4,39393,4.097462034532973,0.0,0.0
39614,3,9614,[318 427 515 185 313],655,5,39398,4.097555902236089,40.0,0.0
39615,3,9615,[318 427 515 185 313],655,5,39403,4.0976497504159735,40.0,0.0
39616,3,9616,[318 427 515 185 313],655,5,39408,4.097743579078715,40.0,0.0
39617,3,9617,[ 82 180 210 197 742],280,2,39410,4.097525473071324,0.0,0.0
39618,3,9618,[318 427 515 185 313],655,5,39415,4.097619295145026,40.0,0.0
39619,3,9619,[318 427 515 185 313],655,5,39420,4.097713097713098,40.0,0.0
39620,3,9620,[ 64 210 357  25 173],457,5,39425,4.097806880781624,20.0,0.0
39621,3,9621,[204  98  64 182 597],450,5,39430,4.097900644356683,20.0,0.0
39622,3,9622,[318 427 515 185 313],655,5,39435,4.097994388444352,40.0,0.0
39623,3,9623,[508 172 276 211 655],655,2,39437,4.097776392352452,0.0,0.0
39624,3,9624,[187 168   1  82 132],796,3,39440,4.097662337662338,0.0,0.0
39625,3,9625,[176  98 200   9 471],655,2,39442,4.09744442135882,0.0,0.0
39626,3,9626,[ 98  82 196  79   1],151,4,39446,4.097434299366365,0.0,0.0
39627,3,9627,[742   4  82  69 173],280,2,39448,4.0972164520149565,0.0,0.0
39628,3,9628,[318 427 515 185 313],655,5,39453,4.0973102087444175,40.0,0.0
39629,3,9629,[  7  15 210 268 222],296,3,39456,4.097196261682243,0.0,0.0
39630,3,9630,[179 289  96 204  98],296,4,39460,4.097186169660471,0.0,0.0
39631,3,9631,[318 427 515 185 313],655,5,39465,4.097279900332226,40.0,0.0
39632,3,9632,[318 427 515 185 313],655,5,39470,4.097373611543652,40.0,0.0
39633,3,9633,[228  88 191 132 216],716,5,39475,4.097467303300809,0.0,0.0
39634,3,9634,[196 568 127 294 427],450,5,39480,4.097560975609756,20.0,20.0
39635,3,9635,[318 427 515 185 313],655,5,39485,4.097654628476547,40.0,0.0
39636,3,9636,[597 286 168 210   9],174,3,39488,4.097540728442461,0.0,20.0
39637,3,9637,[318 427 515 185 313],655,5,39493,4.097634363975929,40.0,0.0
39638,3,9638,[210 228 202 191  79],796,4,39497,4.097624234879137,0.0,0.0
39639,3,9639,[215 588 118 423 195],450,4,39501,4.0976141078838175,0.0,0.0
39640,3,9640,[ 98  69 202 237 174],655,1,39502,4.097292811948968,0.0,0.0
39641,3,9641,[318 427 515 185 313],655,5,39507,4.09738643434972,40.0,0.0
39642,3,9642,[210 245 196  88 151],504,4,39511,4.097376335165405,0.0,0.0
39643,3,9643,[228  96 496 286 471],344,3,39514,4.0972625466611365,20.0,20.0
39644,3,9644,[ 69 176 269 235  98],344,3,39517,4.097148781752203,0.0,0.0
39645,3,9645,[742 117 127 168  25],504,5,39522,4.097242380261248,0.0,20.0
39646,3,9646,[318 427 515 185 313],655,5,39527,4.097335959365606,40.0,0.0
39647,3,9647,[655 357 125 471 144],457,5,39532,4.09742951907131,0.0,0.0
39648,3,9648,[318 427 515 185 313],655,5,39537,4.097523059384392,40.0,0.0
39649,3,9649,[ 97 228 179   4  89],450,4,39541,4.097512953367875,0.0,0.0
39650,3,9650,[271 210 427 300 748],807,4,39545,4.097502849445653,20.0,0.0
39651,3,9651,[  9 144 403 655 182],796,3,39548,4.097389142146706,0.0,0.0
39652,3,9652,[403 268 111  28 176],655,0,39548,4.096964674194551,0.0,0.0
39653,3,9653,[333 546 125 196 655],174,4,39552,4.096954630205096,0.0,0.0
39654,3,9654,[496  98 195  22  12],450,5,39557,4.097048161574314,20.0,0.0
39655,3,9655,[318 427 515 185 313],655,5,39562,4.097141673570837,40.0,0.0
39656,3,9656,[168 265   1 187 182],450,5,39567,4.097235166200684,0.0,0.0
39657,3,9657,[318 427 515 185 313],655,5,39572,4.097328639469869,40.0,0.0
39658,3,9658,[ 11 403  25 202 318],655,1,39573,4.0970079718397345,20.0,0.0
39659,3,9659,[265 471 276 588  15],786,3,39576,4.096894409937888,0.0,0.0
39660,3,9660,[318 427 515 185 313],655,5,39581,4.096987889452437,40.0,0.0
39661,3,9661,[ 50 423 187 568 172],693,1,39582,4.096667356654937,0.0,20.0
39662,3,9662,[318 427 515 185 313],655,5,39587,4.096760840318741,40.0,0.0
39663,3,9663,[318 427 515 185 313],655,5,39592,4.0968543046357615,40.0,0.0
39664,3,9664,[111  56 496 300 191],716,5,39597,4.096947749612002,20.0,0.0
39665,3,9665,[282 435 191 210 176],716,3,39600,4.0968342644320295,0.0,0.0
39666,3,9666,[318 427 515 185 313],655,5,39605,4.0969276921485465,40.0,0.0
39667,3,9667,[603 176 216 294  64],796,4,39609,4.096917666528754,40.0,0.0
39668,3,9668,[318 427 515 185 313],655,5,39614,4.097011066294343,40.0,0.0
39669,3,9669,[179 153 286 127 161],450,5,39619,4.097104446742502,0.0,40.0
39670,3,9670,[318 427 515 185 313],655,5,39624,4.097197807879226,40.0,0.0
39671,3,9671,[318 427 515 185 313],655,5,39629,4.097291149710505,40.0,0.0
39672,3,9672,[318 427 515 185 313],655,5,39634,4.097384472242324,40.0,0.0
39673,3,9673,[318 427 515 185 313],655,5,39639,4.0974777754806695,40.0,0.0
39674,3,9674,[235 603 182 143  82],450,3,39642,4.097364341085271,20.0,0.0
39675,3,9675,[318 427 515 185 313],655,5,39647,4.0974576271186445,40.0,0.0
39676,3,9676,[ 25 210 427 200   9],655,2,39649,4.097240880438152,20.0,0.0
39677,3,9677,[300 202 174 216 215],504,4,39653,4.097230832816698,0.0,0.0
39678,3,9678,[318 427 515 185 313],655,5,39658,4.097324103729724,40.0,0.0
39679,3,9679,[471  88 238  64 187],655,2,39660,4.097107438016529,20.0,0.0
39680,3,9680,[318 427 515 185 313],655,5,39665,4.097200702406776,40.0,0.0
39681,3,9681,[318 427 515 185 313],655,5,39670,4.097293947531502,40.0,0.0
39682,3,9682,[191 322  98 742 196],450,5,39675,4.097387173396674,0.0,0.0
39683,3,9683,[ 12 121 282  89 161],450,4,39679,4.0973771168938455,0.0,0.0
39684,3,9684,[318 427 515 185 313],655,5,39684,4.097470314919979,40.0,0.0
39685,3,9685,[100 294 483 185 187],450,4,39688,4.097460251909973,0.0,20.0
39686,3,9686,[318 427 515 185 313],655,5,39693,4.097553422112109,40.0,0.0
39687,3,9687,[286 211  25  97 423],535,4,39697,4.097543352601156,0.0,20.0
39688,3,9688,[153 202 176  64 275],389,4,39701,4.0975332851687485,20.0,20.0
39689,3,9689,[301 276  12  11 202],655,1,39702,4.097213622291021,0.0,0.0
39690,3,9690,[318 427 515 185 313],655,5,39707,4.0973067794861215,40.0,0.0
39691,3,9691,[357 234   4 597 568],593,3,39710,4.097193561700371,0.0,0.0
39692,3,9692,[318 427 515 185 313],655,5,39715,4.097286701743526,40.0,0.0
39693,3,9693,[186 181 143   9  22],796,3,39718,4.0971735093872494,0.0,0.0
39694,3,9694,[  9 180  15 237 357],72,4,39722,4.097163486333161,0.0,0.0
39695,3,9695,[318 427 515 185 313],655,5,39727,4.097256600660066,40.0,0.0
39696,3,9696,[318 427 515 185 313],655,5,39732,4.097349695782201,40.0,0.0
39697,3,9697,[174 127  11  22 333],629,4,39736,4.097339657661373,0.0,20.0
39698,3,9698,[385 183 111  88 268],655,1,39737,4.097020311372306,0.0,0.0
39699,3,9699,[508 222   1 183 546],280,2,39739,4.09680412371134,0.0,0.0
39700,3,9700,[195  96 568 111 151],756,3,39742,4.096691062777033,0.0,0.0
39701,3,9701,[202 161 496 245 118],280,2,39744,4.096474953617811,20.0,0.0
39702,3,9702,[318 427 515 185 313],655,5,39749,4.096568071730393,40.0,0.0
39703,3,9703,[318 427 515 185 313],655,5,39754,4.096661170651278,40.0,0.0
39704,3,9704,[748 328 202 237 471],450,5,39759,4.0967542503863985,0.0,0.0
39705,3,9705,[318 427 515 185 313],655,5,39764,4.096847310941685,40.0,0.0
39706,3,9706,[ 82 173 202 655 748],450,4,39768,4.096837333882765,0.0,0.0
39707,3,9707,[318 427 515 185 313],655,5,39773,4.09693036670787,40.0,0.0
39708,3,9708,[318 427 515 185 313],655,5,39778,4.09702338036873,40.0,0.0
39709,3,9709,[318 427 515 185 313],655,5,39783,4.097116374871267,40.0,0.0
39710,3,9710,[318 427 515 185 313],655,5,39788,4.097209350221398,40.0,0.0
39711,3,9711,[748 403 216 603 333],796,5,39793,4.097302306425041,20.0,0.0
39712,3,9712,[318 427 515 185 313],655,5,39798,4.0973952434881085,40.0,0.0
39713,3,9713,[187 318  11 179 180],535,4,39802,4.097385217212271,20.0,0.0
39714,3,9714,[546  56   9 222 742],256,4,39806,4.097375193000515,0.0,0.0
39715,3,9715,[ 98  69 301 357 286],593,5,39811,4.097468093865788,0.0,20.0
39716,3,9716,[318 427 515 185 313],655,5,39816,4.097560975609756,40.0,0.0
39717,3,9717,[ 89 655 211 333 191],655,2,39818,4.097345132743363,0.0,0.0
39718,3,9718,[318 427 515 185 313],655,5,39823,4.097438008025517,40.0,0.0
39719,3,9719,[318 427 515 185 313],655,5,39828,4.097530864197531,40.0,0.0
39720,3,9720,[235  89 275 228 143],450,4,39832,4.097520831190207,0.0,20.0
39721,3,9721,[211 195  98 117  69],786,5,39837,4.097613659740794,0.0,0.0
39722,3,9722,[318 427 515 185 313],655,5,39842,4.09770646919675,40.0,0.0
39723,3,9723,[318 427 515 185 313],655,5,39847,4.097799259563965,40.0,0.0
39724,3,9724,[211 333 121 385 200],796,4,39851,4.097789203084833,0.0,0.0
39725,3,9725,[ 15  28 144  25 288],457,5,39856,4.097881965864692,0.0,0.0
39726,3,9726,[318 427 515 185 313],655,5,39861,4.097974709571297,40.0,0.0
39727,3,9727,[  1  25 210 265 172],72,4,39865,4.097964638157895,0.0,0.0
39728,3,9728,[318 427 515 185 313],655,5,39870,4.098057354301573,40.0,0.0
39729,3,9729,[328 210   9  28 204],151,4,39874,4.098047276464543,0.0,0.0
39730,3,9730,[318 427 515 185 313],655,5,39879,4.098139965060117,40.0,0.0
39731,3,9731,[405 195 235 228  25],716,3,39882,4.098027127003699,0.0,0.0
39732,3,9732,[288  22 125  88   7],344,2,39884,4.0978115688893455,0.0,0.0
39733,3,9733,[215  69  71 265  98],577,5,39889,4.097904253133347,0.0,0.0
39734,3,9734,[202 405   1 204 185],796,4,39893,4.097894196199281,0.0,0.0
39735,3,9735,[265 204 403 174 168],457,5,39898,4.097986852917009,0.0,0.0
39736,3,9736,[318 427 515 185 313],655,5,39903,4.0980794906028555,40.0,0.0
39737,3,9737,[318 427 515 185 313],655,5,39908,4.098172109262682,40.0,0.0
39738,3,9738,[318 427 515 185 313],655,5,39913,4.098264708902351,40.0,0.0
39739,3,9739,[385  56 176 300 118],796,5,39918,4.098357289527721,0.0,0.0
39740,3,9740,[318 427 515 185 313],655,5,39923,4.098449851144647,40.0,0.0
39741,3,9741,[228 161 176 196 222],72,2,39925,4.098234448778485,0.0,0.0
39742,3,9742,[ 96 597 132  50 197],269,2,39927,4.09801909062917,0.0,20.0
39743,3,9743,[318 427 515 185 313],655,5,39932,4.098111658456486,40.0,0.0
39744,3,9744,[318 427 515 185 313],655,5,39937,4.098204207285788,40.0,0.0
39745,3,9745,[318 427 515 185 313],655,5,39942,4.098296737122922,40.0,0.0
39746,3,9746,[ 98 508 405 210 204],655,1,39943,4.097978865291885,0.0,0.0
39747,3,9747,[235  22 269 423  12],450,4,39947,4.097968814115716,0.0,0.0
39748,3,9748,[318 427 515 185 313],655,5,39952,4.098061339624577,40.0,0.0
39749,3,9749,[182 132 588 742  95],280,4,39956,4.098051282051282,0.0,0.0
39750,3,9750,[228 238   1 222 194],151,5,39961,4.098143780125115,0.0,0.0
39751,3,9751,[216  70 173 121 125],401,2,39963,4.097928630024611,0.0,0.0
39752,3,9752,[318 427 515 185 313],655,5,39968,4.098021121706141,40.0,0.0
39753,3,9753,[333 182 265  25 568],655,1,39969,4.097703506253844,0.0,0.0
39754,3,9754,[318 427 515 185 313],655,5,39974,4.097796002050231,40.0,0.0
39755,3,9755,[238 191 135 202 168],65,4,39978,4.097785977859779,0.0,0.0
39756,3,9756,[234 185 265 196 655],457,5,39983,4.0978784462437225,0.0,0.0
39757,3,9757,[318 427 515 185 313],655,5,39988,4.097970895675343,40.0,0.0
39758,3,9758,[318 427 515 185 313],655,5,39993,4.098063326160467,40.0,0.0
39759,3,9759,[235 275 237 111 357],344,3,39996,4.097950819672131,0.0,20.0
39760,3,9760,[318 427 515 185 313],655,5,40001,4.098043233275279,40.0,0.0
39761,3,9761,[318 427 515 185 313],655,5,40006,4.098135627945093,40.0,0.0
39762,3,9762,[ 15  79 286  98 117],236,4,40010,4.09812557615487,0.0,20.0
39763,3,9763,[318 427 515 185 313],655,5,40015,4.098217943465793,40.0,0.0
39764,3,9764,[318 427 515 185 313],655,5,40020,4.098310291858679,40.0,0.0
39765,3,9765,[318 427 515 185 313],655,5,40025,4.098402621339341,40.0,0.0
39766,3,9766,[210  56 121 237 269],450,3,40028,4.098290160745367,0.0,0.0
39767,3,9767,[258 127 235   4 185],457,4,40032,4.098280098280099,0.0,20.0
39768,3,9768,[318 427 515 185 313],655,5,40037,4.098372402497697,40.0,0.0
39769,3,9769,[318 427 515 185 313],655,5,40042,4.098464687819857,40.0,0.0
39770,3,9770,[100 174 322 328  64],796,3,40045,4.098352266912292,20.0,20.0
39771,3,9771,[318 427 515 185 313],655,5,40050,4.098444535407286,40.0,0.0
39772,3,9772,[318 427 515 185 313],655,5,40055,4.098536785019953,40.0,0.0
39773,3,9773,[125  15 301 234 313],655,1,40056,4.098219766728054,0.0,0.0
39774,3,9774,[318 427 515 185 313],655,5,40061,4.098312020460358,40.0,0.0
39775,3,9775,[ 28 216 197 174 597],450,5,40066,4.098404255319149,0.0,0.0
39776,3,9776,[196  79  96  56 568],716,4,40070,4.098394190446967,0.0,0.0
39777,3,9777,[318 427 515 185 313],655,5,40075,4.098486398036409,40.0,0.0
39778,3,9778,[318 427 515 185 313],655,5,40080,4.098578586767563,40.0,0.0
39779,3,9779,[318 427 515 185 313],655,5,40085,4.098670756646217,40.0,0.0
39780,3,9780,[111 286 182 603 313],796,4,40089,4.098660668643288,20.0,20.0
39781,3,9781,[318 427 515 185 313],655,5,40094,4.098752811286036,40.0,0.0
39782,3,9782,[568 496  11  22 181],450,5,40099,4.098844935091485,20.0,0.0
39783,3,9783,[318 427 515 185 313],655,5,40104,4.098937040065413,40.0,0.0
39784,3,9784,[318 427 515 185 313],655,5,40109,4.099029126213592,40.0,0.0
39785,3,9785,[216 197 117 127 385],655,2,40111,4.098814633149397,0.0,20.0
39786,3,9786,[ 88 176  69 186 286],655,0,40111,4.098395831204659,0.0,20.0
39787,3,9787,[318 301 748 403 385],796,4,40115,4.098385778504291,20.0,0.0
39788,3,9788,[318 427 515 185 313],655,5,40120,4.098477883338441,40.0,0.0
39789,3,9789,[ 15 175  97 423 196],151,5,40125,4.098569969356486,0.0,0.0
39790,3,9790,[318 427 515 185 313],655,5,40130,4.098662036564192,40.0,0.0
39791,3,9791,[318 427 515 185 313],655,5,40135,4.09875408496732,40.0,0.0
39792,3,9792,[318 427 515 185 313],655,5,40140,4.098846114571633,40.0,0.0
39793,3,9793,[318 427 515 185 313],655,5,40145,4.098938125382888,40.0,0.0
39794,3,9794,[  7 127 313 202 318],655,3,40148,4.098825931597754,20.0,20.0
39795,3,9795,[313 357 185 100 204],655,3,40151,4.098713760718661,0.0,20.0
39796,3,9796,[121  22 132 127  28],450,4,40155,4.09870368480147,0.0,20.0
39797,3,9797,[318 427 515 185 313],655,5,40160,4.098795672586242,40.0,0.0
39798,3,9798,[318 427 515 185 313],655,5,40165,4.0988876415960815,40.0,0.0
39799,3,9799,[318 427 515 185 313],655,5,40170,4.098979591836735,40.0,0.0
39800,3,9800,[318 427 515 185 313],655,5,40175,4.099071523313947,40.0,0.0
39801,3,9801,[186 185 200 234 197],450,2,40177,4.0988573760457045,0.0,0.0
39802,3,9802,[  4 258 568 405 191],655,1,40178,4.098541262878711,0.0,0.0
39803,3,9803,[333  50 215 328 172],655,2,40180,4.0983272133822926,0.0,20.0
39804,3,9804,[ 12 301  50 742 151],796,3,40183,4.098215196328404,0.0,20.0
39805,3,9805,[427 228 216   1 132],151,5,40188,4.098307158882317,20.0,0.0
39806,3,9806,[318 427 515 185 313],655,5,40193,4.098399102681758,40.0,0.0
39807,3,9807,[318 427 515 185 313],655,5,40198,4.0984910277324635,40.0,0.0
39808,3,9808,[ 12  89 180  15 196],18,3,40201,4.098379039657457,0.0,0.0
39809,3,9809,[222 151 183 174 655],23,2,40203,4.098165137614679,0.0,0.0
39810,3,9810,[515 197 135 282 191],716,3,40206,4.098053205585567,0.0,0.0
39811,3,9811,[318 427 515 185 313],655,5,40211,4.0981451284141865,40.0,0.0
39812,3,9812,[ 89 181 132 294 174],23,4,40215,4.098135126872516,0.0,0.0
39813,3,9813,[318 427 515 185 313],655,5,40220,4.098227022620746,40.0,0.0
39814,3,9814,[385 228 121  50 294],655,1,40221,4.097911360163016,0.0,20.0
39815,3,9815,[318 427 515 185 313],655,5,40226,4.0980032599837,40.0,0.0
39816,3,9816,[197 183 423 237 210],716,4,40230,4.097993276968524,0.0,0.0
39817,3,9817,[318 427 515 185 313],655,5,40235,4.098085149724995,40.0,0.0
39818,3,9818,[322 508 173 302 357],401,1,40236,4.097769630308585,0.0,0.0
39819,3,9819,[176  56 183 588 144],457,5,40241,4.09786150712831,0.0,0.0
39820,3,9820,[318 427 515 185 313],655,5,40246,4.097953365237756,40.0,0.0
39821,3,9821,[273 515 174 300 257],655,2,40248,4.097739767868052,0.0,0.0
39822,3,9822,[175 483  71 100  88],23,3,40251,4.097628015881096,0.0,20.0
39823,3,9823,[118 258 742  64  98],344,2,40253,4.097414495114006,20.0,0.0
39824,3,9824,[216 258  69  82 127],796,4,40257,4.097404580152672,0.0,20.0
39825,3,9825,[ 98  50 172 323 195],280,1,40258,4.097089354773051,0.0,20.0
39826,3,9826,[435 294  64  98 117],629,4,40262,4.097079474916048,20.0,0.0
39827,3,9827,[318 427 515 185 313],655,5,40267,4.097171347171347,40.0,0.0
39828,3,9828,[186  22  69  97 515],716,4,40271,4.097161460982806,0.0,0.0
39829,3,9829,[318 427 515 185 313],655,5,40276,4.097253306205493,40.0,0.0
39830,3,9830,[322  11 597 211 161],450,5,40281,4.097345132743363,0.0,0.0
39831,3,9831,[173 185 174 181 197],796,4,40285,4.09733523189585,0.0,0.0
39832,3,9832,[405 496 179 265 403],450,5,40290,4.097427031424794,20.0,0.0
39833,3,9833,[176 282 172   1 174],457,5,40295,4.097518812283913,0.0,0.0
39834,3,9834,[318 427 515 185 313],655,5,40300,4.097610574478902,40.0,0.0
39835,3,9835,[357 180 200 197 186],786,4,40304,4.097600650671004,0.0,0.0
39836,3,9836,[180  79 191 117 288],693,2,40306,4.097387414862255,0.0,0.0
39837,3,9837,[202 172 286 197 176],151,4,40310,4.097377515755235,0.0,20.0
39838,3,9838,[ 56 678 282  82 276],504,3,40313,4.0972659823152755,0.0,0.0
39839,3,9839,[318 427 515 185 313],655,5,40318,4.097357723577236,40.0,0.0
39840,3,9840,[318 427 515 185 313],655,5,40323,4.097449446194492,40.0,0.0
39841,3,9841,[ 89 655 597 435 483],269,2,40325,4.097236334078439,0.0,0.0
39842,3,9842,[  4 100   8 168 191],591,3,40328,4.097124860306817,0.0,20.0
39843,3,9843,[318 427 515 185 313],655,5,40333,4.097216578626575,40.0,0.0
39844,3,9844,[238 194 121 180   7],450,4,40337,4.097206703910614,0.0,0.0
39845,3,9845,[132 385 238 210 174],655,0,40337,4.096790574852732,0.0,0.0
39846,3,9846,[121 603  89 301 185],450,4,40341,4.096780745404692,20.0,0.0
39847,3,9847,[ 56 496 313  96 204],450,5,40346,4.096872461413485,20.0,0.0
39848,3,9848,[186 210 127 300  15],450,2,40348,4.096659559346127,0.0,20.0
39849,3,9849,[471 742 655 288 118],693,0,40348,4.096243654822335,0.0,0.0
39850,3,9850,[318 427 515 185 313],655,5,40353,4.096335397421582,40.0,0.0
39851,3,9851,[318 427 515 185 313],655,5,40358,4.096427121396671,40.0,0.0
39852,3,9852,[318 427 515 185 313],655,5,40363,4.0965188267532735,40.0,0.0
39853,3,9853,[ 96 200  12 282 385],655,1,40364,4.096204586969758,0.0,0.0
39854,3,9854,[ 88  15 275 313 286],655,2,40366,4.095991882293252,0.0,40.0
39855,3,9855,[237 222  98  96 172],280,2,40368,4.095779220779221,0.0,0.0
39856,3,9856,[318 427 515 185 313],655,5,40373,4.095870954651517,40.0,0.0
39857,3,9857,[118  89  71 195 245],344,2,40375,4.095658348549401,0.0,0.0
39858,3,9858,[181 191 302 121 748],151,2,40377,4.09544578557663,0.0,0.0
39859,3,9859,[318 427 515 185 313],655,5,40382,4.0955375253549695,40.0,0.0
39860,3,9860,[111  70 172 191 143],786,5,40387,4.0956292465267214,0.0,0.0
39861,3,9861,[318 427 515 185 313],655,5,40392,4.095720949097546,40.0,0.0
39862,3,9862,[655 181 187 333 191],655,2,40394,4.095508465983981,0.0,0.0
39863,3,9863,[197  11 471  56 333],655,0,40394,4.095093268450933,0.0,0.0
39864,3,9864,[496  79 483 132 588],280,5,40399,4.095184997465788,20.0,0.0
39865,3,9865,[496 483  56 286 588],280,5,40404,4.0952767078856676,20.0,20.0
39866,3,9866,[318 427 515 185 313],655,5,40409,4.095368399716226,40.0,0.0
39867,3,9867,[318 427 515 185 313],655,5,40414,4.095460072963113,40.0,0.0
39868,3,9868,[318 427 515 185 313],655,5,40419,4.095551727631979,40.0,0.0
39869,3,9869,[318 427 515 185 313],655,5,40424,4.09564336372847,40.0,0.0
39870,3,9870,[ 25 234 475 471 132],389,4,40428,4.095633674399757,0.0,0.0
39871,3,9871,[222 127 168 185  22],450,4,40432,4.095623987034036,0.0,20.0
39872,3,9872,[318 427 515 185 313],655,5,40437,4.095715587967184,40.0,0.0
39873,3,9873,[318 427 515 185 313],655,5,40442,4.095807170346364,40.0,0.0
39874,3,9874,[318 427 515 185 313],655,5,40447,4.095898734177215,40.0,0.0
39875,3,9875,[183 117 127 118  95],280,3,40450,4.095787768327258,0.0,20.0
39876,3,9876,[318 427 515 185 313],655,5,40455,4.095879315581654,40.0,0.0
39877,3,9877,[318 427 515 185 313],655,5,40460,4.095970844300465,40.0,0.0
39878,3,9878,[151  69 234 173 471],577,3,40463,4.095859904848669,0.0,0.0
39879,3,9879,[222  64 568 318 181],716,5,40468,4.0959514170040485,40.0,0.0
39880,3,9880,[ 56 153 168 216 127],716,5,40473,4.096042910636576,0.0,20.0
39881,3,9881,[318 427 515 185 313],655,5,40478,4.096134385751872,40.0,0.0
39882,3,9882,[318 427 515 185 313],655,5,40483,4.09622584235556,40.0,0.0
39883,3,9883,[144   8 282  15 180],457,5,40488,4.096317280453258,0.0,0.0
39884,3,9884,[132  15 127 568 288],457,5,40493,4.096408700050581,0.0,20.0
39885,3,9885,[655 196  82  89  88],450,4,40497,4.096398948007283,0.0,0.0
39886,3,9886,[568 245 323 173  71],756,0,40497,4.0959846262769295,0.0,0.0
39887,3,9887,[318 427 515 185 313],655,5,40502,4.096076051779935,40.0,0.0
39888,3,9888,[318 427 515 185 313],655,5,40507,4.096167458792598,40.0,0.0
39889,3,9889,[318 427 515 185 313],655,5,40512,4.0962588473205255,40.0,0.0
39890,3,9890,[318 427 515 185 313],655,5,40517,4.096350217369325,40.0,0.0
39891,3,9891,[318 427 515 185 313],655,5,40522,4.096441568944602,40.0,0.0
39892,3,9892,[318 427 515 185 313],655,5,40527,4.096532902051956,40.0,0.0
39893,3,9893,[318 427 515 185 313],655,5,40532,4.096624216696988,40.0,0.0
39894,3,9894,[ 64  89 405   4  96],796,5,40537,4.096715512885296,20.0,0.0
39895,3,9895,[318 427 515 185 313],655,5,40542,4.096806790622474,40.0,0.0
39896,3,9896,[318 427 515 185 313],655,5,40547,4.096898049914115,40.0,0.0
39897,3,9897,[ 98  79 742 423 318],457,5,40552,4.096989290765811,20.0,0.0
39898,3,9898,[200 185 196 597 238],796,4,40556,4.096979492878068,0.0,0.0
39899,3,9899,[318 427 515 185 313],655,5,40561,4.097070707070707,40.0,0.0
39900,3,9900,[318 427 515 185 313],655,5,40566,4.0971619028380974,40.0,0.0
39901,3,9901,[318 427 515 185 313],655,5,40571,4.097253080185821,40.0,0.0
39902,3,9902,[ 11 215 117 258 191],655,1,40572,4.096940321114814,0.0,0.0
39903,3,9903,[286 197 186   7 195],786,4,40576,4.096930533117932,0.0,20.0
39904,3,9904,[318 427 515 185 313],655,5,40581,4.097021706208985,40.0,0.0
39905,3,9905,[318 427 515 185 313],655,5,40586,4.097112860892389,40.0,0.0
39906,3,9906,[318 427 515 185 313],655,5,40591,4.0972039971737155,40.0,0.0
39907,3,9907,[678 385 313 276 127],344,2,40593,4.096992329430763,0.0,20.0
39908,3,9908,[318 427 515 185 313],655,5,40598,4.097083459481279,40.0,0.0
39909,3,9909,[748  12 546 200 385],796,5,40603,4.097174571140262,0.0,0.0
39910,3,9910,[318 427 515 185 313],655,5,40608,4.097265664413278,40.0,0.0
39911,3,9911,[  7 125 195 313 127],344,3,40611,4.097154963680388,0.0,20.0
39912,3,9912,[ 12 282 313 603 597],450,5,40616,4.097246040552809,20.0,0.0
39913,3,9913,[318 427 515 185 313],655,5,40621,4.097337099051846,40.0,0.0
39914,3,9914,[257 204 475 238 483],655,1,40622,4.0970247100353,0.0,0.0
39915,3,9915,[318 427 515 185 313],655,5,40627,4.097115772488907,40.0,0.0
39916,3,9916,[275 328   9 210 173],151,4,40631,4.097105979630936,0.0,20.0
39917,3,9917,[318 427 515 185 313],655,5,40636,4.097197015527324,40.0,0.0
39918,3,9918,[275 655 568   4 195],716,3,40639,4.097086399838694,0.0,20.0
39919,3,9919,[ 15   7 333 186 475],655,0,40639,4.096673387096774,0.0,0.0
39920,3,9920,[ 64   8 435 423  15],655,1,40640,4.096361253905856,20.0,0.0
39921,3,9921,[200  22 403  89 132],655,2,40642,4.09614996976416,0.0,0.0
39922,3,9922,[318 427 515 185 313],655,5,40647,4.096241056132218,40.0,0.0
39923,3,9923,[191  70 202 210 196],450,4,40651,4.096231358323257,0.0,0.0
39924,3,9924,[271 127 181 228 318],655,2,40653,4.0960201511335015,20.0,20.0
39925,3,9925,[318 427 515 185 313],655,5,40658,4.096111223050574,40.0,0.0
39926,3,9926,[318 427 515 185 313],655,5,40663,4.096202276619321,40.0,0.0
39927,3,9927,[318 427 515 185 313],655,5,40668,4.096293311845286,40.0,0.0
39928,3,9928,[318 427 515 185 313],655,5,40673,4.096384328734011,40.0,0.0
39929,3,9929,[276 496 268 603 238],269,5,40678,4.096475327291038,40.0,0.0
39930,3,9930,[  9  15 568 294 197],655,0,40678,4.096062833551505,0.0,0.0
39931,3,9931,[ 97 117 655  15 228],450,4,40682,4.096053161498188,0.0,0.0
39932,3,9932,[318 427 515 185 313],655,5,40687,4.096144165911608,40.0,0.0
39933,3,9933,[161 210 288 118  98],450,2,40689,4.0959331588484,0.0,0.0
39934,3,9934,[742 173 238 328 195],796,3,40692,4.09582284851535,0.0,0.0
39935,3,9935,[ 96 195 568 183 655],655,1,40693,4.095511272141707,0.0,0.0
39936,3,9936,[318 427 515 185 313],655,5,40698,4.095602294455067,40.0,0.0
39937,3,9937,[318 427 515 185 313],655,5,40703,4.095693298450392,40.0,0.0
39938,3,9938,[318 427 515 185 313],655,5,40708,4.095784284133212,40.0,0.0
39939,3,9939,[318 427 515 185 313],655,5,40713,4.095875251509054,40.0,0.0
39940,3,9940,[ 96 568 216  82 238],655,1,40714,4.095563826576803,0.0,0.0
39941,3,9941,[ 50   7 168 405 121],269,1,40715,4.095252464292899,0.0,20.0
39942,3,9942,[318 427 515 185 313],655,5,40720,4.095343457708941,40.0,0.0
39943,3,9943,[245   4 144 151  95],796,4,40724,4.095333869670153,0.0,0.0
39944,3,9944,[172 215  96 597 483],457,4,40728,4.095324283559577,0.0,0.0
39945,3,9945,[597 300 195 238 294],796,3,40731,4.095214156444802,0.0,0.0
39946,3,9946,[ 12 121 179 471 288],457,5,40736,4.0953051171207395,0.0,0.0
39947,3,9947,[515 181   9 197  25],72,4,40740,4.095295536791315,0.0,0.0
39948,3,9948,[385 182   8 215 322],796,4,40744,4.095285958387778,0.0,0.0
39949,3,9949,[186 546 216 238 125],436,2,40746,4.095075376884422,0.0,0.0
39950,3,9950,[294 215 204 257 172],796,4,40750,4.095065822530399,0.0,0.0
39951,3,9951,[ 89 228 748  28 144],807,5,40755,4.095156752411576,0.0,0.0
39952,3,9952,[318 427 515 185 313],655,5,40760,4.095247664020898,40.0,0.0
39953,3,9953,[121  96 210 125  25],655,0,40760,4.094836246734981,0.0,0.0
39954,3,9954,[318 427 515 185 313],655,5,40765,4.094927172275239,40.0,0.0
39955,3,9955,[143 282 172 125 328],655,2,40767,4.094716753716352,0.0,0.0
39956,3,9956,[100 655   7 748 111],450,5,40772,4.094807672993873,0.0,20.0
39957,3,9957,[357 100  22 423 300],450,5,40777,4.094898574010846,0.0,20.0
39958,3,9958,[318 427 515 185 313],655,5,40782,4.094989456772768,40.0,0.0
39959,3,9959,[  4 185  50 748 403],450,4,40786,4.094979919678715,0.0,20.0
39960,3,9960,[742  97 197 132 194],504,4,40790,4.094970384499549,0.0,0.0
39961,3,9961,[ 88  28 200 211  89],450,4,40794,4.094960851234692,0.0,0.0
39962,3,9962,[174 265 301 496  69],151,5,40799,4.095051691257654,20.0,0.0
39963,3,9963,[313 423 100  15 216],450,4,40803,4.095042151746287,0.0,20.0
39964,3,9964,[ 70 183   8  25 568],655,1,40804,4.094731560461615,0.0,0.0
39965,3,9965,[318 427 515 185 313],655,5,40809,4.094822396146899,40.0,0.0
39966,3,9966,[ 12  88 118 597   4],344,2,40811,4.094612220327079,0.0,0.0
39967,3,9967,[318 427 515 185 313],655,5,40816,4.09470304975923,40.0,0.0
39968,3,9968,[318 427 515 185 313],655,5,40821,4.094793860969004,40.0,0.0
39969,3,9969,[ 22 288  71 153 132],280,5,40826,4.094884653961886,0.0,0.0
39970,3,9970,[ 22 301 180 194 385],796,3,40829,4.094774847056463,0.0,0.0
39971,3,9971,[ 22 175 235 132 100],457,4,40833,4.094765342960288,0.0,20.0
39972,3,9972,[318 427 515 185 313],655,5,40838,4.094856111501053,40.0,0.0
39973,3,9973,[318 427 515 185 313],655,5,40843,4.094946861840786,40.0,0.0
39974,3,9974,[118 282  69 288 100],504,4,40847,4.094937343358396,0.0,20.0
39975,3,9975,[318 427 515 185 313],655,5,40852,4.095028067361668,40.0,0.0
39976,3,9976,[318 210 273 275 748],450,3,40855,4.094918312117871,20.0,20.0
39977,3,9977,[180   8 403 423 286],280,4,40859,4.094908799358589,0.0,20.0
39978,3,9978,[238 151   8  89  96],796,4,40863,4.094899288505863,0.0,0.0
39979,3,9979,[357 237 179 288 289],655,2,40865,4.094689378757515,0.0,0.0
39980,3,9980,[210 568 175 211  28],716,4,40869,4.094679891794409,0.0,0.0
39981,3,9981,[194  89 265  12 275],796,5,40874,4.094770587056702,0.0,20.0
39982,3,9982,[318 427 515 185 313],655,5,40879,4.094861264149054,40.0,0.0
39983,3,9983,[318 427 515 185 313],655,5,40884,4.094951923076923,40.0,0.0
39984,3,9984,[196 187 435 282 111],236,3,40887,4.094842263395092,0.0,0.0
39985,3,9985,[228  28 237 273   8],796,3,40890,4.094732625675946,0.0,0.0
39986,3,9986,[318 427 515 185 313],655,5,40895,4.094823270251327,40.0,0.0
39987,3,9987,[176 172   4 427 268],655,2,40897,4.094613536243492,20.0,0.0
39988,3,9988,[186 183 234  98 357],716,3,40900,4.0945039543497845,0.0,0.0
39989,3,9989,[318 427 515 185 313],655,5,40905,4.094594594594595,40.0,0.0
39990,3,9990,[318 427 515 185 313],655,5,40910,4.094685216695026,40.0,0.0
39991,3,9991,[ 71 216 228 168 144],450,4,40914,4.094675740592474,0.0,0.0
39992,3,9992,[435 118 132 100 275],151,3,40917,4.0945661963374365,0.0,40.0
39993,3,9993,[ 89 174  64  96 588],796,5,40922,4.094656794076446,20.0,0.0
39994,3,9994,[318 427 515 185 313],655,5,40927,4.094747373686843,40.0,0.0
39995,3,9995,[143 179 196  69 200],655,3,40930,4.094637855142057,0.0,0.0
39996,3,9996,[186 211 197 588 161],796,2,40932,4.09442832849855,0.0,0.0
39997,3,9997,[318 427 515 185 313],655,5,40937,4.094518903780756,40.0,0.0
39998,3,9998,[257 357 191 271 117],655,2,40939,4.0943094309430945,0.0,0.0
39999,3,9999,[318 427 515 185 313],655,5,40944,4.0944,40.0,0.0
40000,4,0,[179 603 357  89 427],18,3,3,3.0,40.0,0.0
40001,4,1,[ 71 313 196 294 118],796,4,7,3.5,0.0,0.0
40002,4,2,[118 357 179 427 313],655,4,11,3.6666666666666665,20.0,0.0
40003,4,3,[357 179 427 313 196],450,5,16,4.0,20.0,0.0
40004,4,4,[357 179 427 313 196],450,5,21,4.2,20.0,0.0
40005,4,5,[357 179 427 313 196],639,1,22,3.6666666666666665,20.0,0.0
40006,4,6,[427  71 357 179 313],450,4,26,3.7142857142857144,20.0,0.0
40007,4,7,[183 245 118  56 176],280,1,27,3.375,0.0,0.0
40008,4,8,[ 98  82 215 238 175],655,1,28,3.111111111111111,0.0,0.0
40009,4,9,[216 294  79 172 228],450,5,33,3.3,0.0,0.0
40010,4,10,[228 172  79 216  98],577,4,37,3.3636363636363638,0.0,0.0
40011,4,11,[  8 187 276 185 268],535,2,39,3.25,0.0,0.0
40012,4,12,[427  56   8  98 172],389,5,44,3.3846153846153846,20.0,0.0
40013,4,13,[427  56   8  98 172],535,2,46,3.2857142857142856,20.0,0.0
40014,4,14,[427   8 216 185  79],23,5,51,3.4,20.0,0.0
40015,4,15,[427   8 216 185  79],11,4,55,3.4375,20.0,0.0
40016,4,16,[427   8 185  79 313],655,4,59,3.4705882352941178,20.0,0.0
40017,4,17,[427 185  79 313 357],796,5,64,3.5555555555555554,20.0,0.0
40018,4,18,[427 185  79 313 357],655,5,69,3.6315789473684212,20.0,0.0
40019,4,19,[427 185  79 313 357],450,5,74,3.7,20.0,0.0
40020,4,20,[427 185  79 313 357],450,5,79,3.761904761904762,20.0,0.0
40021,4,21,[427 185  79 313 357],450,5,84,3.8181818181818183,20.0,0.0
40022,4,22,[181 143 202 257 496],389,3,87,3.782608695652174,20.0,0.0
40023,4,23,[427 185  79 202 181],796,5,92,3.8333333333333335,20.0,0.0
40024,4,24,[427 185  79 202 181],18,2,94,3.76,20.0,0.0
40025,4,25,[427  79 496 313 185],450,5,99,3.8076923076923075,40.0,0.0
40026,4,26,[475 215  12 269 204],655,0,99,3.6666666666666665,0.0,0.0
40027,4,27,[427  79 496 313 185],503,5,104,3.7142857142857144,40.0,0.0
40028,4,28,[427  79 496 313 185],450,5,109,3.7586206896551726,40.0,0.0
40029,4,29,[194 597 403 318 210],807,5,114,3.8,20.0,0.0
40030,4,30,[597 194 427 496 318],450,5,119,3.838709677419355,60.0,0.0
40031,4,31,[186 183  15 301   9],655,1,120,3.75,0.0,0.0
40032,4,32,[210 496 318 427  79],942,5,125,3.787878787878788,60.0,0.0
40033,4,33,[210 496 318 427  79],151,5,130,3.823529411764706,60.0,0.0
40034,4,34,[210 496 318 427  79],236,3,133,3.8,60.0,0.0
40035,4,35,[318 427  79 194 403],807,5,138,3.8333333333333335,40.0,0.0
40036,4,36,[318 427  79 194 403],807,5,143,3.864864864864865,40.0,0.0
40037,4,37,[318 427  79 194 403],450,5,148,3.8947368421052633,40.0,0.0
40038,4,38,[318 427  79 194 403],577,5,153,3.923076923076923,40.0,0.0
40039,4,39,[318 427  79 194 403],72,4,157,3.925,40.0,0.0
40040,4,40,[318 427  79 194 597],807,5,162,3.951219512195122,40.0,0.0
40041,4,41,[318 427  79 194 597],450,5,167,3.9761904761904763,40.0,0.0
40042,4,42,[496 546 568  97 117],450,5,172,4.0,20.0,0.0
40043,4,43,[ 97 318 597 546  79],457,3,175,3.977272727272727,20.0,0.0
40044,4,44,[168 185 748 153   4],151,3,178,3.9555555555555557,0.0,0.0
40045,4,45,[194 568  79   4 427],716,4,182,3.9565217391304346,20.0,0.0
40046,4,46,[194 568  79 318 427],450,5,187,3.978723404255319,40.0,0.0
40047,4,47,[194 568  79 318 427],716,5,192,4.0,40.0,0.0
40048,4,48,[194 568  79 318 427],716,5,197,4.020408163265306,40.0,0.0
40049,4,49,[742  64 294 118  15],256,4,201,4.02,20.0,0.0
40050,4,50,[588  97 204 121 286],344,2,203,3.980392156862745,0.0,20.0
40051,4,51,[125 100 423 302 183],151,2,205,3.9423076923076925,0.0,20.0
40052,4,52,[ 64 568 423  79 125],655,2,207,3.9056603773584904,20.0,0.0
40053,4,53,[ 79 318 194 168 588],450,5,212,3.925925925925926,20.0,0.0
40054,4,54,[ 79 318 194 168 588],457,5,217,3.9454545454545453,20.0,0.0
40055,4,55,[ 79 318 194 168 588],807,5,222,3.9642857142857144,20.0,0.0
40056,4,56,[269 286 313  98 603],278,5,227,3.982456140350877,20.0,20.0
40057,4,57,[ 79 194 318 168 588],716,5,232,4.0,20.0,0.0
40058,4,58,[ 79 194 318 168 588],577,5,237,4.016949152542373,20.0,0.0
40059,4,59,[ 79 194 318 168 588],716,5,242,4.033333333333333,20.0,0.0
40060,4,60,[ 79 194 318 168 588],807,5,247,4.049180327868853,20.0,0.0
40061,4,61,[ 79 194 318 168 588],716,5,252,4.064516129032258,20.0,0.0
40062,4,62,[ 79 194 318 168 588],18,3,255,4.0476190476190474,20.0,0.0
40063,4,63,[742  79 318  64 588],457,5,260,4.0625,40.0,0.0
40064,4,64,[742  79 318  64 588],577,5,265,4.076923076923077,40.0,0.0
40065,4,65,[742  79 318  64 588],450,5,270,4.090909090909091,40.0,0.0
40066,4,66,[742  79 318  64 588],450,5,275,4.104477611940299,40.0,0.0
40067,4,67,[742  79 318  64 588],796,4,279,4.102941176470588,40.0,0.0
40068,4,68,[546 275   4 427  28],716,3,282,4.086956521739131,20.0,20.0
40069,4,69,[275 427 117  64 588],450,5,287,4.1,40.0,20.0
40070,4,70,[275 427 117  64 588],796,5,292,4.112676056338028,40.0,20.0
40071,4,71,[275 427 117  64 588],716,5,297,4.125,40.0,20.0
40072,4,72,[79  4 22 15 88],18,3,300,4.109589041095891,0.0,0.0
40073,4,73,[318  28 275  79  64],236,4,304,4.108108108108108,40.0,20.0
40074,4,74,[318  28  79  64 427],716,5,309,4.12,60.0,0.0
40075,4,75,[655 405 403 191  89],457,5,314,4.131578947368421,0.0,0.0
40076,4,76,[655 117  22 191  64],796,4,318,4.12987012987013,20.0,0.0
40077,4,77,[405  79 318 427 588],716,5,323,4.141025641025641,40.0,0.0
40078,4,78,[405  79 318 427 588],796,5,328,4.151898734177215,40.0,0.0
40079,4,79,[405  79 318 427 588],716,5,333,4.1625,40.0,0.0
40080,4,80,[405  79 318 427 588],716,5,338,4.172839506172839,40.0,0.0
40081,4,81,[405  79 318 427 588],450,5,343,4.182926829268292,40.0,0.0
40082,4,82,[405  79 318 427 588],577,4,347,4.180722891566265,40.0,0.0
40083,4,83,[ 79 318 427 588  64],18,5,352,4.190476190476191,60.0,0.0
40084,4,84,[ 79 318 427 588  64],796,5,357,4.2,60.0,0.0
40085,4,85,[ 79 318 427 588  64],796,5,362,4.209302325581396,60.0,0.0
40086,4,86,[ 79 318 427 588  64],450,5,367,4.218390804597701,60.0,0.0
40087,4,87,[172 322 427 313  89],796,4,371,4.215909090909091,20.0,0.0
40088,4,88,[ 79 318 427 588  64],18,5,376,4.224719101123595,60.0,0.0
40089,4,89,[127 185  69 288 117],693,3,379,4.211111111111111,0.0,20.0
40090,4,90,[127 117  28 427 318],796,4,383,4.208791208791209,40.0,20.0
40091,4,91,[127 117 427 318  64],796,5,388,4.217391304347826,60.0,20.0
40092,4,92,[127 117 427 318  64],72,5,393,4.225806451612903,60.0,20.0
40093,4,93,[127 117 427 318  64],655,4,397,4.223404255319149,60.0,20.0
40094,4,94,[127  79 427 318  64],450,5,402,4.231578947368421,60.0,20.0
40095,4,95,[276 195 275 204 151],457,5,407,4.239583333333333,0.0,20.0
40096,4,96,[127 191 195  22 588],457,5,412,4.247422680412371,0.0,20.0
40097,4,97,[127 191 195  22 588],450,5,417,4.255102040816326,0.0,20.0
40098,4,98,[127 191 195  22 588],18,4,421,4.252525252525253,0.0,20.0
40099,4,99,[117 174  97 508 273],693,3,424,4.24,0.0,0.0
40100,4,100,[127  64  79 174 151],292,5,429,4.247524752475248,20.0,20.0
40101,4,101,[127  64  79 174 151],796,5,434,4.254901960784314,20.0,20.0
40102,4,102,[127  64  79 174 151],796,5,439,4.262135922330097,20.0,20.0
40103,4,103,[127  64  79 174 151],344,5,444,4.269230769230769,20.0,20.0
40104,4,104,[127  64  79 174 151],18,4,448,4.266666666666667,20.0,20.0
40105,4,105,[ 12 301 300 125 173],796,4,452,4.264150943396227,0.0,0.0
40106,4,106,[127 318 191 173 174],562,4,456,4.261682242990654,20.0,20.0
40107,4,107,[268 176   7 135  56],269,3,459,4.25,0.0,0.0
40108,4,108,[127 191 300 427 135],693,3,462,4.238532110091743,20.0,20.0
40109,4,109,[127 588  79 174 173],344,5,467,4.245454545454545,0.0,20.0
40110,4,110,[127 588  79 174 173],389,4,471,4.243243243243243,0.0,20.0
40111,4,111,[127 588  79 174  22],344,4,475,4.241071428571429,0.0,20.0
40112,4,112,[127 135  79 174 588],807,4,479,4.238938053097345,0.0,20.0
40113,4,113,[ 64  79 427 135 174],151,5,484,4.245614035087719,40.0,0.0
40114,4,114,[ 64  79 427 135 174],18,4,488,4.243478260869566,40.0,0.0
40115,4,115,[427  64 588 174  79],796,5,493,4.25,40.0,0.0
40116,4,116,[427  64 588 174  79],450,5,498,4.256410256410256,40.0,0.0
40117,4,117,[275 121 202 174 210],344,4,502,4.254237288135593,0.0,20.0
40118,4,118,[427  64 588 174  79],18,5,507,4.260504201680672,40.0,0.0
40119,4,119,[427  64 588 174  79],716,5,512,4.266666666666667,40.0,0.0
40120,4,120,[238  28 588 655 174],796,2,514,4.24793388429752,0.0,0.0
40121,4,121,[427  64 588 174  79],577,5,519,4.254098360655738,40.0,0.0
40122,4,122,[427  64 588 174  79],796,5,524,4.260162601626016,40.0,0.0
40123,4,123,[427  64 588 174  79],577,5,529,4.266129032258065,40.0,0.0
40124,4,124,[427  64 588 174  79],577,5,534,4.272,40.0,0.0
40125,4,125,[427  64 588 174  79],18,5,539,4.277777777777778,40.0,0.0
40126,4,126,[427  64 588 174  79],389,5,544,4.283464566929134,40.0,0.0
40127,4,127,[427  64 588 174  79],389,5,549,4.2890625,40.0,0.0
40128,4,128,[427  64 588 174  79],577,5,554,4.294573643410852,40.0,0.0
40129,4,129,[427  64 588 174  79],389,5,559,4.3,40.0,0.0
40130,4,130,[427  64 588 174  79],389,5,564,4.305343511450381,40.0,0.0
40131,4,131,[427  64 588 174  79],716,5,569,4.3106060606060606,40.0,0.0
40132,4,132,[427  64 588 174  79],450,5,574,4.315789473684211,40.0,0.0
40133,4,133,[427  64 588 174  79],389,5,579,4.32089552238806,40.0,0.0
40134,4,134,[427  64 588 174  79],389,5,584,4.325925925925926,40.0,0.0
40135,4,135,[588 211 275  98 235],23,4,588,4.323529411764706,0.0,20.0
40136,4,136,[  7 234  69  88 174],577,2,590,4.306569343065694,0.0,0.0
40137,4,137,[211 196 194 568 200],796,4,594,4.304347826086956,0.0,0.0
40138,4,138,[174 588  79  64 427],389,5,599,4.309352517985611,40.0,0.0
40139,4,139,[174 588  79  64 427],577,5,604,4.314285714285714,40.0,0.0
40140,4,140,[174 588  79  64 427],18,5,609,4.319148936170213,40.0,0.0
40141,4,141,[144 496 228 204 202],280,1,610,4.295774647887324,20.0,0.0
40142,4,142,[174 588  79  64 427],577,5,615,4.300699300699301,40.0,0.0
40143,4,143,[174 588  79  64 427],389,5,620,4.305555555555555,40.0,0.0
40144,4,144,[174 588  79  64 427],389,5,625,4.310344827586207,40.0,0.0
40145,4,145,[174 588  79  64 427],389,5,630,4.315068493150685,40.0,0.0
40146,4,146,[174 588  79  64 427],577,5,635,4.319727891156463,40.0,0.0
40147,4,147,[174 588  79  64 427],450,5,640,4.324324324324325,40.0,0.0
40148,4,148,[118 174 288  82 313],280,1,641,4.302013422818792,0.0,0.0
40149,4,149,[588  79  64 427 200],18,4,645,4.3,40.0,0.0
40150,4,150,[ 79  64 427 588 318],18,5,650,4.304635761589404,60.0,0.0
40151,4,151,[ 79  64 427 588 318],716,5,655,4.309210526315789,60.0,0.0
40152,4,152,[ 79  64 427 588 318],796,5,660,4.313725490196078,60.0,0.0
40153,4,153,[ 79  64 427 588 318],577,5,665,4.318181818181818,60.0,0.0
40154,4,154,[  1 186 222  88  82],655,0,665,4.290322580645161,0.0,0.0
40155,4,155,[ 79  64 427 588 318],18,5,670,4.294871794871795,60.0,0.0
40156,4,156,[ 79  64 427 588 318],450,5,675,4.2993630573248405,60.0,0.0
40157,4,157,[ 79  64 427 588 318],577,5,680,4.30379746835443,60.0,0.0
40158,4,158,[ 79  64 427 588 318],796,5,685,4.3081761006289305,60.0,0.0
40159,4,159,[ 79  64 427 588 318],716,5,690,4.3125,60.0,0.0
40160,4,160,[483 216 271   8 273],796,4,694,4.3105590062111805,0.0,0.0
40161,4,161,[597 282  98 655 238],593,3,697,4.302469135802469,0.0,0.0
40162,4,162,[588 282 427  64  79],796,5,702,4.306748466257669,40.0,0.0
40163,4,163,[ 88 100 161 135 496],330,4,706,4.304878048780488,20.0,20.0
40164,4,164,[121  97  89 174  82],256,5,711,4.3090909090909095,0.0,0.0
40165,4,165,[275  70 172 183 181],23,3,714,4.301204819277109,0.0,20.0
40166,4,166,[161 282 271  64  79],655,2,716,4.287425149700598,20.0,0.0
40167,4,167,[202 282 300  50 228],716,4,720,4.285714285714286,0.0,20.0
40168,4,168,[ 79 588 427  64  50],716,5,725,4.289940828402367,40.0,20.0
40169,4,169,[ 79 588 427  64  50],716,5,730,4.294117647058823,40.0,20.0
40170,4,170,[ 79 588 427  64  50],577,5,735,4.298245614035087,40.0,20.0
40171,4,171,[ 79 588 427  64  50],577,5,740,4.3023255813953485,40.0,20.0
40172,4,172,[ 79 588 427  64  50],18,5,745,4.30635838150289,40.0,20.0
40173,4,173,[ 79 588 427  64  50],577,5,750,4.310344827586207,40.0,20.0
40174,4,174,[ 79 588 427  64  50],577,5,755,4.314285714285714,40.0,20.0
40175,4,175,[ 79 588 427  64  50],450,5,760,4.318181818181818,40.0,20.0
40176,4,176,[ 79 588 427  64  50],577,5,765,4.322033898305085,40.0,20.0
40177,4,177,[ 79 588 427  64  50],577,5,770,4.325842696629214,40.0,20.0
40178,4,178,[ 79 588 427  64  50],18,5,775,4.329608938547486,40.0,20.0
40179,4,179,[100 294 179 168 385],450,5,780,4.333333333333333,0.0,20.0
40180,4,180,[ 79 385 427  64  50],577,5,785,4.337016574585635,40.0,20.0
40181,4,181,[286 483 211 121  79],796,3,788,4.329670329670329,0.0,20.0
40182,4,182,[ 79 385 427  64  50],577,5,793,4.333333333333333,40.0,20.0
40183,4,183,[ 79 385 427  64  50],151,4,797,4.331521739130435,40.0,20.0
40184,4,184,[ 79 588 427  64  50],796,5,802,4.335135135135135,40.0,20.0
40185,4,185,[ 79 588 427  64  50],796,5,807,4.338709677419355,40.0,20.0
40186,4,186,[ 79 588 427  64  50],716,5,812,4.342245989304812,40.0,20.0
40187,4,187,[ 79 588 427  64  50],716,5,817,4.345744680851064,40.0,20.0
40188,4,188,[ 79 588 427  64  50],716,5,822,4.349206349206349,40.0,20.0
40189,4,189,[ 79 588 427  64  50],450,5,827,4.352631578947369,40.0,20.0
40190,4,190,[172  95  12  88 202],450,4,831,4.350785340314136,0.0,0.0
40191,4,191,[ 79 588 427  64  50],450,5,836,4.354166666666667,40.0,20.0
40192,4,192,[ 79 588 427  64  50],796,5,841,4.357512953367876,40.0,20.0
40193,4,193,[ 79 588 427  64  50],716,5,846,4.360824742268041,40.0,20.0
40194,4,194,[161  82 143  28 135],655,2,848,4.348717948717948,0.0,0.0
40195,4,195,[483 427  50  64 588],316,3,851,4.341836734693878,40.0,20.0
40196,4,196,[357 174 294 191 568],796,4,855,4.340101522842639,0.0,0.0
40197,4,197,[483 427  64  79 588],796,5,860,4.343434343434343,40.0,0.0
40198,4,198,[483 427  64  79 588],796,5,865,4.346733668341709,40.0,0.0
40199,4,199,[483 427  64  79 588],389,5,870,4.35,40.0,0.0
40200,4,200,[483 427  64  79 588],389,5,875,4.353233830845771,40.0,0.0
40201,4,201,[483 427  64  79 588],796,5,880,4.356435643564357,40.0,0.0
40202,4,202,[483 427  64  79 588],450,4,884,4.354679802955665,40.0,0.0
40203,4,203,[ 79 427  64 588 318],577,5,889,4.357843137254902,60.0,0.0
40204,4,204,[294 423 204 125  88],796,4,893,4.35609756097561,0.0,0.0
40205,4,205,[ 79 427  64 588 318],18,5,898,4.359223300970874,60.0,0.0
40206,4,206,[ 79 427  64 588 318],577,5,903,4.36231884057971,60.0,0.0
40207,4,207,[ 79 427  64 588 318],18,5,908,4.365384615384615,60.0,0.0
40208,4,208,[ 79 427  64 588 318],796,5,913,4.368421052631579,60.0,0.0
40209,4,209,[ 79 427  64 588 318],716,5,918,4.371428571428571,60.0,0.0
40210,4,210,[ 88 234 144 322 180],796,2,920,4.360189573459715,0.0,0.0
40211,4,211,[427  79  64 588 318],18,5,925,4.363207547169812,60.0,0.0
40212,4,212,[427  79  64 588 318],450,5,930,4.366197183098592,60.0,0.0
40213,4,213,[427  79  64 588 318],796,5,935,4.369158878504673,60.0,0.0
40214,4,214,[427  79  64 588 318],18,5,940,4.372093023255814,60.0,0.0
40215,4,215,[427  79  64 588 318],577,5,945,4.375,60.0,0.0
40216,4,216,[427  79  64 588 318],450,5,950,4.377880184331797,60.0,0.0
40217,4,217,[427  79  64 588 318],796,5,955,4.3807339449541285,60.0,0.0
40218,4,218,[117 191 121 471 276],457,5,960,4.383561643835616,0.0,0.0
40219,4,219,[ 79 471  64 427 588],577,4,964,4.381818181818182,40.0,0.0
40220,4,220,[ 79  64 427 588 318],18,5,969,4.384615384615385,60.0,0.0
40221,4,221,[ 79  64 427 588 318],577,5,974,4.387387387387387,60.0,0.0
40222,4,222,[ 79  64 427 588 318],796,5,979,4.390134529147982,60.0,0.0
40223,4,223,[197 174 204 678 275],401,4,983,4.388392857142857,0.0,20.0
40224,4,224,[427  79  64 197 588],389,5,988,4.391111111111111,40.0,0.0
40225,4,225,[427  79  64 197 588],796,4,992,4.389380530973451,40.0,0.0
40226,4,226,[ 79  64 427 588 318],577,5,997,4.392070484581498,60.0,0.0
40227,4,227,[ 79  64 427 588 318],716,5,1002,4.394736842105263,60.0,0.0
40228,4,228,[ 79  64 427 588 318],796,5,1007,4.397379912663755,60.0,0.0
40229,4,229,[ 79  64 427 588 318],450,5,1012,4.4,60.0,0.0
40230,4,230,[273 328  64 187 568],796,4,1016,4.3982683982683985,20.0,0.0
40231,4,231,[234 211 475 197  79],503,4,1020,4.396551724137931,0.0,0.0
40232,4,232,[ 64 328 427  79 588],450,5,1025,4.399141630901288,40.0,0.0
40233,4,233,[ 64 328 427  79 588],450,5,1030,4.401709401709402,40.0,0.0
40234,4,234,[ 64 328 427  79 588],450,5,1035,4.404255319148936,40.0,0.0
40235,4,235,[ 64 328 427  79 588],450,5,1040,4.406779661016949,40.0,0.0
40236,4,236,[ 64 328 427  79 588],796,5,1045,4.409282700421941,40.0,0.0
40237,4,237,[427 234 546 132  97],796,3,1048,4.4033613445378155,20.0,0.0
40238,4,238,[ 79 132 328 427  64],450,5,1053,4.405857740585774,40.0,0.0
40239,4,239,[ 79 132 328 427  64],655,3,1056,4.4,40.0,0.0
40240,4,240,[427  79  64 588 318],796,5,1061,4.402489626556017,60.0,0.0
40241,4,241,[427  79  64 588 318],18,5,1066,4.404958677685951,60.0,0.0
40242,4,242,[427  79  64 588 318],18,5,1071,4.407407407407407,60.0,0.0
40243,4,243,[427  79  64 588 318],18,5,1076,4.409836065573771,60.0,0.0
40244,4,244,[ 97 508 282 238 286],655,0,1076,4.391836734693878,0.0,20.0
40245,4,245,[427  79  64 588 318],450,5,1081,4.394308943089431,60.0,0.0
40246,4,246,[427  79  64 588 318],577,5,1086,4.396761133603239,60.0,0.0
40247,4,247,[427  79  64 588 318],577,5,1091,4.399193548387097,60.0,0.0
40248,4,248,[427  79  64 588 318],796,5,1096,4.401606425702811,60.0,0.0
40249,4,249,[ 82 483 748 186 435],450,2,1098,4.392,0.0,0.0
40250,4,250,[ 79 435 427  64 588],716,5,1103,4.394422310756972,40.0,0.0
40251,4,251,[ 79 435 427  64 588],18,5,1108,4.396825396825397,40.0,0.0
40252,4,252,[ 79 435 427  64 588],389,5,1113,4.399209486166008,40.0,0.0
40253,4,253,[ 79 435 427  64 588],18,5,1118,4.4015748031496065,40.0,0.0
40254,4,254,[ 79 435 427  64 588],450,5,1123,4.403921568627451,40.0,0.0
40255,4,255,[405 215 318 238 302],151,2,1125,4.39453125,20.0,0.0
40256,4,256,[603 742 403 289 588],756,3,1128,4.389105058365759,20.0,0.0
40257,4,257,[471  25 174 143 194],389,3,1131,4.383720930232558,0.0,0.0
40258,4,258,[ 79 289 427 435  64],236,5,1136,4.386100386100386,40.0,0.0
40259,4,259,[ 79 289 427 435  64],236,5,1141,4.388461538461539,40.0,0.0
40260,4,260,[117   4 300  69 276],655,1,1142,4.375478927203065,0.0,0.0
40261,4,261,[ 79 289 427 435  64],655,3,1145,4.370229007633588,40.0,0.0
40262,4,262,[427  64  79 588 318],796,5,1150,4.3726235741444865,60.0,0.0
40263,4,263,[427  64  79 588 318],18,5,1155,4.375,60.0,0.0
40264,4,264,[427  64  79 588 318],577,5,1160,4.377358490566038,60.0,0.0
40265,4,265,[427  64  79 588 318],18,5,1165,4.379699248120301,60.0,0.0
40266,4,266,[183 546 172 173 237],786,5,1170,4.382022471910112,0.0,0.0
40267,4,267,[ 64 237 427  79 588],18,4,1174,4.380597014925373,40.0,0.0
40268,4,268,[427  64  79 588 318],716,5,1179,4.382899628252788,60.0,0.0
40269,4,269,[427  64  79 588 318],18,5,1184,4.385185185185185,60.0,0.0
40270,4,270,[ 79 186 333  50 196],796,4,1188,4.3837638376383765,0.0,20.0
40271,4,271,[357 151 135 597 238],450,4,1192,4.382352941176471,0.0,0.0
40272,4,272,[ 79 333  64 427 588],796,5,1197,4.384615384615385,40.0,0.0
40273,4,273,[ 50  88 125 111 435],401,3,1200,4.37956204379562,0.0,20.0
40274,4,274,[333  64  79 427 111],655,3,1203,4.374545454545455,40.0,0.0
40275,4,275,[ 64  79 427 588 318],18,5,1208,4.3768115942028984,60.0,0.0
40276,4,276,[245  11 300 161 187],450,5,1213,4.379061371841155,0.0,0.0
40277,4,277,[ 64  79 427  11 588],716,5,1218,4.381294964028777,40.0,0.0
40278,4,278,[ 64  79 427  11 588],577,4,1222,4.379928315412187,40.0,0.0
40279,4,279,[ 64  79 427 588 318],796,5,1227,4.382142857142857,60.0,0.0
40280,4,280,[ 64  79 427 588 318],577,5,1232,4.384341637010676,60.0,0.0
40281,4,281,[ 64  79 427 588 318],18,5,1237,4.386524822695035,60.0,0.0
40282,4,282,[ 64  79 427 588 318],18,5,1242,4.3886925795053005,60.0,0.0
40283,4,283,[ 64  79 427 588 318],18,5,1247,4.390845070422535,60.0,0.0
40284,4,284,[ 64  79 427 588 318],716,5,1252,4.392982456140351,60.0,0.0
40285,4,285,[ 64  79 427 588 318],577,5,1257,4.395104895104895,60.0,0.0
40286,4,286,[ 64  79 427 588 318],577,5,1262,4.397212543554007,60.0,0.0
40287,4,287,[ 64  79 427 588 318],796,5,1267,4.399305555555555,60.0,0.0
40288,4,288,[191   9  15 211 483],269,4,1271,4.397923875432526,0.0,0.0
40289,4,289,[ 79 427  64 588 318],450,5,1276,4.4,60.0,0.0
40290,4,290,[ 79 427  64 588 318],450,5,1281,4.402061855670103,60.0,0.0
40291,4,291,[ 79 427  64 588 318],796,5,1286,4.404109589041096,60.0,0.0
40292,4,292,[ 79 427  64 588 318],450,5,1291,4.406143344709897,60.0,0.0
40293,4,293,[318 173  79  28 546],577,4,1295,4.404761904761905,20.0,0.0
40294,4,294,[ 79 427  64 588 318],796,5,1300,4.406779661016949,60.0,0.0
40295,4,295,[ 79 427  64 588 318],577,5,1305,4.408783783783784,60.0,0.0
40296,4,296,[ 79 427  64 588 318],450,5,1310,4.410774410774411,60.0,0.0
40297,4,297,[125 121 187  79 403],796,5,1315,4.412751677852349,0.0,0.0
40298,4,298,[ 79 427  64 588 318],716,5,1320,4.414715719063545,60.0,0.0
40299,4,299,[ 79 427  64 588 318],796,5,1325,4.416666666666667,60.0,0.0
40300,4,300,[ 79 427  64 588 318],577,5,1330,4.4186046511627906,60.0,0.0
40301,4,301,[ 79 427  64 588 318],796,5,1335,4.420529801324503,60.0,0.0
40302,4,302,[ 79 427  64 588 318],450,5,1340,4.422442244224422,60.0,0.0
40303,4,303,[ 79 427  64 588 318],716,5,1345,4.4243421052631575,60.0,0.0
40304,4,304,[ 79 427  64 588 318],18,5,1350,4.426229508196721,60.0,0.0
40305,4,305,[ 79 427  64 588 318],450,5,1355,4.428104575163399,60.0,0.0
40306,4,306,[ 95 100 215 405 121],577,4,1359,4.4267100977198695,0.0,20.0
40307,4,307,[427  79  64 588 318],577,5,1364,4.428571428571429,60.0,0.0
40308,4,308,[427  79  64 588 318],796,5,1369,4.43042071197411,60.0,0.0
40309,4,309,[127 197 215 168 286],18,3,1372,4.425806451612903,0.0,40.0
40310,4,310,[427  79  64 588 318],450,5,1377,4.427652733118971,60.0,0.0
40311,4,311,[427  79  64 588 318],18,5,1382,4.42948717948718,60.0,0.0
40312,4,312,[427  79  64 588 318],18,5,1387,4.431309904153355,60.0,0.0
40313,4,313,[427  79  64 588 318],18,5,1392,4.43312101910828,60.0,0.0
40314,4,314,[427  79  64 588 318],577,5,1397,4.434920634920635,60.0,0.0
40315,4,315,[427  79  64 588 318],796,5,1402,4.436708860759493,60.0,0.0
40316,4,316,[427  79  64 588 318],796,5,1407,4.438485804416404,60.0,0.0
40317,4,317,[427  79  64 588 318],716,5,1412,4.440251572327044,60.0,0.0
40318,4,318,[427  79  64 588 318],577,5,1417,4.4420062695924765,60.0,0.0
40319,4,319,[427  79  64 588 318],796,5,1422,4.44375,60.0,0.0
40320,4,320,[427  79  64 588 318],796,5,1427,4.445482866043614,60.0,0.0
40321,4,321,[427  79  64 588 318],577,5,1432,4.447204968944099,60.0,0.0
40322,4,322,[427  79  64 588 318],450,5,1437,4.4489164086687305,60.0,0.0
40323,4,323,[427  79  64 588 318],18,5,1442,4.450617283950617,60.0,0.0
40324,4,324,[427  79  64 588 318],716,5,1447,4.452307692307692,60.0,0.0
40325,4,325,[427  79  64 588 318],716,5,1452,4.45398773006135,60.0,0.0
40326,4,326,[427  79  64 588 318],450,5,1457,4.45565749235474,60.0,0.0
40327,4,327,[427  79  64 588 318],577,5,1462,4.4573170731707314,60.0,0.0
40328,4,328,[427  79  64 588 318],18,5,1467,4.458966565349544,60.0,0.0
40329,4,329,[427  79  64 588 318],18,5,1472,4.460606060606061,60.0,0.0
40330,4,330,[427  79  64 588 318],716,5,1477,4.462235649546828,60.0,0.0
40331,4,331,[216 200  79 187 271],796,5,1482,4.463855421686747,0.0,0.0
40332,4,332,[427  79  64 588 318],796,5,1487,4.465465465465465,60.0,0.0
40333,4,333,[427  79  64 588 318],577,5,1492,4.467065868263473,60.0,0.0
40334,4,334,[427  79  64 588 318],796,5,1497,4.46865671641791,60.0,0.0
40335,4,335,[427  79  64 588 318],577,5,1502,4.470238095238095,60.0,0.0
40336,4,336,[427  79  64 588 318],18,5,1507,4.471810089020772,60.0,0.0
40337,4,337,[427  79  64 588 318],577,5,1512,4.4733727810650885,60.0,0.0
40338,4,338,[427  79  64 588 318],716,5,1517,4.474926253687316,60.0,0.0
40339,4,339,[427  79  64 588 318],577,5,1522,4.476470588235294,60.0,0.0
40340,4,340,[427  79  64 588 318],716,5,1527,4.478005865102639,60.0,0.0
40341,4,341,[427  79  64 588 318],18,5,1532,4.47953216374269,60.0,0.0
40342,4,342,[427  79  64 588 318],18,5,1537,4.481049562682216,60.0,0.0
40343,4,343,[427  79  64 588 318],577,5,1542,4.482558139534884,60.0,0.0
40344,4,344,[568 111 655 603 168],796,4,1546,4.481159420289855,20.0,0.0
40345,4,345,[ 64 427  79 588 318],577,5,1551,4.482658959537572,60.0,0.0
40346,4,346,[ 64 427  79 588 318],450,5,1556,4.484149855907781,60.0,0.0
40347,4,347,[ 64 427  79 588 318],18,5,1561,4.485632183908046,60.0,0.0
40348,4,348,[ 64 427  79 588 318],18,5,1566,4.487106017191977,60.0,0.0
40349,4,349,[ 64 427  79 588 318],716,5,1571,4.488571428571428,60.0,0.0
40350,4,350,[ 64 427  79 588 318],796,5,1576,4.49002849002849,60.0,0.0
40351,4,351,[ 64 427  79 588 318],796,5,1581,4.4914772727272725,60.0,0.0
40352,4,352,[ 64 427  79 588 318],577,5,1586,4.492917847025495,60.0,0.0
40353,4,353,[ 64 427  79 588 318],18,5,1591,4.494350282485875,60.0,0.0
40354,4,354,[  9  95 222 211 748],796,3,1594,4.490140845070423,0.0,0.0
40355,4,355,[ 79 427  64 588 318],450,5,1599,4.491573033707865,60.0,0.0
40356,4,356,[ 79 427  64 588 318],18,5,1604,4.492997198879552,60.0,0.0
40357,4,357,[111 405 288 423 117],457,4,1608,4.4916201117318435,0.0,0.0
40358,4,358,[ 79 427  64 588 318],796,5,1613,4.493036211699164,60.0,0.0
40359,4,359,[ 79 427  64 588 318],450,5,1618,4.4944444444444445,60.0,0.0
40360,4,360,[403 597 603 211  70],450,5,1623,4.49584487534626,20.0,0.0
40361,4,361,[427  79  64 588 318],796,5,1628,4.497237569060774,60.0,0.0
40362,4,362,[121 282 197  50 385],504,4,1632,4.4958677685950414,0.0,20.0
40363,4,363,[427  79  64 588 318],450,5,1637,4.497252747252747,60.0,0.0
40364,4,364,[427  79  64 588 318],18,5,1642,4.498630136986302,60.0,0.0
40365,4,365,[427  79  64 588 318],577,5,1647,4.5,60.0,0.0
40366,4,366,[427  79  64 588 318],796,5,1652,4.501362397820164,60.0,0.0
40367,4,367,[427  79  64 588 318],577,5,1657,4.502717391304348,60.0,0.0
40368,4,368,[427  79  64 588 318],450,5,1662,4.504065040650406,60.0,0.0
40369,4,369,[427  79  64 588 318],577,5,1667,4.505405405405406,60.0,0.0
40370,4,370,[427  79  64 588 318],577,5,1672,4.506738544474394,60.0,0.0
40371,4,371,[427  79  64 588 318],796,5,1677,4.508064516129032,60.0,0.0
40372,4,372,[427  79  64 588 318],716,5,1682,4.509383378016086,60.0,0.0
40373,4,373,[427  79  64 588 318],577,5,1687,4.510695187165775,60.0,0.0
40374,4,374,[117 300 237 143  25],655,1,1688,4.501333333333333,0.0,0.0
40375,4,375,[427  79  64 588 318],716,5,1693,4.502659574468085,60.0,0.0
40376,4,376,[427  79  64 588 318],716,5,1698,4.503978779840849,60.0,0.0
40377,4,377,[427  79  64 588 318],577,5,1703,4.505291005291006,60.0,0.0
40378,4,378,[427  79  64 588 318],716,5,1708,4.506596306068602,60.0,0.0
40379,4,379,[427  79  64 588 318],18,5,1713,4.507894736842105,60.0,0.0
40380,4,380,[427  79  64 588 318],450,5,1718,4.509186351706036,60.0,0.0
40381,4,381,[427  79  64 588 318],796,5,1723,4.510471204188482,60.0,0.0
40382,4,382,[427  79  64 588 318],577,5,1728,4.511749347258486,60.0,0.0
40383,4,383,[427  79  64 588 318],450,5,1733,4.513020833333333,60.0,0.0
40384,4,384,[427  79  64 588 318],796,5,1738,4.514285714285714,60.0,0.0
40385,4,385,[427  79  64 588 318],577,5,1743,4.515544041450777,60.0,0.0
40386,4,386,[427  79  64 588 318],18,5,1748,4.516795865633075,60.0,0.0
40387,4,387,[427  79  64 588 318],716,5,1753,4.518041237113402,60.0,0.0
40388,4,388,[427  79  64 588 318],716,5,1758,4.519280205655527,60.0,0.0
40389,4,389,[427  79  64 588 318],18,5,1763,4.52051282051282,60.0,0.0
40390,4,390,[427  79  64 588 318],450,5,1768,4.521739130434782,60.0,0.0
40391,4,391,[427  79  64 588 318],716,5,1773,4.5229591836734695,60.0,0.0
40392,4,392,[427  79  64 588 318],716,5,1778,4.524173027989822,60.0,0.0
40393,4,393,[427  79  64 588 318],716,5,1783,4.525380710659898,60.0,0.0
40394,4,394,[546 211 234  28 168],716,4,1787,4.5240506329113925,0.0,0.0
40395,4,395,[427  79  64 588 318],18,5,1792,4.525252525252525,60.0,0.0
40396,4,396,[427  79  64 588 318],577,5,1797,4.526448362720403,60.0,0.0
40397,4,397,[427  79  64 588 318],716,5,1802,4.527638190954774,60.0,0.0
40398,4,398,[289  11 265  28 174],655,0,1802,4.516290726817043,0.0,0.0
40399,4,399,[427  79  64 588 318],18,5,1807,4.5175,60.0,0.0
40400,4,400,[427  79  64 588 318],577,5,1812,4.5187032418952615,60.0,0.0
40401,4,401,[427  79  64 588 318],18,5,1817,4.519900497512438,60.0,0.0
40402,4,402,[427  79  64 588 318],577,5,1822,4.521091811414392,60.0,0.0
40403,4,403,[427  79  64 588 318],796,5,1827,4.522277227722772,60.0,0.0
40404,4,404,[427  79  64 588 318],796,5,1832,4.523456790123457,60.0,0.0
40405,4,405,[333  28 181 237 427],236,4,1836,4.522167487684729,20.0,0.0
40406,4,406,[427  79  64 588 318],450,5,1841,4.523341523341523,60.0,0.0
40407,4,407,[427  79  64 588 318],716,5,1846,4.5245098039215685,60.0,0.0
40408,4,408,[427  79  64 588 318],796,5,1851,4.525672371638142,60.0,0.0
40409,4,409,[427  79  64 588 318],577,5,1856,4.5268292682926825,60.0,0.0
40410,4,410,[427  79  64 588 318],796,5,1861,4.527980535279806,60.0,0.0
40411,4,411,[427  79  64 588 318],18,5,1866,4.529126213592233,60.0,0.0
40412,4,412,[427  79  64 588 318],716,5,1871,4.530266343825666,60.0,0.0
40413,4,413,[427  79  64 588 318],796,5,1876,4.531400966183575,60.0,0.0
40414,4,414,[132 117 180 211 286],450,5,1881,4.532530120481928,0.0,20.0
40415,4,415,[ 64 427  79 588 318],716,5,1886,4.533653846153846,60.0,0.0
40416,4,416,[ 64 427  79 588 318],577,5,1891,4.534772182254197,60.0,0.0
40417,4,417,[ 64 427  79 588 318],796,5,1896,4.535885167464115,60.0,0.0
40418,4,418,[100  28 187  70 265],450,5,1901,4.536992840095466,0.0,20.0
40419,4,419,[ 64 427  79 588 318],716,5,1906,4.538095238095238,60.0,0.0
40420,4,420,[ 64 427  79 588 318],796,5,1911,4.539192399049881,60.0,0.0
40421,4,421,[ 64 427  79 588 318],450,5,1916,4.540284360189573,60.0,0.0
40422,4,422,[ 64 427  79 588 318],716,5,1921,4.541371158392435,60.0,0.0
40423,4,423,[ 64 427  79 588 318],577,5,1926,4.5424528301886795,60.0,0.0
40424,4,424,[ 64 427  79 588 318],18,5,1931,4.543529411764706,60.0,0.0
40425,4,425,[ 64 427  79 588 318],577,5,1936,4.544600938967136,60.0,0.0
40426,4,426,[ 64 427  79 588 318],450,5,1941,4.5456674473067915,60.0,0.0
40427,4,427,[ 64 427  79 588 318],716,5,1946,4.546728971962617,60.0,0.0
40428,4,428,[ 64 427  79 588 318],18,5,1951,4.547785547785548,60.0,0.0
40429,4,429,[ 64 427  79 588 318],577,5,1956,4.5488372093023255,60.0,0.0
40430,4,430,[ 64 427  79 588 318],577,5,1961,4.549883990719257,60.0,0.0
40431,4,431,[ 64 427  79 588 318],716,5,1966,4.550925925925926,60.0,0.0
40432,4,432,[ 64 427  79 588 318],577,5,1971,4.551963048498846,60.0,0.0
40433,4,433,[ 64 427  79 588 318],796,5,1976,4.552995391705069,60.0,0.0
40434,4,434,[ 64 427  79 588 318],450,5,1981,4.554022988505747,60.0,0.0
40435,4,435,[ 64 427  79 588 318],18,5,1986,4.555045871559633,60.0,0.0
40436,4,436,[ 64 427  79 588 318],716,5,1991,4.556064073226545,60.0,0.0
40437,4,437,[ 64 427  79 588 318],577,5,1996,4.557077625570776,60.0,0.0
40438,4,438,[ 64 427  79 588 318],450,5,2001,4.5580865603644645,60.0,0.0
40439,4,439,[125 275 132  25 211],151,5,2006,4.5590909090909095,0.0,20.0
40440,4,440,[ 79 427  64 588 318],450,5,2011,4.5600907029478455,60.0,0.0
40441,4,441,[ 79 427  64 588 318],450,5,2016,4.5610859728506785,60.0,0.0
40442,4,442,[ 79 427  64 588 318],18,5,2021,4.562076749435666,60.0,0.0
40443,4,443,[ 79 427  64 588 318],716,5,2026,4.563063063063063,60.0,0.0
40444,4,444,[ 79 427  64 588 318],716,5,2031,4.564044943820225,60.0,0.0
40445,4,445,[ 79 427  64 588 318],18,5,2036,4.565022421524664,60.0,0.0
40446,4,446,[ 79 427  64 588 318],796,5,2041,4.565995525727069,60.0,0.0
40447,4,447,[ 79 427  64 588 318],18,5,2046,4.566964285714286,60.0,0.0
40448,4,448,[ 79 427  64 588 318],577,5,2051,4.567928730512249,60.0,0.0
40449,4,449,[180 127 202 111 678],280,3,2054,4.564444444444445,0.0,20.0
40450,4,450,[ 79 427  64 588 318],577,5,2059,4.565410199556541,60.0,0.0
40451,4,451,[234 423 435 172 357],716,5,2064,4.566371681415929,0.0,0.0
40452,4,452,[ 79 427  64 588 318],796,5,2069,4.567328918322295,60.0,0.0
40453,4,453,[ 79 427  64 588 318],796,5,2074,4.568281938325991,60.0,0.0
40454,4,454,[ 79 427  64 588 318],577,5,2079,4.569230769230769,60.0,0.0
40455,4,455,[ 79 427  64 588 318],450,5,2084,4.5701754385964914,60.0,0.0
40456,4,456,[496 202 301 322 275],450,5,2089,4.571115973741795,20.0,20.0
40457,4,457,[200 238 202 234 385],151,3,2092,4.567685589519651,0.0,0.0
40458,4,458,[ 79  64 427 588 318],577,5,2097,4.568627450980392,60.0,0.0
40459,4,459,[100  15 174 301 111],593,5,2102,4.569565217391304,0.0,20.0
40460,4,460,[ 71  56  97 194 313],577,4,2106,4.568329718004338,0.0,0.0
40461,4,461,[ 79  64 427 588 318],450,5,2111,4.56926406926407,60.0,0.0
40462,4,462,[ 79  64 427 588 318],796,5,2116,4.570194384449244,60.0,0.0
40463,4,463,[ 89   1 121  97 117],786,4,2120,4.568965517241379,0.0,0.0
40464,4,464,[ 79 427  64 588 318],18,5,2125,4.56989247311828,60.0,0.0
40465,4,465,[ 79 427  64 588 318],716,5,2130,4.570815450643777,60.0,0.0
40466,4,466,[ 79 427  64 588 318],450,5,2135,4.571734475374733,60.0,0.0
40467,4,467,[ 79 427  64 588 318],577,5,2140,4.572649572649572,60.0,0.0
40468,4,468,[ 79 427  64 588 318],796,5,2145,4.573560767590618,60.0,0.0
40469,4,469,[ 79 427  64 588 318],18,5,2150,4.574468085106383,60.0,0.0
40470,4,470,[ 79 427  64 588 318],577,5,2155,4.575371549893843,60.0,0.0
40471,4,471,[ 79 427  64 588 318],716,5,2160,4.576271186440678,60.0,0.0
40472,4,472,[ 79 427  64 588 318],716,5,2165,4.577167019027484,60.0,0.0
40473,4,473,[ 79 427  64 588 318],18,5,2170,4.578059071729958,60.0,0.0
40474,4,474,[ 79 427  64 588 318],450,5,2175,4.578947368421052,60.0,0.0
40475,4,475,[ 79 427  64 588 318],716,5,2180,4.579831932773109,60.0,0.0
40476,4,476,[ 79 427  64 588 318],577,5,2185,4.580712788259958,60.0,0.0
40477,4,477,[ 79 427  64 588 318],577,5,2190,4.581589958158996,60.0,0.0
40478,4,478,[ 79 427  64 588 318],796,5,2195,4.582463465553236,60.0,0.0
40479,4,479,[ 79 427  64 588 318],577,5,2200,4.583333333333333,60.0,0.0
40480,4,480,[ 79 427  64 588 318],18,5,2205,4.584199584199585,60.0,0.0
40481,4,481,[ 79 427  64 588 318],577,5,2210,4.5850622406639,60.0,0.0
40482,4,482,[ 79 427  64 588 318],450,5,2215,4.58592132505176,60.0,0.0
40483,4,483,[ 79 427  64 588 318],796,5,2220,4.586776859504132,60.0,0.0
40484,4,484,[ 79 427  64 588 318],716,5,2225,4.587628865979381,60.0,0.0
40485,4,485,[ 79 427  64 588 318],577,5,2230,4.588477366255144,60.0,0.0
40486,4,486,[ 79 427  64 588 318],450,5,2235,4.5893223819301845,60.0,0.0
40487,4,487,[ 79 427  64 588 318],716,5,2240,4.590163934426229,60.0,0.0
40488,4,488,[ 79 427  64 588 318],577,5,2245,4.591002044989775,60.0,0.0
40489,4,489,[ 79 427  64 588 318],796,5,2250,4.591836734693878,60.0,0.0
40490,4,490,[ 79 427  64 588 318],577,5,2255,4.592668024439918,60.0,0.0
40491,4,491,[ 79 427  64 588 318],796,5,2260,4.59349593495935,60.0,0.0
40492,4,492,[196 568  11 427 153],716,5,2265,4.594320486815416,20.0,0.0
40493,4,493,[ 79  64 427 588 318],450,5,2270,4.5951417004048585,60.0,0.0
40494,4,494,[ 79  64 427 588 318],450,5,2275,4.595959595959596,60.0,0.0
40495,4,495,[ 79  64 427 588 318],18,5,2280,4.596774193548387,60.0,0.0
40496,4,496,[ 79  64 427 588 318],18,5,2285,4.597585513078471,60.0,0.0
40497,4,497,[ 79  64 427 588 318],577,5,2290,4.598393574297189,60.0,0.0
40498,4,498,[216  11 655 187  64],269,3,2293,4.595190380761523,20.0,0.0
40499,4,499,[ 79  64 427 588 318],577,5,2298,4.596,60.0,0.0
40500,4,500,[ 79  64 427 588 318],577,5,2303,4.5968063872255485,60.0,0.0
40501,4,501,[ 79  64 427 588 318],18,5,2308,4.597609561752988,60.0,0.0
40502,4,502,[234 286 385 117 100],280,3,2311,4.594433399602385,0.0,40.0
40503,4,503,[211 483 175   7 121],269,3,2314,4.591269841269841,0.0,0.0
40504,4,504,[ 79  64 427 588 318],18,5,2319,4.592079207920792,60.0,0.0
40505,4,505,[ 79  64 427 588 318],716,5,2324,4.592885375494071,60.0,0.0
40506,4,506,[ 79  64 427 588 318],450,5,2329,4.593688362919132,60.0,0.0
40507,4,507,[ 79  64 427 588 318],577,5,2334,4.594488188976378,60.0,0.0
40508,4,508,[ 79  64 427 588 318],18,5,2339,4.595284872298625,60.0,0.0
40509,4,509,[ 79  64 427 588 318],716,5,2344,4.596078431372549,60.0,0.0
40510,4,510,[ 79  64 427 588 318],577,5,2349,4.596868884540117,60.0,0.0
40511,4,511,[282 302 185 215   4],535,2,2351,4.591796875,0.0,0.0
40512,4,512,[ 79  64 427 588 318],796,5,2356,4.592592592592593,60.0,0.0
40513,4,513,[ 79  64 427 588 318],577,5,2361,4.593385214007782,60.0,0.0
40514,4,514,[ 50  88 275 496 568],796,5,2366,4.594174757281554,20.0,40.0
40515,4,515,[ 79  64 427 588 318],577,5,2371,4.594961240310077,60.0,0.0
40516,4,516,[ 79  64 427 588 318],796,5,2376,4.595744680851064,60.0,0.0
40517,4,517,[ 79  64 427 588 318],18,5,2381,4.596525096525096,60.0,0.0
40518,4,518,[ 79  64 427 588 318],716,5,2386,4.597302504816955,60.0,0.0
40519,4,519,[ 79  64 427 588 318],18,5,2391,4.598076923076923,60.0,0.0
40520,4,520,[ 79  64 427 588 318],577,5,2396,4.598848368522073,60.0,0.0
40521,4,521,[ 79  64 427 588 318],716,5,2401,4.599616858237548,60.0,0.0
40522,4,522,[ 79  64 427 588 318],796,5,2406,4.60038240917782,60.0,0.0
40523,4,523,[ 79  64 427 588 318],450,5,2411,4.601145038167939,60.0,0.0
40524,4,524,[ 79  64 427 588 318],716,5,2416,4.601904761904762,60.0,0.0
40525,4,525,[265 568 294 269 496],796,3,2419,4.598859315589354,20.0,0.0
40526,4,526,[ 79  64 427 588 318],18,5,2424,4.599620493358634,60.0,0.0
40527,4,527,[ 79  64 427 588 318],577,5,2429,4.600378787878788,60.0,0.0
40528,4,528,[ 79  64 427 588 318],716,5,2434,4.601134215500945,60.0,0.0
40529,4,529,[ 79  64 427 588 318],577,5,2439,4.60188679245283,60.0,0.0
40530,4,530,[ 79  64 427 588 318],18,5,2444,4.602636534839925,60.0,0.0
40531,4,531,[ 79  64 427 588 318],577,5,2449,4.603383458646617,60.0,0.0
40532,4,532,[ 79  64 427 588 318],450,5,2454,4.6041275797373356,60.0,0.0
40533,4,533,[ 79  64 427 588 318],796,5,2459,4.604868913857678,60.0,0.0
40534,4,534,[ 79  64 427 588 318],796,5,2464,4.605607476635514,60.0,0.0
40535,4,535,[282 174 269 228  22],796,4,2468,4.604477611940299,0.0,0.0
40536,4,536,[423  82 118 151 215],716,4,2472,4.603351955307263,0.0,0.0
40537,4,537,[185 357  25  11 143],401,4,2476,4.602230483271375,0.0,0.0
40538,4,538,[ 79  64 427 588 318],450,5,2481,4.602968460111318,60.0,0.0
40539,4,539,[ 79  64 427 588 318],450,5,2486,4.603703703703704,60.0,0.0
40540,4,540,[ 79  64 427 588 318],450,5,2491,4.6044362292051755,60.0,0.0
40541,4,541,[ 79  64 427 588 318],577,5,2496,4.605166051660516,60.0,0.0
40542,4,542,[ 79  64 427 588 318],18,5,2501,4.605893186003684,60.0,0.0
40543,4,543,[ 79  64 427 588 318],796,5,2506,4.606617647058823,60.0,0.0
40544,4,544,[ 79  64 427 588 318],450,5,2511,4.607339449541285,60.0,0.0
40545,4,545,[204   1 132 210  64],330,5,2516,4.608058608058608,20.0,0.0
40546,4,546,[ 79  64 427 588 318],450,5,2521,4.608775137111517,60.0,0.0
40547,4,547,[ 79  64 427 588 318],450,5,2526,4.609489051094891,60.0,0.0
40548,4,548,[ 79  64 427 588 318],716,5,2531,4.610200364298725,60.0,0.0
40549,4,549,[ 79  64 427 588 318],577,5,2536,4.610909090909091,60.0,0.0
40550,4,550,[ 79  64 427 588 318],450,5,2541,4.611615245009075,60.0,0.0
40551,4,551,[ 79  64 427 588 318],18,5,2546,4.61231884057971,60.0,0.0
40552,4,552,[ 79  64 427 588 318],796,5,2551,4.613019891500904,60.0,0.0
40553,4,553,[318 181 228 328 546],796,5,2556,4.613718411552346,20.0,0.0
40554,4,554,[ 79  64 427 588 318],716,5,2561,4.614414414414415,60.0,0.0
40555,4,555,[ 79  64 427 588 318],577,5,2566,4.615107913669065,60.0,0.0
40556,4,556,[403 187 211 508 265],655,1,2567,4.608617594254937,0.0,0.0
40557,4,557,[ 79  64 427 588 318],577,5,2572,4.60931899641577,60.0,0.0
40558,4,558,[ 82 423 144  28 186],457,5,2577,4.610017889087657,0.0,0.0
40559,4,559,[238  25  50 132 275],18,4,2581,4.608928571428572,0.0,40.0
40560,4,560,[153 265 496 197   4],280,3,2584,4.606060606060606,20.0,0.0
40561,4,561,[ 79  64 427 588 318],450,5,2589,4.606761565836299,60.0,0.0
40562,4,562,[ 79  64 427 588 318],716,5,2594,4.607460035523979,60.0,0.0
40563,4,563,[ 79  64 427 588 318],577,5,2599,4.608156028368795,60.0,0.0
40564,4,564,[ 79  64 427 588 318],450,5,2604,4.608849557522124,60.0,0.0
40565,4,565,[ 79  64 427 588 318],796,5,2609,4.609540636042403,60.0,0.0
40566,4,566,[ 79  64 427 588 318],796,5,2614,4.610229276895944,60.0,0.0
40567,4,567,[ 79  64 427 588 318],796,5,2619,4.610915492957746,60.0,0.0
40568,4,568,[ 79  64 427 588 318],18,5,2624,4.611599297012302,60.0,0.0
40569,4,569,[ 79  64 427 588 318],796,5,2629,4.612280701754386,60.0,0.0
40570,4,570,[ 79  64 427 588 318],796,5,2634,4.612959719789842,60.0,0.0
40571,4,571,[ 79  64 427 588 318],450,5,2639,4.613636363636363,60.0,0.0
40572,4,572,[ 79  64 427 588 318],577,5,2644,4.614310645724259,60.0,0.0
40573,4,573,[ 79  64 427 588 318],18,5,2649,4.614982578397212,60.0,0.0
40574,4,574,[143  89  98 427 257],23,3,2652,4.6121739130434785,20.0,0.0
40575,4,575,[ 79  64 427 588 318],18,5,2657,4.612847222222222,60.0,0.0
40576,4,576,[ 79  64 427 588 318],18,5,2662,4.613518197573657,60.0,0.0
40577,4,577,[ 79  64 427 588 318],796,5,2667,4.614186851211072,60.0,0.0
40578,4,578,[ 79  64 427 588 318],796,5,2672,4.614853195164076,60.0,0.0
40579,4,579,[ 79  64 427 588 318],716,5,2677,4.61551724137931,60.0,0.0
40580,4,580,[ 79  64 427 588 318],716,5,2682,4.616179001721171,60.0,0.0
40581,4,581,[ 79  64 427 588 318],716,5,2687,4.616838487972508,60.0,0.0
40582,4,582,[ 79  64 427 588 318],716,5,2692,4.617495711835335,60.0,0.0
40583,4,583,[ 79  64 427 588 318],450,5,2697,4.618150684931507,60.0,0.0
40584,4,584,[ 79  64 427 588 318],450,5,2702,4.618803418803418,60.0,0.0
40585,4,585,[ 79  64 427 588 318],18,5,2707,4.6194539249146755,60.0,0.0
40586,4,586,[ 79  64 427 588 318],450,5,2712,4.620102214650767,60.0,0.0
40587,4,587,[ 79  64 427 588 318],450,5,2717,4.620748299319728,60.0,0.0
40588,4,588,[ 79  64 427 588 318],450,5,2722,4.621392190152801,60.0,0.0
40589,4,589,[ 79  64 427 588 318],796,5,2727,4.622033898305085,60.0,0.0
40590,4,590,[ 79  64 427 588 318],450,5,2732,4.622673434856176,60.0,0.0
40591,4,591,[ 79  64 427 588 318],450,5,2737,4.6233108108108105,60.0,0.0
40592,4,592,[403  96 655 258   9],655,0,2737,4.6155143338954465,0.0,0.0
40593,4,593,[ 79  64 427 588 318],796,5,2742,4.616161616161616,60.0,0.0
40594,4,594,[100 275 301  71 568],796,3,2745,4.61344537815126,0.0,40.0
40595,4,595,[ 79  64 427 588 318],577,5,2750,4.614093959731544,60.0,0.0
40596,4,596,[475  70 191 181   4],655,1,2751,4.608040201005025,0.0,0.0
40597,4,597,[ 79  64 427 588 318],716,5,2756,4.608695652173913,60.0,0.0
40598,4,598,[ 79  64 427 588 318],18,5,2761,4.609348914858097,60.0,0.0
40599,4,599,[ 79  64 427 588 318],577,5,2766,4.61,60.0,0.0
40600,4,600,[ 79  64 427 588 318],716,5,2771,4.610648918469218,60.0,0.0
40601,4,601,[ 50  96 200   8 132],655,2,2773,4.606312292358804,0.0,20.0
40602,4,602,[427  79  64 588 318],577,5,2778,4.606965174129353,60.0,0.0
40603,4,603,[427  79  64 588 318],796,5,2783,4.607615894039735,60.0,0.0
40604,4,604,[427  79  64 588 318],796,5,2788,4.608264462809918,60.0,0.0
40605,4,605,[427  79  64 588 318],796,5,2793,4.608910891089109,60.0,0.0
40606,4,606,[427  79  64 588 318],18,5,2798,4.6095551894563425,60.0,0.0
40607,4,607,[301 228 273 258 187],796,3,2801,4.6069078947368425,0.0,0.0
40608,4,608,[427  64  79 588 318],577,5,2806,4.607553366174056,60.0,0.0
40609,4,609,[427  64  79 588 318],577,5,2811,4.608196721311476,60.0,0.0
40610,4,610,[427  64  79 588 318],796,5,2816,4.608837970540098,60.0,0.0
40611,4,611,[427  64  79 588 318],18,5,2821,4.609477124183006,60.0,0.0
40612,4,612,[127  11 121 385 143],457,5,2826,4.610114192495922,0.0,20.0
40613,4,613,[427  64  79 588 318],577,5,2831,4.6107491856677525,60.0,0.0
40614,4,614,[427  64  79 588 318],577,5,2836,4.611382113821138,60.0,0.0
40615,4,615,[427  64  79 588 318],450,5,2841,4.612012987012987,60.0,0.0
40616,4,616,[194 135  82 475  11],269,3,2844,4.609400324149108,0.0,0.0
40617,4,617,[ 79 427  64 588 318],796,5,2849,4.610032362459547,60.0,0.0
40618,4,618,[  9 153 234  12 301],151,4,2853,4.609046849757673,0.0,0.0
40619,4,619,[ 79 427  64 588 318],18,5,2858,4.609677419354838,60.0,0.0
40620,4,620,[210  70 173 161 265],457,5,2863,4.610305958132045,0.0,0.0
40621,4,621,[168 161  28  15 258],450,4,2867,4.609324758842444,0.0,0.0
40622,4,622,[ 79 427  64 588 318],796,5,2872,4.609951845906902,60.0,0.0
40623,4,623,[ 79 427  64 588 318],796,5,2877,4.610576923076923,60.0,0.0
40624,4,624,[ 79 427  64 588 318],716,5,2882,4.6112,60.0,0.0
40625,4,625,[471 125 678  12  98],256,5,2887,4.611821086261981,0.0,0.0
40626,4,626,[ 79 427  64 588 318],796,5,2892,4.6124401913875595,60.0,0.0
40627,4,627,[ 79 427  64 588 318],18,5,2897,4.6130573248407645,60.0,0.0
40628,4,628,[ 79 427  64 588 318],716,5,2902,4.613672496025437,60.0,0.0
40629,4,629,[286 200  15 655 176],450,3,2905,4.611111111111111,0.0,20.0
40630,4,630,[427  79  64 588 318],577,5,2910,4.6117274167987325,60.0,0.0
40631,4,631,[403 357  12   4 144],796,5,2915,4.612341772151899,0.0,0.0
40632,4,632,[427  79  64 588 318],796,5,2920,4.612954186413902,60.0,0.0
40633,4,633,[427  79  64 588 318],18,5,2925,4.613564668769716,60.0,0.0
40634,4,634,[427  79  64 588 318],796,5,2930,4.6141732283464565,60.0,0.0
40635,4,635,[427  79  64 588 318],716,5,2935,4.614779874213837,60.0,0.0
40636,4,636,[427  79  64 588 318],796,5,2940,4.615384615384615,60.0,0.0
40637,4,637,[427  79  64 588 318],577,5,2945,4.615987460815047,60.0,0.0
40638,4,638,[427  79  64 588 318],18,5,2950,4.61658841940532,60.0,0.0
40639,4,639,[427  79  64 588 318],796,5,2955,4.6171875,60.0,0.0
40640,4,640,[427  79  64 588 318],18,5,2960,4.617784711388455,60.0,0.0
40641,4,641,[427  79  64 588 318],796,5,2965,4.618380062305296,60.0,0.0
40642,4,642,[405 748  71  50 515],807,5,2970,4.618973561430793,0.0,20.0
40643,4,643,[222 322 271 228 273],796,3,2973,4.616459627329193,0.0,0.0
40644,4,644,[117 144 197 271 288],629,5,2978,4.617054263565891,0.0,0.0
40645,4,645,[427  79 515  64 588],716,5,2983,4.617647058823529,40.0,0.0
40646,4,646,[427  79 515  64 588],716,5,2988,4.618238021638331,40.0,0.0
40647,4,647,[427  79 515  64 588],716,5,2993,4.618827160493828,40.0,0.0
40648,4,648,[  9 100  56 333 427],796,3,2996,4.6163328197226505,20.0,20.0
40649,4,649,[427  79 515  64 588],716,5,3001,4.616923076923077,40.0,0.0
40650,4,650,[427  79 515  64 588],18,5,3006,4.617511520737327,40.0,0.0
40651,4,651,[515  28 678 235 135],807,3,3009,4.615030674846626,0.0,0.0
40652,4,652,[427  79 515  64 588],716,5,3014,4.6156202143951,40.0,0.0
40653,4,653,[427  79 515  64 588],716,5,3019,4.616207951070336,40.0,0.0
40654,4,654,[427  79 515  64 588],716,5,3024,4.616793893129771,40.0,0.0
40655,4,655,[181 176 211 153  82],269,1,3025,4.611280487804878,0.0,0.0
40656,4,656,[211 313  50 204 173],593,5,3030,4.6118721461187215,0.0,20.0
40657,4,657,[427  79 515  64 588],716,5,3035,4.612462006079028,40.0,0.0
40658,4,658,[427  79 515  64 588],716,5,3040,4.613050075872534,40.0,0.0
40659,4,659,[427  79 515  64 588],716,5,3045,4.613636363636363,40.0,0.0
40660,4,660,[ 82 238 546 588 185],716,4,3049,4.612708018154311,0.0,0.0
40661,4,661,[427  79 515  64 588],18,5,3054,4.613293051359516,40.0,0.0
40662,4,662,[603  89 185  50 235],269,2,3056,4.609351432880844,20.0,20.0
40663,4,663,[185  96 125 174 483],655,2,3058,4.605421686746988,0.0,0.0
40664,4,664,[427  64 515  79 588],18,5,3063,4.606015037593985,40.0,0.0
40665,4,665,[ 95 322 215 496  28],796,3,3066,4.603603603603603,20.0,0.0
40666,4,666,[121 471 176 153 288],450,3,3069,4.60119940029985,0.0,0.0
40667,4,667,[427  64 515  79 588],716,5,3074,4.6017964071856285,40.0,0.0
40668,4,668,[ 12 515  11   8 183],655,2,3076,4.597907324364724,0.0,0.0
40669,4,669,[427  64 515  79 588],18,5,3081,4.598507462686567,40.0,0.0
40670,4,670,[427  64 515  79 588],716,5,3086,4.599105812220566,40.0,0.0
40671,4,671,[ 56 216 403 196 210],796,4,3090,4.598214285714286,0.0,0.0
40672,4,672,[427  64 515  79 588],18,5,3095,4.5988112927191676,40.0,0.0
40673,4,673,[427  64 515  79 588],18,5,3100,4.599406528189911,40.0,0.0
40674,4,674,[211 300 111   4 121],151,5,3105,4.6,0.0,0.0
40675,4,675,[427  64 515  79 588],716,5,3110,4.600591715976331,40.0,0.0
40676,4,676,[427  64 515  79 588],18,5,3115,4.601181683899557,40.0,0.0
40677,4,677,[228 176 222 568 179],655,1,3116,4.595870206489676,0.0,0.0
40678,4,678,[427 515  79  64 588],18,5,3121,4.596465390279823,40.0,0.0
40679,4,679,[427 515  79  64 588],18,5,3126,4.597058823529411,40.0,0.0
40680,4,680,[322 202 186  89 427],151,4,3130,4.596182085168869,20.0,0.0
40681,4,681,[151 568   4 196  25],344,5,3135,4.596774193548387,0.0,0.0
40682,4,682,[655 179   9  22 288],457,5,3140,4.597364568081991,0.0,0.0
40683,4,683,[187 597  25 168 742],450,4,3144,4.5964912280701755,0.0,0.0
40684,4,684,[427  64  79 515 588],18,5,3149,4.597080291970803,40.0,0.0
40685,4,685,[427  64  79 515 588],716,5,3154,4.597667638483965,40.0,0.0
40686,4,686,[427  64  79 515 588],716,5,3159,4.598253275109171,40.0,0.0
40687,4,687,[427  64  79 515 588],18,5,3164,4.598837209302325,40.0,0.0
40688,4,688,[427  64  79 515 588],18,5,3169,4.599419448476052,40.0,0.0
40689,4,689,[427  64  79 515 588],18,5,3174,4.6,40.0,0.0
40690,4,690,[181 202 121 322 196],151,4,3178,4.599131693198263,0.0,0.0
40691,4,691,[427  64  79 515 588],716,5,3183,4.5997109826589595,40.0,0.0
40692,4,692,[427  64  79 515 588],18,5,3188,4.6002886002886,40.0,0.0
40693,4,693,[427  64  79 515 588],18,5,3193,4.600864553314121,40.0,0.0
40694,4,694,[427  64  79 515 588],716,5,3198,4.601438848920863,40.0,0.0
40695,4,695,[427  64  79 515 588],716,5,3203,4.602011494252873,40.0,0.0
40696,4,696,[ 88 127 204 182 222],655,2,3205,4.598278335724534,0.0,20.0
40697,4,697,[427  79 182 515  64],72,5,3210,4.598853868194842,40.0,0.0
40698,4,698,[427  79 182 515  64],655,5,3215,4.599427753934192,40.0,0.0
40699,4,699,[427  79 182 515  64],72,5,3220,4.6,40.0,0.0
40700,4,700,[427  79 182 515  64],655,5,3225,4.600570613409415,40.0,0.0
40701,4,701,[508 111 127 197 603],269,4,3229,4.5997150997151,20.0,20.0
40702,4,702,[182 515  79  64 427],72,5,3234,4.600284495021337,40.0,0.0
40703,4,703,[318  50 301 282 182],593,4,3238,4.599431818181818,20.0,20.0
40704,4,704,[210   9 204 127 483],796,3,3241,4.597163120567376,0.0,20.0
40705,4,705,[515  64  79 427 588],18,5,3246,4.597733711048159,40.0,0.0
40706,4,706,[515  64  79 427 588],18,5,3251,4.598302687411598,40.0,0.0
40707,4,707,[515  64  79 427 588],716,5,3256,4.598870056497175,40.0,0.0
40708,4,708,[515  64  79 427 588],18,5,3261,4.5994358251057825,40.0,0.0
40709,4,709,[200 100 275 435  56],18,4,3265,4.598591549295775,0.0,40.0
40710,4,710,[515  64  79 427 588],716,5,3270,4.59915611814346,40.0,0.0
40711,4,711,[ 69 132 127 313 294],450,5,3275,4.599719101123595,0.0,20.0
40712,4,712,[515  64 427  79 588],716,5,3280,4.600280504908836,40.0,0.0
40713,4,713,[515  64 427  79 588],18,5,3285,4.600840336134453,40.0,0.0
40714,4,714,[204 132 215 357  97],796,4,3289,4.6,0.0,0.0
40715,4,715,[515  64 427  79 588],716,5,3294,4.600558659217877,40.0,0.0
40716,4,716,[515  64 427  79 588],716,5,3299,4.601115760111576,40.0,0.0
40717,4,717,[515 185 237 234 179],18,2,3301,4.5974930362116995,0.0,0.0
40718,4,718,[275 678 435 135 100],401,3,3304,4.595271210013908,0.0,40.0
40719,4,719,[655 195  50 245 222],450,4,3308,4.594444444444444,0.0,20.0
40720,4,720,[234 125 275 216 258],151,5,3313,4.59500693481276,0.0,20.0
40721,4,721,[427 515  64  79 588],18,5,3318,4.595567867036011,40.0,0.0
40722,4,722,[427 515  64  79 588],716,5,3323,4.596127247579529,40.0,0.0
40723,4,723,[302 125 172 471  15],450,4,3327,4.595303867403315,0.0,0.0
40724,4,724,[ 79 515  64 427 588],18,5,3332,4.595862068965517,40.0,0.0
40725,4,725,[ 79 515  64 427 588],18,5,3337,4.596418732782369,40.0,0.0
40726,4,726,[ 79 515  64 427 588],716,5,3342,4.59697386519945,40.0,0.0
40727,4,727,[ 22 173 300 245 568],796,4,3346,4.596153846153846,0.0,0.0
40728,4,728,[ 79 515  64 427 588],18,5,3351,4.596707818930041,40.0,0.0
40729,4,729,[ 79 515  64 427 588],18,5,3356,4.597260273972603,40.0,0.0
40730,4,730,[ 79 515  64 427 588],716,5,3361,4.59781121751026,40.0,0.0
40731,4,731,[ 56 288 405 182 282],655,1,3362,4.592896174863388,0.0,0.0
40732,4,732,[313 275  79 100 282],593,4,3366,4.592087312414734,0.0,40.0
40733,4,733,[237  22  97  64 313],450,5,3371,4.592643051771117,20.0,0.0
40734,4,734,[515  79  64 427 588],18,5,3376,4.593197278911565,40.0,0.0
40735,4,735,[515  79  64 427 588],716,5,3381,4.59375,40.0,0.0
40736,4,736,[515  79  64 427 588],716,5,3386,4.5943012211668925,40.0,0.0
40737,4,737,[515  79  64 427 588],716,5,3391,4.594850948509485,40.0,0.0
40738,4,738,[269  96 196 228   8],796,4,3395,4.59404600811908,0.0,0.0
40739,4,739,[515  79  64 427 588],716,5,3400,4.594594594594595,40.0,0.0
40740,4,740,[515  79  64 427 588],18,5,3405,4.5951417004048585,40.0,0.0
40741,4,741,[515  79  64 427 588],716,5,3410,4.595687331536388,40.0,0.0
40742,4,742,[515  79  64 427 588],716,5,3415,4.596231493943472,40.0,0.0
40743,4,743,[515  79  64 427 588],716,5,3420,4.596774193548387,40.0,0.0
40744,4,744,[210  88 568   7 180],280,2,3422,4.593288590604027,0.0,0.0
40745,4,745,[202 200 282 118 313],280,1,3423,4.588471849865952,0.0,0.0
40746,4,746,[427 515  79  64 588],716,5,3428,4.589022757697457,40.0,0.0
40747,4,747,[427 515  79  64 588],716,5,3433,4.589572192513369,40.0,0.0
40748,4,748,[118 111 257 200  89],655,2,3435,4.58611481975968,0.0,0.0
40749,4,749,[427 515  79  64 588],716,5,3440,4.586666666666667,40.0,0.0
40750,4,750,[427 515  79  64 588],716,5,3445,4.587217043941411,40.0,0.0
40751,4,751,[427 515  79  64 588],18,5,3450,4.587765957446808,40.0,0.0
40752,4,752,[427 515  79  64 588],18,5,3455,4.588313413014609,40.0,0.0
40753,4,753,[427 515  79  64 588],18,5,3460,4.588859416445623,40.0,0.0
40754,4,754,[427 515  79  64 588],716,5,3465,4.589403973509934,40.0,0.0
40755,4,755,[427 515  79  64 588],716,5,3470,4.58994708994709,40.0,0.0
40756,4,756,[ 96 288 318  12 258],693,4,3474,4.5891677675033025,20.0,0.0
40757,4,757,[ 79 427  64 515 588],716,5,3479,4.589709762532982,40.0,0.0
40758,4,758,[216 588   4 385  64],457,5,3484,4.590250329380765,20.0,0.0
40759,4,759,[ 79 427  64 515 588],716,5,3489,4.59078947368421,40.0,0.0
40760,4,760,[471 117  97 100 185],256,5,3494,4.591327201051248,0.0,20.0
40761,4,761,[ 79 427  64 515 588],18,5,3499,4.591863517060368,40.0,0.0
40762,4,762,[282 597 153 322 121],450,4,3503,4.591087811271297,0.0,0.0
40763,4,763,[276 282 161 168 258],457,5,3508,4.591623036649215,0.0,0.0
40764,4,764,[ 79 427  64 515 588],716,5,3513,4.592156862745098,40.0,0.0
40765,4,765,[ 79 427  64 515 588],716,5,3518,4.592689295039165,40.0,0.0
40766,4,766,[ 79 427  64 515 588],18,5,3523,4.593220338983051,40.0,0.0
40767,4,767,[ 79 427  64 515 588],716,5,3528,4.59375,40.0,0.0
40768,4,768,[175 100  71  79 276],18,5,3533,4.594278283485045,0.0,20.0
40769,4,769,[ 79 427  64 515 588],716,5,3538,4.594805194805195,40.0,0.0
40770,4,770,[ 79 427  64 515 588],18,5,3543,4.595330739299611,40.0,0.0
40771,4,771,[127  79 204 176 210],236,2,3545,4.591968911917099,0.0,20.0
40772,4,772,[ 79 427  64 515 588],716,5,3550,4.592496765847348,40.0,0.0
40773,4,773,[ 79 427  64 515 588],18,5,3555,4.593023255813954,40.0,0.0
40774,4,774,[ 79 427  64 515 588],716,5,3560,4.593548387096774,40.0,0.0
40775,4,775,[ 79 427  64 515 588],18,5,3565,4.594072164948454,40.0,0.0
40776,4,776,[ 79 427  64 515 588],716,5,3570,4.594594594594595,40.0,0.0
40777,4,777,[ 79 427  64 515 588],18,5,3575,4.595115681233933,40.0,0.0
40778,4,778,[ 79 427  64 515 588],716,5,3580,4.595635430038511,40.0,0.0
40779,4,779,[ 79 427  64 515 588],18,5,3585,4.596153846153846,40.0,0.0
40780,4,780,[ 79 427  64 515 588],716,5,3590,4.5966709346991035,40.0,0.0
40781,4,781,[ 79 427  64 515 588],716,5,3595,4.5971867007672635,40.0,0.0
40782,4,782,[  1  97  64   7 183],344,3,3598,4.59514687100894,20.0,0.0
40783,4,783,[ 79 515  64 427 588],18,5,3603,4.595663265306122,40.0,0.0
40784,4,784,[269  25 496 222 153],450,3,3606,4.593630573248408,20.0,0.0
40785,4,785,[ 79 515  64 427 588],716,5,3611,4.594147582697201,40.0,0.0
40786,4,786,[ 79 515  64 427 588],716,5,3616,4.594663278271919,40.0,0.0
40787,4,787,[210  50 186 182  88],18,4,3620,4.593908629441624,0.0,20.0
40788,4,788,[ 28  64 125 238 100],450,5,3625,4.594423320659062,20.0,20.0
40789,4,789,[ 79 515  64 427 588],18,5,3630,4.594936708860759,40.0,0.0
40790,4,790,[ 79 515  64 427 588],18,5,3635,4.595448798988622,40.0,0.0
40791,4,791,[ 79 515  64 427 588],716,5,3640,4.595959595959596,40.0,0.0
40792,4,792,[  7 568 588 144 216],457,5,3645,4.596469104665826,0.0,0.0
40793,4,793,[ 79 515  64 427 588],716,5,3650,4.596977329974811,40.0,0.0
40794,4,794,[ 79 515  64 427 588],716,5,3655,4.59748427672956,40.0,0.0
40795,4,795,[ 79 515  64 427 588],716,5,3660,4.597989949748744,40.0,0.0
40796,4,796,[ 79 515  64 427 588],18,5,3665,4.598494353826851,40.0,0.0
40797,4,797,[ 79 515  64 427 588],716,5,3670,4.598997493734336,40.0,0.0
40798,4,798,[228   8 423 282 118],655,0,3670,4.593241551939925,0.0,0.0
40799,4,799,[ 79 515  64 427 588],18,5,3675,4.59375,40.0,0.0
40800,4,800,[222 238  88 173 597],796,4,3679,4.593008739076155,0.0,0.0
40801,4,801,[ 79 515  64 427 588],716,5,3684,4.593516209476309,40.0,0.0
40802,4,802,[ 79 515  64 427 588],716,5,3689,4.594022415940224,40.0,0.0
40803,4,803,[ 64 471   4 235  98],716,2,3691,4.590796019900497,20.0,0.0
40804,4,804,[427  79 515  64 588],716,5,3696,4.591304347826087,40.0,0.0
40805,4,805,[427  79 515  64 588],716,5,3701,4.591811414392059,40.0,0.0
40806,4,806,[427  79 515  64 588],18,5,3706,4.592317224287484,40.0,0.0
40807,4,807,[185 182 273  70 289],655,3,3709,4.590346534653466,0.0,0.0
40808,4,808,[196 269  71  98 151],796,4,3713,4.589616810877627,0.0,0.0
40809,4,809,[357  50  12 118   9],457,5,3718,4.590123456790123,0.0,20.0
40810,4,810,[597 187 508 100 268],269,4,3722,4.589395807644883,0.0,20.0
40811,4,811,[427  79 515  64 588],716,5,3727,4.5899014778325125,40.0,0.0
40812,4,812,[191 180 215  69 183],457,5,3732,4.590405904059041,0.0,0.0
40813,4,813,[427  79 515  64 588],716,5,3737,4.590909090909091,40.0,0.0
40814,4,814,[427  79 515  64 588],18,5,3742,4.591411042944785,40.0,0.0
40815,4,815,[  1 174 423 127 515],292,5,3747,4.591911764705882,0.0,20.0
40816,4,816,[427  79 515  64 588],18,5,3752,4.592411260709914,40.0,0.0
40817,4,817,[427  79 515  64 588],18,5,3757,4.592909535452323,40.0,0.0
40818,4,818,[302 405 135  82 568],655,2,3759,4.589743589743589,0.0,0.0
40819,4,819,[655   7 144  95 222],23,3,3762,4.587804878048781,0.0,0.0
40820,4,820,[ 96 748 127 174  98],280,3,3765,4.585870889159562,0.0,20.0
40821,4,821,[195  79 172  12 318],280,3,3768,4.583941605839416,20.0,0.0
40822,4,822,[228 197 215 275 195],151,3,3771,4.582017010935601,0.0,20.0
40823,4,823,[568 127 276 194 204],269,3,3774,4.580097087378641,0.0,20.0
40824,4,824,[427 515  79  64 588],18,5,3779,4.580606060606061,40.0,0.0
40825,4,825,[210 357  25 237  71],401,3,3782,4.578692493946731,0.0,0.0
40826,4,826,[515 427  64  79 588],18,5,3787,4.5792019347037485,40.0,0.0
40827,4,827,[385 210 187 111 257],716,3,3790,4.5772946859903385,0.0,0.0
40828,4,828,[ 95 202 111 215 181],280,2,3792,4.574185765983112,0.0,0.0
40829,4,829,[515 427  64  79 588],716,5,3797,4.574698795180723,40.0,0.0
40830,4,830,[322 385 403 180 568],796,3,3800,4.57280385078219,0.0,0.0
40831,4,831,[515 427  64  79 588],18,5,3805,4.5733173076923075,40.0,0.0
40832,4,832,[176 300  96 161 144],796,5,3810,4.573829531812725,0.0,0.0
40833,4,833,[168  97 125 222  79],796,4,3814,4.5731414868105515,0.0,0.0
40834,4,834,[515 427  64  79 588],18,5,3819,4.573652694610779,40.0,0.0
40835,4,835,[515 427  64  79 588],18,5,3824,4.574162679425838,40.0,0.0
40836,4,836,[515 427  64  79 588],716,5,3829,4.574671445639187,40.0,0.0
40837,4,837,[185 200 153 333 423],655,2,3831,4.571599045346062,0.0,0.0
40838,4,838,[183 655 200 174 322],796,3,3834,4.569725864123957,0.0,0.0
40839,4,839,[515 427  64  79 588],18,5,3839,4.570238095238095,40.0,0.0
40840,4,840,[515 427  64  79 588],18,5,3844,4.570749108204518,40.0,0.0
40841,4,841,[216 181 211 210 176],236,2,3846,4.567695961995249,0.0,0.0
40842,4,842,[515 427  64  79 588],716,5,3851,4.568208778173191,40.0,0.0
40843,4,843,[173 186  71 168 204],450,3,3854,4.5663507109004735,0.0,0.0
40844,4,844,[427  64 515  79 588],716,5,3859,4.566863905325444,40.0,0.0
40845,4,845,[427  64 515  79 588],18,5,3864,4.567375886524823,40.0,0.0
40846,4,846,[427  64 515  79 588],18,5,3869,4.56788665879575,40.0,0.0
40847,4,847,[427  64 515  79 588],716,5,3874,4.568396226415095,40.0,0.0
40848,4,848,[546 228 100 496  95],577,3,3877,4.566548881036513,20.0,20.0
40849,4,849,[568 328 322 282 273],796,3,3880,4.564705882352941,0.0,0.0
40850,4,850,[181 234 153 403  15],655,0,3880,4.559341950646298,0.0,0.0
40851,4,851,[282 194  25 471  22],535,3,3883,4.557511737089202,0.0,0.0
40852,4,852,[ 89  28 268 127  82],655,2,3885,4.554513481828839,0.0,20.0
40853,4,853,[ 79 427  64 515 588],716,5,3890,4.555035128805621,40.0,0.0
40854,4,854,[ 79 427  64 515 588],716,5,3895,4.555555555555555,40.0,0.0
40855,4,855,[ 79 427  64 515 588],716,5,3900,4.55607476635514,40.0,0.0
40856,4,856,[ 79 427  64 515 588],18,5,3905,4.55659276546091,40.0,0.0
40857,4,857,[173 357 318 204  70],11,4,3909,4.555944055944056,20.0,0.0
40858,4,858,[ 96 237 204  97 211],716,4,3913,4.555296856810244,0.0,0.0
40859,4,859,[ 79 427  64 515 588],18,5,3918,4.555813953488372,40.0,0.0
40860,4,860,[ 79 427  64 515 588],716,5,3923,4.5563298490127755,40.0,0.0
40861,4,861,[ 79 427  64 515 588],18,5,3928,4.556844547563805,40.0,0.0
40862,4,862,[ 79 427  64 515 588],18,5,3933,4.557358053302433,40.0,0.0
40863,4,863,[ 96 181  70  25 173],457,5,3938,4.55787037037037,0.0,0.0
40864,4,864,[195 403 294  88 185],655,1,3939,4.553757225433526,0.0,0.0
40865,4,865,[ 79 427  64 515 588],716,5,3944,4.554272517321016,40.0,0.0
40866,4,866,[ 79 427  64 515 588],18,5,3949,4.554786620530566,40.0,0.0
40867,4,867,[245   1 197 333 568],796,2,3951,4.5518433179723505,0.0,0.0
40868,4,868,[179 181 216 385  25],655,2,3953,4.5489067894131185,0.0,0.0
40869,4,869,[427  79 515  64 588],18,5,3958,4.549425287356322,40.0,0.0
40870,4,870,[427  79 515  64 588],18,5,3963,4.549942594718714,40.0,0.0
40871,4,871,[427  79 515  64 588],716,5,3968,4.5504587155963305,40.0,0.0
40872,4,872,[427  79 515  64 588],18,5,3973,4.550973654066437,40.0,0.0
40873,4,873,[427  79 515  64 588],716,5,3978,4.551487414187643,40.0,0.0
40874,4,874,[427  79 515  64 588],18,5,3983,4.552,40.0,0.0
40875,4,875,[ 25  69 275   1 144],457,5,3988,4.552511415525114,0.0,20.0
40876,4,876,[135 121 435 234 127],807,2,3990,4.549600912200684,0.0,20.0
40877,4,877,[182 143 483 111 357],655,4,3994,4.548974943052392,0.0,0.0
40878,4,878,[ 79 427  64 515 588],18,5,3999,4.549488054607509,40.0,0.0
40879,4,879,[202 174 288   9 100],655,0,3999,4.5443181818181815,0.0,20.0
40880,4,880,[ 79 427  64 515 588],18,5,4004,4.54483541430193,40.0,0.0
40881,4,881,[ 79 427  64 515 588],716,5,4009,4.545351473922903,40.0,0.0
40882,4,882,[ 97 204 153 127 176],503,3,4012,4.5436013590033975,0.0,20.0
40883,4,883,[ 79 427  64 515 588],18,5,4017,4.544117647058823,40.0,0.0
40884,4,884,[ 79 427  64 515 588],716,5,4022,4.544632768361582,40.0,0.0
40885,4,885,[ 79 427  64 515 588],18,5,4027,4.545146726862303,40.0,0.0
40886,4,886,[ 97 100 127 210 202],786,5,4032,4.545659526493799,0.0,40.0
40887,4,887,[ 79 427  64 515 588],716,5,4037,4.546171171171171,40.0,0.0
40888,4,888,[176 117 185 496 275],716,4,4041,4.545556805399325,20.0,20.0
40889,4,889,[ 79 427  64 515 588],716,5,4046,4.546067415730337,40.0,0.0
40890,4,890,[ 79 427  64 515 588],18,5,4051,4.546576879910213,40.0,0.0
40891,4,891,[ 79 427  64 515 588],18,5,4056,4.547085201793722,40.0,0.0
40892,4,892,[ 79 427  64 515 588],716,5,4061,4.547592385218365,40.0,0.0
40893,4,893,[ 79 427  64 515 588],18,5,4066,4.5480984340044746,40.0,0.0
40894,4,894,[ 79 427  64 515 588],18,5,4071,4.5486033519553075,40.0,0.0
40895,4,895,[357 313 234 179 216],593,4,4075,4.547991071428571,0.0,0.0
40896,4,896,[427  79  64 515 588],18,5,4080,4.548494983277592,40.0,0.0
40897,4,897,[427  79  64 515 588],716,5,4085,4.548997772828508,40.0,0.0
40898,4,898,[172 333 405 238  71],796,4,4089,4.548387096774194,0.0,0.0
40899,4,899,[ 88  15 153 405 588],796,5,4094,4.5488888888888885,0.0,0.0
40900,4,900,[427  79  64 515 588],18,5,4099,4.549389567147614,40.0,0.0
40901,4,901,[427  79  64 515 588],716,5,4104,4.549889135254989,40.0,0.0
40902,4,902,[427  79  64 515 588],716,5,4109,4.550387596899225,40.0,0.0
40903,4,903,[269  28 200 268 144],655,1,4110,4.54646017699115,0.0,0.0
40904,4,904,[ 64 427 515  79 588],716,5,4115,4.54696132596685,40.0,0.0
40905,4,905,[174  15 228 187 603],655,2,4117,4.544150110375276,20.0,0.0
40906,4,906,[ 64 357  12 238 121],655,2,4119,4.541345093715546,20.0,0.0
40907,4,907,[ 64 427 515  79 588],18,5,4124,4.541850220264317,40.0,0.0
40908,4,908,[ 64 427 515  79 588],716,5,4129,4.542354235423542,40.0,0.0
40909,4,909,[ 64 427 515  79 588],716,5,4134,4.542857142857143,40.0,0.0
40910,4,910,[405  70 204  28  71],450,4,4138,4.542261251372119,0.0,0.0
40911,4,911,[ 98 132 143 588  96],450,5,4143,4.542763157894737,0.0,0.0
40912,4,912,[ 64 427 515  79 588],716,5,4148,4.543263964950712,40.0,0.0
40913,4,913,[655 403  89  98 300],655,2,4150,4.540481400437637,0.0,0.0
40914,4,914,[ 64 427 515  79 588],716,5,4155,4.540983606557377,40.0,0.0
40915,4,915,[ 64 427 515  79 588],716,5,4160,4.541484716157205,40.0,0.0
40916,4,916,[ 64 427 515  79 588],18,5,4165,4.541984732824427,40.0,0.0
40917,4,917,[  7 265 655 210 117],786,5,4170,4.542483660130719,0.0,0.0
40918,4,918,[ 64 427 515  79 588],716,5,4175,4.542981501632209,40.0,0.0
40919,4,919,[ 64 427 515  79 588],18,5,4180,4.543478260869565,40.0,0.0
40920,4,920,[ 64 427 515  79 588],716,5,4185,4.543973941368078,40.0,0.0
40921,4,921,[ 64 427 515  79 588],716,5,4190,4.544468546637744,40.0,0.0
40922,4,922,[ 64 427 515  79 588],716,5,4195,4.544962080173348,40.0,0.0
40923,4,923,[237 176 204 216 385],503,3,4198,4.543290043290043,0.0,0.0
40924,4,924,[515  79 427  64 588],18,5,4203,4.543783783783784,40.0,0.0
40925,4,925,[515  79 427  64 588],18,5,4208,4.544276457883369,40.0,0.0
40926,4,926,[515  79 427  64 588],18,5,4213,4.544768069039914,40.0,0.0
40927,4,927,[515  79 427  64 588],18,5,4218,4.545258620689655,40.0,0.0
40928,4,928,[515  79 427  64 588],18,5,4223,4.545748116254036,40.0,0.0
40929,4,929,[515  79 427  64 588],18,5,4228,4.546236559139785,40.0,0.0
40930,4,930,[515  79 427  64 588],18,5,4233,4.54672395273899,40.0,0.0
40931,4,931,[515  79 427  64 588],716,5,4238,4.547210300429184,40.0,0.0
40932,4,932,[111 269 275 258 181],655,1,4239,4.543408360128617,0.0,20.0
40933,4,933,[288 183 194 172 216],457,5,4244,4.54389721627409,0.0,0.0
40934,4,934,[187  96  70 180 471],450,5,4249,4.5443850267379675,0.0,0.0
40935,4,935,[ 64  79 515 427 588],716,5,4254,4.544871794871795,40.0,0.0
40936,4,936,[ 64  79 515 427 588],18,5,4259,4.545357524012807,40.0,0.0
40937,4,937,[ 64  79 515 427 588],18,5,4264,4.545842217484009,40.0,0.0
40938,4,938,[ 88 313 174 655 275],236,1,4265,4.542066027689031,0.0,20.0
40939,4,939,[427 515  79  64 588],18,5,4270,4.542553191489362,40.0,0.0
40940,4,940,[405  56 288 151 181],256,4,4274,4.541976620616365,0.0,0.0
40941,4,941,[ 79  64 427 515 588],18,5,4279,4.542462845010616,40.0,0.0
40942,4,942,[182 127  88 195 111],18,2,4281,4.5397667020148464,0.0,20.0
40943,4,943,[515  64  79 427 588],18,5,4286,4.540254237288136,40.0,0.0
40944,4,944,[ 88 183  98 385 118],280,2,4288,4.537566137566137,0.0,0.0
40945,4,945,[202 117 111  69  56],577,4,4292,4.5369978858350954,0.0,0.0
40946,4,946,[515  64  79 427 588],18,5,4297,4.5374868004223865,40.0,0.0
40947,4,947,[515  64  79 427 588],18,5,4302,4.537974683544304,40.0,0.0
40948,4,948,[515  64  79 427 588],18,5,4307,4.538461538461538,40.0,0.0
40949,4,949,[515  64  79 427 588],716,5,4312,4.538947368421053,40.0,0.0
40950,4,950,[515  64  79 427 588],18,5,4317,4.539432176656152,40.0,0.0
40951,4,951,[182 234 196 125  98],593,3,4320,4.53781512605042,0.0,0.0
40952,4,952,[655 405 143  98 301],593,3,4323,4.536201469045121,0.0,0.0
40953,4,953,[403 191  15  88  56],796,5,4328,4.536687631027253,0.0,0.0
40954,4,954,[161 258  11 568 286],450,5,4333,4.53717277486911,0.0,20.0
40955,4,955,[515  64  79 427 588],18,5,4338,4.53765690376569,40.0,0.0
40956,4,956,[515  64  79 427 588],18,5,4343,4.538140020898641,40.0,0.0
40957,4,957,[515  64  79 427 588],18,5,4348,4.538622129436326,40.0,0.0
40958,4,958,[173 143 286 403  79],796,4,4352,4.538060479666319,0.0,20.0
40959,4,959,[202 385  56 176 323],796,4,4356,4.5375,0.0,0.0
40960,4,960,[515  64  79 427 588],716,5,4361,4.537981269510926,40.0,0.0
40961,4,961,[568 187 194  71  64],450,4,4365,4.537422037422037,20.0,0.0
40962,4,962,[515  64  79 427 588],716,5,4370,4.5379023883696785,40.0,0.0
40963,4,963,[197 269  82  96 271],796,2,4372,4.535269709543568,0.0,0.0
40964,4,964,[748   9 210 151 269],796,2,4374,4.532642487046632,0.0,0.0
40965,4,965,[515  64  79 427 588],18,5,4379,4.533126293995859,40.0,0.0
40966,4,966,[742 176  50 118 333],796,4,4383,4.532574974146846,0.0,20.0
40967,4,967,[515  64  79 427 588],716,5,4388,4.533057851239669,40.0,0.0
40968,4,968,[187 288 257 301  98],655,2,4390,4.530443756449948,0.0,0.0
40969,4,969,[515  64  79 427 588],18,5,4395,4.530927835051546,40.0,0.0
40970,4,970,[515  64  79 427 588],18,5,4400,4.531410916580844,40.0,0.0
40971,4,971,[515  64  79 427 588],18,5,4405,4.5318930041152266,40.0,0.0
40972,4,972,[515  64  79 427 588],18,5,4410,4.532374100719425,40.0,0.0
40973,4,973,[515  64  79 427 588],18,5,4415,4.532854209445585,40.0,0.0
40974,4,974,[515  64  79 427 588],18,5,4420,4.533333333333333,40.0,0.0
40975,4,975,[313   4 288 153 496],280,3,4423,4.531762295081967,20.0,0.0
40976,4,976,[302  25  89 328  64],151,3,4426,4.530194472876151,20.0,0.0
40977,4,977,[ 64 427  79 515 588],18,5,4431,4.530674846625767,40.0,0.0
40978,4,978,[ 64 427  79 515 588],716,5,4436,4.531154239019408,40.0,0.0
40979,4,979,[ 64 427  79 515 588],18,5,4441,4.531632653061225,40.0,0.0
40980,4,980,[ 64 427  79 515 588],716,5,4446,4.532110091743119,40.0,0.0
40981,4,981,[597 191 111 318 222],450,4,4450,4.531568228105907,20.0,0.0
40982,4,982,[ 64 427  79 515 588],716,5,4455,4.532044760935911,40.0,0.0
40983,4,983,[ 70  97 215 300 180],504,4,4459,4.53150406504065,0.0,0.0
40984,4,984,[273  22  82   1 588],796,2,4461,4.528934010152284,0.0,0.0
40985,4,985,[ 64 427  79 515 588],716,5,4466,4.529411764705882,40.0,0.0
40986,4,986,[ 64 427  79 515 588],716,5,4471,4.529888551165147,40.0,0.0
40987,4,987,[ 64 427  79 515 588],18,5,4476,4.530364372469635,40.0,0.0
40988,4,988,[ 64 427  79 515 588],18,5,4481,4.530839231547017,40.0,0.0
40989,4,989,[496 181  95 153 111],450,4,4485,4.53030303030303,20.0,0.0
40990,4,990,[ 64 427  79 515 588],716,5,4490,4.530776992936428,40.0,0.0
40991,4,991,[ 64 427  79 515 588],18,5,4495,4.53125,40.0,0.0
40992,4,992,[238 483  56 245 323],796,2,4497,4.528700906344411,0.0,0.0
40993,4,993,[655  82 588 173 215],280,1,4498,4.525150905432596,0.0,0.0
40994,4,994,[427  79 515  64 588],716,5,4503,4.5256281407035175,40.0,0.0
40995,4,995,[427  79 515  64 588],18,5,4508,4.526104417670683,40.0,0.0
40996,4,996,[ 22 275  56 357 186],716,4,4512,4.525576730190572,0.0,20.0
40997,4,997,[ 64 515  79 427 588],18,5,4517,4.526052104208417,40.0,0.0
40998,4,998,[ 64 515  79 427 588],716,5,4522,4.526526526526527,40.0,0.0
40999,4,999,[ 64 515  79 427 588],716,5,4527,4.527,40.0,0.0
41000,4,1000,[ 64 515  79 427 588],716,5,4532,4.527472527472527,40.0,0.0
41001,4,1001,[ 11 125  95  12 180],450,4,4536,4.526946107784431,0.0,0.0
41002,4,1002,[ 64 515  79 427 588],18,5,4541,4.5274177467597205,40.0,0.0
41003,4,1003,[151 143  98 568  15],577,2,4543,4.524900398406374,0.0,0.0
41004,4,1004,[ 64 515  79 427 588],716,5,4548,4.525373134328358,40.0,0.0
41005,4,1005,[ 64 515  79 427 588],18,5,4553,4.525844930417495,40.0,0.0
41006,4,1006,[ 64 515  79 427 588],18,5,4558,4.526315789473684,40.0,0.0
41007,4,1007,[ 64 515  79 427 588],18,5,4563,4.526785714285714,40.0,0.0
41008,4,1008,[568 215  98 471 172],72,4,4567,4.526263627353815,0.0,0.0
41009,4,1009,[ 64 515  79 427 588],716,5,4572,4.526732673267326,40.0,0.0
41010,4,1010,[ 64 515  79 427 588],716,5,4577,4.527200791295747,40.0,0.0
41011,4,1011,[ 64 515  79 427 588],716,5,4582,4.527667984189724,40.0,0.0
41012,4,1012,[118 179 603  64 187],450,4,4586,4.527147087857848,40.0,0.0
41013,4,1013,[ 64 515  79 427 588],716,5,4591,4.5276134122287965,40.0,0.0
41014,4,1014,[301 121   8 111 427],796,4,4595,4.527093596059113,20.0,0.0
41015,4,1015,[111  98 427 276 237],296,4,4599,4.5265748031496065,20.0,0.0
41016,4,1016,[515  79  64 427 588],18,5,4604,4.527040314650934,40.0,0.0
41017,4,1017,[515  79  64 427 588],18,5,4609,4.527504911591356,40.0,0.0
41018,4,1018,[ 15  96 204  69 183],655,1,4610,4.5240431795878315,0.0,0.0
41019,4,1019,[121 403  96 197 186],796,3,4613,4.522549019607843,0.0,0.0
41020,4,1020,[515  79  64 427 588],716,5,4618,4.523016650342801,40.0,0.0
41021,4,1021,[204 143  98 405 211],786,5,4623,4.52348336594912,0.0,0.0
41022,4,1022,[515  79  64 427 588],716,5,4628,4.52394916911046,40.0,0.0
41023,4,1023,[515  79  64 427 588],716,5,4633,4.5244140625,40.0,0.0
41024,4,1024,[161 216  25 318 135],716,3,4636,4.522926829268292,20.0,0.0
41025,4,1025,[515  79  64 427 588],716,5,4641,4.523391812865497,40.0,0.0
41026,4,1026,[125 161 176 655 143],504,4,4645,4.522882181110029,0.0,0.0
41027,4,1027,[515  79  64 427 588],716,5,4650,4.523346303501945,40.0,0.0
41028,4,1028,[215 186 172 301   9],796,2,4652,4.52089407191448,0.0,0.0
41029,4,1029,[269 235 748  71 111],450,3,4655,4.519417475728155,0.0,0.0
41030,4,1030,[515  79  64 427 588],18,5,4660,4.519883608147429,40.0,0.0
41031,4,1031,[275 237 300 508 125],15,3,4663,4.5184108527131785,0.0,20.0
41032,4,1032,[ 50 117 276 216  82],280,3,4666,4.516940948693127,0.0,20.0
41033,4,1033,[238  22 187  56  98],269,4,4670,4.516441005802708,0.0,0.0
41034,4,1034,[405 180 515  82 300],716,4,4674,4.515942028985507,0.0,0.0
41035,4,1035,[588  89 215 257 423],23,2,4676,4.513513513513513,0.0,0.0
41036,4,1036,[515  64 427  79 588],18,5,4681,4.513982642237223,40.0,0.0
41037,4,1037,[  7 195 135  12 546],151,3,4684,4.51252408477842,0.0,0.0
41038,4,1038,[515  64 427  79 588],18,5,4689,4.512993262752647,40.0,0.0
41039,4,1039,[515  64 427  79 588],18,5,4694,4.513461538461539,40.0,0.0
41040,4,1040,[153 204  88  64 191],269,2,4696,4.51104707012488,20.0,0.0
41041,4,1041,[515  64 427  79 588],716,5,4701,4.5115163147792705,40.0,0.0
41042,4,1042,[ 69 176 174 282 258],504,4,4705,4.511025886864813,0.0,0.0
41043,4,1043,[144  22 100 117 568],450,5,4710,4.511494252873563,0.0,20.0
41044,4,1044,[515  64 427  79 588],716,5,4715,4.511961722488039,40.0,0.0
41045,4,1045,[515  64 427  79 588],18,5,4720,4.512428298279159,40.0,0.0
41046,4,1046,[515  64 427  79 588],716,5,4725,4.512893982808023,40.0,0.0
41047,4,1047,[515  64 427  79 588],716,5,4730,4.513358778625954,40.0,0.0
41048,4,1048,[194  88  89 328  79],450,5,4735,4.513822688274547,0.0,0.0
41049,4,1049,[202 235 168  82 318],330,4,4739,4.513333333333334,20.0,0.0
41050,4,1050,[ 70 204 300 187 275],655,2,4741,4.510941960038059,0.0,20.0
41051,4,1051,[515  64 427  79 588],18,5,4746,4.511406844106464,40.0,0.0
41052,4,1052,[515  64 427  79 588],716,5,4751,4.511870845204179,40.0,0.0
41053,4,1053,[515  64 427  79 588],716,5,4756,4.512333965844403,40.0,0.0
41054,4,1054,[515  64 427  79 588],18,5,4761,4.512796208530806,40.0,0.0
41055,4,1055,[515  64 427  79 588],18,5,4766,4.513257575757576,40.0,0.0
41056,4,1056,[210 301 176 191  82],655,1,4767,4.509933774834437,0.0,0.0
41057,4,1057,[515  64 427  79 588],716,5,4772,4.510396975425331,40.0,0.0
41058,4,1058,[216 118 132 302 483],450,3,4775,4.508970727101039,0.0,0.0
41059,4,1059,[515  64  79 427 588],716,5,4780,4.509433962264151,40.0,0.0
41060,4,1060,[515  64  79 427 588],716,5,4785,4.5098963242224315,40.0,0.0
41061,4,1061,[403 200 121 185 302],655,3,4788,4.508474576271187,0.0,0.0
41062,4,1062,[427  64 515  79 588],716,5,4793,4.508936970837253,40.0,0.0
41063,4,1063,[385  15 222 234 471],256,5,4798,4.5093984962406015,0.0,0.0
41064,4,1064,[427  64 515  79 588],18,5,4803,4.509859154929577,40.0,0.0
41065,4,1065,[568 271  50 121 276],655,2,4805,4.50750469043152,0.0,20.0
41066,4,1066,[427  64 515  79 588],716,5,4810,4.50796626054358,40.0,0.0
41067,4,1067,[427  64 515  79 588],18,5,4815,4.508426966292135,40.0,0.0
41068,4,1068,[427  64 515  79 588],716,5,4820,4.5088868101029,40.0,0.0
41069,4,1069,[179 282  70  15 127],450,4,4824,4.508411214953271,0.0,20.0
41070,4,1070,[ 15 322 222 197 210],786,2,4826,4.506069094304388,0.0,0.0
41071,4,1071,[427  64 515  79 588],716,5,4831,4.5065298507462686,40.0,0.0
41072,4,1072,[151 216 568 301 118],796,4,4835,4.506057781919851,0.0,0.0
41073,4,1073,[427  64 515  79 588],716,5,4840,4.506517690875233,40.0,0.0
41074,4,1074,[427  64 515  79 588],716,5,4845,4.506976744186047,40.0,0.0
41075,4,1075,[268 151 111 515 132],269,4,4849,4.506505576208179,0.0,0.0
41076,4,1076,[427  64 515  79 588],18,5,4854,4.506963788300836,40.0,0.0
41077,4,1077,[427  64 515  79 588],18,5,4859,4.507421150278293,40.0,0.0
41078,4,1078,[427  64 515  79 588],716,5,4864,4.5078776645041705,40.0,0.0
41079,4,1079,[427  64 515  79 588],18,5,4869,4.508333333333334,40.0,0.0
41080,4,1080,[427  64 515  79 588],716,5,4874,4.508788159111933,40.0,0.0
41081,4,1081,[427  64 515  79 588],716,5,4879,4.509242144177449,40.0,0.0
41082,4,1082,[186 508 187 318 300],655,2,4881,4.5069252077562325,20.0,0.0
41083,4,1083,[427  64 515  79 588],18,5,4886,4.507380073800738,40.0,0.0
41084,4,1084,[135 144 125 117 271],655,1,4887,4.504147465437788,0.0,0.0
41085,4,1085,[427  64 515  79 588],716,5,4892,4.504604051565377,40.0,0.0
41086,4,1086,[427  64 515  79 588],18,5,4897,4.505059797608095,40.0,0.0
41087,4,1087,[328 135 496  25  96],450,3,4900,4.5036764705882355,20.0,0.0
41088,4,1088,[427  64 515  79 588],18,5,4905,4.5041322314049586,40.0,0.0
41089,4,1089,[ 97 215 483 186  79],796,3,4908,4.502752293577982,0.0,0.0
41090,4,1090,[185 125 742  98 172],655,3,4911,4.501374885426214,0.0,0.0
41091,4,1091,[427  64 515  79 588],716,5,4916,4.501831501831502,40.0,0.0
41092,4,1092,[427  64 515  79 588],716,5,4921,4.502287282708143,40.0,0.0
41093,4,1093,[427  64 515  79 588],716,5,4926,4.502742230347349,40.0,0.0
41094,4,1094,[151 403 496 546 288],450,4,4930,4.502283105022831,20.0,0.0
41095,4,1095,[427  64 515  79 588],18,5,4935,4.502737226277373,40.0,0.0
41096,4,1096,[181 111 288 385 100],593,5,4940,4.503190519598906,0.0,20.0
41097,4,1097,[427  64 515  79 588],716,5,4945,4.5036429872495445,40.0,0.0
41098,4,1098,[143 546  69 333 196],796,5,4950,4.5040946314831665,0.0,0.0
41099,4,1099,[427  64 515  79 588],716,5,4955,4.504545454545455,40.0,0.0
41100,4,1100,[403 275 187 228 183],655,3,4958,4.503178928247048,0.0,20.0
41101,4,1101,[427  64 515  79 588],716,5,4963,4.5036297640653356,40.0,0.0
41102,4,1102,[273 313 187 191 180],693,1,4964,4.500453309156845,0.0,0.0
41103,4,1103,[427  64 515  79 588],716,5,4969,4.500905797101449,40.0,0.0
41104,4,1104,[328 222 258 300 423],655,0,4969,4.49683257918552,0.0,0.0
41105,4,1105,[ 64 427 515  79 588],18,5,4974,4.497287522603978,40.0,0.0
41106,4,1106,[ 64 427 515  79 588],716,5,4979,4.497741644083107,40.0,0.0
41107,4,1107,[ 64 427 515  79 588],716,5,4984,4.498194945848375,40.0,0.0
41108,4,1108,[ 64 427 515  79 588],18,5,4989,4.498647430117223,40.0,0.0
41109,4,1109,[195   1  56 273  15],655,1,4990,4.495495495495495,0.0,0.0
41110,4,1110,[  1  64 282  22 132],716,4,4994,4.4950495049504955,20.0,0.0
41111,4,1111,[ 79 427  64 515 588],716,5,4999,4.495503597122302,40.0,0.0
41112,4,1112,[ 79 427  64 515 588],716,5,5004,4.495956873315364,40.0,0.0
41113,4,1113,[ 79 427  64 515 588],716,5,5009,4.496409335727109,40.0,0.0
41114,4,1114,[ 79 427  64 515 588],18,5,5014,4.496860986547085,40.0,0.0
41115,4,1115,[135  56 100  71 427],535,3,5017,4.495519713261649,20.0,20.0
41116,4,1116,[ 79 427  64 515 588],716,5,5022,4.495971351835273,40.0,0.0
41117,4,1117,[174 748  95 286  50],450,4,5026,4.495527728085867,0.0,40.0
41118,4,1118,[ 79 427  64 515 588],716,5,5031,4.49597855227882,40.0,0.0
41119,4,1119,[ 79 427  64 515 588],716,5,5036,4.496428571428571,40.0,0.0
41120,4,1120,[174 121  69  56 405],577,3,5039,4.495093666369313,0.0,0.0
41121,4,1121,[ 98 211   1  50 357],786,5,5044,4.49554367201426,0.0,20.0
41122,4,1122,[ 64  79 515 427 588],716,5,5049,4.495992876224399,40.0,0.0
41123,4,1123,[ 64  79 515 427 588],716,5,5054,4.49644128113879,40.0,0.0
41124,4,1124,[  8  56  89  95 111],796,5,5059,4.496888888888889,0.0,0.0
41125,4,1125,[ 64  79 515 427 588],18,5,5064,4.497335701598579,40.0,0.0
41126,4,1126,[238  96 245 742 121],450,4,5068,4.496894409937888,0.0,0.0
41127,4,1127,[151 385   4  70 288],344,3,5071,4.495567375886525,0.0,0.0
41128,4,1128,[ 64  79 515 427 588],716,5,5076,4.496014171833481,40.0,0.0
41129,4,1129,[183 151 121 294 176],716,3,5079,4.494690265486725,0.0,0.0
41130,4,1130,[ 64  79 515 427 588],716,5,5084,4.495137046861185,40.0,0.0
41131,4,1131,[ 64  79 515 427 588],716,5,5089,4.495583038869258,40.0,0.0
41132,4,1132,[204  95 194 174 265],577,5,5094,4.496028243601059,0.0,0.0
41133,4,1133,[ 64  79 515 427 588],18,5,5099,4.49647266313933,40.0,0.0
41134,4,1134,[  4  50 403  96  88],280,1,5100,4.493392070484582,0.0,20.0
41135,4,1135,[ 64  79 515 427 588],716,5,5105,4.493838028169014,40.0,0.0
41136,4,1136,[ 64  79 515 427 588],716,5,5110,4.494283201407212,40.0,0.0
41137,4,1137,[161  25 185 546 216],457,4,5114,4.493848857644991,0.0,0.0
41138,4,1138,[ 64  79 515 427 588],18,5,5119,4.494293239683933,40.0,0.0
41139,4,1139,[ 64  79 515 427 588],716,5,5124,4.494736842105263,40.0,0.0
41140,4,1140,[168 174 268 194 211],503,5,5129,4.495179666958808,0.0,0.0
41141,4,1141,[ 64 515 427  79 588],716,5,5134,4.495621716287215,40.0,0.0
41142,4,1142,[ 64 515 427  79 588],18,5,5139,4.496062992125984,40.0,0.0
41143,4,1143,[ 64 515 427  79 588],18,5,5144,4.496503496503497,40.0,0.0
41144,4,1144,[ 64 515 427  79 588],716,5,5149,4.4969432314410485,40.0,0.0
41145,4,1145,[181  12 111  64 228],151,5,5154,4.49738219895288,20.0,0.0
41146,4,1146,[427 515  64  79 588],716,5,5159,4.497820401046208,40.0,0.0
41147,4,1147,[427 515  64  79 588],18,5,5164,4.498257839721254,40.0,0.0
41148,4,1148,[427 515  64  79 588],716,5,5169,4.4986945169712795,40.0,0.0
41149,4,1149,[427 515  64  79 588],716,5,5174,4.499130434782609,40.0,0.0
41150,4,1150,[294  56 210 403 265],256,3,5177,4.497827975673328,0.0,0.0
41151,4,1151,[427 515  64  79 588],716,5,5182,4.498263888888889,40.0,0.0
41152,4,1152,[427 515  64  79 588],18,5,5187,4.498699045967043,40.0,0.0
41153,4,1153,[427 515  64  79 588],716,5,5192,4.499133448873484,40.0,0.0
41154,4,1154,[427 515  64  79 588],18,5,5197,4.499567099567099,40.0,0.0
41155,4,1155,[427 515  64  79 588],716,5,5202,4.5,40.0,0.0
41156,4,1156,[427 515  64  79 588],18,5,5207,4.500432152117545,40.0,0.0
41157,4,1157,[427 515  64  79 588],716,5,5212,4.500863557858376,40.0,0.0
41158,4,1158,[100 302 173 427 313],450,5,5217,4.501294219154444,20.0,20.0
41159,4,1159,[180 568  25  28 173],716,4,5221,4.500862068965517,0.0,0.0
41160,4,1160,[427  64 515  79 588],716,5,5226,4.501291989664082,40.0,0.0
41161,4,1161,[180 117 210 288  69],280,4,5230,4.500860585197935,0.0,0.0
41162,4,1162,[181 176 588 117 151],716,4,5234,4.50042992261393,0.0,0.0
41163,4,1163,[427  64 515  79 588],18,5,5239,4.50085910652921,40.0,0.0
41164,4,1164,[427  64 515  79 588],18,5,5244,4.501287553648068,40.0,0.0
41165,4,1165,[427  64 515  79 588],18,5,5249,4.501715265866209,40.0,0.0
41166,4,1166,[427  64 515  79 588],716,5,5254,4.502142245072836,40.0,0.0
41167,4,1167,[427  64 515  79 588],18,5,5259,4.502568493150685,40.0,0.0
41168,4,1168,[427  64 515  79 588],18,5,5264,4.502994011976048,40.0,0.0
41169,4,1169,[427  64 515  79 588],716,5,5269,4.503418803418803,40.0,0.0
41170,4,1170,[196 508  88 357 435],655,1,5270,4.500426985482494,0.0,0.0
41171,4,1171,[238 172 301 275 546],151,4,5274,4.5,0.0,20.0
41172,4,1172,[ 15 289 172 174 275],655,2,5276,4.497868712702473,0.0,20.0
41173,4,1173,[222 323 496 118 748],280,1,5277,4.494889267461669,20.0,0.0
41174,4,1174,[427  64 515  79 588],716,5,5282,4.49531914893617,40.0,0.0
41175,4,1175,[427  64 515  79 588],18,5,5287,4.495748299319728,40.0,0.0
41176,4,1176,[435  15  22 318 282],450,4,5291,4.4953271028037385,20.0,0.0
41177,4,1177,[427  64 515  79 588],716,5,5296,4.495755517826825,40.0,0.0
41178,4,1178,[427  64 515  79 588],18,5,5301,4.4961832061068705,40.0,0.0
41179,4,1179,[427  64 515  79 588],18,5,5306,4.496610169491525,40.0,0.0
41180,4,1180,[195 300 186  89 191],655,2,5308,4.494496189669771,0.0,0.0
41181,4,1181,[ 64 515 427  79 588],18,5,5313,4.49492385786802,40.0,0.0
41182,4,1182,[  7 427  12  50 234],577,3,5316,4.493660185967879,20.0,20.0
41183,4,1183,[144 100 211   8 172],535,3,5319,4.492398648648648,0.0,20.0
41184,4,1184,[ 69  15 174 118 237],593,5,5324,4.492827004219409,0.0,0.0
41185,4,1185,[ 64 427  79 515 588],716,5,5329,4.493254637436762,40.0,0.0
41186,4,1186,[ 64 427  79 515 588],18,5,5334,4.493681550126369,40.0,0.0
41187,4,1187,[ 64 427  79 515 588],716,5,5339,4.494107744107744,40.0,0.0
41188,4,1188,[ 64 427  79 515 588],18,5,5344,4.494533221194281,40.0,0.0
41189,4,1189,[ 64 427  79 515 588],716,5,5349,4.494957983193277,40.0,0.0
41190,4,1190,[ 64 427  79 515 588],716,5,5354,4.495382031905962,40.0,0.0
41191,4,1191,[294 144 204 197 546],716,3,5357,4.494127516778524,0.0,0.0
41192,4,1192,[ 79 515  64 427 588],18,5,5362,4.494551550712489,40.0,0.0
41193,4,1193,[ 79 515  64 427 588],18,5,5367,4.494974874371859,40.0,0.0
41194,4,1194,[185 202 180 111 237],269,1,5368,4.492050209205021,0.0,0.0
41195,4,1195,[210   8  69  64 427],577,4,5372,4.491638795986622,40.0,0.0
41196,4,1196,[385  88 286  89 258],344,1,5373,4.488721804511278,0.0,20.0
41197,4,1197,[ 79  64 427 515 588],18,5,5378,4.489148580968281,40.0,0.0
41198,4,1198,[ 79  64 427 515 588],18,5,5383,4.489574645537949,40.0,0.0
41199,4,1199,[ 79  64 427 515 588],18,5,5388,4.49,40.0,0.0
41200,4,1200,[ 79  64 427 515 588],716,5,5393,4.4904246461282264,40.0,0.0
41201,4,1201,[483  98 202 174 258],457,5,5398,4.490848585690515,0.0,0.0
41202,4,1202,[197  96  98 196 237],450,5,5403,4.491271820448878,0.0,0.0
41203,4,1203,[211 135 742 180 111],450,4,5407,4.490863787375416,0.0,0.0
41204,4,1204,[186 181  97 269  64],796,2,5409,4.488796680497925,20.0,0.0
41205,4,1205,[ 79 515  64 427 588],716,5,5414,4.48922056384743,40.0,0.0
41206,4,1206,[ 79 515  64 427 588],716,5,5419,4.489643744821873,40.0,0.0
41207,4,1207,[181 655 405 100 385],796,3,5422,4.48841059602649,0.0,20.0
41208,4,1208,[ 79 515  64 427 588],716,5,5427,4.488833746898263,40.0,0.0
41209,4,1209,[ 79 515  64 427 588],716,5,5432,4.489256198347108,40.0,0.0
41210,4,1210,[195 210 174 197  70],457,5,5437,4.489677952105698,0.0,0.0
41211,4,1211,[ 79 515  64 427 588],716,5,5442,4.49009900990099,40.0,0.0
41212,4,1212,[ 79 515  64 427 588],18,5,5447,4.490519373454245,40.0,0.0
41213,4,1213,[ 79 515  64 427 588],716,5,5452,4.490939044481054,40.0,0.0
41214,4,1214,[ 79 515  64 427 588],716,5,5457,4.491358024691358,40.0,0.0
41215,4,1215,[ 79 515  64 427 588],716,5,5462,4.4917763157894735,40.0,0.0
41216,4,1216,[ 79 515  64 427 588],716,5,5467,4.492193919474117,40.0,0.0
41217,4,1217,[ 79 515  64 427 588],18,5,5472,4.4926108374384235,40.0,0.0
41218,4,1218,[ 79 515  64 427 588],716,5,5477,4.493027071369975,40.0,0.0
41219,4,1219,[ 79 515  64 427 588],18,5,5482,4.49344262295082,40.0,0.0
41220,4,1220,[ 79 515  64 427 588],716,5,5487,4.493857493857494,40.0,0.0
41221,4,1221,[185 234  71 172 186],796,3,5490,4.4926350245499185,0.0,0.0
41222,4,1222,[ 79 515  64 427 588],716,5,5495,4.493049877350777,40.0,0.0
41223,4,1223,[ 79 515  64 427 588],18,5,5500,4.493464052287582,40.0,0.0
41224,4,1224,[ 79 515  64 427 588],716,5,5505,4.493877551020408,40.0,0.0
41225,4,1225,[ 79 515  64 427 588],716,5,5510,4.494290375203915,40.0,0.0
41226,4,1226,[ 89   7  88   1 282],450,5,5515,4.494702526487368,0.0,0.0
41227,4,1227,[ 64  79 515 427 588],18,5,5520,4.495114006514658,40.0,0.0
41228,4,1228,[143 117  15 173 174],593,5,5525,4.495524816924329,0.0,0.0
41229,4,1229,[357  64 180 185 176],693,2,5527,4.493495934959349,20.0,0.0
41230,4,1230,[328  22 546   4  95],450,3,5530,4.492282696994313,0.0,0.0
41231,4,1231,[ 79 515 427  64 588],18,5,5535,4.492694805194805,40.0,0.0
41232,4,1232,[ 79 515 427  64 588],18,5,5540,4.493106244931062,40.0,0.0
41233,4,1233,[ 79 515 427  64 588],18,5,5545,4.493517017828201,40.0,0.0
41234,4,1234,[ 79 515 427  64 588],18,5,5550,4.493927125506073,40.0,0.0
41235,4,1235,[423  50 228 168 588],798,3,5553,4.492718446601942,0.0,20.0
41236,4,1236,[515  79 427  64 588],716,5,5558,4.493128536782538,40.0,0.0
41237,4,1237,[515  79 427  64 588],716,5,5563,4.493537964458804,40.0,0.0
41238,4,1238,[515  79 427  64 588],18,5,5568,4.493946731234867,40.0,0.0
41239,4,1239,[515  79 427  64 588],716,5,5573,4.494354838709677,40.0,0.0
41240,4,1240,[515  79 427  64 588],18,5,5578,4.494762288477035,40.0,0.0
41241,4,1241,[515  79 427  64 588],18,5,5583,4.495169082125604,40.0,0.0
41242,4,1242,[515  79 427  64 588],716,5,5588,4.495575221238938,40.0,0.0
41243,4,1243,[515  79 427  64 588],18,5,5593,4.495980707395498,40.0,0.0
41244,4,1244,[235 151  82  11 597],450,3,5596,4.494779116465863,0.0,0.0
41245,4,1245,[515  79 427  64 588],716,5,5601,4.495184590690209,40.0,0.0
41246,4,1246,[515  79 427  64 588],18,5,5606,4.495589414595028,40.0,0.0
41247,4,1247,[515  79 427  64 588],716,5,5611,4.495993589743589,40.0,0.0
41248,4,1248,[228 196 276 271 403],655,1,5612,4.493194555644515,0.0,0.0
41249,4,1249,[515  79 427  64 588],18,5,5617,4.4936,40.0,0.0
41250,4,1250,[515  79 427  64 588],18,5,5622,4.494004796163069,40.0,0.0
41251,4,1251,[143   8 211  12  88],796,4,5626,4.493610223642173,0.0,0.0
41252,4,1252,[179 151 235  11  15],450,3,5629,4.492418196328811,0.0,0.0
41253,4,1253,[173 588 168 187  69],716,4,5633,4.492025518341308,0.0,0.0
41254,4,1254,[515  79 427  64 588],18,5,5638,4.492430278884462,40.0,0.0
41255,4,1255,[515  79 427  64 588],18,5,5643,4.492834394904459,40.0,0.0
41256,4,1256,[515  79 427  64 588],716,5,5648,4.493237867939539,40.0,0.0
41257,4,1257,[515  79 427  64 588],18,5,5653,4.493640699523053,40.0,0.0
41258,4,1258,[143 237 183  64 127],450,5,5658,4.494042891183479,20.0,20.0
41259,4,1259,[515  79 427  64 588],18,5,5663,4.4944444444444445,40.0,0.0
41260,4,1260,[515  79 427  64 588],18,5,5668,4.494845360824742,40.0,0.0
41261,4,1261,[ 70 216 111 228 204],786,5,5673,4.495245641838352,0.0,0.0
41262,4,1262,[515  79 427  64 588],18,5,5678,4.495645288994457,40.0,0.0
41263,4,1263,[515  79 427  64 588],716,5,5683,4.4960443037974684,40.0,0.0
41264,4,1264,[515  79 427  64 588],18,5,5688,4.496442687747035,40.0,0.0
41265,4,1265,[515  79 427  64 588],18,5,5693,4.496840442338073,40.0,0.0
41266,4,1266,[111 174 173 196 202],629,5,5698,4.497237569060774,0.0,0.0
41267,4,1267,[515  79 427  64 588],716,5,5703,4.497634069400631,40.0,0.0
41268,4,1268,[515  79 427  64 588],18,5,5708,4.498029944838455,40.0,0.0
41269,4,1269,[515  79 427  64 588],716,5,5713,4.498425196850394,40.0,0.0
41270,4,1270,[515  79 427  64 588],18,5,5718,4.498819826907947,40.0,0.0
41271,4,1271,[515  79 427  64 588],716,5,5723,4.4992138364779874,40.0,0.0
41272,4,1272,[515  79 427  64 588],18,5,5728,4.499607227022781,40.0,0.0
41273,4,1273,[515  79 427  64 588],716,5,5733,4.5,40.0,0.0
41274,4,1274,[515  79 427  64 588],716,5,5738,4.500392156862745,40.0,0.0
41275,4,1275,[515  79 427  64 588],18,5,5743,4.5007836990595615,40.0,0.0
41276,4,1276,[515  79 427  64 588],18,5,5748,4.501174628034455,40.0,0.0
41277,4,1277,[515  79 427  64 588],18,5,5753,4.501564945226917,40.0,0.0
41278,4,1278,[515  79 427  64 588],18,5,5758,4.501954652071931,40.0,0.0
41279,4,1279,[ 56 427  98 234 144],655,2,5760,4.5,20.0,0.0
41280,4,1280,[118 135  56  12 748],280,3,5763,4.498829039812646,0.0,0.0
41281,4,1281,[515  79 427  64 588],716,5,5768,4.4992199687987515,40.0,0.0
41282,4,1282,[ 50 328  69 176 185],151,3,5771,4.49805144193297,0.0,20.0
41283,4,1283,[515  79 427  64 588],716,5,5776,4.498442367601246,40.0,0.0
41284,4,1284,[515  79 427  64 588],716,5,5781,4.498832684824903,40.0,0.0
41285,4,1285,[515  79 427  64 588],716,5,5786,4.499222395023328,40.0,0.0
41286,4,1286,[568 318  15 302 603],269,2,5788,4.497280497280498,40.0,0.0
41287,4,1287,[427 515  79  64 588],18,5,5793,4.497670807453416,40.0,0.0
41288,4,1288,[427 515  79  64 588],716,5,5798,4.498060512024826,40.0,0.0
41289,4,1289,[427 515  79  64 588],716,5,5803,4.498449612403101,40.0,0.0
41290,4,1290,[427 515  79  64 588],716,5,5808,4.498838109992254,40.0,0.0
41291,4,1291,[427 515  79  64 588],716,5,5813,4.49922600619195,40.0,0.0
41292,4,1292,[427 515  79  64 588],18,5,5818,4.499613302397525,40.0,0.0
41293,4,1293,[ 95 187  88 173 144],796,5,5823,4.5,0.0,0.0
41294,4,1294,[655 288 678 197  56],280,2,5825,4.498069498069498,0.0,0.0
41295,4,1295,[211  50   1   9 111],296,4,5829,4.497685185185185,0.0,20.0
41296,4,1296,[427 515  79  64 588],18,5,5834,4.498072474942174,40.0,0.0
41297,4,1297,[427 515  79  64 588],716,5,5839,4.498459167950694,40.0,0.0
41298,4,1298,[427 515  79  64 588],716,5,5844,4.498845265588915,40.0,0.0
41299,4,1299,[427 515  79  64 588],18,5,5849,4.49923076923077,40.0,0.0
41300,4,1300,[427 515  79  64 588],716,5,5854,4.499615680245965,40.0,0.0
41301,4,1301,[194  25 179  98 275],264,5,5859,4.5,0.0,20.0
41302,4,1302,[546 282 132 318  25],504,5,5864,4.500383729854183,20.0,0.0
41303,4,1303,[179 265  50  12 258],450,5,5869,4.500766871165644,0.0,20.0
41304,4,1304,[427 515  79  64 588],716,5,5874,4.501149425287356,40.0,0.0
41305,4,1305,[ 56  97 194 127 286],236,4,5878,4.5007656967840735,0.0,40.0
41306,4,1306,[427 515  79  64 588],716,5,5883,4.5011476664116294,40.0,0.0
41307,4,1307,[427 515  79  64 588],18,5,5888,4.5015290519877675,40.0,0.0
41308,4,1308,[427 515  79  64 588],716,5,5893,4.501909854851031,40.0,0.0
41309,4,1309,[427 515  79  64 588],716,5,5898,4.5022900763358775,40.0,0.0
41310,4,1310,[427 515  79  64 588],716,5,5903,4.502669717772693,40.0,0.0
41311,4,1311,[427 515  79  64 588],716,5,5908,4.503048780487805,40.0,0.0
41312,4,1312,[427 515  79  64 588],18,5,5913,4.503427265803503,40.0,0.0
41313,4,1313,[427 515  79  64 588],716,5,5918,4.5038051750380514,40.0,0.0
41314,4,1314,[427 515  79  64 588],18,5,5923,4.5041825095057035,40.0,0.0
41315,4,1315,[ 82 385  98 121 179],655,2,5925,4.5022796352583585,0.0,0.0
41316,4,1316,[403 161 427 423 508],693,1,5926,4.499620349278664,20.0,0.0
41317,4,1317,[427 515  79  64 588],18,5,5931,4.5,40.0,0.0
41318,4,1318,[427 515  79  64 588],18,5,5936,4.500379075056861,40.0,0.0
41319,4,1319,[237 282 161 496 180],796,4,5940,4.5,20.0,0.0
41320,4,1320,[  7 174  25 655  97],72,4,5944,4.499621498864497,0.0,0.0
41321,4,1321,[427 515  79  64 588],716,5,5949,4.5,40.0,0.0
41322,4,1322,[183 496 405   8  98],280,3,5952,4.498866213151928,20.0,0.0
41323,4,1323,[427 515  79  64 588],18,5,5957,4.4992447129909365,40.0,0.0
41324,4,1324,[588   8 546  88   1],577,3,5960,4.49811320754717,0.0,0.0
41325,4,1325,[427 515  79  64 588],18,5,5965,4.498491704374057,40.0,0.0
41326,4,1326,[427 515  79  64 588],716,5,5970,4.498869630746044,40.0,0.0
41327,4,1327,[  1 483 435  96 195],716,3,5973,4.4977409638554215,0.0,0.0
41328,4,1328,[427 515  79  64 588],18,5,5978,4.4981188863807375,40.0,0.0
41329,4,1329,[427 515  79  64 588],716,5,5983,4.498496240601503,40.0,0.0
41330,4,1330,[286 153 210 282 195],796,3,5986,4.4973703981968445,0.0,20.0
41331,4,1331,[427 515  79  64 588],18,5,5991,4.497747747747748,40.0,0.0
41332,4,1332,[427 515  79  64 588],716,5,5996,4.498124531132783,40.0,0.0
41333,4,1333,[427 515  79  64 588],716,5,6001,4.498500749625188,40.0,0.0
41334,4,1334,[427 515  79  64 588],18,5,6006,4.498876404494382,40.0,0.0
41335,4,1335,[427 515  79  64 588],716,5,6011,4.499251497005988,40.0,0.0
41336,4,1336,[427 515  79  64 588],18,5,6016,4.49962602842184,40.0,0.0
41337,4,1337,[427 515  79  64 588],18,5,6021,4.5,40.0,0.0
41338,4,1338,[427 515  79  64 588],716,5,6026,4.500373412994772,40.0,0.0
41339,4,1339,[427 515  79  64 588],716,5,6031,4.500746268656717,40.0,0.0
41340,4,1340,[427 515  79  64 588],716,5,6036,4.501118568232662,40.0,0.0
41341,4,1341,[176  15 135 195 196],450,3,6039,4.5,0.0,0.0
41342,4,1342,[427 515  79  64 588],18,5,6044,4.500372300819062,40.0,0.0
41343,4,1343,[427 515  79  64 588],716,5,6049,4.5007440476190474,40.0,0.0
41344,4,1344,[427 515  79  64 588],716,5,6054,4.501115241635688,40.0,0.0
41345,4,1345,[427 515  79  64 588],716,5,6059,4.50148588410104,40.0,0.0
41346,4,1346,[427 515  79  64 588],18,5,6064,4.501855976243504,40.0,0.0
41347,4,1347,[135   1 496 143 234],389,3,6067,4.500741839762611,20.0,0.0
41348,4,1348,[427 515  79  64 588],18,5,6072,4.501111934766493,40.0,0.0
41349,4,1349,[427 515  79  64 588],18,5,6077,4.501481481481481,40.0,0.0
41350,4,1350,[427 515  79  64 588],18,5,6082,4.501850481125093,40.0,0.0
41351,4,1351,[427 515  79  64 588],18,5,6087,4.502218934911243,40.0,0.0
41352,4,1352,[427 515  79  64 588],18,5,6092,4.502586844050259,40.0,0.0
41353,4,1353,[427 515  79  64 588],716,5,6097,4.502954209748892,40.0,0.0
41354,4,1354,[427 515  79  64 588],716,5,6102,4.503321033210332,40.0,0.0
41355,4,1355,[427 515  79  64 588],18,5,6107,4.5036873156342185,40.0,0.0
41356,4,1356,[ 50  69 483 100 181],655,2,6109,4.501842299189389,0.0,40.0
41357,4,1357,[427 515  79  64 588],716,5,6114,4.5022091310751104,40.0,0.0
41358,4,1358,[  1 546 195 471  28],786,5,6119,4.502575423105225,0.0,0.0
41359,4,1359,[427 515  79  64 588],716,5,6124,4.502941176470588,40.0,0.0
41360,4,1360,[427 515  79  64 588],18,5,6129,4.50330639235856,40.0,0.0
41361,4,1361,[118   4 127 161  50],256,5,6134,4.50367107195301,0.0,40.0
41362,4,1362,[427 515  79  64 588],18,5,6139,4.504035216434336,40.0,0.0
41363,4,1363,[568 265  11 286 161],655,0,6139,4.500733137829912,0.0,20.0
41364,4,1364,[427 515  79  64 588],18,5,6144,4.501098901098901,40.0,0.0
41365,4,1365,[427 515  79  64 588],716,5,6149,4.501464128843338,40.0,0.0
41366,4,1366,[222  88 228 427 127],655,2,6151,4.499634235552304,20.0,20.0
41367,4,1367,[515  79 427  64 588],18,5,6156,4.5,40.0,0.0
41368,4,1368,[515  79 427  64 588],716,5,6161,4.5003652300949595,40.0,0.0
41369,4,1369,[194 161 153 125  70],504,2,6163,4.498540145985402,0.0,0.0
41370,4,1370,[515  79 427  64 588],18,5,6168,4.49890590809628,40.0,0.0
41371,4,1371,[515  79 427  64 588],716,5,6173,4.4992711370262395,40.0,0.0
41372,4,1372,[515  79 427  64 588],716,5,6178,4.499635833940276,40.0,0.0
41373,4,1373,[515  79 427  64 588],18,5,6183,4.5,40.0,0.0
41374,4,1374,[515  79 427  64 588],18,5,6188,4.500363636363637,40.0,0.0
41375,4,1375,[515  79 427  64 588],18,5,6193,4.500726744186046,40.0,0.0
41376,4,1376,[100  95 313 183  28],450,4,6197,4.500363108206246,0.0,20.0
41377,4,1377,[125 215 197 655 318],65,5,6202,4.500725689404935,20.0,0.0
41378,4,1378,[515  79 427  64 588],716,5,6207,4.501087744742567,40.0,0.0
41379,4,1379,[515  79 427  64 588],716,5,6212,4.501449275362319,40.0,0.0
41380,4,1380,[515  79 427  64 588],18,5,6217,4.501810282404055,40.0,0.0
41381,4,1381,[515  79 427  64 588],18,5,6222,4.502170767004341,40.0,0.0
41382,4,1382,[515  79 427  64 588],716,5,6227,4.502530730296457,40.0,0.0
41383,4,1383,[427 237 742 546  82],450,4,6231,4.502167630057803,20.0,0.0
41384,4,1384,[153 117 161  70  22],450,5,6236,4.502527075812274,0.0,0.0
41385,4,1385,[515  79 427  64 588],716,5,6241,4.502886002886003,40.0,0.0
41386,4,1386,[385 144 357 258 655],450,5,6246,4.503244412400865,0.0,0.0
41387,4,1387,[515  79 427  64 588],18,5,6251,4.503602305475504,40.0,0.0
41388,4,1388,[515  79 427  64 588],716,5,6256,4.503959683225342,40.0,0.0
41389,4,1389,[168  50  79 423 403],18,3,6259,4.502877697841726,0.0,20.0
41390,4,1390,[515  79 427  64 588],18,5,6264,4.503235082674335,40.0,0.0
41391,4,1391,[515  79 427  64 588],18,5,6269,4.503591954022989,40.0,0.0
41392,4,1392,[127 258 403   7 742],457,5,6274,4.503948312993539,0.0,20.0
41393,4,1393,[515  79 427  64 588],716,5,6279,4.504304160688665,40.0,0.0
41394,4,1394,[515  79 427  64 588],716,5,6284,4.504659498207885,40.0,0.0
41395,4,1395,[265 257 228 238 181],457,4,6288,4.504297994269341,0.0,0.0
41396,4,1396,[427 515  79  64 588],716,5,6293,4.504652827487473,40.0,0.0
41397,4,1397,[427 515  79  64 588],716,5,6298,4.505007153075822,40.0,0.0
41398,4,1398,[427 515  79  64 588],18,5,6303,4.505360972122945,40.0,0.0
41399,4,1399,[ 50 269 202 216  71],18,4,6307,4.505,0.0,20.0
41400,4,1400,[427 515  79  64 588],716,5,6312,4.505353319057816,40.0,0.0
41401,4,1401,[546 216  82 202 471],280,2,6314,4.503566333808845,0.0,0.0
41402,4,1402,[427 515  79  64 588],716,5,6319,4.50392017106201,40.0,0.0
41403,4,1403,[427 515  79  64 588],18,5,6324,4.504273504273504,40.0,0.0
41404,4,1404,[427 515  79  64 588],18,5,6329,4.504626334519573,40.0,0.0
41405,4,1405,[427 515  79  64 588],716,5,6334,4.5049786628734,40.0,0.0
41406,4,1406,[483  70 211 748 176],151,3,6337,4.503909026297086,0.0,0.0
41407,4,1407,[ 96 182  89   7 471],457,5,6342,4.504261363636363,0.0,0.0
41408,4,1408,[427 515  79  64 588],18,5,6347,4.504613200851668,40.0,0.0
41409,4,1409,[405 191 385 210   7],344,3,6350,4.50354609929078,0.0,0.0
41410,4,1410,[427 515  79  64 588],716,5,6355,4.503897944720057,40.0,0.0
41411,4,1411,[301 286 385  15 176],796,3,6358,4.502832861189802,0.0,20.0
41412,4,1412,[427 515  79  64 588],18,5,6363,4.503184713375796,40.0,0.0
41413,4,1413,[ 50  95  70 215 125],344,2,6365,4.501414427157002,0.0,20.0
41414,4,1414,[427 515  79  64 588],18,5,6370,4.501766784452297,40.0,0.0
41415,4,1415,[427 515  79  64 588],716,5,6375,4.502118644067797,40.0,0.0
41416,4,1416,[427 515  79  64 588],716,5,6380,4.502470007057163,40.0,0.0
41417,4,1417,[427 515  79  64 588],716,5,6385,4.5028208744710865,40.0,0.0
41418,4,1418,[427 273 153  50 271],796,4,6389,4.5024665257223395,20.0,20.0
41419,4,1419,[238 127 215   8 655],457,5,6394,4.502816901408451,0.0,20.0
41420,4,1420,[318  82 100 168  79],577,5,6399,4.503166783954962,20.0,20.0
41421,4,1421,[427 515  79  64 588],18,5,6404,4.50351617440225,40.0,0.0
41422,4,1422,[222 172 202   1 403],798,3,6407,4.502459592410401,0.0,0.0
41423,4,1423,[427 515  79  64 588],18,5,6412,4.502808988764045,40.0,0.0
41424,4,1424,[427 515  79  64 588],716,5,6417,4.503157894736842,40.0,0.0
41425,4,1425,[427 515  79  64 588],18,5,6422,4.503506311360449,40.0,0.0
41426,4,1426,[237 125 118 144  96],796,5,6427,4.50385423966363,0.0,0.0
41427,4,1427,[172  56 132 655 269],796,3,6430,4.502801120448179,0.0,0.0
41428,4,1428,[427 515  79  64 588],18,5,6435,4.503149055283415,40.0,0.0
41429,4,1429,[427 515  79  64 588],18,5,6440,4.503496503496503,40.0,0.0
41430,4,1430,[427 515  79  64 588],716,5,6445,4.503843466107617,40.0,0.0
41431,4,1431,[427 515  79  64 588],716,5,6450,4.504189944134078,40.0,0.0
41432,4,1432,[  1 117 238  97 111],716,5,6455,4.50453593859037,0.0,0.0
41433,4,1433,[427 515  79  64 588],18,5,6460,4.504881450488145,40.0,0.0
41434,4,1434,[427 515  79  64 588],18,5,6465,4.505226480836237,40.0,0.0
41435,4,1435,[135 403 245 118 172],450,3,6468,4.504178272980502,0.0,0.0
41436,4,1436,[427 515  79  64 588],716,5,6473,4.504523312456507,40.0,0.0
41437,4,1437,[427 515  79  64 588],18,5,6478,4.504867872044506,40.0,0.0
41438,4,1438,[427 515  79  64 588],716,5,6483,4.505211952744962,40.0,0.0
41439,4,1439,[ 79 172 183 222  64],693,1,6484,4.502777777777778,20.0,0.0
41440,4,1440,[427 515  79 588  64],18,5,6489,4.503122831367106,40.0,0.0
41441,4,1441,[427 515  79 588  64],18,5,6494,4.503467406380028,40.0,0.0
41442,4,1442,[597 385 483 196 403],796,5,6499,4.503811503811503,0.0,0.0
41443,4,1443,[427 515  79 588  64],18,5,6504,4.50415512465374,40.0,0.0
41444,4,1444,[427 515  79 588  64],716,5,6509,4.504498269896194,40.0,0.0
41445,4,1445,[427 515  79 588  64],18,5,6514,4.504840940525588,40.0,0.0
41446,4,1446,[427 515  79 588  64],18,5,6519,4.505183137525916,40.0,0.0
41447,4,1447,[427 515  79 588  64],716,5,6524,4.505524861878453,40.0,0.0
41448,4,1448,[427 515  79 588  64],716,5,6529,4.5058661145617664,40.0,0.0
41449,4,1449,[301 211 357  96 288],655,1,6530,4.503448275862069,0.0,0.0
41450,4,1450,[427 515  79 588  64],716,5,6535,4.503790489317712,40.0,0.0
41451,4,1451,[427 515  79 588  64],18,5,6540,4.5041322314049586,40.0,0.0
41452,4,1452,[427 515  79 588  64],716,5,6545,4.50447350309704,40.0,0.0
41453,4,1453,[427 515  79 588  64],716,5,6550,4.504814305364512,40.0,0.0
41454,4,1454,[655 216 143 185 597],269,2,6552,4.503092783505155,0.0,0.0
41455,4,1455,[151 385 174  97 117],330,5,6557,4.503434065934066,0.0,0.0
41456,4,1456,[427  79 515 588  64],18,5,6562,4.5037748798901855,40.0,0.0
41457,4,1457,[427  79 515 588  64],716,5,6567,4.504115226337449,40.0,0.0
41458,4,1458,[ 88   7 423 475 195],655,0,6567,4.501028101439342,0.0,0.0
41459,4,1459,[  8  71  69 318 175],18,4,6571,4.500684931506849,20.0,0.0
41460,4,1460,[202  79  28 435 194],389,5,6576,4.501026694045175,0.0,0.0
41461,4,1461,[515  79 427 588  64],716,5,6581,4.501367989056088,40.0,0.0
41462,4,1462,[515  79 427 588  64],716,5,6586,4.501708817498291,40.0,0.0
41463,4,1463,[515  79 427 588  64],18,5,6591,4.502049180327869,40.0,0.0
41464,4,1464,[  1 748  88  56   8],280,3,6594,4.501023890784983,0.0,0.0
41465,4,1465,[515  79 427 588  64],18,5,6599,4.501364256480218,40.0,0.0
41466,4,1466,[515  79 427 588  64],716,5,6604,4.501704158145876,40.0,0.0
41467,4,1467,[515  79 427 588  64],18,5,6609,4.502043596730245,40.0,0.0
41468,4,1468,[515  79 427 588  64],716,5,6614,4.502382573179033,40.0,0.0
41469,4,1469,[588 172 496 202 121],716,5,6619,4.502721088435374,20.0,0.0
41470,4,1470,[515  79 427 588  64],716,5,6624,4.503059143439837,40.0,0.0
41471,4,1471,[235 180 153 515 151],716,3,6627,4.502038043478261,0.0,0.0
41472,4,1472,[200  69 175 265 153],655,1,6628,4.499660556687033,0.0,0.0
41473,4,1473,[515  79 427 588  64],18,5,6633,4.5,40.0,0.0
41474,4,1474,[179  15  11 127 405],457,5,6638,4.500338983050847,0.0,20.0
41475,4,1475,[515  79 427 588  64],716,5,6643,4.500677506775068,40.0,0.0
41476,4,1476,[515  79 427 588  64],716,5,6648,4.5010155721056195,40.0,0.0
41477,4,1477,[182 423   1 235 385],457,4,6652,4.500676589986468,0.0,0.0
41478,4,1478,[515  79 427 588  64],716,5,6657,4.501014198782961,40.0,0.0
41479,4,1479,[515  79 427 588  64],716,5,6662,4.501351351351351,40.0,0.0
41480,4,1480,[180 197 144 508 423],693,1,6663,4.49898717083052,0.0,0.0
41481,4,1481,[427  79 515 588  64],716,5,6668,4.4993252361673415,40.0,0.0
41482,4,1482,[181 211 222   1 125],655,0,6668,4.496291301416049,0.0,0.0
41483,4,1483,[322  98 153 144  50],280,3,6671,4.495283018867925,0.0,20.0
41484,4,1484,[427  79 515 588  64],716,5,6676,4.495622895622896,40.0,0.0
41485,4,1485,[427  79 515 588  64],716,5,6681,4.495962314939435,40.0,0.0
41486,4,1486,[237 471 301   8 100],655,0,6681,4.492938802958978,0.0,20.0
41487,4,1487,[515  79 427 588  64],18,5,6686,4.493279569892473,40.0,0.0
41488,4,1488,[515  79 427 588  64],716,5,6691,4.493619879113499,40.0,0.0
41489,4,1489,[515  79 427 588  64],18,5,6696,4.493959731543624,40.0,0.0
41490,4,1490,[603 258 172 496   4],450,4,6700,4.493628437290409,40.0,0.0
41491,4,1491,[515  79 427 588  64],716,5,6705,4.4939678284182305,40.0,0.0
41492,4,1492,[313 237   4 216 118],593,5,6710,4.4943067649028805,0.0,0.0
41493,4,1493,[515  79 427 588  64],716,5,6715,4.494645247657296,40.0,0.0
41494,4,1494,[200   9 174 265  95],280,4,6719,4.494314381270903,0.0,0.0
41495,4,1495,[ 79 742 121 276  89],344,3,6722,4.49331550802139,0.0,0.0
41496,4,1496,[483 151 568 237  15],152,5,6727,4.493653974615898,0.0,0.0
41497,4,1497,[427 515  79 588  64],716,5,6732,4.493991989319092,40.0,0.0
41498,4,1498,[  9 135  89  50 143],457,5,6737,4.494329553035357,0.0,20.0
41499,4,1499,[427 515  79 588  64],716,5,6742,4.494666666666666,40.0,0.0
41500,4,1500,[427 515  79 588  64],18,5,6747,4.495003331112591,40.0,0.0
41501,4,1501,[427 515  79 588  64],716,5,6752,4.495339547270306,40.0,0.0
41502,4,1502,[427 515  79 588  64],18,5,6757,4.495675316034598,40.0,0.0
41503,4,1503,[427 515  79 588  64],18,5,6762,4.496010638297872,40.0,0.0
41504,4,1504,[427 515  79 588  64],18,5,6767,4.496345514950166,40.0,0.0
41505,4,1505,[427 515  79 588  64],18,5,6772,4.49667994687915,40.0,0.0
41506,4,1506,[427 515  79 588  64],18,5,6777,4.4970139349701395,40.0,0.0
41507,4,1507,[427 515  79 588  64],18,5,6782,4.497347480106101,40.0,0.0
41508,4,1508,[748  64 181 475 515],292,4,6786,4.497017892644135,20.0,0.0
41509,4,1509,[427 515  79 588  64],716,5,6791,4.497350993377483,40.0,0.0
41510,4,1510,[483   8 191 161 132],269,3,6794,4.4963600264725345,0.0,0.0
41511,4,1511,[ 15 211  89 427 187],269,3,6797,4.49537037037037,20.0,0.0
41512,4,1512,[427  79 515 588  64],716,5,6802,4.495703899537343,40.0,0.0
41513,4,1513,[175 318 655 195  12],151,4,6806,4.495376486129459,20.0,0.0
41514,4,1514,[427  79 515 588  64],716,5,6811,4.495709570957096,40.0,0.0
41515,4,1515,[427  79 515 588  64],716,5,6816,4.496042216358839,40.0,0.0
41516,4,1516,[427  79 515 588  64],716,5,6821,4.496374423203691,40.0,0.0
41517,4,1517,[172 597 423 132 194],807,5,6826,4.496706192358366,0.0,0.0
41518,4,1518,[294 173 275 568  89],450,5,6831,4.497037524687294,0.0,20.0
41519,4,1519,[427 515  79 588  64],716,5,6836,4.497368421052632,40.0,0.0
41520,4,1520,[172  79 195  98 216],18,3,6839,4.496383957922419,0.0,0.0
41521,4,1521,[ 95   7 405  71  56],885,3,6842,4.495400788436268,0.0,0.0
41522,4,1522,[427 515  79 588  64],18,5,6847,4.4957321076822065,40.0,0.0
41523,4,1523,[ 15 132 405 655 211],786,4,6851,4.495406824146982,0.0,0.0
41524,4,1524,[427 515  79 588  64],18,5,6856,4.4957377049180325,40.0,0.0
41525,4,1525,[ 79 179 191 403 742],577,4,6860,4.495412844036697,0.0,0.0
41526,4,1526,[427  79 515 588  64],716,5,6865,4.495743287491814,40.0,0.0
41527,4,1527,[427  79 515 588  64],18,5,6870,4.4960732984293195,40.0,0.0
41528,4,1528,[427  79 515 588  64],716,5,6875,4.496402877697841,40.0,0.0
41529,4,1529,[195 194 405  15 282],457,5,6880,4.496732026143791,0.0,0.0
41530,4,1530,[ 88  50 483 323 588],280,2,6882,4.495101241018942,0.0,20.0
41531,4,1531,[427  79 515 588  64],716,5,6887,4.495430809399478,40.0,0.0
41532,4,1532,[427  79 515 588  64],716,5,6892,4.495759947814743,40.0,0.0
41533,4,1533,[427  79 515 588  64],18,5,6897,4.496088657105607,40.0,0.0
41534,4,1534,[427  79 515 588  64],716,5,6902,4.496416938110749,40.0,0.0
41535,4,1535,[175 144   4 117  70],655,0,6902,4.493489583333333,0.0,0.0
41536,4,1536,[427  79 515 588  64],716,5,6907,4.493819128171763,40.0,0.0
41537,4,1537,[118 742  64 180 546],457,4,6911,4.493498049414825,20.0,0.0
41538,4,1538,[515  79 427 588  64],18,5,6916,4.493827160493828,40.0,0.0
41539,4,1539,[515  79 427 588  64],716,5,6921,4.494155844155844,40.0,0.0
41540,4,1540,[ 97 546  15 655 423],450,4,6925,4.493835171966255,0.0,0.0
41541,4,1541,[515  79 427 588  64],18,5,6930,4.494163424124514,40.0,0.0
41542,4,1542,[245 196 191 294 173],450,5,6935,4.4944912508101105,0.0,0.0
41543,4,1543,[265 318 234  22 191],577,4,6939,4.494170984455959,20.0,0.0
41544,4,1544,[515 427  79 588  64],18,5,6944,4.4944983818770226,40.0,0.0
41545,4,1545,[191 385 273  11 135],655,3,6947,4.49353169469599,0.0,0.0
41546,4,1546,[515 427  79 588  64],716,5,6952,4.493859082094376,40.0,0.0
41547,4,1547,[195 273 288   4 597],450,2,6954,4.492248062015504,0.0,0.0
41548,4,1548,[515 427  79 588  64],18,5,6959,4.492575855390575,40.0,0.0
41549,4,1549,[ 56 185 235 195 322],450,4,6963,4.492258064516129,0.0,0.0
41550,4,1550,[186 288  96 143 237],655,1,6964,4.490006447453256,0.0,0.0
41551,4,1551,[ 97 186 597 161 257],457,3,6967,4.489046391752577,0.0,0.0
41552,4,1552,[515 427  79 588  64],18,5,6972,4.489375402446877,40.0,0.0
41553,4,1553,[515 427  79 588  64],18,5,6977,4.489703989703989,40.0,0.0
41554,4,1554,[ 97   7 174  28 143],450,5,6982,4.490032154340836,0.0,0.0
41555,4,1555,[515 427  79 588  64],18,5,6987,4.490359897172237,40.0,0.0
41556,4,1556,[515 427  79 588  64],716,5,6992,4.490687219010918,40.0,0.0
41557,4,1557,[515 427  79 588  64],716,5,6997,4.491014120667522,40.0,0.0
41558,4,1558,[515 427  79 588  64],716,5,7002,4.4913406029506096,40.0,0.0
41559,4,1559,[515 427  79 588  64],716,5,7007,4.491666666666666,40.0,0.0
41560,4,1560,[515 427  79 588  64],18,5,7012,4.491992312620115,40.0,0.0
41561,4,1561,[515 427  79 588  64],18,5,7017,4.492317541613316,40.0,0.0
41562,4,1562,[  1 257 294 385 328],401,1,7018,4.490083173384517,0.0,0.0
41563,4,1563,[546 405 403  12  69],280,3,7021,4.489130434782608,0.0,0.0
41564,4,1564,[515  79 427 588  64],18,5,7026,4.489456869009585,40.0,0.0
41565,4,1565,[515  79 427 588  64],716,5,7031,4.48978288633461,40.0,0.0
41566,4,1566,[174 546 238 121 185],450,4,7035,4.489470325462667,0.0,0.0
41567,4,1567,[515  79 427 588  64],18,5,7040,4.489795918367347,40.0,0.0
41568,4,1568,[515  79 427 588  64],716,5,7045,4.490121096239643,40.0,0.0
41569,4,1569,[515  79 427 588  64],18,5,7050,4.490445859872612,40.0,0.0
41570,4,1570,[318 216 132 186 175],18,5,7055,4.490770210057288,20.0,0.0
41571,4,1571,[515  79 427 588  64],18,5,7060,4.4910941475826975,40.0,0.0
41572,4,1572,[515  79 427 588  64],18,5,7065,4.491417673235855,40.0,0.0
41573,4,1573,[ 71 271 322 300 211],796,3,7068,4.490470139771284,0.0,0.0
41574,4,1574,[515  79 427 588  64],716,5,7073,4.490793650793651,40.0,0.0
41575,4,1575,[515  79 427 588  64],716,5,7078,4.491116751269035,40.0,0.0
41576,4,1576,[515  79 427 588  64],716,5,7083,4.49143944197844,40.0,0.0
41577,4,1577,[515  79 427 588  64],716,5,7088,4.491761723700887,40.0,0.0
41578,4,1578,[515  79 427 588  64],716,5,7093,4.492083597213426,40.0,0.0
41579,4,1579,[515  79 427 588  64],18,5,7098,4.492405063291139,40.0,0.0
41580,4,1580,[ 15 215  69  71 471],577,3,7101,4.49146110056926,0.0,0.0
41581,4,1581,[423 265 318 385 234],280,4,7105,4.491150442477876,20.0,0.0
41582,4,1582,[515  79 427 588  64],18,5,7110,4.491471888818698,40.0,0.0
41583,4,1583,[515  79 427 588  64],18,5,7115,4.491792929292929,40.0,0.0
41584,4,1584,[117 173 186  95  71],885,5,7120,4.492113564668769,0.0,0.0
41585,4,1585,[568   1 302   7 117],655,1,7121,4.489911727616645,0.0,0.0
41586,4,1586,[210  96 197 215 597],457,4,7125,4.489603024574669,0.0,0.0
41587,4,1587,[427 515  79 588  64],716,5,7130,4.48992443324937,40.0,0.0
41588,4,1588,[302 748 228 238 300],450,5,7135,4.4902454373820015,0.0,0.0
41589,4,1589,[ 79 515 427 588  64],18,5,7140,4.490566037735849,40.0,0.0
41590,4,1590,[ 79 515 427 588  64],18,5,7145,4.490886235072281,40.0,0.0
41591,4,1591,[ 79 515 427 588  64],716,5,7150,4.491206030150754,40.0,0.0
41592,4,1592,[597 172 269 222   9],796,3,7153,4.490269930947897,0.0,0.0
41593,4,1593,[ 79 515 427 588  64],18,5,7158,4.490589711417817,40.0,0.0
41594,4,1594,[ 79 515 427 588  64],18,5,7163,4.490909090909091,40.0,0.0
41595,4,1595,[ 79 515 427 588  64],716,5,7168,4.491228070175438,40.0,0.0
41596,4,1596,[ 79 515 427 588  64],18,5,7173,4.491546649968691,40.0,0.0
41597,4,1597,[ 79 515 427 588  64],716,5,7178,4.491864831038798,40.0,0.0
41598,4,1598,[ 79 515 427 588  64],716,5,7183,4.492182614133833,40.0,0.0
41599,4,1599,[ 79 515 427 588  64],716,5,7188,4.4925,40.0,0.0
41600,4,1600,[ 79 515 427 588  64],18,5,7193,4.4928169893816365,40.0,0.0
41601,4,1601,[ 79 515 427 588  64],716,5,7198,4.493133583021224,40.0,0.0
41602,4,1602,[ 79 515 427 588  64],716,5,7203,4.493449781659389,40.0,0.0
41603,4,1603,[ 79 515 427 588  64],18,5,7208,4.493765586034913,40.0,0.0
41604,4,1604,[ 79 515 427 588  64],716,5,7213,4.494080996884735,40.0,0.0
41605,4,1605,[ 79 515 427 588  64],18,5,7218,4.49439601494396,40.0,0.0
41606,4,1606,[161   4  15  97  28],786,4,7222,4.494088363410081,0.0,0.0
41607,4,1607,[195 568 197 118 588],796,4,7226,4.493781094527363,0.0,0.0
41608,4,1608,[ 79 515 427 588  64],716,5,7231,4.494095711622125,40.0,0.0
41609,4,1609,[ 79 515 427 588  64],716,5,7236,4.494409937888198,40.0,0.0
41610,4,1610,[265 435 200   9  79],655,2,7238,4.492861576660459,0.0,0.0
41611,4,1611,[  4 427 273 215 318],796,4,7242,4.492555831265508,40.0,0.0
41612,4,1612,[ 79 515 427 588  64],716,5,7247,4.492870427774333,40.0,0.0
41613,4,1613,[ 79 515 427 588  64],18,5,7252,4.493184634448575,40.0,0.0
41614,4,1614,[ 79 515 427 588  64],716,5,7257,4.493498452012384,40.0,0.0
41615,4,1615,[ 79 515 427 588  64],716,5,7262,4.493811881188119,40.0,0.0
41616,4,1616,[ 79 515 427 588  64],716,5,7267,4.4941249226963516,40.0,0.0
41617,4,1617,[ 79 515 427 588  64],18,5,7272,4.494437577255871,40.0,0.0
41618,4,1618,[195 265   4 275  56],457,5,7277,4.494749845583693,0.0,20.0
41619,4,1619,[  9 235 118  50 302],344,3,7280,4.493827160493828,0.0,20.0
41620,4,1620,[427 515  79 588  64],716,5,7285,4.4941394201110425,40.0,0.0
41621,4,1621,[427 515  79 588  64],18,5,7290,4.494451294697904,40.0,0.0
41622,4,1622,[427 515  79 588  64],18,5,7295,4.494762784966112,40.0,0.0
41623,4,1623,[125  12 301 228 118],796,4,7299,4.494458128078818,0.0,0.0
41624,4,1624,[427 515  79 588  64],716,5,7304,4.494769230769231,40.0,0.0
41625,4,1625,[427 515  79 588  64],18,5,7309,4.495079950799508,40.0,0.0
41626,4,1626,[ 56 111 222 100 546],796,4,7313,4.494775660725261,0.0,20.0
41627,4,1627,[143 118  96 385 286],796,4,7317,4.494471744471745,0.0,20.0
41628,4,1628,[  8  70  11 121 153],330,5,7322,4.494782074892572,0.0,0.0
41629,4,1629,[427 515  79 588  64],18,5,7327,4.495092024539877,40.0,0.0
41630,4,1630,[197  82 132 742 588],457,5,7332,4.495401594114041,0.0,0.0
41631,4,1631,[427 515  79 588  64],716,5,7337,4.495710784313726,40.0,0.0
41632,4,1632,[405 172 568 238 435],269,1,7338,4.493570116350275,0.0,0.0
41633,4,1633,[323 127 678  15 385],256,5,7343,4.493880048959609,0.0,20.0
41634,4,1634,[237 202 427 328 222],796,5,7348,4.494189602446483,20.0,0.0
41635,4,1635,[427 515  79 588  64],716,5,7353,4.494498777506112,40.0,0.0
41636,4,1636,[  4 180 100 276 168],535,3,7356,4.493585827733659,0.0,20.0
41637,4,1637,[427 515  79 588  64],716,5,7361,4.493894993894994,40.0,0.0
41638,4,1638,[427 515  79 588  64],18,5,7366,4.494203782794387,40.0,0.0
41639,4,1639,[427 515  79 588  64],18,5,7371,4.494512195121951,40.0,0.0
41640,4,1640,[427 515  79 588  64],18,5,7376,4.494820231566118,40.0,0.0
41641,4,1641,[427 515  79 588  64],18,5,7381,4.495127892813642,40.0,0.0
41642,4,1642,[427 515  79 588  64],716,5,7386,4.495435179549604,40.0,0.0
41643,4,1643,[427 515  79 588  64],716,5,7391,4.495742092457421,40.0,0.0
41644,4,1644,[427 515  79 588  64],18,5,7396,4.496048632218845,40.0,0.0
41645,4,1645,[427 515  79 588  64],716,5,7401,4.496354799513973,40.0,0.0
41646,4,1646,[186 403 132 655 483],450,3,7404,4.495446265938069,0.0,0.0
41647,4,1647,[427 515  79 588  64],18,5,7409,4.495752427184466,40.0,0.0
41648,4,1648,[427 515  79 588  64],716,5,7414,4.4960582171012735,40.0,0.0
41649,4,1649,[427 515  79 588  64],716,5,7419,4.496363636363636,40.0,0.0
41650,4,1650,[496   4 357 568 181],344,4,7423,4.496062992125984,20.0,0.0
41651,4,1651,[427 515  79 588  64],716,5,7428,4.49636803874092,40.0,0.0
41652,4,1652,[ 96 211 275 168 186],796,3,7431,4.49546279491833,0.0,20.0
41653,4,1653,[427 515  79 588  64],716,5,7436,4.495767835550182,40.0,0.0
41654,4,1654,[211 191 186   4 172],707,1,7437,4.493655589123867,0.0,0.0
41655,4,1655,[427 515  79 588  64],716,5,7442,4.493961352657005,40.0,0.0
41656,4,1656,[427 515  79 588  64],716,5,7447,4.4942667471333735,40.0,0.0
41657,4,1657,[427 515  79 588  64],716,5,7452,4.4945717732207475,40.0,0.0
41658,4,1658,[427 515  79 588  64],716,5,7457,4.4948764315852925,40.0,0.0
41659,4,1659,[427 515  79 588  64],18,5,7462,4.495180722891567,40.0,0.0
41660,4,1660,[427 515  79 588  64],18,5,7467,4.495484647802528,40.0,0.0
41661,4,1661,[427 515  79 588  64],716,5,7472,4.495788206979543,40.0,0.0
41662,4,1662,[427 515  79 588  64],18,5,7477,4.496091401082381,40.0,0.0
41663,4,1663,[427 515  79 588  64],716,5,7482,4.496394230769231,40.0,0.0
41664,4,1664,[144 183 222 588 200],280,2,7484,4.494894894894895,0.0,0.0
41665,4,1665,[427 515  79 588  64],18,5,7489,4.495198079231693,40.0,0.0
41666,4,1666,[357  28   1 194  96],796,3,7492,4.494301139772046,0.0,0.0
41667,4,1667,[427 515  79 588  64],18,5,7497,4.494604316546763,40.0,0.0
41668,4,1668,[655 357 118 151  69],457,5,7502,4.494907130017975,0.0,0.0
41669,4,1669,[195 172 168 471 385],807,4,7506,4.494610778443114,0.0,0.0
41670,4,1670,[427 515  79 588  64],18,5,7511,4.494913225613405,40.0,0.0
41671,4,1671,[427 515  79 588  64],18,5,7516,4.4952153110047846,40.0,0.0
41672,4,1672,[427 515  79 588  64],716,5,7521,4.49551703526599,40.0,0.0
41673,4,1673,[427 515  79 588  64],18,5,7526,4.4958183990442055,40.0,0.0
41674,4,1674,[427 515  79 588  64],18,5,7531,4.496119402985075,40.0,0.0
41675,4,1675,[427 515  79 588  64],18,5,7536,4.4964200477326965,40.0,0.0
41676,4,1676,[ 25 194 435 748 100],450,4,7540,4.496124031007752,0.0,20.0
41677,4,1677,[ 82   8 294 423  89],796,3,7543,4.495232419547079,0.0,0.0
41678,4,1678,[237   9 174 405 742],280,2,7545,4.493746277546158,0.0,0.0
41679,4,1679,[ 79 427 515 588  64],716,5,7550,4.494047619047619,40.0,0.0
41680,4,1680,[ 79 427 515 588  64],18,5,7555,4.4943486020226056,40.0,0.0
41681,4,1681,[328 182 273 748  82],796,3,7558,4.49346016646849,0.0,0.0
41682,4,1682,[202 269  50 546 204],450,5,7563,4.493761140819965,0.0,20.0
41683,4,1683,[ 82 202 423  71 132],786,5,7568,4.494061757719715,0.0,0.0
41684,4,1684,[ 79 427 515 588  64],716,5,7573,4.494362017804154,40.0,0.0
41685,4,1685,[ 79 427 515 588  64],18,5,7578,4.494661921708185,40.0,0.0
41686,4,1686,[423  25 322 405 546],151,2,7580,4.4931831653823355,0.0,0.0
41687,4,1687,[427 515  79 588  64],18,5,7585,4.493483412322274,40.0,0.0
41688,4,1688,[496 210 127 748 234],796,3,7588,4.492599171107164,20.0,20.0
41689,4,1689,[427 515  79 588  64],716,5,7593,4.492899408284024,40.0,0.0
41690,4,1690,[ 96  50 301 181 195],344,4,7597,4.492607924305145,0.0,20.0
41691,4,1691,[275 568  98 286  71],389,3,7600,4.491725768321513,0.0,40.0
41692,4,1692,[ 71  96  82 294 357],23,1,7601,4.489663319551092,0.0,0.0
41693,4,1693,[515  79 427 588  64],18,5,7606,4.4899645808736715,40.0,0.0
41694,4,1694,[403 275 235 238 179],450,4,7610,4.489675516224189,0.0,20.0
41695,4,1695,[427 515  79 588  64],18,5,7615,4.48997641509434,40.0,0.0
41696,4,1696,[210  89 182 238 403],450,4,7619,4.489687684148497,0.0,0.0
41697,4,1697,[200 222 144 216  69],280,3,7622,4.488810365135453,0.0,0.0
41698,4,1698,[427 515  79 588  64],716,5,7627,4.489111241907004,40.0,0.0
41699,4,1699,[ 50 302 118 132 405],450,4,7631,4.488823529411765,0.0,20.0
41700,4,1700,[ 79 427 515 588  64],18,5,7636,4.4891240446796,40.0,0.0
41701,4,1701,[ 79 427 515 588  64],18,5,7641,4.489424206815511,40.0,0.0
41702,4,1702,[ 79 427 515 588  64],716,5,7646,4.489724016441573,40.0,0.0
41703,4,1703,[ 79 427 515 588  64],716,5,7651,4.490023474178404,40.0,0.0
41704,4,1704,[ 79 427 515 588  64],18,5,7656,4.490322580645161,40.0,0.0
41705,4,1705,[ 79 427 515 588  64],716,5,7661,4.490621336459554,40.0,0.0
41706,4,1706,[237 153 135 427  50],18,3,7664,4.489748096074985,20.0,20.0
41707,4,1707,[475 238 211 318 276],655,2,7666,4.4882903981264635,20.0,0.0
41708,4,1708,[515  79 427 588  64],716,5,7671,4.488589818607373,40.0,0.0
41709,4,1709,[ 11 143  98 403 121],450,4,7675,4.488304093567251,0.0,0.0
41710,4,1710,[515  79 427 588  64],716,5,7680,4.488603156049094,40.0,0.0
41711,4,1711,[515  79 427 588  64],716,5,7685,4.4889018691588785,40.0,0.0
41712,4,1712,[235   1 173 176 216],280,3,7688,4.488032691185055,0.0,0.0
41713,4,1713,[ 79 427 515 588  64],18,5,7693,4.48833138856476,40.0,0.0
41714,4,1714,[ 79 427 515 588  64],716,5,7698,4.48862973760933,40.0,0.0
41715,4,1715,[  4 234  98 275 196],450,3,7701,4.4877622377622375,0.0,20.0
41716,4,1716,[ 79 427 515 588  64],716,5,7706,4.488060570762959,40.0,0.0
41717,4,1717,[ 79 427 515 588  64],18,5,7711,4.488358556461002,40.0,0.0
41718,4,1718,[ 79 427 515 588  64],18,5,7716,4.488656195462478,40.0,0.0
41719,4,1719,[235 195  98   8 546],344,3,7719,4.487790697674418,0.0,0.0
41720,4,1720,[ 79 427 515 588  64],716,5,7724,4.488088320743754,40.0,0.0
41721,4,1721,[427 483 282  56   4],450,3,7727,4.487224157955866,20.0,0.0
41722,4,1722,[ 69   7 151 318 588],457,5,7732,4.48752176436448,20.0,0.0
41723,4,1723,[ 79 427 515 588  64],716,5,7737,4.487819025522041,40.0,0.0
41724,4,1724,[ 79 427 515 588  64],18,5,7742,4.488115942028985,40.0,0.0
41725,4,1725,[245 742 258 294 121],796,2,7744,4.486674391657011,0.0,0.0
41726,4,1726,[ 50 318  25 168 742],504,4,7748,4.486392588303416,20.0,20.0
41727,4,1727,[515  79 427 588  64],18,5,7753,4.486689814814815,40.0,0.0
41728,4,1728,[515  79 427 588  64],716,5,7758,4.4869866975130135,40.0,0.0
41729,4,1729,[257 183  88  12 655],457,4,7762,4.486705202312138,0.0,0.0
41730,4,1730,[515  79 427 588  64],18,5,7767,4.487001733102253,40.0,0.0
41731,4,1731,[471  98 186 276 289],655,2,7769,4.485565819861431,0.0,0.0
41732,4,1732,[515  79 427 588  64],18,5,7774,4.4858626658972875,40.0,0.0
41733,4,1733,[144  15  50  64 258],796,5,7779,4.486159169550173,20.0,20.0
41734,4,1734,[515  79 427 588  64],716,5,7784,4.486455331412103,40.0,0.0
41735,4,1735,[515  79 427 588  64],18,5,7789,4.486751152073733,40.0,0.0
41736,4,1736,[172 181  64 678 268],344,2,7791,4.485319516407599,20.0,0.0
41737,4,1737,[515  79 427 588  64],18,5,7796,4.485615650172612,40.0,0.0
41738,4,1738,[515  79 427 588  64],18,5,7801,4.485911443358252,40.0,0.0
41739,4,1739,[515  79 427 588  64],716,5,7806,4.4862068965517246,40.0,0.0
41740,4,1740,[515  79 427 588  64],716,5,7811,4.486502010338886,40.0,0.0
41741,4,1741,[515  79 427 588  64],716,5,7816,4.486796785304248,40.0,0.0
41742,4,1742,[515  79 427 588  64],716,5,7821,4.487091222030981,40.0,0.0
41743,4,1743,[515  79 427 588  64],716,5,7826,4.487385321100917,40.0,0.0
41744,4,1744,[515  79 427 588  64],18,5,7831,4.487679083094556,40.0,0.0
41745,4,1745,[515  79 427 588  64],18,5,7836,4.487972508591065,40.0,0.0
41746,4,1746,[515  79 427 588  64],18,5,7841,4.488265598168288,40.0,0.0
41747,4,1747,[183 153 357 215 185],23,2,7843,4.4868421052631575,0.0,0.0
41748,4,1748,[515  79 427 588  64],18,5,7848,4.487135506003431,40.0,0.0
41749,4,1749,[515  79 427 588  64],716,5,7853,4.4874285714285715,40.0,0.0
41750,4,1750,[210 655  88   7 194],577,2,7855,4.486007995431182,0.0,0.0
41751,4,1751,[ 11 496 238 132  22],330,5,7860,4.486301369863014,20.0,0.0
41752,4,1752,[515  79 427 588  64],716,5,7865,4.486594409583571,40.0,0.0
41753,4,1753,[515  79 427 588  64],716,5,7870,4.486887115165336,40.0,0.0
41754,4,1754,[515  79 427 588  64],716,5,7875,4.487179487179487,40.0,0.0
41755,4,1755,[515  79 427 588  64],716,5,7880,4.4874715261958995,40.0,0.0
41756,4,1756,[100 435  28   4 151],18,2,7882,4.48605577689243,0.0,20.0
41757,4,1757,[ 79 427 515 588  64],716,5,7887,4.486348122866894,40.0,0.0
41758,4,1758,[  1   4   9 222 176],655,0,7887,4.483797612279704,0.0,0.0
41759,4,1759,[427  79 515 588  64],18,5,7892,4.484090909090909,40.0,0.0
41760,4,1760,[496 181 168   7 186],151,5,7897,4.484383872799546,20.0,0.0
41761,4,1761,[427  79 515 588  64],18,5,7902,4.484676503972758,40.0,0.0
41762,4,1762,[427  79 515 588  64],18,5,7907,4.484968803176404,40.0,0.0
41763,4,1763,[238 216 111 257 210],796,3,7910,4.484126984126984,0.0,0.0
41764,4,1764,[ 25 204  28 238 275],330,5,7915,4.484419263456091,0.0,20.0
41765,4,1765,[483 181 173 568 496],280,2,7917,4.483012457531144,20.0,0.0
41766,4,1766,[271 222 275 211 144],655,1,7918,4.481041312959819,0.0,20.0
41767,4,1767,[185  97  11 405  56],11,3,7921,4.480203619909502,0.0,0.0
41768,4,1768,[118 403 288 216  50],280,2,7923,4.47880158281515,0.0,20.0
41769,4,1769,[427  79 515 588  64],18,5,7928,4.47909604519774,40.0,0.0
41770,4,1770,[427  79 515 588  64],716,5,7933,4.479390175042349,40.0,0.0
41771,4,1771,[427  79 515 588  64],18,5,7938,4.479683972911964,40.0,0.0
41772,4,1772,[483 210 211  97 117],655,1,7939,4.4777213761985335,0.0,0.0
41773,4,1773,[282 403  97 195 197],796,3,7942,4.476888387824126,0.0,0.0
41774,4,1774,[427  79 515 588  64],716,5,7947,4.477183098591549,40.0,0.0
41775,4,1775,[427  79 515 588  64],18,5,7952,4.4774774774774775,40.0,0.0
41776,4,1776,[427  79 515 588  64],716,5,7957,4.477771525042206,40.0,0.0
41777,4,1777,[427  79 515 588  64],18,5,7962,4.478065241844769,40.0,0.0
41778,4,1778,[427  79 515 588  64],716,5,7967,4.478358628442946,40.0,0.0
41779,4,1779,[ 64 168  89 288 183],457,5,7972,4.478651685393259,20.0,0.0
41780,4,1780,[211 185 172 183 288],655,3,7975,4.477821448624368,0.0,0.0
41781,4,1781,[181   9  50 603 427],655,3,7978,4.47699214365881,40.0,20.0
41782,4,1782,[427  79 515 588  64],716,5,7983,4.477285473920359,40.0,0.0
41783,4,1783,[427  79 515 588  64],18,5,7988,4.477578475336323,40.0,0.0
41784,4,1784,[597 427 318 588  89],450,5,7993,4.477871148459384,40.0,0.0
41785,4,1785,[427  79 515 588  64],716,5,7998,4.478163493840985,40.0,0.0
41786,4,1786,[121 265  15 117 111],450,3,8001,4.477336317851147,0.0,0.0
41787,4,1787,[ 50  11 588 678 405],401,0,8001,4.474832214765101,0.0,20.0
41788,4,1788,[ 79 427 515  64 588],18,5,8006,4.475125768585802,40.0,0.0
41789,4,1789,[ 79 427 515  64 588],18,5,8011,4.475418994413408,40.0,0.0
41790,4,1790,[ 79 427 515  64 588],18,5,8016,4.47571189279732,40.0,0.0
41791,4,1791,[ 79 427 515  64 588],18,5,8021,4.476004464285714,40.0,0.0
41792,4,1792,[ 79 427 515  64 588],18,5,8026,4.476296709425544,40.0,0.0
41793,4,1793,[ 79 427 515  64 588],716,5,8031,4.476588628762542,40.0,0.0
41794,4,1794,[276 180 258 435 173],535,4,8035,4.476323119777159,0.0,0.0
41795,4,1795,[515  79 427  64 588],716,5,8040,4.476614699331849,40.0,0.0
41796,4,1796,[ 71 181 678 515 100],401,2,8042,4.475236505286588,0.0,20.0
41797,4,1797,[175 568 132 191 143],269,3,8045,4.4744160177975525,0.0,0.0
41798,4,1798,[153 185 403  88 275],330,5,8050,4.474708171206226,0.0,20.0
41799,4,1799,[515 427  79  64 588],18,5,8055,4.475,40.0,0.0
41800,4,1800,[328 597 496 215   8],796,5,8060,4.4752915047196,20.0,0.0
41801,4,1801,[118 275 603   4  50],716,3,8063,4.474472807991121,20.0,40.0
41802,4,1802,[515 427  79  64 588],716,5,8068,4.474764281752634,40.0,0.0
41803,4,1803,[515 427  79  64 588],716,5,8073,4.475055432372505,40.0,0.0
41804,4,1804,[515 427  79  64 588],18,5,8078,4.475346260387812,40.0,0.0
41805,4,1805,[515 427  79  64 588],18,5,8083,4.475636766334441,40.0,0.0
41806,4,1806,[515 427  79  64 588],18,5,8088,4.475926950747095,40.0,0.0
41807,4,1807,[515 427  79  64 588],716,5,8093,4.476216814159292,40.0,0.0
41808,4,1808,[748 125  71 168 483],796,5,8098,4.476506357103372,0.0,0.0
41809,4,1809,[ 79 427 515  64 588],716,5,8103,4.4767955801104975,40.0,0.0
41810,4,1810,[ 79 427 515  64 588],716,5,8108,4.477084483710657,40.0,0.0
41811,4,1811,[286  69 111 185 204],401,3,8111,4.47626931567329,0.0,20.0
41812,4,1812,[ 79 427 515  64 588],716,5,8116,4.476558190843905,40.0,0.0
41813,4,1813,[ 4 70 98 56  8],535,2,8118,4.475192943770672,0.0,0.0
41814,4,1814,[ 79 427 515  64 588],18,5,8123,4.475482093663912,40.0,0.0
41815,4,1815,[ 79 427 515  64 588],716,5,8128,4.475770925110132,40.0,0.0
41816,4,1816,[ 79 427 515  64 588],18,5,8133,4.4760594386351125,40.0,0.0
41817,4,1817,[237 275 172 435  64],401,2,8135,4.474697469746975,20.0,20.0
41818,4,1818,[ 79 427 515 588 318],716,5,8140,4.4749862561847165,40.0,0.0
41819,4,1819,[ 79 427 515 588 318],716,5,8145,4.475274725274725,40.0,0.0
41820,4,1820,[288 216   4 237  50],655,2,8147,4.473915431081823,0.0,20.0
41821,4,1821,[176 118 202 597 132],344,3,8150,4.473106476399561,0.0,0.0
41822,4,1822,[427  79 515 588 318],18,5,8155,4.473395501919912,40.0,0.0
41823,4,1823,[427  79 515 588 318],716,5,8160,4.473684210526316,40.0,0.0
41824,4,1824,[427  79 515 588 318],807,5,8165,4.473972602739726,40.0,0.0
41825,4,1825,[427  79 515 588 318],716,5,8170,4.474260679079956,40.0,0.0
41826,4,1826,[427  79 515 588 318],716,5,8175,4.474548440065681,40.0,0.0
41827,4,1827,[427  79 515 588 318],807,5,8180,4.474835886214442,40.0,0.0
41828,4,1828,[427  79 515 588 318],716,5,8185,4.4751230180426464,40.0,0.0
41829,4,1829,[427  79 515 588 318],716,5,8190,4.475409836065574,40.0,0.0
41830,4,1830,[427  79 515 588 318],18,5,8195,4.475696340797379,40.0,0.0
41831,4,1831,[427  79 515 588 318],716,5,8200,4.475982532751091,40.0,0.0
41832,4,1832,[427  79 515 588 318],18,5,8205,4.476268412438626,40.0,0.0
41833,4,1833,[427  79 515 588 318],807,5,8210,4.476553980370774,40.0,0.0
41834,4,1834,[471  88 211 271 273],655,1,8211,4.474659400544959,0.0,0.0
41835,4,1835,[144 135   7 288  28],292,3,8214,4.473856209150327,0.0,0.0
41836,4,1836,[427  79 515 588 318],18,5,8219,4.474142623843223,40.0,0.0
41837,4,1837,[427  79 515 588 318],18,5,8224,4.47442872687704,40.0,0.0
41838,4,1838,[427  79 515 588 318],716,5,8229,4.474714518760195,40.0,0.0
41839,4,1839,[427  79 515 588 318],807,5,8234,4.475,40.0,0.0
41840,4,1840,[427  79 515 588 318],807,5,8239,4.475285171102661,40.0,0.0
41841,4,1841,[742 186   9 597 132],457,4,8243,4.475027144408252,0.0,0.0
41842,4,1842,[427  79 515 588 318],18,5,8248,4.475311991318502,40.0,0.0
41843,4,1843,[427  79 515 588 318],807,5,8253,4.475596529284165,40.0,0.0
41844,4,1844,[427  79 515 588 318],807,5,8258,4.475880758807588,40.0,0.0
41845,4,1845,[211 215  97 275 294],655,1,8259,4.473997833152763,0.0,20.0
41846,4,1846,[427  79 515 588 318],807,5,8264,4.47428262046562,40.0,0.0
41847,4,1847,[427  79 515 588 318],716,5,8269,4.4745670995671,40.0,0.0
41848,4,1848,[427  79 515 588 318],807,5,8274,4.4748512709572745,40.0,0.0
41849,4,1849,[196 228 191 257  69],796,5,8279,4.475135135135135,0.0,0.0
41850,4,1850,[427  79 515 588 318],807,5,8284,4.475418692598596,40.0,0.0
41851,4,1851,[427  79 515 588 318],807,5,8289,4.475701943844492,40.0,0.0
41852,4,1852,[427  79 515 588 318],716,5,8294,4.475984889368592,40.0,0.0
41853,4,1853,[427  79 515 588 318],18,5,8299,4.476267529665588,40.0,0.0
41854,4,1854,[427  79 515 588 318],807,5,8304,4.476549865229111,40.0,0.0
41855,4,1855,[427  79 515 588 318],807,5,8309,4.476831896551724,40.0,0.0
41856,4,1856,[427  79 515 588 318],716,5,8314,4.477113624124932,40.0,0.0
41857,4,1857,[427  79 515 588 318],716,5,8319,4.477395048439182,40.0,0.0
41858,4,1858,[200 195 135 588 603],716,3,8322,4.476600322754169,20.0,0.0
41859,4,1859,[508 175 282 475 204],655,0,8322,4.474193548387097,0.0,0.0
41860,4,1860,[427 515  79 588 318],716,5,8327,4.474476088124664,40.0,0.0
41861,4,1861,[168 100  88  25 435],450,4,8331,4.47422126745435,0.0,20.0
41862,4,1862,[427 515  79 588 318],716,5,8336,4.474503488996243,40.0,0.0
41863,4,1863,[427 515  79 588 318],18,5,8341,4.474785407725322,40.0,0.0
41864,4,1864,[132 748  22   4 568],796,5,8346,4.475067024128687,0.0,0.0
41865,4,1865,[313 151 127 238  11],450,5,8351,4.47534833869239,0.0,20.0
41866,4,1866,[427 515  79 588 318],18,5,8356,4.475629351901446,40.0,0.0
41867,4,1867,[186 271 196 121 135],655,1,8357,4.4737687366167025,0.0,0.0
41868,4,1868,[ 69 405 144 748 313],450,5,8362,4.474050294275013,0.0,0.0
41869,4,1869,[322   4  82  71 127],796,3,8365,4.473262032085562,0.0,20.0
41870,4,1870,[427  79 515 588 318],18,5,8370,4.4735435595938,40.0,0.0
41871,4,1871,[427  79 515 588 318],18,5,8375,4.473824786324786,40.0,0.0
41872,4,1872,[427  79 515 588 318],18,5,8380,4.474105712760277,40.0,0.0
41873,4,1873,[276 597 196 222 678],344,3,8383,4.473319103521878,0.0,0.0
41874,4,1874,[427  79 515 588 318],18,5,8388,4.4736,40.0,0.0
41875,4,1875,[427  79 515 588 318],18,5,8393,4.473880597014926,40.0,0.0
41876,4,1876,[427  79 515 588 318],716,5,8398,4.474160895045285,40.0,0.0
41877,4,1877,[180  50 269 427 234],796,2,8400,4.472843450479234,20.0,20.0
41878,4,1878,[202  70 204  79  15],457,5,8405,4.473124002128792,0.0,0.0
41879,4,1879,[427  79 515 588 318],18,5,8410,4.473404255319149,40.0,0.0
41880,4,1880,[211  12 427  88  95],450,4,8414,4.473152578415736,20.0,0.0
41881,4,1881,[172   9 135 508   7],269,3,8417,4.472369819341126,0.0,0.0
41882,4,1882,[181 318 168 655 176],716,4,8421,4.4721189591078065,20.0,0.0
41883,4,1883,[427  79 515 588 318],807,5,8426,4.4723991507431,40.0,0.0
41884,4,1884,[427  79 515 588 318],716,5,8431,4.472679045092838,40.0,0.0
41885,4,1885,[423  15 655 172  22],655,1,8432,4.47083775185578,0.0,0.0
41886,4,1886,[176 318 216 153 655],236,2,8434,4.469528351881293,20.0,0.0
41887,4,1887,[427 515  79 588 318],18,5,8439,4.469809322033898,40.0,0.0
41888,4,1888,[275 216   4 483 568],716,4,8443,4.469560614081525,0.0,20.0
41889,4,1889,[ 56 515 300 282 471],655,1,8444,4.4677248677248675,0.0,0.0
41890,4,1890,[ 70 301 403 237 117],450,5,8449,4.4680063458487576,0.0,0.0
41891,4,1891,[483  28 258 286 385],796,3,8452,4.46723044397463,0.0,20.0
41892,4,1892,[186 294 151 742 403],504,2,8454,4.4659270998415215,0.0,0.0
41893,4,1893,[515 427  79 588 318],18,5,8459,4.466209081309398,40.0,0.0
41894,4,1894,[515 427  79 588 318],716,5,8464,4.466490765171504,40.0,0.0
41895,4,1895,[515 427  79 588 318],18,5,8469,4.466772151898734,40.0,0.0
41896,4,1896,[173 111  64 475 435],629,5,8474,4.467053241960991,20.0,0.0
41897,4,1897,[515 427  79 588 318],807,5,8479,4.467334035827187,40.0,0.0
41898,4,1898,[515 427  79 588 318],716,5,8484,4.467614533965245,40.0,0.0
41899,4,1899,[515 427  79 588 318],807,5,8489,4.467894736842105,40.0,0.0
41900,4,1900,[515 427  79 588 318],716,5,8494,4.4681746449237245,40.0,0.0
41901,4,1901,[515 427  79 588 318],18,5,8499,4.468454258675079,40.0,0.0
41902,4,1902,[173 403   1 546  50],577,4,8503,4.468208092485549,0.0,20.0
41903,4,1903,[204 508 655 153 132],269,3,8506,4.467436974789916,0.0,0.0
41904,4,1904,[ 79 427 515 588 318],18,5,8511,4.467716535433071,40.0,0.0
41905,4,1905,[  4 187 385 185  25],655,2,8513,4.466421825813222,0.0,0.0
41906,4,1906,[427 515  79 588 318],807,5,8518,4.4667016255899314,40.0,0.0
41907,4,1907,[179  69  50 405 228],786,5,8523,4.466981132075472,0.0,20.0
41908,4,1908,[427 515  79 588 318],807,5,8528,4.467260345730749,40.0,0.0
41909,4,1909,[427 515  79 588 318],18,5,8533,4.467539267015707,40.0,0.0
41910,4,1910,[427 515  79 588 318],716,5,8538,4.467817896389325,40.0,0.0
41911,4,1911,[234 202  50 183 125],577,4,8542,4.4675732217573225,0.0,20.0
41912,4,1912,[427 515  79 588 318],807,5,8547,4.467851542080502,40.0,0.0
41913,4,1913,[427 515  79 588 318],18,5,8552,4.4681295715778475,40.0,0.0
41914,4,1914,[427 515  79 588 318],716,5,8557,4.4684073107049604,40.0,0.0
41915,4,1915,[427 515  79 588 318],807,5,8562,4.468684759916493,40.0,0.0
41916,4,1916,[168 257 471 176 742],457,4,8566,4.4684402712571725,0.0,0.0
41917,4,1917,[183 427 202   4 546],450,4,8570,4.468196037539103,20.0,0.0
41918,4,1918,[427 515  79 588 318],716,5,8575,4.468473163105784,40.0,0.0
41919,4,1919,[172 435 300 403  88],450,5,8580,4.46875,0.0,0.0
41920,4,1920,[427 515  79 588 318],18,5,8585,4.469026548672566,40.0,0.0
41921,4,1921,[427 515  79 588 318],716,5,8590,4.469302809573361,40.0,0.0
41922,4,1922,[427 515  79 588 318],18,5,8595,4.469578783151326,40.0,0.0
41923,4,1923,[427 515  79 588 318],807,5,8600,4.46985446985447,40.0,0.0
41924,4,1924,[ 95 187 211 111 100],450,4,8604,4.46961038961039,0.0,20.0
41925,4,1925,[194 202 186 215 222],716,4,8608,4.469366562824507,0.0,0.0
41926,4,1926,[234 117  70 196  88],457,5,8613,4.469641930461858,0.0,0.0
41927,4,1927,[427 515  79 588 318],807,5,8618,4.469917012448133,40.0,0.0
41928,4,1928,[427 515  79 588 318],807,5,8623,4.470191809227579,40.0,0.0
41929,4,1929,[117 202 588  97 216],330,5,8628,4.470466321243523,0.0,0.0
41930,4,1930,[234  98 121 268 333],655,1,8629,4.468669083376489,0.0,0.0
41931,4,1931,[515 427  79 588 318],716,5,8634,4.468944099378882,40.0,0.0
41932,4,1932,[515 427  79 588 318],18,5,8639,4.469218830832903,40.0,0.0
41933,4,1933,[515 427  79 588 318],18,5,8644,4.469493278179938,40.0,0.0
41934,4,1934,[515 427  79 588 318],807,5,8649,4.469767441860465,40.0,0.0
41935,4,1935,[515 427  79 588 318],18,5,8654,4.470041322314049,40.0,0.0
41936,4,1936,[135   1  70  69 427],5,3,8657,4.469282395456892,20.0,0.0
41937,4,1937,[515  79 427 588 318],716,5,8662,4.469556243550052,40.0,0.0
41938,4,1938,[515  79 427 588 318],716,5,8667,4.4698298091799895,40.0,0.0
41939,4,1939,[515  79 427 588 318],807,5,8672,4.470103092783505,40.0,0.0
41940,4,1940,[515  79 427 588 318],716,5,8677,4.470376094796497,40.0,0.0
41941,4,1941,[515  79 427 588 318],18,5,8682,4.4706488156539645,40.0,0.0
41942,4,1942,[748  71 300 568 117],796,5,8687,4.4709212557900155,0.0,0.0
41943,4,1943,[515  79 427 588 318],807,5,8692,4.47119341563786,40.0,0.0
41944,4,1944,[515  79 427 588 318],716,5,8697,4.47146529562982,40.0,0.0
41945,4,1945,[515  79 427 588 318],18,5,8702,4.471736896197328,40.0,0.0
41946,4,1946,[515  79 427 588 318],807,5,8707,4.47200821777093,40.0,0.0
41947,4,1947,[515  79 427 588 318],18,5,8712,4.4722792607802875,40.0,0.0
41948,4,1948,[515  79 427 588 318],807,5,8717,4.472550025654182,40.0,0.0
41949,4,1949,[515  79 427 588 318],716,5,8722,4.472820512820513,40.0,0.0
41950,4,1950,[515  79 427 588 318],716,5,8727,4.473090722706305,40.0,0.0
41951,4,1951,[515  79 427 588 318],807,5,8732,4.473360655737705,40.0,0.0
41952,4,1952,[515  79 427 588 318],807,5,8737,4.473630312339989,40.0,0.0
41953,4,1953,[515  79 427 588 318],18,5,8742,4.473899692937564,40.0,0.0
41954,4,1954,[515  79 427 588 318],716,5,8747,4.474168797953964,40.0,0.0
41955,4,1955,[515  79 427 588 318],716,5,8752,4.474437627811861,40.0,0.0
41956,4,1956,[197  50 121 210 423],450,3,8755,4.473684210526316,0.0,20.0
41957,4,1957,[ 64 174 194 357 168],716,5,8760,4.473953013278856,20.0,0.0
41958,4,1958,[742  56 174 471 423],693,2,8762,4.472690148034712,0.0,0.0
41959,4,1959,[275 276 222  69 742],344,3,8765,4.471938775510204,0.0,20.0
41960,4,1960,[385 175 172 196  82],655,1,8766,4.470168281489036,0.0,0.0
41961,4,1961,[496  69   9 237 202],280,3,8769,4.469418960244648,20.0,0.0
41962,4,1962,[515  79 427 588 318],18,5,8774,4.469689251146205,40.0,0.0
41963,4,1963,[515  79 427 588 318],18,5,8779,4.469959266802444,40.0,0.0
41964,4,1964,[515  79 427 588 318],716,5,8784,4.470229007633588,40.0,0.0
41965,4,1965,[ 98 275 288  97 235],450,3,8787,4.469481180061037,0.0,20.0
41966,4,1966,[515  79 427 588 318],716,5,8792,4.469750889679715,40.0,0.0
41967,4,1967,[515  79 427 588 318],18,5,8797,4.470020325203252,40.0,0.0
41968,4,1968,[ 56 182 435 117 289],655,1,8798,4.468257998984256,0.0,0.0
41969,4,1969,[515  79 427 588 318],18,5,8803,4.468527918781726,40.0,0.0
41970,4,1970,[515  79 427 588 318],18,5,8808,4.468797564687976,40.0,0.0
41971,4,1971,[515  79 427 588 318],807,5,8813,4.469066937119676,40.0,0.0
41972,4,1972,[515  79 427 588 318],807,5,8818,4.469336036492651,40.0,0.0
41973,4,1973,[515  79 427 588 318],716,5,8823,4.4696048632218845,40.0,0.0
41974,4,1974,[515  79 427 588 318],18,5,8828,4.469873417721519,40.0,0.0
41975,4,1975,[288 183 176 127 546],344,4,8832,4.469635627530365,0.0,20.0
41976,4,1976,[515  79 427 588 318],716,5,8837,4.469903894790086,40.0,0.0
41977,4,1977,[515  79 427 588 318],716,5,8842,4.470171890798786,40.0,0.0
41978,4,1978,[515  79 427 588 318],18,5,8847,4.470439615967661,40.0,0.0
41979,4,1979,[515  79 427 588 318],807,5,8852,4.47070707070707,40.0,0.0
41980,4,1980,[515  79 427 588 318],18,5,8857,4.470974255426552,40.0,0.0
41981,4,1981,[515  79 427 588 318],18,5,8862,4.471241170534813,40.0,0.0
41982,4,1982,[515  79 427 588 318],807,5,8867,4.471507816439738,40.0,0.0
41983,4,1983,[515  79 427 588 318],18,5,8872,4.471774193548387,40.0,0.0
41984,4,1984,[515  79 427 588 318],18,5,8877,4.472040302267002,40.0,0.0
41985,4,1985,[515  79 427 588 318],716,5,8882,4.472306143001007,40.0,0.0
41986,4,1986,[328 245  69  96 301],450,5,8887,4.472571716155008,0.0,0.0
41987,4,1987,[515  79 427 588 318],716,5,8892,4.472837022132797,40.0,0.0
41988,4,1988,[515  79 427 588 318],716,5,8897,4.4731020613373556,40.0,0.0
41989,4,1989,[515  79 427 588 318],18,5,8902,4.473366834170855,40.0,0.0
41990,4,1990,[515  79 427 588 318],716,5,8907,4.473631341034656,40.0,0.0
41991,4,1991,[515  79 427 588 318],807,5,8912,4.473895582329317,40.0,0.0
41992,4,1992,[515  79 427 588 318],807,5,8917,4.474159558454591,40.0,0.0
41993,4,1993,[515  79 427 588 318],807,5,8922,4.474423269809428,40.0,0.0
41994,4,1994,[515  79 427 588 318],18,5,8927,4.47468671679198,40.0,0.0
41995,4,1995,[515  79 427 588 318],807,5,8932,4.474949899799599,40.0,0.0
41996,4,1996,[210 301 118  98 125],450,3,8935,4.474211316975463,0.0,0.0
41997,4,1997,[515  79 427 588 318],807,5,8940,4.474474474474475,40.0,0.0
41998,4,1998,[515  79 427 588 318],807,5,8945,4.474737368684342,40.0,0.0
41999,4,1999,[515  79 427 588 318],807,5,8950,4.475,40.0,0.0
42000,4,2000,[515  79 427 588 318],807,5,8955,4.475262368815592,40.0,0.0
42001,4,2001,[215 194 245 200 176],450,4,8959,4.475024975024975,0.0,0.0
42002,4,2002,[515  79 427 588 318],18,5,8964,4.475287069395906,40.0,0.0
42003,4,2003,[515  79 427 588 318],716,5,8969,4.475548902195609,40.0,0.0
42004,4,2004,[515  79 427 588 318],716,5,8974,4.475810473815462,40.0,0.0
42005,4,2005,[515  79 427 588 318],18,5,8979,4.476071784646062,40.0,0.0
42006,4,2006,[515  79 427 588 318],807,5,8984,4.47633283507723,40.0,0.0
42007,4,2007,[515  79 427 588 318],807,5,8989,4.476593625498008,40.0,0.0
42008,4,2008,[515  79 427 588 318],18,5,8994,4.476854156296665,40.0,0.0
42009,4,2009,[515  79 427 588 318],807,5,8999,4.4771144278606965,40.0,0.0
42010,4,2010,[515  79 427 588 318],716,5,9004,4.477374440576828,40.0,0.0
42011,4,2011,[515  79 427 588 318],18,5,9009,4.477634194831014,40.0,0.0
42012,4,2012,[515  79 427 588 318],18,5,9014,4.477893691008445,40.0,0.0
42013,4,2013,[515  79 427 588 318],18,5,9019,4.478152929493545,40.0,0.0
42014,4,2014,[515  79 427 588 318],18,5,9024,4.478411910669975,40.0,0.0
42015,4,2015,[515  79 427 588 318],716,5,9029,4.478670634920635,40.0,0.0
42016,4,2016,[515  79 427 588 318],807,5,9034,4.4789291026276645,40.0,0.0
42017,4,2017,[515  79 427 588 318],18,5,9039,4.479187314172448,40.0,0.0
42018,4,2018,[515  79 427 588 318],716,5,9044,4.479445269935612,40.0,0.0
42019,4,2019,[301 195 197  11 174],535,5,9049,4.47970297029703,0.0,0.0
42020,4,2020,[515  79 427 588 318],716,5,9054,4.479960415635824,40.0,0.0
42021,4,2021,[  4  70 423 237 127],655,1,9055,4.478239366963402,0.0,20.0
42022,4,2022,[515  79 427 588 318],807,5,9060,4.478497281265447,40.0,0.0
42023,4,2023,[515  79 427 588 318],18,5,9065,4.478754940711463,40.0,0.0
42024,4,2024,[  1 588 222   4 151],344,4,9069,4.478518518518518,0.0,0.0
42025,4,2025,[515  79 427 588 318],716,5,9074,4.4787759131293186,40.0,0.0
42026,4,2026,[515  79 427 588 318],716,5,9079,4.47903305377405,40.0,0.0
42027,4,2027,[197 282 117 603 111],450,5,9084,4.479289940828402,20.0,0.0
42028,4,2028,[ 15 268 385 195 117],655,0,9084,4.477082306554953,0.0,0.0
42029,4,2029,[515  79 427 588 318],807,5,9089,4.477339901477833,40.0,0.0
42030,4,2030,[515  79 427 588 318],18,5,9094,4.477597242737568,40.0,0.0
42031,4,2031,[515  79 427 588 318],807,5,9099,4.477854330708661,40.0,0.0
42032,4,2032,[210 197 111 257 435],389,2,9101,4.4766355140186915,0.0,0.0
42033,4,2033,[515  79 427 588 318],716,5,9106,4.476892822025565,40.0,0.0
42034,4,2034,[515  79 427 588 318],716,5,9111,4.477149877149877,40.0,0.0
42035,4,2035,[515  79 427 588 318],18,5,9116,4.477406679764243,40.0,0.0
42036,4,2036,[202 181 173 318  88],786,5,9121,4.47766323024055,20.0,0.0
42037,4,2037,[515  79 427 588 318],716,5,9126,4.4779195289499505,40.0,0.0
42038,4,2038,[515  79 427 588 318],807,5,9131,4.478175576262874,40.0,0.0
42039,4,2039,[238 385 187 333 313],796,4,9135,4.477941176470588,0.0,0.0
42040,4,2040,[515  79 427 588 318],716,5,9140,4.478196962273396,40.0,0.0
42041,4,2041,[515  79 427 588 318],716,5,9145,4.47845249755142,40.0,0.0
42042,4,2042,[515  79 427 588 318],716,5,9150,4.47870778267254,40.0,0.0
42043,4,2043,[ 56  98  79 471 300],655,2,9152,4.477495107632094,0.0,0.0
42044,4,2044,[515  79 427 588 318],807,5,9157,4.477750611246944,40.0,0.0
42045,4,2045,[222 121  79 185  88],457,5,9162,4.478005865102639,0.0,0.0
42046,4,2046,[515  79 427 588 318],18,5,9167,4.478260869565218,40.0,0.0
42047,4,2047,[515  79 427 588 318],18,5,9172,4.478515625,40.0,0.0
42048,4,2048,[515  79 427 588 318],807,5,9177,4.478770131771596,40.0,0.0
42049,4,2049,[515  79 427 588 318],807,5,9182,4.479024390243903,40.0,0.0
42050,4,2050,[515  79 427 588 318],716,5,9187,4.479278400780108,40.0,0.0
42051,4,2051,[515  79 427 588 318],18,5,9192,4.47953216374269,40.0,0.0
42052,4,2052,[515  79 427 588 318],18,5,9197,4.479785679493424,40.0,0.0
42053,4,2053,[ 88 174 172 483 234],693,1,9198,4.47809152872444,0.0,0.0
42054,4,2054,[ 64  88 183 100 313],577,4,9202,4.477858880778589,20.0,20.0
42055,4,2055,[515  79 427 588 318],716,5,9207,4.478112840466926,40.0,0.0
42056,4,2056,[515  79 427 588 318],18,5,9212,4.478366553232863,40.0,0.0
42057,4,2057,[515  79 427 588 318],807,5,9217,4.478620019436346,40.0,0.0
42058,4,2058,[515  79 427 588 318],807,5,9222,4.47887323943662,40.0,0.0
42059,4,2059,[515  79 427 588 318],807,5,9227,4.479126213592233,40.0,0.0
42060,4,2060,[515  79 427 588 318],807,5,9232,4.479378942261039,40.0,0.0
42061,4,2061,[515  79 427 588 318],716,5,9237,4.479631425800194,40.0,0.0
42062,4,2062,[515  79 427 588 318],716,5,9242,4.479883664566166,40.0,0.0
42063,4,2063,[515  79 427 588 318],716,5,9247,4.480135658914729,40.0,0.0
42064,4,2064,[515  79 427 588 318],18,5,9252,4.480387409200969,40.0,0.0
42065,4,2065,[  4 222 742 181  69],457,5,9257,4.480638915779283,0.0,0.0
42066,4,2066,[179 132 183 302  89],269,2,9259,4.479438800193517,0.0,0.0
42067,4,2067,[515  79 427 588 318],716,5,9264,4.479690522243714,40.0,0.0
42068,4,2068,[515  79 427 588 318],716,5,9269,4.47994200096665,40.0,0.0
42069,4,2069,[515  79 427 588 318],807,5,9274,4.4801932367149755,40.0,0.0
42070,4,2070,[180  11 197 117 471],280,3,9277,4.479478512795751,0.0,0.0
42071,4,2071,[515  79 427 588 318],716,5,9282,4.47972972972973,40.0,0.0
42072,4,2072,[181 237 286 185 204],450,5,9287,4.479980704293295,0.0,20.0
42073,4,2073,[200 603 235  25 144],716,3,9290,4.479267116682738,20.0,0.0
42074,4,2074,[ 79 515 427 588 318],716,5,9295,4.4795180722891565,40.0,0.0
42075,4,2075,[ 79 515 427 588 318],18,5,9300,4.479768786127168,40.0,0.0
42076,4,2076,[132   9 204 357  79],655,2,9302,4.478574867597496,0.0,0.0
42077,4,2077,[515  79 427 588 318],18,5,9307,4.478825794032724,40.0,0.0
42078,4,2078,[515  79 427 588 318],807,5,9312,4.479076479076479,40.0,0.0
42079,4,2079,[515  79 427 588 318],807,5,9317,4.479326923076923,40.0,0.0
42080,4,2080,[515  79 427 588 318],18,5,9322,4.479577126381547,40.0,0.0
42081,4,2081,[515  79 427 588 318],716,5,9327,4.479827089337176,40.0,0.0
42082,4,2082,[515  79 427 588 318],18,5,9332,4.480076812289966,40.0,0.0
42083,4,2083,[ 69  95   8 288 234],280,4,9336,4.479846449136277,0.0,0.0
42084,4,2084,[515  79 427 588 318],807,5,9341,4.480095923261391,40.0,0.0
42085,4,2085,[515  79 427 588 318],807,5,9346,4.480345158197507,40.0,0.0
42086,4,2086,[515  79 427 588 318],18,5,9351,4.480594154288452,40.0,0.0
42087,4,2087,[ 28  56 118 483   4],151,4,9355,4.480363984674329,0.0,0.0
42088,4,2088,[515  79 427 588 318],807,5,9360,4.480612733365247,40.0,0.0
42089,4,2089,[515  79 427 588 318],716,5,9365,4.480861244019139,40.0,0.0
42090,4,2090,[515  79 427 588 318],807,5,9370,4.481109516977523,40.0,0.0
42091,4,2091,[515  79 427 588 318],807,5,9375,4.481357552581262,40.0,0.0
42092,4,2092,[286 111  25  64 191],151,4,9379,4.48112756808409,20.0,20.0
42093,4,2093,[742 286 403 302 313],655,2,9381,4.479942693409742,0.0,20.0
42094,4,2094,[ 79 515 427 588 318],18,5,9386,4.48019093078759,40.0,0.0
42095,4,2095,[ 79 515 427 588 318],807,5,9391,4.4804389312977095,40.0,0.0
42096,4,2096,[ 79 515 427 588 318],18,5,9396,4.48068669527897,40.0,0.0
42097,4,2097,[ 79 515 427 588 318],807,5,9401,4.48093422306959,40.0,0.0
42098,4,2098,[ 15 204  12 475  25],655,0,9401,4.47879942829919,0.0,0.0
42099,4,2099,[515  79 427 588 318],807,5,9406,4.479047619047619,40.0,0.0
42100,4,2100,[515  79 427 588 318],716,5,9411,4.479295573536411,40.0,0.0
42101,4,2101,[515  79 427 588 318],807,5,9416,4.479543292102759,40.0,0.0
42102,4,2102,[515  79 427 588 318],18,5,9421,4.479790775083215,40.0,0.0
42103,4,2103,[515  79 427 588 318],807,5,9426,4.480038022813688,40.0,0.0
42104,4,2104,[515  79 427 588 318],716,5,9431,4.4802850356294535,40.0,0.0
42105,4,2105,[515  79 427 588 318],716,5,9436,4.480531813865147,40.0,0.0
42106,4,2106,[ 50 237 121 196  25],72,2,9438,4.479354532510679,0.0,20.0
42107,4,2107,[515  79 427 588 318],807,5,9443,4.479601518026565,40.0,0.0
42108,4,2108,[515  79 427 588 318],807,5,9448,4.479848269321954,40.0,0.0
42109,4,2109,[515  79 427 588 318],716,5,9453,4.4800947867298575,40.0,0.0
42110,4,2110,[515  79 427 588 318],807,5,9458,4.4803410705826625,40.0,0.0
42111,4,2111,[  4 269  12  97 357],655,1,9459,4.478693181818182,0.0,0.0
42112,4,2112,[515  79 427 588 318],716,5,9464,4.478939895882632,40.0,0.0
42113,4,2113,[515  79 427 588 318],716,5,9469,4.47918637653737,40.0,0.0
42114,4,2114,[515  22 435 151 318],716,5,9474,4.479432624113475,20.0,0.0
42115,4,2115,[202 471 282 265 748],280,1,9475,4.477788279773157,0.0,0.0
42116,4,2116,[ 79 515 427 588 318],716,5,9480,4.478034955125177,40.0,0.0
42117,4,2117,[228 176 603 125 405],450,5,9485,4.478281397544854,20.0,0.0
42118,4,2118,[ 79 515 427 588 318],807,5,9490,4.478527607361963,40.0,0.0
42119,4,2119,[ 79 515 427 588 318],807,5,9495,4.47877358490566,40.0,0.0
42120,4,2120,[ 79 515 427 588 318],716,5,9500,4.479019330504479,40.0,0.0
42121,4,2121,[ 79 515 427 588 318],18,5,9505,4.479264844486334,40.0,0.0
42122,4,2122,[ 79 515 427 588 318],18,5,9510,4.479510127178521,40.0,0.0
42123,4,2123,[ 79 515 427 588 318],716,5,9515,4.4797551789077215,40.0,0.0
42124,4,2124,[ 79 515 427 588 318],716,5,9520,4.48,40.0,0.0
42125,4,2125,[204  25  22 210 435],716,5,9525,4.480244590780809,0.0,0.0
42126,4,2126,[ 79 515 427 588 318],18,5,9530,4.480488951574988,40.0,0.0
42127,4,2127,[748 117  12  22 211],450,5,9535,4.480733082706767,0.0,0.0
42128,4,2128,[ 79 515 427 588 318],716,5,9540,4.480976984499765,40.0,0.0
42129,4,2129,[237  12 185  15 597],457,4,9544,4.48075117370892,0.0,0.0
42130,4,2130,[ 79 515 427 588 318],807,5,9549,4.480994838104176,40.0,0.0
42131,4,2131,[ 79 515 427 588 318],807,5,9554,4.481238273921201,40.0,0.0
42132,4,2132,[ 79 515 427 588 318],716,5,9559,4.481481481481482,40.0,0.0
42133,4,2133,[ 79 515 427 588 318],18,5,9564,4.481724461105904,40.0,0.0
42134,4,2134,[ 79 515 427 588 318],807,5,9569,4.481967213114754,40.0,0.0
42135,4,2135,[ 79 515 427 588 318],807,5,9574,4.4822097378277155,40.0,0.0
42136,4,2136,[568 183  15 175   8],655,1,9575,4.480580252690688,0.0,0.0
42137,4,2137,[ 79 515 427 588 318],807,5,9580,4.480823199251637,40.0,0.0
42138,4,2138,[ 79 515 427 588 318],716,5,9585,4.481065918653576,40.0,0.0
42139,4,2139,[100 603  64  15 588],330,5,9590,4.481308411214953,40.0,20.0
42140,4,2140,[403 742 191 125 151],457,5,9595,4.48155067725362,0.0,0.0
42141,4,2141,[ 79 515 427 588 318],18,5,9600,4.481792717086835,40.0,0.0
42142,4,2142,[ 79 515 427 588 318],807,5,9605,4.482034531031265,40.0,0.0
42143,4,2143,[187 276  50 742   7],256,3,9608,4.481343283582089,0.0,20.0
42144,4,2144,[ 79 515 427 588 318],18,5,9613,4.481585081585082,40.0,0.0
42145,4,2145,[ 79 515 427 588 318],807,5,9618,4.4818266542404475,40.0,0.0
42146,4,2146,[ 79 515 427 588 318],716,5,9623,4.482068001863064,40.0,0.0
42147,4,2147,[161  15 655  64 182],269,3,9626,4.481378026070764,20.0,0.0
42148,4,2148,[ 79 515 427 588 318],716,5,9631,4.481619357840856,40.0,0.0
42149,4,2149,[ 79 515 427 588 318],18,5,9636,4.481860465116279,40.0,0.0
42150,4,2150,[196 234  69 568  11],269,0,9636,4.479776847977685,0.0,0.0
42151,4,2151,[ 79 515 427 588 318],807,5,9641,4.480018587360595,40.0,0.0
42152,4,2152,[ 79 515 427 588 318],807,5,9646,4.480260102183,40.0,0.0
42153,4,2153,[ 79 515 427 588 318],807,5,9651,4.4805013927576605,40.0,0.0
42154,4,2154,[ 79 515 427 588 318],716,5,9656,4.480742459396752,40.0,0.0
42155,4,2155,[301  25 173 179 282],593,4,9660,4.48051948051948,0.0,0.0
42156,4,2156,[ 79 515 427 588 318],18,5,9665,4.480760315252666,40.0,0.0
42157,4,2157,[ 79 515 427 588 318],807,5,9670,4.481000926784059,40.0,0.0
42158,4,2158,[ 50 318 168  70 202],65,4,9674,4.4807781380268645,20.0,20.0
42159,4,2159,[405 204 191  70 132],269,2,9676,4.479629629629629,0.0,0.0
42160,4,2160,[196 483 257 204  79],796,5,9681,4.479870430356317,0.0,0.0
42161,4,2161,[515  79 427 588 318],807,5,9686,4.480111008325625,40.0,0.0
42162,4,2162,[435 196  97 173 546],151,4,9690,4.479889042995839,0.0,0.0
42163,4,2163,[174 603  64 181 245],494,3,9693,4.47920517560074,40.0,0.0
42164,4,2164,[603 300 144 181  69],655,1,9694,4.477598152424942,20.0,0.0
42165,4,2165,[515  79 427 588 318],18,5,9699,4.477839335180056,40.0,0.0
42166,4,2166,[515  79 427 588 318],18,5,9704,4.478080295339178,40.0,0.0
42167,4,2167,[515  79 427 588 318],716,5,9709,4.4783210332103325,40.0,0.0
42168,4,2168,[515  79 427 588 318],18,5,9714,4.478561549100968,40.0,0.0
42169,4,2169,[515  79 427 588 318],18,5,9719,4.478801843317973,40.0,0.0
42170,4,2170,[ 79 300 185 258 176],11,3,9722,4.478120681713496,0.0,0.0
42171,4,2171,[515  79 427 588 318],716,5,9727,4.4783609576427255,40.0,0.0
42172,4,2172,[515  79 427 588 318],18,5,9732,4.4786010124252185,40.0,0.0
42173,4,2173,[515  79 427 588 318],18,5,9737,4.478840846366145,40.0,0.0
42174,4,2174,[515  79 427 588 318],18,5,9742,4.479080459770115,40.0,0.0
42175,4,2175,[427 125   7 258 216],655,2,9744,4.477941176470588,20.0,0.0
42176,4,2176,[515  79 427 588 318],716,5,9749,4.478180983004134,40.0,0.0
42177,4,2177,[515  79 427 588 318],18,5,9754,4.478420569329661,40.0,0.0
42178,4,2178,[515  79 427 588 318],716,5,9759,4.478659935750344,40.0,0.0
42179,4,2179,[515  79 427 588 318],807,5,9764,4.478899082568807,40.0,0.0
42180,4,2180,[515  79 427 588 318],18,5,9769,4.479138010087116,40.0,0.0
42181,4,2181,[515  79 427 588 318],18,5,9774,4.479376718606782,40.0,0.0
42182,4,2182,[194 742 265  88 328],796,4,9778,4.47915712322492,0.0,0.0
42183,4,2183,[515  79 427 588 318],18,5,9783,4.479395604395604,40.0,0.0
42184,4,2184,[186 357 161  69 318],796,4,9787,4.479176201372998,20.0,0.0
42185,4,2185,[185 286 181 435 183],236,4,9791,4.478956999085087,0.0,20.0
42186,4,2186,[515  79 427 588 318],716,5,9796,4.479195244627343,40.0,0.0
42187,4,2187,[515  79 427 588 318],716,5,9801,4.479433272394881,40.0,0.0
42188,4,2188,[515  79 427 588 318],807,5,9806,4.479671082686158,40.0,0.0
42189,4,2189,[515  79 427 588 318],807,5,9811,4.479908675799087,40.0,0.0
42190,4,2190,[515  79 427 588 318],807,5,9816,4.480146052031036,40.0,0.0
42191,4,2191,[655 132 216 187 235],716,3,9819,4.479470802919708,0.0,0.0
42192,4,2192,[515  79 427 588 318],18,5,9824,4.479708162334702,40.0,0.0
42193,4,2193,[515  79 427 588 318],807,5,9829,4.479945305378305,40.0,0.0
42194,4,2194,[ 50 237 483 194 144],296,5,9834,4.480182232346241,0.0,20.0
42195,4,2195,[515  79 427 588 318],18,5,9839,4.480418943533698,40.0,0.0
42196,4,2196,[515  79 427 588 318],716,5,9844,4.480655439235321,40.0,0.0
42197,4,2197,[515  79 427 588 318],807,5,9849,4.480891719745223,40.0,0.0
42198,4,2198,[515  79 427 588 318],18,5,9854,4.48112778535698,40.0,0.0
42199,4,2199,[515  79 427 588 318],807,5,9859,4.481363636363636,40.0,0.0
42200,4,2200,[515  79 427 588 318],716,5,9864,4.481599273057701,40.0,0.0
42201,4,2201,[515  79 427 588 318],807,5,9869,4.481834695731154,40.0,0.0
42202,4,2202,[191 183 597  25 603],450,4,9873,4.48161597821153,20.0,0.0
42203,4,2203,[286 471 174 655 204],639,2,9875,4.480490018148821,0.0,20.0
42204,4,2204,[ 56 269 496 168 135],18,3,9878,4.479818594104309,20.0,0.0
42205,4,2205,[ 79 515 427 588 318],18,5,9883,4.480054397098821,40.0,0.0
42206,4,2206,[ 79 515 427 588 318],807,5,9888,4.480289986406887,40.0,0.0
42207,4,2207,[237 186  95 318   7],577,4,9892,4.480072463768116,20.0,0.0
42208,4,2208,[ 79 515 427 588 318],18,5,9897,4.480307831598008,40.0,0.0
42209,4,2209,[ 79 515 427 588 318],807,5,9902,4.480542986425339,40.0,0.0
42210,4,2210,[ 28   1 194 294 196],65,4,9906,4.480325644504749,0.0,0.0
42211,4,2211,[ 79 515 427 588 318],807,5,9911,4.480560578661844,40.0,0.0
42212,4,2212,[ 79 515 427 588 318],716,5,9916,4.480795300497062,40.0,0.0
42213,4,2213,[ 79 515 427 588 318],18,5,9921,4.481029810298103,40.0,0.0
42214,4,2214,[568  12  28 742   8],796,3,9924,4.480361173814899,0.0,0.0
42215,4,2215,[ 79 515 427 588 318],716,5,9929,4.480595667870036,40.0,0.0
42216,4,2216,[ 79 515 427 588 318],807,5,9934,4.480829950383401,40.0,0.0
42217,4,2217,[318 323 237 183 216],280,2,9936,4.479711451758341,20.0,0.0
42218,4,2218,[515  79 427 588 318],716,5,9941,4.4799459215863005,40.0,0.0
42219,4,2219,[515  79 427 588 318],716,5,9946,4.48018018018018,40.0,0.0
42220,4,2220,[515  79 427 588 318],716,5,9951,4.480414227825304,40.0,0.0
42221,4,2221,[269   9 117   7 200],655,1,9952,4.478847884788479,0.0,0.0
42222,4,2222,[515  79 427 588 318],807,5,9957,4.479082321187584,40.0,0.0
42223,4,2223,[275 403 313 423 215],655,2,9959,4.47796762589928,0.0,20.0
42224,4,2224,[234 588 173  88   8],457,5,9964,4.478202247191011,0.0,0.0
42225,4,2225,[515  79 427 588 318],18,5,9969,4.47843665768194,40.0,0.0
42226,4,2226,[515  79 427 588 318],18,5,9974,4.47867085765604,40.0,0.0
42227,4,2227,[144 211 748 238 181],450,5,9979,4.478904847396769,0.0,0.0
42228,4,2228,[186  56 187  70 423],18,5,9984,4.479138627187079,0.0,0.0
42229,4,2229,[172 143 191 186  97],716,4,9988,4.478923766816144,0.0,0.0
42230,4,2230,[187 357 423  22 427],18,5,9993,4.479157328552219,20.0,0.0
42231,4,2231,[515  79 427 588 318],716,5,9998,4.479390681003585,40.0,0.0
42232,4,2232,[515  79 427 588 318],716,5,10003,4.47962382445141,40.0,0.0
42233,4,2233,[168 210 215   4 121],796,4,10007,4.479409131602507,0.0,0.0
42234,4,2234,[204 318 496 200  11],330,5,10012,4.479642058165548,40.0,0.0
42235,4,2235,[515  79 427 588 318],18,5,10017,4.479874776386405,40.0,0.0
42236,4,2236,[515  79 427 588 318],807,5,10022,4.480107286544479,40.0,0.0
42237,4,2237,[403 222  97 187 300],450,4,10026,4.479892761394102,0.0,0.0
42238,4,2238,[ 25 427  79 515 117],72,5,10031,4.480125055828495,20.0,0.0
42239,4,2239,[515  79 427 588 318],716,5,10036,4.480357142857143,40.0,0.0
42240,4,2240,[515  79 427 588 318],716,5,10041,4.480589022757697,40.0,0.0
42241,4,2241,[515  79 427 588 318],18,5,10046,4.4808206958073145,40.0,0.0
42242,4,2242,[515  79 427 588 318],18,5,10051,4.481052162282658,40.0,0.0
42243,4,2243,[515  79 427 588 318],716,5,10056,4.481283422459893,40.0,0.0
42244,4,2244,[515  79 427 588 318],716,5,10061,4.4815144766146995,40.0,0.0
42245,4,2245,[180 186  69 194  56],457,5,10066,4.481745325022262,0.0,0.0
42246,4,2246,[ 98 301 742  96  79],796,3,10069,4.481085892300846,0.0,0.0
42247,4,2247,[515  79 427 588 318],716,5,10074,4.4813167259786475,40.0,0.0
42248,4,2248,[216 185 172 151 187],18,2,10076,4.480213428190307,0.0,0.0
42249,4,2249,[  4 111 333  69  79],655,1,10077,4.478666666666666,0.0,0.0
42250,4,2250,[ 79 515 427 588 318],807,5,10082,4.478898267436695,40.0,0.0
42251,4,2251,[ 79 515 427 588 318],807,5,10087,4.479129662522203,40.0,0.0
42252,4,2252,[300 222 111 127 180],292,4,10091,4.478916999556147,0.0,20.0
42253,4,2253,[ 79 515 427 588 318],716,5,10096,4.479148181011535,40.0,0.0
42254,4,2254,[ 79 515 427 588 318],716,5,10101,4.479379157427938,40.0,0.0
42255,4,2255,[655 144 185 195  22],796,4,10105,4.479166666666667,0.0,0.0
42256,4,2256,[ 79 515 427 588 318],807,5,10110,4.4793974302171025,40.0,0.0
42257,4,2257,[ 79 515 427 588 318],716,5,10115,4.479627989371125,40.0,0.0
42258,4,2258,[ 79 515 427 588 318],716,5,10120,4.479858344400177,40.0,0.0
42259,4,2259,[ 79 515 427 588 318],18,5,10125,4.480088495575221,40.0,0.0
42260,4,2260,[ 79 515 427 588 318],716,5,10130,4.48031844316674,40.0,0.0
42261,4,2261,[ 79 515 427 588 318],716,5,10135,4.4805481874447395,40.0,0.0
42262,4,2262,[ 79 515 427 588 318],18,5,10140,4.480777728678745,40.0,0.0
42263,4,2263,[234  12  11 174   1],450,4,10144,4.480565371024735,0.0,0.0
42264,4,2264,[ 79 515 427 588 318],807,5,10149,4.480794701986755,40.0,0.0
42265,4,2265,[ 79 515 427 588 318],18,5,10154,4.481023830538394,40.0,0.0
42266,4,2266,[ 79 515 427 588 318],18,5,10159,4.481252756947508,40.0,0.0
42267,4,2267,[ 79 515 427 588 318],716,5,10164,4.481481481481482,40.0,0.0
42268,4,2268,[ 79 515 427 588 318],716,5,10169,4.481710004407228,40.0,0.0
42269,4,2269,[ 79 515 427 588 318],716,5,10174,4.481938325991189,40.0,0.0
42270,4,2270,[ 79 515 427 588 318],807,5,10179,4.482166446499339,40.0,0.0
42271,4,2271,[ 79 515 427 588 318],18,5,10184,4.482394366197183,40.0,0.0
42272,4,2272,[  9 294 603 234 144],655,1,10185,4.480862296524417,20.0,0.0
42273,4,2273,[183 222  98 100  22],280,2,10187,4.479771328056288,0.0,20.0
42274,4,2274,[ 79 515 427 588 318],716,5,10192,4.48,40.0,0.0
42275,4,2275,[ 79 515 427 588 318],807,5,10197,4.480228471001757,40.0,0.0
42276,4,2276,[496 265  88 176 742],450,5,10202,4.480456741326306,20.0,0.0
42277,4,2277,[  1  96 121 403 161],256,5,10207,4.480684811237928,0.0,0.0
42278,4,2278,[ 79 515 427 588 318],807,5,10212,4.480912681000439,40.0,0.0
42279,4,2279,[ 79 515 427 588 318],716,5,10217,4.481140350877193,40.0,0.0
42280,4,2280,[ 79 515 427 588 318],716,5,10222,4.481367821131083,40.0,0.0
42281,4,2281,[ 79 515 427 588 318],807,5,10227,4.4815950920245395,40.0,0.0
42282,4,2282,[ 79 515 427 588 318],716,5,10232,4.481822163819536,40.0,0.0
42283,4,2283,[ 79 515 427 588 318],807,5,10237,4.482049036777584,40.0,0.0
42284,4,2284,[ 79 515 427 588 318],18,5,10242,4.482275711159738,40.0,0.0
42285,4,2285,[ 79 515 427 588 318],807,5,10247,4.482502187226597,40.0,0.0
42286,4,2286,[ 79 515 427 588 318],716,5,10252,4.482728465238304,40.0,0.0
42287,4,2287,[508 153 496  11  88],280,3,10255,4.482080419580419,20.0,0.0
42288,4,2288,[294   9 215 496   8],280,3,10258,4.481432940148537,20.0,0.0
42289,4,2289,[ 79 515 427 588 318],18,5,10263,4.481659388646288,40.0,0.0
42290,4,2290,[546 228 111  79 288],280,4,10267,4.4814491488433,0.0,0.0
42291,4,2291,[ 79 515 427 588 318],716,5,10272,4.481675392670157,40.0,0.0
42292,4,2292,[ 97 588 265 286 318],878,2,10274,4.480593109463585,20.0,20.0
42293,4,2293,[ 79 515 427 318 588],807,5,10279,4.480819529206626,40.0,0.0
42294,4,2294,[ 79 515 427 318 588],807,5,10284,4.481045751633987,40.0,0.0
42295,4,2295,[ 79 515 427 318 588],807,5,10289,4.481271777003484,40.0,0.0
42296,4,2296,[ 79 515 427 318 588],807,5,10294,4.4814976055724856,40.0,0.0
42297,4,2297,[ 79 515 427 318 588],807,5,10299,4.481723237597911,40.0,0.0
42298,4,2298,[ 79 515 427 318 588],716,5,10304,4.481948673336233,40.0,0.0
42299,4,2299,[234 132  12 357 210],693,3,10307,4.481304347826087,0.0,0.0
42300,4,2300,[  1 655 143 175 289],655,1,10308,4.479791395045632,0.0,0.0
42301,4,2301,[132 185 121 302 143],151,4,10312,4.479582971329279,0.0,0.0
42302,4,2302,[ 79 515 427 318 588],18,5,10317,4.479808944854538,40.0,0.0
42303,4,2303,[ 79 515 427 318 588],716,5,10322,4.480034722222222,40.0,0.0
42304,4,2304,[ 79 515 427 318 588],18,5,10327,4.480260303687635,40.0,0.0
42305,4,2305,[ 79 515 427 318 588],807,5,10332,4.480485689505637,40.0,0.0
42306,4,2306,[ 79 515 427 318 588],716,5,10337,4.480710879930646,40.0,0.0
42307,4,2307,[ 79 515 427 318 588],18,5,10342,4.4809358752166375,40.0,0.0
42308,4,2308,[144 132 286 483 180],280,4,10346,4.480727587700303,0.0,20.0
42309,4,2309,[ 79 515 427 318 588],18,5,10351,4.480952380952381,40.0,0.0
42310,4,2310,[ 79 515 427 318 588],18,5,10356,4.481176979662484,40.0,0.0
42311,4,2311,[ 79 515 427 318 588],807,5,10361,4.481401384083045,40.0,0.0
42312,4,2312,[ 79 515 427 318 588],716,5,10366,4.4816255944660615,40.0,0.0
42313,4,2313,[ 79 515 427 318 588],18,5,10371,4.481849611063094,40.0,0.0
42314,4,2314,[ 79 515 427 318 588],807,5,10376,4.48207343412527,40.0,0.0
42315,4,2315,[ 79 515 427 318 588],716,5,10381,4.482297063903282,40.0,0.0
42316,4,2316,[ 79 515 427 318 588],716,5,10386,4.4825205006473885,40.0,0.0
42317,4,2317,[ 79 515 427 318 588],807,5,10391,4.48274374460742,40.0,0.0
42318,4,2318,[197  50 211 151 275],796,3,10394,4.482104355325571,0.0,40.0
42319,4,2319,[ 79 515 427 318 588],716,5,10399,4.482327586206897,40.0,0.0
42320,4,2320,[655 238 237 313 301],655,1,10400,4.480827229642395,0.0,0.0
42321,4,2321,[ 79 515 427 318 588],807,5,10405,4.481050818260121,40.0,0.0
42322,4,2322,[ 79 515 427 318 588],716,5,10410,4.48127421437796,40.0,0.0
42323,4,2323,[121 546  82 300  79],450,3,10413,4.480636833046471,0.0,0.0
42324,4,2324,[ 79 515 427 318 588],716,5,10418,4.480860215053763,40.0,0.0
42325,4,2325,[ 79 515 427 318 588],716,5,10423,4.4810834049871024,40.0,0.0
42326,4,2326,[294  50 403 172 597],796,4,10427,4.480876665234207,0.0,20.0
42327,4,2327,[ 79 515 427 318 588],716,5,10432,4.481099656357388,40.0,0.0
42328,4,2328,[ 79 515 427 318 588],716,5,10437,4.481322455989695,40.0,0.0
42329,4,2329,[ 79 515 427 318 588],18,5,10442,4.481545064377682,40.0,0.0
42330,4,2330,[ 79 515 427 318 588],807,5,10447,4.4817674817674815,40.0,0.0
42331,4,2331,[ 79 515 427 318 588],18,5,10452,4.481989708404803,40.0,0.0
42332,4,2332,[ 79 515 427 318 588],716,5,10457,4.482211744534934,40.0,0.0
42333,4,2333,[  7 357 132 568 302],269,2,10459,4.481148243359041,0.0,0.0
42334,4,2334,[678 210 176   1 508],280,1,10460,4.4796573875803,0.0,0.0
42335,4,2335,[ 79 515 427 318 588],716,5,10465,4.479880136986301,40.0,0.0
42336,4,2336,[ 79 515 427 318 588],716,5,10470,4.4801026957638,40.0,0.0
42337,4,2337,[183  71  82 195 151],796,4,10474,4.479897348160821,0.0,0.0
42338,4,2338,[515  79 427 318 588],18,5,10479,4.480119709277469,40.0,0.0
42339,4,2339,[515  79 427 318 588],807,5,10484,4.48034188034188,40.0,0.0
42340,4,2340,[515  79 427 318 588],18,5,10489,4.4805638615976076,40.0,0.0
42341,4,2341,[515  79 427 318 588],807,5,10494,4.480785653287788,40.0,0.0
42342,4,2342,[515  79 427 318 588],716,5,10499,4.481007255655143,40.0,0.0
42343,4,2343,[196  15 181 132 322],450,4,10503,4.4808020477815695,0.0,0.0
42344,4,2344,[515  79 427 318 588],716,5,10508,4.481023454157783,40.0,0.0
42345,4,2345,[603 151 748 191 168],401,2,10510,4.47996589940324,20.0,0.0
42346,4,2346,[216 275 515 185 186],18,4,10514,4.47976139752876,0.0,20.0
42347,4,2347,[515  79 427 318 588],716,5,10519,4.479982964224872,40.0,0.0
42348,4,2348,[515  79 427 318 588],716,5,10524,4.480204342273308,40.0,0.0
42349,4,2349,[515  79 427 318 588],18,5,10529,4.480425531914894,40.0,0.0
42350,4,2350,[515  79 427 318 588],716,5,10534,4.480646533390047,40.0,0.0
42351,4,2351,[258 202 322 435 300],629,4,10538,4.480442176870748,0.0,0.0
42352,4,2352,[515  79 427 318 588],807,5,10543,4.480662983425415,40.0,0.0
42353,4,2353,[173 588  12 286 237],280,3,10546,4.480033984706882,0.0,20.0
42354,4,2354,[234 172 318 168 200],457,5,10551,4.480254777070064,20.0,0.0
42355,4,2355,[515  79 427 318 588],807,5,10556,4.480475382003395,40.0,0.0
42356,4,2356,[515  79 427 318 588],18,5,10561,4.4806957997454395,40.0,0.0
42357,4,2357,[125 127 179  88 234],786,4,10565,4.4804919423240035,0.0,20.0
42358,4,2358,[515  79 427 318 588],18,5,10570,4.480712166172107,40.0,0.0
42359,4,2359,[515  79 427 318 588],18,5,10575,4.4809322033898304,40.0,0.0
42360,4,2360,[515  79 427 318 588],807,5,10580,4.481152054214316,40.0,0.0
42361,4,2361,[172   9 151  64 333],796,4,10584,4.480948348856901,20.0,0.0
42362,4,2362,[228 100 185 194 357],23,4,10588,4.480744815911977,0.0,20.0
42363,4,2363,[515  79 427 318 588],18,5,10593,4.480964467005077,40.0,0.0
42364,4,2364,[515  79 427 318 588],18,5,10598,4.481183932346723,40.0,0.0
42365,4,2365,[515  79 427 318 588],807,5,10603,4.4814032121724425,40.0,0.0
42366,4,2366,[515  79 427 318 588],807,5,10608,4.481622306717364,40.0,0.0
42367,4,2367,[515  79 427 318 588],807,5,10613,4.481841216216216,40.0,0.0
42368,4,2368,[496 196 597 216 175],344,4,10617,4.481637821865766,20.0,0.0
42369,4,2369,[515  79 427 318 588],807,5,10622,4.481856540084388,40.0,0.0
42370,4,2370,[228 161 186 180 100],457,5,10627,4.482075073808519,0.0,20.0
42371,4,2371,[515  79 427 318 588],18,5,10632,4.482293423271501,40.0,0.0
42372,4,2372,[515  79 427 318 588],716,5,10637,4.482511588706279,40.0,0.0
42373,4,2373,[515  79 427 318 588],807,5,10642,4.482729570345408,40.0,0.0
42374,4,2374,[515  79 427 318 588],716,5,10647,4.482947368421053,40.0,0.0
42375,4,2375,[515  79 427 318 588],18,5,10652,4.483164983164984,40.0,0.0
42376,4,2376,[515  79 427 318 588],716,5,10657,4.483382414808582,40.0,0.0
42377,4,2377,[111 655  25 215 235],457,3,10660,4.482758620689655,0.0,0.0
42378,4,2378,[515  79 427 318 588],716,5,10665,4.48297604035309,40.0,0.0
42379,4,2379,[515  79 427 318 588],807,5,10670,4.483193277310924,40.0,0.0
42380,4,2380,[180 151  15 191 269],18,4,10674,4.482990340193196,0.0,0.0
42381,4,2381,[121  88 153  69  11],716,5,10679,4.4832073887489505,0.0,0.0
42382,4,2382,[515  79 427 318 588],807,5,10684,4.483424255140579,40.0,0.0
42383,4,2383,[515  79 427 318 588],18,5,10689,4.483640939597316,40.0,0.0
42384,4,2384,[172 210  70 318  98],655,3,10692,4.483018867924528,20.0,0.0
42385,4,2385,[515  79 427 318 588],18,5,10697,4.483235540653814,40.0,0.0
42386,4,2386,[515  79 427 318 588],716,5,10702,4.483452031839128,40.0,0.0
42387,4,2387,[515  79 427 318 588],18,5,10707,4.483668341708543,40.0,0.0
42388,4,2388,[ 89 328 215 117 301],796,4,10711,4.48346588530766,0.0,0.0
42389,4,2389,[515  79 427 318 588],716,5,10716,4.483682008368201,40.0,0.0
42390,4,2390,[515  79 427 318 588],807,5,10721,4.483897950648264,40.0,0.0
42391,4,2391,[515  79 427 318 588],18,5,10726,4.484113712374582,40.0,0.0
42392,4,2392,[271 196 210 183 100],796,3,10729,4.48349352277476,0.0,20.0
42393,4,2393,[515  79 427 318 588],807,5,10734,4.483709273182957,40.0,0.0
42394,4,2394,[515  79 427 318 588],716,5,10739,4.483924843423799,40.0,0.0
42395,4,2395,[742 216 405 161 322],280,4,10743,4.483722871452421,0.0,0.0
42396,4,2396,[515  79 427 318 588],18,5,10748,4.483938256153525,40.0,0.0
42397,4,2397,[515  79 427 318 588],807,5,10753,4.484153461217681,40.0,0.0
42398,4,2398,[515  79 427 318 588],807,5,10758,4.484368486869529,40.0,0.0
42399,4,2399,[515  79 427 318 588],18,5,10763,4.484583333333333,40.0,0.0
42400,4,2400,[210 153 191  98 174],639,2,10765,4.483548521449396,0.0,0.0
42401,4,2401,[515  79 427 318 588],807,5,10770,4.48376353039134,40.0,0.0
42402,4,2402,[515  79 427 318 588],807,5,10775,4.483978360382855,40.0,0.0
42403,4,2403,[515  79 427 318 588],18,5,10780,4.484193011647254,40.0,0.0
42404,4,2404,[515  79 427 318 588],807,5,10785,4.484407484407485,40.0,0.0
42405,4,2405,[515  79 427 318 588],716,5,10790,4.484621778886118,40.0,0.0
42406,4,2406,[515  79 427 318 588],716,5,10795,4.484835895305359,40.0,0.0
42407,4,2407,[515  79 427 318 588],716,5,10800,4.485049833887043,40.0,0.0
42408,4,2408,[515  79 427 318 588],807,5,10805,4.485263594852636,40.0,0.0
42409,4,2409,[515  79 427 318 588],18,5,10810,4.485477178423237,40.0,0.0
42410,4,2410,[515  79 427 318 588],18,5,10815,4.485690584819577,40.0,0.0
42411,4,2411,[515  79 427 318 588],716,5,10820,4.485903814262024,40.0,0.0
42412,4,2412,[515  79 427 318 588],807,5,10825,4.486116866970576,40.0,0.0
42413,4,2413,[151  82  95  28 313],807,5,10830,4.486329743164871,0.0,0.0
42414,4,2414,[515  79 427 318 588],716,5,10835,4.486542443064182,40.0,0.0
42415,4,2415,[515  79 427 318 588],807,5,10840,4.486754966887418,40.0,0.0
42416,4,2416,[515  79 427 318 588],716,5,10845,4.486967314853124,40.0,0.0
42417,4,2417,[515  79 427 318 588],716,5,10850,4.487179487179487,40.0,0.0
42418,4,2418,[515  79 427 318 588],716,5,10855,4.487391484084332,40.0,0.0
42419,4,2419,[515  79 427 318 588],716,5,10860,4.487603305785124,40.0,0.0
42420,4,2420,[515  79 427 318 588],807,5,10865,4.487814952498967,40.0,0.0
42421,4,2421,[515  79 427 318 588],18,5,10870,4.48802642444261,40.0,0.0
42422,4,2422,[515  79 427 318 588],807,5,10875,4.488237721832439,40.0,0.0
42423,4,2423,[515  79 427 318 588],18,5,10880,4.488448844884489,40.0,0.0
42424,4,2424,[257 132 125 176 194],504,3,10883,4.487835051546392,0.0,0.0
42425,4,2425,[318 117  89 655 216],450,5,10888,4.488046166529267,20.0,0.0
42426,4,2426,[ 79 515 427 318 588],807,5,10893,4.488257107540173,40.0,0.0
42427,4,2427,[ 79 515 427 318 588],807,5,10898,4.488467874794069,40.0,0.0
42428,4,2428,[ 79 515 427 318 588],807,5,10903,4.488678468505558,40.0,0.0
42429,4,2429,[ 79 515 427 318 588],807,5,10908,4.488888888888889,40.0,0.0
42430,4,2430,[ 79 515 427 318 588],716,5,10913,4.48909913615796,40.0,0.0
42431,4,2431,[185   9  64 588 403],18,3,10916,4.488486842105263,20.0,0.0
42432,4,2432,[132 173 237 174 471],280,1,10917,4.487053020961776,0.0,0.0
42433,4,2433,[515  79 427 318 588],807,5,10922,4.487263763352506,40.0,0.0
42434,4,2434,[515  79 427 318 588],807,5,10927,4.487474332648871,40.0,0.0
42435,4,2435,[515  79 427 318 588],18,5,10932,4.487684729064039,40.0,0.0
42436,4,2436,[100 183 196   9 215],151,2,10934,4.4866639310627825,0.0,20.0
42437,4,2437,[515  79 427 318 588],18,5,10939,4.48687448728466,40.0,0.0
42438,4,2438,[515  79 427 318 588],807,5,10944,4.487084870848708,40.0,0.0
42439,4,2439,[515  79 427 318 588],716,5,10949,4.487295081967213,40.0,0.0
42440,4,2440,[ 70 568 546 132 161],280,4,10953,4.487095452683326,0.0,0.0
42441,4,2441,[515  79 427 318 588],18,5,10958,4.487305487305488,40.0,0.0
42442,4,2442,[515  79 427 318 588],18,5,10963,4.4875153499795335,40.0,0.0
42443,4,2443,[515  79 427 318 588],807,5,10968,4.48772504091653,40.0,0.0
42444,4,2444,[515  79 427 318 588],716,5,10973,4.487934560327198,40.0,0.0
42445,4,2445,[515  79 427 318 588],18,5,10978,4.488143908421914,40.0,0.0
42446,4,2446,[515  79 427 318 588],807,5,10983,4.488353085410707,40.0,0.0
42447,4,2447,[172 204 269  12   7],450,5,10988,4.488562091503268,0.0,0.0
42448,4,2448,[179 210 483 234 135],389,3,10991,4.487954267047774,0.0,0.0
42449,4,2449,[515  79 427 318 588],18,5,10996,4.488163265306122,40.0,0.0
42450,4,2450,[515  79 427 318 588],807,5,11001,4.488372093023256,40.0,0.0
42451,4,2451,[117  69 187 222  95],796,5,11006,4.488580750407831,0.0,0.0
42452,4,2452,[515  79 427 318 588],18,5,11011,4.488789237668161,40.0,0.0
42453,4,2453,[515  79 427 318 588],18,5,11016,4.488997555012225,40.0,0.0
42454,4,2454,[515  79 427 318 588],716,5,11021,4.4892057026476575,40.0,0.0
42455,4,2455,[144  22 238 235 588],716,3,11024,4.488599348534202,0.0,0.0
42456,4,2456,[322  98 301 313 508],344,3,11027,4.487993487993488,0.0,0.0
42457,4,2457,[515  79 427 318 588],716,5,11032,4.48820179007323,40.0,0.0
42458,4,2458,[357 496 286 191 125],18,4,11036,4.488003253355022,20.0,20.0
42459,4,2459,[ 97 195 678 215 210],344,2,11038,4.4869918699186995,0.0,0.0
42460,4,2460,[423 151   7 471 100],450,5,11043,4.487200325071109,0.0,20.0
42461,4,2461,[ 12  71 125 235 186],450,2,11045,4.486190089358245,0.0,0.0
42462,4,2462,[515  79 427 318 588],18,5,11050,4.486398700771417,40.0,0.0
42463,4,2463,[515  79 427 318 588],807,5,11055,4.486607142857143,40.0,0.0
42464,4,2464,[515  79 427 318 588],716,5,11060,4.486815415821501,40.0,0.0
42465,4,2465,[515  79 427 318 588],716,5,11065,4.4870235198702355,40.0,0.0
42466,4,2466,[515  79 427 318 588],807,5,11070,4.4872314552087555,40.0,0.0
42467,4,2467,[515  79 427 318 588],807,5,11075,4.4874392220421395,40.0,0.0
42468,4,2468,[515  79 427 318 588],807,5,11080,4.487646820575131,40.0,0.0
42469,4,2469,[515  79 427 318 588],807,5,11085,4.487854251012146,40.0,0.0
42470,4,2470,[ 79 302 275 222 195],655,3,11088,4.4872521246458925,0.0,20.0
42471,4,2471,[300 257  56 172 135],389,2,11090,4.486245954692556,0.0,0.0
42472,4,2472,[ 56 237  22 196  28],457,5,11095,4.486453699959563,0.0,0.0
42473,4,2473,[515  79 427 318 588],18,5,11100,4.486661277283751,40.0,0.0
42474,4,2474,[515  79 427 318 588],807,5,11105,4.486868686868687,40.0,0.0
42475,4,2475,[515  79 427 318 588],18,5,11110,4.487075928917609,40.0,0.0
42476,4,2476,[515  79 427 318 588],716,5,11115,4.4872830036334275,40.0,0.0
42477,4,2477,[515  79 427 318 588],18,5,11120,4.4874899112187245,40.0,0.0
42478,4,2478,[515  79 427 318 588],807,5,11125,4.487696651875757,40.0,0.0
42479,4,2479,[515  79 427 318 588],18,5,11130,4.487903225806452,40.0,0.0
42480,4,2480,[515  79 427 318 588],716,5,11135,4.488109633212415,40.0,0.0
42481,4,2481,[238   8 222 161 655],457,5,11140,4.488315874294924,0.0,0.0
42482,4,2482,[ 79 515 427 318 588],807,5,11145,4.488521949254934,40.0,0.0
42483,4,2483,[ 79 515 427 318 588],807,5,11150,4.488727858293076,40.0,0.0
42484,4,2484,[143 271 423 121  88],655,1,11151,4.487323943661972,0.0,0.0
42485,4,2485,[546 655 186   4 132],151,4,11155,4.487127916331456,0.0,0.0
42486,4,2486,[515  79 427 318 588],716,5,11160,4.487334137515078,40.0,0.0
42487,4,2487,[515  79 427 318 588],18,5,11165,4.487540192926045,40.0,0.0
42488,4,2488,[181 185  12 151 176],796,5,11170,4.487746082764162,0.0,0.0
42489,4,2489,[515  79 427 318 588],18,5,11175,4.4879518072289155,40.0,0.0
42490,4,2490,[515  79 427 318 588],18,5,11180,4.48815736651947,40.0,0.0
42491,4,2491,[515  79 427 318 588],716,5,11185,4.488362760834671,40.0,0.0
42492,4,2492,[515  79 427 318 588],18,5,11190,4.488567990373045,40.0,0.0
42493,4,2493,[515  79 427 318 588],807,5,11195,4.488773055332799,40.0,0.0
42494,4,2494,[515  79 427 318 588],716,5,11200,4.488977955911824,40.0,0.0
42495,4,2495,[216  25   7  97  96],457,5,11205,4.4891826923076925,0.0,0.0
42496,4,2496,[ 79 515 427 318 588],807,5,11210,4.489387264717661,40.0,0.0
42497,4,2497,[ 56 216 210 313 182],655,3,11213,4.488791032826261,0.0,0.0
42498,4,2498,[603 132 216 211 508],655,2,11215,4.487795118047219,20.0,0.0
42499,4,2499,[515  79 427 318 588],807,5,11220,4.488,40.0,0.0
42500,4,2500,[515  79 427 318 588],807,5,11225,4.488204718112755,40.0,0.0
42501,4,2501,[515  79 427 318 588],18,5,11230,4.488409272581935,40.0,0.0
42502,4,2502,[515  79 427 318 588],18,5,11235,4.488613663603676,40.0,0.0
42503,4,2503,[515  79 427 318 588],807,5,11240,4.4888178913738015,40.0,0.0
42504,4,2504,[515  79 427 318 588],807,5,11245,4.489021956087824,40.0,0.0
42505,4,2505,[357 471 333  56 183],693,2,11247,4.488028731045491,0.0,0.0
42506,4,2506,[515  79 427 318 588],807,5,11252,4.488232947746311,40.0,0.0
42507,4,2507,[204 471 286 161 168],401,2,11254,4.487240829346092,0.0,20.0
42508,4,2508,[515  79 427 318 588],716,5,11259,4.487445197289757,40.0,0.0
42509,4,2509,[515  79 427 318 588],716,5,11264,4.4876494023904385,40.0,0.0
42510,4,2510,[515  79 427 318 588],18,5,11269,4.487853444842692,40.0,0.0
42511,4,2511,[515  79 427 318 588],716,5,11274,4.4880573248407645,40.0,0.0
42512,4,2512,[  9 357 175 173 132],269,4,11278,4.487863111818544,0.0,0.0
42513,4,2513,[515  79 427 318 588],716,5,11283,4.488066825775657,40.0,0.0
42514,4,2514,[515  79 427 318 588],716,5,11288,4.488270377733598,40.0,0.0
42515,4,2515,[588 153 318  97 211],450,5,11293,4.488473767885533,20.0,0.0
42516,4,2516,[515  79 427 318 588],716,5,11298,4.4886769964243145,40.0,0.0
42517,4,2517,[515  79 427 318 588],716,5,11303,4.488880063542494,40.0,0.0
42518,4,2518,[515  79 427 318 588],716,5,11308,4.489082969432315,40.0,0.0
42519,4,2519,[515  79 427 318 588],716,5,11313,4.489285714285714,40.0,0.0
42520,4,2520,[515  79 427 318 588],18,5,11318,4.489488298294328,40.0,0.0
42521,4,2521,[515  79 427 318 588],716,5,11323,4.489690721649485,40.0,0.0
42522,4,2522,[182  89 603 143  25],450,4,11327,4.489496630994847,20.0,0.0
42523,4,2523,[515  79 427 318 588],18,5,11332,4.489698890649763,40.0,0.0
42524,4,2524,[515  79 427 318 588],716,5,11337,4.48990099009901,40.0,0.0
42525,4,2525,[515  79 427 318 588],716,5,11342,4.490102929532858,40.0,0.0
42526,4,2526,[515  79 427 318 588],18,5,11347,4.490304709141275,40.0,0.0
42527,4,2527,[515  79 427 318 588],807,5,11352,4.4905063291139244,40.0,0.0
42528,4,2528,[515  79 427 318 588],716,5,11357,4.490707789640174,40.0,0.0
42529,4,2529,[515  79 427 318 588],716,5,11362,4.490909090909091,40.0,0.0
42530,4,2530,[515  79 427 318 588],807,5,11367,4.491110233109443,40.0,0.0
42531,4,2531,[515  79 427 318 588],716,5,11372,4.4913112164296995,40.0,0.0
42532,4,2532,[515  79 427 318 588],807,5,11377,4.491512041058034,40.0,0.0
42533,4,2533,[515  79 427 318 588],716,5,11382,4.49171270718232,40.0,0.0
42534,4,2534,[515  79 427 318 588],716,5,11387,4.491913214990138,40.0,0.0
42535,4,2535,[515  79 427 318 588],807,5,11392,4.492113564668769,40.0,0.0
42536,4,2536,[597 588  89 742 196],457,4,11396,4.491919590067008,0.0,0.0
42537,4,2537,[515  79 427 318 588],18,5,11401,4.492119779353822,40.0,0.0
42538,4,2538,[515  79 427 318 588],807,5,11406,4.492319810949192,40.0,0.0
42539,4,2539,[515  79 427 318 588],716,5,11411,4.49251968503937,40.0,0.0
42540,4,2540,[  9 181  98  71 258],344,2,11413,4.491538764266037,0.0,0.0
42541,4,2541,[515  79 427 318 588],716,5,11418,4.491738788355626,40.0,0.0
42542,4,2542,[515  79 427 318 588],18,5,11423,4.491938655131734,40.0,0.0
42543,4,2543,[515  79 427 318 588],18,5,11428,4.4921383647798745,40.0,0.0
42544,4,2544,[234 121 597 742 245],593,2,11430,4.491159135559921,0.0,0.0
42545,4,2545,[515  79 427 318 588],716,5,11435,4.491358994501178,40.0,0.0
42546,4,2546,[515  79 427 318 588],716,5,11440,4.491558696505693,40.0,0.0
42547,4,2547,[515  79 427 318 588],18,5,11445,4.491758241758242,40.0,0.0
42548,4,2548,[515  79 427 318 588],18,5,11450,4.491957630443311,40.0,0.0
42549,4,2549,[222 172  64 234 238],151,5,11455,4.492156862745098,20.0,0.0
42550,4,2550,[515  79 427 318 588],807,5,11460,4.492355938847511,40.0,0.0
42551,4,2551,[515  79 427 318 588],716,5,11465,4.492554858934169,40.0,0.0
42552,4,2552,[515  79 427 318 588],716,5,11470,4.492753623188406,40.0,0.0
42553,4,2553,[515  79 427 318 588],716,5,11475,4.492952231793265,40.0,0.0
42554,4,2554,[515  79 427 318 588],807,5,11480,4.493150684931507,40.0,0.0
42555,4,2555,[ 88 196 204 180 135],450,4,11484,4.492957746478873,0.0,0.0
42556,4,2556,[187  88 191  96 202],796,5,11489,4.493156042236996,0.0,0.0
42557,4,2557,[515  79 427 318 588],716,5,11494,4.493354182955434,40.0,0.0
42558,4,2558,[515  79 427 318 588],807,5,11499,4.493552168815944,40.0,0.0
42559,4,2559,[515  79 427 318 588],18,5,11504,4.49375,40.0,0.0
42560,4,2560,[515  79 427 318 588],807,5,11509,4.493947676688793,40.0,0.0
42561,4,2561,[515  79 427 318 588],18,5,11514,4.494145199063232,40.0,0.0
42562,4,2562,[515  79 427 318 588],807,5,11519,4.49434256730394,40.0,0.0
42563,4,2563,[132 180 245 183 195],504,4,11523,4.49414976599064,0.0,0.0
42564,4,2564,[ 79 515 427 318 588],18,5,11528,4.4943469785575045,40.0,0.0
42565,4,2565,[118 183 111 322  70],280,3,11531,4.493764614185503,0.0,0.0
42566,4,2566,[300 111 238 204  50],389,3,11534,4.493182703544994,0.0,20.0
42567,4,2567,[ 79 515 427 318 588],716,5,11539,4.493380062305296,40.0,0.0
42568,4,2568,[ 79 515 427 318 588],18,5,11544,4.493577267419229,40.0,0.0
42569,4,2569,[ 79 515 427 318 588],807,5,11549,4.493774319066148,40.0,0.0
42570,4,2570,[ 79 515 427 318 588],716,5,11554,4.493971217425126,40.0,0.0
42571,4,2571,[ 79 515 427 318 588],807,5,11559,4.494167962674961,40.0,0.0
42572,4,2572,[ 79 515 427 318 588],716,5,11564,4.494364554994171,40.0,0.0
42573,4,2573,[ 79 515 427 318 588],716,5,11569,4.494560994560994,40.0,0.0
42574,4,2574,[ 79 515 427 318 588],18,5,11574,4.494757281553398,40.0,0.0
42575,4,2575,[ 79 515 427 318 588],716,5,11579,4.494953416149069,40.0,0.0
42576,4,2576,[ 79 515 427 318 588],716,5,11584,4.495149398525417,40.0,0.0
42577,4,2577,[ 79 515 427 318 588],18,5,11589,4.495345228859581,40.0,0.0
42578,4,2578,[234 275   8  56 328],655,1,11590,4.4939899185730905,0.0,20.0
42579,4,2579,[ 79 515 427 318 588],807,5,11595,4.494186046511628,40.0,0.0
42580,4,2580,[ 79 515 427 318 588],18,5,11600,4.49438202247191,40.0,0.0
42581,4,2581,[ 98 235 275 269 405],450,4,11604,4.49419054996127,0.0,20.0
42582,4,2582,[515  79 427 318 588],716,5,11609,4.4943863724351525,40.0,0.0
42583,4,2583,[515  79 427 318 588],716,5,11614,4.494582043343653,40.0,0.0
42584,4,2584,[318   9 515  71 235],401,2,11616,4.493617021276596,20.0,0.0
42585,4,2585,[515  79 427 318 588],716,5,11621,4.493812838360403,40.0,0.0
42586,4,2586,[515  79 427 318 588],18,5,11626,4.494008504058756,40.0,0.0
42587,4,2587,[603 496 282  50 125],796,5,11631,4.494204018547141,40.0,20.0
42588,4,2588,[515  79 427 318 588],716,5,11636,4.494399382000773,40.0,0.0
42589,4,2589,[515  79 427 318 588],807,5,11641,4.494594594594594,40.0,0.0
42590,4,2590,[515  79 427 318 588],716,5,11646,4.494789656503281,40.0,0.0
42591,4,2591,[515  79 427 318 588],716,5,11651,4.494984567901234,40.0,0.0
42592,4,2592,[185 153  95  56 187],796,5,11656,4.495179328962592,0.0,0.0
42593,4,2593,[515  79 427 318 588],807,5,11661,4.495373939861218,40.0,0.0
42594,4,2594,[132 143 228 100 202],450,5,11666,4.495568400770713,0.0,20.0
42595,4,2595,[515  79 427 318 588],18,5,11671,4.495762711864407,40.0,0.0
42596,4,2596,[515  79 427 318 588],807,5,11676,4.495956873315364,40.0,0.0
42597,4,2597,[515  79 427 318 588],807,5,11681,4.496150885296382,40.0,0.0
42598,4,2598,[515  79 427 318 588],807,5,11686,4.496344747979992,40.0,0.0
42599,4,2599,[515  79 427 318 588],18,5,11691,4.496538461538462,40.0,0.0
42600,4,2600,[515  79 427 318 588],807,5,11696,4.496732026143791,40.0,0.0
42601,4,2601,[  8   4 125 471 235],280,2,11698,4.495772482705611,0.0,0.0
42602,4,2602,[515  79 427 318 588],716,5,11703,4.495966192854398,40.0,0.0
42603,4,2603,[515  79 427 318 588],716,5,11708,4.49615975422427,40.0,0.0
42604,4,2604,[515  79 427 318 588],18,5,11713,4.496353166986564,40.0,0.0
42605,4,2605,[515  79 427 318 588],807,5,11718,4.496546431312356,40.0,0.0
42606,4,2606,[655 237 235 742  50],450,4,11722,4.4963559647103954,0.0,20.0
42607,4,2607,[215 153 234 237 483],655,1,11723,4.495015337423313,0.0,0.0
42608,4,2608,[117  12 333 176 135],693,3,11726,4.494442315063242,0.0,0.0
42609,4,2609,[174 168  95 132 258],450,4,11730,4.494252873563219,0.0,0.0
42610,4,2610,[515  79 427 318 588],18,5,11735,4.494446572194562,40.0,0.0
42611,4,2611,[515  79 427 318 588],18,5,11740,4.494640122511486,40.0,0.0
42612,4,2612,[515  79 427 318 588],18,5,11745,4.494833524684271,40.0,0.0
42613,4,2613,[496 202 318   4 174],450,4,11749,4.4946442234123944,40.0,0.0
42614,4,2614,[515  79 427 318 588],716,5,11754,4.494837476099426,40.0,0.0
42615,4,2615,[515  79 427 318 588],807,5,11759,4.495030581039756,40.0,0.0
42616,4,2616,[515  79 427 318 588],716,5,11764,4.495223538402751,40.0,0.0
42617,4,2617,[515  79 427 318 588],18,5,11769,4.495416348357525,40.0,0.0
42618,4,2618,[515  79 427 318 588],807,5,11774,4.495609011072928,40.0,0.0
42619,4,2619,[515  79 427 318 588],18,5,11779,4.495801526717557,40.0,0.0
42620,4,2620,[515  79 427 318 588],807,5,11784,4.4959938954597485,40.0,0.0
42621,4,2621,[515  79 427 318 588],18,5,11789,4.496186117467582,40.0,0.0
42622,4,2622,[515  79 427 318 588],716,5,11794,4.496378192908883,40.0,0.0
42623,4,2623,[ 12  69 197  96 258],457,5,11799,4.496570121951219,0.0,0.0
42624,4,2624,[515  79 427 318 588],18,5,11804,4.496761904761905,40.0,0.0
42625,4,2625,[515  79 427 318 588],716,5,11809,4.496953541507997,40.0,0.0
42626,4,2626,[515  79 427 318 588],716,5,11814,4.4971450323563,40.0,0.0
42627,4,2627,[515  79 427 318 588],716,5,11819,4.4973363774733635,40.0,0.0
42628,4,2628,[515  79 427 318 588],807,5,11824,4.497527577025485,40.0,0.0
42629,4,2629,[742 118   4 176 265],457,5,11829,4.497718631178707,0.0,0.0
42630,4,2630,[515  79 427 318 588],716,5,11834,4.497909540098822,40.0,0.0
42631,4,2631,[515  79 427 318 588],18,5,11839,4.498100303951368,40.0,0.0
42632,4,2632,[515  79 427 318 588],807,5,11844,4.498290922901633,40.0,0.0
42633,4,2633,[515  79 427 318 588],716,5,11849,4.498481397114655,40.0,0.0
42634,4,2634,[168 132 187  64  95],450,4,11853,4.498292220113852,20.0,0.0
42635,4,2635,[515  79 427 318 588],18,5,11858,4.498482549317147,40.0,0.0
42636,4,2636,[515  79 427 318 588],716,5,11863,4.498672734167615,40.0,0.0
42637,4,2637,[515  79 427 318 588],716,5,11868,4.4988627748294165,40.0,0.0
42638,4,2638,[515  79 427 318 588],807,5,11873,4.4990526714664645,40.0,0.0
42639,4,2639,[515  79 427 318 588],716,5,11878,4.499242424242424,40.0,0.0
42640,4,2640,[515  79 427 318 588],18,5,11883,4.499432033320712,40.0,0.0
42641,4,2641,[515  79 427 318 588],807,5,11888,4.499621498864497,40.0,0.0
42642,4,2642,[127   4 182 200  56],280,3,11891,4.499054105183504,0.0,20.0
42643,4,2643,[515  79 427 318 588],807,5,11896,4.499243570347958,40.0,0.0
42644,4,2644,[515  79 427 318 588],716,5,11901,4.499432892249527,40.0,0.0
42645,4,2645,[ 69 117  25 357 655],457,5,11906,4.499622071050642,0.0,0.0
42646,4,2646,[515  79 427 318 588],18,5,11911,4.499811106913487,40.0,0.0
42647,4,2647,[515  79 427 318 588],807,5,11916,4.5,40.0,0.0
42648,4,2648,[515  79 427 318 588],807,5,11921,4.500188750471876,40.0,0.0
42649,4,2649,[515  79 427 318 588],807,5,11926,4.500377358490566,40.0,0.0
42650,4,2650,[515  79 427 318 588],18,5,11931,4.500565824217277,40.0,0.0
42651,4,2651,[515  79 427 318 588],716,5,11936,4.500754147812971,40.0,0.0
42652,4,2652,[179 211 258 197 175],655,1,11937,4.499434602336977,0.0,0.0
42653,4,2653,[515  79 427 318 588],716,5,11942,4.499623210248681,40.0,0.0
42654,4,2654,[515  79 427 318 588],716,5,11947,4.499811676082863,40.0,0.0
42655,4,2655,[515  79 427 318 588],18,5,11952,4.5,40.0,0.0
42656,4,2656,[515  79 427 318 588],807,5,11957,4.500188182160331,40.0,0.0
42657,4,2657,[515  79 427 318 588],18,5,11962,4.500376222723853,40.0,0.0
42658,4,2658,[125 276 228   9 187],786,4,11966,4.500188040616774,0.0,0.0
42659,4,2659,[515  79 427 318 588],18,5,11971,4.500375939849624,40.0,0.0
42660,4,2660,[ 69  50 210  82 211],389,4,11975,4.500187899285983,0.0,20.0
42661,4,2661,[515  79 427 318 588],716,5,11980,4.5003756574004505,40.0,0.0
42662,4,2662,[515  79 427 318 588],18,5,11985,4.500563274502441,40.0,0.0
42663,4,2663,[515  79 427 318 588],18,5,11990,4.5007507507507505,40.0,0.0
42664,4,2664,[ 69 172 568 151  22],20,2,11992,4.499812382739212,0.0,0.0
42665,4,2665,[515  79 427 318 588],716,5,11997,4.5,40.0,0.0
42666,4,2666,[515  79 427 318 588],18,5,12002,4.500187476565429,40.0,0.0
42667,4,2667,[ 98 215 276 181 508],280,2,12004,4.499250374812593,0.0,0.0
42668,4,2668,[153 508 197 603 276],401,3,12007,4.498688647433496,20.0,0.0
42669,4,2669,[202 318 174  12 182],450,5,12012,4.498876404494382,20.0,0.0
42670,4,2670,[ 79 515 427 318 588],716,5,12017,4.49906402096593,40.0,0.0
42671,4,2671,[ 79 515 427 318 588],18,5,12022,4.499251497005988,40.0,0.0
42672,4,2672,[258 222 568 405 215],796,5,12027,4.499438832772166,0.0,0.0
42673,4,2673,[ 79 515 427 318 588],807,5,12032,4.49962602842184,40.0,0.0
42674,4,2674,[ 79 515 427 318 588],807,5,12037,4.49981308411215,40.0,0.0
42675,4,2675,[ 79 515 427 318 588],18,5,12042,4.5,40.0,0.0
42676,4,2676,[ 79 515 427 318 588],807,5,12047,4.500186776242062,40.0,0.0
42677,4,2677,[ 79 515 427 318 588],716,5,12052,4.500373412994772,40.0,0.0
42678,4,2678,[ 79 515 427 318 588],716,5,12057,4.500559910414334,40.0,0.0
42679,4,2679,[ 79 515 427 318 588],807,5,12062,4.500746268656717,40.0,0.0
42680,4,2680,[ 79 515 427 318 588],807,5,12067,4.500932487877658,40.0,0.0
42681,4,2681,[174  71 546 161  79],577,4,12071,4.500745712155108,0.0,0.0
42682,4,2682,[ 79 515 427 318 588],807,5,12076,4.500931792769288,40.0,0.0
42683,4,2683,[ 79 515 427 318 588],807,5,12081,4.501117734724292,40.0,0.0
42684,4,2684,[ 79 515 427 318 588],18,5,12086,4.501303538175047,40.0,0.0
42685,4,2685,[ 79 515 427 318 588],716,5,12091,4.501489203276247,40.0,0.0
42686,4,2686,[ 79 515 427 318 588],807,5,12096,4.501674730182359,40.0,0.0
42687,4,2687,[403  96 183 742 196],655,1,12097,4.500372023809524,0.0,0.0
42688,4,2688,[ 79 515 427 318 588],18,5,12102,4.500557828188918,40.0,0.0
42689,4,2689,[ 79 515 427 318 588],807,5,12107,4.500743494423792,40.0,0.0
42690,4,2690,[ 79 515 427 318 588],716,5,12112,4.500929022668153,40.0,0.0
42691,4,2691,[ 79 515 427 318 588],807,5,12117,4.50111441307578,40.0,0.0
42692,4,2692,[ 79 515 427 318 588],18,5,12122,4.5012996658002224,40.0,0.0
42693,4,2693,[ 22 144 168 435   1],807,4,12126,4.501113585746102,0.0,0.0
42694,4,2694,[ 79 515 427 318 588],716,5,12131,4.501298701298701,40.0,0.0
42695,4,2695,[ 79 515 427 318 588],18,5,12136,4.501483679525222,40.0,0.0
42696,4,2696,[ 79 515 427 318 588],18,5,12141,4.501668520578421,40.0,0.0
42697,4,2697,[ 79 515 427 318 588],716,5,12146,4.501853224610823,40.0,0.0
42698,4,2698,[181 210  56  79 117],457,5,12151,4.502037791774732,0.0,0.0
42699,4,2699,[172 234 187   7  50],786,4,12155,4.5018518518518515,0.0,20.0
42700,4,2700,[ 79 515 427 318 588],18,5,12160,4.5020362828582,40.0,0.0
42701,4,2701,[ 79 515 427 318 588],18,5,12165,4.502220577350111,40.0,0.0
42702,4,2702,[ 79 515 427 318 588],807,5,12170,4.5024047354790975,40.0,0.0
42703,4,2703,[ 79 515 427 318 588],18,5,12175,4.50258875739645,40.0,0.0
42704,4,2704,[ 79 515 427 318 588],716,5,12180,4.502772643253235,40.0,0.0
42705,4,2705,[195 423 475 276  70],269,3,12183,4.5022172949002215,0.0,0.0
42706,4,2706,[257  97 275  22 237],330,5,12188,4.502401182120429,0.0,20.0
42707,4,2707,[515  79 427 318 588],716,5,12193,4.50258493353028,40.0,0.0
42708,4,2708,[515  79 427 318 588],807,5,12198,4.5027685492801774,40.0,0.0
42709,4,2709,[515  79 427 318 588],807,5,12203,4.502952029520295,40.0,0.0
42710,4,2710,[191 181 257 237 204],457,4,12207,4.5027665068240506,0.0,0.0
42711,4,2711,[515  79 427 318 588],807,5,12212,4.502949852507375,40.0,0.0
42712,4,2712,[515  79 427 318 588],18,5,12217,4.503133063029856,40.0,0.0
42713,4,2713,[515  79 427 318 588],716,5,12222,4.503316138540899,40.0,0.0
42714,4,2714,[515  79 427 318 588],807,5,12227,4.5034990791896865,40.0,0.0
42715,4,2715,[515  79 427 318 588],807,5,12232,4.503681885125184,40.0,0.0
42716,4,2716,[515  79 427 318 588],807,5,12237,4.5038645564961355,40.0,0.0
42717,4,2717,[515  79 427 318 588],716,5,12242,4.504047093451067,40.0,0.0
42718,4,2718,[515  79 427 318 588],716,5,12247,4.5042294961382865,40.0,0.0
42719,4,2719,[ 12 323 546 423 181],280,3,12250,4.5036764705882355,0.0,0.0
42720,4,2720,[ 56   9  15 211 238],296,4,12254,4.503491363469313,0.0,0.0
42721,4,2721,[483 121 655 333  50],655,2,12256,4.502571638501102,0.0,20.0
42722,4,2722,[ 79 515 427 318 588],716,5,12261,4.502754315093647,40.0,0.0
42723,4,2723,[ 79 515 427 318 588],807,5,12266,4.502936857562408,40.0,0.0
42724,4,2724,[ 79 515 427 318 588],18,5,12271,4.503119266055046,40.0,0.0
42725,4,2725,[ 79 515 427 318 588],807,5,12276,4.5033015407190025,40.0,0.0
42726,4,2726,[ 79 515 427 318 588],807,5,12281,4.503483681701503,40.0,0.0
42727,4,2727,[  9 313  28 132  12],655,1,12282,4.502199413489736,0.0,0.0
42728,4,2728,[ 79 515 427 318 588],807,5,12287,4.5023818248442655,40.0,0.0
42729,4,2729,[ 79 515 427 318 588],807,5,12292,4.5025641025641026,40.0,0.0
42730,4,2730,[ 79 515 427 318 588],807,5,12297,4.502746246796045,40.0,0.0
42731,4,2731,[ 79 515 427 318 588],18,5,12302,4.502928257686676,40.0,0.0
42732,4,2732,[ 79 515 427 318 588],18,5,12307,4.5031101353823635,40.0,0.0
42733,4,2733,[ 79 515 427 318 588],18,5,12312,4.503291880029261,40.0,0.0
42734,4,2734,[ 79 515 427 318 588],716,5,12317,4.503473491773309,40.0,0.0
42735,4,2735,[ 79 515 427 318 588],716,5,12322,4.503654970760234,40.0,0.0
42736,4,2736,[483 215 174 183  28],693,2,12324,4.502740226525392,0.0,0.0
42737,4,2737,[ 79 515 427 318 588],807,5,12329,4.5029218407596785,40.0,0.0
42738,4,2738,[175 748 405 195  98],151,2,12331,4.502008032128514,0.0,0.0
42739,4,2739,[ 79 515 427 318 588],807,5,12336,4.502189781021897,40.0,0.0
42740,4,2740,[ 70 204   8  97 153],593,4,12340,4.50200656694637,0.0,0.0
42741,4,2741,[ 79 515 427 318 588],716,5,12345,4.50218818380744,40.0,0.0
42742,4,2742,[ 79 515 427 318 588],716,5,12350,4.502369668246446,40.0,0.0
42743,4,2743,[ 79 515 427 318 588],18,5,12355,4.502551020408164,40.0,0.0
42744,4,2744,[ 79 515 427 318 588],716,5,12360,4.502732240437158,40.0,0.0
42745,4,2745,[ 79 515 427 318 588],807,5,12365,4.502913328477786,40.0,0.0
42746,4,2746,[ 79 515 427 318 588],807,5,12370,4.50309428467419,40.0,0.0
42747,4,2747,[ 79 515 427 318 588],18,5,12375,4.503275109170306,40.0,0.0
42748,4,2748,[ 79 515 427 318 588],716,5,12380,4.503455802109858,40.0,0.0
42749,4,2749,[ 79 515 427 318 588],18,5,12385,4.503636363636364,40.0,0.0
42750,4,2750,[ 79 515 427 318 588],18,5,12390,4.5038167938931295,40.0,0.0
42751,4,2751,[ 79 515 427 318 588],807,5,12395,4.503997093023256,40.0,0.0
42752,4,2752,[179 313  98 655 357],450,5,12400,4.504177261169633,0.0,0.0
42753,4,2753,[ 79 515 427 318 588],807,5,12405,4.504357298474946,40.0,0.0
42754,4,2754,[ 79 515 427 318 588],716,5,12410,4.50453720508167,40.0,0.0
42755,4,2755,[ 79 515 427 318 588],807,5,12415,4.504716981132075,40.0,0.0
42756,4,2756,[ 79 515 427 318 588],716,5,12420,4.504896626768226,40.0,0.0
42757,4,2757,[ 79 515 427 318 588],807,5,12425,4.50507614213198,40.0,0.0
42758,4,2758,[ 79 515 427 318 588],18,5,12430,4.505255527364987,40.0,0.0
42759,4,2759,[ 28 172 197 187 168],716,4,12434,4.505072463768116,0.0,0.0
42760,4,2760,[ 79 515 427 318 588],716,5,12439,4.505251720391163,40.0,0.0
42761,4,2761,[ 79 515 427 318 588],807,5,12444,4.505430847212165,40.0,0.0
42762,4,2762,[ 79 515 427 318 588],716,5,12449,4.505609844372059,40.0,0.0
42763,4,2763,[  7  25 100 121  69],72,3,12452,4.50506512301013,0.0,20.0
42764,4,2764,[515  79 427 318 588],716,5,12457,4.505244122965642,40.0,0.0
42765,4,2765,[435 176  56  95  88],389,3,12460,4.50469992769342,0.0,0.0
42766,4,2766,[742 183  15 135 258],655,2,12462,4.503794723527286,0.0,0.0
42767,4,2767,[ 79 515 427 318 588],18,5,12467,4.503973988439307,40.0,0.0
42768,4,2768,[ 79 515 427 318 588],18,5,12472,4.504153123871434,40.0,0.0
42769,4,2769,[ 79 515 427 318 588],807,5,12477,4.504332129963899,40.0,0.0
42770,4,2770,[ 79 515 427 318 588],716,5,12482,4.50451100685673,40.0,0.0
42771,4,2771,[ 79 515 427 318 588],716,5,12487,4.504689754689755,40.0,0.0
42772,4,2772,[568 186 183  15 151],577,3,12490,4.504147133068878,0.0,0.0
42773,4,2773,[111 194 216 483 211],796,4,12494,4.503965392934391,0.0,0.0
42774,4,2774,[ 79 515 427 318 588],18,5,12499,4.504144144144144,40.0,0.0
42775,4,2775,[ 79 515 427 318 588],807,5,12504,4.504322766570605,40.0,0.0
42776,4,2776,[ 79 515 427 318 588],18,5,12509,4.504501260352899,40.0,0.0
42777,4,2777,[ 79 515 427 318 588],807,5,12514,4.50467962562995,40.0,0.0
42778,4,2778,[ 70 186 435  11 111],450,4,12518,4.504498020870817,0.0,0.0
42779,4,2779,[135 183 313 176 194],450,4,12522,4.50431654676259,0.0,0.0
42780,4,2780,[ 79 515 427 318 588],807,5,12527,4.504494786048184,40.0,0.0
42781,4,2781,[ 79 515 427 318 588],716,5,12532,4.5046728971962615,40.0,0.0
42782,4,2782,[ 79 515 427 318 588],716,5,12537,4.504850880344952,40.0,0.0
42783,4,2783,[318  25 202 132  15],450,3,12540,4.504310344827586,20.0,0.0
42784,4,2784,[ 97 200  15 282 546],593,4,12544,4.504129263913824,0.0,0.0
42785,4,2785,[ 79 515 427 318 588],807,5,12549,4.504307250538407,40.0,0.0
42786,4,2786,[182 245 174 313 588],796,4,12553,4.504126300681737,0.0,0.0
42787,4,2787,[151 282 357 322 275],796,4,12557,4.503945480631277,0.0,20.0
42788,4,2788,[ 79 515 427 318 588],716,5,12562,4.504123341699534,40.0,0.0
42789,4,2789,[ 79 515 427 318 588],807,5,12567,4.504301075268817,40.0,0.0
42790,4,2790,[194 427 588 151  56],18,3,12570,4.5037620924399855,20.0,0.0
42791,4,2791,[ 89  25 210  71 215],450,2,12572,4.502865329512894,0.0,0.0
42792,4,2792,[515  79 427 318 588],807,5,12577,4.503043322592195,40.0,0.0
42793,4,2793,[515  79 427 318 588],807,5,12582,4.503221188260558,40.0,0.0
42794,4,2794,[515  79 427 318 588],716,5,12587,4.50339892665474,40.0,0.0
42795,4,2795,[515  79 427 318 588],807,5,12592,4.503576537911302,40.0,0.0
42796,4,2796,[515  79 427 318 588],18,5,12597,4.503754022166607,40.0,0.0
42797,4,2797,[235 143 195  28 181],23,2,12599,4.5028591851322375,0.0,0.0
42798,4,2798,[515  79 427 318 588],807,5,12604,4.503036798856734,40.0,0.0
42799,4,2799,[276 748 194   1 135],292,4,12608,4.502857142857143,0.0,0.0
42800,4,2800,[515  79 427 318 588],807,5,12613,4.503034630489111,40.0,0.0
42801,4,2801,[508 276 313   8  15],655,2,12615,4.502141327623126,0.0,0.0
42802,4,2802,[515  79 427 318 588],716,5,12620,4.502318943988584,40.0,0.0
42803,4,2803,[135 748  89 181 301],151,4,12624,4.502139800285307,0.0,0.0
42804,4,2804,[ 79 515 427 318 588],18,5,12629,4.502317290552584,40.0,0.0
42805,4,2805,[ 79 515 427 318 588],716,5,12634,4.502494654312188,40.0,0.0
42806,4,2806,[204 275 196 100 228],450,5,12639,4.502671891699323,0.0,40.0
42807,4,2807,[ 79 515 427 318 588],716,5,12644,4.502849002849003,40.0,0.0
42808,4,2808,[742 194  50 176   9],457,5,12649,4.503025987896049,0.0,20.0
42809,4,2809,[ 79 515 427 318 588],18,5,12654,4.503202846975089,40.0,0.0
42810,4,2810,[357 191 204 405 111],655,2,12656,4.502312344361437,0.0,0.0
42811,4,2811,[ 79 515 427 318 588],716,5,12661,4.5024893314367,40.0,0.0
42812,4,2812,[ 79 515 427 318 588],716,5,12666,4.502666192676857,40.0,0.0
42813,4,2813,[ 79 515 427 318 588],18,5,12671,4.5028429282160625,40.0,0.0
42814,4,2814,[ 79 515 427 318 588],18,5,12676,4.503019538188277,40.0,0.0
42815,4,2815,[144 655 216  22 357],655,2,12678,4.502130681818182,0.0,0.0
42816,4,2816,[132 257 238 176 194],716,4,12682,4.501952431664892,0.0,0.0
42817,4,2817,[111 161 258 357 127],457,4,12686,4.501774308019872,0.0,20.0
42818,4,2818,[ 79 515 427 318 588],716,5,12691,4.50195104647038,40.0,0.0
42819,4,2819,[ 79 515 427 318 588],807,5,12696,4.502127659574468,40.0,0.0
42820,4,2820,[ 79 515 427 318 588],807,5,12701,4.502304147465438,40.0,0.0
42821,4,2821,[117 496  88 174 275],330,5,12706,4.5024805102764,20.0,20.0
42822,4,2822,[ 25 215  69 176 302],151,2,12708,4.501594048884166,0.0,0.0
42823,4,2823,[ 79 515 427 318 588],716,5,12713,4.501770538243626,40.0,0.0
42824,4,2824,[275 187 195  82 186],18,3,12716,4.501238938053097,0.0,20.0
42825,4,2825,[ 79 515 427 318 588],716,5,12721,4.501415428167021,40.0,0.0
42826,4,2826,[ 79 515 427 318 588],716,5,12726,4.501591793420587,40.0,0.0
42827,4,2827,[ 79 515 427 318 588],18,5,12731,4.501768033946251,40.0,0.0
42828,4,2828,[ 79 515 427 318 588],18,5,12736,4.501944149876281,40.0,0.0
42829,4,2829,[187  64 111 483 175],269,4,12740,4.501766784452297,20.0,0.0
42830,4,2830,[ 79 515 427 318 588],18,5,12745,4.501942776404097,40.0,0.0
42831,4,2831,[276  12  69 323 215],174,4,12749,4.5017655367231635,0.0,0.0
42832,4,2832,[ 79 515 427 318 588],716,5,12754,4.501941404871161,40.0,0.0
42833,4,2833,[ 82 111 269   7 151],450,4,12758,4.5017642907551165,0.0,0.0
42834,4,2834,[ 79 515 427 318 588],807,5,12763,4.5019400352733685,40.0,0.0
42835,4,2835,[ 79 515 427 318 588],716,5,12768,4.502115655853315,40.0,0.0
42836,4,2836,[ 79 515 427 318 588],716,5,12773,4.502291152626014,40.0,0.0
42837,4,2837,[ 97  70  88 111  11],11,3,12776,4.501761804087385,0.0,0.0
42838,4,2838,[ 79 515 427 318 588],807,5,12781,4.501937301866855,40.0,0.0
42839,4,2839,[ 79 515 427 318 588],807,5,12786,4.502112676056338,40.0,0.0
42840,4,2840,[ 79 427  98 313 210],450,4,12790,4.501935938049982,20.0,0.0
42841,4,2841,[ 89 269 302 258 118],655,2,12792,4.501055594651654,0.0,0.0
42842,4,2842,[515  79 427 318 588],716,5,12797,4.501231093914878,40.0,0.0
42843,4,2843,[515  79 427 318 588],18,5,12802,4.5014064697609,40.0,0.0
42844,4,2844,[181  70 196  82   1],450,4,12806,4.501230228471002,0.0,0.0
42845,4,2845,[515  79 427 318 588],807,5,12811,4.501405481377372,40.0,0.0
42846,4,2846,[515  79 427 318 588],807,5,12816,4.501580611169652,40.0,0.0
42847,4,2847,[515  79 427 318 588],716,5,12821,4.501755617977528,40.0,0.0
42848,4,2848,[515  79 427 318 588],807,5,12826,4.501930501930502,40.0,0.0
42849,4,2849,[515  79 427 318 588],716,5,12831,4.502105263157895,40.0,0.0
42850,4,2850,[515  79 427 318 588],716,5,12836,4.502279901788846,40.0,0.0
42851,4,2851,[ 96 191 211  50   8],796,4,12840,4.502103786816269,0.0,20.0
42852,4,2852,[ 79 515 427 318 588],716,5,12845,4.502278303540133,40.0,0.0
42853,4,2853,[132  69 427 135 237],835,5,12850,4.502452697967764,20.0,0.0
42854,4,2854,[ 12 588 204 216  71],18,4,12854,4.502276707530648,0.0,0.0
42855,4,2855,[ 79 515 427 318 588],716,5,12859,4.502450980392157,40.0,0.0
42856,4,2856,[ 79 515 427 318 588],807,5,12864,4.502625131256563,40.0,0.0
42857,4,2857,[357  96 172 215 121],450,4,12868,4.5024492652204335,0.0,0.0
42858,4,2858,[ 79 515 427 318 588],18,5,12873,4.502623294858342,40.0,0.0
42859,4,2859,[ 79 515 427 318 588],716,5,12878,4.502797202797203,40.0,0.0
42860,4,2860,[ 79 515 427 318 588],716,5,12883,4.502970989164628,40.0,0.0
42861,4,2861,[118  82 135  15  28],389,2,12885,4.5020964360587,0.0,0.0
42862,4,2862,[ 79 515 427 318 588],716,5,12890,4.502270345791128,40.0,0.0
42863,4,2863,[ 79 515 427 318 588],807,5,12895,4.502444134078212,40.0,0.0
42864,4,2864,[ 70 191  98 313 215],655,3,12898,4.501919720767888,0.0,0.0
42865,4,2865,[100 118 588  79  97],457,5,12903,4.502093510118632,0.0,20.0
42866,4,2866,[ 79 515 427 318 588],18,5,12908,4.502267178235089,40.0,0.0
42867,4,2867,[ 79 515 427 318 588],807,5,12913,4.502440725244073,40.0,0.0
42868,4,2868,[ 79 515 427 318 588],807,5,12918,4.50261415127222,40.0,0.0
42869,4,2869,[ 79 515 427 318 588],18,5,12923,4.502787456445993,40.0,0.0
42870,4,2870,[ 79 515 427 318 588],18,5,12928,4.502960640891676,40.0,0.0
42871,4,2871,[ 79 515 427 318 588],716,5,12933,4.503133704735376,40.0,0.0
42872,4,2872,[483 197 275 187 588],389,5,12938,4.503306648103028,0.0,20.0
42873,4,2873,[ 79 515 427 318 588],18,5,12943,4.503479471120389,40.0,0.0
42874,4,2874,[ 79 515 427 318 588],807,5,12948,4.503652173913044,40.0,0.0
42875,4,2875,[181 508 286  69 228],344,2,12950,4.50278164116829,0.0,20.0
42876,4,2876,[ 79 515 427 318 588],716,5,12955,4.5029544664581165,40.0,0.0
42877,4,2877,[ 79 515 427 318 588],716,5,12960,4.503127171646977,40.0,0.0
42878,4,2878,[ 79 515 427 318 588],807,5,12965,4.503299756860021,40.0,0.0
42879,4,2879,[ 79 515 427 318 588],716,5,12970,4.503472222222222,40.0,0.0
42880,4,2880,[ 79 515 427 318 588],18,5,12975,4.503644567858382,40.0,0.0
42881,4,2881,[ 79  70 222  82  12],151,4,12979,4.503469812630118,0.0,0.0
42882,4,2882,[ 79 515 427 318 588],716,5,12984,4.503642039542144,40.0,0.0
42883,4,2883,[ 79 515 427 318 588],18,5,12989,4.503814147018031,40.0,0.0
42884,4,2884,[118 238 174 195 276],655,1,12990,4.50259965337955,0.0,0.0
42885,4,2885,[238 282 204 180 508],296,5,12995,4.502772002772002,0.0,0.0
42886,4,2886,[ 89 172 151  50 194],296,4,12999,4.502597852441982,0.0,20.0
42887,4,2887,[515  79 427 318 588],716,5,13004,4.502770083102493,40.0,0.0
42888,4,2888,[515  79 427 318 588],807,5,13009,4.50294219453098,40.0,0.0
42889,4,2889,[515  79 427 318 588],18,5,13014,4.503114186851211,40.0,0.0
42890,4,2890,[515  79 427 318 588],807,5,13019,4.503286060186786,40.0,0.0
42891,4,2891,[515  79 427 318 588],716,5,13024,4.503457814661134,40.0,0.0
42892,4,2892,[515  79 427 318 588],18,5,13029,4.503629450397511,40.0,0.0
42893,4,2893,[742 258 318 483 121],655,2,13031,4.5027643400138215,20.0,0.0
42894,4,2894,[515  79 427 318 588],807,5,13036,4.50293609671848,40.0,0.0
42895,4,2895,[ 15 187 228 153   9],655,1,13037,4.501726519337017,0.0,0.0
42896,4,2896,[222 191  28 322   7],786,4,13041,4.5015533310321025,0.0,0.0
42897,4,2897,[515  79 427 318 588],716,5,13046,4.501725327812284,40.0,0.0
42898,4,2898,[515  79 427 318 588],716,5,13051,4.50189720593308,40.0,0.0
42899,4,2899,[515  79 427 318 588],18,5,13056,4.502068965517242,40.0,0.0
42900,4,2900,[515  79 427 318 588],18,5,13061,4.502240606687349,40.0,0.0
42901,4,2901,[515  79 427 318 588],18,5,13066,4.502412129565816,40.0,0.0
42902,4,2902,[515  79 427 318 588],716,5,13071,4.502583534274888,40.0,0.0
42903,4,2903,[515  79 427 318 588],18,5,13076,4.502754820936639,40.0,0.0
42904,4,2904,[515  79 427 318 588],807,5,13081,4.502925989672978,40.0,0.0
42905,4,2905,[515  79 427 318 588],18,5,13086,4.503097040605644,40.0,0.0
42906,4,2906,[515  79 427 318 588],716,5,13091,4.503267973856209,40.0,0.0
42907,4,2907,[515  79 427 318 588],716,5,13096,4.50343878954608,40.0,0.0
42908,4,2908,[515  79 427 318 588],18,5,13101,4.503609487796494,40.0,0.0
42909,4,2909,[515  79 427 318 588],18,5,13106,4.503780068728522,40.0,0.0
42910,4,2910,[302 265   7 403  22],655,1,13107,4.5025764342150465,0.0,0.0
42911,4,2911,[215 176 496 100  11],344,3,13110,4.50206043956044,20.0,20.0
42912,4,2912,[ 97 194  56 597 172],796,4,13114,4.501888087881909,0.0,0.0
42913,4,2913,[ 79 515 427 318 588],18,5,13119,4.502059025394646,40.0,0.0
42914,4,2914,[ 79 515 427 318 588],18,5,13124,4.502229845626072,40.0,0.0
42915,4,2915,[ 64 111 180 153 300],292,5,13129,4.502400548696845,20.0,0.0
42916,4,2916,[ 79 515 427 318 588],807,5,13134,4.50257113472746,40.0,0.0
42917,4,2917,[ 79 515 427 318 588],807,5,13139,4.5027416038382455,40.0,0.0
42918,4,2918,[ 79 515 427 318 588],18,5,13144,4.502911956149366,40.0,0.0
42919,4,2919,[ 79 515 427 318 588],18,5,13149,4.5030821917808215,40.0,0.0
42920,4,2920,[ 79 515 427 318 588],18,5,13154,4.503252310852448,40.0,0.0
42921,4,2921,[ 79 515 427 318 588],807,5,13159,4.503422313483915,40.0,0.0
42922,4,2922,[ 79 515 427 318 588],18,5,13164,4.503592199794731,40.0,0.0
42923,4,2923,[ 56 286 143  98 288],655,2,13166,4.502735978112175,0.0,20.0
42924,4,2924,[ 79 515 427 318 588],807,5,13171,4.5029059829059825,40.0,0.0
42925,4,2925,[ 79 515 427 318 588],716,5,13176,4.503075871496924,40.0,0.0
42926,4,2926,[ 79 515 427 318 588],18,5,13181,4.5032456440040995,40.0,0.0
42927,4,2927,[ 79 515 427 318 588],18,5,13186,4.503415300546448,40.0,0.0
42928,4,2928,[ 79 515 427 318 588],807,5,13191,4.503584841242745,40.0,0.0
42929,4,2929,[ 79 515 427 318 588],716,5,13196,4.503754266211604,40.0,0.0
42930,4,2930,[ 79 515 427 318 588],807,5,13201,4.503923575571477,40.0,0.0
42931,4,2931,[ 79 515 427 318 588],18,5,13206,4.504092769440655,40.0,0.0
42932,4,2932,[234 181 179 195 121],450,3,13209,4.5035799522673035,0.0,0.0
42933,4,2933,[ 79 515 427 318 588],716,5,13214,4.503749147920927,40.0,0.0
42934,4,2934,[ 79 515 427 318 588],18,5,13219,4.503918228279387,40.0,0.0
42935,4,2935,[ 79 515 427 318 588],716,5,13224,4.5040871934604905,40.0,0.0
42936,4,2936,[ 79 515 427 318 588],807,5,13229,4.504256043581886,40.0,0.0
42937,4,2937,[435 269 302  56 161],655,1,13230,4.503063308373043,0.0,0.0
42938,4,2938,[603 257 181 313 215],655,2,13232,4.502211636611092,20.0,0.0
42939,4,2939,[ 79 515 427 318 588],18,5,13237,4.502380952380952,40.0,0.0
42940,4,2940,[ 79 515 427 318 588],807,5,13242,4.502550153009181,40.0,0.0
42941,4,2941,[ 79 515 427 318 588],807,5,13247,4.502719238613189,40.0,0.0
42942,4,2942,[ 79 515 427 318 588],807,5,13252,4.502888209310227,40.0,0.0
42943,4,2943,[ 79 515 427 318 588],807,5,13257,4.503057065217392,40.0,0.0
42944,4,2944,[ 79 515 427 318 588],716,5,13262,4.503225806451613,40.0,0.0
42945,4,2945,[183  98 121  22  96],716,3,13265,4.502715546503734,0.0,0.0
42946,4,2946,[ 79 515 427 318 588],716,5,13270,4.502884289107567,40.0,0.0
42947,4,2947,[275 182   4 216 168],796,5,13275,4.503052917232021,0.0,20.0
42948,4,2948,[ 79 515 427 318 588],18,5,13280,4.503221430993557,40.0,0.0
42949,4,2949,[ 79 515 427 318 588],18,5,13285,4.503389830508475,40.0,0.0
42950,4,2950,[ 79 515 427 318 588],807,5,13290,4.503558115892917,40.0,0.0
42951,4,2951,[ 79 515 427 318 588],807,5,13295,4.5037262872628725,40.0,0.0
42952,4,2952,[118 483 153 435 173],389,2,13297,4.502878428716559,0.0,0.0
42953,4,2953,[ 79 515 427 318 588],18,5,13302,4.503046716316859,40.0,0.0
42954,4,2954,[ 79 515 427 318 588],18,5,13307,4.50321489001692,40.0,0.0
42955,4,2955,[ 79 515 427 318 588],716,5,13312,4.503382949932341,40.0,0.0
42956,4,2956,[ 79 515 427 318 588],18,5,13317,4.5035508961785595,40.0,0.0
42957,4,2957,[202 195 180 185  98],450,5,13322,4.503718728870859,0.0,0.0
42958,4,2958,[508 742  56 273  98],655,2,13324,4.502872592091923,0.0,0.0
42959,4,2959,[ 79 515 427 318 588],18,5,13329,4.503040540540541,40.0,0.0
42960,4,2960,[ 95 161 187 181 588],796,5,13334,4.503208375548801,0.0,0.0
42961,4,2961,[ 79 515 427 318 588],716,5,13339,4.5033760972316,40.0,0.0
42962,4,2962,[ 79 515 427 318 588],18,5,13344,4.503543705703679,40.0,0.0
42963,4,2963,[ 79 515 427 318 588],807,5,13349,4.503711201079622,40.0,0.0
42964,4,2964,[ 79 515 427 318 588],807,5,13354,4.5038785834738615,40.0,0.0
42965,4,2965,[ 79 515 427 318 588],18,5,13359,4.504045853000674,40.0,0.0
42966,4,2966,[ 79 515 427 318 588],18,5,13364,4.504213009774182,40.0,0.0
42967,4,2967,[ 79 515 427 318 588],807,5,13369,4.504380053908355,40.0,0.0
42968,4,2968,[ 79 515 427 318 588],18,5,13374,4.504546985517009,40.0,0.0
42969,4,2969,[172 546 111 318  56],593,4,13378,4.504377104377104,20.0,0.0
42970,4,2970,[ 79 515 427 318 588],18,5,13383,4.50454392460451,40.0,0.0
42971,4,2971,[ 79 515 427 318 588],18,5,13388,4.504710632570659,40.0,0.0
42972,4,2972,[ 79 515 427 318 588],807,5,13393,4.504877228388833,40.0,0.0
42973,4,2973,[  8  71 483 179 135],535,4,13397,4.504707464694015,0.0,0.0
42974,4,2974,[ 79 515 427 318 588],807,5,13402,4.504873949579832,40.0,0.0
42975,4,2975,[265 100 204  56   1],450,5,13407,4.505040322580645,0.0,20.0
42976,4,2976,[ 56 180 318 173 117],450,5,13412,4.505206583809204,20.0,0.0
42977,4,2977,[ 79 515 427 318 588],716,5,13417,4.505372733378106,40.0,0.0
42978,4,2978,[ 79 515 427 318 588],807,5,13422,4.505538771399799,40.0,0.0
42979,4,2979,[200 132 196 186 173],269,2,13424,4.504697986577181,0.0,0.0
42980,4,2980,[ 79 515 427 318 588],807,5,13429,4.504864139550486,40.0,0.0
42981,4,2981,[ 79 515 427 318 588],18,5,13434,4.505030181086519,40.0,0.0
42982,4,2982,[ 79 515 427 318 588],18,5,13439,4.5051961112973515,40.0,0.0
42983,4,2983,[ 79 515 427 318 588],716,5,13444,4.505361930294906,40.0,0.0
42984,4,2984,[228 318 216 197 289],655,2,13446,4.504522613065326,20.0,0.0
42985,4,2985,[265 196 194 100  98],450,5,13451,4.504688546550569,0.0,20.0
42986,4,2986,[ 79 515 427 318 588],716,5,13456,4.504854368932039,40.0,0.0
42987,4,2987,[ 11 427  70 288 118],450,3,13459,4.504350736278447,20.0,0.0
42988,4,2988,[515  79 427 318 588],716,5,13464,4.504516560722649,40.0,0.0
42989,4,2989,[515  79 427 318 588],807,5,13469,4.504682274247491,40.0,0.0
42990,4,2990,[515  79 427 318 588],807,5,13474,4.504847876964226,40.0,0.0
42991,4,2991,[515  79 427 318 588],18,5,13479,4.505013368983957,40.0,0.0
42992,4,2992,[515  79 427 318 588],716,5,13484,4.505178750417641,40.0,0.0
42993,4,2993,[ 12 168 174  88 180],450,5,13489,4.505344021376086,0.0,0.0
42994,4,2994,[515  79 427 318 588],807,5,13494,4.50550918196995,40.0,0.0
42995,4,2995,[200 196 257 515 275],716,5,13499,4.5056742323097465,0.0,20.0
42996,4,2996,[ 64 181 182  28  79],450,5,13504,4.505839172505839,20.0,0.0
42997,4,2997,[515  79 427 318 588],807,5,13509,4.506004002668446,40.0,0.0
42998,4,2998,[515  79 427 318 588],716,5,13514,4.506168722907636,40.0,0.0
42999,4,2999,[515  79 427 318 588],18,5,13519,4.506333333333333,40.0,0.0
43000,4,3000,[515  79 427 318 588],716,5,13524,4.506497834055315,40.0,0.0
43001,4,3001,[515  79 427 318 588],716,5,13529,4.506662225183211,40.0,0.0
43002,4,3002,[185 173 275  82  95],23,4,13533,4.5064935064935066,0.0,20.0
43003,4,3003,[515  79 427 318 588],18,5,13538,4.506657789613848,40.0,0.0
43004,4,3004,[515  79 427 318 588],18,5,13543,4.5068219633943425,40.0,0.0
43005,4,3005,[515  79 427 318 588],807,5,13548,4.506986027944111,40.0,0.0
43006,4,3006,[515  79 427 318 588],807,5,13553,4.507149983372131,40.0,0.0
43007,4,3007,[515  79 427 318 588],807,5,13558,4.507313829787234,40.0,0.0
43008,4,3008,[515  79 427 318 588],18,5,13563,4.507477567298106,40.0,0.0
43009,4,3009,[515  79 427 318 588],716,5,13568,4.507641196013289,40.0,0.0
43010,4,3010,[515  79 427 318 588],18,5,13573,4.507804716041182,40.0,0.0
43011,4,3011,[173 211 294 100  12],264,4,13577,4.507636122177955,0.0,20.0
43012,4,3012,[  4 185 127  69  98],457,5,13582,4.50779953534683,0.0,20.0
43013,4,3013,[515  79 427 318 588],716,5,13587,4.507962840079628,40.0,0.0
43014,4,3014,[ 22 313 237 273 118],655,2,13589,4.507131011608624,0.0,0.0
43015,4,3015,[515  79 427 318 588],18,5,13594,4.507294429708223,40.0,0.0
43016,4,3016,[515  79 427 318 588],807,5,13599,4.507457739476301,40.0,0.0
43017,4,3017,[515  79 427 318 588],716,5,13604,4.5076209410205434,40.0,0.0
43018,4,3018,[187 200 179  12 237],18,3,13607,4.5071215634316,0.0,0.0
43019,4,3019,[405 318 186 153   7],450,4,13611,4.506953642384106,20.0,0.0
43020,4,3020,[237   8 125 175 597],457,4,13615,4.506785832505793,0.0,0.0
43021,4,3021,[515  79 427 318 588],807,5,13620,4.506949040370616,40.0,0.0
43022,4,3022,[515  79 427 318 588],716,5,13625,4.507112140258021,40.0,0.0
43023,4,3023,[515  79 427 318 588],807,5,13630,4.507275132275132,40.0,0.0
43024,4,3024,[515  79 427 318 588],716,5,13635,4.507438016528925,40.0,0.0
43025,4,3025,[515  79 427 318 588],18,5,13640,4.507600793126239,40.0,0.0
43026,4,3026,[117 204   9  15 135],457,5,13645,4.507763462173769,0.0,0.0
43027,4,3027,[515  79 427 318 588],18,5,13650,4.507926023778071,40.0,0.0
43028,4,3028,[515  79 427 318 588],807,5,13655,4.5080884780455595,40.0,0.0
43029,4,3029,[515  79 427 318 588],18,5,13660,4.508250825082508,40.0,0.0
43030,4,3030,[515  79 427 318 588],807,5,13665,4.508413064995051,40.0,0.0
43031,4,3031,[515  79 427 318 588],18,5,13670,4.508575197889182,40.0,0.0
43032,4,3032,[515  79 427 318 588],716,5,13675,4.508737223870755,40.0,0.0
43033,4,3033,[515  79 427 318 588],18,5,13680,4.508899143045484,40.0,0.0
43034,4,3034,[234 357  82 405 100],786,4,13684,4.508731466227347,0.0,20.0
43035,4,3035,[515  79 427 318 588],18,5,13689,4.508893280632411,40.0,0.0
43036,4,3036,[515  79 427 318 588],18,5,13694,4.509054988475469,40.0,0.0
43037,4,3037,[515  79 427 318 588],716,5,13699,4.509216589861751,40.0,0.0
43038,4,3038,[515  79 427 318 588],18,5,13704,4.509378084896348,40.0,0.0
43039,4,3039,[194  28 191   7  64],72,4,13708,4.50921052631579,20.0,0.0
43040,4,3040,[515  79 427 318 588],18,5,13713,4.509371917132523,40.0,0.0
43041,4,3041,[515  79 427 318 588],18,5,13718,4.5095332018408945,40.0,0.0
43042,4,3042,[515  79 427 318 588],18,5,13723,4.509694380545514,40.0,0.0
43043,4,3043,[515  79 427 318 588],716,5,13728,4.509855453350855,40.0,0.0
43044,4,3044,[515  79 427 318 588],18,5,13733,4.510016420361248,40.0,0.0
43045,4,3045,[515  79 427 318 588],807,5,13738,4.510177281680893,40.0,0.0
43046,4,3046,[515  79 427 318 588],716,5,13743,4.51033803741385,40.0,0.0
43047,4,3047,[515  79 427 318 588],716,5,13748,4.510498687664042,40.0,0.0
43048,4,3048,[ 97 174  15 405 185],450,4,13752,4.510331256149557,0.0,0.0
43049,4,3049,[515  79 427 318 588],716,5,13757,4.510491803278689,40.0,0.0
43050,4,3050,[515  79 427 318 588],716,5,13762,4.510652245165519,40.0,0.0
43051,4,3051,[515  79 427 318 588],807,5,13767,4.510812581913499,40.0,0.0
43052,4,3052,[515  79 427 318 588],807,5,13772,4.5109728136259415,40.0,0.0
43053,4,3053,[  9 323  15 405 678],256,5,13777,4.511132940406025,0.0,0.0
43054,4,3054,[ 98 603 195 202 515],655,3,13780,4.51063829787234,20.0,0.0
43055,4,3055,[515  79 427 318 588],716,5,13785,4.5107984293193715,40.0,0.0
43056,4,3056,[515  79 427 318 588],807,5,13790,4.510958456002617,40.0,0.0
43057,4,3057,[515  79 427 318 588],807,5,13795,4.511118378024853,40.0,0.0
43058,4,3058,[515  79 427 318 588],18,5,13800,4.511278195488722,40.0,0.0
43059,4,3059,[515  79 427 318 588],18,5,13805,4.511437908496732,40.0,0.0
43060,4,3060,[515  79 427 318 588],18,5,13810,4.511597517151258,40.0,0.0
43061,4,3061,[515  79 427 318 588],18,5,13815,4.51175702155454,40.0,0.0
43062,4,3062,[515  79 427 318 588],716,5,13820,4.511916421808684,40.0,0.0
43063,4,3063,[ 79 427 185 435 197],562,5,13825,4.512075718015666,20.0,0.0
43064,4,3064,[515  79 427 318 588],807,5,13830,4.512234910277325,40.0,0.0
43065,4,3065,[515  79 427 318 588],716,5,13835,4.5123939986953685,40.0,0.0
43066,4,3066,[ 79 228 742 222 275],450,4,13839,4.512226931855233,0.0,20.0
43067,4,3067,[515  79 427 318 588],716,5,13844,4.51238591916558,40.0,0.0
43068,4,3068,[515  79 427 318 588],716,5,13849,4.512544802867383,40.0,0.0
43069,4,3069,[515  79 427 318 588],716,5,13854,4.51270358306189,40.0,0.0
43070,4,3070,[117 483 265 276  50],457,5,13859,4.512862259850212,0.0,20.0
43071,4,3071,[515  79 427 318 588],18,5,13864,4.513020833333333,40.0,0.0
43072,4,3072,[  8 194  56  22 195],457,5,13869,4.513179303612105,0.0,0.0
43073,4,3073,[515  79 427 318 588],807,5,13874,4.513337670787248,40.0,0.0
43074,4,3074,[515  79 427 318 588],18,5,13879,4.51349593495935,40.0,0.0
43075,4,3075,[515  79 427 318 588],716,5,13884,4.513654096228868,40.0,0.0
43076,4,3076,[515  79 427 318 588],716,5,13889,4.513812154696133,40.0,0.0
43077,4,3077,[515  79 427 318 588],18,5,13894,4.513970110461338,40.0,0.0
43078,4,3078,[ 50 423 300 237 196],885,3,13897,4.513478402078597,0.0,20.0
43079,4,3079,[132  95 117 174 515],716,5,13902,4.513636363636364,0.0,0.0
43080,4,3080,[ 79 515 427 318 588],18,5,13907,4.513794222654982,40.0,0.0
43081,4,3081,[ 79 515 427 318 588],18,5,13912,4.513951979234263,40.0,0.0
43082,4,3082,[ 28 234 185 151 228],151,5,13917,4.514109633473889,0.0,0.0
43083,4,3083,[ 79 515 427 318 588],716,5,13922,4.514267185473411,40.0,0.0
43084,4,3084,[ 79 515 427 318 588],18,5,13927,4.514424635332253,40.0,0.0
43085,4,3085,[ 79 515 427 318 588],807,5,13932,4.514581983149708,40.0,0.0
43086,4,3086,[ 79 515 427 318 588],18,5,13937,4.5147392290249435,40.0,0.0
43087,4,3087,[ 79 515 427 318 588],716,5,13942,4.514896373056994,40.0,0.0
43088,4,3088,[ 79 515 427 318 588],18,5,13947,4.515053415344772,40.0,0.0
43089,4,3089,[ 79 515 427 318 588],18,5,13952,4.515210355987055,40.0,0.0
43090,4,3090,[ 79 515 427 318 588],18,5,13957,4.515367195082497,40.0,0.0
43091,4,3091,[210  95 748  25 318],450,2,13959,4.514553686934024,20.0,0.0
43092,4,3092,[ 79 515 427 318 588],807,5,13964,4.514710636922082,40.0,0.0
43093,4,3093,[ 11  98  70 118 216],280,4,13968,4.5145442792501616,0.0,0.0
43094,4,3094,[ 79 515 427 318 588],716,5,13973,4.51470113085622,40.0,0.0
43095,4,3095,[ 79 515 427 318 588],18,5,13978,4.514857881136951,40.0,0.0
43096,4,3096,[ 79 515 427 318 588],716,5,13983,4.515014530190507,40.0,0.0
43097,4,3097,[ 79 515 427 318 588],807,5,13988,4.515171078114913,40.0,0.0
43098,4,3098,[151   1 127 385  88],796,4,13992,4.515004840271055,0.0,20.0
43099,4,3099,[ 79 515 427 318 588],716,5,13997,4.515161290322581,40.0,0.0
43100,4,3100,[265 301 245 180  95],450,4,14001,4.514995162850694,0.0,0.0
43101,4,3101,[496 151 187 176  64],236,1,14002,4.513862024500322,40.0,0.0
43102,4,3102,[515  79 427 318 588],716,5,14007,4.514018691588785,40.0,0.0
43103,4,3103,[515  79 427 318 588],716,5,14012,4.514175257731959,40.0,0.0
43104,4,3104,[515  79 427 318 588],716,5,14017,4.514331723027375,40.0,0.0
43105,4,3105,[515  79 427 318 588],18,5,14022,4.51448808757244,40.0,0.0
43106,4,3106,[515  79 427 318 588],716,5,14027,4.514644351464435,40.0,0.0
43107,4,3107,[515  79 427 318 588],18,5,14032,4.514800514800514,40.0,0.0
43108,4,3108,[515  79 427 318 588],807,5,14037,4.51495657767771,40.0,0.0
43109,4,3109,[515  79 427 318 588],807,5,14042,4.515112540192926,40.0,0.0
43110,4,3110,[515  79 427 318 588],716,5,14047,4.515268402442945,40.0,0.0
43111,4,3111,[515  79 427 318 588],18,5,14052,4.515424164524422,40.0,0.0
43112,4,3112,[ 12 186 282 234  70],655,0,14052,4.513973658849984,0.0,0.0
43113,4,3113,[515  79 427 318 588],807,5,14057,4.514129736673089,40.0,0.0
43114,4,3114,[515  79 427 318 588],807,5,14062,4.514285714285714,40.0,0.0
43115,4,3115,[515  79 427 318 588],18,5,14067,4.514441591784339,40.0,0.0
43116,4,3116,[515  79 427 318 588],807,5,14072,4.514597369265319,40.0,0.0
43117,4,3117,[515  79 427 318 588],18,5,14077,4.514753046824888,40.0,0.0
43118,4,3118,[ 95  28 111 132  79],450,4,14081,4.5145880089772366,0.0,0.0
43119,4,3119,[515  79 427 318 588],807,5,14086,4.51474358974359,40.0,0.0
43120,4,3120,[568  56   9 127 313],796,4,14090,4.514578660685678,0.0,20.0
43121,4,3121,[515  79 427 318 588],716,5,14095,4.514734144778988,40.0,0.0
43122,4,3122,[515  79 427 318 588],716,5,14100,4.514889529298751,40.0,0.0
43123,4,3123,[515  79 427 318 588],18,5,14105,4.515044814340589,40.0,0.0
43124,4,3124,[515  79 427 318 588],18,5,14110,4.5152,40.0,0.0
43125,4,3125,[515  79 427 318 588],18,5,14115,4.515355086372361,40.0,0.0
43126,4,3126,[515  79 427 318 588],807,5,14120,4.515510073552926,40.0,0.0
43127,4,3127,[515  79 427 318 588],18,5,14125,4.515664961636829,40.0,0.0
43128,4,3128,[515  79 427 318 588],18,5,14130,4.515819750719079,40.0,0.0
43129,4,3129,[515  79 427 318 588],18,5,14135,4.515974440894569,40.0,0.0
43130,4,3130,[515  79 427 318 588],716,5,14140,4.516129032258065,40.0,0.0
43131,4,3131,[515  79 427 318 588],807,5,14145,4.516283524904215,40.0,0.0
43132,4,3132,[515  79 427 318 588],18,5,14150,4.516437918927545,40.0,0.0
43133,4,3133,[515  79 427 318 588],807,5,14155,4.516592214422463,40.0,0.0
43134,4,3134,[515  79 427 318 588],18,5,14160,4.516746411483253,40.0,0.0
43135,4,3135,[515  79 427 318 588],716,5,14165,4.516900510204081,40.0,0.0
43136,4,3136,[515  79 427 318 588],807,5,14170,4.517054510678992,40.0,0.0
43137,4,3137,[194 275 183  82 288],457,5,14175,4.517208413001912,0.0,20.0
43138,4,3138,[515  79 427 318 588],716,5,14180,4.517362217266645,40.0,0.0
43139,4,3139,[300 282 423   4  28],796,4,14184,4.5171974522293,0.0,0.0
43140,4,3140,[515  79 427 318 588],18,5,14189,4.517351162050303,40.0,0.0
43141,4,3141,[515  79 427 318 588],716,5,14194,4.51750477402928,40.0,0.0
43142,4,3142,[515  79 427 318 588],18,5,14199,4.517658288259624,40.0,0.0
43143,4,3143,[515  79 427 318 588],18,5,14204,4.517811704834606,40.0,0.0
43144,4,3144,[515  79 427 318 588],807,5,14209,4.517965023847377,40.0,0.0
43145,4,3145,[515  79 427 318 588],807,5,14214,4.518118245390973,40.0,0.0
43146,4,3146,[ 22 185 111  69 174],796,5,14219,4.51827136955831,0.0,0.0
43147,4,3147,[515  79 427 318 588],18,5,14224,4.518424396442185,40.0,0.0
43148,4,3148,[515  79 427 318 588],716,5,14229,4.518577326135281,40.0,0.0
43149,4,3149,[  8 385  95 357 100],344,4,14233,4.518412698412698,0.0,20.0
43150,4,3150,[515  79 427 318 588],716,5,14238,4.518565534750873,40.0,0.0
43151,4,3151,[515  79 427 318 588],716,5,14243,4.518718274111675,40.0,0.0
43152,4,3152,[515  79 427 318 588],807,5,14248,4.518870916587377,40.0,0.0
43153,4,3153,[515  79 427 318 588],716,5,14253,4.519023462270133,40.0,0.0
43154,4,3154,[515  79 427 318 588],807,5,14258,4.519175911251981,40.0,0.0
43155,4,3155,[  9 183 222 117  89],344,4,14262,4.519011406844107,0.0,0.0
43156,4,3156,[515  79 427 318 588],18,5,14267,4.519163763066202,40.0,0.0
43157,4,3157,[275 234 245   1 237],593,1,14268,4.518049398353388,0.0,20.0
43158,4,3158,[515  79 427 318 588],716,5,14273,4.518201962646407,40.0,0.0
43159,4,3159,[ 88 228  96  95  50],796,5,14278,4.5183544303797465,0.0,20.0
43160,4,3160,[515  79 427 318 588],807,5,14283,4.518506801645049,40.0,0.0
43161,4,3161,[515  79 427 318 588],716,5,14288,4.518659076533839,40.0,0.0
43162,4,3162,[515  79 427 318 588],18,5,14293,4.5188112551375275,40.0,0.0
43163,4,3163,[515  79 427 318 588],807,5,14298,4.518963337547408,40.0,0.0
43164,4,3164,[515  79 427 318 588],18,5,14303,4.519115323854661,40.0,0.0
43165,4,3165,[180 121 237 135 125],450,3,14306,4.518635502210992,0.0,0.0
43166,4,3166,[515  79 427 318 588],18,5,14311,4.518787496053047,40.0,0.0
43167,4,3167,[204 210 276 318  70],593,3,14314,4.51830808080808,20.0,0.0
43168,4,3168,[151  28 655 118 597],796,3,14317,4.517828968128748,0.0,0.0
43169,4,3169,[127 405 180   4 282],457,5,14322,4.517981072555205,0.0,20.0
43170,4,3170,[117 742 318  98 191],577,5,14327,4.518133081046988,20.0,0.0
43171,4,3171,[ 79 515 427 318 588],716,5,14332,4.51828499369483,40.0,0.0
43172,4,3172,[ 79 515 427 318 588],807,5,14337,4.518436810589348,40.0,0.0
43173,4,3173,[ 79 515 427 318 588],18,5,14342,4.518588531821046,40.0,0.0
43174,4,3174,[ 79 515 427 318 588],716,5,14347,4.518740157480315,40.0,0.0
43175,4,3175,[ 79 515 427 318 588],716,5,14352,4.5188916876574305,40.0,0.0
43176,4,3176,[286 194   4 216 100],264,4,14356,4.518728360088134,0.0,40.0
43177,4,3177,[ 79 515 427 318 588],716,5,14361,4.518879798615481,40.0,0.0
43178,4,3178,[ 79 515 427 318 588],18,5,14366,4.5190311418685125,40.0,0.0
43179,4,3179,[135 183 215 185 234],655,3,14369,4.518553459119497,0.0,0.0
43180,4,3180,[ 79 515 427 318 588],807,5,14374,4.518704809808236,40.0,0.0
43181,4,3181,[ 82 237 265 161 180],457,5,14379,4.518856065367693,0.0,0.0
43182,4,3182,[515  79 427 318 588],716,5,14384,4.519007225887528,40.0,0.0
43183,4,3183,[515  79 427 318 588],807,5,14389,4.519158291457287,40.0,0.0
43184,4,3184,[515  79 427 318 588],716,5,14394,4.519309262166405,40.0,0.0
43185,4,3185,[275 118 405 121  28],716,4,14398,4.519146264908977,0.0,20.0
43186,4,3186,[515  79 427 318 588],807,5,14403,4.5192971446501415,40.0,0.0
43187,4,3187,[ 98  82 385 235 269],450,3,14406,4.518820577164367,0.0,0.0
43188,4,3188,[ 71 186 357 211 172],18,4,14410,4.5186578864847915,0.0,0.0
43189,4,3189,[515  79 427 318 588],716,5,14415,4.518808777429467,40.0,0.0
43190,4,3190,[515  79 427 318 588],807,5,14420,4.518959573801316,40.0,0.0
43191,4,3191,[515  79 427 318 588],18,5,14425,4.519110275689223,40.0,0.0
43192,4,3192,[143 234 228 174 191],151,4,14429,4.518947698089571,0.0,0.0
43193,4,3193,[515  79 427 318 588],716,5,14434,4.519098309329994,40.0,0.0
43194,4,3194,[515  79 427 318 588],18,5,14439,4.51924882629108,40.0,0.0
43195,4,3195,[265 183 288 191  96],457,5,14444,4.519399249061327,0.0,0.0
43196,4,3196,[515  79 427 318 588],807,5,14449,4.519549577729121,40.0,0.0
43197,4,3197,[515  79 427 318 588],716,5,14454,4.519699812382739,40.0,0.0
43198,4,3198,[161 187 111  95 215],436,5,14459,4.519849953110347,0.0,0.0
43199,4,3199,[515  79 427 318 588],716,5,14464,4.52,40.0,0.0
43200,4,3200,[515  79 427 318 588],18,5,14469,4.520149953139644,40.0,0.0
43201,4,3201,[515  79 427 318 588],18,5,14474,4.5202998126171146,40.0,0.0
43202,4,3202,[515  79 427 318 588],716,5,14479,4.520449578520138,40.0,0.0
43203,4,3203,[175 471 168 288 423],457,5,14484,4.520599250936329,0.0,0.0
43204,4,3204,[515  79 427 318 588],18,5,14489,4.520748829953198,40.0,0.0
43205,4,3205,[515  79 427 318 588],807,5,14494,4.520898315658141,40.0,0.0
43206,4,3206,[515  79 427 318 588],807,5,14499,4.521047708138447,40.0,0.0
43207,4,3207,[515  79 427 318 588],807,5,14504,4.521197007481296,40.0,0.0
43208,4,3208,[515  79 427 318 588],807,5,14509,4.521346213773762,40.0,0.0
43209,4,3209,[ 69  28 496 313 202],796,4,14513,4.521183800623053,20.0,0.0
43210,4,3210,[172 180 182 483  22],280,3,14516,4.520710059171598,0.0,0.0
43211,4,3211,[515  79 427 318 588],807,5,14521,4.520859277708593,40.0,0.0
43212,4,3212,[515  79 427 318 588],716,5,14526,4.5210084033613445,40.0,0.0
43213,4,3213,[ 28  25  89 234   7],72,3,14529,4.520535158680771,0.0,0.0
43214,4,3214,[515  79 427 318 588],807,5,14534,4.520684292379471,40.0,0.0
43215,4,3215,[515  79 427 318 588],807,5,14539,4.520833333333333,40.0,0.0
43216,4,3216,[515  79 427 318 588],807,5,14544,4.5209822816288465,40.0,0.0
43217,4,3217,[  4  70 196  28 143],786,5,14549,4.521131137352393,0.0,0.0
43218,4,3218,[515  79 427 318 588],807,5,14554,4.521279900590246,40.0,0.0
43219,4,3219,[515  79 427 318 588],807,5,14559,4.521428571428571,40.0,0.0
43220,4,3220,[515  79 427 318 588],18,5,14564,4.521577149953431,40.0,0.0
43221,4,3221,[515  79 427 318 588],807,5,14569,4.521725636250776,40.0,0.0
43222,4,3222,[515  79 427 318 588],716,5,14574,4.521874030406454,40.0,0.0
43223,4,3223,[515  79 427 318 588],807,5,14579,4.522022332506204,40.0,0.0
43224,4,3224,[515  79 427 318 588],807,5,14584,4.522170542635659,40.0,0.0
43225,4,3225,[515  79 427 318 588],807,5,14589,4.522318660880347,40.0,0.0
43226,4,3226,[515  79 427 318 588],18,5,14594,4.522466687325689,40.0,0.0
43227,4,3227,[471 191 118 228 132],450,4,14598,4.522304832713755,0.0,0.0
43228,4,3228,[515  79 427 318 588],716,5,14603,4.522452771755962,40.0,0.0
43229,4,3229,[204  88   9 196 216],344,4,14607,4.522291021671827,0.0,0.0
43230,4,3230,[ 64 588 265  11   7],457,5,14612,4.522438873413804,20.0,0.0
43231,4,3231,[515  79 427 318 588],716,5,14617,4.522586633663367,40.0,0.0
43232,4,3232,[202  79 328 302 181],450,5,14622,4.5227343025054125,0.0,0.0
43233,4,3233,[515  79 427 318 588],716,5,14627,4.5228818800247375,40.0,0.0
43234,4,3234,[132 187 742  98 275],450,5,14632,4.5230293663060275,0.0,20.0
43235,4,3235,[515  79 427 318 588],807,5,14637,4.523176761433869,40.0,0.0
43236,4,3236,[515  79 427 318 588],807,5,14642,4.52332406549274,40.0,0.0
43237,4,3237,[515  79 427 318 588],807,5,14647,4.523471278567016,40.0,0.0
43238,4,3238,[515  79 427 318 588],716,5,14652,4.523618400740969,40.0,0.0
43239,4,3239,[515  79 427 318 588],716,5,14657,4.523765432098766,40.0,0.0
43240,4,3240,[515  79 427 318 588],807,5,14662,4.5239123727244674,40.0,0.0
43241,4,3241,[515  79 427 318 588],18,5,14667,4.524059222702036,40.0,0.0
43242,4,3242,[515  79 427 318 588],716,5,14672,4.524205982115325,40.0,0.0
43243,4,3243,[515  79 427 318 588],18,5,14677,4.524352651048089,40.0,0.0
43244,4,3244,[588  50 195   7  28],885,3,14680,4.523882896764253,0.0,20.0
43245,4,3245,[515  79 427 318 588],716,5,14685,4.524029574861368,40.0,0.0
43246,4,3246,[515  79 427 318 588],807,5,14690,4.524176162611641,40.0,0.0
43247,4,3247,[515  79 427 318 588],18,5,14695,4.524322660098522,40.0,0.0
43248,4,3248,[515  79 427 318 588],716,5,14700,4.524469067405356,40.0,0.0
43249,4,3249,[132  79 191  70  98],457,5,14705,4.524615384615385,0.0,0.0
43250,4,3250,[515  79 427 318 588],807,5,14710,4.52476161181175,40.0,0.0
43251,4,3251,[385  69 185 742 318],457,5,14715,4.5249077490774905,20.0,0.0
43252,4,3252,[515  79 427 318 588],18,5,14720,4.525053796495542,40.0,0.0
43253,4,3253,[195 588 197 286 204],18,3,14723,4.524585125998771,0.0,20.0
43254,4,3254,[515  79 427 318 588],807,5,14728,4.524731182795699,40.0,0.0
43255,4,3255,[515  79 427 318 588],807,5,14733,4.52487714987715,40.0,0.0
43256,4,3256,[515  79 427 318 588],807,5,14738,4.52502302732576,40.0,0.0
43257,4,3257,[515  79 427 318 588],807,5,14743,4.525168815224064,40.0,0.0
43258,4,3258,[515  79 427 318 588],18,5,14748,4.525314513654496,40.0,0.0
43259,4,3259,[515  79 427 318 588],18,5,14753,4.5254601226993865,40.0,0.0
43260,4,3260,[405 288  88  89 127],457,5,14758,4.525605642440969,0.0,20.0
43261,4,3261,[ 56 257  88 234 568],655,0,14758,4.524218270999387,0.0,0.0
43262,4,3262,[515  79 427 318 588],716,5,14763,4.5243640821330064,40.0,0.0
43263,4,3263,[515  79 427 318 588],18,5,14768,4.5245098039215685,40.0,0.0
43264,4,3264,[515  79 427 318 588],716,5,14773,4.5246554364471665,40.0,0.0
43265,4,3265,[742 176 181 183 174],504,2,14775,4.5238824249846905,0.0,0.0
43266,4,3266,[423  15 179 173  22],450,4,14779,4.523722069176615,0.0,0.0
43267,4,3267,[515  79 427 318 588],807,5,14784,4.523867809057528,40.0,0.0
43268,4,3268,[515  79 427 318 588],716,5,14789,4.524013459773631,40.0,0.0
43269,4,3269,[515  79 427 318 588],18,5,14794,4.524159021406728,40.0,0.0
43270,4,3270,[222 357 216 202 175],655,2,14796,4.523387343320086,0.0,0.0
43271,4,3271,[515  79 427 318 588],807,5,14801,4.523533007334963,40.0,0.0
43272,4,3272,[515  79 427 318 588],716,5,14806,4.52367858234036,40.0,0.0
43273,4,3273,[515  79 427 318 588],716,5,14811,4.523824068417838,40.0,0.0
43274,4,3274,[423 161 302 118 117],450,4,14815,4.523664122137404,0.0,0.0
43275,4,3275,[515  79 427 318 588],716,5,14820,4.523809523809524,40.0,0.0
43276,4,3276,[515  79 427 318 588],807,5,14825,4.523954836740922,40.0,0.0
43277,4,3277,[515  79 427 318 588],716,5,14830,4.524100061012812,40.0,0.0
43278,4,3278,[515  79 427 318 588],18,5,14835,4.524245196706313,40.0,0.0
43279,4,3279,[515  79 427 318 588],716,5,14840,4.524390243902439,40.0,0.0
43280,4,3280,[186 258 204 318 174],535,5,14845,4.5245352026821095,20.0,0.0
43281,4,3281,[515  79 427 318 588],807,5,14850,4.5246800731261425,40.0,0.0
43282,4,3282,[318 258  69 173 282],457,5,14855,4.52482485531526,20.0,0.0
43283,4,3283,[515  79 427 318 588],716,5,14860,4.524969549330085,40.0,0.0
43284,4,3284,[515  79 427 318 588],807,5,14865,4.525114155251141,40.0,0.0
43285,4,3285,[237 180 183  79 176],716,2,14867,4.524345709068776,0.0,0.0
43286,4,3286,[546 238   4  97 194],151,4,14871,4.5241861880133865,0.0,0.0
43287,4,3287,[515  79 427 318 588],807,5,14876,4.524330900243309,40.0,0.0
43288,4,3288,[172 183  96 265  28],577,5,14881,4.524475524475524,0.0,0.0
43289,4,3289,[515  79 427 318 588],807,5,14886,4.524620060790274,40.0,0.0
43290,4,3290,[  1 173 216 568 423],280,3,14889,4.524156791248861,0.0,0.0
43291,4,3291,[483 228 403 423   1],655,1,14890,4.523086269744836,0.0,0.0
43292,4,3292,[515  79 427 318 588],716,5,14895,4.523231096264804,40.0,0.0
43293,4,3293,[515  79 427 318 588],807,5,14900,4.523375834851245,40.0,0.0
43294,4,3294,[515  79 427 318 588],716,5,14905,4.523520485584219,40.0,0.0
43295,4,3295,[318 179 568 183 144],593,5,14910,4.523665048543689,20.0,0.0
43296,4,3296,[515  79 427 318 588],18,5,14915,4.523809523809524,40.0,0.0
43297,4,3297,[515  79 427 318 588],807,5,14920,4.523953911461492,40.0,0.0
43298,4,3298,[515  79 427 318 588],18,5,14925,4.5240982115792665,40.0,0.0
43299,4,3299,[515  79 427 318 588],18,5,14930,4.524242424242424,40.0,0.0
43300,4,3300,[515  79 427 318 588],716,5,14935,4.524386549530445,40.0,0.0
43301,4,3301,[515  79 427 318 588],807,5,14940,4.5245305875227135,40.0,0.0
43302,4,3302,[568 276 742  89 118],457,5,14945,4.524674538298516,0.0,0.0
43303,4,3303,[328 228 216 204 301],655,1,14946,4.52360774818402,0.0,0.0
43304,4,3304,[515  79 427 318 588],716,5,14951,4.52375189107413,40.0,0.0
43305,4,3305,[515  79 427 318 588],807,5,14956,4.52389594676346,40.0,0.0
43306,4,3306,[515  79 427 318 588],716,5,14961,4.524039915331116,40.0,0.0
43307,4,3307,[ 69 168  25 204   4],151,5,14966,4.524183796856106,0.0,0.0
43308,4,3308,[515  79 427 318 588],716,5,14971,4.524327591417347,40.0,0.0
43309,4,3309,[288 258 211   7 144],693,3,14974,4.523867069486405,0.0,0.0
43310,4,3310,[515  79 427 318 588],807,5,14979,4.524010872848082,40.0,0.0
43311,4,3311,[515  79 427 318 588],716,5,14984,4.524154589371981,40.0,0.0
43312,4,3312,[515  79 427 318 588],716,5,14989,4.5242982191367345,40.0,0.0
43313,4,3313,[515  79 427 318 588],807,5,14994,4.5244417622208815,40.0,0.0
43314,4,3314,[ 96 357 151 215 216],457,5,14999,4.524585218702866,0.0,0.0
43315,4,3315,[515  79 427 318 588],716,5,15004,4.524728588661038,40.0,0.0
43316,4,3316,[515  79 427 318 588],18,5,15009,4.524871872173651,40.0,0.0
43317,4,3317,[515  79 427 318 588],18,5,15014,4.525015069318867,40.0,0.0
43318,4,3318,[269  15 100  50 234],629,4,15018,4.524856884603796,0.0,40.0
43319,4,3319,[ 79 515 427 318 588],18,5,15023,4.525,40.0,0.0
43320,4,3320,[ 79 515 427 318 588],807,5,15028,4.52514302920807,40.0,0.0
43321,4,3321,[ 79 515 427 318 588],18,5,15033,4.52528597230584,40.0,0.0
43322,4,3322,[ 79 515 427 318 588],18,5,15038,4.52542882937105,40.0,0.0
43323,4,3323,[197 143 186 265 185],151,5,15043,4.5255716004813475,0.0,0.0
43324,4,3324,[515  79 427 318 588],18,5,15048,4.525714285714286,40.0,0.0
43325,4,3325,[515  79 427 318 588],716,5,15053,4.525856885147324,40.0,0.0
43326,4,3326,[515  79 427 318 588],716,5,15058,4.52599939885783,40.0,0.0
43327,4,3327,[515  79 427 318 588],716,5,15063,4.526141826923077,40.0,0.0
43328,4,3328,[515  79 427 318 588],807,5,15068,4.526284169420246,40.0,0.0
43329,4,3329,[ 70 748 258 121  22],450,4,15072,4.526126126126126,0.0,0.0
43330,4,3330,[515  79 427 318 588],716,5,15077,4.52626838787151,40.0,0.0
43331,4,3331,[515  79 427 318 588],716,5,15082,4.52641056422569,40.0,0.0
43332,4,3332,[313 234 568 174 655],450,4,15086,4.526252625262527,0.0,0.0
43333,4,3333,[515  79 427 318 588],18,5,15091,4.526394721055789,40.0,0.0
43334,4,3334,[301 153 268 175 423],655,0,15091,4.52503748125937,0.0,0.0
43335,4,3335,[588 187 117  96  22],450,5,15096,4.525179856115108,0.0,0.0
43336,4,3336,[ 79 515 427 318 588],18,5,15101,4.525322145639796,40.0,0.0
43337,4,3337,[186 127 496 228   7],786,5,15106,4.525464349910126,20.0,20.0
43338,4,3338,[228 222 181 603 117],292,4,15110,4.525306978137166,20.0,0.0
43339,4,3339,[ 79 515 427 318 588],807,5,15115,4.525449101796407,40.0,0.0
43340,4,3340,[181  82  28 603 172],716,5,15120,4.5255911403771325,20.0,0.0
43341,4,3341,[211 186 153 121 180],296,4,15124,4.525433871932974,0.0,0.0
43342,4,3342,[ 79 515 427 318 588],807,5,15129,4.525575830092731,40.0,0.0
43343,4,3343,[ 79 515 427 318 588],807,5,15134,4.525717703349282,40.0,0.0
43344,4,3344,[357  15 210 742 181],457,5,15139,4.525859491778775,0.0,0.0
43345,4,3345,[ 79 515 427 318 588],716,5,15144,4.526001195457263,40.0,0.0
43346,4,3346,[ 79 515 427 318 588],716,5,15149,4.526142814460711,40.0,0.0
43347,4,3347,[98 50 56 69 79],457,5,15154,4.526284348864994,0.0,20.0
43348,4,3348,[ 79 515 427 318 588],807,5,15159,4.526425798745894,40.0,0.0
43349,4,3349,[111 186  11  15 483],296,2,15161,4.525671641791045,0.0,0.0
43350,4,3350,[515  79 427 318 588],716,5,15166,4.52581319009251,40.0,0.0
43351,4,3351,[127   1 135 181 508],401,0,15166,4.524463007159905,0.0,20.0
43352,4,3352,[318  69  88 322 176],151,3,15169,4.524008350730689,20.0,0.0
43353,4,3353,[423 546 125  69 216],280,4,15173,4.523852116875372,0.0,0.0
43354,4,3354,[515  79 427 318 588],18,5,15178,4.523994038748137,40.0,0.0
43355,4,3355,[215 153 173  50 117],280,2,15180,4.523241954707986,0.0,20.0
43356,4,3356,[515  79 427 318 588],807,5,15185,4.523383973786118,40.0,0.0
43357,4,3357,[603 228 238 176 187],655,2,15187,4.52263251935676,20.0,0.0
43358,4,3358,[357   8 245 269 385],344,3,15190,4.522179220005954,0.0,0.0
43359,4,3359,[515  79 427 318 588],807,5,15195,4.522321428571429,40.0,0.0
43360,4,3360,[515  79 427 318 588],716,5,15200,4.522463552514132,40.0,0.0
43361,4,3361,[515  79 427 318 588],18,5,15205,4.522605591909578,40.0,0.0
43362,4,3362,[515  79 427 318 588],807,5,15210,4.522747546833185,40.0,0.0
43363,4,3363,[313 405 211 111 275],593,3,15213,4.522294887039239,0.0,20.0
43364,4,3364,[515  79 427 318 588],807,5,15218,4.522436849925706,40.0,0.0
43365,4,3365,[174 678  22 132  71],344,2,15220,4.521687462863934,0.0,0.0
43366,4,3366,[515  79 427 318 588],18,5,15225,4.521829521829522,40.0,0.0
43367,4,3367,[515  79 427 318 588],716,5,15230,4.521971496437055,40.0,0.0
43368,4,3368,[161   4 117 121 143],655,1,15231,4.520926090828139,0.0,0.0
43369,4,3369,[302 258 496 546 588],450,5,15236,4.52106824925816,20.0,0.0
43370,4,3370,[515  79 427 318 588],18,5,15241,4.521210323346188,40.0,0.0
43371,4,3371,[515  79 427 318 588],807,5,15246,4.5213523131672595,40.0,0.0
43372,4,3372,[515  79 427 318 588],18,5,15251,4.521494218796324,40.0,0.0
43373,4,3373,[515  79 427 318 588],807,5,15256,4.521636040308239,40.0,0.0
43374,4,3374,[211 215  98 483 173],450,4,15260,4.521481481481482,0.0,0.0
43375,4,3375,[515  79 427 318 588],807,5,15265,4.521623222748815,40.0,0.0
43376,4,3376,[515  79 427 318 588],807,5,15270,4.521764880071069,40.0,0.0
43377,4,3377,[515  79 427 318 588],716,5,15275,4.521906453522795,40.0,0.0
43378,4,3378,[515  79 427 318 588],807,5,15280,4.522047943178455,40.0,0.0
43379,4,3379,[515  79 427 318 588],716,5,15285,4.522189349112426,40.0,0.0
43380,4,3380,[143  95 172 238   8],389,3,15288,4.521739130434782,0.0,0.0
43381,4,3381,[515  79 427 318 588],716,5,15293,4.5218805440567715,40.0,0.0
43382,4,3382,[515  79 427 318 588],716,5,15298,4.522021874076263,40.0,0.0
43383,4,3383,[515  79 427 318 588],18,5,15303,4.522163120567376,40.0,0.0
43384,4,3384,[515  79 427 318 588],807,5,15308,4.522304283604136,40.0,0.0
43385,4,3385,[515  79 427 318 588],18,5,15313,4.522445363260484,40.0,0.0
43386,4,3386,[515  79 427 318 588],716,5,15318,4.522586359610274,40.0,0.0
43387,4,3387,[182 483 313 289 196],655,3,15321,4.522136953955136,0.0,0.0
43388,4,3388,[515  79 427 318 588],716,5,15326,4.5222779580997345,40.0,0.0
43389,4,3389,[385 168 357 597  64],450,5,15331,4.522418879056048,20.0,0.0
43390,4,3390,[ 70 195 655 222 508],280,1,15332,4.521380123857269,0.0,0.0
43391,4,3391,[515  79 427 318 588],716,5,15337,4.521521226415095,40.0,0.0
43392,4,3392,[515  79 427 318 588],807,5,15342,4.521662245800177,40.0,0.0
43393,4,3393,[286 405 496  88 195],796,4,15346,4.521508544490277,20.0,20.0
43394,4,3394,[515  79 427 318 588],18,5,15351,4.521649484536082,40.0,0.0
43395,4,3395,[ 25 235 546 187 403],450,3,15354,4.521201413427562,0.0,0.0
43396,4,3396,[515  79 427 318 588],18,5,15359,4.521342360906682,40.0,0.0
43397,4,3397,[515  79 427 318 588],807,5,15364,4.521483225426722,40.0,0.0
43398,4,3398,[515  79 427 318 588],18,5,15369,4.5216240070609,40.0,0.0
43399,4,3399,[515  79 427 318 588],807,5,15374,4.521764705882353,40.0,0.0
43400,4,3400,[ 96 187 313 282   9],796,4,15378,4.521611290796825,0.0,0.0
43401,4,3401,[515  79 427 318 588],716,5,15383,4.521751910640799,40.0,0.0
43402,4,3402,[515  79 427 318 588],18,5,15388,4.521892447840141,40.0,0.0
43403,4,3403,[515  79 427 318 588],716,5,15393,4.522032902467685,40.0,0.0
43404,4,3404,[127  96 276 204 294],504,2,15395,4.52129221732746,0.0,20.0
43405,4,3405,[515  79 427 318 588],18,5,15400,4.521432765707575,40.0,0.0
43406,4,3406,[588  79 483 238 194],716,5,15405,4.521573231582037,0.0,0.0
43407,4,3407,[515  79 427 318 588],18,5,15410,4.521713615023474,40.0,0.0
43408,4,3408,[215 210   9 176 182],655,1,15411,4.520680551481373,0.0,0.0
43409,4,3409,[180  79  88 328 195],796,4,15415,4.520527859237537,0.0,0.0
43410,4,3410,[515  79 427 318 588],807,5,15420,4.5206684256816185,40.0,0.0
43411,4,3411,[515  79 427 318 588],18,5,15425,4.520808909730364,40.0,0.0
43412,4,3412,[515  79 427 318 588],18,5,15430,4.520949311456197,40.0,0.0
43413,4,3413,[405  98  96 301 435],450,5,15435,4.521089630931459,0.0,0.0
43414,4,3414,[153 216 132 202 435],655,1,15436,4.520058565153733,0.0,0.0
43415,4,3415,[515  79 427 318 588],807,5,15441,4.52019906323185,40.0,0.0
43416,4,3416,[515  79 427 318 588],18,5,15446,4.520339479075212,40.0,0.0
43417,4,3417,[ 82 181 117 257  96],504,4,15450,4.520187244002341,0.0,0.0
43418,4,3418,[515  79 427 318 588],807,5,15455,4.520327581164083,40.0,0.0
43419,4,3419,[515  79 427 318 588],716,5,15460,4.52046783625731,40.0,0.0
43420,4,3420,[125 257  89 333 385],655,1,15461,4.519438760596317,0.0,0.0
43421,4,3421,[515  79 427 318 588],18,5,15466,4.5195791934541205,40.0,0.0
43422,4,3422,[151 202 127 111 181],89,4,15470,4.519427402862986,0.0,20.0
43423,4,3423,[515  79 427 318 588],18,5,15475,4.519567757009346,40.0,0.0
43424,4,3424,[515  79 427 318 588],18,5,15480,4.51970802919708,40.0,0.0
43425,4,3425,[515  79 427 318 588],716,5,15485,4.519848219497957,40.0,0.0
43426,4,3426,[515  79 427 318 588],716,5,15490,4.5199883279836595,40.0,0.0
43427,4,3427,[515  79 427 318 588],18,5,15495,4.520128354725788,40.0,0.0
43428,4,3428,[302 603 275  89 121],655,4,15499,4.519976669582968,20.0,20.0
43429,4,3429,[515  79 427 318 588],18,5,15504,4.520116618075802,40.0,0.0
43430,4,3430,[ 98 257 294 282  79],796,4,15508,4.519965024774119,0.0,0.0
43431,4,3431,[588 286  95 186 322],786,4,15512,4.519813519813519,0.0,20.0
43432,4,3432,[515  79 427 318 588],716,5,15517,4.519953393533353,40.0,0.0
43433,4,3433,[515  79 427 318 588],807,5,15522,4.520093185789167,40.0,0.0
43434,4,3434,[173 318  79 210 228],577,3,15525,4.5196506550218345,20.0,0.0
43435,4,3435,[151 215 357 655  82],151,3,15528,4.5192083818393485,0.0,0.0
43436,4,3436,[515  79 427 318 588],807,5,15533,4.519348268839104,40.0,0.0
43437,4,3437,[125 597 180  50 257],796,4,15537,4.519197207678883,0.0,20.0
43438,4,3438,[515  79 427 318 588],716,5,15542,4.519337016574585,40.0,0.0
43439,4,3439,[515  79 427 318 588],18,5,15547,4.519476744186046,40.0,0.0
43440,4,3440,[515  79 427 318 588],807,5,15552,4.519616390584132,40.0,0.0
43441,4,3441,[515  79 427 318 588],716,5,15557,4.519755955839628,40.0,0.0
43442,4,3442,[132 245 183 118 282],504,3,15560,4.519314551263433,0.0,0.0
43443,4,3443,[515  79 427 318 588],18,5,15565,4.519454123112659,40.0,0.0
43444,4,3444,[515  79 427 318 588],18,5,15570,4.519593613933236,40.0,0.0
43445,4,3445,[268  12   4 173 235],344,3,15573,4.51915264074289,0.0,0.0
43446,4,3446,[515  79 427 318 588],716,5,15578,4.519292138091093,40.0,0.0
43447,4,3447,[204 186 118 196 168],457,5,15583,4.5194315545243615,0.0,0.0
43448,4,3448,[515  79 427 318 588],807,5,15588,4.5195708901130764,40.0,0.0
43449,4,3449,[515  79 427 318 588],18,5,15593,4.5197101449275365,40.0,0.0
43450,4,3450,[515  79 427 318 588],18,5,15598,4.51984931903796,40.0,0.0
43451,4,3451,[515  79 427 318 588],18,5,15603,4.5199884125144845,40.0,0.0
43452,4,3452,[515  79 427 318 588],18,5,15608,4.520127425427165,40.0,0.0
43453,4,3453,[515  79 427 318 588],18,5,15613,4.520266357845975,40.0,0.0
43454,4,3454,[515  79 427 318 588],807,5,15618,4.520405209840811,40.0,0.0
43455,4,3455,[174  82 181  69  50],504,3,15621,4.519965277777778,0.0,20.0
43456,4,3456,[ 15 118  97 185 117],655,1,15622,4.518947063928262,0.0,0.0
43457,4,3457,[515  79 427 318 588],716,5,15627,4.519086176980914,40.0,0.0
43458,4,3458,[515  79 427 318 588],807,5,15632,4.51922520959815,40.0,0.0
43459,4,3459,[515  79 427 318 588],18,5,15637,4.519364161849711,40.0,0.0
43460,4,3460,[237 211 265  56 200],796,4,15641,4.519214099971107,0.0,0.0
43461,4,3461,[183 603 282 118 196],655,2,15643,4.518486424032352,20.0,0.0
43462,4,3462,[515  79 427 318 588],807,5,15648,4.518625469246318,40.0,0.0
43463,4,3463,[318 185  70 135 143],457,5,15653,4.518764434180139,20.0,0.0
43464,4,3464,[515  79 427 318 588],807,5,15658,4.518903318903319,40.0,0.0
43465,4,3465,[515  79 427 318 588],716,5,15663,4.519042123485286,40.0,0.0
43466,4,3466,[ 98 191 286 427 258],655,3,15666,4.5186039803865015,20.0,20.0
43467,4,3467,[228 173 195  71  79],23,4,15670,4.518454440599769,0.0,0.0
43468,4,3468,[515 597 318 427  88],269,3,15673,4.51801671951571,40.0,0.0
43469,4,3469,[204 385 173 222 228],23,4,15677,4.517867435158501,0.0,0.0
43470,4,3470,[515  79 427 318 588],18,5,15682,4.518006338231057,40.0,0.0
43471,4,3471,[300 228 195 216  28],450,5,15687,4.518145161290323,0.0,0.0
43472,4,3472,[515  79 427 318 588],716,5,15692,4.518283904405413,40.0,0.0
43473,4,3473,[197 405  64 161 294],716,4,15696,4.518134715025907,20.0,0.0
43474,4,3474,[515  79 427 318 588],716,5,15701,4.518273381294964,40.0,0.0
43475,4,3475,[515  79 427 318 588],18,5,15706,4.518411967779056,40.0,0.0
43476,4,3476,[588  56 496 196  69],731,3,15709,4.517975266033937,20.0,0.0
43477,4,3477,[515  79 427 318 588],807,5,15714,4.51811385853939,40.0,0.0
43478,4,3478,[121 748 183  98 174],450,4,15718,4.517964932451854,0.0,0.0
43479,4,3479,[515  79 427 318 588],716,5,15723,4.518103448275862,40.0,0.0
43480,4,3480,[515  79 427 318 588],807,5,15728,4.518241884515944,40.0,0.0
43481,4,3481,[515  79 427 318 588],18,5,15733,4.518380241240666,40.0,0.0
43482,4,3482,[515  79 427 318 588],18,5,15738,4.518518518518518,40.0,0.0
43483,4,3483,[182 186 235 168 475],264,5,15743,4.518656716417911,0.0,0.0
43484,4,3484,[515  79 427 318 588],807,5,15748,4.518794835007173,40.0,0.0
43485,4,3485,[273   8 357 121 271],796,4,15752,4.518646012621916,0.0,0.0
43486,4,3486,[515  79 427 318 588],18,5,15757,4.518784055061658,40.0,0.0
43487,4,3487,[515  79 427 318 588],716,5,15762,4.518922018348624,40.0,0.0
43488,4,3488,[515  79 427 318 588],716,5,15767,4.519059902550874,40.0,0.0
43489,4,3489,[515  79 427 318 588],807,5,15772,4.51919770773639,40.0,0.0
43490,4,3490,[168 245 195  56 194],450,5,15777,4.519335433973073,0.0,0.0
43491,4,3491,[515  79 427 318 588],18,5,15782,4.519473081328751,40.0,0.0
43492,4,3492,[515  79 427 318 588],807,5,15787,4.519610649871171,40.0,0.0
43493,4,3493,[515  79 427 318 588],18,5,15792,4.519748139668002,40.0,0.0
43494,4,3494,[515  79 427 318 588],18,5,15797,4.519885550786839,40.0,0.0
43495,4,3495,[515  79 427 318 588],807,5,15802,4.520022883295194,40.0,0.0
43496,4,3496,[515  79 427 318 588],18,5,15807,4.520160137260509,40.0,0.0
43497,4,3497,[515  79 427 318 588],716,5,15812,4.520297312750143,40.0,0.0
43498,4,3498,[515  79 427 318 588],807,5,15817,4.52043440983138,40.0,0.0
43499,4,3499,[515  79 427 318 588],18,5,15822,4.5205714285714285,40.0,0.0
43500,4,3500,[515  79 427 318 588],18,5,15827,4.5207083690374175,40.0,0.0
43501,4,3501,[515  79 427 318 588],807,5,15832,4.520845231296402,40.0,0.0
43502,4,3502,[ 98 228  22  56  71],450,4,15836,4.52069654581787,0.0,0.0
43503,4,3503,[515  79 427 318 588],716,5,15841,4.520833333333333,40.0,0.0
43504,4,3504,[515  79 427 318 588],807,5,15846,4.520970042796006,40.0,0.0
43505,4,3505,[  9 182  88 282 678],280,1,15847,4.519965772960639,0.0,0.0
43506,4,3506,[132 204 200 546 176],450,4,15851,4.51981750784146,0.0,0.0
43507,4,3507,[210  89  50 153 405],655,2,15853,4.519099201824401,0.0,20.0
43508,4,3508,[515  79 427 318 588],18,5,15858,4.5192362496437735,40.0,0.0
43509,4,3509,[515  79 427 318 588],716,5,15863,4.519373219373219,40.0,0.0
43510,4,3510,[515  79 427 318 588],807,5,15868,4.519510111079464,40.0,0.0
43511,4,3511,[515  79 427 318 588],807,5,15873,4.519646924829157,40.0,0.0
43512,4,3512,[515  79 427 318 588],807,5,15878,4.51978366068887,40.0,0.0
43513,4,3513,[515  79 427 318 588],716,5,15883,4.5199203187251,40.0,0.0
43514,4,3514,[515  79 427 318 588],716,5,15888,4.520056899004268,40.0,0.0
43515,4,3515,[423 403 273  56  98],796,4,15892,4.519908987485779,0.0,0.0
43516,4,3516,[268  12 181 385  82],655,0,15892,4.518623827125391,0.0,0.0
43517,4,3517,[515  79 427 318 588],716,5,15897,4.518760659465605,40.0,0.0
43518,4,3518,[515  79 427 318 588],807,5,15902,4.518897414038079,40.0,0.0
43519,4,3519,[515  79 427 318 588],18,5,15907,4.5190340909090905,40.0,0.0
43520,4,3520,[515  79 427 318 588],716,5,15912,4.519170690144845,40.0,0.0
43521,4,3521,[328 238 301 118  50],151,3,15915,4.518739352640545,0.0,20.0
43522,4,3522,[515  79 427 318 588],18,5,15920,4.518875957990349,40.0,0.0
43523,4,3523,[515  79 427 318 588],716,5,15925,4.519012485811578,40.0,0.0
43524,4,3524,[200 204 173 508 132],280,2,15927,4.518297872340425,0.0,0.0
43525,4,3525,[515  79 427 318 588],18,5,15932,4.518434486670448,40.0,0.0
43526,4,3526,[515  79 427 318 588],716,5,15937,4.518571023532747,40.0,0.0
43527,4,3527,[515  79 427 318 588],716,5,15942,4.5187074829931975,40.0,0.0
43528,4,3528,[515  79 427 318 588],18,5,15947,4.518843865117597,40.0,0.0
43529,4,3529,[515  79 427 318 588],18,5,15952,4.518980169971671,40.0,0.0
43530,4,3530,[515  79 427 318 588],807,5,15957,4.519116397621071,40.0,0.0
43531,4,3531,[ 98  25 222  89  64],151,5,15962,4.51925254813137,20.0,0.0
43532,4,3532,[515  79 427 318 588],807,5,15967,4.519388621568073,40.0,0.0
43533,4,3533,[515  79 427 318 588],807,5,15972,4.519524617996605,40.0,0.0
43534,4,3534,[515  79 427 318 588],18,5,15977,4.51966053748232,40.0,0.0
43535,4,3535,[515  79 427 318 588],807,5,15982,4.519796380090498,40.0,0.0
43536,4,3536,[515  79 427 318 588],18,5,15987,4.519932145886345,40.0,0.0
43537,4,3537,[ 64 191  15 427 483],389,4,15991,4.519785189372527,40.0,0.0
43538,4,3538,[357 508 294 282 117],401,1,15992,4.518790618818875,0.0,0.0
43539,4,3539,[ 79 515 427 318 588],18,5,15997,4.518926553672316,40.0,0.0
43540,4,3540,[ 79 515 427 318 588],18,5,16002,4.519062411748094,40.0,0.0
43541,4,3541,[ 79 515 427 318 588],18,5,16007,4.519198193111237,40.0,0.0
43542,4,3542,[ 79 515 427 318 588],716,5,16012,4.519333897826701,40.0,0.0
43543,4,3543,[ 79 515 427 318 588],807,5,16017,4.519469525959368,40.0,0.0
43544,4,3544,[ 79 515 427 318 588],807,5,16022,4.519605077574048,40.0,0.0
43545,4,3545,[ 79 515 427 318 588],716,5,16027,4.519740552735477,40.0,0.0
43546,4,3546,[ 98 186 161 202 173],796,4,16031,4.519594023118128,0.0,0.0
43547,4,3547,[ 79 515 427 318 588],807,5,16036,4.519729425028185,40.0,0.0
43548,4,3548,[ 79 515 427 318 588],18,5,16041,4.519864750633982,40.0,0.0
43549,4,3549,[748 245 235  95 405],450,3,16044,4.51943661971831,0.0,0.0
43550,4,3550,[ 79 515 427 318 588],18,5,16049,4.5195719515629404,40.0,0.0
43551,4,3551,[ 11 144 300 191 180],693,2,16051,4.518862612612613,0.0,0.0
43552,4,3552,[ 79 515 427 318 588],18,5,16056,4.518998029833943,40.0,0.0
43553,4,3553,[ 79 515 427 318 588],18,5,16061,4.5191333708497465,40.0,0.0
43554,4,3554,[ 79 515 427 318 588],716,5,16066,4.519268635724332,40.0,0.0
43555,4,3555,[ 79 515 427 318 588],18,5,16071,4.519403824521935,40.0,0.0
43556,4,3556,[135 322 300  12 200],151,3,16074,4.518976665729547,0.0,0.0
43557,4,3557,[ 79 515 427 318 588],807,5,16079,4.5191118605958405,40.0,0.0
43558,4,3558,[ 79 515 427 318 588],807,5,16084,4.519246979488621,40.0,0.0
43559,4,3559,[ 79 515 427 318 588],18,5,16089,4.51938202247191,40.0,0.0
43560,4,3560,[ 79 515 427 318 588],18,5,16094,4.51951698960966,40.0,0.0
43561,4,3561,[ 79 515 427 318 588],716,5,16099,4.51965188096575,40.0,0.0
43562,4,3562,[ 79 515 427 318 588],807,5,16104,4.519786696603985,40.0,0.0
43563,4,3563,[ 79 515 427 318 588],716,5,16109,4.5199214365881035,40.0,0.0
43564,4,3564,[125 322 678  82 237],504,4,16113,4.519775596072932,0.0,0.0
43565,4,3565,[ 79 515 427 318 588],716,5,16118,4.519910263600673,40.0,0.0
43566,4,3566,[ 79 515 427 318 588],807,5,16123,4.52004485562097,40.0,0.0
43567,4,3567,[276 423 176 186 196],504,2,16125,4.519338565022421,0.0,0.0
43568,4,3568,[ 79 515 427 318 588],18,5,16130,4.519473241804427,40.0,0.0
43569,4,3569,[ 79 515 427 318 588],716,5,16135,4.519607843137255,40.0,0.0
43570,4,3570,[173 153 603  56 294],796,4,16139,4.519462335480258,20.0,0.0
43571,4,3571,[ 79 515 427 318 588],807,5,16144,4.51959686450168,40.0,0.0
43572,4,3572,[ 70 111 196 127  71],786,5,16149,4.519731318219983,0.0,20.0
43573,4,3573,[ 79 515 427 318 588],807,5,16154,4.5198656966983775,40.0,0.0
43574,4,3574,[ 79 515 427 318 588],18,5,16159,4.52,40.0,0.0
43575,4,3575,[153 181  50 245   1],450,5,16164,4.52013422818792,0.0,20.0
43576,4,3576,[ 79 515 427 318 588],716,5,16169,4.520268381325133,40.0,0.0
43577,4,3577,[173 603 151 222 748],151,4,16173,4.5201229737283395,20.0,0.0
43578,4,3578,[195 496 222  88   4],716,3,16176,4.519698239731769,20.0,0.0
43579,4,3579,[ 79 515 427 318 588],18,5,16181,4.519832402234637,40.0,0.0
43580,4,3580,[ 79 515 427 318 588],807,5,16186,4.519966489807317,40.0,0.0
43581,4,3581,[111 125  97 143 202],655,1,16187,4.518983807928532,0.0,0.0
43582,4,3582,[ 79 515 427 318 588],716,5,16192,4.519118057493721,40.0,0.0
43583,4,3583,[ 79 515 427 318 588],807,5,16197,4.519252232142857,40.0,0.0
43584,4,3584,[ 79 515 427 318 588],807,5,16202,4.519386331938633,40.0,0.0
43585,4,3585,[ 79 515 427 318 588],18,5,16207,4.51952035694367,40.0,0.0
43586,4,3586,[ 79 515 427 318 588],716,5,16212,4.519654307220518,40.0,0.0
43587,4,3587,[655 496 385  79 238],796,3,16215,4.519230769230769,20.0,0.0
43588,4,3588,[ 79 515 427 318 588],18,5,16220,4.519364725550292,40.0,0.0
43589,4,3589,[ 79 515 427 318 588],807,5,16225,4.5194986072423395,40.0,0.0
43590,4,3590,[294 234  69 588 496],280,3,16228,4.519075466443888,20.0,0.0
43591,4,3591,[181 191 127 258  97],693,3,16231,4.518652561247216,0.0,20.0
43592,4,3592,[ 79 515 427 318 588],807,5,16236,4.518786529362649,40.0,0.0
43593,4,3593,[ 79 515 427 318 588],716,5,16241,4.518920422927101,40.0,0.0
43594,4,3594,[ 79 515 427 318 588],18,5,16246,4.519054242002782,40.0,0.0
43595,4,3595,[ 79 515 427 318 588],18,5,16251,4.519187986651835,40.0,0.0
43596,4,3596,[ 79 515 427 318 588],716,5,16256,4.519321656936336,40.0,0.0
43597,4,3597,[ 79 515 427 318 588],807,5,16261,4.519455252918288,40.0,0.0
43598,4,3598,[ 79 515 427 318 588],18,5,16266,4.519588774659628,40.0,0.0
43599,4,3599,[ 79 515 427 318 588],716,5,16271,4.519722222222223,40.0,0.0
43600,4,3600,[ 79 515 427 318 588],18,5,16276,4.51985559566787,40.0,0.0
43601,4,3601,[ 79 515 427 318 588],18,5,16281,4.519988895058301,40.0,0.0
43602,4,3602,[ 79 515 427 318 588],716,5,16286,4.520122120455176,40.0,0.0
43603,4,3603,[ 79 515 427 318 588],716,5,16291,4.520255271920089,40.0,0.0
43604,4,3604,[ 79 515 427 318 588],716,5,16296,4.520388349514563,40.0,0.0
43605,4,3605,[ 79 515 427 318 588],807,5,16301,4.5205213533000554,40.0,0.0
43606,4,3606,[ 79 515 427 318 588],716,5,16306,4.520654283337954,40.0,0.0
43607,4,3607,[ 79 515 427 318 588],807,5,16311,4.5207871396895785,40.0,0.0
43608,4,3608,[ 79 515 427 318 588],807,5,16316,4.520919922416182,40.0,0.0
43609,4,3609,[ 79 515 427 318 588],807,5,16321,4.521052631578947,40.0,0.0
43610,4,3610,[546 185 127 211 678],504,5,16326,4.521185267238992,0.0,20.0
43611,4,3611,[ 79 515 427 318 588],716,5,16331,4.521317829457364,40.0,0.0
43612,4,3612,[ 79 515 427 318 588],716,5,16336,4.521450318295046,40.0,0.0
43613,4,3613,[ 79 515 427 318 588],18,5,16341,4.5215827338129495,40.0,0.0
43614,4,3614,[ 79 515 427 318 588],18,5,16346,4.5217150760719225,40.0,0.0
43615,4,3615,[ 22 173 175 180  88],457,5,16351,4.521847345132743,0.0,0.0
43616,4,3616,[ 79 515 427 318 588],807,5,16356,4.521979541056123,40.0,0.0
43617,4,3617,[ 79 515 427 318 588],716,5,16361,4.522111663902709,40.0,0.0
43618,4,3618,[ 79 515 427 318 588],807,5,16366,4.522243713733076,40.0,0.0
43619,4,3619,[185 161 195 357 144],693,4,16370,4.5220994475138125,0.0,0.0
43620,4,3620,[ 79 515 427 318 588],18,5,16375,4.522231427782381,40.0,0.0
43621,4,3621,[127 175  25   4 182],457,5,16380,4.522363335173937,0.0,20.0
43622,4,3622,[258 180  71 210  98],504,5,16385,4.522495169748827,0.0,0.0
43623,4,3623,[111  22  11 185 196],716,5,16390,4.522626931567329,0.0,0.0
43624,4,3624,[ 22   9 144 100 132],535,3,16393,4.522206896551724,0.0,20.0
43625,4,3625,[ 79 515 427 318 588],807,5,16398,4.522338665195808,40.0,0.0
43626,4,3626,[ 79 515 427 318 588],18,5,16403,4.522470361180039,40.0,0.0
43627,4,3627,[ 79 515 427 318 588],716,5,16408,4.522601984564498,40.0,0.0
43628,4,3628,[ 79 515 427 318 588],716,5,16413,4.522733535409204,40.0,0.0
43629,4,3629,[ 79 515 427 318 588],18,5,16418,4.522865013774105,40.0,0.0
43630,4,3630,[ 79 515 427 318 588],716,5,16423,4.522996419719085,40.0,0.0
43631,4,3631,[ 79 515 427 318 588],807,5,16428,4.523127753303965,40.0,0.0
43632,4,3632,[ 79 515 427 318 588],807,5,16433,4.523259014588494,40.0,0.0
43633,4,3633,[ 79 515 427 318 588],807,5,16438,4.523390203632361,40.0,0.0
43634,4,3634,[588  50 265 143 144],716,4,16442,4.523246217331499,0.0,20.0
43635,4,3635,[ 79 515 427 318 588],807,5,16447,4.523377337733773,40.0,0.0
43636,4,3636,[ 79 515 427 318 588],807,5,16452,4.523508386032445,40.0,0.0
43637,4,3637,[ 79 515 427 318 588],18,5,16457,4.523639362286971,40.0,0.0
43638,4,3638,[ 79 515 427 318 588],807,5,16462,4.523770266556746,40.0,0.0
43639,4,3639,[234 265 210 186  98],450,2,16464,4.523076923076923,0.0,0.0
43640,4,3640,[ 79 515 427 318 588],807,5,16469,4.523207909914858,40.0,0.0
43641,4,3641,[ 79 515 427 318 588],18,5,16474,4.5233388248215265,40.0,0.0
43642,4,3642,[323 471 257 678   9],938,1,16475,4.522371671699149,0.0,0.0
43643,4,3643,[ 79 515 427 318 588],716,5,16480,4.522502744237102,40.0,0.0
43644,4,3644,[ 79 515 427 318 588],807,5,16485,4.522633744855967,40.0,0.0
43645,4,3645,[ 79 515 427 318 588],716,5,16490,4.522764673614921,40.0,0.0
43646,4,3646,[313 215 196  88 222],655,1,16491,4.521798738689334,0.0,0.0
43647,4,3647,[ 79 515 427 318 588],807,5,16496,4.521929824561403,40.0,0.0
43648,4,3648,[ 79 515 427 318 588],716,5,16501,4.522060838585914,40.0,0.0
43649,4,3649,[ 79 515 427 318 588],18,5,16506,4.522191780821918,40.0,0.0
43650,4,3650,[282 403 483 333 179],655,2,16508,4.521500958641468,0.0,0.0
43651,4,3651,[ 79 515 427 318 588],807,5,16513,4.521631982475356,40.0,0.0
43652,4,3652,[ 79 515 427 318 588],807,5,16518,4.521762934574323,40.0,0.0
43653,4,3653,[ 79 515 427 318 588],807,5,16523,4.521893814997263,40.0,0.0
43654,4,3654,[ 79 515 427 318 588],807,5,16528,4.522024623803009,40.0,0.0
43655,4,3655,[153 268 143 235 515],269,2,16530,4.521334792122539,0.0,0.0
43656,4,3656,[ 79 515 427 318 588],807,5,16535,4.521465682253213,40.0,0.0
43657,4,3657,[ 79 515 427 318 588],18,5,16540,4.52159650082012,40.0,0.0
43658,4,3658,[ 79 515 427 318 588],807,5,16545,4.521727247881935,40.0,0.0
43659,4,3659,[ 79 515 427 318 588],807,5,16550,4.521857923497268,40.0,0.0
43660,4,3660,[ 79 515 427 318 588],807,5,16555,4.521988527724665,40.0,0.0
43661,4,3661,[ 79 515 427 318 588],18,5,16560,4.522119060622611,40.0,0.0
43662,4,3662,[403 385  88 748   1],796,4,16564,4.521976521976522,0.0,0.0
43663,4,3663,[ 79 515 427 318 588],18,5,16569,4.522106986899563,40.0,0.0
43664,4,3664,[ 79 515 427 318 588],807,5,16574,4.522237380627558,40.0,0.0
43665,4,3665,[ 79 515 427 318 588],18,5,16579,4.522367703218767,40.0,0.0
43666,4,3666,[ 79 515 427 318 588],716,5,16584,4.522497954731388,40.0,0.0
43667,4,3667,[ 79 515 427 318 588],807,5,16589,4.522628135223555,40.0,0.0
43668,4,3668,[ 79 515 427 318 588],807,5,16594,4.522758244753339,40.0,0.0
43669,4,3669,[ 79 515 427 318 588],18,5,16599,4.522888283378746,40.0,0.0
43670,4,3670,[ 79 515 427 318 588],716,5,16604,4.523018251157723,40.0,0.0
43671,4,3671,[ 79 515 427 318 588],807,5,16609,4.523148148148148,40.0,0.0
43672,4,3672,[ 79 515 427 318 588],18,5,16614,4.523277974407841,40.0,0.0
43673,4,3673,[ 70 328 121 196 385],151,3,16617,4.522863364180729,0.0,0.0
43674,4,3674,[204 403 286 265   8],655,0,16617,4.521632653061224,0.0,20.0
43675,4,3675,[ 79 515 427 318 588],716,5,16622,4.521762785636562,40.0,0.0
43676,4,3676,[ 79 515 427 318 588],716,5,16627,4.52189284742997,40.0,0.0
43677,4,3677,[ 79 515 427 318 588],807,5,16632,4.5220228384991845,40.0,0.0
43678,4,3678,[ 79 515 427 318 588],716,5,16637,4.522152758901876,40.0,0.0
43679,4,3679,[ 79 515 427 318 588],18,5,16642,4.522282608695652,40.0,0.0
43680,4,3680,[ 79 515 427 318 588],18,5,16647,4.52241238793806,40.0,0.0
43681,4,3681,[318 275 238 496   9],151,5,16652,4.522542096686584,40.0,20.0
43682,4,3682,[ 79 515 427 318 588],807,5,16657,4.522671734998642,40.0,0.0
43683,4,3683,[238 235 135  64 496],716,3,16660,4.522258414766558,40.0,0.0
43684,4,3684,[ 79 515 427 318 588],716,5,16665,4.522388059701493,40.0,0.0
43685,4,3685,[ 79 515 427 318 588],18,5,16670,4.5225176342919156,40.0,0.0
43686,4,3686,[ 79 515 427 318 588],807,5,16675,4.5226471385950635,40.0,0.0
43687,4,3687,[  1 195  70  56 258],457,5,16680,4.522776572668112,0.0,0.0
43688,4,3688,[ 79 515 427 318 588],807,5,16685,4.522905936568176,40.0,0.0
43689,4,3689,[603 273  82   8   4],796,3,16688,4.52249322493225,20.0,0.0
43690,4,3690,[269 100 357 117  28],796,2,16690,4.521809807640206,0.0,20.0
43691,4,3691,[234  69 403 435 118],72,3,16693,4.521397616468039,0.0,0.0
43692,4,3692,[153 508  69 195 186],655,0,16693,4.520173300839426,0.0,0.0
43693,4,3693,[181 357 174 132 515],535,3,16696,4.519761775852734,0.0,0.0
43694,4,3694,[ 79 427 515 318 588],807,5,16701,4.519891745602165,40.0,0.0
43695,4,3695,[ 79 427 515 318 588],716,5,16706,4.520021645021645,40.0,0.0
43696,4,3696,[276 202  64 288 117],457,5,16711,4.5201514741682445,20.0,0.0
43697,4,3697,[ 79 427 515 318 588],18,5,16716,4.520281233098973,40.0,0.0
43698,4,3698,[ 79 427 515 318 588],18,5,16721,4.520410921870776,40.0,0.0
43699,4,3699,[ 79 427 515 318 588],716,5,16726,4.520540540540541,40.0,0.0
43700,4,3700,[ 79 427 515 318 588],807,5,16731,4.52067008916509,40.0,0.0
43701,4,3701,[ 79 427 515 318 588],18,5,16736,4.5207995678011885,40.0,0.0
43702,4,3702,[ 79 427 515 318 588],18,5,16741,4.5209289765055365,40.0,0.0
43703,4,3703,[ 79 427 515 318 588],716,5,16746,4.521058315334773,40.0,0.0
43704,4,3704,[ 79 427 515 318 588],18,5,16751,4.521187584345479,40.0,0.0
43705,4,3705,[ 79 427 515 318 588],716,5,16756,4.521316783594171,40.0,0.0
43706,4,3706,[ 79 427 515 318 588],18,5,16761,4.521445913137308,40.0,0.0
43707,4,3707,[111  79 276 313 357],344,4,16765,4.521305285868393,0.0,0.0
43708,4,3708,[483  82 423 100 588],796,3,16768,4.520895119978431,0.0,20.0
43709,4,3709,[ 79 427 515 318 588],807,5,16773,4.521024258760108,40.0,0.0
43710,4,3710,[ 79 427 515 318 588],18,5,16778,4.52115332794395,40.0,0.0
43711,4,3711,[ 79 427 515 318 588],807,5,16783,4.521282327586207,40.0,0.0
43712,4,3712,[200 153 182 273  79],655,4,16787,4.521141933746296,0.0,0.0
43713,4,3713,[ 79 427 515 318 588],716,5,16792,4.521270866989768,40.0,0.0
43714,4,3714,[ 79 427 515 318 588],18,5,16797,4.521399730820996,40.0,0.0
43715,4,3715,[ 79 427 515 318 588],716,5,16802,4.521528525296017,40.0,0.0
43716,4,3716,[ 79 427 515 318 588],716,5,16807,4.52165725047081,40.0,0.0
43717,4,3717,[655 282  25 568 237],450,4,16811,4.521516944593868,0.0,0.0
43718,4,3718,[ 79 427 515 318 588],18,5,16816,4.521645603656897,40.0,0.0
43719,4,3719,[ 79 427 515 318 588],18,5,16821,4.521774193548387,40.0,0.0
43720,4,3720,[111 237 182 181   4],457,4,16825,4.521633969363075,0.0,0.0
43721,4,3721,[ 88  69 172 385 265],457,5,16830,4.521762493283181,0.0,0.0
43722,4,3722,[238 135 161 210 405],716,3,16833,4.521353746978243,0.0,0.0
43723,4,3723,[ 79 427 515 318 588],18,5,16838,4.5214822771213745,40.0,0.0
43724,4,3724,[ 71   8 288 100 125],344,3,16841,4.521073825503356,0.0,20.0
43725,4,3725,[ 79 427 515 318 588],18,5,16846,4.521202361782072,40.0,0.0
43726,4,3726,[181 161 204 282 151],457,5,16851,4.521330829085055,0.0,0.0
43727,4,3727,[234 357 228 132 179],450,4,16855,4.521190987124464,0.0,0.0
43728,4,3728,[ 79 427 515 318 588],18,5,16860,4.521319388576026,40.0,0.0
43729,4,3729,[ 79 427 515 318 588],18,5,16865,4.521447721179625,40.0,0.0
43730,4,3730,[ 79 427 515 318 588],18,5,16870,4.521575984990619,40.0,0.0
43731,4,3731,[ 79 427 515 318 588],716,5,16875,4.521704180064309,40.0,0.0
43732,4,3732,[ 79 427 515 318 588],807,5,16880,4.521832306455933,40.0,0.0
43733,4,3733,[143  96 186  98 271],655,2,16882,4.521156936261382,0.0,0.0
43734,4,3734,[ 79 427 515 318 588],807,5,16887,4.521285140562249,40.0,0.0
43735,4,3735,[ 79 427 515 318 588],807,5,16892,4.5214132762312635,40.0,0.0
43736,4,3736,[ 79 427 515 318 588],18,5,16897,4.521541343323522,40.0,0.0
43737,4,3737,[ 79 427 515 318 588],18,5,16902,4.521669341894061,40.0,0.0
43738,4,3738,[179 211 435 204 210],389,4,16906,4.521529820807703,0.0,0.0
43739,4,3739,[ 79 427 515 318 588],18,5,16911,4.521657754010695,40.0,0.0
43740,4,3740,[ 79 427 515 318 588],18,5,16916,4.521785618818498,40.0,0.0
43741,4,3741,[ 79 427 515 318 588],18,5,16921,4.521913415285943,40.0,0.0
43742,4,3742,[ 79 427 515 318 588],18,5,16926,4.522041143467806,40.0,0.0
43743,4,3743,[ 79 427 515 318 588],716,5,16931,4.522168803418803,40.0,0.0
43744,4,3744,[ 79 427 515 318 588],716,5,16936,4.5222963951935915,40.0,0.0
43745,4,3745,[ 79 427 515 318 588],716,5,16941,4.52242391884677,40.0,0.0
43746,4,3746,[ 79 427 515 318 588],807,5,16946,4.522551374432879,40.0,0.0
43747,4,3747,[ 79 427 515 318 588],807,5,16951,4.522678762006404,40.0,0.0
43748,4,3748,[ 79 427 515 318 588],716,5,16956,4.5228060816217655,40.0,0.0
43749,4,3749,[ 79 427 515 318 588],716,5,16961,4.5229333333333335,40.0,0.0
43750,4,3750,[ 79 427 515 318 588],807,5,16966,4.523060517195415,40.0,0.0
43751,4,3751,[ 79 427 515 318 588],807,5,16971,4.5231876332622605,40.0,0.0
43752,4,3752,[ 79 427 515 318 588],807,5,16976,4.5233146815880625,40.0,0.0
43753,4,3753,[ 79 427 515 318 588],18,5,16981,4.523441662226958,40.0,0.0
43754,4,3754,[ 79 427 515 318 588],807,5,16986,4.523568575233023,40.0,0.0
43755,4,3755,[ 79 427 515 318 588],716,5,16991,4.523695420660277,40.0,0.0
43756,4,3756,[603 385  82 655 195],796,3,16994,4.5232898589299975,20.0,0.0
43757,4,3757,[ 79 427 515 318 588],18,5,16999,4.523416711016498,40.0,0.0
43758,4,3758,[168 211 186 181 195],504,3,17002,4.523011439212556,0.0,0.0
43759,4,3759,[197 151 172 174 588],798,3,17005,4.522606382978723,0.0,0.0
43760,4,3760,[ 79 427 515 318 588],716,5,17010,4.522733315607551,40.0,0.0
43761,4,3761,[ 79 427 515 318 588],716,5,17015,4.522860180754917,40.0,0.0
43762,4,3762,[515  28 204 234  25],716,5,17020,4.522986978474622,0.0,0.0
43763,4,3763,[ 79 427 515 318 588],18,5,17025,4.523113708820404,40.0,0.0
43764,4,3764,[186  79   1  15 588],389,3,17028,4.522709163346613,0.0,0.0
43765,4,3765,[181 127 228 118 275],450,4,17032,4.522570366436537,0.0,40.0
43766,4,3766,[153 195 100 180 222],292,4,17036,4.5224316432174145,0.0,20.0
43767,4,3767,[ 79 427 515 318 588],18,5,17041,4.522558386411889,40.0,0.0
43768,4,3768,[496 215 318 135 237],716,4,17045,4.52241973998408,40.0,0.0
43769,4,3769,[357 210 153 117  70],330,5,17050,4.522546419098143,0.0,0.0
43770,4,3770,[100 405 185 202 151],256,4,17054,4.522407849376823,0.0,20.0
43771,4,3771,[313  69 276 176 100],655,2,17056,4.521739130434782,0.0,20.0
43772,4,3772,[ 79 427 515 318 588],18,5,17061,4.521865889212828,40.0,0.0
43773,4,3773,[ 79 427 515 318 588],807,5,17066,4.52199258081611,40.0,0.0
43774,4,3774,[ 79 427 515 318 588],18,5,17071,4.522119205298013,40.0,0.0
43775,4,3775,[ 79 427 515 318 588],18,5,17076,4.522245762711864,40.0,0.0
43776,4,3776,[ 79 427 515 318 588],18,5,17081,4.522372253110935,40.0,0.0
43777,4,3777,[100  50 288 405  88],593,4,17085,4.522233986236103,0.0,40.0
43778,4,3778,[655 132 210 215 678],280,1,17086,4.521301931727971,0.0,0.0
43779,4,3779,[100 471  22 258 185],655,1,17087,4.520370370370371,0.0,20.0
43780,4,3780,[ 79 427 515 318 588],716,5,17092,4.52049722295689,40.0,0.0
43781,4,3781,[ 79 427 515 318 588],716,5,17097,4.520624008461132,40.0,0.0
43782,4,3782,[496 151 318  25 153],716,5,17102,4.520750726936294,40.0,0.0
43783,4,3783,[471 235 173 216 265],280,3,17105,4.520348837209302,0.0,0.0
43784,4,3784,[ 79 427 515 318 588],716,5,17110,4.520475561426684,40.0,0.0
43785,4,3785,[ 79 427 515 318 588],716,5,17115,4.520602218700476,40.0,0.0
43786,4,3786,[435  15 151   1 216],450,4,17119,4.520464747821495,0.0,0.0
43787,4,3787,[ 79 427 515 318 588],716,5,17124,4.520591341077085,40.0,0.0
43788,4,3788,[282 276 228 111 197],457,4,17128,4.5204539456320925,0.0,0.0
43789,4,3789,[ 79 427 515 318 588],807,5,17133,4.520580474934037,40.0,0.0
43790,4,3790,[ 79 427 515 318 588],18,5,17138,4.520706937483514,40.0,0.0
43791,4,3791,[ 79 427 515 318 588],716,5,17143,4.520833333333333,40.0,0.0
43792,4,3792,[ 79 427 515 318 588],18,5,17148,4.520959662536251,40.0,0.0
43793,4,3793,[174 168   4 210 357],504,5,17153,4.521085925144965,0.0,0.0
43794,4,3794,[496 143 748 121 204],796,5,17158,4.5212121212121215,20.0,0.0
43795,4,3795,[ 79 427 515 318 588],716,5,17163,4.521338250790306,40.0,0.0
43796,4,3796,[ 79 427 515 318 588],716,5,17168,4.521464313932052,40.0,0.0
43797,4,3797,[ 79 427 515 318 588],807,5,17173,4.521590310689837,40.0,0.0
43798,4,3798,[405 111 195 161   7],457,4,17177,4.52145301395104,0.0,0.0
43799,4,3799,[ 79 427 515 318 588],716,5,17182,4.521578947368421,40.0,0.0
43800,4,3800,[ 79 427 515 318 588],807,5,17187,4.5217048145224945,40.0,0.0
43801,4,3801,[ 79 234  70  71 111],280,4,17191,4.521567596002104,0.0,0.0
43802,4,3802,[ 79 427 515 318 588],18,5,17196,4.52169339994741,40.0,0.0
43803,4,3803,[ 79 427 515 318 588],716,5,17201,4.521819137749737,40.0,0.0
43804,4,3804,[185  12  89 483 215],450,4,17205,4.521681997371879,0.0,0.0
43805,4,3805,[ 79 427 515 318 588],716,5,17210,4.521807672096689,40.0,0.0
43806,4,3806,[ 79 427 515 318 588],18,5,17215,4.521933280798529,40.0,0.0
43807,4,3807,[ 79 427 515 318 588],716,5,17220,4.522058823529412,40.0,0.0
43808,4,3808,[ 79 427 515 318 588],807,5,17225,4.522184300341297,40.0,0.0
43809,4,3809,[ 25 276 143   9 183],457,5,17230,4.5223097112860895,0.0,0.0
43810,4,3810,[ 79 427 515 318 588],18,5,17235,4.522435056415639,40.0,0.0
43811,4,3811,[ 79 427 515 318 588],716,5,17240,4.522560335781741,40.0,0.0
43812,4,3812,[276  97 175 125 385],344,2,17242,4.52189876737477,0.0,0.0
43813,4,3813,[ 79 427 515 318 588],18,5,17247,4.522024121657053,40.0,0.0
43814,4,3814,[ 79 427 515 318 588],807,5,17252,4.522149410222805,40.0,0.0
43815,4,3815,[ 79 427 515 318 588],18,5,17257,4.52227463312369,40.0,0.0
43816,4,3816,[ 79 427 515 318 588],18,5,17262,4.522399790411318,40.0,0.0
43817,4,3817,[ 79 427 515 318 588],807,5,17267,4.522524882137245,40.0,0.0
43818,4,3818,[ 79 427 515 318 588],807,5,17272,4.522649908352972,40.0,0.0
43819,4,3819,[ 79 427 515 318 588],807,5,17277,4.522774869109948,40.0,0.0
43820,4,3820,[ 79 427 515 318 588],807,5,17282,4.522899764459566,40.0,0.0
43821,4,3821,[471 237 228 271   7],655,0,17282,4.521716378859236,0.0,0.0
43822,4,3822,[ 28 385 471 195 423],457,5,17287,4.52184148574418,0.0,0.0
43823,4,3823,[ 79 427 515 318 588],18,5,17292,4.5219665271966525,40.0,0.0
43824,4,3824,[ 79 427 515 318 588],807,5,17297,4.522091503267974,40.0,0.0
43825,4,3825,[ 79 427 515 318 588],18,5,17302,4.522216414009409,40.0,0.0
43826,4,3826,[ 79 427 515 318 588],716,5,17307,4.522341259472172,40.0,0.0
43827,4,3827,[ 79 427 515 318 588],18,5,17312,4.522466039707419,40.0,0.0
43828,4,3828,[ 79 427 515 318 588],716,5,17317,4.522590754766258,40.0,0.0
43829,4,3829,[125  28  98   1 237],457,5,17322,4.522715404699739,0.0,0.0
43830,4,3830,[ 79 427 515 318 588],716,5,17327,4.522839989558862,40.0,0.0
43831,4,3831,[ 79 427 515 318 588],716,5,17332,4.522964509394572,40.0,0.0
43832,4,3832,[ 70 603 210 216 172],716,5,17337,4.523088964257761,20.0,0.0
43833,4,3833,[ 79 427 515 318 588],716,5,17342,4.52321335419927,40.0,0.0
43834,4,3834,[ 79 427 515 318 588],716,5,17347,4.523337679269883,40.0,0.0
43835,4,3835,[ 79 427 515 318 588],716,5,17352,4.523461939520334,40.0,0.0
43836,4,3836,[ 79 427 515 318 588],716,5,17357,4.523586135001303,40.0,0.0
43837,4,3837,[ 79 427 515 318 588],807,5,17362,4.523710265763419,40.0,0.0
43838,4,3838,[ 79 427 515 318 588],18,5,17367,4.5238343318572545,40.0,0.0
43839,4,3839,[ 79 427 515 318 588],18,5,17372,4.523958333333334,40.0,0.0
43840,4,3840,[ 79 427 515 318 588],807,5,17377,4.524082270242125,40.0,0.0
43841,4,3841,[ 79 427 515 318 588],18,5,17382,4.5242061426340445,40.0,0.0
43842,4,3842,[ 79 427 515 318 588],716,5,17387,4.5243299505594585,40.0,0.0
43843,4,3843,[ 79 427 515 318 588],807,5,17392,4.524453694068678,40.0,0.0
43844,4,3844,[ 79 427 515 318 588],716,5,17397,4.524577373211963,40.0,0.0
43845,4,3845,[ 79 427 515 318 588],716,5,17402,4.5247009880395215,40.0,0.0
43846,4,3846,[ 79 427 515 318 588],18,5,17407,4.524824538601508,40.0,0.0
43847,4,3847,[ 79 427 515 318 588],18,5,17412,4.524948024948025,40.0,0.0
43848,4,3848,[ 79 427 515 318 588],18,5,17417,4.5250714471291245,40.0,0.0
43849,4,3849,[ 79 427 515 318 588],716,5,17422,4.525194805194805,40.0,0.0
43850,4,3850,[ 79 427 515 318 588],716,5,17427,4.525318099195014,40.0,0.0
43851,4,3851,[568 181 153 300 135],389,1,17428,4.524402907580478,0.0,0.0
43852,4,3852,[ 70 322 195 288  56],504,3,17431,4.524007267064625,0.0,0.0
43853,4,3853,[ 79 427 515 318 588],716,5,17436,4.524130773222626,40.0,0.0
43854,4,3854,[ 79 427 515 318 588],807,5,17441,4.524254215304799,40.0,0.0
43855,4,3855,[215  88 269 182 427],450,5,17446,4.524377593360996,20.0,0.0
43856,4,3856,[  1 125  69 161 187],796,4,17450,4.524241638579206,0.0,0.0
43857,4,3857,[ 79 427 515 318 588],807,5,17455,4.524364955935718,40.0,0.0
43858,4,3858,[ 79 427 515 318 588],18,5,17460,4.524488209380668,40.0,0.0
43859,4,3859,[ 79 427 515 318 588],18,5,17465,4.524611398963731,40.0,0.0
43860,4,3860,[ 79 427 515 318 588],716,5,17470,4.524734524734525,40.0,0.0
43861,4,3861,[ 79 427 515 318 588],18,5,17475,4.524857586742621,40.0,0.0
43862,4,3862,[588  89 181 216   1],796,4,17479,4.524721718871343,0.0,0.0
43863,4,3863,[ 79 427 515 318 588],807,5,17484,4.524844720496894,40.0,0.0
43864,4,3864,[288  96 238  25 237],450,3,17487,4.524450194049159,0.0,0.0
43865,4,3865,[ 64 202  89 118 385],450,4,17491,4.524314536989136,20.0,0.0
43866,4,3866,[ 79 427 515 318 588],807,5,17496,4.5244375484871995,40.0,0.0
43867,4,3867,[ 79 427 515 318 588],716,5,17501,4.524560496380558,40.0,0.0
43868,4,3868,[568 301 210 300  98],655,1,17502,4.523649521840269,0.0,0.0
43869,4,3869,[ 79 427 515 318 588],716,5,17507,4.5237726098191215,40.0,0.0
43870,4,3870,[ 79 427 515 318 588],18,5,17512,4.523895634203049,40.0,0.0
43871,4,3871,[ 79 427 515 318 588],807,5,17517,4.524018595041323,40.0,0.0
43872,4,3872,[ 79 427 515 318 588],807,5,17522,4.5241414923831655,40.0,0.0
43873,4,3873,[ 79 427 515 318 588],716,5,17527,4.524264326277749,40.0,0.0
43874,4,3874,[ 79 427 515 318 588],18,5,17532,4.524387096774194,40.0,0.0
43875,4,3875,[ 79 427 515 318 588],807,5,17537,4.5245098039215685,40.0,0.0
43876,4,3876,[ 79 427 515 318 588],716,5,17542,4.5246324477688935,40.0,0.0
43877,4,3877,[117 202 357 546 603],716,4,17546,4.524497163486333,20.0,0.0
43878,4,3878,[ 79 427 515 318 588],716,5,17551,4.5246197473575664,40.0,0.0
43879,4,3879,[ 79 427 515 318 588],716,5,17556,4.524742268041237,40.0,0.0
43880,4,3880,[ 79 427 515 318 588],18,5,17561,4.524864725586189,40.0,0.0
43881,4,3881,[ 15 197 237 202  12],450,4,17565,4.524729520865534,0.0,0.0
43882,4,3882,[ 79 427 515 318 588],18,5,17570,4.524851918619624,40.0,0.0
43883,4,3883,[ 79 427 515 318 588],18,5,17575,4.5249742533470645,40.0,0.0
43884,4,3884,[ 79 427 515 318 588],716,5,17580,4.525096525096525,40.0,0.0
43885,4,3885,[ 79 427 515 318 588],18,5,17585,4.525218733916624,40.0,0.0
43886,4,3886,[ 79 427 515 318 588],716,5,17590,4.52534087985593,40.0,0.0
43887,4,3887,[568  96  15  89 111],796,5,17595,4.525462962962963,0.0,0.0
43888,4,3888,[ 79 427 515 318 588],18,5,17600,4.525584983286191,40.0,0.0
43889,4,3889,[405 273 176 195 508],655,1,17601,4.524678663239075,0.0,0.0
43890,4,3890,[423 568 179 183 181],457,5,17606,4.5248008224106915,0.0,0.0
43891,4,3891,[ 79 427 515 318 588],716,5,17611,4.524922918807811,40.0,0.0
43892,4,3892,[ 79 427 515 318 588],807,5,17616,4.525044952478808,40.0,0.0
43893,4,3893,[ 79 427 515 318 588],716,5,17621,4.525166923472008,40.0,0.0
43894,4,3894,[ 79 427 515 318 588],807,5,17626,4.525288831835687,40.0,0.0
43895,4,3895,[ 79 427 515 318 588],18,5,17631,4.52541067761807,40.0,0.0
43896,4,3896,[ 79 427 515 318 588],716,5,17636,4.525532460867334,40.0,0.0
43897,4,3897,[  1 423  95   7 216],280,5,17641,4.525654181631606,0.0,0.0
43898,4,3898,[ 79 427 515 318 588],807,5,17646,4.525775839958964,40.0,0.0
43899,4,3899,[ 79 427 515 318 588],18,5,17651,4.525897435897436,40.0,0.0
43900,4,3900,[ 79 427 515 318 588],716,5,17656,4.526018969495001,40.0,0.0
43901,4,3901,[483  95 333 328 742],796,4,17660,4.5258841619682215,0.0,0.0
43902,4,3902,[ 79 427 515 318 588],18,5,17665,4.526005636689725,40.0,0.0
43903,4,3903,[ 79 427 515 318 588],18,5,17670,4.526127049180328,40.0,0.0
43904,4,3904,[ 79 427 515 318 588],18,5,17675,4.526248399487836,40.0,0.0
43905,4,3905,[ 79 427 515 318 588],807,5,17680,4.526369687660011,40.0,0.0
43906,4,3906,[ 79 427 515 318 588],18,5,17685,4.526490913744561,40.0,0.0
43907,4,3907,[ 79 427 515 318 588],18,5,17690,4.52661207778915,40.0,0.0
43908,4,3908,[ 79 427 515 318 588],807,5,17695,4.526733179841392,40.0,0.0
43909,4,3909,[ 79 427 515 318 588],716,5,17700,4.5268542199488495,40.0,0.0
43910,4,3910,[ 79 427 515 318 588],18,5,17705,4.526975198159039,40.0,0.0
43911,4,3911,[ 79 427 515 318 588],807,5,17710,4.527096114519427,40.0,0.0
43912,4,3912,[ 79 427 515 318 588],807,5,17715,4.527216969077434,40.0,0.0
43913,4,3913,[ 79 427 515 318 588],807,5,17720,4.527337761880429,40.0,0.0
43914,4,3914,[237 276 185 483   4],18,2,17722,4.52669220945083,0.0,0.0
43915,4,3915,[568 176 216 294  12],796,4,17726,4.526557711950971,0.0,0.0
43916,4,3916,[ 79 427 515 318 588],716,5,17731,4.526678580546337,40.0,0.0
43917,4,3917,[ 25 144 423 655 210],716,4,17735,4.526544155181215,0.0,0.0
43918,4,3918,[ 79 427 515 318 588],807,5,17740,4.5266649655524365,40.0,0.0
43919,4,3919,[ 79 427 515 318 588],18,5,17745,4.526785714285714,40.0,0.0
43920,4,3920,[ 79 427 515 318 588],807,5,17750,4.526906401428207,40.0,0.0
43921,4,3921,[ 79 427 515 318 588],716,5,17755,4.527027027027027,40.0,0.0
43922,4,3922,[ 79 427 515 318 588],807,5,17760,4.527147591129238,40.0,0.0
43923,4,3923,[328 111 288   1 237],938,3,17763,4.526758409785932,0.0,0.0
43924,4,3924,[ 79 427 515 318 588],716,5,17768,4.52687898089172,40.0,0.0
43925,4,3925,[603 286 275 471 191],655,3,17771,4.526490066225166,20.0,40.0
43926,4,3926,[176 742  97 286 515],655,1,17772,4.52559205500382,0.0,20.0
43927,4,3927,[ 79 427 515 318 588],716,5,17777,4.5257128309572305,40.0,0.0
43928,4,3928,[ 79 427 515 318 588],807,5,17782,4.525833545431407,40.0,0.0
43929,4,3929,[ 79 427 515 318 588],807,5,17787,4.525954198473283,40.0,0.0
43930,4,3930,[ 79 427 515 318 588],18,5,17792,4.526074790129738,40.0,0.0
43931,4,3931,[ 79 427 515 318 588],18,5,17797,4.526195320447609,40.0,0.0
43932,4,3932,[603 202  12 191 234],655,2,17799,4.525553012967201,20.0,0.0
43933,4,3933,[ 79 427 515 318 588],807,5,17804,4.525673614641586,40.0,0.0
43934,4,3934,[ 79 427 515 318 588],18,5,17809,4.52579415501906,40.0,0.0
43935,4,3935,[471 568 237  88 385],450,5,17814,4.525914634146342,0.0,0.0
43936,4,3936,[186  89 185 211 176],269,2,17816,4.525273050546101,0.0,0.0
43937,4,3937,[ 79 427 515 318 588],807,5,17821,4.5253936008125955,40.0,0.0
43938,4,3938,[ 79 427 515 318 588],807,5,17826,4.5255140898705255,40.0,0.0
43939,4,3939,[ 79 427 515 318 588],716,5,17831,4.525634517766497,40.0,0.0
43940,4,3940,[ 79 427 515 318 588],716,5,17836,4.525754884547069,40.0,0.0
43941,4,3941,[237  50 143  98 302],269,1,17837,4.524860476915271,0.0,20.0
43942,4,3942,[238  22 568  56 234],716,5,17842,4.524980978950038,0.0,0.0
43943,4,3943,[385 271 204 269 222],655,0,17842,4.523833671399594,0.0,0.0
43944,4,3944,[ 79 427 515 318 588],18,5,17847,4.5239543726235745,40.0,0.0
43945,4,3945,[173 194   7 185 483],535,5,17852,4.52407501267106,0.0,0.0
43946,4,3946,[678 222 117 127 282],280,2,17854,4.523435520648594,0.0,20.0
43947,4,3947,[ 79 427 515 318 588],716,5,17859,4.52355623100304,40.0,0.0
43948,4,3948,[182 265 271 496 144],796,5,17864,4.523676880222841,20.0,0.0
43949,4,3949,[186 288 176 211 127],504,3,17867,4.523291139240507,0.0,20.0
43950,4,3950,[ 50  12 423   7 276],655,2,17869,4.522652493039737,0.0,20.0
43951,4,3951,[ 79 427 515 318 588],716,5,17874,4.522773279352227,40.0,0.0
43952,4,3952,[ 79 427 515 318 588],18,5,17879,4.522894004553503,40.0,0.0
43953,4,3953,[ 79 427 515 318 588],18,5,17884,4.523014668689934,40.0,0.0
43954,4,3954,[ 79 427 515 318 588],716,5,17889,4.523135271807838,40.0,0.0
43955,4,3955,[ 79 427 515 318 588],18,5,17894,4.523255813953488,40.0,0.0
43956,4,3956,[ 79 427 515 318 588],807,5,17899,4.523376295173111,40.0,0.0
43957,4,3957,[216  50 200  28  25],457,5,17904,4.523496715512885,0.0,20.0
43958,4,3958,[151 173 748 275  82],450,4,17908,4.5233644859813085,0.0,20.0
43959,4,3959,[ 79 427 515 318 588],716,5,17913,4.523484848484848,40.0,0.0
43960,4,3960,[357 135  88 204 216],11,2,17915,4.522847765715729,0.0,0.0
43961,4,3961,[ 79 427 515 318 588],716,5,17920,4.522968197879859,40.0,0.0
43962,4,3962,[161  12  88 168 182],796,5,17925,4.523088569265708,0.0,0.0
43963,4,3963,[ 79 427 515 318 588],807,5,17930,4.523208879919274,40.0,0.0
43964,4,3964,[ 79 427 515 318 588],807,5,17935,4.523329129886507,40.0,0.0
43965,4,3965,[313   4 179 286 271],655,2,17937,4.522692889561271,0.0,20.0
43966,4,3966,[273 183 204 180 265],450,4,17941,4.522561129316864,0.0,0.0
43967,4,3967,[ 79 427 515 318 588],807,5,17946,4.522681451612903,40.0,0.0
43968,4,3968,[ 79 427 515 318 588],716,5,17951,4.522801713277904,40.0,0.0
43969,4,3969,[237 423 588 276 125],786,4,17955,4.5226700251889165,0.0,0.0
43970,4,3970,[ 79 427 515 318 588],807,5,17960,4.52279022916142,40.0,0.0
43971,4,3971,[ 79 427 515 318 588],807,5,17965,4.522910372608258,40.0,0.0
43972,4,3972,[ 79 427 515 318 588],807,5,17970,4.523030455575132,40.0,0.0
43973,4,3973,[ 79 427 515 318 588],807,5,17975,4.5231504781077,40.0,0.0
43974,4,3974,[ 79 427 515 318 588],18,5,17980,4.523270440251572,40.0,0.0
43975,4,3975,[153  25 117 100 238],330,5,17985,4.523390342052314,0.0,20.0
43976,4,3976,[196 191 435 211 168],591,4,17989,4.523258737742017,0.0,0.0
43977,4,3977,[ 79 427 515 318 588],807,5,17994,4.5233785822021115,40.0,0.0
43978,4,3978,[ 79 427 515 318 588],807,5,17999,4.523498366423724,40.0,0.0
43979,4,3979,[ 79 427 515 318 588],716,5,18004,4.523618090452262,40.0,0.0
43980,4,3980,[ 79 427 515 318 588],807,5,18009,4.523737754333082,40.0,0.0
43981,4,3981,[318 100 153 288 655],655,1,18010,4.522852837769965,20.0,20.0
43982,4,3982,[ 64 117 204 588 546],716,4,18014,4.522721566658298,20.0,0.0
43983,4,3983,[ 79 427 515 318 588],807,5,18019,4.522841365461847,40.0,0.0
43984,4,3984,[597 216 237 403  56],796,5,18024,4.522961104140527,0.0,0.0
43985,4,3985,[ 79 427 515 318 588],716,5,18029,4.523080782739589,40.0,0.0
43986,4,3986,[ 79 427 515 318 588],18,5,18034,4.523200401304239,40.0,0.0
43987,4,3987,[204 197 216  95 194],796,4,18038,4.523069207622869,0.0,0.0
43988,4,3988,[ 79 427 515 318 588],807,5,18043,4.523188769115066,40.0,0.0
43989,4,3989,[ 79 427 515 318 588],716,5,18048,4.523308270676692,40.0,0.0
43990,4,3990,[ 79 427 515 318 588],716,5,18053,4.5234277123527935,40.0,0.0
43991,4,3991,[197  98 276 187 151],504,3,18056,4.5230460921843685,0.0,0.0
43992,4,3992,[ 79 427 515 318 588],807,5,18061,4.523165539694466,40.0,0.0
43993,4,3993,[ 79 427 515 318 588],716,5,18066,4.523284927391087,40.0,0.0
43994,4,3994,[ 79 427 515 318 588],716,5,18071,4.523404255319149,40.0,0.0
43995,4,3995,[121 185 318  98  64],330,5,18076,4.523523523523523,40.0,0.0
43996,4,3996,[403 175 211 288 153],655,0,18076,4.522391793845384,0.0,0.0
43997,4,3997,[ 79 427 515 318 588],807,5,18081,4.522511255627814,40.0,0.0
43998,4,3998,[  8  88 238 597 222],796,4,18085,4.522380595148787,0.0,0.0
43999,4,3999,[ 79 427 515 318 588],716,5,18090,4.5225,40.0,0.0
44000,4,4000,[ 79 427 515 318 588],716,5,18095,4.522619345163709,40.0,0.0
44001,4,4001,[183 111  56  89 215],151,3,18098,4.52223888055972,0.0,0.0
44002,4,4002,[ 96 180 191 655  12],72,5,18103,4.522358231326505,0.0,0.0
44003,4,4003,[ 79 127  71  15 655],236,3,18106,4.521978021978022,0.0,20.0
44004,4,4004,[ 79 427 515 318 588],807,5,18111,4.522097378277153,40.0,0.0
44005,4,4005,[ 79 427 515 318 588],716,5,18116,4.522216674987519,40.0,0.0
44006,4,4006,[234   1 176 435 258],756,2,18118,4.521587222360869,0.0,0.0
44007,4,4007,[ 79 427 515 318 588],18,5,18123,4.5217065868263475,40.0,0.0
44008,4,4008,[ 79 427 515 318 588],18,5,18128,4.5218258917435765,40.0,0.0
44009,4,4009,[ 79 427 515 318 588],716,5,18133,4.5219451371571076,40.0,0.0
44010,4,4010,[ 79 427 515 318 588],716,5,18138,4.522064323111444,40.0,0.0
44011,4,4011,[ 98 191 258 216  79],796,5,18143,4.522183449651047,0.0,0.0
44012,4,4012,[168 181   7  64 471],450,5,18148,4.522302516820334,20.0,0.0
44013,4,4013,[ 79 427 515 318 588],716,5,18153,4.522421524663677,40.0,0.0
44014,4,4014,[ 79 427 515 318 588],716,5,18158,4.522540473225405,40.0,0.0
44015,4,4015,[ 79 427 515 318 588],18,5,18163,4.522659362549801,40.0,0.0
44016,4,4016,[ 79 427 515 318 588],716,5,18168,4.5227781926811055,40.0,0.0
44017,4,4017,[ 79 427 515 318 588],18,5,18173,4.522896963663515,40.0,0.0
44018,4,4018,[ 79 427 515 318 588],18,5,18178,4.5230156755411794,40.0,0.0
44019,4,4019,[ 79 427 515 318 588],18,5,18183,4.523134328358209,40.0,0.0
44020,4,4020,[ 79 427 515 318 588],716,5,18188,4.523252922158667,40.0,0.0
44021,4,4021,[ 79 427 515 318 588],716,5,18193,4.523371456986574,40.0,0.0
44022,4,4022,[271 196 603 176   4],655,1,18194,4.522495650012429,20.0,0.0
44023,4,4023,[ 79 427 515 318 588],18,5,18199,4.522614314115308,40.0,0.0
44024,4,4024,[ 71 174 118 173  15],389,2,18201,4.521987577639751,0.0,0.0
44025,4,4025,[ 89  70 288 655 174],655,1,18202,4.521112767014406,0.0,0.0
44026,4,4026,[ 79 427 515 318 588],18,5,18207,4.521231686118699,40.0,0.0
44027,4,4027,[111 174  89 151 202],457,4,18211,4.521102284011916,0.0,0.0
44028,4,4028,[ 79 427 515 318 588],807,5,18216,4.521221146686523,40.0,0.0
44029,4,4029,[ 79 427 515 318 588],18,5,18221,4.521339950372209,40.0,0.0
44030,4,4030,[ 79 427 515 318 588],807,5,18226,4.521458695112875,40.0,0.0
44031,4,4031,[ 79 427 515 318 588],807,5,18231,4.521577380952381,40.0,0.0
44032,4,4032,[ 79 427 515 318 588],716,5,18236,4.52169600793454,40.0,0.0
44033,4,4033,[ 79 427 515 318 588],807,5,18241,4.521814576103123,40.0,0.0
44034,4,4034,[ 79 427 515 318 588],716,5,18246,4.521933085501859,40.0,0.0
44035,4,4035,[ 79 427 515 318 588],18,5,18251,4.5220515361744305,40.0,0.0
44036,4,4036,[ 79 427 515 318 588],807,5,18256,4.5221699281644785,40.0,0.0
44037,4,4037,[ 79 427 515 318 588],807,5,18261,4.522288261515602,40.0,0.0
44038,4,4038,[302  69 127 237 276],401,1,18262,4.521416192126764,0.0,20.0
44039,4,4039,[ 79 427 515 318 588],807,5,18267,4.521534653465347,40.0,0.0
44040,4,4040,[ 79 427 515 318 588],716,5,18272,4.521653056174214,40.0,0.0
44041,4,4041,[ 79 427 515 318 588],807,5,18277,4.521771400296883,40.0,0.0
44042,4,4042,[ 79 427 515 318 588],18,5,18282,4.5218896858768245,40.0,0.0
44043,4,4043,[ 79 427 515 318 588],18,5,18287,4.522007912957468,40.0,0.0
44044,4,4044,[125 385 286 508 423],655,0,18287,4.520889987639061,0.0,20.0
44045,4,4045,[385 118   9 288  25],256,5,18292,4.5210084033613445,0.0,0.0
44046,4,4046,[ 79 427 515 318 588],716,5,18297,4.52112676056338,40.0,0.0
44047,4,4047,[ 79 427 515 318 588],716,5,18302,4.521245059288537,40.0,0.0
44048,4,4048,[ 79 427 515 318 588],807,5,18307,4.521363299580143,40.0,0.0
44049,4,4049,[183   7 423 180 215],457,5,18312,4.521481481481482,0.0,0.0
44050,4,4050,[ 79 427 515 318 588],716,5,18317,4.521599605035794,40.0,0.0
44051,4,4051,[ 79 427 515 318 588],807,5,18322,4.521717670286279,40.0,0.0
44052,4,4052,[ 79 427 515 318 588],18,5,18327,4.5218356772760915,40.0,0.0
44053,4,4053,[211 111 161 294 275],450,5,18332,4.521953626048347,0.0,20.0
44054,4,4054,[ 79 427 515 318 588],18,5,18337,4.522071516646116,40.0,0.0
44055,4,4055,[ 79 427 515 318 588],716,5,18342,4.522189349112426,40.0,0.0
44056,4,4056,[ 79 427 515 318 588],716,5,18347,4.522307123490264,40.0,0.0
44057,4,4057,[ 79 427 515 318 588],716,5,18352,4.522424839822572,40.0,0.0
44058,4,4058,[ 79 427 515 318 588],18,5,18357,4.522542498152254,40.0,0.0
44059,4,4059,[ 79 427 515 318 588],807,5,18362,4.522660098522167,40.0,0.0
44060,4,4060,[ 79 427 515 318 588],18,5,18367,4.5227776409751295,40.0,0.0
44061,4,4061,[ 79 427 515 318 588],18,5,18372,4.522895125553914,40.0,0.0
44062,4,4062,[143 597 168 202 286],796,4,18376,4.522766428747231,0.0,20.0
44063,4,4063,[ 79 427 515 318 588],18,5,18381,4.522883858267717,40.0,0.0
44064,4,4064,[ 79 427 515 318 588],18,5,18386,4.5230012300123,40.0,0.0
44065,4,4065,[ 79 427 515 318 588],716,5,18391,4.52311854402361,40.0,0.0
44066,4,4066,[ 79 427 515 318 588],716,5,18396,4.523235800344234,40.0,0.0
44067,4,4067,[ 79 427 515 318 588],18,5,18401,4.523352999016716,40.0,0.0
44068,4,4068,[ 79 427 515 318 588],18,5,18406,4.523470140083559,40.0,0.0
44069,4,4069,[ 79 427 515 318 588],807,5,18411,4.523587223587223,40.0,0.0
44070,4,4070,[222 357 172  28 269],655,2,18413,4.5229673298943744,0.0,0.0
44071,4,4071,[385 588 144 100 496],450,5,18418,4.523084479371317,20.0,20.0
44072,4,4072,[ 79 427 515 318 588],18,5,18423,4.523201571323349,40.0,0.0
44073,4,4073,[153 496 597 238  56],269,3,18426,4.522827687776141,20.0,0.0
44074,4,4074,[ 79 182 183 196 483],457,5,18431,4.522944785276073,0.0,0.0
44075,4,4075,[ 79 427 515 318 588],716,5,18436,4.5230618253189405,40.0,0.0
44076,4,4076,[ 79 427 515 318 588],807,5,18441,4.52317880794702,40.0,0.0
44077,4,4077,[191 132 313   7  56],693,4,18445,4.523050514958313,0.0,0.0
44078,4,4078,[174 385 275 172 176],796,5,18450,4.523167443000736,0.0,20.0
44079,4,4079,[ 79 427 515 318 588],807,5,18455,4.52328431372549,40.0,0.0
44080,4,4080,[ 79 427 515 318 588],18,5,18460,4.523401127174712,40.0,0.0
44081,4,4081,[ 79 427 515 318 588],18,5,18465,4.523517883390495,40.0,0.0
44082,4,4082,[ 79 427 515 318 588],807,5,18470,4.523634582414891,40.0,0.0
44083,4,4083,[168 234  82  22 302],269,1,18471,4.522771792360431,0.0,0.0
44084,4,4084,[ 79 427 515 318 588],716,5,18476,4.5228886168910645,40.0,0.0
44085,4,4085,[ 79 427 515 318 588],18,5,18481,4.523005384238864,40.0,0.0
44086,4,4086,[ 79 427 515 318 588],716,5,18486,4.523122094445804,40.0,0.0
44087,4,4087,[176 174 318 117 234],72,4,18490,4.522994129158513,20.0,0.0
44088,4,4088,[ 79 427 515 318 588],807,5,18495,4.5231107850330154,40.0,0.0
44089,4,4089,[186 568  96 597  82],457,4,18499,4.5229828850855744,0.0,0.0
44090,4,4090,[ 56 282   9 234 100],256,3,18502,4.5226106086531415,0.0,20.0
44091,4,4091,[143  56 215 655  96],693,4,18506,4.522482893450635,0.0,0.0
44092,4,4092,[ 79 427 515 318 588],807,5,18511,4.522599560224774,40.0,0.0
44093,4,4093,[ 70 211 237 405 183],716,4,18515,4.522471910112359,0.0,0.0
44094,4,4094,[ 79 427 515 318 588],807,5,18520,4.5225885225885225,40.0,0.0
44095,4,4095,[ 71 153 183  28 191],796,4,18524,4.5224609375,0.0,0.0
44096,4,4096,[ 79 427 515 318 588],18,5,18529,4.522577495728582,40.0,0.0
44097,4,4097,[ 79 427 515 318 588],716,5,18534,4.522693997071742,40.0,0.0
44098,4,4098,[ 79 427 515 318 588],716,5,18539,4.522810441571115,40.0,0.0
44099,4,4099,[ 79 427 515 318 588],807,5,18544,4.522926829268292,40.0,0.0
44100,4,4100,[ 79 427 515 318 588],18,5,18549,4.523043160204828,40.0,0.0
44101,4,4101,[ 79 427 515 318 588],716,5,18554,4.523159434422233,40.0,0.0
44102,4,4102,[ 79 427 515 318 588],807,5,18559,4.5232756519619794,40.0,0.0
44103,4,4103,[ 79 427 515 318 588],807,5,18564,4.523391812865497,40.0,0.0
44104,4,4104,[ 79 427 515 318 588],716,5,18569,4.523507917174178,40.0,0.0
44105,4,4105,[ 79 427 515 318 588],716,5,18574,4.523623964929372,40.0,0.0
44106,4,4106,[ 79 427 515 318 588],807,5,18579,4.523739956172388,40.0,0.0
44107,4,4107,[ 79 427 515 318 588],18,5,18584,4.523855890944499,40.0,0.0
44108,4,4108,[ 79 427 515 318 588],807,5,18589,4.5239717692869315,40.0,0.0
44109,4,4109,[ 79 427 515 318 588],18,5,18594,4.524087591240876,40.0,0.0
44110,4,4110,[603 117  98 546  79],450,5,18599,4.524203356847482,20.0,0.0
44111,4,4111,[ 79 427 515 318 588],807,5,18604,4.52431906614786,40.0,0.0
44112,4,4112,[ 79 427 515 318 588],18,5,18609,4.524434719183078,40.0,0.0
44113,4,4113,[265 238 237 588 143],716,5,18614,4.5245503159941665,0.0,0.0
44114,4,4114,[ 79 427 515 318 588],18,5,18619,4.524665856622114,40.0,0.0
44115,4,4115,[ 79 427 515 318 588],18,5,18624,4.524781341107872,40.0,0.0
44116,4,4116,[ 79 427 515 318 588],716,5,18629,4.524896769492349,40.0,0.0
44117,4,4117,[ 22 655 588 185 172],457,5,18634,4.525012141816416,0.0,0.0
44118,4,4118,[ 79 427 515 318 588],18,5,18639,4.525127458120903,40.0,0.0
44119,4,4119,[127 515 135  82 204],716,4,18643,4.525,0.0,20.0
44120,4,4120,[ 79 427 515 318 588],18,5,18648,4.525115263285611,40.0,0.0
44121,4,4121,[ 79 427 515 318 588],716,5,18653,4.525230470645318,40.0,0.0
44122,4,4122,[ 79 427 515 318 588],716,5,18658,4.525345622119816,40.0,0.0
44123,4,4123,[ 79 427 515 318 588],716,5,18663,4.525460717749757,40.0,0.0
44124,4,4124,[ 79 427 515 318 588],716,5,18668,4.525575757575758,40.0,0.0
44125,4,4125,[ 79 427 515 318 588],716,5,18673,4.525690741638391,40.0,0.0
44126,4,4126,[ 79 427 515 318 588],716,5,18678,4.525805669978192,40.0,0.0
44127,4,4127,[ 79 427 515 318 588],807,5,18683,4.525920542635659,40.0,0.0
44128,4,4128,[515 135 238 195  88],269,3,18686,4.525550980867038,0.0,0.0
44129,4,4129,[ 79 427 515 318 588],807,5,18691,4.525665859564165,40.0,0.0
44130,4,4130,[ 79 427 515 318 588],807,5,18696,4.525780682643428,40.0,0.0
44131,4,4131,[238 435 186 603  64],716,4,18700,4.5256534365924495,40.0,0.0
44132,4,4132,[ 79 427 515 318 588],807,5,18705,4.525768207113477,40.0,0.0
44133,4,4133,[ 79 427 515 318 588],716,5,18710,4.5258829221093375,40.0,0.0
44134,4,4134,[ 79 427 515 318 588],716,5,18715,4.525997581620314,40.0,0.0
44135,4,4135,[ 79 427 515 318 588],807,5,18720,4.526112185686654,40.0,0.0
44136,4,4136,[ 79 427 515 318 588],807,5,18725,4.526226734348562,40.0,0.0
44137,4,4137,[195  95  22 180 111],280,4,18729,4.52609956500725,0.0,0.0
44138,4,4138,[ 79 427 515 318 588],18,5,18734,4.52621406136748,40.0,0.0
44139,4,4139,[ 79 427 515 318 588],807,5,18739,4.526328502415459,40.0,0.0
44140,4,4140,[ 79 427 515 318 588],716,5,18744,4.526442888191258,40.0,0.0
44141,4,4141,[ 79 427 515 318 588],716,5,18749,4.526557218734911,40.0,0.0
44142,4,4142,[265 405  79 135 121],450,3,18752,4.526188752111996,0.0,0.0
44143,4,4143,[216 222   7  98 210],264,5,18757,4.526303088803089,0.0,0.0
44144,4,4144,[ 79 427 515 318 588],18,5,18762,4.526417370325694,40.0,0.0
44145,4,4145,[ 79 427 515 318 588],18,5,18767,4.52653159671973,40.0,0.0
44146,4,4146,[ 79 427 515 318 588],716,5,18772,4.5266457680250785,40.0,0.0
44147,4,4147,[ 79 427 515 318 588],807,5,18777,4.5267598842815815,40.0,0.0
44148,4,4148,[ 79 427 515 318 588],18,5,18782,4.526873945529043,40.0,0.0
44149,4,4149,[ 79 427 515 318 588],18,5,18787,4.526987951807229,40.0,0.0
44150,4,4150,[ 79 427 515 318 588],716,5,18792,4.527101903155866,40.0,0.0
44151,4,4151,[ 11 268  50 282  15],296,4,18796,4.526974951830443,0.0,20.0
44152,4,4152,[ 79 427 515 318 588],807,5,18801,4.5270888514326995,40.0,0.0
44153,4,4153,[ 79 427 515 318 588],716,5,18806,4.527202696196437,40.0,0.0
44154,4,4154,[ 79 427 515 318 588],716,5,18811,4.527316486161252,40.0,0.0
44155,4,4155,[ 79 427 515 318 588],716,5,18816,4.527430221366699,40.0,0.0
44156,4,4156,[ 79 427 515 318 588],716,5,18821,4.527543901852297,40.0,0.0
44157,4,4157,[ 11 161 173  69  50],280,3,18824,4.527176527176527,0.0,20.0
44158,4,4158,[ 79 427 515 318 588],807,5,18829,4.527290213993749,40.0,0.0
44159,4,4159,[ 79 427 515 318 588],807,5,18834,4.527403846153846,40.0,0.0
44160,4,4160,[ 79 427 515 318 588],18,5,18839,4.527517423696227,40.0,0.0
44161,4,4161,[ 79 427 515 318 588],716,5,18844,4.52763094666026,40.0,0.0
44162,4,4162,[ 25   1 385  79 143],577,4,18848,4.527504203699255,0.0,0.0
44163,4,4163,[ 79 427 515 318 588],807,5,18853,4.5276176753122,40.0,0.0
44164,4,4164,[ 79 427 515 318 588],807,5,18858,4.527731092436975,40.0,0.0
44165,4,4165,[ 79 427 515 318 588],18,5,18863,4.527844455112818,40.0,0.0
44166,4,4166,[ 79 427 515 318 588],807,5,18868,4.52795776337893,40.0,0.0
44167,4,4167,[196 182 194 245 318],796,4,18872,4.527831094049904,20.0,0.0
44168,4,4168,[ 79 427 515 318 588],807,5,18877,4.527944351163349,40.0,0.0
44169,4,4169,[215 111 121 135 161],457,4,18881,4.5278177458033575,0.0,0.0
44170,4,4170,[ 79 427 515 318 588],807,5,18886,4.527930951810117,40.0,0.0
44171,4,4171,[183 175  70 294 568],655,1,18887,4.527085330776606,0.0,0.0
44172,4,4172,[ 79 427 515 318 588],18,5,18892,4.527198658039779,40.0,0.0
44173,4,4173,[237 100 175  64 301],655,1,18893,4.526353617632966,20.0,20.0
44174,4,4174,[ 79 427 515 318 588],807,5,18898,4.526467065868263,40.0,0.0
44175,4,4175,[ 79 427 515 318 588],18,5,18903,4.526580459770115,40.0,0.0
44176,4,4176,[302 435 258  79  28],655,2,18905,4.52597558056021,0.0,0.0
44177,4,4177,[427   4 215 313  97],796,4,18909,4.525849688846338,20.0,0.0
44178,4,4178,[328 228 385 132 435],450,5,18914,4.525963149078727,0.0,0.0
44179,4,4179,[ 79 427 515 318 588],18,5,18919,4.5260765550239235,40.0,0.0
44180,4,4180,[268 153 216 435  70],655,1,18920,4.52523319779957,0.0,0.0
44181,4,4181,[ 79 427 515 318 588],716,5,18925,4.525346724055476,40.0,0.0
44182,4,4182,[ 79 427 515 318 588],18,5,18930,4.525460196031556,40.0,0.0
44183,4,4183,[276  82 294 273 100],655,2,18932,4.524856596558317,0.0,20.0
44184,4,4184,[ 79 427 515 318 588],807,5,18937,4.524970131421744,40.0,0.0
44185,4,4185,[286 187 195  98 196],18,3,18940,4.524605828953655,0.0,20.0
44186,4,4186,[ 50 197  22 385 181],330,5,18945,4.524719369476952,0.0,20.0
44187,4,4187,[ 79 427 515 318 588],807,5,18950,4.524832855778414,40.0,0.0
44188,4,4188,[ 79 427 515 318 588],716,5,18955,4.5249462878968725,40.0,0.0
44189,4,4189,[ 79 427 515 318 588],716,5,18960,4.5250596658711215,40.0,0.0
44190,4,4190,[ 79 427 515 318 588],716,5,18965,4.525172989739919,40.0,0.0
44191,4,4191,[  1 318 202 125 742],457,5,18970,4.525286259541985,20.0,0.0
44192,4,4192,[176 196   7  15 174],450,4,18974,4.525160982590031,0.0,0.0
44193,4,4193,[ 79 427 515 318 588],807,5,18979,4.525274201239866,40.0,0.0
44194,4,4194,[ 79 427 515 318 588],18,5,18984,4.5253873659118,40.0,0.0
44195,4,4195,[258 742 300  70 385],504,4,18988,4.525262154432793,0.0,0.0
44196,4,4196,[  7 238   8 257 742],655,0,18988,4.524183940910174,0.0,0.0
44197,4,4197,[ 79 427 515 318 588],18,5,18993,4.524297284421153,40.0,0.0
44198,4,4198,[ 79 258  95 568 322],344,3,18996,4.523934270064301,0.0,0.0
44199,4,4199,[ 79 427 515 318 588],716,5,19001,4.524047619047619,40.0,0.0
44200,4,4200,[588 471 655 405 357],786,5,19006,4.524160914068079,0.0,0.0
44201,4,4201,[183 423 125 151  64],151,4,19010,4.524036173250833,20.0,0.0
44202,4,4202,[125 183 197  15 111],457,4,19014,4.523911491791577,0.0,0.0
44203,4,4203,[ 79 427 515 318 588],18,5,19019,4.524024738344434,40.0,0.0
44204,4,4204,[234 153 117 215  15],796,4,19023,4.523900118906064,0.0,0.0
44205,4,4205,[ 79 427 515 318 588],716,5,19028,4.524013314312886,40.0,0.0
44206,4,4206,[ 79 427 515 318 588],18,5,19033,4.524126455906822,40.0,0.0
44207,4,4207,[ 79 427 515 318 588],807,5,19038,4.524239543726236,40.0,0.0
44208,4,4208,[ 97 180 423 144 235],450,4,19042,4.524114991684486,0.0,0.0
44209,4,4209,[172 179 268 211  69],655,2,19044,4.523515439429929,0.0,0.0
44210,4,4210,[ 79 427 515 318 588],18,5,19049,4.5236285917834245,40.0,0.0
44211,4,4211,[ 98 132 222 322   7],151,4,19053,4.523504273504273,0.0,0.0
44212,4,4212,[ 79 427 515 318 588],18,5,19058,4.52361737479231,40.0,0.0
44213,4,4213,[ 79 427 515 318 588],807,5,19063,4.523730422401519,40.0,0.0
44214,4,4214,[ 79 427 515 318 588],18,5,19068,4.523843416370107,40.0,0.0
44215,4,4215,[ 79 427 515 318 588],18,5,19073,4.523956356736243,40.0,0.0
44216,4,4216,[ 79 427 515 318 588],807,5,19078,4.52406924353806,40.0,0.0
44217,4,4217,[183 328 111 174 268],655,1,19079,4.523233760075866,0.0,0.0
44218,4,4218,[ 79 427 515 318 588],18,5,19084,4.52334676463617,40.0,0.0
44219,4,4219,[238 546 143 121 276],593,3,19087,4.5229857819905215,0.0,0.0
44220,4,4220,[ 79 427 515 318 588],18,5,19092,4.523098791755508,40.0,0.0
44221,4,4221,[ 79 427 515 318 588],807,5,19097,4.523211747986736,40.0,0.0
44222,4,4222,[ 79 427 515 318 588],716,5,19102,4.523324650722236,40.0,0.0
44223,4,4223,[ 79 427 515 318 588],18,5,19107,4.5234375,40.0,0.0
44224,4,4224,[222 475   7 202 210],655,0,19107,4.522366863905326,0.0,0.0
44225,4,4225,[265 403 301 655 238],450,5,19112,4.522479886417416,0.0,0.0
44226,4,4226,[655 435 210 265 132],655,0,19112,4.521409983439792,0.0,0.0
44227,4,4227,[ 79 427 515 318 588],807,5,19117,4.521523178807947,40.0,0.0
44228,4,4228,[ 79 427 515 318 588],18,5,19122,4.521636320643178,40.0,0.0
44229,4,4229,[ 79 427 515 318 588],18,5,19127,4.521749408983451,40.0,0.0
44230,4,4230,[ 79 427 515 318 588],18,5,19132,4.5218624438666986,40.0,0.0
44231,4,4231,[181 288  70 182  12],457,5,19137,4.521975425330813,0.0,0.0
44232,4,4232,[ 79 427 515 318 588],716,5,19142,4.522088353413655,40.0,0.0
44233,4,4233,[ 79 427 515 318 588],716,5,19147,4.522201228153047,40.0,0.0
44234,4,4234,[ 79 427 515 318 588],807,5,19152,4.522314049586777,40.0,0.0
44235,4,4235,[ 79 427 515 318 588],716,5,19157,4.522426817752597,40.0,0.0
44236,4,4236,[ 79 427 515 318 588],716,5,19162,4.5225395326882225,40.0,0.0
44237,4,4237,[ 79 427 515 318 588],18,5,19167,4.522652194431336,40.0,0.0
44238,4,4238,[ 79 427 515 318 588],716,5,19172,4.52276480301958,40.0,0.0
44239,4,4239,[ 79 427 515 318 588],716,5,19177,4.522877358490566,40.0,0.0
44240,4,4240,[ 79 427 515 318 588],807,5,19182,4.522989860881867,40.0,0.0
44241,4,4241,[100 475 187 328  89],655,2,19184,4.522395096652523,0.0,20.0
44242,4,4242,[ 79 427 515 318 588],716,5,19189,4.522507659674758,40.0,0.0
44243,4,4243,[ 79 427 515 318 588],807,5,19194,4.5226201696512724,40.0,0.0
44244,4,4244,[ 79 427 515 318 588],18,5,19199,4.522732626619552,40.0,0.0
44245,4,4245,[ 79 427 515 318 588],807,5,19204,4.522845030617051,40.0,0.0
44246,4,4246,[ 79 427 515 318 588],18,5,19209,4.522957381681187,40.0,0.0
44247,4,4247,[172 143 286 179  79],655,4,19213,4.522834274952919,0.0,20.0
44248,4,4248,[ 79 427 515 318 588],807,5,19218,4.522946575664863,40.0,0.0
44249,4,4249,[ 79 427 515 318 588],807,5,19223,4.523058823529412,40.0,0.0
44250,4,4250,[200  15  88 172 210],18,2,19225,4.522465302281816,0.0,0.0
44251,4,4251,[ 79 427 515 318 588],807,5,19230,4.522577610536218,40.0,0.0
44252,4,4252,[176 100  88  97 294],504,2,19232,4.52198448154244,0.0,20.0
44253,4,4253,[ 79 427 515 318 588],716,5,19237,4.522096850023507,40.0,0.0
44254,4,4254,[ 79 427 515 318 588],807,5,19242,4.522209165687427,40.0,0.0
44255,4,4255,[ 79 427 515 318 588],18,5,19247,4.522321428571429,40.0,0.0
44256,4,4256,[ 79 427 515 318 588],807,5,19252,4.522433638712709,40.0,0.0
44257,4,4257,[ 79 427 515 318 588],807,5,19257,4.522545796148426,40.0,0.0
44258,4,4258,[ 79 427 515 318 588],18,5,19262,4.522657900915708,40.0,0.0
44259,4,4259,[ 79 427 515 318 588],18,5,19267,4.522769953051643,40.0,0.0
44260,4,4260,[ 79 427 515 318 588],807,5,19272,4.522881952593288,40.0,0.0
44261,4,4261,[ 79 427 515 318 588],716,5,19277,4.5229938995776635,40.0,0.0
44262,4,4262,[ 12  50 294  56 313],577,4,19281,4.522871217452498,0.0,20.0
44263,4,4263,[238  98 234 211 200],504,3,19284,4.522514071294559,0.0,0.0
44264,4,4264,[ 79 427 515 318 588],18,5,19289,4.5226260257913244,40.0,0.0
44265,4,4265,[ 79 427 515 318 588],807,5,19294,4.522737927801219,40.0,0.0
44266,4,4266,[ 79 427 515 318 588],716,5,19299,4.522849777361143,40.0,0.0
44267,4,4267,[ 79 427 515 318 588],716,5,19304,4.522961574507966,40.0,0.0
44268,4,4268,[183 194 275 132  50],457,5,19309,4.523073319278519,0.0,40.0
44269,4,4269,[ 79 427 515 318 588],18,5,19314,4.523185011709602,40.0,0.0
44270,4,4270,[ 79 427 515 318 588],18,5,19319,4.523296651837977,40.0,0.0
44271,4,4271,[ 79 427 515 318 588],807,5,19324,4.523408239700374,40.0,0.0
44272,4,4272,[117 196 176  12 234],577,4,19328,4.523285747718231,0.0,0.0
44273,4,4273,[ 82   4 273 313 182],655,3,19331,4.522929340196537,0.0,0.0
44274,4,4274,[185  95 196 175 515],716,4,19335,4.52280701754386,0.0,0.0
44275,4,4275,[ 79 427 515 318 588],807,5,19340,4.522918615528531,40.0,0.0
44276,4,4276,[ 79 427 515 318 588],807,5,19345,4.523030161328034,40.0,0.0
44277,4,4277,[ 79 427 515 318 588],807,5,19350,4.5231416549789625,40.0,0.0
44278,4,4278,[ 79 427 515 318 588],807,5,19355,4.523253096517878,40.0,0.0
44279,4,4279,[ 79 427 515 318 588],807,5,19360,4.5233644859813085,40.0,0.0
44280,4,4280,[234 125 173 288  98],292,3,19363,4.523008642840458,0.0,0.0
44281,4,4281,[ 79 427 515 318 588],807,5,19368,4.523120037365717,40.0,0.0
44282,4,4282,[ 79 427 515 318 588],807,5,19373,4.52323137987392,40.0,0.0
44283,4,4283,[ 79 427 515 318 588],716,5,19378,4.523342670401494,40.0,0.0
44284,4,4284,[ 79 427 515 318 588],716,5,19383,4.5234539089848305,40.0,0.0
44285,4,4285,[ 79 427 515 318 588],807,5,19388,4.523565095660289,40.0,0.0
44286,4,4286,[ 79 427 515 318 588],18,5,19393,4.523676230464194,40.0,0.0
44287,4,4287,[ 79 427 515 318 588],807,5,19398,4.523787313432836,40.0,0.0
44288,4,4288,[ 79 427 515 318 588],807,5,19403,4.523898344602472,40.0,0.0
44289,4,4289,[ 79 427 515 318 588],807,5,19408,4.524009324009324,40.0,0.0
44290,4,4290,[288 127 161   7 546],693,2,19410,4.52342111395945,0.0,20.0
44291,4,4291,[ 88  71 195  56 357],504,3,19413,4.523066169617894,0.0,0.0
44292,4,4292,[ 79 427 515 318 588],807,5,19418,4.52317726531563,40.0,0.0
44293,4,4293,[144 161  82 204 282],280,1,19419,4.522356776897997,0.0,0.0
44294,4,4294,[ 79 427 515 318 588],18,5,19424,4.522467986030268,40.0,0.0
44295,4,4295,[ 79 427 515 318 588],716,5,19429,4.5225791433891995,40.0,0.0
44296,4,4296,[ 79 427 515 318 588],716,5,19434,4.522690249010938,40.0,0.0
44297,4,4297,[ 79 427 515 318 588],18,5,19439,4.522801302931596,40.0,0.0
44298,4,4298,[ 79 427 515 318 588],716,5,19444,4.522912305187253,40.0,0.0
44299,4,4299,[ 79 427 515 318 588],807,5,19449,4.523023255813953,40.0,0.0
44300,4,4300,[187 282   1 471 302],450,5,19454,4.5231341548477095,0.0,0.0
44301,4,4301,[ 79 427 515 318 588],18,5,19459,4.5232450023245,40.0,0.0
44302,4,4302,[234 161 597 302 187],269,1,19460,4.522426214269115,0.0,0.0
44303,4,4303,[132 204 235   7 234],23,2,19462,4.521840148698884,0.0,0.0
44304,4,4304,[ 79 427 515 318 588],807,5,19467,4.521951219512195,40.0,0.0
44305,4,4305,[ 79 427 515 318 588],716,5,19472,4.5220622387366465,40.0,0.0
44306,4,4306,[385 357 117 118 215],457,5,19477,4.522173206408173,0.0,0.0
44307,4,4307,[ 79 427 515 318 588],18,5,19482,4.522284122562674,40.0,0.0
44308,4,4308,[ 71 222 286 471 216],786,5,19487,4.522394987236018,0.0,20.0
44309,4,4309,[257 588 151 603  28],716,5,19492,4.522505800464037,20.0,0.0
44310,4,4310,[427  98  97 187 204],503,4,19496,4.522384597541174,20.0,0.0
44311,4,4311,[191 174 135 475   7],629,3,19499,4.522031539888682,0.0,0.0
44312,4,4312,[269 603 151 143 322],450,5,19504,4.522142360306051,20.0,0.0
44313,4,4313,[ 79 427 515 318 588],18,5,19509,4.522253129346314,40.0,0.0
44314,4,4314,[ 79 427 515 318 588],716,5,19514,4.522363847045191,40.0,0.0
44315,4,4315,[258  11 117 496 176],450,5,19519,4.522474513438369,20.0,0.0
44316,4,4316,[ 79 427 515 318 588],716,5,19524,4.522585128561501,40.0,0.0
44317,4,4317,[ 79 427 515 318 588],716,5,19529,4.522695692450209,40.0,0.0
44318,4,4318,[ 79 427 515 318 588],716,5,19534,4.522806205140078,40.0,0.0
44319,4,4319,[ 95 111   1 546 222],786,5,19539,4.522916666666666,0.0,0.0
44320,4,4320,[ 79 427 515 318 588],807,5,19544,4.523027077065494,40.0,0.0
44321,4,4321,[  1 153 496 111 151],796,4,19548,4.52290606200833,20.0,0.0
44322,4,4322,[ 79 427 515 318 588],18,5,19553,4.523016423779783,40.0,0.0
44323,4,4323,[ 79 427 515 318 588],18,5,19558,4.523126734505088,40.0,0.0
44324,4,4324,[ 79 427 515 318 588],716,5,19563,4.523236994219653,40.0,0.0
44325,4,4325,[ 79 427 515 318 588],716,5,19568,4.5233472029588535,40.0,0.0
44326,4,4326,[ 79 427 515 318 588],18,5,19573,4.523457360758031,40.0,0.0
44327,4,4327,[ 79 427 515 318 588],807,5,19578,4.523567467652495,40.0,0.0
44328,4,4328,[ 95   4 655  15  79],796,4,19582,4.523446523446523,0.0,0.0
44329,4,4329,[ 79 427 515 318 588],807,5,19587,4.523556581986143,40.0,0.0
44330,4,4330,[ 79 427 515 318 588],716,5,19592,4.523666589702147,40.0,0.0
44331,4,4331,[ 79 427 515 318 588],716,5,19597,4.523776546629732,40.0,0.0
44332,4,4332,[176 678 357 174 288],504,4,19601,4.523655665820447,0.0,0.0
44333,4,4333,[215 176 405 678  88],280,0,19601,4.522611905860637,0.0,0.0
44334,4,4334,[ 79 427 515 318 588],807,5,19606,4.522722029988466,40.0,0.0
44335,4,4335,[ 79 427 515 318 588],807,5,19611,4.522832103321033,40.0,0.0
44336,4,4336,[ 79 427 515 318 588],716,5,19616,4.522942125893475,40.0,0.0
44337,4,4337,[234 118 168 176 135],292,4,19620,4.522821576763485,0.0,0.0
44338,4,4338,[ 79 427 515 318 588],18,5,19625,4.522931551048629,40.0,0.0
44339,4,4339,[ 79 427 515 318 588],716,5,19630,4.523041474654378,40.0,0.0
44340,4,4340,[  1   8 655 204 194],796,3,19633,4.52269062428012,0.0,0.0
44341,4,4341,[ 79 427 515 318 588],807,5,19638,4.522800552740673,40.0,0.0
44342,4,4342,[ 79 427 515 318 588],716,5,19643,4.522910430577942,40.0,0.0
44343,4,4343,[ 79 427 515 318 588],807,5,19648,4.523020257826888,40.0,0.0
44344,4,4344,[ 79 427 515 318 588],807,5,19653,4.523130034522439,40.0,0.0
44345,4,4345,[ 79 427 515 318 588],807,5,19658,4.523239760699494,40.0,0.0
44346,4,4346,[597 180 258  15 117],796,4,19662,4.5231193926846105,0.0,0.0
44347,4,4347,[ 79 427 515 318 588],807,5,19667,4.523229070837166,40.0,0.0
44348,4,4348,[ 79 427 515 318 588],716,5,19672,4.523338698551391,40.0,0.0
44349,4,4349,[ 79 427 515 318 588],716,5,19677,4.523448275862069,40.0,0.0
44350,4,4350,[ 79 427 515 318 588],716,5,19682,4.523557802803953,40.0,0.0
44351,4,4351,[ 50 181 286 222 118],151,4,19686,4.5234375,0.0,40.0
44352,4,4352,[ 79 427 515 318 588],807,5,19691,4.523546979094877,40.0,0.0
44353,4,4353,[237 186 427 210  89],296,3,19694,4.523197060174552,20.0,0.0
44354,4,4354,[ 79 427 515 318 588],716,5,19699,4.523306544202066,40.0,0.0
44355,4,4355,[435 127 286 235 385],450,4,19703,4.523186409550046,0.0,40.0
44356,4,4356,[ 97 135  98 117 200],457,5,19708,4.523295845765435,0.0,0.0
44357,4,4357,[211  88 153 265 273],236,0,19708,4.522257916475447,0.0,0.0
44358,4,4358,[268 183  56 187 132],655,2,19710,4.521679284239505,0.0,0.0
44359,4,4359,[ 96 237 328 655 187],655,1,19711,4.520871559633028,0.0,0.0
44360,4,4360,[172 385  50 471 275],401,2,19713,4.520293510662692,0.0,40.0
44361,4,4361,[ 79 427 515 318 588],807,5,19718,4.520403484640074,40.0,0.0
44362,4,4362,[ 79 427 515 318 588],716,5,19723,4.520513408205363,40.0,0.0
44363,4,4363,[ 79 427 515 318 588],807,5,19728,4.520623281393218,40.0,0.0
44364,4,4364,[294 216 111 197  70],450,5,19733,4.520733104238259,0.0,0.0
44365,4,4365,[ 79 427 515 318 588],807,5,19738,4.52084287677508,40.0,0.0
44366,4,4366,[ 79 427 515 318 588],18,5,19743,4.5209525990382415,40.0,0.0
44367,4,4367,[ 79 427 515 318 588],807,5,19748,4.521062271062271,40.0,0.0
44368,4,4368,[ 79 427 515 318 588],807,5,19753,4.521171892881666,40.0,0.0
44369,4,4369,[ 79 427 515 318 588],18,5,19758,4.521281464530892,40.0,0.0
44370,4,4370,[ 79 427 515 318 588],807,5,19763,4.521390986044383,40.0,0.0
44371,4,4371,[ 79 427 515 318 588],807,5,19768,4.521500457456542,40.0,0.0
44372,4,4372,[294  56 237 211 197],655,0,19768,4.520466498970958,0.0,0.0
44373,4,4373,[ 79 427 515 318 588],807,5,19773,4.520576131687243,40.0,0.0
44374,4,4374,[385 186  28 187  69],504,3,19776,4.5202285714285715,0.0,0.0
44375,4,4375,[597  64  88 173 161],269,1,19777,4.519424131627057,20.0,0.0
44376,4,4376,[195 118  69 282  28],796,4,19781,4.519305460360978,0.0,0.0
44377,4,4377,[ 79 427 515 318 588],716,5,19786,4.519415258108725,40.0,0.0
44378,4,4378,[196 471 234   7 222],693,1,19787,4.518611555149578,0.0,0.0
44379,4,4379,[ 79 427 515 318 588],716,5,19792,4.518721461187215,40.0,0.0
44380,4,4380,[ 79 427 515 318 588],716,5,19797,4.518831317050902,40.0,0.0
44381,4,4381,[ 79 427 515 318 588],807,5,19802,4.518941122774988,40.0,0.0
44382,4,4382,[ 79 427 515 318 588],18,5,19807,4.519050878393794,40.0,0.0
44383,4,4383,[ 79 427 515 318 588],807,5,19812,4.519160583941606,40.0,0.0
44384,4,4384,[ 79 427 515 318 588],18,5,19817,4.51927023945268,40.0,0.0
44385,4,4385,[ 79 427 515 318 588],807,5,19822,4.51937984496124,40.0,0.0
44386,4,4386,[ 79 427 515 318 588],18,5,19827,4.519489400501482,40.0,0.0
44387,4,4387,[ 79 427 515 318 588],807,5,19832,4.519598906107566,40.0,0.0
44388,4,4388,[127  82  98 588 179],457,5,19837,4.519708361813625,0.0,20.0
44389,4,4389,[228 245  71  56 117],796,4,19841,4.5195899772209565,0.0,0.0
44390,4,4390,[ 79 427 515 318 588],807,5,19846,4.519699385105898,40.0,0.0
44391,4,4391,[ 79 427 515 318 588],716,5,19851,4.519808743169399,40.0,0.0
44392,4,4392,[ 79 427 515 318 588],716,5,19856,4.519918051445481,40.0,0.0
44393,4,4393,[568 187   4 302  64],655,3,19859,4.519572143832499,20.0,0.0
44394,4,4394,[ 79 427 515 318 588],807,5,19864,4.519681456200227,40.0,0.0
44395,4,4395,[228 245 182 173 197],450,5,19869,4.519790718835305,0.0,0.0
44396,4,4396,[ 79 427 515 318 588],807,5,19874,4.519899931771662,40.0,0.0
44397,4,4397,[ 79 427 515 318 588],18,5,19879,4.520009095043202,40.0,0.0
44398,4,4398,[ 79 427 515 318 588],807,5,19884,4.520118208683792,40.0,0.0
44399,4,4399,[ 79 742 125 568 655],450,5,19889,4.520227272727273,0.0,0.0
44400,4,4400,[748 496  98  56  82],280,3,19892,4.519881845035219,20.0,0.0
44401,4,4401,[ 22 546 186 176  28],457,4,19896,4.51976374375284,0.0,0.0
44402,4,4402,[ 79 427 515 318 588],807,5,19901,4.519872813990461,40.0,0.0
44403,4,4403,[ 79 427 515 318 588],18,5,19906,4.519981834695731,40.0,0.0
44404,4,4404,[ 79 427 515 318 588],807,5,19911,4.520090805902384,40.0,0.0
44405,4,4405,[ 79 427 515 318 588],807,5,19916,4.520199727644122,40.0,0.0
44406,4,4406,[282   4 174 405 234],280,0,19916,4.519174041297935,0.0,0.0
44407,4,4407,[ 79 427 515 318 588],807,5,19921,4.5192831215970966,40.0,0.0
44408,4,4408,[ 79 427 515 318 588],716,5,19926,4.519392152415514,40.0,0.0
44409,4,4409,[ 79 427 515 318 588],807,5,19931,4.519501133786848,40.0,0.0
44410,4,4410,[496 180 333  15 294],796,3,19934,4.519156653819995,20.0,0.0
44411,4,4411,[302 748 153  11  70],450,5,19939,4.519265639165911,0.0,0.0
44412,4,4412,[132 197 269 215 603],338,3,19942,4.5189213686834355,20.0,0.0
44413,4,4413,[ 79 427 515 318 588],807,5,19947,4.519030357951971,40.0,0.0
44414,4,4414,[ 79 427 515 318 588],716,5,19952,4.519139297848245,40.0,0.0
44415,4,4415,[ 79 427 515 318 588],18,5,19957,4.519248188405797,40.0,0.0
44416,4,4416,[ 79 427 515 318 588],716,5,19962,4.519357029658139,40.0,0.0
44417,4,4417,[ 96  88 313 546 318],693,3,19965,4.519013128112268,20.0,0.0
44418,4,4418,[ 79 427 515 318 588],716,5,19970,4.519121973297126,40.0,0.0
44419,4,4419,[ 79 427 515 318 588],18,5,19975,4.519230769230769,40.0,0.0
44420,4,4420,[ 79 427 515 318 588],18,5,19980,4.519339515946618,40.0,0.0
44421,4,4421,[ 79 427 515 318 588],716,5,19985,4.519448213478064,40.0,0.0
44422,4,4422,[300  96 294 204 228],796,4,19989,4.51933077096993,0.0,0.0
44423,4,4423,[ 79 427 515 318 588],18,5,19994,4.519439421338156,40.0,0.0
44424,4,4424,[ 79 427 515 318 588],18,5,19999,4.51954802259887,40.0,0.0
44425,4,4425,[ 79 427 515 318 588],18,5,20004,4.519656574785359,40.0,0.0
44426,4,4426,[111 174 183 323 265],796,4,20008,4.519539191325954,0.0,0.0
44427,4,4427,[ 79 427 515 318 588],807,5,20013,4.519647696476965,40.0,0.0
44428,4,4428,[ 79 427 515 318 588],716,5,20018,4.51975615263039,40.0,0.0
44429,4,4429,[269 328 196 182 195],629,3,20021,4.51941309255079,0.0,0.0
44430,4,4430,[ 79 427 515 318 588],716,5,20026,4.519521552696908,40.0,0.0
44431,4,4431,[187 546 588 174 135],450,4,20030,4.519404332129964,0.0,0.0
44432,4,4432,[ 79 427 515 318 588],18,5,20035,4.519512745319197,40.0,0.0
44433,4,4433,[ 79 427 515 318 588],807,5,20040,4.519621109607578,40.0,0.0
44434,4,4434,[ 79 427 515 318 588],18,5,20045,4.519729425028185,40.0,0.0
44435,4,4435,[179 181 153 318 183],655,3,20048,4.5193868349864745,20.0,0.0
44436,4,4436,[ 79 427 515 318 588],18,5,20053,4.519495154383592,40.0,0.0
44437,4,4437,[179 153 173 172 275],450,5,20058,4.519603424966201,0.0,20.0
44438,4,4438,[ 79 427 515 318 588],716,5,20063,4.5197116467672895,40.0,0.0
44439,4,4439,[568  98 181  28 200],655,2,20065,4.5191441441441444,0.0,0.0
44440,4,4440,[ 79 427 515 318 588],18,5,20070,4.519252420625985,40.0,0.0
44441,4,4441,[ 79 427 515 318 588],18,5,20075,4.519360648356596,40.0,0.0
44442,4,4442,[ 79 427 515 318 588],18,5,20080,4.519468827368895,40.0,0.0
44443,4,4443,[ 79 427 515 318 588],716,5,20085,4.51957695769577,40.0,0.0
44444,4,4444,[ 79 427 515 318 588],807,5,20090,4.519685039370079,40.0,0.0
44445,4,4445,[ 79 427 515 318 588],18,5,20095,4.519793072424651,40.0,0.0
44446,4,4446,[194  71 273 187 183],236,0,20095,4.518776703395548,0.0,0.0
44447,4,4447,[286 742 273 483 471],450,3,20098,4.518435251798561,0.0,20.0
44448,4,4448,[ 79 427 515 318 588],18,5,20103,4.518543492919758,40.0,0.0
44449,4,4449,[655  28 238 180 237],504,3,20106,4.518202247191011,0.0,0.0
44450,4,4450,[ 79 427 515 318 588],716,5,20111,4.5183104920242645,40.0,0.0
44451,4,4451,[ 79 427 515 318 588],807,5,20116,4.518418688230009,40.0,0.0
44452,4,4452,[ 79 427 515 318 588],807,5,20121,4.518526835841006,40.0,0.0
44453,4,4453,[ 79 427 515 318 588],807,5,20126,4.518634934889986,40.0,0.0
44454,4,4454,[ 79 427 515 318 588],807,5,20131,4.518742985409652,40.0,0.0
44455,4,4455,[118  88 173 172 210],796,4,20135,4.518626570915619,0.0,0.0
44456,4,4456,[ 79 427 515 318 588],18,5,20140,4.518734574826116,40.0,0.0
44457,4,4457,[111 215  95 496 153],796,5,20145,4.518842530282638,20.0,0.0
44458,4,4458,[301 318  71 151 195],535,5,20150,4.518950437317784,20.0,0.0
44459,4,4459,[ 79 427 515 318 588],807,5,20155,4.5190582959641254,40.0,0.0
44460,4,4460,[ 79 427 515 318 588],18,5,20160,4.519166106254203,40.0,0.0
44461,4,4461,[216   9 258 427 215],878,3,20163,4.518825638727028,20.0,0.0
44462,4,4462,[ 79 427 515 318 588],807,5,20168,4.518933452834417,40.0,0.0
44463,4,4463,[ 79 427 515 318 588],18,5,20173,4.519041218637993,40.0,0.0
44464,4,4464,[186 483 313 143 603],655,4,20177,4.518924972004479,20.0,0.0
44465,4,4465,[ 79 427 515 318 588],807,5,20182,4.519032691446484,40.0,0.0
44466,4,4466,[187 181 211 423 265],716,4,20186,4.518916498768749,0.0,0.0
44467,4,4467,[ 79 427 515 318 588],716,5,20191,4.519024171888988,40.0,0.0
44468,4,4468,[ 79 427 515 318 588],716,5,20196,4.519131796822555,40.0,0.0
44469,4,4469,[ 79 427 515 318 588],716,5,20201,4.519239373601789,40.0,0.0
44470,4,4470,[ 79 427 515 318 588],716,5,20206,4.519346902259002,40.0,0.0
44471,4,4471,[ 79 427 515 318 588],716,5,20211,4.519454382826476,40.0,0.0
44472,4,4472,[216 211 186 301  88],655,1,20212,4.518667560921082,0.0,0.0
44473,4,4473,[742  79 173   4 496],796,4,20216,4.51855163164953,20.0,0.0
44474,4,4474,[471  96 289 144 427],655,1,20217,4.5177653631284915,20.0,0.0
44475,4,4475,[ 79 427 515 318 588],716,5,20222,4.517873100983021,40.0,0.0
44476,4,4476,[ 79 427 515 318 588],807,5,20227,4.517980790708063,40.0,0.0
44477,4,4477,[ 79 427 515 318 588],716,5,20232,4.5180884323358645,40.0,0.0
44478,4,4478,[ 79 427 515 318 588],716,5,20237,4.5181960258986384,40.0,0.0
44479,4,4479,[ 79 427 515 318 588],18,5,20242,4.5183035714285715,40.0,0.0
44480,4,4480,[ 79 427 515 318 588],18,5,20247,4.518411068957822,40.0,0.0
44481,4,4481,[ 79 427 515 318 588],807,5,20252,4.518518518518518,40.0,0.0
44482,4,4482,[257 216 282 515 471],716,3,20255,4.518179790318983,0.0,0.0
44483,4,4483,[ 79 427 515 318 588],18,5,20260,4.51828724353256,40.0,0.0
44484,4,4484,[195 427  98  12 117],72,5,20265,4.518394648829432,20.0,0.0
44485,4,4485,[ 79 427 515 318 588],807,5,20270,4.518502006241641,40.0,0.0
44486,4,4486,[ 79 427 515 318 588],18,5,20275,4.5186093158012035,40.0,0.0
44487,4,4487,[ 79 427 515 318 588],18,5,20280,4.518716577540107,40.0,0.0
44488,4,4488,[ 79 427 515 318 588],18,5,20285,4.51882379149031,40.0,0.0
44489,4,4489,[ 79 427 515 318 588],716,5,20290,4.518930957683741,40.0,0.0
44490,4,4490,[ 79 427 515 318 588],807,5,20295,4.519038076152305,40.0,0.0
44491,4,4491,[ 79 427 515 318 588],18,5,20300,4.519145146927872,40.0,0.0
44492,4,4492,[ 79 427 515 318 588],807,5,20305,4.519252170042288,40.0,0.0
44493,4,4493,[ 79 427 515 318 588],18,5,20310,4.519359145527369,40.0,0.0
44494,4,4494,[ 79 427 515 318 588],807,5,20315,4.519466073414906,40.0,0.0
44495,4,4495,[ 79 427 515 318 588],716,5,20320,4.519572953736655,40.0,0.0
44496,4,4496,[ 79 427 515 318 588],716,5,20325,4.51967978652435,40.0,0.0
44497,4,4497,[ 79 427 515 318 588],18,5,20330,4.519786571809693,40.0,0.0
44498,4,4498,[ 79 427 515 318 588],807,5,20335,4.5198933096243605,40.0,0.0
44499,4,4499,[ 79 427 515 318 588],807,5,20340,4.52,40.0,0.0
44500,4,4500,[423   1 222 435 181],450,4,20344,4.519884470117751,0.0,0.0
44501,4,4501,[182  95  50  89  79],18,4,20348,4.519768991559307,0.0,20.0
44502,4,4502,[ 79 427 515 318 588],716,5,20353,4.519875638463247,40.0,0.0
44503,4,4503,[ 79 427 515 318 588],716,5,20358,4.519982238010657,40.0,0.0
44504,4,4504,[ 79 427 515 318 588],807,5,20363,4.520088790233074,40.0,0.0
44505,4,4505,[ 79 427 515 318 588],807,5,20368,4.520195295162006,40.0,0.0
44506,4,4506,[ 79 427 515 318 588],807,5,20373,4.520301752828932,40.0,0.0
44507,4,4507,[ 79 427 515 318 588],18,5,20378,4.520408163265306,40.0,0.0
44508,4,4508,[ 82  69 282 483 385],655,1,20379,4.519627411842981,0.0,0.0
44509,4,4509,[289 237 258 427 194],296,4,20383,4.519512195121951,20.0,0.0
44510,4,4510,[ 79 427 515 318 588],716,5,20388,4.519618709820439,40.0,0.0
44511,4,4511,[ 79 427 515 318 588],807,5,20393,4.519725177304965,40.0,0.0
44512,4,4512,[ 79 427 515 318 588],807,5,20398,4.519831597606913,40.0,0.0
44513,4,4513,[ 79 427 515 318 588],716,5,20403,4.519937970757643,40.0,0.0
44514,4,4514,[ 79 427 515 318 588],716,5,20408,4.520044296788483,40.0,0.0
44515,4,4515,[ 79 427 515 318 588],807,5,20413,4.520150575730735,40.0,0.0
44516,4,4516,[216 423  82  15 286],174,3,20416,4.519814035864512,0.0,20.0
44517,4,4517,[357 288 176 655  88],450,4,20420,4.519698981850376,0.0,0.0
44518,4,4518,[ 79 427 515 318 588],18,5,20425,4.519805266651914,40.0,0.0
44519,4,4519,[238   1 183 135 268],655,2,20427,4.519247787610619,0.0,0.0
44520,4,4520,[ 79 427 515 318 588],18,5,20432,4.519354125193542,40.0,0.0
44521,4,4521,[ 88  28 216 508 187],693,1,20433,4.518575851393189,0.0,0.0
44522,4,4522,[181 405  28   8 161],457,5,20438,4.5186822905151445,0.0,0.0
44523,4,4523,[ 79 427 515 318 588],18,5,20443,4.5187886825817865,40.0,0.0
44524,4,4524,[ 12 125 228  64 174],450,5,20448,4.51889502762431,20.0,0.0
44525,4,4525,[ 79 427 515 318 588],807,5,20453,4.519001325673885,40.0,0.0
44526,4,4526,[ 79 427 515 318 588],807,5,20458,4.519107576761653,40.0,0.0
44527,4,4527,[ 79 427 515 318 588],716,5,20463,4.519213780918728,40.0,0.0
44528,4,4528,[ 79 427 515 318 588],716,5,20468,4.5193199381761975,40.0,0.0
44529,4,4529,[ 79 427 515 318 588],18,5,20473,4.519426048565121,40.0,0.0
44530,4,4530,[ 79 427 515 318 588],716,5,20478,4.51953211211653,40.0,0.0
44531,4,4531,[237 100 568 403 176],269,1,20479,4.518755516328332,0.0,20.0
44532,4,4532,[ 79 427 515 318 588],716,5,20484,4.518861681005957,40.0,0.0
44533,4,4533,[ 79 427 515 318 588],716,5,20489,4.51896779885311,40.0,0.0
44534,4,4534,[ 79 427 515 318 588],807,5,20494,4.5190738699007715,40.0,0.0
44535,4,4535,[181   8 118 168 186],457,5,20499,4.519179894179894,0.0,0.0
44536,4,4536,[191  97 168 322  82],796,2,20501,4.518624641833811,0.0,0.0
44537,4,4537,[ 79 427 515 318 588],18,5,20506,4.51873071837814,40.0,0.0
44538,4,4538,[ 79 427 515 318 588],807,5,20511,4.518836748182419,40.0,0.0
44539,4,4539,[ 79 427 515 318 588],716,5,20516,4.518942731277533,40.0,0.0
44540,4,4540,[ 79 427 515 318 588],807,5,20521,4.51904866769434,40.0,0.0
44541,4,4541,[ 79 427 515 318 588],716,5,20526,4.519154557463672,40.0,0.0
44542,4,4542,[211 423 173 174 100],503,5,20531,4.519260400616333,0.0,20.0
44543,4,4543,[ 79 427 515 318 588],18,5,20536,4.519366197183099,40.0,0.0
44544,4,4544,[ 79 427 515 318 588],716,5,20541,4.519471947194719,40.0,0.0
44545,4,4545,[153 269 174 475 195],655,0,20541,4.51847778266608,0.0,0.0
44546,4,4546,[ 79 427 515 318 588],18,5,20546,4.518583681548273,40.0,0.0
44547,4,4547,[125  82 588   7 216],577,4,20550,4.518469656992084,0.0,0.0
44548,4,4548,[ 79 427 515 318 588],18,5,20555,4.518575511101341,40.0,0.0
44549,4,4549,[ 79 427 515 318 588],807,5,20560,4.518681318681319,40.0,0.0
44550,4,4550,[ 64 211  50  22 483],655,3,20563,4.518347615908591,20.0,20.0
44551,4,4551,[ 79 427 515 318 588],807,5,20568,4.518453427065026,40.0,0.0
44552,4,4552,[273 603 286 144 100],655,2,20570,4.517900285526027,20.0,40.0
44553,4,4553,[ 79 427 515 318 588],807,5,20575,4.518006148440931,40.0,0.0
44554,4,4554,[183 222 204  88 143],716,4,20579,4.517892425905599,0.0,0.0
44555,4,4555,[237 194 748 127 357],450,5,20584,4.517998244073749,0.0,20.0
44556,4,4556,[ 79 427 515 318 588],18,5,20589,4.518104015799868,40.0,0.0
44557,4,4557,[742  95 202  56 222],796,4,20593,4.5179903466432645,0.0,0.0
44558,4,4558,[ 79 427 515 318 588],716,5,20598,4.518096073700373,40.0,0.0
44559,4,4559,[286 235 195  12 546],280,4,20602,4.517982456140351,0.0,20.0
44560,4,4560,[ 79 427 515 318 588],18,5,20607,4.518088138566104,40.0,0.0
44561,4,4561,[ 79 427 515 318 588],716,5,20612,4.5181937746602365,40.0,0.0
44562,4,4562,[117 546 678 186 200],504,4,20616,4.518080210387903,0.0,0.0
44563,4,4563,[ 79 427 515 318 588],18,5,20621,4.518185801928134,40.0,0.0
44564,4,4564,[ 79 427 515 318 588],716,5,20626,4.518291347207009,40.0,0.0
44565,4,4565,[ 79 427 515 318 588],716,5,20631,4.5183968462549275,40.0,0.0
44566,4,4566,[ 79 427 515 318 588],807,5,20636,4.518502299102256,40.0,0.0
44567,4,4567,[ 79 427 515 318 588],807,5,20641,4.518607705779335,40.0,0.0
44568,4,4568,[ 96 597 234 132  28],23,2,20643,4.518056467498359,0.0,0.0
44569,4,4569,[ 79 427 515 318 588],18,5,20648,4.518161925601751,40.0,0.0
44570,4,4570,[ 79 427 515 318 588],18,5,20653,4.518267337562897,40.0,0.0
44571,4,4571,[210 222 237 196 471],457,5,20658,4.518372703412074,0.0,0.0
44572,4,4572,[ 79 427 515 318 588],807,5,20663,4.518478023179532,40.0,0.0
44573,4,4573,[ 79 427 515 318 588],716,5,20668,4.518583296895496,40.0,0.0
44574,4,4574,[300 174 210  25  50],151,5,20673,4.518688524590164,0.0,20.0
44575,4,4575,[ 79 427 515 318 588],716,5,20678,4.518793706293707,40.0,0.0
44576,4,4576,[ 79 427 515 318 588],18,5,20683,4.518898842036268,40.0,0.0
44577,4,4577,[ 79 427 515 318 588],807,5,20688,4.519003931847968,40.0,0.0
44578,4,4578,[ 79 427 515 318 588],18,5,20693,4.5191089757589,40.0,0.0
44579,4,4579,[ 79 427 515 318 588],18,5,20698,4.519213973799126,40.0,0.0
44580,4,4580,[ 79 427 515 318 588],716,5,20703,4.51931892599869,40.0,0.0
44581,4,4581,[ 50 174 258 275 228],457,5,20708,4.519423832387604,0.0,40.0
44582,4,4582,[ 79 427 515 318 588],716,5,20713,4.519528692995854,40.0,0.0
44583,4,4583,[ 79 427 515 318 588],716,5,20718,4.519633507853404,40.0,0.0
44584,4,4584,[237 265 196 597 357],796,5,20723,4.519738276990186,0.0,0.0
44585,4,4585,[ 79 427 515 318 588],807,5,20728,4.51984300043611,40.0,0.0
44586,4,4586,[ 79 427 515 318 588],18,5,20733,4.51994767822106,40.0,0.0
44587,4,4587,[ 79 427 515 318 588],18,5,20738,4.520052310374891,40.0,0.0
44588,4,4588,[ 79 427 515 318 588],716,5,20743,4.5201568969274355,40.0,0.0
44589,4,4589,[ 79 427 515 318 588],716,5,20748,4.520261437908497,40.0,0.0
44590,4,4590,[ 79 427 515 318 588],807,5,20753,4.520365933347854,40.0,0.0
44591,4,4591,[185 204 187 403 196],655,2,20755,4.5198170731707314,0.0,0.0
44592,4,4592,[ 79 427 515 318 588],716,5,20760,4.519921619856303,40.0,0.0
44593,4,4593,[ 79 427 515 318 588],807,5,20765,4.520026121027427,40.0,0.0
44594,4,4594,[ 79 427 515 318 588],716,5,20770,4.52013057671382,40.0,0.0
44595,4,4595,[ 79 427 515 318 588],807,5,20775,4.5202349869451695,40.0,0.0
44596,4,4596,[ 79 427 515 318 588],807,5,20780,4.520339351751142,40.0,0.0
44597,4,4597,[ 79 427 515 318 588],18,5,20785,4.520443671161375,40.0,0.0
44598,4,4598,[ 79 427 515 318 588],18,5,20790,4.52054794520548,40.0,0.0
44599,4,4599,[ 79 427 515 318 588],807,5,20795,4.520652173913043,40.0,0.0
44600,4,4600,[ 79 427 515 318 588],18,5,20800,4.520756357313627,40.0,0.0
44601,4,4601,[151 127 403  56 286],18,3,20803,4.520425901781834,0.0,40.0
44602,4,4602,[ 79 427 515 318 588],18,5,20808,4.520530089072344,40.0,0.0
44603,4,4603,[ 79 427 515 318 588],807,5,20813,4.520634231103388,40.0,0.0
44604,4,4604,[ 79 427 515 318 588],807,5,20818,4.520738327904452,40.0,0.0
44605,4,4605,[ 79 427 515 318 588],716,5,20823,4.520842379504994,40.0,0.0
44606,4,4606,[ 79 427 515 318 588],18,5,20828,4.520946385934447,40.0,0.0
44607,4,4607,[ 79 427 515 318 588],807,5,20833,4.521050347222222,40.0,0.0
44608,4,4608,[ 79 427 515 318 588],18,5,20838,4.5211542633977,40.0,0.0
44609,4,4609,[ 79 427 515 318 588],18,5,20843,4.521258134490239,40.0,0.0
44610,4,4610,[ 79 427 515 318 588],716,5,20848,4.52136196052917,40.0,0.0
44611,4,4611,[ 79 427 515 318 588],716,5,20853,4.521465741543799,40.0,0.0
44612,4,4612,[ 64 132 200 302 403],450,4,20857,4.521352698894429,20.0,0.0
44613,4,4613,[ 79 427 515 318 588],716,5,20862,4.5214564369310795,40.0,0.0
44614,4,4614,[357 385 111 151 302],401,2,20864,4.520910075839653,0.0,0.0
44615,4,4615,[ 79 427 515 318 588],716,5,20869,4.521013864818024,40.0,0.0
44616,4,4616,[ 79 427 515 318 588],807,5,20874,4.521117608836907,40.0,0.0
44617,4,4617,[ 79 427 515 318 588],716,5,20879,4.521221307925509,40.0,0.0
44618,4,4618,[328 300 257 176 204],655,0,20879,4.5202424767265645,0.0,0.0
44619,4,4619,[ 79 427 515 318 588],716,5,20884,4.52034632034632,40.0,0.0
44620,4,4620,[182 195 211  56 186],655,1,20885,4.519584505518286,0.0,0.0
44621,4,4621,[ 79 427 515 318 588],807,5,20890,4.519688446559931,40.0,0.0
44622,4,4622,[ 79 427 515 318 588],18,5,20895,4.519792342634653,40.0,0.0
44623,4,4623,[ 79 427 515 318 588],18,5,20900,4.519896193771626,40.0,0.0
44624,4,4624,[ 79 427 515 318 588],716,5,20905,4.52,40.0,0.0
44625,4,4625,[ 79 427 515 318 588],18,5,20910,4.5201037613488975,40.0,0.0
44626,4,4626,[ 79 427 515 318 588],18,5,20915,4.520207477847418,40.0,0.0
44627,4,4627,[ 79 427 515 318 588],18,5,20920,4.520311149524633,40.0,0.0
44628,4,4628,[ 79 427 515 318 588],716,5,20925,4.520414776409591,40.0,0.0
44629,4,4629,[ 79 427 515 318 588],807,5,20930,4.520518358531318,40.0,0.0
44630,4,4630,[135 318   7 179 403],450,4,20934,4.520405959835888,20.0,0.0
44631,4,4631,[423 210 483 194 286],236,3,20937,4.5200777202072535,0.0,20.0
44632,4,4632,[153  22 182   9 328],796,4,20941,4.519965465141377,0.0,0.0
44633,4,4633,[ 79 427 515 318 588],807,5,20946,4.520069054812257,40.0,0.0
44634,4,4634,[ 79 427 515 318 588],807,5,20951,4.52017259978425,40.0,0.0
44635,4,4635,[ 79 427 515 318 588],716,5,20956,4.5202761000862814,40.0,0.0
44636,4,4636,[ 88  69 282 427 228],693,2,20958,4.519732585723528,20.0,0.0
44637,4,4637,[ 79 427 515 318 588],807,5,20963,4.519836136265631,40.0,0.0
44638,4,4638,[ 79 427 515 318 588],18,5,20968,4.5199396421642595,40.0,0.0
44639,4,4639,[ 79 427 515 318 588],716,5,20973,4.520043103448276,40.0,0.0
44640,4,4640,[ 79 427 515 318 588],18,5,20978,4.52014652014652,40.0,0.0
44641,4,4641,[ 79 427 515 318 588],716,5,20983,4.520249892287807,40.0,0.0
44642,4,4642,[ 79 427 515 318 588],807,5,20988,4.520353219900926,40.0,0.0
44643,4,4643,[ 79 427 515 318 588],18,5,20993,4.520456503014643,40.0,0.0
44644,4,4644,[ 12 655 135 508 357],655,2,20995,4.519913885898816,0.0,0.0
44645,4,4645,[ 79 427 515 318 588],807,5,21000,4.520017219113216,40.0,0.0
44646,4,4646,[ 79 427 515 318 588],807,5,21005,4.5201205078545295,40.0,0.0
44647,4,4647,[228 118 173 603  98],716,4,21009,4.520008605851979,20.0,0.0
44648,4,4648,[ 79 427 515 318 588],18,5,21014,4.520111852011185,40.0,0.0
44649,4,4649,[423 603 483   4 100],535,4,21018,4.52,20.0,20.0
44650,4,4650,[196 118  96 194   4],796,5,21023,4.520103203612126,0.0,0.0
44651,4,4651,[ 79 427 515 318 588],807,5,21028,4.520206362854686,40.0,0.0
44652,4,4652,[ 79 427 515 318 588],807,5,21033,4.520309477756286,40.0,0.0
44653,4,4653,[ 79 427 515 318 588],18,5,21038,4.520412548345509,40.0,0.0
44654,4,4654,[197  88 273  70 289],655,1,21039,4.519656283566058,0.0,0.0
44655,4,4655,[ 79 427 515 318 588],18,5,21044,4.519759450171821,40.0,0.0
44656,4,4656,[ 79 427 515 318 588],807,5,21049,4.519862572471548,40.0,0.0
44657,4,4657,[202 245 185 181 403],796,4,21053,4.5197509660798625,0.0,0.0
44658,4,4658,[181  15 237  88 186],450,3,21056,4.51942476926379,0.0,0.0
44659,4,4659,[ 79 427 515 318 588],716,5,21061,4.519527896995708,40.0,0.0
44660,4,4660,[385 322 186   4 161],796,3,21064,4.519201888006865,0.0,0.0
44661,4,4661,[ 79 427 515 318 588],807,5,21069,4.519305019305019,40.0,0.0
44662,4,4662,[357 405 191 197   4],655,2,21071,4.518764743727214,0.0,0.0
44663,4,4663,[ 79 427 515 318 588],18,5,21076,4.518867924528302,40.0,0.0
44664,4,4664,[ 79 427 515 318 588],716,5,21081,4.518971061093247,40.0,0.0
44665,4,4665,[ 79 427 515 318 588],18,5,21086,4.519074153450493,40.0,0.0
44666,4,4666,[302 655 215 200 144],450,4,21090,4.518962931219199,0.0,0.0
44667,4,4667,[ 79 427 515 318 588],807,5,21095,4.519065981148243,40.0,0.0
44668,4,4668,[ 79 427 515 318 588],807,5,21100,4.519168986935104,40.0,0.0
44669,4,4669,[ 79 427 515 318 588],716,5,21105,4.519271948608137,40.0,0.0
44670,4,4670,[ 89 216  25  50  22],450,4,21109,4.519160779276386,0.0,20.0
44671,4,4671,[ 79 427 515 318 588],716,5,21114,4.519263698630137,40.0,0.0
44672,4,4672,[ 79 427 515 318 588],716,5,21119,4.519366573935374,40.0,0.0
44673,4,4673,[185 210 423  50  28],655,2,21121,4.518827556696619,0.0,20.0
44674,4,4674,[ 79 427 515 318 588],18,5,21126,4.518930481283422,40.0,0.0
44675,4,4675,[ 79 427 515 318 588],807,5,21131,4.519033361847733,40.0,0.0
44676,4,4676,[ 79 427 515 318 588],807,5,21136,4.519136198417789,40.0,0.0
44677,4,4677,[ 79 427 515 318 588],716,5,21141,4.519238991021804,40.0,0.0
44678,4,4678,[100  12   9 143 546],174,4,21145,4.519128018807438,0.0,20.0
44679,4,4679,[238  50 271  70 182],655,2,21147,4.518589743589744,0.0,20.0
44680,4,4680,[151 100  22 423 196],450,5,21152,4.518692587054049,0.0,20.0
44681,4,4681,[ 79 427 515 318 588],18,5,21157,4.518795386586929,40.0,0.0
44682,4,4682,[ 79 427 515 318 588],716,5,21162,4.5188981422165275,40.0,0.0
44683,4,4683,[ 79 427 515 318 588],807,5,21167,4.519000853970965,40.0,0.0
44684,4,4684,[ 79 427 515 318 588],807,5,21172,4.5191035218783355,40.0,0.0
44685,4,4685,[ 79 427 515 318 588],716,5,21177,4.519206145966709,40.0,0.0
44686,4,4686,[ 79 427 515 318 588],18,5,21182,4.519308726264135,40.0,0.0
44687,4,4687,[ 79 427 515 318 588],807,5,21187,4.519411262798635,40.0,0.0
44688,4,4688,[ 79 427 515 318 588],807,5,21192,4.519513755598209,40.0,0.0
44689,4,4689,[ 79 427 515 318 588],18,5,21197,4.5196162046908315,40.0,0.0
44690,4,4690,[301 100 496 202 357],450,5,21202,4.519718610104455,20.0,20.0
44691,4,4691,[ 79 427 515 318 588],807,5,21207,4.5198209718670075,40.0,0.0
44692,4,4692,[ 79 427 515 318 588],18,5,21212,4.519923290006393,40.0,0.0
44693,4,4693,[121 237 200 183  28],504,3,21215,4.51959948870899,0.0,0.0
44694,4,4694,[ 79 427 515 318 588],807,5,21220,4.519701810436635,40.0,0.0
44695,4,4695,[ 96 176 151 588  88],796,5,21225,4.519804088586031,0.0,0.0
44696,4,4696,[ 79 427 515 318 588],18,5,21230,4.519906323185012,40.0,0.0
44697,4,4697,[ 79 427 515 318 588],807,5,21235,4.520008514261388,40.0,0.0
44698,4,4698,[ 79 427 515 318 588],807,5,21240,4.520110661842946,40.0,0.0
44699,4,4699,[ 79 427 515 318 588],18,5,21245,4.520212765957447,40.0,0.0
44700,4,4700,[ 79 427 515 318 588],18,5,21250,4.520314826632632,40.0,0.0
44701,4,4701,[ 79 427 515 318 588],18,5,21255,4.520416843896214,40.0,0.0
44702,4,4702,[ 79 427 515 318 588],807,5,21260,4.520518817775888,40.0,0.0
44703,4,4703,[ 79 427 515 318 588],716,5,21265,4.5206207482993195,40.0,0.0
44704,4,4704,[269 135  56 127 215],655,2,21267,4.520085015940489,0.0,20.0
44705,4,4705,[ 79 427 515 318 588],18,5,21272,4.520186995325117,40.0,0.0
44706,4,4706,[ 79 427 515 318 588],716,5,21277,4.520288931378798,40.0,0.0
44707,4,4707,[ 79 427 515 318 588],18,5,21282,4.520390824129142,40.0,0.0
44708,4,4708,[ 22 121 271 186 258],796,4,21286,4.520280314291782,0.0,0.0
44709,4,4709,[111 175 100 185  56],18,3,21289,4.51995753715499,0.0,20.0
44710,4,4710,[ 79 427 515 318 588],716,5,21294,4.5200594353640415,40.0,0.0
44711,4,4711,[ 79 427 515 318 588],18,5,21299,4.520161290322581,40.0,0.0
44712,4,4712,[ 79 427 515 318 588],716,5,21304,4.520263102058137,40.0,0.0
44713,4,4713,[ 79 427 515 318 588],807,5,21309,4.520364870598218,40.0,0.0
44714,4,4714,[ 79 427 515 318 588],807,5,21314,4.520466595970308,40.0,0.0
44715,4,4715,[ 79 427 515 318 588],716,5,21319,4.520568278201866,40.0,0.0
44716,4,4716,[204 257  89 427 143],655,3,21322,4.5202459190163236,20.0,0.0
44717,4,4717,[ 79 427 515 318 588],716,5,21327,4.520347604917338,40.0,0.0
44718,4,4718,[ 79 427 515 318 588],18,5,21332,4.520449247721975,40.0,0.0
44719,4,4719,[ 79 427 515 318 588],716,5,21337,4.520550847457627,40.0,0.0
44720,4,4720,[ 79 427 515 318 588],716,5,21342,4.5206524041516625,40.0,0.0
44721,4,4721,[ 79 427 515 318 588],18,5,21347,4.520753917831428,40.0,0.0
44722,4,4722,[ 79 427 515 318 588],807,5,21352,4.520855388524243,40.0,0.0
44723,4,4723,[181  69 100 427 127],18,3,21355,4.520533446232006,20.0,40.0
44724,4,4724,[ 79 427 515 318 588],807,5,21360,4.520634920634921,40.0,0.0
44725,4,4725,[ 79 427 515 318 588],807,5,21365,4.5207363520947945,40.0,0.0
44726,4,4726,[ 79 427 515 318 588],716,5,21370,4.520837740638883,40.0,0.0
44727,4,4727,[237 202  71 597  89],344,2,21372,4.520304568527918,0.0,0.0
44728,4,4728,[ 79 427 515 318 588],807,5,21377,4.520406005497991,40.0,0.0
44729,4,4729,[ 79 427 515 318 588],716,5,21382,4.520507399577167,40.0,0.0
44730,4,4730,[ 79 427 515 318 588],18,5,21387,4.520608750792644,40.0,0.0
44731,4,4731,[ 79 427 515 318 588],716,5,21392,4.520710059171598,40.0,0.0
44732,4,4732,[ 79 427 515 318 588],18,5,21397,4.520811324741179,40.0,0.0
44733,4,4733,[ 70 161   7 742 191],457,5,21402,4.520912547528517,0.0,0.0
44734,4,4734,[ 79 427 515 318 588],807,5,21407,4.521013727560718,40.0,0.0
44735,4,4735,[ 79 427 515 318 588],18,5,21412,4.521114864864865,40.0,0.0
44736,4,4736,[172   9  82  98 204],878,3,21415,4.520793751319401,0.0,0.0
44737,4,4737,[ 79 427 515 318 588],807,5,21420,4.520894892359645,40.0,0.0
44738,4,4738,[ 50  69 288   4 234],629,4,21424,4.520784975733277,0.0,20.0
44739,4,4739,[ 79 427 515 318 588],807,5,21429,4.520886075949367,40.0,0.0
44740,4,4740,[ 79 427 515 318 588],18,5,21434,4.520987133516136,40.0,0.0
44741,4,4741,[ 79 427 515 318 588],716,5,21439,4.521088148460565,40.0,0.0
44742,4,4742,[ 79 427 515 318 588],18,5,21444,4.521189120809614,40.0,0.0
44743,4,4743,[ 79 427 515 318 588],716,5,21449,4.52129005059022,40.0,0.0
44744,4,4744,[ 79 427 515 318 588],716,5,21454,4.521390937829294,40.0,0.0
44745,4,4745,[ 79 427 515 318 588],716,5,21459,4.5214917825537295,40.0,0.0
44746,4,4746,[ 79 427 515 318 588],18,5,21464,4.521592584790394,40.0,0.0
44747,4,4747,[655 196 174   1 135],72,5,21469,4.521693344566133,0.0,0.0
44748,4,4748,[144 323 215 176 183],280,0,21469,4.520741208675511,0.0,0.0
44749,4,4749,[357  97 655 194 196],639,1,21470,4.52,0.0,0.0
44750,4,4750,[ 79 427 515 318 588],807,5,21475,4.520101031361818,40.0,0.0
44751,4,4751,[ 79 427 515 318 588],716,5,21480,4.52020202020202,40.0,0.0
44752,4,4752,[385 185 597 186 118],796,4,21484,4.520092573111719,0.0,0.0
44753,4,4753,[ 79 427 515 318 588],18,5,21489,4.520193521245267,40.0,0.0
44754,4,4754,[ 79 427 515 318 588],716,5,21494,4.520294426919032,40.0,0.0
44755,4,4755,[234 742 161  97 127],504,4,21498,4.520185029436501,0.0,20.0
44756,4,4756,[568 117 172 357 181],450,5,21503,4.520285894471305,0.0,0.0
44757,4,4757,[ 79 427 515 318 588],716,5,21508,4.520386717108028,40.0,0.0
44758,4,4758,[323 183   1 294  69],796,2,21510,4.519857112838832,0.0,0.0
44759,4,4759,[423 268 403 275 187],655,2,21512,4.519327731092437,0.0,20.0
44760,4,4760,[144 143 238 282  56],450,5,21517,4.519428691451376,0.0,0.0
44761,4,4761,[ 79 427 515 318 588],716,5,21522,4.519529609407812,40.0,0.0
44762,4,4762,[ 79 427 515 318 588],18,5,21527,4.519630484988452,40.0,0.0
44763,4,4763,[ 79 427 515 318 588],807,5,21532,4.519731318219983,40.0,0.0
44764,4,4764,[ 79 427 515 318 588],807,5,21537,4.519832109129066,40.0,0.0
44765,4,4765,[ 79 427 515 318 588],716,5,21542,4.519932857742342,40.0,0.0
44766,4,4766,[ 79 427 515 318 588],716,5,21547,4.520033564086427,40.0,0.0
44767,4,4767,[ 79 427 515 318 588],18,5,21552,4.52013422818792,40.0,0.0
44768,4,4768,[ 56 216 161 179  50],450,5,21557,4.520234850073391,0.0,20.0
44769,4,4769,[ 79 427 515 318 588],18,5,21562,4.520335429769392,40.0,0.0
44770,4,4770,[ 79 427 515 318 588],807,5,21567,4.520435967302452,40.0,0.0
44771,4,4771,[ 79 427 515 318 588],716,5,21572,4.520536462699078,40.0,0.0
44772,4,4772,[ 79 427 515 318 588],716,5,21577,4.520636915985754,40.0,0.0
44773,4,4773,[181 183 222  98 196],716,4,21581,4.520527859237537,0.0,0.0
44774,4,4774,[ 79 172 175 202 678],344,4,21585,4.520418848167539,0.0,0.0
44775,4,4775,[ 79 427 515 318 588],807,5,21590,4.5205192629815745,40.0,0.0
44776,4,4776,[ 79 427 515 318 588],716,5,21595,4.520619635754658,40.0,0.0
44777,4,4777,[238  98 423 282 127],716,4,21599,4.520510673922143,0.0,20.0
44778,4,4778,[ 79 427 515 318 588],807,5,21604,4.520611006486713,40.0,0.0
44779,4,4779,[ 79 427 515 318 588],18,5,21609,4.52071129707113,40.0,0.0
44780,4,4780,[ 79 427 515 318 588],18,5,21614,4.520811545701736,40.0,0.0
44781,4,4781,[ 79 427 515 318 588],18,5,21619,4.520911752404851,40.0,0.0
44782,4,4782,[ 79 427 515 318 588],807,5,21624,4.521011917206774,40.0,0.0
44783,4,4783,[286 288  82 275 357],450,3,21627,4.52069397993311,0.0,40.0
44784,4,4784,[ 79 427 515 318 588],716,5,21632,4.5207941483803555,40.0,0.0
44785,4,4785,[132 185 202 423 483],151,5,21637,4.520894274968659,0.0,0.0
44786,4,4786,[210 179  50 111 435],389,3,21640,4.520576561520786,0.0,20.0
44787,4,4787,[ 79 427 515 318 588],18,5,21645,4.5206766917293235,40.0,0.0
44788,4,4788,[265 357 333 179 301],655,2,21647,4.520150344539569,0.0,0.0
44789,4,4789,[204  64 183 215  50],457,5,21652,4.520250521920668,20.0,20.0
44790,4,4790,[ 79 427 515 318 588],716,5,21657,4.52035065748278,40.0,0.0
44791,4,4791,[ 79 427 515 318 588],716,5,21662,4.520450751252087,40.0,0.0
44792,4,4792,[237 117 265 135 300],655,1,21663,4.519716252868767,0.0,0.0
44793,4,4793,[515 111 265 238 172],655,2,21665,4.519190654985398,0.0,0.0
44794,4,4794,[ 79 427 515 318 588],716,5,21670,4.519290928050052,40.0,0.0
44795,4,4795,[ 79 427 515 318 588],716,5,21675,4.519391159299416,40.0,0.0
44796,4,4796,[435 228  28 185 273],450,4,21679,4.519282885136544,0.0,0.0
44797,4,4797,[ 79 427 515 318 588],716,5,21684,4.519383076281784,40.0,0.0
44798,4,4798,[ 79 427 515 318 588],716,5,21689,4.519483225672015,40.0,0.0
44799,4,4799,[211  70 143 117 151],401,3,21692,4.519166666666667,0.0,0.0
44800,4,4800,[  7 237  89 322 405],786,4,21696,4.5190585294730266,0.0,0.0
44801,4,4801,[ 79 427 515 318 588],18,5,21701,4.519158683881716,40.0,0.0
44802,4,4802,[276 182 216 546 181],593,2,21703,4.518634186966479,0.0,0.0
44803,4,4803,[313 135 385 328  96],450,4,21707,4.518526228143214,0.0,0.0
44804,4,4804,[191 333 273 210 222],236,2,21709,4.518002081165452,0.0,0.0
44805,4,4805,[423  88 173  25 286],151,5,21714,4.5181023720349565,0.0,20.0
44806,4,4806,[ 79 427 515 318 588],716,5,21719,4.5182026211774495,40.0,0.0
44807,4,4807,[ 79 427 515 318 588],18,5,21724,4.518302828618968,40.0,0.0
44808,4,4808,[ 79 427 515 318 588],716,5,21729,4.518402994385527,40.0,0.0
44809,4,4809,[ 69 117 228 161  71],786,5,21734,4.518503118503118,0.0,0.0
44810,4,4810,[194  28 471 180 153],450,5,21739,4.518603200997713,0.0,0.0
44811,4,4811,[ 79 427 515 318 588],18,5,21744,4.5187032418952615,40.0,0.0
44812,4,4812,[153  69 357  25  50],18,3,21747,4.518387699979223,0.0,20.0
44813,4,4813,[196 180  79  12 603],18,3,21750,4.518072289156627,20.0,0.0
44814,4,4814,[ 79 427 515 318 588],716,5,21755,4.518172377985462,40.0,0.0
44815,4,4815,[ 79 427 515 318 588],716,5,21760,4.51827242524917,40.0,0.0
44816,4,4816,[ 79 427 515 318 588],807,5,21765,4.518372430973635,40.0,0.0
44817,4,4817,[ 79 427 515 318 588],807,5,21770,4.518472395184724,40.0,0.0
44818,4,4818,[ 79 427 515 318 588],807,5,21775,4.51857231790828,40.0,0.0
44819,4,4819,[ 79 427 515 318 588],716,5,21780,4.518672199170124,40.0,0.0
44820,4,4820,[ 79 427 515 318 588],716,5,21785,4.518772038996059,40.0,0.0
44821,4,4821,[ 79 427 515 318 588],716,5,21790,4.518871837411862,40.0,0.0
44822,4,4822,[ 79 427 515 318 588],18,5,21795,4.518971594443292,40.0,0.0
44823,4,4823,[ 79 427 515 318 588],18,5,21800,4.519071310116086,40.0,0.0
44824,4,4824,[ 79 427 515 318 588],18,5,21805,4.519170984455958,40.0,0.0
44825,4,4825,[ 79 427 515 318 588],18,5,21810,4.519270617488603,40.0,0.0
44826,4,4826,[ 79 427 515 318 588],716,5,21815,4.5193702092396935,40.0,0.0
44827,4,4827,[ 79 427 515 318 588],716,5,21820,4.51946975973488,40.0,0.0
44828,4,4828,[ 79 427 515 318 588],18,5,21825,4.519569268999793,40.0,0.0
44829,4,4829,[ 79 427 515 318 588],18,5,21830,4.519668737060042,40.0,0.0
44830,4,4830,[216 313 176 483 210],280,2,21832,4.519147174498033,0.0,0.0
44831,4,4831,[132  22 143 168 197],330,4,21836,4.519039735099338,0.0,0.0
44832,4,4832,[ 79 427 515 318 588],716,5,21841,4.5191392509828265,40.0,0.0
44833,4,4833,[ 79 427 515 318 588],716,5,21846,4.5192387256930076,40.0,0.0
44834,4,4834,[127 655  96 183 269],655,2,21848,4.518717683557394,0.0,20.0
44835,4,4835,[ 79 427 515 318 588],807,5,21853,4.518817204301075,40.0,0.0
44836,4,4836,[200 118 471 100  79],450,3,21856,4.518503204465578,0.0,20.0
44837,4,4837,[121 655 143 275 127],457,5,21861,4.5186027284001655,0.0,40.0
44838,4,4838,[ 79 427 515 318 588],807,5,21866,4.518702211200662,40.0,0.0
44839,4,4839,[ 79 427 515 318 588],807,5,21871,4.518801652892562,40.0,0.0
44840,4,4840,[258 151 211 427  28],796,3,21874,4.518487915719892,20.0,0.0
44841,4,4841,[ 12 423 111  82 118],174,2,21876,4.517967781908302,0.0,0.0
44842,4,4842,[ 79 427 515 318 588],807,5,21881,4.518067313648565,40.0,0.0
44843,4,4843,[ 79 427 515 318 588],18,5,21886,4.518166804293972,40.0,0.0
44844,4,4844,[ 79 427 515 318 588],716,5,21891,4.518266253869969,40.0,0.0
44845,4,4845,[ 79 427 515 318 588],716,5,21896,4.5183656624019815,40.0,0.0
44846,4,4846,[496  11 181 183   1],344,2,21898,4.5178460903651745,20.0,0.0
44847,4,4847,[ 79 427 515 318 588],807,5,21903,4.517945544554456,40.0,0.0
44848,4,4848,[ 79 427 515 318 588],18,5,21908,4.518044957723242,40.0,0.0
44849,4,4849,[483 210 403 187 515],269,3,21911,4.517731958762886,0.0,0.0
44850,4,4850,[121 197 172  98  22],716,5,21916,4.517831374974232,0.0,0.0
44851,4,4851,[ 82 215 153 174  70],23,2,21918,4.517312448474856,0.0,0.0
44852,4,4852,[ 12 179 216 211 427],18,5,21923,4.517411910158665,20.0,0.0
44853,4,4853,[ 56 268 121 180 237],269,2,21925,4.5168932838895755,0.0,0.0
44854,4,4854,[ 79 427 515 318 588],716,5,21930,4.516992790937178,40.0,0.0
44855,4,4855,[ 79 427 515 318 588],807,5,21935,4.517092257001647,40.0,0.0
44856,4,4856,[ 22 132 423 173 168],269,3,21938,4.516779905291332,0.0,0.0
44857,4,4857,[ 79 427 515 318 588],18,5,21943,4.516879374228077,40.0,0.0
44858,4,4858,[ 79 427 515 318 588],18,5,21948,4.516978802222679,40.0,0.0
44859,4,4859,[ 79 427 515 318 588],716,5,21953,4.5170781893004115,40.0,0.0
44860,4,4860,[ 79 427 515 318 588],18,5,21958,4.517177535486526,40.0,0.0
44861,4,4861,[ 79 427 515 318 588],18,5,21963,4.517276840806253,40.0,0.0
44862,4,4862,[ 79 427 515 318 588],807,5,21968,4.517376105284804,40.0,0.0
44863,4,4863,[ 79 427 515 318 588],716,5,21973,4.517475328947368,40.0,0.0
44864,4,4864,[161 100 202 117 172],457,5,21978,4.517574511819116,0.0,20.0
44865,4,4865,[ 79 427 515 318 588],18,5,21983,4.517673653925195,40.0,0.0
44866,4,4866,[318  11 174 471  95],280,3,21986,4.517361824532566,20.0,0.0
44867,4,4867,[179 588 546   7  64],457,4,21990,4.517255546425637,20.0,0.0
44868,4,4868,[ 79 427 515 318 588],18,5,21995,4.517354692955433,40.0,0.0
44869,4,4869,[161 194 211 323 597],796,3,21998,4.517043121149897,0.0,0.0
44870,4,4870,[ 79 427 515 318 588],18,5,22003,4.517142270580989,40.0,0.0
44871,4,4871,[ 79 427 515 318 588],18,5,22008,4.517241379310345,40.0,0.0
44872,4,4872,[ 79 427 515 318 588],807,5,22013,4.51734044736302,40.0,0.0
44873,4,4873,[ 79 427 515 318 588],807,5,22018,4.517439474764054,40.0,0.0
44874,4,4874,[ 79 427 515 318 588],18,5,22023,4.517538461538462,40.0,0.0
44875,4,4875,[ 79 427 515 318 588],716,5,22028,4.517637407711239,40.0,0.0
44876,4,4876,[ 70 276 204   7 210],269,1,22029,4.516916136969448,0.0,0.0
44877,4,4877,[ 79 427 515 318 588],807,5,22034,4.517015170151701,40.0,0.0
44878,4,4878,[195 423 238   9  25],457,5,22039,4.517114162738266,0.0,0.0
44879,4,4879,[ 79 427 515 318 588],807,5,22044,4.517213114754099,40.0,0.0
44880,4,4880,[ 79 427 515 318 588],716,5,22049,4.517312026224134,40.0,0.0
44881,4,4881,[265 742  95 282 125],280,3,22052,4.5170012290045065,0.0,0.0
44882,4,4882,[ 28   1  69  22 204],450,5,22057,4.5171001433544955,0.0,0.0
44883,4,4883,[ 79 427 515 318 588],716,5,22062,4.517199017199017,40.0,0.0
44884,4,4884,[ 79 427 515 318 588],807,5,22067,4.517297850562948,40.0,0.0
44885,4,4885,[ 22 180 144 403 288],280,3,22070,4.516987310683586,0.0,0.0
44886,4,4886,[186  70   4 173 176],716,2,22072,4.51647227337835,0.0,0.0
44887,4,4887,[ 79 427 515 318 588],716,5,22077,4.516571194762684,40.0,0.0
44888,4,4888,[ 79 427 515 318 588],18,5,22082,4.516670075680098,40.0,0.0
44889,4,4889,[ 79 427 515 318 588],18,5,22087,4.516768916155419,40.0,0.0
44890,4,4890,[111 153 210  97 194],639,1,22088,4.516049887548559,0.0,0.0
44891,4,4891,[ 79 427 515 318 588],807,5,22093,4.516148814390842,40.0,0.0
44892,4,4892,[ 79 427 515 318 588],807,5,22098,4.516247700797057,40.0,0.0
44893,4,4893,[ 79 427 515 318 588],18,5,22103,4.51634654679199,40.0,0.0
44894,4,4894,[ 79 427 515 318 588],18,5,22108,4.5164453524004085,40.0,0.0
44895,4,4895,[ 79 427 515 318 588],18,5,22113,4.516544117647059,40.0,0.0
44896,4,4896,[ 79 427 515 318 588],18,5,22118,4.516642842556667,40.0,0.0
44897,4,4897,[ 79 427 515 318 588],807,5,22123,4.516741527153941,40.0,0.0
44898,4,4898,[ 79 427 515 318 588],18,5,22128,4.516840171463564,40.0,0.0
44899,4,4899,[211 181 427 228 357],716,5,22133,4.516938775510204,20.0,0.0
44900,4,4900,[ 79 427 515 318 588],807,5,22138,4.517037339318507,40.0,0.0
44901,4,4901,[ 79 427 515 318 588],716,5,22143,4.517135862913097,40.0,0.0
44902,4,4902,[ 79 427 515 318 588],716,5,22148,4.51723434631858,40.0,0.0
44903,4,4903,[143 301 603 179 427],389,4,22152,4.517128874388255,40.0,0.0
44904,4,4904,[ 79 427 515 318 588],716,5,22157,4.517227319062181,40.0,0.0
44905,4,4905,[ 79 427 515 318 588],18,5,22162,4.517325723603751,40.0,0.0
44906,4,4906,[ 79 427 515 318 588],18,5,22167,4.517424088037497,40.0,0.0
44907,4,4907,[301 597 144   9 172],796,3,22170,4.517114914425428,0.0,0.0
44908,4,4908,[ 79 427 515 318 588],716,5,22175,4.5172132817274395,40.0,0.0
44909,4,4909,[ 79 427 515 318 588],716,5,22180,4.517311608961304,40.0,0.0
44910,4,4910,[ 79 427 515 318 588],18,5,22185,4.517409896151497,40.0,0.0
44911,4,4911,[ 79 427 515 318 588],716,5,22190,4.517508143322476,40.0,0.0
44912,4,4912,[ 79 427 515 318 588],807,5,22195,4.517606350498677,40.0,0.0
44913,4,4913,[ 79 427 515 318 588],807,5,22200,4.517704517704518,40.0,0.0
44914,4,4914,[ 79 427 515 318 588],807,5,22205,4.517802644964394,40.0,0.0
44915,4,4915,[ 79 427 515 318 588],716,5,22210,4.517900732302685,40.0,0.0
44916,4,4916,[405 173 161 135 211],450,4,22214,4.517795403701444,0.0,0.0
44917,4,4917,[ 79 427 515 318 588],807,5,22219,4.517893452623017,40.0,0.0
44918,4,4918,[ 79 427 515 318 588],18,5,22224,4.517991461679203,40.0,0.0
44919,4,4919,[ 79 427 515 318 588],18,5,22229,4.518089430894309,40.0,0.0
44920,4,4920,[ 79 427 515 318 588],18,5,22234,4.5181873602926235,40.0,0.0
44921,4,4921,[ 79 427 515 318 588],807,5,22239,4.518285249898415,40.0,0.0
44922,4,4922,[ 79 427 515 318 588],716,5,22244,4.518383099735933,40.0,0.0
44923,4,4923,[ 79 427 515 318 588],18,5,22249,4.518480909829407,40.0,0.0
44924,4,4924,[ 79 427 515 318 588],18,5,22254,4.518578680203046,40.0,0.0
44925,4,4925,[ 79 427 515 318 588],18,5,22259,4.5186764108810396,40.0,0.0
44926,4,4926,[ 79 427 515 318 588],18,5,22264,4.5187741018875585,40.0,0.0
44927,4,4927,[237 357  96 132 568],269,2,22266,4.518262987012987,0.0,0.0
44928,4,4928,[ 79 427 515 318 588],18,5,22271,4.518360722256036,40.0,0.0
44929,4,4929,[ 79 427 515 318 588],807,5,22276,4.5184584178498985,40.0,0.0
44930,4,4930,[ 79 427 515 318 588],716,5,22281,4.518556073818698,40.0,0.0
44931,4,4931,[ 79 427 515 318 588],18,5,22286,4.518653690186537,40.0,0.0
44932,4,4932,[ 79 427 515 318 588],807,5,22291,4.518751266977499,40.0,0.0
44933,4,4933,[ 79 427 515 318 588],18,5,22296,4.518848804215646,40.0,0.0
44934,4,4934,[ 79 427 515 318 588],716,5,22301,4.518946301925025,40.0,0.0
44935,4,4935,[ 79 427 515 318 588],716,5,22306,4.51904376012966,40.0,0.0
44936,4,4936,[168  11 282  79 258],535,3,22309,4.518736074539194,0.0,0.0
44937,4,4937,[ 98   1 742 333 222],655,1,22310,4.518023491292021,0.0,0.0
44938,4,4938,[ 79 427 515 318 588],716,5,22315,4.518121077141122,40.0,0.0
44939,4,4939,[ 79 427 515 318 588],18,5,22320,4.518218623481781,40.0,0.0
44940,4,4940,[ 79 427 515 318 588],807,5,22325,4.518316130337988,40.0,0.0
44941,4,4941,[ 79 427 515 318 588],716,5,22330,4.518413597733711,40.0,0.0
44942,4,4942,[385  11 427 100 269],450,5,22335,4.518511025692899,20.0,20.0
44943,4,4943,[ 79 427 515 318 588],18,5,22340,4.518608414239482,40.0,0.0
44944,4,4944,[ 79 427 515 318 588],18,5,22345,4.518705763397371,40.0,0.0
44945,4,4945,[ 79 427 515 318 588],807,5,22350,4.518803073190457,40.0,0.0
44946,4,4946,[ 79 427 515 318 588],716,5,22355,4.518900343642612,40.0,0.0
44947,4,4947,[ 79 427 515 318 588],716,5,22360,4.518997574777688,40.0,0.0
44948,4,4948,[ 64 271 144 121 423],796,5,22365,4.519094766619519,20.0,0.0
44949,4,4949,[ 79 427 515 318 588],18,5,22370,4.519191919191919,40.0,0.0
44950,4,4950,[ 79 427 515 318 588],716,5,22375,4.519289032518683,40.0,0.0
44951,4,4951,[174 603 179  11 286],450,5,22380,4.519386106623586,20.0,20.0
44952,4,4952,[ 79 427 515 318 588],807,5,22385,4.519483141530386,40.0,0.0
44953,4,4953,[215 125 168  25 173],65,4,22389,4.5193782801776345,0.0,0.0
44954,4,4954,[ 79 427 515 318 588],716,5,22394,4.519475277497477,40.0,0.0
44955,4,4955,[ 79 427 515 318 588],18,5,22399,4.51957223567393,40.0,0.0
44956,4,4956,[ 79 427 515 318 588],807,5,22404,4.519669154730684,40.0,0.0
44957,4,4957,[ 79 427 515 318 588],807,5,22409,4.519766034691408,40.0,0.0
44958,4,4958,[ 79 427 515 318 588],807,5,22414,4.519862875579754,40.0,0.0
44959,4,4959,[ 79 427 515 318 588],716,5,22419,4.5199596774193544,40.0,0.0
44960,4,4960,[ 79 427 515 318 588],18,5,22424,4.520056440233824,40.0,0.0
44961,4,4961,[ 79 427 515 318 588],807,5,22429,4.520153164046755,40.0,0.0
44962,4,4962,[175 655 197 427 471],716,3,22432,4.519846866814427,20.0,0.0
44963,4,4963,[ 79 427 515 318 588],716,5,22437,4.519943593875906,40.0,0.0
44964,4,4964,[ 79 427 515 318 588],716,5,22442,4.520040281973817,40.0,0.0
44965,4,4965,[ 79 427 515 318 588],716,5,22447,4.520136931131695,40.0,0.0
44966,4,4966,[181 144 257 186 151],457,4,22451,4.520032212603181,0.0,0.0
44967,4,4967,[ 79  25 546 174 117],693,4,22455,4.519927536231884,0.0,0.0
44968,4,4968,[ 79 427 515 318 588],716,5,22460,4.520024149728315,40.0,0.0
44969,4,4969,[ 79 427 515 318 588],807,5,22465,4.520120724346077,40.0,0.0
44970,4,4970,[ 79 427 515 318 588],18,5,22470,4.52021726010863,40.0,0.0
44971,4,4971,[ 79 427 515 318 588],807,5,22475,4.520313757039421,40.0,0.0
44972,4,4972,[ 79 427 515 318 588],716,5,22480,4.520410215161874,40.0,0.0
44973,4,4973,[ 79 427 515 318 588],807,5,22485,4.520506634499397,40.0,0.0
44974,4,4974,[ 79 427 515 318 588],716,5,22490,4.520603015075377,40.0,0.0
44975,4,4975,[182 132 238 276 265],655,2,22492,4.520096463022508,0.0,0.0
44976,4,4976,[ 79 427 515 318 588],716,5,22497,4.520192887281495,40.0,0.0
44977,4,4977,[245 172 197 194  56],450,5,22502,4.520289272800321,0.0,0.0
44978,4,4978,[187 210 211 269  97],655,1,22503,4.51958224543081,0.0,0.0
44979,4,4979,[ 79 427 515 318 588],716,5,22508,4.519678714859438,40.0,0.0
44980,4,4980,[294 546  25 161 288],504,4,22512,4.519574382654086,0.0,0.0
44981,4,4981,[ 79 427 515 318 588],716,5,22517,4.519670814933762,40.0,0.0
44982,4,4982,[151  88 100 181 234],151,4,22521,4.519566526189043,0.0,20.0
44983,4,4983,[ 79 427 515 318 588],807,5,22526,4.519662921348314,40.0,0.0
44984,4,4984,[ 79 427 515 318 588],18,5,22531,4.519759277833501,40.0,0.0
44985,4,4985,[204  98 483 194 427],236,3,22534,4.519454472523065,20.0,0.0
44986,4,4986,[ 79 427 515 318 588],716,5,22539,4.519550832163626,40.0,0.0
44987,4,4987,[ 79 427 515 318 588],807,5,22544,4.519647153167602,40.0,0.0
44988,4,4988,[ 79 427 515 318 588],716,5,22549,4.519743435558228,40.0,0.0
44989,4,4989,[ 79 427 515 318 588],716,5,22554,4.519839679358717,40.0,0.0
44990,4,4990,[ 79 427 515 318 588],18,5,22559,4.519935884592266,40.0,0.0
44991,4,4991,[ 64 202 191 275 234],450,4,22563,4.519831730769231,20.0,20.0
44992,4,4992,[ 79 427 515 318 588],807,5,22568,4.519927899058682,40.0,0.0
44993,4,4993,[ 79 427 515 318 588],716,5,22573,4.520024028834602,40.0,0.0
44994,4,4994,[ 79 427 515 318 588],807,5,22578,4.52012012012012,40.0,0.0
44995,4,4995,[ 79 427 515 318 588],18,5,22583,4.52021617293835,40.0,0.0
44996,4,4996,[222 118  64 265  71],796,5,22588,4.5203121873123875,20.0,0.0
44997,4,4997,[ 79 427 515 318 588],18,5,22593,4.520408163265306,40.0,0.0
44998,4,4998,[ 79 427 515 318 588],18,5,22598,4.520504100820164,40.0,0.0
44999,4,4999,[ 79 427 515 318 588],807,5,22603,4.5206,40.0,0.0
45000,4,5000,[ 79 427 515 318 588],18,5,22608,4.520695860827835,40.0,0.0
45001,4,5001,[403 234 222 496  96],450,3,22611,4.520391843262695,20.0,0.0
45002,4,5002,[ 79 427 515 318 588],18,5,22616,4.520487707375574,40.0,0.0
45003,4,5003,[ 79 427 515 318 588],18,5,22621,4.520583533173461,40.0,0.0
45004,4,5004,[ 79 427 515 318 588],807,5,22626,4.520679320679321,40.0,0.0
45005,4,5005,[ 79 427 515 318 588],807,5,22631,4.520775069916101,40.0,0.0
45006,4,5006,[ 79 427 515 318 588],716,5,22636,4.520870780906731,40.0,0.0
45007,4,5007,[ 79 427 515 318 588],716,5,22641,4.520966453674121,40.0,0.0
45008,4,5008,[ 79 427 515 318 588],716,5,22646,4.521062088241166,40.0,0.0
45009,4,5009,[ 79 427 515 318 588],18,5,22651,4.521157684630738,40.0,0.0
45010,4,5010,[ 79 427 515 318 588],807,5,22656,4.521253242865695,40.0,0.0
45011,4,5011,[ 82 186 100  11  15],269,1,22657,4.520550678371907,0.0,20.0
45012,4,5012,[ 79 427 515 318 588],18,5,22662,4.520646319569121,40.0,0.0
45013,4,5013,[ 79 427 515 318 588],807,5,22667,4.520741922616673,40.0,0.0
45014,4,5014,[ 79 427 515 318 588],18,5,22672,4.520837487537388,40.0,0.0
45015,4,5015,[ 79 427 515 318 588],807,5,22677,4.520933014354067,40.0,0.0
45016,4,5016,[ 79 427 515 318 588],716,5,22682,4.521028503089496,40.0,0.0
45017,4,5017,[ 79 427 515 318 588],807,5,22687,4.521123953766441,40.0,0.0
45018,4,5018,[111 132 245 385 182],280,3,22690,4.520820880653517,0.0,0.0
45019,4,5019,[483  79  64 286 301],389,4,22694,4.520717131474104,20.0,20.0
45020,4,5020,[ 79 427 515 318 588],18,5,22699,4.520812587134037,40.0,0.0
45021,4,5021,[318 125 301 405  28],450,5,22704,4.520908004778972,20.0,0.0
45022,4,5022,[ 79 427 515 318 588],716,5,22709,4.521003384431615,40.0,0.0
45023,4,5023,[265 471  15 228 186],577,2,22711,4.520501592356688,0.0,0.0
45024,4,5024,[ 79 427 515 318 588],18,5,22716,4.520597014925373,40.0,0.0
45025,4,5025,[ 79 427 515 318 588],716,5,22721,4.520692399522483,40.0,0.0
45026,4,5026,[ 79 427 515 318 588],18,5,22726,4.5207877461706785,40.0,0.0
45027,4,5027,[174 200  95 183  15],796,5,22731,4.520883054892601,0.0,0.0
45028,4,5028,[ 79 427 515 318 588],18,5,22736,4.520978325710877,40.0,0.0
45029,4,5029,[ 79 427 515 318 588],716,5,22741,4.521073558648111,40.0,0.0
45030,4,5030,[405  95 588 176 471],716,3,22744,4.5207712184456375,0.0,0.0
45031,4,5031,[ 79 427 515 318 588],18,5,22749,4.520866454689984,40.0,0.0
45032,4,5032,[ 79 427 515 318 588],18,5,22754,4.520961653089609,40.0,0.0
45033,4,5033,[ 79 427 515 318 588],18,5,22759,4.521056813667064,40.0,0.0
45034,4,5034,[ 79 427 515 318 588],18,5,22764,4.521151936444886,40.0,0.0
45035,4,5035,[ 79 427 515 318 588],807,5,22769,4.521247021445592,40.0,0.0
45036,4,5036,[186   7  96  82 175],457,5,22774,4.521342068691681,0.0,0.0
45037,4,5037,[179 180 276   8 174],457,5,22779,4.521437078205637,0.0,0.0
45038,4,5038,[ 79 427 515 318 588],18,5,22784,4.521532050009923,40.0,0.0
45039,4,5039,[ 79 427 515 318 588],807,5,22789,4.521626984126984,40.0,0.0
45040,4,5040,[ 79 427 515 318 588],18,5,22794,4.52172188057925,40.0,0.0
45041,4,5041,[ 79 427 515 318 588],716,5,22799,4.5218167393891315,40.0,0.0
45042,4,5042,[ 79 427 515 318 588],807,5,22804,4.521911560579021,40.0,0.0
45043,4,5043,[ 79 427 515 318 588],807,5,22809,4.5220063441712925,40.0,0.0
45044,4,5044,[196  79 174 200 385],716,4,22813,4.521902874132805,0.0,0.0
45045,4,5045,[ 70  28 117  64 195],330,4,22817,4.521799445105033,20.0,0.0
45046,4,5046,[222 200 111 135 204],457,4,22821,4.521696057063602,0.0,0.0
45047,4,5047,[194 176 235 186 202],457,4,22825,4.521592709984152,0.0,0.0
45048,4,5048,[ 79 427 515 318 588],807,5,22830,4.521687462863934,40.0,0.0
45049,4,5049,[403 286 161 204 322],280,3,22833,4.521386138613861,0.0,20.0
45050,4,5050,[ 79 427 515 318 588],807,5,22838,4.521480894872303,40.0,0.0
45051,4,5051,[ 79 427 515 318 588],18,5,22843,4.521575613618369,40.0,0.0
45052,4,5052,[ 64 385  97 172 111],344,3,22846,4.5212744904017415,20.0,0.0
45053,4,5053,[ 79 427 515 318 588],716,5,22851,4.521369212504947,40.0,0.0
45054,4,5054,[300 748  64 427 238],796,4,22855,4.521266073194856,40.0,0.0
45055,4,5055,[196 313 258 174 268],344,2,22857,4.5207674050632916,0.0,0.0
45056,4,5056,[ 79 427 515 318 588],18,5,22862,4.520862171247775,40.0,0.0
45057,4,5057,[ 79 427 515 318 588],716,5,22867,4.520956899960459,40.0,0.0
45058,4,5058,[ 79 427 515 318 588],716,5,22872,4.521051591223562,40.0,0.0
45059,4,5059,[ 79 427 515 318 588],18,5,22877,4.521146245059288,40.0,0.0
45060,4,5060,[ 79 427 515 318 588],18,5,22882,4.521240861489824,40.0,0.0
45061,4,5061,[ 79 427 515 318 588],716,5,22887,4.521335440537337,40.0,0.0
45062,4,5062,[ 79 427 515 318 588],716,5,22892,4.521429982223978,40.0,0.0
45063,4,5063,[ 98 168 588   1 215],796,4,22896,4.521327014218009,0.0,0.0
45064,4,5064,[ 79 427 515 318 588],716,5,22901,4.52142152023692,40.0,0.0
45065,4,5065,[ 79 427 515 318 588],18,5,22906,4.5215159889459136,40.0,0.0
45066,4,5066,[282 127 151 196 191],796,5,22911,4.5216104203670815,0.0,20.0
45067,4,5067,[ 79 427 515 318 588],18,5,22916,4.5217048145224945,40.0,0.0
45068,4,5068,[ 79 427 515 318 588],716,5,22921,4.521799171434208,40.0,0.0
45069,4,5069,[183 328 118 483  56],796,5,22926,4.521893491124261,0.0,0.0
45070,4,5070,[216 202 174 195 245],796,4,22930,4.521790573851312,0.0,0.0
45071,4,5071,[ 22 322 175   7 245],344,2,22932,4.521293375394322,0.0,0.0
45072,4,5072,[302 435 185  50 273],450,4,22936,4.521190616991918,0.0,20.0
45073,4,5073,[357 204  79 238 211],591,5,22941,4.5212849822625145,0.0,0.0
45074,4,5074,[ 79 427 515 318 588],716,5,22946,4.521379310344828,40.0,0.0
45075,4,5075,[234 235 100 742 357],450,3,22949,4.521079590228527,0.0,20.0
45076,4,5076,[ 79 427 515 318 588],18,5,22954,4.521173921607248,40.0,0.0
45077,4,5077,[ 79 427 515 318 588],716,5,22959,4.521268215833005,40.0,0.0
45078,4,5078,[ 79 427 515 318 588],716,5,22964,4.521362472927741,40.0,0.0
45079,4,5079,[181 286 135 196 111],151,5,22969,4.521456692913386,0.0,20.0
45080,4,5080,[ 79 427 515 318 588],18,5,22974,4.521550875811848,40.0,0.0
45081,4,5081,[ 79 427 515 318 588],716,5,22979,4.521645021645021,40.0,0.0
45082,4,5082,[ 79 427 515 318 588],716,5,22984,4.521739130434782,40.0,0.0
45083,4,5083,[ 79 427 515 318 588],18,5,22989,4.5218332022029895,40.0,0.0
45084,4,5084,[ 79 427 515 318 588],716,5,22994,4.521927236971485,40.0,0.0
45085,4,5085,[ 15 597 127  82 300],796,4,22998,4.521824616594573,0.0,20.0
45086,4,5086,[ 79 427 515 318 588],18,5,23003,4.521918616080204,40.0,0.0
45087,4,5087,[496 168 143  25 588],18,3,23006,4.521619496855346,20.0,0.0
45088,4,5088,[ 79 427 515 318 588],807,5,23011,4.521713499705247,40.0,0.0
45089,4,5089,[423 118 143 161 174],577,3,23014,4.521414538310412,0.0,0.0
45090,4,5090,[ 79 427 515 318 588],807,5,23019,4.521508544490277,40.0,0.0
45091,4,5091,[ 79 427 515 318 588],807,5,23024,4.521602513747054,40.0,0.0
45092,4,5092,[186 603 194 269 301],450,4,23028,4.521500098173965,20.0,0.0
45093,4,5093,[ 79 427 515 318 588],18,5,23033,4.521594032194739,40.0,0.0
45094,4,5094,[ 79 427 515 318 588],716,5,23038,4.521687929342493,40.0,0.0
45095,4,5095,[ 79 427 515 318 588],716,5,23043,4.521781789638933,40.0,0.0
45096,4,5096,[ 79 427 515 318 588],18,5,23048,4.521875613105748,40.0,0.0
45097,4,5097,[153 603 286 655 197],450,5,23053,4.521969399764614,20.0,20.0
45098,4,5098,[ 79 427 515 318 588],716,5,23058,4.522063149637184,40.0,0.0
45099,4,5099,[ 79 427 515 318 588],18,5,23063,4.522156862745098,40.0,0.0
45100,4,5100,[ 79 427 515 318 588],18,5,23068,4.5222505391099785,40.0,0.0
45101,4,5101,[275 125 197  97 172],655,2,23070,4.521756174049393,0.0,20.0
45102,4,5102,[234 161  12 265 655],450,4,23074,4.521653929061337,0.0,0.0
45103,4,5103,[ 79 427 515 318 588],807,5,23079,4.521747648902822,40.0,0.0
45104,4,5104,[ 79 427 515 318 588],807,5,23084,4.521841332027424,40.0,0.0
45105,4,5105,[ 79 427 515 318 588],18,5,23089,4.521934978456717,40.0,0.0
45106,4,5106,[ 79 427 515 318 588],18,5,23094,4.522028588212257,40.0,0.0
45107,4,5107,[ 25 181  97  79 546],577,4,23098,4.521926389976508,0.0,0.0
45108,4,5108,[ 79 427 515 318 588],716,5,23103,4.522019964768057,40.0,0.0
45109,4,5109,[ 79 427 515 318 588],18,5,23108,4.5221135029354205,40.0,0.0
45110,4,5110,[ 79 427 515 318 588],716,5,23113,4.522207004500098,40.0,0.0
45111,4,5111,[568 222 143  15  28],457,5,23118,4.522300469483568,0.0,0.0
45112,4,5112,[ 79 427 515 318 588],18,5,23123,4.522393897907295,40.0,0.0
45113,4,5113,[ 79 427 515 318 588],18,5,23128,4.522487289792726,40.0,0.0
45114,4,5114,[187 742 127 228 195],693,2,23130,4.521994134897361,0.0,20.0
45115,4,5115,[ 96 568 135 222  88],280,2,23132,4.521501172791243,0.0,0.0
45116,4,5116,[ 79 427 515 318 588],807,5,23137,4.5215946843853825,40.0,0.0
45117,4,5117,[ 79 427 515 318 588],716,5,23142,4.52168815943728,40.0,0.0
45118,4,5118,[ 79 427 515 318 588],716,5,23147,4.521781597968353,40.0,0.0
45119,4,5119,[ 79 427 515 318 588],716,5,23152,4.521875,40.0,0.0
45120,4,5120,[ 79 427 515 318 588],716,5,23157,4.521968365553603,40.0,0.0
45121,4,5121,[ 79 427 515 318 588],807,5,23162,4.522061694650527,40.0,0.0
45122,4,5122,[ 79 427 515 318 588],18,5,23167,4.522154987312121,40.0,0.0
45123,4,5123,[ 79 427 515 318 588],807,5,23172,4.522248243559719,40.0,0.0
45124,4,5124,[ 70 100 286   8 423],330,5,23177,4.522341463414634,0.0,40.0
45125,4,5125,[ 79 427 515 318 588],807,5,23182,4.522434646898167,40.0,0.0
45126,4,5126,[ 96  69  88   8 496],344,3,23185,4.522137702360054,20.0,0.0
45127,4,5127,[234 117 180 748 245],280,2,23187,4.521645865834634,0.0,0.0
45128,4,5128,[ 79 427 515 318 588],807,5,23192,4.521739130434782,40.0,0.0
45129,4,5129,[  1 186 515  28 403],655,1,23193,4.521052631578947,0.0,0.0
45130,4,5130,[ 79 427 515 318 588],807,5,23198,4.521145975443384,40.0,0.0
45131,4,5131,[ 79 427 515 318 588],807,5,23203,4.521239282930631,40.0,0.0
45132,4,5132,[ 79 427 515 318 588],807,5,23208,4.521332554061952,40.0,0.0
45133,4,5133,[ 79 427 515 318 588],716,5,23213,4.52142578885859,40.0,0.0
45134,4,5134,[ 79 427 515 318 588],716,5,23218,4.521518987341772,40.0,0.0
45135,4,5135,[ 28 742 471  79 496],577,4,23222,4.521417445482866,20.0,0.0
45136,4,5136,[ 79 427 515 318 588],807,5,23227,4.521510609305042,40.0,0.0
45137,4,5137,[180  70 237 125 179],504,2,23229,4.521019852082523,0.0,0.0
45138,4,5138,[ 79 427 515 318 588],18,5,23234,4.521113057014984,40.0,0.0
45139,4,5139,[ 98 174 194 427  28],23,4,23238,4.521011673151751,20.0,0.0
45140,4,5140,[172 186  50 183 403],655,3,23241,4.52071581404396,0.0,20.0
45141,4,5141,[ 79 427 515 318 588],807,5,23246,4.520809023726176,40.0,0.0
45142,4,5142,[ 79 427 515 318 588],716,5,23251,4.52090219716119,40.0,0.0
45143,4,5143,[100 195 135 200 144],457,5,23256,4.52099533437014,0.0,20.0
45144,4,5144,[ 79 427 515 318 588],807,5,23261,4.52108843537415,40.0,0.0
45145,4,5145,[ 79 427 515 318 588],807,5,23266,4.521181500194325,40.0,0.0
45146,4,5146,[ 79 427 515 318 588],18,5,23271,4.521274528851758,40.0,0.0
45147,4,5147,[ 79 427 515 318 588],716,5,23276,4.521367521367521,40.0,0.0
45148,4,5148,[202 100 597  64 423],269,3,23279,4.521072052825791,20.0,20.0
45149,4,5149,[ 79 427 515 318 588],18,5,23284,4.521165048543689,40.0,0.0
45150,4,5150,[ 79 427 515 318 588],18,5,23289,4.521258008153756,40.0,0.0
45151,4,5151,[ 70 515  97 237 182],18,4,23293,4.521156832298137,0.0,0.0
45152,4,5152,[ 79 427 515 318 588],716,5,23298,4.5212497574228605,40.0,0.0
45153,4,5153,[ 79 427 515 318 588],716,5,23303,4.521342646488165,40.0,0.0
45154,4,5154,[174 318  69 125 210],504,5,23308,4.521435499515034,20.0,0.0
45155,4,5155,[ 79 427 515 318 588],18,5,23313,4.521528316524438,40.0,0.0
45156,4,5156,[ 79 427 515 318 588],807,5,23318,4.521621097537328,40.0,0.0
45157,4,5157,[ 79 427 515 318 588],807,5,23323,4.521713842574641,40.0,0.0
45158,4,5158,[ 79 427 515 318 588],18,5,23328,4.521806551657298,40.0,0.0
45159,4,5159,[ 79 427 515 318 588],807,5,23333,4.5218992248062015,40.0,0.0
45160,4,5160,[273 603 180 322 210],450,3,23336,4.521604340244139,20.0,0.0
45161,4,5161,[ 79 427 515 318 588],807,5,23341,4.521697016660209,40.0,0.0
45162,4,5162,[ 79 427 515 318 588],807,5,23346,4.52178965717606,40.0,0.0
45163,4,5163,[ 79 427 515 318 588],18,5,23351,4.521882261812548,40.0,0.0
45164,4,5164,[216  82 742 238  15],174,4,23355,4.521781219748306,0.0,0.0
45165,4,5165,[597  79  25 118 125],344,2,23357,4.521293070073558,0.0,0.0
45166,4,5166,[ 79 427 515 318 588],18,5,23362,4.521385717050513,40.0,0.0
45167,4,5167,[275 245 238 300 100],796,2,23364,4.5208978328173375,0.0,40.0
45168,4,5168,[ 79 427 515 318 588],716,5,23369,4.5209905204101375,40.0,0.0
45169,4,5169,[ 79 427 515 318 588],716,5,23374,4.5210831721470015,40.0,0.0
45170,4,5170,[ 79 427 515 318 588],18,5,23379,4.521175788048733,40.0,0.0
45171,4,5171,[ 79 427 515 318 588],18,5,23384,4.521268368136117,40.0,0.0
45172,4,5172,[ 79 427 515 318 588],18,5,23389,4.521360912429925,40.0,0.0
45173,4,5173,[ 79 427 515 318 588],807,5,23394,4.521453420950908,40.0,0.0
45174,4,5174,[ 79 427 515 318 588],18,5,23399,4.521545893719807,40.0,0.0
45175,4,5175,[ 88  79 127 597  89],344,3,23402,4.521251931993818,0.0,20.0
45176,4,5176,[ 79 427 515 318 588],18,5,23407,4.521344407958277,40.0,0.0
45177,4,5177,[ 79 427 515 318 588],807,5,23412,4.5214368482039395,40.0,0.0
45178,4,5178,[ 79 427 515 318 588],716,5,23417,4.521529252751496,40.0,0.0
45179,4,5179,[ 79 427 515 318 588],807,5,23422,4.521621621621621,40.0,0.0
45180,4,5180,[ 79 427 515 318 588],807,5,23427,4.521713954834974,40.0,0.0
45181,4,5181,[194 269 405 185 172],450,5,23432,4.521806252412196,0.0,0.0
45182,4,5182,[ 70 318   4 100 200],151,3,23435,4.521512637468647,20.0,20.0
45183,4,5183,[ 25 127 100  71 181],389,4,23439,4.521412037037037,0.0,40.0
45184,4,5184,[ 79 427 515 318 588],807,5,23444,4.521504339440694,40.0,0.0
45185,4,5185,[ 79 427 515 318 588],807,5,23449,4.52159660624759,40.0,0.0
45186,4,5186,[ 79 427 515 318 588],18,5,23454,4.521688837478311,40.0,0.0
45187,4,5187,[ 79 427 515 318 588],716,5,23459,4.521781033153431,40.0,0.0
45188,4,5188,[ 79 427 515 318 588],18,5,23464,4.521873193293506,40.0,0.0
45189,4,5189,[172 322  64 153 215],450,5,23469,4.521965317919075,20.0,0.0
45190,4,5190,[ 79 427 515 318 588],18,5,23474,4.5220574070506645,40.0,0.0
45191,4,5191,[187 603  15 357  64],796,5,23479,4.522149460708783,40.0,0.0
45192,4,5192,[496 182 318 276 238],269,5,23484,4.522241478913923,40.0,0.0
45193,4,5193,[ 79 427 515 318 588],807,5,23489,4.522333461686562,40.0,0.0
45194,4,5194,[ 79 427 515 318 588],18,5,23494,4.522425409047161,40.0,0.0
45195,4,5195,[ 79 427 515 318 588],807,5,23499,4.522517321016166,40.0,0.0
45196,4,5196,[ 79 427 515 318 588],18,5,23504,4.522609197614008,40.0,0.0
45197,4,5197,[ 79 427 515 318 588],716,5,23509,4.522701038861101,40.0,0.0
45198,4,5198,[423  89  88  79 175],151,5,23514,4.522792844777842,0.0,0.0
45199,4,5199,[ 79 427 515 318 588],716,5,23519,4.522884615384616,40.0,0.0
45200,4,5200,[237  15 174 210 191],269,1,23520,4.522207267833109,0.0,0.0
45201,4,5201,[ 79 427 515 318 588],807,5,23525,4.522299115724722,40.0,0.0
45202,4,5202,[ 79 427 515 318 588],18,5,23530,4.52239092831059,40.0,0.0
45203,4,5203,[ 79 427 515 318 588],807,5,23535,4.522482705611068,40.0,0.0
45204,4,5204,[ 79 427 515 318 588],807,5,23540,4.522574447646494,40.0,0.0
45205,4,5205,[ 79 427 515 318 588],807,5,23545,4.522666154437188,40.0,0.0
45206,4,5206,[ 79 427 515 318 588],18,5,23550,4.522757826003457,40.0,0.0
45207,4,5207,[ 79 427 515 318 588],716,5,23555,4.522849462365591,40.0,0.0
45208,4,5208,[ 79 427 515 318 588],807,5,23560,4.5229410635438665,40.0,0.0
45209,4,5209,[ 79 427 515 318 588],807,5,23565,4.523032629558541,40.0,0.0
45210,4,5210,[ 79 427 515 318 588],807,5,23570,4.52312416042986,40.0,0.0
45211,4,5211,[ 79 427 515 318 588],807,5,23575,4.523215656178051,40.0,0.0
45212,4,5212,[ 79 427 515 318 588],807,5,23580,4.523307116823326,40.0,0.0
45213,4,5213,[286 161  70 597  96],450,5,23585,4.523398542385884,0.0,20.0
45214,4,5214,[ 79 427 515 318 588],807,5,23590,4.523489932885906,40.0,0.0
45215,4,5215,[ 79 427 515 318 588],716,5,23595,4.523581288343558,40.0,0.0
45216,4,5216,[ 79 427 515 318 588],18,5,23600,4.523672608778992,40.0,0.0
45217,4,5217,[ 79 427 515 318 588],716,5,23605,4.523763894212342,40.0,0.0
45218,4,5218,[222  50 194 427 235],23,4,23609,4.523663537076068,20.0,20.0
45219,4,5219,[ 79 427 515 318 588],716,5,23614,4.52375478927203,40.0,0.0
45220,4,5220,[ 79 427 515 318 588],807,5,23619,4.523846006512162,40.0,0.0
45221,4,5221,[ 79 427 515 318 588],807,5,23624,4.523937188816546,40.0,0.0
45222,4,5222,[ 79 427 515 318 588],807,5,23629,4.524028336205246,40.0,0.0
45223,4,5223,[ 79 427 515 318 588],716,5,23634,4.524119448698316,40.0,0.0
45224,4,5224,[ 79 427 515 318 588],18,5,23639,4.524210526315789,40.0,0.0
45225,4,5225,[ 79 427 515 318 588],807,5,23644,4.524301569077688,40.0,0.0
45226,4,5226,[ 4 88 69 22 56],577,3,23647,4.524009948345131,0.0,0.0
45227,4,5227,[ 79 427 515 318 588],807,5,23652,4.524100994644224,40.0,0.0
45228,4,5228,[ 79 427 515 318 588],716,5,23657,4.524192006119717,40.0,0.0
45229,4,5229,[ 79 427 515 318 588],807,5,23662,4.524282982791587,40.0,0.0
45230,4,5230,[176 100 194 235   7],292,3,23665,4.523991588606385,0.0,20.0
45231,4,5231,[ 79 427 515 318 588],716,5,23670,4.52408256880734,40.0,0.0
45232,4,5232,[ 79 427 515 318 588],807,5,23675,4.524173514236575,40.0,0.0
45233,4,5233,[328 197 403 435 282],450,5,23680,4.524264424914024,0.0,0.0
45234,4,5234,[ 50 427 195 318 200],269,3,23683,4.523973256924546,40.0,20.0
45235,4,5235,[ 79 427 515 318 588],807,5,23688,4.524064171122995,40.0,0.0
45236,4,5236,[ 79 427 515 318 588],807,5,23693,4.52415505060149,40.0,0.0
45237,4,5237,[ 79 427 515 318 588],18,5,23698,4.524245895379916,40.0,0.0
45238,4,5238,[ 79 427 515 318 588],18,5,23703,4.524336705478144,40.0,0.0
45239,4,5239,[ 79 427 515 318 588],807,5,23708,4.524427480916031,40.0,0.0
45240,4,5240,[ 79 427 515 318 588],18,5,23713,4.5245182217134134,40.0,0.0
45241,4,5241,[186 475 427  79 181],503,4,23717,4.524418161007249,20.0,0.0
45242,4,5242,[ 79 427 515 318 588],807,5,23722,4.524508868968148,40.0,0.0
45243,4,5243,[ 79 427 515 318 588],807,5,23727,4.524599542334096,40.0,0.0
45244,4,5244,[191 151  15 313 176],796,5,23732,4.524690181124881,0.0,0.0
45245,4,5245,[ 79 427 515 318 588],18,5,23737,4.524780785360274,40.0,0.0
45246,4,5246,[ 79 427 515 318 588],18,5,23742,4.524871355060034,40.0,0.0
45247,4,5247,[427 257 176 186  56],716,3,23745,4.524580792682927,20.0,0.0
45248,4,5248,[ 79 427 515 318 588],807,5,23750,4.524671365974472,40.0,0.0
45249,4,5249,[ 79 427 515 318 588],716,5,23755,4.524761904761904,40.0,0.0
45250,4,5250,[ 79 427 515 318 588],716,5,23760,4.52485240906494,40.0,0.0
45251,4,5251,[ 11 385  56 127 182],457,5,23765,4.524942878903275,0.0,20.0
45252,4,5252,[ 79 427 515 318 588],716,5,23770,4.525033314296593,40.0,0.0
45253,4,5253,[ 79 427 515 318 588],716,5,23775,4.52512371526456,40.0,0.0
45254,4,5254,[ 79 427 515 318 588],716,5,23780,4.525214081826832,40.0,0.0
45255,4,5255,[ 79 427 515 318 588],716,5,23785,4.5253044140030445,40.0,0.0
45256,4,5256,[ 79 427 515 318 588],716,5,23790,4.525394711812821,40.0,0.0
45257,4,5257,[265  28 182 238 143],457,5,23795,4.52548497527577,0.0,0.0
45258,4,5258,[ 79 427 515 318 588],716,5,23800,4.525575204411485,40.0,0.0
45259,4,5259,[ 79 427 515 318 588],18,5,23805,4.525665399239544,40.0,0.0
45260,4,5260,[ 79 427 515 318 588],716,5,23810,4.525755559779509,40.0,0.0
45261,4,5261,[ 50 403 125  82 196],457,5,23815,4.525845686050931,0.0,20.0
45262,4,5262,[ 79 427 515 318 588],18,5,23820,4.525935778073342,40.0,0.0
45263,4,5263,[ 79 427 515 318 588],807,5,23825,4.526025835866261,40.0,0.0
45264,4,5264,[ 79 427 515 318 588],18,5,23830,4.526115859449193,40.0,0.0
45265,4,5265,[ 79 427 515 318 588],716,5,23835,4.5262058488416255,40.0,0.0
45266,4,5266,[ 50  56 100  28   7],577,3,23838,4.52591608126068,0.0,40.0
45267,4,5267,[ 79 427 515 318 588],716,5,23843,4.526006074411542,40.0,0.0
45268,4,5268,[211 265 135  96  88],450,4,23847,4.525906244069083,0.0,0.0
45269,4,5269,[ 97 127 403 143 655],450,5,23852,4.525996204933587,0.0,20.0
45270,4,5270,[ 79 427 515 318 588],716,5,23857,4.526086131663821,40.0,0.0
45271,4,5271,[228 742  89 182 186],457,5,23862,4.526176024279211,0.0,0.0
45272,4,5272,[ 79 427 515 318 588],18,5,23867,4.526265882799166,40.0,0.0
45273,4,5273,[ 79 427 515 318 588],807,5,23872,4.526355707243079,40.0,0.0
45274,4,5274,[ 79 427 515 318 588],716,5,23877,4.526445497630331,40.0,0.0
45275,4,5275,[185 200 180  88 257],504,4,23881,4.526345716451858,0.0,0.0
45276,4,5276,[161 182 302 176  15],450,4,23885,4.526245973090771,0.0,0.0
45277,4,5277,[ 79 427 515 318 588],716,5,23890,4.526335733232285,40.0,0.0
45278,4,5278,[ 79 427 515 318 588],716,5,23895,4.526425459367305,40.0,0.0
45279,4,5279,[435  11  79 191  88],450,5,23900,4.526515151515151,0.0,0.0
45280,4,5280,[ 79 427 515 318 588],716,5,23905,4.526604809695134,40.0,0.0
45281,4,5281,[ 79 427 515 318 588],18,5,23910,4.526694433926543,40.0,0.0
45282,4,5282,[588 483 200 173  69],796,5,23915,4.526784024228658,0.0,0.0
45283,4,5283,[ 79 427 515 318 588],807,5,23920,4.526873580620742,40.0,0.0
45284,4,5284,[ 79 427 515 318 588],716,5,23925,4.526963103122044,40.0,0.0
45285,4,5285,[202 211  88 216 318],716,5,23930,4.527052591751797,20.0,0.0
45286,4,5286,[ 79 427 515 318 588],716,5,23935,4.527142046529223,40.0,0.0
45287,4,5287,[ 79 427 515 318 588],18,5,23940,4.527231467473525,40.0,0.0
45288,4,5288,[ 79 427 515 318 588],18,5,23945,4.527320854603895,40.0,0.0
45289,4,5289,[ 79 427 515 318 588],18,5,23950,4.527410207939509,40.0,0.0
45290,4,5290,[405 195 173 235 197],280,1,23951,4.526743526743527,0.0,0.0
45291,4,5291,[ 79 427 515 318 588],18,5,23956,4.526832955404384,40.0,0.0
45292,4,5292,[ 79 427 515 318 588],716,5,23961,4.526922350273947,40.0,0.0
45293,4,5293,[ 79 427 515 318 588],807,5,23966,4.5270117113713635,40.0,0.0
45294,4,5294,[187 258 318 257  69],655,2,23968,4.526534466477809,20.0,0.0
45295,4,5295,[ 79 427 515 318 588],807,5,23973,4.526623867069486,40.0,0.0
45296,4,5296,[ 79 427 515 318 588],807,5,23978,4.526713233905984,40.0,0.0
45297,4,5297,[ 79 427 515 318 588],18,5,23983,4.526802567006418,40.0,0.0
45298,4,5298,[194 174 127 234   8],807,3,23986,4.526514436686167,0.0,20.0
45299,4,5299,[ 79 427 515 318 588],807,5,23991,4.526603773584906,40.0,0.0
45300,4,5300,[ 79 427 515 318 588],807,5,23996,4.526693076777966,40.0,0.0
45301,4,5301,[ 79 427 515 318 588],716,5,24001,4.5267823462844206,40.0,0.0
45302,4,5302,[ 79 427 515 318 588],807,5,24006,4.526871582123326,40.0,0.0
45303,4,5303,[ 79 427 515 318 588],18,5,24011,4.526960784313726,40.0,0.0
45304,4,5304,[ 79 427 515 318 588],18,5,24016,4.527049952874647,40.0,0.0
45305,4,5305,[237 234  56  28  15],796,3,24019,4.526762156049755,0.0,0.0
45306,4,5306,[ 79 427 515 318 588],716,5,24024,4.526851328434144,40.0,0.0
45307,4,5307,[ 79 427 515 318 588],807,5,24029,4.526940467219291,40.0,0.0
45308,4,5308,[ 79 427 515 318 588],18,5,24034,4.527029572424185,40.0,0.0
45309,4,5309,[ 79 427 515 318 588],716,5,24039,4.527118644067796,40.0,0.0
45310,4,5310,[ 79 427 515 318 588],18,5,24044,4.527207682169083,40.0,0.0
45311,4,5311,[ 79 427 515 318 588],18,5,24049,4.527296686746988,40.0,0.0
45312,4,5312,[ 79 427 515 318 588],716,5,24054,4.527385657820441,40.0,0.0
45313,4,5313,[ 79 427 515 318 588],18,5,24059,4.527474595408355,40.0,0.0
45314,4,5314,[179  98 176 200 204],504,2,24061,4.5269990592662275,0.0,0.0
45315,4,5315,[ 79 427 515 318 588],18,5,24066,4.527088036117381,40.0,0.0
45316,4,5316,[ 79 427 515 318 588],807,5,24071,4.527176979499718,40.0,0.0
45317,4,5317,[ 25 168 183 603 202],716,4,24075,4.5270778488153445,20.0,0.0
45318,4,5318,[ 79 427 515 318 588],18,5,24080,4.5271667606692985,40.0,0.0
45319,4,5319,[181  15 427 125 289],655,1,24081,4.526503759398496,20.0,0.0
45320,4,5320,[ 79 427 515 318 588],716,5,24086,4.526592745724487,40.0,0.0
45321,4,5321,[125 357 191 403 143],457,5,24091,4.526681698609545,0.0,0.0
45322,4,5322,[300 301  56 313 183],450,5,24096,4.526770618072516,0.0,0.0
45323,4,5323,[ 79 427 515 318 588],18,5,24101,4.526859504132231,40.0,0.0
45324,4,5324,[ 79 427 515 318 588],18,5,24106,4.5269483568075115,40.0,0.0
45325,4,5325,[234 423 294 286 269],450,4,24110,4.5268494179496805,0.0,20.0
45326,4,5326,[210 174 100 294  22],577,4,24114,4.526750516238033,0.0,20.0
45327,4,5327,[ 79 427 515 318 588],716,5,24119,4.52683933933934,40.0,0.0
45328,4,5328,[ 15 121 172 508 111],296,3,24122,4.526552824169638,0.0,0.0
45329,4,5329,[ 79 427 515 318 588],716,5,24127,4.526641651031895,40.0,0.0
45330,4,5330,[ 79 427 515 318 588],807,5,24132,4.526730444569499,40.0,0.0
45331,4,5331,[ 79 427 515 318 588],18,5,24137,4.526819204801201,40.0,0.0
45332,4,5332,[294 185  22  64  98],123,3,24140,4.526532908306769,20.0,0.0
45333,4,5333,[ 79 427 515 318 588],807,5,24145,4.526621672290964,40.0,0.0
45334,4,5334,[ 79 427 515 318 588],716,5,24150,4.526710402999063,40.0,0.0
45335,4,5335,[ 79 427 515 318 588],807,5,24155,4.526799100449775,40.0,0.0
45336,4,5336,[ 79 427 515 318 588],18,5,24160,4.526887764661795,40.0,0.0
45337,4,5337,[ 69 427  64 286   4],151,5,24165,4.5269763956538025,40.0,20.0
45338,4,5338,[282 202 313 276  98],280,2,24167,4.526503090466379,0.0,0.0
45339,4,5339,[186  97 200 121 185],655,2,24169,4.526029962546817,0.0,0.0
45340,4,5340,[313  22 195   9 269],655,1,24170,4.525369780939899,0.0,0.0
45341,4,5341,[ 79 427 515 318 588],18,5,24175,4.525458629726694,40.0,0.0
45342,4,5342,[ 79 427 515 318 588],807,5,24180,4.525547445255475,40.0,0.0
45343,4,5343,[ 69 210 655   7 194],629,4,24184,4.525449101796407,0.0,0.0
45344,4,5344,[144 237 568  15 238],655,0,24184,4.5246024321796074,0.0,0.0
45345,4,5345,[ 79 427 515 318 588],807,5,24189,4.5246913580246915,40.0,0.0
45346,4,5346,[ 79 427 515 318 588],716,5,24194,4.524780250607818,40.0,0.0
45347,4,5347,[ 79 427 515 318 588],807,5,24199,4.524869109947644,40.0,0.0
45348,4,5348,[ 79 427 515 318 588],716,5,24204,4.524957936062815,40.0,0.0
45349,4,5349,[ 79 427 515 318 588],716,5,24209,4.5250467289719625,40.0,0.0
45350,4,5350,[234 153 151 265 286],151,4,24213,4.524948607736872,0.0,20.0
45351,4,5351,[ 79 427 515 318 588],807,5,24218,4.525037369207773,40.0,0.0
45352,4,5352,[742 183 286 125 195],280,2,24220,4.524565664113581,0.0,20.0
45353,4,5353,[288  96  98 257  28],655,1,24221,4.523907358983937,0.0,0.0
45354,4,5354,[ 79 427 515 318 588],18,5,24226,4.523996265172736,40.0,0.0
45355,4,5355,[ 79 427 515 318 588],807,5,24231,4.524085138162808,40.0,0.0
45356,4,5356,[237 234 568 151 185],796,4,24235,4.523987306328169,0.0,0.0
45357,4,5357,[ 79 427 515 318 588],18,5,24240,4.524076147816349,40.0,0.0
45358,4,5358,[ 79 427 515 318 588],716,5,24245,4.524164956148535,40.0,0.0
45359,4,5359,[ 79 427 515 318 588],18,5,24250,4.524253731343284,40.0,0.0
45360,4,5360,[ 79 427 515 318 588],716,5,24255,4.524342473419138,40.0,0.0
45361,4,5361,[ 79 427 515 318 588],716,5,24260,4.524431182394629,40.0,0.0
45362,4,5362,[ 79 427 515 318 588],18,5,24265,4.524519858288271,40.0,0.0
45363,4,5363,[ 79 427 515 318 588],18,5,24270,4.524608501118569,40.0,0.0
45364,4,5364,[ 79 427 515 318 588],716,5,24275,4.5246971109040075,40.0,0.0
45365,4,5365,[196 185  12 265 423],655,1,24276,4.524040253447633,0.0,0.0
45366,4,5366,[282  71  88 286 546],280,3,24279,4.52375628842929,0.0,20.0
45367,4,5367,[318 276 100 204 174],280,2,24281,4.523286140089419,20.0,20.0
45368,4,5368,[ 79 427 515 318 588],18,5,24286,4.523374930154591,40.0,0.0
45369,4,5369,[ 79 427 515 318 588],18,5,24291,4.523463687150838,40.0,0.0
45370,4,5370,[ 79 427 515 318 588],18,5,24296,4.52355241109663,40.0,0.0
45371,4,5371,[ 79 427 515 318 588],807,5,24301,4.523641102010425,40.0,0.0
45372,4,5372,[ 79 427 515 318 588],716,5,24306,4.5237297599106645,40.0,0.0
45373,4,5373,[427   9 197 435  71],18,5,24311,4.52381838481578,20.0,0.0
45374,4,5374,[ 79 427 515 318 588],716,5,24316,4.523906976744186,40.0,0.0
45375,4,5375,[742  95 204  69 173],796,4,24320,4.523809523809524,0.0,0.0
45376,4,5376,[ 79 427 515 318 588],716,5,24325,4.523898084433699,40.0,0.0
45377,4,5377,[ 79 427 515 318 588],716,5,24330,4.5239866121234655,40.0,0.0
45378,4,5378,[ 79 427 515 318 588],18,5,24335,4.524075106897193,40.0,0.0
45379,4,5379,[ 79 427 515 318 588],716,5,24340,4.5241635687732344,40.0,0.0
45380,4,5380,[ 95 301 117 742 273],796,2,24342,4.523694480579818,0.0,0.0
45381,4,5381,[ 79 427 515 318 588],18,5,24347,4.52378298030472,40.0,0.0
45382,4,5382,[322  15 471 269 742],450,4,24351,4.523685677131711,0.0,0.0
45383,4,5383,[ 79 427 515 318 588],18,5,24356,4.523774145616642,40.0,0.0
45384,4,5384,[118 222 111 234 135],450,1,24357,4.523119777158774,0.0,0.0
45385,4,5385,[ 79 427 515 318 588],716,5,24362,4.523208317861122,40.0,0.0
45386,4,5386,[168 222  79 174 194],292,4,24366,4.523111193614256,0.0,0.0
45387,4,5387,[ 79 427 515 318 588],18,5,24371,4.523199703043801,40.0,0.0
45388,4,5388,[ 79 427 515 318 588],18,5,24376,4.523288179625163,40.0,0.0
45389,4,5389,[200 172 127 179 111],655,4,24380,4.523191094619666,0.0,20.0
45390,4,5390,[ 79 427 515 318 588],716,5,24385,4.52327953997403,40.0,0.0
45391,4,5391,[143 546 125 300 117],450,5,24390,4.523367952522255,0.0,0.0
45392,4,5392,[ 79 427 515 318 588],716,5,24395,4.5234563322825885,40.0,0.0
45393,4,5393,[ 79 427 515 318 588],807,5,24400,4.523544679273266,40.0,0.0
45394,4,5394,[ 79 427 515 318 588],18,5,24405,4.5236329935125115,40.0,0.0
45395,4,5395,[ 79 427 515 318 588],807,5,24410,4.5237212750185325,40.0,0.0
45396,4,5396,[ 79 427 515 318 588],18,5,24415,4.523809523809524,40.0,0.0
45397,4,5397,[ 79 427 515 318 588],807,5,24420,4.523897739903668,40.0,0.0
45398,4,5398,[ 79 427 515 318 588],716,5,24425,4.523985923319133,40.0,0.0
45399,4,5399,[ 15  95 181  11  56],577,2,24427,4.523518518518519,0.0,0.0
45400,4,5400,[ 79 427 515 318 588],716,5,24432,4.523606739492687,40.0,0.0
45401,4,5401,[ 79 427 515 318 588],18,5,24437,4.523694927804517,40.0,0.0
45402,4,5402,[257 427 125 238 153],296,5,24442,4.5237830834721455,20.0,0.0
45403,4,5403,[496 176 245  97 200],796,3,24445,4.523501110288675,20.0,0.0
45404,4,5404,[ 79 427 515 318 588],716,5,24450,4.52358926919519,40.0,0.0
45405,4,5405,[271 186 333 211 121],796,3,24453,4.52330743618202,0.0,0.0
45406,4,5406,[ 79 427 515 318 588],18,5,24458,4.523395598298502,40.0,0.0
45407,4,5407,[357   7 179 318 111],450,5,24463,4.523483727810651,20.0,0.0
45408,4,5408,[ 79 427 515 318 588],716,5,24468,4.523571824736551,40.0,0.0
45409,4,5409,[ 79 427 515 318 588],18,5,24473,4.52365988909427,40.0,0.0
45410,4,5410,[ 79 427 515 318 588],716,5,24478,4.523747920901867,40.0,0.0
45411,4,5411,[ 79 427 515 318 588],18,5,24483,4.523835920177383,40.0,0.0
45412,4,5412,[ 79 427 515 318 588],807,5,24488,4.523923886938851,40.0,0.0
45413,4,5413,[ 79 427 515 318 588],716,5,24493,4.524011821204285,40.0,0.0
45414,4,5414,[182 235 174 127 202],450,4,24497,4.523915050784857,0.0,20.0
45415,4,5415,[ 79 427 515 318 588],18,5,24502,4.524002954209749,40.0,0.0
45416,4,5416,[ 79 427 515 318 588],18,5,24507,4.5240908251799885,40.0,0.0
45417,4,5417,[ 79 427 515 318 588],18,5,24512,4.524178663713547,40.0,0.0
45418,4,5418,[ 79 427 515 318 588],716,5,24517,4.524266469828381,40.0,0.0
45419,4,5419,[ 79 427 515 318 588],807,5,24522,4.524354243542436,40.0,0.0
45420,4,5420,[ 79 427 515 318 588],807,5,24527,4.52444198487364,40.0,0.0
45421,4,5421,[ 79 427 515 318 588],18,5,24532,4.524529693839911,40.0,0.0
45422,4,5422,[597 173   7 286 748],450,5,24537,4.524617370459155,0.0,20.0
45423,4,5423,[ 79 427 515 318 588],807,5,24542,4.524705014749262,40.0,0.0
45424,4,5424,[302 153  56   9 185],151,3,24545,4.524423963133641,0.0,0.0
45425,4,5425,[121 168 603   9  97],535,5,24550,4.524511610762993,20.0,0.0
45426,4,5426,[ 79 427 515 318 588],807,5,24555,4.524599226091763,40.0,0.0
45427,4,5427,[ 79 427 515 318 588],807,5,24560,4.524686809137804,40.0,0.0
45428,4,5428,[742 286 322  70 183],450,5,24565,4.524774359918954,0.0,20.0
45429,4,5429,[385 257 405 216 161],23,3,24568,4.524493554327808,0.0,0.0
45430,4,5430,[ 79 427 515 318 588],18,5,24573,4.524581108451482,40.0,0.0
45431,4,5431,[ 79 427 515 318 588],807,5,24578,4.524668630338733,40.0,0.0
45432,4,5432,[ 79 427 515 318 588],18,5,24583,4.524756120007362,40.0,0.0
45433,4,5433,[ 50 405 183 197 118],716,3,24586,4.524475524475524,0.0,20.0
45434,4,5434,[ 79 427 515 318 588],807,5,24591,4.524563017479301,40.0,0.0
45435,4,5435,[273  15  79 144 238],450,3,24594,4.524282560706402,0.0,0.0
45436,4,5436,[ 79 427 515 318 588],18,5,24599,4.524370057016737,40.0,0.0
45437,4,5437,[ 79 427 515 318 588],807,5,24604,4.524457521147481,40.0,0.0
45438,4,5438,[ 79 427 515 318 588],18,5,24609,4.524544953116382,40.0,0.0
45439,4,5439,[ 79 427 515 318 588],716,5,24614,4.524632352941176,40.0,0.0
45440,4,5440,[ 79 427 515 318 588],716,5,24619,4.524719720639588,40.0,0.0
45441,4,5441,[603 111  12 182 204],450,5,24624,4.524807056229328,20.0,0.0
45442,4,5442,[ 79 427 515 318 588],18,5,24629,4.5248943597280915,40.0,0.0
45443,4,5443,[ 79 427 515 318 588],807,5,24634,4.5249816311535636,40.0,0.0
45444,4,5444,[318 191  15 215 174],835,5,24639,4.525068870523416,20.0,0.0
45445,4,5445,[ 79 427 515 318 588],807,5,24644,4.525156077855307,40.0,0.0
45446,4,5446,[655 183 118 161 273],693,0,24644,4.524325316688085,0.0,0.0
45447,4,5447,[ 79 427 515 318 588],716,5,24649,4.524412628487519,40.0,0.0
45448,4,5448,[ 79 427 515 318 588],18,5,24654,4.524499908240044,40.0,0.0
45449,4,5449,[ 79 427 515 318 588],716,5,24659,4.524587155963303,40.0,0.0
45450,4,5450,[ 79 427 515 318 588],18,5,24664,4.524674371674922,40.0,0.0
45451,4,5451,[ 79 427 515 318 588],716,5,24669,4.524761555392517,40.0,0.0
45452,4,5452,[ 79 427 515 318 588],716,5,24674,4.524848707133688,40.0,0.0
45453,4,5453,[174 423 210  98  70],639,2,24676,4.5243857719105245,0.0,0.0
45454,4,5454,[ 79 427 515 318 588],18,5,24681,4.524472960586618,40.0,0.0
45455,4,5455,[ 79 427 515 318 588],18,5,24686,4.524560117302053,40.0,0.0
45456,4,5456,[515 210  82  11 385],716,4,24690,4.524463991203958,0.0,0.0
45457,4,5457,[ 79 427 515 318 588],716,5,24695,4.524551117625504,40.0,0.0
45458,4,5458,[ 79 427 515 318 588],807,5,24700,4.524638212126763,40.0,0.0
45459,4,5459,[ 79 427 515 318 588],18,5,24705,4.524725274725275,40.0,0.0
45460,4,5460,[ 79 427 515 318 588],716,5,24710,4.524812305438564,40.0,0.0
45461,4,5461,[ 79 427 515 318 588],807,5,24715,4.524899304284145,40.0,0.0
45462,4,5462,[ 79 427 515 318 588],18,5,24720,4.524986271279516,40.0,0.0
45463,4,5463,[ 79 427 515 318 588],807,5,24725,4.525073206442167,40.0,0.0
45464,4,5464,[ 79 427 515 318 588],807,5,24730,4.52516010978957,40.0,0.0
45465,4,5465,[ 79 427 515 318 588],807,5,24735,4.525246981339188,40.0,0.0
45466,4,5466,[ 79 427 515 318 588],807,5,24740,4.525333821108469,40.0,0.0
45467,4,5467,[215   7   8 286 427],535,4,24744,4.525237746891002,20.0,20.0
45468,4,5468,[ 79 427 515 318 588],807,5,24749,4.525324556591698,40.0,0.0
45469,4,5469,[ 79 427 515 318 588],716,5,24754,4.5254113345521025,40.0,0.0
45470,4,5470,[328 318 405 435   4],655,1,24755,4.524766953025041,20.0,0.0
45471,4,5471,[ 79 427 515 318 588],18,5,24760,4.5248538011695905,40.0,0.0
45472,4,5472,[153 175 269  25 127],655,1,24761,4.524209756988855,0.0,20.0
45473,4,5473,[ 79 427 515 318 588],807,5,24766,4.524296675191816,40.0,0.0
45474,4,5474,[ 79 427 515 318 588],18,5,24771,4.524383561643836,40.0,0.0
45475,4,5475,[  4  88 132 271 333],796,5,24776,4.524470416362308,0.0,0.0
45476,4,5476,[ 79 427 515 318 588],716,5,24781,4.524557239364616,40.0,0.0
45477,4,5477,[ 79 427 515 318 588],18,5,24786,4.524644030668127,40.0,0.0
45478,4,5478,[ 79 427 515 318 588],716,5,24791,4.5247307902901985,40.0,0.0
45479,4,5479,[ 96  64 288 196 215],457,5,24796,4.524817518248176,20.0,0.0
45480,4,5480,[ 79 427 515 318 588],716,5,24801,4.524904214559387,40.0,0.0
45481,4,5481,[655 121 186  70 127],655,1,24802,4.524261218533382,0.0,20.0
45482,4,5482,[357  79  11 273 161],450,4,24806,4.524165602772205,0.0,0.0
45483,4,5483,[ 98 197 546 117 427],796,4,24810,4.524070021881838,20.0,0.0
45484,4,5484,[ 79 427 515 318 588],807,5,24815,4.524156791248861,40.0,0.0
45485,4,5485,[ 79 427 515 318 588],807,5,24820,4.524243528982866,40.0,0.0
45486,4,5486,[ 79 427 515 318 588],807,5,24825,4.524330235101148,40.0,0.0
45487,4,5487,[ 79 427 515 318 588],18,5,24830,4.524416909620991,40.0,0.0
45488,4,5488,[ 79 427 515 318 588],716,5,24835,4.524503552559665,40.0,0.0
45489,4,5489,[186 185  70 127  11],269,2,24837,4.524043715846995,0.0,20.0
45490,4,5490,[ 79 427 515 318 588],807,5,24842,4.524130395192133,40.0,0.0
45491,4,5491,[ 79 427 515 318 588],18,5,24847,4.524217042971595,40.0,0.0
45492,4,5492,[ 12 183 127 200 132],450,4,24851,4.524121609320954,0.0,20.0
45493,4,5493,[403 323  56 228   9],280,2,24853,4.5236621769202765,0.0,0.0
45494,4,5494,[ 79 427 515 318 588],807,5,24858,4.523748862602366,40.0,0.0
45495,4,5495,[ 79 427 515 318 588],716,5,24863,4.523835516739447,40.0,0.0
45496,4,5496,[144 568 125  82 194],796,4,24867,4.5237402219392395,0.0,0.0
45497,4,5497,[ 79 427 515 318 588],18,5,24872,4.523826846125864,40.0,0.0
45498,4,5498,[ 79 427 515 318 588],18,5,24877,4.523913438807056,40.0,0.0
45499,4,5499,[ 79 427 515 318 588],18,5,24882,4.524,40.0,0.0
45500,4,5500,[ 79 427 515 318 588],807,5,24887,4.524086529721869,40.0,0.0
45501,4,5501,[ 79 427 515 318 588],807,5,24892,4.524173027989822,40.0,0.0
45502,4,5502,[ 79 427 515 318 588],807,5,24897,4.524259494821007,40.0,0.0
45503,4,5503,[ 79 427 515 318 588],18,5,24902,4.524345930232558,40.0,0.0
45504,4,5504,[ 79 427 515 318 588],18,5,24907,4.524432334241599,40.0,0.0
45505,4,5505,[ 89 403  28 257 200],655,2,24909,4.523973846712677,0.0,0.0
45506,4,5506,[ 79 427 515 318 588],18,5,24914,4.524060286907572,40.0,0.0
45507,4,5507,[ 88 508 496  98  69],269,3,24917,4.523783587509078,20.0,0.0
45508,4,5508,[328  82  22 294 215],796,3,24920,4.523506988564168,0.0,0.0
45509,4,5509,[ 79 427 515 318 588],18,5,24925,4.523593466424682,40.0,0.0
45510,4,5510,[ 79 427 515 318 588],807,5,24930,4.5236799129014695,40.0,0.0
45511,4,5511,[ 79 427 515 318 588],807,5,24935,4.523766328011611,40.0,0.0
45512,4,5512,[ 79 427 515 318 588],807,5,24940,4.523852711772175,40.0,0.0
45513,4,5513,[ 79 427 515 318 588],18,5,24945,4.523939064200218,40.0,0.0
45514,4,5514,[ 79 427 515 318 588],807,5,24950,4.524025385312783,40.0,0.0
45515,4,5515,[ 79 427 515 318 588],807,5,24955,4.524111675126903,40.0,0.0
45516,4,5516,[118 271 132   8  12],796,5,24960,4.524197933659598,0.0,0.0
45517,4,5517,[ 79 427 515 318 588],716,5,24965,4.5242841609278726,40.0,0.0
45518,4,5518,[204  15 603 186 191],655,2,24967,4.523826780213807,20.0,0.0
45519,4,5519,[ 79 427 515 318 588],807,5,24972,4.523913043478261,40.0,0.0
45520,4,5520,[121  12 168 216  25],457,5,24977,4.52399927549357,0.0,0.0
45521,4,5521,[ 79 427 515 318 588],18,5,24982,4.524085476276712,40.0,0.0
45522,4,5522,[ 79 427 515 318 588],716,5,24987,4.52417164584465,40.0,0.0
45523,4,5523,[ 79 427 515 318 588],807,5,24992,4.524257784214337,40.0,0.0
45524,4,5524,[ 79 427 515 318 588],18,5,24997,4.524343891402715,40.0,0.0
45525,4,5525,[ 79 427 515 318 588],716,5,25002,4.52442996742671,40.0,0.0
45526,4,5526,[135  22 237  28 357],457,5,25007,4.524516012303239,0.0,0.0
45527,4,5527,[ 79 427 515 318 588],807,5,25012,4.524602026049204,40.0,0.0
45528,4,5528,[ 79 427 515 318 588],807,5,25017,4.524688008681498,40.0,0.0
45529,4,5529,[ 69 385 144  25 302],450,4,25021,4.524593128390597,0.0,0.0
45530,4,5530,[ 79 427 515 318 588],807,5,25026,4.524679081540409,40.0,0.0
45531,4,5531,[ 79 427 515 318 588],716,5,25031,4.524765003615329,40.0,0.0
45532,4,5532,[ 79 427 515 318 588],807,5,25036,4.524850894632206,40.0,0.0
45533,4,5533,[ 79 427 515 318 588],716,5,25041,4.524936754607879,40.0,0.0
45534,4,5534,[168  22 483 197 144],457,5,25046,4.525022583559169,0.0,0.0
45535,4,5535,[ 79 427 515 318 588],18,5,25051,4.52510838150289,40.0,0.0
45536,4,5536,[ 79 427 515 318 588],716,5,25056,4.525194148455842,40.0,0.0
45537,4,5537,[ 79 427 515 318 588],716,5,25061,4.525279884434814,40.0,0.0
45538,4,5538,[ 79 427 515 318 588],18,5,25066,4.52536558945658,40.0,0.0
45539,4,5539,[ 79 427 515 318 588],807,5,25071,4.5254512635379065,40.0,0.0
45540,4,5540,[ 79 427 515 318 588],18,5,25076,4.525536906695542,40.0,0.0
45541,4,5541,[269 322  11 435 200],629,2,25078,4.525081198123421,0.0,0.0
45542,4,5542,[ 79 427 515 318 588],716,5,25083,4.5251668771423414,40.0,0.0
45543,4,5543,[ 79 427 515 318 588],716,5,25088,4.525252525252525,40.0,0.0
45544,4,5544,[ 79 427 515 318 588],18,5,25093,4.525338142470694,40.0,0.0
45545,4,5545,[173 655 301  97 153],593,4,25097,4.52524341868013,0.0,0.0
45546,4,5546,[ 79 427 515 318 588],716,5,25102,4.5253290066702725,40.0,0.0
45547,4,5547,[546  64 211 234 100],151,3,25105,4.525054073540014,20.0,20.0
45548,4,5548,[423 195 275 235 258],457,4,25109,4.524959452153541,0.0,20.0
45549,4,5549,[ 79 427 515 318 588],716,5,25114,4.5250450450450455,40.0,0.0
45550,4,5550,[ 79 427 515 318 588],716,5,25119,4.52513060709782,40.0,0.0
45551,4,5551,[ 79 427 515 318 588],18,5,25124,4.52521613832853,40.0,0.0
45552,4,5552,[ 79 427 515 318 588],807,5,25129,4.5253016387538265,40.0,0.0
45553,4,5553,[ 28 125 427 182 143],18,3,25132,4.525027007562118,20.0,0.0
45554,4,5554,[ 79 427 515 318 588],18,5,25137,4.525112511251125,40.0,0.0
45555,4,5555,[286   9 127 174  82],796,2,25139,4.524658027357812,0.0,40.0
45556,4,5556,[ 79 427 515 318 588],716,5,25144,4.524743566672665,40.0,0.0
45557,4,5557,[ 12 182 282 144 168],450,5,25149,4.524829075206909,0.0,0.0
45558,4,5558,[ 79 427 515 318 588],807,5,25154,4.524914552977154,40.0,0.0
45559,4,5559,[ 79 427 515 318 588],807,5,25159,4.525,40.0,0.0
45560,4,5560,[132 200 180  15 238],450,3,25162,4.524725768746628,0.0,0.0
45561,4,5561,[ 79 427 515 318 588],807,5,25167,4.524811218985977,40.0,0.0
45562,4,5562,[ 95 328  64 195 333],796,5,25172,4.524896638504404,20.0,0.0
45563,4,5563,[ 79 427 515 318 588],807,5,25177,4.524982027318476,40.0,0.0
45564,4,5564,[187 238 265 302  82],655,2,25179,4.524528301886792,0.0,0.0
45565,4,5565,[ 79 427 515 318 588],807,5,25184,4.524613726194754,40.0,0.0
45566,4,5566,[ 79 427 515 318 588],716,5,25189,4.524699119813185,40.0,0.0
45567,4,5567,[200 191  11 210 483],655,3,25192,4.524425287356322,0.0,0.0
45568,4,5568,[ 79 427 515 318 588],807,5,25197,4.524510684144371,40.0,0.0
45569,4,5569,[ 79 427 515 318 588],18,5,25202,4.5245960502693,40.0,0.0
45570,4,5570,[ 79 427 515 318 588],18,5,25207,4.524681385747622,40.0,0.0
45571,4,5571,[202   1  88 282  50],716,4,25211,4.524587221823403,0.0,20.0
45572,4,5572,[ 79 427 515 318 588],18,5,25216,4.524672528261259,40.0,0.0
45573,4,5573,[ 79 427 515 318 588],716,5,25221,4.52475780409042,40.0,0.0
45574,4,5574,[ 79 427 515 318 588],807,5,25226,4.524843049327354,40.0,0.0
45575,4,5575,[ 79 427 515 318 588],807,5,25231,4.524928263988523,40.0,0.0
45576,4,5576,[ 79 427 515 318 588],716,5,25236,4.525013448090371,40.0,0.0
45577,4,5577,[ 79 427 515 318 588],716,5,25241,4.525098601649336,40.0,0.0
45578,4,5578,[ 11 300  64 127 423],716,5,25246,4.525183724681843,20.0,20.0
45579,4,5579,[385 196  88 121 172],593,5,25251,4.525268817204301,0.0,0.0
45580,4,5580,[ 79 427 515 318 588],807,5,25256,4.525353879233112,40.0,0.0
45581,4,5581,[333  88 215 257  64],796,5,25261,4.525438910784665,20.0,0.0
45582,4,5582,[ 79 427 515 318 588],716,5,25266,4.525523911875336,40.0,0.0
45583,4,5583,[ 79 427 515 318 588],18,5,25271,4.52560888252149,40.0,0.0
45584,4,5584,[276 127 546  70 286],280,5,25276,4.5256938227394805,0.0,40.0
45585,4,5585,[135 215 508  28 195],655,1,25277,4.525062656641604,0.0,0.0
45586,4,5586,[245 181 568 172 265],796,4,25281,4.524968677286558,0.0,0.0
45587,4,5587,[265 405 328 151  64],450,5,25286,4.52505368647101,20.0,0.0
45588,4,5588,[ 79 427 515 318 588],18,5,25291,4.525138665235284,40.0,0.0
45589,4,5589,[ 79 427 515 318 588],716,5,25296,4.525223613595706,40.0,0.0
45590,4,5590,[ 79 427 515 318 588],18,5,25301,4.525308531568593,40.0,0.0
45591,4,5591,[ 79 427 515 318 588],716,5,25306,4.525393419170244,40.0,0.0
45592,4,5592,[ 79 427 515 318 588],716,5,25311,4.525478276416949,40.0,0.0
45593,4,5593,[ 79 427 515 318 588],716,5,25316,4.525563103324991,40.0,0.0
45594,4,5594,[210 423  71 132 742],450,3,25319,4.525290437890974,0.0,0.0
45595,4,5595,[ 79 427 515 318 588],18,5,25324,4.525375268048606,40.0,0.0
45596,4,5596,[ 79 427 515 318 588],807,5,25329,4.525460067893515,40.0,0.0
45597,4,5597,[ 79 427 515 318 588],18,5,25334,4.525544837441943,40.0,0.0
45598,4,5598,[ 79 427 515 318 588],716,5,25339,4.525629576710127,40.0,0.0
45599,4,5599,[333 234 318 118  89],796,4,25343,4.525535714285715,20.0,0.0
45600,4,5600,[ 79 427 515 318 588],807,5,25348,4.525620424924121,40.0,0.0
45601,4,5601,[588 121  15  28  96],577,4,25352,4.525526597643698,0.0,0.0
45602,4,5602,[ 79 427 515 318 588],807,5,25357,4.525611279671605,40.0,0.0
45603,4,5603,[ 79 427 515 318 588],807,5,25362,4.525695931477516,40.0,0.0
45604,4,5604,[238 135 276   4 182],457,5,25367,4.52578055307761,0.0,0.0
45605,4,5605,[204 100  97 143 182],593,4,25371,4.525686764181234,0.0,20.0
45606,4,5606,[ 79 427 515 318 588],18,5,25376,4.525771357232031,40.0,0.0
45607,4,5607,[ 79 427 515 318 588],716,5,25381,4.525855920114123,40.0,0.0
45608,4,5608,[ 79 427 515 318 588],807,5,25386,4.525940452843644,40.0,0.0
45609,4,5609,[ 79 427 515 318 588],807,5,25391,4.5260249554367205,40.0,0.0
45610,4,5610,[ 79 427 515 318 588],716,5,25396,4.526109427909463,40.0,0.0
45611,4,5611,[ 79 427 515 318 588],18,5,25401,4.526193870277976,40.0,0.0
45612,4,5612,[286 202 276   1 435],401,3,25404,4.52592196686264,0.0,20.0
45613,4,5613,[ 50 289 228 357 216],655,3,25407,4.525650160313502,0.0,20.0
45614,4,5614,[ 15 423 143 435   7],269,1,25408,4.525022261798753,0.0,0.0
45615,4,5615,[181 132   8 655 275],655,1,25409,4.524394586894587,0.0,20.0
45616,4,5616,[ 79 427 515 318 588],18,5,25414,4.524479259391134,40.0,0.0
45617,4,5617,[ 79 427 515 318 588],716,5,25419,4.524563901744393,40.0,0.0
45618,4,5618,[ 79 427 515 318 588],716,5,25424,4.524648513970457,40.0,0.0
45619,4,5619,[ 79 427 515 318 588],18,5,25429,4.524733096085409,40.0,0.0
45620,4,5620,[161 183  28   8 655],457,5,25434,4.524817648105319,0.0,0.0
45621,4,5621,[ 79 427 515 318 588],716,5,25439,4.524902170046247,40.0,0.0
45622,4,5622,[ 79 427 515 318 588],716,5,25444,4.52498666192424,40.0,0.0
45623,4,5623,[ 79 427 515 318 588],807,5,25449,4.5250711237553345,40.0,0.0
45624,4,5624,[ 79 427 515 318 588],716,5,25454,4.525155555555555,40.0,0.0
45625,4,5625,[ 98 276 135  82 143],655,4,25458,4.52506221116246,0.0,0.0
45626,4,5626,[ 50 185 121 197   9],65,5,25463,4.525146614537054,0.0,20.0
45627,4,5627,[ 79 427 515 318 588],716,5,25468,4.525230987917555,40.0,0.0
45628,4,5628,[ 79 427 515 318 588],807,5,25473,4.52531533131995,40.0,0.0
45629,4,5629,[ 79 427 515 318 588],18,5,25478,4.525399644760213,40.0,0.0
45630,4,5630,[ 79 427 515 318 588],716,5,25483,4.525483928254307,40.0,0.0
45631,4,5631,[ 79 427 515 318 588],716,5,25488,4.525568181818182,40.0,0.0
45632,4,5632,[ 79 427 515 318 588],807,5,25493,4.525652405467779,40.0,0.0
45633,4,5633,[357 215  69 200  15],450,3,25496,4.525381611643592,0.0,0.0
45634,4,5634,[ 79 427 515 318 588],18,5,25501,4.525465838509317,40.0,0.0
45635,4,5635,[195 234  56 271   7],655,0,25501,4.524662881476225,0.0,0.0
45636,4,5636,[121 269 191  50 427],655,3,25504,4.524392407308852,20.0,20.0
45637,4,5637,[ 79 427 515 318 588],807,5,25509,4.524476764810216,40.0,0.0
45638,4,5638,[ 79 427 515 318 588],18,5,25514,4.524561092392268,40.0,0.0
45639,4,5639,[ 79 427 515 318 588],716,5,25519,4.524645390070922,40.0,0.0
45640,4,5640,[ 79 427 515 318 588],18,5,25524,4.524729657862081,40.0,0.0
45641,4,5641,[ 79 427 515 318 588],807,5,25529,4.524813895781637,40.0,0.0
45642,4,5642,[ 79 427 515 318 588],716,5,25534,4.524898103845472,40.0,0.0
45643,4,5643,[ 79 427 515 318 588],18,5,25539,4.5249822820694545,40.0,0.0
45644,4,5644,[ 79 427 515 318 588],716,5,25544,4.525066430469442,40.0,0.0
45645,4,5645,[ 79 427 515 318 588],716,5,25549,4.525150549061283,40.0,0.0
45646,4,5646,[ 79 427 515 318 588],716,5,25554,4.5252346378608115,40.0,0.0
45647,4,5647,[483 216 179 435 318],450,4,25558,4.52514164305949,20.0,0.0
45648,4,5648,[ 79 427 515 318 588],807,5,25563,4.525225703664366,40.0,0.0
45649,4,5649,[ 79 427 515 318 588],807,5,25568,4.525309734513274,40.0,0.0
45650,4,5650,[ 79 427 515 318 588],716,5,25573,4.525393735622014,40.0,0.0
45651,4,5651,[ 79 427 515 318 588],18,5,25578,4.525477707006369,40.0,0.0
45652,4,5652,[ 79 427 515 318 588],716,5,25583,4.525561648682116,40.0,0.0
45653,4,5653,[ 79 427 515 318 588],807,5,25588,4.525645560665016,40.0,0.0
45654,4,5654,[ 79 427 515 318 588],18,5,25593,4.525729442970822,40.0,0.0
45655,4,5655,[ 98 245  89 258 385],344,2,25595,4.5252828854314,0.0,0.0
45656,4,5656,[ 79 427 515 318 588],716,5,25600,4.525366802191974,40.0,0.0
45657,4,5657,[111 182 216 301 238],450,5,25605,4.525450689289501,0.0,0.0
45658,4,5658,[ 79 427 515 318 588],18,5,25610,4.525534546739706,40.0,0.0
45659,4,5659,[ 79 427 515 318 588],807,5,25615,4.525618374558304,40.0,0.0
45660,4,5660,[ 79 427 515 318 588],716,5,25620,4.5257021727609965,40.0,0.0
45661,4,5661,[ 79 427 515 318 588],18,5,25625,4.525785941363476,40.0,0.0
45662,4,5662,[ 79 427 515 318 588],716,5,25630,4.525869680381423,40.0,0.0
45663,4,5663,[ 79 427 515 318 588],18,5,25635,4.525953389830509,40.0,0.0
45664,4,5664,[216 318  79 195  28],18,3,25638,4.525684024713151,20.0,0.0
45665,4,5665,[ 79 427 515 318 588],18,5,25643,4.5257677373808685,40.0,0.0
45666,4,5666,[ 79 427 515 318 588],18,5,25648,4.525851420504676,40.0,0.0
45667,4,5667,[ 79 427 515 318 588],716,5,25653,4.525935074100212,40.0,0.0
45668,4,5668,[215 185 603 748  22],796,5,25658,4.526018698183101,20.0,0.0
45669,4,5669,[ 79 427 515 318 588],18,5,25663,4.526102292768959,40.0,0.0
45670,4,5670,[ 79 427 515 318 588],18,5,25668,4.526185857873391,40.0,0.0
45671,4,5671,[ 79 427 515 318 588],716,5,25673,4.526269393511988,40.0,0.0
45672,4,5672,[ 79 427 515 318 588],716,5,25678,4.526352899700335,40.0,0.0
45673,4,5673,[ 79 427 515 318 588],18,5,25683,4.526436376454001,40.0,0.0
45674,4,5674,[200 197 405 161 265],450,4,25687,4.526343612334802,0.0,0.0
45675,4,5675,[ 79 427 515 318 588],716,5,25692,4.526427061310782,40.0,0.0
45676,4,5676,[197 183 187 357 111],269,3,25695,4.526158182138453,0.0,0.0
45677,4,5677,[333 234  79 265 427],796,4,25699,4.52606551602677,20.0,0.0
45678,4,5678,[ 79 427 515 318 588],807,5,25704,4.526148969889065,40.0,0.0
45679,4,5679,[294 265 191  82 427],655,2,25706,4.525704225352112,20.0,0.0
45680,4,5680,[ 79 427 515 318 588],716,5,25711,4.525787713430734,40.0,0.0
45681,4,5681,[ 79 427 515 318 588],807,5,25716,4.525871172122492,40.0,0.0
45682,4,5682,[ 79 427 515 318 588],18,5,25721,4.5259546014428995,40.0,0.0
45683,4,5683,[ 79 427 515 318 588],716,5,25726,4.52603800140746,40.0,0.0
45684,4,5684,[385 597 194 118 237],457,4,25730,4.5259454705365,0.0,0.0
45685,4,5685,[357  95  70 135 302],450,3,25733,4.525677101653184,0.0,0.0
45686,4,5686,[ 79 427 515 318 588],716,5,25738,4.5257605064181465,40.0,0.0
45687,4,5687,[ 79 427 515 318 588],807,5,25743,4.52584388185654,40.0,0.0
45688,4,5688,[ 79 427 515 318 588],716,5,25748,4.5259272279838285,40.0,0.0
45689,4,5689,[ 79 427 515 318 588],807,5,25753,4.526010544815466,40.0,0.0
45690,4,5690,[ 79 427 515 318 588],18,5,25758,4.526093832366895,40.0,0.0
45691,4,5691,[282 182  88 185  56],655,2,25760,4.525650035137034,0.0,0.0
45692,4,5692,[ 79 427 515 318 588],716,5,25765,4.525733356753908,40.0,0.0
45693,4,5693,[ 79 427 515 318 588],807,5,25770,4.52581664910432,40.0,0.0
45694,4,5694,[ 79 427 515 318 588],18,5,25775,4.525899912203688,40.0,0.0
45695,4,5695,[ 79 427 515 318 588],716,5,25780,4.525983146067416,40.0,0.0
45696,4,5696,[ 79 427 515 318 588],716,5,25785,4.5260663507109005,40.0,0.0
45697,4,5697,[ 82 200 403 121 191],655,2,25787,4.525623025623026,0.0,0.0
45698,4,5698,[ 79 427 515 318 588],18,5,25792,4.525706264256887,40.0,0.0
45699,4,5699,[ 79 427 515 318 588],716,5,25797,4.525789473684211,40.0,0.0
45700,4,5700,[ 79 427 515 318 588],716,5,25802,4.525872653920365,40.0,0.0
45701,4,5701,[ 79 427 515 318 588],18,5,25807,4.5259558049807085,40.0,0.0
45702,4,5702,[483 471  69   7 313],280,3,25810,4.5256882342626685,0.0,0.0
45703,4,5703,[210 100 135 117 197],72,5,25815,4.525771388499299,0.0,20.0
45704,4,5704,[ 79 427 515 318 588],716,5,25820,4.525854513584575,40.0,0.0
45705,4,5705,[ 79 427 515 318 588],18,5,25825,4.525937609533824,40.0,0.0
45706,4,5706,[216 197 202  56 597],450,5,25830,4.526020676362362,0.0,0.0
45707,4,5707,[427 175 118 238 235],716,2,25832,4.525578135949544,20.0,0.0
45708,4,5708,[ 79 427 515 318 588],716,5,25837,4.525661236643896,40.0,0.0
45709,4,5709,[265  96  89 655 185],457,5,25842,4.5257443082311735,0.0,0.0
45710,4,5710,[ 79 427 515 318 588],18,5,25847,4.525827350726668,40.0,0.0
45711,4,5711,[185 168  79  95  64],796,5,25852,4.525910364145658,20.0,0.0
45712,4,5712,[ 79 427 515 318 588],18,5,25857,4.525993348503413,40.0,0.0
45713,4,5713,[ 79 427 515 318 588],716,5,25862,4.5260763038151905,40.0,0.0
45714,4,5714,[265 275 197 216 175],878,3,25865,4.52580927384077,0.0,20.0
45715,4,5715,[174 180 496 111 172],280,3,25868,4.52554233729881,20.0,0.0
45716,4,5716,[ 79 427 515 318 588],807,5,25873,4.525625327969214,40.0,0.0
45717,4,5717,[ 79 427 515 318 588],807,5,25878,4.525708289611752,40.0,0.0
45718,4,5718,[ 79 427 515 318 588],18,5,25883,4.525791222241651,40.0,0.0
45719,4,5719,[ 79 427 515 318 588],716,5,25888,4.525874125874126,40.0,0.0
45720,4,5720,[ 79 427 515 318 588],18,5,25893,4.525957000524384,40.0,0.0
45721,4,5721,[ 70 405 471 191 216],655,2,25895,4.525515554002097,0.0,0.0
45722,4,5722,[ 79 427 515 318 588],18,5,25900,4.525598462344924,40.0,0.0
45723,4,5723,[172 471 275  50 234],457,5,25905,4.5256813417190775,0.0,40.0
45724,4,5724,[ 79 427 515 318 588],807,5,25910,4.525764192139738,40.0,0.0
45725,4,5725,[200  25 245 183  22],450,3,25913,4.525497729654209,0.0,0.0
45726,4,5726,[ 79 427 515 318 588],18,5,25918,4.525580583202375,40.0,0.0
45727,4,5727,[ 79 427 515 318 588],807,5,25923,4.525663407821229,40.0,0.0
45728,4,5728,[ 79 427 515 318 588],716,5,25928,4.52574620352592,40.0,0.0
45729,4,5729,[ 79 427 515 318 588],807,5,25933,4.525828970331588,40.0,0.0
45730,4,5730,[ 79 427 515 318 588],18,5,25938,4.525911708253359,40.0,0.0
45731,4,5731,[588 111 196 322 228],344,4,25942,4.525819958129798,0.0,0.0
45732,4,5732,[ 79 427 515 318 588],18,5,25947,4.525902668759811,40.0,0.0
45733,4,5733,[ 79 427 515 318 588],18,5,25952,4.525985350540635,40.0,0.0
45734,4,5734,[ 79 427 515 318 588],807,5,25957,4.526068003487358,40.0,0.0
45735,4,5735,[ 79 427 515 318 588],18,5,25962,4.5261506276150625,40.0,0.0
45736,4,5736,[ 79 427 515 318 588],18,5,25967,4.526233222938818,40.0,0.0
45737,4,5737,[ 79 427 515 318 588],716,5,25972,4.526315789473684,40.0,0.0
45738,4,5738,[ 79 427 515 318 588],807,5,25977,4.52639832723471,40.0,0.0
45739,4,5739,[423  50 151 385 269],23,3,25980,4.526132404181185,0.0,20.0
45740,4,5740,[ 70  79 181  50 273],344,3,25983,4.525866573767637,0.0,20.0
45741,4,5741,[ 79 427 515 318 588],18,5,25988,4.525949146638802,40.0,0.0
45742,4,5742,[ 79 427 515 318 588],716,5,25993,4.526031690753961,40.0,0.0
45743,4,5743,[258 328 603 132 176],151,3,25996,4.525766016713092,20.0,0.0
45744,4,5744,[238  69 508 111 187],655,1,25997,4.525152306353351,0.0,0.0
45745,4,5745,[ 79 427 515 318 588],807,5,26002,4.525234946049426,40.0,0.0
45746,4,5746,[ 79 427 515 318 588],18,5,26007,4.525317556986254,40.0,0.0
45747,4,5747,[ 79 427 515 318 588],807,5,26012,4.525400139178845,40.0,0.0
45748,4,5748,[172 300  82  64 301],796,3,26015,4.525134806053226,20.0,0.0
45749,4,5749,[ 88 153  56 185 151],796,5,26020,4.525217391304348,0.0,0.0
45750,4,5750,[ 97 161 121 265 143],457,5,26025,4.525299947835159,0.0,0.0
45751,4,5751,[161 273 313  70 100],655,2,26027,4.524860917941585,0.0,20.0
45752,4,5752,[ 98  89 187 257 405],796,5,26032,4.524943507735094,0.0,0.0
45753,4,5753,[ 79 427 515 318 588],18,5,26037,4.525026068821689,40.0,0.0
45754,4,5754,[323 172 568 215 204],280,0,26037,4.524239791485664,0.0,0.0
45755,4,5755,[ 79 427 515 318 588],18,5,26042,4.524322446143155,40.0,0.0
45756,4,5756,[ 79 427 515 318 588],18,5,26047,4.524405072086156,40.0,0.0
45757,4,5757,[ 79 427 515 318 588],18,5,26052,4.524487669329629,40.0,0.0
45758,4,5758,[ 88 204 318 228 748],151,4,26056,4.52439659663136,20.0,0.0
45759,4,5759,[ 79 427 515 318 588],18,5,26061,4.524479166666667,40.0,0.0
45760,4,5760,[202 423  25 245 151],450,4,26065,4.5243881270612745,0.0,0.0
45761,4,5761,[234 288 427 228  96],450,3,26068,4.524123568205484,20.0,0.0
45762,4,5762,[ 79 427 515 318 588],716,5,26073,4.5242061426340445,40.0,0.0
45763,4,5763,[655 237  50  70 176],269,1,26074,4.523594725884802,0.0,20.0
45764,4,5764,[125 282 655  12 187],655,1,26075,4.522983521248916,0.0,0.0
45765,4,5765,[179 268 172  11  79],535,2,26077,4.5225459590704125,0.0,0.0
45766,4,5766,[427 515 318  79 588],807,5,26082,4.52262874978325,40.0,0.0
45767,4,5767,[427 515 318  79 588],716,5,26087,4.522711511789182,40.0,0.0
45768,4,5768,[427 515 318  79 588],716,5,26092,4.522794245103137,40.0,0.0
45769,4,5769,[427 515 318  79 588],716,5,26097,4.522876949740034,40.0,0.0
45770,4,5770,[427 515 318  79 588],716,5,26102,4.522959625714781,40.0,0.0
45771,4,5771,[427 515 318  79 588],716,5,26107,4.5230422730422735,40.0,0.0
45772,4,5772,[427 515 318  79 588],18,5,26112,4.523124891737398,40.0,0.0
45773,4,5773,[427 515 318  79 588],716,5,26117,4.5232074818150325,40.0,0.0
45774,4,5774,[427 515 318  79 588],18,5,26122,4.523290043290043,40.0,0.0
45775,4,5775,[427 515 318  79 588],716,5,26127,4.523372576177286,40.0,0.0
45776,4,5776,[427 515 318  79 588],807,5,26132,4.523455080491605,40.0,0.0
45777,4,5777,[427 515 318  79 588],716,5,26137,4.523537556247836,40.0,0.0
45778,4,5778,[228  22 173 172 257],796,5,26142,4.523620003460806,0.0,0.0
45779,4,5779,[427 515 318  79 588],807,5,26147,4.523702422145329,40.0,0.0
45780,4,5780,[427 515 318  79 588],716,5,26152,4.523784812316208,40.0,0.0
45781,4,5781,[427 515 318  79 588],716,5,26157,4.523867173988239,40.0,0.0
45782,4,5782,[427 515 318  79 588],716,5,26162,4.523949507176206,40.0,0.0
45783,4,5783,[ 89 333 423  50   8],655,2,26164,4.523513139695712,0.0,20.0
45784,4,5784,[427 515 318  79 588],807,5,26169,4.523595505617978,40.0,0.0
45785,4,5785,[588  98 546 191 204],796,5,26174,4.523677843069478,0.0,0.0
45786,4,5786,[385 403  95  88 265],280,3,26177,4.523414549853119,0.0,0.0
45787,4,5787,[427 515 318  79 588],18,5,26182,4.523496890117484,40.0,0.0
45788,4,5788,[427 515 318  79 588],807,5,26187,4.523579201934703,40.0,0.0
45789,4,5789,[117 210 100 174 588],330,5,26192,4.523661485319517,0.0,20.0
45790,4,5790,[427 515 318  79 588],807,5,26197,4.523743740286652,40.0,0.0
45791,4,5791,[427 515 318  79 588],716,5,26202,4.523825966850829,40.0,0.0
45792,4,5792,[ 97 118 275 179 153],655,2,26204,4.5233902986362855,0.0,20.0
45793,4,5793,[427 515 318  79 588],716,5,26209,4.523472557818433,40.0,0.0
45794,4,5794,[427 515 318  79 588],807,5,26214,4.523554788610872,40.0,0.0
45795,4,5795,[ 70 237 385 678  50],280,2,26216,4.5231193926846105,0.0,20.0
45796,4,5796,[427 515 318  79 588],716,5,26221,4.523201656028981,40.0,0.0
45797,4,5797,[427 515 318  79 588],716,5,26226,4.523283890996895,40.0,0.0
45798,4,5798,[215  50 588  25 210],18,3,26229,4.5230212105535434,0.0,20.0
45799,4,5799,[427 515 318  79 588],716,5,26234,4.523103448275862,40.0,0.0
45800,4,5800,[427 515 318  79 588],18,5,26239,4.523185657645233,40.0,0.0
45801,4,5801,[427 515 318  79 588],18,5,26244,4.523267838676318,40.0,0.0
45802,4,5802,[427 515 318  79 588],18,5,26249,4.523349991383767,40.0,0.0
45803,4,5803,[235 496 286  64 435],450,4,26253,4.523259820813232,40.0,20.0
45804,4,5804,[ 22 273 172  98 405],450,4,26257,4.523169681309216,0.0,0.0
45805,4,5805,[ 95 328 228 161 183],796,5,26262,4.523251808473993,0.0,0.0
45806,4,5806,[405  89  69  98 238],457,5,26267,4.523333907353194,0.0,0.0
45807,4,5807,[286 168 245 300  28],450,5,26272,4.523415977961433,0.0,20.0
45808,4,5808,[427 515 318  79 588],716,5,26277,4.523498020313307,40.0,0.0
45809,4,5809,[427 515 318  79 588],18,5,26282,4.523580034423408,40.0,0.0
45810,4,5810,[ 98 276 195 168  79],18,3,26285,4.523317845465496,0.0,0.0
45811,4,5811,[237   8  88 275 186],796,4,26289,4.523227804542326,0.0,20.0
45812,4,5812,[202 289 328  88  97],655,0,26289,4.522449681747807,0.0,0.0
45813,4,5813,[427 515 318  79 588],18,5,26294,4.522531819745442,40.0,0.0
45814,4,5814,[427 515 318  79 588],18,5,26299,4.5226139294926915,40.0,0.0
45815,4,5815,[385 168   9   8 405],457,5,26304,4.522696011004126,0.0,0.0
45816,4,5816,[427 515 318  79 588],18,5,26309,4.52277806429431,40.0,0.0
45817,4,5817,[427 515 318  79 588],807,5,26314,4.522860089377793,40.0,0.0
45818,4,5818,[427 515 318  79 588],18,5,26319,4.5229420862691185,40.0,0.0
45819,4,5819,[258 655 216 282  98],796,4,26323,4.522852233676976,0.0,0.0
45820,4,5820,[427 515 318  79 588],18,5,26328,4.522934203745061,40.0,0.0
45821,4,5821,[427 515 318  79 588],807,5,26333,4.523016145654414,40.0,0.0
45822,4,5822,[427 515 318  79 588],807,5,26338,4.523098059419543,40.0,0.0
45823,4,5823,[427 515 318  79 588],18,5,26343,4.523179945054945,40.0,0.0
45824,4,5824,[427 515 318  79 588],807,5,26348,4.5232618025751075,40.0,0.0
45825,4,5825,[427 515 318  79 588],716,5,26353,4.523343631994507,40.0,0.0
45826,4,5826,[282  79 176   8 313],655,2,26355,4.5229105886390935,0.0,0.0
45827,4,5827,[427 515 318  79 588],807,5,26360,4.52299245024022,40.0,0.0
45828,4,5828,[427 515 318  79 588],18,5,26365,4.523074283753646,40.0,0.0
45829,4,5829,[427 515 318  79 588],716,5,26370,4.523156089193825,40.0,0.0
45830,4,5830,[182 127  82  71 181],389,5,26375,4.523237866575202,0.0,20.0
45831,4,5831,[427 515 318  79 588],807,5,26380,4.523319615912208,40.0,0.0
45832,4,5832,[427 515 318  79 588],807,5,26385,4.52340133721927,40.0,0.0
45833,4,5833,[655 546  12 742 322],280,4,26389,4.523311621528968,0.0,0.0
45834,4,5834,[427 515 318  79 588],18,5,26394,4.5233933161953725,40.0,0.0
45835,4,5835,[427 515 318  79 588],716,5,26399,4.523474982864976,40.0,0.0
45836,4,5836,[ 71 235 568 301  96],344,3,26402,4.523213979784136,0.0,0.0
45837,4,5837,[427 515 318  79 588],807,5,26407,4.52329564919493,40.0,0.0
45838,4,5838,[427 515 318  79 588],807,5,26412,4.523377290631958,40.0,0.0
45839,4,5839,[427 515 318  79 588],807,5,26417,4.523458904109589,40.0,0.0
45840,4,5840,[427 515 318  79 588],716,5,26422,4.523540489642184,40.0,0.0
45841,4,5841,[427 515 318  79 588],716,5,26427,4.5236220472440944,40.0,0.0
45842,4,5842,[427 515 318  79 588],807,5,26432,4.52370357692966,40.0,0.0
45843,4,5843,[427 515 318  79 588],807,5,26437,4.52378507871321,40.0,0.0
45844,4,5844,[275  22 118 271 568],655,1,26438,4.523182207014543,0.0,20.0
45845,4,5845,[427 515 318  79 588],716,5,26443,4.523263770099213,40.0,0.0
45846,4,5846,[427 515 318  79 588],18,5,26448,4.523345305284761,40.0,0.0
45847,4,5847,[118 200 144 186 286],450,2,26450,4.522913816689466,0.0,20.0
45848,4,5848,[427 515 318  79 588],18,5,26455,4.522995383826295,40.0,0.0
45849,4,5849,[427 515 318  79 588],18,5,26460,4.523076923076923,40.0,0.0
45850,4,5850,[179 117 127 483 322],450,4,26464,4.522987523500256,0.0,20.0
45851,4,5851,[427 515 318  79 588],18,5,26469,4.523069036226931,40.0,0.0
45852,4,5852,[427 515 318  79 588],18,5,26474,4.52315052110029,40.0,0.0
45853,4,5853,[ 98 269 117 496 173],796,4,26478,4.523061154765972,20.0,0.0
45854,4,5854,[427 515 318  79 588],716,5,26483,4.523142613151153,40.0,0.0
45855,4,5855,[300 471 182  70 143],655,2,26485,4.5227117486338795,0.0,0.0
45856,4,5856,[427 515 318  79 588],716,5,26490,4.522793238859484,40.0,0.0
45857,4,5857,[427 515 318  79 588],18,5,26495,4.5228747012632295,40.0,0.0
45858,4,5858,[427 515 318  79 588],18,5,26500,4.522956135859362,40.0,0.0
45859,4,5859,[427 515 318  79 588],807,5,26505,4.523037542662116,40.0,0.0
45860,4,5860,[427 515 318  79 588],716,5,26510,4.523118921685719,40.0,0.0
45861,4,5861,[196  69 423 173  22],629,5,26515,4.523200272944387,0.0,0.0
45862,4,5862,[427 515 318  79 588],18,5,26520,4.523281596452328,40.0,0.0
45863,4,5863,[427 515 318  79 588],716,5,26525,4.523362892223738,40.0,0.0
45864,4,5864,[286 265 117 597 403],796,4,26529,4.523273657289002,0.0,20.0
45865,4,5865,[427 515 318  79 588],807,5,26534,4.523354926696215,40.0,0.0
45866,4,5866,[427 515 318  79 588],18,5,26539,4.523436168399523,40.0,0.0
45867,4,5867,[427 515 318  79 588],716,5,26544,4.523517382413088,40.0,0.0
45868,4,5868,[111  96 228 275 282],655,1,26545,4.522917021639121,0.0,20.0
45869,4,5869,[427 515 318  79 588],716,5,26550,4.522998296422487,40.0,0.0
45870,4,5870,[405 435 144  98   1],450,5,26555,4.523079543518992,0.0,0.0
45871,4,5871,[427 515 318  79 588],807,5,26560,4.523160762942779,40.0,0.0
45872,4,5872,[427 515 318  79 588],807,5,26565,4.523241954707986,40.0,0.0
45873,4,5873,[427 515 318  79 588],807,5,26570,4.523323118828737,40.0,0.0
45874,4,5874,[471 313 546 172 222],693,1,26571,4.522723404255319,0.0,0.0
45875,4,5875,[427 515 318  79 588],807,5,26576,4.522804628999319,40.0,0.0
45876,4,5876,[427 515 318  79 588],716,5,26581,4.522885826101753,40.0,0.0
45877,4,5877,[427 515 318  79 588],807,5,26586,4.522966995576727,40.0,0.0
45878,4,5878,[427 515 318  79 588],716,5,26591,4.52304813743834,40.0,0.0
45879,4,5879,[427 515 318  79 588],18,5,26596,4.523129251700681,40.0,0.0
45880,4,5880,[427 515 318  79 588],807,5,26601,4.523210338377827,40.0,0.0
45881,4,5881,[313 181 275 204 191],344,3,26604,4.522951377082625,0.0,20.0
45882,4,5882,[427 515 318  79 588],807,5,26609,4.523032466428693,40.0,0.0
45883,4,5883,[427 515 318  79 588],807,5,26614,4.5231135282121,40.0,0.0
45884,4,5884,[ 25 210  79  89 286],151,5,26619,4.523194562446899,0.0,20.0
45885,4,5885,[427 515 318  79 588],716,5,26624,4.5232755691471285,40.0,0.0
45886,4,5886,[427 515 318  79 588],716,5,26629,4.523356548326822,40.0,0.0
45887,4,5887,[427 515 318  79 588],716,5,26634,4.5234375,40.0,0.0
45888,4,5888,[427 515 318  79 588],716,5,26639,4.523518424180676,40.0,0.0
45889,4,5889,[427 515 318  79 588],807,5,26644,4.523599320882853,40.0,0.0
45890,4,5890,[427 515 318  79 588],716,5,26649,4.523680190120523,40.0,0.0
45891,4,5891,[427 515 318  79 588],716,5,26654,4.5237610319076715,40.0,0.0
45892,4,5892,[427 515 318  79 588],716,5,26659,4.523841846258272,40.0,0.0
45893,4,5893,[475  11 471 121  22],655,0,26659,4.523074312860536,0.0,0.0
45894,4,5894,[427 515 318  79 588],716,5,26664,4.523155216284987,40.0,0.0
45895,4,5895,[202   9 191 168 483],796,4,26668,4.523066485753053,0.0,0.0
45896,4,5896,[ 95 245 173 179 318],450,4,26672,4.522977785314566,20.0,0.0
45897,4,5897,[  4 238 132 423  50],796,4,26676,4.522889114954221,0.0,20.0
45898,4,5898,[427 515 318  79 588],18,5,26681,4.5229699949143924,40.0,0.0
45899,4,5899,[427 515 318  79 588],716,5,26686,4.523050847457627,40.0,0.0
45900,4,5900,[427 515 318  79 588],18,5,26691,4.523131672597865,40.0,0.0
45901,4,5901,[427 515 318  79 588],18,5,26696,4.523212470349034,40.0,0.0
45902,4,5902,[427 515 318  79 588],18,5,26701,4.523293240725055,40.0,0.0
45903,4,5903,[427 515 318  79 588],18,5,26706,4.5233739837398375,40.0,0.0
45904,4,5904,[111 258 269 275 211],796,3,26709,4.52311600338696,0.0,20.0
45905,4,5905,[427 515 318  79 588],18,5,26714,4.5231967490687435,40.0,0.0
45906,4,5906,[427 515 318  79 588],716,5,26719,4.523277467411545,40.0,0.0
45907,4,5907,[427 515 318  79 588],716,5,26724,4.523358158429248,40.0,0.0
45908,4,5908,[427 515 318  79 588],716,5,26729,4.523438822135725,40.0,0.0
45909,4,5909,[176  95   4  15 471],786,4,26733,4.523350253807107,0.0,0.0
45910,4,5910,[427 515 318  79 588],807,5,26738,4.523430891558112,40.0,0.0
45911,4,5911,[118 322 210 187 405],450,3,26741,4.523173207036536,0.0,0.0
45912,4,5912,[294 655 100 748 117],280,1,26742,4.5225773718924405,0.0,20.0
45913,4,5913,[427 515 318  79 588],807,5,26747,4.522658099425093,40.0,0.0
45914,4,5914,[427 515 318  79 588],716,5,26752,4.522738799661877,40.0,0.0
45915,4,5915,[234 258 276 175 288],655,1,26753,4.522143340094659,0.0,0.0
45916,4,5916,[427 515 318  79 588],716,5,26758,4.5222241000507015,40.0,0.0
45917,4,5917,[ 71  95 403 228  98],798,2,26760,4.521797904697533,0.0,0.0
45918,4,5918,[427 515 318  79 588],716,5,26765,4.521878695725629,40.0,0.0
45919,4,5919,[427 515 318  79 588],807,5,26770,4.52195945945946,40.0,0.0
45920,4,5920,[121 385 202  98 175],716,3,26773,4.521702415132579,0.0,0.0
45921,4,5921,[427 515 318  79 588],807,5,26778,4.521783181357649,40.0,0.0
45922,4,5922,[427 515 318  79 588],807,5,26783,4.521863920310653,40.0,0.0
45923,4,5923,[427 515 318  79 588],18,5,26788,4.521944632005402,40.0,0.0
45924,4,5924,[427 515 318  79 588],807,5,26793,4.5220253164556965,40.0,0.0
45925,4,5925,[427 515 318  79 588],18,5,26798,4.522105973675329,40.0,0.0
45926,4,5926,[151 228 144 181 195],716,3,26801,4.521849164838873,0.0,0.0
45927,4,5927,[427 515 318  79 588],716,5,26806,4.521929824561403,40.0,0.0
45928,4,5928,[427 515 318  79 588],807,5,26811,4.5220104570753925,40.0,0.0
45929,4,5929,[427 515 318  79 588],18,5,26816,4.522091062394604,40.0,0.0
45930,4,5930,[427 515 318  79 588],807,5,26821,4.522171640532794,40.0,0.0
45931,4,5931,[427 515 318  79 588],716,5,26826,4.522252191503709,40.0,0.0
45932,4,5932,[427 515 318  79 588],807,5,26831,4.5223327153210855,40.0,0.0
45933,4,5933,[  1  98 186 202 187],450,4,26835,4.522244691607685,0.0,0.0
45934,4,5934,[ 79 174 197 182 210],18,5,26840,4.522325189553496,0.0,0.0
45935,4,5935,[427 515 318  79 588],716,5,26845,4.522405660377358,40.0,0.0
45936,4,5936,[427 515 318  79 588],716,5,26850,4.522486104092977,40.0,0.0
45937,4,5937,[273  69 143 111 328],401,3,26853,4.522229706972045,0.0,0.0
45938,4,5938,[427 515 318  79 588],807,5,26858,4.522310153224448,40.0,0.0
45939,4,5939,[322 286 111   1 211],796,1,26859,4.521717171717172,0.0,20.0
45940,4,5940,[ 25 151 257 173   8],457,4,26863,4.521629355327386,0.0,0.0
45941,4,5941,[427 515 318  79 588],716,5,26868,4.521709861999327,40.0,0.0
45942,4,5942,[427 515 318  79 588],807,5,26873,4.521790341578328,40.0,0.0
45943,4,5943,[427 515 318  79 588],807,5,26878,4.521870794078062,40.0,0.0
45944,4,5944,[427 515 318  79 588],18,5,26883,4.521951219512195,40.0,0.0
45945,4,5945,[427 515 318  79 588],807,5,26888,4.522031617894383,40.0,0.0
45946,4,5946,[427 515 318  79 588],807,5,26893,4.5221119892382715,40.0,0.0
45947,4,5947,[427 515 318  79 588],807,5,26898,4.5221923335574985,40.0,0.0
45948,4,5948,[427 515 318  79 588],18,5,26903,4.522272650865692,40.0,0.0
45949,4,5949,[427 515 318  79 588],807,5,26908,4.522352941176471,40.0,0.0
45950,4,5950,[427 515 318  79 588],18,5,26913,4.522433204503445,40.0,0.0
45951,4,5951,[357  56 183 471 228],655,2,26915,4.522009408602151,0.0,0.0
45952,4,5952,[427 515 318  79 588],716,5,26920,4.522089702670923,40.0,0.0
45953,4,5953,[427 515 318  79 588],716,5,26925,4.522169969768223,40.0,0.0
45954,4,5954,[427 515 318  79 588],18,5,26930,4.52225020990764,40.0,0.0
45955,4,5955,[427 515 318  79 588],18,5,26935,4.522330423102754,40.0,0.0
45956,4,5956,[427 515 318  79 588],716,5,26940,4.522410609367131,40.0,0.0
45957,4,5957,[118  79 168 288   9],457,5,26945,4.522490768714333,0.0,0.0
45958,4,5958,[427 515 318  79 588],807,5,26950,4.522570901157913,40.0,0.0
45959,4,5959,[301 216 118 185 423],389,3,26953,4.522315436241611,0.0,0.0
45960,4,5960,[427 515 318  79 588],18,5,26958,4.522395571212884,40.0,0.0
45961,4,5961,[427 515 318  79 588],807,5,26963,4.522475679302247,40.0,0.0
45962,4,5962,[427 515 318  79 588],18,5,26968,4.522555760523226,40.0,0.0
45963,4,5963,[427 515 318  79 588],18,5,26973,4.522635814889336,40.0,0.0
45964,4,5964,[385 168   7 215 197],450,5,26978,4.522715842414082,0.0,0.0
45965,4,5965,[215 180 483 405  88],716,4,26982,4.522628226617499,0.0,0.0
45966,4,5966,[427 515 318  79 588],807,5,26987,4.522708228590582,40.0,0.0
45967,4,5967,[427 515 318  79 588],18,5,26992,4.522788203753351,40.0,0.0
45968,4,5968,[ 70 127 132 151 111],269,3,26995,4.522533087619367,0.0,20.0
45969,4,5969,[427 515 318  79 588],716,5,27000,4.522613065326633,40.0,0.0
45970,4,5970,[427 515 318  79 588],807,5,27005,4.522693016245185,40.0,0.0
45971,4,5971,[496  79 597 127  28],807,4,27009,4.522605492297388,20.0,20.0
45972,4,5972,[427  64 475  69  50],655,3,27012,4.522350577599196,40.0,20.0
45973,4,5973,[427 515 318  79 588],716,5,27017,4.522430532306662,40.0,0.0
45974,4,5974,[427 515 318  79 588],716,5,27022,4.522510460251046,40.0,0.0
45975,4,5975,[121 132 313 191 403],450,4,27026,4.5224230254350735,0.0,0.0
45976,4,5976,[427 515 318  79 588],807,5,27031,4.522502927890246,40.0,0.0
45977,4,5977,[427 515 318  79 588],18,5,27036,4.522582803613249,40.0,0.0
45978,4,5978,[427 515 318  79 588],18,5,27041,4.522662652617495,40.0,0.0
45979,4,5979,[427 515 318  79 588],807,5,27046,4.522742474916388,40.0,0.0
45980,4,5980,[427 515 318  79 588],807,5,27051,4.522822270523323,40.0,0.0
45981,4,5981,[427 515 318  79 588],807,5,27056,4.522902039451688,40.0,0.0
45982,4,5982,[427 515 318  79 588],716,5,27061,4.522981781714859,40.0,0.0
45983,4,5983,[427 515 318  79 588],716,5,27066,4.5230614973262036,40.0,0.0
45984,4,5984,[427 515 318  79 588],807,5,27071,4.523141186299081,40.0,0.0
45985,4,5985,[427 515 318  79 588],716,5,27076,4.523220848646843,40.0,0.0
45986,4,5986,[427 515 318  79 588],716,5,27081,4.52330048438283,40.0,0.0
45987,4,5987,[427 515 318  79 588],18,5,27086,4.523380093520374,40.0,0.0
45988,4,5988,[427 515 318  79 588],716,5,27091,4.5234596760728,40.0,0.0
45989,4,5989,[427 515 318  79 588],807,5,27096,4.523539232053422,40.0,0.0
45990,4,5990,[427 515 318  79 588],18,5,27101,4.5236187614755465,40.0,0.0
45991,4,5991,[ 82 603  12 174  56],72,4,27105,4.523531375166889,20.0,0.0
45992,4,5992,[427 515 318  79 588],716,5,27110,4.523610879359253,40.0,0.0
45993,4,5993,[427 515 318  79 588],716,5,27115,4.52369035702369,40.0,0.0
45994,4,5994,[427 515 318  79 588],716,5,27120,4.523769808173478,40.0,0.0
45995,4,5995,[427 515 318  79 588],18,5,27125,4.523849232821881,40.0,0.0
45996,4,5996,[161 181 132 322 294],450,5,27130,4.523928630982158,0.0,0.0
45997,4,5997,[427 515 318  79 588],807,5,27135,4.524008002667556,40.0,0.0
45998,4,5998,[427 515 318  79 588],716,5,27140,4.5240873478913155,40.0,0.0
45999,4,5999,[427 515 318  79 588],716,5,27145,4.524166666666667,40.0,0.0
46000,4,6000,[427 515 318  79 588],807,5,27150,4.524245959006832,40.0,0.0
46001,4,6001,[427 515 318  79 588],807,5,27155,4.524325224925025,40.0,0.0
46002,4,6002,[427 515 318  79 588],18,5,27160,4.52440446443445,40.0,0.0
46003,4,6003,[427 515 318  79 588],18,5,27165,4.524483677548301,40.0,0.0
46004,4,6004,[427 515 318  79 588],18,5,27170,4.524562864279767,40.0,0.0
46005,4,6005,[427 515 318  79 588],18,5,27175,4.5246420246420245,40.0,0.0
46006,4,6006,[427 515 318  79 588],807,5,27180,4.524721158648243,40.0,0.0
46007,4,6007,[427 515 318  79 588],18,5,27185,4.524800266311584,40.0,0.0
46008,4,6008,[427 515 318  79 588],716,5,27190,4.524879347645199,40.0,0.0
46009,4,6009,[427 515 318  79 588],716,5,27195,4.52495840266223,40.0,0.0
46010,4,6010,[427 515 318  79 588],807,5,27200,4.525037431375811,40.0,0.0
46011,4,6011,[222 546 182 588 655],457,4,27204,4.5249500998003995,0.0,0.0
46012,4,6012,[286 318 546   4 172],796,4,27208,4.524862797272576,20.0,20.0
46013,4,6013,[427 515 318  79 588],716,5,27213,4.5249418024609245,40.0,0.0
46014,4,6014,[427 515 318  79 588],807,5,27218,4.525020781379884,40.0,0.0
46015,4,6015,[427 515 318  79 588],716,5,27223,4.525099734042553,40.0,0.0
46016,4,6016,[111 405 302 235 301],344,3,27226,4.52484626890477,0.0,0.0
46017,4,6017,[  1 588 265 234 172],280,3,27229,4.524592888002659,0.0,0.0
46018,4,6018,[427 515 318  79 588],807,5,27234,4.5246718724040536,40.0,0.0
46019,4,6019,[603  50 204 174  82],655,2,27236,4.5242524916943525,20.0,20.0
46020,4,6020,[427 515 318  79 588],716,5,27241,4.524331506394287,40.0,0.0
46021,4,6021,[427 515 318  79 588],18,5,27246,4.524410494852209,40.0,0.0
46022,4,6022,[427 515 318  79 588],18,5,27251,4.524489457081189,40.0,0.0
46023,4,6023,[427 515 318  79 588],807,5,27256,4.52456839309429,40.0,0.0
46024,4,6024,[427 515 318  79 588],807,5,27261,4.524647302904564,40.0,0.0
46025,4,6025,[ 89   1 286 174  25],18,3,27264,4.524394291403916,0.0,20.0
46026,4,6026,[427 515 318  79 588],716,5,27269,4.524473203915712,40.0,0.0
46027,4,6027,[427 515 318  79 588],807,5,27274,4.524552090245521,40.0,0.0
46028,4,6028,[257 144   4 125 143],655,1,27275,4.523967490462764,0.0,0.0
46029,4,6029,[427 515 318  79 588],807,5,27280,4.5240464344941955,40.0,0.0
46030,4,6030,[ 82 546 265 196  69],716,4,27284,4.523959542364451,0.0,0.0
46031,4,6031,[427 515 318  79 588],18,5,27289,4.524038461538462,40.0,0.0
46032,4,6032,[427 515 318  79 588],18,5,27294,4.5241173545499755,40.0,0.0
46033,4,6033,[427 515 318  79 588],18,5,27299,4.524196221411999,40.0,0.0
46034,4,6034,[427 515 318  79 588],807,5,27304,4.524275062137531,40.0,0.0
46035,4,6035,[427 515 318  79 588],18,5,27309,4.524353876739562,40.0,0.0
46036,4,6036,[427 515 318  79 588],18,5,27314,4.524432665231075,40.0,0.0
46037,4,6037,[ 11 204 276 161 597],593,3,27317,4.524180192116595,0.0,0.0
46038,4,6038,[427 515 318  79 588],18,5,27322,4.524258983275376,40.0,0.0
46039,4,6039,[655 204 118 357 405],716,4,27326,4.524172185430464,0.0,0.0
46040,4,6040,[427 515 318  79 588],18,5,27331,4.524250951829167,40.0,0.0
46041,4,6041,[427 515 318  79 588],807,5,27336,4.524329692154915,40.0,0.0
46042,4,6042,[302 508 143  88 186],269,1,27337,4.523746483534668,0.0,0.0
46043,4,6043,[288 176 191 125 132],655,1,27338,4.523163467902052,0.0,0.0
46044,4,6044,[ 22 234  12 423  25],577,4,27342,4.523076923076923,0.0,0.0
46045,4,6045,[427 515 318  79 588],18,5,27347,4.523155805491234,40.0,0.0
46046,4,6046,[427 515 318  79 588],18,5,27352,4.523234661815777,40.0,0.0
46047,4,6047,[427 515 318  79 588],18,5,27357,4.523313492063492,40.0,0.0
46048,4,6048,[427 515 318  79 588],18,5,27362,4.523392296247313,40.0,0.0
46049,4,6049,[427 515 318  79 588],807,5,27367,4.523471074380165,40.0,0.0
46050,4,6050,[427 515 318  79 588],716,5,27372,4.523549826474963,40.0,0.0
46051,4,6051,[427 515 318  79 588],716,5,27377,4.523628552544613,40.0,0.0
46052,4,6052,[427 515 318  79 588],716,5,27382,4.523707252602016,40.0,0.0
46053,4,6053,[427 515 318  79 588],716,5,27387,4.523785926660059,40.0,0.0
46054,4,6054,[427 515 318  79 588],807,5,27392,4.523864574731626,40.0,0.0
46055,4,6055,[427 515 318  79 588],716,5,27397,4.523943196829591,40.0,0.0
46056,4,6056,[237  12 313 403 202],450,5,27402,4.524021792966815,0.0,0.0
46057,4,6057,[427 515 318  79 588],18,5,27407,4.524100363156157,40.0,0.0
46058,4,6058,[183 186 483 121 234],269,1,27408,4.523518732464103,0.0,0.0
46059,4,6059,[427 515 318  79 588],716,5,27413,4.523597359735974,40.0,0.0
46060,4,6060,[427 515 318  79 588],716,5,27418,4.523675961062531,40.0,0.0
46061,4,6061,[427 515 318  79 588],716,5,27423,4.523754536456615,40.0,0.0
46062,4,6062,[204  69 202 111  82],450,4,27427,4.523668151080323,0.0,0.0
46063,4,6063,[ 71 313 323 144 678],280,1,27428,4.523087071240106,0.0,0.0
46064,4,6064,[427 515 318  79 588],18,5,27433,4.523165704863974,40.0,0.0
46065,4,6065,[427 515 318  79 588],716,5,27438,4.52324431256182,40.0,0.0
46066,4,6066,[427 515 318  79 588],807,5,27443,4.523322894346465,40.0,0.0
46067,4,6067,[427 515 318  79 588],716,5,27448,4.523401450230718,40.0,0.0
46068,4,6068,[427 515 318  79 588],18,5,27453,4.5234799802273855,40.0,0.0
46069,4,6069,[427 515 318  79 588],18,5,27458,4.523558484349259,40.0,0.0
46070,4,6070,[427 515 318  79 588],807,5,27463,4.5236369626091255,40.0,0.0
46071,4,6071,[427 515 318  79 588],807,5,27468,4.523715415019763,40.0,0.0
46072,4,6072,[265 183 588 742 282],450,5,27473,4.523793841593941,0.0,0.0
46073,4,6073,[427 515 318  79 588],18,5,27478,4.523872242344419,40.0,0.0
46074,4,6074,[427 515 318  79 588],716,5,27483,4.52395061728395,40.0,0.0
46075,4,6075,[427 515 318  79 588],18,5,27488,4.52402896642528,40.0,0.0
46076,4,6076,[427 515 318  79 588],18,5,27493,4.524107289781142,40.0,0.0
46077,4,6077,[427 515 318  79 588],807,5,27498,4.524185587364265,40.0,0.0
46078,4,6078,[427 515 318  79 588],807,5,27503,4.524263859187366,40.0,0.0
46079,4,6079,[427 515 318  79 588],716,5,27508,4.524342105263158,40.0,0.0
46080,4,6080,[427 515 318  79 588],807,5,27513,4.524420325604342,40.0,0.0
46081,4,6081,[ 82 185 100 282 313],655,2,27515,4.524005261427162,0.0,20.0
46082,4,6082,[427 515 318  79 588],807,5,27520,4.5240835114252835,40.0,0.0
46083,4,6083,[427 515 318  79 588],18,5,27525,4.524161735700197,40.0,0.0
46084,4,6084,[427 515 318  79 588],807,5,27530,4.524239934264585,40.0,0.0
46085,4,6085,[427 515 318  79 588],18,5,27535,4.524318107131121,40.0,0.0
46086,4,6086,[427 515 318  79 588],716,5,27540,4.524396254312469,40.0,0.0
46087,4,6087,[427 515 318  79 588],716,5,27545,4.5244743758212875,40.0,0.0
46088,4,6088,[427 515 318  79 588],18,5,27550,4.524552471670225,40.0,0.0
46089,4,6089,[196  88   1  28  64],796,3,27553,4.5243021346469625,20.0,0.0
46090,4,6090,[427 515 318  79 588],716,5,27558,4.524380233130849,40.0,0.0
46091,4,6091,[427 515 318  79 588],18,5,27563,4.524458305975049,40.0,0.0
46092,4,6092,[427 515 318  79 588],18,5,27568,4.524536353192188,40.0,0.0
46093,4,6093,[427 515 318  79 588],18,5,27573,4.52461437479488,40.0,0.0
46094,4,6094,[427 515 318  79 588],807,5,27578,4.5246923707957345,40.0,0.0
46095,4,6095,[ 28 405 153 234 118],450,3,27581,4.5244422572178475,0.0,0.0
46096,4,6096,[471 318 173 197 180],457,5,27586,4.524520255863539,20.0,0.0
46097,4,6097,[196 216 289 294 127],236,3,27589,4.524270252541817,0.0,20.0
46098,4,6098,[427 515 318  79 588],807,5,27594,4.5243482538121,40.0,0.0
46099,4,6099,[204 238  12  64 655],655,1,27595,4.523770491803279,20.0,0.0
46100,4,6100,[427 515 318  79 588],807,5,27600,4.523848549418128,40.0,0.0
46101,4,6101,[427 515 318  79 588],18,5,27605,4.5239265814487055,40.0,0.0
46102,4,6102,[427 515 318  79 588],807,5,27610,4.524004587907586,40.0,0.0
46103,4,6103,[427 515 318  79 588],807,5,27615,4.52408256880734,40.0,0.0
46104,4,6104,[427 515 318  79 588],716,5,27620,4.524160524160524,40.0,0.0
46105,4,6105,[427 515 318  79 588],18,5,27625,4.5242384539796925,40.0,0.0
46106,4,6106,[427 515 318  79 588],807,5,27630,4.524316358277386,40.0,0.0
46107,4,6107,[427 515 318  79 588],18,5,27635,4.524394237066143,40.0,0.0
46108,4,6108,[427 515 318  79 588],716,5,27640,4.524472090358487,40.0,0.0
46109,4,6109,[427 515 318  79 588],807,5,27645,4.524549918166939,40.0,0.0
46110,4,6110,[168 322 183   7 597],450,5,27650,4.524627720504009,0.0,0.0
46111,4,6111,[427 515 318  79 588],18,5,27655,4.5247054973821985,40.0,0.0
46112,4,6112,[427 515 318  79 588],716,5,27660,4.5247832488140025,40.0,0.0
46113,4,6113,[427 515 318  79 588],807,5,27665,4.524860974811907,40.0,0.0
46114,4,6114,[427 515 318  79 588],807,5,27670,4.524938675388389,40.0,0.0
46115,4,6115,[427 515 318  79 588],716,5,27675,4.525016350555919,40.0,0.0
46116,4,6116,[427 515 318  79 588],807,5,27680,4.525094000326957,40.0,0.0
46117,4,6117,[ 89  95 182 118 423],450,3,27683,4.524844720496894,0.0,0.0
46118,4,6118,[427 515 318  79 588],18,5,27688,4.5249223729367545,40.0,0.0
46119,4,6119,[427 515 318  79 588],716,5,27693,4.525,40.0,0.0
46120,4,6120,[427 515 318  79 588],716,5,27698,4.525077601699069,40.0,0.0
46121,4,6121,[427 515 318  79 588],716,5,27703,4.52515517804639,40.0,0.0
46122,4,6122,[427 515 318  79 588],716,5,27708,4.525232729054385,40.0,0.0
46123,4,6123,[301 173  22 215 161],450,5,27713,4.525310254735467,0.0,0.0
46124,4,6124,[568 222  70 168 588],450,4,27717,4.525224489795918,0.0,0.0
46125,4,6125,[427 515 318  79 588],716,5,27722,4.52530199151159,40.0,0.0
46126,4,6126,[427 515 318  79 588],716,5,27727,4.52537946792884,40.0,0.0
46127,4,6127,[427 515 318  79 588],18,5,27732,4.525456919060052,40.0,0.0
46128,4,6128,[427 515 318  79 588],18,5,27737,4.525534344917605,40.0,0.0
46129,4,6129,[427 515 318  79 588],716,5,27742,4.525611745513866,40.0,0.0
46130,4,6130,[427 515 318  79 588],807,5,27747,4.525689120861197,40.0,0.0
46131,4,6131,[100  15  12   1 118],796,3,27750,4.525440313111546,0.0,20.0
46132,4,6132,[ 50 211 183 742 100],655,2,27752,4.525028534159465,0.0,40.0
46133,4,6133,[427 515 318  79 588],18,5,27757,4.525105966742745,40.0,0.0
46134,4,6134,[ 50 216 427 144 151],908,3,27760,4.524857375713122,20.0,20.0
46135,4,6135,[100 282 322 211  82],450,4,27764,4.52477183833116,0.0,20.0
46136,4,6136,[182 423 471  50 176],280,1,27765,4.524197490630601,0.0,20.0
46137,4,6137,[427 515 318  79 588],716,5,27770,4.524275008145976,40.0,0.0
46138,4,6138,[427 515 318  79 588],807,5,27775,4.5243525004072325,40.0,0.0
46139,4,6139,[427 515 318  79 588],807,5,27780,4.52442996742671,40.0,0.0
46140,4,6140,[427 515 318  79 588],716,5,27785,4.52450740921674,40.0,0.0
46141,4,6141,[427 515 318  79 588],18,5,27790,4.5245848257896455,40.0,0.0
46142,4,6142,[ 70 183 174 588  89],457,5,27795,4.524662217157741,0.0,0.0
46143,4,6143,[427 515 318  79 588],716,5,27800,4.524739583333333,40.0,0.0
46144,4,6144,[427 515 318  79 588],716,5,27805,4.524816924328722,40.0,0.0
46145,4,6145,[427 515 318  79 588],18,5,27810,4.5248942401562,40.0,0.0
46146,4,6146,[427 515 318  79 588],18,5,27815,4.524971530828046,40.0,0.0
46147,4,6147,[427 515 318  79 588],18,5,27820,4.525048796356539,40.0,0.0
46148,4,6148,[427 515 318  79 588],807,5,27825,4.525126036753944,40.0,0.0
46149,4,6149,[427 515 318  79 588],18,5,27830,4.5252032520325205,40.0,0.0
46150,4,6150,[282  50 515 183 405],292,4,27834,4.525117867013494,0.0,20.0
46151,4,6151,[195  50 237  56 276],256,3,27837,4.524869960988297,0.0,20.0
46152,4,6152,[ 71 200 172 508 118],280,2,27839,4.5244596131968144,0.0,0.0
46153,4,6153,[427 515 318  79 588],716,5,27844,4.5245368865778355,40.0,0.0
46154,4,6154,[427 515 318  79 588],807,5,27849,4.524614134849716,40.0,0.0
46155,4,6155,[427 515 318  79 588],716,5,27854,4.5246913580246915,40.0,0.0
46156,4,6156,[427 515 318  79 588],18,5,27859,4.524768556114991,40.0,0.0
46157,4,6157,[427 515 318  79 588],807,5,27864,4.524845729132835,40.0,0.0
46158,4,6158,[427 515 318  79 588],18,5,27869,4.524922877090437,40.0,0.0
46159,4,6159,[427 515 318  79 588],716,5,27874,4.525,40.0,0.0
46160,4,6160,[ 98 183 153  97 216],593,5,27879,4.525077097873722,0.0,0.0
46161,4,6161,[ 25 282  97  88 153],450,4,27883,4.52499188575138,0.0,0.0
46162,4,6162,[237  50 405 181 151],89,4,27887,4.524906701281843,0.0,20.0
46163,4,6163,[427 515 318  79 588],716,5,27892,4.524983776768332,40.0,0.0
46164,4,6164,[427 515 318  79 588],716,5,27897,4.525060827250608,40.0,0.0
46165,4,6165,[143 546 597 196  79],796,5,27902,4.525137852740837,0.0,0.0
46166,4,6166,[427 515 318  79 588],716,5,27907,4.525214853251176,40.0,0.0
46167,4,6167,[427 515 318  79 588],807,5,27912,4.525291828793774,40.0,0.0
46168,4,6168,[427 515 318  79 588],18,5,27917,4.525368779380774,40.0,0.0
46169,4,6169,[427 515 318  79 588],716,5,27922,4.525445705024311,40.0,0.0
46170,4,6170,[427 515 318  79 588],807,5,27927,4.525522605736509,40.0,0.0
46171,4,6171,[185 127 496 181 294],716,5,27932,4.525599481529488,20.0,20.0
46172,4,6172,[427 515 318  79 588],807,5,27937,4.525676332415357,40.0,0.0
46173,4,6173,[195  22 127 121 187],655,2,27939,4.525267249757046,0.0,20.0
46174,4,6174,[405 143 195 197 546],716,3,27942,4.52502024291498,0.0,0.0
46175,4,6175,[427 515 318  79 588],807,5,27947,4.525097150259067,40.0,0.0
46176,4,6176,[427 515 318  79 588],807,5,27952,4.525174032701959,40.0,0.0
46177,4,6177,[427 515 318  79 588],18,5,27957,4.525250890255746,40.0,0.0
46178,4,6178,[427 515 318  79 588],716,5,27962,4.525327722932514,40.0,0.0
46179,4,6179,[427 515 318  79 588],18,5,27967,4.5254045307443365,40.0,0.0
46180,4,6180,[ 22 238 275 282 515],716,4,27971,4.525319527584533,0.0,20.0
46181,4,6181,[ 22 211 117  97 197],716,5,27976,4.52539631187318,0.0,0.0
46182,4,6182,[427 515 318  79 588],716,5,27981,4.525473071324599,40.0,0.0
46183,4,6183,[427 515 318  79 588],807,5,27986,4.525549805950841,40.0,0.0
46184,4,6184,[427 515 318  79 588],807,5,27991,4.525626515763945,40.0,0.0
46185,4,6185,[182 546  64 216 294],796,4,27995,4.5255415454251535,20.0,0.0
46186,4,6186,[427 515 318  79 588],807,5,28000,4.525618231776305,40.0,0.0
46187,4,6187,[288 228 546  98 268],344,3,28003,4.525371687136393,0.0,0.0
46188,4,6188,[245 300 323 301 546],796,2,28005,4.524963645176927,0.0,0.0
46189,4,6189,[427 515 318  79 588],18,5,28010,4.525040387722132,40.0,0.0
46190,4,6190,[427 515 318  79 588],18,5,28015,4.52511710547569,40.0,0.0
46191,4,6191,[427 515 318  79 588],716,5,28020,4.525193798449612,40.0,0.0
46192,4,6192,[ 64 234 117   7  98],577,3,28023,4.524947521395124,20.0,0.0
46193,4,6193,[427 515 318  79 588],18,5,28028,4.525024216984178,40.0,0.0
46194,4,6194,[427 515 318  79 588],18,5,28033,4.525100887812752,40.0,0.0
46195,4,6195,[427 515 318  79 588],807,5,28038,4.525177533892834,40.0,0.0
46196,4,6196,[508 186   8 194  96],269,2,28040,4.524770050024205,0.0,0.0
46197,4,6197,[258 294 215 286 202],796,3,28043,4.524524040012907,0.0,20.0
46198,4,6198,[427 515 318  79 588],807,5,28048,4.524600742055171,40.0,0.0
46199,4,6199,[427 515 318  79 588],716,5,28053,4.5246774193548385,40.0,0.0
46200,4,6200,[427 515 318  79 588],807,5,28058,4.5247540719238835,40.0,0.0
46201,4,6201,[427 515 318  79 588],807,5,28063,4.524830699774267,40.0,0.0
46202,4,6202,[427 515 318  79 588],18,5,28068,4.524907302917943,40.0,0.0
46203,4,6203,[427 515 318  79 588],807,5,28073,4.52498388136686,40.0,0.0
46204,4,6204,[546  25  50  22 318],457,4,28077,4.524899274778405,20.0,20.0
46205,4,6205,[172 742 210 211 237],655,1,28078,4.524331292297776,0.0,0.0
46206,4,6206,[265  12  88 118 294],655,0,28078,4.523602384404704,0.0,0.0
46207,4,6207,[  1  95 423 588 234],450,3,28081,4.523356958762887,0.0,0.0
46208,4,6208,[276 286 603 423  25],655,2,28083,4.522950555645031,20.0,20.0
46209,4,6209,[200 318 546 143 245],450,4,28087,4.522866344605475,20.0,0.0
46210,4,6210,[427 515 318  79 588],807,5,28092,4.522943165351795,40.0,0.0
46211,4,6211,[427 515 318  79 588],18,5,28097,4.5230199613651,40.0,0.0
46212,4,6212,[271   7  56 237 228],655,0,28097,4.522291968453243,0.0,0.0
46213,4,6213,[427 515 318  79 588],807,5,28102,4.522368844544577,40.0,0.0
46214,4,6214,[427 515 318  79 588],807,5,28107,4.522445695897023,40.0,0.0
46215,4,6215,[427 515 318  79 588],716,5,28112,4.5225225225225225,40.0,0.0
46216,4,6216,[427 515 318  79 588],807,5,28117,4.522599324433006,40.0,0.0
46217,4,6217,[427 515 318  79 588],807,5,28122,4.522676101640399,40.0,0.0
46218,4,6218,[427 515 318  79 588],18,5,28127,4.522752854156617,40.0,0.0
46219,4,6219,[427 515 318  79 588],716,5,28132,4.5228295819935695,40.0,0.0
46220,4,6220,[238  56 197  69 385],457,5,28137,4.522906285163157,0.0,0.0
46221,4,6221,[427 515 318  79 588],807,5,28142,4.522982963677274,40.0,0.0
46222,4,6222,[427 515 318  79 588],18,5,28147,4.523059617547807,40.0,0.0
46223,4,6223,[568 427  12  82  96],655,1,28148,4.522493573264781,20.0,0.0
46224,4,6224,[427 515 318  79 588],807,5,28153,4.522570281124498,40.0,0.0
46225,4,6225,[427 515 318  79 588],807,5,28158,4.522646964343077,40.0,0.0
46226,4,6226,[121 588 405 173 228],457,5,28163,4.522723622932391,0.0,0.0
46227,4,6227,[427 515 318  79 588],18,5,28168,4.522800256904303,40.0,0.0
46228,4,6228,[427 515 318  79 588],716,5,28173,4.5228768662706695,40.0,0.0
46229,4,6229,[427 515 318  79 588],716,5,28178,4.522953451043339,40.0,0.0
46230,4,6230,[161  64 200 121  22],457,5,28183,4.523030011234152,20.0,0.0
46231,4,6231,[427 515 318  79 588],716,5,28188,4.523106546854942,40.0,0.0
46232,4,6232,[508 322  97 135 202],401,2,28190,4.522701748756618,0.0,0.0
46233,4,6233,[427 515 318  79 588],18,5,28195,4.522778312479948,40.0,0.0
46234,4,6234,[275 135 238 181 313],655,3,28198,4.522534081796311,0.0,20.0
46235,4,6235,[427 515 318  79 588],18,5,28203,4.522610647851186,40.0,0.0
46236,4,6236,[427 515 318  79 588],18,5,28208,4.522687189353856,40.0,0.0
46237,4,6237,[427 515 318  79 588],807,5,28213,4.522763706316127,40.0,0.0
46238,4,6238,[427 515 318  79 588],18,5,28218,4.522840198749799,40.0,0.0
46239,4,6239,[ 22 194 423 313  82],450,4,28222,4.52275641025641,0.0,0.0
46240,4,6240,[427 515 318  79 588],807,5,28227,4.522832879346258,40.0,0.0
46241,4,6241,[427 515 318  79 588],807,5,28232,4.522909323934637,40.0,0.0
46242,4,6242,[427 515 318  79 588],716,5,28237,4.522985744033317,40.0,0.0
46243,4,6243,[427 515 318  79 588],807,5,28242,4.523062139654068,40.0,0.0
46244,4,6244,[427 515 318  79 588],716,5,28247,4.523138510808647,40.0,0.0
46245,4,6245,[ 89 185 655  88   1],151,5,28252,4.523214857508806,0.0,0.0
46246,4,6246,[427 515 318  79 588],716,5,28257,4.523291179766288,40.0,0.0
46247,4,6247,[496   8  88   4 117],344,3,28260,4.5230473751600515,20.0,0.0
46248,4,6248,[427 515 318  79 588],18,5,28265,4.523123699791967,40.0,0.0
46249,4,6249,[427 515 318  79 588],716,5,28270,4.5232,40.0,0.0
46250,4,6250,[427 515 318  79 588],716,5,28275,4.523276275795872,40.0,0.0
46251,4,6251,[194 357 265 742 151],796,4,28279,4.52319257837492,0.0,0.0
46252,4,6252,[204 200 265 172  88],716,5,28284,4.523268830961139,0.0,0.0
46253,4,6253,[313 127 508 117 294],655,2,28286,4.522865366165654,0.0,20.0
46254,4,6254,[427 515 318  79 588],18,5,28291,4.5229416466826535,40.0,0.0
46255,4,6255,[175 183 385 100 234],23,3,28294,4.52269820971867,0.0,20.0
46256,4,6256,[427 515 318  79 588],807,5,28299,4.522774492568323,40.0,0.0
46257,4,6257,[427 515 318  79 588],807,5,28304,4.52285075103867,40.0,0.0
46258,4,6258,[427 515 318  79 588],807,5,28309,4.522926985141396,40.0,0.0
46259,4,6259,[427 515 318  79 588],807,5,28314,4.523003194888179,40.0,0.0
46260,4,6260,[427 515 318  79 588],807,5,28319,4.523079380290689,40.0,0.0
46261,4,6261,[427 515 318  79 588],716,5,28324,4.5231555413605875,40.0,0.0
46262,4,6262,[427 515 318  79 588],807,5,28329,4.523231678109532,40.0,0.0
46263,4,6263,[427 515 318  79 588],807,5,28334,4.52330779054917,40.0,0.0
46264,4,6264,[427 515 318  79 588],18,5,28339,4.523383878691141,40.0,0.0
46265,4,6265,[405 179 196 235 238],269,2,28341,4.522981168209384,0.0,0.0
46266,4,6266,[271 135 202 265 210],655,1,28342,4.52241902026488,0.0,0.0
46267,4,6267,[ 69 144 196 269   7],450,5,28347,4.5224952137843015,0.0,0.0
46268,4,6268,[427 515 318  79 588],18,5,28352,4.522571382995693,40.0,0.0
46269,4,6269,[597 175 568 215   1],344,2,28354,4.522169059011164,0.0,0.0
46270,4,6270,[427 515 318  79 588],18,5,28359,4.5222452559400415,40.0,0.0
46271,4,6271,[427 515 318  79 588],807,5,28364,4.522321428571429,40.0,0.0
46272,4,6272,[427 515 318  79 588],18,5,28369,4.522397576916946,40.0,0.0
46273,4,6273,[427 515 318  79 588],716,5,28374,4.522473700988205,40.0,0.0
46274,4,6274,[427 515 318  79 588],18,5,28379,4.522549800796813,40.0,0.0
46275,4,6275,[427 515 318  79 588],807,5,28384,4.522625876354366,40.0,0.0
46276,4,6276,[427 515 318  79 588],807,5,28389,4.522701927672455,40.0,0.0
46277,4,6277,[427 515 318  79 588],807,5,28394,4.522777954762663,40.0,0.0
46278,4,6278,[427 515 318  79 588],807,5,28399,4.522853957636566,40.0,0.0
46279,4,6279,[385 125 245  15 276],256,4,28403,4.522770700636943,0.0,0.0
46280,4,6280,[427 515 318  79 588],807,5,28408,4.522846680464894,40.0,0.0
46281,4,6281,[427 515 318  79 588],18,5,28413,4.522922636103152,40.0,0.0
46282,4,6282,[427 515 318  79 588],807,5,28418,4.522998567563266,40.0,0.0
46283,4,6283,[  7 210 288 197 121],457,5,28423,4.523074474856779,0.0,0.0
46284,4,6284,[427 515 318  79 588],18,5,28428,4.523150357995227,40.0,0.0
46285,4,6285,[427 515 318  79 588],807,5,28433,4.523226216990137,40.0,0.0
46286,4,6286,[427 515 318  79 588],716,5,28438,4.5233020518530305,40.0,0.0
46287,4,6287,[427 515 318  79 588],18,5,28443,4.52337786259542,40.0,0.0
46288,4,6288,[427 515 318  79 588],18,5,28448,4.523453649228812,40.0,0.0
46289,4,6289,[427 515 318  79 588],716,5,28453,4.523529411764706,40.0,0.0
46290,4,6290,[403 483 127 117 357],693,3,28456,4.523287235733588,0.0,20.0
46291,4,6291,[286 405 191 258   1],796,3,28459,4.5230451366815005,0.0,20.0
46292,4,6292,[161 475 269  28   1],655,0,28459,4.522326394406483,0.0,0.0
46293,4,6293,[ 96 144  97 195 153],450,5,28464,4.5224022878932315,0.0,0.0
46294,4,6294,[238  69   4 195 191],786,5,28469,4.522478157267673,0.0,0.0
46295,4,6295,[427 515 318  79 588],18,5,28474,4.5225540025412965,40.0,0.0
46296,4,6296,[427 515 318  79 588],716,5,28479,4.522629823725584,40.0,0.0
46297,4,6297,[427 515 318  79 588],807,5,28484,4.52270562083201,40.0,0.0
46298,4,6298,[427 515 318  79 588],18,5,28489,4.522781393872044,40.0,0.0
46299,4,6299,[427 515 318  79 588],716,5,28494,4.522857142857143,40.0,0.0
46300,4,6300,[427 515 318  79 588],18,5,28499,4.522932867798762,40.0,0.0
46301,4,6301,[427 515 318  79 588],18,5,28504,4.523008568708347,40.0,0.0
46302,4,6302,[176 245   1   7 196],344,3,28507,4.522766936379502,0.0,0.0
46303,4,6303,[427 515 318  79 588],18,5,28512,4.522842639593908,40.0,0.0
46304,4,6304,[427 515 318  79 588],807,5,28517,4.522918318794607,40.0,0.0
46305,4,6305,[427 515 318  79 588],18,5,28522,4.522993973993023,40.0,0.0
46306,4,6306,[427 515 318  79 588],18,5,28527,4.523069605200571,40.0,0.0
46307,4,6307,[427 515 318  79 588],716,5,28532,4.523145212428662,40.0,0.0
46308,4,6308,[427 515 318  79 588],716,5,28537,4.523220795688698,40.0,0.0
46309,4,6309,[427 515 318  79 588],807,5,28542,4.523296354992076,40.0,0.0
46310,4,6310,[427 515 318  79 588],716,5,28547,4.523371890350182,40.0,0.0
46311,4,6311,[427 515 318  79 588],18,5,28552,4.523447401774398,40.0,0.0
46312,4,6312,[427 515 318  79 588],716,5,28557,4.523522889276097,40.0,0.0
46313,4,6313,[427 515 318  79 588],807,5,28562,4.523598352866646,40.0,0.0
46314,4,6314,[185 179 678 294 118],504,2,28564,4.52319873317498,0.0,0.0
46315,4,6315,[427 515 318  79 588],807,5,28569,4.523274224192527,40.0,0.0
46316,4,6316,[427 515 318  79 588],18,5,28574,4.523349691309166,40.0,0.0
46317,4,6317,[ 71   4 174  28 427],450,3,28577,4.523108578664134,20.0,0.0
46318,4,6318,[427 515 318  79 588],716,5,28582,4.523184048108878,40.0,0.0
46319,4,6319,[197 257 300  22  82],716,5,28587,4.523259493670886,0.0,0.0
46320,4,6320,[427 515 318  79 588],807,5,28592,4.5233349153614935,40.0,0.0
46321,4,6321,[286 202 294 357 161],450,5,28597,4.523410313192028,0.0,20.0
46322,4,6322,[427 515 318  79 588],18,5,28602,4.52348568717381,40.0,0.0
46323,4,6323,[100 117 748 286 257],401,1,28603,4.522928526249209,0.0,40.0
46324,4,6324,[228 215 235  22 161],450,4,28607,4.522845849802372,0.0,0.0
46325,4,6325,[202   8 301  15  56],389,4,28611,4.522763199494151,0.0,0.0
46326,4,6326,[ 79 313  12 202 176],796,5,28616,4.522838628101786,0.0,0.0
46327,4,6327,[  7 135  64 237 179],535,4,28620,4.52275600505689,20.0,0.0
46328,4,6328,[427 515 318  79 588],18,5,28625,4.522831410965398,40.0,0.0
46329,4,6329,[427 515 318  79 588],807,5,28630,4.522906793048973,40.0,0.0
46330,4,6330,[427 515 318  79 588],807,5,28635,4.522982151318907,40.0,0.0
46331,4,6331,[427 515 318  79 588],807,5,28640,4.523057485786481,40.0,0.0
46332,4,6332,[427 515 318  79 588],807,5,28645,4.5231327964629715,40.0,0.0
46333,4,6333,[427 515 318  79 588],18,5,28650,4.523208083359647,40.0,0.0
46334,4,6334,[427 515 318  79 588],18,5,28655,4.523283346487767,40.0,0.0
46335,4,6335,[172 655 194 176 318],236,1,28656,4.5227272727272725,20.0,0.0
46336,4,6336,[427 515 318  79 588],18,5,28661,4.522802587975383,40.0,0.0
46337,4,6337,[427 515 318  79 588],716,5,28666,4.522877879457242,40.0,0.0
46338,4,6338,[427 515 318  79 588],18,5,28671,4.522953147184098,40.0,0.0
46339,4,6339,[427 515 318  79 588],716,5,28676,4.523028391167192,40.0,0.0
46340,4,6340,[427 515 318  79 588],18,5,28681,4.523103611417757,40.0,0.0
46341,4,6341,[427 515 318  79 588],18,5,28686,4.52317880794702,40.0,0.0
46342,4,6342,[427 515 318  79 588],716,5,28691,4.523253980766199,40.0,0.0
46343,4,6343,[427 515 318  79 588],18,5,28696,4.523329129886507,40.0,0.0
46344,4,6344,[ 69 222 175 173 185],704,2,28698,4.522931442080378,0.0,0.0
46345,4,6345,[269 423 288  97 125],450,4,28702,4.522849038764576,0.0,0.0
46346,4,6346,[234 182 185  28  98],389,5,28707,4.5229242161651175,0.0,0.0
46347,4,6347,[427 515 318  79 588],807,5,28712,4.522999369880277,40.0,0.0
46348,4,6348,[427 515 318  79 588],18,5,28717,4.523074499921248,40.0,0.0
46349,4,6349,[  4 180 496 215 127],280,3,28720,4.522834645669291,20.0,20.0
46350,4,6350,[ 82 286 132 294 588],450,4,28724,4.522752322468903,0.0,20.0
46351,4,6351,[427 515 318  79 588],807,5,28729,4.522827455919395,40.0,0.0
46352,4,6352,[168 265 271 588 496],807,4,28733,4.522745159767039,20.0,0.0
46353,4,6353,[427 515 318  79 588],716,5,28738,4.522820270695624,40.0,0.0
46354,4,6354,[427 515 318  79 588],807,5,28743,4.5228953579858375,40.0,0.0
46355,4,6355,[144 385  79 111 153],716,3,28746,4.522655758338578,0.0,0.0
46356,4,6356,[427 515 318  79 588],716,5,28751,4.5227308478842225,40.0,0.0
46357,4,6357,[427 515 318  79 588],716,5,28756,4.522805913809374,40.0,0.0
46358,4,6358,[427 515 318  79 588],807,5,28761,4.522880956125177,40.0,0.0
46359,4,6359,[427 515 318  79 588],807,5,28766,4.522955974842767,40.0,0.0
46360,4,6360,[427 515 318  79 588],18,5,28771,4.5230309699732745,40.0,0.0
46361,4,6361,[427 515 318  79 588],807,5,28776,4.523105941527821,40.0,0.0
46362,4,6362,[179 175 185 269 235],264,5,28781,4.523180889517524,0.0,0.0
46363,4,6363,[427 515 318  79 588],807,5,28786,4.523255813953488,40.0,0.0
46364,4,6364,[427 515 318  79 588],807,5,28791,4.523330714846819,40.0,0.0
46365,4,6365,[427 515 318  79 588],807,5,28796,4.523405592208608,40.0,0.0
46366,4,6366,[427 515 318  79 588],716,5,28801,4.523480446049945,40.0,0.0
46367,4,6367,[427 515 318  79 588],716,5,28806,4.523555276381909,40.0,0.0
46368,4,6368,[427 515 318  79 588],18,5,28811,4.523630083215576,40.0,0.0
46369,4,6369,[ 56 211 508 117 286],655,0,28811,4.522919937205652,0.0,20.0
46370,4,6370,[427 515 318  79 588],807,5,28816,4.522994820279391,40.0,0.0
46371,4,6371,[427 515 318  79 588],807,5,28821,4.523069679849341,40.0,0.0
46372,4,6372,[427 515 318  79 588],807,5,28826,4.523144515926565,40.0,0.0
46373,4,6373,[427 515 318  79 588],716,5,28831,4.523219328522121,40.0,0.0
46374,4,6374,[427 515 318  79 588],18,5,28836,4.523294117647059,40.0,0.0
46375,4,6375,[427 515 318  79 588],716,5,28841,4.523368883312422,40.0,0.0
46376,4,6376,[427 515 318  79 588],18,5,28846,4.523443625529246,40.0,0.0
46377,4,6377,[427 515 318  79 588],18,5,28851,4.5235183443085605,40.0,0.0
46378,4,6378,[427 515 318  79 588],18,5,28856,4.523593039661389,40.0,0.0
46379,4,6379,[427 515 318  79 588],807,5,28861,4.523667711598746,40.0,0.0
46380,4,6380,[427 515 318  79 588],716,5,28866,4.52374236013164,40.0,0.0
46381,4,6381,[427 515 318  79 588],807,5,28871,4.523816985271075,40.0,0.0
46382,4,6382,[216 172 655 176 127],280,2,28873,4.5234215885947044,0.0,20.0
46383,4,6383,[427 515 318  79 588],18,5,28878,4.523496240601504,40.0,0.0
46384,4,6384,[427 515 318  79 588],716,5,28883,4.523570869224746,40.0,0.0
46385,4,6385,[405 197 191 271 183],796,4,28887,4.52348888192922,0.0,0.0
46386,4,6386,[427 515 318  79 588],807,5,28892,4.5235634883356814,40.0,0.0
46387,4,6387,[427 515 318  79 588],18,5,28897,4.523638071383845,40.0,0.0
46388,4,6388,[427 515 318  79 588],807,5,28902,4.523712631084677,40.0,0.0
46389,4,6389,[183 153 546 132 173],503,4,28906,4.523630672926448,0.0,0.0
46390,4,6390,[427 515 318  79 588],807,5,28911,4.523705210452198,40.0,0.0
46391,4,6391,[427 515 318  79 588],716,5,28916,4.52377972465582,40.0,0.0
46392,4,6392,[427 515 318  79 588],716,5,28921,4.523854215548256,40.0,0.0
46393,4,6393,[427 515 318  79 588],18,5,28926,4.523928683140444,40.0,0.0
46394,4,6394,[655 117 265 282 194],450,5,28931,4.524003127443315,0.0,0.0
46395,4,6395,[427 515 318  79 588],18,5,28936,4.524077548467792,40.0,0.0
46396,4,6396,[328 172 222 174 322],796,4,28940,4.523995622948257,0.0,0.0
46397,4,6397,[301 300 328 216 172],655,2,28942,4.523601125351672,0.0,0.0
46398,4,6398,[508 301 237 302 204],344,4,28946,4.523519299890608,0.0,0.0
46399,4,6399,[427 515 318  79 588],18,5,28951,4.52359375,40.0,0.0
46400,4,6400,[427 515 318  79 588],807,5,28956,4.523668176847368,40.0,0.0
46401,4,6401,[427 515 318  79 588],716,5,28961,4.523742580443612,40.0,0.0
46402,4,6402,[427 515 318  79 588],716,5,28966,4.523816960799625,40.0,0.0
46403,4,6403,[427 515 318  79 588],716,5,28971,4.523891317926296,40.0,0.0
46404,4,6404,[135 176 216  71 179],236,1,28972,4.523341139734582,0.0,0.0
46405,4,6405,[121  25 143 385 655],655,1,28973,4.52279113331252,0.0,0.0
46406,4,6406,[427 515 318  79 588],716,5,28978,4.522865615732792,40.0,0.0
46407,4,6407,[427 515 318  79 588],807,5,28983,4.522940074906367,40.0,0.0
46408,4,6408,[427 515 318  79 588],18,5,28988,4.523014510844125,40.0,0.0
46409,4,6409,[427 515 318  79 588],716,5,28993,4.5230889235569425,40.0,0.0
46410,4,6410,[427 515 318  79 588],18,5,28998,4.523163313055686,40.0,0.0
46411,4,6411,[  7  89 135 182 288],457,5,29003,4.523237679351216,0.0,0.0
46412,4,6412,[427 515 318  79 588],716,5,29008,4.523312022454389,40.0,0.0
46413,4,6413,[288 174 403 191 228],450,4,29012,4.523230433426879,0.0,0.0
46414,4,6414,[423 202 168 546  79],457,4,29016,4.523148869836321,0.0,0.0
46415,4,6415,[427 515 318  79 588],807,5,29021,4.52322319201995,40.0,0.0
46416,4,6416,[427 515 318  79 588],716,5,29026,4.523297491039426,40.0,0.0
46417,4,6417,[427 515 318  79 588],716,5,29031,4.523371766905578,40.0,0.0
46418,4,6418,[427 515 318  79 588],807,5,29036,4.523446019629226,40.0,0.0
46419,4,6419,[427 515 318  79 588],18,5,29041,4.523520249221184,40.0,0.0
46420,4,6420,[427 515 318  79 588],807,5,29046,4.52359445569226,40.0,0.0
46421,4,6421,[427 515 318  79 588],716,5,29051,4.523668639053255,40.0,0.0
46422,4,6422,[427 515 318  79 588],18,5,29056,4.523742799314962,40.0,0.0
46423,4,6423,[427 515 318  79 588],716,5,29061,4.52381693648817,40.0,0.0
46424,4,6424,[427 515 318  79 588],807,5,29066,4.523891050583657,40.0,0.0
46425,4,6425,[427 515 318  79 588],18,5,29071,4.523965141612201,40.0,0.0
46426,4,6426,[427 515 318  79 588],807,5,29076,4.524039209584565,40.0,0.0
46427,4,6427,[427 515 318  79 588],716,5,29081,4.524113254511512,40.0,0.0
46428,4,6428,[427 515 318  79 588],807,5,29086,4.524187276403795,40.0,0.0
46429,4,6429,[427 515 318  79 588],807,5,29091,4.524261275272162,40.0,0.0
46430,4,6430,[427 515 318  79 588],807,5,29096,4.524335251127352,40.0,0.0
46431,4,6431,[216 322 204 135   7],151,4,29100,4.524253731343284,0.0,0.0
46432,4,6432,[234 546 135 144 118],693,2,29102,4.523861339965801,0.0,0.0
46433,4,6433,[655 187 153  15 215],450,4,29106,4.5237799191793595,0.0,0.0
46434,4,6434,[427 515 318  79 588],716,5,29111,4.523853923853924,40.0,0.0
46435,4,6435,[427 515 318  79 588],716,5,29116,4.523927905531386,40.0,0.0
46436,4,6436,[427 515 318  79 588],716,5,29121,4.5240018642224635,40.0,0.0
46437,4,6437,[143 132 168 238 328],151,4,29125,4.523920472196334,0.0,0.0
46438,4,6438,[427 515 318  79 588],716,5,29130,4.523994409069731,40.0,0.0
46439,4,6439,[196 118 135  79 215],450,3,29133,4.523757763975155,0.0,0.0
46440,4,6440,[427 515 318  79 588],716,5,29138,4.523831703151685,40.0,0.0
46441,4,6441,[427 515 318  79 588],18,5,29143,4.523905619372866,40.0,0.0
46442,4,6442,[427 515 318  79 588],18,5,29148,4.523979512649387,40.0,0.0
46443,4,6443,[301 216 385 483   1],450,4,29152,4.523898199875854,0.0,0.0
46444,4,6444,[427 515 318  79 588],716,5,29157,4.523972071373158,40.0,0.0
46445,4,6445,[427 515 318  79 588],807,5,29162,4.524045919950357,40.0,0.0
46446,4,6446,[427 515 318  79 588],716,5,29167,4.524119745618117,40.0,0.0
46447,4,6447,[427 515 318  79 588],716,5,29172,4.524193548387097,40.0,0.0
46448,4,6448,[427 515 318  79 588],807,5,29177,4.524267328267949,40.0,0.0
46449,4,6449,[181 546 237  79 423],503,5,29182,4.524341085271318,0.0,0.0
46450,4,6450,[161  11 546 496 185],716,3,29185,4.524104789955046,20.0,0.0
46451,4,6451,[427 515 318  79 588],716,5,29190,4.5241785492870426,40.0,0.0
46452,4,6452,[427 515 318  79 588],716,5,29195,4.524252285758562,40.0,0.0
46453,4,6453,[427 515 318  79 588],18,5,29200,4.524325999380229,40.0,0.0
46454,4,6454,[427 515 318  79 588],716,5,29205,4.524399690162665,40.0,0.0
46455,4,6455,[427 515 318  79 588],18,5,29210,4.524473358116481,40.0,0.0
46456,4,6456,[  8  98 191 183 275],796,5,29215,4.524547003252285,0.0,20.0
46457,4,6457,[427 515 318  79 588],18,5,29220,4.524620625580675,40.0,0.0
46458,4,6458,[427 515 318  79 588],716,5,29225,4.524694225112246,40.0,0.0
46459,4,6459,[151 265 603  71 435],535,4,29229,4.5246130030959755,20.0,0.0
46460,4,6460,[  7 222 301 546   8],344,4,29233,4.5245318062219475,0.0,0.0
46461,4,6461,[282 161 322 144  88],593,4,29237,4.52445063447849,0.0,0.0
46462,4,6462,[427 515 318  79 588],807,5,29242,4.524524214760947,40.0,0.0
46463,4,6463,[427 515 318  79 588],18,5,29247,4.524597772277228,40.0,0.0
46464,4,6464,[427 515 318  79 588],716,5,29252,4.524671307037896,40.0,0.0
46465,4,6465,[427 515 318  79 588],716,5,29257,4.5247448190535104,40.0,0.0
46466,4,6466,[427 515 318  79 588],716,5,29262,4.524818308334622,40.0,0.0
46467,4,6467,[427 515 318  79 588],716,5,29267,4.524891774891775,40.0,0.0
46468,4,6468,[ 79 182 196 186  88],18,3,29270,4.524656051940021,0.0,0.0
46469,4,6469,[427 515 318  79 588],18,5,29275,4.524729520865534,40.0,0.0
46470,4,6470,[322 172 151 568  70],344,3,29278,4.524493895842991,0.0,0.0
46471,4,6471,[427 515 318  79 588],716,5,29283,4.524567367119901,40.0,0.0
46472,4,6472,[228 211   1 265  12],151,5,29288,4.524640815695967,0.0,0.0
46473,4,6473,[427 515 318  79 588],807,5,29293,4.524714241581711,40.0,0.0
46474,4,6474,[ 64 435 196 197 181],18,3,29296,4.524478764478764,20.0,0.0
46475,4,6475,[176 174 357 235  28],450,4,29300,4.524397776405189,0.0,0.0
46476,4,6476,[ 64 742 235  25 276],256,3,29303,4.524162420873862,20.0,0.0
46477,4,6477,[427 515 318  79 588],18,5,29308,4.524235875270145,40.0,0.0
46478,4,6478,[427 515 318  79 588],716,5,29313,4.52430930699182,40.0,0.0
46479,4,6479,[427 515 318  79 588],807,5,29318,4.524382716049383,40.0,0.0
46480,4,6480,[197 222 357   9  79],457,5,29323,4.524456102453325,0.0,0.0
46481,4,6481,[427 515 318  79 588],18,5,29328,4.5245294662141315,40.0,0.0
46482,4,6482,[427 515 318  79 588],807,5,29333,4.52460280734228,40.0,0.0
46483,4,6483,[427 515 318  79 588],716,5,29338,4.5246761258482415,40.0,0.0
46484,4,6484,[427 515 318  79 588],807,5,29343,4.524749421742483,40.0,0.0
46485,4,6485,[427 515 318  79 588],18,5,29348,4.524822695035461,40.0,0.0
46486,4,6486,[427 515 318  79 588],716,5,29353,4.524895945737629,40.0,0.0
46487,4,6487,[427 515 318  79 588],18,5,29358,4.524969173859433,40.0,0.0
46488,4,6488,[ 69 294 423  79 289],236,4,29362,4.524888272461088,0.0,0.0
46489,4,6489,[427 515 318  79 588],807,5,29367,4.524961479198767,40.0,0.0
46490,4,6490,[172 186 265 234 282],716,3,29370,4.524726544446156,0.0,0.0
46491,4,6491,[427 515 318  79 588],18,5,29375,4.524799753542822,40.0,0.0
46492,4,6492,[427 515 318  79 588],716,5,29380,4.524872940089327,40.0,0.0
46493,4,6493,[427 515 318  79 588],807,5,29385,4.524946104096089,40.0,0.0
46494,4,6494,[427 515 318  79 588],807,5,29390,4.525019245573518,40.0,0.0
46495,4,6495,[427 515 318  79 588],18,5,29395,4.52509236453202,40.0,0.0
46496,4,6496,[427 515 318  79 588],18,5,29400,4.525165460981992,40.0,0.0
46497,4,6497,[427 515 318  79 588],807,5,29405,4.525238534933826,40.0,0.0
46498,4,6498,[427 515 318  79 588],807,5,29410,4.525311586397907,40.0,0.0
46499,4,6499,[427 515 318  79 588],807,5,29415,4.525384615384615,40.0,0.0
46500,4,6500,[302 245 265 235 202],450,4,29419,4.525303799415474,0.0,0.0
46501,4,6501,[427 515 318  79 588],716,5,29424,4.525376807136266,40.0,0.0
46502,4,6502,[ 95 385 181 100 301],450,4,29428,4.5252960172228205,0.0,20.0
46503,4,6503,[427 515 318  79 588],18,5,29433,4.525369003690037,40.0,0.0
46504,4,6504,[427 515 318  79 588],18,5,29438,4.525441967717141,40.0,0.0
46505,4,6505,[427 515 318  79 588],18,5,29443,4.525514909314479,40.0,0.0
46506,4,6506,[427 515 318  79 588],716,5,29448,4.525587828492393,40.0,0.0
46507,4,6507,[427 515 318  79 588],18,5,29453,4.525660725261217,40.0,0.0
46508,4,6508,[427 515 318  79 588],18,5,29458,4.5257335996312795,40.0,0.0
46509,4,6509,[237  88 216 173 183],593,5,29463,4.525806451612903,0.0,0.0
46510,4,6510,[427 515 318  79 588],716,5,29468,4.525879281216403,40.0,0.0
46511,4,6511,[427 515 318  79 588],18,5,29473,4.5259520884520885,40.0,0.0
46512,4,6512,[427 515 318  79 588],716,5,29478,4.526024873330263,40.0,0.0
46513,4,6513,[427 515 318  79 588],716,5,29483,4.526097635861222,40.0,0.0
46514,4,6514,[135 173 151 181 483],716,4,29487,4.526016884113584,0.0,0.0
46515,4,6515,[427 515 318  79 588],18,5,29492,4.526089625537139,40.0,0.0
46516,4,6516,[427 515 318  79 588],716,5,29497,4.526162344637103,40.0,0.0
46517,4,6517,[222 318  71 125 323],796,4,29501,4.526081620128874,20.0,0.0
46518,4,6518,[427 515 318  79 588],716,5,29506,4.526154318146955,40.0,0.0
46519,4,6519,[588 258  71 204 748],796,5,29511,4.526226993865031,0.0,0.0
46520,4,6520,[427 515 318  79 588],807,5,29516,4.52629964729336,40.0,0.0
46521,4,6521,[427 515 318  79 588],18,5,29521,4.526372278442196,40.0,0.0
46522,4,6522,[427 515 318  79 588],18,5,29526,4.526444887321785,40.0,0.0
46523,4,6523,[427 515 318  79 588],18,5,29531,4.526517473942366,40.0,0.0
46524,4,6524,[427 515 318  79 588],716,5,29536,4.526590038314176,40.0,0.0
46525,4,6525,[427 515 318  79 588],716,5,29541,4.526662580447441,40.0,0.0
46526,4,6526,[176 222 194  95 180],796,4,29545,4.5265818906082425,0.0,0.0
46527,4,6527,[302 483  82  28 318],151,3,29548,4.526348039215686,20.0,0.0
46528,4,6528,[427 515 318  79 588],18,5,29553,4.526420585081942,40.0,0.0
46529,4,6529,[427 515 318  79 588],807,5,29558,4.5264931087289435,40.0,0.0
46530,4,6530,[427 515 318  79 588],18,5,29563,4.526565610166896,40.0,0.0
46531,4,6531,[427 515 318  79 588],18,5,29568,4.526638089406001,40.0,0.0
46532,4,6532,[427 515 318  79 588],18,5,29573,4.526710546456452,40.0,0.0
46533,4,6533,[179  98 301   9 496],535,4,29577,4.526629935720845,20.0,0.0
46534,4,6534,[427 515 318  79 588],18,5,29582,4.526702371843918,40.0,0.0
46535,4,6535,[269 191 268  12 151],344,4,29586,4.526621787025704,0.0,0.0
46536,4,6536,[427 515 318  79 588],18,5,29591,4.526694202233441,40.0,0.0
46537,4,6537,[423 237  28 187 323],504,3,29594,4.526460691342918,0.0,0.0
46538,4,6538,[174 215 257 172  97],655,1,29595,4.525921394708671,0.0,0.0
46539,4,6539,[427 515 318  79 588],716,5,29600,4.525993883792049,40.0,0.0
46540,4,6540,[427 515 318  79 588],18,5,29605,4.5260663507109005,40.0,0.0
46541,4,6541,[289 357 182 282  12],655,2,29607,4.525680220116173,0.0,0.0
46542,4,6542,[427 515 318  79 588],716,5,29612,4.5257527128228645,40.0,0.0
46543,4,6543,[427 515 318  79 588],18,5,29617,4.525825183374083,40.0,0.0
46544,4,6544,[427 515 318  79 588],18,5,29622,4.525897631779984,40.0,0.0
46545,4,6545,[427 515 318  79 588],807,5,29627,4.525970058050718,40.0,0.0
46546,4,6546,[427 515 318  79 588],807,5,29632,4.5260424621964255,40.0,0.0
46547,4,6547,[427 515 318  79 588],18,5,29637,4.526114844227245,40.0,0.0
46548,4,6548,[ 64 181 427 215 176],693,2,29639,4.5257291189494575,40.0,0.0
46549,4,6549,[508 216 181  64 197],693,1,29640,4.525190839694656,20.0,0.0
46550,4,6550,[333  96 237 427  11],655,1,29641,4.524652724774843,20.0,0.0
46551,4,6551,[427 515 318  79 588],807,5,29646,4.524725274725275,40.0,0.0
46552,4,6552,[427 515 318  79 588],18,5,29651,4.5247978025331905,40.0,0.0
46553,4,6553,[427 515 318  79 588],716,5,29656,4.524870308208728,40.0,0.0
46554,4,6554,[427 515 318  79 588],807,5,29661,4.5249427917620135,40.0,0.0
46555,4,6555,[427 515 318  79 588],18,5,29666,4.525015253203173,40.0,0.0
46556,4,6556,[427 515 318  79 588],807,5,29671,4.525087692542321,40.0,0.0
46557,4,6557,[276 179  50 568 168],436,3,29674,4.524855138761818,0.0,20.0
46558,4,6558,[427 515 318  79 588],807,5,29679,4.524927580423845,40.0,0.0
46559,4,6559,[427 515 318  79 588],807,5,29684,4.525,40.0,0.0
46560,4,6560,[121 182 125 183 186],796,4,29688,4.524919981710105,0.0,0.0
46561,4,6561,[427 515 318  79 588],716,5,29693,4.524992380371838,40.0,0.0
46562,4,6562,[175 228 121 268  95],344,3,29696,4.524760018284321,0.0,0.0
46563,4,6563,[427 515 318  79 588],716,5,29701,4.524832419256551,40.0,0.0
46564,4,6564,[222  11 275 385  70],344,2,29703,4.524447829398325,0.0,20.0
46565,4,6565,[427 515 318  79 588],716,5,29708,4.524520255863539,40.0,0.0
46566,4,6566,[302 187  89 175 318],655,4,29712,4.5244403837368665,20.0,0.0
46567,4,6567,[427 515 318  79 588],716,5,29717,4.524512789281364,40.0,0.0
46568,4,6568,[427 515 318  79 588],807,5,29722,4.524585172781245,40.0,0.0
46569,4,6569,[427 515 318  79 588],18,5,29727,4.524657534246575,40.0,0.0
46570,4,6570,[427 515 318  79 588],807,5,29732,4.524729873687415,40.0,0.0
46571,4,6571,[427 515 318  79 588],716,5,29737,4.5248021911138165,40.0,0.0
46572,4,6572,[427 515 318  79 588],716,5,29742,4.524874486535828,40.0,0.0
46573,4,6573,[427 515 318  79 588],716,5,29747,4.524946759963493,40.0,0.0
46574,4,6574,[427 515 318  79 588],716,5,29752,4.525019011406844,40.0,0.0
46575,4,6575,[322 210 568 237 286],593,3,29755,4.524787104622871,0.0,20.0
46576,4,6576,[427 515 318  79 588],716,5,29760,4.524859358370078,40.0,0.0
46577,4,6577,[427 515 318  79 588],807,5,29765,4.524931590148982,40.0,0.0
46578,4,6578,[ 11 546 143 173 258],457,4,29769,4.524851801185591,0.0,0.0
46579,4,6579,[427 515 318  79 588],807,5,29774,4.5249240121580545,40.0,0.0
46580,4,6580,[427 515 318  79 588],716,5,29779,4.52499620118523,40.0,0.0
46581,4,6581,[427 515 318  79 588],716,5,29784,4.525068368277119,40.0,0.0
46582,4,6582,[427 515 318  79 588],716,5,29789,4.525140513443719,40.0,0.0
46583,4,6583,[427 515 318  79 588],716,5,29794,4.525212636695018,40.0,0.0
46584,4,6584,[132 172  25 471 268],655,1,29795,4.524677296886864,0.0,0.0
46585,4,6585,[118  97 182 125 273],655,2,29797,4.5242939568782266,0.0,0.0
46586,4,6586,[427 515 318  79 588],807,5,29802,4.52436617580082,40.0,0.0
46587,4,6587,[135  50 273 237 187],236,1,29803,4.5238312082574375,0.0,20.0
46588,4,6588,[ 82 301 135   8 211],655,1,29804,4.52329640309607,0.0,0.0
46589,4,6589,[427 515 318  79 588],716,5,29809,4.5233687405159335,40.0,0.0
46590,4,6590,[427 515 318  79 588],807,5,29814,4.523441055985435,40.0,0.0
46591,4,6591,[427 515 318  79 588],18,5,29819,4.523513349514563,40.0,0.0
46592,4,6592,[191 271  64 196   7],655,2,29821,4.523130593053239,20.0,0.0
46593,4,6593,[427 515 318  79 588],18,5,29826,4.523202911737943,40.0,0.0
46594,4,6594,[ 97  70 234  98 125],450,4,29830,4.523123578468537,0.0,0.0
46595,4,6595,[427 515 318  79 588],716,5,29835,4.52319587628866,40.0,0.0
46596,4,6596,[427 515 318  79 588],18,5,29840,4.52326815219039,40.0,0.0
46597,4,6597,[427 515 318  79 588],18,5,29845,4.523340406183692,40.0,0.0
46598,4,6598,[427 515 318  79 588],807,5,29850,4.523412638278527,40.0,0.0
46599,4,6599,[427 515 318  79 588],716,5,29855,4.523484848484848,40.0,0.0
46600,4,6600,[ 56 125 471 195 423],450,5,29860,4.523557036812604,0.0,0.0
46601,4,6601,[427 515 318  79 588],807,5,29865,4.523629203271736,40.0,0.0
46602,4,6602,[427 515 318  79 588],716,5,29870,4.523701347872179,40.0,0.0
46603,4,6603,[237 161 216 228 183],655,2,29872,4.523319200484555,0.0,0.0
46604,4,6604,[427 515 318  79 588],18,5,29877,4.52339137017411,40.0,0.0
46605,4,6605,[427 515 318  79 588],716,5,29882,4.523463518013926,40.0,0.0
46606,4,6606,[427 515 318  79 588],807,5,29887,4.523535644013925,40.0,0.0
46607,4,6607,[427 515 318  79 588],807,5,29892,4.52360774818402,40.0,0.0
46608,4,6608,[427 515 318  79 588],716,5,29897,4.52367983053412,40.0,0.0
46609,4,6609,[427 515 318  79 588],716,5,29902,4.52375189107413,40.0,0.0
46610,4,6610,[427 515 318  79 588],807,5,29907,4.523823929813947,40.0,0.0
46611,4,6611,[427 515 318  79 588],807,5,29912,4.52389594676346,40.0,0.0
46612,4,6612,[423  71 546 181 211],593,4,29916,4.523816724633298,0.0,0.0
46613,4,6613,[427 515 318  79 588],807,5,29921,4.523888720895071,40.0,0.0
46614,4,6614,[427 515 318  79 588],716,5,29926,4.523960695389267,40.0,0.0
46615,4,6615,[427 515 318  79 588],716,5,29931,4.524032648125756,40.0,0.0
46616,4,6616,[427 515 318  79 588],18,5,29936,4.524104579114402,40.0,0.0
46617,4,6617,[427 515 318  79 588],716,5,29941,4.524176488365065,40.0,0.0
46618,4,6618,[204 276 234 546 215],280,2,29943,4.5237951352168,0.0,0.0
46619,4,6619,[179  69 273 357 423],655,3,29946,4.523564954682779,0.0,0.0
46620,4,6620,[427 515 318  79 588],807,5,29951,4.523636912853044,40.0,0.0
46621,4,6621,[427 515 318  79 588],18,5,29956,4.523708849290244,40.0,0.0
46622,4,6622,[427 515 318  79 588],716,5,29961,4.523780764004227,40.0,0.0
46623,4,6623,[427 515 318  79 588],807,5,29966,4.523852657004831,40.0,0.0
46624,4,6624,[427 515 318  79 588],716,5,29971,4.523924528301887,40.0,0.0
46625,4,6625,[427 515 318  79 588],18,5,29976,4.523996377905222,40.0,0.0
46626,4,6626,[427 515 318  79 588],807,5,29981,4.524068205824657,40.0,0.0
46627,4,6627,[427 515 318  79 588],18,5,29986,4.524140012070006,40.0,0.0
46628,4,6628,[427 515 318  79 588],18,5,29991,4.524211796651079,40.0,0.0
46629,4,6629,[161 588  11 125  79],457,5,29996,4.524283559577677,0.0,0.0
46630,4,6630,[427 515 318  79 588],716,5,30001,4.5243553008595985,40.0,0.0
46631,4,6631,[185 258 273 173 235],450,3,30004,4.524125452352232,0.0,0.0
46632,4,6632,[427 515 318  79 588],18,5,30009,4.524197195838987,40.0,0.0
46633,4,6633,[427 515 318  79 588],18,5,30014,4.5242689176967135,40.0,0.0
46634,4,6634,[427 515 318  79 588],807,5,30019,4.524340617935192,40.0,0.0
46635,4,6635,[ 22 194 181 286 143],450,5,30024,4.524412296564195,0.0,20.0
46636,4,6636,[ 98  50 144 568 143],436,4,30028,4.524333283109839,0.0,20.0
46637,4,6637,[427 515 318  79 588],716,5,30033,4.524404941247363,40.0,0.0
46638,4,6638,[427 515 318  79 588],807,5,30038,4.524476577797861,40.0,0.0
46639,4,6639,[427 515 318  79 588],716,5,30043,4.524548192771085,40.0,0.0
46640,4,6640,[427 515 318  79 588],716,5,30048,4.524619786176781,40.0,0.0
46641,4,6641,[258  69 174  71 276],344,2,30050,4.524239686841313,0.0,0.0
46642,4,6642,[427 515 318  79 588],18,5,30055,4.524311305133223,40.0,0.0
46643,4,6643,[427 515 318  79 588],716,5,30060,4.524382901866345,40.0,0.0
46644,4,6644,[427 515 318  79 588],807,5,30065,4.524454477050414,40.0,0.0
46645,4,6645,[427 515 318  79 588],18,5,30070,4.524526030695155,40.0,0.0
46646,4,6646,[235 423  69 174 588],457,4,30074,4.524447119001053,0.0,0.0
46647,4,6647,[385 597 151  15   7],457,4,30078,4.524368231046932,0.0,0.0
46648,4,6648,[427 515 318  79 588],807,5,30083,4.524439765378252,40.0,0.0
46649,4,6649,[237 238  56  79 288],593,5,30088,4.524511278195488,0.0,0.0
46650,4,6650,[427 515 318  79 588],716,5,30093,4.524582769508345,40.0,0.0
46651,4,6651,[427 515 318  79 588],716,5,30098,4.524654239326519,40.0,0.0
46652,4,6652,[568 118  12 288 357],344,4,30102,4.524575379528033,0.0,0.0
46653,4,6653,[427 515 318  79 588],807,5,30107,4.524646828975053,40.0,0.0
46654,4,6654,[427 515 318  79 588],807,5,30112,4.524718256949662,40.0,0.0
46655,4,6655,[427 515 318  79 588],807,5,30117,4.524789663461538,40.0,0.0
46656,4,6656,[427 515 318  79 588],18,5,30122,4.524861048520354,40.0,0.0
46657,4,6657,[427 515 318  79 588],807,5,30127,4.524932412135777,40.0,0.0
46658,4,6658,[427 515 318  79 588],18,5,30132,4.525003754317465,40.0,0.0
46659,4,6659,[427 515 318  79 588],716,5,30137,4.525075075075075,40.0,0.0
46660,4,6660,[427 515 318  79 588],716,5,30142,4.525146374418256,40.0,0.0
46661,4,6661,[427 515 318  79 588],716,5,30147,4.52521765235665,40.0,0.0
46662,4,6662,[174 118 182 742 175],655,1,30148,4.524688578718295,0.0,0.0
46663,4,6663,[427 515 318  79 588],18,5,30153,4.524759903961584,40.0,0.0
46664,4,6664,[427 515 318  79 588],18,5,30158,4.524831207801951,40.0,0.0
46665,4,6665,[313  71 302 202 234],450,3,30161,4.524602460246024,0.0,0.0
46666,4,6666,[153 313 121 496 186],796,4,30165,4.5245237738113095,20.0,0.0
46667,4,6667,[161 435 174 237   9],72,4,30169,4.524445110977805,0.0,0.0
46668,4,6668,[427 515 318  79 588],716,5,30174,4.524516419253262,40.0,0.0
46669,4,6669,[427 515 318  79 588],18,5,30179,4.524587706146926,40.0,0.0
46670,4,6670,[427 515 318  79 588],807,5,30184,4.524658971668416,40.0,0.0
46671,4,6671,[515 385 135 423 273],655,3,30187,4.524430455635492,0.0,0.0
46672,4,6672,[427 515 318  79 588],807,5,30192,4.524501723362805,40.0,0.0
46673,4,6673,[427 515 318  79 588],18,5,30197,4.524572969733294,40.0,0.0
46674,4,6674,[121 496 151 282 300],796,5,30202,4.524644194756554,20.0,0.0
46675,4,6675,[427 515 318  79 588],716,5,30207,4.524715398442181,40.0,0.0
46676,4,6676,[427 515 318  79 588],807,5,30212,4.52478658079976,40.0,0.0
46677,4,6677,[427 515 318  79 588],18,5,30217,4.524857741838874,40.0,0.0
46678,4,6678,[  7  79  12 118 302],450,4,30221,4.524779158556671,0.0,0.0
46679,4,6679,[210  82 300 197  64],716,5,30226,4.524850299401198,20.0,0.0
46680,4,6680,[427 515 318  79 588],716,5,30231,4.524921418949259,40.0,0.0
46681,4,6681,[357 195 127 471 546],457,4,30235,4.524842861418737,0.0,20.0
46682,4,6682,[427 515 318  79 588],18,5,30240,4.52491396079605,40.0,0.0
46683,4,6683,[427 515 318  79 588],716,5,30245,4.524985038898863,40.0,0.0
46684,4,6684,[427 515 318  79 588],807,5,30250,4.525056095736724,40.0,0.0
46685,4,6685,[427 515 318  79 588],716,5,30255,4.5251271313191745,40.0,0.0
46686,4,6686,[588  96 471 117  88],457,5,30260,4.52519814565575,0.0,0.0
46687,4,6687,[427 515 318  79 588],18,5,30265,4.525269138755981,40.0,0.0
46688,4,6688,[427 515 318  79 588],18,5,30270,4.525340110629392,40.0,0.0
46689,4,6689,[427 515 318  79 588],807,5,30275,4.525411061285501,40.0,0.0
46690,4,6690,[427 515 318  79 588],807,5,30280,4.525481990733821,40.0,0.0
46691,4,6691,[427 515 318  79 588],18,5,30285,4.525552898983861,40.0,0.0
46692,4,6692,[427 515 318  79 588],807,5,30290,4.525623786045122,40.0,0.0
46693,4,6693,[427 515 318  79 588],18,5,30295,4.525694651927099,40.0,0.0
46694,4,6694,[427 515 318  79 588],807,5,30300,4.525765496639283,40.0,0.0
46695,4,6695,[427 515 318  79 588],18,5,30305,4.525836320191159,40.0,0.0
46696,4,6696,[427 515 318  79 588],18,5,30310,4.525907122592206,40.0,0.0
46697,4,6697,[257 318 471 135 125],457,4,30314,4.5258286055538965,20.0,0.0
46698,4,6698,[245 742 161  88  82],756,0,30314,4.525153007911628,0.0,0.0
46699,4,6699,[405 211 153  50 423],503,3,30317,4.524925373134328,0.0,20.0
46700,4,6700,[427 515 318  79 588],716,5,30322,4.52499626921355,40.0,0.0
46701,4,6701,[427 515 318  79 588],807,5,30327,4.525067144136079,40.0,0.0
46702,4,6702,[427 515 318  79 588],18,5,30332,4.525137997911383,40.0,0.0
46703,4,6703,[405 197 204 125  97],151,4,30336,4.5250596658711215,0.0,0.0
46704,4,6704,[427 515 318  79 588],18,5,30341,4.525130499627144,40.0,0.0
46705,4,6705,[427 515 318  79 588],807,5,30346,4.525201312257679,40.0,0.0
46706,4,6706,[427 515 318  79 588],807,5,30351,4.525272103772179,40.0,0.0
46707,4,6707,[427 515 318  79 588],807,5,30356,4.525342874180083,40.0,0.0
46708,4,6708,[568 265 405 187 228],72,3,30359,4.525115516470413,0.0,0.0
46709,4,6709,[427 515 318  79 588],18,5,30364,4.5251862891207155,40.0,0.0
46710,4,6710,[427 515 318  79 588],716,5,30369,4.525257040679482,40.0,0.0
46711,4,6711,[427 515 318  79 588],18,5,30374,4.525327771156138,40.0,0.0
46712,4,6712,[427 515 318  79 588],18,5,30379,4.525398480560107,40.0,0.0
46713,4,6713,[427 515 318  79 588],807,5,30384,4.525469168900805,40.0,0.0
46714,4,6714,[427 515 318  79 588],807,5,30389,4.525539836187639,40.0,0.0
46715,4,6715,[ 69 286 275 357 210],786,5,30394,4.525610482430018,0.0,40.0
46716,4,6716,[427 515 318  79 588],716,5,30399,4.525681107637338,40.0,0.0
46717,4,6717,[427 515 318  79 588],716,5,30404,4.525751711818994,40.0,0.0
46718,4,6718,[427 515 318  79 588],18,5,30409,4.525822294984373,40.0,0.0
46719,4,6719,[286 195 174 228 318],796,4,30413,4.525744047619048,20.0,20.0
46720,4,6720,[427 515 318  79 588],716,5,30418,4.525814610920994,40.0,0.0
46721,4,6721,[173 125 234 568 742],457,5,30423,4.525885153228206,0.0,0.0
46722,4,6722,[427 515 318  79 588],18,5,30428,4.525955674550052,40.0,0.0
46723,4,6723,[427 515 318  79 588],18,5,30433,4.526026174895895,40.0,0.0
46724,4,6724,[276 237 300 471  64],535,3,30436,4.525799256505576,20.0,0.0
46725,4,6725,[427 515 318  79 588],716,5,30441,4.525869759143622,40.0,0.0
46726,4,6726,[181 175  22 237  89],269,1,30442,4.525345622119816,0.0,0.0
46727,4,6727,[427 515 318  79 588],18,5,30447,4.525416171224732,40.0,0.0
46728,4,6728,[427 515 318  79 588],807,5,30452,4.525486699360975,40.0,0.0
46729,4,6729,[427 515 318  79 588],716,5,30457,4.52555720653789,40.0,0.0
46730,4,6730,[427 515 318  79 588],807,5,30462,4.52562769276482,40.0,0.0
46731,4,6731,[427 515 318  79 588],18,5,30467,4.5256981580510995,40.0,0.0
46732,4,6732,[427 515 318  79 588],807,5,30472,4.5257686024060595,40.0,0.0
46733,4,6733,[172 143  95 289 127],807,4,30476,4.525690525690526,0.0,20.0
46734,4,6734,[427 515 318  79 588],18,5,30481,4.525760950259837,40.0,0.0
46735,4,6735,[427 515 318  79 588],18,5,30486,4.52583135391924,40.0,0.0
46736,4,6736,[427 515 318  79 588],716,5,30491,4.525901736678047,40.0,0.0
46737,4,6737,[427 515 318  79 588],18,5,30496,4.525972098545562,40.0,0.0
46738,4,6738,[427 515 318  79 588],807,5,30501,4.526042439531087,40.0,0.0
46739,4,6739,[195 655 191 435  22],716,4,30505,4.525964391691395,0.0,0.0
46740,4,6740,[427 515 318  79 588],716,5,30510,4.526034712950601,40.0,0.0
46741,4,6741,[  9 210 318 471 423],535,5,30515,4.526105013349155,20.0,0.0
46742,4,6742,[234  98 496 204 118],450,3,30518,4.525878689010826,20.0,0.0
46743,4,6743,[204 211 151 173 328],450,5,30523,4.525948991696323,0.0,0.0
46744,4,6744,[ 25 173 172 237 568],344,4,30527,4.525871015567087,0.0,0.0
46745,4,6745,[151 183 174  97 175],716,3,30530,4.52564482656389,0.0,0.0
46746,4,6746,[427 515 318  79 588],716,5,30535,4.525715132651549,40.0,0.0
46747,4,6747,[427 515 318  79 588],18,5,30540,4.5257854179016,40.0,0.0
46748,4,6748,[427 515 318  79 588],807,5,30545,4.525855682323307,40.0,0.0
46749,4,6749,[427 515 318  79 588],807,5,30550,4.525925925925926,40.0,0.0
46750,4,6750,[427 515 318  79 588],716,5,30555,4.525996148718709,40.0,0.0
46751,4,6751,[427 515 318  79 588],18,5,30560,4.5260663507109005,40.0,0.0
46752,4,6752,[427 515 318  79 588],716,5,30565,4.526136531911743,40.0,0.0
46753,4,6753,[427  79 151 117 194],236,2,30567,4.5257625111045305,20.0,0.0
46754,4,6754,[427 515 318  79 588],18,5,30572,4.525832716506292,40.0,0.0
46755,4,6755,[427 515 318  79 588],716,5,30577,4.525902901124926,40.0,0.0
46756,4,6756,[427 515 318  79 588],18,5,30582,4.525973064969661,40.0,0.0
46757,4,6757,[211 180 289 172 294],296,3,30585,4.5257472625037,0.0,0.0
46758,4,6758,[427 515 318  79 588],716,5,30590,4.5258174286137,40.0,0.0
46759,4,6759,[427 515 318  79 588],716,5,30595,4.525887573964497,40.0,0.0
46760,4,6760,[427 515 318  79 588],716,5,30600,4.525957698565301,40.0,0.0
46761,4,6761,[427 515 318  79 588],716,5,30605,4.526027802425318,40.0,0.0
46762,4,6762,[427 515 318  79 588],807,5,30610,4.526097885553749,40.0,0.0
46763,4,6763,[427 515 318  79 588],18,5,30615,4.526167947959787,40.0,0.0
46764,4,6764,[427 515 318  79 588],716,5,30620,4.526237989652624,40.0,0.0
46765,4,6765,[ 82  56 211 322 197],796,1,30621,4.525716819391073,0.0,0.0
46766,4,6766,[427 515 318  79 588],716,5,30626,4.525786907048914,40.0,0.0
46767,4,6767,[427 515 318  79 588],716,5,30631,4.525856973995272,40.0,0.0
46768,4,6768,[427 515 318  79 588],18,5,30636,4.525927020239326,40.0,0.0
46769,4,6769,[427 515 318  79 588],18,5,30641,4.525997045790251,40.0,0.0
46770,4,6770,[568 273 257 228 471],655,1,30642,4.525476295968099,0.0,0.0
46771,4,6771,[427 515 318  79 588],807,5,30647,4.525546367395156,40.0,0.0
46772,4,6772,[427 515 318  79 588],716,5,30652,4.525616418130814,40.0,0.0
46773,4,6773,[427 515 318  79 588],807,5,30657,4.525686448184234,40.0,0.0
46774,4,6774,[427 515 318  79 588],807,5,30662,4.525756457564576,40.0,0.0
46775,4,6775,[427 515 318  79 588],18,5,30667,4.525826446280992,40.0,0.0
46776,4,6776,[ 22 200  95 215 385],796,5,30672,4.52589641434263,0.0,0.0
46777,4,6777,[427 515 318  79 588],716,5,30677,4.5259663617586305,40.0,0.0
46778,4,6778,[ 70 200  88 603 100],330,5,30682,4.5260362885381324,20.0,20.0
46779,4,6779,[ 79 196 176  28 211],796,3,30685,4.525811209439528,0.0,0.0
46780,4,6780,[427 515 318  79 588],807,5,30690,4.525881138475151,40.0,0.0
46781,4,6781,[427 515 318  79 588],716,5,30695,4.5259510468888235,40.0,0.0
46782,4,6782,[ 71  82 191  50 275],23,2,30697,4.525578652513637,0.0,40.0
46783,4,6783,[168 186 204   1 187],503,4,30701,4.525501179245283,0.0,0.0
46784,4,6784,[427 515 318  79 588],716,5,30706,4.52557111274871,40.0,0.0
46785,4,6785,[427 515 318  79 588],18,5,30711,4.5256410256410255,40.0,0.0
46786,4,6786,[427 515 318  79 588],716,5,30716,4.525710917931339,40.0,0.0
46787,4,6787,[427 515 318  79 588],716,5,30721,4.525780789628756,40.0,0.0
46788,4,6788,[385 153 655 174 313],593,4,30725,4.52570334364413,0.0,0.0
46789,4,6789,[427 515 318  79 588],18,5,30730,4.525773195876289,40.0,0.0
46790,4,6790,[427 515 318  79 588],807,5,30735,4.525843027536445,40.0,0.0
46791,4,6791,[427 515 318  79 588],18,5,30740,4.525912838633687,40.0,0.0
46792,4,6792,[427 515 318  79 588],807,5,30745,4.525982629177094,40.0,0.0
46793,4,6793,[427 515 318  79 588],807,5,30750,4.526052399175743,40.0,0.0
46794,4,6794,[427 515 318  79 588],716,5,30755,4.526122148638705,40.0,0.0
46795,4,6795,[427 515 318  79 588],716,5,30760,4.5261918775750445,40.0,0.0
46796,4,6796,[427 515 318  79 588],807,5,30765,4.5262615859938204,40.0,0.0
46797,4,6797,[185  98 211 257  97],796,3,30768,4.5260370697263905,0.0,0.0
46798,4,6798,[121 546 202 294 182],450,4,30772,4.525959699955876,0.0,0.0
46799,4,6799,[427 515 318  79 588],716,5,30777,4.526029411764706,40.0,0.0
46800,4,6800,[427 515 318  79 588],716,5,30782,4.5260991030730775,40.0,0.0
46801,4,6801,[427 515 318  79 588],807,5,30787,4.526168773890032,40.0,0.0
46802,4,6802,[597  11 216 471   8],344,2,30789,4.5257974423048655,0.0,0.0
46803,4,6803,[427 515 318  79 588],716,5,30794,4.525867136978248,40.0,0.0
46804,4,6804,[  8 471 204 117 127],807,4,30798,4.525789860396767,0.0,20.0
46805,4,6805,[427 515 318  79 588],807,5,30803,4.525859535703791,40.0,0.0
46806,4,6806,[427 515 318  79 588],807,5,30808,4.525929190539151,40.0,0.0
46807,4,6807,[427 515 318  79 588],716,5,30813,4.525998824911868,40.0,0.0
46808,4,6808,[427 515 318  79 588],18,5,30818,4.526068438830959,40.0,0.0
46809,4,6809,[427 515 318  79 588],807,5,30823,4.526138032305433,40.0,0.0
46810,4,6810,[427 515 318  79 588],18,5,30828,4.526207605344296,40.0,0.0
46811,4,6811,[427 515 318  79 588],716,5,30833,4.526277157956547,40.0,0.0
46812,4,6812,[427 515 318  79 588],18,5,30838,4.526346690151182,40.0,0.0
46813,4,6813,[215 172 185 210  79],18,2,30840,4.5259759319049016,0.0,0.0
46814,4,6814,[117 238 125 276 127],296,4,30844,4.525898752751284,0.0,20.0
46815,4,6815,[427 515 318  79 588],807,5,30849,4.525968309859155,40.0,0.0
46816,4,6816,[427 515 318  79 588],18,5,30854,4.526037846560071,40.0,0.0
46817,4,6817,[172 135 257 282 174],401,1,30855,4.525520680551481,0.0,0.0
46818,4,6818,[427 515 318  79 588],716,5,30860,4.525590262501833,40.0,0.0
46819,4,6819,[427 515 318  79 588],716,5,30865,4.525659824046921,40.0,0.0
46820,4,6820,[427 515 318  79 588],807,5,30870,4.525729365195719,40.0,0.0
46821,4,6821,[427 515 318  79 588],716,5,30875,4.525798885957197,40.0,0.0
46822,4,6822,[237 276 182 273  22],655,3,30878,4.525575260149495,0.0,0.0
46823,4,6823,[427 515 318  79 588],716,5,30883,4.5256447831184055,40.0,0.0
46824,4,6824,[294 215 323 180 257],796,2,30885,4.525274725274725,0.0,0.0
46825,4,6825,[427 515 318  79 588],18,5,30890,4.525344271901553,40.0,0.0
46826,4,6826,[471 313  95 748 265],450,4,30894,4.5252673209315954,0.0,0.0
46827,4,6827,[ 89 742  98 405  97],344,2,30896,4.52489748096075,0.0,0.0
46828,4,6828,[ 25 588  82 172  15],389,3,30899,4.524674183628642,0.0,0.0
46829,4,6829,[427 515 318  79 588],807,5,30904,4.524743777452416,40.0,0.0
46830,4,6830,[427 515 318  79 588],807,5,30909,4.524813350900307,40.0,0.0
46831,4,6831,[427 515 318  79 588],18,5,30914,4.524882903981265,40.0,0.0
46832,4,6832,[179 222 181  15 228],457,5,30919,4.524952436704229,0.0,0.0
46833,4,6833,[100 405  12 185 168],151,3,30922,4.524729294702956,0.0,20.0
46834,4,6834,[100 568 265   4  70],280,2,30924,4.524359912216532,0.0,20.0
46835,4,6835,[ 71  28 742 183 258],450,4,30928,4.52428320655354,0.0,0.0
46836,4,6836,[238 508  97 175 187],655,1,30929,4.523767734386427,0.0,0.0
46837,4,6837,[427 515 318  79 588],716,5,30934,4.523837379350687,40.0,0.0
46838,4,6838,[172 245 111 143 258],450,5,30939,4.523907003947945,0.0,0.0
46839,4,6839,[427 515 318  79 588],807,5,30944,4.523976608187135,40.0,0.0
46840,4,6840,[427 515 318  79 588],716,5,30949,4.524046192077182,40.0,0.0
46841,4,6841,[427 515 318  79 588],716,5,30954,4.52411575562701,40.0,0.0
46842,4,6842,[161  79 117 200 318],280,5,30959,4.524185298845536,20.0,0.0
46843,4,6843,[515 211 121 403 181],807,5,30964,4.524254821741671,0.0,0.0
46844,4,6844,[173  25 597 357 258],344,3,30967,4.524032140248356,0.0,0.0
46845,4,6845,[427 515 318  79 588],807,5,30972,4.52410166520596,40.0,0.0
46846,4,6846,[427 515 318  79 588],807,5,30977,4.5241711698554115,40.0,0.0
46847,4,6847,[427 515 318  79 588],18,5,30982,4.524240654205608,40.0,0.0
46848,4,6848,[282 127   9  25  96],457,5,30987,4.52431011826544,0.0,20.0
46849,4,6849,[427 515 318  79 588],807,5,30992,4.524379562043795,40.0,0.0
46850,4,6850,[427 515 318  79 588],807,5,30997,4.524448985549554,40.0,0.0
46851,4,6851,[322   7  22  82 403],280,3,31000,4.524226503210741,0.0,0.0
46852,4,6852,[427 515 318  79 588],716,5,31005,4.524295928790311,40.0,0.0
46853,4,6853,[427 515 318  79 588],807,5,31010,4.524365334111468,40.0,0.0
46854,4,6854,[427 515 318  79 588],807,5,31015,4.524434719183078,40.0,0.0
46855,4,6855,[180 216  98  12 176],450,5,31020,4.524504084014002,0.0,0.0
46856,4,6856,[427 515 318  79 588],807,5,31025,4.524573428613096,40.0,0.0
46857,4,6857,[427 515 318  79 588],807,5,31030,4.52464275298921,40.0,0.0
46858,4,6858,[427 515 318  79 588],807,5,31035,4.524712057151188,40.0,0.0
46859,4,6859,[427 515 318  79 588],716,5,31040,4.524781341107872,40.0,0.0
46860,4,6860,[427 515 318  79 588],807,5,31045,4.524850604868095,40.0,0.0
46861,4,6861,[427 515 318  79 588],807,5,31050,4.524919848440688,40.0,0.0
46862,4,6862,[427 515 318  79 588],807,5,31055,4.524989071834475,40.0,0.0
46863,4,6863,[427 515 318  79 588],716,5,31060,4.525058275058275,40.0,0.0
46864,4,6864,[427 515 318  79 588],716,5,31065,4.525127458120903,40.0,0.0
46865,4,6865,[427 515 318  79 588],807,5,31070,4.525196621031168,40.0,0.0
46866,4,6866,[427 515 318  79 588],18,5,31075,4.525265763797874,40.0,0.0
46867,4,6867,[427 515 318  79 588],807,5,31080,4.525334886429819,40.0,0.0
46868,4,6868,[427 515 318  79 588],18,5,31085,4.525403988935799,40.0,0.0
46869,4,6869,[427 515 318  79 588],807,5,31090,4.525473071324599,40.0,0.0
46870,4,6870,[427 515 318  79 588],716,5,31095,4.525542133605007,40.0,0.0
46871,4,6871,[427 515 318  79 588],716,5,31100,4.525611175785797,40.0,0.0
46872,4,6872,[427 515 318  79 588],807,5,31105,4.5256801978757455,40.0,0.0
46873,4,6873,[427 515 318  79 588],18,5,31110,4.525749199883619,40.0,0.0
46874,4,6874,[176 183 186 179 132],577,4,31114,4.5256727272727275,0.0,0.0
46875,4,6875,[301  98 210 215 172],450,4,31118,4.525596276905177,0.0,0.0
46876,4,6876,[427 515 318  79 588],18,5,31123,4.525665261014978,40.0,0.0
46877,4,6877,[144 175 181 204  82],716,3,31126,4.525443442861297,0.0,0.0
46878,4,6878,[196 194  82 742  12],577,5,31131,4.525512429132141,0.0,0.0
46879,4,6879,[427 515 318  79 588],18,5,31136,4.525581395348837,40.0,0.0
46880,4,6880,[427 515 318  79 588],716,5,31141,4.5256503415201275,40.0,0.0
46881,4,6881,[357 423 258  12 143],693,4,31145,4.525573961057832,0.0,0.0
46882,4,6882,[427 515 318  79 588],807,5,31150,4.525642888275462,40.0,0.0
46883,4,6883,[427 515 318  79 588],18,5,31155,4.5257117954677515,40.0,0.0
46884,4,6884,[427 515 318  79 588],18,5,31160,4.525780682643428,40.0,0.0
46885,4,6885,[427 515 318  79 588],18,5,31165,4.525849549811211,40.0,0.0
46886,4,6886,[ 56   4 568 143 172],796,5,31170,4.525918396979817,0.0,0.0
46887,4,6887,[427 515 318  79 588],18,5,31175,4.525987224157956,40.0,0.0
46888,4,6888,[427 515 318  79 588],807,5,31180,4.526056031354333,40.0,0.0
46889,4,6889,[427 515 318  79 588],807,5,31185,4.526124818577649,40.0,0.0
46890,4,6890,[405   7 302 179 173],269,1,31186,4.525613118560441,0.0,0.0
46891,4,6891,[ 95   4 173 143 118],796,5,31191,4.5256819500870575,0.0,0.0
46892,4,6892,[318 294 257 357 117],716,5,31196,4.525750761642246,20.0,0.0
46893,4,6893,[427 515 318  79 588],18,5,31201,4.5258195532346965,40.0,0.0
46894,4,6894,[427 515 318  79 588],18,5,31206,4.525888324873097,40.0,0.0
46895,4,6895,[427 515 318  79 588],18,5,31211,4.525957076566125,40.0,0.0
46896,4,6896,[427 515 318  79 588],716,5,31216,4.526025808322459,40.0,0.0
46897,4,6897,[427 515 318  79 588],716,5,31221,4.526094520150768,40.0,0.0
46898,4,6898,[ 12 257 318 269  88],796,4,31225,4.526018263516452,20.0,0.0
46899,4,6899,[427 515 318  79 588],18,5,31230,4.526086956521739,40.0,0.0
46900,4,6900,[427 515 318  79 588],807,5,31235,4.526155629618896,40.0,0.0
46901,4,6901,[427 515 318  79 588],18,5,31240,4.526224282816575,40.0,0.0
46902,4,6902,[427 515 318  79 588],18,5,31245,4.526292916123425,40.0,0.0
46903,4,6903,[427 515 318  79 588],716,5,31250,4.526361529548088,40.0,0.0
46904,4,6904,[427 515 318  79 588],18,5,31255,4.526430123099203,40.0,0.0
46905,4,6905,[313 742  11 385 496],450,5,31260,4.526498696785404,20.0,0.0
46906,4,6906,[427 515 318  79 588],716,5,31265,4.526567250615318,40.0,0.0
46907,4,6907,[210 127 117 204 288],655,1,31266,4.526056745801969,0.0,20.0
46908,4,6908,[427 515 318  79 588],807,5,31271,4.526125343754523,40.0,0.0
46909,4,6909,[427 515 318  79 588],18,5,31276,4.5261939218523874,40.0,0.0
46910,4,6910,[183 168 196 742 496],796,4,31280,4.5261177832441035,20.0,0.0
46911,4,6911,[427 515 318  79 588],807,5,31285,4.526186342592593,40.0,0.0
46912,4,6912,[427 515 318  79 588],716,5,31290,4.526254882106176,40.0,0.0
46913,4,6913,[235 174  97 403 216],256,4,31294,4.526178767717674,0.0,0.0
46914,4,6914,[427 515 318  79 588],716,5,31299,4.526247288503254,40.0,0.0
46915,4,6915,[427 515 318  79 588],18,5,31304,4.526315789473684,40.0,0.0
46916,4,6916,[ 15 174  88 172 215],796,5,31309,4.52638427063756,0.0,0.0
46917,4,6917,[427 515 318  79 588],18,5,31314,4.526452732003469,40.0,0.0
46918,4,6918,[427 515 318  79 588],807,5,31319,4.526521173579997,40.0,0.0
46919,4,6919,[427 515 318  79 588],807,5,31324,4.5265895953757225,40.0,0.0
46920,4,6920,[427 515 318  79 588],18,5,31329,4.526657997399219,40.0,0.0
46921,4,6921,[269  96 211 318  56],655,1,31330,4.526148511990754,20.0,0.0
46922,4,6922,[427 515 318  79 588],716,5,31335,4.5262169579661995,40.0,0.0
46923,4,6923,[427 515 318  79 588],807,5,31340,4.526285384171,40.0,0.0
46924,4,6924,[427 515 318  79 588],716,5,31345,4.526353790613719,40.0,0.0
46925,4,6925,[427 515 318  79 588],18,5,31350,4.5264221773029165,40.0,0.0
46926,4,6926,[427 515 318  79 588],18,5,31355,4.526490544247149,40.0,0.0
46927,4,6927,[427 515 318  79 588],716,5,31360,4.5265588914549655,40.0,0.0
46928,4,6928,[ 89  95  28 125 294],796,3,31363,4.526338576995237,0.0,0.0
46929,4,6929,[427 515 318  79 588],18,5,31368,4.526406926406926,40.0,0.0
46930,4,6930,[427 515 318  79 588],716,5,31373,4.526475256095801,40.0,0.0
46931,4,6931,[427 515 318  79 588],18,5,31378,4.526543566070398,40.0,0.0
46932,4,6932,[427 515 318  79 588],18,5,31383,4.5266118563392475,40.0,0.0
46933,4,6933,[427 515 318  79 588],18,5,31388,4.526680126910874,40.0,0.0
46934,4,6934,[427 515 318  79 588],716,5,31393,4.526748377793799,40.0,0.0
46935,4,6935,[ 82 183 328 313 191],796,4,31397,4.526672433679354,0.0,0.0
46936,4,6936,[427 515 318  79 588],807,5,31402,4.5267406659939455,40.0,0.0
46937,4,6937,[427 515 318  79 588],807,5,31407,4.526808878639377,40.0,0.0
46938,4,6938,[742  69 237 275 204],457,5,31412,4.5268770716241535,0.0,20.0
46939,4,6939,[318 194 235  28 222],807,4,31416,4.526801152737752,20.0,0.0
46940,4,6940,[427 515 318  79 588],807,5,31421,4.526869327186285,40.0,0.0
46941,4,6941,[427 515 318  79 588],807,5,31426,4.526937481993662,40.0,0.0
46942,4,6942,[427 515 318  79 588],18,5,31431,4.5270056171683715,40.0,0.0
46943,4,6943,[427 515 318  79 588],18,5,31436,4.527073732718894,40.0,0.0
46944,4,6944,[427 515 318  79 588],716,5,31441,4.527141828653708,40.0,0.0
46945,4,6945,[427 515 318  79 588],807,5,31446,4.527209904981285,40.0,0.0
46946,4,6946,[597 546   4 301 202],344,3,31449,4.5269900676551025,0.0,0.0
46947,4,6947,[427 515 318  79 588],716,5,31454,4.52705814622913,40.0,0.0
46948,4,6948,[183 125 313 176 301],796,4,31458,4.526982299611455,0.0,0.0
46949,4,6949,[427 515 318  79 588],18,5,31463,4.52705035971223,40.0,0.0
46950,4,6950,[175 228  70 200 211],716,4,31467,4.52697453603798,0.0,0.0
46951,4,6951,[427 515 318  79 588],716,5,31472,4.5270425776754895,40.0,0.0
46952,4,6952,[273 289 276 127  96],655,3,31475,4.526822954120523,0.0,20.0
46953,4,6953,[427 515 318  79 588],716,5,31480,4.52689099798677,40.0,0.0
46954,4,6954,[275 302 301 427 191],389,5,31485,4.526959022286125,20.0,20.0
46955,4,6955,[328   1 288 179  22],450,4,31489,4.526883266244968,0.0,0.0
46956,4,6956,[427 515 318  79 588],18,5,31494,4.526951272100043,40.0,0.0
46957,4,6957,[427 515 318  79 588],716,5,31499,4.527019258407589,40.0,0.0
46958,4,6958,[301  79 196 546 168],151,4,31503,4.526943526368731,0.0,0.0
46959,4,6959,[427 515 318  79 588],18,5,31508,4.527011494252873,40.0,0.0
46960,4,6960,[427 515 318  79 588],18,5,31513,4.52707944260882,40.0,0.0
46961,4,6961,[427 515 318  79 588],18,5,31518,4.527147371444987,40.0,0.0
46962,4,6962,[427 515 318  79 588],18,5,31523,4.527215280769783,40.0,0.0
46963,4,6963,[427 515 318  79 588],716,5,31528,4.527283170591614,40.0,0.0
46964,4,6964,[427 515 318  79 588],807,5,31533,4.52735104091888,40.0,0.0
46965,4,6965,[427 515 318  79 588],807,5,31538,4.527418891759977,40.0,0.0
46966,4,6966,[ 50 496 143  88 100],450,5,31543,4.527486723123295,20.0,40.0
46967,4,6967,[427 515 318  79 588],18,5,31548,4.527554535017222,40.0,0.0
46968,4,6968,[427 515 318  79 588],807,5,31553,4.527622327450136,40.0,0.0
46969,4,6969,[427 515 318  79 588],716,5,31558,4.527690100430416,40.0,0.0
46970,4,6970,[427 515 318  79 588],807,5,31563,4.527757853966432,40.0,0.0
46971,4,6971,[427 515 318  79 588],18,5,31568,4.527825588066552,40.0,0.0
46972,4,6972,[427 515 318  79 588],807,5,31573,4.527893302739137,40.0,0.0
46973,4,6973,[ 50 168  15  28   7],457,5,31578,4.527960997992544,0.0,20.0
46974,4,6974,[427 515 318  79 588],18,5,31583,4.528028673835125,40.0,0.0
46975,4,6975,[427 515 318  79 588],807,5,31588,4.528096330275229,40.0,0.0
46976,4,6976,[427 515 318  79 588],18,5,31593,4.528163967321198,40.0,0.0
46977,4,6977,[427 515 318  79 588],716,5,31598,4.52823158498137,40.0,0.0
46978,4,6978,[183 118 245 234 127],504,2,31600,4.527869322252472,0.0,20.0
46979,4,6979,[405 161  22 121 111],655,0,31600,4.527220630372493,0.0,0.0
46980,4,6980,[427 515 318  79 588],18,5,31605,4.527288354103996,40.0,0.0
46981,4,6981,[200  79 405 185 179],457,5,31610,4.527356058435978,0.0,0.0
46982,4,6982,[427 515 318  79 588],807,5,31615,4.527423743376772,40.0,0.0
46983,4,6983,[111  56 211 385 135],716,3,31618,4.527205040091638,0.0,0.0
46984,4,6984,[174 180  25 210  79],72,5,31623,4.527272727272727,0.0,0.0
46985,4,6985,[294  98  82 181 118],655,1,31624,4.526767821357,0.0,0.0
46986,4,6986,[427 515 318  79 588],716,5,31629,4.526835551738944,40.0,0.0
46987,4,6987,[427 515 318  79 588],807,5,31634,4.526903262736119,40.0,0.0
46988,4,6988,[427 515 318  79 588],807,5,31639,4.526970954356846,40.0,0.0
46989,4,6989,[427 515 318  79 588],716,5,31644,4.527038626609442,40.0,0.0
46990,4,6990,[269 215  12 471 202],655,0,31644,4.5263910742383064,0.0,0.0
46991,4,6991,[427 515 318  79 588],18,5,31649,4.52645881006865,40.0,0.0
46992,4,6992,[427 515 318  79 588],807,5,31654,4.526526526526527,40.0,0.0
46993,4,6993,[427 515 318  79 588],716,5,31659,4.526594223620246,40.0,0.0
46994,4,6994,[427 515 318  79 588],716,5,31664,4.526661901358113,40.0,0.0
46995,4,6995,[427 515 318  79 588],716,5,31669,4.526729559748428,40.0,0.0
46996,4,6996,[427 515 318  79 588],716,5,31674,4.5267971987994855,40.0,0.0
46997,4,6997,[427 515 318  79 588],716,5,31679,4.526864818519577,40.0,0.0
46998,4,6998,[427 515 318  79 588],716,5,31684,4.526932418916988,40.0,0.0
46999,4,6999,[427 515 318  79 588],716,5,31689,4.527,40.0,0.0
47000,4,7000,[427 515 318  79 588],807,5,31694,4.527067561776889,40.0,0.0
47001,4,7001,[427 515 318  79 588],807,5,31699,4.527135104255927,40.0,0.0
47002,4,7002,[427 515 318  79 588],807,5,31704,4.527202627445381,40.0,0.0
47003,4,7003,[427 515 318  79 588],716,5,31709,4.527270131353513,40.0,0.0
47004,4,7004,[427 515 318  79 588],807,5,31714,4.527337615988579,40.0,0.0
47005,4,7005,[427 515 318  79 588],807,5,31719,4.527405081358835,40.0,0.0
47006,4,7006,[427 515 318  79 588],807,5,31724,4.527472527472527,40.0,0.0
47007,4,7007,[151 318  70 302  12],450,5,31729,4.527539954337899,20.0,0.0
47008,4,7008,[427 515 318  79 588],716,5,31734,4.52760736196319,40.0,0.0
47009,4,7009,[427 515 318  79 588],18,5,31739,4.527674750356633,40.0,0.0
47010,4,7010,[427 515 318  79 588],716,5,31744,4.527742119526458,40.0,0.0
47011,4,7011,[427 515 318  79 588],716,5,31749,4.52780946948089,40.0,0.0
47012,4,7012,[427 515 318  79 588],716,5,31754,4.527876800228148,40.0,0.0
47013,4,7013,[  9  98 127 403 405],256,5,31759,4.527944111776447,0.0,20.0
47014,4,7014,[427 515 318  79 588],18,5,31764,4.5280114041339985,40.0,0.0
47015,4,7015,[211 235 173  50 597],23,3,31767,4.527793614595211,0.0,20.0
47016,4,7016,[427 515 318  79 588],18,5,31772,4.527860909220465,40.0,0.0
47017,4,7017,[234 269 748 182 245],450,4,31776,4.527785693929895,0.0,0.0
47018,4,7018,[427 515 318  79 588],18,5,31781,4.5278529705086195,40.0,0.0
47019,4,7019,[427  95 603 185 357],450,4,31785,4.527777777777778,40.0,0.0
47020,4,7020,[427 515 318  79 588],716,5,31790,4.527845036319612,40.0,0.0
47021,4,7021,[ 64  69 403 175   1],655,1,31791,4.527342637425235,20.0,0.0
47022,4,7022,[427 515 318  79 588],807,5,31796,4.527409938772604,40.0,0.0
47023,4,7023,[427 515 318  79 588],18,5,31801,4.52747722095672,40.0,0.0
47024,4,7024,[427 515 318  79 588],18,5,31806,4.527544483985765,40.0,0.0
47025,4,7025,[211 176 210 228 181],450,4,31810,4.5274693993737545,0.0,0.0
47026,4,7026,[427 515 318  79 588],18,5,31815,4.527536644371709,40.0,0.0
47027,4,7027,[427 515 318  79 588],807,5,31820,4.527603870233352,40.0,0.0
47028,4,7028,[427 515 318  79 588],807,5,31825,4.527671076966851,40.0,0.0
47029,4,7029,[100 127 172 121  89],344,4,31829,4.527596017069701,0.0,40.0
47030,4,7030,[427 515 318  79 588],807,5,31834,4.527663205802873,40.0,0.0
47031,4,7031,[427 515 318  79 588],807,5,31839,4.527730375426621,40.0,0.0
47032,4,7032,[427 515 318  79 588],807,5,31844,4.527797525949097,40.0,0.0
47033,4,7033,[427 515 318  79 588],716,5,31849,4.527864657378448,40.0,0.0
47034,4,7034,[427 515 318  79 588],807,5,31854,4.527931769722814,40.0,0.0
47035,4,7035,[427 515 318  79 588],18,5,31859,4.527998862990335,40.0,0.0
47036,4,7036,[427 515 318  79 588],807,5,31864,4.528065937189143,40.0,0.0
47037,4,7037,[427 515 318  79 588],716,5,31869,4.528132992327365,40.0,0.0
47038,4,7038,[427 515 318  79 588],716,5,31874,4.528200028413127,40.0,0.0
47039,4,7039,[427 515 318  79 588],807,5,31879,4.5282670454545455,40.0,0.0
47040,4,7040,[427 515 318  79 588],716,5,31884,4.5283340434597354,40.0,0.0
47041,4,7041,[427 515 318  79 588],807,5,31889,4.528401022436808,40.0,0.0
47042,4,7042,[427 515 318  79 588],716,5,31894,4.528467982393866,40.0,0.0
47043,4,7043,[742 282  97 313  15],593,5,31899,4.528534923339012,0.0,0.0
47044,4,7044,[427 515 318  79 588],18,5,31904,4.528601845280341,40.0,0.0
47045,4,7045,[427 515 318  79 588],807,5,31909,4.528668748225944,40.0,0.0
47046,4,7046,[238 216  56  12 175],11,1,31910,4.528168014758053,0.0,0.0
47047,4,7047,[427 515 318  79 588],716,5,31915,4.5282349602724175,40.0,0.0
47048,4,7048,[427 515 318  79 588],716,5,31920,4.528301886792453,40.0,0.0
47049,4,7049,[  4 180  88  12 286],280,3,31923,4.528085106382979,0.0,20.0
47050,4,7050,[427 515 318  79 588],716,5,31928,4.528152035172316,40.0,0.0
47051,4,7051,[427 515 318  79 588],18,5,31933,4.528218944980147,40.0,0.0
47052,4,7052,[427 515 318  79 588],807,5,31938,4.528285835814547,40.0,0.0
47053,4,7053,[427 515 318  79 588],18,5,31943,4.528352707683584,40.0,0.0
47054,4,7054,[182 202  25 174  56],18,3,31946,4.528136073706591,0.0,0.0
47055,4,7055,[427 515 318  79 588],18,5,31951,4.528202947845805,40.0,0.0
47056,4,7056,[427 515 318  79 588],18,5,31956,4.52826980303245,40.0,0.0
47057,4,7057,[427 515 318  79 588],807,5,31961,4.528336639274582,40.0,0.0
47058,4,7058,[427 515 318  79 588],18,5,31966,4.528403456580252,40.0,0.0
47059,4,7059,[427 515 318  79 588],807,5,31971,4.528470254957507,40.0,0.0
47060,4,7060,[427 515 318  79 588],807,5,31976,4.528537034414389,40.0,0.0
47061,4,7061,[427 515 318  79 588],18,5,31981,4.5286037949589355,40.0,0.0
47062,4,7062,[427 515 318  79 588],807,5,31986,4.528670536599178,40.0,0.0
47063,4,7063,[427 515 318  79 588],18,5,31991,4.528737259343148,40.0,0.0
47064,4,7064,[427 515 318  79 588],807,5,31996,4.528803963198867,40.0,0.0
47065,4,7065,[427 515 318  79 588],18,5,32001,4.528870648174356,40.0,0.0
47066,4,7066,[180 405  28  12 127],457,5,32006,4.528937314277629,0.0,20.0
47067,4,7067,[427 515 318  79 588],716,5,32011,4.529003961516695,40.0,0.0
47068,4,7068,[427 515 318  79 588],716,5,32016,4.529070589899561,40.0,0.0
47069,4,7069,[427 515 318  79 588],807,5,32021,4.5291371994342295,40.0,0.0
47070,4,7070,[427 515 318  79 588],18,5,32026,4.529203790128695,40.0,0.0
47071,4,7071,[168 275 181 235 185],450,4,32030,4.529128959276018,0.0,20.0
47072,4,7072,[427 515 318  79 588],716,5,32035,4.529195532305952,40.0,0.0
47073,4,7073,[427 515 318  79 588],18,5,32040,4.529262086513995,40.0,0.0
47074,4,7074,[302  28  88 742 210],655,1,32041,4.528763250883392,0.0,0.0
47075,4,7075,[427 515 318  79 588],716,5,32046,4.528829847371396,40.0,0.0
47076,4,7076,[427 515 318  79 588],716,5,32051,4.528896425038858,40.0,0.0
47077,4,7077,[427 515 318  79 588],807,5,32056,4.528962983893756,40.0,0.0
47078,4,7078,[427 515 318  79 588],18,5,32061,4.52902952394406,40.0,0.0
47079,4,7079,[427 515 318  79 588],18,5,32066,4.52909604519774,40.0,0.0
47080,4,7080,[427 515 318  79 588],716,5,32071,4.52916254766276,40.0,0.0
47081,4,7081,[427 515 318  79 588],716,5,32076,4.529229031347077,40.0,0.0
47082,4,7082,[ 25 423  79 151 179],389,4,32080,4.529154313144148,0.0,0.0
47083,4,7083,[427 515 318  79 588],716,5,32085,4.529220779220779,40.0,0.0
47084,4,7084,[427 515 318  79 588],18,5,32090,4.529287226534933,40.0,0.0
47085,4,7085,[427 515 318  79 588],807,5,32095,4.529353655094552,40.0,0.0
47086,4,7086,[427 515 318  79 588],18,5,32100,4.529420064907577,40.0,0.0
47087,4,7087,[302 183 269 200  70],450,4,32104,4.529345372460496,0.0,0.0
47088,4,7088,[427 515 318  79 588],716,5,32109,4.529411764705882,40.0,0.0
47089,4,7089,[427 515 318  79 588],716,5,32114,4.529478138222849,40.0,0.0
47090,4,7090,[427 515 318  79 588],18,5,32119,4.52954449301932,40.0,0.0
47091,4,7091,[427 515 318  79 588],716,5,32124,4.529610829103215,40.0,0.0
47092,4,7092,[427 515 318  79 588],18,5,32129,4.529677146482448,40.0,0.0
47093,4,7093,[427 515 318  79 588],807,5,32134,4.529743445164928,40.0,0.0
47094,4,7094,[427 515 318  79 588],18,5,32139,4.529809725158563,40.0,0.0
47095,4,7095,[427 515 318  79 588],807,5,32144,4.529875986471251,40.0,0.0
47096,4,7096,[427 515 318  79 588],807,5,32149,4.529942229110892,40.0,0.0
47097,4,7097,[427 515 318  79 588],807,5,32154,4.530008453085376,40.0,0.0
47098,4,7098,[427 515 318  79 588],716,5,32159,4.530074658402592,40.0,0.0
47099,4,7099,[597 742 258 127 197],457,4,32163,4.53,0.0,20.0
47100,4,7100,[210 176 179 322 187],786,4,32167,4.529925362624982,0.0,0.0
47101,4,7101,[427 515 318  79 588],807,5,32172,4.529991551675584,40.0,0.0
47102,4,7102,[427 515 318  79 588],807,5,32177,4.530057722089258,40.0,0.0
47103,4,7103,[ 79  88 191 288  25],344,4,32181,4.529983108108108,0.0,0.0
47104,4,7104,[168  89  56  64 179],269,4,32185,4.52990851513019,20.0,0.0
47105,4,7105,[427 515 318  79 588],716,5,32190,4.529974669293555,40.0,0.0
47106,4,7106,[ 28 187 222  64 185],693,1,32191,4.529477979456874,20.0,0.0
47107,4,7107,[427 515 318  79 588],716,5,32196,4.529544175576815,40.0,0.0
47108,4,7108,[427 515 318  79 588],807,5,32201,4.5296103530735685,40.0,0.0
47109,4,7109,[427 515 318  79 588],716,5,32206,4.529676511954993,40.0,0.0
47110,4,7110,[427 515 318  79 588],716,5,32211,4.529742652228941,40.0,0.0
47111,4,7111,[603 144  98 237 275],655,3,32214,4.5295275590551185,20.0,20.0
47112,4,7112,[427 515 318  79 588],716,5,32219,4.529593701672993,40.0,0.0
47113,4,7113,[427 515 318  79 588],716,5,32224,4.529659825695811,40.0,0.0
47114,4,7114,[ 25 215 196   4 235],344,3,32227,4.529444834855938,0.0,0.0
47115,4,7115,[427 515 318  79 588],807,5,32232,4.529510961214165,40.0,0.0
47116,4,7116,[143 179 181 204 568],885,3,32235,4.52929605170718,0.0,0.0
47117,4,7117,[427 515 318  79 588],807,5,32240,4.529362180387749,40.0,0.0
47118,4,7118,[427 515 318  79 588],716,5,32245,4.529428290490237,40.0,0.0
47119,4,7119,[427 515 318  79 588],807,5,32250,4.529494382022472,40.0,0.0
47120,4,7120,[427 515 318  79 588],807,5,32255,4.529560454992277,40.0,0.0
47121,4,7121,[427 515 318  79 588],807,5,32260,4.5296265094074695,40.0,0.0
47122,4,7122,[183  11 288 181  22],457,5,32265,4.529692545275867,0.0,0.0
47123,4,7123,[427 515 318  79 588],807,5,32270,4.529758562605278,40.0,0.0
47124,4,7124,[176 100  79  70   1],457,5,32275,4.529824561403509,0.0,20.0
47125,4,7125,[121 179 191 180 161],450,4,32279,4.529750210496772,0.0,0.0
47126,4,7126,[427 515 318  79 588],807,5,32284,4.529816191946121,40.0,0.0
47127,4,7127,[427 515 318  79 588],18,5,32289,4.529882154882155,40.0,0.0
47128,4,7128,[427 515 318  79 588],716,5,32294,4.529948099312667,40.0,0.0
47129,4,7129,[427 515 318  79 588],18,5,32299,4.530014025245442,40.0,0.0
47130,4,7130,[288 265 200 176 132],280,4,32303,4.529939699901837,0.0,0.0
47131,4,7131,[427 515 318  79 588],716,5,32308,4.530005608524958,40.0,0.0
47132,4,7132,[427 515 318  79 588],807,5,32313,4.530071498668162,40.0,0.0
47133,4,7133,[427 515 318  79 588],18,5,32318,4.5301373703392205,40.0,0.0
47134,4,7134,[427 515 318  79 588],716,5,32323,4.5302032235459,40.0,0.0
47135,4,7135,[427 515 318  79 588],18,5,32328,4.530269058295964,40.0,0.0
47136,4,7136,[427 515 318  79 588],716,5,32333,4.53033487459717,40.0,0.0
47137,4,7137,[427 515 318  79 588],18,5,32338,4.5304006724572705,40.0,0.0
47138,4,7138,[427 515 318  79 588],18,5,32343,4.530466451884017,40.0,0.0
47139,4,7139,[427 515 318  79 588],716,5,32348,4.530532212885154,40.0,0.0
47140,4,7140,[427 515 318  79 588],807,5,32353,4.530597955468422,40.0,0.0
47141,4,7141,[237 151   7  89 202],344,4,32357,4.530523662839541,0.0,0.0
47142,4,7142,[ 98 197 269 168   7],535,4,32361,4.53044939101218,0.0,0.0
47143,4,7143,[ 25 273  89 282 194],450,3,32364,4.53023516237402,0.0,0.0
47144,4,7144,[427 515 318  79 588],807,5,32369,4.530300909727082,40.0,0.0
47145,4,7145,[234 200 301   9 186],796,1,32370,4.529806884970613,0.0,0.0
47146,4,7146,[427 515 318  79 588],716,5,32375,4.529872673849168,40.0,0.0
47147,4,7147,[ 98 234 357 215 322],450,4,32379,4.529798545047566,0.0,0.0
47148,4,7148,[ 69 275 173 423  97],457,5,32384,4.529864316687648,0.0,20.0
47149,4,7149,[427 515 318  79 588],716,5,32389,4.52993006993007,40.0,0.0
47150,4,7150,[118 273   9 151 271],796,3,32392,4.529716123619075,0.0,0.0
47151,4,7151,[427 515 318  79 588],18,5,32397,4.529781879194631,40.0,0.0
47152,4,7152,[181 196  22  79 385],577,5,32402,4.529847616384734,0.0,0.0
47153,4,7153,[427 515 318  79 588],18,5,32407,4.529913335197093,40.0,0.0
47154,4,7154,[117  95 216 405 483],280,4,32411,4.5298392732355,0.0,0.0
47155,4,7155,[111 328 546 403 100],796,4,32415,4.529765231973169,0.0,20.0
47156,4,7156,[427 515 318  79 588],18,5,32420,4.529830934749197,40.0,0.0
47157,4,7157,[180 273 282  50 182],450,4,32424,4.5297569153394805,0.0,20.0
47158,4,7158,[427 515 318  79 588],18,5,32429,4.529822600921917,40.0,0.0
47159,4,7159,[427 515 318  79 588],18,5,32434,4.529888268156425,40.0,0.0
47160,4,7160,[182 127 185 204 222],655,3,32437,4.52967462644882,0.0,20.0
47161,4,7161,[427 515 318  79 588],807,5,32442,4.529740296006702,40.0,0.0
47162,4,7162,[597 143 161 210  71],807,5,32447,4.529805947228815,0.0,0.0
47163,4,7163,[ 11 161 222 183  69],280,3,32450,4.529592406476828,0.0,0.0
47164,4,7164,[427 515 318  79 588],716,5,32455,4.529658060013957,40.0,0.0
47165,4,7165,[427 515 318  79 588],807,5,32460,4.529723695227463,40.0,0.0
47166,4,7166,[427 515 318  79 588],716,5,32465,4.5297893121250175,40.0,0.0
47167,4,7167,[427 515 318  79 588],18,5,32470,4.529854910714286,40.0,0.0
47168,4,7168,[427 515 318  79 588],807,5,32475,4.52992049100293,40.0,0.0
47169,4,7169,[427 515 318  79 588],716,5,32480,4.529986052998606,40.0,0.0
47170,4,7170,[427 515 318  79 588],807,5,32485,4.530051596708967,40.0,0.0
47171,4,7171,[427 515 318  79 588],716,5,32490,4.530117122141662,40.0,0.0
47172,4,7172,[200 211 288 435  70],655,1,32491,4.52962498257354,0.0,0.0
47173,4,7173,[427 515 318  79 588],18,5,32496,4.529690549205464,40.0,0.0
47174,4,7174,[427 515 318  79 588],716,5,32501,4.529756097560975,40.0,0.0
47175,4,7175,[ 70 238  88 423 234],269,2,32503,4.529403567447046,0.0,0.0
47176,4,7176,[427 515 318  79 588],807,5,32508,4.529469137522642,40.0,0.0
47177,4,7177,[427 515 318  79 588],18,5,32513,4.529534689328504,40.0,0.0
47178,4,7178,[427 515 318  79 588],18,5,32518,4.529600222872267,40.0,0.0
47179,4,7179,[427 515 318  79 588],716,5,32523,4.52966573816156,40.0,0.0
47180,4,7180,[427 515 318  79 588],18,5,32528,4.529731235204011,40.0,0.0
47181,4,7181,[427 515 318  79 588],716,5,32533,4.52979671400724,40.0,0.0
47182,4,7182,[427 515 318  79 588],18,5,32538,4.5298621745788665,40.0,0.0
47183,4,7183,[427 515 318  79 588],807,5,32543,4.5299276169265035,40.0,0.0
47184,4,7184,[427 515 318  79 588],716,5,32548,4.529993041057759,40.0,0.0
47185,4,7185,[427 515 318  79 588],807,5,32553,4.530058446980239,40.0,0.0
47186,4,7186,[427 515 318  79 588],807,5,32558,4.530123834701545,40.0,0.0
47187,4,7187,[427 515 318  79 588],18,5,32563,4.530189204229271,40.0,0.0
47188,4,7188,[258 144 135 742  69],655,1,32564,4.529698149951314,0.0,0.0
47189,4,7189,[405  69 186   8  96],269,0,32564,4.529068150208623,0.0,0.0
47190,4,7190,[427 515 318  79 588],18,5,32569,4.529133639271311,40.0,0.0
47191,4,7191,[427 515 318  79 588],807,5,32574,4.5291991101223585,40.0,0.0
47192,4,7192,[427 515 318  79 588],807,5,32579,4.5292645627693595,40.0,0.0
47193,4,7193,[257 202 174 151  96],716,4,32583,4.529190992493745,0.0,0.0
47194,4,7194,[153  69 300  22 173],629,5,32588,4.529256428075052,0.0,0.0
47195,4,7195,[427 515 318  79 588],716,5,32593,4.529321845469705,40.0,0.0
47196,4,7196,[427 515 318  79 588],716,5,32598,4.529387244685285,40.0,0.0
47197,4,7197,[427 515 318  79 588],716,5,32603,4.52945262572937,40.0,0.0
47198,4,7198,[427 515 318  79 588],807,5,32608,4.529517988609529,40.0,0.0
47199,4,7199,[427 515 318  79 588],18,5,32613,4.529583333333333,40.0,0.0
47200,4,7200,[427 515 318  79 588],18,5,32618,4.529648659908346,40.0,0.0
47201,4,7201,[427 515 318  79 588],18,5,32623,4.5297139683421275,40.0,0.0
47202,4,7202,[427 515 318  79 588],807,5,32628,4.5297792586422325,40.0,0.0
47203,4,7203,[427 515 318  79 588],18,5,32633,4.529844530816213,40.0,0.0
47204,4,7204,[427 515 318  79 588],716,5,32638,4.5299097848716166,40.0,0.0
47205,4,7205,[ 22 172 182 357 100],450,5,32643,4.529975020815987,0.0,20.0
47206,4,7206,[427 515 318  79 588],716,5,32648,4.530040238656861,40.0,0.0
47207,4,7207,[168 153 265   7  69],151,4,32652,4.5299667036625975,0.0,0.0
47208,4,7208,[181 748 196 742 597],450,5,32657,4.53003190456374,0.0,0.0
47209,4,7209,[427 515 318  79 588],807,5,32662,4.530097087378641,40.0,0.0
47210,4,7210,[427 515 318  79 588],716,5,32667,4.530162252114825,40.0,0.0
47211,4,7211,[427 515 318  79 588],716,5,32672,4.530227398779812,40.0,0.0
47212,4,7212,[228 210 216 271 187],796,4,32676,4.530153888811867,0.0,0.0
47213,4,7213,[427 515 318  79 588],18,5,32681,4.530219018574993,40.0,0.0
47214,4,7214,[427 515 318  79 588],807,5,32686,4.53028413028413,40.0,0.0
47215,4,7215,[427 515 318  79 588],807,5,32691,4.530349223946785,40.0,0.0
47216,4,7216,[427 515 318  79 588],18,5,32696,4.530414299570459,40.0,0.0
47217,4,7217,[427 515 318  79 588],716,5,32701,4.5304793571626485,40.0,0.0
47218,4,7218,[ 71 127 588  22 385],807,4,32705,4.530405873389666,0.0,20.0
47219,4,7219,[427 515 318  79 588],18,5,32710,4.530470914127424,40.0,0.0
47220,4,7220,[515 135 132 257 318],807,5,32715,4.5305359368508515,20.0,0.0
47221,4,7221,[427 515 318  79 588],807,5,32720,4.530600941567433,40.0,0.0
47222,4,7222,[427 515 318  79 588],18,5,32725,4.530665928284646,40.0,0.0
47223,4,7223,[ 88 588  95  70 172],344,3,32728,4.530454042081949,0.0,0.0
47224,4,7224,[427 515 318  79 588],716,5,32733,4.530519031141869,40.0,0.0
47225,4,7225,[153 215 403 200 318],504,3,32736,4.5303072239136455,20.0,0.0
47226,4,7226,[427 515 318  79 588],18,5,32741,4.530372215303722,40.0,0.0
47227,4,7227,[427 515 318  79 588],716,5,32746,4.53043718871057,40.0,0.0
47228,4,7228,[153 471 282 182  71],593,3,32749,4.530225480702725,0.0,0.0
47229,4,7229,[427 515 318  79 588],716,5,32754,4.530290456431535,40.0,0.0
47230,4,7230,[427 515 318  79 588],716,5,32759,4.530355414188909,40.0,0.0
47231,4,7231,[427 515 318  79 588],18,5,32764,4.530420353982301,40.0,0.0
47232,4,7232,[427 515 318  79 588],716,5,32769,4.530485275819162,40.0,0.0
47233,4,7233,[427 515 318  79 588],716,5,32774,4.53055017970694,40.0,0.0
47234,4,7234,[427 515 318  79 588],807,5,32779,4.530615065653075,40.0,0.0
47235,4,7235,[427 515 318  79 588],18,5,32784,4.5306799336650085,40.0,0.0
47236,4,7236,[427 515 318  79 588],716,5,32789,4.530744783750173,40.0,0.0
47237,4,7237,[427 515 318  79 588],807,5,32794,4.530809615915999,40.0,0.0
47238,4,7238,[427 515 318  79 588],807,5,32799,4.530874430169913,40.0,0.0
47239,4,7239,[427 515 318  79 588],18,5,32804,4.530939226519337,40.0,0.0
47240,4,7240,[427 515 318  79 588],716,5,32809,4.531004004971689,40.0,0.0
47241,4,7241,[ 88 234 127 172 302],389,4,32813,4.5309306821320074,0.0,20.0
47242,4,7242,[ 97 228 333 508 181],693,1,32814,4.530443186524921,0.0,0.0
47243,4,7243,[427 515 318  79 588],18,5,32819,4.530508006626174,40.0,0.0
47244,4,7244,[427 515 318  79 588],18,5,32824,4.5305728088336785,40.0,0.0
47245,4,7245,[282 144 197 301 471],535,3,32827,4.530361578802098,0.0,0.0
47246,4,7246,[427 515 318  79 588],807,5,32832,4.530426383331034,40.0,0.0
47247,4,7247,[427 515 318  79 588],716,5,32837,4.530491169977925,40.0,0.0
47248,4,7248,[427 515 318  79 588],716,5,32842,4.530555938750172,40.0,0.0
47249,4,7249,[427 515 318  79 588],18,5,32847,4.530620689655173,40.0,0.0
47250,4,7250,[427 515 318  79 588],716,5,32852,4.5306854227003175,40.0,0.0
47251,4,7251,[174 143 215 515  28],716,5,32857,4.530750137892995,0.0,0.0
47252,4,7252,[ 98  79  50 195 294],457,4,32861,4.530676961257411,0.0,20.0
47253,4,7253,[427 515 318  79 588],807,5,32866,4.530741659773918,40.0,0.0
47254,4,7254,[427 515 318  79 588],716,5,32871,4.530806340454859,40.0,0.0
47255,4,7255,[427 515 318  79 588],807,5,32876,4.530871003307608,40.0,0.0
47256,4,7256,[427 515 318  79 588],716,5,32881,4.530935648339534,40.0,0.0
47257,4,7257,[265 742 257 125 111],796,4,32885,4.530862496555525,0.0,0.0
47258,4,7258,[275  28 405 385  71],450,4,32889,4.5307893649262985,0.0,20.0
47259,4,7259,[427 515 318  79 588],807,5,32894,4.530853994490358,40.0,0.0
47260,4,7260,[ 12 111 176 228 546],457,3,32897,4.530643162098884,0.0,0.0
47261,4,7261,[427 515 318  79 588],18,5,32902,4.530707793996144,40.0,0.0
47262,4,7262,[427 515 318  79 588],807,5,32907,4.530772408095828,40.0,0.0
47263,4,7263,[427 515 318  79 588],716,5,32912,4.530837004405286,40.0,0.0
47264,4,7264,[427 515 318  79 588],716,5,32917,4.5309015829318655,40.0,0.0
47265,4,7265,[182 117 269 196   4],450,4,32921,4.53082851637765,0.0,0.0
47266,4,7266,[132 111 100   8 211],389,4,32925,4.530755469932572,0.0,20.0
47267,4,7267,[427 515 318  79 588],807,5,32930,4.530820033021464,40.0,0.0
47268,4,7268,[427 515 318  79 588],807,5,32935,4.530884578346402,40.0,0.0
47269,4,7269,[235 222 111 237 200],450,2,32937,4.530536451169189,0.0,0.0
47270,4,7270,[427 515 318  79 588],807,5,32942,4.530601017741714,40.0,0.0
47271,4,7271,[427 515 318  79 588],18,5,32947,4.530665566556656,40.0,0.0
47272,4,7272,[427 515 318  79 588],716,5,32952,4.53073009762134,40.0,0.0
47273,4,7273,[427 515 318  79 588],716,5,32957,4.530794610943085,40.0,0.0
47274,4,7274,[427 515 318  79 588],807,5,32962,4.53085910652921,40.0,0.0
47275,4,7275,[313 275 322   1  22],450,5,32967,4.5309235843870255,0.0,20.0
47276,4,7276,[427 515 318  79 588],807,5,32972,4.530988044523842,40.0,0.0
47277,4,7277,[427 515 318  79 588],716,5,32977,4.5310524869469635,40.0,0.0
47278,4,7278,[185 176 286 237 121],796,4,32981,4.530979530155241,0.0,20.0
47279,4,7279,[427 515 318  79 588],18,5,32986,4.531043956043956,40.0,0.0
47280,4,7280,[427 515 318  79 588],716,5,32991,4.531108364235682,40.0,0.0
47281,4,7281,[427 515 318  79 588],807,5,32996,4.531172754737709,40.0,0.0
47282,4,7282,[427 515 318  79 588],716,5,33001,4.5312371275573256,40.0,0.0
47283,4,7283,[427 515 318  79 588],716,5,33006,4.531301482701812,40.0,0.0
47284,4,7284,[427 515 318  79 588],807,5,33011,4.531365820178449,40.0,0.0
47285,4,7285,[  9 265 655  97 603],655,1,33012,4.530881141916003,20.0,0.0
47286,4,7286,[186  70 301  12 100],151,4,33016,4.530808288733361,0.0,20.0
47287,4,7287,[196 132  98  22 197],716,5,33021,4.530872667398463,0.0,0.0
47288,4,7288,[322 483   7 153  82],151,2,33023,4.530525449307175,0.0,0.0
47289,4,7289,[427 515 318  79 588],18,5,33028,4.530589849108368,40.0,0.0
47290,4,7290,[427 515 318  79 588],807,5,33033,4.530654231243999,40.0,0.0
47291,4,7291,[ 95 185 125 180 222],450,3,33036,4.530444322545255,0.0,0.0
47292,4,7292,[427 515 318  79 588],807,5,33041,4.530508706979295,40.0,0.0
47293,4,7293,[427 515 318  79 588],716,5,33046,4.530573073759254,40.0,0.0
47294,4,7294,[427 515 318  79 588],18,5,33051,4.530637422892392,40.0,0.0
47295,4,7295,[427 515 318  79 588],807,5,33056,4.530701754385965,40.0,0.0
47296,4,7296,[427 515 318  79 588],807,5,33061,4.530766068247225,40.0,0.0
47297,4,7297,[427 515 318  79 588],807,5,33066,4.53083036448342,40.0,0.0
47298,4,7298,[427 515 318  79 588],807,5,33071,4.530894643101795,40.0,0.0
47299,4,7299,[427 515 318  79 588],807,5,33076,4.530958904109589,40.0,0.0
47300,4,7300,[ 89 176 151 181 269],23,3,33079,4.530749212436652,0.0,0.0
47301,4,7301,[427 515 318  79 588],18,5,33084,4.530813475760065,40.0,0.0
47302,4,7302,[427 515 318  79 588],716,5,33089,4.530877721484321,40.0,0.0
47303,4,7303,[427 515 318  79 588],18,5,33094,4.530941949616649,40.0,0.0
47304,4,7304,[427 515 318  79 588],807,5,33099,4.531006160164271,40.0,0.0
47305,4,7305,[187 197  22 269  50],704,4,33103,4.530933479332056,0.0,20.0
47306,4,7306,[427 515 318  79 588],18,5,33108,4.530997673463802,40.0,0.0
47307,4,7307,[427 515 318  79 588],807,5,33113,4.531061850027367,40.0,0.0
47308,4,7308,[427 515 318  79 588],716,5,33118,4.531126009029963,40.0,0.0
47309,4,7309,[202 127 275 496 132],389,5,33123,4.531190150478796,20.0,40.0
47310,4,7310,[427 515 318  79 588],716,5,33128,4.5312542743810695,40.0,0.0
47311,4,7311,[427 515 318  79 588],716,5,33133,4.531318380743983,40.0,0.0
47312,4,7312,[427 515 318  79 588],18,5,33138,4.53138246957473,40.0,0.0
47313,4,7313,[427 515 318  79 588],807,5,33143,4.531446540880503,40.0,0.0
47314,4,7314,[427 515 318  79 588],18,5,33148,4.5315105946684895,40.0,0.0
47315,4,7315,[117 273 234 405 357],655,2,33150,4.531164570803718,0.0,0.0
47316,4,7316,[427 515 318  79 588],18,5,33155,4.531228645619789,40.0,0.0
47317,4,7317,[427 515 318  79 588],18,5,33160,4.531292702924296,40.0,0.0
47318,4,7318,[427 515 318  79 588],18,5,33165,4.531356742724416,40.0,0.0
47319,4,7319,[172 197 151 191 603],796,4,33169,4.531284153005465,20.0,0.0
47320,4,7320,[135 258 603  89 181],151,5,33174,4.531348176478623,20.0,0.0
47321,4,7321,[427 515 318  79 588],18,5,33179,4.531412182463808,40.0,0.0
47322,4,7322,[181 121 210  11 427],535,5,33184,4.531476170968182,20.0,0.0
47323,4,7323,[187 135 300 235  71],450,2,33186,4.531130529765155,0.0,0.0
47324,4,7324,[427 515 318  79 588],716,5,33191,4.531194539249147,40.0,0.0
47325,4,7325,[427 515 318  79 588],716,5,33196,4.531258531258532,40.0,0.0
47326,4,7326,[427 515 318  79 588],807,5,33201,4.531322505800464,40.0,0.0
47327,4,7327,[427 515 318  79 588],716,5,33206,4.531386462882096,40.0,0.0
47328,4,7328,[427 515 318  79 588],807,5,33211,4.531450402510575,40.0,0.0
47329,4,7329,[427 515 318  79 588],807,5,33216,4.531514324693043,40.0,0.0
47330,4,7330,[427 515 318  79 588],18,5,33221,4.531578229436639,40.0,0.0
47331,4,7331,[  1  64 100  15  97],450,4,33225,4.531505728314239,20.0,20.0
47332,4,7332,[427 515 318  79 588],716,5,33230,4.5315696168007635,40.0,0.0
47333,4,7333,[427 515 318  79 588],716,5,33235,4.53163348786474,40.0,0.0
47334,4,7334,[135   8 144 215 181],280,2,33237,4.531288343558282,0.0,0.0
47335,4,7335,[471 318 742 211 546],693,1,33238,4.530806979280261,20.0,0.0
47336,4,7336,[111  64 748 515 100],401,3,33241,4.5305983371950385,20.0,20.0
47337,4,7337,[427 515 318  79 588],807,5,33246,4.5306623058053965,40.0,0.0
47338,4,7338,[ 82 655  56 204 301],450,4,33250,4.530589998637416,0.0,0.0
47339,4,7339,[237   9 187 268 132],535,3,33253,4.530381471389646,0.0,0.0
47340,4,7340,[427 515 318  79 588],18,5,33258,4.530445443400081,40.0,0.0
47341,4,7341,[427 515 318  79 588],716,5,33263,4.530509397984201,40.0,0.0
47342,4,7342,[427 515 318  79 588],18,5,33268,4.530573335149121,40.0,0.0
47343,4,7343,[427 515 318  79 588],807,5,33273,4.5306372549019605,40.0,0.0
47344,4,7344,[427 515 318  79 588],716,5,33278,4.53070115724983,40.0,0.0
47345,4,7345,[427 515 318  79 588],807,5,33283,4.530765042199836,40.0,0.0
47346,4,7346,[427 515 318  79 588],716,5,33288,4.5308289097590855,40.0,0.0
47347,4,7347,[427 515 318  79 588],18,5,33293,4.530892759934676,40.0,0.0
47348,4,7348,[300  50   9 151 258],535,4,33297,4.5308205197986124,0.0,20.0
47349,4,7349,[427 515 318  79 588],18,5,33302,4.530884353741497,40.0,0.0
47350,4,7350,[427 515 318  79 588],716,5,33307,4.530948170316964,40.0,0.0
47351,4,7351,[294 403 276  11 282],457,4,33311,4.530875952121872,0.0,0.0
47352,4,7352,[132  64 318 118 568],796,5,33316,4.53093975248198,40.0,0.0
47353,4,7353,[427 515 318  79 588],807,5,33321,4.531003535490889,40.0,0.0
47354,4,7354,[125  71 238  97 153],796,3,33324,4.530795377294358,0.0,0.0
47355,4,7355,[427 515 318  79 588],18,5,33329,4.530859162588364,40.0,0.0
47356,4,7356,[427 515 318  79 588],18,5,33334,4.53092293054234,40.0,0.0
47357,4,7357,[ 12 187 546  70 282],450,5,33339,4.53098668116336,0.0,0.0
47358,4,7358,[427 515 318  79 588],18,5,33344,4.531050414458486,40.0,0.0
47359,4,7359,[427 515 318  79 588],716,5,33349,4.531114130434783,40.0,0.0
47360,4,7360,[318   7 132  64 215],655,2,33351,4.530770275777748,40.0,0.0
47361,4,7361,[427 515 318  79 588],716,5,33356,4.530834012496604,40.0,0.0
47362,4,7362,[427 515 318  79 588],807,5,33361,4.5308977319027575,40.0,0.0
47363,4,7363,[427 515 318  79 588],807,5,33366,4.530961434003259,40.0,0.0
47364,4,7364,[ 28 588  50   7  79],577,4,33370,4.5308893414799725,0.0,20.0
47365,4,7365,[427 515 318  79 588],716,5,33375,4.530953027423296,40.0,0.0
47366,4,7366,[427 515 318  79 588],18,5,33380,4.531016696077101,40.0,0.0
47367,4,7367,[204 197 403 483  96],457,5,33385,4.531080347448426,0.0,0.0
47368,4,7368,[ 96 318 405 179 288],655,2,33387,4.530736870674447,20.0,0.0
47369,4,7369,[427 515 318  79 588],716,5,33392,4.530800542740841,40.0,0.0
47370,4,7370,[427 515 318  79 588],716,5,33397,4.530864197530864,40.0,0.0
47371,4,7371,[427 515 318  79 588],716,5,33402,4.530927835051546,40.0,0.0
47372,4,7372,[427 515 318  79 588],807,5,33407,4.530991455309914,40.0,0.0
47373,4,7373,[427 515 318  79 588],807,5,33412,4.531055058312991,40.0,0.0
47374,4,7374,[ 79 234  12 161 357],450,4,33416,4.530983050847458,0.0,0.0
47375,4,7375,[427 515 318  79 588],716,5,33421,4.531046637744034,40.0,0.0
47376,4,7376,[427 515 318  79 588],18,5,33426,4.531110207401382,40.0,0.0
47377,4,7377,[180 196 216 132 282],457,5,33431,4.531173759826511,0.0,0.0
47378,4,7378,[427 515 318  79 588],716,5,33436,4.531237295026426,40.0,0.0
47379,4,7379,[427 515 318  79 588],716,5,33441,4.53130081300813,40.0,0.0
47380,4,7380,[427 515 318  79 588],716,5,33446,4.531364313778621,40.0,0.0
47381,4,7381,[427 515 318  79 588],716,5,33451,4.531427797344893,40.0,0.0
47382,4,7382,[427 515 318  79 588],18,5,33456,4.531491263713938,40.0,0.0
47383,4,7383,[100 194 143  56  50],796,4,33460,4.531419284940411,0.0,40.0
47384,4,7384,[427 515 318  79 588],807,5,33465,4.531482735274205,40.0,0.0
47385,4,7385,[427 515 318  79 588],807,5,33470,4.531546168426753,40.0,0.0
47386,4,7386,[427 515 318  79 588],716,5,33475,4.531609584405036,40.0,0.0
47387,4,7387,[427 515 318  79 588],807,5,33480,4.531672983216026,40.0,0.0
47388,4,7388,[427 515 318  79 588],716,5,33485,4.531736364866694,40.0,0.0
47389,4,7389,[427 515 318  79 588],807,5,33490,4.531799729364005,40.0,0.0
47390,4,7390,[111  89  98 568  22],796,5,33495,4.531863076714924,0.0,0.0
47391,4,7391,[427 515 318  79 588],18,5,33500,4.531926406926407,40.0,0.0
47392,4,7392,[427 515 318  79 588],716,5,33505,4.53198972000541,40.0,0.0
47393,4,7393,[427 515 318  79 588],807,5,33510,4.532053015958885,40.0,0.0
47394,4,7394,[427 515 318  79 588],807,5,33515,4.53211629479378,40.0,0.0
47395,4,7395,[ 11 282 276  50  88],593,4,33519,4.532044348296377,0.0,20.0
47396,4,7396,[168 302 496 597 568],450,5,33524,4.5321076111937275,20.0,0.0
47397,4,7397,[427 515 318  79 588],716,5,33529,4.532170856988375,40.0,0.0
47398,4,7398,[427 515 318  79 588],18,5,33534,4.532234085687255,40.0,0.0
47399,4,7399,[427 515 318  79 588],18,5,33539,4.532297297297298,40.0,0.0
47400,4,7400,[427 515 318  79 588],716,5,33544,4.532360491825429,40.0,0.0
47401,4,7401,[427 515 318  79 588],18,5,33549,4.5324236692785735,40.0,0.0
47402,4,7402,[ 22 568  11 183 191],269,1,33550,4.531946508172362,0.0,0.0
47403,4,7403,[427 515 318  79 588],716,5,33555,4.532009724473258,40.0,0.0
47404,4,7404,[427 515 318  79 588],716,5,33560,4.532072923700203,40.0,0.0
47405,4,7405,[655 118 197  98 265],72,4,33564,4.532001080205239,0.0,0.0
47406,4,7406,[427 515 318  79 588],18,5,33569,4.532064263534495,40.0,0.0
47407,4,7407,[195 200 182   7 202],450,4,33573,4.531992440604752,0.0,0.0
47408,4,7408,[ 15  82 258 191 275],457,5,33578,4.532055608044271,0.0,20.0
47409,4,7409,[427 515 318  79 588],807,5,33583,4.532118758434548,40.0,0.0
47410,4,7410,[427 515 318  79 588],807,5,33588,4.532181891782486,40.0,0.0
47411,4,7411,[427 515 318  79 588],807,5,33593,4.532245008094981,40.0,0.0
47412,4,7412,[427 515 318  79 588],807,5,33598,4.532308107378929,40.0,0.0
47413,4,7413,[427 515 318  79 588],807,5,33603,4.5323711896412195,40.0,0.0
47414,4,7414,[191 483 288 121 143],450,2,33605,4.532029669588671,0.0,0.0
47415,4,7415,[427 515 318  79 588],716,5,33610,4.5320927723840345,40.0,0.0
47416,4,7416,[427 515 318  79 588],807,5,33615,4.532155858163678,40.0,0.0
47417,4,7417,[427 515 318  79 588],18,5,33620,4.532218926934483,40.0,0.0
47418,4,7418,[427 515 318  79 588],807,5,33625,4.532281978703329,40.0,0.0
47419,4,7419,[427 515 318  79 588],716,5,33630,4.532345013477089,40.0,0.0
47420,4,7420,[427 515 318  79 588],716,5,33635,4.532408031262633,40.0,0.0
47421,4,7421,[427 515 318  79 588],716,5,33640,4.532471032066828,40.0,0.0
47422,4,7422,[427 515 318  79 588],716,5,33645,4.5325340158965375,40.0,0.0
47423,4,7423,[427 515 318  79 588],716,5,33650,4.532596982758621,40.0,0.0
47424,4,7424,[427 515 318  79 588],716,5,33655,4.532659932659933,40.0,0.0
47425,4,7425,[427 515 318  79 588],716,5,33660,4.532722865607326,40.0,0.0
47426,4,7426,[427 515 318  79 588],18,5,33665,4.532785781607648,40.0,0.0
47427,4,7427,[427 515 318  79 588],716,5,33670,4.532848680667744,40.0,0.0
47428,4,7428,[427 515 318  79 588],807,5,33675,4.532911562794454,40.0,0.0
47429,4,7429,[427 515 318  79 588],18,5,33680,4.532974427994616,40.0,0.0
47430,4,7430,[427 515 318  79 588],807,5,33685,4.533037276275064,40.0,0.0
47431,4,7431,[427 515 318  79 588],18,5,33690,4.5331001076426265,40.0,0.0
47432,4,7432,[ 28 294 100 185 132],450,5,33695,4.53316292210413,0.0,20.0
47433,4,7433,[245 269 288  28 597],450,4,33699,4.533091202582728,0.0,0.0
47434,4,7434,[258 276 423 168  64],535,4,33703,4.533019502353732,20.0,0.0
47435,4,7435,[181 143 282 194 117],450,5,33708,4.533082302313072,0.0,0.0
47436,4,7436,[ 11 182 172  28 183],457,5,33713,4.533145085383891,0.0,0.0
47437,4,7437,[427 515 318  79 588],807,5,33718,4.533207851573003,40.0,0.0
47438,4,7438,[427 515 318  79 588],18,5,33723,4.533270600887216,40.0,0.0
47439,4,7439,[427 515 318  79 588],18,5,33728,4.533333333333333,40.0,0.0
47440,4,7440,[427 515 318  79 588],807,5,33733,4.533396048918156,40.0,0.0
47441,4,7441,[427 515 318  79 588],716,5,33738,4.533458747648481,40.0,0.0
47442,4,7442,[427 515 318  79 588],18,5,33743,4.5335214295311035,40.0,0.0
47443,4,7443,[427 515 318  79 588],807,5,33748,4.53358409457281,40.0,0.0
47444,4,7444,[427 515 318  79 588],18,5,33753,4.533646742780389,40.0,0.0
47445,4,7445,[427 515 318  79 588],807,5,33758,4.533709374160623,40.0,0.0
47446,4,7446,[427 515 318  79 588],807,5,33763,4.53377198872029,40.0,0.0
47447,4,7447,[427 515 318  79 588],807,5,33768,4.533834586466165,40.0,0.0
47448,4,7448,[427 515 318  79 588],807,5,33773,4.533897167405021,40.0,0.0
47449,4,7449,[173 275 276 172  22],316,2,33775,4.533557046979865,0.0,20.0
47450,4,7450,[427 515 318  79 588],716,5,33780,4.5336196483693465,40.0,0.0
47451,4,7451,[427 515 318  79 588],807,5,33785,4.533682232957595,40.0,0.0
47452,4,7452,[427 515 318  79 588],807,5,33790,4.533744800751375,40.0,0.0
47453,4,7453,[ 15   7 423 515 216],269,2,33792,4.533404883284143,0.0,0.0
47454,4,7454,[427 515 318  79 588],807,5,33797,4.533467471495641,40.0,0.0
47455,4,7455,[603  98 269 271  88],655,2,33799,4.533127682403434,20.0,0.0
47456,4,7456,[655  15  56 153 118],593,4,33803,4.533056188815878,0.0,0.0
47457,4,7457,[427 515 318  79 588],18,5,33808,4.533118798605524,40.0,0.0
47458,4,7458,[427 515 318  79 588],807,5,33813,4.533181391607454,40.0,0.0
47459,4,7459,[427 515 318  79 588],18,5,33818,4.533243967828418,40.0,0.0
47460,4,7460,[204 427   9 197 135],151,5,33823,4.5333065272751645,20.0,0.0
47461,4,7461,[427 515 318  79 588],807,5,33828,4.533369069954436,40.0,0.0
47462,4,7462,[427 515 318  79 588],18,5,33833,4.533431595872973,40.0,0.0
47463,4,7463,[427 515 318  79 588],716,5,33838,4.533494105037513,40.0,0.0
47464,4,7464,[427 515 318  79 588],18,5,33843,4.533556597454789,40.0,0.0
47465,4,7465,[427 515 318  79 588],18,5,33848,4.53361907313153,40.0,0.0
47466,4,7466,[427 515 318  79 588],716,5,33853,4.533681532074461,40.0,0.0
47467,4,7467,[195 216 245 357 185],450,5,33858,4.533743974290306,0.0,0.0
47468,4,7468,[427 515 318  79 588],18,5,33863,4.533806399785782,40.0,0.0
47469,4,7469,[427 515 318  79 588],716,5,33868,4.533868808567604,40.0,0.0
47470,4,7470,[427 515 318  79 588],807,5,33873,4.533931200642484,40.0,0.0
47471,4,7471,[427 515 318  79 588],18,5,33878,4.533993576017131,40.0,0.0
47472,4,7472,[427 515 318  79 588],716,5,33883,4.534055934698247,40.0,0.0
47473,4,7473,[427 515 318  79 588],716,5,33888,4.534118276692534,40.0,0.0
47474,4,7474,[427 515 318  79 588],716,5,33893,4.534180602006689,40.0,0.0
47475,4,7475,[427 515 318  79 588],18,5,33898,4.534242910647405,40.0,0.0
47476,4,7476,[385  25 197 258 234],151,4,33902,4.534171459141366,0.0,0.0
47477,4,7477,[427 515 318  79 588],18,5,33907,4.534233752340198,40.0,0.0
47478,4,7478,[265 125 235  56 182],450,4,33911,4.534162321165931,0.0,0.0
47479,4,7479,[427 515 318  79 588],716,5,33916,4.534224598930481,40.0,0.0
47480,4,7480,[427 515 318  79 588],716,5,33921,4.534286860045449,40.0,0.0
47481,4,7481,[427 515 318  79 588],807,5,33926,4.534349104517509,40.0,0.0
47482,4,7482,[ 64  79 234 546 215],450,4,33930,4.534277696111185,20.0,0.0
47483,4,7483,[427 515 318  79 588],18,5,33935,4.534339925173704,40.0,0.0
47484,4,7484,[111  79 427 228  12],796,5,33940,4.53440213760855,20.0,0.0
47485,4,7485,[427 515 318  79 588],18,5,33945,4.534464333422388,40.0,0.0
47486,4,7486,[427 515 318  79 588],807,5,33950,4.534526512621878,40.0,0.0
47487,4,7487,[427 515 318  79 588],18,5,33955,4.5345886752136755,40.0,0.0
47488,4,7488,[427 515 318  79 588],716,5,33960,4.534650821204433,40.0,0.0
47489,4,7489,[186 132 215 211 300],796,3,33963,4.534445927903872,0.0,0.0
47490,4,7490,[427 515 318  79 588],807,5,33968,4.534508076358296,40.0,0.0
47491,4,7491,[496 200 427 357  97],716,5,33973,4.534570208222104,40.0,0.0
47492,4,7492,[427 515 318  79 588],716,5,33978,4.534632323501935,40.0,0.0
47493,4,7493,[ 12 423  25 180 151],18,3,33981,4.534427542033627,0.0,0.0
47494,4,7494,[200 282 603 568 176],655,2,33983,4.534089392928619,20.0,0.0
47495,4,7495,[427 515 318  79 588],807,5,33988,4.534151547491995,40.0,0.0
47496,4,7496,[ 95 174 258 173  15],798,5,33993,4.53421368547419,0.0,0.0
47497,4,7497,[427 515 318  79 588],807,5,33998,4.534275806881835,40.0,0.0
47498,4,7498,[ 69 186   4  71 282],796,4,34002,4.534204560608081,0.0,0.0
47499,4,7499,[427 515 318  79 588],18,5,34007,4.5342666666666664,40.0,0.0
47500,4,7500,[427 515 318  79 588],18,5,34012,4.534328756165845,40.0,0.0
47501,4,7501,[427 515 318  79 588],716,5,34017,4.534390829112237,40.0,0.0
47502,4,7502,[ 11 288 204 302   9],344,4,34021,4.534319605491137,0.0,0.0
47503,4,7503,[ 97 191 245  25  69],344,2,34023,4.533981876332622,0.0,0.0
47504,4,7504,[427 515 318  79 588],18,5,34028,4.534043970686209,40.0,0.0
47505,4,7505,[427 515 318  79 588],807,5,34033,4.534106048494538,40.0,0.0
47506,4,7506,[427 515 318  79 588],807,5,34038,4.53416810976422,40.0,0.0
47507,4,7507,[427 515 318  79 588],716,5,34043,4.534230154501865,40.0,0.0
47508,4,7508,[ 50 181 273 100   7],344,4,34047,4.534159009188973,0.0,40.0
47509,4,7509,[427 515 318  79 588],716,5,34052,4.53422103861518,40.0,0.0
47510,4,7510,[  1  64 215 179 318],450,5,34057,4.534283051524431,40.0,0.0
47511,4,7511,[257 202  82  56 483],23,2,34059,4.5339456869009584,0.0,0.0
47512,4,7512,[427 515 318  79 588],716,5,34064,4.534007719952083,40.0,0.0
47513,4,7513,[427 515 318  79 588],18,5,34069,4.534069736491881,40.0,0.0
47514,4,7514,[427 515 318  79 588],18,5,34074,4.5341317365269465,40.0,0.0
47515,4,7515,[427 515 318  79 588],18,5,34079,4.534193720063864,40.0,0.0
47516,4,7516,[301  69   4 202 173],796,4,34083,4.53412265531462,0.0,0.0
47517,4,7517,[427 515 318  79 588],807,5,34088,4.534184623570098,40.0,0.0
47518,4,7518,[427 515 318  79 588],807,5,34093,4.534246575342466,40.0,0.0
47519,4,7519,[427 515 318  79 588],807,5,34098,4.534308510638298,40.0,0.0
47520,4,7520,[427 515 318  79 588],716,5,34103,4.534370429464167,40.0,0.0
47521,4,7521,[427 515 318  79 588],716,5,34108,4.5344323318266415,40.0,0.0
47522,4,7522,[427 515 318  79 588],18,5,34113,4.534494217732288,40.0,0.0
47523,4,7523,[427 515 318  79 588],18,5,34118,4.534556087187666,40.0,0.0
47524,4,7524,[427 515 318  79 588],716,5,34123,4.534617940199335,40.0,0.0
47525,4,7525,[427 515 318  79 588],716,5,34128,4.53467977677385,40.0,0.0
47526,4,7526,[161 176 197 237  71],280,2,34130,4.534343031752358,0.0,0.0
47527,4,7527,[427 515 318  79 588],18,5,34135,4.534404888416578,40.0,0.0
47528,4,7528,[427 515 318  79 588],18,5,34140,4.534466728649223,40.0,0.0
47529,4,7529,[427 515 318  79 588],716,5,34145,4.534528552456839,40.0,0.0
47530,4,7530,[427 515 318  79 588],18,5,34150,4.53459035984597,40.0,0.0
47531,4,7531,[427 515 318  79 588],716,5,34155,4.534652150823154,40.0,0.0
47532,4,7532,[176 603 427  15 302],450,4,34159,4.5345811761582375,40.0,0.0
47533,4,7533,[301 179  97 216 204],593,5,34164,4.534642951951155,0.0,0.0
47534,4,7534,[427 515 318  79 588],716,5,34169,4.534704711347048,40.0,0.0
47535,4,7535,[427 515 318  79 588],18,5,34174,4.534766454352441,40.0,0.0
47536,4,7536,[427 515 318  79 588],716,5,34179,4.534828180973863,40.0,0.0
47537,4,7537,[427 515 318  79 588],716,5,34184,4.53488989121783,40.0,0.0
47538,4,7538,[427 515 318  79 588],18,5,34189,4.534951585090861,40.0,0.0
47539,4,7539,[427 515 318  79 588],807,5,34194,4.5350132625994695,40.0,0.0
47540,4,7540,[427 515 318  79 588],18,5,34199,4.535074923750166,40.0,0.0
47541,4,7541,[427 515 318  79 588],807,5,34204,4.535136568549456,40.0,0.0
47542,4,7542,[117 111   9 127 313],296,3,34207,4.534933050510407,0.0,20.0
47543,4,7543,[194  22 127 286  98],629,5,34212,4.534994697773064,0.0,40.0
47544,4,7544,[427 515 318  79 588],716,5,34217,4.5350563286945,40.0,0.0
47545,4,7545,[427 515 318  79 588],716,5,34222,4.535117943281208,40.0,0.0
47546,4,7546,[427 515 318  79 588],18,5,34227,4.5351795415396845,40.0,0.0
47547,4,7547,[427 515 318  79 588],18,5,34232,4.535241123476418,40.0,0.0
47548,4,7548,[427 515 318  79 588],807,5,34237,4.535302689097894,40.0,0.0
47549,4,7549,[427 515 318  79 588],807,5,34242,4.535364238410596,40.0,0.0
47550,4,7550,[132 318  25 222  12],457,5,34247,4.535425771421004,20.0,0.0
47551,4,7551,[427 515 318  79 588],18,5,34252,4.535487288135593,40.0,0.0
47552,4,7552,[427 515 318  79 588],716,5,34257,4.5355487885608365,40.0,0.0
47553,4,7553,[427 515 318  79 588],716,5,34262,4.535610272703203,40.0,0.0
47554,4,7554,[168 273 144 313 234],450,3,34265,4.535407015221708,0.0,0.0
47555,4,7555,[427 515 318  79 588],716,5,34270,4.535468501852832,40.0,0.0
47556,4,7556,[427 515 318  79 588],18,5,34275,4.535529972211195,40.0,0.0
47557,4,7557,[135 271 289  11 405],655,1,34276,4.5350621857634295,0.0,0.0
47558,4,7558,[427 515 318  79 588],807,5,34281,4.535123693610266,40.0,0.0
47559,4,7559,[427 515 318  79 588],807,5,34286,4.535185185185185,40.0,0.0
47560,4,7560,[427 515 318  79 588],716,5,34291,4.535246660494644,40.0,0.0
47561,4,7561,[151 385 183 143 176],796,5,34296,4.5353081195450935,0.0,0.0
47562,4,7562,[427 515 318  79 588],807,5,34301,4.535369562342986,40.0,0.0
47563,4,7563,[427 515 318  79 588],18,5,34306,4.535430988894765,40.0,0.0
47564,4,7564,[427 515 318  79 588],716,5,34311,4.535492399206873,40.0,0.0
47565,4,7565,[302 435 427 275 153],535,4,34315,4.535421623050489,20.0,20.0
47566,4,7566,[ 96 176  70 194 546],504,2,34317,4.535086560063434,0.0,0.0
47567,4,7567,[427 515 318  79 588],807,5,34322,4.53514799154334,40.0,0.0
47568,4,7568,[427 515 318  79 588],807,5,34327,4.535209406790857,40.0,0.0
47569,4,7569,[427 515 318  79 588],716,5,34332,4.535270805812417,40.0,0.0
47570,4,7570,[427 515 318  79 588],807,5,34337,4.53533218861445,40.0,0.0
47571,4,7571,[100   1 173 286 588],450,5,34342,4.535393555203381,0.0,40.0
47572,4,7572,[427 515 318  79 588],716,5,34347,4.535454905585633,40.0,0.0
47573,4,7573,[427 515 318  79 588],807,5,34352,4.5355162397676265,40.0,0.0
47574,4,7574,[496 210 215   7 196],450,4,34356,4.535445544554455,20.0,0.0
47575,4,7575,[655  15 282 204 186],655,0,34356,4.534846884899683,0.0,0.0
47576,4,7576,[427 515 318  79 588],807,5,34361,4.534908275042893,40.0,0.0
47577,4,7577,[427 515 318  79 588],807,5,34366,4.534969648983901,40.0,0.0
47578,4,7578,[427 515 318  79 588],716,5,34371,4.5350310067291195,40.0,0.0
47579,4,7579,[427 515 318  79 588],716,5,34376,4.5350923482849606,40.0,0.0
47580,4,7580,[496 151 202 194 546],151,4,34380,4.535021764938662,20.0,0.0
47581,4,7581,[ 25 186 748 322 185],151,3,34383,4.5348193088894755,0.0,0.0
47582,4,7582,[ 70  25 176 210   1],151,4,34387,4.5347487801661615,0.0,0.0
47583,4,7583,[237 405  71 333  96],796,5,34392,4.534810126582278,0.0,0.0
47584,4,7584,[427 515 318  79 588],18,5,34397,4.5348714568226764,40.0,0.0
47585,4,7585,[ 79 132 202 118 385],280,3,34400,4.5346691273398365,0.0,0.0
47586,4,7586,[427 515 318  79 588],807,5,34405,4.534730459997364,40.0,0.0
47587,4,7587,[185 111 143  96  50],655,3,34408,4.534528202424881,0.0,20.0
47588,4,7588,[258 215   9 200 202],504,4,34412,4.534457767821848,0.0,0.0
47589,4,7589,[427 515 318  79 588],807,5,34417,4.534519104084321,40.0,0.0
47590,4,7590,[427 515 318  79 588],18,5,34422,4.534580424186537,40.0,0.0
47591,4,7591,[427 515 318  79 588],716,5,34427,4.534641728134879,40.0,0.0
47592,4,7592,[427 515 318  79 588],807,5,34432,4.53470301593573,40.0,0.0
47593,4,7593,[427 515 318  79 588],807,5,34437,4.53476428759547,40.0,0.0
47594,4,7594,[427 515 318  79 588],716,5,34442,4.534825543120474,40.0,0.0
47595,4,7595,[427 515 318  79 588],807,5,34447,4.534886782517114,40.0,0.0
47596,4,7596,[427 515 318  79 588],716,5,34452,4.53494800579176,40.0,0.0
47597,4,7597,[175 286 191 273 117],655,2,34454,4.534614372203212,0.0,20.0
47598,4,7598,[427 515 318  79 588],716,5,34459,4.534675615212528,40.0,0.0
47599,4,7599,[427 515 318  79 588],807,5,34464,4.534736842105263,40.0,0.0
47600,4,7600,[  9 234  50  71  95],756,1,34465,4.534271806341271,0.0,20.0
47601,4,7601,[427 515 318  79 588],18,5,34470,4.5343330702446725,40.0,0.0
47602,4,7602,[427 515 318  79 588],18,5,34475,4.534394318032356,40.0,0.0
47603,4,7603,[427 515 318  79 588],807,5,34480,4.534455549710678,40.0,0.0
47604,4,7604,[427 515 318  79 588],18,5,34485,4.534516765285996,40.0,0.0
47605,4,7605,[168   4 275 151   1],457,5,34490,4.53457796476466,0.0,20.0
47606,4,7606,[471 282 357 216 191],450,5,34495,4.534639148153017,0.0,0.0
47607,4,7607,[427 515 318  79 588],807,5,34500,4.534700315457413,40.0,0.0
47608,4,7608,[427 515 318  79 588],18,5,34505,4.53476146668419,40.0,0.0
47609,4,7609,[294 196 174   8 300],796,4,34509,4.5346911957950065,0.0,0.0
47610,4,7610,[427 515 318  79 588],18,5,34514,4.534752332150834,40.0,0.0
47611,4,7611,[ 50 172 181 216 121],593,5,34519,4.53481345244351,0.0,20.0
47612,4,7612,[427 515 318  79 588],18,5,34524,4.534874556679364,40.0,0.0
47613,4,7613,[427 515 318  79 588],716,5,34529,4.5349356448647224,40.0,0.0
47614,4,7614,[427 515 318  79 588],716,5,34534,4.534996717005909,40.0,0.0
47615,4,7615,[427 515 318  79 588],18,5,34539,4.535057773109243,40.0,0.0
47616,4,7616,[196  71 333 179 211],236,0,34539,4.534462386766443,0.0,0.0
47617,4,7617,[427 515 318  79 588],716,5,34544,4.534523496980835,40.0,0.0
47618,4,7618,[427 515 318  79 588],18,5,34549,4.534584591153695,40.0,0.0
47619,4,7619,[427 515 318  79 588],18,5,34554,4.534645669291338,40.0,0.0
47620,4,7620,[ 50 194 588  15  89],457,5,34559,4.534706731400079,0.0,20.0
47621,4,7621,[427 515 318  79 588],716,5,34564,4.534767777486224,40.0,0.0
47622,4,7622,[197 210 405 238  11],716,5,34569,4.53482880755608,0.0,0.0
47623,4,7623,[202 185 273 216 257],401,3,34572,4.534627492130116,0.0,0.0
47624,4,7624,[427 515 318  79 588],716,5,34577,4.534688524590164,40.0,0.0
47625,4,7625,[427 515 318  79 588],18,5,34582,4.534749541043798,40.0,0.0
47626,4,7626,[  1  88 204 405 100],23,3,34585,4.534548315196014,0.0,20.0
47627,4,7627,[427 515 318  79 588],716,5,34590,4.5346093340325115,40.0,0.0
47628,4,7628,[427 515 318  79 588],807,5,34595,4.53467033687246,40.0,0.0
47629,4,7629,[216 748 151 183 228],450,5,34600,4.534731323722149,0.0,0.0
47630,4,7630,[427 515 318  79 588],716,5,34605,4.534792294587866,40.0,0.0
47631,4,7631,[427 515 318  79 588],716,5,34610,4.534853249475891,40.0,0.0
47632,4,7632,[427 515 318  79 588],807,5,34615,4.534914188392507,40.0,0.0
47633,4,7633,[427 515 318  79 588],716,5,34620,4.534975111343988,40.0,0.0
47634,4,7634,[237 172 118  97  25],577,4,34624,4.534905042567125,0.0,0.0
47635,4,7635,[427 515 318  79 588],716,5,34629,4.53496595075956,40.0,0.0
47636,4,7636,[427 515 318  79 588],18,5,34634,4.535026843001178,40.0,0.0
47637,4,7637,[427 515 318  79 588],807,5,34639,4.535087719298246,40.0,0.0
47638,4,7638,[403 288 286 143 588],450,4,34643,4.535017672470219,0.0,20.0
47639,4,7639,[427 515 318  79 588],716,5,34648,4.535078534031413,40.0,0.0
47640,4,7640,[427 515 318  79 588],716,5,34653,4.535139379662348,40.0,0.0
47641,4,7641,[427 515 318  79 588],716,5,34658,4.535200209369275,40.0,0.0
47642,4,7642,[427 515 318  79 588],716,5,34663,4.535261023158446,40.0,0.0
47643,4,7643,[483 202   9 265 125],151,5,34668,4.535321821036106,0.0,0.0
47644,4,7644,[427 515 318  79 588],716,5,34673,4.535382603008502,40.0,0.0
47645,4,7645,[427 515 318  79 588],716,5,34678,4.5354433690818725,40.0,0.0
47646,4,7646,[427 515 318  79 588],716,5,34683,4.5355041192624554,40.0,0.0
47647,4,7647,[427 515 318  79 588],18,5,34688,4.535564853556485,40.0,0.0
47648,4,7648,[427 515 318  79 588],807,5,34693,4.535625571970193,40.0,0.0
47649,4,7649,[427 515 318  79 588],716,5,34698,4.535686274509804,40.0,0.0
47650,4,7650,[143 204 191 313 100],577,4,34702,4.5356162593125084,0.0,20.0
47651,4,7651,[182  22 655 118 200],796,4,34706,4.535546262415055,0.0,0.0
47652,4,7652,[742 257 125 174 173],457,4,34710,4.5354762838102705,0.0,0.0
47653,4,7653,[427 515 318  79 588],807,5,34715,4.5355369741311735,40.0,0.0
47654,4,7654,[427 515 318  79 588],18,5,34720,4.535597648595689,40.0,0.0
47655,4,7655,[427 515 318  79 588],18,5,34725,4.535658307210031,40.0,0.0
47656,4,7656,[427 515 318  79 588],716,5,34730,4.53571894998041,40.0,0.0
47657,4,7657,[268  70 118 210 111],344,2,34732,4.535387829720554,0.0,0.0
47658,4,7658,[427 515 318  79 588],18,5,34737,4.535448491970231,40.0,0.0
47659,4,7659,[427 515 318  79 588],807,5,34742,4.535509138381201,40.0,0.0
47660,4,7660,[427 515 318  79 588],716,5,34747,4.5355697689596655,40.0,0.0
47661,4,7661,[427 515 318  79 588],807,5,34752,4.535630383711824,40.0,0.0
47662,4,7662,[427 515 318  79 588],18,5,34757,4.535690982643873,40.0,0.0
47663,4,7663,[294 187 282 313 475],655,2,34759,4.5353601252609606,0.0,0.0
47664,4,7664,[427 181 508 235 132],269,3,34762,4.535159817351598,20.0,0.0
47665,4,7665,[427 515 318  79 588],807,5,34767,4.535220453952518,40.0,0.0
47666,4,7666,[427 515 318  79 588],807,5,34772,4.535281074735881,40.0,0.0
47667,4,7667,[427 515 318  79 588],18,5,34777,4.5353416797078765,40.0,0.0
47668,4,7668,[ 88  89 546  22 181],256,5,34782,4.53540226887469,0.0,0.0
47669,4,7669,[ 50 191 176  70 117],450,5,34787,4.535462842242503,0.0,20.0
47670,4,7670,[427 515 318  79 588],807,5,34792,4.535523399817494,40.0,0.0
47671,4,7671,[427 515 318  79 588],716,5,34797,4.535583941605839,40.0,0.0
47672,4,7672,[191 275 200 175 423],655,3,34800,4.5353838133715625,0.0,20.0
47673,4,7673,[427 515 318  79 588],18,5,34805,4.535444357571019,40.0,0.0
47674,4,7674,[427 515 318  79 588],807,5,34810,4.535504885993485,40.0,0.0
47675,4,7675,[427 515 318  79 588],716,5,34815,4.535565398645128,40.0,0.0
47676,4,7676,[427 515 318  79 588],18,5,34820,4.5356258955321085,40.0,0.0
47677,4,7677,[ 15  28  97 405 269],450,4,34824,4.535556134410003,0.0,0.0
47678,4,7678,[427 515 318  79 588],18,5,34829,4.535616616746973,40.0,0.0
47679,4,7679,[328 183 135  11 237],450,4,34833,4.535546875,0.0,0.0
47680,4,7680,[117 282  95 588 435],450,4,34837,4.535477151412577,0.0,0.0
47681,4,7681,[427 515 318  79 588],807,5,34842,4.535537620411351,40.0,0.0
47682,4,7682,[427 515 318  79 588],807,5,34847,4.5355980736691395,40.0,0.0
47683,4,7683,[427 515 318  79 588],807,5,34852,4.5356585111920875,40.0,0.0
47684,4,7684,[ 97 546 288  79 216],450,4,34856,4.5355888093689005,0.0,0.0
47685,4,7685,[427 515 318  79 588],18,5,34861,4.5356492323705435,40.0,0.0
47686,4,7686,[427 515 318  79 588],716,5,34866,4.535709639651359,40.0,0.0
47687,4,7687,[427 515 318  79 588],716,5,34871,4.535770031217481,40.0,0.0
47688,4,7688,[195  82 118  88 228],457,5,34876,4.535830407075042,0.0,0.0
47689,4,7689,[427 515 318  79 588],807,5,34881,4.535890767230169,40.0,0.0
47690,4,7690,[427 515 318  79 588],18,5,34886,4.535951111688987,40.0,0.0
47691,4,7691,[427 515 318  79 588],807,5,34891,4.536011440457618,40.0,0.0
47692,4,7692,[427 515 318  79 588],18,5,34896,4.536071753542181,40.0,0.0
47693,4,7693,[435 181 300 496 228],450,5,34901,4.536132050948791,20.0,0.0
47694,4,7694,[427 515 318  79 588],807,5,34906,4.5361923326835605,40.0,0.0
47695,4,7695,[475 273 302 265 288],655,2,34908,4.535862785862786,0.0,0.0
47696,4,7696,[427 515 318  79 588],18,5,34913,4.535923086916981,40.0,0.0
47697,4,7697,[427 515 318  79 588],18,5,34918,4.535983372304495,40.0,0.0
47698,4,7698,[427 515 318  79 588],18,5,34923,4.536043642031433,40.0,0.0
47699,4,7699,[196 100 546  98 168],796,4,34927,4.535974025974026,0.0,20.0
47700,4,7700,[427 515 318  79 588],807,5,34932,4.5360342812621735,40.0,0.0
47701,4,7701,[427 515 318  79 588],807,5,34937,4.536094520903661,40.0,0.0
47702,4,7702,[427 515 318  79 588],807,5,34942,4.536154744904582,40.0,0.0
47703,4,7703,[427 515 318  79 588],807,5,34947,4.536214953271028,40.0,0.0
47704,4,7704,[427 515 318  79 588],807,5,34952,4.536275146009085,40.0,0.0
47705,4,7705,[427 515 318  79 588],716,5,34957,4.536335323124838,40.0,0.0
47706,4,7706,[427 515 318  79 588],807,5,34962,4.536395484624367,40.0,0.0
47707,4,7707,[143 403 385  71 245],450,4,34966,4.536325895173845,0.0,0.0
47708,4,7708,[273   1 435 216 125],450,4,34970,4.536256323777403,0.0,0.0
47709,4,7709,[427 515 318  79 588],807,5,34975,4.536316472114137,40.0,0.0
47710,4,7710,[427 515 318  79 588],716,5,34980,4.536376604850214,40.0,0.0
47711,4,7711,[427 515 318  79 588],807,5,34985,4.536436721991701,40.0,0.0
47712,4,7712,[427 515 318  79 588],18,5,34990,4.536496823544665,40.0,0.0
47713,4,7713,[427 515 318  79 588],716,5,34995,4.536556909515167,40.0,0.0
47714,4,7714,[427 515 318  79 588],807,5,35000,4.536616979909268,40.0,0.0
47715,4,7715,[403 181 268  22 200],269,2,35002,4.5362882322446865,0.0,0.0
47716,4,7716,[427 515 318  79 588],18,5,35007,4.536348321886743,40.0,0.0
47717,4,7717,[ 22 211 238  95 168],18,4,35011,4.536278828712102,0.0,0.0
47718,4,7718,[ 88 200 173 117 313],450,4,35015,4.536209353543205,0.0,0.0
47719,4,7719,[135 215  71 588 228],330,4,35019,4.536139896373057,0.0,0.0
47720,4,7720,[ 70 238  89  96 183],23,3,35022,4.535940940292708,0.0,0.0
47721,4,7721,[427 515 318  79 588],716,5,35027,4.536001036001036,40.0,0.0
47722,4,7722,[427 515 318  79 588],18,5,35032,4.536061116146575,40.0,0.0
47723,4,7723,[427 515 318  79 588],716,5,35037,4.53612118073537,40.0,0.0
47724,4,7724,[427 515 318  79 588],807,5,35042,4.5361812297734625,40.0,0.0
47725,4,7725,[427 515 318  79 588],807,5,35047,4.536241263266891,40.0,0.0
47726,4,7726,[427 515 318  79 588],807,5,35052,4.53630128122169,40.0,0.0
47727,4,7727,[238   1  50  79   7],296,5,35057,4.536361283643893,0.0,20.0
47728,4,7728,[427 515 318  79 588],807,5,35062,4.536421270539527,40.0,0.0
47729,4,7729,[427 515 318  79 588],18,5,35067,4.536481241914618,40.0,0.0
47730,4,7730,[202 185 111 168 471],389,4,35071,4.536411848402535,0.0,0.0
47731,4,7731,[185 216 237 168 191],796,5,35076,4.536471805483704,0.0,0.0
47732,4,7732,[427 515 318  79 588],716,5,35081,4.536531747058063,40.0,0.0
47733,4,7733,[427 515 318  79 588],18,5,35086,4.5365916731316265,40.0,0.0
47734,4,7734,[427 515 318  79 588],716,5,35091,4.536651583710407,40.0,0.0
47735,4,7735,[153 143 186 195 301],151,3,35094,4.536452947259566,0.0,0.0
47736,4,7736,[427 515 318  79 588],807,5,35099,4.536512860281763,40.0,0.0
47737,4,7737,[427 515 318  79 588],716,5,35104,4.536572757818558,40.0,0.0
47738,4,7738,[427 515 318  79 588],807,5,35109,4.536632639875953,40.0,0.0
47739,4,7739,[427 515 318  79 588],716,5,35114,4.536692506459948,40.0,0.0
47740,4,7740,[427 515 318  79 588],807,5,35119,4.536752357576541,40.0,0.0
47741,4,7741,[153 302 471  71 185],401,2,35121,4.5364246964608625,0.0,0.0
47742,4,7742,[  9 197 655 172 496],535,4,35125,4.536355417796719,20.0,0.0
47743,4,7743,[427 515 318  79 588],716,5,35130,4.536415289256198,40.0,0.0
47744,4,7744,[427 515 318  79 588],807,5,35135,4.536475145255003,40.0,0.0
47745,4,7745,[427 515 318  79 588],807,5,35140,4.536534985799122,40.0,0.0
47746,4,7746,[427 515 318  79 588],807,5,35145,4.53659481089454,40.0,0.0
47747,4,7747,[427 515 318  79 588],18,5,35150,4.536654620547238,40.0,0.0
47748,4,7748,[427 515 318  79 588],807,5,35155,4.536714414763195,40.0,0.0
47749,4,7749,[269 322 655  70  50],450,5,35160,4.536774193548387,0.0,20.0
47750,4,7750,[427 121  71 194  22],796,5,35165,4.536833956908786,20.0,0.0
47751,4,7751,[423 185 194 403 179],269,4,35169,4.536764705882353,0.0,0.0
47752,4,7752,[427 515 318  79 588],807,5,35174,4.536824455049659,40.0,0.0
47753,4,7753,[427 515 318  79 588],18,5,35179,4.536884188805778,40.0,0.0
47754,4,7754,[ 22 202 127  69 245],450,5,35184,4.536943907156673,0.0,20.0
47755,4,7755,[427 515 318  79 588],716,5,35189,4.537003610108303,40.0,0.0
47756,4,7756,[427 515 318  79 588],716,5,35194,4.537063297666624,40.0,0.0
47757,4,7757,[288 215 515 275 204],655,2,35196,4.536736272235112,0.0,20.0
47758,4,7758,[427 515 318  79 588],716,5,35201,4.536795978863256,40.0,0.0
47759,4,7759,[144 222 153 313 181],450,4,35205,4.536726804123711,0.0,0.0
47760,4,7760,[118 403 173 655 742],457,5,35210,4.536786496585491,0.0,0.0
47761,4,7761,[427 515 318  79 588],807,5,35215,4.53684617366658,40.0,0.0
47762,4,7762,[182 403  98 300 135],450,4,35219,4.536777019193611,0.0,0.0
47763,4,7763,[427 515 318  79 588],807,5,35224,4.536836682122617,40.0,0.0
47764,4,7764,[328 234 245  28 117],450,4,35228,4.536767546683838,0.0,0.0
47765,4,7765,[427 515 318  79 588],716,5,35233,4.536827195467422,40.0,0.0
47766,4,7766,[427 515 318  79 588],716,5,35238,4.536886828891464,40.0,0.0
47767,4,7767,[427 515 318  79 588],716,5,35243,4.5369464469618945,40.0,0.0
47768,4,7768,[427 515 318  79 588],716,5,35248,4.537006049684644,40.0,0.0
47769,4,7769,[427 515 318  79 588],18,5,35253,4.537065637065637,40.0,0.0
47770,4,7770,[195 328 197 435 194],629,4,35257,4.536996525543688,0.0,0.0
47771,4,7771,[427 515 318  79 588],716,5,35262,4.537056098816263,40.0,0.0
47772,4,7772,[300 118 176  97 186],655,0,35262,4.536472404477036,0.0,0.0
47773,4,7773,[151 216   7 174  12],256,5,35267,4.536532029843067,0.0,0.0
47774,4,7774,[427 515 318  79 588],716,5,35272,4.536591639871383,40.0,0.0
47775,4,7775,[427 515 318  79 588],18,5,35277,4.536651234567901,40.0,0.0
47776,4,7776,[173 323 568 258  64],796,4,35281,4.536582229651537,20.0,0.0
47777,4,7777,[427 515 318  79 588],18,5,35286,4.536641810233993,40.0,0.0
47778,4,7778,[194 508 151 121 173],401,1,35287,4.536187170587479,0.0,0.0
47779,4,7779,[427 515 318  79 588],18,5,35292,4.536246786632391,40.0,0.0
47780,4,7780,[ 28 186 197 179 275],655,2,35294,4.535920832797841,0.0,20.0
47781,4,7781,[216 597  56 180 196],269,1,35295,4.535466461063994,0.0,0.0
47782,4,7782,[427 515 318  79 588],716,5,35300,4.535526146730053,40.0,0.0
47783,4,7783,[427 515 318  79 588],716,5,35305,4.535585817060637,40.0,0.0
47784,4,7784,[427 515 318  79 588],18,5,35310,4.535645472061657,40.0,0.0
47785,4,7785,[144  70  15  97 385],457,5,35315,4.535705111739019,0.0,0.0
47786,4,7786,[427 515 318  79 588],807,5,35320,4.535764736098626,40.0,0.0
47787,4,7787,[427 515 318  79 588],807,5,35325,4.535824345146379,40.0,0.0
47788,4,7788,[427 515 318  79 588],716,5,35330,4.535883938888175,40.0,0.0
47789,4,7789,[427 515 318  79 588],716,5,35335,4.53594351732991,40.0,0.0
47790,4,7790,[427 515 318  79 588],18,5,35340,4.536003080477474,40.0,0.0
47791,4,7791,[427 515 318  79 588],18,5,35345,4.536062628336755,40.0,0.0
47792,4,7792,[427 515 318  79 588],716,5,35350,4.53612216091364,40.0,0.0
47793,4,7793,[546  15  71 197 318],796,4,35354,4.536053374390557,20.0,0.0
47794,4,7794,[237  98 125 183 176],503,4,35358,4.535984605516357,0.0,0.0
47795,4,7795,[427 515 318  79 588],807,5,35363,4.536044125192406,40.0,0.0
47796,4,7796,[427 515 318  79 588],716,5,35368,4.536103629601128,40.0,0.0
47797,4,7797,[427 515 318  79 588],18,5,35373,4.536163118748397,40.0,0.0
47798,4,7798,[427 515 318  79 588],18,5,35378,4.536222592640082,40.0,0.0
47799,4,7799,[427 515 318  79 588],716,5,35383,4.536282051282051,40.0,0.0
47800,4,7800,[118 127  15 276  89],655,3,35386,4.536085117292655,0.0,20.0
47801,4,7801,[427 515 318  79 588],807,5,35391,4.536144578313253,40.0,0.0
47802,4,7802,[258 300 181 269  98],796,4,35395,4.536075868255799,0.0,0.0
47803,4,7803,[603 655 238 168  82],450,4,35399,4.536007175807279,20.0,0.0
47804,4,7804,[427 515 318  79 588],807,5,35404,4.536066623959001,40.0,0.0
47805,4,7805,[427 515 318  79 588],18,5,35409,4.536126056879324,40.0,0.0
47806,4,7806,[427 515 318  79 588],716,5,35414,4.536185474574101,40.0,0.0
47807,4,7807,[427 515 318  79 588],716,5,35419,4.53624487704918,40.0,0.0
47808,4,7808,[427 515 318  79 588],716,5,35424,4.536304264310411,40.0,0.0
47809,4,7809,[427 515 318  79 588],807,5,35429,4.536363636363636,40.0,0.0
47810,4,7810,[427 515 318  79 588],807,5,35434,4.536422993214697,40.0,0.0
47811,4,7811,[ 69 318 127 276  97],504,4,35438,4.536354326676907,20.0,20.0
47812,4,7812,[427 515 318  79 588],807,5,35443,4.5364136695251505,40.0,0.0
47813,4,7813,[318  56  64 197 111],796,4,35447,4.536345021755823,40.0,0.0
47814,4,7814,[186 265 144 210  64],535,3,35450,4.5361484325016,20.0,0.0
47815,4,7815,[258 144 183 282 603],796,5,35455,4.536207778915046,20.0,0.0
47816,4,7816,[427 515 318  79 588],18,5,35460,4.536267110144557,40.0,0.0
47817,4,7817,[427 515 318  79 588],807,5,35465,4.536326426195958,40.0,0.0
47818,4,7818,[427 515 318  79 588],807,5,35470,4.536385727075073,40.0,0.0
47819,4,7819,[427 515 318  79 588],18,5,35475,4.536445012787723,40.0,0.0
47820,4,7820,[427 515 318  79 588],807,5,35480,4.536504283339727,40.0,0.0
47821,4,7821,[568 483 427 269 357],655,3,35483,4.53630784965482,20.0,0.0
47822,4,7822,[427 515 318  79 588],716,5,35488,4.536367122587243,40.0,0.0
47823,4,7823,[427 515 318  79 588],18,5,35493,4.536426380368098,40.0,0.0
47824,4,7824,[427 515 318  79 588],716,5,35498,4.536485623003195,40.0,0.0
47825,4,7825,[427 515 318  79 588],807,5,35503,4.5365448504983386,40.0,0.0
47826,4,7826,[427 515 318  79 588],18,5,35508,4.536604062859333,40.0,0.0
47827,4,7827,[427 515 318  79 588],18,5,35513,4.536663260091977,40.0,0.0
47828,4,7828,[427 515 318  79 588],18,5,35518,4.536722442202069,40.0,0.0
47829,4,7829,[427 515 318  79 588],18,5,35523,4.536781609195402,40.0,0.0
47830,4,7830,[427 515 318  79 588],807,5,35528,4.536840761077768,40.0,0.0
47831,4,7831,[302 257  25 385 132],655,1,35529,4.536389172625127,0.0,0.0
47832,4,7832,[161 268 385 191 357],655,2,35531,4.536065364483595,0.0,0.0
47833,4,7833,[ 22 175 496 211 196],269,3,35534,4.535869287720194,20.0,0.0
47834,4,7834,[427 515 318  79 588],807,5,35539,4.535928525845565,40.0,0.0
47835,4,7835,[427 515 318  79 588],18,5,35544,4.535987748851455,40.0,0.0
47836,4,7836,[427 515 318  79 588],716,5,35549,4.536046956743652,40.0,0.0
47837,4,7837,[427 515 318  79 588],18,5,35554,4.5361061495279404,40.0,0.0
47838,4,7838,[322 117 111 423 300],796,4,35558,4.536037759918357,0.0,0.0
47839,4,7839,[515  12 300 191 197],655,2,35560,4.535714285714286,0.0,0.0
47840,4,7840,[427 515 318  79 588],716,5,35565,4.535773498278281,40.0,0.0
47841,4,7841,[ 88 172  69 173 405],269,0,35565,4.535195103289977,0.0,0.0
47842,4,7842,[183 181 215 300 318],693,2,35567,4.534871860257555,20.0,0.0
47843,4,7843,[427 515 318  79 588],18,5,35572,4.534931157572667,40.0,0.0
47844,4,7844,[427 515 318  79 588],807,5,35577,4.534990439770555,40.0,0.0
47845,4,7845,[427 515 318  79 588],807,5,35582,4.535049706856997,40.0,0.0
47846,4,7846,[427 515 318  79 588],716,5,35587,4.535108958837772,40.0,0.0
47847,4,7847,[427 515 318  79 588],807,5,35592,4.535168195718654,40.0,0.0
47848,4,7848,[ 64 282 471 202 121],401,2,35594,4.5348452032106,20.0,0.0
47849,4,7849,[357 100 294   1 127],296,4,35598,4.5347770700636945,0.0,40.0
47850,4,7850,[427 515 318  79 588],716,5,35603,4.534836326582601,40.0,0.0
47851,4,7851,[427 515 318  79 588],807,5,35608,4.53489556800815,40.0,0.0
47852,4,7852,[427 515 318  79 588],807,5,35613,4.53495479434611,40.0,0.0
47853,4,7853,[427 515 318  79 588],716,5,35618,4.535014005602241,40.0,0.0
47854,4,7854,[427 515 318  79 588],716,5,35623,4.535073201782304,40.0,0.0
47855,4,7855,[194 357 496 196  12],151,5,35628,4.535132382892057,20.0,0.0
47856,4,7856,[ 12 161 187 568 174],693,3,35631,4.5349369988545245,0.0,0.0
47857,4,7857,[427 515 318  79 588],18,5,35636,4.534996182234665,40.0,0.0
47858,4,7858,[427 515 318  79 588],716,5,35641,4.535055350553505,40.0,0.0
47859,4,7859,[427 515 318  79 588],716,5,35646,4.535114503816794,40.0,0.0
47860,4,7860,[427 515 318  79 588],18,5,35651,4.535173642030276,40.0,0.0
47861,4,7861,[427 515 318  79 588],18,5,35656,4.535232765199694,40.0,0.0
47862,4,7862,[427 515 318  79 588],807,5,35661,4.53529187333079,40.0,0.0
47863,4,7863,[475 211 471 196 288],655,0,35661,4.534715157680569,0.0,0.0
47864,4,7864,[427 515 318  79 588],716,5,35666,4.5347743165924985,40.0,0.0
47865,4,7865,[211 282 328 300 222],796,4,35670,4.534706331045004,0.0,0.0
47866,4,7866,[427 515 318  79 588],18,5,35675,4.5347654760391505,40.0,0.0
47867,4,7867,[200 423 186 132  50],716,4,35679,4.534697508896797,0.0,20.0
47868,4,7868,[185   9 301 302 289],655,2,35681,4.53437539712797,0.0,0.0
47869,4,7869,[427 515 318  79 588],18,5,35686,4.53443456162643,40.0,0.0
47870,4,7870,[ 71  56  11  70 216],450,4,35690,4.534366662431712,0.0,0.0
47871,4,7871,[427 515 318  79 588],716,5,35695,4.53442581300813,40.0,0.0
47872,4,7872,[427 515 318  79 588],18,5,35700,4.534484948558364,40.0,0.0
47873,4,7873,[153  97 125 237 294],796,3,35703,4.5342900685801375,0.0,0.0
47874,4,7874,[427 515 318  79 588],807,5,35708,4.534349206349206,40.0,0.0
47875,4,7875,[427 515 318  79 588],18,5,35713,4.534408329101066,40.0,0.0
47876,4,7876,[153 427  11 176 202],716,4,35717,4.534340484956202,20.0,0.0
47877,4,7877,[427 515 318  79 588],716,5,35722,4.534399593805534,40.0,0.0
47878,4,7878,[508 357 181  70 273],655,2,35724,4.5340779286711514,0.0,0.0
47879,4,7879,[ 79  56 385 403 742],280,4,35728,4.534010152284264,0.0,0.0
47880,4,7880,[202 216 180  69 234],786,4,35732,4.533942393097322,0.0,0.0
47881,4,7881,[427 515 318  79 588],18,5,35737,4.534001522456229,40.0,0.0
47882,4,7882,[496 300 269 357 172],535,2,35739,4.533680071038945,20.0,0.0
47883,4,7883,[427 515 318  79 588],807,5,35744,4.533739218670726,40.0,0.0
47884,4,7884,[  9 143 588  96 318],457,5,35749,4.533798351299937,20.0,0.0
47885,4,7885,[427 515 318  79 588],18,5,35754,4.533857468932285,40.0,0.0
47886,4,7886,[427 515 318  79 588],716,5,35759,4.533916571573475,40.0,0.0
47887,4,7887,[427 515 318  79 588],716,5,35764,4.533975659229209,40.0,0.0
47888,4,7888,[427 515 318  79 588],716,5,35769,4.534034731905185,40.0,0.0
47889,4,7889,[427 515 318  79 588],716,5,35774,4.534093789607097,40.0,0.0
47890,4,7890,[235  28 222 483 269],23,3,35777,4.533899379039412,0.0,0.0
47891,4,7891,[427 515 318  79 588],18,5,35782,4.533958438925494,40.0,0.0
47892,4,7892,[427 515 318  79 588],18,5,35787,4.534017483846446,40.0,0.0
47893,4,7893,[427 515 318  79 588],716,5,35792,4.534076513807955,40.0,0.0
47894,4,7894,[427 515 318  79 588],716,5,35797,4.534135528815706,40.0,0.0
47895,4,7895,[603 181   4  64  12],796,5,35802,4.53419452887538,40.0,0.0
47896,4,7896,[427 515 318  79 588],18,5,35807,4.534253513992655,40.0,0.0
47897,4,7897,[427 515 318  79 588],716,5,35812,4.534312484173208,40.0,0.0
47898,4,7898,[427 515 318  79 588],716,5,35817,4.534371439422712,40.0,0.0
47899,4,7899,[180  70  28  11 182],450,5,35822,4.534430379746835,0.0,0.0
47900,4,7900,[427 515 318  79 588],716,5,35827,4.534489305151246,40.0,0.0
47901,4,7901,[427 515 318  79 588],716,5,35832,4.5345482156416095,40.0,0.0
47902,4,7902,[427 515 318  79 588],807,5,35837,4.534607111223586,40.0,0.0
47903,4,7903,[427 515 318  79 588],18,5,35842,4.534665991902834,40.0,0.0
47904,4,7904,[427 515 318  79 588],716,5,35847,4.53472485768501,40.0,0.0
47905,4,7905,[427 515 318  79 588],807,5,35852,4.534783708575765,40.0,0.0
47906,4,7906,[427 515 318  79 588],716,5,35857,4.534842544580751,40.0,0.0
47907,4,7907,[427 515 318  79 588],18,5,35862,4.534901365705615,40.0,0.0
47908,4,7908,[427 515 318  79 588],716,5,35867,4.5349601719559995,40.0,0.0
47909,4,7909,[427 515 318  79 588],18,5,35872,4.5350189633375475,40.0,0.0
47910,4,7910,[427 515 318  79 588],18,5,35877,4.535077739855897,40.0,0.0
47911,4,7911,[ 71 132 183 151 143],796,5,35882,4.535136501516684,0.0,0.0
47912,4,7912,[427 515 318  79 588],807,5,35887,4.53519524832554,40.0,0.0
47913,4,7913,[427 515 318  79 588],18,5,35892,4.535253980288097,40.0,0.0
47914,4,7914,[427 515 318  79 588],716,5,35897,4.535312697409981,40.0,0.0
47915,4,7915,[ 56 172 186 216   1],151,5,35902,4.535371399696817,0.0,0.0
47916,4,7916,[427 515 318  79 588],18,5,35907,4.535430087154225,40.0,0.0
47917,4,7917,[427 515 318  79 588],716,5,35912,4.5354887597878255,40.0,0.0
47918,4,7918,[427 515 318  79 588],716,5,35917,4.535547417603233,40.0,0.0
47919,4,7919,[427 515 318  79 588],716,5,35922,4.53560606060606,40.0,0.0
47920,4,7920,[483 222 210 258 197],151,5,35927,4.535664688801919,0.0,0.0
47921,4,7921,[204 546   9 195 161],504,4,35931,4.535597071446604,0.0,0.0
47922,4,7922,[427 515 318  79 588],807,5,35936,4.535655685977534,40.0,0.0
47923,4,7923,[427 515 318  79 588],807,5,35941,4.535714285714286,40.0,0.0
47924,4,7924,[427 515 318  79 588],716,5,35946,4.535772870662461,40.0,0.0
47925,4,7925,[135 202 185 194 181],389,4,35950,4.535705273782488,0.0,0.0
47926,4,7926,[427 515 318  79 588],18,5,35955,4.5357638450864135,40.0,0.0
47927,4,7927,[427 515 318  79 588],807,5,35960,4.5358224016145305,40.0,0.0
47928,4,7928,[427 515 318  79 588],807,5,35965,4.5358809433724305,40.0,0.0
47929,4,7929,[427 515 318  79 588],807,5,35970,4.5359394703657,40.0,0.0
47930,4,7930,[210 161  22 357 118],655,1,35971,4.535493632581011,0.0,0.0
47931,4,7931,[357  15 496 210  98],796,4,35975,4.535426122037317,20.0,0.0
47932,4,7932,[427 515 318  79 588],18,5,35980,4.53548468423043,40.0,0.0
47933,4,7933,[210  97 294  98 179],65,4,35984,4.535417191832619,0.0,0.0
47934,4,7934,[427 515 318  79 588],18,5,35989,4.535475740390674,40.0,0.0
47935,4,7935,[427 515 318  79 588],18,5,35994,4.535534274193548,40.0,0.0
47936,4,7936,[427 515 318  79 588],807,5,35999,4.535592793246819,40.0,0.0
47937,4,7937,[427 515 318  79 588],807,5,36004,4.5356512975560594,40.0,0.0
47938,4,7938,[427 515 318  79 588],716,5,36009,4.535709787126843,40.0,0.0
47939,4,7939,[427 515 318  79 588],716,5,36014,4.535768261964735,40.0,0.0
47940,4,7940,[405 313 210 161 100],796,3,36017,4.535574864626621,0.0,20.0
47941,4,7941,[197 483  28 313 300],655,2,36019,4.535255603122639,0.0,0.0
47942,4,7942,[427 515 318  79 588],716,5,36024,4.535314113055521,40.0,0.0
47943,4,7943,[427 515 318  79 588],716,5,36029,4.535372608257805,40.0,0.0
47944,4,7944,[427 515 318  79 588],18,5,36034,4.535431088735053,40.0,0.0
47945,4,7945,[179   4 121 276  89],786,3,36037,4.535237855524793,0.0,0.0
47946,4,7946,[427 515 318  79 588],807,5,36042,4.535296338240846,40.0,0.0
47947,4,7947,[118   8  15 132 111],655,0,36042,4.5347257171615505,0.0,0.0
47948,4,7948,[427 515 318  79 588],716,5,36047,4.5347842495911435,40.0,0.0
47949,4,7949,[427 515 318  79 588],716,5,36052,4.534842767295597,40.0,0.0
47950,4,7950,[427 515 318  79 588],716,5,36057,4.534901270280468,40.0,0.0
47951,4,7951,[423 257  70 568 222],655,0,36057,4.534330985915493,0.0,0.0
47952,4,7952,[427 515 318  79 588],18,5,36062,4.534389538538917,40.0,0.0
47953,4,7953,[475 275 271 174 187],629,5,36067,4.534448076439527,0.0,20.0
47954,4,7954,[427 515 318  79 588],716,5,36072,4.534506599622879,40.0,0.0
47955,4,7955,[427 515 318  79 588],18,5,36077,4.53456510809452,40.0,0.0
47956,4,7956,[427 515 318  79 588],807,5,36082,4.534623601859997,40.0,0.0
47957,4,7957,[427 515 318  79 588],18,5,36087,4.534682080924855,40.0,0.0
47958,4,7958,[427 515 318  79 588],716,5,36092,4.534740545294635,40.0,0.0
47959,4,7959,[427 515 318  79 588],18,5,36097,4.534798994974874,40.0,0.0
47960,4,7960,[427 515 318  79 588],807,5,36102,4.534857429971109,40.0,0.0
47961,4,7961,[427 515 318  79 588],807,5,36107,4.534915850288872,40.0,0.0
47962,4,7962,[427 515 318  79 588],18,5,36112,4.534974255933693,40.0,0.0
47963,4,7963,[194 288 143  50 161],450,4,36116,4.534907081868408,0.0,20.0
47964,4,7964,[427 515 318  79 588],18,5,36121,4.534965473948525,40.0,0.0
47965,4,7965,[427 515 318  79 588],18,5,36126,4.535023851368315,40.0,0.0
47966,4,7966,[191  25 182  82 322],450,3,36129,4.534831178611774,0.0,0.0
47967,4,7967,[328 183 603  25 655],450,4,36133,4.534764056224899,20.0,0.0
47968,4,7968,[228 508 471 286 118],344,2,36135,4.534445978165391,0.0,20.0
47969,4,7969,[ 15 168  25 125  22],457,5,36140,4.534504391468005,0.0,0.0
47970,4,7970,[427 515 318  79 588],18,5,36145,4.534562790114164,40.0,0.0
47971,4,7971,[427 515 318  79 588],18,5,36150,4.5346211741093825,40.0,0.0
47972,4,7972,[180 125 300 385 269],450,5,36155,4.534679543459175,0.0,0.0
47973,4,7973,[427 515 318  79 588],716,5,36160,4.534737898169049,40.0,0.0
47974,4,7974,[427 515 318  79 588],18,5,36165,4.534796238244514,40.0,0.0
47975,4,7975,[427 515 318  79 588],716,5,36170,4.5348545636910735,40.0,0.0
47976,4,7976,[427 515 318  79 588],18,5,36175,4.534912874514228,40.0,0.0
47977,4,7977,[405 333 258 191  96],655,1,36176,4.534469791927801,0.0,0.0
47978,4,7978,[427 515 318  79 588],18,5,36181,4.53452813635794,40.0,0.0
47979,4,7979,[427 515 318  79 588],807,5,36186,4.534586466165414,40.0,0.0
47980,4,7980,[427 515 318  79 588],807,5,36191,4.53464478135572,40.0,0.0
47981,4,7981,[427 515 318  79 588],18,5,36196,4.534703081934352,40.0,0.0
47982,4,7982,[182 655 125 197  96],796,3,36199,4.5345108355254915,0.0,0.0
47983,4,7983,[427 515 318  79 588],18,5,36204,4.534569138276553,40.0,0.0
47984,4,7984,[427 515 318  79 588],18,5,36209,4.534627426424546,40.0,0.0
47985,4,7985,[427 515 318  79 588],807,5,36214,4.534685699974956,40.0,0.0
47986,4,7986,[427 515 318  79 588],18,5,36219,4.534743958933267,40.0,0.0
47987,4,7987,[427 515 318  79 588],807,5,36224,4.534802203304958,40.0,0.0
47988,4,7988,[323 125 546   4  89],796,4,36228,4.534735260983853,0.0,0.0
47989,4,7989,[427 515 318  79 588],18,5,36233,4.534793491864831,40.0,0.0
47990,4,7990,[427 515 318  79 588],716,5,36238,4.5348517081716935,40.0,0.0
47991,4,7991,[471  50 403 323 161],256,5,36243,4.53490990990991,0.0,20.0
47992,4,7992,[427 515 318  79 588],807,5,36248,4.534968097084949,40.0,0.0
47993,4,7993,[588 100 185  97 403],450,5,36253,4.535026269702277,0.0,20.0
47994,4,7994,[151 186 210 322 196],504,4,36257,4.534959349593496,0.0,0.0
47995,4,7995,[216 121  71  88 357],450,3,36260,4.534767383691846,0.0,0.0
47996,4,7996,[427 515 318  79 588],716,5,36265,4.534825559584844,40.0,0.0
47997,4,7997,[  8 546 508 588 210],280,3,36268,4.534633658414604,0.0,0.0
47998,4,7998,[427 515 318  79 588],716,5,36273,4.53469183647956,40.0,0.0
47999,4,7999,[427 515 318  79 588],716,5,36278,4.53475,40.0,0.0
48000,4,8000,[427 515 318  79 588],716,5,36283,4.534808148981377,40.0,0.0
48001,4,8001,[588 294 197 216  96],450,5,36288,4.534866283429142,0.0,0.0
48002,4,8002,[ 69  98 228 294 200],450,4,36292,4.534799450206172,0.0,0.0
48003,4,8003,[427 515 318  79 588],807,5,36297,4.534857571214393,40.0,0.0
48004,4,8004,[427 515 318  79 588],18,5,36302,4.534915677701437,40.0,0.0
48005,4,8005,[427 515 318  79 588],716,5,36307,4.534973769672745,40.0,0.0
48006,4,8006,[427 515 318  79 588],807,5,36312,4.535031847133758,40.0,0.0
48007,4,8007,[427 515 318  79 588],18,5,36317,4.53508991008991,40.0,0.0
48008,4,8008,[427 515 318  79 588],18,5,36322,4.535147958546635,40.0,0.0
48009,4,8009,[427 515 318  79 588],807,5,36327,4.535205992509363,40.0,0.0
48010,4,8010,[174 121 588 132 275],450,4,36331,4.535139183622519,0.0,20.0
48011,4,8011,[427 515 318  79 588],716,5,36336,4.535197204193709,40.0,0.0
48012,4,8012,[427 515 318  79 588],716,5,36341,4.53525521028329,40.0,0.0
48013,4,8013,[483 161 176 234 282],716,2,36343,4.53493885700025,0.0,0.0
48014,4,8014,[427 515 318  79 588],807,5,36348,4.534996880848409,40.0,0.0
48015,4,8015,[427 515 318  79 588],807,5,36353,4.535054890219561,40.0,0.0
48016,4,8016,[427 515 318  79 588],716,5,36358,4.535112885119122,40.0,0.0
48017,4,8017,[427 515 318  79 588],807,5,36363,4.535170865552507,40.0,0.0
48018,4,8018,[427 515 318  79 588],716,5,36368,4.535228831525128,40.0,0.0
48019,4,8019,[427 515 318  79 588],18,5,36373,4.535286783042394,40.0,0.0
48020,4,8020,[117 216  70 286 195],450,5,36378,4.535344720109712,0.0,20.0
48021,4,8021,[427 515 318  79 588],18,5,36383,4.535402642732485,40.0,0.0
48022,4,8022,[204 603 300 143  15],655,2,36385,4.535086625950393,20.0,0.0
48023,4,8023,[427 515 318  79 588],716,5,36390,4.5351445663010965,40.0,0.0
48024,4,8024,[427 515 318  79 588],807,5,36395,4.535202492211838,40.0,0.0
48025,4,8025,[427 515 318  79 588],18,5,36400,4.535260403688014,40.0,0.0
48026,4,8026,[ 97 258  11 588  88],457,5,36405,4.535318300735019,0.0,0.0
48027,4,8027,[427 515 318  79 588],807,5,36410,4.535376183358246,40.0,0.0
48028,4,8028,[568  96 222 111 172],450,4,36414,4.5353095030514385,0.0,0.0
48029,4,8029,[427 515 318  79 588],807,5,36419,4.535367372353674,40.0,0.0
48030,4,8030,[196   8 174 111 655],593,3,36422,4.535176192255012,0.0,0.0
48031,4,8031,[427 515 318  79 588],18,5,36427,4.53523406374502,40.0,0.0
48032,4,8032,[427 515 318  79 588],807,5,36432,4.53529192082659,40.0,0.0
48033,4,8033,[427 515 318  79 588],716,5,36437,4.535349763505104,40.0,0.0
48034,4,8034,[427 515 318  79 588],18,5,36442,4.535407591785937,40.0,0.0
48035,4,8035,[427 515 318  79 588],807,5,36447,4.535465405674465,40.0,0.0
48036,4,8036,[427 515 318  79 588],18,5,36452,4.535523205176061,40.0,0.0
48037,4,8037,[427 515 318  79 588],18,5,36457,4.5355809902960935,40.0,0.0
48038,4,8038,[427 515 318  79 588],18,5,36462,4.53563876103993,40.0,0.0
48039,4,8039,[427 515 318  79 588],807,5,36467,4.535696517412935,40.0,0.0
48040,4,8040,[301 385 111 173  97],796,3,36470,4.535505534137545,0.0,0.0
48041,4,8041,[427 515 318  79 588],18,5,36475,4.535563292713255,40.0,0.0
48042,4,8042,[427 515 318  79 588],716,5,36480,4.5356210369265195,40.0,0.0
48043,4,8043,[427 515 318  79 588],716,5,36485,4.535678766782695,40.0,0.0
48044,4,8044,[427 515 318  79 588],18,5,36490,4.535736482287135,40.0,0.0
48045,4,8045,[ 11 357 197 403 282],450,5,36495,4.53579418344519,0.0,0.0
48046,4,8046,[ 79  25 135 183 143],693,4,36499,4.535727600347956,0.0,0.0
48047,4,8047,[135  88 273 179 143],236,1,36500,4.535288270377734,0.0,0.0
48048,4,8048,[427 515 318  79 588],18,5,36505,4.535346005714995,40.0,0.0
48049,4,8049,[ 50  15  56 427 204],450,4,36509,4.53527950310559,20.0,20.0
48050,4,8050,[427 515 318  79 588],716,5,36514,4.5353372251894175,40.0,0.0
48051,4,8051,[427 515 318  79 588],716,5,36519,4.535394932935916,40.0,0.0
48052,4,8052,[153 234  70 385 200],504,2,36521,4.535080094374767,0.0,0.0
48053,4,8053,[427 515 318  79 588],807,5,36526,4.535137819716911,40.0,0.0
48054,4,8054,[427 515 318  79 588],18,5,36531,4.535195530726257,40.0,0.0
48055,4,8055,[427 515 318  79 588],807,5,36536,4.535253227408143,40.0,0.0
48056,4,8056,[427 515 318  79 588],18,5,36541,4.535310909767904,40.0,0.0
48057,4,8057,[197  97 515 186   8],18,5,36546,4.535368577810871,0.0,0.0
48058,4,8058,[427 515 318  79 588],18,5,36551,4.535426231542375,40.0,0.0
48059,4,8059,[427 515 318  79 588],716,5,36556,4.535483870967742,40.0,0.0
48060,4,8060,[427 515 318  79 588],716,5,36561,4.535541496092296,40.0,0.0
48061,4,8061,[427 515 318  79 588],716,5,36566,4.535599106921359,40.0,0.0
48062,4,8062,[427 515 318  79 588],807,5,36571,4.53565670346025,40.0,0.0
48063,4,8063,[427 515 318  79 588],18,5,36576,4.535714285714286,40.0,0.0
48064,4,8064,[427 515 318  79 588],807,5,36581,4.535771853688779,40.0,0.0
48065,4,8065,[117 121 655 742 597],457,4,36585,4.535705430200843,0.0,0.0
48066,4,8066,[427 515 318  79 588],716,5,36590,4.53576298500062,40.0,0.0
48067,4,8067,[427 515 318  79 588],807,5,36595,4.535820525532969,40.0,0.0
48068,4,8068,[427 515 318  79 588],807,5,36600,4.535878051803198,40.0,0.0
48069,4,8069,[427 515 318  79 588],807,5,36605,4.535935563816604,40.0,0.0
48070,4,8070,[427 515 318  79 588],807,5,36610,4.535993061578491,40.0,0.0
48071,4,8071,[427 515 318  79 588],716,5,36615,4.536050545094152,40.0,0.0
48072,4,8072,[427 515 318  79 588],18,5,36620,4.536108014368884,40.0,0.0
48073,4,8073,[427 515 318  79 588],18,5,36625,4.536165469407976,40.0,0.0
48074,4,8074,[144 173 568   1 161],716,3,36628,4.535975232198142,0.0,0.0
48075,4,8075,[427 515 318  79 588],18,5,36633,4.536032689450223,40.0,0.0
48076,4,8076,[427 515 318  79 588],807,5,36638,4.5360901324749285,40.0,0.0
48077,4,8077,[427 515 318  79 588],18,5,36643,4.536147561277544,40.0,0.0
48078,4,8078,[427 515 318  79 588],18,5,36648,4.53620497586335,40.0,0.0
48079,4,8079,[427 515 318  79 588],807,5,36653,4.536262376237624,40.0,0.0
48080,4,8080,[427 515 318  79 588],807,5,36658,4.536319762405643,40.0,0.0
48081,4,8081,[ 28 176 183 471 181],655,1,36659,4.535882207374412,0.0,0.0
48082,4,8082,[427 515 318  79 588],807,5,36664,4.535939626376345,40.0,0.0
48083,4,8083,[ 28 210 300  50 117],807,5,36669,4.535997031172687,0.0,20.0
48084,4,8084,[427 515 318  79 588],716,5,36674,4.536054421768707,40.0,0.0
48085,4,8085,[427 515 318  79 588],716,5,36679,4.536111798169676,40.0,0.0
48086,4,8086,[427 515 318  79 588],807,5,36684,4.536169160380858,40.0,0.0
48087,4,8087,[427 515 318  79 588],716,5,36689,4.536226508407517,40.0,0.0
48088,4,8088,[427 515 318  79 588],18,5,36694,4.536283842254914,40.0,0.0
48089,4,8089,[427 515 318  79 588],18,5,36699,4.5363411619283065,40.0,0.0
48090,4,8090,[427 515 318  79 588],807,5,36704,4.53639846743295,40.0,0.0
48091,4,8091,[427 515 318  79 588],807,5,36709,4.536455758774098,40.0,0.0
48092,4,8092,[427 515 318  79 588],716,5,36714,4.536513035957,40.0,0.0
48093,4,8093,[301 176 273 194 186],796,2,36716,4.536199654064739,0.0,0.0
48094,4,8094,[302  88 357 301 135],450,4,36720,4.536133415688696,0.0,0.0
48095,4,8095,[427 515 318  79 588],807,5,36725,4.53619071146245,40.0,0.0
48096,4,8096,[427 515 318  79 588],807,5,36730,4.536247993083858,40.0,0.0
48097,4,8097,[427 515 318  79 588],18,5,36735,4.536305260558162,40.0,0.0
48098,4,8098,[427 515 318  79 588],807,5,36740,4.536362513890603,40.0,0.0
48099,4,8099,[328 195 286 183 210],236,2,36742,4.536049382716049,0.0,20.0
48100,4,8100,[427 515 318  79 588],807,5,36747,4.5361066534995675,40.0,0.0
48101,4,8101,[427 515 318  79 588],18,5,36752,4.5361639101456435,40.0,0.0
48102,4,8102,[187   1 215 183 385],450,5,36757,4.536221152659508,0.0,0.0
48103,4,8103,[427 515 318  79 588],807,5,36762,4.5362783810463965,40.0,0.0
48104,4,8104,[427 515 318  79 588],807,5,36767,4.536335595311536,40.0,0.0
48105,4,8105,[427 515 318  79 588],18,5,36772,4.536392795460153,40.0,0.0
48106,4,8106,[427 515 318  79 588],18,5,36777,4.536449981497471,40.0,0.0
48107,4,8107,[195 211 357 597 269],450,5,36782,4.536507153428713,0.0,0.0
48108,4,8108,[427 515 318  79 588],18,5,36787,4.536564311259095,40.0,0.0
48109,4,8109,[427 515 318  79 588],18,5,36792,4.536621454993835,40.0,0.0
48110,4,8110,[427 515 318  79 588],716,5,36797,4.536678584638146,40.0,0.0
48111,4,8111,[216 597 194  64  69],450,5,36802,4.536735700197239,20.0,0.0
48112,4,8112,[183  82 173 176 603],796,4,36806,4.536669542709232,20.0,0.0
48113,4,8113,[427 515 318  79 588],807,5,36811,4.536726645304412,40.0,0.0
48114,4,8114,[273 204 153 471 435],401,3,36814,4.536537276648183,0.0,0.0
48115,4,8115,[427 515 318  79 588],18,5,36819,4.536594381468704,40.0,0.0
48116,4,8116,[427 515 318  79 588],807,5,36824,4.5366514722188,40.0,0.0
48117,4,8117,[427 515 318  79 588],18,5,36829,4.536708548903671,40.0,0.0
48118,4,8118,[427 515 318  79 588],716,5,36834,4.536765611528513,40.0,0.0
48119,4,8119,[427 515 318  79 588],18,5,36839,4.536822660098522,40.0,0.0
48120,4,8120,[427 515 318  79 588],716,5,36844,4.536879694618889,40.0,0.0
48121,4,8121,[427 515 318  79 588],716,5,36849,4.536936715094805,40.0,0.0
48122,4,8122,[194 265 288 273 197],450,3,36852,4.536747507078665,0.0,0.0
48123,4,8123,[427 515 318  79 588],18,5,36857,4.536804529788282,40.0,0.0
48124,4,8124,[100 174 328 200 186],655,1,36858,4.536369230769231,0.0,20.0
48125,4,8125,[187  50 258 127 117],655,3,36861,4.536180162441545,0.0,40.0
48126,4,8126,[405 748  22 742 322],450,5,36866,4.536237233911653,0.0,0.0
48127,4,8127,[427 515 318  79 588],18,5,36871,4.536294291338582,40.0,0.0
48128,4,8128,[427 515 318  79 588],716,5,36876,4.536351334727518,40.0,0.0
48129,4,8129,[427 515 318  79 588],18,5,36881,4.536408364083641,40.0,0.0
48130,4,8130,[427 515 318  79 588],807,5,36886,4.536465379412126,40.0,0.0
48131,4,8131,[427 515 318  79 588],18,5,36891,4.536522380718151,40.0,0.0
48132,4,8132,[427 515 318  79 588],18,5,36896,4.536579368006885,40.0,0.0
48133,4,8133,[ 96  82 403 182 215],796,4,36900,4.536513400540939,0.0,0.0
48134,4,8134,[ 95 655 568 204  96],577,4,36904,4.536447449293178,0.0,0.0
48135,4,8135,[427 515 318  79 588],18,5,36909,4.536504424778761,40.0,0.0
48136,4,8136,[427 515 318  79 588],807,5,36914,4.536561386260293,40.0,0.0
48137,4,8137,[181 275 286 204 357],296,5,36919,4.536618333742934,0.0,40.0
48138,4,8138,[508 273  25 144 483],693,2,36921,4.536306671581276,0.0,0.0
48139,4,8139,[427 515 318  79 588],716,5,36926,4.536363636363636,40.0,0.0
48140,4,8140,[427 515 318  79 588],807,5,36931,4.536420587151456,40.0,0.0
48141,4,8141,[318 235 215 185 238],457,4,36935,4.53635470400393,20.0,0.0
48142,4,8142,[427 515 318  79 588],716,5,36940,4.53641164190102,40.0,0.0
48143,4,8143,[427 515 318  79 588],18,5,36945,4.5364685658153245,40.0,0.0
48144,4,8144,[427 515 318  79 588],716,5,36950,4.536525475751995,40.0,0.0
48145,4,8145,[427 515 318  79 588],807,5,36955,4.53658237171618,40.0,0.0
48146,4,8146,[427 515 318  79 588],716,5,36960,4.536639253713023,40.0,0.0
48147,4,8147,[427 515 318  79 588],18,5,36965,4.536696121747668,40.0,0.0
48148,4,8148,[195 245  88 318 655],280,1,36966,4.536262118051295,20.0,0.0
48149,4,8149,[427 515 318  79 588],716,5,36971,4.536319018404908,40.0,0.0
48150,4,8150,[427 515 318  79 588],716,5,36976,4.536375904796958,40.0,0.0
48151,4,8151,[288 322 100  70 202],344,3,36979,4.536187438665358,0.0,20.0
48152,4,8152,[427 515 318  79 588],716,5,36984,4.536244327241506,40.0,0.0
48153,4,8153,[  4 135 202 265 151],716,3,36987,4.536055923473142,0.0,0.0
48154,4,8154,[427 515 318  79 588],716,5,36992,4.536112814224402,40.0,0.0
48155,4,8155,[427 515 318  79 588],716,5,36997,4.536169691025012,40.0,0.0
48156,4,8156,[427 515 318  79 588],716,5,37002,4.536226553880103,40.0,0.0
48157,4,8157,[427 515 318  79 588],716,5,37007,4.536283402794803,40.0,0.0
48158,4,8158,[197 748 313 202 288],450,4,37011,4.536217673734527,0.0,0.0
48159,4,8159,[588 197 161 172 603],798,2,37013,4.535906862745098,20.0,0.0
48160,4,8160,[427 515 318  79 588],716,5,37018,4.535963729935057,40.0,0.0
48161,4,8161,[427 515 318  79 588],18,5,37023,4.536020583190394,40.0,0.0
48162,4,8162,[ 15  64  69 403  82],330,5,37028,4.5360774225162315,20.0,0.0
48163,4,8163,[427 515 318  79 588],18,5,37033,4.536134247917688,40.0,0.0
48164,4,8164,[172 202  56 328   9],629,4,37037,4.536068585425597,0.0,0.0
48165,4,8165,[238 187 546  95 282],716,2,37039,4.535758021062944,0.0,0.0
48166,4,8166,[143 100 111 215 385],796,4,37043,4.535692420717521,0.0,20.0
48167,4,8167,[427 515 318  79 588],716,5,37048,4.535749265426053,40.0,0.0
48168,4,8168,[427 515 318  79 588],716,5,37053,4.535806096217407,40.0,0.0
48169,4,8169,[427 515 318  79 588],807,5,37058,4.535862913096695,40.0,0.0
48170,4,8170,[427 515 318  79 588],807,5,37063,4.535919716069024,40.0,0.0
48171,4,8171,[427 515 318  79 588],18,5,37068,4.535976505139501,40.0,0.0
48172,4,8172,[427 515 318  79 588],716,5,37073,4.536033280313227,40.0,0.0
48173,4,8173,[ 12 258 748 174 121],151,4,37077,4.53596770247125,0.0,0.0
48174,4,8174,[427 515 318  79 588],18,5,37082,4.536024464831804,40.0,0.0
48175,4,8175,[427 515 318  79 588],807,5,37087,4.536081213307241,40.0,0.0
48176,4,8176,[427 515 318  79 588],18,5,37092,4.536137947902653,40.0,0.0
48177,4,8177,[427 515 318  79 588],18,5,37097,4.536194668623136,40.0,0.0
48178,4,8178,[427 515 318  79 588],807,5,37102,4.536251375473774,40.0,0.0
48179,4,8179,[427 515 318  79 588],807,5,37107,4.5363080684596575,40.0,0.0
48180,4,8180,[427 515 318  79 588],18,5,37112,4.5363647475858695,40.0,0.0
48181,4,8181,[427 515 318  79 588],716,5,37117,4.536421412857492,40.0,0.0
48182,4,8182,[427 515 318  79 588],716,5,37122,4.536478064279604,40.0,0.0
48183,4,8183,[405 174 161 300   1],807,5,37127,4.536534701857282,0.0,0.0
48184,4,8184,[427 515 318  79 588],716,5,37132,4.536591325595602,40.0,0.0
48185,4,8185,[427 515 318  79 588],716,5,37137,4.536647935499634,40.0,0.0
48186,4,8186,[427 515 318  79 588],18,5,37142,4.536704531574447,40.0,0.0
48187,4,8187,[427 515 318  79 588],807,5,37147,4.53676111382511,40.0,0.0
48188,4,8188,[181 125  12 471 238],450,5,37152,4.536817682256686,0.0,0.0
48189,4,8189,[ 50 483  70 286 423],655,2,37154,4.536507936507936,0.0,40.0
48190,4,8190,[427 515 318  79 588],18,5,37159,4.5365645220363815,40.0,0.0
48191,4,8191,[427 515 318  79 588],716,5,37164,4.53662109375,40.0,0.0
48192,4,8192,[427 515 318  79 588],716,5,37169,4.536677651653851,40.0,0.0
48193,4,8193,[196 269 655 132 197],450,5,37174,4.53673419575299,0.0,0.0
48194,4,8194,[427 515 318  79 588],716,5,37179,4.536790726052471,40.0,0.0
48195,4,8195,[427 515 318  79 588],716,5,37184,4.536847242557345,40.0,0.0
48196,4,8196,[168 185   4 234   1],389,5,37189,4.536903745272661,0.0,0.0
48197,4,8197,[427 515 318  79 588],18,5,37194,4.536960234203464,40.0,0.0
48198,4,8198,[427 515 318  79 588],18,5,37199,4.537016709354799,40.0,0.0
48199,4,8199,[427 515 318  79 588],807,5,37204,4.537073170731707,40.0,0.0
48200,4,8200,[ 98  25 275  95 302],450,3,37207,4.536885745640776,0.0,20.0
48201,4,8201,[427 515 318  79 588],18,5,37212,4.536942209217264,40.0,0.0
48202,4,8202,[427 515 318  79 588],18,5,37217,4.536998659027185,40.0,0.0
48203,4,8203,[427 515 318  79 588],18,5,37222,4.537055095075573,40.0,0.0
48204,4,8204,[427 515 318  79 588],807,5,37227,4.5371115173674585,40.0,0.0
48205,4,8205,[195 132 174 405 196],269,1,37228,4.536680477699244,0.0,0.0
48206,4,8206,[427 515 318  79 588],716,5,37233,4.536736931887413,40.0,0.0
48207,4,8207,[427 515 318  79 588],716,5,37238,4.536793372319688,40.0,0.0
48208,4,8208,[423 181 427 151 111],450,5,37243,4.5368497990010965,20.0,0.0
48209,4,8209,[427 515 318  79 588],716,5,37248,4.536906211936663,40.0,0.0
48210,4,8210,[427 515 318  79 588],716,5,37253,4.536962611131409,40.0,0.0
48211,4,8211,[ 22  25  12  15 318],11,3,37256,4.536775450560156,20.0,0.0
48212,4,8212,[427 515 318  79 588],716,5,37261,4.536831851942043,40.0,0.0
48213,4,8213,[427 515 318  79 588],18,5,37266,4.536888239590942,40.0,0.0
48214,4,8214,[423 234 172 176  22],716,4,37270,4.536822884966525,0.0,0.0
48215,4,8215,[427 515 318  79 588],716,5,37275,4.536879259980526,40.0,0.0
48216,4,8216,[427 515 318  79 588],18,5,37280,4.536935621272971,40.0,0.0
48217,4,8217,[427 515 318  79 588],18,5,37285,4.536991968848868,40.0,0.0
48218,4,8218,[427 515 318  79 588],18,5,37290,4.537048302713226,40.0,0.0
48219,4,8219,[427 515 318  79 588],18,5,37295,4.5371046228710465,40.0,0.0
48220,4,8220,[427 515 318  79 588],716,5,37300,4.5371609293273325,40.0,0.0
48221,4,8221,[427 515 318  79 588],18,5,37305,4.537217222087083,40.0,0.0
48222,4,8222,[427 515 318  79 588],807,5,37310,4.537273501155296,40.0,0.0
48223,4,8223,[427 515 318  79 588],18,5,37315,4.537329766536965,40.0,0.0
48224,4,8224,[427 515 318  79 588],807,5,37320,4.537386018237082,40.0,0.0
48225,4,8225,[ 89 302 181 275   4],344,4,37324,4.537320690493557,0.0,20.0
48226,4,8226,[427 515 318  79 588],807,5,37329,4.537376929621977,40.0,0.0
48227,4,8227,[  4  28  15  69 111],151,5,37334,4.537433155080214,0.0,0.0
48228,4,8228,[282 125 238  79 405],450,5,37339,4.537489366873253,0.0,0.0
48229,4,8229,[427 515 318  79 588],18,5,37344,4.537545565006075,40.0,0.0
48230,4,8230,[427 515 318  79 588],18,5,37349,4.53760174948366,40.0,0.0
48231,4,8231,[427 515 318  79 588],716,5,37354,4.5376579203109815,40.0,0.0
48232,4,8232,[427 515 318  79 588],18,5,37359,4.537714077493016,40.0,0.0
48233,4,8233,[427 515 318  79 588],716,5,37364,4.537770221034734,40.0,0.0
48234,4,8234,[ 11 286 273 258 300],450,4,37368,4.537704918032787,0.0,20.0
48235,4,8235,[427 515 318  79 588],716,5,37373,4.537761049052938,40.0,0.0
48236,4,8236,[427 515 318  79 588],18,5,37378,4.537817166444094,40.0,0.0
48237,4,8237,[508 111 117  15 301],463,3,37381,4.537630492838067,0.0,0.0
48238,4,8238,[427 515 318  79 588],807,5,37386,4.537686612452967,40.0,0.0
48239,4,8239,[427 515 318  79 588],807,5,37391,4.537742718446602,40.0,0.0
48240,4,8240,[222 215 275  12 180],796,4,37395,4.537677466326902,0.0,20.0
48241,4,8241,[427 515 318  79 588],18,5,37400,4.537733559815579,40.0,0.0
48242,4,8242,[100 135 423 204 313],236,2,37402,4.537425694528691,0.0,20.0
48243,4,8243,[282 405 172 286 100],401,1,37403,4.53699660359049,0.0,40.0
48244,4,8244,[496  71  15 210 111],593,4,37407,4.536931473620376,20.0,0.0
48245,4,8245,[427 515 318  79 588],716,5,37412,4.536987630366238,40.0,0.0
48246,4,8246,[172 423   1  71 216],885,3,37415,4.53680126106463,0.0,0.0
48247,4,8247,[427 515 318  79 588],716,5,37420,4.536857419980602,40.0,0.0
48248,4,8248,[313  79  64 143 183],450,5,37425,4.53691356528064,20.0,0.0
48249,4,8249,[427 515 318  79 588],807,5,37430,4.536969696969697,40.0,0.0
48250,4,8250,[427 515 318  79 588],807,5,37435,4.537025815052721,40.0,0.0
48251,4,8251,[427 515 318  79 588],807,5,37440,4.537081919534658,40.0,0.0
48252,4,8252,[427 515 318  79 588],716,5,37445,4.5371380104204535,40.0,0.0
48253,4,8253,[427 515 318  79 588],807,5,37450,4.537194087715047,40.0,0.0
48254,4,8254,[427 515 318  79 588],18,5,37455,4.53725015142338,40.0,0.0
48255,4,8255,[427 515 318  79 588],18,5,37460,4.537306201550388,40.0,0.0
48256,4,8256,[427 515 318  79 588],18,5,37465,4.5373622381010055,40.0,0.0
48257,4,8257,[427 515 318  79 588],18,5,37470,4.537418261080164,40.0,0.0
48258,4,8258,[427 515 318  79 588],807,5,37475,4.537474270492796,40.0,0.0
48259,4,8259,[427 515 318  79 588],716,5,37480,4.5375302663438255,40.0,0.0
48260,4,8260,[427 515 318  79 588],716,5,37485,4.5375862486381795,40.0,0.0
48261,4,8261,[427 515 318  79 588],807,5,37490,4.537642217380779,40.0,0.0
48262,4,8262,[174 173 125  96 202],577,5,37495,4.537698172576546,0.0,0.0
48263,4,8263,[237 427  22 286  28],450,5,37500,4.537754114230397,20.0,20.0
48264,4,8264,[427 515 318  79 588],807,5,37505,4.537810042347248,40.0,0.0
48265,4,8265,[427 515 318  79 588],18,5,37510,4.537865956932011,40.0,0.0
48266,4,8266,[427 515 318  79 588],716,5,37515,4.5379218579895975,40.0,0.0
48267,4,8267,[427 515 318  79 588],716,5,37520,4.537977745524915,40.0,0.0
48268,4,8268,[496 508 228   8 313],344,4,37524,4.537912685935422,20.0,0.0
48269,4,8269,[427 515 318  79 588],18,5,37529,4.537968561064087,40.0,0.0
48270,4,8270,[427 515 318  79 588],807,5,37534,4.538024422681659,40.0,0.0
48271,4,8271,[  1 196  97 405 228],344,2,37536,4.537717601547389,0.0,0.0
48272,4,8272,[ 12 174 301 403  28],655,0,37536,4.537169104315242,0.0,0.0
48273,4,8273,[161 300 471 194 132],807,5,37541,4.537225042301184,0.0,0.0
48274,4,8274,[  9 427 144 313 211],296,5,37546,4.537280966767372,20.0,0.0
48275,4,8275,[427 515 318  79 588],716,5,37551,4.537336877718705,40.0,0.0
48276,4,8276,[427 515 318  79 588],807,5,37556,4.537392775160082,40.0,0.0
48277,4,8277,[427 515 318  79 588],807,5,37561,4.5374486590964,40.0,0.0
48278,4,8278,[427 515 318  79 588],807,5,37566,4.537504529532552,40.0,0.0
48279,4,8279,[427 515 318  79 588],18,5,37571,4.53756038647343,40.0,0.0
48280,4,8280,[427 515 318  79 588],807,5,37576,4.537616229923922,40.0,0.0
48281,4,8281,[427 515 318  79 588],18,5,37581,4.537672059888916,40.0,0.0
48282,4,8282,[197 200  79 127 118],655,3,37584,4.537486417964506,0.0,20.0
48283,4,8283,[427 515 318  79 588],18,5,37589,4.5375422501207145,40.0,0.0
48284,4,8284,[313 546 273 187  71],796,4,37593,4.537477368738684,0.0,0.0
48285,4,8285,[427 515 318  79 588],18,5,37598,4.537533188510741,40.0,0.0
48286,4,8286,[427 515 318  79 588],18,5,37603,4.53758899481115,40.0,0.0
48287,4,8287,[  1 196 194  79 173],796,4,37607,4.5375241312741315,0.0,0.0
48288,4,8288,[427 515 318  79 588],807,5,37612,4.537579925202075,40.0,0.0
48289,4,8289,[ 11 313 515 655 268],655,2,37614,4.537273823884198,0.0,0.0
48290,4,8290,[427 515 318  79 588],716,5,37619,4.537329634543481,40.0,0.0
48291,4,8291,[427 515 318  79 588],716,5,37624,4.537385431741438,40.0,0.0
48292,4,8292,[194 238 318  28 144],716,4,37628,4.537320631858194,20.0,0.0
48293,4,8293,[ 12 211  70  88  28],151,5,37633,4.537376416686762,0.0,0.0
48294,4,8294,[427 515 318  79 588],18,5,37638,4.537432188065099,40.0,0.0
48295,4,8295,[427 515 318  79 588],18,5,37643,4.5374879459980715,40.0,0.0
48296,4,8296,[100  97 568 357  79],796,3,37646,4.537302639508256,0.0,20.0
48297,4,8297,[302 588 288 176 210],344,5,37651,4.537358399614365,0.0,0.0
48298,4,8298,[427 515 318  79 588],716,5,37656,4.537414146282685,40.0,0.0
48299,4,8299,[427 515 318  79 588],807,5,37661,4.537469879518072,40.0,0.0
48300,4,8300,[427 515 318  79 588],18,5,37666,4.537525599325383,40.0,0.0
48301,4,8301,[427 515 318  79 588],18,5,37671,4.537581305709468,40.0,0.0
48302,4,8302,[427 515 318  79 588],716,5,37676,4.537636998675177,40.0,0.0
48303,4,8303,[427 515 318  79 588],716,5,37681,4.53769267822736,40.0,0.0
48304,4,8304,[427 515 318  79 588],18,5,37686,4.537748344370861,40.0,0.0
48305,4,8305,[427 515 318  79 588],807,5,37691,4.537803997110522,40.0,0.0
48306,4,8306,[427 515 318  79 588],18,5,37696,4.537859636451186,40.0,0.0
48307,4,8307,[427 515 318  79 588],807,5,37701,4.537915262397689,40.0,0.0
48308,4,8308,[427 515 318  79 588],807,5,37706,4.537970874954868,40.0,0.0
48309,4,8309,[245   4 427   8 194],796,4,37710,4.537906137184115,20.0,0.0
48310,4,8310,[427 515 318  79 588],716,5,37715,4.537961737456383,40.0,0.0
48311,4,8311,[427 515 318  79 588],18,5,37720,4.538017324350337,40.0,0.0
48312,4,8312,[427 515 318  79 588],18,5,37725,4.538072897870805,40.0,0.0
48313,4,8313,[427 515 318  79 588],716,5,37730,4.538128458022612,40.0,0.0
48314,4,8314,[427 515 318  79 588],18,5,37735,4.538184004810583,40.0,0.0
48315,4,8315,[181 176 117 194 328],450,5,37740,4.538239538239538,0.0,0.0
48316,4,8316,[427 515 318  79 588],18,5,37745,4.538295058314296,40.0,0.0
48317,4,8317,[427 515 318  79 588],716,5,37750,4.538350565039673,40.0,0.0
48318,4,8318,[427 515 318  79 588],716,5,37755,4.538406058420483,40.0,0.0
48319,4,8319,[427 515 318  79 588],18,5,37760,4.538461538461538,40.0,0.0
48320,4,8320,[427 515 318  79 588],18,5,37765,4.538517005167648,40.0,0.0
48321,4,8321,[  8 423 174 168 183],269,2,37767,4.5382119682768565,0.0,0.0
48322,4,8322,[ 22 405 216 151 546],450,5,37772,4.538267451640033,0.0,0.0
48323,4,8323,[427 515 318  79 588],716,5,37777,4.538322921672273,40.0,0.0
48324,4,8324,[435 405   7  22 174],269,0,37777,4.5377777777777775,0.0,0.0
48325,4,8325,[427 515 318  79 588],716,5,37782,4.537833293298102,40.0,0.0
48326,4,8326,[427 515 318  79 588],18,5,37787,4.537888795484569,40.0,0.0
48327,4,8327,[427 515 318  79 588],18,5,37792,4.537944284341979,40.0,0.0
48328,4,8328,[427 515 318  79 588],716,5,37797,4.537999759875135,40.0,0.0
48329,4,8329,[427 515 318  79 588],807,5,37802,4.538055222088835,40.0,0.0
48330,4,8330,[427 515 318  79 588],716,5,37807,4.5381106709878765,40.0,0.0
48331,4,8331,[427 515 318  79 588],807,5,37812,4.538166106577052,40.0,0.0
48332,4,8332,[423 222 204  98 273],236,3,37815,4.537981519260771,0.0,0.0
48333,4,8333,[427 515 318  79 588],807,5,37820,4.5380369570434365,40.0,0.0
48334,4,8334,[216   1 385  70 234],23,3,37823,4.537852429514097,0.0,0.0
48335,4,8335,[427 515 318  79 588],18,5,37828,4.537907869481766,40.0,0.0
48336,4,8336,[427 515 318  79 588],18,5,37833,4.5379632961496945,40.0,0.0
48337,4,8337,[427 515 318  79 588],18,5,37838,4.538018709522667,40.0,0.0
48338,4,8338,[427 515 318  79 588],807,5,37843,4.538074109605469,40.0,0.0
48339,4,8339,[427 515 318  79 588],807,5,37848,4.5381294964028775,40.0,0.0
48340,4,8340,[427 515 318  79 588],807,5,37853,4.538184869919674,40.0,0.0
48341,4,8341,[269 322  98  28 222],450,4,37857,4.538120354830975,0.0,0.0
48342,4,8342,[ 28 423 215 211  22],796,3,37860,4.5379359942466735,0.0,0.0
48343,4,8343,[427 515 318  79 588],18,5,37865,4.537991371045062,40.0,0.0
48344,4,8344,[427 515 318  79 588],18,5,37870,4.5380467345716,40.0,0.0
48345,4,8345,[301 273  70 403  96],450,4,37874,4.53798226695423,0.0,0.0
48346,4,8346,[118 210 174 211 302],655,1,37875,4.537558404217084,0.0,0.0
48347,4,8347,[427 515 318  79 588],807,5,37880,4.537613799712506,40.0,0.0
48348,4,8348,[427 515 318  79 588],807,5,37885,4.537669181937956,40.0,0.0
48349,4,8349,[427 515 318  79 588],807,5,37890,4.537724550898203,40.0,0.0
48350,4,8350,[427 515 318  79 588],716,5,37895,4.537779906598012,40.0,0.0
48351,4,8351,[196 357 117 496  98],796,5,37900,4.537835249042145,20.0,0.0
48352,4,8352,[ 12 210 186 125 182],18,4,37904,4.537770860768586,0.0,0.0
48353,4,8353,[427 515 318  79 588],807,5,37909,4.537826191046205,40.0,0.0
48354,4,8354,[ 15 269 168 195 204],450,4,37913,4.537761819269898,0.0,0.0
48355,4,8355,[427 515 318  79 588],716,5,37918,4.537817137386309,40.0,0.0
48356,4,8356,[175  98  82 238 196],716,4,37922,4.537752782098839,0.0,0.0
48357,4,8357,[427 515 318  79 588],716,5,37927,4.537808088059345,40.0,0.0
48358,4,8358,[ 11 275 475 228 216],655,2,37929,4.5375044861825575,0.0,20.0
48359,4,8359,[427 515 318  79 588],807,5,37934,4.53755980861244,40.0,0.0
48360,4,8360,[427 515 318  79 588],807,5,37939,4.537615117808874,40.0,0.0
48361,4,8361,[427 117 143 210 211],807,5,37944,4.537670413776609,20.0,0.0
48362,4,8362,[427 515 318  79 588],716,5,37949,4.537725696520387,40.0,0.0
48363,4,8363,[427 515 318  79 588],18,5,37954,4.537780966044955,40.0,0.0
48364,4,8364,[427 515 318  79 588],716,5,37959,4.537836222355051,40.0,0.0
48365,4,8365,[427 515 318  79 588],716,5,37964,4.537891465455415,40.0,0.0
48366,4,8366,[427 515 318  79 588],807,5,37969,4.537946695350783,40.0,0.0
48367,4,8367,[258 191 143  89 216],23,3,37972,4.5377629063097515,0.0,0.0
48368,4,8368,[175 176  22 143 204],655,1,37973,4.537340184012427,0.0,0.0
48369,4,8369,[427 515 318  79 588],716,5,37978,4.537395459976105,40.0,0.0
48370,4,8370,[427 515 318  79 588],18,5,37983,4.5374507227332455,40.0,0.0
48371,4,8371,[427 515 318  79 588],807,5,37988,4.537505972288581,40.0,0.0
48372,4,8372,[427 515 318  79 588],18,5,37993,4.537561208646841,40.0,0.0
48373,4,8373,[179  64  79  28  50],389,5,37998,4.537616431812753,20.0,20.0
48374,4,8374,[427 515 318  79 588],807,5,38003,4.537671641791045,40.0,0.0
48375,4,8375,[427 515 318  79 588],18,5,38008,4.537726838586438,40.0,0.0
48376,4,8376,[427 515 318  79 588],716,5,38013,4.537782022203653,40.0,0.0
48377,4,8377,[427 515 318  79 588],716,5,38018,4.53783719264741,40.0,0.0
48378,4,8378,[427 515 318  79 588],18,5,38023,4.5378923499224255,40.0,0.0
48379,4,8379,[427 515 318  79 588],807,5,38028,4.537947494033413,40.0,0.0
48380,4,8380,[427 515 318  79 588],807,5,38033,4.5380026249850856,40.0,0.0
48381,4,8381,[427 515 318  79 588],18,5,38038,4.5380577427821525,40.0,0.0
48382,4,8382,[427 515 318  79 588],716,5,38043,4.538112847429321,40.0,0.0
48383,4,8383,[ 11   4 234 143 568],716,4,38047,4.538048664122138,0.0,0.0
48384,4,8384,[427 515 318  79 588],18,5,38052,4.5381037567084075,40.0,0.0
48385,4,8385,[196 423 100 427 245],796,3,38055,4.537920343429525,20.0,20.0
48386,4,8386,[427 515 318  79 588],716,5,38060,4.537975438178133,40.0,0.0
48387,4,8387,[427 515 318  79 588],716,5,38065,4.538030519790176,40.0,0.0
48388,4,8388,[195  88 238  82 597],269,1,38066,4.53760877339373,0.0,0.0
48389,4,8389,[427 515 318  79 588],807,5,38071,4.537663885578069,40.0,0.0
48390,4,8390,[427 515 318  79 588],18,5,38076,4.537718984626386,40.0,0.0
48391,4,8391,[427 515 318  79 588],716,5,38081,4.5377740705433744,40.0,0.0
48392,4,8392,[  4 179 186 210 276],786,4,38085,4.537709996425593,0.0,0.0
48393,4,8393,[300 435 151 181 275],151,5,38090,4.537765070288301,0.0,20.0
48394,4,8394,[427 515 318  79 588],716,5,38095,4.537820131030375,40.0,0.0
48395,4,8395,[427 515 318  79 588],716,5,38100,4.5378751786565035,40.0,0.0
48396,4,8396,[427 515 318  79 588],716,5,38105,4.537930213171371,40.0,0.0
48397,4,8397,[427 515 318  79 588],18,5,38110,4.537985234579661,40.0,0.0
48398,4,8398,[427 515 318  79 588],807,5,38115,4.538040242886058,40.0,0.0
48399,4,8399,[427 515 318  79 588],716,5,38120,4.538095238095238,40.0,0.0
48400,4,8400,[ 79 496 125  64 597],450,5,38125,4.53815022021188,40.0,0.0
48401,4,8401,[427 515 318  79 588],807,5,38130,4.538205189240657,40.0,0.0
48402,4,8402,[427 515 318  79 588],18,5,38135,4.538260145186243,40.0,0.0
48403,4,8403,[427 515 318  79 588],18,5,38140,4.538315088053308,40.0,0.0
48404,4,8404,[275 191  97 435 508],655,2,38142,4.538013087447948,0.0,20.0
48405,4,8405,[508 294 180  56 118],280,2,38144,4.53771115869617,0.0,0.0
48406,4,8406,[302 258   1 328 181],902,1,38145,4.537290353277031,0.0,0.0
48407,4,8407,[427 515 318  79 588],716,5,38150,4.5373453853472885,40.0,0.0
48408,4,8408,[  9 195  95 183 127],796,4,38154,4.537281484124152,0.0,20.0
48409,4,8409,[200 187 403  50 288],450,3,38157,4.537098692033294,0.0,20.0
48410,4,8410,[ 69 187 202 300 111],389,3,38160,4.536915943407442,0.0,0.0
48411,4,8411,[427 515 318  79 588],18,5,38165,4.536970993818355,40.0,0.0
48412,4,8412,[427 515 318  79 588],716,5,38170,4.53702603114228,40.0,0.0
48413,4,8413,[427 515 318  79 588],18,5,38175,4.537081055383884,40.0,0.0
48414,4,8414,[427 515 318  79 588],18,5,38180,4.5371360665478315,40.0,0.0
48415,4,8415,[318   8 546 235 742],457,3,38183,4.536953422053232,20.0,0.0
48416,4,8416,[427 515 318  79 588],807,5,38188,4.537008435309493,40.0,0.0
48417,4,8417,[427 515 318  79 588],716,5,38193,4.537063435495367,40.0,0.0
48418,4,8418,[427 515 318  79 588],716,5,38198,4.537118422615513,40.0,0.0
48419,4,8419,[427 515 318  79 588],18,5,38203,4.537173396674584,40.0,0.0
48420,4,8420,[427 515 318  79 588],807,5,38208,4.537228357677235,40.0,0.0
48421,4,8421,[427 515 318  79 588],807,5,38213,4.537283305628117,40.0,0.0
48422,4,8422,[427 515 318  79 588],807,5,38218,4.537338240531877,40.0,0.0
48423,4,8423,[427 515 318  79 588],807,5,38223,4.537393162393163,40.0,0.0
48424,4,8424,[427 515 318  79 588],716,5,38228,4.537448071216617,40.0,0.0
48425,4,8425,[427 515 318  79 588],807,5,38233,4.537502967006883,40.0,0.0
48426,4,8426,[185  79 125 427  11],655,3,38236,4.537320517384597,20.0,0.0
48427,4,8427,[294 269 258 435  98],629,3,38239,4.537138111058377,0.0,0.0
48428,4,8428,[427 515 318  79 588],18,5,38244,4.537193024083521,40.0,0.0
48429,4,8429,[181 191 405 172   7],577,3,38247,4.537010676156584,0.0,0.0
48430,4,8430,[427 515 318  79 588],18,5,38252,4.537065591270312,40.0,0.0
48431,4,8431,[427 515 318  79 588],716,5,38257,4.537120493358634,40.0,0.0
48432,4,8432,[427 515 318  79 588],18,5,38262,4.537175382426183,40.0,0.0
48433,4,8433,[ 88 195 173 185 143],151,4,38266,4.537111690775433,0.0,0.0
48434,4,8434,[427 515 318  79 588],18,5,38271,4.537166567871962,40.0,0.0
48435,4,8435,[427 515 318  79 588],18,5,38276,4.537221431958274,40.0,0.0
48436,4,8436,[427 515 318  79 588],807,5,38281,4.537276283038995,40.0,0.0
48437,4,8437,[427 515 318  79 588],716,5,38286,4.537331121118749,40.0,0.0
48438,4,8438,[427 515 318  79 588],18,5,38291,4.537385946202157,40.0,0.0
48439,4,8439,[427 515 318  79 588],18,5,38296,4.5374407582938385,40.0,0.0
48440,4,8440,[235  50 265 179 125],450,4,38300,4.537377088022746,0.0,20.0
48441,4,8441,[471 204 117 275 423],457,5,38305,4.537431888178157,0.0,20.0
48442,4,8442,[427 515 318  79 588],716,5,38310,4.537486675352363,40.0,0.0
48443,4,8443,[427 515 318  79 588],18,5,38315,4.537541449549976,40.0,0.0
48444,4,8444,[427 515 318  79 588],716,5,38320,4.5375962107756065,40.0,0.0
48445,4,8445,[ 12 258  15 313  95],450,3,38323,4.537414160549372,0.0,0.0
48446,4,8446,[173  12  89  11  88],344,3,38326,4.537232153427253,0.0,0.0
48447,4,8447,[228  88  11 172 222],344,3,38329,4.5370501893939394,0.0,0.0
48448,4,8448,[  9  56  82  12 288],457,5,38334,4.537104982838206,0.0,0.0
48449,4,8449,[427 515 318  79 588],716,5,38339,4.53715976331361,40.0,0.0
48450,4,8450,[427 515 318  79 588],716,5,38344,4.5372145308247545,40.0,0.0
48451,4,8451,[427 515 318  79 588],716,5,38349,4.537269285376242,40.0,0.0
48452,4,8452,[427 515 318  79 588],807,5,38354,4.537324026972672,40.0,0.0
48453,4,8453,[427 515 318  79 588],807,5,38359,4.537378755618642,40.0,0.0
48454,4,8454,[  7 183  22 405  56],655,1,38360,4.536960378474276,0.0,0.0
48455,4,8455,[427 515 318  79 588],807,5,38365,4.5370151371807,40.0,0.0
48456,4,8456,[427 515 318  79 588],18,5,38370,4.537069882937212,40.0,0.0
48457,4,8457,[258  79  25 275 471],655,2,38372,4.536769921967368,0.0,20.0
48458,4,8458,[427 515 318  79 588],716,5,38377,4.536824683768767,40.0,0.0
48459,4,8459,[427 515 318  79 588],807,5,38382,4.536879432624113,40.0,0.0
48460,4,8460,[427 515 318  79 588],716,5,38387,4.536934168537998,40.0,0.0
48461,4,8461,[427 515 318  79 588],716,5,38392,4.5369888915150085,40.0,0.0
48462,4,8462,[427 515 318  79 588],18,5,38397,4.537043601559731,40.0,0.0
48463,4,8463,[427 515 318  79 588],18,5,38402,4.5370982986767485,40.0,0.0
48464,4,8464,[427 515 318  79 588],716,5,38407,4.537152982870643,40.0,0.0
48465,4,8465,[427 515 318  79 588],18,5,38412,4.537207654145996,40.0,0.0
48466,4,8466,[427 515 318  79 588],18,5,38417,4.537262312507382,40.0,0.0
48467,4,8467,[265  97 117 302 135],655,2,38419,4.536962683042041,0.0,0.0
48468,4,8468,[471 185  89 202 265],450,5,38424,4.537017357421183,0.0,0.0
48469,4,8469,[174  97 100 168 286],450,5,38429,4.537072018890201,0.0,40.0
48470,4,8470,[265 496 245 258 210],450,4,38433,4.537008617636642,20.0,0.0
48471,4,8471,[435  96 216 427 197],269,2,38435,4.536709159584514,20.0,0.0
48472,4,8472,[427 515 318  79 588],18,5,38440,4.536763838073882,40.0,0.0
48473,4,8473,[568 276 117 204  15],593,4,38444,4.536700495633703,0.0,0.0
48474,4,8474,[427 515 318  79 588],807,5,38449,4.536755162241888,40.0,0.0
48475,4,8475,[427 515 318  79 588],807,5,38454,4.53680981595092,40.0,0.0
48476,4,8476,[427 515 318  79 588],716,5,38459,4.5368644567653655,40.0,0.0
48477,4,8477,[427 515 318  79 588],716,5,38464,4.536919084689785,40.0,0.0
48478,4,8478,[427 515 318  79 588],807,5,38469,4.536973699728741,40.0,0.0
48479,4,8479,[ 97 273 597 275  15],796,3,38472,4.536792452830189,0.0,20.0
48480,4,8480,[427 515 318  79 588],18,5,38477,4.5368470699209995,40.0,0.0
48481,4,8481,[427 515 318  79 588],807,5,38482,4.536901674133459,40.0,0.0
48482,4,8482,[427 515 318  79 588],716,5,38487,4.536956265472121,40.0,0.0
48483,4,8483,[427 515 318  79 588],716,5,38492,4.537010843941537,40.0,0.0
48484,4,8484,[427 515 318  79 588],716,5,38497,4.537065409546258,40.0,0.0
48485,4,8485,[427 515 318  79 588],18,5,38502,4.537119962290832,40.0,0.0
48486,4,8486,[427 515 318  79 588],807,5,38507,4.537174502179805,40.0,0.0
48487,4,8487,[655 191 194 282 174],401,3,38510,4.536993402450518,0.0,0.0
48488,4,8488,[427 515 318  79 588],18,5,38515,4.537047944398633,40.0,0.0
48489,4,8489,[427 515 318  79 588],716,5,38520,4.5371024734982335,40.0,0.0
48490,4,8490,[173 144 603 117 323],796,4,38524,4.537039217995525,20.0,0.0
48491,4,8491,[313  79 144 100   1],593,4,38528,4.536975977390485,0.0,20.0
48492,4,8492,[427 515 318  79 588],807,5,38533,4.537030495702343,40.0,0.0
48493,4,8493,[211 173 328  95 127],450,4,38537,4.536967271014834,0.0,20.0
48494,4,8494,[195 176 197 742 300],796,3,38540,4.53678634490877,0.0,0.0
48495,4,8495,[427 515 318  79 588],18,5,38545,4.536840866290019,40.0,0.0
48496,4,8496,[427 515 318  79 588],807,5,38550,4.536895374838179,40.0,0.0
48497,4,8497,[427 515 318  79 588],18,5,38555,4.536949870557779,40.0,0.0
48498,4,8498,[427 515 318  79 588],716,5,38560,4.537004353453347,40.0,0.0
48499,4,8499,[427 515 318  79 588],807,5,38565,4.537058823529412,40.0,0.0
48500,4,8500,[276 180  79 194  71],535,3,38568,4.536878014351252,0.0,0.0
48501,4,8501,[ 15  50 187 742 211],450,4,38572,4.536814867090096,0.0,20.0
48502,4,8502,[427 515 318  79 588],716,5,38577,4.536869340232859,40.0,0.0
48503,4,8503,[135 211  88 127 568],389,2,38579,4.5365710253998115,0.0,20.0
48504,4,8504,[427 515 318  79 588],18,5,38584,4.536625514403292,40.0,0.0
48505,4,8505,[117 403 228 471 546],457,4,38588,4.536562426522455,0.0,0.0
48506,4,8506,[427 515 318  79 588],716,5,38593,4.536616903726343,40.0,0.0
48507,4,8507,[234  22 515 273 269],655,2,38595,4.5363187588152325,0.0,0.0
48508,4,8508,[427 515 318  79 588],716,5,38600,4.536373251850981,40.0,0.0
48509,4,8509,[ 64 403   1 117 515],72,4,38604,4.536310223266745,20.0,0.0
48510,4,8510,[427 515 318  79 588],807,5,38609,4.536364704500059,40.0,0.0
48511,4,8511,[427 515 318  79 588],18,5,38614,4.536419172932331,40.0,0.0
48512,4,8512,[427 515 318  79 588],18,5,38619,4.536473628568072,40.0,0.0
48513,4,8513,[427 515 318  79 588],18,5,38624,4.536528071411793,40.0,0.0
48514,4,8514,[568 483  12 471 742],693,2,38626,4.536230182031709,0.0,0.0
48515,4,8515,[427 515 318  79 588],18,5,38631,4.5362846406763735,40.0,0.0
48516,4,8516,[427 515 318  79 588],18,5,38636,4.536339086532816,40.0,0.0
48517,4,8517,[427 515 318  79 588],18,5,38641,4.536393519605541,40.0,0.0
48518,4,8518,[313 187 118 323 117],796,4,38645,4.536330555229487,0.0,0.0
48519,4,8519,[427 515 318  79 588],18,5,38650,4.536384976525822,40.0,0.0
48520,4,8520,[182 286 202 357 111],450,5,38655,4.536439385048703,0.0,20.0
48521,4,8521,[ 56 174 118 161 179],577,2,38657,4.536141750762732,0.0,0.0
48522,4,8522,[427 515 318  79 588],18,5,38662,4.536196175055731,40.0,0.0
48523,4,8523,[427 515 318  79 588],18,5,38667,4.5362505865790705,40.0,0.0
48524,4,8524,[427 515 318  79 588],18,5,38672,4.536304985337243,40.0,0.0
48525,4,8525,[427 515 318  79 588],18,5,38677,4.536359371334741,40.0,0.0
48526,4,8526,[427 515 318  79 588],807,5,38682,4.536413744576053,40.0,0.0
48527,4,8527,[427 515 318  79 588],807,5,38687,4.536468105065666,40.0,0.0
48528,4,8528,[427 515 318  79 588],807,5,38692,4.536522452808066,40.0,0.0
48529,4,8529,[427 515 318  79 588],807,5,38697,4.536576787807737,40.0,0.0
48530,4,8530,[ 79 286 173 748 222],796,4,38701,4.536513890516939,0.0,20.0
48531,4,8531,[427 515 318  79 588],18,5,38706,4.536568213783403,40.0,0.0
48532,4,8532,[427 515 318  79 588],18,5,38711,4.536622524317356,40.0,0.0
48533,4,8533,[427 515 318  79 588],18,5,38716,4.536676822123272,40.0,0.0
48534,4,8534,[427 515 318  79 588],18,5,38721,4.536731107205624,40.0,0.0
48535,4,8535,[427 515 318  79 588],18,5,38726,4.536785379568885,40.0,0.0
48536,4,8536,[427 515 318  79 588],716,5,38731,4.536839639217524,40.0,0.0
48537,4,8537,[427 515 318  79 588],716,5,38736,4.536893886156008,40.0,0.0
48538,4,8538,[427 515 318  79 588],18,5,38741,4.5369481203888045,40.0,0.0
48539,4,8539,[427 515 318  79 588],18,5,38746,4.537002341920375,40.0,0.0
48540,4,8540,[427 515 318  79 588],716,5,38751,4.537056550755181,40.0,0.0
48541,4,8541,[197 385 185  25 200],655,2,38753,4.5367595410910795,0.0,0.0
48542,4,8542,[238 318 182  22  96],269,3,38756,4.536579655858597,20.0,0.0
48543,4,8543,[228 300  56 191 176],450,5,38761,4.536633895131086,0.0,0.0
48544,4,8544,[603 210 202 211  15],151,5,38766,4.536688121708601,20.0,0.0
48545,4,8545,[318 180  25 210  12],457,5,38771,4.5367423355956005,20.0,0.0
48546,4,8546,[427 515 318  79 588],18,5,38776,4.536796536796537,40.0,0.0
48547,4,8547,[427 515 318  79 588],716,5,38781,4.536850725315864,40.0,0.0
48548,4,8548,[427 515 318  79 588],18,5,38786,4.53690490115803,40.0,0.0
48549,4,8549,[427 515 318  79 588],807,5,38791,4.536959064327485,40.0,0.0
48550,4,8550,[ 98 176 174 204  82],911,3,38794,4.536779324055666,0.0,0.0
48551,4,8551,[427 515 318  79 588],807,5,38799,4.536833489242283,40.0,0.0
48552,4,8552,[427 515 318  79 588],18,5,38804,4.536887641763124,40.0,0.0
48553,4,8553,[ 64 405 118 275  71],344,2,38806,4.536591068505962,20.0,20.0
48554,4,8554,[427 515 318  79 588],807,5,38811,4.5366452367036825,40.0,0.0
48555,4,8555,[210 211 151 268 302],269,3,38814,4.536465638148668,0.0,0.0
48556,4,8556,[ 79  28  69  95 179],577,4,38818,4.536402944957345,0.0,0.0
48557,4,8557,[427 515 318  79 588],716,5,38823,4.5364571161486325,40.0,0.0
48558,4,8558,[427 515 318  79 588],18,5,38828,4.536511274681621,40.0,0.0
48559,4,8559,[197 118 161 423  64],796,4,38832,4.536448598130841,20.0,0.0
48560,4,8560,[427 515 318  79 588],18,5,38837,4.536502745006424,40.0,0.0
48561,4,8561,[427 515 318  79 588],716,5,38842,4.536556879233824,40.0,0.0
48562,4,8562,[200 210 144 151  11],450,3,38845,4.53637743781385,0.0,0.0
48563,4,8563,[427 515 318  79 588],716,5,38850,4.536431574030827,40.0,0.0
48564,4,8564,[  1 174 235 181 196],450,4,38854,4.536368943374197,0.0,0.0
48565,4,8565,[427 515 318  79 588],18,5,38859,4.536423067943031,40.0,0.0
48566,4,8566,[427 515 318  79 588],716,5,38864,4.536477179876269,40.0,0.0
48567,4,8567,[427 515 318  79 588],18,5,38869,4.536531279178338,40.0,0.0
48568,4,8568,[427 515 318  79 588],18,5,38874,4.536585365853658,40.0,0.0
48569,4,8569,[427 515 318  79 588],18,5,38879,4.536639439906651,40.0,0.0
48570,4,8570,[143 186   4 174 200],457,5,38884,4.536693501341734,0.0,0.0
48571,4,8571,[427 515 318  79 588],716,5,38889,4.536747550163322,40.0,0.0
48572,4,8572,[427 515 318  79 588],807,5,38894,4.536801586375831,40.0,0.0
48573,4,8573,[427 515 318  79 588],716,5,38899,4.536855609983672,40.0,0.0
48574,4,8574,[234 197 597 183 121],457,4,38903,4.536793002915452,0.0,0.0
48575,4,8575,[427 515 318  79 588],18,5,38908,4.536847014925373,40.0,0.0
48576,4,8576,[427 515 318  79 588],18,5,38913,4.536901014340678,40.0,0.0
48577,4,8577,[179 258 173 210 135],457,5,38918,4.536955001165773,0.0,0.0
48578,4,8578,[427 515 318  79 588],716,5,38923,4.537008975405059,40.0,0.0
48579,4,8579,[202 269 180 301 144],450,5,38928,4.537062937062937,0.0,0.0
48580,4,8580,[427 515 318  79 588],716,5,38933,4.5371168861438065,40.0,0.0
48581,4,8581,[427 515 318  79 588],18,5,38938,4.537170822652063,40.0,0.0
48582,4,8582,[427 515 318  79 588],716,5,38943,4.5372247465921,40.0,0.0
48583,4,8583,[143 288  12   9 191],457,5,38948,4.537278657968313,0.0,0.0
48584,4,8584,[427 515 318  79 588],716,5,38953,4.53733255678509,40.0,0.0
48585,4,8585,[427 515 318  79 588],807,5,38958,4.53738644304682,40.0,0.0
48586,4,8586,[313  79 211  70 276],655,3,38961,4.537207406544777,0.0,0.0
48587,4,8587,[427 515 318  79 588],807,5,38966,4.537261294829995,40.0,0.0
48588,4,8588,[ 15 176 435   1  82],72,3,38969,4.537082314588427,0.0,0.0
48589,4,8589,[427 515 318  79 588],807,5,38974,4.537136204889406,40.0,0.0
48590,4,8590,[427 515 318  79 588],807,5,38979,4.537190082644628,40.0,0.0
48591,4,8591,[191 204 265 471  89],786,5,38984,4.537243947858473,0.0,0.0
48592,4,8592,[427 515 318  79 588],18,5,38989,4.5372978005353195,40.0,0.0
48593,4,8593,[427 515 318  79 588],807,5,38994,4.537351640679544,40.0,0.0
48594,4,8594,[257 655 318 588 546],457,3,38997,4.53717277486911,20.0,0.0
48595,4,8595,[427 515 318  79 588],807,5,39002,4.537226617031178,40.0,0.0
48596,4,8596,[427 515 318  79 588],18,5,39007,4.537280446667443,40.0,0.0
48597,4,8597,[427 515 318  79 588],18,5,39012,4.537334263782275,40.0,0.0
48598,4,8598,[427 515 318  79 588],807,5,39017,4.537388068380044,40.0,0.0
48599,4,8599,[427 515 318  79 588],807,5,39022,4.537441860465116,40.0,0.0
48600,4,8600,[118 546 151  69 385],796,5,39027,4.537495640041856,0.0,0.0
48601,4,8601,[427 515 318  79 588],807,5,39032,4.537549407114624,40.0,0.0
48602,4,8602,[427 515 318  79 588],807,5,39037,4.537603161687783,40.0,0.0
48603,4,8603,[ 28 100 175 216 655],23,3,39040,4.537424453742445,0.0,20.0
48604,4,8604,[427 515 318  79 588],18,5,39045,4.537478210342824,40.0,0.0
48605,4,8605,[427 515 318  79 588],716,5,39050,4.537531954450383,40.0,0.0
48606,4,8606,[427 515 318  79 588],716,5,39055,4.5375856860694785,40.0,0.0
48607,4,8607,[427 515 318  79 588],807,5,39060,4.537639405204461,40.0,0.0
48608,4,8608,[ 79 176  96 186 405],716,2,39062,4.537344639330933,0.0,0.0
48609,4,8609,[427 515 318  79 588],716,5,39067,4.53739837398374,40.0,0.0
48610,4,8610,[427 515 318  79 588],716,5,39072,4.53745209615608,40.0,0.0
48611,4,8611,[427 515 318  79 588],716,5,39077,4.537505805852299,40.0,0.0
48612,4,8612,[427 515 318  79 588],807,5,39082,4.537559503076745,40.0,0.0
48613,4,8613,[427 515 318  79 588],807,5,39087,4.537613187833759,40.0,0.0
48614,4,8614,[427 515 318  79 588],807,5,39092,4.537666860127684,40.0,0.0
48615,4,8615,[427 515 318  79 588],716,5,39097,4.53772051996286,40.0,0.0
48616,4,8616,[237  56  88 185 286],450,5,39102,4.537774167343623,0.0,20.0
48617,4,8617,[427 515 318  79 588],716,5,39107,4.537827802274309,40.0,0.0
48618,4,8618,[286 328 257  12 515],655,1,39108,4.537417333797424,0.0,20.0
48619,4,8619,[427 515 318  79 588],807,5,39113,4.537470997679814,40.0,0.0
48620,4,8620,[427 515 318  79 588],716,5,39118,4.5375246491126315,40.0,0.0
48621,4,8621,[121 181 385  50 173],796,5,39123,4.5375782881002085,0.0,20.0
48622,4,8622,[427 515 318  79 588],18,5,39128,4.537631914646875,40.0,0.0
48623,4,8623,[427 515 318  79 588],716,5,39133,4.537685528756957,40.0,0.0
48624,4,8624,[427 515 318  79 588],716,5,39138,4.537739130434782,40.0,0.0
48625,4,8625,[427 515 318  79 588],807,5,39143,4.537792719684674,40.0,0.0
48626,4,8626,[427 515 318  79 588],807,5,39148,4.537846296510954,40.0,0.0
48627,4,8627,[427 515 318  79 588],716,5,39153,4.537899860917942,40.0,0.0
48628,4,8628,[427 515 318  79 588],18,5,39158,4.537953412909955,40.0,0.0
48629,4,8629,[427 515 318  79 588],716,5,39163,4.538006952491309,40.0,0.0
48630,4,8630,[132 282  98  28 185],457,5,39168,4.538060479666319,0.0,0.0
48631,4,8631,[427 515 318  79 588],807,5,39173,4.538113994439295,40.0,0.0
48632,4,8632,[427 515 318  79 588],18,5,39178,4.538167496814549,40.0,0.0
48633,4,8633,[427 515 318  79 588],716,5,39183,4.538220986796387,40.0,0.0
48634,4,8634,[427 515 318  79 588],716,5,39188,4.538274464389114,40.0,0.0
48635,4,8635,[427 515 318  79 588],807,5,39193,4.538327929597036,40.0,0.0
48636,4,8636,[427 515 318  79 588],18,5,39198,4.538381382424453,40.0,0.0
48637,4,8637,[427 515 318  79 588],807,5,39203,4.538434822875666,40.0,0.0
48638,4,8638,[427 515 318  79 588],807,5,39208,4.5384882509549715,40.0,0.0
48639,4,8639,[132  79 265 275 161],450,5,39213,4.538541666666666,0.0,20.0
48640,4,8640,[ 12 288 172  22 118],457,5,39218,4.538595070015044,0.0,0.0
48641,4,8641,[427 515 318  79 588],807,5,39223,4.538648461004398,40.0,0.0
48642,4,8642,[427 515 318  79 588],807,5,39228,4.538701839639014,40.0,0.0
48643,4,8643,[161 216 186 185 173],389,1,39229,4.538292457195743,0.0,0.0
48644,4,8644,[427 515 318  79 588],18,5,39234,4.538345864661654,40.0,0.0
48645,4,8645,[427 515 318  79 588],716,5,39239,4.538399259773305,40.0,0.0
48646,4,8646,[111   9 182 318 515],269,4,39243,4.538336995489765,20.0,0.0
48647,4,8647,[427 515 318  79 588],18,5,39248,4.538390379278446,40.0,0.0
48648,4,8648,[204 245 496 196  71],796,4,39252,4.538328130419702,20.0,0.0
48649,4,8649,[191   8   4 186 258],457,5,39257,4.538381502890173,0.0,0.0
48650,4,8650,[427 515 318  79 588],807,5,39262,4.538434863021616,40.0,0.0
48651,4,8651,[427 515 318  79 588],807,5,39267,4.538488210818308,40.0,0.0
48652,4,8652,[427 515 318  79 588],716,5,39272,4.5385415462845256,40.0,0.0
48653,4,8653,[427 515 318  79 588],18,5,39277,4.538594869424544,40.0,0.0
48654,4,8654,[175 234  82 435 176],151,3,39280,4.5384170999422295,0.0,0.0
48655,4,8655,[427 515 318  79 588],807,5,39285,4.538470425138632,40.0,0.0
48656,4,8656,[282 202 153 183  95],716,3,39288,4.538292711100843,0.0,0.0
48657,4,8657,[302 405  97   1 568],450,5,39293,4.538346038346038,0.0,0.0
48658,4,8658,[427 515 318  79 588],18,5,39298,4.53839935327405,40.0,0.0
48659,4,8659,[427 515 318  79 588],18,5,39303,4.538452655889145,40.0,0.0
48660,4,8660,[427 515 318  79 588],716,5,39308,4.538505946195589,40.0,0.0
48661,4,8661,[427 515 318  79 588],716,5,39313,4.538559224197645,40.0,0.0
48662,4,8662,[427 515 318  79 588],18,5,39318,4.538612489899573,40.0,0.0
48663,4,8663,[427 515 318  79 588],18,5,39323,4.538665743305632,40.0,0.0
48664,4,8664,[427 515 318  79 588],716,5,39328,4.538718984420081,40.0,0.0
48665,4,8665,[427 515 318  79 588],716,5,39333,4.538772213247173,40.0,0.0
48666,4,8666,[427 515 318  79 588],807,5,39338,4.538825429791162,40.0,0.0
48667,4,8667,[427 515 318  79 588],807,5,39343,4.538878634056299,40.0,0.0
48668,4,8668,[328  50 211  88 294],796,3,39346,4.538701118929519,0.0,20.0
48669,4,8669,[403  82 200 265  89],450,3,39349,4.5385236447520185,0.0,0.0
48670,4,8670,[427 515 318  79 588],716,5,39354,4.5385768654134475,40.0,0.0
48671,4,8671,[427 515 318  79 588],18,5,39359,4.538630073800738,40.0,0.0
48672,4,8672,[427 515 318  79 588],716,5,39364,4.5386832699181365,40.0,0.0
48673,4,8673,[180  56 357  69 202],450,5,39369,4.538736453769887,0.0,0.0
48674,4,8674,[427 515 318  79 588],807,5,39374,4.538789625360231,40.0,0.0
48675,4,8675,[191 175 268 151  12],344,4,39378,4.5387275242047025,0.0,0.0
48676,4,8676,[427 515 318  79 588],18,5,39383,4.538780684568399,40.0,0.0
48677,4,8677,[427 515 318  79 588],716,5,39388,4.538833832680341,40.0,0.0
48678,4,8678,[118 282 143   1  50],450,4,39392,4.538771747897223,0.0,20.0
48679,4,8679,[427 515 318  79 588],716,5,39397,4.538824884792627,40.0,0.0
48680,4,8680,[427 515 318  79 588],807,5,39402,4.5388780094459165,40.0,0.0
48681,4,8681,[174 405 111 144 301],593,4,39406,4.538815941027413,0.0,0.0
48682,4,8682,[427 515 318  79 588],18,5,39411,4.53886905447426,40.0,0.0
48683,4,8683,[427 515 318  79 588],716,5,39416,4.538922155688622,40.0,0.0
48684,4,8684,[427 515 318  79 588],18,5,39421,4.5389752446747265,40.0,0.0
48685,4,8685,[121 234 195 228  50],716,4,39425,4.538913193644946,0.0,20.0
48686,4,8686,[427 515 318  79 588],18,5,39430,4.538966271440083,40.0,0.0
48687,4,8687,[427 515 318  79 588],18,5,39435,4.539019337016574,40.0,0.0
48688,4,8688,[191 100  79 210 286],450,4,39439,4.5389573023362875,0.0,40.0
48689,4,8689,[427 515 318  79 588],716,5,39444,4.539010356731875,40.0,0.0
48690,4,8690,[427 515 318  79 588],716,5,39449,4.5390633989184215,40.0,0.0
48691,4,8691,[427 515 318  79 588],807,5,39454,4.5391164289001384,40.0,0.0
48692,4,8692,[427 515 318  79 588],18,5,39459,4.539169446681238,40.0,0.0
48693,4,8693,[427 515 318  79 588],18,5,39464,4.53922245226593,40.0,0.0
48694,4,8694,[427 515 318  79 588],18,5,39469,4.539275445658425,40.0,0.0
48695,4,8695,[427 515 318  79 588],18,5,39474,4.539328426862926,40.0,0.0
48696,4,8696,[427 515 318  79 588],807,5,39479,4.539381395883638,40.0,0.0
48697,4,8697,[427 515 318  79 588],807,5,39484,4.539434352724764,40.0,0.0
48698,4,8698,[427 515 318  79 588],716,5,39489,4.5394872973905045,40.0,0.0
48699,4,8699,[427 515 318  79 588],716,5,39494,4.539540229885057,40.0,0.0
48700,4,8700,[427 515 318  79 588],716,5,39499,4.539593150212619,40.0,0.0
48701,4,8701,[427 515 318  79 588],716,5,39504,4.539646058377384,40.0,0.0
48702,4,8702,[174 200 204 300 196],151,4,39508,4.539584051476503,0.0,0.0
48703,4,8703,[  7   9 228 118 471],280,2,39510,4.5392922794117645,0.0,0.0
48704,4,8704,[286 179 182 173 405],450,5,39515,4.5393452039058015,0.0,20.0
48705,4,8705,[313 423  64 172 234],655,3,39518,4.539168389616356,20.0,0.0
48706,4,8706,[427 515 318  79 588],807,5,39523,4.539221316182382,40.0,0.0
48707,4,8707,[427 515 318  79 588],716,5,39528,4.539274230592558,40.0,0.0
48708,4,8708,[427 515 318  79 588],807,5,39533,4.539327132851073,40.0,0.0
48709,4,8709,[427 515 318  79 588],807,5,39538,4.539380022962113,40.0,0.0
48710,4,8710,[588 234 655 313  82],577,4,39542,4.539318103547239,0.0,0.0
48711,4,8711,[427 515 318  79 588],18,5,39547,4.539370982552801,40.0,0.0
48712,4,8712,[427 515 318  79 588],807,5,39552,4.539423849420406,40.0,0.0
48713,4,8713,[216 125   1 176 385],151,3,39555,4.539247188432408,0.0,0.0
48714,4,8714,[427 515 318  79 588],807,5,39560,4.539300057372347,40.0,0.0
48715,4,8715,[121  56   1  12 215],450,4,39564,4.539238182652593,0.0,0.0
48716,4,8716,[323 318 151 185 275],796,4,39568,4.5391763221291725,20.0,20.0
48717,4,8717,[100  70 179 588 121],786,4,39572,4.539114475797201,0.0,20.0
48718,4,8718,[427 515 318  79 588],716,5,39577,4.5391673357036355,40.0,0.0
48719,4,8719,[427 515 318  79 588],18,5,39582,4.539220183486239,40.0,0.0
48720,4,8720,[427 515 318  79 588],716,5,39587,4.539273019149181,40.0,0.0
48721,4,8721,[427 515 318  79 588],716,5,39592,4.53932584269663,40.0,0.0
48722,4,8722,[427 515 318  79 588],716,5,39597,4.5393786541327525,40.0,0.0
48723,4,8723,[427 515 318  79 588],18,5,39602,4.539431453461715,40.0,0.0
48724,4,8724,[427 515 318  79 588],716,5,39607,4.539484240687679,40.0,0.0
48725,4,8725,[427 515 318  79 588],18,5,39612,4.5395370158148065,40.0,0.0
48726,4,8726,[ 15 269 385  97 151],796,3,39615,4.539360605018907,0.0,0.0
48727,4,8727,[427 515 318  79 588],18,5,39620,4.539413382218148,40.0,0.0
48728,4,8728,[427 515 318  79 588],807,5,39625,4.539466147325008,40.0,0.0
48729,4,8729,[427 515 318  79 588],18,5,39630,4.5395189003436425,40.0,0.0
48730,4,8730,[ 28 186 257 275 271],655,1,39631,4.539113503607834,0.0,20.0
48731,4,8731,[427 515 318  79 588],716,5,39636,4.539166284928997,40.0,0.0
48732,4,8732,[135 144 357 197 588],457,5,39641,4.5392190541623725,0.0,0.0
48733,4,8733,[427 515 318  79 588],807,5,39646,4.539271811312114,40.0,0.0
48734,4,8734,[427 515 318  79 588],18,5,39651,4.53932455638237,40.0,0.0
48735,4,8735,[427 515 318  79 588],807,5,39656,4.539377289377289,40.0,0.0
48736,4,8736,[228 100  50 235 603],450,4,39660,4.539315554538171,20.0,40.0
48737,4,8737,[427 515 318  79 588],716,5,39665,4.539368276493477,40.0,0.0
48738,4,8738,[427 515 318  79 588],18,5,39670,4.539420986382881,40.0,0.0
48739,4,8739,[200  95 427   4  98],450,2,39672,4.539130434782609,20.0,0.0
48740,4,8740,[427 515 318  79 588],716,5,39677,4.539183159821531,40.0,0.0
48741,4,8741,[427 515 318  79 588],807,5,39682,4.5392358727979865,40.0,0.0
48742,4,8742,[427 515 318  79 588],807,5,39687,4.5392885737161155,40.0,0.0
48743,4,8743,[427 515 318  79 588],807,5,39692,4.539341262580055,40.0,0.0
48744,4,8744,[427 515 318  79 588],807,5,39697,4.539393939393939,40.0,0.0
48745,4,8745,[357 181   8 568 132],344,4,39701,4.539332266178825,0.0,0.0
48746,4,8746,[427 515 318  79 588],807,5,39706,4.539384931976678,40.0,0.0
48747,4,8747,[427 515 318  79 588],18,5,39711,4.539437585733882,40.0,0.0
48748,4,8748,[ 50 187 191 174 210],450,4,39715,4.539375928677563,0.0,20.0
48749,4,8749,[258 210 323 172 269],942,3,39718,4.5392,0.0,0.0
48750,4,8750,[427 515 318  79 588],807,5,39723,4.539252656839218,40.0,0.0
48751,4,8751,[427 515 318  79 588],716,5,39728,4.539305301645339,40.0,0.0
48752,4,8752,[427 515 318  79 588],716,5,39733,4.539357934422484,40.0,0.0
48753,4,8753,[427 515 318  79 588],716,5,39738,4.539410555174777,40.0,0.0
48754,4,8754,[ 79 435 117 222 215],716,5,39743,4.53946316390634,0.0,0.0
48755,4,8755,[483 100  96  56 275],450,4,39747,4.539401553220649,0.0,40.0
48756,4,8756,[427 515 318  79 588],716,5,39752,4.539454150964942,40.0,0.0
48757,4,8757,[427 515 318  79 588],18,5,39757,4.539506736697876,40.0,0.0
48758,4,8758,[427 515 318  79 588],18,5,39762,4.539559310423565,40.0,0.0
48759,4,8759,[427 515 318  79 588],18,5,39767,4.539611872146119,40.0,0.0
48760,4,8760,[427 515 318  79 588],807,5,39772,4.53966442186965,40.0,0.0
48761,4,8761,[174  11 168 185  22],269,2,39774,4.539374572015522,0.0,0.0
48762,4,8762,[ 64 151 121 276 268],344,3,39777,4.539198904484765,20.0,0.0
48763,4,8763,[427 515 318  79 588],18,5,39782,4.53925148334094,40.0,0.0
48764,4,8764,[427 515 318  79 588],716,5,39787,4.539304050199657,40.0,0.0
48765,4,8765,[427 515 318  79 588],18,5,39792,4.539356605065024,40.0,0.0
48766,4,8766,[427 515 318  79 588],18,5,39797,4.539409147941143,40.0,0.0
48767,4,8767,[427 515 318  79 588],18,5,39802,4.539461678832117,40.0,0.0
48768,4,8768,[496 301  95 237 202],796,4,39806,4.539400159653324,20.0,0.0
48769,4,8769,[427 515 318  79 588],807,5,39811,4.53945267958951,40.0,0.0
48770,4,8770,[427 515 318  79 588],807,5,39816,4.539505187549881,40.0,0.0
48771,4,8771,[300 288  89 301 265],450,4,39820,4.539443684450524,0.0,0.0
48772,4,8772,[427 515 318  79 588],716,5,39825,4.539496181465861,40.0,0.0
48773,4,8773,[427 515 318  79 588],716,5,39830,4.539548666514703,40.0,0.0
48774,4,8774,[427 515 318  79 588],18,5,39835,4.53960113960114,40.0,0.0
48775,4,8775,[603   8 196 273 748],796,4,39839,4.5395396536007295,20.0,0.0
48776,4,8776,[427 515 318  79 588],716,5,39844,4.539592115757093,40.0,0.0
48777,4,8777,[427 515 318  79 588],807,5,39849,4.539644565960355,40.0,0.0
48778,4,8778,[313 180 273 245 588],796,2,39851,4.539355279644607,0.0,0.0
48779,4,8779,[323 300 202 588 153],796,4,39855,4.539293849658314,0.0,0.0
48780,4,8780,[427 515 318  79 588],18,5,39860,4.5393463159093494,40.0,0.0
48781,4,8781,[427 515 318  79 588],807,5,39865,4.539398770211797,40.0,0.0
48782,4,8782,[427 515 318  79 588],18,5,39870,4.539451212569737,40.0,0.0
48783,4,8783,[427 515 318  79 588],807,5,39875,4.53950364298725,40.0,0.0
48784,4,8784,[427 515 318  79 588],716,5,39880,4.539556061468412,40.0,0.0
48785,4,8785,[234 483 258 238 181],151,5,39885,4.5396084680173,0.0,0.0
48786,4,8786,[276   1 275 204 175],457,5,39890,4.539660862637988,0.0,20.0
48787,4,8787,[427 515 318  79 588],716,5,39895,4.539713245334547,40.0,0.0
48788,4,8788,[294 194 222 323  82],23,2,39897,4.539424280350438,0.0,0.0
48789,4,8789,[427 515 318  79 588],716,5,39902,4.539476678043231,40.0,0.0
48790,4,8790,[427 515 318  79 588],807,5,39907,4.539529063815266,40.0,0.0
48791,4,8791,[182 187 176  50 153],655,3,39910,4.539353958143767,0.0,20.0
48792,4,8792,[427 515 318  79 588],18,5,39915,4.539406345957011,40.0,0.0
48793,4,8793,[427 515 318  79 588],716,5,39920,4.5394587218558105,40.0,0.0
48794,4,8794,[427 515 318  79 588],18,5,39925,4.53951108584423,40.0,0.0
48795,4,8795,[427 515 318  79 588],18,5,39930,4.53956343792633,40.0,0.0
48796,4,8796,[427 515 318  79 588],18,5,39935,4.539615778106173,40.0,0.0
48797,4,8797,[427 515 318  79 588],807,5,39940,4.539668106387816,40.0,0.0
48798,4,8798,[427 515 318  79 588],716,5,39945,4.539720422775315,40.0,0.0
48799,4,8799,[427 515 318  79 588],716,5,39950,4.5397727272727275,40.0,0.0
48800,4,8800,[427 515 318  79 588],807,5,39955,4.539825019884104,40.0,0.0
48801,4,8801,[427 515 318  79 588],716,5,39960,4.539877300613497,40.0,0.0
48802,4,8802,[427 515 318  79 588],716,5,39965,4.539929569464955,40.0,0.0
48803,4,8803,[427 515 318  79 588],807,5,39970,4.539981826442526,40.0,0.0
48804,4,8804,[427 515 318  79 588],18,5,39975,4.540034071550256,40.0,0.0
48805,4,8805,[427 515 318  79 588],807,5,39980,4.5400863047921876,40.0,0.0
48806,4,8806,[427 515 318  79 588],18,5,39985,4.540138526172363,40.0,0.0
48807,4,8807,[427 515 318  79 588],716,5,39990,4.540190735694823,40.0,0.0
48808,4,8808,[427 515 318  79 588],18,5,39995,4.540242933363605,40.0,0.0
48809,4,8809,[427 515 318  79 588],807,5,40000,4.540295119182747,40.0,0.0
48810,4,8810,[427 515 318  79 588],716,5,40005,4.540347293156282,40.0,0.0
48811,4,8811,[427 515 318  79 588],18,5,40010,4.540399455288243,40.0,0.0
48812,4,8812,[427 515 318  79 588],18,5,40015,4.540451605582662,40.0,0.0
48813,4,8813,[427 515 318  79 588],716,5,40020,4.540503744043567,40.0,0.0
48814,4,8814,[427 515 318  79 588],18,5,40025,4.540555870674986,40.0,0.0
48815,4,8815,[427 515 318  79 588],18,5,40030,4.540607985480944,40.0,0.0
48816,4,8816,[121 182 143 186 603],269,2,40032,4.540319836679142,20.0,0.0
48817,4,8817,[427 515 318  79 588],18,5,40037,4.540371966432297,40.0,0.0
48818,4,8818,[427 515 318  79 588],18,5,40042,4.540424084363306,40.0,0.0
48819,4,8819,[210 301  98 185 318],450,4,40046,4.5403628117913835,20.0,0.0
48820,4,8820,[427 515 318  79 588],18,5,40051,4.540414918943431,40.0,0.0
48821,4,8821,[427 515 318  79 588],716,5,40056,4.540467014282475,40.0,0.0
48822,4,8822,[ 64 195  70 132 237],330,4,40060,4.540405757678794,20.0,0.0
48823,4,8823,[191  98 483 588  64],457,5,40065,4.540457842248413,20.0,0.0
48824,4,8824,[427 515 318  79 588],18,5,40070,4.540509915014164,40.0,0.0
48825,4,8825,[427 515 318  79 588],807,5,40075,4.540561975980059,40.0,0.0
48826,4,8826,[427 515 318  79 588],807,5,40080,4.5406140251501075,40.0,0.0
48827,4,8827,[143 125 100 174 187],655,2,40082,4.540326234707748,0.0,20.0
48828,4,8828,[427 515 318  79 588],18,5,40087,4.5403782987880845,40.0,0.0
48829,4,8829,[183 180 318 245 322],796,2,40089,4.540090600226501,20.0,0.0
48830,4,8830,[313 257 265 172 423],807,5,40094,4.540142679198278,0.0,0.0
48831,4,8831,[172  95 210 132 405],798,5,40099,4.5401947463768115,0.0,0.0
48832,4,8832,[427 515 318  79 588],807,5,40104,4.540246801766104,40.0,0.0
48833,4,8833,[ 22  69 318 742 172],457,5,40109,4.5402988453701605,20.0,0.0
48834,4,8834,[427 515 318  79 588],807,5,40114,4.540350877192982,40.0,0.0
48835,4,8835,[427 515 318  79 588],18,5,40119,4.540402897238569,40.0,0.0
48836,4,8836,[427 515 318  79 588],807,5,40124,4.54045490551092,40.0,0.0
48837,4,8837,[191 603   9 234 183],269,3,40127,4.540280606472052,20.0,0.0
48838,4,8838,[588  50 176 202  56],577,4,40131,4.540219481841837,0.0,20.0
48839,4,8839,[427 515 318  79 588],18,5,40136,4.5402714932126695,40.0,0.0
48840,4,8840,[427 515 318  79 588],18,5,40141,4.540323492817555,40.0,0.0
48841,4,8841,[427 515 318  79 588],716,5,40146,4.540375480660484,40.0,0.0
48842,4,8842,[210  98  69  25 276],457,5,40151,4.540427456745449,0.0,0.0
48843,4,8843,[427 515 318  79 588],716,5,40156,4.540479421076436,40.0,0.0
48844,4,8844,[427 515 318  79 588],807,5,40161,4.5405313736574335,40.0,0.0
48845,4,8845,[125 196   4   8 655],457,5,40166,4.540583314492426,0.0,0.0
48846,4,8846,[427 515 318  79 588],807,5,40171,4.540635243585396,40.0,0.0
48847,4,8847,[427 515 318  79 588],716,5,40176,4.540687160940325,40.0,0.0
48848,4,8848,[195 210 197 179 151],18,3,40179,4.5405130523222965,0.0,0.0
48849,4,8849,[427 515 318  79 588],807,5,40184,4.5405649717514125,40.0,0.0
48850,4,8850,[427 515 318  79 588],716,5,40189,4.54061687944865,40.0,0.0
48851,4,8851,[427 515 318  79 588],807,5,40194,4.540668775417984,40.0,0.0
48852,4,8852,[427 515 318  79 588],716,5,40199,4.540720659663391,40.0,0.0
48853,4,8853,[427 515 318  79 588],807,5,40204,4.540772532188841,40.0,0.0
48854,4,8854,[427 515 318  79 588],807,5,40209,4.540824392998306,40.0,0.0
48855,4,8855,[427 515 318  79 588],807,5,40214,4.540876242095754,40.0,0.0
48856,4,8856,[427 515 318  79 588],716,5,40219,4.540928079485153,40.0,0.0
48857,4,8857,[427 515 318  79 588],716,5,40224,4.540979905170468,40.0,0.0
48858,4,8858,[427 515 318  79 588],18,5,40229,4.541031719155661,40.0,0.0
48859,4,8859,[427 515 318  79 588],807,5,40234,4.541083521444695,40.0,0.0
48860,4,8860,[ 56  97 168 197  70],535,4,40238,4.541022457961855,0.0,0.0
48861,4,8861,[427 515 318  79 588],807,5,40243,4.541074249605055,40.0,0.0
48862,4,8862,[427 515 318  79 588],807,5,40248,4.541126029561097,40.0,0.0
48863,4,8863,[204 144 182 215 176],796,5,40253,4.541177797833935,0.0,0.0
48864,4,8864,[427 515 318  79 588],716,5,40258,4.541229554427524,40.0,0.0
48865,4,8865,[181 268 161 742   1],655,0,40258,4.54071734716896,0.0,0.0
48866,4,8866,[174 655 471 176  25],716,3,40261,4.540543588586895,0.0,0.0
48867,4,8867,[427 515 318  79 588],807,5,40266,4.540595399188092,40.0,0.0
48868,4,8868,[427 515 318  79 588],716,5,40271,4.540647198105762,40.0,0.0
48869,4,8869,[427 515 318  79 588],807,5,40276,4.540698985343855,40.0,0.0
48870,4,8870,[427 515 318  79 588],807,5,40281,4.540750760906324,40.0,0.0
48871,4,8871,[427 515 318  79 588],18,5,40286,4.540802524797114,40.0,0.0
48872,4,8872,[427 515 318  79 588],716,5,40291,4.540854277020173,40.0,0.0
48873,4,8873,[603  64 186 194 275],707,2,40293,4.540567951318458,40.0,20.0
48874,4,8874,[195 508 172 118 228],344,4,40297,4.540507042253521,0.0,0.0
48875,4,8875,[427 515 318  79 588],18,5,40302,4.540558810274899,40.0,0.0
48876,4,8876,[427 515 318  79 588],18,5,40307,4.540610566632871,40.0,0.0
48877,4,8877,[427 515 318  79 588],807,5,40312,4.540662311331381,40.0,0.0
48878,4,8878,[427 515 318  79 588],807,5,40317,4.540714044374367,40.0,0.0
48879,4,8879,[427 515 318  79 588],807,5,40322,4.540765765765766,40.0,0.0
48880,4,8880,[427 515 318  79 588],18,5,40327,4.540817475509515,40.0,0.0
48881,4,8881,[427 515 318  79 588],716,5,40332,4.540869173609547,40.0,0.0
48882,4,8882,[427 515 318  79 588],716,5,40337,4.540920860069797,40.0,0.0
48883,4,8883,[427 515 318  79 588],716,5,40342,4.540972534894192,40.0,0.0
48884,4,8884,[427 515 318  79 588],18,5,40347,4.541024198086663,40.0,0.0
48885,4,8885,[427 515 318  79 588],18,5,40352,4.541075849651136,40.0,0.0
48886,4,8886,[427 515 318  79 588],807,5,40357,4.541127489591538,40.0,0.0
48887,4,8887,[603 151 496 176  28],796,4,40361,4.541066606660666,40.0,0.0
48888,4,8888,[111 546  22 196 135],457,3,40364,4.5408932388345145,0.0,0.0
48889,4,8889,[427 515 318  79 588],716,5,40369,4.5409448818897635,40.0,0.0
48890,4,8890,[427 515 318  79 588],18,5,40374,4.540996513328085,40.0,0.0
48891,4,8891,[294 313 286 135  79],655,3,40377,4.540823211875844,0.0,20.0
48892,4,8892,[427 515 318  79 588],716,5,40382,4.5408748453840095,40.0,0.0
48893,4,8893,[427 515 318  79 588],716,5,40387,4.540926467281313,40.0,0.0
48894,4,8894,[427 515 318  79 588],18,5,40392,4.540978077571669,40.0,0.0
48895,4,8895,[427 515 318  79 588],807,5,40397,4.541029676258993,40.0,0.0
48896,4,8896,[427 515 318  79 588],807,5,40402,4.541081263347196,40.0,0.0
48897,4,8897,[427 515 318  79 588],807,5,40407,4.541132838840189,40.0,0.0
48898,4,8898,[427 515 318  79 588],18,5,40412,4.541184402741881,40.0,0.0
48899,4,8899,[427 515 318  79 588],18,5,40417,4.541235955056179,40.0,0.0
48900,4,8900,[427 515 318  79 588],807,5,40422,4.541287495786991,40.0,0.0
48901,4,8901,[427 515 318  79 588],807,5,40427,4.541339024938216,40.0,0.0
48902,4,8902,[427 515 318  79 588],807,5,40432,4.541390542513759,40.0,0.0
48903,4,8903,[427 515 318  79 588],716,5,40437,4.541442048517521,40.0,0.0
48904,4,8904,[427 515 318  79 588],807,5,40442,4.541493542953397,40.0,0.0
48905,4,8905,[427 515 318  79 588],18,5,40447,4.541545025825286,40.0,0.0
48906,4,8906,[427 515 318  79 588],18,5,40452,4.541596497137083,40.0,0.0
48907,4,8907,[471 210 328 427   1],655,1,40453,4.541198922317019,20.0,0.0
48908,4,8908,[427 515 318  79 588],18,5,40458,4.541250420922663,40.0,0.0
48909,4,8909,[427 515 318  79 588],807,5,40463,4.541301907968575,40.0,0.0
48910,4,8910,[161 257 132 185 322],504,5,40468,4.541353383458647,0.0,0.0
48911,4,8911,[174 121 168 322 435],450,4,40472,4.54129263913824,0.0,0.0
48912,4,8912,[ 88 196   4 237 143],18,1,40473,4.540895321440592,0.0,0.0
48913,4,8913,[132  28 210 357 423],504,5,40478,4.540946825218757,0.0,0.0
48914,4,8914,[427 515 318  79 588],716,5,40483,4.540998317442512,40.0,0.0
48915,4,8915,[427 515 318  79 588],807,5,40488,4.541049798115747,40.0,0.0
48916,4,8916,[282 333 313 151 568],796,5,40493,4.541101267242346,0.0,0.0
48917,4,8917,[427 515 318  79 588],807,5,40498,4.541152724826194,40.0,0.0
48918,4,8918,[174 742 238   8 273],796,2,40500,4.540867810292633,0.0,0.0
48919,4,8919,[265 191 118 161 427],796,5,40505,4.540919282511211,20.0,0.0
48920,4,8920,[427 515 318  79 588],716,5,40510,4.5409707431902255,40.0,0.0
48921,4,8921,[427 515 318  79 588],807,5,40515,4.541022192333558,40.0,0.0
48922,4,8922,[427 515 318  79 588],807,5,40520,4.541073629945085,40.0,0.0
48923,4,8923,[ 56 211 210 333  69],796,3,40523,4.5409009412819366,0.0,0.0
48924,4,8924,[427 515 318  79 588],807,5,40528,4.540952380952381,40.0,0.0
48925,4,8925,[427 515 318  79 588],807,5,40533,4.5410038090970195,40.0,0.0
48926,4,8926,[427 515 318  79 588],807,5,40538,4.5410552257197265,40.0,0.0
48927,4,8927,[427 515 318  79 588],18,5,40543,4.541106630824372,40.0,0.0
48928,4,8928,[ 96 197 597 323 301],796,2,40545,4.540822040542054,0.0,0.0
48929,4,8929,[183  50 143  56 185],693,3,40548,4.540649496080627,0.0,20.0
48930,4,8930,[ 22 483 186 427   9],18,5,40553,4.540700929347217,20.0,0.0
48931,4,8931,[427 515 318  79 588],807,5,40558,4.540752351097178,40.0,0.0
48932,4,8932,[427 515 318  79 588],18,5,40563,4.540803761334378,40.0,0.0
48933,4,8933,[427 515 318  79 588],18,5,40568,4.540855160062682,40.0,0.0
48934,4,8934,[427 515 318  79 588],716,5,40573,4.540906547285954,40.0,0.0
48935,4,8935,[427 515 318  79 588],807,5,40578,4.540957923008057,40.0,0.0
48936,4,8936,[427 515 318  79 588],716,5,40583,4.5410092872328525,40.0,0.0
48937,4,8937,[427 515 318  79 588],18,5,40588,4.541060639964198,40.0,0.0
48938,4,8938,[144  89  50 176 151],23,2,40590,4.540776373196107,0.0,20.0
48939,4,8939,[427 515 318  79 588],716,5,40595,4.54082774049217,40.0,0.0
48940,4,8940,[427 515 318  79 588],716,5,40600,4.540879096297953,40.0,0.0
48941,4,8941,[427 515 318  79 588],807,5,40605,4.540930440617312,40.0,0.0
48942,4,8942,[427 515 318  79 588],18,5,40610,4.5409817734540985,40.0,0.0
48943,4,8943,[427 515 318  79 588],716,5,40615,4.541033094812165,40.0,0.0
48944,4,8944,[427 515 318  79 588],716,5,40620,4.5410844046953605,40.0,0.0
48945,4,8945,[427 515 318  79 588],807,5,40625,4.541135703107534,40.0,0.0
48946,4,8946,[427 515 318  79 588],807,5,40630,4.541186990052531,40.0,0.0
48947,4,8947,[597  69 237 204 357],450,5,40635,4.541238265534197,0.0,0.0
48948,4,8948,[234 302  64 174 423],389,5,40640,4.541289529556375,20.0,0.0
48949,4,8949,[427 515 318  79 588],807,5,40645,4.541340782122905,40.0,0.0
48950,4,8950,[427 515 318  79 588],18,5,40650,4.541392023237627,40.0,0.0
48951,4,8951,[427 515 318  79 588],716,5,40655,4.541443252904379,40.0,0.0
48952,4,8952,[471 202 237 265 385],716,3,40658,4.541271082318776,0.0,0.0
48953,4,8953,[427 515 318  79 588],18,5,40663,4.541322314049586,40.0,0.0
48954,4,8954,[427 515 318  79 588],807,5,40668,4.5413735343383586,40.0,0.0
48955,4,8955,[427 515 318  79 588],18,5,40673,4.541424743188924,40.0,0.0
48956,4,8956,[427 515 318  79 588],716,5,40678,4.541475940605113,40.0,0.0
48957,4,8957,[427 515 318  79 588],807,5,40683,4.541527126590757,40.0,0.0
48958,4,8958,[427 515 318  79 588],716,5,40688,4.5415783011496815,40.0,0.0
48959,4,8959,[323 176  97 222 195],756,1,40689,4.541183035714286,0.0,0.0
48960,4,8960,[153 194 210 313 318],503,4,40693,4.541122642562214,20.0,0.0
48961,4,8961,[427 515 318  79 588],18,5,40698,4.541173845123856,40.0,0.0
48962,4,8962,[427 515 318  79 588],716,5,40703,4.5412250362601805,40.0,0.0
48963,4,8963,[427 515 318  79 588],716,5,40708,4.541276215975011,40.0,0.0
48964,4,8964,[427 515 318  79 588],18,5,40713,4.5413273842721695,40.0,0.0
48965,4,8965,[427 515 318  79 588],716,5,40718,4.541378541155476,40.0,0.0
48966,4,8966,[427 515 318  79 588],716,5,40723,4.54142968662875,40.0,0.0
48967,4,8967,[ 71 100  12 222 655],796,3,40726,4.541257805530776,0.0,20.0
48968,4,8968,[185 237 276 323  96],504,3,40729,4.5410859627606195,0.0,0.0
48969,4,8969,[427 515 318  79 588],18,5,40734,4.54113712374582,40.0,0.0
48970,4,8970,[161 135 678 228 403],807,4,40738,4.541076803031992,0.0,0.0
48971,4,8971,[427 515 318  79 588],807,5,40743,4.541127953633526,40.0,0.0
48972,4,8972,[742 471 588 286 237],450,5,40748,4.541179092834057,0.0,20.0
48973,4,8973,[185 168 161   4 187],504,4,40752,4.541118787608648,0.0,0.0
48974,4,8974,[427 515 318  79 588],716,5,40757,4.541169916434541,40.0,0.0
48975,4,8975,[427 515 318  79 588],716,5,40762,4.5412210338680925,40.0,0.0
48976,4,8976,[ 95   1 275  11 318],330,5,40767,4.5412721399131115,20.0,20.0
48977,4,8977,[427 515 318  79 588],716,5,40772,4.541323234573402,40.0,0.0
48978,4,8978,[187 268 202 294 216],655,2,40774,4.541040204922597,0.0,0.0
48979,4,8979,[427 515 318  79 588],716,5,40779,4.54109131403118,40.0,0.0
48980,4,8980,[  8 237 238 161 301],655,0,40779,4.540585680881862,0.0,0.0
48981,4,8981,[427 515 318  79 588],807,5,40784,4.540636829213984,40.0,0.0
48982,4,8982,[427 515 318  79 588],716,5,40789,4.540687966158299,40.0,0.0
48983,4,8983,[ 98 191 181 269 294],23,3,40792,4.540516473731078,0.0,0.0
48984,4,8984,[427 515 318  79 588],807,5,40797,4.540567612687813,40.0,0.0
48985,4,8985,[180 168  97 183  70],716,3,40800,4.540396171822835,0.0,0.0
48986,4,8986,[427 515 318  79 588],18,5,40805,4.540447312785134,40.0,0.0
48987,4,8987,[318 322   7 153  22],450,5,40810,4.540498442367602,20.0,0.0
48988,4,8988,[427 515 318  79 588],716,5,40815,4.540549560574035,40.0,0.0
48989,4,8989,[427 515 318  79 588],18,5,40820,4.540600667408231,40.0,0.0
48990,4,8990,[496 100 333 597 588],796,4,40824,4.54054054054054,20.0,20.0
48991,4,8991,[186 210 144 185 313],450,3,40827,4.54036921708185,0.0,0.0
48992,4,8992,[427 515 318  79 588],18,5,40832,4.540420326920938,40.0,0.0
48993,4,8993,[427 515 318  79 588],18,5,40837,4.540471425394707,40.0,0.0
48994,4,8994,[ 71 235 173  69 144],450,3,40840,4.540300166759311,0.0,0.0
48995,4,8995,[427 515 318  79 588],18,5,40845,4.54035126722988,40.0,0.0
48996,4,8996,[427 515 318  79 588],18,5,40850,4.540402356341002,40.0,0.0
48997,4,8997,[427 515 318  79 588],807,5,40855,4.540453434096466,40.0,0.0
48998,4,8998,[427 515 318  79 588],18,5,40860,4.540504500500056,40.0,0.0
48999,4,8999,[234 195 200 257 588],457,4,40864,4.540444444444445,0.0,0.0
49000,4,9000,[427 515 318  79 588],18,5,40869,4.5404955004999445,40.0,0.0
49001,4,9001,[427 515 318  79 588],807,5,40874,4.540546545212175,40.0,0.0
49002,4,9002,[135 435 196 328 111],655,1,40875,4.540153282239253,0.0,0.0
49003,4,9003,[475 176 144 423  88],655,0,40875,4.5396490448689475,0.0,0.0
49004,4,9004,[427 515 318  79 588],18,5,40880,4.539700166574126,40.0,0.0
49005,4,9005,[427 515 318  79 588],18,5,40885,4.539751276926493,40.0,0.0
49006,4,9006,[427 515 318  79 588],807,5,40890,4.539802375929832,40.0,0.0
49007,4,9007,[427 515 318  79 588],18,5,40895,4.539853463587922,40.0,0.0
49008,4,9008,[427 515 318  79 588],716,5,40900,4.53990453990454,40.0,0.0
49009,4,9009,[427 515 318  79 588],716,5,40905,4.539955604883462,40.0,0.0
49010,4,9010,[427 515 318  79 588],716,5,40910,4.5400066585284655,40.0,0.0
49011,4,9011,[132 323 318 197 118],796,3,40913,4.539835774522858,20.0,0.0
49012,4,9012,[427 515 318  79 588],807,5,40918,4.53988683013425,40.0,0.0
49013,4,9013,[427 515 318  79 588],18,5,40923,4.539937874417572,40.0,0.0
49014,4,9014,[237 282 121   1 127],120,4,40927,4.53987798114254,0.0,20.0
49015,4,9015,[135  82 276  12 151],18,2,40929,4.5395962732919255,0.0,0.0
49016,4,9016,[427 515 318  79 588],716,5,40934,4.539647332815792,40.0,0.0
49017,4,9017,[427 515 318  79 588],18,5,40939,4.5396983810157465,40.0,0.0
49018,4,9018,[748   1  50 196 234],796,3,40942,4.539527663820823,0.0,20.0
49019,4,9019,[294 357  88 127 125],504,3,40945,4.539356984478935,0.0,20.0
49020,4,9020,[427 515 318  79 588],807,5,40950,4.53940804788826,40.0,0.0
49021,4,9021,[427 515 318  79 588],716,5,40955,4.539459099977832,40.0,0.0
49022,4,9022,[427 515 318  79 588],716,5,40960,4.539510140751413,40.0,0.0
49023,4,9023,[427 515 318  79 588],807,5,40965,4.539561170212766,40.0,0.0
49024,4,9024,[427 515 318  79 588],18,5,40970,4.539612188365651,40.0,0.0
49025,4,9025,[427 515 318  79 588],716,5,40975,4.539663195213826,40.0,0.0
49026,4,9026,[427 515 318  79 588],807,5,40980,4.5397141907610505,40.0,0.0
49027,4,9027,[427 515 318  79 588],716,5,40985,4.539765175011077,40.0,0.0
49028,4,9028,[210 117 597 313  64],344,2,40987,4.539483885258611,20.0,0.0
49029,4,9029,[179 568 176 357 111],655,2,40989,4.539202657807309,0.0,0.0
49030,4,9030,[427 515 318  79 588],18,5,40994,4.539253681762817,40.0,0.0
49031,4,9031,[588 286 318 423  95],330,5,40999,4.53930469441984,20.0,20.0
49032,4,9032,[211 174 185 197 176],389,5,41004,4.539355695782132,0.0,0.0
49033,4,9033,[427 515 318  79 588],716,5,41009,4.539406685853443,40.0,0.0
49034,4,9034,[ 79  28 194   7 275],151,5,41014,4.539457664637521,0.0,20.0
49035,4,9035,[427 515 318  79 588],716,5,41019,4.539508632138114,40.0,0.0
49036,4,9036,[427 515 318  79 588],807,5,41024,4.539559588358968,40.0,0.0
49037,4,9037,[427 515 318  79 588],807,5,41029,4.539610533303828,40.0,0.0
49038,4,9038,[427 515 318  79 588],807,5,41034,4.539661466976435,40.0,0.0
49039,4,9039,[427 515 318  79 588],18,5,41039,4.539712389380531,40.0,0.0
49040,4,9040,[427 515 318  79 588],18,5,41044,4.539763300519854,40.0,0.0
49041,4,9041,[118 322 405  98 204],280,2,41046,4.539482415394824,0.0,0.0
49042,4,9042,[427 515 318  79 588],716,5,41051,4.5395333407055185,40.0,0.0
49043,4,9043,[427 515 318  79 588],716,5,41056,4.5395842547545335,40.0,0.0
49044,4,9044,[427 515 318  79 588],18,5,41061,4.5396351575456055,40.0,0.0
49045,4,9045,[427 515 318  79 588],807,5,41066,4.5396860490824675,40.0,0.0
49046,4,9046,[228 301 125 172   1],655,1,41067,4.5392947938543164,0.0,0.0
49047,4,9047,[427 515 318  79 588],18,5,41072,4.539345711759505,40.0,0.0
49048,4,9048,[427 515 318  79 588],807,5,41077,4.5393966184108745,40.0,0.0
49049,4,9049,[427 515 318  79 588],716,5,41082,4.539447513812155,40.0,0.0
49050,4,9050,[161   7  89 179 276],457,5,41087,4.539498397967075,0.0,0.0
49051,4,9051,[ 12  96 121  28 568],655,0,41087,4.538996906760937,0.0,0.0
49052,4,9052,[427 515 318  79 588],18,5,41092,4.539047829448801,40.0,0.0
49053,4,9053,[427 515 318  79 588],807,5,41097,4.539098740888005,40.0,0.0
49054,4,9054,[568  50 161 328 176],796,5,41102,4.539149641082275,0.0,20.0
49055,4,9055,[427 515 318  79 588],18,5,41107,4.539200530035336,40.0,0.0
49056,4,9056,[427 515 318  79 588],716,5,41112,4.5392514077509105,40.0,0.0
49057,4,9057,[132 195 286 135 144],629,5,41117,4.539302274232722,0.0,20.0
49058,4,9058,[427 515 318  79 588],18,5,41122,4.539353129484491,40.0,0.0
49059,4,9059,[427 515 318  79 588],716,5,41127,4.539403973509934,40.0,0.0
49060,4,9060,[427 515 318  79 588],18,5,41132,4.539454806312769,40.0,0.0
49061,4,9061,[427 515 318  79 588],18,5,41137,4.539505627896712,40.0,0.0
49062,4,9062,[427 515 318  79 588],807,5,41142,4.539556438265475,40.0,0.0
49063,4,9063,[427 515 318  79 588],18,5,41147,4.539607237422771,40.0,0.0
49064,4,9064,[427 515 318  79 588],18,5,41152,4.539658025372311,40.0,0.0
49065,4,9065,[427 515 318  79 588],807,5,41157,4.5397088021178025,40.0,0.0
49066,4,9066,[427 515 318  79 588],18,5,41162,4.539759567662953,40.0,0.0
49067,4,9067,[427 515 318  79 588],716,5,41167,4.539810322011469,40.0,0.0
49068,4,9068,[483 301 427  56 125],296,5,41172,4.539861065167052,20.0,0.0
49069,4,9069,[ 11 275 435 328  50],450,5,41177,4.539911797133406,0.0,40.0
49070,4,9070,[427 515 318  79 588],807,5,41182,4.539962517914232,40.0,0.0
49071,4,9071,[427 515 318  79 588],18,5,41187,4.540013227513228,40.0,0.0
49072,4,9072,[427 515 318  79 588],18,5,41192,4.54006392593409,40.0,0.0
49073,4,9073,[427 515 318  79 588],807,5,41197,4.540114613180516,40.0,0.0
49074,4,9074,[427 515 318  79 588],716,5,41202,4.5401652892561986,40.0,0.0
49075,4,9075,[427 515 318  79 588],807,5,41207,4.540215954164831,40.0,0.0
49076,4,9076,[427 515 318  79 588],716,5,41212,4.540266607910103,40.0,0.0
49077,4,9077,[427 515 318  79 588],807,5,41217,4.540317250495704,40.0,0.0
49078,4,9078,[427 515 318  79 588],716,5,41222,4.540367881925322,40.0,0.0
49079,4,9079,[258 211 215 117 200],450,4,41226,4.540308370044053,0.0,0.0
49080,4,9080,[238 196  12 222 183],796,4,41230,4.540248871269684,0.0,0.0
49081,4,9081,[427 515 318  79 588],716,5,41235,4.540299493503634,40.0,0.0
49082,4,9082,[323 597 427 483 132],796,4,41239,4.540240008807663,20.0,0.0
49083,4,9083,[427 515 318  79 588],716,5,41244,4.540290620871863,40.0,0.0
49084,4,9084,[268 191 228 135 195],655,2,41246,4.540011007154651,0.0,0.0
49085,4,9085,[427 515 318  79 588],807,5,41251,4.540061633281972,40.0,0.0
49086,4,9086,[174  50 302 181 742],450,5,41256,4.540112248266754,0.0,20.0
49087,4,9087,[427 222 403 135  50],807,5,41261,4.540162852112676,20.0,20.0
49088,4,9088,[403 173 245  50 269],450,5,41266,4.540213444823413,0.0,20.0
49089,4,9089,[427 515 318  79 588],716,5,41271,4.540264026402641,40.0,0.0
49090,4,9090,[427 515 318  79 588],807,5,41276,4.5403145968540315,40.0,0.0
49091,4,9091,[187 276 288  56 121],655,2,41278,4.540035195776507,0.0,0.0
49092,4,9092,[427 515 318  79 588],716,5,41283,4.540085780270537,40.0,0.0
49093,4,9093,[427 515 318  79 588],18,5,41288,4.540136353639762,40.0,0.0
49094,4,9094,[427 515 318  79 588],716,5,41293,4.54018691588785,40.0,0.0
49095,4,9095,[427 515 318  79 588],18,5,41298,4.5402374670184695,40.0,0.0
49096,4,9096,[427 515 318  79 588],716,5,41303,4.5402880070352865,40.0,0.0
49097,4,9097,[597   8  96 228 117],796,5,41308,4.540338535941966,0.0,0.0
49098,4,9098,[427 515 318  79 588],807,5,41313,4.540389053742169,40.0,0.0
49099,4,9099,[174 385 125 245 748],450,5,41318,4.540439560439561,0.0,0.0
49100,4,9100,[427 515 318  79 588],716,5,41323,4.540490056037798,40.0,0.0
49101,4,9101,[427 515 318  79 588],716,5,41328,4.54054054054054,40.0,0.0
49102,4,9102,[427 515 318  79 588],18,5,41333,4.5405910139514445,40.0,0.0
49103,4,9103,[427 515 318  79 588],18,5,41338,4.540641476274165,40.0,0.0
49104,4,9104,[427 515 318  79 588],716,5,41343,4.540691927512356,40.0,0.0
49105,4,9105,[ 11 294 385 237 181],401,0,41343,4.5401932791566,0.0,0.0
49106,4,9106,[427 515 318  79 588],807,5,41348,4.540243768529702,40.0,0.0
49107,4,9107,[ 50  98 143 196 161],796,5,41353,4.540294246815986,0.0,20.0
49108,4,9108,[546 168 143 318 118],504,4,41357,4.540234932484356,20.0,0.0
49109,4,9109,[427 515 318  79 588],807,5,41362,4.540285400658617,40.0,0.0
49110,4,9110,[427 515 318  79 588],716,5,41367,4.540335857754362,40.0,0.0
49111,4,9111,[427 515 318  79 588],716,5,41372,4.540386303775241,40.0,0.0
49112,4,9112,[427 515 318  79 588],18,5,41377,4.540436738724899,40.0,0.0
49113,4,9113,[427 515 318  79 588],716,5,41382,4.540487162606978,40.0,0.0
49114,4,9114,[143  95 288 275 132],450,3,41385,4.540318156884257,0.0,20.0
49115,4,9115,[427 515 318  79 588],807,5,41390,4.540368582711715,40.0,0.0
49116,4,9116,[427 515 318  79 588],716,5,41395,4.54041899747724,40.0,0.0
49117,4,9117,[427 515 318  79 588],18,5,41400,4.54046940118447,40.0,0.0
49118,4,9118,[427 515 318  79 588],716,5,41405,4.540519793837044,40.0,0.0
49119,4,9119,[427 515 318  79 588],716,5,41410,4.540570175438597,40.0,0.0
49120,4,9120,[427 515 318  79 588],716,5,41415,4.5406205459927635,40.0,0.0
49121,4,9121,[427 515 318  79 588],807,5,41420,4.5406709055031795,40.0,0.0
49122,4,9122,[427 515 318  79 588],716,5,41425,4.540721253973474,40.0,0.0
49123,4,9123,[427 515 318  79 588],716,5,41430,4.540771591407277,40.0,0.0
49124,4,9124,[427 515 318  79 588],807,5,41435,4.540821917808219,40.0,0.0
49125,4,9125,[427 515 318  79 588],18,5,41440,4.540872233179925,40.0,0.0
49126,4,9126,[427 515 318  79 588],716,5,41445,4.540922537526022,40.0,0.0
49127,4,9127,[427 515 318  79 588],18,5,41450,4.540972830850132,40.0,0.0
49128,4,9128,[237 125 435 181 174],18,2,41452,4.540694490086538,0.0,0.0
49129,4,9129,[427 515 318  79 588],807,5,41457,4.540744797371303,40.0,0.0
49130,4,9130,[144 271 200 748   8],796,5,41462,4.540795093637061,0.0,0.0
49131,4,9131,[427 515 318  79 588],18,5,41467,4.540845378887429,40.0,0.0
49132,4,9132,[427 265  71  82 748],796,4,41471,4.540786160078835,20.0,0.0
49133,4,9133,[172 204 153 269 301],796,3,41474,4.54061747317714,0.0,0.0
49134,4,9134,[427 515 318  79 588],807,5,41479,4.540667761357416,40.0,0.0
49135,4,9135,[655 194  96 182 197],72,5,41484,4.5407180385288965,0.0,0.0
49136,4,9136,[ 22 234 357 174 300],655,1,41485,4.540330524242092,0.0,0.0
49137,4,9137,[427 515 318  79 588],18,5,41490,4.540380827314511,40.0,0.0
49138,4,9138,[427 515 318  79 588],807,5,41495,4.540431119378487,40.0,0.0
49139,4,9139,[222  82 237 216 322],450,3,41498,4.540262582056893,0.0,0.0
49140,4,9140,[385  98  12 234 483],457,5,41503,4.5403128760529485,0.0,0.0
49141,4,9141,[427 515 318  79 588],807,5,41508,4.54036315904616,40.0,0.0
49142,4,9142,[118   9 294 313 435],655,1,41509,4.539975937875971,0.0,0.0
49143,4,9143,[427 515 318  79 588],807,5,41514,4.54002624671916,40.0,0.0
49144,4,9144,[427 515 318  79 588],18,5,41519,4.540076544559869,40.0,0.0
49145,4,9145,[427 515 318  79 588],716,5,41524,4.540126831401706,40.0,0.0
49146,4,9146,[427 515 318  79 588],18,5,41529,4.540177107248278,40.0,0.0
49147,4,9147,[ 69 228 135  95  64],716,4,41533,4.540118058592042,20.0,0.0
49148,4,9148,[427 515 318  79 588],807,5,41538,4.540168324407039,40.0,0.0
49149,4,9149,[ 56 603 204  64  70],269,3,41541,4.54,40.0,0.0
49150,4,9150,[427 515 318  79 588],18,5,41546,4.540050267730303,40.0,0.0
49151,4,9151,[427 515 318  79 588],716,5,41551,4.540100524475524,40.0,0.0
49152,4,9152,[427 515 318  79 588],807,5,41556,4.540150770239266,40.0,0.0
49153,4,9153,[427 515 318  79 588],807,5,41561,4.540201005025126,40.0,0.0
49154,4,9154,[427 515 318  79 588],18,5,41566,4.540251228836701,40.0,0.0
49155,4,9155,[427 515 318  79 588],716,5,41571,4.540301441677588,40.0,0.0
49156,4,9156,[  4  96 302 237 118],344,3,41574,4.540133231407666,0.0,0.0
49157,4,9157,[427 515 318  79 588],807,5,41579,4.540183446167285,40.0,0.0
49158,4,9158,[427 515 318  79 588],716,5,41584,4.540233649961786,40.0,0.0
49159,4,9159,[427 515 318  79 588],18,5,41589,4.54028384279476,40.0,0.0
49160,4,9160,[427 515 318  79 588],716,5,41594,4.540334024669796,40.0,0.0
49161,4,9161,[427 515 318  79 588],716,5,41599,4.540384195590482,40.0,0.0
49162,4,9162,[427 515 318  79 588],807,5,41604,4.540434355560406,40.0,0.0
49163,4,9163,[100  50 173 265 603],292,5,41609,4.5404845045831514,20.0,40.0
49164,4,9164,[427 515 318  79 588],716,5,41614,4.540534642662302,40.0,0.0
49165,4,9165,[427 515 318  79 588],807,5,41619,4.54058476980144,40.0,0.0
49166,4,9166,[427 515 318  79 588],807,5,41624,4.540634886004145,40.0,0.0
49167,4,9167,[269 187 475 427  50],655,3,41627,4.540466841186737,20.0,20.0
49168,4,9168,[427 515 318  79 588],716,5,41632,4.540516959319446,40.0,0.0
49169,4,9169,[427 515 318  79 588],18,5,41637,4.540567066521265,40.0,0.0
49170,4,9170,[187 546 195 117 200],796,5,41642,4.540617162795769,0.0,0.0
49171,4,9171,[427 515 318  79 588],716,5,41647,4.540667248146533,40.0,0.0
49172,4,9172,[427 515 318  79 588],18,5,41652,4.5407173225771285,40.0,0.0
49173,4,9173,[427 515 318  79 588],807,5,41657,4.540767386091127,40.0,0.0
49174,4,9174,[427 515 318  79 588],18,5,41662,4.540817438692098,40.0,0.0
49175,4,9175,[427 515 318  79 588],716,5,41667,4.54086748038361,40.0,0.0
49176,4,9176,[427 515 318  79 588],18,5,41672,4.540917511169227,40.0,0.0
49177,4,9177,[427 515 318  79 588],18,5,41677,4.540967531052517,40.0,0.0
49178,4,9178,[427 515 318  79 588],807,5,41682,4.541017540037041,40.0,0.0
49179,4,9179,[ 97 118 258 742 132],796,3,41685,4.540849673202614,0.0,0.0
49180,4,9180,[ 79  97 204 603 265],72,5,41690,4.540899684130269,20.0,0.0
49181,4,9181,[427 515 318  79 588],18,5,41695,4.54094968416467,40.0,0.0
49182,4,9182,[427 515 318  79 588],18,5,41700,4.540999673309376,40.0,0.0
49183,4,9183,[427 515 318  79 588],716,5,41705,4.541049651567945,40.0,0.0
49184,4,9184,[235 191  11 210 273],401,2,41707,4.540772999455634,0.0,0.0
49185,4,9185,[427 515 318  79 588],807,5,41712,4.540822991508818,40.0,0.0
49186,4,9186,[121 151 173  70  69],401,1,41713,4.540437574834004,0.0,0.0
49187,4,9187,[427 515 318  79 588],716,5,41718,4.5404875925119725,40.0,0.0
49188,4,9188,[300 258 435 161 127],450,5,41723,4.540537599303515,0.0,20.0
49189,4,9189,[258  70 237 186 435],450,4,41727,4.540478781284004,0.0,0.0
49190,4,9190,[427 515 318  79 588],716,5,41732,4.540528778152541,40.0,0.0
49191,4,9191,[427 515 318  79 588],716,5,41737,4.540578764142733,40.0,0.0
49192,4,9192,[288 318 742  88 161],504,4,41741,4.540519960839769,20.0,0.0
49193,4,9193,[427 515 318  79 588],716,5,41746,4.54056993691538,40.0,0.0
49194,4,9194,[427 515 318  79 588],716,5,41751,4.540619902120718,40.0,0.0
49195,4,9195,[427 515 318  79 588],807,5,41756,4.54066985645933,40.0,0.0
49196,4,9196,[427 515 318  79 588],807,5,41761,4.540719799934761,40.0,0.0
49197,4,9197,[427 515 318  79 588],18,5,41766,4.5407697325505545,40.0,0.0
49198,4,9198,[210 100 318  28 288],655,1,41767,4.540384824437439,20.0,20.0
49199,4,9199,[427 515 318  79 588],716,5,41772,4.5404347826086955,40.0,0.0
49200,4,9200,[ 69 168 265 496  50],151,5,41777,4.540484729920661,20.0,20.0
49201,4,9201,[427 515 318  79 588],716,5,41782,4.540534666376875,40.0,0.0
49202,4,9202,[427 515 318  79 588],807,5,41787,4.540584591980876,40.0,0.0
49203,4,9203,[427 515 318  79 588],807,5,41792,4.540634506736201,40.0,0.0
49204,4,9204,[ 12 100 385 121 118],796,4,41796,4.54057577403585,0.0,20.0
49205,4,9205,[427 515 318  79 588],807,5,41801,4.540625678905062,40.0,0.0
49206,4,9206,[427 515 318  79 588],716,5,41806,4.540675572933638,40.0,0.0
49207,4,9207,[427 515 318  79 588],18,5,41811,4.5407254561251085,40.0,0.0
49208,4,9208,[185 597 186 235  89],450,3,41814,4.540558149636225,0.0,0.0
49209,4,9209,[427 515 318  79 588],18,5,41819,4.540608034744842,40.0,0.0
49210,4,9210,[427 515 318  79 588],18,5,41824,4.540657909021822,40.0,0.0
49211,4,9211,[427 515 318  79 588],807,5,41829,4.54070777247069,40.0,0.0
49212,4,9212,[427 515 318  79 588],18,5,41834,4.540757625094974,40.0,0.0
49213,4,9213,[427 515 318  79 588],716,5,41839,4.540807466898198,40.0,0.0
49214,4,9214,[427 515 318  79 588],807,5,41844,4.540857297883885,40.0,0.0
49215,4,9215,[427 515 318  79 588],18,5,41849,4.540907118055555,40.0,0.0
49216,4,9216,[211 197 144 121 185],401,4,41853,4.540848432244765,0.0,0.0
49217,4,9217,[427 515 318  79 588],807,5,41858,4.540898242568887,40.0,0.0
49218,4,9218,[427 515 318  79 588],807,5,41863,4.5409480420869945,40.0,0.0
49219,4,9219,[  7 173 405 276 216],786,4,41867,4.540889370932755,0.0,0.0
49220,4,9220,[427 515 318  79 588],18,5,41872,4.540939160611647,40.0,0.0
49221,4,9221,[427 515 318  79 588],716,5,41877,4.540988939492518,40.0,0.0
49222,4,9222,[427 515 318  79 588],807,5,41882,4.5410387075788785,40.0,0.0
49223,4,9223,[427 515 318  79 588],716,5,41887,4.541088464874241,40.0,0.0
49224,4,9224,[172 191 210 173 275],389,3,41890,4.540921409214092,0.0,20.0
49225,4,9225,[427 515 318  79 588],807,5,41895,4.540971168437026,40.0,0.0
49226,4,9226,[176 313 195 194  12],450,5,41900,4.54102091687439,0.0,0.0
49227,4,9227,[132  28 180 273 568],796,2,41902,4.540745557000434,0.0,0.0
49228,4,9228,[  1 191 200  50 588],716,5,41907,4.540795319102828,0.0,20.0
49229,4,9229,[427 515 318  79 588],18,5,41912,4.540845070422535,40.0,0.0
49230,4,9230,[333   1 111 546 405],938,3,41915,4.540678149712924,0.0,0.0
49231,4,9231,[427 515 318  79 588],807,5,41920,4.540727902946274,40.0,0.0
49232,4,9232,[ 28 318 294 151  95],796,3,41923,4.540561031084155,20.0,0.0
49233,4,9233,[427 515 318  79 588],807,5,41928,4.540610786224821,40.0,0.0
49234,4,9234,[427 515 318  79 588],716,5,41933,4.540660530590146,40.0,0.0
49235,4,9235,[427 515 318  79 588],18,5,41938,4.540710264183629,40.0,0.0
49236,4,9236,[191 132 144 238 135],716,3,41941,4.5405434664934505,0.0,0.0
49237,4,9237,[427 515 318  79 588],18,5,41946,4.540593201991773,40.0,0.0
49238,4,9238,[427 515 318  79 588],18,5,41951,4.540642926723671,40.0,0.0
49239,4,9239,[427 515 318  79 588],716,5,41956,4.540692640692641,40.0,0.0
49240,4,9240,[427 515 318  79 588],716,5,41961,4.540742343902175,40.0,0.0
49241,4,9241,[300 237 318 423 121],504,4,41965,4.540683834667821,20.0,0.0
49242,4,9242,[ 22 328 144   8 742],655,0,41965,4.540192578167262,0.0,0.0
49243,4,9243,[427 515 318  79 588],807,5,41970,4.540242319342276,40.0,0.0
49244,4,9244,[427 515 318  79 588],716,5,41975,4.5402920497566255,40.0,0.0
49245,4,9245,[258 185 204  88 121],655,1,41976,4.539909149902661,0.0,0.0
49246,4,9246,[427 515 318  79 588],716,5,41981,4.539958905591003,40.0,0.0
49247,4,9247,[427 515 318  79 588],807,5,41986,4.540008650519031,40.0,0.0
49248,4,9248,[423 385 265  82 176],457,5,41991,4.540058384690237,0.0,0.0
49249,4,9249,[427 515 318  79 588],807,5,41996,4.540108108108108,40.0,0.0
49250,4,9250,[276 258 111 161  98],655,2,41998,4.539833531510107,0.0,0.0
49251,4,9251,[427 515 318  79 588],716,5,42003,4.53988326848249,40.0,0.0
49252,4,9252,[427 515 318  79 588],18,5,42008,4.5399329947044205,40.0,0.0
49253,4,9253,[186 228 191   1 333],796,3,42011,4.5397665874216555,0.0,0.0
49254,4,9254,[427 515 318  79 588],18,5,42016,4.539816315505132,40.0,0.0
49255,4,9255,[427 515 318  79 588],807,5,42021,4.539866032843561,40.0,0.0
49256,4,9256,[427 515 318  79 588],807,5,42026,4.539915739440423,40.0,0.0
49257,4,9257,[427 515 318  79 588],807,5,42031,4.539965435299201,40.0,0.0
49258,4,9258,[289 288  89 313 144],655,2,42033,4.539691111351118,0.0,0.0
49259,4,9259,[427 515 318  79 588],716,5,42038,4.539740820734341,40.0,0.0
49260,4,9260,[427 515 318  79 588],807,5,42043,4.539790519382356,40.0,0.0
49261,4,9261,[427 515 318  79 588],18,5,42048,4.5398402072986395,40.0,0.0
49262,4,9262,[427 515 318  79 588],18,5,42053,4.5398898844866675,40.0,0.0
49263,4,9263,[427 515 318  79 588],807,5,42058,4.539939550949914,40.0,0.0
49264,4,9264,[ 88 204 318 111  96],269,1,42059,4.5395574743658935,20.0,0.0
49265,4,9265,[427 515 318  79 588],18,5,42064,4.539607165983164,40.0,0.0
49266,4,9266,[427 515 318  79 588],807,5,42069,4.539656846876012,40.0,0.0
49267,4,9267,[427 515 318  79 588],18,5,42074,4.5397065170479065,40.0,0.0
49268,4,9268,[151  50 183 403 143],457,5,42079,4.53975617650232,0.0,20.0
49269,4,9269,[427 515 318  79 588],807,5,42084,4.539805825242718,40.0,0.0
49270,4,9270,[385 100 328 195 153],450,5,42089,4.539855463272571,0.0,20.0
49271,4,9271,[427 515 318  79 588],716,5,42094,4.539905090595341,40.0,0.0
49272,4,9272,[427 515 318  79 588],807,5,42099,4.539954707214494,40.0,0.0
49273,4,9273,[427 515 318  79 588],18,5,42104,4.540004313133491,40.0,0.0
49274,4,9274,[427 515 318  79 588],716,5,42109,4.540053908355795,40.0,0.0
49275,4,9275,[191 151 228   8 288],457,5,42114,4.540103492884864,0.0,0.0
49276,4,9276,[427 515 318  79 588],716,5,42119,4.540153066724156,40.0,0.0
49277,4,9277,[427 515 318  79 588],807,5,42124,4.540202629877129,40.0,0.0
49278,4,9278,[427 515 318  79 588],18,5,42129,4.540252182347236,40.0,0.0
49279,4,9279,[427 515 318  79 588],716,5,42134,4.540301724137931,40.0,0.0
49280,4,9280,[427 515 318  79 588],807,5,42139,4.540351255252666,40.0,0.0
49281,4,9281,[186 196 118 357 288],504,3,42142,4.540185304891187,0.0,0.0
49282,4,9282,[427 515 318  79 588],716,5,42147,4.540234837875687,40.0,0.0
49283,4,9283,[185 423 234 597 182],457,4,42151,4.540176647996553,0.0,0.0
49284,4,9284,[427 515 318  79 588],807,5,42156,4.540226171243942,40.0,0.0
49285,4,9285,[ 96 135 186   1 117],807,4,42160,4.540167994830928,0.0,0.0
49286,4,9286,[427 515 318  79 588],807,5,42165,4.540217508344998,40.0,0.0
49287,4,9287,[427 515 318  79 588],716,5,42170,4.540267011197244,40.0,0.0
49288,4,9288,[427 515 318  79 588],716,5,42175,4.540316503391108,40.0,0.0
49289,4,9289,[427 515 318  79 588],807,5,42180,4.540365984930032,40.0,0.0
49290,4,9290,[215 196 265 111   7],457,4,42184,4.540307824776666,0.0,0.0
49291,4,9291,[427 515 318  79 588],716,5,42189,4.540357296599225,40.0,0.0
49292,4,9292,[427 515 318  79 588],807,5,42194,4.540406757774669,40.0,0.0
49293,4,9293,[175 210  28 202  79],457,5,42199,4.540456208306434,0.0,0.0
49294,4,9294,[427 515 318  79 588],807,5,42204,4.540505648197956,40.0,0.0
49295,4,9295,[427 515 318  79 588],716,5,42209,4.540555077452668,40.0,0.0
49296,4,9296,[275 172 210  96 222],796,4,42213,4.540496934494999,0.0,20.0
49297,4,9297,[174  69 204  79 496],807,5,42218,4.540546354054635,20.0,0.0
49298,4,9298,[427 515 318  79 588],18,5,42223,4.540595762985268,40.0,0.0
49299,4,9299,[427 515 318  79 588],807,5,42228,4.540645161290323,40.0,0.0
49300,4,9300,[423 100 172 322   4],786,4,42232,4.5405870336522955,0.0,20.0
49301,4,9301,[301 172 191   1 100],151,3,42235,4.540421414749516,0.0,20.0
49302,4,9302,[427 515 318  79 588],807,5,42240,4.5404708158658496,40.0,0.0
49303,4,9303,[153  70 405 318 182],593,3,42243,4.54030524505589,20.0,0.0
49304,4,9304,[427 515 318  79 588],18,5,42248,4.540354648038689,40.0,0.0
49305,4,9305,[427 515 318  79 588],716,5,42253,4.540404040404041,40.0,0.0
49306,4,9306,[427 515 318  79 588],716,5,42258,4.540453422155367,40.0,0.0
49307,4,9307,[427 515 318  79 588],18,5,42263,4.540502793296089,40.0,0.0
49308,4,9308,[111 173 181 151 200],577,4,42267,4.540444730905575,0.0,0.0
49309,4,9309,[427 515 318  79 588],18,5,42272,4.540494092373792,40.0,0.0
49310,4,9310,[273 127 181 175 288],655,2,42274,4.540221243690259,0.0,20.0
49311,4,9311,[427 515 318  79 588],716,5,42279,4.540270618556701,40.0,0.0
49312,4,9312,[508 471 118 403 191],655,1,42280,4.539890475679158,0.0,0.0
49313,4,9313,[427 515 318  79 588],807,5,42285,4.5399398754563025,40.0,0.0
49314,4,9314,[403 318 245 322 301],224,2,42287,4.53966720343532,20.0,0.0
49315,4,9315,[427 515 318  79 588],716,5,42292,4.539716616573637,40.0,0.0
49316,4,9316,[427 515 318  79 588],716,5,42297,4.539766019104862,40.0,0.0
49317,4,9317,[403 196 258  82 568],457,5,42302,4.539815411032411,0.0,0.0
49318,4,9318,[427 515 318  79 588],716,5,42307,4.539864792359695,40.0,0.0
49319,4,9319,[427 515 318  79 588],18,5,42312,4.5399141630901285,40.0,0.0
49320,4,9320,[427 515 318  79 588],18,5,42317,4.539963523227121,40.0,0.0
49321,4,9321,[427 515 318  79 588],716,5,42322,4.540012872774083,40.0,0.0
49322,4,9322,[427 515 318  79 588],18,5,42327,4.54006221173442,40.0,0.0
49323,4,9323,[ 97 385 127 144   8],655,1,42328,4.5396825396825395,0.0,20.0
49324,4,9324,[427 515 318  79 588],18,5,42333,4.539731903485254,40.0,0.0
49325,4,9325,[176 235   4   8 121],344,3,42336,4.539566802487669,0.0,0.0
49326,4,9326,[ 79 300 328 181 210],796,4,42340,4.539508952503485,0.0,0.0
49327,4,9327,[427 515 318  79 588],807,5,42345,4.539558319039451,40.0,0.0
49328,4,9328,[427 515 318  79 588],716,5,42350,4.53960767499196,40.0,0.0
49329,4,9329,[427 515 318  79 588],716,5,42355,4.539657020364416,40.0,0.0
49330,4,9330,[603 318 275  79  15],151,5,42360,4.539706355160218,40.0,20.0
49331,4,9331,[121 603 238  50  69],655,2,42362,4.539434204886413,20.0,20.0
49332,4,9332,[427 515 318  79 588],807,5,42367,4.539483552984035,40.0,0.0
49333,4,9333,[427 515 318  79 588],18,5,42372,4.539532890507821,40.0,0.0
49334,4,9334,[427 515 318  79 588],18,5,42377,4.5395822174611675,40.0,0.0
49335,4,9335,[173 742   9   4 323],280,2,42379,4.539310197086547,0.0,0.0
49336,4,9336,[ 12 357   4 185 118],151,4,42383,4.539252436542787,0.0,0.0
49337,4,9337,[ 71 202  69 275 118],450,3,42386,4.539087599057614,0.0,20.0
49338,4,9338,[427 515 318  79 588],716,5,42391,4.539136952564514,40.0,0.0
49339,4,9339,[427 515 318  79 588],807,5,42396,4.539186295503212,40.0,0.0
49340,4,9340,[427 515 318  79 588],716,5,42401,4.539235627877101,40.0,0.0
49341,4,9341,[237 143 117   1 174],655,1,42402,4.538856775850996,0.0,0.0
49342,4,9342,[187 195 151  79 194],535,3,42405,4.53869206892861,0.0,0.0
49343,4,9343,[211 546  56 195  28],151,3,42408,4.538527397260274,0.0,0.0
49344,4,9344,[427 515 318  79 588],716,5,42413,4.538576779026217,40.0,0.0
49345,4,9345,[427 515 318  79 588],807,5,42418,4.538626150224695,40.0,0.0
49346,4,9346,[427 515 318  79 588],18,5,42423,4.5386755108590995,40.0,0.0
49347,4,9347,[427 515 318  79 588],716,5,42428,4.5387248609328195,40.0,0.0
49348,4,9348,[182  12 135 111 161],280,4,42432,4.538667237137662,0.0,0.0
49349,4,9349,[427 515 318  79 588],716,5,42437,4.538716577540107,40.0,0.0
49350,4,9350,[427 515 318  79 588],18,5,42442,4.538765907389584,40.0,0.0
49351,4,9351,[427 515 318  79 588],18,5,42447,4.538815226689478,40.0,0.0
49352,4,9352,[228 204 322 181 568],450,5,42452,4.538864535443174,0.0,0.0
49353,4,9353,[427 515 318  79 588],18,5,42457,4.5389138336540515,40.0,0.0
49354,4,9354,[302 191 185 161 174],450,5,42462,4.538963121325494,0.0,0.0
49355,4,9355,[427 515 318  79 588],807,5,42467,4.539012398460881,40.0,0.0
49356,4,9356,[427 515 318  79 588],807,5,42472,4.539061665063588,40.0,0.0
49357,4,9357,[427 515 318  79 588],18,5,42477,4.539110921136995,40.0,0.0
49358,4,9358,[427 515 318  79 588],807,5,42482,4.539160166684475,40.0,0.0
49359,4,9359,[427 515 318  79 588],807,5,42487,4.539209401709401,40.0,0.0
49360,4,9360,[ 50 258 176 100 135],450,4,42491,4.539151800021365,0.0,40.0
49361,4,9361,[427 515 318  79 588],716,5,42496,4.539201025421918,40.0,0.0
49362,4,9362,[427 515 318  79 588],716,5,42501,4.539250240307593,40.0,0.0
49363,4,9363,[301 197 183 238   4],151,4,42505,4.539192652712516,0.0,0.0
49364,4,9364,[427 515 318  79 588],716,5,42510,4.539241857981847,40.0,0.0
49365,4,9365,[210 181 245 302 546],344,2,42512,4.538970745248772,0.0,0.0
49366,4,9366,[427 515 318  79 588],18,5,42517,4.539019963702359,40.0,0.0
49367,4,9367,[121 603 258 508 282],535,4,42521,4.538962425277541,20.0,0.0
49368,4,9368,[427 515 318  79 588],18,5,42526,4.539011634112499,40.0,0.0
49369,4,9369,[427 515 318  79 588],716,5,42531,4.53906083244397,40.0,0.0
49370,4,9370,[427 515 318  79 588],807,5,42536,4.539110020275317,40.0,0.0
49371,4,9371,[427 515 318  79 588],807,5,42541,4.5391591976099015,40.0,0.0
49372,4,9372,[427 515 318  79 588],18,5,42546,4.539208364451083,40.0,0.0
49373,4,9373,[  7  56 222 265 357],655,1,42547,4.538830808619586,0.0,0.0
49374,4,9374,[427 515 318  79 588],807,5,42552,4.53888,40.0,0.0
49375,4,9375,[427 515 318  79 588],716,5,42557,4.538929180887372,40.0,0.0
49376,4,9376,[427 515 318  79 588],807,5,42562,4.538978351285059,40.0,0.0
49377,4,9377,[ 22 210 300 423 238],535,3,42565,4.538814246107912,0.0,0.0
49378,4,9378,[ 97 111 588  70 151],457,4,42569,4.538756797099904,0.0,0.0
49379,4,9379,[403 423   9 275  88],796,4,42573,4.538699360341151,0.0,20.0
49380,4,9380,[427 515 318  79 588],716,5,42578,4.5387485342714,40.0,0.0
49381,4,9381,[ 22 228 172 191 423],716,5,42583,4.538797697719036,0.0,0.0
49382,4,9382,[427 515 318  79 588],18,5,42588,4.538846850687413,40.0,0.0
49383,4,9383,[427 515 318  79 588],716,5,42593,4.538895993179881,40.0,0.0
49384,4,9384,[427 515 318  79 588],716,5,42598,4.5389451251997865,40.0,0.0
49385,4,9385,[427 515 318  79 588],807,5,42603,4.538994246750479,40.0,0.0
49386,4,9386,[427 515 318  79 588],716,5,42608,4.539043357835304,40.0,0.0
49387,4,9387,[427 515 318  79 588],716,5,42613,4.539092458457605,40.0,0.0
49388,4,9388,[427 515 318  79 588],807,5,42618,4.5391415486207265,40.0,0.0
49389,4,9389,[427 515 318  79 588],716,5,42623,4.539190628328009,40.0,0.0
49390,4,9390,[427 515 318  79 588],18,5,42628,4.539239697582792,40.0,0.0
49391,4,9391,[427 515 318  79 588],716,5,42633,4.539288756388416,40.0,0.0
49392,4,9392,[427 515 318  79 588],18,5,42638,4.539337804748217,40.0,0.0
49393,4,9393,[143 228 121 328  15],655,1,42639,4.538961038961039,0.0,0.0
49394,4,9394,[427 515 318  79 588],716,5,42644,4.539010111761575,40.0,0.0
49395,4,9395,[427 515 318  79 588],807,5,42649,4.5390591741166455,40.0,0.0
49396,4,9396,[427 515 318  79 588],807,5,42654,4.539108226029584,40.0,0.0
49397,4,9397,[427 515 318  79 588],18,5,42659,4.539157267503724,40.0,0.0
49398,4,9398,[427 515 318  79 588],18,5,42664,4.539206298542398,40.0,0.0
49399,4,9399,[427 515 318  79 588],716,5,42669,4.539255319148936,40.0,0.0
49400,4,9400,[385 210  50 185 313],450,4,42673,4.539197957664078,0.0,20.0
49401,4,9401,[427 515 318  79 588],807,5,42678,4.539246968730057,40.0,0.0
49402,4,9402,[427 515 318  79 588],716,5,42683,4.539295969371477,40.0,0.0
49403,4,9403,[427 515 318  79 588],716,5,42688,4.539344959591663,40.0,0.0
49404,4,9404,[427 515 318  79 588],807,5,42693,4.539393939393939,40.0,0.0
49405,4,9405,[144   1 655 172  97],535,2,42695,4.539123963427599,0.0,0.0
49406,4,9406,[ 98  50 588  88 125],577,4,42699,4.539066652492824,0.0,20.0
49407,4,9407,[427 515 318  79 588],807,5,42704,4.539115646258503,40.0,0.0
49408,4,9408,[427 515 318  79 588],807,5,42709,4.539164629609948,40.0,0.0
49409,4,9409,[ 28 748 546  25 427],450,4,42713,4.539107332624867,20.0,0.0
49410,4,9410,[427 515 318  79 588],807,5,42718,4.539156306449899,40.0,0.0
49411,4,9411,[427 515 318  79 588],716,5,42723,4.539205269868253,40.0,0.0
49412,4,9412,[546 294 183 216 300],450,5,42728,4.539254222883247,0.0,0.0
49413,4,9413,[427 515 318  79 588],807,5,42733,4.539303165498194,40.0,0.0
49414,4,9414,[427 515 318  79 588],807,5,42738,4.53935209771641,40.0,0.0
49415,4,9415,[427 515 318  79 588],716,5,42743,4.539401019541207,40.0,0.0
49416,4,9416,[168 176  28  56  89],796,4,42747,4.5393437400446,0.0,0.0
49417,4,9417,[427 515 318  79 588],18,5,42752,4.539392652367806,40.0,0.0
49418,4,9418,[427 515 318  79 588],716,5,42757,4.539441554305128,40.0,0.0
49419,4,9419,[427 515 318  79 588],18,5,42762,4.539490445859872,40.0,0.0
49420,4,9420,[427 515 318  79 588],807,5,42767,4.539539327035347,40.0,0.0
49421,4,9421,[427 515 318  79 588],18,5,42772,4.5395881978348545,40.0,0.0
49422,4,9422,[427 515 318  79 588],716,5,42777,4.5396370582617,40.0,0.0
49423,4,9423,[427 515 318  79 588],807,5,42782,4.539685908319185,40.0,0.0
49424,4,9424,[427 515 318  79 588],807,5,42787,4.53973474801061,40.0,0.0
49425,4,9425,[742 172 216 276 257],457,4,42791,4.539677487799703,0.0,0.0
49426,4,9426,[427 515 318  79 588],716,5,42796,4.5397263180227005,40.0,0.0
49427,4,9427,[427 515 318  79 588],716,5,42801,4.539775137887145,40.0,0.0
49428,4,9428,[427 515 318  79 588],807,5,42806,4.53982394739633,40.0,0.0
49429,4,9429,[427 515 318  79 588],807,5,42811,4.539872746553552,40.0,0.0
49430,4,9430,[301 132 175 403 273],655,1,42812,4.539497402184286,0.0,0.0
49431,4,9431,[427 515 318  79 588],716,5,42817,4.539546225614928,40.0,0.0
49432,4,9432,[427 515 318  79 588],716,5,42822,4.539595038693947,40.0,0.0
49433,4,9433,[427 515 318  79 588],716,5,42827,4.539643841424635,40.0,0.0
49434,4,9434,[318   4  12 200  89],457,5,42832,4.539692633810281,20.0,0.0
49435,4,9435,[427 515 318  79 588],807,5,42837,4.539741415854175,40.0,0.0
49436,4,9436,[427 515 318  79 588],716,5,42842,4.539790187559606,40.0,0.0
49437,4,9437,[427 515 318  79 588],716,5,42847,4.539838948929858,40.0,0.0
49438,4,9438,[289 181 423 175 118],655,0,42847,4.539357982837165,0.0,0.0
49439,4,9439,[427 515 318  79 588],807,5,42852,4.539406779661017,40.0,0.0
49440,4,9440,[427 515 318  79 588],807,5,42857,4.539455566147653,40.0,0.0
49441,4,9441,[427 515 318  79 588],807,5,42862,4.5395043423003605,40.0,0.0
49442,4,9442,[427 515 318  79 588],716,5,42867,4.539553108122418,40.0,0.0
49443,4,9443,[427 515 318  79 588],18,5,42872,4.539601863617111,40.0,0.0
49444,4,9444,[427 515 318  79 588],716,5,42877,4.539650608787718,40.0,0.0
49445,4,9445,[427 515 318  79 588],18,5,42882,4.539699343637518,40.0,0.0
49446,4,9446,[183 182   7 234  70],264,5,42887,4.539748068169789,0.0,0.0
49447,4,9447,[427 515 318  79 588],716,5,42892,4.539796782387807,40.0,0.0
49448,4,9448,[427 515 318  79 588],18,5,42897,4.539845486294846,40.0,0.0
49449,4,9449,[427 515 318  79 588],18,5,42902,4.53989417989418,40.0,0.0
49450,4,9450,[183 300  71   1 181],756,4,42906,4.53983705427997,0.0,0.0
49451,4,9451,[427 515 318  79 588],18,5,42911,4.539885738468049,40.0,0.0
49452,4,9452,[127  11 194  98 186],450,4,42915,4.539828625833069,0.0,20.0
49453,4,9453,[427 515 318  79 588],18,5,42920,4.539877300613497,40.0,0.0
49454,4,9454,[427 515 318  79 588],18,5,42925,4.539925965097832,40.0,0.0
49455,4,9455,[427 515 318  79 588],18,5,42930,4.53997461928934,40.0,0.0
49456,4,9456,[427 515 318  79 588],716,5,42935,4.540023263191287,40.0,0.0
49457,4,9457,[427 515 318  79 588],18,5,42940,4.540071896806936,40.0,0.0
49458,4,9458,[427 515 318  79 588],807,5,42945,4.54012052013955,40.0,0.0
49459,4,9459,[427 515 318  79 588],18,5,42950,4.540169133192389,40.0,0.0
49460,4,9460,[427 515 318  79 588],716,5,42955,4.540217735968714,40.0,0.0
49461,4,9461,[ 69  79 313 215 127],796,5,42960,4.540266328471782,0.0,20.0
49462,4,9462,[427 515 318  79 588],716,5,42965,4.540314910704851,40.0,0.0
49463,4,9463,[427 515 318  79 588],716,5,42970,4.540363482671175,40.0,0.0
49464,4,9464,[427 515 318  79 588],18,5,42975,4.540412044374009,40.0,0.0
49465,4,9465,[427 515 318  79 588],807,5,42980,4.540460595816607,40.0,0.0
49466,4,9466,[427 515 318  79 588],716,5,42985,4.540509137002219,40.0,0.0
49467,4,9467,[427 515 318  79 588],716,5,42990,4.5405576679340935,40.0,0.0
49468,4,9468,[427 515 318  79 588],807,5,42995,4.540606188615482,40.0,0.0
49469,4,9469,[427 515 318  79 588],807,5,43000,4.540654699049631,40.0,0.0
49470,4,9470,[427 515 318  79 588],807,5,43005,4.540703199239784,40.0,0.0
49471,4,9471,[427 515 318  79 588],807,5,43010,4.5407516891891895,40.0,0.0
49472,4,9472,[427 515 318  79 588],18,5,43015,4.540800168901088,40.0,0.0
49473,4,9473,[427 515 318  79 588],807,5,43020,4.540848638378721,40.0,0.0
49474,4,9474,[117 655 176 172 237],72,2,43022,4.540580474934037,0.0,0.0
49475,4,9475,[427 515 318  79 588],18,5,43027,4.5406289573659775,40.0,0.0
49476,4,9476,[427 515 318  79 588],18,5,43032,4.540677429566318,40.0,0.0
49477,4,9477,[427 515 318  79 588],716,5,43037,4.540725891538299,40.0,0.0
49478,4,9478,[427 515 318  79 588],18,5,43042,4.540774343285157,40.0,0.0
49479,4,9479,[427 515 318  79 588],716,5,43047,4.540822784810127,40.0,0.0
49480,4,9480,[427 515 318  79 588],18,5,43052,4.540871216116443,40.0,0.0
49481,4,9481,[183 121  97 173 228],577,4,43056,4.540814174224847,0.0,0.0
49482,4,9482,[427 515 318  79 588],18,5,43061,4.540862596224823,40.0,0.0
49483,4,9483,[  7 174  25 143  56],655,1,43062,4.540489245044285,0.0,0.0
49484,4,9484,[427 515 318  79 588],18,5,43067,4.540537691091196,40.0,0.0
49485,4,9485,[427 515 318  79 588],807,5,43072,4.540586126923888,40.0,0.0
49486,4,9486,[196 597 275   9 302],344,4,43076,4.540529145145989,0.0,20.0
49487,4,9487,[427 515 318  79 588],18,5,43081,4.540577571669477,40.0,0.0
49488,4,9488,[427 515 318  79 588],807,5,43086,4.540625987986089,40.0,0.0
49489,4,9489,[427 515 318  79 588],716,5,43091,4.540674394099051,40.0,0.0
49490,4,9490,[427 515 318  79 588],807,5,43096,4.54072279001159,40.0,0.0
49491,4,9491,[427 515 318  79 588],18,5,43101,4.540771175726928,40.0,0.0
49492,4,9492,[427 515 318  79 588],716,5,43106,4.540819551248288,40.0,0.0
49493,4,9493,[427 515 318  79 588],807,5,43111,4.540867916578892,40.0,0.0
49494,4,9494,[ 79 125 333   8  56],796,5,43116,4.540916271721959,0.0,0.0
49495,4,9495,[427 515 318  79 588],716,5,43121,4.540964616680708,40.0,0.0
49496,4,9496,[111 655  97  50   1],401,2,43123,4.540697062230178,0.0,20.0
49497,4,9497,[427 515 318  79 588],18,5,43128,4.54074542008844,40.0,0.0
49498,4,9498,[427 515 318  79 588],18,5,43133,4.540793767765028,40.0,0.0
49499,4,9499,[144  79 132 294 496],450,5,43138,4.540842105263158,20.0,0.0
49500,4,9500,[427 515 318  79 588],807,5,43143,4.5408904325860435,40.0,0.0
49501,4,9501,[427 515 318  79 588],716,5,43148,4.540938749736897,40.0,0.0
49502,4,9502,[427 515 318  79 588],18,5,43153,4.540987056718931,40.0,0.0
49503,4,9503,[ 50 196 496  88 182],450,5,43158,4.541035353535354,20.0,20.0
49504,4,9504,[180 282 121  50 197],716,3,43161,4.540873224618622,0.0,20.0
49505,4,9505,[427 515 318  79 588],807,5,43166,4.540921523248475,40.0,0.0
49506,4,9506,[135 300 153 423 235],450,3,43169,4.5407594404123275,0.0,0.0
49507,4,9507,[210 125 172 318  70],151,5,43174,4.540807740849811,20.0,0.0
49508,4,9508,[427 515 318  79 588],18,5,43179,4.5408560311284045,40.0,0.0
49509,4,9509,[427 515 318  79 588],807,5,43184,4.540904311251315,40.0,0.0
49510,4,9510,[427 515 318  79 588],18,5,43189,4.5409525812217435,40.0,0.0
49511,4,9511,[427 515 318  79 588],807,5,43194,4.5410008410428935,40.0,0.0
49512,4,9512,[427 515 318  79 588],807,5,43199,4.541049090717965,40.0,0.0
49513,4,9513,[427 515 318  79 588],807,5,43204,4.541097330250158,40.0,0.0
49514,4,9514,[427 515 318  79 588],716,5,43209,4.541145559642669,40.0,0.0
49515,4,9515,[427 515 318  79 588],18,5,43214,4.541193778898697,40.0,0.0
49516,4,9516,[427 515 318  79 588],716,5,43219,4.541241988021436,40.0,0.0
49517,4,9517,[427 515 318  79 588],807,5,43224,4.541290187014079,40.0,0.0
49518,4,9518,[427 515 318  79 588],716,5,43229,4.541338375879819,40.0,0.0
49519,4,9519,[210   1 265  28  15],457,5,43234,4.541386554621849,0.0,0.0
49520,4,9520,[427 515 318  79 588],807,5,43239,4.5414347232433565,40.0,0.0
49521,4,9521,[427 515 318  79 588],807,5,43244,4.541482881747532,40.0,0.0
49522,4,9522,[427 515 318  79 588],807,5,43249,4.541531030137562,40.0,0.0
49523,4,9523,[427 515 318  79 588],18,5,43254,4.541579168416631,40.0,0.0
49524,4,9524,[427 515 318  79 588],807,5,43259,4.541627296587927,40.0,0.0
49525,4,9525,[181 496  79  98 403],18,3,43262,4.541465462943523,20.0,0.0
49526,4,9526,[204 427  79 222  98],655,3,43265,4.541303663272804,20.0,0.0
49527,4,9527,[427 515 318  79 588],18,5,43270,4.54135180520571,40.0,0.0
49528,4,9528,[427 515 318  79 588],807,5,43275,4.541399937034316,40.0,0.0
49529,4,9529,[588 100 483  89 228],796,4,43279,4.5413431269674716,0.0,20.0
49530,4,9530,[427 515 318  79 588],716,5,43284,4.541391249606547,40.0,0.0
49531,4,9531,[427 515 318  79 588],18,5,43289,4.5414393621485525,40.0,0.0
49532,4,9532,[427 515 318  79 588],18,5,43294,4.541487464596664,40.0,0.0
49533,4,9533,[427 515 318  79 588],807,5,43299,4.541535556954059,40.0,0.0
49534,4,9534,[132 357 385 117 161],716,3,43302,4.541373885684321,0.0,0.0
49535,4,9535,[427 515 318  79 588],807,5,43307,4.541421979865772,40.0,0.0
49536,4,9536,[427 515 318  79 588],18,5,43312,4.541470063961413,40.0,0.0
49537,4,9537,[257 237 161 118 117],457,4,43316,4.5414132941916545,0.0,0.0
49538,4,9538,[238 294 202 257 118],716,4,43320,4.541356536324562,0.0,0.0
49539,4,9539,[427 515 318  79 588],716,5,43325,4.5414046121593294,40.0,0.0
49540,4,9540,[427 515 318  79 588],807,5,43330,4.541452677916361,40.0,0.0
49541,4,9541,[427 515 318  79 588],716,5,43335,4.541500733598826,40.0,0.0
49542,4,9542,[427 515 318  79 588],807,5,43340,4.541548779209892,40.0,0.0
49543,4,9543,[ 12 183 111 238 195],796,4,43344,4.54149203688181,0.0,0.0
49544,4,9544,[204 161 568 117  98],72,5,43349,4.541540073336826,0.0,0.0
49545,4,9545,[427 515 318  79 588],807,5,43354,4.541588099727635,40.0,0.0
49546,4,9546,[427 515 318  79 588],18,5,43359,4.541636116057401,40.0,0.0
49547,4,9547,[427 515 318  79 588],807,5,43364,4.541684122329284,40.0,0.0
49548,4,9548,[182  56  82  28   1],72,4,43368,4.5416273955388,0.0,0.0
49549,4,9549,[427 515 318  79 588],807,5,43373,4.541675392670157,40.0,0.0
49550,4,9550,[427 515 318  79 588],807,5,43378,4.541723379750811,40.0,0.0
49551,4,9551,[427 515 318  79 588],716,5,43383,4.5417713567839195,40.0,0.0
49552,4,9552,[427 515 318  79 588],18,5,43388,4.5418193237726365,40.0,0.0
49553,4,9553,[427 515 318  79 588],807,5,43393,4.541867280720117,40.0,0.0
49554,4,9554,[427 515 318  79 588],18,5,43398,4.541915227629513,40.0,0.0
49555,4,9555,[427 515 318  79 588],716,5,43403,4.541963164503977,40.0,0.0
49556,4,9556,[ 64 161 216  96 183],716,2,43405,4.541697185309197,20.0,0.0
49557,4,9557,[427 515 318  79 588],716,5,43410,4.541745134965474,40.0,0.0
49558,4,9558,[427 515 318  79 588],716,5,43415,4.541793074589393,40.0,0.0
49559,4,9559,[427 515 318  79 588],716,5,43420,4.541841004184101,40.0,0.0
49560,4,9560,[427 515 318  79 588],716,5,43425,4.5418889237527456,40.0,0.0
49561,4,9561,[427 515 318  79 588],18,5,43430,4.5419368332984735,40.0,0.0
49562,4,9562,[202 182 265   1  82],280,2,43432,4.541671023737321,0.0,0.0
49563,4,9563,[427 515 318  79 588],716,5,43437,4.541718946047679,40.0,0.0
49564,4,9564,[427 515 318  79 588],18,5,43442,4.54176685833769,40.0,0.0
49565,4,9565,[ 64 234 197 328 301],655,1,43443,4.54139661300439,20.0,0.0
49566,4,9566,[427 515 318  79 588],18,5,43448,4.541444548970419,40.0,0.0
49567,4,9567,[515 300  64 196   4],716,4,43452,4.541387959866221,20.0,0.0
49568,4,9568,[228 132 204 215   7],151,4,43456,4.541331382589612,0.0,0.0
49569,4,9569,[222 271 257 300 168],796,5,43461,4.541379310344827,0.0,0.0
49570,4,9570,[427 515 318  79 588],716,5,43466,4.54142722808484,40.0,0.0
49571,4,9571,[427 515 318  79 588],716,5,43471,4.541475135812787,40.0,0.0
49572,4,9572,[427 515 318  79 588],18,5,43476,4.541523033531808,40.0,0.0
49573,4,9573,[427 515 318  79 588],716,5,43481,4.541570921245039,40.0,0.0
49574,4,9574,[427 515 318  79 588],18,5,43486,4.541618798955613,40.0,0.0
49575,4,9575,[211 168 603 286  22],450,5,43491,4.541666666666667,20.0,20.0
49576,4,9576,[427 515 318  79 588],807,5,43496,4.54171452438133,40.0,0.0
49577,4,9577,[427 515 318  79 588],807,5,43501,4.541762372102736,40.0,0.0
49578,4,9578,[427 515 318  79 588],18,5,43506,4.541810209834012,40.0,0.0
49579,4,9579,[427 515 318  79 588],807,5,43511,4.541858037578288,40.0,0.0
49580,4,9580,[427 515 318  79 588],807,5,43516,4.541905855338691,40.0,0.0
49581,4,9581,[427 515 318  79 588],807,5,43521,4.541953663118347,40.0,0.0
49582,4,9582,[  1  64 301 153  15],796,3,43524,4.541792758008974,20.0,0.0
49583,4,9583,[427 515 318  79 588],18,5,43529,4.541840567612688,40.0,0.0
49584,4,9584,[427 515 318  79 588],807,5,43534,4.54188836724048,40.0,0.0
49585,4,9585,[ 69 318 200 132  98],236,4,43538,4.541831838097225,20.0,0.0
49586,4,9586,[427 515 318  79 588],807,5,43543,4.541879628663816,40.0,0.0
49587,4,9587,[257 191 182 357 143],796,5,43548,4.541927409261577,0.0,0.0
49588,4,9588,[427 515 318  79 588],807,5,43553,4.541975179893628,40.0,0.0
49589,4,9589,[427 515 318  79 588],18,5,43558,4.542022940563086,40.0,0.0
49590,4,9590,[427 515 318  79 588],18,5,43563,4.542070691273069,40.0,0.0
49591,4,9591,[427 515 318  79 588],716,5,43568,4.5421184320266885,40.0,0.0
49592,4,9592,[427 515 318  79 588],18,5,43573,4.542166162827061,40.0,0.0
49593,4,9593,[427 515 318  79 588],716,5,43578,4.542213883677299,40.0,0.0
49594,4,9594,[427 515 318  79 588],807,5,43583,4.542261594580511,40.0,0.0
49595,4,9595,[427 515 318  79 588],18,5,43588,4.542309295539808,40.0,0.0
49596,4,9596,[191 265 202 197 275],629,4,43592,4.542252787329374,0.0,20.0
49597,4,9597,[202 111  79 483 185],18,2,43594,4.541987914148781,0.0,0.0
49598,4,9598,[427 515 318  79 588],18,5,43599,4.542035628711324,40.0,0.0
49599,4,9599,[427 515 318  79 588],18,5,43604,4.542083333333333,40.0,0.0
49600,4,9600,[427 515 318  79 588],807,5,43609,4.542131028017915,40.0,0.0
49601,4,9601,[427 515 318  79 588],18,5,43614,4.542178712768173,40.0,0.0
49602,4,9602,[427 515 318  79 588],18,5,43619,4.542226387587212,40.0,0.0
49603,4,9603,[185 234 174 385 427],5,2,43621,4.541961682632237,20.0,0.0
49604,4,9604,[515 318 427  79 588],716,5,43626,4.54200937011973,40.0,0.0
49605,4,9605,[ 64 179 328 273 471],450,4,43630,4.541952946075369,20.0,0.0
49606,4,9606,[515 318 427  79 588],807,5,43635,4.5420006245446025,40.0,0.0
49607,4,9607,[132 172 475 313 191],655,3,43638,4.541840133222315,0.0,0.0
49608,4,9608,[515 318 427  79 588],18,5,43643,4.541887813508169,40.0,0.0
49609,4,9609,[515 318 427  79 588],716,5,43648,4.541935483870968,40.0,0.0
49610,4,9610,[515 318 427  79 588],807,5,43653,4.541983144313807,40.0,0.0
49611,4,9611,[515 318 427  79 588],716,5,43658,4.542030794839784,40.0,0.0
49612,4,9612,[515 318 427  79 588],716,5,43663,4.542078435451992,40.0,0.0
49613,4,9613,[515 318 427  79 588],807,5,43668,4.542126066153526,40.0,0.0
49614,4,9614,[515 318 427  79 588],716,5,43673,4.542173686947478,40.0,0.0
49615,4,9615,[515 318 427  79 588],807,5,43678,4.542221297836939,40.0,0.0
49616,4,9616,[515 318 427  79 588],18,5,43683,4.5422688988249975,40.0,0.0
49617,4,9617,[515 318 427  79 588],807,5,43688,4.542316489914743,40.0,0.0
49618,4,9618,[515 318 427  79 588],18,5,43693,4.5423640711092625,40.0,0.0
49619,4,9619,[210 180 191 195 318],693,2,43695,4.542099792099792,20.0,0.0
49620,4,9620,[515 318 427  79 588],716,5,43700,4.542147385926619,40.0,0.0
49621,4,9621,[515 318 427  79 588],716,5,43705,4.542194969860736,40.0,0.0
49622,4,9622,[237 100 127 181 678],280,1,43706,4.5418268731164915,0.0,40.0
49623,4,9623,[515 318 427  79 588],18,5,43711,4.541874480465503,40.0,0.0
49624,4,9624,[515 318 427  79 588],807,5,43716,4.541922077922078,40.0,0.0
49625,4,9625,[515 318 427  79 588],807,5,43721,4.5419696654893,40.0,0.0
49626,4,9626,[515 318 427  79 588],716,5,43726,4.542017243170251,40.0,0.0
49627,4,9627,[515 318 427  79 588],807,5,43731,4.54206481096801,40.0,0.0
49628,4,9628,[515 318 427  79 588],716,5,43736,4.5421123688856575,40.0,0.0
49629,4,9629,[258 125 269  50 275],796,4,43740,4.542056074766355,0.0,40.0
49630,4,9630,[515 318 427  79 588],807,5,43745,4.542103623715087,40.0,0.0
49631,4,9631,[515 318 427  79 588],18,5,43750,4.542151162790698,40.0,0.0
49632,4,9632,[286  98 176  88 546],503,4,43754,4.542094882175854,0.0,20.0
49633,4,9633,[515 318 427  79 588],807,5,43759,4.542142412289807,40.0,0.0
49634,4,9634,[515 318 427  79 588],18,5,43764,4.542189932537624,40.0,0.0
49635,4,9635,[515 318 427  79 588],807,5,43769,4.542237442922374,40.0,0.0
49636,4,9636,[ 69 294  25 185 180],457,4,43773,4.542181176714745,0.0,0.0
49637,4,9637,[515 318 427  79 588],18,5,43778,4.542228678148994,40.0,0.0
49638,4,9638,[515 318 427  79 588],716,5,43783,4.54227616972715,40.0,0.0
49639,4,9639,[515 318 427  79 588],18,5,43788,4.542323651452282,40.0,0.0
49640,4,9640,[515 318 427  79 588],807,5,43793,4.542371123327456,40.0,0.0
49641,4,9641,[515 318 427  79 588],807,5,43798,4.542418585355735,40.0,0.0
49642,4,9642,[515 318 427  79 588],807,5,43803,4.542466037540184,40.0,0.0
49643,4,9643,[568 742  96 187 174],436,4,43807,4.542409788469515,0.0,0.0
49644,4,9644,[515 318 427  79 588],716,5,43812,4.542457231726283,40.0,0.0
49645,4,9645,[515 318 427  79 588],716,5,43817,4.542504665146175,40.0,0.0
49646,4,9646,[174 238 210 357 216],330,5,43822,4.542552088732249,0.0,0.0
49647,4,9647,[423 282 508 265 183],280,2,43824,4.54228855721393,0.0,0.0
49648,4,9648,[515 318 427  79 588],716,5,43829,4.542335993367188,40.0,0.0
49649,4,9649,[515 318 427  79 588],807,5,43834,4.542383419689119,40.0,0.0
49650,4,9650,[181 127 268 183  98],344,3,43837,4.54222360377163,0.0,20.0
49651,4,9651,[515 318 427  79 588],807,5,43842,4.542271031910485,40.0,0.0
49652,4,9652,[515 318 427  79 588],807,5,43847,4.542318450222728,40.0,0.0
49653,4,9653,[174 176  56 245 234],504,2,43849,4.542055106691527,0.0,0.0
49654,4,9654,[515 318 427  79 588],807,5,43854,4.542102537545313,40.0,0.0
49655,4,9655,[515 318 427  79 588],807,5,43859,4.54214995857498,40.0,0.0
49656,4,9656,[515 318 427  79 588],18,5,43864,4.542197369783577,40.0,0.0
49657,4,9657,[515 318 427  79 588],18,5,43869,4.542244771174156,40.0,0.0
49658,4,9658,[515 318 427  79 588],807,5,43874,4.542292162749767,40.0,0.0
49659,4,9659,[ 71 423 588  28 111],786,5,43879,4.542339544513458,0.0,0.0
49660,4,9660,[515 318 427  79 588],807,5,43884,4.542386916468274,40.0,0.0
49661,4,9661,[211 118 496 276 153],593,4,43888,4.542330780376734,20.0,0.0
49662,4,9662,[515 318 427  79 588],716,5,43893,4.542378143433716,40.0,0.0
49663,4,9663,[515 318 427  79 588],18,5,43898,4.542425496688741,40.0,0.0
49664,4,9664,[515 318 427  79 588],807,5,43903,4.542472840144852,40.0,0.0
49665,4,9665,[515 318 427  79 588],18,5,43908,4.54252017380509,40.0,0.0
49666,4,9666,[515 318 427  79 588],18,5,43913,4.542567497672494,40.0,0.0
49667,4,9667,[ 95 568 546 176  15],796,5,43918,4.542614811750103,0.0,0.0
49668,4,9668,[515 318 427  79 588],716,5,43923,4.5426621160409555,40.0,0.0
49669,4,9669,[ 56  70 294 508 742],655,0,43923,4.542192347466391,0.0,0.0
49670,4,9670,[515 318 427  79 588],807,5,43928,4.542239685658153,40.0,0.0
49671,4,9671,[515 318 427  79 588],18,5,43933,4.542287014061207,40.0,0.0
49672,4,9672,[515 318 427  79 588],807,5,43938,4.54233433267859,40.0,0.0
49673,4,9673,[515 318 427  79 588],716,5,43943,4.542381641513335,40.0,0.0
49674,4,9674,[515 318 427  79 588],716,5,43948,4.542428940568476,40.0,0.0
49675,4,9675,[153 211 257 196  50],796,4,43952,4.5423728813559325,0.0,20.0
49676,4,9676,[515 318 427  79 588],18,5,43957,4.542420171540766,40.0,0.0
49677,4,9677,[515 318 427  79 588],716,5,43962,4.5424674519528825,40.0,0.0
49678,4,9678,[515 318 427  79 588],716,5,43967,4.5425147225953095,40.0,0.0
49679,4,9679,[515 318 427  79 588],807,5,43972,4.542561983471074,40.0,0.0
49680,4,9680,[515 318 427  79 588],18,5,43977,4.542609234583204,40.0,0.0
49681,4,9681,[546 204  11 357 742],344,2,43979,4.542346622598637,0.0,0.0
49682,4,9682,[515 318 427  79 588],716,5,43984,4.542393886192296,40.0,0.0
49683,4,9683,[238 483 172   8 318],707,4,43988,4.542337876910367,20.0,0.0
49684,4,9684,[515 318 427  79 588],716,5,43993,4.542385131646877,40.0,0.0
49685,4,9685,[258 271 318  12  82],796,4,43997,4.542329134833781,20.0,0.0
49686,4,9686,[515 318 427  79 588],716,5,44002,4.542376380716424,40.0,0.0
49687,4,9687,[515 318 427  79 588],18,5,44007,4.542423616845582,40.0,0.0
49688,4,9688,[515 318 427  79 588],716,5,44012,4.542470843224275,40.0,0.0
49689,4,9689,[515 318 427  79 588],18,5,44017,4.542518059855521,40.0,0.0
49690,4,9690,[235 183 161 168 173],457,4,44021,4.542462078216902,0.0,0.0
49691,4,9691,[515 318 427  79 588],807,5,44026,4.542509286009079,40.0,0.0
49692,4,9692,[515 318 427  79 588],807,5,44031,4.542556484060662,40.0,0.0
49693,4,9693,[515 318 427  79 588],18,5,44036,4.542603672374665,40.0,0.0
49694,4,9694,[515 318 427  79 588],716,5,44041,4.5426508509541,40.0,0.0
49695,4,9695,[515 318 427  79 588],807,5,44046,4.54269801980198,40.0,0.0
49696,4,9696,[515 318 427  79 588],807,5,44051,4.542745178921316,40.0,0.0
49697,4,9697,[176  56 197  70 168],457,5,44056,4.542792328315117,0.0,0.0
49698,4,9698,[515 318 427  79 588],716,5,44061,4.54283946798639,40.0,0.0
49699,4,9699,[515 318 427  79 588],18,5,44066,4.5428865979381445,40.0,0.0
49700,4,9700,[ 69 111  50 238 211],716,5,44071,4.542933718173384,0.0,20.0
49701,4,9701,[515 318 427  79 588],18,5,44076,4.542980828695114,40.0,0.0
49702,4,9702,[515 318 427  79 588],18,5,44081,4.543027929506338,40.0,0.0
49703,4,9703,[515 318 427  79 588],716,5,44086,4.543075020610058,40.0,0.0
49704,4,9704,[515 318 427  79 588],716,5,44091,4.543122102009273,40.0,0.0
49705,4,9705,[515 318 427  79 588],18,5,44096,4.5431691737069855,40.0,0.0
49706,4,9706,[515 318 427  79 588],807,5,44101,4.543216235706192,40.0,0.0
49707,4,9707,[197  22 182 313 200],450,4,44105,4.543160280181294,0.0,0.0
49708,4,9708,[132 182  28 588  56],457,5,44110,4.543207333401998,0.0,0.0
49709,4,9709,[515 318 427  79 588],18,5,44115,4.5432543769309985,40.0,0.0
49710,4,9710,[515 318 427  79 588],807,5,44120,4.54330141077129,40.0,0.0
49711,4,9711,[515 318 427  79 588],716,5,44125,4.543348434925865,40.0,0.0
49712,4,9712,[515 318 427  79 588],18,5,44130,4.543395449397714,40.0,0.0
49713,4,9713,[318 202  64 238 111],655,2,44132,4.543133621577105,40.0,0.0
49714,4,9714,[515 318 427  79 588],716,5,44137,4.543180648481729,40.0,0.0
49715,4,9715,[515 318 427  79 588],18,5,44142,4.543227665706052,40.0,0.0
49716,4,9716,[515 318 427  79 588],807,5,44147,4.543274673253062,40.0,0.0
49717,4,9717,[ 88 265 385   4   1],786,5,44152,4.543321671125746,0.0,0.0
49718,4,9718,[515 318 427  79 588],807,5,44157,4.543368659327092,40.0,0.0
49719,4,9719,[ 96 202 175 216  82],457,5,44162,4.5434156378600825,0.0,0.0
49720,4,9720,[515 318 427  79 588],807,5,44167,4.543462606727703,40.0,0.0
49721,4,9721,[ 25 143   1  12  28],18,3,44170,4.543303846945073,0.0,0.0
49722,4,9722,[515 318 427  79 588],807,5,44175,4.543350817648874,40.0,0.0
49723,4,9723,[515 318 427  79 588],807,5,44180,4.543397778691896,40.0,0.0
49724,4,9724,[515 318 427  79 588],807,5,44185,4.543444730077121,40.0,0.0
49725,4,9725,[ 22 216 286 204  88],11,2,44187,4.543183220234424,0.0,20.0
49726,4,9726,[515 318 427  79 588],18,5,44192,4.543230184023851,40.0,0.0
49727,4,9727,[515 318 427  79 588],807,5,44197,4.543277138157895,40.0,0.0
49728,4,9728,[117 288  82 471 173],280,2,44199,4.543015726179464,0.0,0.0
49729,4,9729,[118 568 546   7 405],280,2,44201,4.542754367934224,0.0,0.0
49730,4,9730,[435 216 603 288 471],655,2,44203,4.542493063405611,20.0,0.0
49731,4,9731,[ 97  98 143 100 403],18,4,44207,4.542437320180847,0.0,20.0
49732,4,9732,[515 318 427  79 588],18,5,44212,4.542484331655194,40.0,0.0
49733,4,9733,[173 603 300   9  69],151,5,44217,4.54253133347031,20.0,0.0
49734,4,9734,[515 318 427  79 588],716,5,44222,4.542578325629173,40.0,0.0
49735,4,9735,[515 318 427  79 588],716,5,44227,4.542625308134758,40.0,0.0
49736,4,9736,[318 286 235 187  64],450,4,44231,4.542569579952757,40.0,20.0
49737,4,9737,[ 98 385 132 183  56],655,2,44233,4.542308482234545,0.0,0.0
49738,4,9738,[215 603 435 333 318],655,2,44235,4.542047438135332,40.0,0.0
49739,4,9739,[385 655  25 258 168],151,4,44239,4.541991786447639,0.0,0.0
49740,4,9740,[515 318 427  79 588],807,5,44244,4.542038805050816,40.0,0.0
49741,4,9741,[515 318 427  79 588],716,5,44249,4.542085814001232,40.0,0.0
49742,4,9742,[515 318 427  79 588],716,5,44254,4.5421328133018575,40.0,0.0
49743,4,9743,[515 318 427  79 588],807,5,44259,4.542179802955665,40.0,0.0
49744,4,9744,[515 318 427  79 588],18,5,44264,4.542226782965623,40.0,0.0
49745,4,9745,[655   8 211 269 268],655,0,44264,4.54176072234763,0.0,0.0
49746,4,9746,[515 318 427  79 588],18,5,44269,4.541807735713553,40.0,0.0
49747,4,9747,[185  64 273 210 216],450,3,44272,4.541649569142388,20.0,0.0
49748,4,9748,[300 111 275 202 196],629,5,44277,4.541696584265053,0.0,20.0
49749,4,9749,[546 302 385 121 483],151,2,44279,4.541435897435897,0.0,0.0
49750,4,9750,[515 318 427  79 588],807,5,44284,4.541482924828223,40.0,0.0
49751,4,9751,[515 318 427  79 588],18,5,44289,4.541529942575882,40.0,0.0
49752,4,9752,[515 318 427  79 588],716,5,44294,4.541576950681842,40.0,0.0
49753,4,9753,[515 318 427  79 588],807,5,44299,4.541623949149067,40.0,0.0
49754,4,9754,[515 318 427  79 588],716,5,44304,4.5416709379805225,40.0,0.0
49755,4,9755,[318 385 111 238 588],716,4,44308,4.541615416154162,20.0,0.0
49756,4,9756,[515 318 427  79 588],716,5,44313,4.541662396228348,40.0,0.0
49757,4,9757,[515 318 427  79 588],716,5,44318,4.541709366673499,40.0,0.0
49758,4,9758,[515 318 427  79 588],807,5,44323,4.541756327492571,40.0,0.0
49759,4,9759,[515 318 427  79 588],807,5,44328,4.5418032786885245,40.0,0.0
49760,4,9760,[515 318 427  79 588],716,5,44333,4.541850220264317,40.0,0.0
49761,4,9761,[515 318 427  79 588],18,5,44338,4.541897152222905,40.0,0.0
49762,4,9762,[515 318 427  79 588],807,5,44343,4.541944074567244,40.0,0.0
49763,4,9763,[286 172  50 282 275],655,3,44346,4.541786153215895,0.0,60.0
49764,4,9764,[515 318 427  79 588],18,5,44351,4.541833077316948,40.0,0.0
49765,4,9765,[515 318 427  79 588],716,5,44356,4.541879991808314,40.0,0.0
49766,4,9766,[197 318  79 588   7],457,5,44361,4.541926896692946,20.0,0.0
49767,4,9767,[515 318 427  79 588],716,5,44366,4.541973791973792,40.0,0.0
49768,4,9768,[515 318 427  79 588],716,5,44371,4.542020677653803,40.0,0.0
49769,4,9769,[121 234 403 202  50],655,1,44372,4.541658137154554,0.0,20.0
49770,4,9770,[515 318 427  79 588],807,5,44377,4.541705045542933,40.0,0.0
49771,4,9771,[515 318 427  79 588],18,5,44382,4.541751944330741,40.0,0.0
49772,4,9772,[515 318 427  79 588],807,5,44387,4.541798833520925,40.0,0.0
49773,4,9773,[187 515 222 191 132],655,3,44390,4.5416410886024146,0.0,0.0
49774,4,9774,[515 318 427  79 588],807,5,44395,4.541687979539642,40.0,0.0
49775,4,9775,[515 318 427  79 588],807,5,44400,4.541734860883797,40.0,0.0
49776,4,9776,[515 318 427  79 588],716,5,44405,4.541781732637824,40.0,0.0
49777,4,9777,[202 222 185 546  50],151,4,44409,4.5417263244017185,0.0,20.0
49778,4,9778,[435 135 215 222 174],72,4,44413,4.541670927497699,0.0,0.0
49779,4,9779,[515 318 427  79 588],18,5,44418,4.541717791411043,40.0,0.0
49780,4,9780,[515 318 427  79 588],807,5,44423,4.541764645741744,40.0,0.0
49781,4,9781,[194 191  28 228  64],716,5,44428,4.541811490492742,20.0,0.0
49782,4,9782,[357 176  28 121   7],450,4,44432,4.541756107533477,0.0,0.0
49783,4,9783,[515 318 427  79 588],807,5,44437,4.541802943581358,40.0,0.0
49784,4,9784,[515 318 427  79 588],18,5,44442,4.541849770056208,40.0,0.0
49785,4,9785,[515 318 427  79 588],716,5,44447,4.541896586960965,40.0,0.0
49786,4,9786,[515 318 427  79 588],807,5,44452,4.541943394298559,40.0,0.0
49787,4,9787,[515 318 427  79 588],716,5,44457,4.541990192071925,40.0,0.0
49788,4,9788,[515 318 427  79 588],807,5,44462,4.542036980283992,40.0,0.0
49789,4,9789,[515 318 427  79 588],716,5,44467,4.542083758937691,40.0,0.0
49790,4,9790,[742 172 195 174 185],450,5,44472,4.542130528035951,0.0,0.0
49791,4,9791,[515 318 427  79 588],807,5,44477,4.5421772875816995,40.0,0.0
49792,4,9792,[515 318 427  79 588],18,5,44482,4.542224037577862,40.0,0.0
49793,4,9793,[515 318 427  79 588],716,5,44487,4.542270778027364,40.0,0.0
49794,4,9794,[515 318 427  79 588],716,5,44492,4.542317508933129,40.0,0.0
49795,4,9795,[515 318 427  79 588],716,5,44497,4.542364230298081,40.0,0.0
49796,4,9796,[742 655 423 405 216],457,5,44502,4.54241094212514,0.0,0.0
49797,4,9797,[515 318 427  79 588],716,5,44507,4.542457644417228,40.0,0.0
49798,4,9798,[423 323 111 194 151],798,2,44509,4.542198183488111,0.0,0.0
49799,4,9799,[515 318 427  79 588],716,5,44514,4.542244897959184,40.0,0.0
49800,4,9800,[194 196  71 483 153],401,3,44517,4.542087542087542,0.0,0.0
49801,4,9801,[515 318 427  79 588],18,5,44522,4.54213425831463,40.0,0.0
49802,4,9802,[ 89 200 435  70  88],450,4,44526,4.542078955421809,0.0,0.0
49803,4,9803,[515 318 427  79 588],716,5,44531,4.542125662994696,40.0,0.0
49804,4,9804,[515 318 427  79 588],716,5,44536,4.5421723610402855,40.0,0.0
49805,4,9805,[235  88 100 176 181],450,4,44540,4.542117071180909,0.0,20.0
49806,4,9806,[515 318 427  79 588],18,5,44545,4.542163760579178,40.0,0.0
49807,4,9807,[515 318 427  79 588],716,5,44550,4.54221044045677,40.0,0.0
49808,4,9808,[ 15 228 289 483 300],655,1,44551,4.541849322051178,0.0,0.0
49809,4,9809,[515 318 427  79 588],18,5,44556,4.541896024464831,40.0,0.0
49810,4,9810,[515 318 427  79 588],716,5,44561,4.541942717358068,40.0,0.0
49811,4,9811,[515 318 427  79 588],18,5,44566,4.5419894007337955,40.0,0.0
49812,4,9812,[515 318 427  79 588],18,5,44571,4.542036074594925,40.0,0.0
49813,4,9813,[143 135 202 182 210],18,3,44574,4.541878948441003,0.0,0.0
49814,4,9814,[161 288 655 323 210],280,2,44576,4.541619969434539,0.0,0.0
49815,4,9815,[515 318 427  79 588],18,5,44581,4.541666666666667,40.0,0.0
49816,4,9816,[515 318 427  79 588],716,5,44586,4.54171335438525,40.0,0.0
49817,4,9817,[427 202 183   1  79],796,4,44590,4.5416581788551635,20.0,0.0
49818,4,9818,[182 132  56 144 328],629,4,44594,4.541603014563601,0.0,0.0
49819,4,9819,[ 64 273 215 234 186],450,2,44596,4.541344195519348,20.0,0.0
49820,4,9820,[515 318 427  79 588],18,5,44601,4.541390897057326,40.0,0.0
49821,4,9821,[515 318 427  79 588],807,5,44606,4.541437589085726,40.0,0.0
49822,4,9822,[515 318 427  79 588],18,5,44611,4.541484271607452,40.0,0.0
49823,4,9823,[515 318 427  79 588],18,5,44616,4.541530944625407,40.0,0.0
49824,4,9824,[515 318 427  79 588],18,5,44621,4.541577608142494,40.0,0.0
49825,4,9825,[301 405 268  28 483],655,1,44622,4.5412171789130875,0.0,0.0
49826,4,9826,[210 294 125 153 151],796,3,44625,4.541060343950341,0.0,0.0
49827,4,9827,[ 15 151 204 301  50],296,3,44628,4.540903540903541,0.0,20.0
49828,4,9828,[515 318 427  79 588],807,5,44633,4.540950249262387,40.0,0.0
49829,4,9829,[515 318 427  79 588],807,5,44638,4.540996948118006,40.0,0.0
49830,4,9830,[153 187 588 427  88],796,5,44643,4.541043637473298,20.0,0.0
49831,4,9831,[515 318 427  79 588],18,5,44648,4.541090317331164,40.0,0.0
49832,4,9832,[515 318 427  79 588],807,5,44653,4.5411369876944985,40.0,0.0
49833,4,9833,[228 202 135  70  82],457,5,44658,4.541183648566199,0.0,0.0
49834,4,9834,[515 318 427  79 588],807,5,44663,4.541230299949161,40.0,0.0
49835,4,9835,[515 318 427  79 588],807,5,44668,4.541276941846279,40.0,0.0
49836,4,9836,[183 143 202   9 100],151,3,44671,4.541120260241944,0.0,20.0
49837,4,9837,[515 318 427  79 588],18,5,44676,4.541166903842244,40.0,0.0
49838,4,9838,[515 318 427  79 588],807,5,44681,4.541213537961175,40.0,0.0
49839,4,9839,[196   9 168  64 216],18,3,44684,4.541056910569106,20.0,0.0
49840,4,9840,[515 318 427  79 588],716,5,44689,4.541103546387562,40.0,0.0
49841,4,9841,[515 318 427  79 588],807,5,44694,4.54115017272912,40.0,0.0
49842,4,9842,[515 318 427  79 588],18,5,44699,4.541196789596667,40.0,0.0
49843,4,9843,[313 237 276  89 271],655,3,44702,4.541040227549776,0.0,0.0
49844,4,9844,[515 318 427  79 588],716,5,44707,4.541086846114779,40.0,0.0
49845,4,9845,[210 216 204 127 318],786,5,44712,4.541133455210238,20.0,20.0
49846,4,9846,[515 318 427  79 588],716,5,44717,4.541180054839037,40.0,0.0
49847,4,9847,[515 318 427  79 588],18,5,44722,4.541226645004062,40.0,0.0
49848,4,9848,[385 172 204 180 427],450,5,44727,4.541273225708194,20.0,0.0
49849,4,9849,[515 318 427  79 588],18,5,44732,4.541319796954315,40.0,0.0
49850,4,9850,[515 318 427  79 588],716,5,44737,4.5413663587453055,40.0,0.0
49851,4,9851,[ 12  22 172  97 151],450,5,44742,4.541412911084044,0.0,0.0
49852,4,9852,[ 70 195   9 175 301],655,0,44742,4.540951994316452,0.0,0.0
49853,4,9853,[515 318 427  79 588],18,5,44747,4.540998579257154,40.0,0.0
49854,4,9854,[515 318 427  79 588],716,5,44752,4.5410451547437845,40.0,0.0
49855,4,9855,[515 318 427  79 588],807,5,44757,4.541091720779221,40.0,0.0
49856,4,9856,[515 318 427  79 588],807,5,44762,4.541138277366339,40.0,0.0
49857,4,9857,[515 318 427  79 588],716,5,44767,4.541184824508014,40.0,0.0
49858,4,9858,[515 318 427  79 588],716,5,44772,4.54123136220712,40.0,0.0
49859,4,9859,[318 100  98  89 435],151,4,44776,4.541176470588235,20.0,20.0
49860,4,9860,[210   4 127 181 588],457,5,44781,4.541222999695771,0.0,20.0
49861,4,9861,[515 318 427  79 588],807,5,44786,4.541269519367268,40.0,0.0
49862,4,9862,[515 318 427  79 588],716,5,44791,4.541316029605596,40.0,0.0
49863,4,9863,[515 318 427  79 588],18,5,44796,4.541362530413625,40.0,0.0
49864,4,9864,[515 318 427  79 588],807,5,44801,4.541409021794222,40.0,0.0
49865,4,9865,[515 318 427  79 588],18,5,44806,4.541455503750253,40.0,0.0
49866,4,9866,[515 318 427  79 588],807,5,44811,4.541501976284585,40.0,0.0
49867,4,9867,[216 200 210 121 153],504,4,44815,4.541447101743008,0.0,0.0
49868,4,9868,[234  64  79  88  56],18,3,44818,4.541290910933225,20.0,0.0
49869,4,9869,[515 318 427  79 588],716,5,44823,4.541337386018237,40.0,0.0
49870,4,9870,[515 318 427  79 588],18,5,44828,4.541383851686759,40.0,0.0
49871,4,9871,[234  88  69 200  98],280,3,44831,4.541227714748785,0.0,0.0
49872,4,9872,[515 318 427  79 588],807,5,44836,4.541274182112833,40.0,0.0
49873,4,9873,[515 318 427  79 588],807,5,44841,4.541320640064817,40.0,0.0
49874,4,9874,[515 318 427  79 588],18,5,44846,4.541367088607595,40.0,0.0
49875,4,9875,[ 56 118 176  25 228],151,3,44849,4.541211016605914,0.0,0.0
49876,4,9876,[515 318 427  79 588],716,5,44854,4.541257466842159,40.0,0.0
49877,4,9877,[515 318 427  79 588],18,5,44859,4.541303907673618,40.0,0.0
49878,4,9878,[515 318 427  79 588],18,5,44864,4.541350339103148,40.0,0.0
49879,4,9879,[ 69 125 182 357 183],796,5,44869,4.541396761133603,0.0,0.0
49880,4,9880,[135 186 181 179  69],655,2,44871,4.5411395607732015,0.0,0.0
49881,4,9881,[187 258 176 228  98],796,5,44876,4.541185994737908,0.0,0.0
49882,4,9882,[515 318 427  79 588],807,5,44881,4.541232419305879,40.0,0.0
49883,4,9883,[515 318 427  79 588],807,5,44886,4.541278834479968,40.0,0.0
49884,4,9884,[ 28 286 318 191 301],796,2,44888,4.541021750126454,20.0,20.0
49885,4,9885,[238  22 186 132 168],18,4,44892,4.540967024074448,0.0,0.0
49886,4,9886,[515 318 427  79 588],807,5,44897,4.541013452007687,40.0,0.0
49887,4,9887,[515 318 427  79 588],18,5,44902,4.5410598705501615,40.0,0.0
49888,4,9888,[515 318 427  79 588],807,5,44907,4.541106279704723,40.0,0.0
49889,4,9889,[515 318 427  79 588],18,5,44912,4.541152679474217,40.0,0.0
49890,4,9890,[ 70 153 508 546 118],280,3,44915,4.54099686583763,0.0,0.0
49891,4,9891,[125 286  50 588 655],786,5,44920,4.541043267286696,0.0,40.0
49892,4,9892,[515 318 427  79 588],18,5,44925,4.5410896593551,40.0,0.0
49893,4,9893,[515 318 427  79 588],807,5,44930,4.541136042045684,40.0,0.0
49894,4,9894,[515 318 427  79 588],716,5,44935,4.541182415361294,40.0,0.0
49895,4,9895,[515 318 427  79 588],807,5,44940,4.541228779304769,40.0,0.0
49896,4,9896,[515 318 427  79 588],18,5,44945,4.541275133878953,40.0,0.0
49897,4,9897,[515 318 427  79 588],18,5,44950,4.541321479086684,40.0,0.0
49898,4,9898,[515 318 427  79 588],18,5,44955,4.541367814930801,40.0,0.0
49899,4,9899,[515 318 427  79 588],716,5,44960,4.541414141414141,40.0,0.0
49900,4,9900,[204 742 197 273 211],796,1,44961,4.541056458943541,0.0,0.0
49901,4,9901,[515 318 427  79 588],716,5,44966,4.541102807513633,40.0,0.0
49902,4,9902,[515 318 427  79 588],716,5,44971,4.541149146723215,40.0,0.0
49903,4,9903,[515 318 427  79 588],18,5,44976,4.541195476575121,40.0,0.0
49904,4,9904,[515 318 427  79 588],18,5,44981,4.5412417970721854,40.0,0.0
49905,4,9905,[161 289 144 195 183],655,1,44982,4.540884312537856,0.0,0.0
49906,4,9906,[515 318 427  79 588],807,5,44987,4.540930655092359,40.0,0.0
49907,4,9907,[515 318 427  79 588],18,5,44992,4.5409769882922895,40.0,0.0
49908,4,9908,[515 318 427  79 588],18,5,44997,4.541023312140478,40.0,0.0
49909,4,9909,[515 318 427  79 588],18,5,45002,4.541069626639758,40.0,0.0
49910,4,9910,[ 22 568 183 196 403],450,5,45007,4.541115931792957,0.0,0.0
49911,4,9911,[515 318 427  79 588],716,5,45012,4.541162227602905,40.0,0.0
49912,4,9912,[423 111 143 200 185],151,4,45016,4.541107636437002,0.0,0.0
49913,4,9913,[515 318 427  79 588],807,5,45021,4.5411539237442,40.0,0.0
49914,4,9914,[515 435 153 196 100],401,4,45025,4.541099344427635,0.0,20.0
49915,4,9915,[515 318 427  79 588],716,5,45030,4.541145623235176,40.0,0.0
49916,4,9916,[515 318 427  79 588],807,5,45035,4.541191892709489,40.0,0.0
49917,4,9917,[318 286  64 183 117],655,3,45038,4.541036499294212,40.0,20.0
49918,4,9918,[204 286 197 265 215],151,4,45042,4.54098195382599,0.0,20.0
49919,4,9919,[515 318 427  79 588],716,5,45047,4.541028225806452,40.0,0.0
49920,4,9920,[121  96  50  11 186],450,3,45050,4.540872895877432,0.0,20.0
49921,4,9921,[515 318 427  79 588],716,5,45055,4.540919169522274,40.0,0.0
49922,4,9922,[515 318 427  79 588],18,5,45060,4.540965433840572,40.0,0.0
49923,4,9923,[515 318 427  79 588],807,5,45065,4.541011688835147,40.0,0.0
49924,4,9924,[515 318 427  79 588],18,5,45070,4.5410579345088165,40.0,0.0
49925,4,9925,[515 318 427  79 588],716,5,45075,4.541104170864396,40.0,0.0
49926,4,9926,[515 318 427  79 588],18,5,45080,4.541150397904705,40.0,0.0
49927,4,9927,[515 318 427  79 588],807,5,45085,4.541196615632554,40.0,0.0
49928,4,9928,[515 318 427  79 588],807,5,45090,4.5412428240507605,40.0,0.0
49929,4,9929,[515 318 427  79 588],807,5,45095,4.541289023162135,40.0,0.0
49930,4,9930,[515 318 427  79 588],18,5,45100,4.541335212969489,40.0,0.0
49931,4,9931,[127 202  28 143  15],655,2,45102,4.541079339508659,0.0,20.0
49932,4,9932,[515 318 427  79 588],716,5,45107,4.541125541125541,40.0,0.0
49933,4,9933,[515 318 427  79 588],18,5,45112,4.5411717334407085,40.0,0.0
49934,4,9934,[515 318 427  79 588],18,5,45117,4.54121791645697,40.0,0.0
49935,4,9935,[515 318 427  79 588],716,5,45122,4.541264090177133,40.0,0.0
49936,4,9936,[515 318 427  79 588],18,5,45127,4.541310254604006,40.0,0.0
49937,4,9937,[515 318 427  79 588],716,5,45132,4.5413564097403905,40.0,0.0
49938,4,9938,[515 318 427  79 588],18,5,45137,4.541402555589094,40.0,0.0
49939,4,9939,[ 82  98  15 202 289],798,2,45139,4.541146881287727,0.0,0.0
49940,4,9940,[515 318 427  79 588],716,5,45144,4.541193038929685,40.0,0.0
49941,4,9941,[ 98 588 143  88 258],23,3,45147,4.54103802051901,0.0,0.0
49942,4,9942,[515 318 427  79 588],18,5,45152,4.541084179825003,40.0,0.0
49943,4,9943,[318 204  89 568 196],450,5,45157,4.541130329847144,20.0,0.0
49944,4,9944,[515 318 427  79 588],807,5,45162,4.541176470588235,40.0,0.0
49945,4,9945,[515 318 427  79 588],716,5,45167,4.541222602051076,40.0,0.0
49946,4,9946,[515 318 427  79 588],807,5,45172,4.5412687242384635,40.0,0.0
49947,4,9947,[515 318 427  79 588],716,5,45177,4.541314837153196,40.0,0.0
49948,4,9948,[187 181 471 483  28],655,2,45179,4.541059402955071,0.0,0.0
49949,4,9949,[515 313  56 132 172],655,3,45182,4.540904522613065,0.0,0.0
49950,4,9950,[515 318 427  79 588],716,5,45187,4.540950658225304,40.0,0.0
49951,4,9951,[515 318 427  79 588],716,5,45192,4.540996784565916,40.0,0.0
49952,4,9952,[515 318 427  79 588],18,5,45197,4.541042901637697,40.0,0.0
49953,4,9953,[515 318 427  79 588],716,5,45202,4.54108900944344,40.0,0.0
49954,4,9954,[515 318 427  79 588],18,5,45207,4.541135107985936,40.0,0.0
49955,4,9955,[ 50 228 322 423 153],450,5,45212,4.541181197267979,0.0,20.0
49956,4,9956,[515 318 427  79 588],716,5,45217,4.541227277292357,40.0,0.0
49957,4,9957,[515 318 427  79 588],716,5,45222,4.54127334806186,40.0,0.0
49958,4,9958,[515 318 427  79 588],807,5,45227,4.541319409579275,40.0,0.0
49959,4,9959,[515 318 427  79 588],716,5,45232,4.5413654618473895,40.0,0.0
49960,4,9960,[ 15 603 117  64 215],796,5,45237,4.541411504868989,40.0,0.0
49961,4,9961,[515 318 427  79 588],18,5,45242,4.541457538646858,40.0,0.0
49962,4,9962,[515 318 427  79 588],807,5,45247,4.54150356318378,40.0,0.0
49963,4,9963,[515 318 427  79 588],18,5,45252,4.541549578482537,40.0,0.0
49964,4,9964,[ 70  22 403 174 195],280,2,45254,4.541294530858003,0.0,0.0
49965,4,9965,[515 318 427  79 588],716,5,45259,4.5413405578968495,40.0,0.0
49966,4,9966,[174 588  89 111 275],786,5,45264,4.54138657569981,0.0,20.0
49967,4,9967,[515 318 427  79 588],716,5,45269,4.541432584269663,40.0,0.0
49968,4,9968,[515 318 427  79 588],18,5,45274,4.541478583609188,40.0,0.0
49969,4,9969,[748 197 245 196  50],450,5,45279,4.541524573721164,0.0,20.0
49970,4,9970,[ 56 194 135 427 210],269,4,45283,4.541470263764919,20.0,0.0
49971,4,9971,[515 318 427  79 588],18,5,45288,4.541516245487364,40.0,0.0
49972,4,9972,[515 318 427  79 588],716,5,45293,4.541562217988569,40.0,0.0
49973,4,9973,[515 318 427  79 588],716,5,45298,4.541608181271306,40.0,0.0
49974,4,9974,[515 318 427  79 588],716,5,45303,4.541654135338346,40.0,0.0
49975,4,9975,[  4 286 546 144 403],796,4,45307,4.541599839615076,0.0,20.0
49976,4,9976,[515 318 427  79 588],807,5,45312,4.541645785306204,40.0,0.0
49977,4,9977,[515 318 427  79 588],18,5,45317,4.541691721787934,40.0,0.0
49978,4,9978,[471 286  98 111   4],786,5,45322,4.541737649063032,0.0,20.0
49979,4,9979,[515 318 427  79 588],807,5,45327,4.541783567134268,40.0,0.0
49980,4,9980,[515 318 427  79 588],807,5,45332,4.541829476004408,40.0,0.0
49981,4,9981,[515 318 427  79 588],18,5,45337,4.541875375676217,40.0,0.0
49982,4,9982,[515 318 427  79 588],18,5,45342,4.5419212661524595,40.0,0.0
49983,4,9983,[ 82  69 210  50  98],796,3,45345,4.541766826923077,0.0,20.0
49984,4,9984,[515 318 427  79 588],807,5,45350,4.541812719078618,40.0,0.0
49985,4,9985,[515 318 427  79 588],18,5,45355,4.54185860204286,40.0,0.0
49986,4,9986,[  9 132 268  11 182],535,3,45358,4.541704215480125,0.0,0.0
49987,4,9987,[515 318 427  79 588],807,5,45363,4.541750100120145,40.0,0.0
49988,4,9988,[515 318 427  79 588],716,5,45368,4.54179597557313,40.0,0.0
49989,4,9989,[515 318 427  79 588],716,5,45373,4.541841841841842,40.0,0.0
49990,4,9990,[515 318 427  79 588],807,5,45378,4.541887698929036,40.0,0.0
49991,4,9991,[515 318 427  79 588],807,5,45383,4.54193354683747,40.0,0.0
49992,4,9992,[143 568 228 405   4],796,5,45388,4.541979385569899,0.0,0.0
49993,4,9993,[ 15 111 144 125 179],457,4,45392,4.541925155093056,0.0,0.0
49994,4,9994,[515 318 427  79 588],716,5,45397,4.541970985492746,40.0,0.0
49995,4,9995,[515 318 427  79 588],18,5,45402,4.542016806722689,40.0,0.0
49996,4,9996,[515 318 427  79 588],716,5,45407,4.542062618785636,40.0,0.0
49997,4,9997,[ 70 143 179 194 294],457,4,45411,4.542008401680336,0.0,0.0
49998,4,9998,[100  98 197 151  82],269,4,45415,4.541954195419542,0.0,20.0
49999,4,9999,[132 173  15  88 546],457,4,45419,4.5419,0.0,0.0
