,iteration,visit,item_id_list,visitor_id,reward,total_reward,fraction_relevant,percentage_overlap_rating,percentage_overlap_like
0,0,0,[216  95 257 265 196],92,2,2,2.0,0.0,0.0
1,0,1,[143 515 322 196 265],207,3,5,2.5,0.0,0.0
2,0,2,[196 143 515 265  79],234,1,6,2.0,0.0,0.0
3,0,3,[515 196 143 265  79],311,4,10,2.5,0.0,0.0
4,0,4,[515 196 265  79 143],200,5,15,3.0,0.0,0.0
5,0,5,[515 196  79 265 143],843,0,15,2.5,0.0,0.0
6,0,6,[515 196 265  79 143],815,5,20,2.857142857142857,0.0,0.0
7,0,7,[515 196  79 265 143],200,5,25,3.125,0.0,0.0
8,0,8,[515 196  79 265 143],881,4,29,3.2222222222222223,0.0,0.0
9,0,9,[515  79 265 196 143],537,1,30,3.0,0.0,0.0
10,0,10,[515  79 265 196 143],892,4,34,3.090909090909091,0.0,0.0
11,0,11,[132   1 423 496  97],313,5,39,3.25,0.0,0.0
12,0,12,[181 175  70 176 151],334,3,42,3.230769230769231,0.0,0.0
13,0,13,[496 132 423  97   1],650,2,44,3.142857142857143,0.0,0.0
14,0,14,[228  98 151  28 405],788,3,47,3.1333333333333333,0.0,20.0
15,0,15,[405  28 496 132  98],85,4,51,3.1875,0.0,20.0
16,0,16,[ 28 496 132  98 181],380,4,55,3.235294117647059,0.0,20.0
17,0,17,[222  96 678 403 121],881,2,57,3.1666666666666665,0.0,0.0
18,0,18,[222 121 175  28 496],479,4,61,3.210526315789474,0.0,0.0
19,0,19,[222 121 175  28 132],815,3,64,3.2,0.0,0.0
20,0,20,[222  28 132  98 515],290,3,67,3.1904761904761907,0.0,20.0
21,0,21,[222  28  98 132 515],13,3,70,3.1818181818181817,0.0,20.0
22,0,22,[ 28  98 132 222 496],804,5,75,3.260869565217391,0.0,20.0
23,0,23,[ 28  98 132 222 496],815,5,80,3.3333333333333335,0.0,20.0
24,0,24,[ 28  98 132 222 496],378,3,83,3.32,0.0,20.0
25,0,25,[237  97  88 175 276],474,5,88,3.3846153846153846,0.0,0.0
26,0,26,[238 288 294 603 234],804,4,92,3.4074074074074074,20.0,0.0
27,0,27,[215 187 385 322 546],13,2,94,3.357142857142857,0.0,0.0
28,0,28,[215 197 508  89  22],774,0,94,3.2413793103448274,0.0,0.0
29,0,29,[132  98 176  97 301],499,5,99,3.3,0.0,20.0
30,0,30,[175  50 100 191  64],194,3,102,3.2903225806451615,0.0,40.0
31,0,31,[276 191 234 187 237],343,4,106,3.3125,0.0,0.0
32,0,32,[100 288 185 175  28],474,4,110,3.3333333333333335,0.0,20.0
33,0,33,[313 597  64 216 282],533,4,114,3.3529411764705883,0.0,0.0
34,0,34,[127 196 173  88  69],95,5,119,3.4,0.0,20.0
35,0,35,[276 191 603  88 185],271,3,122,3.388888888888889,20.0,0.0
36,0,36,[ 98 215 423 508 143],533,5,127,3.4324324324324325,0.0,20.0
37,0,37,[186 245 183 318 603],666,3,130,3.4210526315789473,40.0,0.0
38,0,38,[196 222 182   1   4],194,2,132,3.3846153846153846,0.0,0.0
39,0,39,[  9 161 275 194 181],474,4,136,3.4,0.0,0.0
40,0,40,[603  69   4 313 301],13,4,140,3.4146341463414633,20.0,0.0
41,0,41,[603 100   4 313  98],533,4,144,3.4285714285714284,20.0,40.0
42,0,42,[258 175 471 135 237],6,2,146,3.395348837209302,0.0,0.0
43,0,43,[216 289  79 405 258],537,1,147,3.340909090909091,0.0,0.0
44,0,44,[237 257 515 423   4],666,2,149,3.311111111111111,0.0,0.0
45,0,45,[603  69 294 313  98],271,4,153,3.3260869565217392,20.0,20.0
46,0,46,[301 153 286 174 127],184,2,155,3.297872340425532,0.0,40.0
47,0,47,[144  56 483 175 195],385,3,158,3.2916666666666665,20.0,0.0
48,0,48,[197 300 318 496 176],533,4,162,3.306122448979592,20.0,0.0
49,0,49,[179 200 210  15 211],537,2,164,3.28,0.0,0.0
50,0,50,[302 151 182 273 475],537,3,167,3.2745098039215685,0.0,0.0
51,0,51,[ 56 286 515 172 265],60,5,172,3.3076923076923075,0.0,0.0
52,0,52,[282   9 302 100  56],271,3,175,3.30188679245283,0.0,20.0
53,0,53,[187 132 117 176 216],346,3,178,3.2962962962962963,0.0,0.0
54,0,54,[ 15   1 328 127  96],95,5,183,3.327272727272727,0.0,20.0
55,0,55,[125 172 655 181 135],334,3,186,3.3214285714285716,0.0,0.0
56,0,56,[194 496   8 222 275],474,4,190,3.3333333333333335,0.0,0.0
57,0,57,[655  64 475  88 211],339,5,195,3.3620689655172415,0.0,0.0
58,0,58,[323 405 273 313 258],894,2,197,3.3389830508474576,0.0,0.0
59,0,59,[191  97 132   4 100],7,5,202,3.3666666666666667,0.0,20.0
60,0,60,[186 132 258 125 678],92,3,205,3.360655737704918,0.0,0.0
61,0,61,[655 100  69  28 183],92,4,209,3.370967741935484,0.0,20.0
62,0,62,[ 12 322  70 313 603],90,5,214,3.3968253968253967,40.0,0.0
63,0,63,[265 301 202 186 195],378,1,215,3.359375,0.0,0.0
64,0,64,[196 318 210 357 268],288,4,219,3.3692307692307693,40.0,0.0
65,0,65,[143 496 234  12 423],538,3,222,3.3636363636363638,20.0,0.0
66,0,66,[ 82 202 427 161 186],295,5,227,3.388059701492537,0.0,0.0
67,0,67,[191 204 127  50 234],232,3,230,3.3823529411764706,0.0,40.0
68,0,68,[655  69 183 483 117],339,4,234,3.391304347826087,20.0,0.0
69,0,69,[ 89  70 185 286 328],788,5,239,3.414285714285714,0.0,0.0
70,0,70,[234 301 173 471 181],524,4,243,3.4225352112676055,0.0,0.0
71,0,71,[655 135 357 183 483],749,5,248,3.4444444444444446,40.0,0.0
72,0,72,[282 678 237 268 301],334,3,251,3.4383561643835616,0.0,0.0
73,0,73,[655 135 357 183 483],840,5,256,3.4594594594594597,40.0,0.0
74,0,74,[655 135 357 183 483],474,5,261,3.48,40.0,0.0
75,0,75,[655 135 357 183 483],339,5,266,3.5,40.0,0.0
76,0,76,[655 135 357 183 483],749,5,271,3.5194805194805197,40.0,0.0
77,0,77,[ 82   1 191  50 228],343,5,276,3.5384615384615383,0.0,20.0
78,0,78,[655 135 357 183 483],59,5,281,3.5569620253164556,40.0,0.0
79,0,79,[210 186  98 322 100],749,4,285,3.5625,0.0,40.0
80,0,80,[655 603 357 183 483],643,5,290,3.580246913580247,60.0,0.0
81,0,81,[655 603 357 183 483],815,3,293,3.573170731707317,60.0,0.0
82,0,82,[  9  82  12 318 194],308,5,298,3.5903614457831323,40.0,0.0
83,0,83,[143 471 300 318  12],533,5,303,3.607142857142857,40.0,0.0
84,0,84,[161 173 174  89 132],59,4,307,3.611764705882353,0.0,20.0
85,0,85,[183 191   9 204 427],6,4,311,3.616279069767442,0.0,0.0
86,0,86,[183 191   9 427  82],194,3,314,3.6091954022988504,0.0,0.0
87,0,87,[174 300 195 271   1],788,1,315,3.5795454545454546,0.0,20.0
88,0,88,[357 475 483 302 211],343,5,320,3.595505617977528,40.0,0.0
89,0,89,[357 475 483 302 211],474,5,325,3.611111111111111,40.0,0.0
90,0,90,[357 475 483 302 211],833,2,327,3.5934065934065935,40.0,0.0
91,0,91,[357 483 318  88 135],311,5,332,3.608695652173913,60.0,0.0
92,0,92,[ 96 282  69 132  88],95,4,336,3.6129032258064515,0.0,0.0
93,0,93,[357 483 318  88 135],815,4,340,3.617021276595745,60.0,0.0
94,0,94,[245 597 215 318 275],605,2,342,3.6,20.0,0.0
95,0,95,[357 427 318  88  64],533,4,346,3.6041666666666665,40.0,0.0
96,0,96,[180  82 172 202  12],59,5,351,3.618556701030928,20.0,0.0
97,0,97,[258 135 216  50 210],64,3,354,3.6122448979591835,0.0,20.0
98,0,98,[483  69 427  12  88],13,5,359,3.6262626262626263,40.0,0.0
99,0,99,[483  69 427  12  88],406,4,363,3.63,40.0,0.0
100,0,100,[204 258  88 289 200],13,3,366,3.623762376237624,0.0,0.0
101,0,101,[483  69 427  12 318],537,3,369,3.6176470588235294,60.0,0.0
102,0,102,[483  98 427 318 194],899,5,374,3.6310679611650487,40.0,20.0
103,0,103,[483  98 427 318 194],694,5,379,3.644230769230769,40.0,20.0
104,0,104,[483  98 427 318 194],7,5,384,3.657142857142857,40.0,20.0
105,0,105,[483  98 427 318 194],666,4,388,3.660377358490566,40.0,20.0
106,0,106,[483 179 427 318 180],59,5,393,3.6728971962616823,40.0,0.0
107,0,107,[483 179 427 318 180],666,5,398,3.685185185185185,40.0,0.0
108,0,108,[748 100  64 435  50],474,4,402,3.688073394495413,0.0,40.0
109,0,109,[183  98  22 216 286],883,2,404,3.672727272727273,0.0,20.0
110,0,110,[180 179 427 435 318],537,4,408,3.675675675675676,20.0,0.0
111,0,111,[318  70  50 742 135],328,4,412,3.6785714285714284,20.0,20.0
112,0,112,[289  56 185 143 357],537,3,415,3.672566371681416,20.0,0.0
113,0,113,[179 180  64 191 483],458,5,420,3.6842105263157894,20.0,0.0
114,0,114,[179 180  64 191 483],13,3,423,3.6782608695652175,20.0,0.0
115,0,115,[121 210 318  70 181],536,4,427,3.6810344827586206,20.0,0.0
116,0,116,[ 89 475 153 258  22],90,3,430,3.675213675213675,0.0,0.0
117,0,117,[748 271  11 186 313],328,2,432,3.6610169491525424,0.0,0.0
118,0,118,[228 153 200  88 151],95,4,436,3.6638655462184873,0.0,0.0
119,0,119,[ 88 204 385 196  69],653,3,439,3.658333333333333,0.0,0.0
120,0,120,[132  98 333   4 289],533,3,442,3.652892561983471,0.0,20.0
121,0,121,[ 88 475 144 216 282],92,3,445,3.6475409836065573,0.0,0.0
122,0,122,[118  28 496 323 195],648,5,450,3.658536585365854,0.0,0.0
123,0,123,[ 70 318 323 322  71],454,2,452,3.6451612903225805,20.0,0.0
124,0,124,[ 95 191 127 194  25],881,3,455,3.64,0.0,20.0
125,0,125,[ 11 125  56  28  15],200,5,460,3.6507936507936507,0.0,0.0
126,0,126,[357 234 111  28 403],643,4,464,3.6535433070866143,20.0,0.0
127,0,127,[121 234 318  71  98],64,3,467,3.6484375,20.0,20.0
128,0,128,[483   9 427  64 318],308,4,471,3.6511627906976742,40.0,0.0
129,0,129,[483   9 423 185 588],308,4,475,3.6538461538461537,20.0,0.0
130,0,130,[275 269  88 191 405],279,1,476,3.633587786259542,0.0,0.0
131,0,131,[186 174  95  69 176],648,3,479,3.628787878787879,0.0,20.0
132,0,132,[143 168  79 678  50],749,4,483,3.6315789473684212,0.0,20.0
133,0,133,[175 471 179  64 197],343,5,488,3.6417910447761193,0.0,0.0
134,0,134,[117 496 237 423 265],899,5,493,3.651851851851852,0.0,0.0
135,0,135,[328 182  95 186  97],234,0,493,3.625,0.0,0.0
136,0,136,[405 200 204  25 210],7,3,496,3.6204379562043796,0.0,0.0
137,0,137,[748 181 323  97 515],488,4,500,3.6231884057971016,0.0,0.0
138,0,138,[588 300   9 168 118],13,3,503,3.618705035971223,0.0,0.0
139,0,139,[118 318  64 268 168],92,3,506,3.6142857142857143,20.0,0.0
140,0,140,[174 204 161 180 210],694,5,511,3.624113475177305,0.0,20.0
141,0,141,[186 143 235 597 210],308,3,514,3.619718309859155,0.0,0.0
142,0,142,[ 98 294 144 181 100],447,5,519,3.629370629370629,0.0,40.0
143,0,143,[174  22 655 202  15],406,2,521,3.6180555555555554,0.0,20.0
144,0,144,[216 173  22 180 132],6,4,525,3.6206896551724137,0.0,0.0
145,0,145,[302 100 179 275 294],10,4,529,3.6232876712328768,0.0,20.0
146,0,146,[603 318 328 238 273],234,2,531,3.6122448979591835,40.0,0.0
147,0,147,[132 423 234 427 121],848,5,536,3.6216216216216215,0.0,0.0
148,0,148,[496 194  70 333 191],506,5,541,3.6308724832214767,0.0,0.0
149,0,149,[268 269  64 180 313],85,4,545,3.6333333333333333,0.0,0.0
150,0,150,[ 96 742 748  79 216],328,3,548,3.629139072847682,0.0,0.0
151,0,151,[ 50   9 588 471 318],815,4,552,3.6315789473684212,20.0,20.0
152,0,152,[273 182 475 496 172],64,4,556,3.633986928104575,0.0,0.0
153,0,153,[135 282 117 318  15],474,5,561,3.642857142857143,20.0,0.0
154,0,154,[427 268 111   8 333],13,4,565,3.6451612903225805,0.0,0.0
155,0,155,[ 50   8 258 186  82],234,2,567,3.6346153846153846,0.0,20.0
156,0,156,[ 64 258 276 385  56],533,3,570,3.6305732484076434,0.0,0.0
157,0,157,[748 300 357 127 168],13,3,573,3.6265822784810124,20.0,20.0
158,0,158,[168  64 111   8 588],64,5,578,3.6352201257861636,0.0,0.0
159,0,159,[125 210 151 121 301],334,1,579,3.61875,0.0,0.0
160,0,160,[180 173 313 111 742],92,2,581,3.608695652173913,0.0,0.0
161,0,161,[588 313   8 168  64],233,4,585,3.611111111111111,0.0,0.0
162,0,162,[245 546 118  89  11],653,2,587,3.6012269938650308,0.0,0.0
163,0,163,[173  22 210 118 234],664,2,589,3.591463414634146,0.0,0.0
164,0,164,[181 423 176 179 313],650,3,592,3.587878787878788,0.0,0.0
165,0,165,[275 655 333  12 222],64,4,596,3.5903614457831323,20.0,0.0
166,0,166,[100 186 180 135   4],207,2,598,3.5808383233532934,0.0,20.0
167,0,167,[742  97 385 238  50],881,2,600,3.5714285714285716,0.0,20.0
168,0,168,[211  71 405 318 181],290,3,603,3.5680473372781063,20.0,0.0
169,0,169,[111 471 125  69 265],653,2,605,3.5588235294117645,0.0,0.0
170,0,170,[288 175 568   8 515],64,5,610,3.5672514619883042,0.0,0.0
171,0,171,[234  95 118 125 172],455,4,614,3.5697674418604652,0.0,0.0
172,0,172,[153 111  50 228 117],92,4,618,3.5722543352601157,0.0,20.0
173,0,173,[211 186 180 597 405],533,1,619,3.557471264367816,0.0,0.0
174,0,174,[403 183 132 216  25],313,3,622,3.5542857142857143,0.0,0.0
175,0,175,[ 98 515  96 183 588],64,5,627,3.5625,0.0,20.0
176,0,176,[ 89 175  96 228 197],95,4,631,3.5649717514124295,0.0,0.0
177,0,177,[238 168  96 175 196],738,4,635,3.567415730337079,0.0,0.0
178,0,178,[ 64 427 313 588 268],13,5,640,3.5754189944134076,0.0,0.0
179,0,179,[234 181 215  15  50],378,5,645,3.5833333333333335,0.0,20.0
180,0,180,[100 127 403  70 194],643,3,648,3.5801104972375692,0.0,40.0
181,0,181,[ 96  88 257 118 275],454,4,652,3.5824175824175826,0.0,0.0
182,0,182,[168 234 322 181 357],881,3,655,3.579234972677596,20.0,0.0
183,0,183,[ 96  28  97 186 597],59,4,659,3.5815217391304346,0.0,0.0
184,0,184,[144 265   1 132   7],343,4,663,3.5837837837837836,0.0,0.0
185,0,185,[435 194 235 180 118],328,2,665,3.575268817204301,0.0,0.0
186,0,186,[ 28  98 271 161 742],334,1,666,3.5614973262032086,0.0,20.0
187,0,187,[328 282 546  69 168],533,4,670,3.5638297872340425,0.0,0.0
188,0,188,[118 471 318 144  96],308,2,672,3.5555555555555554,20.0,0.0
189,0,189,[258  22  28 294 268],119,3,675,3.5526315789473686,0.0,0.0
190,0,190,[  7 588 313 268 427],13,4,679,3.554973821989529,0.0,0.0
191,0,191,[275 302  12 322 435],90,5,684,3.5625,20.0,0.0
192,0,192,[286  88  96 210 117],537,0,684,3.5440414507772022,0.0,0.0
193,0,193,[ 89 100 118 546 286],343,2,686,3.536082474226804,0.0,20.0
194,0,194,[173 294 211  70 318],194,4,690,3.5384615384615383,20.0,0.0
195,0,195,[176 216 181 237 483],892,5,695,3.545918367346939,20.0,0.0
196,0,196,[313 568 588  64 268],537,2,697,3.5380710659898478,0.0,0.0
197,0,197,[121 153 288 196 132],650,3,700,3.5353535353535355,0.0,0.0
198,0,198,[195 202 144 153 603],840,3,703,3.5326633165829144,20.0,0.0
199,0,199,[313 268 427 318  98],537,4,707,3.535,20.0,20.0
200,0,200,[313 268 427 318  64],234,4,711,3.537313432835821,20.0,0.0
201,0,201,[313 427 318  64 183],59,5,716,3.5445544554455446,20.0,0.0
202,0,202,[313 427 318  64 183],328,4,720,3.5467980295566504,20.0,0.0
203,0,203,[313 318 427  64 183],537,3,723,3.5441176470588234,20.0,0.0
204,0,204,[185 238  98 182 172],64,5,728,3.551219512195122,0.0,20.0
205,0,205,[313 318 427 483  98],537,4,732,3.5533980582524274,40.0,20.0
206,0,206,[313 318 427 483 603],13,4,736,3.5555555555555554,60.0,0.0
207,0,207,[117 269 435  79 323],90,3,739,3.5528846153846154,0.0,0.0
208,0,208,[313 427 318 483 603],91,5,744,3.5598086124401913,60.0,0.0
209,0,209,[313 427 318 483 603],234,5,749,3.566666666666667,60.0,0.0
210,0,210,[176  11 182   7  50],234,1,750,3.5545023696682465,0.0,20.0
211,0,211,[313 427 318 483 603],474,5,755,3.561320754716981,60.0,0.0
212,0,212,[ 96 546 403  71 121],308,3,758,3.5586854460093895,0.0,0.0
213,0,213,[313 427 318 483 603],334,5,763,3.5654205607476634,60.0,0.0
214,0,214,[176 275  22 144 143],694,5,768,3.572093023255814,0.0,0.0
215,0,215,[313 427 318 483 603],234,5,773,3.5787037037037037,60.0,0.0
216,0,216,[313 427 318 483 603],454,4,777,3.5806451612903225,60.0,0.0
217,0,217,[313 427 318 603 483],59,5,782,3.5871559633027523,60.0,0.0
218,0,218,[186  11  89 258 271],749,5,787,3.593607305936073,0.0,0.0
219,0,219,[313 427 318 603 483],308,3,790,3.590909090909091,60.0,0.0
220,0,220,[174 182 258 423  71],479,3,793,3.588235294117647,0.0,20.0
221,0,221,[427 313 318 603 268],334,5,798,3.5945945945945947,40.0,0.0
222,0,222,[546 121 603 211 176],60,5,803,3.600896860986547,20.0,0.0
223,0,223,[ 15 289 275 179 197],406,3,806,3.5982142857142856,0.0,0.0
224,0,224,[405  11 273  25 179],92,3,809,3.5955555555555554,0.0,0.0
225,0,225,[195 282  79 135 187],328,2,811,3.588495575221239,0.0,0.0
226,0,226,[234 181 405 100 144],488,2,813,3.5814977973568283,0.0,20.0
227,0,227,[427 313 318 603 268],13,4,817,3.5833333333333335,40.0,0.0
228,0,228,[191 132 276 301 175],6,3,820,3.5807860262008733,0.0,0.0
229,0,229,[143 515 182 289  64],537,2,822,3.5739130434782607,0.0,0.0
230,0,230,[288 318 181 275 180],533,3,825,3.5714285714285716,20.0,0.0
231,0,231,[357   8 216 191 125],881,5,830,3.5775862068965516,20.0,0.0
232,0,232,[ 69 127 568  70 588],881,2,832,3.570815450643777,0.0,20.0
233,0,233,[151 322 117 197  79],749,5,837,3.576923076923077,0.0,0.0
234,0,234,[176 210   4 588 187],326,0,837,3.5617021276595744,0.0,0.0
235,0,235,[427 313 603 318 268],537,5,842,3.5677966101694913,40.0,0.0
236,0,236,[427 313 603 318 268],234,4,846,3.569620253164557,40.0,0.0
237,0,237,[427 313 603 318 357],271,5,851,3.5756302521008405,60.0,0.0
238,0,238,[427 313 603 318 357],271,5,856,3.581589958158996,60.0,0.0
239,0,239,[427 313 603 318 357],13,3,859,3.5791666666666666,60.0,0.0
240,0,240,[427 313 603 318  12],59,5,864,3.5850622406639006,60.0,0.0
241,0,241,[187  89 143  28 288],643,4,868,3.5867768595041323,0.0,0.0
242,0,242,[257 265  70 313  98],378,5,873,3.5925925925925926,0.0,20.0
243,0,243,[318 546 211 301 471],328,2,875,3.5860655737704916,20.0,0.0
244,0,244,[222 508 273 200  25],537,1,876,3.5755102040816324,0.0,0.0
245,0,245,[427 313 603 318  12],271,5,881,3.5813008130081303,60.0,0.0
246,0,246,[211 144 168 742 322],749,5,886,3.5870445344129553,0.0,0.0
247,0,247,[318   7 475 333 508],537,4,890,3.588709677419355,20.0,0.0
248,0,248,[211  71 483 282 204],479,4,894,3.5903614457831323,20.0,0.0
249,0,249,[ 96 172 405 176 588],59,3,897,3.588,0.0,0.0
250,0,250,[161 423  11  28 385],897,3,900,3.585657370517928,0.0,0.0
251,0,251,[427 313 603 318  12],234,4,904,3.5873015873015874,60.0,0.0
252,0,252,[427 313 603 318 483],90,5,909,3.5928853754940713,60.0,0.0
253,0,253,[318 181 237 194  88],207,3,912,3.590551181102362,20.0,0.0
254,0,254,[176   8 237  69 235],398,2,914,3.5843137254901962,0.0,0.0
255,0,255,[427 313 603 318 483],59,5,919,3.58984375,60.0,0.0
256,0,256,[427 313 603 318 483],454,4,923,3.5914396887159534,60.0,0.0
257,0,257,[ 15 194 174  70 357],271,4,927,3.5930232558139537,20.0,20.0
258,0,258,[403 215 234 182 161],346,1,928,3.583011583011583,0.0,0.0
259,0,259,[168  50 603 175 215],537,4,932,3.5846153846153848,20.0,20.0
260,0,260,[427 313 603 318  28],334,4,936,3.586206896551724,40.0,0.0
261,0,261,[211 302 300 117 357],537,3,939,3.5839694656488548,20.0,0.0
262,0,262,[427 313 603 318 183],474,5,944,3.5893536121673004,40.0,0.0
263,0,263,[427 313 603 318 183],780,2,946,3.5833333333333335,40.0,0.0
264,0,264,[ 89 143  98 125 483],374,2,948,3.577358490566038,20.0,20.0
265,0,265,[403 117  64 289 323],328,3,951,3.575187969924812,0.0,0.0
266,0,266,[471 121 288 135  25],474,3,954,3.5730337078651684,0.0,0.0
267,0,267,[179 118 216 176 196],378,4,958,3.574626865671642,0.0,0.0
268,0,268,[313 427 603 318  98],91,5,963,3.579925650557621,40.0,20.0
269,0,269,[ 88 153 216 300 748],479,2,965,3.574074074074074,0.0,0.0
270,0,270,[161 183  97 357 132],60,4,969,3.5756457564575648,20.0,0.0
271,0,271,[597 216 144 204 245],804,4,973,3.577205882352941,0.0,0.0
272,0,272,[313 427 603 318  98],780,2,975,3.5714285714285716,40.0,20.0
273,0,273,[435 273 204  97 405],524,2,977,3.565693430656934,0.0,0.0
274,0,274,[194 118 742  82 153],454,2,979,3.56,0.0,0.0
275,0,275,[100 180  70 294 210],311,4,983,3.5615942028985508,0.0,20.0
276,0,276,[ 89 508  28 483 197],406,4,987,3.563176895306859,20.0,0.0
277,0,277,[300  70 405  64  79],84,4,991,3.564748201438849,0.0,0.0
278,0,278,[313 427 318 603   9],474,5,996,3.5698924731182795,40.0,0.0
279,0,279,[ 71 318 508  64  96],474,4,1000,3.5714285714285716,20.0,0.0
280,0,280,[197  82 181 210 588],326,1,1001,3.5622775800711746,0.0,0.0
281,0,281,[222 196  82 403 210],290,4,1005,3.5638297872340425,0.0,0.0
282,0,282,[204 179 202 357 318],13,2,1007,3.558303886925795,40.0,0.0
283,0,283,[125  96  79  56 496],653,3,1010,3.556338028169014,0.0,0.0
284,0,284,[313 427 318 603   9],234,4,1014,3.557894736842105,40.0,0.0
285,0,285,[313 427 318 603 302],537,5,1019,3.562937062937063,40.0,0.0
286,0,286,[ 89 483 265 471 118],648,5,1024,3.56794425087108,20.0,0.0
287,0,287,[172 168  95 181 125],64,4,1028,3.5694444444444446,0.0,0.0
288,0,288,[191 483 183 237  71],452,3,1031,3.5674740484429064,20.0,0.0
289,0,289,[313 427 603 318 302],13,4,1035,3.5689655172413794,40.0,0.0
290,0,290,[ 82 323  89 200 182],59,5,1040,3.5738831615120277,0.0,0.0
291,0,291,[257 176 268 318  15],92,2,1042,3.5684931506849313,20.0,0.0
292,0,292,[273 211 132  98  88],897,4,1046,3.569965870307167,0.0,20.0
293,0,293,[427 117 132 257  79],669,2,1048,3.564625850340136,0.0,0.0
294,0,294,[174 286 181 234 173],379,5,1053,3.5694915254237287,0.0,20.0
295,0,295,[568 174  15 127  56],308,4,1057,3.570945945945946,0.0,40.0
296,0,296,[228   1 125  70 175],59,2,1059,3.5656565656565657,0.0,0.0
297,0,297,[168 286  56 173 153],648,3,1062,3.563758389261745,0.0,0.0
298,0,298,[182 125 403  15 144],378,4,1066,3.5652173913043477,0.0,0.0
299,0,299,[ 82   8  69  28 228],60,3,1069,3.5633333333333335,0.0,0.0
300,0,300,[100  79 357  64 151],90,4,1073,3.564784053156146,20.0,20.0
301,0,301,[197 175  89  25 168],339,5,1078,3.5695364238410594,0.0,0.0
302,0,302,[ 50 182 237 100 385],666,2,1080,3.5643564356435644,0.0,40.0
303,0,303,[173 172 238  79 483],666,3,1083,3.5625,20.0,0.0
304,0,304,[323 151 471 143  97],90,3,1086,3.560655737704918,0.0,0.0
305,0,305,[286 111 496 275 168],524,2,1088,3.5555555555555554,0.0,0.0
306,0,306,[742 385 151 423  28],897,3,1091,3.553745928338762,0.0,0.0
307,0,307,[181   8   1 186 423],308,5,1096,3.5584415584415585,0.0,0.0
308,0,308,[179 153  56  82 275],13,2,1098,3.5533980582524274,0.0,0.0
309,0,309,[313 427 603 318 173],454,4,1102,3.554838709677419,40.0,0.0
310,0,310,[435 238 385 496 204],899,2,1104,3.54983922829582,0.0,0.0
311,0,311,[435 176 144 194 121],308,3,1107,3.548076923076923,0.0,0.0
312,0,312,[197  71   4 168 245],749,5,1112,3.5527156549520766,0.0,0.0
313,0,313,[ 25 216 132 515 435],234,2,1114,3.5477707006369426,0.0,0.0
314,0,314,[182 118  89   1 423],92,3,1117,3.546031746031746,0.0,0.0
315,0,315,[403 185  71 597 385],308,4,1121,3.5474683544303796,0.0,0.0
316,0,316,[ 28  56  98  79 271],788,3,1124,3.545741324921136,0.0,20.0
317,0,317,[197 515 176 118  15],59,5,1129,3.550314465408805,0.0,0.0
318,0,318,[313 427 603 318 302],90,5,1134,3.554858934169279,40.0,0.0
319,0,319,[135 132 385 187 197],13,4,1138,3.55625,0.0,0.0
320,0,320,[174 275 210 179 121],334,3,1141,3.554517133956386,0.0,20.0
321,0,321,[265  79 515  98  97],537,1,1142,3.546583850931677,0.0,20.0
322,0,322,[ 28 222 238 195 204],881,4,1146,3.5479876160990713,0.0,0.0
323,0,323,[ 22 143 294 125 191],406,1,1147,3.5401234567901234,0.0,0.0
324,0,324,[  7 175 222 182 515],92,5,1152,3.5446153846153847,0.0,0.0
325,0,325,[313 427 603 302 318],271,5,1157,3.549079754601227,40.0,0.0
326,0,326,[269 655  96 286 515],537,1,1158,3.541284403669725,0.0,0.0
327,0,327,[313 427 603 302 318],474,5,1163,3.5457317073170733,40.0,0.0
328,0,328,[313 427 603 302 318],90,5,1168,3.5501519756838906,40.0,0.0
329,0,329,[385 196 100 121 546],194,1,1169,3.5424242424242425,0.0,20.0
330,0,330,[153 742 508 186  98],387,3,1172,3.540785498489426,0.0,20.0
331,0,331,[313 427 603 302 318],537,5,1177,3.5451807228915664,40.0,0.0
332,0,332,[121 427 196 234 282],194,1,1178,3.5375375375375375,0.0,0.0
333,0,333,[234 403   9 357 215],234,2,1180,3.532934131736527,20.0,0.0
334,0,334,[ 22  82 183 357 515],234,4,1184,3.5343283582089553,20.0,0.0
335,0,335,[748 423 118  98 313],454,4,1188,3.5357142857142856,0.0,20.0
336,0,336,[ 28 180 135 742 588],189,4,1192,3.537091988130564,0.0,0.0
337,0,337,[313 427 603 302 318],537,5,1197,3.5414201183431953,40.0,0.0
338,0,338,[655 258 153 300 185],13,3,1200,3.5398230088495577,0.0,0.0
339,0,339,[742 195 117 215 194],144,5,1205,3.5441176470588234,0.0,0.0
340,0,340,[222 135 318  95   8],406,4,1209,3.5454545454545454,20.0,0.0
341,0,341,[313 427 603 302 318],271,5,1214,3.5497076023391814,40.0,0.0
342,0,342,[211 204 423 175 144],543,3,1217,3.5481049562682214,0.0,0.0
343,0,343,[ 56 257  11 117  71],749,3,1220,3.546511627906977,0.0,0.0
344,0,344,[423  82 268 111 276],234,1,1221,3.5391304347826087,0.0,0.0
345,0,345,[313 427 603 302 318],474,5,1226,3.5433526011560694,40.0,0.0
346,0,346,[210 182 294 496 603],650,2,1228,3.5389048991354466,20.0,0.0
347,0,347,[313 427 302 603 318],454,5,1233,3.543103448275862,40.0,0.0
348,0,348,[216  70   4 286 100],234,2,1235,3.5386819484240686,0.0,20.0
349,0,349,[ 11 655  82 265 228],343,4,1239,3.54,0.0,0.0
350,0,350,[118 282 302 603 185],271,2,1241,3.5356125356125356,20.0,0.0
351,0,351,[185 180  82 143 271],325,2,1243,3.53125,0.0,0.0
352,0,352,[ 88 175 237   7 405],346,3,1246,3.5297450424929178,0.0,0.0
353,0,353,[313 427 302 603 318],13,4,1250,3.531073446327684,40.0,0.0
354,0,354,[313 427 302 603 318],474,5,1255,3.535211267605634,40.0,0.0
355,0,355,[151  11 174 385 187],788,1,1256,3.5280898876404496,0.0,20.0
356,0,356,[313 427 302 603 318],537,5,1261,3.5322128851540615,40.0,0.0
357,0,357,[294 385  69 318  64],452,4,1265,3.5335195530726256,20.0,0.0
358,0,358,[ 96 288  98 568 173],188,5,1270,3.5376044568245124,0.0,20.0
359,0,359,[403 423  69 515 483],815,5,1275,3.5416666666666665,20.0,0.0
360,0,360,[313 427 302 603 318],334,5,1280,3.5457063711911356,40.0,0.0
361,0,361,[546 216 273 151 238],64,2,1282,3.541436464088398,0.0,0.0
362,0,362,[ 22 318 258 151 328],313,2,1284,3.5371900826446283,20.0,0.0
363,0,363,[546 257  89 204 191],650,3,1287,3.5357142857142856,0.0,0.0
364,0,364,[742 111 181 186 121],899,4,1291,3.536986301369863,0.0,0.0
365,0,365,[200 318 175   4 196],234,3,1294,3.5355191256830603,20.0,0.0
366,0,366,[235  50 222 435 483],897,2,1296,3.5313351498637604,20.0,20.0
367,0,367,[228  69 183 222  50],64,5,1301,3.535326086956522,0.0,20.0
368,0,368,[222 180 333 427  98],13,3,1304,3.5338753387533877,0.0,20.0
369,0,369,[185 322 289 282 258],328,3,1307,3.5324324324324325,0.0,0.0
370,0,370,[238 265  98 471 302],343,4,1311,3.533692722371968,0.0,20.0
371,0,371,[143 168 357   8   1],881,4,1315,3.53494623655914,20.0,0.0
372,0,372,[172 235 183 475   9],648,3,1318,3.5335120643431637,0.0,0.0
373,0,373,[ 11 286 294 318 423],378,3,1321,3.5320855614973263,20.0,0.0
374,0,374,[257  69 385 186 222],92,4,1325,3.533333333333333,0.0,0.0
375,0,375,[282 423  11 427 678],474,4,1329,3.5345744680851063,0.0,0.0
376,0,376,[191 185 471  11  88],653,1,1330,3.5278514588859418,0.0,0.0
377,0,377,[385 211 655 179 153],95,3,1333,3.5264550264550265,0.0,0.0
378,0,378,[313 302 427 603 318],271,5,1338,3.530343007915567,40.0,0.0
379,0,379,[357 275 475 294 200],308,4,1342,3.531578947368421,20.0,0.0
380,0,380,[313 302 427 603 318],474,5,1347,3.5354330708661417,40.0,0.0
381,0,381,[ 96 204 174 357 191],188,4,1351,3.5366492146596857,20.0,20.0
382,0,382,[211 204  25   1 273],308,4,1355,3.537859007832898,0.0,0.0
383,0,383,[135 172 210  25  95],271,4,1359,3.5390625,0.0,0.0
384,0,384,[597 181   7 173 546],455,3,1362,3.5376623376623377,0.0,0.0
385,0,385,[313 302 427 603 318],271,5,1367,3.5414507772020727,40.0,0.0
386,0,386,[313 302 427 603 318],271,5,1372,3.545219638242894,40.0,0.0
387,0,387,[ 25 216 161 153 234],13,3,1375,3.5438144329896906,0.0,0.0
388,0,388,[173 234 603 286 185],452,4,1379,3.544987146529563,20.0,0.0
389,0,389,[273 153 496 265 181],892,5,1384,3.5487179487179485,0.0,0.0
390,0,390,[313 302 427 603 318],474,5,1389,3.5524296675191818,40.0,0.0
391,0,391,[ 22 111  56 318 385],474,5,1394,3.556122448979592,20.0,0.0
392,0,392,[121 300 483 234 258],447,5,1399,3.559796437659033,20.0,0.0
393,0,393,[ 82  69  12 125 234],788,2,1401,3.5558375634517767,20.0,0.0
394,0,394,[187 195 301  50 194],666,2,1403,3.551898734177215,0.0,20.0
395,0,395,[181 186 215   1 196],83,5,1408,3.5555555555555554,0.0,0.0
396,0,396,[318 185  69 202 234],188,4,1412,3.556675062972292,20.0,0.0
397,0,397,[195 210  88 176 161],374,3,1415,3.5552763819095476,0.0,0.0
398,0,398,[ 70   4 275  69  25],533,4,1419,3.556390977443609,0.0,0.0
399,0,399,[313 302 427 603 318],334,5,1424,3.56,40.0,0.0
400,0,400,[181 211 328  88  28],537,1,1425,3.5536159600997506,0.0,0.0
401,0,401,[222 282 135 405   9],881,4,1429,3.554726368159204,0.0,0.0
402,0,402,[313 302 427 603 318],13,4,1433,3.555831265508685,40.0,0.0
403,0,403,[ 71 288 328 655 238],378,2,1435,3.551980198019802,0.0,0.0
404,0,404,[313 302 427 603 318],90,5,1440,3.5555555555555554,40.0,0.0
405,0,405,[ 69 235 435 568 174],650,2,1442,3.5517241379310347,0.0,20.0
406,0,406,[210 144 118 427  82],308,3,1445,3.5503685503685505,0.0,0.0
407,0,407,[313 302 427 603 318],334,5,1450,3.553921568627451,40.0,0.0
408,0,408,[427 515 475 183  89],833,2,1452,3.550122249388753,0.0,0.0
409,0,409,[403 216  97 186  70],87,4,1456,3.551219512195122,0.0,0.0
410,0,410,[423 235 187 357 175],13,3,1459,3.5498783454987834,20.0,0.0
411,0,411,[515 174 191 194 216],64,5,1464,3.5533980582524274,0.0,20.0
412,0,412,[496 132 211 185 265],452,2,1466,3.549636803874092,0.0,0.0
413,0,413,[313 302 603 427 318],271,5,1471,3.5531400966183573,40.0,0.0
414,0,414,[313 302 603 427 318],90,5,1476,3.5566265060240965,40.0,0.0
415,0,415,[  8 179 385 276 143],452,3,1479,3.5552884615384617,0.0,0.0
416,0,416,[403 568 127 423 118],308,4,1483,3.5563549160671464,0.0,20.0
417,0,417,[  4  28 143 222 180],653,2,1485,3.5526315789473686,0.0,0.0
418,0,418,[195 568   4 183 135],543,4,1489,3.5536992840095465,0.0,0.0
419,0,419,[323 748  70 121  88],881,1,1490,3.5476190476190474,0.0,0.0
420,0,420,[313 302 603 427 318],90,5,1495,3.5510688836104514,40.0,0.0
421,0,421,[144  15 210 215  50],95,5,1500,3.5545023696682465,0.0,20.0
422,0,422,[202 144  56  95   7],279,4,1504,3.5555555555555554,0.0,0.0
423,0,423,[ 70 435  11 185 273],643,3,1507,3.5542452830188678,0.0,0.0
424,0,424,[655 182 191 288 265],378,4,1511,3.5552941176470587,0.0,0.0
425,0,425,[423 172  69 174 100],774,1,1512,3.5492957746478875,0.0,40.0
426,0,426,[234  56 176  25 508],474,4,1516,3.550351288056206,0.0,0.0
427,0,427,[322   1 282   7 678],294,2,1518,3.546728971962617,0.0,0.0
428,0,428,[ 89 121 195   4 168],882,5,1523,3.55011655011655,0.0,0.0
429,0,429,[204 222 175 597  96],788,0,1523,3.541860465116279,0.0,0.0
430,0,430,[678 318  22  64 496],82,3,1526,3.5406032482598606,20.0,0.0
431,0,431,[313 302 603 427 318],334,5,1531,3.5439814814814814,40.0,0.0
432,0,432,[234 357   9 121 265],308,2,1533,3.540415704387991,20.0,0.0
433,0,433,[183  22 197 282  50],378,4,1537,3.5414746543778803,0.0,20.0
434,0,434,[313 302 603 427 318],537,5,1542,3.5448275862068965,40.0,0.0
435,0,435,[313 302 603 427 318],474,5,1547,3.5481651376146788,40.0,0.0
436,0,436,[ 56 143 111 186 100],334,2,1549,3.5446224256292904,0.0,20.0
437,0,437,[385 588 276  12  82],537,1,1550,3.538812785388128,20.0,0.0
438,0,438,[ 22 118 515 603 427],13,4,1554,3.5398633257403187,20.0,0.0
439,0,439,[  7   8  82 183 172],308,5,1559,3.543181818181818,0.0,0.0
440,0,440,[357 181 191 153 211],454,1,1560,3.5374149659863945,20.0,0.0
441,0,441,[143 194 197 117 237],474,5,1565,3.5407239819004523,0.0,0.0
442,0,442,[515 323 286 546 144],650,1,1566,3.5349887133182842,0.0,0.0
443,0,443,[313 302 603 427 318],271,5,1571,3.5382882882882885,40.0,0.0
444,0,444,[187 286 195 294 678],387,2,1573,3.534831460674157,0.0,0.0
445,0,445,[313 302 603 427 318],454,5,1578,3.5381165919282513,40.0,0.0
446,0,446,[ 89 194 196 357 176],653,2,1580,3.534675615212528,20.0,0.0
447,0,447,[174 172 197 215 385],643,3,1583,3.533482142857143,0.0,20.0
448,0,448,[197  96 175 195 117],308,3,1586,3.532293986636971,0.0,0.0
449,0,449,[313 302 603 427 318],13,4,1590,3.533333333333333,40.0,0.0
450,0,450,[194 180  64 742 483],666,3,1593,3.532150776053215,20.0,0.0
451,0,451,[ 89 275 471  50 405],378,3,1596,3.5309734513274336,0.0,20.0
452,0,452,[435 496  56 357 135],385,2,1598,3.5275938189845473,20.0,0.0
453,0,453,[313 302 603 427 318],271,5,1603,3.5308370044052864,40.0,0.0
454,0,454,[222  28 215 202 546],897,4,1607,3.5318681318681318,0.0,0.0
455,0,455,[144 294   8 153 125],234,1,1608,3.526315789473684,0.0,0.0
456,0,456,[313 302 603 427 318],13,4,1612,3.527352297592998,40.0,0.0
457,0,457,[282 183  89  64  56],326,3,1615,3.5262008733624453,0.0,0.0
458,0,458,[215 471  56 143 238],194,2,1617,3.522875816993464,0.0,0.0
459,0,459,[121 132 515  11 471],328,3,1620,3.5217391304347827,0.0,0.0
460,0,460,[313 302 603 427 318],13,4,1624,3.522776572668113,40.0,0.0
461,0,461,[313 302 603 427 183],334,5,1629,3.5259740259740258,20.0,0.0
462,0,462,[313 403 194  12 318],64,5,1634,3.529157667386609,40.0,0.0
463,0,463,[568 183 118 222  95],13,3,1637,3.5280172413793105,0.0,0.0
464,0,464,[181  50 121 234  88],145,4,1641,3.529032258064516,0.0,20.0
465,0,465,[182 176  82 483 313],815,4,1645,3.5300429184549356,20.0,0.0
466,0,466,[197 111 333 288 135],334,3,1648,3.5289079229122056,0.0,0.0
467,0,467,[313 302 603 427 183],537,4,1652,3.52991452991453,20.0,0.0
468,0,468,[ 64 153 182 471 197],13,4,1656,3.5309168443496803,0.0,0.0
469,0,469,[313 302 603 427 127],13,5,1661,3.5340425531914894,20.0,20.0
470,0,470,[313 302 603 427 127],271,5,1666,3.537154989384289,20.0,20.0
471,0,471,[435 215 328  79 301],378,3,1669,3.5360169491525424,0.0,0.0
472,0,472,[117 385 423 286 191],653,4,1673,3.536997885835095,0.0,0.0
473,0,473,[183 258  89  22 294],774,1,1674,3.5316455696202533,0.0,0.0
474,0,474,[588 385 183 300 333],313,5,1679,3.534736842105263,0.0,0.0
475,0,475,[269 215 182 288 172],488,1,1680,3.5294117647058822,0.0,0.0
476,0,476,[313 302 603 427 127],13,5,1685,3.5324947589098534,20.0,20.0
477,0,477,[ 96 135 435 172  12],474,5,1690,3.5355648535564854,20.0,0.0
478,0,478,[546  50 100 125 183],92,4,1694,3.536534446764092,0.0,40.0
479,0,479,[172 286 265  22  89],95,3,1697,3.535416666666667,0.0,0.0
480,0,480,[ 25   8 748 100 357],474,4,1701,3.5363825363825363,20.0,20.0
481,0,481,[282 185 235 265   8],479,4,1705,3.537344398340249,0.0,0.0
482,0,482,[313 302 603 427 127],271,5,1710,3.540372670807453,20.0,20.0
483,0,483,[132 100 302   1 405],537,2,1712,3.5371900826446283,0.0,20.0
484,0,484,[427 191 423 322 258],454,4,1716,3.538144329896907,0.0,0.0
485,0,485,[603 237 210 471 546],308,2,1718,3.5349794238683128,20.0,0.0
486,0,486,[742 161 276 173 216],346,1,1719,3.529774127310062,0.0,0.0
487,0,487,[197 185 423 288  69],648,3,1722,3.528688524590164,0.0,0.0
488,0,488,[210 144 313 483  56],934,3,1725,3.5276073619631902,20.0,0.0
489,0,489,[742 185 471 496 322],454,1,1726,3.522448979591837,0.0,0.0
490,0,490,[ 22 234 175   1 186],650,3,1729,3.521384928716904,0.0,0.0
491,0,491,[ 22 182 258   4  11],339,4,1733,3.522357723577236,0.0,0.0
492,0,492,[176 173 151 288 195],537,1,1734,3.5172413793103448,0.0,0.0
493,0,493,[  7 237 234 176 273],548,5,1739,3.520242914979757,0.0,0.0
494,0,494,[222 496  64 288   4],666,3,1742,3.519191919191919,0.0,0.0
495,0,495,[194   9  12 183 100],940,2,1744,3.5161290322580645,20.0,20.0
496,0,496,[302 313 603 427 127],334,5,1749,3.5191146881287727,20.0,20.0
497,0,497,[568 183 515 228 273],92,4,1753,3.5200803212851404,0.0,0.0
498,0,498,[100 180 127 186 294],533,3,1756,3.5190380761523046,0.0,40.0
499,0,499,[  7  12 174 508  96],774,0,1756,3.512,20.0,20.0
500,0,500,[168 204 143 176 144],815,4,1760,3.5129740518962076,0.0,0.0
501,0,501,[234 132 197 144  22],234,4,1764,3.5139442231075697,0.0,0.0
502,0,502,[568 117 135 197 234],537,2,1766,3.510934393638171,0.0,0.0
503,0,503,[144  97 186 194 181],234,1,1767,3.505952380952381,0.0,0.0
504,0,504,[ 22 300 185  69 161],694,5,1772,3.508910891089109,0.0,0.0
505,0,505,[117 275 222  50 258],634,3,1775,3.507905138339921,0.0,20.0
506,0,506,[179 210 174 588 127],479,3,1778,3.5069033530571994,0.0,40.0
507,0,507,[302 313 603 427 127],669,5,1783,3.5098425196850394,20.0,20.0
508,0,508,[302 313 603 427 127],669,5,1788,3.512770137524558,20.0,20.0
509,0,509,[ 28 125 172 655  71],398,4,1792,3.5137254901960784,0.0,0.0
510,0,510,[235 196 117  88  82],650,2,1794,3.5107632093933465,0.0,0.0
511,0,511,[655  22 144 153 748],328,3,1797,3.509765625,0.0,0.0
512,0,512,[ 69 197 237 174  25],899,3,1800,3.508771929824561,0.0,20.0
513,0,513,[302 313 603 427 127],669,5,1805,3.5116731517509727,20.0,20.0
514,0,514,[202 196 143 125 515],59,3,1808,3.5106796116504855,0.0,0.0
515,0,515,[182 275 300 265 286],537,2,1810,3.507751937984496,0.0,0.0
516,0,516,[302 313 603 427 127],669,5,1815,3.5106382978723403,20.0,20.0
517,0,517,[176 216  64 265  96],653,3,1818,3.5096525096525095,0.0,0.0
518,0,518,[435  50 196 678 423],506,4,1822,3.510597302504817,0.0,20.0
519,0,519,[302 313 603 427 127],90,5,1827,3.5134615384615384,20.0,20.0
520,0,520,[483 210 194 180 515],7,4,1831,3.5143953934740884,20.0,0.0
521,0,521,[ 79 508 197   8 288],13,2,1833,3.5114942528735633,0.0,0.0
522,0,522,[202 197  79 294 186],271,4,1837,3.5124282982791586,0.0,0.0
523,0,523,[265 483 496 603  69],815,4,1841,3.513358778625954,40.0,0.0
524,0,524,[181 118 196  71 271],92,3,1844,3.512380952380952,0.0,0.0
525,0,525,[268 211  50 568  82],643,4,1848,3.5133079847908744,0.0,20.0
526,0,526,[186 196 194  12 132],537,1,1849,3.50853889943074,20.0,0.0
527,0,527,[ 82  96 195 118 176],533,4,1853,3.509469696969697,0.0,0.0
528,0,528,[182 318   8 151 211],406,4,1857,3.510396975425331,20.0,0.0
529,0,529,[174 202 385   7 238],650,4,1861,3.5113207547169814,0.0,20.0
530,0,530,[  1 588 174   9 191],184,4,1865,3.512241054613936,0.0,20.0
531,0,531,[603  50 210  28 204],537,2,1867,3.5093984962406015,20.0,20.0
532,0,532,[ 71  11 245 172 313],334,2,1869,3.50656660412758,0.0,0.0
533,0,533,[ 70 257 180 179 405],840,3,1872,3.50561797752809,0.0,0.0
534,0,534,[302 313 427 603 127],669,5,1877,3.508411214953271,20.0,20.0
535,0,535,[302 313 427 603 127],90,5,1882,3.5111940298507465,20.0,20.0
536,0,536,[  8 508 196 496 186],474,4,1886,3.5121042830540037,0.0,0.0
537,0,537,[127 276 385  96  64],308,5,1891,3.5148698884758365,0.0,20.0
538,0,538,[385 176 405  98 302],883,2,1893,3.5120593692022264,0.0,20.0
539,0,539,[302 313 427 603 127],537,5,1898,3.5148148148148146,20.0,20.0
540,0,540,[216  25 546 568  95],95,2,1900,3.512014787430684,0.0,0.0
541,0,541,[ 88 195 174 282 257],378,4,1904,3.5129151291512914,0.0,20.0
542,0,542,[222 204 196 546 357],774,0,1904,3.5064456721915285,20.0,0.0
543,0,543,[237  11 143   1 179],378,3,1907,3.505514705882353,0.0,0.0
544,0,544,[238  11   8 173 508],474,4,1911,3.5064220183486237,0.0,0.0
545,0,545,[182  79 173 127 300],334,3,1914,3.5054945054945055,0.0,20.0
546,0,546,[286   1 187 385 176],234,1,1915,3.5009140767824496,0.0,0.0
547,0,547,[ 98 483 245 234 191],804,5,1920,3.5036496350364965,20.0,20.0
548,0,548,[195 153 197 183 127],308,4,1924,3.504553734061931,0.0,20.0
549,0,549,[ 88 245 111   9 300],749,3,1927,3.5036363636363634,0.0,0.0
550,0,550,[302 313 427 127 603],14,3,1930,3.5027223230490017,20.0,20.0
551,0,551,[228  89 742 515 655],881,4,1934,3.503623188405797,0.0,0.0
552,0,552,[216 197   1 471 176],648,4,1938,3.5045207956600364,0.0,0.0
553,0,553,[302 313 427 603 127],669,5,1943,3.5072202166064983,20.0,20.0
554,0,554,[ 88 180  22  98 357],207,2,1945,3.5045045045045047,20.0,20.0
555,0,555,[ 79 185 174 276 655],194,3,1948,3.5035971223021583,0.0,20.0
556,0,556,[ 88 135  15 568 269],207,3,1951,3.502692998204668,0.0,0.0
557,0,557,[135 568 161   4 234],378,3,1954,3.5017921146953404,0.0,0.0
558,0,558,[211  56 179 276  22],406,4,1958,3.5026833631484795,0.0,0.0
559,0,559,[568  11 195 215 194],378,3,1961,3.5017857142857145,0.0,0.0
560,0,560,[200 268 191 153 172],92,4,1965,3.5026737967914436,0.0,0.0
561,0,561,[ 82 196 111 302  11],207,2,1967,3.5,0.0,0.0
562,0,562,[302 313 427 603 127],14,3,1970,3.4991119005328595,20.0,20.0
563,0,563,[204 288 301 300 200],234,1,1971,3.49468085106383,0.0,0.0
564,0,564,[174 275 216 161  96],7,4,1975,3.495575221238938,0.0,20.0
565,0,565,[302 427 313 603  64],669,5,1980,3.498233215547703,20.0,0.0
566,0,566,[200 176 195 210 153],650,4,1984,3.4991181657848323,0.0,0.0
567,0,567,[302 427 313 603  64],13,5,1989,3.5017605633802815,20.0,0.0
568,0,568,[678  15   7 546 191],92,2,1991,3.499121265377856,0.0,0.0
569,0,569,[245   7 121 301 175],102,1,1992,3.4947368421052634,0.0,0.0
570,0,570,[302 427 313 603  64],13,5,1997,3.497373029772329,20.0,0.0
571,0,571,[216 483   7  22 173],648,4,2001,3.4982517482517483,20.0,0.0
572,0,572,[588 132 265 121 174],650,3,2004,3.4973821989528795,0.0,20.0
573,0,573,[ 82 118 288 237 211],533,3,2007,3.4965156794425085,0.0,0.0
574,0,574,[202 427 204 588 144],398,4,2011,3.497391304347826,0.0,0.0
575,0,575,[238 195  64 161 313],85,3,2014,3.4965277777777777,0.0,0.0
576,0,576,[ 69 132 183 168 405],536,3,2017,3.4956672443674175,0.0,0.0
577,0,577,[302 427 313 603  64],474,5,2022,3.4982698961937717,20.0,0.0
578,0,578,[289  82 483 202  12],533,4,2026,3.4991364421416233,40.0,0.0
579,0,579,[302 427 313 603  64],669,5,2031,3.5017241379310344,20.0,0.0
580,0,580,[ 98 748 269 144 323],125,2,2033,3.4991394148020656,0.0,20.0
581,0,581,[204 210 282  22 238],653,3,2036,3.4982817869415808,0.0,0.0
582,0,582,[ 70 357 144 515 111],666,3,2039,3.497427101200686,20.0,0.0
583,0,583,[302 427 313 603  64],271,5,2044,3.5,20.0,0.0
584,0,584,[125 187 111 483 204],6,2,2046,3.4974358974358974,20.0,0.0
585,0,585,[215 405 197 183  15],378,3,2049,3.4965870307167237,0.0,0.0
586,0,586,[508 151 385 210 196],387,2,2051,3.4940374787052813,0.0,0.0
587,0,587,[238 153   7  95 143],892,4,2055,3.4948979591836733,0.0,0.0
588,0,588,[302 427 313 603  64],271,5,2060,3.497453310696095,20.0,0.0
589,0,589,[180 403 423 300  79],749,5,2065,3.5,0.0,0.0
590,0,590,[588 135  22  79 125],82,1,2066,3.495769881556684,0.0,0.0
591,0,591,[180 286 258  88   7],339,4,2070,3.4966216216216215,0.0,0.0
592,0,592,[194 100  28 176 258],64,4,2074,3.4974704890387858,0.0,20.0
593,0,593,[100 204 143  71 185],474,5,2079,3.5,0.0,20.0
594,0,594,[302 427 313 603  64],669,5,2084,3.5025210084033613,20.0,0.0
595,0,595,[ 50  22 135 143 215],537,2,2086,3.5,0.0,20.0
596,0,596,[265 222 175  22 286],387,4,2090,3.5008375209380236,0.0,0.0
597,0,597,[118 265 174 135 180],653,4,2094,3.5016722408026757,0.0,20.0
598,0,598,[ 70 176 222 132  79],328,4,2098,3.5025041736227047,0.0,0.0
599,0,599,[117 143 132 210   7],650,4,2102,3.5033333333333334,0.0,0.0
600,0,600,[546  98   1 117 161],653,3,2105,3.502495840266223,0.0,20.0
601,0,601,[ 50 196 200 655 294],378,3,2108,3.5016611295681064,0.0,20.0
602,0,602,[185 237 121 174 204],13,4,2112,3.5024875621890548,0.0,20.0
603,0,603,[216 435 471 302 179],524,5,2117,3.5049668874172184,0.0,0.0
604,0,604,[302 427 313 603  64],669,5,2122,3.507438016528926,20.0,0.0
605,0,605,[302 427 313 603  64],474,5,2127,3.50990099009901,20.0,0.0
606,0,606,[127 546 151 322 237],533,2,2129,3.5074135090609557,0.0,20.0
607,0,607,[302 427 313 603  64],271,5,2134,3.5098684210526314,20.0,0.0
608,0,608,[302 427 313 603  64],454,5,2139,3.5123152709359604,20.0,0.0
609,0,609,[302 603  95 423 475],334,4,2143,3.5131147540983605,20.0,0.0
610,0,610,[174 655 385  71 186],387,1,2144,3.5090016366612113,0.0,20.0
611,0,611,[196  88  50  95 161],901,5,2149,3.511437908496732,0.0,20.0
612,0,612,[302 427 313 603  64],669,5,2154,3.5138662316476346,20.0,0.0
613,0,613,[204  28 127 176  64],892,5,2159,3.51628664495114,0.0,20.0
614,0,614,[302 427 313 603  64],90,5,2164,3.51869918699187,20.0,0.0
615,0,615,[191 322 286  82 135],207,1,2165,3.5146103896103895,0.0,0.0
616,0,616,[313 423 194 174 144],378,5,2170,3.5170178282009723,0.0,20.0
617,0,617,[655 276 161 515 202],59,4,2174,3.517799352750809,0.0,0.0
618,0,618,[237 245 742 385  15],84,4,2178,3.518578352180937,0.0,0.0
619,0,619,[302 427 313 603  64],669,5,2183,3.520967741935484,20.0,0.0
620,0,620,[294  28 181 202  98],379,4,2187,3.5217391304347827,0.0,20.0
621,0,621,[302 427 313 603  64],271,5,2192,3.5241157556270095,20.0,0.0
622,0,622,[215 174 185  82 161],749,4,2196,3.524879614767255,0.0,20.0
623,0,623,[302 427 313 603  64],474,5,2201,3.52724358974359,20.0,0.0
624,0,624,[127   1 144 385   7],343,4,2205,3.528,0.0,20.0
625,0,625,[215 143 322 234  96],90,4,2209,3.5287539936102235,0.0,0.0
626,0,626,[ 64 300 508 301  12],13,2,2211,3.526315789473684,20.0,0.0
627,0,627,[302 427 313 603  64],669,5,2216,3.5286624203821657,20.0,0.0
628,0,628,[405 204   9 475 180],92,4,2220,3.5294117647058822,0.0,0.0
629,0,629,[302 427 313 603  64],474,5,2225,3.5317460317460316,20.0,0.0
630,0,630,[322 121 118 117 405],881,5,2230,3.5340729001584785,0.0,0.0
631,0,631,[ 50   7 237 258 121],184,2,2232,3.5316455696202533,0.0,20.0
632,0,632,[302 427 313 603  64],271,5,2237,3.5339652448657186,20.0,0.0
633,0,633,[202 496 197 176 357],694,5,2242,3.5362776025236595,20.0,0.0
634,0,634,[302 427 313 603  64],454,5,2247,3.5385826771653544,20.0,0.0
635,0,635,[181   8 127  15  96],455,4,2251,3.539308176100629,0.0,20.0
636,0,636,[302 427 313 603  64],13,5,2256,3.5416012558869703,20.0,0.0
637,0,637,[191  56 328 210 172],804,4,2260,3.542319749216301,0.0,0.0
638,0,638,[216 196 210  70 187],308,3,2263,3.541471048513302,0.0,0.0
639,0,639,[286   4  98 125 300],455,3,2266,3.540625,0.0,20.0
640,0,640,[302 427 313 603  64],271,5,2271,3.5429017160686427,20.0,0.0
641,0,641,[423 132 181 405  25],59,4,2275,3.543613707165109,0.0,0.0
642,0,642,[176 181  69 568 197],533,4,2279,3.5443234836702957,0.0,0.0
643,0,643,[  7 211 603 294 515],666,4,2283,3.5450310559006213,20.0,0.0
644,0,644,[127 222 143 228 423],881,4,2287,3.545736434108527,0.0,20.0
645,0,645,[269 175 173 195 125],7,4,2291,3.5464396284829722,0.0,0.0
646,0,646,[302 427 313 603  64],537,4,2295,3.547140649149923,20.0,0.0
647,0,647,[151 286 144   7 153],650,2,2297,3.544753086419753,0.0,0.0
648,0,648,[302 427 313 603  64],90,5,2302,3.546995377503852,20.0,0.0
649,0,649,[153  96 423 204 655],7,5,2307,3.5492307692307694,0.0,0.0
650,0,650,[301 515  96 127 258],455,4,2311,3.5499231950844856,0.0,20.0
651,0,651,[186 483 151 515 603],553,4,2315,3.5506134969325154,40.0,0.0
652,0,652,[294  82 182 151  11],788,0,2315,3.545176110260337,0.0,0.0
653,0,653,[318  25 357 175  28],7,4,2319,3.5458715596330275,40.0,0.0
654,0,654,[ 96 195 202 269 357],14,3,2322,3.545038167938931,20.0,0.0
655,0,655,[180  64  22 234 100],343,4,2326,3.5457317073170733,0.0,20.0
656,0,656,[100  56 276   1 228],92,5,2331,3.547945205479452,0.0,20.0
657,0,657,[144 121 210 222  70],378,4,2335,3.548632218844985,0.0,0.0
658,0,658,[197 175 186 289  64],406,3,2338,3.5477996965098635,0.0,0.0
659,0,659,[302 427 313 603  64],669,5,2343,3.55,20.0,0.0
660,0,660,[286   9 275 200 173],271,5,2348,3.552193645990923,0.0,0.0
661,0,661,[ 88 568  64 117 153],184,1,2349,3.5483383685800605,0.0,0.0
662,0,662,[748 294 257 181 678],447,2,2351,3.5460030165912517,0.0,0.0
663,0,663,[174 197 313 215 117],378,3,2354,3.5451807228915664,0.0,20.0
664,0,664,[475 194 182 161 186],13,4,2358,3.5458646616541354,0.0,0.0
665,0,665,[302 174 222 748 118],788,1,2359,3.542042042042042,0.0,20.0
666,0,666,[161 174  15 483 211],313,4,2363,3.542728635682159,20.0,20.0
667,0,667,[302 427 313 603  64],474,5,2368,3.5449101796407185,20.0,0.0
668,0,668,[194 496  12 179   4],343,5,2373,3.5470852017937218,20.0,0.0
669,0,669,[ 71 403 294 161  95],650,0,2373,3.5417910447761196,0.0,0.0
670,0,670,[289 179  82 222 228],13,1,2374,3.5380029806259317,0.0,0.0
671,0,671,[181 202 176 172 273],479,5,2379,3.5401785714285716,0.0,0.0
672,0,672,[ 98  97 174  89 100],488,4,2383,3.540861812778603,0.0,60.0
673,0,673,[121 228 172 151  64],537,0,2383,3.535608308605341,0.0,0.0
674,0,674,[181 182  70 135 235],537,3,2386,3.5348148148148146,0.0,0.0
675,0,675,[258 678 286 202 238],145,3,2389,3.5340236686390534,0.0,0.0
676,0,676,[322 176 183  28 182],91,5,2394,3.536189069423929,0.0,0.0
677,0,677,[302 427 313 603  64],90,5,2399,3.53834808259587,20.0,0.0
678,0,678,[302 427 313 603  64],669,5,2404,3.540500736377025,20.0,0.0
679,0,679,[302 427 313 603  64],454,5,2409,3.5426470588235293,20.0,0.0
680,0,680,[302 427 313 603  64],474,5,2414,3.5447870778267254,20.0,0.0
681,0,681,[196 185 179  98 153],650,3,2417,3.5439882697947214,0.0,20.0
682,0,682,[125  15 202 471 508],533,5,2422,3.5461200585651538,0.0,0.0
683,0,683,[ 56 235 678 405  12],145,3,2425,3.5453216374269005,20.0,0.0
684,0,684,[302 427 313 603  64],669,5,2430,3.5474452554744524,20.0,0.0
685,0,685,[117 185 385 187  28],479,3,2433,3.5466472303206995,0.0,0.0
686,0,686,[302 427 313 603  64],474,5,2438,3.548762736535662,20.0,0.0
687,0,687,[195 328 258  71 508],85,2,2440,3.546511627906977,0.0,0.0
688,0,688,[275 179 475  22 286],334,5,2445,3.548621190130624,0.0,0.0
689,0,689,[275 258 172  56 265],843,1,2446,3.544927536231884,0.0,0.0
690,0,690,[302 427 313 603  64],537,4,2450,3.545586107091172,20.0,0.0
691,0,691,[ 98 211 222 234  50],313,4,2454,3.546242774566474,0.0,40.0
692,0,692,[ 95 210 423 427 185],271,4,2458,3.5468975468975468,0.0,0.0
693,0,693,[179 135  88 235 197],406,4,2462,3.547550432276657,0.0,0.0
694,0,694,[603 143 546  82 357],42,4,2466,3.548201438848921,40.0,0.0
695,0,695,[302 427 313 603 127],334,5,2471,3.550287356321839,20.0,20.0
696,0,696,[302 427 313 603 127],669,5,2476,3.552367288378766,20.0,20.0
697,0,697,[597 118 121 508 385],653,3,2479,3.5515759312320916,0.0,0.0
698,0,698,[405 216 403  11 125],378,2,2481,3.5493562231759657,0.0,0.0
699,0,699,[125  70 215   7  22],234,1,2482,3.545714285714286,0.0,0.0
700,0,700,[302 427 313 603 127],537,5,2487,3.5477888730385163,20.0,20.0
701,0,701,[ 50 423 257 323 211],254,2,2489,3.5455840455840457,0.0,20.0
702,0,702,[ 70 515  79 194 210],666,2,2491,3.543385490753912,0.0,0.0
703,0,703,[302 427 313 603 127],271,5,2496,3.5454545454545454,20.0,20.0
704,0,704,[ 89 216 238 300   1],537,2,2498,3.5432624113475177,0.0,0.0
705,0,705,[153 286 427  12 302],90,5,2503,3.545325779036827,20.0,0.0
706,0,706,[258 216 174  56 125],6,3,2506,3.5445544554455446,0.0,20.0
707,0,707,[318   1 276 405 742],533,3,2509,3.5437853107344632,20.0,0.0
708,0,708,[237 197 435 568 228],64,4,2513,3.544428772919605,0.0,0.0
709,0,709,[215 273  28 216 111],378,4,2517,3.545070422535211,0.0,0.0
710,0,710,[302 427 313 603 127],669,5,2522,3.5471167369901546,20.0,20.0
711,0,711,[ 82 235  89 328 435],788,2,2524,3.544943820224719,0.0,0.0
712,0,712,[237  71 121 179 153],308,3,2527,3.544179523141655,0.0,0.0
713,0,713,[  7 288 471 100 588],7,5,2532,3.546218487394958,0.0,20.0
714,0,714,[302 427 313 603 127],13,5,2537,3.548251748251748,20.0,20.0
715,0,715,[318   8 475 275 385],343,4,2541,3.548882681564246,20.0,0.0
716,0,716,[302 427 313 603 127],13,5,2546,3.5509065550906556,20.0,20.0
717,0,717,[302 427 313 603 127],90,5,2551,3.552924791086351,20.0,20.0
718,0,718,[  7  79 302 333 181],145,4,2555,3.553546592489569,0.0,0.0
719,0,719,[302 427 313 603 127],669,5,2560,3.5555555555555554,20.0,20.0
720,0,720,[194 265  12  70 200],311,5,2565,3.5575589459084607,20.0,0.0
721,0,721,[302 427 313 603 127],13,5,2570,3.559556786703601,20.0,20.0
722,0,722,[127 111 196 100 603],666,3,2573,3.5587828492392806,20.0,40.0
723,0,723,[176 423  28  97  25],398,5,2578,3.5607734806629834,0.0,0.0
724,0,724,[508 403 235  71 211],13,2,2580,3.5586206896551724,0.0,0.0
725,0,725,[435 143 385 132 118],194,1,2581,3.5550964187327825,0.0,0.0
726,0,726,[313 286  96  89 237],119,5,2586,3.5570839064649244,0.0,0.0
727,0,727,[318   9 286 222 173],488,4,2590,3.5576923076923075,20.0,0.0
728,0,728,[127  96 237  88 143],653,2,2592,3.5555555555555554,0.0,20.0
729,0,729,[215 405 318 588 179],85,3,2595,3.5547945205479454,20.0,0.0
730,0,730,[385  82 403  22 168],7,4,2599,3.555403556771546,0.0,0.0
731,0,731,[302 427 313 603 127],474,5,2604,3.557377049180328,20.0,20.0
732,0,732,[168 182 546 191 257],749,2,2606,3.5552523874488404,0.0,0.0
733,0,733,[182 185 204 153 269],666,4,2610,3.555858310626703,0.0,0.0
734,0,734,[ 71 282   7 333 180],881,5,2615,3.557823129251701,0.0,0.0
735,0,735,[269  97  96 385 405],488,2,2617,3.5557065217391304,0.0,0.0
736,0,736,[ 98   1 174  79 678],387,4,2621,3.5563093622795114,0.0,40.0
737,0,737,[302 427 313 603 127],669,5,2626,3.5582655826558267,20.0,20.0
738,0,738,[191 655   1 200 275],378,4,2630,3.5588633288227336,0.0,0.0
739,0,739,[181 196  22 182 195],308,4,2634,3.5594594594594593,0.0,0.0
740,0,740,[127 117  15  25 197],537,2,2636,3.5573549257759782,0.0,20.0
741,0,741,[288 183 282 176 210],92,4,2640,3.557951482479784,0.0,0.0
742,0,742,[185 216 197 153 151],95,4,2644,3.5585464333781966,0.0,0.0
743,0,743,[275 135  71 222 179],536,4,2648,3.5591397849462365,0.0,0.0
744,0,744,[197 282 121 508 175],207,3,2651,3.5583892617449666,0.0,0.0
745,0,745,[288 132 678 268 313],683,2,2653,3.5563002680965146,0.0,0.0
746,0,746,[180 322  28 175 121],804,5,2658,3.5582329317269075,0.0,0.0
747,0,747,[403 100 678 117 179],881,3,2661,3.557486631016043,0.0,20.0
748,0,748,[222 427 135  28  82],85,2,2663,3.555407209612817,0.0,0.0
749,0,749,[ 56  15 237 405 118],554,4,2667,3.556,0.0,0.0
750,0,750,[ 69 385 273  64 357],666,2,2669,3.5539280958721706,20.0,0.0
751,0,751,[ 97  89 235 423 194],524,4,2673,3.554521276595745,0.0,0.0
752,0,752,[385 211 282 357 200],311,4,2677,3.555112881806109,20.0,0.0
753,0,753,[302 603 427 313 127],13,5,2682,3.557029177718833,20.0,20.0
754,0,754,[405 385 118 257 294],749,0,2682,3.552317880794702,0.0,0.0
755,0,755,[222 125  79 228  89],881,4,2686,3.552910052910053,0.0,0.0
756,0,756,[ 97 191   9 135 197],543,4,2690,3.5535006605019817,0.0,0.0
757,0,757,[435   4  50 183 289],194,2,2692,3.5514511873350925,0.0,20.0
758,0,758,[237 186 258 546 181],7,4,2696,3.552042160737813,0.0,0.0
759,0,759,[186 222 475 318 176],334,3,2699,3.5513157894736844,20.0,0.0
760,0,760,[357  69 313 245 173],207,3,2702,3.5505913272010514,20.0,0.0
761,0,761,[  7 568 269 179 655],343,4,2706,3.5511811023622046,0.0,0.0
762,0,762,[111 168 173 515  56],6,4,2710,3.551769331585845,0.0,0.0
763,0,763,[302 603 427 313 127],13,5,2715,3.553664921465969,20.0,20.0
764,0,764,[197 568  79 202 176],881,4,2719,3.5542483660130717,0.0,0.0
765,0,765,[151 328 471 135 245],378,0,2719,3.549608355091384,0.0,0.0
766,0,766,[302 603 427 313 127],14,3,2722,3.548891786179922,20.0,20.0
767,0,767,[258 181 204 302 286],474,5,2727,3.55078125,0.0,0.0
768,0,768,[597  82 117 423 655],643,2,2729,3.5487646293888164,0.0,0.0
769,0,769,[125 143 182 313 117],92,4,2733,3.5493506493506493,0.0,0.0
770,0,770,[302 603 427 313 127],474,5,2738,3.551232166018158,20.0,20.0
771,0,771,[403 132 427 204 202],934,5,2743,3.5531088082901556,0.0,0.0
772,0,772,[328 200 301 222 288],537,0,2743,3.548512289780078,0.0,0.0
773,0,773,[483 275  56 204 211],311,4,2747,3.549095607235142,20.0,0.0
774,0,774,[222 300 111 125 117],779,4,2751,3.549677419354839,0.0,0.0
775,0,775,[302 603 427 313 127],271,5,2756,3.551546391752577,20.0,20.0
776,0,776,[135  25  98 132 597],882,4,2760,3.552123552123552,0.0,20.0
777,0,777,[483 143 748 182 475],474,4,2764,3.5526992287917736,20.0,0.0
778,0,778,[302 603 427 313 127],474,5,2769,3.5545571245186136,20.0,20.0
779,0,779,[515 403 144 300  95],13,2,2771,3.5525641025641024,0.0,0.0
780,0,780,[ 98 179 200 121 318],374,3,2774,3.5518565941101152,20.0,20.0
781,0,781,[ 28  25  12 194 603],42,4,2778,3.5524296675191818,40.0,0.0
782,0,782,[276 197 568 185   9],59,5,2783,3.554278416347382,0.0,0.0
783,0,783,[210 174 235  50 483],648,5,2788,3.556122448979592,20.0,40.0
784,0,784,[127 197   4  50 183],406,4,2792,3.556687898089172,0.0,40.0
785,0,785,[ 70 496 546 202  82],533,4,2796,3.5572519083969465,0.0,0.0
786,0,786,[238   4  97 194 176],881,1,2797,3.554002541296061,0.0,0.0
787,0,787,[ 69 175 151  97 588],59,4,2801,3.5545685279187818,0.0,0.0
788,0,788,[546  95 742  70 313],271,3,2804,3.5538656527249683,0.0,0.0
789,0,789,[302 603 427 313 127],334,5,2809,3.5556962025316454,20.0,20.0
790,0,790,[568 197 215   8  50],454,5,2814,3.5575221238938055,0.0,20.0
791,0,791,[172  70 186 234 323],788,1,2815,3.5542929292929295,0.0,0.0
792,0,792,[405 196 127 195 282],85,2,2817,3.5523329129886507,0.0,20.0
793,0,793,[302 603 427 313 127],14,3,2820,3.5516372795969775,20.0,20.0
794,0,794,[427 187 181  25 322],474,5,2825,3.5534591194968552,0.0,0.0
795,0,795,[ 22 294  69 161 508],533,5,2830,3.5552763819095476,0.0,0.0
796,0,796,[302 603 427 313  64],454,5,2835,3.5570890840652445,20.0,0.0
797,0,797,[ 97  79 427  82 655],537,1,2836,3.5538847117794488,0.0,0.0
798,0,798,[182 496  11  98 216],90,4,2840,3.5544430538172715,0.0,20.0
799,0,799,[302 603 427 313  64],454,5,2845,3.55625,20.0,0.0
800,0,800,[405  70 191 173  89],7,3,2848,3.5555555555555554,0.0,0.0
801,0,801,[475 144 187 195 183],207,1,2849,3.552369077306733,0.0,0.0
802,0,802,[483  71 197 179 174],840,4,2853,3.5529265255292652,20.0,20.0
803,0,803,[186 195 181 168 153],385,1,2854,3.5497512437810945,0.0,0.0
804,0,804,[302 603 427 313  64],13,5,2859,3.5515527950310557,20.0,0.0
805,0,805,[180 245  82  79 196],653,4,2863,3.5521091811414394,0.0,0.0
806,0,806,[135 273   8 182 179],234,2,2865,3.550185873605948,0.0,0.0
807,0,807,[180   4 202 265 471],537,1,2866,3.547029702970297,0.0,0.0
808,0,808,[546 121 237 186  64],92,4,2870,3.547589616810878,0.0,0.0
809,0,809,[496  71 435 228 143],406,2,2872,3.545679012345679,0.0,0.0
810,0,810,[ 69  95 286 204 196],378,4,2876,3.5462392108508016,0.0,0.0
811,0,811,[174  79 471 496 258],474,4,2880,3.5467980295566504,0.0,20.0
812,0,812,[ 70  89 515 185 182],271,2,2882,3.5448954489544895,0.0,0.0
813,0,813,[302 603 427 313  64],90,5,2887,3.5466830466830466,20.0,0.0
814,0,814,[ 56  82 200 204   4],59,5,2892,3.5484662576687116,0.0,0.0
815,0,815,[357  89 180 182 228],488,3,2895,3.547794117647059,20.0,0.0
816,0,816,[ 64 357  22 568 121],387,2,2897,3.5458996328029375,20.0,0.0
817,0,817,[204 180 742  15 174],533,4,2901,3.5464547677261615,0.0,20.0
818,0,818,[ 97 195 168 186 176],379,3,2904,3.5457875457875456,0.0,0.0
819,0,819,[151 273 475 179 423],308,4,2908,3.546341463414634,0.0,0.0
820,0,820,[588 215 222 210 176],815,4,2912,3.5468940316686965,0.0,0.0
821,0,821,[187 333 678 258 186],13,3,2915,3.546228710462287,0.0,0.0
822,0,822,[405 257 323 117 180],290,1,2916,3.543134872417983,0.0,0.0
823,0,823,[211 568 237  79  22],64,5,2921,3.5449029126213594,0.0,0.0
824,0,824,[302 603 427 313 127],13,5,2926,3.546666666666667,20.0,20.0
825,0,825,[294 182  69 185 322],234,1,2927,3.543583535108959,0.0,0.0
826,0,826,[187 475 195 121 318],533,4,2931,3.5441354292623943,20.0,0.0
827,0,827,[ 12 176  28 427 216],7,4,2935,3.5446859903381642,20.0,0.0
828,0,828,[273 301 294 471 276],145,4,2939,3.545235223160434,0.0,0.0
829,0,829,[ 11 135   9 222 118],145,3,2942,3.544578313253012,0.0,0.0
830,0,830,[405 471  88 197 196],374,3,2945,3.5439229843561972,0.0,0.0
831,0,831,[475 222 385 471 483],479,3,2948,3.543269230769231,20.0,0.0
832,0,832,[282 174 322 515 180],311,5,2953,3.545018007202881,0.0,20.0
833,0,833,[196 403 186 182 568],95,3,2956,3.5443645083932855,0.0,0.0
834,0,834,[ 89 197  70 588 175],406,4,2960,3.5449101796407185,0.0,0.0
835,0,835,[655  22 276 273 210],59,4,2964,3.5454545454545454,0.0,0.0
836,0,836,[302 603 427 313 127],334,5,2969,3.5471923536439665,20.0,20.0
837,0,837,[282 427 172 275  11],328,2,2971,3.545346062052506,0.0,0.0
838,0,838,[508 423 276 546  89],339,4,2975,3.545887961859356,0.0,0.0
839,0,839,[215 144  11  15   4],749,5,2980,3.5476190476190474,0.0,0.0
840,0,840,[302 603 427 313 127],14,3,2983,3.5469678953626635,20.0,20.0
841,0,841,[302 603 427 313 191],537,5,2988,3.548693586698337,20.0,0.0
842,0,842,[302 603 427 313 191],537,5,2993,3.550415183867141,20.0,0.0
843,0,843,[ 69 435 323 185 603],537,2,2995,3.5485781990521326,20.0,0.0
844,0,844,[286 471 174 179  79],666,3,2998,3.5479289940828402,0.0,20.0
845,0,845,[313 153 127  79 276],883,4,3002,3.548463356973995,0.0,20.0
846,0,846,[172 135 318 276 323],374,2,3004,3.5466351829988194,20.0,0.0
847,0,847,[ 50 568  88 173 174],659,3,3007,3.545990566037736,0.0,40.0
848,0,848,[742   9 118 333   8],298,4,3011,3.546525323910483,0.0,0.0
849,0,849,[174 655 161 546 228],234,0,3011,3.5423529411764707,0.0,20.0
850,0,850,[302 603 427 313 191],13,4,3015,3.54289071680376,20.0,0.0
851,0,851,[257  89 294  64 168],374,1,3016,3.539906103286385,0.0,0.0
852,0,852,[302 603 427 313  64],90,5,3021,3.541617819460727,20.0,0.0
853,0,853,[210 168  98 289 153],234,2,3023,3.5398126463700232,0.0,20.0
854,0,854,[276 187 179  22  25],90,5,3028,3.5415204678362575,0.0,0.0
855,0,855,[302 603 427 313  64],669,5,3033,3.5432242990654204,20.0,0.0
856,0,856,[ 50 182  79 161 515],313,5,3038,3.544924154025671,0.0,20.0
857,0,857,[ 50 275 211 135  89],474,4,3042,3.5454545454545454,0.0,20.0
858,0,858,[228 187  88 172 211],749,4,3046,3.545983701979045,0.0,0.0
859,0,859,[238 180 183 195  11],59,5,3051,3.547674418604651,0.0,0.0
860,0,860,[ 15 121 385 742 258],59,3,3054,3.5470383275261326,0.0,0.0
861,0,861,[302 603 427 313  64],454,5,3059,3.5487238979118327,20.0,0.0
862,0,862,[275 183 257  69  11],499,3,3062,3.5480880648899187,0.0,0.0
863,0,863,[302 603 427 313  64],90,5,3067,3.5497685185185186,20.0,0.0
864,0,864,[153 121 357  70 175],194,1,3068,3.5468208092485547,20.0,0.0
865,0,865,[ 89 100 234 127 174],664,4,3072,3.5473441108545036,0.0,60.0
866,0,866,[265 153 210 161 135],313,4,3076,3.5478662053056516,0.0,0.0
867,0,867,[508 234 196  98 313],92,5,3081,3.5495391705069124,0.0,20.0
868,0,868,[300  71  95 245 187],313,3,3084,3.5489067894131185,0.0,0.0
869,0,869,[183 174 196 125 333],815,4,3088,3.5494252873563217,0.0,20.0
870,0,870,[172 180  89  28 318],892,5,3093,3.5510907003444316,20.0,0.0
871,0,871,[238 318 597  25 168],59,4,3097,3.551605504587156,20.0,0.0
872,0,872,[302 603 427 313  64],13,5,3102,3.5532646048109964,20.0,0.0
873,0,873,[197 234  50 180 508],13,4,3106,3.553775743707094,0.0,20.0
874,0,874,[211  28 273  70 286],537,2,3108,3.552,0.0,0.0
875,0,875,[153 496 151 135 144],60,4,3112,3.5525114155251143,0.0,0.0
876,0,876,[302 603 427 313  64],271,5,3117,3.5541619156214366,20.0,0.0
877,0,877,[258 144  95 405  71],738,3,3120,3.5535307517084282,0.0,0.0
878,0,878,[423 195 196 135 288],7,5,3125,3.5551763367463027,0.0,0.0
879,0,879,[302 603 427 313  64],271,5,3130,3.5568181818181817,20.0,0.0
880,0,880,[ 28 289 216 275 182],378,5,3135,3.5584562996594777,0.0,0.0
881,0,881,[483 318 357  97 385],59,5,3140,3.560090702947846,60.0,0.0
882,0,882,[323 301 322 222 176],788,2,3142,3.5583238958097394,0.0,0.0
883,0,883,[180 202 289 234 333],881,3,3145,3.5576923076923075,0.0,0.0
884,0,884,[100 257 238 175 185],474,4,3149,3.55819209039548,0.0,20.0
885,0,885,[302 603 427 313  64],474,5,3154,3.559819413092551,20.0,0.0
886,0,886,[471 301 258 678   7],13,1,3155,3.556933483652762,0.0,0.0
887,0,887,[ 56 496 403 180 215],308,3,3158,3.5563063063063063,0.0,0.0
888,0,888,[275 294   4  70 100],554,2,3160,3.5545556805399325,0.0,20.0
889,0,889,[302 603 427 313  64],13,5,3165,3.556179775280899,20.0,0.0
890,0,890,[175 202   9 187 210],326,1,3166,3.55331088664422,0.0,0.0
891,0,891,[427 276 475  69 127],537,4,3170,3.5538116591928253,0.0,20.0
892,0,892,[ 79 174 117 222 195],479,4,3174,3.5543113101903696,0.0,20.0
893,0,893,[ 50  69 200 288 179],643,3,3177,3.553691275167785,0.0,20.0
894,0,894,[302 603 427 313  64],13,5,3182,3.5553072625698325,20.0,0.0
895,0,895,[181 222 237  56 405],82,1,3183,3.552455357142857,0.0,0.0
896,0,896,[302 603 427 313  64],669,5,3188,3.5540691192865106,20.0,0.0
897,0,897,[179 286 385  88 202],650,1,3189,3.5512249443207127,0.0,0.0
898,0,898,[151  22 258  50 117],447,4,3193,3.5517241379310347,0.0,20.0
899,0,899,[210  82  88 153 435],207,2,3195,3.55,0.0,0.0
900,0,900,[238 173  98 471 222],213,3,3198,3.549389567147614,0.0,20.0
901,0,901,[ 82 111 288 313  70],537,2,3200,3.5476718403547673,0.0,0.0
902,0,902,[318 117 302 196 222],343,4,3204,3.548172757475083,20.0,0.0
903,0,903,[678 289 118 471 258],455,3,3207,3.547566371681416,0.0,0.0
904,0,904,[204   4 294 197  82],207,2,3209,3.54585635359116,0.0,0.0
905,0,905,[181 237 185 175 151],60,5,3214,3.5474613686534218,0.0,0.0
906,0,906,[302 603 427 313  64],90,5,3219,3.5490628445424477,20.0,0.0
907,0,907,[471 202   8  89  70],13,3,3222,3.548458149779736,0.0,0.0
908,0,908,[181 258 168 328 185],102,1,3223,3.5456545654565454,0.0,0.0
909,0,909,[121 423 228 172   4],554,4,3227,3.546153846153846,0.0,0.0
910,0,910,[302 603 427 313  64],90,5,3232,3.5477497255762898,20.0,0.0
911,0,911,[302 603 427 313  64],13,5,3237,3.549342105263158,20.0,0.0
912,0,912,[603 276 185 151 385],537,3,3240,3.5487404162102956,20.0,0.0
913,0,913,[ 69 117 179 180 515],13,2,3242,3.5470459518599564,0.0,0.0
914,0,914,[197 228  69  79  96],664,3,3245,3.546448087431694,0.0,0.0
915,0,915,[302 603 427 313  64],669,5,3250,3.5480349344978164,20.0,0.0
916,0,916,[302 603 427 313  64],90,5,3255,3.549618320610687,20.0,0.0
917,0,917,[186  79 268 215 135],537,3,3258,3.549019607843137,0.0,0.0
918,0,918,[588 182  96 222  89],881,2,3260,3.547334058759521,0.0,0.0
919,0,919,[125  25 179 258 275],271,2,3262,3.5456521739130435,0.0,0.0
920,0,920,[748 197 427  98 127],313,4,3266,3.54614549402823,0.0,40.0
921,0,921,[185  64 496  88 385],42,5,3271,3.5477223427331888,0.0,0.0
922,0,922,[237  56 153  70 483],454,2,3273,3.5460455037919827,20.0,0.0
923,0,923,[111  79  22 273 546],234,1,3274,3.5432900432900434,0.0,0.0
924,0,924,[258 273  69 265 183],64,3,3277,3.5427027027027025,0.0,0.0
925,0,925,[ 25 237 161  22 275],474,4,3281,3.5431965442764577,0.0,0.0
926,0,926,[ 98 127   4 483 265],339,4,3285,3.5436893203883497,20.0,40.0
927,0,927,[273 117 211   9 323],328,3,3288,3.543103448275862,0.0,0.0
928,0,928,[302 603 427 313  64],13,5,3293,3.5446716899892357,20.0,0.0
929,0,929,[322 483 172 471 508],474,3,3296,3.544086021505376,20.0,0.0
930,0,930,[ 96 180 215   1 300],892,5,3301,3.5456498388829214,0.0,0.0
931,0,931,[215 603 151 187   1],537,2,3303,3.5439914163090127,20.0,0.0
932,0,932,[302 603 427 313  64],474,5,3308,3.545551982851018,20.0,0.0
933,0,933,[185 423 328 168 435],234,1,3309,3.5428265524625266,0.0,0.0
934,0,934,[302 603 427 313  64],271,5,3314,3.544385026737968,20.0,0.0
935,0,935,[238 211 183 194  25],7,4,3318,3.5448717948717947,0.0,0.0
936,0,936,[ 15 294 655  95 197],479,3,3321,3.544290288153682,0.0,0.0
937,0,937,[302 143 496 471  98],454,3,3324,3.5437100213219614,0.0,20.0
938,0,938,[  8 191 176 288  97],892,5,3329,3.5452609158679445,0.0,0.0
939,0,939,[302 603 427 313  64],537,4,3333,3.545744680851064,20.0,0.0
940,0,940,[121 748 427 294  12],328,2,3335,3.544102019128587,20.0,0.0
941,0,941,[288 173  98 132 403],843,1,3336,3.5414012738853504,0.0,20.0
942,0,942,[318  79 588   7  96],452,3,3339,3.5408271474019086,20.0,0.0
943,0,943,[655 195  50 194 132],881,2,3341,3.5391949152542375,0.0,20.0
944,0,944,[302 603 427 313  64],669,5,3346,3.5407407407407407,20.0,0.0
945,0,945,[655 323 286 185 257],474,3,3349,3.540169133192389,0.0,0.0
946,0,946,[151 117 143  69 496],200,4,3353,3.5406546990496306,0.0,0.0
947,0,947,[125 288 187 405  97],897,5,3358,3.542194092827004,0.0,0.0
948,0,948,[588 222 135 121  22],536,4,3362,3.542676501580611,0.0,0.0
949,0,949,[269   9 435 194 265],883,2,3364,3.5410526315789475,0.0,0.0
950,0,950,[121 328  11 174 515],13,2,3366,3.5394321766561516,0.0,20.0
951,0,951,[333 385 318 328 403],313,4,3370,3.5399159663865545,20.0,0.0
952,0,952,[435 228 144 282 204],194,3,3373,3.539349422875131,0.0,0.0
953,0,953,[302 603 427 313  64],454,5,3378,3.540880503144654,20.0,0.0
954,0,954,[302 603 427 313  64],90,5,3383,3.5424083769633508,20.0,0.0
955,0,955,[100  22 742 179 180],524,3,3386,3.5418410041841004,0.0,20.0
956,0,956,[187   1  25 194 333],458,2,3388,3.5402298850574714,0.0,0.0
957,0,957,[302 603 427 313  64],13,5,3393,3.5417536534446765,20.0,0.0
958,0,958,[153 185 496 427 222],932,5,3398,3.543274244004171,0.0,0.0
959,0,959,[117 173 174 655  50],378,4,3402,3.54375,0.0,40.0
960,0,960,[ 97 182 161 228 588],234,0,3402,3.5400624349635796,0.0,0.0
961,0,961,[237 174 385  96  15],308,3,3405,3.5395010395010393,0.0,20.0
962,0,962,[111 546 288  97 322],234,0,3405,3.5358255451713396,0.0,0.0
963,0,963,[546 215  70 234 183],13,3,3408,3.5352697095435683,0.0,0.0
964,0,964,[144 588 235 294 265],308,1,3409,3.532642487046632,0.0,0.0
965,0,965,[ 56 127 286 568 135],207,3,3412,3.5320910973084887,0.0,20.0
966,0,966,[655 403 405 257 182],815,2,3414,3.530506721820062,0.0,0.0
967,0,967,[ 97 258 200 196 125],378,3,3417,3.5299586776859506,0.0,0.0
968,0,968,[ 69  97 546 286 228],533,3,3420,3.5294117647058822,0.0,0.0
969,0,969,[144  79  69 172   7],60,5,3425,3.5309278350515463,0.0,0.0
970,0,970,[294 265 197 202 191],666,3,3428,3.53038105046344,0.0,0.0
971,0,971,[302 603 427 313  64],13,5,3433,3.5318930041152266,20.0,0.0
972,0,972,[215 234  98 238 655],7,5,3438,3.5334018499486124,0.0,20.0
973,0,973,[ 89 186  79 151 176],308,5,3443,3.534907597535934,0.0,0.0
974,0,974,[ 11 427  98 276 403],59,5,3448,3.536410256410256,0.0,20.0
975,0,975,[273  11 286 235   1],537,0,3448,3.5327868852459017,0.0,0.0
976,0,976,[ 25 288 228  15 186],537,1,3449,3.5301944728761514,0.0,0.0
977,0,977,[385 328 405 161 322],533,4,3453,3.5306748466257667,0.0,0.0
978,0,978,[111 268 405   7 210],92,3,3456,3.530132788559755,0.0,0.0
979,0,979,[135 238  98 174 385],774,2,3458,3.5285714285714285,0.0,40.0
980,0,980,[ 70   7   1   4 118],374,3,3461,3.5280326197757392,0.0,0.0
981,0,981,[515 143 196 172 357],184,4,3465,3.5285132382892055,20.0,0.0
982,0,982,[186 471 748 228 318],311,4,3469,3.5289928789420144,20.0,0.0
983,0,983,[153  64  88 127 117],308,4,3473,3.529471544715447,0.0,20.0
984,0,984,[180 144 196 187 135],653,3,3476,3.5289340101522844,0.0,0.0
985,0,985,[423 257 357  69 318],454,4,3480,3.5294117647058822,40.0,0.0
986,0,986,[ 25 597  71  56 117],650,1,3481,3.5268490374873354,0.0,0.0
987,0,987,[313 269 125  28 515],455,4,3485,3.527327935222672,0.0,0.0
988,0,988,[302 603 427 313  64],669,5,3490,3.5288169868554093,20.0,0.0
989,0,989,[ 12 111 204 187 168],524,2,3492,3.5272727272727273,20.0,0.0
990,0,990,[403 257 187   1 435],308,5,3497,3.5287588294651866,0.0,0.0
991,0,991,[273 275 100  11 144],7,3,3500,3.528225806451613,0.0,20.0
992,0,992,[333 100  98 282 185],328,3,3503,3.527693856998993,0.0,40.0
993,0,993,[215 210 742 403 185],308,4,3507,3.528169014084507,0.0,0.0
994,0,994,[ 95 385 742 161  22],378,5,3512,3.52964824120603,0.0,0.0
995,0,995,[195 475 194   8 300],125,4,3516,3.5301204819277108,0.0,0.0
996,0,996,[202 215 125 196 245],804,5,3521,3.531594784353059,0.0,0.0
997,0,997,[302 603 427 313  64],537,4,3525,3.532064128256513,20.0,0.0
998,0,998,[515  12 100 195 300],64,4,3529,3.5325325325325325,20.0,20.0
999,0,999,[182 313  56 333 271],145,4,3533,3.533,0.0,0.0
1000,0,1000,[ 25 748 300 117 100],533,4,3537,3.5334665334665334,0.0,20.0
1001,0,1001,[187  22 302 174 111],543,4,3541,3.5339321357285427,0.0,20.0
1002,0,1002,[301 275  12 323 568],378,3,3544,3.5333998005982052,20.0,0.0
1003,0,1003,[ 15 161  96 179 197],650,2,3546,3.5318725099601593,0.0,0.0
1004,0,1004,[179 568 228 135   1],194,2,3548,3.530348258706468,0.0,0.0
1005,0,1005,[  7 228 161 301 100],13,3,3551,3.529821073558648,0.0,20.0
1006,0,1006,[302 603 427 313  64],90,5,3556,3.5312810327706057,20.0,0.0
1007,0,1007,[302 603 427 313  64],537,4,3560,3.5317460317460316,20.0,0.0
1008,0,1008,[ 50  82  15 403 245],92,3,3563,3.531219028741328,0.0,20.0
1009,0,1009,[265  71  98 435 258],533,4,3567,3.5316831683168317,0.0,20.0
1010,0,1010,[181 117   1 176  89],144,4,3571,3.532146389713155,0.0,0.0
1011,0,1011,[175 508 127  98 515],232,2,3573,3.530632411067194,0.0,40.0
1012,0,1012,[302 603 427 313  64],90,5,3578,3.5320829220138203,20.0,0.0
1013,0,1013,[273 215 234 328 288],234,1,3579,3.529585798816568,0.0,0.0
1014,0,1014,[271 496 515 238 186],64,4,3583,3.530049261083744,0.0,0.0
1015,0,1015,[237  12 294 215 313],144,5,3588,3.531496062992126,20.0,0.0
1016,0,1016,[333 228  69  89 100],313,4,3592,3.5319567354965584,0.0,20.0
1017,0,1017,[197 176 195  82 288],643,4,3596,3.5324165029469548,0.0,0.0
1018,0,1018,[323 568 194 597 161],13,2,3598,3.5309126594700686,0.0,0.0
1019,0,1019,[603 423 179  28 496],339,4,3602,3.5313725490196077,20.0,0.0
1020,0,1020,[302 603 427 313  64],90,5,3607,3.53281096963761,20.0,0.0
1021,0,1021,[200 235 546 228 323],328,1,3608,3.5303326810176126,0.0,0.0
1022,0,1022,[302 603 427 313  64],13,5,3613,3.5317693059628543,20.0,0.0
1023,0,1023,[302 603 427 313  64],537,4,3617,3.5322265625,20.0,0.0
1024,0,1024,[302 603 427 313  64],271,5,3622,3.533658536585366,20.0,0.0
1025,0,1025,[  8 471 180 655 423],13,4,3626,3.53411306042885,0.0,0.0
1026,0,1026,[228   7 288 211  69],447,5,3631,3.5355404089581306,0.0,0.0
1027,0,1027,[127 546 471 196 118],343,3,3634,3.535019455252918,0.0,20.0
1028,0,1028,[173 678  71 403  88],506,4,3638,3.5354713313896986,0.0,0.0
1029,0,1029,[135  79 322 144 127],13,3,3641,3.5349514563106794,0.0,20.0
1030,0,1030,[302 603 427 313  64],669,5,3646,3.536372453928225,20.0,0.0
1031,0,1031,[182 286 403  69 405],318,2,3648,3.5348837209302326,0.0,0.0
1032,0,1032,[204  11 117   7 125],213,5,3653,3.5363020329138433,0.0,0.0
1033,0,1033,[302 603 427 313  64],13,5,3658,3.5377176015473886,20.0,0.0
1034,0,1034,[302 603 427 313  64],669,5,3663,3.5391304347826087,20.0,0.0
1035,0,1035,[117  56   9 286   8],90,4,3667,3.5395752895752897,0.0,0.0
1036,0,1036,[302 603 427 313  64],13,5,3672,3.540983606557377,20.0,0.0
1037,0,1037,[ 15 118   7 282 222],634,4,3676,3.541425818882466,0.0,0.0
1038,0,1038,[144 273  98 322 405],883,3,3679,3.5409047160731473,0.0,20.0
1039,0,1039,[286 423 118 546 228],7,4,3683,3.541346153846154,0.0,0.0
1040,0,1040,[302 603 427 313  64],669,5,3688,3.542747358309318,20.0,0.0
1041,0,1041,[302 603 427 313  64],90,5,3693,3.5441458733205375,20.0,0.0
1042,0,1042,[215 121 204  97 187],479,3,3696,3.5436241610738257,0.0,0.0
1043,0,1043,[121 174 187  56  95],892,5,3701,3.5450191570881224,0.0,20.0
1044,0,1044,[ 11 471 678 222 385],13,0,3701,3.5416267942583732,0.0,0.0
1045,0,1045,[302 603 427 313  64],474,5,3706,3.54302103250478,20.0,0.0
1046,0,1046,[186  95 118 197 215],378,3,3709,3.542502387774594,0.0,0.0
1047,0,1047,[427 475  25 568  88],308,5,3714,3.5438931297709924,0.0,0.0
1048,0,1048,[ 64 197 187 275  70],308,4,3718,3.544327931363203,0.0,0.0
1049,0,1049,[200 153  15 182  22],313,1,3719,3.541904761904762,0.0,0.0
1050,0,1050,[ 56  15 245 483 179],200,4,3723,3.542340627973359,20.0,0.0
1051,0,1051,[211  79  89 194 357],833,2,3725,3.540874524714829,20.0,0.0
1052,0,1052,[ 70  22 151 135 132],537,2,3727,3.539411206077873,0.0,0.0
1053,0,1053,[ 70 172  64 176 181],666,3,3730,3.538899430740038,0.0,0.0
1054,0,1054,[302 603 427 313  64],537,4,3734,3.539336492890995,20.0,0.0
1055,0,1055,[288 168 228  88 385],279,3,3737,3.538825757575758,0.0,0.0
1056,0,1056,[318 197 603 185 238],666,5,3742,3.5402081362346265,40.0,0.0
1057,0,1057,[385 181 185 237 483],454,1,3743,3.5378071833648392,20.0,0.0
1058,0,1058,[ 98 318 187 238 222],13,2,3745,3.5363550519357885,20.0,20.0
1059,0,1059,[742 143 168 282  98],881,4,3749,3.5367924528301886,0.0,20.0
1060,0,1060,[173 234 237  82 215],524,3,3752,3.536286522148916,0.0,0.0
1061,0,1061,[302 603 427 313 127],669,5,3757,3.5376647834274952,20.0,20.0
1062,0,1062,[302 603 427 313 127],13,5,3762,3.5390404515522107,20.0,20.0
1063,0,1063,[ 69 204 118 143 234],666,0,3762,3.5357142857142856,0.0,0.0
1064,0,1064,[257 210 180  64 195],653,4,3766,3.536150234741784,0.0,0.0
1065,0,1065,[302 603 427 313 127],537,5,3771,3.5375234521575987,20.0,20.0
1066,0,1066,[204 144 121  96 385],843,0,3771,3.534208059981256,0.0,0.0
1067,0,1067,[302 603 427 313 127],90,5,3776,3.5355805243445695,20.0,20.0
1068,0,1068,[323 300 111 125 471],294,3,3779,3.5350795135640785,0.0,0.0
1069,0,1069,[168 435 185  11 269],666,5,3784,3.5364485981308413,0.0,0.0
1070,0,1070,[302 603 427 313 127],537,5,3789,3.53781512605042,20.0,20.0
1071,0,1071,[ 69 471 568 174 322],207,3,3792,3.537313432835821,0.0,20.0
1072,0,1072,[427 196  97 515  12],339,5,3797,3.5386766076421248,20.0,0.0
1073,0,1073,[286 118 200 328 197],13,2,3799,3.537243947858473,0.0,0.0
1074,0,1074,[121  69  22 385 204],194,3,3802,3.5367441860465116,0.0,0.0
1075,0,1075,[302 603 427 313 127],537,5,3807,3.5381040892193307,20.0,20.0
1076,0,1076,[302 603 427 313 127],13,5,3812,3.539461467038069,20.0,20.0
1077,0,1077,[302 603 427 313 127],537,5,3817,3.5408163265306123,20.0,20.0
1078,0,1078,[196 127  56 121 168],346,4,3821,3.541241890639481,0.0,20.0
1079,0,1079,[ 89 183 211 427 496],60,5,3826,3.5425925925925927,0.0,0.0
1080,0,1080,[237 135 302 238 423],537,3,3829,3.54209065679926,0.0,0.0
1081,0,1081,[385 191 153 173 185],454,1,3830,3.5397412199630316,0.0,0.0
1082,0,1082,[  9 174 302 172   7],788,3,3833,3.5392428439519854,0.0,20.0
1083,0,1083,[111  11 186  97  64],64,4,3837,3.5396678966789668,0.0,0.0
1084,0,1084,[ 88 174 196 568  96],881,2,3839,3.5382488479262673,0.0,20.0
1085,0,1085,[174  22 118 204 238],881,4,3843,3.5386740331491713,0.0,20.0
1086,0,1086,[302 603 427 313 127],669,5,3848,3.5400183992640293,20.0,20.0
1087,0,1087,[302 603 427 313 127],334,5,3853,3.541360294117647,20.0,20.0
1088,0,1088,[294 161 238  25 568],207,3,3856,3.5408631772268135,0.0,0.0
1089,0,1089,[302 603 427 313 127],669,5,3861,3.5422018348623854,20.0,20.0
1090,0,1090,[ 22  98 237 143 496],334,3,3864,3.5417048579285058,0.0,20.0
1091,0,1091,[435  12  97 471 322],537,0,3864,3.5384615384615383,20.0,0.0
1092,0,1092,[302 603 427 313 127],271,5,3869,3.5397987191216833,20.0,20.0
1093,0,1093,[191 333 603 275  12],13,2,3871,3.5383912248628886,40.0,0.0
1094,0,1094,[302 603 427 313 127],271,5,3876,3.5397260273972604,20.0,20.0
1095,0,1095,[405 294  28 435 323],13,2,3878,3.5383211678832116,0.0,0.0
1096,0,1096,[111  69 204 508 237],447,3,3881,3.5378304466727437,0.0,0.0
1097,0,1097,[ 28 204   7 423  79],653,3,3884,3.5373406193078325,0.0,0.0
1098,0,1098,[742  79 173 180  22],378,4,3888,3.537761601455869,0.0,0.0
1099,0,1099,[318 289 288  96 546],378,3,3891,3.537272727272727,20.0,0.0
1100,0,1100,[183 483 191  56 204],234,3,3894,3.536784741144414,20.0,0.0
1101,0,1101,[176   9 185 235  69],406,5,3899,3.5381125226860255,0.0,0.0
1102,0,1102,[403 196 269 183 276],378,5,3904,3.5394378966455124,0.0,0.0
1103,0,1103,[144 127 471 435 179],666,4,3908,3.539855072463768,0.0,20.0
1104,0,1104,[215 273 161 191 471],92,4,3912,3.5402714932126695,0.0,0.0
1105,0,1105,[195 151 182 127 300],666,2,3914,3.538878842676311,0.0,20.0
1106,0,1106,[302 603 427 313 127],537,5,3919,3.5401987353206867,20.0,20.0
1107,0,1107,[323  96 265 183 405],13,3,3922,3.53971119133574,0.0,0.0
1108,0,1108,[258 301  56 194 423],666,3,3925,3.539224526600541,0.0,0.0
1109,0,1109,[568 117 678  82  96],13,1,3926,3.536936936936937,0.0,0.0
1110,0,1110,[302 603 427 313 127],14,3,3929,3.5364536453645363,20.0,20.0
1111,0,1111,[153 275 121 135 172],13,4,3933,3.536870503597122,0.0,0.0
1112,0,1112,[282  11 216 286 144],328,2,3935,3.5354896675651393,0.0,0.0
1113,0,1113,[ 12  89 471 194   4],194,3,3938,3.535008976660682,20.0,0.0
1114,0,1114,[302 603 427 313 127],474,5,3943,3.536322869955157,20.0,20.0
1115,0,1115,[196 215 117 273  50],346,3,3946,3.53584229390681,0.0,20.0
1116,0,1116,[172 200   1 238 125],653,2,3948,3.5344673231871084,0.0,0.0
1117,0,1117,[ 71 121  88 144 496],749,4,3952,3.5348837209302326,0.0,0.0
1118,0,1118,[302 603 427 313 127],669,5,3957,3.5361930294906165,20.0,20.0
1119,0,1119,[655   7  98 318 275],378,5,3962,3.5375,20.0,20.0
1120,0,1120,[  4 273 216  70 144],643,3,3965,3.5370205173951828,0.0,0.0
1121,0,1121,[294 385 603 185  96],474,4,3969,3.537433155080214,20.0,0.0
1122,0,1122,[ 97 183  28   4 151],474,4,3973,3.5378450578806766,0.0,0.0
1123,0,1123,[211 216 174   4  28],13,4,3977,3.538256227758007,0.0,20.0
1124,0,1124,[302 603 427 313 127],334,5,3982,3.5395555555555553,20.0,20.0
1125,0,1125,[151 423 168 357 176],533,2,3984,3.5381882770870337,20.0,0.0
1126,0,1126,[ 28 435  69 265 515],380,3,3987,3.5377107364685005,0.0,0.0
1127,0,1127,[435 423  69  64 161],452,4,3991,3.5381205673758864,0.0,0.0
1128,0,1128,[197 496 234  56 127],311,5,3996,3.5394154118689105,0.0,20.0
1129,0,1129,[ 69 204 196 181 125],263,5,4001,3.54070796460177,0.0,0.0
1130,0,1130,[ 96 100   1  82 118],653,4,4005,3.5411140583554377,0.0,20.0
1131,0,1131,[210 187 742 197 403],533,4,4009,3.541519434628975,0.0,0.0
1132,0,1132,[258 180   8 216 132],488,1,4010,3.5392762577228596,0.0,0.0
1133,0,1133,[211  89 100 405 435],638,2,4012,3.5379188712522045,0.0,20.0
1134,0,1134,[ 12 269  82  98 117],524,2,4014,3.5365638766519822,20.0,20.0
1135,0,1135,[275  79 197 588  11],7,4,4018,3.5369718309859155,0.0,0.0
1136,0,1136,[153 202  15 161 215],454,2,4020,3.5356200527704487,0.0,0.0
1137,0,1137,[144 328 282 211 273],328,3,4023,3.5351493848857647,0.0,0.0
1138,0,1138,[302 603 427 313 127],14,3,4026,3.5346795434591747,20.0,20.0
1139,0,1139,[ 97 655 202 257 185],881,4,4030,3.5350877192982457,0.0,0.0
1140,0,1140,[  8 403  88 257 228],533,3,4033,3.534618755477651,0.0,0.0
1141,0,1141,[  7 289 121  79   4],334,2,4035,3.533274956217163,0.0,0.0
1142,0,1142,[  1 515 151  12 181],339,5,4040,3.5345581802274717,20.0,0.0
1143,0,1143,[ 25 176 282 748 288],200,4,4044,3.534965034965035,0.0,0.0
1144,0,1144,[197 238 273 117 234],524,3,4047,3.5344978165938863,0.0,0.0
1145,0,1145,[302 603 427 313  64],537,4,4051,3.5349040139616057,20.0,0.0
1146,0,1146,[ 82 183 742 328 111],207,1,4052,3.5326939843068876,0.0,0.0
1147,0,1147,[403 234 195 111 228],749,4,4056,3.533101045296167,0.0,0.0
1148,0,1148,[515 328 175   8 185],334,4,4060,3.533507397737163,0.0,0.0
1149,0,1149,[302 603 427 313 127],537,5,4065,3.534782608695652,20.0,20.0
1150,0,1150,[ 28  50 204  98 181],91,5,4070,3.5360556038227626,0.0,40.0
1151,0,1151,[328 216 183 197 168],334,3,4073,3.5355902777777777,0.0,0.0
1152,0,1152,[176 196  64 179 174],666,3,4076,3.5351257588898526,0.0,20.0
1153,0,1153,[194 100 202   4 181],234,3,4079,3.5346620450606587,0.0,20.0
1154,0,1154,[302 603 427 313 127],90,5,4084,3.535930735930736,20.0,20.0
1155,0,1155,[258   1 111 121  69],537,1,4085,3.533737024221453,0.0,0.0
1156,0,1156,[302 603 427 313 127],14,3,4088,3.533275713050994,20.0,20.0
1157,0,1157,[ 22 204 238 195 174],207,1,4089,3.5310880829015545,0.0,20.0
1158,0,1158,[ 22 265 228 300 515],334,3,4092,3.530629853321829,0.0,0.0
1159,0,1159,[210 238 273  15 196],59,4,4096,3.5310344827586206,0.0,0.0
1160,0,1160,[  4 215 515 269 183],537,1,4097,3.52885443583118,0.0,0.0
1161,0,1161,[300  12 111 318 222],378,3,4100,3.5283993115318415,40.0,0.0
1162,0,1162,[191 100 222   1 176],650,4,4104,3.528804815133276,0.0,20.0
1163,0,1163,[176 288 182 143 508],339,4,4108,3.529209621993127,0.0,0.0
1164,0,1164,[222 183 322 144  69],488,3,4111,3.528755364806867,0.0,0.0
1165,0,1165,[181 211 294  88 748],207,1,4112,3.5265866209262438,0.0,0.0
1166,0,1166,[ 89 385 228  96 194],643,3,4115,3.526135389888603,0.0,0.0
1167,0,1167,[258 172   4 568 187],328,3,4118,3.5256849315068495,0.0,0.0
1168,0,1168,[302 603 427 313  64],669,5,4123,3.5269461077844313,20.0,0.0
1169,0,1169,[405 200 144  50 742],95,3,4126,3.5264957264957264,0.0,20.0
1170,0,1170,[ 22 215 357 202 185],479,4,4130,3.5269000853970964,20.0,0.0
1171,0,1171,[187  28 678 180  88],188,2,4132,3.525597269624573,0.0,0.0
1172,0,1172,[211 435 121 313 161],308,2,4134,3.524296675191816,0.0,0.0
1173,0,1173,[180   1 508 125 121],653,3,4137,3.5238500851788754,0.0,0.0
1174,0,1174,[403  96 237 435  82],749,4,4141,3.5242553191489363,0.0,0.0
1175,0,1175,[403 168 172 318  98],815,4,4145,3.5246598639455784,20.0,20.0
1176,0,1176,[ 70 483 215  22 173],474,5,4150,3.525913338997451,20.0,0.0
1177,0,1177,[  1 300  70 175 143],125,3,4153,3.525466893039049,0.0,0.0
1178,0,1178,[302 603 427 313  64],271,5,4158,3.5267175572519083,20.0,0.0
1179,0,1179,[127 200  50  70 357],328,5,4163,3.5279661016949153,20.0,40.0
1180,0,1180,[216 168 200 183 423],95,4,4167,3.5283657917019475,0.0,0.0
1181,0,1181,[475  69 265 174 100],387,3,4170,3.527918781725888,0.0,40.0
1182,0,1182,[  1 125 117 180  64],533,4,4174,3.5283178360101437,0.0,0.0
1183,0,1183,[181 127  12 302 174],458,3,4177,3.5278716216216215,20.0,40.0
1184,0,1184,[322  79 153 172  70],488,1,4178,3.5257383966244724,0.0,0.0
1185,0,1185,[168 182 597  25  96],119,5,4183,3.526981450252951,0.0,0.0
1186,0,1186,[ 11 200 194 187 276],537,2,4185,3.5256950294860996,0.0,0.0
1187,0,1187,[194 191 546 186   8],13,3,4188,3.525252525252525,0.0,0.0
1188,0,1188,[127 202 117  82  28],374,4,4192,3.5256518082422206,0.0,20.0
1189,0,1189,[302 603 427 313  64],537,4,4196,3.526050420168067,20.0,0.0
1190,0,1190,[ 25 515 211  28 186],85,3,4199,3.5256087321578504,0.0,0.0
1191,0,1191,[302 603 427 313 127],13,5,4204,3.5268456375838926,20.0,20.0
1192,0,1192,[ 79 385  96   8 143],13,2,4206,3.525565800502934,0.0,0.0
1193,0,1193,[  7 176  15 183 603],59,5,4211,3.5268006700167502,20.0,0.0
1194,0,1194,[  7 121 100 678 132],213,5,4216,3.5280334728033473,0.0,20.0
1195,0,1195,[132 475 427 202 215],90,2,4218,3.5267558528428093,0.0,0.0
1196,0,1196,[181 546 323   7  25],650,2,4220,3.5254803675856308,0.0,0.0
1197,0,1197,[435 496 172 588 181],7,4,4224,3.5258764607679467,0.0,0.0
1198,0,1198,[211 216 496   1  88],406,3,4227,3.5254378648874063,0.0,0.0
1199,0,1199,[228 385 276 202  71],92,4,4231,3.5258333333333334,0.0,0.0
1200,0,1200,[168  11 235 403 194],64,5,4236,3.527060782681099,0.0,0.0
1201,0,1201,[258 121 182 568  69],788,3,4239,3.526622296173045,0.0,0.0
1202,0,1202,[302 603 427 313 127],669,5,4244,3.5278470490440563,20.0,20.0
1203,0,1203,[135 111 143 228  96],524,2,4246,3.526578073089701,0.0,0.0
1204,0,1204,[187  12  88 204   1],308,5,4251,3.5278008298755186,20.0,0.0
1205,0,1205,[603 111 318 588 301],13,3,4254,3.527363184079602,40.0,0.0
1206,0,1206,[ 71 144  69  22 180],749,5,4259,3.528583264291632,0.0,0.0
1207,0,1207,[385 323 179 132 121],897,3,4262,3.5281456953642385,0.0,0.0
1208,0,1208,[183 302  69 174 435],339,5,4267,3.5293631100082714,0.0,20.0
1209,0,1209,[313 204 333 181 185],653,4,4271,3.5297520661157025,0.0,0.0
1210,0,1210,[ 12 742 322 471   4],524,3,4274,3.5293146160198186,20.0,0.0
1211,0,1211,[143 168 508 300 211],85,3,4277,3.528877887788779,0.0,0.0
1212,0,1212,[200 423 257 302 183],666,3,4280,3.528441879637263,0.0,0.0
1213,0,1213,[180 215  79 216  89],537,2,4282,3.5271828665568368,0.0,0.0
1214,0,1214,[200 427 302 186 238],537,4,4286,3.5275720164609052,0.0,0.0
1215,0,1215,[302 603 427 313 127],13,5,4291,3.528782894736842,20.0,20.0
1216,0,1216,[405 655 175 237 194],666,2,4293,3.5275267050123253,0.0,0.0
1217,0,1217,[403 143   8 197 496],378,3,4296,3.5270935960591134,0.0,0.0
1218,0,1218,[161  11 301 568 181],378,3,4299,3.526661197703035,0.0,0.0
1219,0,1219,[568 195 186  97  15],311,4,4303,3.527049180327869,0.0,0.0
1220,0,1220,[200 515 288 269  82],666,3,4306,3.526617526617527,0.0,0.0
1221,0,1221,[603  98 568   1 191],308,4,4310,3.5270049099836336,20.0,20.0
1222,0,1222,[302 603 427 313 127],474,5,4315,3.528209321340965,20.0,20.0
1223,0,1223,[258 179 597 300  22],653,4,4319,3.52859477124183,0.0,0.0
1224,0,1224,[302 603 427 313 127],14,3,4322,3.5281632653061226,20.0,20.0
1225,0,1225,[403 323 496 168 258],254,2,4324,3.5269168026101143,0.0,0.0
1226,0,1226,[151 153   7 286 588],234,0,4324,3.524042379788101,0.0,0.0
1227,0,1227,[215 173 151 195 176],882,5,4329,3.525244299674267,0.0,0.0
1228,0,1228,[ 15 475  25 258 238],474,5,4334,3.526444263628967,0.0,0.0
1229,0,1229,[302 603 427 313 127],13,5,4339,3.5276422764227644,20.0,20.0
1230,0,1230,[117 237   8   7 546],95,3,4342,3.527213647441105,0.0,0.0
1231,0,1231,[275 294 117 187 215],474,3,4345,3.5267857142857144,0.0,0.0
1232,0,1232,[118  50   8 180 117],840,3,4348,3.5263584752635846,0.0,20.0
1233,0,1233,[ 89 191 216 269 275],90,5,4353,3.527552674230146,0.0,0.0
1234,0,1234,[238 185 603 153 385],385,4,4357,3.5279352226720646,20.0,0.0
1235,0,1235,[385 127  70 288 168],234,1,4358,3.5258899676375406,0.0,20.0
1236,0,1236,[  7 588 271 357 568],537,2,4360,3.524656426839127,20.0,0.0
1237,0,1237,[234  56 173 282 196],92,4,4364,3.5250403877221324,0.0,0.0
1238,0,1238,[173 286  15 508 172],455,4,4368,3.5254237288135593,0.0,0.0
1239,0,1239,[ 69 515 172  70 257],95,5,4373,3.5266129032258067,0.0,0.0
1240,0,1240,[172  64 179 210 588],234,1,4374,3.524576954069299,0.0,0.0
1241,0,1241,[302 603 427 313 127],537,5,4379,3.525764895330113,20.0,20.0
1242,0,1242,[300  97 427 238 405],13,2,4381,3.5245374094931616,0.0,0.0
1243,0,1243,[135 215  89  98  56],92,5,4386,3.5257234726688105,0.0,20.0
1244,0,1244,[161   8 127 181 121],308,3,4389,3.525301204819277,0.0,20.0
1245,0,1245,[161  28 237 235 135],901,3,4392,3.524879614767255,0.0,0.0
1246,0,1246,[302 603 427 313 127],13,5,4397,3.526062550120289,20.0,20.0
1247,0,1247,[191 195 179  70  64],406,4,4401,3.5264423076923075,0.0,0.0
1248,0,1248,[302 603 427 313 127],669,5,4406,3.5276220976781425,20.0,20.0
1249,0,1249,[515 200 245 168  88],102,0,4406,3.5248,0.0,0.0
1250,0,1250,[245 117 181 286 237],533,3,4409,3.524380495603517,0.0,0.0
1251,0,1251,[185 132 403 234 172],650,3,4412,3.523961661341853,0.0,0.0
1252,0,1252,[143 318 196 288 471],666,2,4414,3.5227454110135676,20.0,0.0
1253,0,1253,[302 603 427 313 127],90,5,4419,3.5239234449760763,20.0,20.0
1254,0,1254,[ 71 100  12 111 300],64,3,4422,3.5235059760956173,20.0,20.0
1255,0,1255,[282 222 180 294   4],533,3,4425,3.5230891719745223,0.0,0.0
1256,0,1256,[302 603 427 313 127],537,5,4430,3.5242641209228323,20.0,20.0
1257,0,1257,[302 603 427 313 127],90,5,4435,3.52543720190779,20.0,20.0
1258,0,1258,[174 200 182   8 180],488,1,4436,3.523431294678316,0.0,20.0
1259,0,1259,[302 603 427 313 127],537,5,4441,3.5246031746031745,20.0,20.0
1260,0,1260,[132 427 678 328 204],334,2,4443,3.5233941316415542,0.0,0.0
1261,0,1261,[568 238 357 127   8],25,4,4447,3.523771790808241,20.0,20.0
1262,0,1262,[302 603 427 313 127],669,5,4452,3.5249406175771973,20.0,20.0
1263,0,1263,[ 15 176  89 200 423],881,3,4455,3.524525316455696,0.0,0.0
1264,0,1264,[ 28 172 546 678  70],13,2,4457,3.523320158102767,0.0,0.0
1265,0,1265,[ 95 180 118 318 508],59,4,4461,3.523696682464455,20.0,0.0
1266,0,1266,[153 168 275 175   9],7,5,4466,3.5248618784530388,0.0,0.0
1267,0,1267,[ 64 423 183 181  28],263,4,4470,3.5252365930599368,0.0,0.0
1268,0,1268,[174 195 546  96 385],533,4,4474,3.525610717100079,0.0,20.0
1269,0,1269,[216 268 175 173 300],334,3,4477,3.525196850393701,0.0,0.0
1270,0,1270,[194 186  70 301 423],666,2,4479,3.5239968528717545,0.0,0.0
1271,0,1271,[173 191 175 185 183],194,3,4482,3.5235849056603774,0.0,0.0
1272,0,1272,[318 265 210 204 211],188,5,4487,3.5247446975648073,20.0,0.0
1273,0,1273,[302 603 427 313 127],14,3,4490,3.524332810047096,20.0,20.0
1274,0,1274,[185  50 127  98 215],890,5,4495,3.5254901960784313,0.0,60.0
1275,0,1275,[302 603 427 313  64],90,5,4500,3.5266457680250785,20.0,0.0
1276,0,1276,[  9 228 117 268 288],13,2,4502,3.5254502740798745,0.0,0.0
1277,0,1277,[ 89 191 186  97 294],189,4,4506,3.5258215962441315,0.0,0.0
1278,0,1278,[ 95 215 300 200 423],313,3,4509,3.5254104769351056,0.0,0.0
1279,0,1279,[ 79 235 111 655 435],13,3,4512,3.525,0.0,0.0
1280,0,1280,[385 172   8  56 111],234,1,4513,3.5230288836846215,0.0,0.0
1281,0,1281,[196 471 121  98 181],533,5,4518,3.5241809672386895,0.0,20.0
1282,0,1282,[125 475 742 196   4],334,2,4520,3.5229929851909585,0.0,0.0
1283,0,1283,[302 603 427 313  64],454,5,4525,3.5241433021806854,20.0,0.0
1284,0,1284,[302 603 427 313  64],537,4,4529,3.5245136186770427,20.0,0.0
1285,0,1285,[405 153 237 121 185],313,2,4531,3.5233281493001556,0.0,0.0
1286,0,1286,[302 603 427 313  64],454,5,4536,3.5244755244755246,20.0,0.0
1287,0,1287,[275  22 333 111 135],64,4,4540,3.5248447204968945,0.0,0.0
1288,0,1288,[302 603 427 313  64],90,5,4545,3.525989138867339,20.0,0.0
1289,0,1289,[302 603 427 313  64],474,5,4550,3.5271317829457365,20.0,0.0
1290,0,1290,[302 603 427 313  64],454,5,4555,3.528272656855151,20.0,0.0
1291,0,1291,[234 200   7 179  25],881,2,4557,3.527089783281734,0.0,0.0
1292,0,1292,[288 175  71 151  50],308,5,4562,3.5282289249806653,0.0,20.0
1293,0,1293,[268 204 179 496 161],234,1,4563,3.526275115919629,0.0,0.0
1294,0,1294,[197 357 204 176 228],313,4,4567,3.5266409266409267,20.0,0.0
1295,0,1295,[196 496 588  50 403],42,4,4571,3.5270061728395063,0.0,20.0
1296,0,1296,[302 603 427 313  64],454,5,4576,3.528141865844256,20.0,0.0
1297,0,1297,[235  89 125 323 318],378,3,4579,3.5277349768875195,20.0,0.0
1298,0,1298,[257 211 286 180 357],95,3,4582,3.527328714395689,20.0,0.0
1299,0,1299,[  7   8 179 568  22],92,3,4585,3.526923076923077,0.0,0.0
1300,0,1300,[302 603 427 313  64],90,5,4590,3.5280553420445813,20.0,0.0
1301,0,1301,[268 323 385 496   4],537,2,4592,3.5268817204301075,0.0,0.0
1302,0,1302,[143 405  96 475 237],474,5,4597,3.528012279355334,0.0,0.0
1303,0,1303,[  1 405 183  88 200],374,4,4601,3.5283742331288344,0.0,0.0
1304,0,1304,[302  89 508 174 168],524,4,4605,3.528735632183908,0.0,20.0
1305,0,1305,[191 288 118  25 182],59,5,4610,3.529862174578867,0.0,0.0
1306,0,1306,[302 603 427 313  64],669,5,4615,3.5309869931140017,20.0,0.0
1307,0,1307,[471 194 403 202 176],311,5,4620,3.532110091743119,0.0,0.0
1308,0,1308,[127 125 100 144 204],207,2,4622,3.5309396485867075,0.0,40.0
1309,0,1309,[245 483 742 427 176],313,3,4625,3.530534351145038,20.0,0.0
1310,0,1310,[496 194 125 678 144],263,4,4629,3.530892448512586,0.0,0.0
1311,0,1311,[  9 245 196 172 258],749,4,4633,3.53125,0.0,0.0
1312,0,1312,[678 288  89 182 175],474,3,4636,3.530845392231531,0.0,0.0
1313,0,1313,[187 515   8 228  64],328,3,4639,3.5304414003044142,0.0,0.0
1314,0,1314,[180  50  98 282 237],899,4,4643,3.5307984790874523,0.0,40.0
1315,0,1315,[ 96 117 742 282 483],447,4,4647,3.5311550151975686,20.0,0.0
1316,0,1316,[200 471 288 216 215],537,0,4647,3.5284738041002277,0.0,0.0
1317,0,1317,[202 318 276 300 135],533,3,4650,3.528072837632777,20.0,0.0
1318,0,1318,[302 603 427 313  64],474,5,4655,3.529188779378317,20.0,0.0
1319,0,1319,[302 603 427 313  64],90,5,4660,3.5303030303030303,20.0,0.0
1320,0,1320,[748 323 313 603  50],13,4,4664,3.530658591975776,20.0,20.0
1321,0,1321,[180 179 238 174  50],653,4,4668,3.5310136157337366,0.0,40.0
1322,0,1322,[302 603 427 313  64],669,5,4673,3.5321239606953894,20.0,0.0
1323,0,1323,[132 228 568  25  28],313,2,4675,3.530966767371601,0.0,0.0
1324,0,1324,[405 173  79 197 176],213,4,4679,3.531320754716981,0.0,0.0
1325,0,1325,[237 132 318 194  79],298,5,4684,3.5324283559577676,20.0,0.0
1326,0,1326,[121 222 234 427  88],536,5,4689,3.53353428786737,0.0,0.0
1327,0,1327,[423  28 176 151 588],897,5,4694,3.5346385542168677,0.0,0.0
1328,0,1328,[  7   9 175 742  82],881,3,4697,3.5342362678705794,0.0,0.0
1329,0,1329,[ 69 257 176 168  56],271,2,4699,3.5330827067669173,0.0,0.0
1330,0,1330,[ 12 179  11 515 273],90,4,4703,3.5334335086401203,20.0,0.0
1331,0,1331,[174  96  89 742 313],92,4,4707,3.5337837837837838,0.0,20.0
1332,0,1332,[ 98 748 271   4  79],13,3,4710,3.533383345836459,0.0,20.0
1333,0,1333,[100  11 202 144 228],64,4,4714,3.5337331334332833,0.0,20.0
1334,0,1334,[ 98 318 234 333 187],91,5,4719,3.534831460674157,20.0,20.0
1335,0,1335,[294 289  98  12 282],474,3,4722,3.534431137724551,20.0,20.0
1336,0,1336,[172 655 182 313 275],537,3,4725,3.5340314136125652,0.0,0.0
1337,0,1337,[568  79 196 405 435],749,4,4729,3.5343796711509716,0.0,0.0
1338,0,1338,[ 50 183  96 186 237],346,4,4733,3.5347274085138163,0.0,20.0
1339,0,1339,[179 568 357  88   7],643,4,4737,3.5350746268656716,20.0,0.0
1340,0,1340,[515  50 196 435 588],326,3,4740,3.534675615212528,0.0,20.0
1341,0,1341,[237 216 318 265  28],64,5,4745,3.5357675111773474,20.0,0.0
1342,0,1342,[257 176  89   8  70],455,2,4747,3.5346239761727474,0.0,0.0
1343,0,1343,[200 257  89 191 195],6,3,4750,3.5342261904761907,0.0,0.0
1344,0,1344,[302 603 427 313  64],90,5,4755,3.5353159851301115,20.0,0.0
1345,0,1345,[302 603 427 313  64],271,5,4760,3.536404160475483,20.0,0.0
1346,0,1346,[185  89  79 196 288],374,3,4763,3.5360059391239793,0.0,0.0
1347,0,1347,[191 405   4 176 215],13,2,4765,3.53486646884273,0.0,0.0
1348,0,1348,[176 568  98 301 265],13,2,4767,3.5337286879169754,0.0,20.0
1349,0,1349,[ 97  79 210   8 153],406,3,4770,3.533333333333333,0.0,0.0
1350,0,1350,[678 403  70 275 216],7,3,4773,3.532938564026647,0.0,0.0
1351,0,1351,[ 64 186 269 258 100],343,5,4778,3.5340236686390534,0.0,20.0
1352,0,1352,[273 153 423  89  56],385,3,4781,3.533628972653363,0.0,0.0
1353,0,1353,[655 186  22 195  28],92,3,4784,3.533234859675037,0.0,0.0
1354,0,1354,[ 69 357 678  22 385],7,4,4788,3.533579335793358,20.0,0.0
1355,0,1355,[ 15 144 153  64 143],374,3,4791,3.5331858407079646,0.0,0.0
1356,0,1356,[282 238 294  89 234],378,3,4794,3.532792925571113,0.0,0.0
1357,0,1357,[302 603 427 313  64],13,5,4799,3.5338733431516935,20.0,0.0
1358,0,1358,[483 273 405 313 234],13,3,4802,3.5334805003679177,20.0,0.0
1359,0,1359,[204 403 257 286 357],653,3,4805,3.5330882352941178,20.0,0.0
1360,0,1360,[302 603 427 313  64],271,5,4810,3.5341660543717857,20.0,0.0
1361,0,1361,[282 748  28 179 204],92,3,4813,3.5337738619676946,0.0,0.0
1362,0,1362,[301 300 302 678 276],334,2,4815,3.532648569332355,0.0,0.0
1363,0,1363,[435  25 318 546 515],7,3,4818,3.532258064516129,20.0,0.0
1364,0,1364,[302 603 427 313  64],13,5,4823,3.533333333333333,20.0,0.0
1365,0,1365,[111 471 405  79  64],537,0,4823,3.5307467057101025,0.0,0.0
1366,0,1366,[302 603 427 313  64],537,4,4827,3.531089978054133,20.0,0.0
1367,0,1367,[302 603 427 313  64],13,5,4832,3.5321637426900585,20.0,0.0
1368,0,1368,[423  50   8 135  12],343,5,4837,3.533235938641344,20.0,20.0
1369,0,1369,[235 323 179  79 211],13,1,4838,3.5313868613138686,0.0,0.0
1370,0,1370,[181 161 405  50 127],334,3,4841,3.5309992706053976,0.0,40.0
1371,0,1371,[271   8  82 273   1],883,2,4843,3.5298833819241984,0.0,0.0
1372,0,1372,[  7 118  25  11 216],374,4,4847,3.5302257829570283,0.0,0.0
1373,0,1373,[181 202 216 269  56],7,2,4849,3.529112081513828,0.0,0.0
1374,0,1374,[ 98 173 182   7 176],815,4,4853,3.5294545454545454,0.0,20.0
1375,0,1375,[ 97 275 118 216 191],533,4,4857,3.529796511627907,0.0,0.0
1376,0,1376,[302 603 427 313  64],474,5,4862,3.5308641975308643,20.0,0.0
1377,0,1377,[403 313 508  71 125],92,5,4867,3.5319303338171264,0.0,0.0
1378,0,1378,[183 181 286 333 121],537,0,4867,3.5293691080493113,0.0,0.0
1379,0,1379,[153 185 211 179 357],7,5,4872,3.5304347826086957,20.0,0.0
1380,0,1380,[302 603 427 313  64],454,5,4877,3.5314989138305575,20.0,0.0
1381,0,1381,[ 98 196 197 435 234],232,4,4881,3.531837916063676,0.0,20.0
1382,0,1382,[180  64   4 118 471],7,4,4885,3.532176428054953,0.0,0.0
1383,0,1383,[ 98   9 187 568 196],85,4,4889,3.532514450867052,0.0,20.0
1384,0,1384,[302 603 427 313  64],474,5,4894,3.5335740072202166,20.0,0.0
1385,0,1385,[ 64  95 215 132  88],537,0,4894,3.531024531024531,0.0,0.0
1386,0,1386,[153 423 405  22 215],92,2,4896,3.529920692141312,0.0,0.0
1387,0,1387,[ 50  95 258 196  71],506,5,4901,3.5309798270893373,0.0,20.0
1388,0,1388,[211  25 125 234 197],533,4,4905,3.5313174946004318,0.0,0.0
1389,0,1389,[302 603 427 313 127],334,5,4910,3.5323741007194243,20.0,20.0
1390,0,1390,[228 258 300 427 175],843,3,4913,3.5319913731128683,0.0,0.0
1391,0,1391,[202 151 118 483 181],648,4,4917,3.5323275862068964,20.0,0.0
1392,0,1392,[496  64 168 135  97],666,5,4922,3.5333811916726487,0.0,0.0
1393,0,1393,[597 200  64 288 151],7,4,4926,3.533715925394548,0.0,0.0
1394,0,1394,[118 176 185  56 202],897,3,4929,3.533333333333333,0.0,0.0
1395,0,1395,[471 143  79 302 191],474,4,4933,3.5336676217765044,0.0,0.0
1396,0,1396,[282 180 238  25 215],378,3,4936,3.5332856120257694,0.0,0.0
1397,0,1397,[185 153 258  96 427],90,4,4940,3.5336194563662375,0.0,0.0
1398,0,1398,[302 603 427 313 127],474,5,4945,3.5346676197283773,20.0,20.0
1399,0,1399,[288  25 234 186  22],339,4,4949,3.535,0.0,0.0
1400,0,1400,[302 603 427 313 127],271,5,4954,3.5360456816559602,20.0,20.0
1401,0,1401,[ 95 322 748 742 135],749,3,4957,3.5356633380884452,0.0,0.0
1402,0,1402,[302 603 427 313 127],271,5,4962,3.5367070563079115,20.0,20.0
1403,0,1403,[546 271 403   7  22],788,2,4964,3.5356125356125356,0.0,0.0
1404,0,1404,[ 64 313 496 276 286],533,4,4968,3.5359430604982207,0.0,0.0
1405,0,1405,[173 202  28  97 196],897,2,4970,3.534850640113798,0.0,0.0
1406,0,1406,[176 288 211 475 200],339,4,4974,3.535181236673774,0.0,0.0
1407,0,1407,[748 508 289  50 405],894,1,4975,3.5333806818181817,0.0,20.0
1408,0,1408,[ 11 176 194 568  69],188,4,4979,3.533711852377573,0.0,0.0
1409,0,1409,[100 153 423  22 117],378,4,4983,3.5340425531914894,0.0,20.0
1410,0,1410,[302 603 427 313 127],13,5,4988,3.5350815024805105,20.0,20.0
1411,0,1411,[168 568  88 135 100],774,0,4988,3.5325779036827196,0.0,20.0
1412,0,1412,[597 588 118  79  88],650,1,4989,3.5307855626326963,0.0,0.0
1413,0,1413,[211 182 117  22 161],95,2,4991,3.5297029702970297,0.0,0.0
1414,0,1414,[180 603 117 546 403],308,3,4994,3.5293286219081272,20.0,0.0
1415,0,1415,[153 234 265 385 403],536,4,4998,3.5296610169491527,0.0,0.0
1416,0,1416,[276 423 195 210  12],378,4,5002,3.5299929428369796,20.0,0.0
1417,0,1417,[302 603 427 313 127],13,5,5007,3.5310296191819464,20.0,20.0
1418,0,1418,[173 121 258 403 603],387,3,5010,3.5306553911205074,20.0,0.0
1419,0,1419,[655  50 187 175  88],537,3,5013,3.530281690140845,0.0,20.0
1420,0,1420,[175 194   8 385 313],85,4,5017,3.5306122448979593,0.0,0.0
1421,0,1421,[181 655 294   7 168],881,3,5020,3.530239099859353,0.0,0.0
1422,0,1422,[202 655 222 168 179],899,4,5024,3.5305692199578353,0.0,0.0
1423,0,1423,[ 69  22  28 603 289],271,5,5029,3.5316011235955056,20.0,0.0
1424,0,1424,[257 271 121 405 153],738,2,5031,3.5305263157894737,0.0,0.0
1425,0,1425,[187 568 211 289 496],387,2,5033,3.52945301542777,0.0,0.0
1426,0,1426,[175 215 234  64 127],524,2,5035,3.5283812193412754,0.0,20.0
1427,0,1427,[204 211 423 228 175],934,4,5039,3.5287114845938374,0.0,0.0
1428,0,1428,[302  96  82 235 117],537,1,5040,3.5269419174247725,0.0,0.0
1429,0,1429,[215  22 276 471 603],537,2,5042,3.5258741258741257,20.0,0.0
1430,0,1430,[257  71 143  22 179],308,5,5047,3.526904262753319,0.0,0.0
1431,0,1431,[302 603 427 313 127],474,5,5052,3.5279329608938546,20.0,20.0
1432,0,1432,[143 603 210  71 403],42,4,5056,3.5282623866015355,20.0,0.0
1433,0,1433,[ 96  79 228 186 216],749,5,5061,3.5292887029288704,0.0,0.0
1434,0,1434,[301 196  12 135 216],90,5,5066,3.5303135888501744,20.0,0.0
1435,0,1435,[186 385 121 235 111],92,3,5069,3.5299442896935935,0.0,0.0
1436,0,1436,[237  96 508 265 132],59,4,5073,3.5302713987473906,0.0,0.0
1437,0,1437,[ 50 180 187 100 168],524,4,5077,3.530598052851182,0.0,40.0
1438,0,1438,[302 603 427 313 127],537,5,5082,3.5316191799861016,20.0,20.0
1439,0,1439,[237  95 135  25 742],92,2,5084,3.5305555555555554,0.0,0.0
1440,0,1440,[427 210  25  82 301],537,1,5085,3.5287994448299793,0.0,0.0
1441,0,1441,[ 69 174 603   4 182],533,3,5088,3.5284327323162277,20.0,20.0
1442,0,1442,[302 603 427 313 127],13,5,5093,3.5294525294525294,20.0,20.0
1443,0,1443,[282 289 222 144  82],92,3,5096,3.5290858725761773,0.0,0.0
1444,0,1444,[273 111 258 187  89],479,5,5101,3.530103806228374,0.0,0.0
1445,0,1445,[ 89  11 403 265  12],59,5,5106,3.5311203319502074,20.0,0.0
1446,0,1446,[ 50 202 435  98 275],454,1,5107,3.5293711126468557,0.0,40.0
1447,0,1447,[288  79  28 181 483],409,3,5110,3.5290055248618786,20.0,0.0
1448,0,1448,[ 71 179 471  64 186],95,4,5114,3.5293305728088336,0.0,0.0
1449,0,1449,[302 603 427 313 127],334,5,5119,3.530344827586207,20.0,20.0
1450,0,1450,[302 603 427 313 127],474,5,5124,3.531357684355617,20.0,20.0
1451,0,1451,[187 172  25 237 269],85,2,5126,3.5303030303030303,0.0,0.0
1452,0,1452,[125 546 427  88 313],271,3,5129,3.529938059187887,0.0,0.0
1453,0,1453,[228  89 100 183  98],650,5,5134,3.530949105914718,0.0,40.0
1454,0,1454,[173 265  88  64 121],346,4,5138,3.53127147766323,0.0,0.0
1455,0,1455,[403 181 187   4  89],13,4,5142,3.5315934065934065,0.0,0.0
1456,0,1456,[302 603 427 313 127],90,5,5147,3.5326012354152367,20.0,20.0
1457,0,1457,[302 603 427 313 127],537,5,5152,3.53360768175583,20.0,20.0
1458,0,1458,[302 603 427 313 127],669,5,5157,3.534612748457848,20.0,20.0
1459,0,1459,[191 132 187 100 168],537,4,5161,3.5349315068493152,0.0,20.0
1460,0,1460,[117 173 385 211 143],650,5,5166,3.5359342915811087,0.0,0.0
1461,0,1461,[302 603 427 313 127],14,3,5169,3.5355677154582765,20.0,20.0
1462,0,1462,[568 118 258 257 496],738,2,5171,3.5345181134654817,0.0,0.0
1463,0,1463,[121 333 268 151 515],637,3,5174,3.5341530054644807,0.0,0.0
1464,0,1464,[182  56 179 191 357],653,4,5178,3.534470989761092,20.0,0.0
1465,0,1465,[135 153 588 234 186],804,4,5182,3.5347885402455663,0.0,0.0
1466,0,1466,[435 143 234  12 655],234,1,5183,3.533060668029993,20.0,0.0
1467,0,1467,[215 204 111 435 172],648,4,5187,3.5333787465940056,0.0,0.0
1468,0,1468,[194 195  88 179 515],13,2,5189,3.5323349217154525,0.0,0.0
1469,0,1469,[ 98 204 289 302 235],378,5,5194,3.533333333333333,0.0,20.0
1470,0,1470,[127  69 173 181 191],85,4,5198,3.5336505778382055,0.0,20.0
1471,0,1471,[302 603 427 313 127],90,5,5203,3.5346467391304346,20.0,20.0
1472,0,1472,[172 168 197 405 238],804,5,5208,3.5356415478615073,0.0,0.0
1473,0,1473,[237  79 117  71 185],13,2,5210,3.5345997286295794,0.0,0.0
1474,0,1474,[318  96  69 385 275],90,4,5214,3.534915254237288,20.0,0.0
1475,0,1475,[196 222  89 742 265],200,5,5219,3.535907859078591,0.0,0.0
1476,0,1476,[ 71 187 202 318  82],479,4,5223,3.5362220717670954,20.0,0.0
1477,0,1477,[302 603 427 313 127],537,5,5228,3.537212449255751,20.0,20.0
1478,0,1478,[117 187 185 172 427],650,3,5231,3.5368492224475996,0.0,0.0
1479,0,1479,[302 603 427 313 127],334,5,5236,3.537837837837838,20.0,20.0
1480,0,1480,[515 181 275 185 211],308,4,5240,3.538149898717083,0.0,0.0
1481,0,1481,[161 286 216 180 357],479,2,5242,3.5371120107962213,20.0,0.0
1482,0,1482,[302 603 427 313 127],334,5,5247,3.538098449089683,20.0,20.0
1483,0,1483,[238  96 234 174 678],145,4,5251,3.538409703504043,0.0,20.0
1484,0,1484,[175  82 127 515  95],95,3,5254,3.538047138047138,0.0,20.0
1485,0,1485,[435   4 238 135  56],210,4,5258,3.5383580080753703,0.0,0.0
1486,0,1486,[ 22 144  82 168 245],749,5,5263,3.539340954942838,0.0,0.0
1487,0,1487,[302 603 427 313 127],537,5,5268,3.5403225806451615,20.0,20.0
1488,0,1488,[257  28 121 546  96],95,4,5272,3.5406312961719273,0.0,0.0
1489,0,1489,[121  97 216 151   7],669,2,5274,3.5395973154362417,0.0,0.0
1490,0,1490,[302 603 427 313 127],90,5,5279,3.540576794097921,20.0,20.0
1491,0,1491,[ 28 194 237 180 117],378,3,5282,3.540214477211796,0.0,0.0
1492,0,1492,[302 603 427 313 127],90,5,5287,3.5411922304085732,20.0,20.0
1493,0,1493,[302 603 427 313 127],90,5,5292,3.5421686746987953,20.0,20.0
1494,0,1494,[ 64  79 427 179 496],7,5,5297,3.54314381270903,0.0,0.0
1495,0,1495,[276 196  28 143 301],13,3,5300,3.5427807486631018,0.0,0.0
1496,0,1496,[161 276 182 216 300],210,5,5305,3.5437541750167,0.0,0.0
1497,0,1497,[179  69  50 153 302],210,4,5309,3.5440587449933245,0.0,20.0
1498,0,1498,[302 603 427 313 127],271,5,5314,3.545030020013342,20.0,20.0
1499,0,1499,[176  50  28 483 161],188,3,5317,3.5446666666666666,20.0,20.0
1500,0,1500,[200 268  15  22 435],288,5,5322,3.5456362425049965,0.0,0.0
1501,0,1501,[196 135 313 678 405],92,3,5325,3.545272969374168,0.0,0.0
1502,0,1502,[117 546 273 294 194],749,3,5328,3.5449101796407185,0.0,0.0
1503,0,1503,[385 235  89   8 143],200,4,5332,3.5452127659574466,0.0,0.0
1504,0,1504,[588 405 294  70 301],13,1,5333,3.5435215946843854,0.0,0.0
1505,0,1505,[ 64 546 180 748  11],653,3,5336,3.543160690571049,0.0,0.0
1506,0,1506,[302 603 427 313 127],474,5,5341,3.544127405441274,20.0,20.0
1507,0,1507,[111 173 234 289 222],474,4,5345,3.5444297082228116,0.0,0.0
1508,0,1508,[ 70 135 204 121 161],60,5,5350,3.545394300861498,0.0,0.0
1509,0,1509,[265 194 117 183 748],653,3,5353,3.5450331125827814,0.0,0.0
1510,0,1510,[187 405 172 174  70],213,3,5356,3.544672402382528,0.0,20.0
1511,0,1511,[302 603 427 313 127],90,5,5361,3.5456349206349205,20.0,20.0
1512,0,1512,[385 568 276 176 294],538,1,5362,3.5439524124256443,0.0,0.0
1513,0,1513,[313  70 318 405 655],85,3,5365,3.543593130779392,20.0,0.0
1514,0,1514,[302 603 427 313 127],334,5,5370,3.5445544554455446,20.0,20.0
1515,0,1515,[245 471  25  15 135],378,2,5372,3.5435356200527703,0.0,0.0
1516,0,1516,[302 603 427 313 127],14,3,5375,3.5431773236651285,20.0,20.0
1517,0,1517,[302 603 427 313 127],90,5,5380,3.544137022397892,20.0,20.0
1518,0,1518,[186 655   7 235 568],804,5,5385,3.5450954575378537,0.0,0.0
1519,0,1519,[144 496 175  95 135],194,2,5387,3.544078947368421,0.0,0.0
1520,0,1520,[655  79 186  50 127],95,5,5392,3.545036160420776,0.0,40.0
1521,0,1521,[ 15 151 385  98 202],537,0,5392,3.542706964520368,0.0,20.0
1522,0,1522,[144 185  22 194  88],749,5,5397,3.5436638214051213,0.0,0.0
1523,0,1523,[ 69 176 191 245 228],804,5,5402,3.5446194225721785,0.0,0.0
1524,0,1524,[179 216 235 185  95],13,1,5403,3.5429508196721313,0.0,0.0
1525,0,1525,[161 228  79 234 603],234,2,5405,3.541939711664482,20.0,0.0
1526,0,1526,[181 196 183  88 175],815,4,5409,3.5422396856581533,0.0,0.0
1527,0,1527,[313  50 288 405 273],92,3,5412,3.5418848167539267,0.0,20.0
1528,0,1528,[515 588 385  11  69],59,4,5416,3.5421844342707653,0.0,0.0
1529,0,1529,[302 603 427 313 127],14,3,5419,3.541830065359477,20.0,20.0
1530,0,1530,[216 161   8 121 318],207,3,5422,3.5414761593729587,20.0,0.0
1531,0,1531,[143 423 496 202  82],263,5,5427,3.5424281984334205,0.0,0.0
1532,0,1532,[302 603 427 313  50],669,5,5432,3.5433789954337898,20.0,20.0
1533,0,1533,[100 127 143 176 508],474,4,5436,3.5436766623207303,0.0,40.0
1534,0,1534,[ 50 204 237  96 483],537,2,5438,3.542671009771987,20.0,20.0
1535,0,1535,[  7 117  25  88 238],339,4,5442,3.54296875,0.0,0.0
1536,0,1536,[125 357 597 179 172],653,3,5445,3.542615484710475,20.0,0.0
1537,0,1537,[  7 195 385 186 183],788,2,5447,3.5416124837451237,0.0,0.0
1538,0,1538,[118 678 258 228 111],749,2,5449,3.5406107862248213,0.0,0.0
1539,0,1539,[211 191 197 196 483],311,4,5453,3.540909090909091,20.0,0.0
1540,0,1540,[302 603 427 313  50],334,5,5458,3.5418559377027905,20.0,20.0
1541,0,1541,[183 181 211 176 153],694,5,5463,3.5428015564202333,0.0,0.0
1542,0,1542,[405 328 257 597 276],486,2,5465,3.541801685029164,0.0,0.0
1543,0,1543,[186  12 302 288 300],329,3,5468,3.5414507772020727,20.0,0.0
1544,0,1544,[191  15   4 176 546],92,3,5471,3.5411003236245953,0.0,0.0
1545,0,1545,[ 98 125  22 182 197],378,3,5474,3.5407503234152653,0.0,20.0
1546,0,1546,[194   1 143 121  96],59,2,5476,3.539754363283775,0.0,0.0
1547,0,1547,[  1  88 234 185 211],643,4,5480,3.5400516795865635,0.0,0.0
1548,0,1548,[ 25 127 435 183 294],452,2,5482,3.539057456423499,0.0,20.0
1549,0,1549,[302 603 427 313  50],334,5,5487,3.54,20.0,20.0
1550,0,1550,[496 238 222 328 174],378,1,5488,3.5383623468729852,0.0,20.0
1551,0,1551,[302 603 427 313  50],537,5,5493,3.5393041237113403,20.0,20.0
1552,0,1552,[176 204 118 276   1],189,3,5496,3.5389568576947843,0.0,0.0
1553,0,1553,[216  88   7 187  22],474,5,5501,3.5398970398970397,0.0,0.0
1554,0,1554,[ 95  11  71 135 333],64,3,5504,3.539549839228296,0.0,0.0
1555,0,1555,[302 603 427 313  50],334,5,5509,3.540488431876607,20.0,20.0
1556,0,1556,[302 603 427 313  50],669,5,5514,3.541425818882466,20.0,20.0
1557,0,1557,[181  89 186   9 172],474,5,5519,3.542362002567394,0.0,0.0
1558,0,1558,[ 88 194  82 234 318],326,2,5521,3.541372674791533,20.0,0.0
1559,0,1559,[172 132 318 179  97],474,5,5526,3.542307692307692,20.0,0.0
1560,0,1560,[ 50 282  89  82 100],455,3,5529,3.5419602818705958,0.0,40.0
1561,0,1561,[546   1 275  98 180],13,2,5531,3.5409731113956466,0.0,20.0
1562,0,1562,[ 11 117 118 216  25],92,2,5533,3.5399872040946896,0.0,0.0
1563,0,1563,[191 185 234   8  89],406,5,5538,3.540920716112532,0.0,0.0
1564,0,1564,[302 603 427 313  50],13,5,5543,3.54185303514377,20.0,20.0
1565,0,1565,[ 50 135 180 179 655],92,5,5548,3.5427841634738186,0.0,20.0
1566,0,1566,[258 235 300 234 181],145,4,5552,3.5430759412890875,0.0,0.0
1567,0,1567,[302 603 427 313  50],13,5,5557,3.5440051020408165,20.0,20.0
1568,0,1568,[302 603 427 313  50],13,5,5562,3.5449330783938815,20.0,20.0
1569,0,1569,[194  95  15 181 185],454,0,5562,3.5426751592356687,0.0,0.0
1570,0,1570,[588 186 273 318  64],892,4,5566,3.542966263526416,20.0,0.0
1571,0,1571,[405 427 202 183  82],42,5,5571,3.5438931297709924,0.0,0.0
1572,0,1572,[748 286 275 222   1],486,2,5573,3.542911633820725,0.0,0.0
1573,0,1573,[302 603 427 313  50],13,5,5578,3.5438373570520967,20.0,20.0
1574,0,1574,[172 191 144 269 300],125,4,5582,3.5441269841269842,0.0,0.0
1575,0,1575,[508 196 423 168 288],474,2,5584,3.5431472081218276,0.0,0.0
1576,0,1576,[ 82 275 483  69  50],452,4,5588,3.543436905516804,20.0,20.0
1577,0,1577,[302 603 427 313  50],14,4,5592,3.543726235741445,20.0,20.0
1578,0,1578,[ 64 318 427 435  12],7,5,5597,3.544648511716276,40.0,0.0
1579,0,1579,[215 100 121  82   8],533,4,5601,3.5449367088607593,0.0,20.0
1580,0,1580,[176 508  56 588 111],59,4,5605,3.545224541429475,0.0,0.0
1581,0,1581,[302 603 427 313  50],454,5,5610,3.5461441213653604,20.0,20.0
1582,0,1582,[655 546  96 183 435],328,4,5614,3.5464308275426406,0.0,0.0
1583,0,1583,[496 216 191 294 172],666,2,5616,3.5454545454545454,0.0,0.0
1584,0,1584,[302 603 427 313  50],537,5,5621,3.546372239747634,20.0,20.0
1585,0,1585,[302   9 211 100 151],6,4,5625,3.546658259773014,0.0,20.0
1586,0,1586,[302 603 427 313  50],454,5,5630,3.5475740390674226,20.0,20.0
1587,0,1587,[168  22 132  89   9],7,5,5635,3.5484886649874054,0.0,0.0
1588,0,1588,[100 323 546 235 302],378,3,5638,3.5481434864694776,0.0,20.0
1589,0,1589,[111 175 100 181  64],833,2,5640,3.547169811320755,0.0,20.0
1590,0,1590,[302 603 427 313  50],14,4,5644,3.5474544311753613,20.0,20.0
1591,0,1591,[ 22 603 151 172 196],474,4,5648,3.5477386934673367,20.0,0.0
1592,0,1592,[211 100  98  50 185],6,5,5653,3.5486503452605147,0.0,60.0
1593,0,1593,[ 12 496 301 302 471],524,3,5656,3.548306148055207,20.0,0.0
1594,0,1594,[655 323  89   7 357],788,3,5659,3.547962382445141,20.0,0.0
1595,0,1595,[302 603 427 313  50],14,4,5663,3.5482456140350878,20.0,20.0
1596,0,1596,[  1  22  12 153 100],406,3,5666,3.5479023168440826,20.0,20.0
1597,0,1597,[678  88 172 475  25],92,2,5668,3.546933667083855,0.0,0.0
1598,0,1598,[  9 200 179 151 568],881,2,5670,3.5459662288930582,0.0,0.0
1599,0,1599,[125 546 435 496  28],271,3,5673,3.545625,0.0,0.0
1600,0,1600,[ 50 403 204 265  69],59,5,5678,3.546533416614616,0.0,20.0
1601,0,1601,[185 228 282 196  69],804,5,5683,3.5474406991260925,0.0,0.0
1602,0,1602,[333 183 194 265 546],13,3,5686,3.5470991890205865,0.0,0.0
1603,0,1603,[175  89  70 357  79],537,4,5690,3.5473815461346634,20.0,0.0
1604,0,1604,[195 200 403 228 215],59,5,5695,3.5482866043613708,0.0,0.0
1605,0,1605,[187 515 100  12 215],343,5,5700,3.5491905354919053,20.0,20.0
1606,0,1606,[546   7 175  11 111],653,0,5700,3.5469819539514624,0.0,0.0
1607,0,1607,[302 603 427 313  50],334,5,5705,3.5478855721393034,20.0,20.0
1608,0,1608,[172 238  89 194 423],295,5,5710,3.548788067122436,0.0,0.0
1609,0,1609,[191 175 132 181 282],666,3,5713,3.548447204968944,0.0,0.0
1610,0,1610,[ 15  64 282 333 180],605,5,5718,3.549348230912477,0.0,0.0
1611,0,1611,[423  98  69 153  88],659,3,5721,3.5490074441687347,0.0,20.0
1612,0,1612,[111 496  88 313 195],378,2,5723,3.5480471171729695,0.0,0.0
1613,0,1613,[143  25 318 216 195],13,0,5723,3.5458488228004956,20.0,0.0
1614,0,1614,[678 237 191  22 181],537,1,5724,3.5442724458204333,0.0,0.0
1615,0,1615,[ 56 181   9   8 168],271,3,5727,3.5439356435643563,0.0,0.0
1616,0,1616,[228 357 302 176 211],380,2,5729,3.5429808286951143,20.0,0.0
1617,0,1617,[568 496  70 546 153],7,4,5733,3.543263288009889,0.0,0.0
1618,0,1618,[302 603 427 313  50],334,5,5738,3.5441630636195183,20.0,20.0
1619,0,1619,[294 237 194  95 423],308,3,5741,3.543827160493827,0.0,0.0
1620,0,1620,[288 187  79 423 100],479,2,5743,3.5428747686613202,0.0,20.0
1621,0,1621,[257  12  98 483  50],385,2,5745,3.541923551171393,40.0,40.0
1622,0,1622,[294 168  95 328 175],13,3,5748,3.5415896487985212,0.0,0.0
1623,0,1623,[294 127 143  97  82],263,4,5752,3.541871921182266,0.0,20.0
1624,0,1624,[125  96 276  95  15],406,4,5756,3.542153846153846,0.0,0.0
1625,0,1625,[  1 187   7 273 173],64,4,5760,3.5424354243542435,0.0,0.0
1626,0,1626,[ 89  98  79 191 385],13,2,5762,3.5414874001229255,0.0,20.0
1627,0,1627,[183 161 237 322 268],13,4,5766,3.541769041769042,0.0,0.0
1628,0,1628,[302 603 427 313  50],14,4,5770,3.542050337630448,20.0,20.0
1629,0,1629,[191 197 286 403 655],59,4,5774,3.5423312883435583,0.0,0.0
1630,0,1630,[268 603 132 385 183],7,4,5778,3.5426118945432252,20.0,0.0
1631,0,1631,[427 238  88   8  64],234,3,5781,3.542279411764706,0.0,0.0
1632,0,1632,[427 210 405 186 117],406,3,5784,3.5419473361910594,0.0,0.0
1633,0,1633,[222 215 118  82 568],343,3,5787,3.5416156670746632,0.0,0.0
1634,0,1634,[216 238  88  79 210],643,3,5790,3.541284403669725,0.0,0.0
1635,0,1635,[168  88 182 151 496],346,5,5795,3.5421760391198043,0.0,0.0
1636,0,1636,[135 187 195  56 202],210,5,5800,3.54306658521686,0.0,0.0
1637,0,1637,[174 191  25 318 118],59,5,5805,3.543956043956044,20.0,20.0
1638,0,1638,[ 70 215  96  50 187],406,2,5807,3.543014032946919,0.0,20.0
1639,0,1639,[  7  64  25  70 180],666,4,5811,3.5432926829268294,0.0,0.0
1640,0,1640,[ 56 286 678  11 268],387,1,5812,3.541742839731871,0.0,0.0
1641,0,1641,[276 195 508 678 179],537,3,5815,3.541412911084044,0.0,0.0
1642,0,1642,[302 603 427 313  50],454,5,5820,3.542300669506999,20.0,20.0
1643,0,1643,[302 603 427 313  50],454,5,5825,3.5431873479318736,20.0,20.0
1644,0,1644,[357 200 234 215 265],881,2,5827,3.5422492401215804,20.0,0.0
1645,0,1645,[258 678 161 235 269],13,2,5829,3.5413122721749697,0.0,0.0
1646,0,1646,[143 197 181 191 179],659,3,5832,3.540983606557377,0.0,0.0
1647,0,1647,[202 268 328 172 427],13,4,5836,3.54126213592233,0.0,0.0
1648,0,1648,[302 603 427 313  50],334,5,5841,3.54214675560946,20.0,20.0
1649,0,1649,[302 603 427 313  50],271,5,5846,3.543030303030303,20.0,20.0
1650,0,1650,[202 546   4  96 118],774,1,5847,3.541490006056935,0.0,0.0
1651,0,1651,[135 288 182  12 655],213,5,5852,3.542372881355932,20.0,0.0
1652,0,1652,[235 276 183   9 210],200,4,5856,3.542649727767695,0.0,0.0
1653,0,1653,[302 603 427 313  50],474,5,5861,3.5435308343409915,20.0,20.0
1654,0,1654,[302 603 427 313  50],334,5,5866,3.5444108761329307,20.0,20.0
1655,0,1655,[135 153 496 111 234],95,3,5869,3.5440821256038646,0.0,0.0
1656,0,1656,[237 322 265 245 175],334,2,5871,3.543150271575136,0.0,0.0
1657,0,1657,[ 69  11 121 234 275],455,4,5875,3.5434258142340167,0.0,0.0
1658,0,1658,[ 22 483 180 496 121],650,2,5877,3.54249547920434,20.0,0.0
1659,0,1659,[496   4 211 111 197],749,4,5881,3.542771084337349,0.0,0.0
1660,0,1660,[173 172 313 318   1],189,4,5885,3.543046357615894,20.0,0.0
1661,0,1661,[151 435 357   7 427],815,5,5890,3.5439229843561972,20.0,0.0
1662,0,1662,[172 204  88 322 268],92,3,5893,3.5435959110042092,0.0,0.0
1663,0,1663,[273 197  22 385  71],524,1,5894,3.5420673076923075,0.0,0.0
1664,0,1664,[ 79  89 333 186 197],666,2,5896,3.541141141141141,0.0,0.0
1665,0,1665,[ 28  79 238 273 222],883,3,5899,3.5408163265306123,0.0,0.0
1666,0,1666,[196  82  12  70 568],455,3,5902,3.540491901619676,20.0,0.0
1667,0,1667,[185 328 294 275 427],271,2,5904,3.539568345323741,0.0,0.0
1668,0,1668,[210 276   8 100 132],406,5,5909,3.5404433792690235,0.0,20.0
1669,0,1669,[257  64 546 143 435],339,5,5914,3.541317365269461,0.0,0.0
1670,0,1670,[275 172 289 176 515],406,2,5916,3.540394973070018,0.0,0.0
1671,0,1671,[127 215 496 435 318],524,3,5919,3.540071770334928,20.0,20.0
1672,0,1672,[276 117 357 333  28],533,3,5922,3.5397489539748954,20.0,0.0
1673,0,1673,[180 216   9  50 435],6,5,5927,3.540621266427718,0.0,20.0
1674,0,1674,[ 95 127 357 294 200],234,3,5930,3.5402985074626865,20.0,20.0
1675,0,1675,[282  11 742  98 153],447,4,5934,3.5405727923627683,0.0,20.0
1676,0,1676,[127 276  25  79 215],90,4,5938,3.540846750149076,0.0,20.0
1677,0,1677,[588 118  70 111 176],13,3,5941,3.5405244338498214,0.0,0.0
1678,0,1678,[423 322  50 127 245],83,2,5943,3.53960690887433,0.0,40.0
1679,0,1679,[568 475 423 273 144],374,2,5945,3.5386904761904763,0.0,0.0
1680,0,1680,[237  56 175 194  22],343,5,5950,3.5395597858417607,0.0,0.0
1681,0,1681,[ 88  82 234   7 204],60,4,5954,3.539833531510107,0.0,0.0
1682,0,1682,[ 28 127 118 294 234],479,3,5957,3.5395127748068926,0.0,20.0
1683,0,1683,[302 603 427 313  50],334,5,5962,3.540380047505938,20.0,20.0
1684,0,1684,[176 135 125 197 237],263,4,5966,3.5406528189910977,0.0,0.0
1685,0,1685,[195 237 168 300 194],749,4,5970,3.5409252669039146,0.0,0.0
1686,0,1686,[ 25 435 118 237  56],447,5,5975,3.5417901600474213,0.0,0.0
1687,0,1687,[302 603 427 313  50],14,4,5979,3.5420616113744074,20.0,20.0
1688,0,1688,[181 210 238   4 678],804,5,5984,3.5429248075784487,0.0,0.0
1689,0,1689,[302 603 427 313  50],271,5,5989,3.5437869822485206,20.0,20.0
1690,0,1690,[302 603 427 313  50],474,5,5994,3.544648137196925,20.0,20.0
1691,0,1691,[302 603 427 313  50],13,5,5999,3.5455082742316786,20.0,20.0
1692,0,1692,[237  70 275 161 235],308,2,6001,3.544595392793857,0.0,0.0
1693,0,1693,[515 182   9  70 294],308,3,6004,3.5442739079102714,0.0,0.0
1694,0,1694,[403 318 195 435  79],234,1,6005,3.5427728613569323,20.0,0.0
1695,0,1695,[515 183 121   1 181],458,3,6008,3.542452830188679,0.0,0.0
1696,0,1696,[194 483 127 300 403],234,3,6011,3.5421331761932824,20.0,20.0
1697,0,1697,[238 144 475 197 151],387,1,6012,3.5406360424028267,0.0,0.0
1698,0,1698,[173 597 282 121 235],374,3,6015,3.5403178340200117,0.0,0.0
1699,0,1699,[302 603 427 313  50],271,5,6020,3.541176470588235,20.0,20.0
1700,0,1700,[215 496 194 183 195],42,5,6025,3.542034097589653,0.0,0.0
1701,0,1701,[405 294 179 176   7],774,2,6027,3.5411280846063455,0.0,0.0
1702,0,1702,[180  96 211 144  22],738,3,6030,3.5408103347034645,0.0,0.0
1703,0,1703,[135 127 174   4 215],659,3,6033,3.540492957746479,0.0,40.0
1704,0,1704,[245 286 196  82  50],454,2,6035,3.5395894428152492,0.0,20.0
1705,0,1705,[ 64 216  28 186 125],7,5,6040,3.540445486518171,0.0,0.0
1706,0,1706,[302 603 427 313  50],14,4,6044,3.540714704159344,20.0,20.0
1707,0,1707,[ 11  25 153 179  70],666,4,6048,3.540983606557377,0.0,0.0
1708,0,1708,[302 603 427 313  50],454,5,6053,3.5418373317729666,20.0,20.0
1709,0,1709,[215  71 125 405 271],92,3,6056,3.5415204678362575,0.0,0.0
1710,0,1710,[211 405 276  79 182],406,3,6059,3.5412039742840444,0.0,0.0
1711,0,1711,[143 385 211 176 216],379,4,6063,3.5414719626168223,0.0,0.0
1712,0,1712,[183 216 168  15  70],60,5,6068,3.5423234092235845,0.0,0.0
1713,0,1713,[655 222 318 194 515],234,3,6071,3.542007001166861,20.0,0.0
1714,0,1714,[ 96  25  28 588 234],7,4,6075,3.542274052478134,0.0,0.0
1715,0,1715,[427 181 200 194   1],59,3,6078,3.541958041958042,0.0,0.0
1716,0,1716,[302 603 427 313  50],537,5,6083,3.5428072218986606,20.0,20.0
1717,0,1717,[ 50 197 210 100  71],830,5,6088,3.5436554132712454,0.0,40.0
1718,0,1718,[302 603 427 313  50],13,5,6093,3.5445026178010473,20.0,20.0
1719,0,1719,[132   7 603 172 197],64,3,6096,3.5441860465116277,20.0,0.0
1720,0,1720,[211  22 176 742 258],650,2,6098,3.5432887855897732,0.0,0.0
1721,0,1721,[302 603 427 313  50],14,4,6102,3.543554006968641,20.0,20.0
1722,0,1722,[ 25 195 228 179  95],59,4,6106,3.5438189204875217,0.0,0.0
1723,0,1723,[ 25  56 143 568  11],90,5,6111,3.5446635730858467,0.0,0.0
1724,0,1724,[202 211 117 427 483],533,5,6116,3.5455072463768116,20.0,0.0
1725,0,1725,[302 603 427 313  50],14,4,6120,3.54577056778679,20.0,20.0
1726,0,1726,[302 603 427 313  50],13,5,6125,3.546612623045744,20.0,20.0
1727,0,1727,[ 82 508 318  56  28],59,5,6130,3.5474537037037037,20.0,0.0
1728,0,1728,[172 475 742  79 121],334,2,6132,3.5465587044534415,0.0,0.0
1729,0,1729,[245 234  11   1 117],653,3,6135,3.546242774566474,0.0,0.0
1730,0,1730,[168 403 237 385 210],13,2,6137,3.5453495089543616,0.0,0.0
1731,0,1731,[197   9 127 172  96],881,2,6139,3.5444572748267897,0.0,20.0
1732,0,1732,[302 603 427 313  50],14,4,6143,3.544720138488171,20.0,20.0
1733,0,1733,[302 603 427 313  50],537,5,6148,3.5455594002306805,20.0,20.0
1734,0,1734,[302 603 427  50 313],13,5,6153,3.5463976945244955,20.0,20.0
1735,0,1735,[302 603 427  50 313],454,5,6158,3.5472350230414746,20.0,20.0
1736,0,1736,[483 186 195 179  97],60,4,6162,3.547495682210708,20.0,0.0
1737,0,1737,[603 403 197 194 515],59,4,6166,3.5477560414269274,20.0,0.0
1738,0,1738,[222  64 118 357 181],666,2,6168,3.5468660149511213,20.0,0.0
1739,0,1739,[302 603 427  50 313],334,5,6173,3.5477011494252872,20.0,20.0
1740,0,1740,[181 191  56 180 210],313,4,6177,3.5479609419873634,0.0,0.0
1741,0,1741,[302 603 427  50 313],334,5,6182,3.5487944890929968,20.0,20.0
1742,0,1742,[ 69 196 179 385 204],200,5,6187,3.5496270797475615,0.0,0.0
1743,0,1743,[302 603 427  50 313],474,5,6192,3.55045871559633,20.0,20.0
1744,0,1744,[ 69  97  96 135 132],506,5,6197,3.5512893982808023,0.0,0.0
1745,0,1745,[302 603 427  50 313],454,5,6202,3.552119129438717,20.0,20.0
1746,0,1746,[228 111 357 175 127],13,4,6206,3.5523755008586146,20.0,20.0
1747,0,1747,[ 25  79 191   9 294],13,0,6206,3.5503432494279177,0.0,0.0
1748,0,1748,[196  64  88 475  22],474,5,6211,3.5511720983419095,0.0,0.0
1749,0,1749,[405 234 204  97 180],95,2,6213,3.5502857142857143,0.0,0.0
1750,0,1750,[ 95 143 200 187 483],881,4,6217,3.5505425471159335,20.0,0.0
1751,0,1751,[ 89 289 271 228 168],537,2,6219,3.5496575342465753,0.0,0.0
1752,0,1752,[302 603 427  50 313],454,5,6224,3.5504848830576154,20.0,20.0
1753,0,1753,[294   1 180 204 100],92,4,6228,3.5507411630558723,0.0,20.0
1754,0,1754,[ 15 286 475 257 302],26,2,6230,3.54985754985755,0.0,0.0
1755,0,1755,[216  98 204 222 125],290,4,6234,3.550113895216401,0.0,20.0
1756,0,1756,[302 603 427  50 313],669,5,6239,3.5509391007398974,20.0,20.0
1757,0,1757,[302 603 427  50 313],271,5,6244,3.551763367463026,20.0,20.0
1758,0,1758,[ 25 237 176 515 100],145,4,6248,3.5520181921546334,0.0,20.0
1759,0,1759,[234 182  96  15  88],234,1,6249,3.550568181818182,0.0,0.0
1760,0,1760,[118 132 238 181 496],295,4,6253,3.5508233957978423,0.0,0.0
1761,0,1761,[302 603 427  50 313],334,5,6258,3.551645856980704,20.0,20.0
1762,0,1762,[302 603 427  50 313],474,5,6263,3.552467385138968,20.0,20.0
1763,0,1763,[427  89 289 185 546],374,2,6265,3.5515873015873014,0.0,0.0
1764,0,1764,[ 71 238 275 168 172],524,1,6266,3.55014164305949,0.0,0.0
1765,0,1765,[302 603 427  50 313],454,5,6271,3.5509626274065687,20.0,20.0
1766,0,1766,[  8 132 423 173 318],232,4,6275,3.5512167515563102,20.0,0.0
1767,0,1767,[127 121 118 125 173],311,4,6279,3.551470588235294,0.0,20.0
1768,0,1768,[215 121 234 265 471],95,3,6282,3.5511588468061053,0.0,0.0
1769,0,1769,[496 211 265  50 194],312,4,6286,3.551412429378531,0.0,20.0
1770,0,1770,[302 603 427  50 313],271,5,6291,3.552230378317335,20.0,20.0
1771,0,1771,[121 313  50 182 172],13,5,6296,3.5530474040632054,0.0,20.0
1772,0,1772,[302 603 427  50 313],334,5,6301,3.553863508178229,20.0,20.0
1773,0,1773,[302 603 427  50 313],454,5,6306,3.5546786922209694,20.0,20.0
1774,0,1774,[180 127 111 144 183],95,4,6310,3.554929577464789,0.0,20.0
1775,0,1775,[196  56  89 210 228],411,3,6313,3.5546171171171173,0.0,0.0
1776,0,1776,[268 276 300 475 508],13,2,6315,3.5537422622397297,0.0,0.0
1777,0,1777,[302 603 427  50 313],13,5,6320,3.5545556805399325,20.0,20.0
1778,0,1778,[302 603 427  50 313],271,5,6325,3.5553681843732434,20.0,20.0
1779,0,1779,[191 385 597 202 121],804,4,6329,3.55561797752809,0.0,0.0
1780,0,1780,[210 197 282  82 185],207,3,6332,3.5553060078607523,0.0,0.0
1781,0,1781,[275 183  11   8  22],378,4,6336,3.5555555555555554,0.0,0.0
1782,0,1782,[515  79  95 216 161],524,4,6340,3.5558048233314636,0.0,0.0
1783,0,1783,[ 22 357  50   4 195],406,3,6343,3.555493273542601,20.0,20.0
1784,0,1784,[385  22 181 186 471],648,5,6348,3.556302521008403,0.0,0.0
1785,0,1785,[117 268 161  25 276],234,0,6348,3.5543113101903696,0.0,0.0
1786,0,1786,[302 603 427  50 313],669,5,6353,3.5551203133743705,20.0,20.0
1787,0,1787,[135 127 435  96 405],59,4,6357,3.5553691275167787,0.0,20.0
1788,0,1788,[ 56  12 269 483  79],339,5,6362,3.5561766349916155,40.0,0.0
1789,0,1789,[ 82 173 282  98 678],92,2,6364,3.5553072625698325,0.0,20.0
1790,0,1790,[323   9 238 286 258],59,3,6367,3.55499720826354,0.0,0.0
1791,0,1791,[185 200 742  50 144],374,4,6371,3.5552455357142856,0.0,20.0
1792,0,1792,[302 603 427  50 313],334,5,6376,3.5560513106525375,20.0,20.0
1793,0,1793,[ 50 215  88 179  97],536,3,6379,3.5557413600891863,0.0,20.0
1794,0,1794,[234  95 235 238 568],650,2,6381,3.554874651810585,0.0,0.0
1795,0,1795,[172 313 197 435   9],474,5,6386,3.5556792873051224,0.0,0.0
1796,0,1796,[ 64 175 597 237 294],92,3,6389,3.555370061213133,0.0,0.0
1797,0,1797,[302 603 427  50 313],14,4,6393,3.5556173526140156,20.0,20.0
1798,0,1798,[302 603 427  50 313],271,5,6398,3.556420233463035,20.0,20.0
1799,0,1799,[302 603 427  50 313],669,5,6403,3.5572222222222223,20.0,20.0
1800,0,1800,[ 96  70  22 237 423],95,4,6407,3.557468073292615,0.0,0.0
1801,0,1801,[300 174 302 172 357],537,2,6409,3.556603773584906,20.0,20.0
1802,0,1802,[ 98 265 181   4 132],881,3,6412,3.5562950637825845,0.0,20.0
1803,0,1803,[118 179 328 135  70],271,3,6415,3.555986696230599,0.0,0.0
1804,0,1804,[238 117 222 173  50],454,1,6416,3.5545706371191135,0.0,20.0
1805,0,1805,[282 121 204 508 153],447,4,6420,3.5548172757475083,0.0,0.0
1806,0,1806,[301 265 655 143 258],234,0,6420,3.5528500276701718,0.0,0.0
1807,0,1807,[302 603 427  50 313],454,5,6425,3.5536504424778763,20.0,20.0
1808,0,1808,[302 603 427  50 313],271,5,6430,3.55444997236042,20.0,20.0
1809,0,1809,[ 98  69 174 121 234],804,5,6435,3.5552486187845305,0.0,40.0
1810,0,1810,[132  64 385 265 174],533,4,6439,3.5554942020982883,0.0,20.0
1811,0,1811,[ 96 194 322 186 197],263,4,6443,3.5557395143487858,0.0,0.0
1812,0,1812,[302 603 427  50 313],14,4,6447,3.555984555984556,20.0,20.0
1813,0,1813,[302 603 427  50 313],537,5,6452,3.5567805953693497,20.0,20.0
1814,0,1814,[ 50  70  89 151 603],234,2,6454,3.555922865013774,20.0,20.0
1815,0,1815,[302 603 427  50 313],14,4,6458,3.556167400881057,20.0,20.0
1816,0,1816,[ 71 172 211 210  15],650,2,6460,3.5553109521188775,0.0,0.0
1817,0,1817,[302 603 427  50 313],537,5,6465,3.556105610561056,20.0,20.0
1818,0,1818,[ 89 286 153 289 151],90,3,6468,3.5557998900494776,0.0,0.0
1819,0,1819,[300 546  11 322 153],13,1,6469,3.554395604395604,0.0,0.0
1820,0,1820,[  7 211 118 546  79],7,4,6473,3.554640307523339,0.0,0.0
1821,0,1821,[176 210  50 471 168],479,5,6478,3.5554335894621296,0.0,20.0
1822,0,1822,[  1 678 508 269 333],537,1,6479,3.554031815688426,0.0,0.0
1823,0,1823,[  1   7 245 197 121],653,3,6482,3.553728070175439,0.0,0.0
1824,0,1824,[302 603 427  50 313],537,5,6487,3.5545205479452053,20.0,20.0
1825,0,1825,[ 12 655 301 234 222],666,3,6490,3.5542168674698793,20.0,0.0
1826,0,1826,[172 202 357 197 181],59,5,6495,3.555008210180624,20.0,0.0
1827,0,1827,[ 71 237  88 427  82],234,1,6496,3.553610503282276,0.0,0.0
1828,0,1828,[143 174 546 678  98],881,4,6500,3.553854565336249,0.0,40.0
1829,0,1829,[ 71 179 151 196  98],234,1,6501,3.5524590163934424,0.0,20.0
1830,0,1830,[333 403 268 181 423],13,3,6504,3.552157291097761,0.0,0.0
1831,0,1831,[302 603 427  50 313],13,5,6509,3.552947598253275,20.0,20.0
1832,0,1832,[286 143  28 257 427],6,1,6510,3.551554828150573,0.0,0.0
1833,0,1833,[471 185 168  88 603],313,3,6513,3.551254089422028,20.0,0.0
1834,0,1834,[302 603 427  50 313],454,5,6518,3.552043596730245,20.0,20.0
1835,0,1835,[  7 181  12   4  11],474,5,6523,3.5528322440087146,20.0,0.0
1836,0,1836,[302 603 427  50 313],334,5,6528,3.5536200326619487,20.0,20.0
1837,0,1837,[302 603 427  50 313],271,5,6533,3.5544069640914038,20.0,20.0
1838,0,1838,[ 11 515  15 333 435],881,3,6536,3.55410549211528,0.0,0.0
1839,0,1839,[423 117 210 475 100],474,5,6541,3.554891304347826,0.0,20.0
1840,0,1840,[172   1 238 588  82],254,2,6543,3.5540467137425313,0.0,0.0
1841,0,1841,[302 603 427  50 313],454,5,6548,3.554831704668838,20.0,20.0
1842,0,1842,[282  97  98 127 100],328,3,6551,3.554530656538253,0.0,60.0
1843,0,1843,[302 603 427  50 313],334,5,6556,3.5553145336225596,20.0,20.0
1844,0,1844,[  9 173 179 215  95],749,3,6559,3.5550135501355014,0.0,0.0
1845,0,1845,[ 69 161 176  98  88],339,4,6563,3.5552546045503792,0.0,20.0
1846,0,1846,[302 603 427  50 313],669,5,6568,3.5560368164591227,20.0,20.0
1847,0,1847,[175 238 742 117  89],524,2,6570,3.5551948051948052,0.0,0.0
1848,0,1848,[ 69 135  97 215 210],311,5,6575,3.555976203353164,0.0,0.0
1849,0,1849,[195 301  64  95  70],378,3,6578,3.5556756756756758,0.0,0.0
1850,0,1850,[302 269  56 597 173],145,5,6583,3.556455969746083,0.0,0.0
1851,0,1851,[427 168 496 186 385],537,4,6587,3.556695464362851,0.0,0.0
1852,0,1852,[ 82 183 588 121 546],194,1,6588,3.5553157042633567,0.0,0.0
1853,0,1853,[357  50 289 483 183],91,5,6593,3.5560949298813376,40.0,20.0
1854,0,1854,[302 603 427  50 313],13,5,6598,3.556873315363881,20.0,20.0
1855,0,1855,[ 69 588 508 222  95],406,4,6602,3.5571120689655173,0.0,0.0
1856,0,1856,[302 603 427  50 313],334,5,6607,3.5578890683898763,20.0,20.0
1857,0,1857,[228 161 546  69 237],533,3,6610,3.557588805166846,0.0,0.0
1858,0,1858,[172 216  69 161 121],334,0,6610,3.5556750941366326,0.0,0.0
1859,0,1859,[ 89 196  70   8 385],311,5,6615,3.556451612903226,0.0,0.0
1860,0,1860,[172 276 288 186  50],537,3,6618,3.556152606125739,0.0,20.0
1861,0,1861,[176 153 385 546 111],374,4,6622,3.556390977443609,0.0,0.0
1862,0,1862,[ 98 357 202 191 180],738,5,6627,3.5571658615136874,20.0,20.0
1863,0,1863,[127 748 174 568 216],313,4,6631,3.5574034334763946,0.0,40.0
1864,0,1864,[302 603 427  50 313],537,5,6636,3.5581769436997317,20.0,20.0
1865,0,1865,[483 182 202 286   4],194,2,6638,3.557341907824223,20.0,0.0
1866,0,1866,[403  98 196 318 172],194,2,6640,3.5565077664702733,20.0,20.0
1867,0,1867,[302 603 427  50 313],271,5,6645,3.5572805139186294,20.0,20.0
1868,0,1868,[ 89 588 546 655 427],308,4,6649,3.5575173889780634,0.0,0.0
1869,0,1869,[302 603 427  50 313],454,5,6654,3.5582887700534758,20.0,20.0
1870,0,1870,[194 357 423 183  82],95,4,6658,3.5585248530197755,20.0,0.0
1871,0,1871,[173 222 357 186 100],650,5,6663,3.559294871794872,20.0,20.0
1872,0,1872,[183 153  64  97  71],328,3,6666,3.5589962626801923,0.0,0.0
1873,0,1873,[195 194  25 118 176],749,4,6670,3.55923159018143,0.0,0.0
1874,0,1874,[471 385 210 174  22],308,4,6674,3.559466666666667,0.0,20.0
1875,0,1875,[ 98 172 742  50 237],92,4,6678,3.5597014925373136,0.0,40.0
1876,0,1876,[197 275 276 357 181],311,5,6683,3.5604688332445393,20.0,0.0
1877,0,1877,[302 603 427  50 313],334,5,6688,3.5612353567625132,20.0,20.0
1878,0,1878,[210 546 153 655  82],64,1,6689,3.5598722724853644,0.0,0.0
1879,0,1879,[323 546  22  28 597],897,5,6694,3.5606382978723405,0.0,0.0
1880,0,1880,[235 238 268 204 288],537,2,6696,3.5598086124401913,0.0,0.0
1881,0,1881,[302 603 427  50 313],537,5,6701,3.5605738575982997,20.0,20.0
1882,0,1882,[237 174 181  70 210],308,4,6705,3.56080722251726,0.0,20.0
1883,0,1883,[302 603 427  50 313],669,5,6710,3.561571125265393,20.0,20.0
1884,0,1884,[200 186 176  79 265],326,3,6713,3.561273209549072,0.0,0.0
1885,0,1885,[100 187 273 186 216],234,2,6715,3.560445387062566,0.0,20.0
1886,0,1886,[211 153 265  98 127],326,4,6719,3.560678325384208,0.0,40.0
1887,0,1887,[302 603 427  50 313],537,5,6724,3.5614406779661016,20.0,20.0
1888,0,1888,[191  56 183 186 515],6,5,6729,3.5622022233986237,0.0,0.0
1889,0,1889,[302 603 427  50 313],271,5,6734,3.562962962962963,20.0,20.0
1890,0,1890,[153 204 216 403 228],643,3,6737,3.562665256478054,0.0,0.0
1891,0,1891,[302 603 427  50 313],474,5,6742,3.563424947145877,20.0,20.0
1892,0,1892,[176 289  12 151  15],234,1,6743,3.562070787110407,20.0,0.0
1893,0,1893,[300 204 168 132 172],653,2,6745,3.561246040126716,0.0,0.0
1894,0,1894,[111 100 678 196   8],334,3,6748,3.5609498680738785,0.0,20.0
1895,0,1895,[132  88 318 195 144],653,2,6750,3.560126582278481,20.0,0.0
1896,0,1896,[161 168 181 423 172],334,3,6753,3.55983131259884,0.0,0.0
1897,0,1897,[ 69 191 742 194 176],543,3,6756,3.559536354056902,0.0,0.0
1898,0,1898,[ 28  79 100 258 200],738,2,6758,3.558715113217483,0.0,20.0
1899,0,1899,[748 180  88 132  25],474,4,6762,3.5589473684210526,0.0,0.0
1900,0,1900,[483 318 300 301  64],666,4,6766,3.5591793792740662,40.0,0.0
1901,0,1901,[302 603 427  50 313],474,5,6771,3.5599369085173502,20.0,20.0
1902,0,1902,[111 748 318 471 144],899,4,6775,3.560168155543878,20.0,0.0
1903,0,1903,[ 79 546 194 183 234],653,1,6776,3.5588235294117645,0.0,0.0
1904,0,1904,[ 98  70 144  12 234],406,3,6779,3.5585301837270342,20.0,20.0
1905,0,1905,[ 71 197 172 202 187],479,4,6783,3.5587618048268626,0.0,0.0
1906,0,1906,[191 286 235 210  56],524,3,6786,3.558468799160986,0.0,0.0
1907,0,1907,[196 678 216 118 302],13,3,6789,3.558176100628931,0.0,0.0
1908,0,1908,[ 15 742  56 174  98],59,4,6793,3.558407543216344,0.0,40.0
1909,0,1909,[ 69 245 211  56 313],533,3,6796,3.5581151832460733,0.0,0.0
1910,0,1910,[427 286   1 168 300],533,5,6801,3.5588697017268447,0.0,0.0
1911,0,1911,[318 483 100  89   7],13,3,6804,3.5585774058577404,40.0,20.0
1912,0,1912,[183 234 111 153  88],452,2,6806,3.5577626764244643,0.0,0.0
1913,0,1913,[302 603 427  50 313],474,5,6811,3.558516196447231,20.0,20.0
1914,0,1914,[ 96  69 118 222 483],200,5,6816,3.5592689295039164,20.0,0.0
1915,0,1915,[302 603 427  50 313],669,5,6821,3.5600208768267225,20.0,20.0
1916,0,1916,[ 82 265 597 216 385],95,2,6823,3.559207094418362,0.0,0.0
1917,0,1917,[678 313 175  88 515],92,3,6826,3.558915537017727,0.0,0.0
1918,0,1918,[181 153 144  50 117],313,4,6830,3.559145388223033,0.0,20.0
1919,0,1919,[423 215 204 294 655],234,1,6831,3.5578125,0.0,0.0
1920,0,1920,[ 50 238  98 117 168],234,2,6833,3.5570015616866217,0.0,40.0
1921,0,1921,[302 603 427  50 313],454,5,6838,3.5577523413111343,20.0,20.0
1922,0,1922,[238 132 300 191  71],488,1,6839,3.5564222568902757,0.0,0.0
1923,0,1923,[318 568 196  71 273],7,4,6843,3.5566528066528065,20.0,0.0
1924,0,1924,[302 603 427  50 313],334,5,6848,3.5574025974025973,20.0,20.0
1925,0,1925,[323  28 333 210 515],488,4,6852,3.5576323987538943,0.0,0.0
1926,0,1926,[176 222 603 742 385],897,3,6855,3.557343020238713,20.0,0.0
1927,0,1927,[185 603 211 294  69],82,4,6859,3.5575726141078836,20.0,0.0
1928,0,1928,[302 603 427  50 313],271,5,6864,3.558320373250389,20.0,20.0
1929,0,1929,[302 603 427  50 313],669,5,6869,3.5590673575129532,20.0,20.0
1930,0,1930,[235 318 508 258 215],537,3,6872,3.558777835318488,20.0,0.0
1931,0,1931,[302 603 427  50 313],13,5,6877,3.5595238095238093,20.0,20.0
1932,0,1932,[211   9 357 475  97],409,5,6882,3.5602690118986033,20.0,0.0
1933,0,1933,[328  89 176   9 313],378,4,6886,3.560496380558428,0.0,0.0
1934,0,1934,[181 568  88   1 173],379,5,6891,3.5612403100775194,0.0,0.0
1935,0,1935,[151  50   1  28 202],653,3,6894,3.5609504132231407,0.0,20.0
1936,0,1936,[175 216 423 180 186],60,5,6899,3.5616933402168303,0.0,0.0
1937,0,1937,[288 483 172 197 176],215,4,6903,3.5619195046439627,20.0,0.0
1938,0,1938,[302 603 427  50 313],537,5,6908,3.5626611655492524,20.0,20.0
1939,0,1939,[202 483 117  89  95],95,2,6910,3.5618556701030926,20.0,0.0
1940,0,1940,[405 132  71 215 318],59,3,6913,3.5615662029881503,20.0,0.0
1941,0,1941,[323 286 265  69 185],650,1,6914,3.560247167868177,0.0,0.0
1942,0,1942,[195 286 111 135  88],479,4,6918,3.5604734945959855,0.0,0.0
1943,0,1943,[302 603 427  50 313],537,5,6923,3.5612139917695473,20.0,20.0
1944,0,1944,[302 603 427  50 313],14,4,6927,3.561439588688946,20.0,20.0
1945,0,1945,[435 268  70 515 195],7,2,6929,3.5606372045220964,0.0,0.0
1946,0,1946,[127 471  56 191 135],666,5,6934,3.561376476630714,0.0,20.0
1947,0,1947,[302 603 427  50 313],454,5,6939,3.5621149897330597,20.0,20.0
1948,0,1948,[427 176 435 357 405],406,4,6943,3.5623396613648026,20.0,0.0
1949,0,1949,[216 328  12 294 210],506,5,6948,3.563076923076923,20.0,0.0
1950,0,1950,[  1  88 172 173 405],738,3,6951,3.5627883136852896,0.0,0.0
1951,0,1951,[ 15 403 125  89 100],144,3,6954,3.5625,0.0,20.0
1952,0,1952,[222   8 282 258 117],474,5,6959,3.563236047107015,0.0,0.0
1953,0,1953,[ 56 144 176  64 200],60,5,6964,3.563971340839304,0.0,0.0
1954,0,1954,[127  64 132 185 117],234,3,6967,3.563682864450128,0.0,20.0
1955,0,1955,[ 50 195 385  89   8],452,5,6972,3.5644171779141103,0.0,20.0
1956,0,1956,[568  88  98 257 121],738,2,6974,3.5636177823198776,0.0,20.0
1957,0,1957,[ 89 597  28  88 183],308,3,6977,3.563329928498468,0.0,0.0
1958,0,1958,[186 174 288  11 153],334,3,6980,3.5630423685553856,0.0,20.0
1959,0,1959,[  4 322 197  25 215],234,2,6982,3.5622448979591836,0.0,0.0
1960,0,1960,[302 603 427  50 313],454,5,6987,3.562978072412035,20.0,20.0
1961,0,1961,[ 89 257  69 215 427],454,4,6991,3.5632008154943935,0.0,0.0
1962,0,1962,[603 258 151 180   7],666,4,6995,3.5634233316352524,20.0,0.0
1963,0,1963,[405 172 197 357  69],738,4,6999,3.5636456211812626,20.0,0.0
1964,0,1964,[174 245 238 435 546],804,3,7002,3.5633587786259544,0.0,20.0
1965,0,1965,[ 96  70  69 194 318],42,4,7006,3.563580874872838,20.0,0.0
1966,0,1966,[302 603 427  50 313],669,5,7011,3.5643111337061515,20.0,20.0
1967,0,1967,[215 117 100 196 258],13,4,7015,3.564532520325203,0.0,20.0
1968,0,1968,[187 435 181 121 182],158,4,7019,3.564753682072118,0.0,0.0
1969,0,1969,[265  95 125 357 191],234,2,7021,3.5639593908629443,20.0,0.0
1970,0,1970,[302 603 427  50 313],454,5,7026,3.56468797564688,20.0,20.0
1971,0,1971,[273 403 172  96 176],279,1,7027,3.563387423935091,0.0,0.0
1972,0,1972,[302 603 427  50 313],13,5,7032,3.564115560060821,20.0,20.0
1973,0,1973,[302 603 427  50 313],669,5,7037,3.56484295845998,20.0,20.0
1974,0,1974,[ 22 117 132 238 588],892,5,7042,3.5655696202531644,0.0,0.0
1975,0,1975,[269 328 186 313 403],378,3,7045,3.5652834008097165,0.0,0.0
1976,0,1976,[228 161  56 268 168],92,4,7049,3.565503287809813,0.0,0.0
1977,0,1977,[118 678 748  69  25],749,2,7051,3.5647118301314458,0.0,0.0
1978,0,1978,[302 603 427  50 313],454,5,7056,3.5654370894391105,20.0,20.0
1979,0,1979,[655 183 143 282 234],881,4,7060,3.5656565656565657,0.0,0.0
1980,0,1980,[302 603 427  50 313],474,5,7065,3.5663806158505804,20.0,20.0
1981,0,1981,[175 435  82 403  89],524,4,7069,3.5665993945509586,0.0,0.0
1982,0,1982,[234 257 265 173 100],92,3,7072,3.5663136661623804,0.0,20.0
1983,0,1983,[302 603 427  50 313],271,5,7077,3.5670362903225805,20.0,20.0
1984,0,1984,[117 322 403  98 195],749,5,7082,3.567758186397985,0.0,20.0
1985,0,1985,[302 603 427  50 313],13,5,7087,3.568479355488419,20.0,20.0
1986,0,1986,[  4  89 118  25 183],378,4,7091,3.568696527428284,0.0,0.0
1987,0,1987,[168  15 175 323 211],650,3,7094,3.5684104627766597,0.0,0.0
1988,0,1988,[176  50 483 197 238],385,3,7097,3.568124685771745,20.0,20.0
1989,0,1989,[100 161  28 168 194],774,0,7097,3.5663316582914573,0.0,20.0
1990,0,1990,[179  64 161 405   4],87,5,7102,3.567051732797589,0.0,0.0
1991,0,1991,[100 300 196  89   8],7,5,7107,3.5677710843373496,0.0,20.0
1992,0,1992,[302 603 427  50 313],474,5,7112,3.5684897139989964,20.0,20.0
1993,0,1993,[  4 135 289 175  69],10,4,7116,3.568706118355065,0.0,0.0
1994,0,1994,[168 111 211 313  70],653,1,7117,3.5674185463659147,0.0,0.0
1995,0,1995,[ 88 257 153 204 180],650,2,7119,3.5666332665330662,0.0,0.0
1996,0,1996,[197 496 161  69 132],524,4,7123,3.5668502754131195,0.0,0.0
1997,0,1997,[302 603 427  50 313],454,5,7128,3.5675675675675675,20.0,20.0
1998,0,1998,[181 100 216   1 228],295,5,7133,3.5682841420710356,0.0,20.0
1999,0,1999,[302 603 427  50 313],474,5,7138,3.569,20.0,20.0
2000,0,2000,[143 168  69 276 222],474,4,7142,3.569215392303848,0.0,0.0
2001,0,2001,[ 89 195 144 174 200],479,5,7147,3.56993006993007,0.0,20.0
2002,0,2002,[282 195 294 180 435],533,4,7151,3.5701447828257615,0.0,0.0
2003,0,2003,[313  70 603 333 235],13,2,7153,3.56936127744511,20.0,0.0
2004,0,2004,[ 79 318   7 211 546],328,4,7157,3.569576059850374,20.0,0.0
2005,0,2005,[302 313 268 161 197],334,4,7161,3.569790628115653,0.0,0.0
2006,0,2006,[186 176 181 180  25],210,5,7166,3.570503238664674,0.0,0.0
2007,0,2007,[265 235 238  96 182],145,5,7171,3.571215139442231,0.0,0.0
2008,0,2008,[276 427 483 195   4],59,5,7176,3.5719263315082133,20.0,0.0
2009,0,2009,[200 182 300 121  69],328,4,7180,3.572139303482587,0.0,0.0
2010,0,2010,[202 257 210 568 678],92,1,7181,3.570860268523123,0.0,0.0
2011,0,2011,[185 546  64 265 153],95,2,7183,3.570079522862823,0.0,0.0
2012,0,2012,[302 603 427  50 313],474,5,7188,3.570789865871833,20.0,20.0
2013,0,2013,[302 603 427  50 313],334,5,7193,3.5714995034756702,20.0,20.0
2014,0,2014,[238 235  70  98 118],184,3,7196,3.5712158808933,0.0,20.0
2015,0,2015,[302 603 427  50 313],537,5,7201,3.5719246031746033,20.0,20.0
2016,0,2016,[588 385 135 234  79],95,2,7203,3.571145265245414,0.0,0.0
2017,0,2017,[135  50  89 234 202],290,3,7206,3.570862239841427,0.0,20.0
2018,0,2018,[176  89 603 173 174],659,5,7211,3.5715700842000992,20.0,20.0
2019,0,2019,[ 98 197 143  15 215],406,3,7214,3.5712871287128714,0.0,20.0
2020,0,2020,[185 403 100  82 153],650,2,7216,3.570509648688768,0.0,20.0
2021,0,2021,[302 603 427  50 313],474,5,7221,3.5712166172106823,20.0,20.0
2022,0,2022,[403 179 204  69 483],308,3,7224,3.5709342560553634,20.0,0.0
2023,0,2023,[265 475 273 168 179],479,3,7227,3.5706521739130435,0.0,0.0
2024,0,2024,[302 603 427  50 313],14,4,7231,3.5708641975308644,20.0,20.0
2025,0,2025,[  8 300 302 191 508],378,5,7236,3.5715695952615993,0.0,0.0
2026,0,2026,[176 168 125  82  96],648,4,7240,3.5717809570794277,0.0,0.0
2027,0,2027,[195 588 294  56 183],537,1,7241,3.5705128205128207,0.0,0.0
2028,0,2028,[132 135   1 151 258],378,3,7244,3.5702316412025628,0.0,0.0
2029,0,2029,[228 222 568 300 121],87,4,7248,3.5704433497536945,0.0,0.0
2030,0,2030,[302 603 427  50 313],537,5,7253,3.5711472181191533,20.0,20.0
2031,0,2031,[603  70 423 301  56],334,3,7256,3.5708661417322833,20.0,0.0
2032,0,2032,[ 96 302 143  56 182],537,3,7259,3.570585341859321,0.0,0.0
2033,0,2033,[435 172  79 216 568],13,2,7261,3.5698131760078664,0.0,0.0
2034,0,2034,[234  97  88 515 197],537,2,7263,3.569041769041769,0.0,0.0
2035,0,2035,[ 98 183 427 187  88],694,5,7268,3.569744597249509,0.0,20.0
2036,0,2036,[403 175  11   1 546],339,4,7272,3.569955817378498,0.0,0.0
2037,0,2037,[265 471  15 748 235],83,2,7274,3.5691854759568202,0.0,0.0
2038,0,2038,[ 50 144   1 194 515],883,3,7277,3.5689063266307013,0.0,20.0
2039,0,2039,[302 603 427  50 313],271,5,7282,3.569607843137255,20.0,20.0
2040,0,2040,[302 603 427  50 313],334,5,7287,3.5703086722195003,20.0,20.0
2041,0,2041,[ 12  69 234 603 245],666,2,7289,3.569539666993144,40.0,0.0
2042,0,2042,[302 603 427  50 313],537,5,7294,3.5702398433675966,20.0,20.0
2043,0,2043,[302 603 427  50 313],14,4,7298,3.5704500978473583,20.0,20.0
2044,0,2044,[135 215 588  89 125],406,3,7301,3.5701711491442545,0.0,0.0
2045,0,2045,[423 125  95 111 100],334,2,7303,3.569403714565005,0.0,20.0
2046,0,2046,[121 222 111 275  70],13,2,7305,3.568637029799707,0.0,0.0
2047,0,2047,[ 15  25 302 288 222],378,3,7308,3.568359375,0.0,0.0
2048,0,2048,[302 603 427  50 313],474,5,7313,3.569058077110786,20.0,20.0
2049,0,2049,[302 603 427  50 313],537,5,7318,3.5697560975609757,20.0,20.0
2050,0,2050,[357   4 144 222   7],738,5,7323,3.570453437347635,20.0,0.0
2051,0,2051,[168  56 172 678 125],648,2,7325,3.5696881091617936,0.0,0.0
2052,0,2052,[182 153  56  64 143],666,4,7329,3.569897710667316,0.0,0.0
2053,0,2053,[  8 216 185  96 257],883,5,7334,3.5705939629990264,0.0,0.0
2054,0,2054,[ 69  95  25 483 100],881,3,7337,3.570316301703163,20.0,20.0
2055,0,2055,[302 603 427  50 313],13,5,7342,3.571011673151751,20.0,20.0
2056,0,2056,[333 742 191  22  56],881,4,7346,3.5712202236266406,0.0,0.0
2057,0,2057,[181  56 183 191 515],840,4,7350,3.5714285714285716,0.0,0.0
2058,0,2058,[100 125 215 172 195],77,1,7351,3.570179698882953,0.0,20.0
2059,0,2059,[237  28 183 301 176],666,3,7354,3.5699029126213593,0.0,0.0
2060,0,2060,[597 268 181 275 173],145,4,7358,3.57011159631247,0.0,0.0
2061,0,2061,[475 333 273 216 211],13,1,7359,3.5688651794374393,0.0,0.0
2062,0,2062,[ 11   4 483 144 323],804,5,7364,3.5695588948133787,20.0,0.0
2063,0,2063,[655 182  50 194  69],95,4,7368,3.5697674418604652,0.0,20.0
2064,0,2064,[588  89 181  64 183],64,4,7372,3.5699757869249393,0.0,0.0
2065,0,2065,[302 603 427  50 313],537,5,7377,3.5706679574056146,20.0,20.0
2066,0,2066,[302 603 427  50 313],271,5,7382,3.571359458151911,20.0,20.0
2067,0,2067,[302 603 427  50 313],14,4,7386,3.5715667311411994,20.0,20.0
2068,0,2068,[275  79 144 235 216],648,5,7391,3.5722571290478493,0.0,0.0
2069,0,2069,[302 603 427  50 313],334,5,7396,3.572946859903382,20.0,20.0
2070,0,2070,[302 603 427  50 313],474,5,7401,3.5736359246740705,20.0,20.0
2071,0,2071,[302 603 427  50 313],454,5,7406,3.574324324324324,20.0,20.0
2072,0,2072,[ 25 286 276 215  88],234,0,7406,3.5726000964785336,0.0,0.0
2073,0,2073,[302 603 427  50 313],334,5,7411,3.573288331726133,20.0,20.0
2074,0,2074,[302 603 427  50 313],454,5,7416,3.573975903614458,20.0,20.0
2075,0,2075,[ 89 196 435 403   7],59,5,7421,3.5746628131021194,0.0,0.0
2076,0,2076,[271   7  69 183 187],144,3,7424,3.5743861338468945,0.0,0.0
2077,0,2077,[194  79 176 286   4],664,5,7429,3.57507218479307,0.0,0.0
2078,0,2078,[173 385 215 117 180],524,2,7431,3.5743145743145743,0.0,0.0
2079,0,2079,[313 181 333 204  79],13,3,7434,3.5740384615384615,0.0,0.0
2080,0,2080,[405 678 603 173 185],213,4,7438,3.5742431523306104,20.0,0.0
2081,0,2081,[238  11  96 257 228],454,2,7440,3.5734870317002883,0.0,0.0
2082,0,2082,[194  50 196  98   1],234,3,7443,3.57321171387422,0.0,40.0
2083,0,2083,[302 603 427  50 313],271,5,7448,3.5738963531669867,20.0,20.0
2084,0,2084,[173  56 195 127 117],234,1,7449,3.5726618705035973,0.0,20.0
2085,0,2085,[322 185 173  22 172],488,3,7452,3.572387344199425,0.0,0.0
2086,0,2086,[302 603 427  50 313],474,5,7457,3.573071394345951,20.0,20.0
2087,0,2087,[ 22 423  82  69  98],311,5,7462,3.5737547892720305,0.0,20.0
2088,0,2088,[222 234  71 191 196],378,4,7466,3.5739588319770226,0.0,0.0
2089,0,2089,[  4 173 117 204 276],234,1,7467,3.5727272727272728,0.0,0.0
2090,0,2090,[161 210 496   4 204],524,2,7469,3.571975131516021,0.0,0.0
2091,0,2091,[161 173 181 483  88],648,4,7473,3.5721797323135753,20.0,0.0
2092,0,2092,[301 194 300 197 423],234,3,7476,3.57190635451505,0.0,0.0
2093,0,2093,[195 268  56  64 515],85,4,7480,3.572110792741165,0.0,0.0
2094,0,2094,[302 603 427  50 313],14,4,7484,3.5723150357995226,20.0,20.0
2095,0,2095,[568 187 302   1 127],210,5,7489,3.572996183206107,0.0,20.0
2096,0,2096,[742 294  98 175 228],447,3,7492,3.5727229375298046,0.0,20.0
2097,0,2097,[302 603 427  50 313],454,5,7497,3.573403241182078,20.0,20.0
2098,0,2098,[302 603 427  50 313],271,5,7502,3.574082896617437,20.0,20.0
2099,0,2099,[302 603 427  50 313],14,4,7506,3.5742857142857143,20.0,20.0
2100,0,2100,[194 333 427 286 191],343,4,7510,3.5744883388862445,0.0,0.0
2101,0,2101,[403 215 234 174 117],95,3,7513,3.5742150333016176,0.0,20.0
2102,0,2102,[328 508  82  22 172],653,3,7516,3.5739419876367093,0.0,0.0
2103,0,2103,[403 655 195   4  11],804,4,7520,3.574144486692015,0.0,0.0
2104,0,2104,[302 603 427  50 313],454,5,7525,3.5748218527315916,20.0,20.0
2105,0,2105,[ 82  22 257 111  88],95,4,7529,3.5750237416904085,0.0,0.0
2106,0,2106,[302 603 427  50 313],334,5,7534,3.575700047460845,20.0,20.0
2107,0,2107,[194 323 742 187 748],648,3,7537,3.575426944971537,0.0,0.0
2108,0,2108,[302 603 427  50 313],334,5,7542,3.5761024182076815,20.0,20.0
2109,0,2109,[174   4 111   9 194],64,4,7546,3.576303317535545,0.0,20.0
2110,0,2110,[357  12  70  11   7],537,3,7549,3.5760303173851256,40.0,0.0
2111,0,2111,[200  95 405 185 183],59,3,7552,3.5757575757575757,0.0,0.0
2112,0,2112,[ 56 161  82 385   7],7,3,7555,3.5754850922858497,0.0,0.0
2113,0,2113,[  4  98  97  64 127],308,3,7558,3.575212866603595,0.0,40.0
2114,0,2114,[302 603 427  50 313],474,5,7563,3.575886524822695,20.0,20.0
2115,0,2115,[268 168 204 121 175],85,4,7567,3.5760869565217392,0.0,0.0
2116,0,2116,[288 405 268  50 475],894,1,7568,3.574870099196977,0.0,20.0
2117,0,2117,[185  97 118 435 100],194,3,7571,3.5745986779981114,0.0,20.0
2118,0,2118,[515 135 603  69  88],13,4,7575,3.5747994336951394,20.0,0.0
2119,0,2119,[546  79 282 300 258],447,3,7578,3.5745283018867924,0.0,0.0
2120,0,2120,[655 435 111  50 173],474,5,7583,3.5752003771805754,0.0,20.0
2121,0,2121,[318 238 258  25  69],184,3,7586,3.5749293119698398,20.0,0.0
2122,0,2122,[204 471 234 135 603],308,3,7589,3.574658502119642,20.0,0.0
2123,0,2123,[118 333 269 385  11],343,2,7591,3.5739171374764593,0.0,0.0
2124,0,2124,[191  98 100 328 275],499,4,7595,3.5741176470588236,0.0,40.0
2125,0,2125,[197 182 153  88 135],653,1,7596,3.5729068673565383,0.0,0.0
2126,0,2126,[597  64 405 294  82],95,1,7597,3.5716972261401034,0.0,0.0
2127,0,2127,[289 117 496 182  71],95,3,7600,3.5714285714285716,0.0,0.0
2128,0,2128,[313 257  89 210  25],934,4,7604,3.5716298731798966,0.0,0.0
2129,0,2129,[318 245 475  70  89],455,1,7605,3.5704225352112675,20.0,0.0
2130,0,2130,[ 70 196   7  88 135],659,2,7607,3.56968559361802,0.0,0.0
2131,0,2131,[180 181  50 127 385],537,3,7610,3.569418386491557,0.0,40.0
2132,0,2132,[302 603 427  50 313],669,5,7615,3.5700890764181903,20.0,20.0
2133,0,2133,[ 22   4 435 210 742],524,2,7617,3.569353327085286,0.0,0.0
2134,0,2134,[300  28 257 301 194],119,5,7622,3.570023419203747,0.0,0.0
2135,0,2135,[ 70 275  12 186 282],378,4,7626,3.5702247191011236,20.0,0.0
2136,0,2136,[222 153 742 174 286],666,2,7628,3.5694899391670565,0.0,20.0
2137,0,2137,[174 195 235 275 100],279,3,7631,3.5692235734331152,0.0,40.0
2138,0,2138,[  1 403  88 313 204],883,3,7634,3.568957456755493,0.0,0.0
2139,0,2139,[258 176  98 273 515],328,4,7638,3.569158878504673,0.0,20.0
2140,0,2140,[302 603 427  50 313],271,5,7643,3.5698271835590845,20.0,20.0
2141,0,2141,[197 161 179 742 200],271,3,7646,3.569561157796452,0.0,0.0
2142,0,2142,[302 603 427  50 313],669,5,7651,3.5702286514232386,20.0,20.0
2143,0,2143,[228   8 118 100 302],158,5,7656,3.5708955223880596,0.0,20.0
2144,0,2144,[286 234 176  79  69],380,3,7659,3.5706293706293706,0.0,0.0
2145,0,2145,[176 168 127 273 183],158,3,7662,3.570363466915191,0.0,20.0
2146,0,2146,[496 118 194 568 172],311,4,7666,3.570563577084304,0.0,0.0
2147,0,2147,[748 294 187 405 323],804,5,7671,3.57122905027933,0.0,0.0
2148,0,2148,[ 79 289 180 182  11],13,2,7673,3.570497906002792,0.0,0.0
2149,0,2149,[302 603 427  50 313],474,5,7678,3.5711627906976746,20.0,20.0
2150,0,2150,[300 276 135 235   8],271,2,7680,3.5704323570432357,0.0,0.0
2151,0,2151,[ 12 276 135 357 125],406,4,7684,3.570631970260223,40.0,0.0
2152,0,2152,[ 28 405 282 187 515],328,4,7688,3.5708313980492337,0.0,0.0
2153,0,2153,[200 257  70 185 210],271,4,7692,3.5710306406685235,0.0,0.0
2154,0,2154,[ 82 118 222 435 210],313,3,7695,3.5707656612529,0.0,0.0
2155,0,2155,[  9 318 172 182 568],488,2,7697,3.5700371057513913,20.0,0.0
2156,0,2156,[216 655 176 475  56],13,2,7699,3.5693092257765415,0.0,0.0
2157,0,2157,[302 603 427  50 313],454,5,7704,3.5699721964782207,20.0,20.0
2158,0,2158,[294 215 234 174 183],346,2,7706,3.569245020842983,0.0,20.0
2159,0,2159,[302 603 427  50 313],13,5,7711,3.5699074074074075,20.0,20.0
2160,0,2160,[179 135   1 282 276],271,2,7713,3.5691809347524295,0.0,0.0
2161,0,2161,[118   9  98 187 179],308,3,7716,3.568917668825162,0.0,20.0
2162,0,2162,[215 191 275 238 234],308,3,7719,3.5686546463245494,0.0,0.0
2163,0,2163,[302 603 427  50 313],669,5,7724,3.569316081330869,20.0,20.0
2164,0,2164,[301 568 333 121 187],13,2,7726,3.568591224018476,0.0,0.0
2165,0,2165,[282 294 121  11 288],554,2,7728,3.5678670360110805,0.0,0.0
2166,0,2166,[603 143 176  64   4],339,5,7733,3.568527918781726,20.0,0.0
2167,0,2167,[ 88 173 210  97 174],848,5,7738,3.569188191881919,0.0,20.0
2168,0,2168,[405 568  98 234 678],7,3,7741,3.5689257722452745,0.0,20.0
2169,0,2169,[385  97 194 268 179],7,4,7745,3.5691244239631335,0.0,0.0
2170,0,2170,[423 597 318 294  95],200,5,7750,3.5697835099032704,20.0,0.0
2171,0,2171,[302 603 427  50 313],14,4,7754,3.5699815837937385,20.0,20.0
2172,0,2172,[748 127  56 222 405],102,0,7754,3.568338702254947,0.0,20.0
2173,0,2173,[588  25 427 172 258],13,4,7758,3.5685372585096595,0.0,0.0
2174,0,2174,[ 28 302 121 294 183],537,1,7759,3.5673563218390805,0.0,0.0
2175,0,2175,[257  50 200  89 597],653,4,7763,3.5675551470588234,0.0,20.0
2176,0,2176,[302 603 427  50 313],13,5,7768,3.56821313734497,20.0,20.0
2177,0,2177,[322 200 496  69 515],313,3,7771,3.5679522497704315,0.0,0.0
2178,0,2178,[ 69 234 180 333  28],533,3,7774,3.567691601652134,0.0,0.0
2179,0,2179,[302 603 427  50 313],474,5,7779,3.568348623853211,20.0,20.0
2180,0,2180,[302 603 427  50 313],13,5,7784,3.569005043558001,20.0,20.0
2181,0,2181,[302 603 427  50 313],271,5,7789,3.5696608615948673,20.0,20.0
2182,0,2182,[ 89 132  28  64 195],215,5,7794,3.570316078790655,0.0,0.0
2183,0,2183,[597 288 294 245 151],141,2,7796,3.56959706959707,0.0,0.0
2184,0,2184,[ 96  50 423 135 151],189,5,7801,3.5702517162471397,0.0,20.0
2185,0,2185,[515 318  50 174 483],326,5,7806,3.5709057639524246,40.0,40.0
2186,0,2186,[237 302 235  97 185],271,3,7809,3.570644718792867,0.0,0.0
2187,0,2187,[427 202 655 176  69],234,2,7811,3.569926873857404,0.0,0.0
2188,0,2188,[143 197 423 237 357],749,4,7815,3.570123343992691,20.0,0.0
2189,0,2189,[ 56 172 204 282 300],378,5,7820,3.5707762557077625,0.0,0.0
2190,0,2190,[ 25 175 265  95 180],92,3,7823,3.570515746234596,0.0,0.0
2191,0,2191,[302 603 427  50 313],13,5,7828,3.571167883211679,20.0,20.0
2192,0,2192,[588 196 174 210 195],64,4,7832,3.571363429092567,0.0,20.0
2193,0,2193,[258 172 328 294  25],145,4,7836,3.571558796718323,0.0,0.0
2194,0,2194,[302 603 427  50 313],454,5,7841,3.5722095671981777,20.0,20.0
2195,0,2195,[200 475 202 182 204],527,2,7843,3.5714936247723132,0.0,0.0
2196,0,2196,[187 238 191  12  98],379,5,7848,3.572143832498862,20.0,20.0
2197,0,2197,[ 12 435 197 318 181],7,4,7852,3.572338489535942,40.0,0.0
2198,0,2198,[ 25  82 197  22  95],378,4,7856,3.5725329695316055,0.0,0.0
2199,0,2199,[427 191 385 300   4],234,3,7859,3.5722727272727273,0.0,0.0
2200,0,2200,[302 603 427  50 313],334,5,7864,3.5729213993639255,20.0,20.0
2201,0,2201,[302 603 427  50 313],334,5,7869,3.5735694822888284,20.0,20.0
2202,0,2202,[302 603 427  50 313],474,5,7874,3.5742169768497503,20.0,20.0
2203,0,2203,[ 50 176 216 385 132],10,5,7879,3.57486388384755,0.0,20.0
2204,0,2204,[ 56  95 215 546  71],308,3,7882,3.574603174603175,0.0,0.0
2205,0,2205,[196 483 180  15 132],650,3,7885,3.574342701722575,20.0,0.0
2206,0,2206,[197 153 174  97 172],298,4,7889,3.57453556864522,0.0,20.0
2207,0,2207,[302 603 427  50 313],13,5,7894,3.57518115942029,20.0,20.0
2208,0,2208,[181 194  89 175 168],60,5,7899,3.5758261656858306,0.0,0.0
2209,0,2209,[168 191 187 125 588],194,4,7903,3.5760180995475115,0.0,0.0
2210,0,2210,[ 71 257 300 144 204],749,4,7907,3.576209859791949,0.0,0.0
2211,0,2211,[322 186 357 196 127],881,3,7910,3.5759493670886076,20.0,20.0
2212,0,2212,[180 405 257 111 286],479,4,7914,3.5761409850881156,0.0,0.0
2213,0,2213,[153  96 603 121 357],7,5,7919,3.576784101174345,40.0,0.0
2214,0,2214,[302 603 427  50 313],334,5,7924,3.5774266365688487,20.0,20.0
2215,0,2215,[117  98 191 211 322],234,2,7926,3.5767148014440435,0.0,20.0
2216,0,2216,[302 603 427  50 313],474,5,7931,3.5773567884528643,20.0,20.0
2217,0,2217,[ 97   8  95  98 496],892,5,7936,3.5779981965734895,0.0,20.0
2218,0,2218,[ 89 182  70  88 423],13,4,7940,3.5781883731410544,0.0,0.0
2219,0,2219,[180 288 172 273 153],378,3,7943,3.577927927927928,0.0,0.0
2220,0,2220,[175 423 127 186  82],666,2,7945,3.5772174696082844,0.0,20.0
2221,0,2221,[228 153 403   4  22],64,3,7948,3.576957695769577,0.0,0.0
2222,0,2222,[ 79 100 385 222 357],13,1,7949,3.5757984705353127,20.0,20.0
2223,0,2223,[183  12 286 328 100],144,4,7953,3.5759892086330933,20.0,20.0
2224,0,2224,[271 153 568 294  50],92,2,7955,3.5752808988764047,0.0,20.0
2225,0,2225,[302 603 427  50 313],537,5,7960,3.5759209344115006,20.0,20.0
2226,0,2226,[496 191 132  88 135],200,5,7965,3.576560395150427,0.0,0.0
2227,0,2227,[302 603 427  50 313],454,5,7970,3.5771992818671454,20.0,20.0
2228,0,2228,[302 603 427  50 313],474,5,7975,3.5778375953342305,20.0,20.0
2229,0,2229,[196 204 313 258 322],533,5,7980,3.57847533632287,0.0,0.0
2230,0,2230,[ 25 187 195  96 197],308,4,7984,3.578664276109368,0.0,0.0
2231,0,2231,[ 71 132 111 435  25],234,1,7985,3.5775089605734767,0.0,0.0
2232,0,2232,[302 603 427  50 313],334,5,7990,3.5781459919390954,20.0,20.0
2233,0,2233,[294 204  56 403 328],328,2,7992,3.5774395702775292,0.0,0.0
2234,0,2234,[143  97  71 222  88],60,2,7994,3.5767337807606263,0.0,0.0
2235,0,2235,[271 195 655  69 175],64,4,7998,3.576923076923077,0.0,0.0
2236,0,2236,[302 603 427  50 313],537,5,8003,3.577559231113098,20.0,20.0
2237,0,2237,[496 427  89 186  79],650,4,8007,3.5777479892761392,0.0,0.0
2238,0,2238,[483 288 471   1   4],13,2,8009,3.577043322912014,20.0,0.0
2239,0,2239,[  7 313 245 268 185],334,4,8013,3.577232142857143,0.0,0.0
2240,0,2240,[ 28 211  79 194 151],897,5,8018,3.577867023650156,0.0,0.0
2241,0,2241,[143 222 172  71 117],454,1,8019,3.5767172167707404,0.0,0.0
2242,0,2242,[182  70 286 483 186],406,2,8021,3.5760142666072223,20.0,0.0
2243,0,2243,[  7 496 175  22 173],738,4,8025,3.5762032085561497,0.0,0.0
2244,0,2244,[302 603 427  50 313],454,5,8030,3.576837416481069,20.0,20.0
2245,0,2245,[302 603 427  50 313],13,5,8035,3.5774710596616206,20.0,20.0
2246,0,2246,[222 215  11 143 216],378,3,8038,3.5772140631953717,0.0,0.0
2247,0,2247,[153 597 245 748  11],92,3,8041,3.5769572953736657,0.0,0.0
2248,0,2248,[302 603 427  50 313],14,4,8045,3.5771453979546464,20.0,20.0
2249,0,2249,[237 288 496 132 357],308,2,8047,3.5764444444444443,20.0,0.0
2250,0,2250,[294 186 385 195  50],653,4,8051,3.576632607729898,0.0,20.0
2251,0,2251,[ 22 180 186 265 568],59,5,8056,3.577264653641208,0.0,0.0
2252,0,2252,[302 603 427  50 313],454,5,8061,3.577896138482024,20.0,20.0
2253,0,2253,[302 603 427  50 313],474,5,8066,3.578527062999113,20.0,20.0
2254,0,2254,[ 97 132 168 546   4],295,5,8071,3.5791574279379157,0.0,0.0
2255,0,2255,[173 118   8  98  96],92,3,8074,3.5789007092198584,0.0,20.0
2256,0,2256,[471 655 289 216 127],537,1,8075,3.5777580859548075,0.0,20.0
2257,0,2257,[ 69 161 271 475 216],13,2,8077,3.5770593445527017,0.0,0.0
2258,0,2258,[357 181  95 300 179],479,3,8080,3.576803895528995,20.0,0.0
2259,0,2259,[186 173 180 257 100],749,3,8083,3.5765486725663718,0.0,20.0
2260,0,2260,[318 127 132 168   7],776,4,8087,3.5767359575409112,20.0,20.0
2261,0,2261,[127 237 153 183 202],184,3,8090,3.576480990274094,0.0,20.0
2262,0,2262,[153 100  79 117 125],313,3,8093,3.5762262483429077,0.0,20.0
2263,0,2263,[286 300 200  12 568],379,4,8097,3.5764134275618376,20.0,0.0
2264,0,2264,[161 135 143   1 153],918,1,8098,3.5752759381898453,0.0,0.0
2265,0,2265,[202 194 168  82 196],897,2,8100,3.5745807590467784,0.0,0.0
2266,0,2266,[302 603 427  50 313],14,4,8104,3.5747684164093516,20.0,20.0
2267,0,2267,[302 603 427  50 313],271,5,8109,3.5753968253968256,20.0,20.0
2268,0,2268,[302 603 427  50 313],474,5,8114,3.5760246804759808,20.0,20.0
2269,0,2269,[161  97   1 117 496],339,3,8117,3.575770925110132,0.0,0.0
2270,0,2270,[234 175 200 322 403],313,2,8119,3.575077058564509,0.0,0.0
2271,0,2271,[475  97 546  64   7],455,4,8123,3.5752640845070425,0.0,0.0
2272,0,2272,[135 508 568  96 275],533,4,8127,3.5754509458864936,0.0,0.0
2273,0,2273,[302 603 427  50 313],334,5,8132,3.5760773966578716,20.0,20.0
2274,0,2274,[302 603 427  50 313],537,5,8137,3.576703296703297,20.0,20.0
2275,0,2275,[197   7 237  89 144],343,4,8141,3.57688927943761,0.0,0.0
2276,0,2276,[183 174 294 318 195],452,4,8145,3.5770750988142295,20.0,20.0
2277,0,2277,[282  70 117  15 175],378,4,8149,3.5772607550482878,0.0,0.0
2278,0,2278,[588 191 265  56  28],537,2,8151,3.5765686704695043,0.0,0.0
2279,0,2279,[ 79 282 597 234 191],95,3,8154,3.5763157894736843,0.0,0.0
2280,0,2280,[603 228 161 143 197],648,3,8157,3.57606313020605,20.0,0.0
2281,0,2281,[302 603 427  50 313],669,5,8162,3.576687116564417,20.0,20.0
2282,0,2282,[302 603 427  50 313],13,5,8167,3.577310556285589,20.0,20.0
2283,0,2283,[568 200 515 118 405],643,2,8169,3.5766199649737302,0.0,0.0
2284,0,2284,[678 427 435 204   8],454,3,8172,3.5763676148796497,0.0,0.0
2285,0,2285,[176  96   9  11  22],7,3,8175,3.5761154855643045,0.0,0.0
2286,0,2286,[655  69 496  11 742],749,5,8180,3.5767380848272845,0.0,0.0
2287,0,2287,[121   7 191 195 143],653,3,8183,3.576486013986014,0.0,0.0
2288,0,2288,[186 215  25 196  79],271,4,8187,3.5766710353866316,0.0,0.0
2289,0,2289,[121 195 175 143 183],881,4,8191,3.5768558951965064,0.0,0.0
2290,0,2290,[191 234  56 742 258],59,3,8194,3.5766041030117854,0.0,0.0
2291,0,2291,[302 603 427  50 313],537,5,8199,3.5772251308900525,20.0,20.0
2292,0,2292,[302 603 427  50 313],454,5,8204,3.577845617095508,20.0,20.0
2293,0,2293,[302 603 427  50 313],14,4,8208,3.5780296425457716,20.0,20.0
2294,0,2294,[132 187   9 211 135],788,4,8212,3.5782135076252723,0.0,0.0
2295,0,2295,[405  50  28 179 125],271,3,8215,3.5779616724738674,0.0,20.0
2296,0,2296,[168 275 173 202 357],95,4,8219,3.5781454070526775,20.0,0.0
2297,0,2297,[423 235 302  64 132],537,1,8220,3.577023498694517,0.0,0.0
2298,0,2298,[300 435 118 216 235],313,4,8224,3.577207481513702,0.0,0.0
2299,0,2299,[181 191 182   4 483],234,3,8227,3.5769565217391306,20.0,0.0
2300,0,2300,[302 603 427  50 313],334,5,8232,3.577574967405476,20.0,20.0
2301,0,2301,[215   8 151 322 286],881,2,8234,3.576889661164205,0.0,0.0
2302,0,2302,[276  28 483 568 258],13,4,8238,3.577073382544507,20.0,0.0
2303,0,2303,[302 603 427  50 313],334,5,8243,3.5776909722222223,20.0,20.0
2304,0,2304,[257 121 132 176  79],343,3,8246,3.5774403470715836,0.0,0.0
2305,0,2305,[313  71 135 435 191],85,5,8251,3.5780572419774503,0.0,0.0
2306,0,2306,[118 172 210 222 234],311,4,8255,3.578240138708279,0.0,0.0
2307,0,2307,[302 603 427  50 313],271,5,8260,3.5788561525129983,20.0,20.0
2308,0,2308,[301 508 655 196  82],13,2,8262,3.5781723689909053,0.0,0.0
2309,0,2309,[302 603 427  50 313],271,5,8267,3.5787878787878786,20.0,20.0
2310,0,2310,[121 187 153  50  71],13,5,8272,3.579402855906534,0.0,20.0
2311,0,2311,[496 180 121 216  98],666,3,8275,3.579152249134948,0.0,20.0
2312,0,2312,[302 603 427  50 313],669,5,8280,3.5797665369649807,20.0,20.0
2313,0,2313,[204 215 117 385  97],881,3,8283,3.5795159896283493,0.0,0.0
2314,0,2314,[135 195 216  15 403],308,3,8286,3.5792656587473,0.0,0.0
2315,0,2315,[289 546 275   1 302],271,3,8289,3.5790155440414506,0.0,0.0
2316,0,2316,[423 143  12 197 546],13,3,8292,3.5787656452309022,20.0,0.0
2317,0,2317,[405 125 228  64 176],64,3,8295,3.578515962036238,0.0,0.0
2318,0,2318,[  9  22  25 271 118],92,1,8296,3.577404053471324,0.0,0.0
2319,0,2319,[655 294 111  82 235],479,3,8299,3.577155172413793,0.0,0.0
2320,0,2320,[302 603 427  50 313],474,5,8304,3.5777682033606206,20.0,20.0
2321,0,2321,[ 50 143 210 173 597],59,3,8307,3.5775193798449614,0.0,20.0
2322,0,2322,[318 568 176  12 265],387,2,8309,3.5768402927249245,40.0,0.0
2323,0,2323,[313 216  25 161 100],533,5,8314,3.5774526678141134,0.0,20.0
2324,0,2324,[302 603 427  50 313],454,5,8319,3.5780645161290323,20.0,20.0
2325,0,2325,[222  50 174  95 508],125,4,8323,3.5782459157351676,0.0,40.0
2326,0,2326,[183 175 196 180 127],95,4,8327,3.578427159432746,0.0,20.0
2327,0,2327,[185 275 172 121 196],694,5,8332,3.5790378006872854,0.0,0.0
2328,0,2328,[174  69 228  88 153],850,5,8337,3.5796479175611853,0.0,20.0
2329,0,2329,[302 603 427  50 313],537,5,8342,3.5802575107296137,20.0,20.0
2330,0,2330,[168  82 588 357 546],479,3,8345,3.58000858000858,20.0,0.0
2331,0,2331,[275 195  25 546 187],648,3,8348,3.579759862778731,0.0,0.0
2332,0,2332,[302 603 427  50 313],271,5,8353,3.5803686240891555,20.0,20.0
2333,0,2333,[302 603 427  50 313],334,5,8358,3.5809768637532136,20.0,20.0
2334,0,2334,[100 182 195  82 237],454,4,8362,3.581156316916488,0.0,20.0
2335,0,2335,[302 603 427  50 313],474,5,8367,3.581763698630137,20.0,20.0
2336,0,2336,[211  89 435 588  79],387,3,8370,3.581514762516046,0.0,0.0
2337,0,2337,[302 603 427  50 313],271,5,8375,3.582121471343028,20.0,20.0
2338,0,2338,[ 64 183 127 235 111],669,3,8378,3.5818725951261223,0.0,20.0
2339,0,2339,[180 483 168 181 204],881,4,8382,3.582051282051282,20.0,0.0
2340,0,2340,[237 153  64 185 182],7,5,8387,3.5826569841947884,0.0,0.0
2341,0,2341,[302 603 427  50 313],13,5,8392,3.583262169086251,20.0,20.0
2342,0,2342,[496 228  50 423 427],899,4,8396,3.5834400341442594,0.0,20.0
2343,0,2343,[174 245  64 194 269],378,4,8400,3.583617747440273,0.0,20.0
2344,0,2344,[191 215  22 194 328],144,4,8404,3.5837953091684436,0.0,0.0
2345,0,2345,[302 603 427  50 313],537,5,8409,3.584398976982097,20.0,20.0
2346,0,2346,[  9 179 144 197 174],374,3,8412,3.584149978696208,0.0,20.0
2347,0,2347,[471 276 176 181 174],374,4,8416,3.5843270868824533,0.0,20.0
2348,0,2348,[ 70  79 194 135 322],308,4,8420,3.5845040442741594,0.0,0.0
2349,0,2349,[302 603 427  50 313],271,5,8425,3.5851063829787235,20.0,20.0
2350,0,2350,[322 234 515 100 300],311,4,8429,3.5852828583581453,0.0,20.0
2351,0,2351,[ 69 100 180 357 182],804,5,8434,3.5858843537414966,20.0,20.0
2352,0,2352,[265 174  28   4 471],194,4,8438,3.5860603484912876,0.0,20.0
2353,0,2353,[258  98  79 100 357],454,3,8441,3.5858113848768056,20.0,40.0
2354,0,2354,[302 603 427  50 313],13,5,8446,3.586411889596603,20.0,20.0
2355,0,2355,[302 603 427  50 313],474,5,8451,3.5870118845500847,20.0,20.0
2356,0,2356,[302 603 427  50 313],271,5,8456,3.587611370386084,20.0,20.0
2357,0,2357,[ 70 173 276 546  56],378,4,8460,3.5877862595419847,0.0,0.0
2358,0,2358,[333 210   8 228 546],64,2,8462,3.587113183552353,0.0,0.0
2359,0,2359,[655  12  82 175 588],194,3,8465,3.586864406779661,20.0,0.0
2360,0,2360,[117 118 269 471 235],13,1,8466,3.5857687420584496,0.0,0.0
2361,0,2361,[180 423 546 234 288],346,3,8469,3.5855207451312445,0.0,0.0
2362,0,2362,[515  98 423  25  50],92,3,8472,3.5852729581041047,0.0,40.0
2363,0,2363,[ 82 483 357  28 216],207,4,8476,3.5854483925549916,40.0,0.0
2364,0,2364,[238 471 173 186  88],474,4,8480,3.5856236786469347,0.0,0.0
2365,0,2365,[132 655  97 194  64],788,3,8483,3.585376162299239,0.0,0.0
2366,0,2366,[  8 275 471 403 423],328,2,8485,3.5847063793831855,0.0,0.0
2367,0,2367,[302 603 427  50 313],13,5,8490,3.585304054054054,20.0,20.0
2368,0,2368,[302 603 427  50 313],271,5,8495,3.585901224145209,20.0,20.0
2369,0,2369,[286 265  15  56 181],59,4,8499,3.5860759493670886,0.0,0.0
2370,0,2370,[302 603 427  50 313],13,5,8504,3.5866722901729227,20.0,20.0
2371,0,2371,[302 603 427  50 313],13,5,8509,3.5872681281618886,20.0,20.0
2372,0,2372,[174 385 127 183 187],13,4,8513,3.587442056468605,0.0,40.0
2373,0,2373,[ 50 288 294 172 276],92,3,8516,3.587194608256108,0.0,20.0
2374,0,2374,[302 603 427  50 313],474,5,8521,3.5877894736842104,20.0,20.0
2375,0,2375,[302 603 427  50 313],474,5,8526,3.5883838383838382,20.0,20.0
2376,0,2376,[196 202  95 655 176],92,3,8529,3.5881363062684057,0.0,0.0
2377,0,2377,[143 187 385 181 121],313,4,8533,3.588309503784693,0.0,0.0
2378,0,2378,[135 121 289 195  98],328,3,8536,3.5880622110130305,0.0,20.0
2379,0,2379,[300 655 271 313   8],144,3,8539,3.5878151260504203,0.0,0.0
2380,0,2380,[302 603 427  50 313],334,5,8544,3.588408231835363,20.0,20.0
2381,0,2381,[ 82 328 302 181  22],207,1,8545,3.5873215785054575,0.0,0.0
2382,0,2382,[ 71 258 603 300 153],313,3,8548,3.587075115400755,20.0,0.0
2383,0,2383,[  1 300 144 228 483],788,3,8551,3.5868288590604025,20.0,0.0
2384,0,2384,[176 143 271 168  22],64,4,8555,3.5870020964360587,0.0,0.0
2385,0,2385,[289  71 655  82  96],881,3,8558,3.586756077116513,0.0,0.0
2386,0,2386,[302 603 427  50 313],14,4,8562,3.5869291998324258,20.0,20.0
2387,0,2387,[357 678 181 151  95],881,3,8565,3.586683417085427,20.0,0.0
2388,0,2388,[161 328   1 215 168],533,5,8570,3.5872750104646296,0.0,0.0
2389,0,2389,[ 79 265 175 172 318],738,4,8574,3.5874476987447697,20.0,0.0
2390,0,2390,[385 748 471 357  79],653,4,8578,3.5876202425763277,20.0,0.0
2391,0,2391,[357 202  95 222 215],194,1,8579,3.5865384615384617,20.0,0.0
2392,0,2392,[302 603 427  50 313],669,5,8584,3.587129126619306,20.0,20.0
2393,0,2393,[546 228 161 322 195],13,2,8586,3.5864661654135337,0.0,0.0
2394,0,2394,[ 98  11 186  56   4],537,2,8588,3.5858037578288102,0.0,20.0
2395,0,2395,[289 237  89 271 222],788,3,8591,3.585559265442404,0.0,0.0
2396,0,2396,[302 603 427  50 313],14,4,8595,3.585732165206508,20.0,20.0
2397,0,2397,[288 168 678 153 496],339,3,8598,3.585487906588824,0.0,0.0
2398,0,2398,[ 22  12 385 117 234],308,3,8601,3.5852438516048353,20.0,0.0
2399,0,2399,[286 515 237   8  95],95,3,8604,3.585,0.0,0.0
2400,0,2400,[302 603 427  50 313],271,5,8609,3.5855893377759265,20.0,20.0
2401,0,2401,[302 603 427  50 313],537,5,8614,3.5861781848459615,20.0,20.0
2402,0,2402,[ 69 237 118 546   1],533,3,8617,3.585934248855597,0.0,0.0
2403,0,2403,[144   4 265 222 655],234,1,8618,3.5848585690515806,0.0,0.0
2404,0,2404,[238 216 183 282 294],145,5,8623,3.5854469854469855,0.0,0.0
2405,0,2405,[200 508 211 127 195],653,3,8626,3.5852036575228596,0.0,20.0
2406,0,2406,[215 423 245 173 135],378,3,8629,3.5849605317823015,0.0,0.0
2407,0,2407,[173 186 357 234  25],13,2,8631,3.5843023255813953,20.0,0.0
2408,0,2408,[748 135  69 322  15],488,4,8635,3.584474885844749,0.0,0.0
2409,0,2409,[302 603 427  50 313],537,5,8640,3.5850622406639006,20.0,20.0
2410,0,2410,[121  89 603 180 257],308,4,8644,3.585234342596433,20.0,0.0
2411,0,2411,[302 603 427  50 313],14,4,8648,3.585406301824212,20.0,20.0
2412,0,2412,[222 143   4 194 127],13,3,8651,3.585163696643183,0.0,20.0
2413,0,2413,[211 202   4  89 435],271,4,8655,3.5853355426677713,0.0,0.0
2414,0,2414,[111  12  69 204 322],901,4,8659,3.5855072463768116,20.0,0.0
2415,0,2415,[322 132 173  96  89],234,1,8660,3.584437086092715,0.0,0.0
2416,0,2416,[302 603 427  50 313],271,5,8665,3.5850227554820027,20.0,20.0
2417,0,2417,[403  98 568 742 508],92,3,8668,3.584780810587262,0.0,20.0
2418,0,2418,[546  28 216 173 423],60,5,8673,3.5853658536585367,0.0,0.0
2419,0,2419,[179 273 294  25  88],378,3,8676,3.585123966942149,0.0,0.0
2420,0,2420,[173  71 568 179 194],749,5,8681,3.5857083849648905,0.0,0.0
2421,0,2421,[471 168 196  96 302],537,2,8683,3.5850536746490502,0.0,0.0
2422,0,2422,[483 132 135 597 173],200,5,8688,3.585637639290136,20.0,0.0
2423,0,2423,[  9  11 322 186 172],328,3,8691,3.5853960396039604,0.0,0.0
2424,0,2424,[302 603 427  50 313],271,5,8696,3.5859793814432988,20.0,20.0
2425,0,2425,[655  95 238 257 265],308,4,8700,3.5861500412201153,0.0,0.0
2426,0,2426,[302 603 427  50 313],669,5,8705,3.5867325916769675,20.0,20.0
2427,0,2427,[271  69  97  50  82],263,4,8709,3.5869028006589785,0.0,20.0
2428,0,2428,[603 234  25 153  79],13,3,8712,3.5866611774392756,20.0,0.0
2429,0,2429,[ 11 143 655 276 135],234,1,8713,3.58559670781893,0.0,0.0
2430,0,2430,[678 300 210  22 173],188,4,8717,3.585767174002468,0.0,0.0
2431,0,2431,[100  25 265 588 210],234,1,8718,3.5847039473684212,0.0,20.0
2432,0,2432,[302 603 427  50 313],669,5,8723,3.585285655569256,20.0,20.0
2433,0,2433,[ 98 546 204  71 132],378,4,8727,3.585456039441249,0.0,20.0
2434,0,2434,[ 89 186 483   4 546],7,5,8732,3.586036960985626,20.0,0.0
2435,0,2435,[302 603 427  50 313],537,5,8737,3.5866174055829227,20.0,20.0
2436,0,2436,[265 288 318 515 300],7,4,8741,3.586787033237587,20.0,0.0
2437,0,2437,[423 238 568  96 496],313,5,8746,3.587366694011485,0.0,0.0
2438,0,2438,[118  28   1 276 179],881,5,8751,3.5879458794587946,0.0,0.0
2439,0,2439,[202 168  97 496 427],537,3,8754,3.5877049180327867,0.0,0.0
2440,0,2440,[187 333 172 117 200],387,3,8757,3.5874641540352314,0.0,0.0
2441,0,2441,[195 588  69 302 161],13,4,8761,3.5876330876330877,0.0,0.0
2442,0,2442,[117 127   1 176  50],650,3,8764,3.5873925501432664,0.0,40.0
2443,0,2443,[302 603 427  50 313],454,5,8769,3.5879705400982,20.0,20.0
2444,0,2444,[215 118 187 423 210],7,4,8773,3.5881390593047033,0.0,0.0
2445,0,2445,[302 603 427  50 313],537,5,8778,3.588716271463614,20.0,20.0
2446,0,2446,[  7 186 508  89 183],378,4,8782,3.5888843481814465,0.0,0.0
2447,0,2447,[302 603 427  50 313],14,4,8786,3.5890522875816995,20.0,20.0
2448,0,2448,[302 603 427  50 313],669,5,8791,3.5896284197631685,20.0,20.0
2449,0,2449,[195 202 301  79 302],210,5,8796,3.590204081632653,0.0,0.0
2450,0,2450,[273 168 435 294 471],537,1,8797,3.5891472868217056,0.0,0.0
2451,0,2451,[185 197 234  50  70],311,4,8801,3.58931484502447,0.0,20.0
2452,0,2452,[302 603 427  50 313],474,5,8806,3.5898899306971055,20.0,20.0
2453,0,2453,[302 603 427  50 313],271,5,8811,3.5904645476772616,20.0,20.0
2454,0,2454,[302 603 427  50 313],271,5,8816,3.5910386965376784,20.0,20.0
2455,0,2455,[302 603 427  50 313],454,5,8821,3.5916123778501627,20.0,20.0
2456,0,2456,[302 603 427  50 313],334,5,8826,3.5921855921855923,20.0,20.0
2457,0,2457,[117 174  22 328 515],92,3,8829,3.591944670463792,0.0,20.0
2458,0,2458,[258 176  79 211 186],788,4,8833,3.5921106140707604,0.0,0.0
2459,0,2459,[168 151 323  22 282],804,4,8837,3.5922764227642277,0.0,0.0
2460,0,2460,[423 200   4 125 265],648,2,8839,3.5916294189353923,0.0,0.0
2461,0,2461,[194 496 181 515 603],890,5,8844,3.5922014622258325,20.0,0.0
2462,0,2462,[257 195  88 333 176],533,4,8848,3.5923670320747054,0.0,0.0
2463,0,2463,[302 603 427  50 313],14,4,8852,3.5925324675324677,20.0,20.0
2464,0,2464,[302 603 427  50 313],537,5,8857,3.593103448275862,20.0,20.0
2465,0,2465,[302 603 427  50 313],14,4,8861,3.5932684509326847,20.0,20.0
2466,0,2466,[ 89  28 597 603 161],804,4,8865,3.5934333198216457,20.0,0.0
2467,0,2467,[603 172 435 179 173],524,3,8868,3.593192868719611,20.0,0.0
2468,0,2468,[182 423 313 186 300],85,3,8871,3.5929526123936815,0.0,0.0
2469,0,2469,[127  82 125 135 179],311,4,8875,3.5931174089068825,0.0,20.0
2470,0,2470,[202  22 300 117 144],749,5,8880,3.5936867664912993,0.0,0.0
2471,0,2471,[302 603 427  50 313],271,5,8885,3.594255663430421,20.0,20.0
2472,0,2472,[ 98 282 210 173 286],271,4,8889,3.594419733117671,0.0,20.0
2473,0,2473,[302 603 427  50 313],669,5,8894,3.59498787388844,20.0,20.0
2474,0,2474,[222 427 237 151 423],334,5,8899,3.5955555555555554,0.0,0.0
2475,0,2475,[268 237 235 228 143],92,3,8902,3.5953150242326335,0.0,0.0
2476,0,2476,[742 238 269 118 153],378,4,8906,3.5954784012918855,0.0,0.0
2477,0,2477,[ 25 678 265 483 318],474,4,8910,3.595641646489104,40.0,0.0
2478,0,2478,[175 603 173  25  98],666,4,8914,3.5958047599838645,20.0,20.0
2479,0,2479,[197 153 385 173 222],883,3,8917,3.5955645161290324,0.0,0.0
2480,0,2480,[282  64  96 385 435],455,3,8920,3.595324465941153,0.0,0.0
2481,0,2481,[ 50 313 238  11 234],13,3,8923,3.59508460918614,0.0,20.0
2482,0,2482,[655 483 234 313   8],232,2,8925,3.594442207007652,20.0,0.0
2483,0,2483,[265  98 515 271 172],102,1,8926,3.5933977455716586,0.0,20.0
2484,0,2484,[302 603 427  50 313],454,5,8931,3.5939637826961772,20.0,20.0
2485,0,2485,[174   1 143 405  88],290,4,8935,3.594127111826227,0.0,20.0
2486,0,2486,[238  69  64 357 289],458,2,8937,3.5934861278648973,20.0,0.0
2487,0,2487,[301 276 121 180 546],13,3,8940,3.5932475884244375,0.0,0.0
2488,0,2488,[186  82  15 179 313],92,3,8943,3.5930092406588994,0.0,0.0
2489,0,2489,[ 12 117 191  28 496],454,3,8946,3.5927710843373495,20.0,0.0
2490,0,2490,[168 742 423  97 435],298,4,8950,3.592934564431955,0.0,0.0
2491,0,2491,[302 603 427  50 313],537,5,8955,3.5934991974317816,20.0,20.0
2492,0,2492,[182 187  70 357 471],13,2,8957,3.592860008022463,20.0,0.0
2493,0,2493,[ 70   4 245 235 301],83,1,8958,3.5918203688853247,0.0,0.0
2494,0,2494,[194 288 168 603 273],897,3,8961,3.5915831663326654,20.0,0.0
2495,0,2495,[ 98 186 180 271 174],263,4,8965,3.5917467948717947,0.0,40.0
2496,0,2496,[179 742 197 174 678],387,2,8967,3.591109331197437,0.0,20.0
2497,0,2497,[  8 271  12 132 194],328,2,8969,3.590472377902322,20.0,0.0
2498,0,2498,[ 15 405  88 288 603],474,4,8973,3.590636254501801,20.0,0.0
2499,0,2499,[132  70  11 194 265],653,1,8974,3.5896,0.0,0.0
2500,0,2500,[385  97  50 286  89],653,4,8978,3.589764094362255,0.0,20.0
2501,0,2501,[216 195 322  79 215],313,4,8982,3.5899280575539567,0.0,0.0
2502,0,2502,[313 405 215 176 237],92,4,8986,3.5900918897323213,0.0,0.0
2503,0,2503,[302 603 427  50 313],669,5,8991,3.5906549520766773,20.0,20.0
2504,0,2504,[302 603 427  50 313],454,5,8996,3.5912175648702593,20.0,20.0
2505,0,2505,[ 70 435 211 405 172],64,4,9000,3.5913806863527533,0.0,0.0
2506,0,2506,[269 161 403  56 117],334,2,9002,3.5907459114479456,0.0,0.0
2507,0,2507,[222 273 196   8  28],378,4,9006,3.590909090909091,0.0,0.0
2508,0,2508,[228 258 100 153 183],738,4,9010,3.5910721402949384,0.0,20.0
2509,0,2509,[269 211  15 258  79],650,2,9012,3.590438247011952,0.0,0.0
2510,0,2510,[302 603 427  50 313],537,5,9017,3.59099960175229,20.0,20.0
2511,0,2511,[302 603 427  50 313],537,5,9022,3.59156050955414,20.0,20.0
2512,0,2512,[678 258 211 515 237],13,3,9025,3.591325109430959,0.0,0.0
2513,0,2513,[273 144 678  95 403],387,1,9026,3.590294351630867,0.0,0.0
2514,0,2514,[ 79 234  56 237 271],548,4,9030,3.5904572564612325,0.0,0.0
2515,0,2515,[179 151 471 237 132],234,1,9031,3.5894276629570747,0.0,0.0
2516,0,2516,[ 69  70 423 180 483],210,5,9036,3.5899880810488676,20.0,0.0
2517,0,2517,[302 603 427  50 313],334,5,9041,3.59054805401112,20.0,20.0
2518,0,2518,[ 71 403 179 118 238],749,3,9044,3.5903136165144898,0.0,0.0
2519,0,2519,[302 603 427  50 313],454,5,9049,3.590873015873016,20.0,20.0
2520,0,2520,[257 127 435 125 655],804,3,9052,3.5906386354621183,0.0,20.0
2521,0,2521,[748  89 742 228   1],200,4,9056,3.590800951625694,0.0,0.0
2522,0,2522,[ 50 216 742 515 268],334,3,9059,3.590566785572731,0.0,20.0
2523,0,2523,[282 403 515 357 508],643,3,9062,3.5903328050713155,20.0,0.0
2524,0,2524,[302 603 427  50 313],14,4,9066,3.5904950495049506,20.0,20.0
2525,0,2525,[294 318 301  97 185],328,2,9068,3.589865399841647,20.0,0.0
2526,0,2526,[100 200   4  71 588],59,3,9071,3.589631974673526,0.0,20.0
2527,0,2527,[ 15 496 153 143 179],60,3,9074,3.589398734177215,0.0,0.0
2528,0,2528,[302 603 427  50 313],474,5,9079,3.589956504547252,20.0,20.0
2529,0,2529,[  9 286 191 385 100],10,5,9084,3.590513833992095,0.0,20.0
2530,0,2530,[202 121 191 289 173],13,2,9086,3.5898854207822994,0.0,0.0
2531,0,2531,[210 195 742 151 357],95,5,9091,3.5904423380726698,20.0,0.0
2532,0,2532,[  4 588  88 385 423],13,4,9095,3.5906040268456376,0.0,0.0
2533,0,2533,[135 194  79 215 143],385,0,9095,3.589187056037885,0.0,0.0
2534,0,2534,[161 173 111 385 300],454,2,9097,3.588560157790927,0.0,0.0
2535,0,2535,[302 603 427  50 313],669,5,9102,3.5891167192429023,20.0,20.0
2536,0,2536,[302 603 427  50 313],474,5,9107,3.5896728419392985,20.0,20.0
2537,0,2537,[175 515 153 276 328],90,3,9110,3.5894405043341213,0.0,0.0
2538,0,2538,[302 603 427  50 313],669,5,9115,3.5899960614415125,20.0,20.0
2539,0,2539,[135 265 322 427 597],533,2,9117,3.5893700787401577,0.0,0.0
2540,0,2540,[ 89 289 238 196 204],881,2,9119,3.588744588744589,0.0,0.0
2541,0,2541,[ 64 546 143 172  12],64,4,9123,3.588906372934697,20.0,0.0
2542,0,2542,[257 135  64  25  70],308,5,9128,3.589461266220999,0.0,0.0
2543,0,2543,[302 603 427  50 313],454,5,9133,3.59001572327044,20.0,20.0
2544,0,2544,[ 89  88 357 496 568],311,5,9138,3.5905697445972495,20.0,0.0
2545,0,2545,[405 186  70 294 435],102,1,9139,3.58955223880597,0.0,0.0
2546,0,2546,[302 603 427  50 313],537,5,9144,3.590106007067138,20.0,20.0
2547,0,2547,[111 515 196   1 471],95,5,9149,3.590659340659341,0.0,0.0
2548,0,2548,[117 301 187 269 202],102,1,9150,3.589642997253825,0.0,0.0
2549,0,2549,[302 603 427  50 313],537,5,9155,3.5901960784313727,20.0,20.0
2550,0,2550,[153 185 222 568 603],648,5,9160,3.590748725989808,20.0,0.0
2551,0,2551,[483  89 288   9 403],13,2,9162,3.5901253918495297,20.0,0.0
2552,0,2552,[  4 172 143 385 235],64,4,9166,3.590285938112025,0.0,0.0
2553,0,2553,[143 179  89 202 655],95,3,9169,3.5900548159749412,0.0,0.0
2554,0,2554,[172  56  82 427 176],60,4,9173,3.590215264187867,0.0,0.0
2555,0,2555,[496 153  15 742  95],313,1,9174,3.5892018779342725,0.0,0.0
2556,0,2556,[265 121 118   7 202],804,5,9179,3.589753617520532,0.0,0.0
2557,0,2557,[ 22  12 405 174 196],774,0,9179,3.5883502736512902,20.0,20.0
2558,0,2558,[183 211 173  22  50],650,4,9183,3.5885111371629543,0.0,20.0
2559,0,2559,[ 64  96 318 322 196],537,1,9184,3.5875,20.0,0.0
2560,0,2560,[153 111 183 179 655],579,3,9187,3.5872705974228816,0.0,0.0
2561,0,2561,[ 11  22 200   9  89],308,5,9192,3.5878220140515222,0.0,0.0
2562,0,2562,[302 603 427  50 313],334,5,9197,3.5883730003901677,20.0,20.0
2563,0,2563,[302 603 427  50 313],334,5,9202,3.5889235569422775,20.0,20.0
2564,0,2564,[174  28 111 496  70],82,4,9206,3.589083820662768,0.0,20.0
2565,0,2565,[302 603 427  50 313],669,5,9211,3.5896336710833983,20.0,20.0
2566,0,2566,[302 603 427  50 313],537,5,9216,3.5901830931047916,20.0,20.0
2567,0,2567,[302 603 427  50 313],334,5,9221,3.590732087227414,20.0,20.0
2568,0,2568,[216 182 276 161 191],194,2,9223,3.5901128843908134,0.0,0.0
2569,0,2569,[496 546  97 151 258],479,2,9225,3.5894941634241246,0.0,0.0
2570,0,2570,[216 121 143 385  89],892,3,9228,3.58926487747958,0.0,0.0
2571,0,2571,[191 655 322 471  12],13,2,9230,3.588646967340591,20.0,0.0
2572,0,2572,[  8 496 185  89 286],479,3,9233,3.5884181888845705,0.0,0.0
2573,0,2573,[322 235 405 132 125],788,3,9236,3.588189588189588,0.0,0.0
2574,0,2574,[568 323 175 194  15],537,1,9237,3.5871844660194174,0.0,0.0
2575,0,2575,[289 271 196 118 275],13,2,9239,3.5865683229813663,0.0,0.0
2576,0,2576,[515 127 403  28 282],311,5,9244,3.587116802483508,0.0,20.0
2577,0,2577,[187  95 144 405 172],64,3,9247,3.58688906128782,0.0,0.0
2578,0,2578,[ 97 245 313 202  11],378,2,9249,3.586273749515316,0.0,0.0
2579,0,2579,[176  22 276 235  88],200,4,9253,3.586434108527132,0.0,0.0
2580,0,2580,[302 603 427  50 313],669,5,9258,3.5869817900038745,20.0,20.0
2581,0,2581,[216 194 471 174   4],234,2,9260,3.5863671572424476,0.0,20.0
2582,0,2582,[ 15   4 197 471 294],533,4,9264,3.586527293844367,0.0,0.0
2583,0,2583,[302 603 427  50 313],334,5,9269,3.5870743034055725,20.0,20.0
2584,0,2584,[202 289 143 483 173],454,1,9270,3.586073500967118,20.0,0.0
2585,0,2585,[ 97 181 151 288 269],339,4,9274,3.5862335653518946,0.0,0.0
2586,0,2586,[210 183  96 228 144],479,5,9279,3.5867800541167374,0.0,0.0
2587,0,2587,[302 603 427  50 313],454,5,9284,3.587326120556414,20.0,20.0
2588,0,2588,[173 200 435 546 168],899,2,9286,3.586713016608729,0.0,0.0
2589,0,2589,[294 273 194 234 200],774,0,9286,3.5853281853281853,0.0,0.0
2590,0,2590,[655  89   7  56 265],92,5,9291,3.5858741798533385,0.0,0.0
2591,0,2591,[302 603 427  50 313],334,5,9296,3.5864197530864197,20.0,20.0
2592,0,2592,[313 117 271  50 174],119,5,9301,3.5869649055148476,0.0,40.0
2593,0,2593,[302 603 427  50 313],14,4,9305,3.5871241326137238,20.0,20.0
2594,0,2594,[423 161 117 174 127],897,4,9309,3.5872832369942196,0.0,40.0
2595,0,2595,[302 603 427  50 313],13,5,9314,3.5878274268104775,20.0,20.0
2596,0,2596,[ 69 328 318 174 210],653,5,9319,3.588371197535618,20.0,20.0
2597,0,2597,[328 238 118  79 196],271,3,9322,3.588144726712856,0.0,0.0
2598,0,2598,[197  15 276  97 151],474,4,9326,3.5883031935359755,0.0,0.0
2599,0,2599,[197   4 180 204 127],339,4,9330,3.5884615384615386,0.0,20.0
2600,0,2600,[204 172   1 258  95],13,4,9334,3.588619761630142,0.0,0.0
2601,0,2601,[302 603 427  50 313],669,5,9339,3.589162182936203,20.0,20.0
2602,0,2602,[515   7  71 173 318],64,4,9343,3.5893200153668845,20.0,0.0
2603,0,2603,[235  25 265  69 176],343,3,9346,3.589093701996928,0.0,0.0
2604,0,2604,[187 333 238  69 269],605,4,9350,3.5892514395393476,0.0,0.0
2605,0,2605,[175 176  12 588  95],664,4,9354,3.5894090560245586,20.0,0.0
2606,0,2606,[302 603 427  50 313],334,5,9359,3.5899501342539315,20.0,20.0
2607,0,2607,[496 182  56   1 568],749,3,9362,3.589723926380368,0.0,0.0
2608,0,2608,[302 603 427  50 313],537,5,9367,3.5902644691452665,20.0,20.0
2609,0,2609,[302 603 427  50 313],474,5,9372,3.5908045977011493,20.0,20.0
2610,0,2610,[328  28  82 210  50],533,5,9377,3.5913443125239373,0.0,20.0
2611,0,2611,[302 603 427  50 313],669,5,9382,3.591883614088821,20.0,20.0
2612,0,2612,[405  97  70 204 385],455,2,9384,3.5912743972445464,0.0,0.0
2613,0,2613,[302 603 427  50 313],14,4,9388,3.5914307574598316,20.0,20.0
2614,0,2614,[210 282 245 127 742],533,4,9392,3.591586998087954,0.0,20.0
2615,0,2615,[238   7 202 176 181],738,5,9397,3.592125382262997,0.0,0.0
2616,0,2616,[385  69 742 210 275],524,1,9398,3.5911348872755062,0.0,0.0
2617,0,2617,[302 603 427  50 313],537,5,9403,3.5916730328495032,20.0,20.0
2618,0,2618,[ 79 181 265 483 204],899,4,9407,3.591828942344406,20.0,0.0
2619,0,2619,[302 603 427  50 313],669,5,9412,3.5923664122137406,20.0,20.0
2620,0,2620,[174 282 215   1 496],406,3,9415,3.5921404044257916,0.0,20.0
2621,0,2621,[302 603 427  50 313],334,5,9420,3.5926773455377576,20.0,20.0
2622,0,2622,[ 28 117 235 258 268],537,2,9422,3.592070148684712,0.0,0.0
2623,0,2623,[302 603 427  50 313],14,4,9426,3.5922256097560976,20.0,20.0
2624,0,2624,[153 405 143  69 125],378,2,9428,3.5916190476190475,0.0,0.0
2625,0,2625,[121 435  96  71  11],454,2,9430,3.5910129474485912,0.0,0.0
2626,0,2626,[302 603 427  50 313],454,5,9435,3.591549295774648,20.0,20.0
2627,0,2627,[508 265  11 245 204],334,2,9437,3.590943683409437,0.0,0.0
2628,0,2628,[ 25 174   7  98 182],458,2,9439,3.590338531761126,0.0,40.0
2629,0,2629,[ 82 174 173 234 405],804,5,9444,3.590874524714829,0.0,20.0
2630,0,2630,[121 151  96 568 603],59,5,9449,3.5914101102242495,20.0,0.0
2631,0,2631,[313 186  97 151  79],738,4,9453,3.591565349544073,0.0,0.0
2632,0,2632,[22 11 69 88 56],543,3,9456,3.591340676034941,0.0,0.0
2633,0,2633,[176  15 153  56  64],313,2,9458,3.5907365223993923,0.0,0.0
2634,0,2634,[185 483 175 237 179],524,3,9461,3.5905123339658442,20.0,0.0
2635,0,2635,[176  64 475  22 748],13,3,9464,3.590288315629742,0.0,0.0
2636,0,2636,[ 56 132 265 195 222],64,5,9469,3.5908229048160787,0.0,0.0
2637,0,2637,[151 678   7 196  95],308,3,9472,3.590598938589841,0.0,0.0
2638,0,2638,[302 603 427  50 313],14,4,9476,3.590754073512694,20.0,20.0
2639,0,2639,[333  71 200 748  56],13,3,9479,3.590530303030303,0.0,0.0
2640,0,2640,[385 265 181 286 288],7,4,9483,3.5906853464596744,0.0,0.0
2641,0,2641,[302 603 427  50 313],669,5,9488,3.591218773656321,20.0,20.0
2642,0,2642,[228 202 187 168 173],234,1,9489,3.5902383654937573,0.0,0.0
2643,0,2643,[ 56 286 228 258 269],339,4,9493,3.5903933434190622,0.0,0.0
2644,0,2644,[302 603 427  50 313],13,5,9498,3.5909262759924387,20.0,20.0
2645,0,2645,[302 603 427  50 313],14,4,9502,3.5910808767951625,20.0,20.0
2646,0,2646,[161 655 294 180 216],234,0,9502,3.589724216093691,0.0,0.0
2647,0,2647,[ 71 286  89   7 153],406,2,9504,3.5891238670694863,0.0,0.0
2648,0,2648,[200 180 211 182 176],210,5,9509,3.589656474141185,0.0,0.0
2649,0,2649,[302 603 427  50 313],669,5,9514,3.590188679245283,20.0,20.0
2650,0,2650,[302 603 427  50 313],334,5,9519,3.5907204828366655,20.0,20.0
2651,0,2651,[143  64 403 173 483],749,5,9524,3.5912518853695325,20.0,0.0
2652,0,2652,[ 22 328 100  50   4],533,4,9528,3.5914059555220503,0.0,40.0
2653,0,2653,[318 111 204 748 427],454,4,9532,3.5915599095704596,20.0,0.0
2654,0,2654,[ 95  97 185   7 265],95,2,9534,3.590960451977401,0.0,0.0
2655,0,2655,[323 153 385 508 403],378,4,9538,3.5911144578313254,0.0,0.0
2656,0,2656,[161   1 125 238 322],804,5,9543,3.591644712081295,0.0,0.0
2657,0,2657,[286 176 132  28 357],339,5,9548,3.5921745673438674,20.0,0.0
2658,0,2658,[423  11  64 197 172],474,5,9553,3.592704024069199,0.0,0.0
2659,0,2659,[423 175 603 118 196],308,3,9556,3.5924812030075186,20.0,0.0
2660,0,2660,[117   4 289 180  89],474,4,9560,3.5926343479894776,0.0,0.0
2661,0,2661,[185 194 153 121 174],804,5,9565,3.593163035311796,0.0,20.0
2662,0,2662,[302 603 427  50 313],454,5,9570,3.5936913255726624,20.0,20.0
2663,0,2663,[ 69  28 172   8 197],234,4,9574,3.593843843843844,0.0,0.0
2664,0,2664,[ 64 215 222 187 180],194,2,9576,3.593245778611632,0.0,0.0
2665,0,2665,[603 183  98 153 568],738,4,9580,3.593398349587397,20.0,20.0
2666,0,2666,[196 496  70 210  50],334,2,9582,3.5928008998875143,0.0,20.0
2667,0,2667,[ 97 196 471 222 403],374,3,9585,3.592578710644678,0.0,0.0
2668,0,2668,[301 235  97 179  82],524,4,9589,3.5927313600599478,0.0,0.0
2669,0,2669,[181  88 196  70 179],537,2,9591,3.5921348314606742,0.0,0.0
2670,0,2670,[174  89 172 357 318],406,5,9596,3.592661924372894,40.0,20.0
2671,0,2671,[ 28 496 182 186 269],537,3,9599,3.592440119760479,0.0,0.0
2672,0,2672,[185  79 496 135 515],271,4,9603,3.5925925925925926,0.0,0.0
2673,0,2673,[ 70  82  98 186  71],7,3,9606,3.5923709798055348,0.0,20.0
2674,0,2674,[302 603 427  50 313],669,5,9611,3.5928971962616822,20.0,20.0
2675,0,2675,[302 603 427  50 313],14,4,9615,3.5930493273542603,20.0,20.0
2676,0,2676,[ 64 180   8 135  69],892,5,9620,3.593574897273067,0.0,0.0
2677,0,2677,[173 282 182 175 121],666,3,9623,3.5933532486930546,0.0,0.0
2678,0,2678,[302 603 427  50 313],14,4,9627,3.593505039193729,20.0,20.0
2679,0,2679,[200 318   1 655 423],13,2,9629,3.592910447761194,20.0,0.0
2680,0,2680,[151 174  98 118 496],524,2,9631,3.5923162998881013,0.0,40.0
2681,0,2681,[302 603 427  50 313],669,5,9636,3.592841163310962,20.0,20.0
2682,0,2682,[168  15 228 496  98],215,4,9640,3.5929929183749536,0.0,20.0
2683,0,2683,[678 182  11 125  96],749,3,9643,3.5927719821162443,0.0,0.0
2684,0,2684,[508 300  28 245 179],334,1,9644,3.591806331471136,0.0,0.0
2685,0,2685,[405  79 275 302 185],271,3,9647,3.5915860014892034,0.0,0.0
2686,0,2686,[183  79 423  69 202],295,4,9651,3.5917379977670265,0.0,0.0
2687,0,2687,[202 216 182 742 294],749,3,9654,3.591517857142857,0.0,0.0
2688,0,2688,[302 603 427  50 313],474,5,9659,3.592041651171439,20.0,20.0
2689,0,2689,[302 603 427  50 313],14,4,9663,3.592193308550186,20.0,20.0
2690,0,2690,[215  12  22  97 483],234,2,9665,3.591601635079896,40.0,0.0
2691,0,2691,[ 64 568  22 194 276],119,4,9669,3.5917533432392275,0.0,0.0
2692,0,2692,[471 111 176  56 301],145,4,9673,3.591904938730041,0.0,0.0
2693,0,2693,[238 176 496 588 173],378,3,9676,3.5916852264291017,0.0,0.0
2694,0,2694,[176 117 568 186 475],339,3,9679,3.5914656771799627,0.0,0.0
2695,0,2695,[ 28  98 173 294  95],200,5,9684,3.591988130563798,0.0,20.0
2696,0,2696,[265 289  89  28 318],194,3,9687,3.591768631813126,20.0,0.0
2697,0,2697,[385   9 237 197 200],455,3,9690,3.591549295774648,0.0,0.0
2698,0,2698,[135 151 357 204  56],234,2,9692,3.5909596146721006,20.0,0.0
2699,0,2699,[117  12  96  88 186],374,4,9696,3.591111111111111,20.0,0.0
2700,0,2700,[471  50 588 515 215],311,5,9701,3.59163272861903,0.0,20.0
2701,0,2701,[300  22 385 588 275],13,2,9703,3.5910436713545524,0.0,0.0
2702,0,2702,[ 64 357  15 151 216],406,3,9706,3.5908250092489826,20.0,0.0
2703,0,2703,[333   4  69 357   1],533,3,9709,3.5906065088757395,20.0,0.0
2704,0,2704,[ 79 186 300  98 403],788,3,9712,3.5903881700554527,0.0,20.0
2705,0,2705,[302 603 427  50 313],334,5,9717,3.590909090909091,20.0,20.0
2706,0,2706,[135 176 235 173 168],59,4,9721,3.5910602142593278,0.0,0.0
2707,0,2707,[302 603 427  50 313],669,5,9726,3.5915805022156575,20.0,20.0
2708,0,2708,[328 196  28 234 111],533,4,9730,3.591731266149871,0.0,0.0
2709,0,2709,[187 328 313 238 282],271,3,9733,3.5915129151291514,0.0,0.0
2710,0,2710,[282 185 191 204 183],406,4,9737,3.5916635927701956,0.0,0.0
2711,0,2711,[302 603 427  50 313],271,5,9742,3.592182890855457,20.0,20.0
2712,0,2712,[144  50 288 183 435],833,2,9744,3.591596019166974,0.0,20.0
2713,0,2713,[423 100 301 144 191],666,3,9747,3.5913780397936623,0.0,20.0
2714,0,2714,[196 483 405  70 385],13,2,9749,3.590791896869245,20.0,0.0
2715,0,2715,[168 216  82 197 181],326,1,9750,3.589837997054492,0.0,0.0
2716,0,2716,[216 210   7 121 195],643,5,9755,3.590357011409643,0.0,0.0
2717,0,2717,[222  96 180 204 182],533,3,9758,3.590139808682855,0.0,0.0
2718,0,2718,[127 271 200 568 161],650,1,9759,3.5891872011769035,0.0,20.0
2719,0,2719,[ 69 176 294  11 118],666,2,9761,3.5886029411764704,0.0,0.0
2720,0,2720,[427 168   8  89   9],60,4,9765,3.5887541345093714,0.0,0.0
2721,0,2721,[286 294 176 132 200],378,3,9768,3.588537839823659,0.0,0.0
2722,0,2722,[302 603 427  50 313],271,5,9773,3.5890561880279104,20.0,20.0
2723,0,2723,[302 603 427  50 313],669,5,9778,3.589574155653451,20.0,20.0
2724,0,2724,[ 25 294 435 475 603],452,1,9779,3.588623853211009,20.0,0.0
2725,0,2725,[302 603 427  50 313],454,5,9784,3.5891415994130593,20.0,20.0
2726,0,2726,[175 144 143 182 215],653,0,9784,3.587825449211588,0.0,0.0
2727,0,2727,[ 88 175  64  11 215],406,3,9787,3.5876099706744866,0.0,0.0
2728,0,2728,[302 603 427  50 313],537,5,9792,3.588127519237816,20.0,20.0
2729,0,2729,[288 216 179 183 135],452,2,9794,3.5875457875457877,0.0,0.0
2730,0,2730,[181 222 196  97 183],537,0,9794,3.586232149395826,0.0,0.0
2731,0,2731,[302 603 427  50 313],14,4,9798,3.5863836017569546,20.0,20.0
2732,0,2732,[ 98 111 423  70 127],13,4,9802,3.5865349432857667,0.0,40.0
2733,0,2733,[302 603 427  50 313],537,5,9807,3.5870519385515727,20.0,20.0
2734,0,2734,[ 71  79 603 742 282],298,4,9811,3.587202925045704,20.0,0.0
2735,0,2735,[ 89 196  70 357 286],234,1,9812,3.5862573099415203,20.0,0.0
2736,0,2736,[111 496 117 655 276],474,5,9817,3.5867738399707707,0.0,0.0
2737,0,2737,[180 275 237 318   7],308,4,9821,3.586924762600438,20.0,0.0
2738,0,2738,[183 181   4 515 288],882,4,9825,3.587075575027382,0.0,0.0
2739,0,2739,[742 237 195 117  98],788,3,9828,3.586861313868613,0.0,20.0
2740,0,2740,[302 603 427  50 313],13,5,9833,3.5873768697555635,20.0,20.0
2741,0,2741,[302 603 427  50 313],669,5,9838,3.587892049598833,20.0,20.0
2742,0,2742,[288 174  89  12 222],64,4,9842,3.58804228946409,20.0,20.0
2743,0,2743,[302 603 427  50 313],474,5,9847,3.5885568513119535,20.0,20.0
2744,0,2744,[302 603 427  50 313],537,5,9852,3.589071038251366,20.0,20.0
2745,0,2745,[111 181 742 204  69],59,4,9856,3.5892206846321923,0.0,0.0
2746,0,2746,[ 50 127 172 143 300],234,2,9858,3.5886421550782672,0.0,40.0
2747,0,2747,[258 405 118  79 546],328,3,9861,3.5884279475982535,0.0,0.0
2748,0,2748,[ 25 597 483 195  56],804,3,9864,3.588213895962168,20.0,0.0
2749,0,2749,[496 173 127 135 100],271,5,9869,3.5887272727272728,0.0,40.0
2750,0,2750,[202 302 588 197 275],378,3,9872,3.588513267902581,0.0,0.0
2751,0,2751,[196 588 200 515 742],95,3,9875,3.588299418604651,0.0,0.0
2752,0,2752,[ 12 187  98  22 151],387,4,9879,3.58844896476571,20.0,20.0
2753,0,2753,[179 597 568 403 135],650,1,9880,3.587509077705156,0.0,0.0
2754,0,2754,[302 603 427  50 313],474,5,9885,3.588021778584392,20.0,20.0
2755,0,2755,[118 301 269 196  98],378,4,9889,3.5881712626995648,0.0,20.0
2756,0,2756,[172 546 121 135 117],13,3,9892,3.5879579252811027,0.0,0.0
2757,0,2757,[ 88 515 210 100  71],279,2,9894,3.587382160986222,0.0,20.0
2758,0,2758,[210   8 282 174 211],207,3,9897,3.5871692642261688,0.0,20.0
2759,0,2759,[ 82   4 678 200 161],339,3,9900,3.5869565217391304,0.0,0.0
2760,0,2760,[655   1  88 357 568],643,4,9904,3.5871061209706627,20.0,0.0
2761,0,2761,[187 211 200  50  12],234,3,9907,3.5868935553946417,20.0,20.0
2762,0,2762,[427 173 195 423 183],59,5,9912,3.587404994571118,0.0,0.0
2763,0,2763,[204 180 234 515 121],7,4,9916,3.5875542691751083,0.0,0.0
2764,0,2764,[195 300  97 211 175],506,4,9920,3.5877034358047015,0.0,0.0
2765,0,2765,[143 237 313 403 176],234,1,9921,3.5867678958785247,0.0,0.0
2766,0,2766,[302 603 427  50 313],14,4,9925,3.586917238886881,20.0,20.0
2767,0,2767,[143  12 173  79   9],194,3,9928,3.586705202312139,20.0,0.0
2768,0,2768,[ 71 181 182 143 427],474,5,9933,3.5872156013001084,0.0,0.0
2769,0,2769,[210 180 483 191 187],409,4,9937,3.587364620938628,20.0,0.0
2770,0,2770,[196 195 175  70 323],378,3,9940,3.5871526524720316,0.0,0.0
2771,0,2771,[151 268 515 197 143],6,2,9942,3.5865800865800868,0.0,0.0
2772,0,2772,[ 69 168 357 183   1],643,4,9946,3.586729174179589,20.0,0.0
2773,0,2773,[423 176 515 168 211],774,1,9947,3.5857966834895456,0.0,0.0
2774,0,2774,[483 238 161  70 286],85,4,9951,3.5859459459459457,20.0,0.0
2775,0,2775,[302 603 427  50 313],334,5,9956,3.586455331412104,20.0,20.0
2776,0,2776,[196 258 568 118 288],533,4,9960,3.586604249189773,0.0,0.0
2777,0,2777,[385   8 435  96 423],892,4,9964,3.5867530597552197,0.0,0.0
2778,0,2778,[ 79 748 294   9   8],881,2,9966,3.5861820798848507,0.0,0.0
2779,0,2779,[196   9  25 318 211],85,4,9970,3.5863309352517985,20.0,0.0
2780,0,2780,[173  96 427 186 194],899,4,9974,3.5864796835670623,0.0,0.0
2781,0,2781,[385 186 144 289   8],328,3,9977,3.5862688713156,0.0,0.0
2782,0,2782,[168  89  98 405 238],271,2,9979,3.5856988860941432,0.0,20.0
2783,0,2783,[302 603 427  50 313],271,5,9984,3.586206896551724,20.0,20.0
2784,0,2784,[302 603 427  50 313],334,5,9989,3.5867145421903053,20.0,20.0
2785,0,2785,[153 603 216  28 228],334,3,9992,3.5865039483129935,20.0,0.0
2786,0,2786,[168 655 288 423  97],387,1,9993,3.5855758880516686,0.0,0.0
2787,0,2787,[187  70 174  64 125],271,4,9997,3.5857245337159256,0.0,20.0
2788,0,2788,[194 568 181  25 183],804,5,10002,3.5862316242380783,0.0,0.0
2789,0,2789,[ 12 186 153 313  89],328,4,10006,3.586379928315412,20.0,0.0
2790,0,2790,[ 64 186 276 125 100],207,3,10009,3.5861698316015764,0.0,20.0
2791,0,2791,[132 385 151 210 196],804,4,10013,3.5863180515759314,0.0,0.0
2792,0,2792,[238 135  64   7 182],59,5,10018,3.586824203365557,0.0,0.0
2793,0,2793,[302 603 427  50 313],669,5,10023,3.587329992841804,20.0,20.0
2794,0,2794,[ 69  89  97 273 186],7,4,10027,3.5874776386404292,0.0,0.0
2795,0,2795,[302 603 427  50 313],474,5,10032,3.587982832618026,20.0,20.0
2796,0,2796,[  1 318  11 268  70],13,1,10033,3.5870575616732214,20.0,0.0
2797,0,2797,[ 12 153 202 117 161],643,2,10035,3.5864903502501786,20.0,0.0
2798,0,2798,[302 603 427  50 313],454,5,10040,3.5869953554841016,20.0,20.0
2799,0,2799,[143 286  69 173  98],200,5,10045,3.5875,0.0,20.0
2800,0,2800,[276 289 286 427 496],409,4,10049,3.58764726883256,0.0,0.0
2801,0,2801,[ 56  71  95 603  69],804,3,10052,3.5874375446109923,20.0,0.0
2802,0,2802,[153 288   9 603 191],334,4,10056,3.587584730645737,20.0,0.0
2803,0,2803,[176 200 211  98 196],379,5,10061,3.5880884450784594,0.0,20.0
2804,0,2804,[186 237 294 181 144],92,4,10065,3.588235294117647,0.0,0.0
2805,0,2805,[202  82 183 288 191],882,4,10069,3.588382038488952,0.0,0.0
2806,0,2806,[603 269 273 161 100],524,3,10072,3.588172426077663,20.0,20.0
2807,0,2807,[216 183 118 161   7],308,2,10074,3.5876068376068377,0.0,0.0
2808,0,2808,[215 172 181 180 273],92,5,10079,3.5881096475614096,0.0,0.0
2809,0,2809,[216 273  69 202  97],374,3,10082,3.587900355871886,0.0,0.0
2810,0,2810,[ 82 121 161  98 216],374,5,10087,3.5884027036641766,0.0,20.0
2811,0,2811,[ 79   4 301 286 238],13,1,10088,3.5874822190611666,0.0,0.0
2812,0,2812,[568 181 161 127 435],749,4,10092,3.5876288659793816,0.0,20.0
2813,0,2813,[183  25 173 182 237],95,2,10094,3.5870646766169156,0.0,0.0
2814,0,2814,[357 182 257 187 405],653,2,10096,3.5865008880994673,20.0,0.0
2815,0,2815,[  9 742 195 144 172],328,4,10100,3.586647727272727,0.0,0.0
2816,0,2816,[302 603 427  50 313],271,5,10105,3.587149449769258,20.0,20.0
2817,0,2817,[302 603 427  50 313],454,5,10110,3.5876508161816894,20.0,20.0
2818,0,2818,[ 12 179 322  25  89],374,3,10113,3.5874423554451935,20.0,0.0
2819,0,2819,[748 742  98 181 195],648,4,10117,3.5875886524822693,0.0,20.0
2820,0,2820,[508 282 322 427  28],474,4,10121,3.587734845799362,0.0,0.0
2821,0,2821,[269  97 508 328 161],13,2,10123,3.587172218284904,0.0,0.0
2822,0,2822,[302 603 427  50 313],474,5,10128,3.587672688629118,20.0,20.0
2823,0,2823,[322 216 271  82 179],749,5,10133,3.588172804532578,0.0,0.0
2824,0,2824,[172  15 161 197 194],194,4,10137,3.5883185840707963,0.0,0.0
2825,0,2825,[234 121 238 216 423],311,5,10142,3.588818117480538,0.0,0.0
2826,0,2826,[186 161 196  96 318],13,4,10146,3.588963565617262,20.0,0.0
2827,0,2827,[475 655 182 197 174],833,1,10147,3.588048090523338,0.0,20.0
2828,0,2828,[546 204 508 187 405],213,4,10151,3.5881937080240367,0.0,0.0
2829,0,2829,[302 603 427  50 313],334,5,10156,3.5886925795053,20.0,20.0
2830,0,2830,[302 603 427  50 313],271,5,10161,3.5891910985517486,20.0,20.0
2831,0,2831,[  8 318  15 588 228],892,4,10165,3.5893361581920904,20.0,0.0
2832,0,2832,[185  79 144 568 471],95,4,10169,3.589481115425344,0.0,0.0
2833,0,2833,[144  69 204  50  28],378,4,10173,3.5896259703599154,0.0,20.0
2834,0,2834,[258 427 121  89 200],339,3,10176,3.5894179894179894,0.0,0.0
2835,0,2835,[ 22 273 282 301 597],378,3,10179,3.5892101551480957,0.0,0.0
2836,0,2836,[172 323 161 151 117],378,2,10181,3.588649982375749,0.0,0.0
2837,0,2837,[237  96  11 174 655],537,0,10181,3.58738548273432,0.0,20.0
2838,0,2838,[180  97 435 210 125],378,3,10184,3.587178584008454,0.0,0.0
2839,0,2839,[302 603 427  50 313],13,5,10189,3.587676056338028,20.0,20.0
2840,0,2840,[300 176 100  50  79],7,4,10193,3.5878211897219288,0.0,40.0
2841,0,2841,[302 603 427  50 313],537,5,10198,3.5883180858550316,20.0,20.0
2842,0,2842,[132 215 200  97 515],343,4,10202,3.5884628913119943,0.0,0.0
2843,0,2843,[302 603 427  50 313],669,5,10207,3.588959212376934,20.0,20.0
2844,0,2844,[211  70 258 237  64],537,3,10210,3.5887521968365554,0.0,0.0
2845,0,2845,[ 97 151 435 121  95],295,5,10215,3.589248067463106,0.0,0.0
2846,0,2846,[ 28 257 405 196 403],290,3,10218,3.589041095890411,0.0,0.0
2847,0,2847,[ 11 496   4 568 234],343,3,10221,3.588834269662921,0.0,0.0
2848,0,2848,[182 515 300 181 161],271,2,10223,3.5882765882765884,0.0,0.0
2849,0,2849,[302 603 427  50 313],14,4,10227,3.588421052631579,20.0,20.0
2850,0,2850,[  1 153 238  64 172],406,3,10230,3.5882146615222728,0.0,0.0
2851,0,2851,[194 132 313 127   7],537,3,10233,3.588008415147265,0.0,20.0
2852,0,2852,[ 64 234 323 176 181],254,3,10236,3.5878023133543637,0.0,0.0
2853,0,2853,[238 132 288 215  15],59,5,10241,3.5882971268395236,0.0,0.0
2854,0,2854,[153  50 215  22  69],343,5,10246,3.5887915936952717,0.0,20.0
2855,0,2855,[144 269 143 496 286],343,5,10251,3.5892857142857144,0.0,0.0
2856,0,2856,[496 257  64 237 294],666,2,10253,3.5887294364718234,0.0,0.0
2857,0,2857,[302 603 427  50 313],537,5,10258,3.589223233030091,20.0,20.0
2858,0,2858,[318 427 496 197 194],899,5,10263,3.589716684155299,20.0,0.0
2859,0,2859,[318 508  98 496 186],6,4,10267,3.5898601398601397,20.0,20.0
2860,0,2860,[202 268 186 323 238],537,3,10270,3.589653967144355,0.0,0.0
2861,0,2861,[ 98 187 168   9   4],271,4,10274,3.589797344514326,0.0,20.0
2862,0,2862,[182 204 151 435 655],537,1,10275,3.5888927698218653,0.0,0.0
2863,0,2863,[302 603 427  50 313],454,5,10280,3.589385474860335,20.0,20.0
2864,0,2864,[302 603 427  50 313],669,5,10285,3.5898778359511345,20.0,20.0
2865,0,2865,[302 603 427  50 313],454,5,10290,3.5903698534542916,20.0,20.0
2866,0,2866,[168 655 427  28 143],7,4,10294,3.590512731077782,0.0,0.0
2867,0,2867,[302 603 427  50 313],669,5,10299,3.5910041841004183,20.0,20.0
2868,0,2868,[302 603 427  50 313],454,5,10304,3.59149529452771,20.0,20.0
2869,0,2869,[181  96 211  28 471],537,1,10305,3.5905923344947737,0.0,0.0
2870,0,2870,[196 403 135 175 121],42,3,10308,3.5903866248693834,0.0,0.0
2871,0,2871,[ 88 258  50 275 515],184,3,10311,3.590181058495822,0.0,20.0
2872,0,2872,[ 89  79 204 185 275],474,4,10315,3.5903237034458755,0.0,0.0
2873,0,2873,[ 12 603 234 357 127],59,5,10320,3.5908141962421714,60.0,20.0
2874,0,2874,[275 181 183 132 200],7,4,10324,3.5909565217391304,0.0,0.0
2875,0,2875,[302 603 427  50 313],474,5,10329,3.5914464534075106,20.0,20.0
2876,0,2876,[ 69 286  50 191 100],10,5,10334,3.591936044490789,0.0,40.0
2877,0,2877,[235  25  69 265 234],313,3,10337,3.5917303683113273,0.0,0.0
2878,0,2878,[100 423  70 143 127],653,2,10339,3.5911774921847863,0.0,40.0
2879,0,2879,[302 603 427  50 313],334,5,10344,3.591666666666667,20.0,20.0
2880,0,2880,[275  79  95 265 515],882,5,10349,3.5921555015619577,0.0,0.0
2881,0,2881,[318 215  97 222   1],378,4,10353,3.592297015961138,20.0,0.0
2882,0,2882,[323 168 179 423 210],59,5,10358,3.5927852930974677,0.0,0.0
2883,0,2883,[302 603 427  50 313],334,5,10363,3.5932732316227463,20.0,20.0
2884,0,2884,[172 385 176  89  22],892,4,10367,3.593414211438475,0.0,0.0
2885,0,2885,[174 117  79 215 269],524,3,10370,3.593208593208593,0.0,20.0
2886,0,2886,[302 603 427  50 313],537,5,10375,3.5936958780741253,20.0,20.0
2887,0,2887,[288  15 202 175 183],447,2,10377,3.59314404432133,0.0,0.0
2888,0,2888,[111 475  25 268 195],537,2,10379,3.5925925925925926,0.0,0.0
2889,0,2889,[ 95 222 301   4 496],234,2,10381,3.5920415224913493,0.0,0.0
2890,0,2890,[302 603 427  50 313],474,5,10386,3.592528536838464,20.0,20.0
2891,0,2891,[546  82 322 423 118],533,4,10390,3.5926694329183957,0.0,0.0
2892,0,2892,[191 210   9 111  98],271,5,10395,3.593155893536122,0.0,20.0
2893,0,2893,[ 25 168  64 496 210],749,5,10400,3.59364201796821,0.0,0.0
2894,0,2894,[ 95 228 151 183   7],664,3,10403,3.5934369602763385,0.0,0.0
2895,0,2895,[132   8  71 211 276],6,4,10407,3.5935773480662982,0.0,0.0
2896,0,2896,[435 191  22   1 125],234,2,10409,3.5930272695892302,0.0,0.0
2897,0,2897,[153  22  95  96 301],279,3,10412,3.5928226363008973,0.0,0.0
2898,0,2898,[174 515 100 111 475],64,5,10417,3.5933080372542254,0.0,40.0
2899,0,2899,[161 222 215 313  98],200,5,10422,3.593793103448276,0.0,20.0
2900,0,2900,[  9  98  89 197  97],308,2,10424,3.5932437090658396,0.0,20.0
2901,0,2901,[313 161  56 117 275],184,2,10426,3.592694693314955,0.0,0.0
2902,0,2902,[515 183 186 173 175],406,2,10428,3.5921460558043403,0.0,0.0
2903,0,2903,[176 135 210 655 222],64,4,10432,3.5922865013774103,0.0,0.0
2904,0,2904,[197 161 678 323 175],474,3,10435,3.5920826161790016,0.0,0.0
2905,0,2905,[181 125 423 742  12],207,3,10438,3.5918788713007572,20.0,0.0
2906,0,2906,[204 257 194 168 508],6,2,10440,3.5913312693498454,0.0,0.0
2907,0,2907,[168 186 234 195 211],897,4,10444,3.591471801925722,0.0,0.0
2908,0,2908,[187  15   1  71 237],194,4,10448,3.591612237882434,0.0,0.0
2909,0,2909,[265 289 143  98 173],13,2,10450,3.59106529209622,0.0,20.0
2910,0,2910,[405 546 603 200 168],648,4,10454,3.5912057712126417,20.0,0.0
2911,0,2911,[  8 328 204 172  71],328,3,10457,3.5910027472527473,0.0,0.0
2912,0,2912,[546 302 197 194 269],666,4,10461,3.591143151390319,0.0,0.0
2913,0,2913,[748  28 546 187 405],64,2,10463,3.5905971173644473,0.0,0.0
2914,0,2914,[302 603 427  50 313],474,5,10468,3.5910806174957117,20.0,20.0
2915,0,2915,[302 603 427  50 313],474,5,10473,3.5915637860082303,20.0,20.0
2916,0,2916,[302 603 427  50 313],474,5,10478,3.592046623243058,20.0,20.0
2917,0,2917,[268 333  71 111 228],334,3,10481,3.59184372858122,0.0,0.0
2918,0,2918,[405 216   9 275 546],60,5,10486,3.592326139088729,0.0,0.0
2919,0,2919,[258 174 132 328 603],506,5,10491,3.592808219178082,20.0,20.0
2920,0,2920,[121  96 187 153 597],788,2,10493,3.592262923656282,0.0,0.0
2921,0,2921,[302 603 427  50 313],14,4,10497,3.5924024640657084,20.0,20.0
2922,0,2922,[ 28 286 185 423  12],527,2,10499,3.5918576804652753,20.0,0.0
2923,0,2923,[302 603 427  50 313],474,5,10504,3.5923392612859097,20.0,20.0
2924,0,2924,[196 100 143  98 132],311,3,10507,3.592136752136752,0.0,40.0
2925,0,2925,[257 508 302 318  22],343,4,10511,3.592276144907724,20.0,0.0
2926,0,2926,[176 204 568 234 238],538,2,10513,3.5917321489579774,0.0,0.0
2927,0,2927,[185 483 318  69 183],6,4,10517,3.5918715846994536,40.0,0.0
2928,0,2928,[222 357 185 294 216],311,4,10521,3.592010925230454,20.0,0.0
2929,0,2929,[471 655 204 483 202],454,1,10522,3.5911262798634813,20.0,0.0
2930,0,2930,[135 168 202 215 111],653,1,10523,3.5902422381439782,0.0,0.0
2931,0,2931,[302 603 427  50 313],474,5,10528,3.590723055934516,20.0,20.0
2932,0,2932,[ 28 194 655 191 172],379,5,10533,3.591203545857484,0.0,0.0
2933,0,2933,[228 173 121 237  69],454,3,10536,3.591002044989775,0.0,0.0
2934,0,2934,[202  69 161 222  50],290,5,10541,3.591482112436116,0.0,20.0
2935,0,2935,[301 322 174 282 300],334,2,10543,3.590940054495913,0.0,20.0
2936,0,2936,[276 174 258  22 275],474,4,10547,3.5910793326523662,0.0,20.0
2937,0,2937,[ 15  79  11  96 132],537,0,10547,3.589857045609258,0.0,0.0
2938,0,2938,[216 197 515  89 187],406,2,10549,3.5893160939094932,0.0,0.0
2939,0,2939,[197 286 289 195 194],85,3,10552,3.589115646258503,0.0,0.0
2940,0,2940,[  9 603 200 235 168],308,4,10556,3.589255355321319,20.0,0.0
2941,0,2941,[385 216 187 210 483],804,5,10561,3.589734874235214,20.0,0.0
2942,0,2942,[ 69 603  12  64 172],7,5,10566,3.5902140672782874,40.0,0.0
2943,0,2943,[546 475 265 655 216],339,3,10569,3.590013586956522,0.0,0.0
2944,0,2944,[328 196 204 568 132],537,0,10569,3.5887945670628185,0.0,0.0
2945,0,2945,[302 603 427  50 313],271,5,10574,3.5892735913102514,20.0,20.0
2946,0,2946,[ 69 211 423 427 153],666,3,10577,3.5890736342042757,0.0,0.0
2947,0,2947,[423 435 168  56 172],666,3,10580,3.58887381275441,0.0,0.0
2948,0,2948,[161 202 210  69  79],653,4,10584,3.5890132248219735,0.0,0.0
2949,0,2949,[271 196 183 222  98],92,4,10588,3.589152542372881,0.0,20.0
2950,0,2950,[204 168 546  56 215],234,0,10588,3.587936292782108,0.0,0.0
2951,0,2951,[196 546   1 357 385],194,2,10590,3.58739837398374,20.0,0.0
2952,0,2952,[185 143 202 197 471],648,4,10594,3.5875380968506603,0.0,0.0
2953,0,2953,[ 88 111 423 655 276],207,2,10596,3.5870006770480702,0.0,0.0
2954,0,2954,[302 603 427  50 313],271,5,10601,3.5874788494077836,20.0,20.0
2955,0,2955,[ 69 588 127 161 222],85,3,10604,3.5872801082543977,0.0,20.0
2956,0,2956,[118 273  11 168 403],7,2,10606,3.5867433209333783,0.0,0.0
2957,0,2957,[405 179 403 197  97],524,4,10610,3.5868830290736984,0.0,0.0
2958,0,2958,[568 318 118 234 132],454,3,10613,3.58668469077391,20.0,0.0
2959,0,2959,[302 603 427  50 313],334,5,10618,3.587162162162162,20.0,20.0
2960,0,2960,[302 603 427  50 313],454,5,10623,3.5876393110435663,20.0,20.0
2961,0,2961,[ 97 515 211  56 603],524,4,10627,3.587778528021607,20.0,0.0
2962,0,2962,[ 98   7 186 202 546],7,4,10631,3.587917651029362,0.0,20.0
2963,0,2963,[302 603 427  50 313],14,4,10635,3.588056680161943,20.0,20.0
2964,0,2964,[258 273 117 546 111],486,2,10637,3.58752107925801,0.0,0.0
2965,0,2965,[144  50 191  82 210],234,2,10639,3.586985839514498,0.0,20.0
2966,0,2966,[144   1  79 195  82],892,4,10643,3.5871250421300975,0.0,0.0
2967,0,2967,[168  28 117  96 195],374,3,10646,3.5869272237196768,0.0,0.0
2968,0,2968,[302 603 427  50 313],14,4,10650,3.587066352307174,20.0,20.0
2969,0,2969,[322 200 228 275 403],13,1,10651,3.586195286195286,0.0,0.0
2970,0,2970,[302 603 427  50 313],537,5,10656,3.5866711544934367,20.0,20.0
2971,0,2971,[181 143  11 175 269],207,2,10658,3.5861372812920593,0.0,0.0
2972,0,2972,[  1 143 185 403 127],194,3,10661,3.58594012781702,0.0,20.0
2973,0,2973,[302 603 427  50 313],474,5,10666,3.586415601882986,20.0,20.0
2974,0,2974,[427 144 202 483  11],666,4,10670,3.5865546218487396,20.0,0.0
2975,0,2975,[186  82  98 228 215],313,2,10672,3.586021505376344,0.0,20.0
2976,0,2976,[286  95 118   8  25],200,5,10677,3.586496472959355,0.0,0.0
2977,0,2977,[302 100 515 161 127],328,5,10682,3.5869711215580926,0.0,40.0
2978,0,2978,[172  97 405 273   1],64,2,10684,3.5864384021483717,0.0,0.0
2979,0,2979,[302 204 273 322 186],207,3,10687,3.586241610738255,0.0,0.0
2980,0,2980,[235 173  82 405 385],932,1,10688,3.5853740355585373,0.0,0.0
2981,0,2981,[328 238 435 191 132],271,4,10692,3.585513078470825,0.0,0.0
2982,0,2982,[496 210  89  11 100],537,3,10695,3.585316795172645,0.0,20.0
2983,0,2983,[302 603 427  50 313],334,5,10700,3.5857908847184987,20.0,20.0
2984,0,2984,[ 71  50 200   7 121],334,3,10703,3.5855946398659966,0.0,20.0
2985,0,2985,[  7 655 515 181  79],881,5,10708,3.5860683188211655,0.0,0.0
2986,0,2986,[302 603 427  50 313],334,5,10713,3.5865416806160026,20.0,20.0
2987,0,2987,[288 153  79  97 187],409,3,10716,3.5863453815261046,0.0,0.0
2988,0,2988,[302 603 427  50 313],13,5,10721,3.5868183338909336,20.0,20.0
2989,0,2989,[302 603 427  50 313],537,5,10726,3.5872909698996653,20.0,20.0
2990,0,2990,[144 173 276 204 153],144,3,10729,3.587094617184888,0.0,0.0
2991,0,2991,[168 568  25  28 132],882,4,10733,3.5872326203208558,0.0,0.0
2992,0,2992,[204   7 168  50 496],95,5,10738,3.5877046441697296,0.0,20.0
2993,0,2993,[175 187 211 435 135],524,3,10741,3.5875083500334,0.0,0.0
2994,0,2994,[ 28 323 228  88 182],537,1,10742,3.586644407345576,0.0,0.0
2995,0,2995,[185 127  95   7 174],650,2,10744,3.5861148197596795,0.0,40.0
2996,0,2996,[238 288 742 475  64],308,5,10749,3.5865865865865865,0.0,0.0
2997,0,2997,[191  96 471  25 238],7,4,10753,3.586724482988659,0.0,0.0
2998,0,2998,[100  79  12 258 173],59,4,10757,3.586862287429143,20.0,20.0
2999,0,2999,[678  88 183 200  96],749,4,10761,3.587,0.0,0.0
3000,0,3000,[ 28 175 174 111 176],125,3,10764,3.5868043985338223,0.0,20.0
3001,0,3001,[183 588 125  25  89],804,5,10769,3.5872751499000666,0.0,0.0
3002,0,3002,[ 95 180 655 144 210],194,2,10771,3.5867465867465866,0.0,0.0
3003,0,3003,[174 153  82  89 546],13,3,10774,3.5865512649800264,0.0,20.0
3004,0,3004,[302 603 427  50 313],14,4,10778,3.5866888519134776,20.0,20.0
3005,0,3005,[ 28 228  96   1 508],92,4,10782,3.586826347305389,0.0,0.0
3006,0,3006,[ 25 238 403 328 222],804,4,10786,3.58696375124709,0.0,0.0
3007,0,3007,[302 603 427  50 313],537,5,10791,3.5874335106382977,20.0,20.0
3008,0,3008,[515 186 183  88  82],102,2,10793,3.586905948820206,0.0,0.0
3009,0,3009,[210 588 318 181 202],387,2,10795,3.586378737541528,20.0,0.0
3010,0,3010,[ 71 172  98 121 191],406,4,10799,3.586516107605447,0.0,20.0
3011,0,3011,[357 118 132 318 211],666,4,10803,3.5866533864541834,40.0,0.0
3012,0,3012,[318  11 127  70 276],271,4,10807,3.5867905741785595,20.0,20.0
3013,0,3013,[  9 135 286   4 222],883,3,10810,3.586595885865959,0.0,0.0
3014,0,3014,[234  95 357 197 405],648,2,10812,3.5860696517412936,20.0,0.0
3015,0,3015,[427  15  12  22 301],537,1,10813,3.5852122015915118,20.0,0.0
3016,0,3016,[302 603 427  50 313],537,5,10818,3.585681140205502,20.0,20.0
3017,0,3017,[385 546 194 191 118],881,4,10822,3.585818422796554,0.0,0.0
3018,0,3018,[302 603 427  50 313],13,5,10827,3.586286849950315,20.0,20.0
3019,0,3019,[127 121 215  89 403],7,5,10832,3.5867549668874172,0.0,20.0
3020,0,3020,[ 28  79 216 210 282],271,4,10836,3.5868917576961272,0.0,0.0
3021,0,3021,[258 118 435 144 175],7,4,10840,3.587028457974851,0.0,0.0
3022,0,3022,[172 546 742 597 588],897,4,10844,3.5871650678134306,0.0,0.0
3023,0,3023,[175 174 328 245 742],92,3,10847,3.5869708994708995,0.0,20.0
3024,0,3024,[228 143 175  96 204],479,4,10851,3.587107438016529,0.0,0.0
3025,0,3025,[186   8 258 172 181],13,5,10856,3.5875743555849304,0.0,0.0
3026,0,3026,[302 603 427  50 313],14,4,10860,3.587710604558969,20.0,20.0
3027,0,3027,[195  98 191  79 180],13,2,10862,3.587186261558785,0.0,20.0
3028,0,3028,[  7  69  89 194 228],59,4,10866,3.5873225486959393,0.0,0.0
3029,0,3029,[276  69 275 174 183],13,4,10870,3.5874587458745872,0.0,20.0
3030,0,3030,[302 603 427  50 313],669,5,10875,3.587924777301221,20.0,20.0
3031,0,3031,[  1 191 215  88 222],536,5,10880,3.588390501319261,0.0,0.0
3032,0,3032,[302 603 427  50 313],14,4,10884,3.588526211671612,20.0,20.0
3033,0,3033,[302 603 427  50 313],271,5,10889,3.588991430454845,20.0,20.0
3034,0,3034,[302 603 427  50 313],13,5,10894,3.5894563426688633,20.0,20.0
3035,0,3035,[195 100 275 269 204],13,2,10896,3.588932806324111,0.0,20.0
3036,0,3036,[286 197 515 153 216],194,2,10898,3.5884096147513995,0.0,0.0
3037,0,3037,[302 603 427  50 313],271,5,10903,3.5888742593811718,20.0,20.0
3038,0,3038,[302 603 427  50 313],474,5,10908,3.5893385982230996,20.0,20.0
3039,0,3039,[ 96 496 265   9 186],7,5,10913,3.5898026315789475,0.0,0.0
3040,0,3040,[ 69 228   7 202 328],234,1,10914,3.588951002959553,0.0,0.0
3041,0,3041,[302 603 427  50 313],13,5,10919,3.589414858645628,20.0,20.0
3042,0,3042,[302 603 427  50 313],334,5,10924,3.5898784094643443,20.0,20.0
3043,0,3043,[175 118  97 328 742],788,1,10925,3.5890275952693824,0.0,0.0
3044,0,3044,[ 50 483  79 132 187],406,3,10928,3.5888341543513955,20.0,20.0
3045,0,3045,[195 313 194 323  79],669,1,10929,3.587984241628365,0.0,0.0
3046,0,3046,[100 168 191 173 286],409,4,10933,3.5881194617656713,0.0,20.0
3047,0,3047,[195 216   7 300 222],843,2,10935,3.5875984251968505,0.0,0.0
3048,0,3048,[568 200 172 405 258],213,4,10939,3.5877336831748114,0.0,0.0
3049,0,3049,[302 603 427  50 313],454,5,10944,3.5881967213114754,20.0,20.0
3050,0,3050,[183  12 151 121  15],447,3,10947,3.5880039331366764,20.0,0.0
3051,0,3051,[216 132   7  28  79],334,2,10949,3.587483617300131,0.0,0.0
3052,0,3052,[655   1 294 183 273],10,4,10953,3.587618735669833,0.0,0.0
3053,0,3053,[186  64 202   8 238],311,4,10957,3.5877537655533724,0.0,0.0
3054,0,3054,[286 175 125 237  25],234,0,10957,3.58657937806874,0.0,0.0
3055,0,3055,[333 286 748 210 385],488,4,10961,3.586714659685864,0.0,0.0
3056,0,3056,[302 603 427  50 313],14,4,10965,3.5868498527968598,20.0,20.0
3057,0,3057,[ 12 568 216 173  22],537,1,10966,3.5860039241334207,20.0,0.0
3058,0,3058,[202 496  70 235 294],271,3,10969,3.585812356979405,0.0,0.0
3059,0,3059,[269  71 237 423 258],64,3,10972,3.58562091503268,0.0,0.0
3060,0,3060,[235   9 427 195 215],194,2,10974,3.5851029075465535,0.0,0.0
3061,0,3061,[302 603 427  50 313],334,5,10979,3.585564990202482,20.0,20.0
3062,0,3062,[ 15 118 132 185 144],313,4,10983,3.585700293829579,0.0,0.0
3063,0,3063,[302 603 427  50 313],537,5,10988,3.5861618798955615,20.0,20.0
3064,0,3064,[216  89 265 204 215],843,1,10989,3.5853181076672103,0.0,0.0
3065,0,3065,[ 64  12 496 742 132],42,5,10994,3.5857795172863667,20.0,0.0
3066,0,3066,[273 183 121 173 496],7,4,10998,3.5859145745027714,0.0,0.0
3067,0,3067,[265 174 144  11   8],234,1,10999,3.585071707953064,0.0,20.0
3068,0,3068,[655 195  96 471 313],92,5,11004,3.5855327468230693,0.0,0.0
3069,0,3069,[234 186  12 180 268],234,1,11005,3.5846905537459284,20.0,0.0
3070,0,3070,[ 69 191 265  79 258],882,4,11009,3.5848257896450666,0.0,0.0
3071,0,3071,[302 603 427  50 313],14,4,11013,3.5849609375,20.0,20.0
3072,0,3072,[191 288  11 125  15],554,3,11016,3.5847705824926783,0.0,0.0
3073,0,3073,[222 135 603 748 322],13,3,11019,3.5845803513337673,20.0,0.0
3074,0,3074,[173 289 257 546 265],374,2,11021,3.5840650406504064,0.0,0.0
3075,0,3075,[ 12 200 318 174 265],543,4,11025,3.5842002600780236,40.0,20.0
3076,0,3076,[ 95 135 515  69 333],537,2,11027,3.5836854078648033,0.0,0.0
3077,0,3077,[187  11  15  98 118],271,3,11030,3.5834957764782325,0.0,20.0
3078,0,3078,[ 96 210 161 258 204],474,5,11035,3.583955829814875,0.0,0.0
3079,0,3079,[235 176 127 174 318],271,3,11038,3.5837662337662337,20.0,40.0
3080,0,3080,[ 98  15 235 111 423],374,1,11039,3.5829276209023044,0.0,20.0
3081,0,3081,[275 276 200 471 423],537,2,11041,3.582414016872161,0.0,0.0
3082,0,3082,[135  95 195 515  22],537,2,11043,3.5819007460265975,0.0,0.0
3083,0,3083,[ 89 151 211 196  69],918,1,11044,3.5810635538262,0.0,0.0
3084,0,3084,[185 288 318 117  71],479,2,11046,3.580551053484603,20.0,0.0
3085,0,3085,[186  97 322 153 151],804,4,11050,3.5806869734283864,0.0,0.0
3086,0,3086,[182 175 180  25 655],234,0,11050,3.579527048914804,0.0,0.0
3087,0,3087,[508 143 588 301 265],537,1,11051,3.5786917098445596,0.0,0.0
3088,0,3088,[405 191 200 127  70],881,3,11054,3.5785043703463906,0.0,20.0
3089,0,3089,[302 603 427  50 313],474,5,11059,3.5789644012944986,20.0,20.0
3090,0,3090,[ 69  11 234   8 435],271,5,11064,3.579424134584277,0.0,0.0
3091,0,3091,[302 603 427  50 313],537,5,11069,3.5798835705045278,20.0,20.0
3092,0,3092,[302 603 427  50 313],669,5,11074,3.5803427093436793,20.0,20.0
3093,0,3093,[302 603 427  50 313],13,5,11079,3.580801551389787,20.0,20.0
3094,0,3094,[265  71  97 515 180],387,3,11082,3.580613893376414,0.0,0.0
3095,0,3095,[289 194 286 121 435],387,0,11082,3.5794573643410854,0.0,0.0
3096,0,3096,[238 161 100 235 175],339,3,11085,3.5792702615434293,0.0,20.0
3097,0,3097,[275 265 603  79  82],64,3,11088,3.579083279535184,20.0,0.0
3098,0,3098,[496 204  88 427 168],379,5,11093,3.579541787673443,0.0,0.0
3099,0,3099,[216  50  96 195 183],144,5,11098,3.58,0.0,20.0
3100,0,3100,[603 111   4 216 194],64,3,11101,3.579812963560142,20.0,0.0
3101,0,3101,[175 118 216   7 288],666,2,11103,3.579303675048356,0.0,0.0
3102,0,3102,[302 175 127  25 211],14,3,11106,3.5791169835642926,0.0,20.0
3103,0,3103,[183 403 204 313 515],234,3,11109,3.578930412371134,0.0,0.0
3104,0,3104,[302  71 100   4 597],378,3,11112,3.578743961352657,0.0,20.0
3105,0,3105,[302 427 603  50 313],454,5,11117,3.5792015453960078,20.0,20.0
3106,0,3106,[302 427 603  50 313],271,5,11122,3.5796588348889604,20.0,20.0
3107,0,3107,[302 427 603  50 313],14,4,11126,3.57979407979408,20.0,20.0
3108,0,3108,[302 427 603  50 313],334,5,11131,3.5802508845287875,20.0,20.0
3109,0,3109,[302 427 603  50 313],334,5,11136,3.580707395498392,20.0,20.0
3110,0,3110,[183 323 265 228 313],650,4,11140,3.5808421729347475,0.0,0.0
3111,0,3111,[302 427 603  50 313],474,5,11145,3.581298200514139,20.0,20.0
3112,0,3112,[180 202 258 191 118],13,4,11149,3.581432701574044,0.0,0.0
3113,0,3113,[302 427 603  50 313],13,5,11154,3.581888246628131,20.0,20.0
3114,0,3114,[ 56  25 333 222 211],666,2,11156,3.5813804173354735,0.0,0.0
3115,0,3115,[302 427 603  50 313],334,5,11161,3.58183568677792,20.0,20.0
3116,0,3116,[301 427  82 215 496],85,3,11164,3.581649021495027,0.0,0.0
3117,0,3117,[655 423   9 187 176],881,4,11168,3.581783194355356,0.0,0.0
3118,0,3118,[597  69 678  71 275],82,2,11170,3.5812760500160308,0.0,0.0
3119,0,3119,[275  25 168   7  89],343,3,11173,3.5810897435897435,0.0,0.0
3120,0,3120,[302 427 603  50 313],669,5,11178,3.5815443768023068,20.0,20.0
3121,0,3121,[181  95 286 135 245],455,4,11182,3.5816784112748237,0.0,0.0
3122,0,3122,[286  98 127 427 294],271,4,11186,3.5818123599103426,0.0,40.0
3123,0,3123,[302 427 603  50 313],669,5,11191,3.582266325224072,20.0,20.0
3124,0,3124,[302 427 603  50 313],271,5,11196,3.58272,20.0,20.0
3125,0,3125,[204 322 121 228 168],92,4,11200,3.582853486884197,0.0,0.0
3126,0,3126,[135 195  15 748 117],881,3,11203,3.5826670930604414,0.0,0.0
3127,0,3127,[275 294 483   1 174],298,3,11206,3.5824808184143224,20.0,20.0
3128,0,3128,[471 202 282 483 132],298,4,11210,3.5826142537551933,20.0,0.0
3129,0,3129,[143 286   1 151 333],298,4,11214,3.582747603833866,0.0,0.0
3130,0,3130,[333 132  71 153 180],13,4,11218,3.5828808687320346,0.0,0.0
3131,0,3131,[302 427 603  50 313],537,5,11223,3.5833333333333335,20.0,20.0
3132,0,3132,[238 196  97  98 742],653,0,11223,3.5821895946377276,0.0,20.0
3133,0,3133,[288  97 300  50  88],892,5,11228,3.5826419910657306,0.0,20.0
3134,0,3134,[211 196  97  82  56],339,5,11233,3.5830940988835724,0.0,0.0
3135,0,3135,[  1 435 237 111   8],533,3,11236,3.582908163265306,0.0,0.0
3136,0,3136,[173 181 204 174 403],385,1,11237,3.582084794389544,0.0,20.0
3137,0,3137,[216 125  69 195 175],653,2,11239,3.5815806246016573,0.0,0.0
3138,0,3138,[302 427 603  50 313],13,5,11244,3.582032494424976,20.0,20.0
3139,0,3139,[222 234 174 357 318],774,0,11244,3.580891719745223,40.0,20.0
3140,0,3140,[175 197 471 132  12],234,2,11246,3.58038841133397,20.0,0.0
3141,0,3141,[357   4  96 568 111],207,3,11249,3.580203691915977,20.0,0.0
3142,0,3142,[151 423 216 144 258],378,4,11253,3.580337257397391,0.0,0.0
3143,0,3143,[ 69  22  70 197 143],452,4,11257,3.580470737913486,0.0,0.0
3144,0,3144,[195  69 568  50   8],85,3,11260,3.5802861685214626,0.0,20.0
3145,0,3145,[742 185 483 357 275],95,2,11262,3.579783852511125,40.0,0.0
3146,0,3146,[ 50 125 286 238 183],648,2,11264,3.5792818557356214,0.0,20.0
3147,0,3147,[302 427 603  50 313],454,5,11269,3.579733163913596,20.0,20.0
3148,0,3148,[302 427 603  50 313],454,5,11274,3.5801841854557,20.0,20.0
3149,0,3149,[302 427 603  50 313],13,5,11279,3.5806349206349206,20.0,20.0
3150,0,3150,[168 300 181 234 211],102,0,11279,3.5794985718819423,0.0,0.0
3151,0,3151,[197  25 172 215  97],234,1,11280,3.5786802030456855,0.0,0.0
3152,0,3152,[183  64  95 197 301],6,3,11283,3.578496669838249,0.0,0.0
3153,0,3153,[197 194 228 174 483],537,2,11285,3.577996195307546,20.0,20.0
3154,0,3154,[357  79  96 475 144],458,4,11289,3.5781299524564183,20.0,0.0
3155,0,3155,[210 135 222 127   9],406,4,11293,3.5782636248415716,0.0,20.0
3156,0,3156,[302 427 603  50 313],13,5,11298,3.5787139689578713,20.0,20.0
3157,0,3157,[172 357 111 195 202],666,2,11300,3.5782140595313487,20.0,0.0
3158,0,3158,[ 97 403 175  15 151],881,0,11300,3.5770813548591325,0.0,0.0
3159,0,3159,[288 195 546   1 238],279,2,11302,3.5765822784810126,0.0,0.0
3160,0,3160,[302 427 603  50 313],537,5,11307,3.5770325846251185,20.0,20.0
3161,0,3161,[ 98  70 215 471 173],537,2,11309,3.5765338393421886,0.0,20.0
3162,0,3162,[ 28 273  88 483   9],13,3,11312,3.5763515649699653,20.0,0.0
3163,0,3163,[186  79 143 496 742],749,5,11317,3.576801517067004,0.0,0.0
3164,0,3164,[302 427 603  50 313],537,5,11322,3.577251184834123,20.0,20.0
3165,0,3165,[180 471  97 161 294],7,3,11325,3.57706885660139,0.0,0.0
3166,0,3166,[151 655 318 172 202],537,1,11326,3.576255131038838,20.0,0.0
3167,0,3167,[302 427 603  50 313],454,5,11331,3.5767045454545454,20.0,20.0
3168,0,3168,[302 427 603  50 313],271,5,11336,3.577153676238561,20.0,20.0
3169,0,3169,[ 25 276  97  50 168],374,3,11339,3.5769716088328076,0.0,20.0
3170,0,3170,[302 427 603  50 313],537,5,11344,3.5774203721223587,20.0,20.0
3171,0,3171,[302 427 603  50 313],474,5,11349,3.5778688524590163,20.0,20.0
3172,0,3172,[187 257  28 161 597],308,2,11351,3.5773715726441853,0.0,0.0
3173,0,3173,[ 28 181 302 183 211],328,5,11356,3.5778197857592944,0.0,0.0
3174,0,3174,[202  96 195  56 215],313,4,11360,3.5779527559055118,0.0,0.0
3175,0,3175,[302 427 603  50 313],13,5,11365,3.5784005037783375,20.0,20.0
3176,0,3176,[302 427 603  50 313],334,5,11370,3.578847969782814,20.0,20.0
3177,0,3177,[168 282 435 515 183],804,4,11374,3.578980490874764,0.0,0.0
3178,0,3178,[161 282 111 121 471],42,4,11378,3.5791129285938976,0.0,0.0
3179,0,3179,[302 427 603  50 313],474,5,11383,3.579559748427673,20.0,20.0
3180,0,3180,[302 427 603  50 313],271,5,11388,3.580006287331028,20.0,20.0
3181,0,3181,[ 96 318 237 180 118],804,5,11393,3.5804525455688245,20.0,0.0
3182,0,3182,[302 427 603  50 313],537,5,11398,3.580898523405592,20.0,20.0
3183,0,3183,[302 427 603  50 313],334,5,11403,3.5813442211055277,20.0,20.0
3184,0,3184,[185 588 181 655 328],13,3,11406,3.5811616954474097,0.0,0.0
3185,0,3185,[ 22 405   8 161 100],474,5,11411,3.581607030759573,0.0,20.0
3186,0,3186,[181 197  56 288 182],533,2,11413,3.581110762472545,0.0,0.0
3187,0,3187,[302 427 603  50 313],537,5,11418,3.581555834378921,20.0,20.0
3188,0,3188,[182 118  98 742 403],524,3,11421,3.5813734713076197,0.0,20.0
3189,0,3189,[  7  15 111   1 181],779,4,11425,3.5815047021943576,0.0,0.0
3190,0,3190,[237 210   7 271 423],890,3,11428,3.5813224694453147,0.0,0.0
3191,0,3191,[318 423 143   4 228],524,3,11431,3.581140350877193,20.0,0.0
3192,0,3192,[ 96 117  95  70 496],95,4,11435,3.581271531475102,0.0,0.0
3193,0,3193,[187 405 471   7  96],524,3,11438,3.5810895428929244,0.0,0.0
3194,0,3194,[302 427 603  50 313],13,5,11443,3.5815336463223786,20.0,20.0
3195,0,3195,[302 427 603  50 313],334,5,11448,3.5819774718398,20.0,20.0
3196,0,3196,[211 588 385 742 271],650,2,11450,3.5814826399749764,0.0,0.0
3197,0,3197,[204 276 286  97 215],378,5,11455,3.5819262038774236,0.0,0.0
3198,0,3198,[302 427 603  50 313],271,5,11460,3.5823694904657706,20.0,20.0
3199,0,3199,[ 12 180  89  98 282],378,4,11464,3.5825,20.0,20.0
3200,0,3200,[ 15  56 234 288 228],455,3,11467,3.5823180256169946,0.0,0.0
3201,0,3201,[568 515 403  70 318],308,4,11471,3.5824484697064336,20.0,0.0
3202,0,3202,[ 70 168 427 423 151],536,3,11474,3.582266625039026,0.0,0.0
3203,0,3203,[182 276 183 333 286],537,2,11476,3.581772784019975,0.0,0.0
3204,0,3204,[151  79 403 174   4],379,5,11481,3.5822152886115446,0.0,20.0
3205,0,3205,[328 333 288 183 245],334,2,11483,3.5817217716781036,0.0,0.0
3206,0,3206,[302 427 603  50 313],334,5,11488,3.5821640162145307,20.0,20.0
3207,0,3207,[655 196 568  64 300],119,5,11493,3.5826059850374063,0.0,0.0
3208,0,3208,[302 427 603  50 313],13,5,11498,3.5830476784044873,20.0,20.0
3209,0,3209,[197 179 238  69 127],334,4,11502,3.583177570093458,0.0,20.0
3210,0,3210,[302 172 289 258 121],378,5,11507,3.583618810339458,0.0,0.0
3211,0,3211,[179 191 181 144 328],653,4,11511,3.5837484433374844,0.0,0.0
3212,0,3212,[237 202 222 132 151],378,2,11513,3.583255524431995,0.0,0.0
3213,0,3213,[ 89 678 515 597 200],455,2,11515,3.5827629122588673,0.0,0.0
3214,0,3214,[302 427 603  50 313],454,5,11520,3.583203732503888,20.0,20.0
3215,0,3215,[144 215 228 655 357],234,1,11521,3.5824004975124377,20.0,0.0
3216,0,3216,[125 202 172  71 655],92,4,11525,3.5825303077401305,0.0,0.0
3217,0,3217,[286 435 211 204 215],454,2,11527,3.5820385332504663,0.0,0.0
3218,0,3218,[302 427 603  50 313],537,5,11532,3.582479030754893,20.0,20.0
3219,0,3219,[357 153  79 333 100],343,4,11536,3.582608695652174,20.0,20.0
3220,0,3220,[ 82 202 301 655 435],234,0,11536,3.5814964296802234,0.0,0.0
3221,0,3221,[742 245 257 286  56],378,4,11540,3.5816263190564865,0.0,0.0
3222,0,3222,[161 269  79  56 191],339,4,11544,3.581756127831213,0.0,0.0
3223,0,3223,[ 64 323 655 222 187],474,4,11548,3.5818858560794045,0.0,0.0
3224,0,3224,[  9 211 204 271 678],13,2,11550,3.5813953488372094,0.0,0.0
3225,0,3225,[179 200 185  79 568],95,2,11552,3.5809051456912586,0.0,0.0
3226,0,3226,[423 435 118  12 196],59,5,11557,3.581344902386117,20.0,0.0
3227,0,3227,[202 135 121  96 603],804,4,11561,3.581474597273854,20.0,0.0
3228,0,3228,[176 235 403 748 191],92,3,11564,3.5812945184267577,0.0,0.0
3229,0,3229,[302 427 603  50 313],13,5,11569,3.581733746130031,20.0,20.0
3230,0,3230,[302 427 603  50 313],474,5,11574,3.582172701949861,20.0,20.0
3231,0,3231,[144 181 204 265 200],379,5,11579,3.582611386138614,0.0,0.0
3232,0,3232,[302 427 603  50 313],14,4,11583,3.582740488710176,20.0,20.0
3233,0,3233,[588 300  70 144 196],454,3,11586,3.5825602968460113,0.0,0.0
3234,0,3234,[135 286 228 204 588],650,3,11589,3.5823802163833074,0.0,0.0
3235,0,3235,[302 427 603  50 313],454,5,11594,3.5828182941903584,20.0,20.0
3236,0,3236,[151 211 496 135   7],883,4,11598,3.582947173308619,0.0,0.0
3237,0,3237,[153 357 228 195  89],312,3,11601,3.5827671402100063,20.0,0.0
3238,0,3238,[168 176 568  79 257],343,3,11604,3.5825872182772462,0.0,0.0
3239,0,3239,[ 11 234  56 282 175],406,4,11608,3.582716049382716,0.0,0.0
3240,0,3240,[318 427 144  70   1],234,2,11610,3.582227707497686,20.0,0.0
3241,0,3241,[  7 268   4  22 153],92,4,11614,3.582356570018507,0.0,0.0
3242,0,3242,[180 144 238 204 182],339,3,11617,3.5821769966080788,0.0,0.0
3243,0,3243,[204 655 210 143 276],207,2,11619,3.5816892725030827,0.0,0.0
3244,0,3244,[597 357 195 180 135],328,2,11621,3.581201848998459,20.0,0.0
3245,0,3245,[302 427 603  50 313],537,5,11626,3.5816389402341344,20.0,20.0
3246,0,3246,[655 215 328 257  22],479,4,11630,3.5817677856482906,0.0,0.0
3247,0,3247,[302 427 603  50 313],454,5,11635,3.582204433497537,20.0,20.0
3248,0,3248,[273 111 100  25 185],749,3,11638,3.582025238534934,0.0,20.0
3249,0,3249,[228 183 678 568 117],13,2,11640,3.5815384615384613,0.0,0.0
3250,0,3250,[302 427 603  50 313],669,5,11645,3.5819747769916948,20.0,20.0
3251,0,3251,[508 235 568 161  97],83,3,11648,3.5817958179581795,0.0,0.0
3252,0,3252,[276 197 180 111 508],533,3,11651,3.581616968951737,0.0,0.0
3253,0,3253,[111   9  22   8 405],474,5,11656,3.5820528580208975,0.0,0.0
3254,0,3254,[748  25  88 235 475],125,1,11657,3.5812596006144393,0.0,0.0
3255,0,3255,[ 69   1 194 176  88],883,2,11659,3.5807739557739557,0.0,0.0
3256,0,3256,[234 265 118 195 294],200,5,11664,3.5812097021799203,0.0,0.0
3257,0,3257,[483 211 117  64   8],311,4,11668,3.5813382443216697,20.0,0.0
3258,0,3258,[ 69  50 135 210 603],239,4,11672,3.581466707579012,20.0,20.0
3259,0,3259,[197   1 196 121  79],664,4,11676,3.58159509202454,0.0,0.0
3260,0,3260,[ 64 235 515  96 132],524,3,11679,3.5814167433302666,0.0,0.0
3261,0,3261,[181 228 322 568 182],804,5,11684,3.5818516247700796,0.0,0.0
3262,0,3262,[ 79 183 176 258 288],488,4,11688,3.581979773214833,0.0,0.0
3263,0,3263,[  8 132 111 222 302],334,3,11691,3.5818014705882355,0.0,0.0
3264,0,3264,[294 135 423 153  50],308,4,11695,3.581929555895865,0.0,20.0
3265,0,3265,[144 568 323  96 187],328,3,11698,3.5817513778322105,0.0,0.0
3266,0,3266,[385 127 175 144 300],346,5,11703,3.5821854912764004,0.0,20.0
3267,0,3267,[ 56  89 191 268 183],13,4,11707,3.582313341493268,0.0,0.0
3268,0,3268,[180 288 742 234 143],804,3,11710,3.582135209544203,0.0,0.0
3269,0,3269,[302 427 603  50 313],334,5,11715,3.5825688073394497,20.0,20.0
3270,0,3270,[ 97 427 323 302  64],90,4,11719,3.582696423112198,0.0,0.0
3271,0,3271,[288 385 603  70 211],234,1,11720,3.5819070904645476,20.0,0.0
3272,0,3272,[588  22 132 483  95],537,1,11721,3.5811182401466546,20.0,0.0
3273,0,3273,[302 427 603  50 313],334,5,11726,3.5815516188149052,20.0,20.0
3274,0,3274,[ 71  89 405  98 185],60,4,11730,3.5816793893129772,0.0,20.0
3275,0,3275,[748 174  12 265 222],64,4,11734,3.581807081807082,20.0,20.0
3276,0,3276,[197  96 318  70 302],883,4,11738,3.58193469636863,20.0,0.0
3277,0,3277,[302 427 603  50 313],271,5,11743,3.582367297132398,20.0,20.0
3278,0,3278,[  1 318  64 273 182],892,5,11748,3.5827996340347665,20.0,0.0
3279,0,3279,[ 82 176 471 185 191],653,2,11750,3.582317073170732,0.0,0.0
3280,0,3280,[174 210 228 265 181],334,3,11753,3.5821395915879304,0.0,20.0
3281,0,3281,[118 603 313 357 175],543,2,11755,3.581657525898842,40.0,0.0
3282,0,3282,[172 568 318   1  96],59,4,11759,3.581784952787085,20.0,0.0
3283,0,3283,[117 118 257 216 153],479,2,11761,3.5813032886723506,0.0,0.0
3284,0,3284,[276  82 100 245   8],455,4,11765,3.5814307458143073,0.0,20.0
3285,0,3285,[196 132  64 318 183],380,4,11769,3.581558125380402,20.0,0.0
3286,0,3286,[ 97  79 186 385 180],892,3,11772,3.5813811986613935,0.0,0.0
3287,0,3287,[496  25 191 678 175],387,2,11774,3.5809002433090025,0.0,0.0
3288,0,3288,[318 127 135  56 179],189,5,11779,3.5813317117664942,20.0,20.0
3289,0,3289,[237 194 174 265  70],234,1,11780,3.580547112462006,0.0,20.0
3290,0,3290,[258  89  98 161 121],313,4,11784,3.5806745670009117,0.0,20.0
3291,0,3291,[423 475 100 125 235],92,3,11787,3.580498177399757,0.0,20.0
3292,0,3292,[180 313 475  96  11],13,3,11790,3.5803218949286366,0.0,0.0
3293,0,3293,[215 195  89  96 322],13,3,11793,3.5801457194899817,0.0,0.0
3294,0,3294,[196 125 427 655 568],42,4,11797,3.5802731411229134,0.0,0.0
3295,0,3295,[258 235 204 318 282],328,2,11799,3.5797936893203883,20.0,0.0
3296,0,3296,[ 50 185  96 288 118],882,4,11803,3.5799211404306948,0.0,20.0
3297,0,3297,[  4 168 234  79 403],804,4,11807,3.5800485142510614,0.0,0.0
3298,0,3298,[195 180 127  82 196],843,1,11808,3.579266444377084,0.0,20.0
3299,0,3299,[302 427 603  50 313],454,5,11813,3.5796969696969696,20.0,20.0
3300,0,3300,[405  28 191 385  95],194,2,11815,3.5792184186610116,0.0,0.0
3301,0,3301,[302 427 603  50 313],454,5,11820,3.579648697758934,20.0,20.0
3302,0,3302,[257 179   4  15 185],749,4,11824,3.5797759612473508,0.0,0.0
3303,0,3303,[ 97 273 237  12 258],64,2,11826,3.5792978208232444,20.0,0.0
3304,0,3304,[  4 202  89 385 257],650,2,11828,3.578819969742814,0.0,0.0
3305,0,3305,[568 132 180 301 174],85,4,11832,3.5789473684210527,0.0,20.0
3306,0,3306,[234  98 187 186  89],326,3,11835,3.5787723011793164,0.0,20.0
3307,0,3307,[144 183  98 496  11],339,4,11839,3.578899637243047,0.0,20.0
3308,0,3308,[302 427 603  50 313],14,4,11843,3.579026896343306,20.0,20.0
3309,0,3309,[180  79  64 121  82],313,4,11847,3.579154078549849,0.0,0.0
3310,0,3310,[313 357 180 168 204],59,5,11852,3.579583207490184,20.0,0.0
3311,0,3311,[ 11 385 194 175 568],749,3,11855,3.5794082125603865,0.0,0.0
3312,0,3312,[ 82 597 173 405 273],897,3,11858,3.579233323271959,0.0,0.0
3313,0,3313,[333 172 211 294 234],533,4,11862,3.5793602896801446,0.0,0.0
3314,0,3314,[ 96 678 132  11 143],537,0,11862,3.5782805429864255,0.0,0.0
3315,0,3315,[216 187   9 153  89],85,3,11865,3.5781061519903496,0.0,0.0
3316,0,3316,[302 427 603  50 313],537,5,11870,3.578534820621043,20.0,20.0
3317,0,3317,[302 427 603  50 313],669,5,11875,3.578963230861965,20.0,20.0
3318,0,3318,[302 427 603  50 313],537,5,11880,3.5793913829466706,20.0,20.0
3319,0,3319,[222  11  56 546 182],749,1,11881,3.5786144578313253,0.0,0.0
3320,0,3320,[  8 328 211 204 228],328,2,11883,3.5781391147244808,0.0,0.0
3321,0,3321,[265  97  82 483 182],488,3,11886,3.5779650812763397,20.0,0.0
3322,0,3322,[302 427 603  50 313],474,5,11891,3.5783930183569064,20.0,20.0
3323,0,3323,[302 427 603  50 313],334,5,11896,3.578820697954272,20.0,20.0
3324,0,3324,[273 483 151 144  28],7,4,11900,3.5789473684210527,20.0,0.0
3325,0,3325,[ 12 273   8 258 161],378,5,11905,3.579374624173181,20.0,0.0
3326,0,3326,[238 748 273   1 328],749,3,11908,3.579200480913736,0.0,0.0
3327,0,3327,[403  28 294 568 210],648,4,11912,3.579326923076923,0.0,0.0
3328,0,3328,[ 56 228 151 185 121],788,2,11914,3.5788525082607388,0.0,0.0
3329,0,3329,[276 288  70 403 385],13,1,11915,3.578078078078078,0.0,0.0
3330,0,3330,[302 427 603  50 313],537,5,11920,3.5785049534674274,20.0,20.0
3331,0,3331,[ 50 196  28 318 300],85,4,11924,3.5786314525810323,20.0,20.0
3332,0,3332,[ 89 257 100 268  56],6,3,11927,3.5784578457845786,0.0,20.0
3333,0,3333,[302 427 603  50 313],454,5,11932,3.578884223155369,20.0,20.0
3334,0,3334,[276 357 323  70 588],311,4,11936,3.5790104947526236,20.0,0.0
3335,0,3335,[302 427 603  50 313],537,5,11941,3.5794364508393284,20.0,20.0
3336,0,3336,[ 11 427  98  64 174],343,5,11946,3.5798621516332036,0.0,40.0
3337,0,3337,[302 427 603  50 313],14,4,11950,3.579988016776513,20.0,20.0
3338,0,3338,[135 182 275 435  56],406,4,11954,3.580113806528901,0.0,0.0
3339,0,3339,[603  96 135 300   7],840,3,11957,3.579940119760479,20.0,0.0
3340,0,3340,[ 97 234 678  95  69],506,4,11961,3.580065848548339,0.0,0.0
3341,0,3341,[132  88  56 475  22],92,2,11963,3.5795930580490722,0.0,0.0
3342,0,3342,[496 423 204  98 121],653,2,11965,3.579120550403829,0.0,20.0
3343,0,3343,[176  98  28 216 161],308,1,11966,3.5783492822966507,0.0,20.0
3344,0,3344,[ 82 258 181 174 172],8,5,11971,3.5787742899850525,0.0,20.0
3345,0,3345,[302 427 603  50 313],13,5,11976,3.57919904363419,20.0,20.0
3346,0,3346,[202 333 496 222 179],343,4,11980,3.5793247684493577,0.0,0.0
3347,0,3347,[603  79   4 151 496],387,2,11982,3.578853046594982,20.0,0.0
3348,0,3348,[ 69  79 143 289 186],334,1,11983,3.5780830098536875,0.0,0.0
3349,0,3349,[385 173  50 187 196],59,5,11988,3.578507462686567,0.0,20.0
3350,0,3350,[172 132  71 180 235],313,4,11992,3.5786332438078188,0.0,0.0
3351,0,3351,[322 172 215   8 176],13,3,11995,3.5784606205250595,0.0,0.0
3352,0,3352,[ 70   9 197 185 238],308,4,11999,3.578586340590516,0.0,0.0
3353,0,3353,[180 216 238 655 121],13,3,12002,3.5784138342277876,0.0,0.0
3354,0,3354,[302 427 603  50 313],454,5,12007,3.5788375558867362,20.0,20.0
3355,0,3355,[302 427 603  50 313],454,5,12012,3.5792610250297976,20.0,20.0
3356,0,3356,[302 427 603  50 313],474,5,12017,3.5796842418826333,20.0,20.0
3357,0,3357,[385  50  79  97  89],524,4,12021,3.5798094103633114,0.0,20.0
3358,0,3358,[302 427 603  50 313],334,5,12026,3.5802322119678474,20.0,20.0
3359,0,3359,[ 97 200 288 127 323],474,2,12028,3.579761904761905,0.0,20.0
3360,0,3360,[678 742  50 546 237],548,5,12033,3.580184468908063,0.0,20.0
3361,0,3361,[143 748  82 210  28],882,5,12038,3.580606781677573,0.0,0.0
3362,0,3362,[427 132 121 288 180],650,2,12040,3.5801367826345523,0.0,0.0
3363,0,3363,[235 191   1 175 313],59,3,12043,3.579964328180737,0.0,0.0
3364,0,3364,[194  11  97 286 191],271,5,12048,3.5803863298662706,0.0,0.0
3365,0,3365,[302 427 603  50 313],13,5,12053,3.580808080808081,20.0,20.0
3366,0,3366,[302 427 603  50 313],14,4,12057,3.580932580932581,20.0,20.0
3367,0,3367,[200 168 135 357 238],385,2,12059,3.580463182897862,20.0,0.0
3368,0,3368,[153 135 515 183  95],892,5,12064,3.580884535470466,0.0,0.0
3369,0,3369,[194 496 597 143 196],897,4,12068,3.5810089020771514,0.0,0.0
3370,0,3370,[323 132 202 127 471],537,1,12069,3.5802432512607534,0.0,20.0
3371,0,3371,[ 82 174  12  50 176],13,3,12072,3.580071174377224,20.0,40.0
3372,0,3372,[302 427 603  50 313],537,5,12077,3.58049214349244,20.0,20.0
3373,0,3373,[ 96 181 100 180 202],188,3,12080,3.5803200948429166,0.0,20.0
3374,0,3374,[ 15 204 273   1  95],308,3,12083,3.5801481481481483,0.0,0.0
3375,0,3375,[302 427 603  50 313],13,5,12088,3.580568720379147,20.0,20.0
3376,0,3376,[195 174 153 597  79],788,1,12089,3.579804560260586,0.0,20.0
3377,0,3377,[302 427 603  50 313],14,4,12093,3.579928952042629,20.0,20.0
3378,0,3378,[546 318 196 118 427],343,3,12096,3.579757324652264,20.0,0.0
3379,0,3379,[143  98 144 132 202],263,5,12101,3.5801775147928994,0.0,20.0
3380,0,3380,[ 69 176 385 405 323],374,4,12105,3.580301685891748,0.0,0.0
3381,0,3381,[427 191 385 515  71],313,5,12110,3.5807214665878178,0.0,0.0
3382,0,3382,[302 427 603  50 313],14,4,12114,3.5808454034880284,20.0,20.0
3383,0,3383,[ 56 568 197  98 180],59,5,12119,3.5812647754137115,0.0,20.0
3384,0,3384,[121 588  88 496 172],313,4,12123,3.5813884785819794,0.0,0.0
3385,0,3385,[385 234  15  71 603],234,2,12125,3.5809214412285884,20.0,0.0
3386,0,3386,[268  70 117  96 186],537,3,12128,3.5807499261883673,0.0,0.0
3387,0,3387,[181  50 135 405  15],488,4,12132,3.5808736717827627,0.0,20.0
3388,0,3388,[302 427 603  50 313],334,5,12137,3.581292416642077,20.0,20.0
3389,0,3389,[  4   9 211 237 216],64,4,12141,3.5814159292035397,0.0,0.0
3390,0,3390,[302 427 603  50 313],474,5,12146,3.5818342671778236,20.0,20.0
3391,0,3391,[  7 179 121 328 289],378,3,12149,3.5816627358490565,0.0,0.0
3392,0,3392,[302 427 603  50 313],454,5,12154,3.5820807544945477,20.0,20.0
3393,0,3393,[ 97 168 238 655 204],311,5,12159,3.5824985268120213,0.0,0.0
3394,0,3394,[238 222 403 228  79],339,4,12163,3.5826215022091312,0.0,0.0
3395,0,3395,[302 427 603  50 313],334,5,12168,3.5830388692579507,20.0,20.0
3396,0,3396,[302 427 603  50 313],474,5,12173,3.5834559905799233,20.0,20.0
3397,0,3397,[294 508 173 289  98],537,2,12175,3.5829899941141847,0.0,20.0
3398,0,3398,[194  69 496 174 180],10,5,12180,3.5834068843777582,0.0,20.0
3399,0,3399,[302 427 603  50 313],537,5,12185,3.583823529411765,20.0,20.0
3400,0,3400,[302 427 603  50 313],334,5,12190,3.58423992943252,20.0,20.0
3401,0,3401,[471   8  96 273 245],207,1,12191,3.583480305702528,0.0,0.0
3402,0,3402,[  7 228  89 222 174],234,0,12191,3.5824272700558333,0.0,20.0
3403,0,3403,[496 508 742  71 172],378,4,12195,3.5825499412455932,0.0,0.0
3404,0,3404,[302 427 603  50 313],454,5,12200,3.582966226138032,20.0,20.0
3405,0,3405,[435 216 742  50  88],506,5,12205,3.5833822665883734,0.0,20.0
3406,0,3406,[181 117 127 111 568],95,5,12210,3.5837980628118578,0.0,20.0
3407,0,3407,[302 427 603  50 313],537,5,12215,3.584213615023474,20.0,20.0
3408,0,3408,[515 435 318 151 471],666,4,12219,3.5843355822821943,20.0,0.0
3409,0,3409,[302 427 603  50 313],14,4,12223,3.584457478005865,20.0,20.0
3410,0,3410,[ 69  11 172 132   7],840,3,12226,3.584286133098798,0.0,0.0
3411,0,3411,[385 286 204 269 211],7,4,12230,3.5844079718640094,0.0,0.0
3412,0,3412,[ 64 423 180 273   9],144,5,12235,3.5848227365953704,0.0,0.0
3413,0,3413,[135 286 282 423 181],881,4,12239,3.5849443468072644,0.0,0.0
3414,0,3414,[302 427 603  50 313],271,5,12244,3.585358711566618,20.0,20.0
3415,0,3415,[235 186 286   1 143],13,1,12245,3.5846018735363,0.0,0.0
3416,0,3416,[132 200 211  56 222],60,5,12250,3.585016095990635,0.0,0.0
3417,0,3417,[174 175   4 179 196],379,5,12255,3.585430076067876,0.0,20.0
3418,0,3418,[302 427 603  50 313],454,5,12260,3.5858438139806963,20.0,20.0
3419,0,3419,[302 427 603  50 313],474,5,12265,3.5862573099415203,20.0,20.0
3420,0,3420,[196  22 202 515 179],311,4,12269,3.586378251973107,0.0,0.0
3421,0,3421,[186 405 197 435 546],804,3,12272,3.586206896551724,0.0,0.0
3422,0,3422,[118  97 405 210  22],897,5,12277,3.586619924043237,0.0,0.0
3423,0,3423,[238 357 127 161 183],234,3,12280,3.586448598130841,20.0,20.0
3424,0,3424,[302 427 603  50 313],669,5,12285,3.586861313868613,20.0,20.0
3425,0,3425,[302 427 603  50 313],537,5,12290,3.5872737886748394,20.0,20.0
3426,0,3426,[496 173 216 228  11],7,4,12294,3.5873942223519113,0.0,0.0
3427,0,3427,[117 258 173  12  25],271,2,12296,3.586931155192532,20.0,0.0
3428,0,3428,[405 568 196 173 423],455,4,12300,3.5870516185476817,0.0,0.0
3429,0,3429,[302 427 603  50 313],669,5,12305,3.587463556851312,20.0,20.0
3430,0,3430,[302 427 603  50 313],454,5,12310,3.5878752550276887,20.0,20.0
3431,0,3431,[182 127 471 603  88],308,4,12314,3.587995337995338,20.0,20.0
3432,0,3432,[333 289 357  25 197],387,1,12315,3.587241479755316,20.0,0.0
3433,0,3433,[302 427 603  50 313],334,5,12320,3.5876528829353522,20.0,20.0
3434,0,3434,[161 173 228  71  95],13,4,12324,3.587772925764192,0.0,0.0
3435,0,3435,[211  12  95  56  69],506,5,12329,3.5881839348079163,20.0,0.0
3436,0,3436,[323 187  11 597 168],13,2,12331,3.5877218504509747,0.0,0.0
3437,0,3437,[318  98   7 215 179],648,2,12333,3.587260034904014,20.0,20.0
3438,0,3438,[423 181 588 275   1],311,5,12338,3.5876708345449257,0.0,0.0
3439,0,3439,[302 427 603  50 313],474,5,12343,3.588081395348837,20.0,20.0
3440,0,3440,[181 187 196 117 265],311,5,12348,3.5884917175239757,0.0,0.0
3441,0,3441,[427 265 196 197 234],666,2,12350,3.588030214991284,0.0,0.0
3442,0,3442,[216 175 187 265 302],524,4,12354,3.588149869300029,0.0,0.0
3443,0,3443,[475  88 211 238 322],537,3,12357,3.587979094076655,0.0,0.0
3444,0,3444,[483 135 300 357 546],788,3,12360,3.5878084179970973,40.0,0.0
3445,0,3445,[302 427 603  50 313],669,5,12365,3.5882182240278584,20.0,20.0
3446,0,3446,[191  69 183 151   8],378,3,12368,3.5880475776037133,0.0,0.0
3447,0,3447,[328 197 153 111  28],95,5,12373,3.5884570765661254,0.0,0.0
3448,0,3448,[185  70 258 202 222],699,3,12376,3.5882864598434328,0.0,0.0
3449,0,3449,[  9 289 125 195 174],378,3,12379,3.5881159420289856,0.0,20.0
3450,0,3450,[302 427 603  50 313],334,5,12384,3.588525065198493,20.0,20.0
3451,0,3451,[282 288 258  22 195],479,4,12388,3.5886442641946696,0.0,0.0
3452,0,3452,[ 82 200   8 144 265],328,4,12392,3.5887633941500146,0.0,0.0
3453,0,3453,[435  56 294 172 175],125,3,12395,3.5885929357266937,0.0,0.0
3454,0,3454,[546 125 423  98 121],207,3,12398,3.5884225759768453,0.0,20.0
3455,0,3455,[302 427 603  50 313],334,5,12403,3.5888310185185186,20.0,20.0
3456,0,3456,[300 187  70 191 127],559,3,12406,3.5886606884582006,0.0,20.0
3457,0,3457,[181 588  64 194 265],263,4,12410,3.5887796414112203,0.0,0.0
3458,0,3458,[235 483  22 328 180],313,3,12413,3.5886094246892166,20.0,0.0
3459,0,3459,[238 118  95 385 286],479,2,12415,3.588150289017341,0.0,0.0
3460,0,3460,[153  70 186 174 385],234,0,12415,3.587113550996822,0.0,20.0
3461,0,3461,[111  79 197  50 318],653,3,12418,3.586943963027152,20.0,20.0
3462,0,3462,[ 12 182 237 222  96],406,3,12421,3.586774473000289,20.0,0.0
3463,0,3463,[302 427 603  50 313],13,5,12426,3.5871824480369514,20.0,20.0
3464,0,3464,[302 427 603  50 313],454,5,12431,3.5875901875901874,20.0,20.0
3465,0,3465,[210  71  64 215 333],387,1,12432,3.586843623773803,0.0,0.0
3466,0,3466,[ 88 403 191 185  25],313,2,12434,3.5863859244303433,0.0,0.0
3467,0,3467,[216 222 427 318 286],537,2,12436,3.5859284890426757,20.0,0.0
3468,0,3468,[153 265 211 403 286],194,2,12438,3.585471317382531,0.0,0.0
3469,0,3469,[357 127 121 423  88],184,3,12441,3.5853025936599425,20.0,20.0
3470,0,3470,[ 50 515 183 286 172],455,5,12446,3.585710169979833,0.0,20.0
3471,0,3471,[302 427 603  50 313],14,4,12450,3.5858294930875574,20.0,20.0
3472,0,3472,[302 427 603  50 313],334,5,12455,3.586236682983012,20.0,20.0
3473,0,3473,[234 300  89 568   9],64,3,12458,3.5860679332181924,0.0,0.0
3474,0,3474,[153 191  56 475  11],92,5,12463,3.5864748201438847,0.0,0.0
3475,0,3475,[568 204 435 357 427],328,2,12465,3.586018411967779,20.0,0.0
3476,0,3476,[302 603 427  50 313],454,5,12470,3.5864250790911707,20.0,20.0
3477,0,3477,[211 302 258   4 286],666,5,12475,3.5868315123634273,0.0,0.0
3478,0,3478,[302 603 427  50 313],454,5,12480,3.587237711986203,20.0,20.0
3479,0,3479,[176  22 333  50 588],881,3,12483,3.587068965517241,0.0,20.0
3480,0,3480,[211 202 435 748 568],883,4,12487,3.5871875897730536,0.0,0.0
3481,0,3481,[132 197 195 235 135],804,4,12491,3.587306145893165,0.0,0.0
3482,0,3482,[597 222 174 175 204],213,4,12495,3.5874246339362617,0.0,20.0
3483,0,3483,[196 210 301 161 151],334,2,12497,3.5869690011481055,0.0,0.0
3484,0,3484,[302 603 427  50 313],537,5,12502,3.587374461979914,20.0,20.0
3485,0,3485,[182 427 300  79 568],788,2,12504,3.586919104991394,0.0,0.0
3486,0,3486,[ 15 318  64 174   9],144,5,12509,3.5873243475767134,20.0,20.0
3487,0,3487,[  9 515 288 180 269],7,3,12512,3.5871559633027523,0.0,0.0
3488,0,3488,[210 173 183 222 176],666,3,12515,3.586987675551734,0.0,0.0
3489,0,3489,[435 125 265   9 183],298,3,12518,3.5868194842406877,0.0,0.0
3490,0,3490,[151 289   7 222 403],234,1,12519,3.586078487539387,0.0,0.0
3491,0,3491,[273 483  98  95 222],524,1,12520,3.5853379152348226,20.0,20.0
3492,0,3492,[183 483 427  12 423],60,5,12525,3.585742914400229,40.0,0.0
3493,0,3493,[302 603 427  50 313],14,4,12529,3.585861476817401,20.0,20.0
3494,0,3494,[117 173 269 195 161],339,2,12531,3.5854077253218883,0.0,0.0
3495,0,3495,[111  79 186 185  56],334,3,12534,3.5852402745995424,0.0,0.0
3496,0,3496,[302 603 427  50 313],334,5,12539,3.5856448384329425,20.0,20.0
3497,0,3497,[275 748 180 288 385],474,2,12541,3.5851915380217267,0.0,0.0
3498,0,3498,[100   9 423  79 185],6,3,12544,3.5850242926550444,0.0,20.0
3499,0,3499,[275  64 197 302 179],378,3,12547,3.584857142857143,0.0,0.0
3500,0,3500,[496 597  56 211 196],882,5,12552,3.5852613538988862,0.0,0.0
3501,0,3501,[286 655 202 211 475],479,3,12555,3.585094231867504,0.0,0.0
3502,0,3502,[302 603 427  50 313],454,5,12560,3.5854981444476164,20.0,20.0
3503,0,3503,[435 655  15   4   8],144,5,12565,3.5859018264840183,0.0,0.0
3504,0,3504,[ 15 238   1 568  11],308,4,12569,3.5860199714693297,0.0,0.0
3505,0,3505,[483 748   9 286 173],207,2,12571,3.585567598402738,20.0,0.0
3506,0,3506,[ 50 216  70 187 194],85,4,12575,3.585685771314514,0.0,20.0
3507,0,3507,[117 176  25 405 191],882,4,12579,3.5858038768529075,0.0,0.0
3508,0,3508,[237  97 508 483  28],533,3,12582,3.585636933599316,20.0,0.0
3509,0,3509,[655   4 143 588 186],13,4,12586,3.5857549857549857,0.0,0.0
3510,0,3510,[187 197   4 405 215],406,1,12587,3.58501851324409,0.0,0.0
3511,0,3511,[588 200 483  96 328],804,4,12591,3.5851366742596813,20.0,0.0
3512,0,3512,[181 117 172  70 173],194,1,12592,3.5844007970395673,0.0,0.0
3513,0,3513,[302 603 427  50 313],334,5,12597,3.5848036425725667,20.0,20.0
3514,0,3514,[302 603 427  50 313],454,5,12602,3.5852062588904694,20.0,20.0
3515,0,3515,[313 435 202 289 568],533,4,12606,3.5853242320819114,0.0,0.0
3516,0,3516,[ 64 328 276 234 568],13,3,12609,3.585157804947398,0.0,0.0
3517,0,3517,[181 276 234 202 179],406,4,12613,3.5852757248436613,0.0,0.0
3518,0,3518,[121 238 313 357 179],13,2,12615,3.584825234441603,20.0,0.0
3519,0,3519,[302 603 427  50 313],454,5,12620,3.585227272727273,20.0,20.0
3520,0,3520,[180 286 228 173  82],7,4,12624,3.5853450724226072,0.0,0.0
3521,0,3521,[302 603 427  50 313],474,5,12629,3.585746734809767,20.0,20.0
3522,0,3522,[180 245 282 568 265],533,2,12631,3.5852966221969913,0.0,0.0
3523,0,3523,[302 603 427  50 313],454,5,12636,3.5856980703745744,20.0,20.0
3524,0,3524,[135 423 181  89 132],843,2,12638,3.5852482269503545,0.0,0.0
3525,0,3525,[655 180 475 333  11],10,5,12643,3.585649461145774,0.0,0.0
3526,0,3526,[471 181 435 200 515],234,2,12645,3.5851998865891694,0.0,0.0
3527,0,3527,[135 196   8 318 271],334,4,12649,3.5853174603174605,20.0,0.0
3528,0,3528,[302 603 427  50 313],334,5,12654,3.5857183338056107,20.0,20.0
3529,0,3529,[302 603 427  50 313],669,5,12659,3.5861189801699718,20.0,20.0
3530,0,3530,[ 82  25 427 117 286],537,1,12660,3.5853865760407815,0.0,0.0
3531,0,3531,[ 96 196 153 515 151],95,5,12665,3.5857870894677237,0.0,0.0
3532,0,3532,[302 603 427  50 313],13,5,12670,3.586187376167563,20.0,20.0
3533,0,3533,[302 603 427  50 313],669,5,12675,3.5865874363327674,20.0,20.0
3534,0,3534,[174   7 144 655 127],666,3,12678,3.5864214992927863,0.0,40.0
3535,0,3535,[302  97 117 597 269],378,3,12681,3.586255656108597,0.0,0.0
3536,0,3536,[210 168 282 515 125],92,5,12686,3.5866553576477243,0.0,0.0
3537,0,3537,[175  82 228 333 132],815,3,12689,3.586489542114189,0.0,0.0
3538,0,3538,[186 197 173 117 496],95,5,12694,3.586888951681266,0.0,0.0
3539,0,3539,[301 125 196 288  50],378,2,12696,3.5864406779661016,0.0,20.0
3540,0,3540,[318   1 405 508 197],378,3,12699,3.5862750635413727,20.0,0.0
3541,0,3541,[302 603 427  50 313],334,5,12704,3.5866741953698473,20.0,20.0
3542,0,3542,[153 175  82 195  11],10,4,12708,3.5867908552074512,0.0,0.0
3543,0,3543,[168 318 100 151 132],7,5,12713,3.5871896162528216,20.0,20.0
3544,0,3544,[183  69 195 222 603],13,3,12716,3.587023977433004,20.0,0.0
3545,0,3545,[302 603 427  50 313],454,5,12721,3.5874224478285393,20.0,20.0
3546,0,3546,[195  95 515 191 300],313,4,12725,3.587538765153651,0.0,0.0
3547,0,3547,[ 64 300 742 271  98],144,3,12728,3.5873731679819616,0.0,20.0
3548,0,3548,[215  88 186 194 742],648,4,12732,3.5874894336432797,0.0,0.0
3549,0,3549,[546 282 588 151 196],298,3,12735,3.5873239436619717,0.0,0.0
3550,0,3550,[195 173  97 174 228],312,3,12738,3.5871585468882006,0.0,20.0
3551,0,3551,[121 125 238 202 194],313,4,12742,3.587274774774775,0.0,0.0
3552,0,3552,[216 568 176 195 282],643,4,12746,3.5873909372361386,0.0,0.0
3553,0,3553,[ 70 176  56 678 385],474,4,12750,3.587507034327518,0.0,0.0
3554,0,3554,[276  71 183 275  89],378,5,12755,3.587904360056259,0.0,0.0
3555,0,3555,[ 98 568  95  11 222],102,2,12757,3.5874578177727785,0.0,20.0
3556,0,3556,[204 186  82   8 180],882,5,12762,3.5878549339330896,0.0,0.0
3557,0,3557,[483 191 202 100 186],308,4,12766,3.587970770095559,20.0,20.0
3558,0,3558,[302 603 427  50 313],669,5,12771,3.5883675189660016,20.0,20.0
3559,0,3559,[286 258 132 313  50],378,5,12776,3.58876404494382,0.0,20.0
3560,0,3560,[302 603 427  50 313],14,4,12780,3.5888795282224093,20.0,20.0
3561,0,3561,[ 97 237  28 385 125],398,2,12782,3.588433464345873,0.0,0.0
3562,0,3562,[194 238 357  70 546],7,4,12786,3.5885489755823743,20.0,0.0
3563,0,3563,[302 603 427  50 313],334,5,12791,3.5889450056116723,20.0,20.0
3564,0,3564,[357  56 200 403   4],648,1,12792,3.588218793828892,20.0,0.0
3565,0,3565,[302 603 427  50 313],334,5,12797,3.58861469433539,20.0,20.0
3566,0,3566,[186 238  69  50 200],643,2,12799,3.588169329969162,0.0,20.0
3567,0,3567,[483 176  11 168  25],339,5,12804,3.5885650224215246,20.0,0.0
3568,0,3568,[196 173 265 194  11],64,5,12809,3.588960493135332,0.0,0.0
3569,0,3569,[302 603 427  50 313],474,5,12814,3.589355742296919,20.0,20.0
3570,0,3570,[202 288  89 568 187],830,3,12817,3.589190702884346,0.0,0.0
3571,0,3571,[302 603 427  50 313],474,5,12822,3.589585666293393,20.0,20.0
3572,0,3572,[302 603 427  50 313],454,5,12827,3.589980408620207,20.0,20.0
3573,0,3573,[ 82 515  50 132 294],882,5,12832,3.5903749300503636,0.0,20.0
3574,0,3574,[168   1 180 111 385],653,3,12835,3.5902097902097903,0.0,0.0
3575,0,3575,[302 603 427  50 313],669,5,12840,3.5906040268456376,20.0,20.0
3576,0,3576,[202  28 132 144   4],343,5,12845,3.5909980430528377,0.0,0.0
3577,0,3577,[300 151  56 117 333],533,3,12848,3.590832867523756,0.0,0.0
3578,0,3578,[302 603 427  50 313],14,4,12852,3.5909471919530596,20.0,20.0
3579,0,3579,[197  97 222 546 215],194,1,12853,3.590223463687151,0.0,0.0
3580,0,3580,[300 318 265  79 301],666,2,12855,3.5897793912314997,20.0,0.0
3581,0,3581,[180 172 204 403 568],881,4,12859,3.589893914014517,0.0,0.0
3582,0,3582,[ 97  22  88  64 117],653,3,12862,3.5897292771420597,0.0,0.0
3583,0,3583,[181 483 125 333 204],533,5,12867,3.590122767857143,20.0,0.0
3584,0,3584,[ 64 191  56 176 515],474,5,12872,3.5905160390516038,0.0,0.0
3585,0,3585,[ 50 271  71  15 385],290,4,12876,3.5906302286670386,0.0,20.0
3586,0,3586,[ 89  64 268 228 588],85,3,12879,3.5904655701143016,0.0,0.0
3587,0,3587,[117 234 180 100 245],90,3,12882,3.5903010033444818,0.0,20.0
3588,0,3588,[357   4  96 275  82],308,5,12887,3.590693786570075,20.0,0.0
3589,0,3589,[195 313  89 117 191],454,3,12890,3.5905292479108635,0.0,0.0
3590,0,3590,[191 176 603 475 435],64,4,12894,3.590643274853801,20.0,0.0
3591,0,3591,[276 196 333 265 183],881,4,12898,3.59075723830735,0.0,0.0
3592,0,3592,[ 98 302 200 182 423],6,3,12901,3.590592819370999,0.0,20.0
3593,0,3593,[289 475 318 403 597],533,1,12902,3.5898720089037286,20.0,0.0
3594,0,3594,[125 197  69 216 196],881,2,12904,3.5894297635605006,0.0,0.0
3595,0,3595,[182 475 273 210 211],308,4,12908,3.589543937708565,0.0,0.0
3596,0,3596,[  7  71 135 403 161],378,4,12912,3.5896580483736447,0.0,0.0
3597,0,3597,[302 603 427  50 313],334,5,12917,3.5900500277932186,20.0,20.0
3598,0,3598,[216 245   7 121 222],554,2,12919,3.5896082245068075,0.0,0.0
3599,0,3599,[ 69 181 172 195 210],406,5,12924,3.59,0.0,0.0
3600,0,3600,[ 56 328 318 286   9],85,4,12928,3.590113857261872,20.0,0.0
3601,0,3601,[186 435 179   1 568],210,4,12932,3.5902276513048306,0.0,0.0
3602,0,3602,[323 118 678   1 333],141,4,12936,3.5903413821815153,0.0,0.0
3603,0,3603,[ 11 286 275 357 191],7,4,12940,3.5904550499445063,20.0,0.0
3604,0,3604,[ 15  98  82 508 385],207,3,12943,3.5902912621359224,0.0,20.0
3605,0,3605,[228  70 318 153 385],7,4,12947,3.5904048807542983,20.0,0.0
3606,0,3606,[211 655 186 286 282],207,4,12951,3.590518436373718,0.0,0.0
3607,0,3607,[357 191 222 328 135],749,4,12955,3.5906319290465634,20.0,0.0
3608,0,3608,[121 333 423 210  50],666,0,12955,3.5896370185646993,0.0,20.0
3609,0,3609,[302 603 427  50 313],334,5,12960,3.590027700831025,20.0,20.0
3610,0,3610,[ 28 238 423 228 313],59,5,12965,3.590418166712822,0.0,0.0
3611,0,3611,[ 69  22 742 185 597],804,4,12969,3.590531561461794,0.0,0.0
3612,0,3612,[496 172 405 143 268],643,4,12973,3.5906448934403543,0.0,0.0
3613,0,3613,[508 168 385 197  50],13,3,12976,3.590481460985058,0.0,20.0
3614,0,3614,[ 96 144   8 176 275],95,3,12979,3.5903181189488245,0.0,0.0
3615,0,3615,[302 603 427  50 313],14,4,12983,3.5904314159292037,20.0,20.0
3616,0,3616,[238 135 175  82  56],537,4,12987,3.5905446502626486,0.0,0.0
3617,0,3617,[302 603 427  50 313],537,5,12992,3.5909342177998895,20.0,20.0
3618,0,3618,[302 603 427  50 313],13,5,12997,3.591323570046974,20.0,20.0
3619,0,3619,[302 603 427  50 313],454,5,13002,3.5917127071823205,20.0,20.0
3620,0,3620,[176 405  97 191 174],271,3,13005,3.591549295774648,0.0,20.0
3621,0,3621,[151 196 211 185 117],650,3,13008,3.591385974599669,0.0,0.0
3622,0,3622,[588  89 195 597 546],13,2,13010,3.5909467292299198,0.0,0.0
3623,0,3623,[302 603 427  50 313],474,5,13015,3.5913355408388523,20.0,20.0
3624,0,3624,[196 180 333 546 748],653,3,13018,3.5911724137931036,0.0,0.0
3625,0,3625,[144 100  97 194 357],13,4,13022,3.591285162713734,20.0,20.0
3626,0,3626,[200 286 403 176  97],60,3,13025,3.591122139509236,0.0,0.0
3627,0,3627,[301 182 275 172 515],85,4,13029,3.591234840132304,0.0,0.0
3628,0,3628,[ 97  89 216 403  22],479,2,13031,3.5907963626343347,0.0,0.0
3629,0,3629,[588 200 271 603  89],650,3,13034,3.590633608815427,20.0,0.0
3630,0,3630,[  4 357 187  50 175],833,3,13037,3.590470944643349,20.0,20.0
3631,0,3631,[471 603 333 174  69],666,2,13039,3.5900330396475773,20.0,20.0
3632,0,3632,[ 11 294 275 186 276],271,3,13042,3.589870630333058,0.0,0.0
3633,0,3633,[ 22 187   9 237 100],328,5,13047,3.5902586681342874,0.0,20.0
3634,0,3634,[302 603 427  50 313],271,5,13052,3.590646492434663,20.0,20.0
3635,0,3635,[357 228 323 322 655],788,2,13054,3.59020902090209,20.0,0.0
3636,0,3636,[135   9 286 179 405],13,1,13055,3.5894968380533405,0.0,0.0
3637,0,3637,[273  98  22  88  70],207,2,13057,3.5890599230346343,0.0,20.0
3638,0,3638,[294 144  50  56 100],308,3,13060,3.588898048914537,0.0,40.0
3639,0,3639,[302 603 427  50 313],13,5,13065,3.5892857142857144,20.0,20.0
3640,0,3640,[588  82  28  97 318],13,3,13068,3.5891238670694863,20.0,0.0
3641,0,3641,[405  97  95 196 385],455,3,13071,3.588962108731466,0.0,0.0
3642,0,3642,[186 300 475 271 323],537,2,13073,3.5885259401592093,0.0,0.0
3643,0,3643,[257 215 186 234 385],378,4,13077,3.5886388583973656,0.0,0.0
3644,0,3644,[211  97  50 289 275],474,3,13080,3.588477366255144,0.0,20.0
3645,0,3645,[245 435  15 222  95],455,2,13082,3.5880416895227647,0.0,0.0
3646,0,3646,[  4 194 742 117  71],308,4,13086,3.588154647655607,0.0,0.0
3647,0,3647,[302 603 427  50 313],474,5,13091,3.5885416666666665,20.0,20.0
3648,0,3648,[322 276 286   8 258],334,4,13095,3.5886544258701014,0.0,0.0
3649,0,3649,[471 127 210 151 118],7,4,13099,3.5887671232876714,0.0,20.0
3650,0,3650,[302 603 427  50 313],271,5,13104,3.589153656532457,20.0,20.0
3651,0,3651,[597  89 269 301   4],650,2,13106,3.5887185104052572,0.0,0.0
3652,0,3652,[302 603 427  50 313],14,4,13110,3.588831097727895,20.0,20.0
3653,0,3653,[302 603 427  50 313],14,4,13114,3.588943623426382,20.0,20.0
3654,0,3654,[471  56 204  28 196],455,5,13119,3.589329685362517,0.0,0.0
3655,0,3655,[186  56 748 300 127],328,4,13123,3.5894420131291027,0.0,20.0
3656,0,3656,[143 215 135 423  96],815,4,13127,3.5895542794640414,0.0,0.0
3657,0,3657,[168 197 196 135 435],343,5,13132,3.5899398578458173,0.0,0.0
3658,0,3658,[568 216  70 423 121],85,2,13134,3.589505329324952,0.0,0.0
3659,0,3659,[180 471 475 235 405],648,3,13137,3.589344262295082,0.0,0.0
3660,0,3660,[568 483  82 318 215],85,3,13140,3.589183283255941,40.0,0.0
3661,0,3661,[302 603 427  50 313],474,5,13145,3.589568541780448,20.0,20.0
3662,0,3662,[100  50  95 117  22],263,4,13149,3.5896805896805897,0.0,40.0
3663,0,3663,[288 276  82 144 195],234,0,13149,3.5887008733624453,0.0,0.0
3664,0,3664,[357 289 234 135 191],85,4,13153,3.5888130968622103,20.0,0.0
3665,0,3665,[180 288 204   7 655],339,3,13156,3.5886524822695036,0.0,0.0
3666,0,3666,[182 597 235 125   8],897,3,13159,3.588491955276793,0.0,0.0
3667,0,3667,[180   4 187 568 176],650,1,13160,3.5877862595419847,0.0,0.0
3668,0,3668,[ 89  95 215 111 302],271,4,13164,3.58789860997547,0.0,0.0
3669,0,3669,[180  11  82 265 151],59,5,13169,3.588283378746594,0.0,0.0
3670,0,3670,[174 175   1 135 100],892,5,13174,3.5886679378915827,0.0,40.0
3671,0,3671,[568 197 588 180 323],59,4,13178,3.588779956427015,0.0,0.0
3672,0,3672,[357  22 174   7 125],804,5,13183,3.5891641709774027,20.0,20.0
3673,0,3673,[  1 496 228 111 168],234,1,13184,3.58845944474687,0.0,0.0
3674,0,3674,[118 357  88  89 234],311,4,13188,3.5885714285714285,20.0,0.0
3675,0,3675,[302 603 427  50 313],669,5,13193,3.588955386289445,20.0,20.0
3676,0,3676,[200 151 475  12 186],474,3,13196,3.5887952134892576,20.0,0.0
3677,0,3677,[302 603 427  50 313],13,5,13201,3.589178901576944,20.0,20.0
3678,0,3678,[ 96 568 289  69  22],455,4,13205,3.5892905680891545,0.0,0.0
3679,0,3679,[183 185 174 275  98],883,4,13209,3.5894021739130433,0.0,40.0
3680,0,3680,[197 603 172 742 179],666,3,13212,3.589242053789731,20.0,0.0
3681,0,3681,[302 603 427  50 313],537,5,13217,3.589625203693645,20.0,20.0
3682,0,3682,[168  82 603 143  12],524,1,13218,3.5889220743958727,40.0,0.0
3683,0,3683,[302 427 603  50 313],669,5,13223,3.5893051031487513,20.0,20.0
3684,0,3684,[ 79 180 135 216 238],234,1,13224,3.5886024423337854,0.0,0.0
3685,0,3685,[ 82 172  98 265 322],488,3,13227,3.588442756375475,0.0,20.0
3686,0,3686,[748  89 176 186 222],92,4,13231,3.58855438025495,0.0,0.0
3687,0,3687,[273  79 294 300 117],548,4,13235,3.588665943600868,0.0,0.0
3688,0,3688,[597  25 313 185  15],308,2,13237,3.588235294117647,0.0,0.0
3689,0,3689,[ 71  79 168 435 197],650,3,13240,3.5880758807588076,0.0,0.0
3690,0,3690,[302 427 179  69 187],458,4,13244,3.5881874830669194,0.0,0.0
3691,0,3691,[496 423 234 483 117],458,3,13247,3.5880281690140845,20.0,0.0
3692,0,3692,[ 25 318 197 185  12],537,3,13250,3.5878689412401843,40.0,0.0
3693,0,3693,[302 427 603  50 313],14,4,13254,3.5879805089334056,20.0,20.0
3694,0,3694,[ 12  25 403 176 174],13,2,13256,3.587550744248985,20.0,20.0
3695,0,3695,[508 435 282 234 132],643,4,13260,3.5876623376623376,0.0,0.0
3696,0,3696,[186 202 118 168  79],666,2,13262,3.587232891533676,0.0,0.0
3697,0,3697,[ 15 471 237  64 200],474,3,13265,3.5870740941049215,0.0,0.0
3698,0,3698,[405 568 202 176 117],533,3,13268,3.5869153825358207,0.0,0.0
3699,0,3699,[175 194  12 168  22],339,5,13273,3.5872972972972974,20.0,0.0
3700,0,3700,[100 183 117 222 202],406,3,13276,3.587138611186166,0.0,20.0
3701,0,3701,[ 98 173  88 172  95],749,4,13280,3.5872501350621286,0.0,20.0
3702,0,3702,[294 215  70 234 186],7,3,13283,3.587091547394005,0.0,0.0
3703,0,3703,[302 427 603  50 313],334,5,13288,3.587473002159827,20.0,20.0
3704,0,3704,[302 427 603  50 313],474,5,13293,3.587854251012146,20.0,20.0
3705,0,3705,[546  50 180 196  71],308,3,13296,3.5876956287101995,0.0,20.0
3706,0,3706,[121 405 228 186 180],95,3,13299,3.5875370919881306,0.0,0.0
3707,0,3707,[ 88 161 195 168 385],379,2,13301,3.587108953613808,0.0,0.0
3708,0,3708,[603  71   7 195 151],59,4,13305,3.5872202750067403,20.0,0.0
3709,0,3709,[302 427 603  50 313],669,5,13310,3.5876010781671157,20.0,20.0
3710,0,3710,[302 427 603  50 313],334,5,13315,3.587981676098087,20.0,20.0
3711,0,3711,[210 132 234  28  88],897,5,13320,3.5883620689655173,0.0,0.0
3712,0,3712,[161 210 125 183  89],313,4,13324,3.5884729329383247,0.0,0.0
3713,0,3713,[302 427 603  50 313],537,5,13329,3.5888529886914378,20.0,20.0
3714,0,3714,[111 179 186 183 228],92,4,13333,3.588963660834455,0.0,0.0
3715,0,3715,[202 323 111 121 185],537,1,13334,3.5882669537136707,0.0,0.0
3716,0,3716,[118  95 403  69 125],892,4,13338,3.5883777239709445,0.0,0.0
3717,0,3717,[302 427 603  50 313],14,4,13342,3.5884884346422807,20.0,20.0
3718,0,3718,[237 238  28 475 185],13,2,13344,3.588061306802904,0.0,0.0
3719,0,3719,[302 427 603  50 313],271,5,13349,3.5884408602150537,20.0,20.0
3720,0,3720,[302 427 603  50 313],669,5,13354,3.5888202096210695,20.0,20.0
3721,0,3721,[546  11 471 204 100],158,4,13358,3.588930682428802,0.0,20.0
3722,0,3722,[173 172 257 423 546],666,2,13360,3.5885038947085683,0.0,0.0
3723,0,3723,[302 427 603  50 313],537,5,13365,3.5888829215896885,20.0,20.0
3724,0,3724,[ 71  98 183 655 153],64,3,13368,3.588724832214765,0.0,20.0
3725,0,3725,[182   1 294 318 508],92,3,13371,3.5885668276972624,20.0,0.0
3726,0,3726,[195 179 132 435 228],234,1,13372,3.587872283337805,0.0,0.0
3727,0,3727,[302 427 603  50 313],13,5,13377,3.5882510729613735,20.0,20.0
3728,0,3728,[196 111 475 143 210],479,3,13380,3.5880933226065967,0.0,0.0
3729,0,3729,[  8 288 333 121 234],13,3,13383,3.587935656836461,0.0,0.0
3730,0,3730,[265 204  28 202 333],815,4,13387,3.5880461002412223,0.0,0.0
3731,0,3731,[588  56  96  89 289],13,4,13391,3.5881564844587355,0.0,0.0
3732,0,3732,[121 202 143 200  89],92,2,13393,3.5877310474149477,0.0,0.0
3733,0,3733,[ 70 175 118 161 179],378,4,13397,3.5878414568826997,0.0,0.0
3734,0,3734,[302 427 603  50 313],14,4,13401,3.5879518072289156,20.0,20.0
3735,0,3735,[302 427 603  50 313],537,5,13406,3.5883297644539613,20.0,20.0
3736,0,3736,[ 79   1 100   7 357],387,5,13411,3.5887075194005886,20.0,20.0
3737,0,3737,[183 194 161 423 125],295,4,13415,3.588817549491707,0.0,0.0
3738,0,3738,[196 117 202 181 185],194,1,13416,3.588125167156994,0.0,0.0
3739,0,3739,[302 427 603  50 313],14,4,13420,3.588235294117647,20.0,20.0
3740,0,3740,[172 276  56 322 204],881,4,13424,3.58834536220262,0.0,0.0
3741,0,3741,[302 427 603  50 191],334,5,13429,3.5887226082308925,20.0,20.0
3742,0,3742,[143 179  64  89 245],378,3,13432,3.5885653219342775,0.0,0.0
3743,0,3743,[302 427 603  50 191],666,4,13436,3.588675213675214,20.0,20.0
3744,0,3744,[ 28 357 515 265 215],343,4,13440,3.588785046728972,20.0,0.0
3745,0,3745,[427  15 294 100   8],194,4,13444,3.588894821142552,0.0,20.0
3746,0,3746,[ 96 588 194  70 210],7,4,13448,3.5890045369629036,0.0,0.0
3747,0,3747,[  8 181 483 185 180],326,4,13452,3.5891141942369265,20.0,0.0
3748,0,3748,[121 301 172  97 135],145,4,13456,3.58922379301147,0.0,0.0
3749,0,3749,[196  82 144 121 333],13,3,13459,3.5890666666666666,0.0,0.0
3750,0,3750,[125 405 237 597 258],141,4,13463,3.589176219674753,0.0,0.0
3751,0,3751,[ 70 173 403  97 182],59,4,13467,3.5892857142857144,0.0,0.0
3752,0,3752,[302 427 603  50 191],13,4,13471,3.58939515054623,20.0,20.0
3753,0,3753,[302 427 603  50 313],14,4,13475,3.58950452850293,20.0,20.0
3754,0,3754,[302 427 603  50  64],537,4,13479,3.5896138482023967,20.0,20.0
3755,0,3755,[183 405 181 174 655],295,4,13483,3.589723109691161,0.0,20.0
3756,0,3756,[302 427 603  50 313],537,5,13488,3.590098482832047,20.0,20.0
3757,0,3757,[200  82 127 181 265],897,3,13491,3.5899414582224587,0.0,20.0
3758,0,3758,[200  89   9 603 568],543,4,13495,3.590050545357808,20.0,0.0
3759,0,3759,[202 302 181 187  56],48,4,13499,3.590159574468085,0.0,0.0
3760,0,3760,[ 15 100 111 222 405],84,4,13503,3.5902685455995744,0.0,20.0
3761,0,3761,[  1 258 135 175 186],378,3,13506,3.5901116427432216,0.0,0.0
3762,0,3762,[302 427 603  50 313],13,5,13511,3.5904863141110814,20.0,20.0
3763,0,3763,[475 245 121 655 144],119,5,13516,3.5908607863974495,0.0,0.0
3764,0,3764,[182 174  98 286 202],13,4,13520,3.590969455511288,0.0,40.0
3765,0,3765,[ 56 172  11 153 197],184,2,13522,3.5905469994689327,0.0,0.0
3766,0,3766,[153 175 179 200 186],843,2,13524,3.590124767719671,0.0,0.0
3767,0,3767,[235 496 196 174 357],343,5,13529,3.590498938428875,20.0,20.0
3768,0,3768,[302 427 603  50 313],13,5,13534,3.5908729105863624,20.0,20.0
3769,0,3769,[117 275 301   4 294],13,1,13535,3.590185676392573,0.0,0.0
3770,0,3770,[748  50 588 237 288],64,4,13539,3.590294351630867,0.0,20.0
3771,0,3771,[302 427 603  50 313],13,5,13544,3.5906680805938493,20.0,20.0
3772,0,3772,[186 235  88 182 183],897,4,13548,3.590776570368407,0.0,0.0
3773,0,3773,[168 191 121  98  70],85,4,13552,3.5908850026497086,0.0,20.0
3774,0,3774,[302  12 435 121 597],13,4,13556,3.5909933774834437,20.0,0.0
3775,0,3775,[ 50 118 132 655 427],194,2,13558,3.590572033898305,0.0,20.0
3776,0,3776,[289 121 435  11 204],378,4,13562,3.5906804342070426,0.0,0.0
3777,0,3777,[ 12  25 216 173 172],59,5,13567,3.5910534674430914,20.0,0.0
3778,0,3778,[302 427 603  50 313],14,4,13571,3.5911616829849167,20.0,20.0
3779,0,3779,[302 427 603  50 127],664,5,13576,3.5915343915343914,20.0,40.0
3780,0,3780,[294  22 215 318 508],605,4,13580,3.5916424226395134,20.0,0.0
3781,0,3781,[182 135 194 143 237],13,4,13584,3.5917503966155473,0.0,0.0
3782,0,3782,[302 427 603  50 127],334,5,13589,3.592122653978324,20.0,40.0
3783,0,3783,[302 427 603  50 127],537,5,13594,3.5924947145877377,20.0,40.0
3784,0,3784,[ 89 289 117 276 568],92,3,13597,3.592338177014531,0.0,0.0
3785,0,3785,[427  64 204 483  79],833,1,13598,3.5916534601162176,20.0,0.0
3786,0,3786,[742  97 210 568 176],533,3,13601,3.5914972273567467,0.0,0.0
3787,0,3787,[273  79   4 195 333],328,1,13602,3.5908130939809926,0.0,0.0
3788,0,3788,[186 174 151 483 211],298,4,13606,3.590921087358142,20.0,20.0
3789,0,3789,[ 56   1  95  79 258],271,2,13608,3.5905013192612136,0.0,0.0
3790,0,3790,[222 216 483 185 257],374,3,13611,3.5903455552624637,20.0,0.0
3791,0,3791,[302 603 427  50 127],745,3,13614,3.5901898734177213,20.0,40.0
3792,0,3792,[196  82   8  25 235],398,3,13617,3.590034273662009,0.0,0.0
3793,0,3793,[ 22 153 117 143 182],339,4,13621,3.5901423299947286,0.0,0.0
3794,0,3794,[181 286   9 318 748],488,4,13625,3.590250329380764,20.0,0.0
3795,0,3795,[603 202 180 328 117],749,5,13630,3.590621707060063,20.0,0.0
3796,0,3796,[ 22 202 196 269 174],207,3,13633,3.5904661574927577,0.0,20.0
3797,0,3797,[ 71 144   1  89 153],374,4,13637,3.5905739863085833,0.0,0.0
3798,0,3798,[161 186 196 121 127],774,1,13638,3.5898920768623324,0.0,20.0
3799,0,3799,[276 405 143  15 180],605,3,13641,3.589736842105263,0.0,0.0
3800,0,3800,[ 28 405 175 127  70],6,2,13643,3.589318600368324,0.0,20.0
3801,0,3801,[  7  98 435  96 196],379,5,13648,3.5896896370331404,0.0,20.0
3802,0,3802,[302 603 427  50 313],334,5,13653,3.5900604785695505,20.0,20.0
3803,0,3803,[302 603 427  50 313],669,5,13658,3.5904311251314405,20.0,20.0
3804,0,3804,[568  82 135 423 216],749,5,13663,3.5908015768725363,0.0,0.0
3805,0,3805,[302 603 427  50 313],271,5,13668,3.5911718339464005,20.0,20.0
3806,0,3806,[302 603 427  50 313],334,5,13673,3.5915418965064356,20.0,20.0
3807,0,3807,[496 182 515 318 195],313,5,13678,3.5919117647058822,20.0,0.0
3808,0,3808,[302 603 427  50 313],334,5,13683,3.592281438697821,20.0,20.0
3809,0,3809,[357  28 385 405 423],537,1,13684,3.5916010498687663,20.0,0.0
3810,0,3810,[496 265 405 195 117],533,3,13687,3.591445814746786,0.0,0.0
3811,0,3811,[302 603 427  50 313],271,5,13692,3.591815320041973,20.0,20.0
3812,0,3812,[588 111 357 182 127],479,4,13696,3.5919223708366115,20.0,20.0
3813,0,3813,[357  25 197  56 191],387,3,13699,3.591767173571054,20.0,0.0
3814,0,3814,[ 98 245 111 211 200],666,3,13702,3.5916120576671036,0.0,20.0
3815,0,3815,[151 385  89 423 655],738,4,13706,3.591719077568134,0.0,0.0
3816,0,3816,[200  69 187 265 180],339,4,13710,3.5918260413937646,0.0,0.0
3817,0,3817,[ 15 237 405 204  12],271,3,13713,3.5916710319539025,20.0,0.0
3818,0,3818,[ 64 153 180  50 175],308,5,13718,3.5920398009950247,0.0,20.0
3819,0,3819,[204  22 210   1 237],406,3,13721,3.5918848167539266,0.0,0.0
3820,0,3820,[237 173 127   8 176],474,5,13726,3.592253336822821,0.0,20.0
3821,0,3821,[ 12   8 323   9 245],455,2,13728,3.5918367346938775,20.0,0.0
3822,0,3822,[302 603 427  50 313],537,5,13733,3.5922050745487835,20.0,20.0
3823,0,3823,[496  95 187  69 202],59,4,13737,3.5923117154811717,0.0,0.0
3824,0,3824,[302 603 427  50 313],474,5,13742,3.5926797385620914,20.0,20.0
3825,0,3825,[183 322  15 405  28],881,4,13746,3.5927861996863566,0.0,0.0
3826,0,3826,[194 195 475  88 117],474,5,13751,3.5931539064541416,0.0,0.0
3827,0,3827,[302 603 427  50 313],537,5,13756,3.593521421107628,20.0,20.0
3828,0,3828,[204 265 234 508  79],455,5,13761,3.593888743797336,0.0,0.0
3829,0,3829,[568 183 275  88  28],538,2,13763,3.593472584856397,0.0,0.0
3830,0,3830,[191  56 235 125   9],144,4,13767,3.5935787000783086,0.0,0.0
3831,0,3831,[302 603 427  50 313],271,5,13772,3.593945720250522,20.0,20.0
3832,0,3832,[655 357 168 197  15],194,5,13777,3.5943125489172973,20.0,0.0
3833,0,3833,[302 603 427  50 313],334,5,13782,3.594679186228482,20.0,20.0
3834,0,3834,[258 118 196 427  25],59,4,13786,3.5947848761408085,0.0,0.0
3835,0,3835,[258 172  56 216  69],488,3,13789,3.5946298227320126,0.0,0.0
3836,0,3836,[216 125 143 179 195],194,1,13790,3.593953609590826,0.0,0.0
3837,0,3837,[ 89 435  70 173 222],666,4,13794,3.594059405940594,0.0,0.0
3838,0,3838,[ 50 161 200 143 222],313,2,13796,3.593644178171399,0.0,20.0
3839,0,3839,[ 22  50   7  96 211],883,4,13800,3.59375,0.0,20.0
3840,0,3840,[ 70 182  98 180 191],308,4,13804,3.593855766727415,0.0,20.0
3841,0,3841,[302 603 427  50 313],334,5,13809,3.59422175950026,20.0,20.0
3842,0,3842,[222 423 597 210 186],374,4,13813,3.594327348425709,0.0,0.0
3843,0,3843,[435 196 175 127 475],339,5,13818,3.5946930280957337,0.0,20.0
3844,0,3844,[ 50 546 202 194 265],194,2,13820,3.5942782834850453,0.0,20.0
3845,0,3845,[265  89  28   9   7],881,4,13824,3.594383775351014,0.0,0.0
3846,0,3846,[265 185 328 742  70],271,2,13826,3.593969326748115,0.0,0.0
3847,0,3847,[302 603 427  50 313],669,5,13831,3.5943347193347193,20.0,20.0
3848,0,3848,[ 82 125 273 603   1],234,1,13832,3.5936606910885946,20.0,0.0
3849,0,3849,[125 216 194  71  79],313,4,13836,3.593766233766234,0.0,0.0
3850,0,3850,[ 56  71 496 385 200],234,2,13838,3.5933523760062323,0.0,0.0
3851,0,3851,[302 603 427  50 313],13,5,13843,3.5937175493250257,20.0,20.0
3852,0,3852,[172 181 191 197 202],313,5,13848,3.5940825330910977,0.0,0.0
3853,0,3853,[144  11 328  50  69],92,4,13852,3.5941878567721846,0.0,20.0
3854,0,3854,[187 423 655 313 194],328,4,13856,3.5942931258106356,0.0,0.0
3855,0,3855,[127 187 275 597 191],605,4,13860,3.5943983402489628,0.0,20.0
3856,0,3856,[302 603 427  50 191],13,4,13864,3.5945035001296346,20.0,20.0
3857,0,3857,[302 603 427  50 313],474,5,13869,3.5948678071539657,20.0,20.0
3858,0,3858,[ 56  96 118 183 179],308,4,13873,3.594972790878466,0.0,0.0
3859,0,3859,[403 282  64   1 271],92,4,13877,3.5950777202072537,0.0,0.0
3860,0,3860,[ 71 322 275 471 271],328,2,13879,3.5946645946645948,0.0,0.0
3861,0,3861,[302 603 427  50 313],474,5,13884,3.595028482651476,20.0,20.0
3862,0,3862,[302 603 427  50 313],537,5,13889,3.595392182241781,20.0,20.0
3863,0,3863,[318 153 175 276 151],378,4,13893,3.595496894409938,20.0,0.0
3864,0,3864,[ 82  64  56 268  98],7,3,13896,3.5953428201811124,0.0,20.0
3865,0,3865,[302 603 427  50 313],334,5,13901,3.5957061562338333,20.0,20.0
3866,0,3866,[176 175 286 228  95],881,2,13903,3.595293509180243,0.0,0.0
3867,0,3867,[302 603 427  50 313],13,5,13908,3.595656670113754,20.0,20.0
3868,0,3868,[ 70 111 286 153 237],452,3,13911,3.5955027138795552,0.0,0.0
3869,0,3869,[265   4 118  64 132],881,3,13914,3.5953488372093023,0.0,0.0
3870,0,3870,[196 176  11 197 180],653,1,13915,3.594678377680186,0.0,0.0
3871,0,3871,[234 194 328   1 215],788,2,13917,3.59426652892562,0.0,0.0
3872,0,3872,[302 603 427  50 313],537,5,13922,3.594629486186419,20.0,20.0
3873,0,3873,[202  56 546 161  28],313,3,13925,3.5944759938048527,0.0,0.0
3874,0,3874,[678 216  25  22 286],648,2,13927,3.5940645161290323,0.0,0.0
3875,0,3875,[216  70 200  98   7],59,4,13931,3.5941692466460267,0.0,20.0
3876,0,3876,[182 385 318 173 135],92,3,13934,3.5940159917461956,20.0,0.0
3877,0,3877,[288  15 132 235   1],378,4,13938,3.59412068076328,0.0,0.0
3878,0,3878,[313   9 216 180  98],271,5,13943,3.594483114204692,0.0,20.0
3879,0,3879,[127 143 265 100 132],524,4,13947,3.5945876288659795,0.0,40.0
3880,0,3880,[265 144 161 215 180],648,2,13949,3.5941767585673796,0.0,0.0
3881,0,3881,[302 603 427  50 313],474,5,13954,3.594538897475528,20.0,20.0
3882,0,3882,[496 172  97 215 238],271,5,13959,3.594900849858357,0.0,0.0
3883,0,3883,[ 98 144 132  25 313],13,4,13963,3.595005149330587,0.0,20.0
3884,0,3884,[235  88 117 423 179],897,2,13965,3.5945945945945947,0.0,0.0
3885,0,3885,[302 603 427  50 313],537,5,13970,3.5949562532166754,20.0,20.0
3886,0,3886,[302 603 427  50 313],454,5,13975,3.5953177257525084,20.0,20.0
3887,0,3887,[191  56 357 196 100],537,4,13979,3.5954218106995883,20.0,20.0
3888,0,3888,[196 135 197 286  64],90,5,13984,3.5957829776292107,0.0,0.0
3889,0,3889,[302 603 427  50 313],669,5,13989,3.5961439588688946,20.0,20.0
3890,0,3890,[302 603 427  50 313],669,5,13994,3.5965047545618094,20.0,20.0
3891,0,3891,[ 95  70  15 655  12],234,0,13994,3.5955806783144912,20.0,0.0
3892,0,3892,[111 183 655 322 483],334,3,13997,3.595427690726946,20.0,0.0
3893,0,3893,[286 127 258 222 194],213,3,14000,3.5952747817154598,0.0,20.0
3894,0,3894,[222 288   7   8  89],387,4,14004,3.5953786906290115,0.0,0.0
3895,0,3895,[302 603 427  50 313],334,5,14009,3.5957392197125255,20.0,20.0
3896,0,3896,[515 357 300 200 211],843,0,14009,3.594816525532461,20.0,0.0
3897,0,3897,[187  11  96 568 237],59,4,14013,3.594920472036942,0.0,0.0
3898,0,3898,[300  96 118 197 117],311,4,14017,3.595024365221852,0.0,0.0
3899,0,3899,[655 405 216 322 215],92,2,14019,3.5946153846153845,0.0,0.0
3900,0,3900,[357  28 385  15 202],694,5,14024,3.594975647269931,20.0,0.0
3901,0,3901,[ 11 117  25 300 258],13,1,14025,3.594310609943619,0.0,0.0
3902,0,3902,[179   7 197 427  56],334,5,14030,3.5946707660773765,0.0,0.0
3903,0,3903,[302 603 427  50 313],474,5,14035,3.595030737704918,20.0,20.0
3904,0,3904,[143 286 197 300 742],454,3,14038,3.594878361075544,0.0,0.0
3905,0,3905,[121 273 483 403 265],892,4,14042,3.5949820788530467,20.0,0.0
3906,0,3906,[302 603 427  50 313],454,5,14047,3.5953416943946763,20.0,20.0
3907,0,3907,[302 603 427  50 313],13,5,14052,3.595701125895599,20.0,20.0
3908,0,3908,[234 175 168 183 286],339,5,14057,3.596060373497058,0.0,0.0
3909,0,3909,[200 185 318  95 313],13,2,14059,3.5956521739130434,20.0,0.0
3910,0,3910,[742 238  12 300  56],666,3,14062,3.5954998721554587,20.0,0.0
3911,0,3911,[211  71 204 405  15],474,5,14067,3.5958588957055215,0.0,0.0
3912,0,3912,[ 50 204 173 302 172],232,5,14072,3.5962177357526195,0.0,20.0
3913,0,3913,[175 202 181 318 179],774,2,14074,3.5958099131323453,20.0,0.0
3914,0,3914,[196 258 302 265 471],207,3,14077,3.5956577266922096,0.0,0.0
3915,0,3915,[302 603 427  50 313],474,5,14082,3.5960163432073546,20.0,20.0
3916,0,3916,[546 183 127 483 427],650,3,14085,3.595864181771764,20.0,20.0
3917,0,3917,[ 96 234 475 423 200],374,3,14088,3.5957120980091886,0.0,0.0
3918,0,3918,[182 196  96 187 118],533,4,14092,3.5958152589946413,0.0,0.0
3919,0,3919,[568 742 174 175 237],207,4,14096,3.595918367346939,0.0,20.0
3920,0,3920,[742 603 132 185 234],59,4,14100,3.5960214231063503,20.0,0.0
3921,0,3921,[ 28  22 742 323 197],804,5,14105,3.596379398266191,0.0,0.0
3922,0,3922,[271 186  69 180 318],738,4,14109,3.596482283966352,20.0,0.0
3923,0,3923,[302 603 427  50 313],454,5,14114,3.59683995922528,20.0,20.0
3924,0,3924,[ 70 588   9 475 257],308,5,14119,3.5971974522292993,0.0,0.0
3925,0,3925,[302 603 322  69 111],524,4,14123,3.597300050942435,20.0,0.0
3926,0,3926,[333 323 197 185   9],881,2,14125,3.5968933027756558,0.0,0.0
3927,0,3927,[302 427 603  50 313],474,5,14130,3.5972505091649696,20.0,20.0
3928,0,3928,[302 427 603  50 313],474,5,14135,3.5976075337235938,20.0,20.0
3929,0,3929,[483 269 204 508  56],334,3,14138,3.5974554707379136,20.0,0.0
3930,0,3930,[568 313 288 144 194],119,5,14143,3.597812261511066,0.0,0.0
3931,0,3931,[302 427 603  50 313],474,5,14148,3.5981688708036623,20.0,20.0
3932,0,3932,[302 427 603  50 313],271,5,14153,3.5985252987541316,20.0,20.0
3933,0,3933,[ 71 496 182 204  22],406,3,14156,3.598373157092018,0.0,0.0
3934,0,3934,[228 186 187 182 181],506,5,14161,3.5987293519695043,0.0,0.0
3935,0,3935,[175 196 179  25  79],95,3,14164,3.5985772357723578,0.0,0.0
3936,0,3936,[423 655 222 385  96],506,5,14169,3.598933197866396,0.0,0.0
3937,0,3937,[238 568 515  12 210],643,4,14173,3.5990350431691214,20.0,0.0
3938,0,3938,[302 427 603  50 313],334,5,14178,3.5993907083015992,20.0,20.0
3939,0,3939,[151 175 117 328 322],90,1,14179,3.598730964467005,0.0,0.0
3940,0,3940,[  8 216  28 161 269],64,4,14183,3.598832783557473,0.0,0.0
3941,0,3941,[302 427 603  50 313],454,5,14188,3.5991882293252155,20.0,20.0
3942,0,3942,[302 427 603  50 313],474,5,14193,3.599543494800913,20.0,20.0
3943,0,3943,[302 427 603  50 313],454,5,14198,3.599898580121704,20.0,20.0
3944,0,3944,[302 427 603  50 313],537,5,14203,3.600253485424588,20.0,20.0
3945,0,3945,[ 97  71  88 405 100],892,4,14207,3.6003547896604156,0.0,20.0
3946,0,3946,[ 88  69 405 300  11],749,4,14211,3.6004560425639727,0.0,0.0
3947,0,3947,[302 427 603  50 313],271,5,14216,3.6008105369807497,20.0,20.0
3948,0,3948,[302 427 603  50 313],669,5,14221,3.6011648518612307,20.0,20.0
3949,0,3949,[403  12 118 423 515],308,3,14224,3.601012658227848,20.0,0.0
3950,0,3950,[210   9 132 181  70],311,5,14229,3.6013667425968108,0.0,0.0
3951,0,3951,[302 427 603  50 313],454,5,14234,3.6017206477732793,20.0,20.0
3952,0,3952,[302 427 603  50 313],271,5,14239,3.6020743738932457,20.0,20.0
3953,0,3953,[423 385 197 265 276],207,2,14241,3.601669195751138,0.0,0.0
3954,0,3954,[  8  71 423 173 258],7,5,14246,3.602022756005057,0.0,0.0
3955,0,3955,[302 427 603  50 313],454,5,14251,3.602376137512639,20.0,20.0
3956,0,3956,[ 25 111 216 186 318],452,1,14252,3.6017184735911045,20.0,0.0
3957,0,3957,[302 427 603  50 313],13,5,14257,3.6020717534108138,20.0,20.0
3958,0,3958,[302 427 603  50 313],334,5,14262,3.602424854761303,20.0,20.0
3959,0,3959,[127 132   9 211  56],328,5,14267,3.602777777777778,0.0,20.0
3960,0,3960,[  4  95 210 202 385],543,2,14269,3.60237313809644,0.0,0.0
3961,0,3961,[ 64   8 323 185 273],90,3,14272,3.602221100454316,0.0,0.0
3962,0,3962,[588 183  15 257 210],378,5,14277,3.602573807721423,0.0,0.0
3963,0,3963,[302 427 603  50 313],474,5,14282,3.6029263370332996,20.0,20.0
3964,0,3964,[185 127   7  88 194],650,2,14284,3.6025220680958387,0.0,20.0
3965,0,3965,[195 204  79 235 191],833,3,14287,3.602370146243066,0.0,0.0
3966,0,3966,[483 265 275   7 135],537,4,14291,3.6024703806402822,20.0,0.0
3967,0,3967,[182 211 238   7 202],527,4,14295,3.602570564516129,0.0,0.0
3968,0,3968,[ 25 238 546 265 427],308,3,14298,3.6024187452758882,0.0,0.0
3969,0,3969,[ 12 333  64 275 174],537,1,14299,3.60176322418136,20.0,20.0
3970,0,3970,[302 427 603  50 313],454,5,14304,3.6021153361873584,20.0,20.0
3971,0,3971,[302 427 603  50 313],454,5,14309,3.6024672708962737,20.0,20.0
3972,0,3972,[153 118 195 210  96],92,4,14313,3.602567329473949,0.0,0.0
3973,0,3973,[302 427 603  50 313],454,5,14318,3.602918973326623,20.0,20.0
3974,0,3974,[175 121  71 275 195],406,3,14321,3.6027672955974843,0.0,0.0
3975,0,3975,[153 603 135 181 191],843,1,14322,3.602112676056338,20.0,0.0
3976,0,3976,[302 427 603  50 313],13,5,14327,3.602464168971587,20.0,20.0
3977,0,3977,[234  70 215  88 333],653,1,14328,3.6018099547511313,0.0,0.0
3978,0,3978,[172 237 168 182 121],666,2,14330,3.6014073887911535,0.0,0.0
3979,0,3979,[180  95 100 185  15],308,4,14334,3.601507537688442,0.0,20.0
3980,0,3980,[121  95 328 603 234],13,4,14338,3.6016076362722935,20.0,0.0
3981,0,3981,[655 127 235   1 195],804,4,14342,3.601707684580613,0.0,20.0
3982,0,3982,[ 97   4 144 127  96],406,3,14345,3.6015566156163694,0.0,20.0
3983,0,3983,[405  95  50 300 265],479,4,14349,3.601656626506024,0.0,20.0
3984,0,3984,[176  28 174  70  50],7,3,14352,3.601505646173149,0.0,40.0
3985,0,3985,[235  70 597  98  12],59,2,14354,3.601103863522328,20.0,20.0
3986,0,3986,[202 168 546 235   8],882,3,14357,3.600953097567093,0.0,0.0
3987,0,3987,[515 286 282  69 127],194,3,14360,3.600802407221665,0.0,20.0
3988,0,3988,[357  64 237 132 483],892,5,14365,3.6011531712208575,40.0,0.0
3989,0,3989,[ 64 655   4 180 403],774,1,14366,3.600501253132832,0.0,0.0
3990,0,3990,[ 50 748 100 302   7],883,5,14371,3.600851916812829,0.0,40.0
3991,0,3991,[302 427 603  50 313],537,5,14376,3.6012024048096194,20.0,20.0
3992,0,3992,[127  64 228 357  79],234,3,14379,3.6010518407212624,20.0,20.0
3993,0,3993,[302 427 603  50 313],474,5,14384,3.601402103154732,20.0,20.0
3994,0,3994,[202 237   8 357 117],454,2,14386,3.6010012515644556,20.0,0.0
3995,0,3995,[302 427 603  50 313],271,5,14391,3.6013513513513513,20.0,20.0
3996,0,3996,[333 405 276   7  97],458,3,14394,3.6012009006755066,0.0,0.0
3997,0,3997,[515 597 144 132 655],95,3,14397,3.6010505252626315,0.0,0.0
3998,0,3998,[302 427 603  50 313],454,5,14402,3.601400350087522,20.0,20.0
3999,0,3999,[302 427 603  50 313],334,5,14407,3.60175,20.0,20.0
4000,0,4000,[302 427 603  50 313],271,5,14412,3.602099475131217,20.0,20.0
4001,0,4001,[186 655 546 174  79],64,4,14416,3.602198900549725,0.0,20.0
4002,0,4002,[318 301  79 181 742],328,4,14420,3.6022982762927804,20.0,0.0
4003,0,4003,[187 228 202 385 183],774,3,14423,3.6021478521478523,0.0,0.0
4004,0,4004,[302 427 603  50 313],537,5,14428,3.6024968789013734,20.0,20.0
4005,0,4005,[302 427 603  50 313],13,5,14433,3.6028457314028954,20.0,20.0
4006,0,4006,[318 187 258 196  12],533,5,14438,3.60319440978288,40.0,0.0
4007,0,4007,[ 69  98 127 180 211],666,4,14442,3.6032934131736525,0.0,40.0
4008,0,4008,[483 258 289 100 405],474,4,14446,3.603392367173859,20.0,20.0
4009,0,4009,[183 603 302 191 172],669,2,14448,3.602992518703242,20.0,0.0
4010,0,4010,[302 427 603  50 313],13,5,14453,3.6033408127648965,20.0,20.0
4011,0,4011,[185 180  11 328 195],833,4,14457,3.6034396809571287,0.0,0.0
4012,0,4012,[655 132 144 174 546],343,4,14461,3.603538499875405,0.0,20.0
4013,0,4013,[132 172 144  79  88],194,1,14462,3.6028898854010962,0.0,0.0
4014,0,4014,[182 195 121 118   9],328,2,14464,3.6024906600249067,0.0,0.0
4015,0,4015,[100 483 423 180 194],694,5,14469,3.6028386454183265,20.0,20.0
4016,0,4016,[269 603 275 125 202],64,3,14472,3.60268857356236,20.0,0.0
4017,0,4017,[100 216 286  25 423],533,5,14477,3.603036336485814,0.0,20.0
4018,0,4018,[ 11 151  69 216 273],59,4,14481,3.60313510823588,0.0,0.0
4019,0,4019,[678 238  89 294  96],7,3,14484,3.6029850746268655,0.0,0.0
4020,0,4020,[257 185 237 496 195],474,4,14488,3.603083809997513,0.0,0.0
4021,0,4021,[302 427 603  50 313],271,5,14493,3.603431128791646,20.0,20.0
4022,0,4022,[302 427 603  50 313],334,5,14498,3.6037782749192147,20.0,20.0
4023,0,4023,[403  89 179 333 153],343,3,14501,3.603628230616302,0.0,0.0
4024,0,4024,[302 427 603  50 313],537,5,14506,3.603975155279503,20.0,20.0
4025,0,4025,[302 427 603  50 313],537,5,14511,3.604321907600596,20.0,20.0
4026,0,4026,[385 597 357 318  11],7,3,14514,3.604171840079464,40.0,0.0
4027,0,4027,[186  56 546  89 153],653,3,14517,3.6040218470705065,0.0,0.0
4028,0,4028,[228  11 172 403 238],881,2,14519,3.6036237279722014,0.0,0.0
4029,0,4029,[100 546 117 403 237],346,3,14522,3.603473945409429,0.0,20.0
4030,0,4030,[ 89 121 385 172 144],659,4,14526,3.603572314562143,0.0,0.0
4031,0,4031,[403 143 748 180 194],524,3,14529,3.603422619047619,0.0,0.0
4032,0,4032,[200  79 235 127 211],648,3,14532,3.6032729977684106,0.0,20.0
4033,0,4033,[302 427 603  50 313],13,5,14537,3.6036192364898363,20.0,20.0
4034,0,4034,[211 176 153 202  11],666,5,14542,3.6039653035935566,0.0,0.0
4035,0,4035,[427   9 182 180 132],59,5,14547,3.6043111992071357,0.0,0.0
4036,0,4036,[603 185 174   1 313],815,3,14550,3.604161506068863,20.0,20.0
4037,0,4037,[302 427 603  50 313],271,5,14555,3.604507181773155,20.0,20.0
4038,0,4038,[302 427 603  50 313],669,5,14560,3.604852686308492,20.0,20.0
4039,0,4039,[302 427 603  50 313],334,5,14565,3.60519801980198,20.0,20.0
4040,0,4040,[302 427 603  50 313],271,5,14570,3.605543182380599,20.0,20.0
4041,0,4041,[546 175   4 183   8],194,1,14571,3.6048985650667986,0.0,0.0
4042,0,4042,[302 427 603  50 313],13,5,14576,3.6052436309671037,20.0,20.0
4043,0,4043,[ 69   7 181 471 357],308,3,14579,3.605093966369931,20.0,0.0
4044,0,4044,[302 427 603  50 313],454,5,14584,3.6054388133498145,20.0,20.0
4045,0,4045,[258  98  97  12 179],7,5,14589,3.6057834898665346,20.0,20.0
4046,0,4046,[302 427 603  50 313],537,5,14594,3.606127996046454,20.0,20.0
4047,0,4047,[210 204  22 135  89],524,1,14595,3.6054841897233203,0.0,0.0
4048,0,4048,[655  28 742 328 183],92,2,14597,3.6050876759693753,0.0,0.0
4049,0,4049,[302 427 603  50 313],334,5,14602,3.6054320987654322,20.0,20.0
4050,0,4050,[216 300 181 161 568],940,2,14604,3.605035793631202,0.0,0.0
4051,0,4051,[742 153 483 194  64],899,5,14609,3.60538005923001,20.0,0.0
4052,0,4052,[179  89 286 385  12],343,3,14612,3.6052306933135947,20.0,0.0
4053,0,4053,[210 181  12 288 182],533,3,14615,3.605081401085348,20.0,0.0
4054,0,4054,[ 89 194  69 143 191],311,4,14619,3.6051787916152898,0.0,0.0
4055,0,4055,[302 427 603  50 313],271,5,14624,3.6055226824457596,20.0,20.0
4056,0,4056,[423 180 403 228  15],313,2,14626,3.605126941089475,0.0,0.0
4057,0,4057,[302 427 603  50 313],334,5,14631,3.605470675209463,20.0,20.0
4058,0,4058,[318  64 168 435 427],474,4,14635,3.605567873860557,20.0,0.0
4059,0,4059,[127  98 234 276 180],537,3,14638,3.6054187192118228,0.0,40.0
4060,0,4060,[216 294  71 210 403],901,3,14641,3.605269638020192,0.0,0.0
4061,0,4061,[302 427 603  50 313],454,5,14646,3.6056129985228953,20.0,20.0
4062,0,4062,[118 273 144 288 302],666,1,14647,3.604971695791287,0.0,0.0
4063,0,4063,[191  15 275 313  25],14,3,14650,3.6048228346456694,0.0,0.0
4064,0,4064,[194 282 222  15 125],194,2,14652,3.604428044280443,0.0,0.0
4065,0,4065,[748 180 197  98 568],881,3,14655,3.6042793900639447,0.0,20.0
4066,0,4066,[427 194 282 172 568],326,4,14659,3.60437669043521,0.0,0.0
4067,0,4067,[302 427 603  50 313],13,5,14664,3.6047197640117994,20.0,20.0
4068,0,4068,[181 588 238 197 215],308,3,14667,3.604571147702138,0.0,0.0
4069,0,4069,[302 427 603  50 313],537,5,14672,3.6049140049140047,20.0,20.0
4070,0,4070,[200 172 118  15 597],374,3,14675,3.604765413903218,0.0,0.0
4071,0,4071,[161 143  28 273   7],374,2,14677,3.604371316306483,0.0,0.0
4072,0,4072,[183 179 655 357 234],95,3,14680,3.604222931500123,20.0,0.0
4073,0,4073,[202 238 235 187 515],184,3,14683,3.604074619538537,0.0,0.0
4074,0,4074,[  1 210 100   7 385],738,4,14687,3.604171779141104,0.0,20.0
4075,0,4075,[234 100 200 286 323],13,2,14689,3.6037782139352306,0.0,20.0
4076,0,4076,[ 97  96 273 180 197],13,4,14693,3.6038753985773853,0.0,0.0
4077,0,4077,[302 427 603  50 313],474,5,14698,3.604217753800883,20.0,20.0
4078,0,4078,[216 483 471 515 182],308,1,14699,3.6035793086540817,20.0,0.0
4079,0,4079,[180 269 678 271 546],13,1,14700,3.6029411764705883,0.0,0.0
4080,0,4080,[ 22 195 237 143  64],313,2,14702,3.602548395001225,0.0,0.0
4081,0,4081,[678  69  56 151 127],82,1,14703,3.6019108280254777,0.0,20.0
4082,0,4082,[302 427 603  50 313],13,5,14708,3.6022532451628706,20.0,20.0
4083,0,4083,[186 194 172 153  79],650,4,14712,3.6023506366307543,0.0,0.0
4084,0,4084,[187 183 655 276  70],13,4,14716,3.602447980416157,0.0,0.0
4085,0,4085,[200 257 588 286 276],881,2,14718,3.6020558002936856,0.0,0.0
4086,0,4086,[269 179  96  50 245],452,3,14721,3.601908490335209,0.0,20.0
4087,0,4087,[568  28 185 196 294],374,3,14724,3.601761252446184,0.0,0.0
4088,0,4088,[357 678 423  96   7],537,2,14726,3.6013695280019564,20.0,0.0
4089,0,4089,[302 427 603  50 313],454,5,14731,3.601711491442543,20.0,20.0
4090,0,4090,[183 276  25 357 174],194,2,14733,3.6013199706673187,20.0,20.0
4091,0,4091,[302 427 603  50 313],334,5,14738,3.601661779081134,20.0,20.0
4092,0,4092,[211 423   1 175 471],13,3,14741,3.601514781333985,0.0,0.0
4093,0,4093,[ 98  95 175 143 515],13,3,14744,3.6013678553981436,0.0,20.0
4094,0,4094,[  1 245 276 385 143],200,4,14748,3.6014652014652015,0.0,0.0
4095,0,4095,[ 69 168 180 215  96],92,5,14753,3.601806640625,0.0,0.0
4096,0,4096,[302 427 603  50 313],334,5,14758,3.6021479131071517,20.0,20.0
4097,0,4097,[187 228 258 215 300],533,5,14763,3.602489019033675,0.0,0.0
4098,0,4098,[153 161 127 176 435],326,1,14764,3.6018541107587216,0.0,20.0
4099,0,4099,[181 245 271  96   1],263,4,14768,3.601951219512195,0.0,0.0
4100,0,4100,[289 748 172 180 286],524,3,14771,3.6018044379419654,0.0,0.0
4101,0,4101,[173 174 228 143 144],312,2,14773,3.601413944417357,0.0,20.0
4102,0,4102,[318 143   9 195 100],374,1,14774,3.6007799171338046,20.0,20.0
4103,0,4103,[ 79 301 132 289 153],328,3,14777,3.6006335282651074,0.0,0.0
4104,0,4104,[300 100 234  22 228],145,4,14781,3.6007308160779536,0.0,20.0
4105,0,4105,[302 427 603  50 313],334,5,14786,3.601071602532879,20.0,20.0
4106,0,4106,[302 427 603  50 313],13,5,14791,3.6014122230338446,20.0,20.0
4107,0,4107,[302 427 603  50 313],14,4,14795,3.6015092502434274,20.0,20.0
4108,0,4108,[ 50 483  96 257 117],533,5,14800,3.6018495984424432,20.0,20.0
4109,0,4109,[302 427 603  50 313],474,5,14805,3.602189781021898,20.0,20.0
4110,0,4110,[180  82  69  96 117],882,5,14810,3.6025297981026516,0.0,0.0
4111,0,4111,[302 427 603  50 313],454,5,14815,3.6028696498054473,20.0,20.0
4112,0,4112,[181 194 173 176 127],474,5,14820,3.6032093362509117,0.0,20.0
4113,0,4113,[196 173  12 496 127],234,2,14822,3.6028196402527954,20.0,20.0
4114,0,4114,[121  25 179  69 742],200,5,14827,3.6031591737545563,0.0,0.0
4115,0,4115,[302 427 603  50 313],454,5,14832,3.6034985422740524,20.0,20.0
4116,0,4116,[121 323 210 211 144],454,3,14835,3.6033519553072626,0.0,0.0
4117,0,4117,[302 427 603  50 313],537,5,14840,3.6036911121903836,20.0,20.0
4118,0,4118,[ 69 187 286 333   1],13,2,14842,3.603301772274824,0.0,0.0
4119,0,4119,[655 235  70  89 211],194,2,14844,3.6029126213592235,0.0,0.0
4120,0,4120,[302 427 603  50 313],537,5,14849,3.6032516379519532,20.0,20.0
4121,0,4121,[302 427 603  50 313],669,5,14854,3.603590490053372,20.0,20.0
4122,0,4122,[ 88  56 357 179 151],738,3,14857,3.603444094106233,20.0,0.0
4123,0,4123,[302 427 603  50 313],537,5,14862,3.603782735208535,20.0,20.0
4124,0,4124,[204 135 245 435 117],749,5,14867,3.6041212121212123,0.0,0.0
4125,0,4125,[302 427 603  50 313],537,5,14872,3.6044595249636453,20.0,20.0
4126,0,4126,[117 269  69  50 174],378,3,14875,3.604313060334383,0.0,40.0
4127,0,4127,[603  56 185  64 301],234,2,14877,3.603924418604651,20.0,0.0
4128,0,4128,[435 748 483 185  69],328,4,14881,3.6040203439089367,20.0,0.0
4129,0,4129,[742 237 483 174   7],374,3,14884,3.6038740920096854,20.0,20.0
4130,0,4130,[302 322 100  25 185],13,2,14886,3.603485838779956,0.0,20.0
4131,0,4131,[185  82  28 655 195],454,3,14889,3.6033397870280734,0.0,0.0
4132,0,4132,[288 211  11   9 483],343,4,14893,3.6034357609484635,20.0,0.0
4133,0,4133,[302 427 603  50 313],334,5,14898,3.6037735849056602,20.0,20.0
4134,0,4134,[471 588 153 273  97],308,2,14900,3.6033857315598548,0.0,0.0
4135,0,4135,[302 427 603  50 313],14,4,14904,3.6034816247582206,20.0,20.0
4136,0,4136,[496 423  98 483 588],899,4,14908,3.603577471597776,20.0,20.0
4137,0,4137,[302 427 603  50 313],271,5,14913,3.6039149347510873,20.0,20.0
4138,0,4138,[302 427 603  50 313],271,5,14918,3.604252234839333,20.0,20.0
4139,0,4139,[302 427 603  50 313],537,5,14923,3.6045893719806763,20.0,20.0
4140,0,4140,[161  96 568  69 118],311,4,14927,3.6046848587297755,0.0,0.0
4141,0,4141,[ 79 127 153  97   8],90,5,14932,3.6050217286335102,0.0,20.0
4142,0,4142,[302 427 603  50 313],13,5,14937,3.6053584359160027,20.0,20.0
4143,0,4143,[121 161  12   7 127],64,3,14940,3.6052123552123554,20.0,20.0
4144,0,4144,[568 427 322 181 258],533,5,14945,3.605548854041013,0.0,0.0
4145,0,4145,[ 95 265 183 172 475],374,3,14948,3.6054027978774723,0.0,0.0
4146,0,4146,[302 427 603  50 313],13,5,14953,3.605739088497709,20.0,20.0
4147,0,4147,[302 427 603  50 313],13,5,14958,3.6060752169720347,20.0,20.0
4148,0,4148,[  1 143 238 174 357],406,3,14961,3.6059291395516992,20.0,20.0
4149,0,4149,[168 282 200 276 483],643,3,14964,3.6057831325301204,20.0,0.0
4150,0,4150,[318 742 258  97 328],653,2,14966,3.60539629005059,20.0,0.0
4151,0,4151,[238  70 168 197 289],883,4,14970,3.6054913294797686,0.0,0.0
4152,0,4152,[237 275 483 100 235],524,2,14972,3.605104743558873,20.0,20.0
4153,0,4153,[300 289 204  98 151],788,3,14975,3.604959075589793,0.0,20.0
4154,0,4154,[302 427 603  50 313],454,5,14980,3.605294825511432,20.0,20.0
4155,0,4155,[ 11  79 496 144 427],295,5,14985,3.60563041385948,0.0,0.0
4156,0,4156,[588 118   8 143  22],892,4,14989,3.6057252826557615,0.0,0.0
4157,0,4157,[313 258  56 117 748],207,3,14992,3.6055796055796057,0.0,0.0
4158,0,4158,[202 204 135  70 405],378,2,14994,3.6051935561433037,0.0,0.0
4159,0,4159,[423 196 597  97 655],95,4,14998,3.6052884615384615,0.0,0.0
4160,0,4160,[276  15 515 197  71],311,5,15003,3.6056236481614996,0.0,0.0
4161,0,4161,[423 216   7  71 125],234,1,15004,3.6049975973089863,0.0,0.0
4162,0,4162,[405 435 161 228 403],60,4,15008,3.6050924813836174,0.0,0.0
4163,0,4163,[151   4 496   9 546],533,2,15010,3.6047070124879923,0.0,0.0
4164,0,4164,[187 195 313 588   1],13,3,15013,3.604561824729892,0.0,0.0
4165,0,4165,[302 427 603  50 313],454,5,15018,3.6048967834853576,20.0,20.0
4166,0,4166,[196 179  11 258 121],749,4,15022,3.6049916006719465,0.0,0.0
4167,0,4167,[ 28 200  69 121 211],308,2,15024,3.6046065259117084,0.0,0.0
4168,0,4168,[ 70 161 483 286 174],207,3,15027,3.604461501559127,20.0,20.0
4169,0,4169,[179 181  82 483 174],897,2,15029,3.6040767386091126,20.0,20.0
4170,0,4170,[655 318  50 176 276],144,4,15033,3.604171661472069,20.0,20.0
4171,0,4171,[483 265   7   1 405],13,2,15035,3.6037871524448706,20.0,0.0
4172,0,4172,[302 427 603  50 313],537,5,15040,3.6041217349628565,20.0,20.0
4173,0,4173,[ 98 313 286 301 174],90,5,15045,3.6044561571633924,0.0,40.0
4174,0,4174,[173 234 238 300 117],749,4,15049,3.604550898203593,0.0,0.0
4175,0,4175,[118  69 172 273 235],524,2,15051,3.6041666666666665,0.0,0.0
4176,0,4176,[302 427 603  50 313],669,5,15056,3.6045008379219534,20.0,20.0
4177,0,4177,[ 11 153  88 568 182],207,2,15058,3.6041168022977503,0.0,0.0
4178,0,4178,[173 186 276 181 180],452,3,15061,3.603972242163197,0.0,0.0
4179,0,4179,[ 64 168 228 182   9],374,3,15064,3.6038277511961723,0.0,0.0
4180,0,4180,[302 427 603  50 313],13,5,15069,3.6041616838077015,20.0,20.0
4181,0,4181,[302 427 603  50 313],334,5,15074,3.604495456719273,20.0,20.0
4182,0,4182,[215 132 483   9 174],60,5,15079,3.604829070045422,20.0,20.0
4183,0,4183,[294 185  15   7 200],95,2,15081,3.604445506692161,0.0,0.0
4184,0,4184,[ 15 121 118  82 168],42,4,15085,3.6045400238948626,0.0,0.0
4185,0,4185,[143  70 135 204 180],194,1,15086,3.6039178213091256,0.0,0.0
4186,0,4186,[ 25  15 135 197 288],234,2,15088,3.6035347504179605,0.0,0.0
4187,0,4187,[  8  11 333 546 483],881,5,15093,3.603868194842407,20.0,0.0
4188,0,4188,[168 323   9 238 173],311,4,15097,3.6039627596084984,0.0,0.0
4189,0,4189,[268  25 276 235 302],486,3,15100,3.60381861575179,0.0,0.0
4190,0,4190,[288  98 275 235 121],343,3,15103,3.6036745406824147,0.0,20.0
4191,0,4191,[197  96 228 597 678],7,3,15106,3.6035305343511452,0.0,0.0
4192,0,4192,[ 12 185 117 655   1],339,4,15110,3.603625089434772,20.0,0.0
4193,0,4193,[  4 173 100 179 655],537,3,15113,3.6034811635670003,0.0,20.0
4194,0,4194,[302 427 603  50 313],669,5,15118,3.603814064362336,20.0,20.0
4195,0,4195,[175 405 151 435 318],788,2,15120,3.603431839847474,20.0,0.0
4196,0,4196,[235 588 180 132 405],537,1,15121,3.6028115320467,0.0,0.0
4197,0,4197,[655   7 121  97 194],664,1,15122,3.6021915197713197,0.0,0.0
4198,0,4198,[288 496 153 234 275],648,5,15127,3.6025244105739462,0.0,0.0
4199,0,4199,[180 117  50   1 328],234,1,15128,3.6019047619047617,0.0,20.0
4200,0,4200,[276 180 127 423 121],892,5,15133,3.6022375624851226,0.0,20.0
4201,0,4201,[ 96 182  25  71 235],406,3,15136,3.602094240837696,0.0,0.0
4202,0,4202,[ 50  25 475 222  22],343,4,15140,3.602188912681418,0.0,20.0
4203,0,4203,[127 748 118 471 172],524,3,15143,3.602045670789724,0.0,20.0
4204,0,4204,[302 427 603  50 313],537,5,15148,3.6023781212841857,20.0,20.0
4205,0,4205,[302 427 603  50 313],474,5,15153,3.6027104136947217,20.0,20.0
4206,0,4206,[302 427 603  50 313],334,5,15158,3.6030425481340624,20.0,20.0
4207,0,4207,[302 286 546   1   9],339,5,15163,3.603374524714829,0.0,0.0
4208,0,4208,[435 289 323   7 174],881,2,15165,3.6029935851746258,0.0,20.0
4209,0,4209,[423 275  98 234 182],308,3,15168,3.6028503562945366,0.0,20.0
4210,0,4210,[204 168 496 546 288],339,3,15171,3.6027071954405128,0.0,0.0
4211,0,4211,[180 496 257 294 143],6,2,15173,3.602326685660019,0.0,0.0
4212,0,4212,[302 427 603  50 313],669,5,15178,3.6026584381675764,20.0,20.0
4213,0,4213,[121  15  89 271 288],537,1,15179,3.6020408163265305,0.0,0.0
4214,0,4214,[508 191  82 161 100],378,5,15184,3.6023724792408065,0.0,20.0
4215,0,4215,[302 427 603  50 313],454,5,15189,3.602703984819734,20.0,20.0
4216,0,4216,[168 546  50 216 180],308,3,15192,3.6025610623666116,0.0,20.0
4217,0,4217,[515 301 228  98 174],524,3,15195,3.6024182076813656,0.0,40.0
4218,0,4218,[ 22  82 301  25 403],234,1,15196,3.6018013747333493,0.0,0.0
4219,0,4219,[302 427 603  50 313],334,5,15201,3.6021327014218008,20.0,20.0
4220,0,4220,[ 56 210 289 179   4],579,0,15201,3.601279317697228,0.0,0.0
4221,0,4221,[  4 385 258 238 257],92,4,15205,3.601373756513501,0.0,0.0
4222,0,4222,[211  50 100 174 135],524,4,15209,3.601468150603836,0.0,60.0
4223,0,4223,[195  50  95 286 183],479,4,15213,3.6015625,0.0,20.0
4224,0,4224,[176 423 471  95  79],92,3,15216,3.6014201183431953,0.0,0.0
4225,0,4225,[405 496 234 174 196],343,4,15220,3.601514434453384,0.0,20.0
4226,0,4226,[174  56  28 245 132],200,4,15224,3.6016087059380175,0.0,20.0
4227,0,4227,[300  97 276  79 125],234,0,15224,3.6007568590350045,0.0,0.0
4228,0,4228,[302 427 603  50 313],669,5,15229,3.6010877275951763,20.0,20.0
4229,0,4229,[235 215   9 173 179],271,4,15233,3.6011820330969266,0.0,0.0
4230,0,4230,[179 228 265 161 135],387,4,15237,3.6012762940203262,0.0,0.0
4231,0,4231,[302 427 603  50 313],537,5,15242,3.6016068052930055,20.0,20.0
4232,0,4232,[302 427 603  50 313],14,4,15246,3.6017009213323883,20.0,20.0
4233,0,4233,[302 427 603  50 313],271,5,15251,3.6020311761927255,20.0,20.0
4234,0,4234,[302 427 603  50 313],454,5,15256,3.6023612750885476,20.0,20.0
4235,0,4235,[ 82 216 496 333 204],313,4,15260,3.6024551463644947,0.0,0.0
4236,0,4236,[195 258 187  50 211],13,4,15264,3.6025489733301863,0.0,20.0
4237,0,4237,[302 427 603  50 313],334,5,15269,3.602878716375649,20.0,20.0
4238,0,4238,[302 427 603  50 313],14,4,15273,3.602972399150743,20.0,20.0
4239,0,4239,[ 69  89 385  28 483],648,4,15277,3.603066037735849,20.0,0.0
4240,0,4240,[204  56 385  98 357],833,2,15279,3.6026880452723415,20.0,20.0
4241,0,4241,[ 11 182 127 222 117],387,3,15282,3.6025459688826027,0.0,20.0
4242,0,4242,[302 427 603  50 313],271,5,15287,3.602875324063163,20.0,20.0
4243,0,4243,[ 98  96  82 173 568],64,4,15291,3.6029688972667295,0.0,20.0
4244,0,4244,[176 234 100  98 228],312,4,15295,3.603062426383981,0.0,40.0
4245,0,4245,[ 79 197   8 265 181],7,4,15299,3.6031559114460667,0.0,0.0
4246,0,4246,[196 121   9 204 186],339,3,15302,3.6030138921591712,0.0,0.0
4247,0,4247,[603 269 173 161 168],650,4,15306,3.603107344632768,20.0,0.0
4248,0,4248,[275 427 385 435 286],343,4,15310,3.6032007531183807,0.0,0.0
4249,0,4249,[111  22 288 100 216],452,2,15312,3.6028235294117645,0.0,20.0
4250,0,4250,[357 313 323 175 588],650,3,15315,3.602681721947777,20.0,0.0
4251,0,4251,[302 427 603  50 313],474,5,15320,3.603010348071496,20.0,20.0
4252,0,4252,[302 427 603  50 313],13,5,15325,3.603338819656713,20.0,20.0
4253,0,4253,[ 96 435 204 200 322],881,2,15327,3.6029619181946404,0.0,0.0
4254,0,4254,[302 427 603  50 313],669,5,15332,3.6032902467685077,20.0,20.0
4255,0,4255,[127  71 191  15 118],694,5,15337,3.6036184210526314,0.0,20.0
4256,0,4256,[302 427 603  50 313],334,5,15342,3.6039464411557436,20.0,20.0
4257,0,4257,[ 89 187 182 568 194],881,3,15345,3.603804603100047,0.0,0.0
4258,0,4258,[302 427 603  50 313],537,5,15350,3.604132425451984,20.0,20.0
4259,0,4259,[496 318  98 179 405],200,4,15354,3.604225352112676,20.0,20.0
4260,0,4260,[197 597 161 238 202],833,1,15355,3.6036141750762734,0.0,0.0
4261,0,4261,[132   1 197  71   8],64,3,15358,3.603472548099484,0.0,0.0
4262,0,4262,[302 427 603  50 313],454,5,15363,3.6038001407459537,20.0,20.0
4263,0,4263,[302 427 603  50 313],13,5,15368,3.604127579737336,20.0,20.0
4264,0,4264,[302 427 603  50 313],454,5,15373,3.6044548651817117,20.0,20.0
4265,0,4265,[655 125 215  15   7],406,2,15375,3.6040787623066106,0.0,0.0
4266,0,4266,[196  69 496 742 187],804,5,15380,3.60440590578861,0.0,0.0
4267,0,4267,[302 427 603  50 313],537,5,15385,3.6047328959700096,20.0,20.0
4268,0,4268,[135 181 603 187  82],897,3,15388,3.6045912391660813,20.0,0.0
4269,0,4269,[ 12  79 423 143 185],474,5,15393,3.6049180327868853,20.0,0.0
4270,0,4270,[423 271 403 111 748],749,3,15396,3.6047763989697965,0.0,0.0
4271,0,4271,[175 195 385 405 194],648,4,15400,3.6048689138576777,0.0,0.0
4272,0,4272,[302 427 603  50 313],334,5,15405,3.605195413058741,20.0,20.0
4273,0,4273,[  1 228 265 173 174],537,1,15406,3.6045858680393073,0.0,20.0
4274,0,4274,[  7 357 427 211  89],6,4,15410,3.6046783625730994,20.0,0.0
4275,0,4275,[186 603 168  50  97],339,5,15415,3.605004677268475,20.0,20.0
4276,0,4276,[302 427 603  50 313],13,5,15420,3.6053308393733925,20.0,20.0
4277,0,4277,[742 289 191 121 471],378,4,15424,3.605423094904161,0.0,0.0
4278,0,4278,[237 125 121 118 194],788,3,15427,3.605281607852302,0.0,0.0
4279,0,4279,[ 79   7 211 195 216],60,5,15432,3.605607476635514,0.0,0.0
4280,0,4280,[302 427 603  50 313],14,4,15436,3.6056996028965194,20.0,20.0
4281,0,4281,[  8 176 175  50 117],774,2,15438,3.605324614666044,0.0,20.0
4282,0,4282,[135  56 435 423  70],328,4,15442,3.605416763950502,0.0,0.0
4283,0,4283,[302 427 603  50 313],669,5,15447,3.6057422969187676,20.0,20.0
4284,0,4284,[546 161 742 182 568],95,2,15449,3.60536756126021,0.0,0.0
4285,0,4285,[204  25  69 405 187],59,4,15453,3.605459636024265,0.0,0.0
4286,0,4286,[471  64 275 427 546],533,4,15457,3.6055516678329833,0.0,0.0
4287,0,4287,[302 427 603  50 313],669,5,15462,3.605876865671642,20.0,20.0
4288,0,4288,[385 181 172 117 179],897,1,15463,3.605269293541618,0.0,0.0
4289,0,4289,[245 125 174 204 153],749,5,15468,3.6055944055944056,0.0,20.0
4290,0,4290,[302 427 603  50 313],474,5,15473,3.6059193661151245,20.0,20.0
4291,0,4291,[194 286 151 175 588],95,4,15477,3.6060111835973907,0.0,0.0
4292,0,4292,[302 427 603  50 313],271,5,15482,3.606335895644072,20.0,20.0
4293,0,4293,[302 427 603  50 313],13,5,15487,3.6066604564508618,20.0,20.0
4294,0,4294,[186  64 471 187 179],543,3,15490,3.6065192083818394,0.0,0.0
4295,0,4295,[228 125 515 496 385],64,4,15494,3.606610800744879,0.0,0.0
4296,0,4296,[323  50 216 181 176],378,4,15498,3.606702350477077,0.0,20.0
4297,0,4297,[294  28 100 302 211],207,3,15501,3.606561191251745,0.0,20.0
4298,0,4298,[127 197 289 385 471],90,4,15505,3.6066527099325425,0.0,20.0
4299,0,4299,[215  64 143 302 405],13,3,15508,3.606511627906977,0.0,0.0
4300,0,4300,[180 603 183  69 289],13,4,15512,3.606603115554522,20.0,0.0
4301,0,4301,[302 427 603  50 313],271,5,15517,3.606927010692701,20.0,20.0
4302,0,4302,[655  15 202 258 405],378,3,15520,3.6067859632814314,0.0,0.0
4303,0,4303,[175 286 257 216 357],650,3,15523,3.6066449814126393,20.0,0.0
4304,0,4304,[ 64 423 100  71 323],804,4,15527,3.6067363530778165,0.0,20.0
4305,0,4305,[333  89  12 603  95],506,5,15532,3.607059916395727,40.0,0.0
4306,0,4306,[483 322 265 245 144],488,1,15533,3.6064546087764104,20.0,0.0
4307,0,4307,[222 216 195 483  70],311,5,15538,3.60677808727948,20.0,0.0
4308,0,4308,[195  11 234 215   1],653,2,15540,3.6064051984219074,0.0,0.0
4309,0,4309,[ 89 183 161  22 117],158,2,15542,3.606032482598608,0.0,0.0
4310,0,4310,[153 175  50   9 238],6,5,15547,3.6063558339132453,0.0,20.0
4311,0,4311,[200 180 144 748 204],648,2,15549,3.605983302411874,0.0,0.0
4312,0,4312,[742  22  56  98 238],524,2,15551,3.6056109436587063,0.0,20.0
4313,0,4313,[153 405  15 328 168],92,2,15553,3.6052387575336113,0.0,0.0
4314,0,4314,[302 427 603  50 313],474,5,15558,3.605561993047509,20.0,20.0
4315,0,4315,[294  69 127 655 265],95,3,15561,3.605421686746988,0.0,20.0
4316,0,4316,[302 427 603  50 313],14,4,15565,3.6055130877924486,20.0,20.0
4317,0,4317,[655  15 483 204 200],308,3,15568,3.605372857804539,20.0,0.0
4318,0,4318,[245 302 357 172  82],666,2,15570,3.605001157675388,20.0,0.0
4319,0,4319,[333 215 211 357 423],653,2,15572,3.60462962962963,20.0,0.0
4320,0,4320,[191 127 215 144 483],13,4,15576,3.604721129368202,20.0,20.0
4321,0,4321,[202 496 238  82 118],313,4,15580,3.6048125867653864,0.0,0.0
4322,0,4322,[ 70 172 211 318  11],406,4,15584,3.6049040018505667,20.0,0.0
4323,0,4323,[302 427 603  50 313],537,5,15589,3.60522664199815,20.0,20.0
4324,0,4324,[423 222  71 435 385],897,3,15592,3.605086705202312,0.0,0.0
4325,0,4325,[168 125 194 144  56],7,5,15597,3.6054091539528432,0.0,0.0
4326,0,4326,[302 427 603  50 313],13,5,15602,3.605731453663046,20.0,20.0
4327,0,4327,[ 50 423   8  22 257],6,2,15604,3.6053604436229203,0.0,20.0
4328,0,4328,[269 132  82 168 118],343,4,15608,3.6054516054516053,0.0,0.0
4329,0,4329,[302 427 603  50 313],334,5,15613,3.6057736720554274,20.0,20.0
4330,0,4330,[322   8 179 403 168],92,4,15617,3.605864696374971,0.0,0.0
4331,0,4331,[143 153 182  97 471],7,4,15621,3.60595567867036,0.0,0.0
4332,0,4332,[257  69 471  79 302],454,4,15625,3.60604661897069,0.0,0.0
4333,0,4333,[161  89 318 508 742],184,3,15628,3.605906783571758,20.0,0.0
4334,0,4334,[302 427 603  50 313],454,5,15633,3.606228373702422,20.0,20.0
4335,0,4335,[288 294  50 568  28],378,3,15636,3.606088560885609,0.0,20.0
4336,0,4336,[302 427 603  50 313],334,5,15641,3.606409960802398,20.0,20.0
4337,0,4337,[423 121  50 655 508],387,2,15643,3.6060396496081144,0.0,20.0
4338,0,4338,[302 427 603  50 313],13,5,15648,3.606360912652685,20.0,20.0
4339,0,4339,[301   7 121 286  95],102,1,15649,3.6057603686635944,0.0,0.0
4340,0,4340,[ 98 216 127  12 186],346,2,15651,3.605390463026952,20.0,40.0
4341,0,4341,[215 496 180 132 100],892,5,15656,3.6057116536158453,0.0,20.0
4342,0,4342,[176 215  56  89 111],378,4,15660,3.605802440709187,0.0,0.0
4343,0,4343,[191 300 100 194   1],379,4,15664,3.605893186003683,0.0,20.0
4344,0,4344,[153 234 258 276 173],234,1,15665,3.6052934407364785,0.0,0.0
4345,0,4345,[302 427 603  50 313],14,4,15669,3.6053842613897835,20.0,20.0
4346,0,4346,[118 183 168 216  56],648,4,15673,3.605475040257649,0.0,0.0
4347,0,4347,[471 200 237 216 185],271,3,15676,3.605335786568537,0.0,0.0
4348,0,4348,[181  15  96 111 202],537,0,15676,3.6045067831685444,0.0,0.0
4349,0,4349,[153 196  64 258 183],378,5,15681,3.6048275862068966,0.0,0.0
4350,0,4350,[302 427 603  50 313],13,5,15686,3.605148241783498,20.0,20.0
4351,0,4351,[302 427 603  50 313],454,5,15691,3.60546875,20.0,20.0
4352,0,4352,[483 127 228 144 185],313,4,15695,3.6055593843326443,20.0,20.0
4353,0,4353,[603 118  98  89  56],59,5,15700,3.6058796508957283,20.0,20.0
4354,0,4354,[ 95 183  89 603 143],234,2,15702,3.605510907003444,20.0,0.0
4355,0,4355,[423 258 153 196  98],184,3,15705,3.605371900826446,0.0,20.0
4356,0,4356,[258 172 186 265 323],650,3,15708,3.6052329584576546,0.0,0.0
4357,0,4357,[515 313 127 323 322],548,5,15713,3.6055530059660397,0.0,20.0
4358,0,4358,[127   8 100 597 265],452,4,15717,3.605643496214728,0.0,40.0
4359,0,4359,[175 294 153 174  25],234,0,15717,3.604816513761468,0.0,20.0
4360,0,4360,[ 64 121 313 168 271],669,3,15720,3.6046778261866543,0.0,0.0
4361,0,4361,[258  56 175 173 100],378,5,15725,3.604997707473636,0.0,20.0
4362,0,4362,[194 100 202 603 588],454,2,15727,3.6046298418519367,20.0,20.0
4363,0,4363,[286 328 269  28 210],207,2,15729,3.604262144821265,0.0,0.0
4364,0,4364,[302 427 603  50 313],334,5,15734,3.604581901489118,20.0,20.0
4365,0,4365,[ 89 121  95 678 195],92,3,15737,3.604443426477325,0.0,0.0
4366,0,4366,[427 322 187  70   4],559,3,15740,3.60430501488436,0.0,0.0
4367,0,4367,[427 271 174  96   4],788,0,15740,3.6034798534798536,0.0,20.0
4368,0,4368,[  9 655 322 405 186],334,2,15742,3.603112840466926,0.0,0.0
4369,0,4369,[202 273 322 483 211],308,2,15744,3.602745995423341,20.0,0.0
4370,0,4370,[271 323 151 288 276],537,1,15745,3.6021505376344085,0.0,0.0
4371,0,4371,[ 15  50  28  69 265],554,5,15750,3.602470265324794,0.0,20.0
4372,0,4372,[475 118 568 288 286],343,2,15752,3.6021038188886347,0.0,0.0
4373,0,4373,[181 180 313 258 161],378,4,15756,3.6021947873799727,0.0,0.0
4374,0,4374,[568 204 173  71 216],95,5,15761,3.602514285714286,0.0,0.0
4375,0,4375,[196 127 286  97 423],452,5,15766,3.602833638025594,0.0,20.0
4376,0,4376,[302 427 603  50 313],454,5,15771,3.603152844413982,20.0,20.0
4377,0,4377,[135 228 125 204 318],406,3,15774,3.6030150753768844,20.0,0.0
4378,0,4378,[302 427 603  50 313],14,4,15778,3.603105731902261,20.0,20.0
4379,0,4379,[423 289 111 173 742],524,4,15782,3.6031963470319637,0.0,0.0
4380,0,4380,[180 144 546 175 121],833,3,15785,3.6030586624058434,0.0,0.0
4381,0,4381,[ 12  56 276 322 210],207,1,15786,3.6024646280237334,20.0,0.0
4382,0,4382,[180 322  95  11 328],234,0,15786,3.6016427104722792,0.0,0.0
4383,0,4383,[144 423 179 204 268],234,1,15787,3.6010492700729926,0.0,0.0
4384,0,4384,[175  95 245   9 197],749,2,15789,3.600684150513113,0.0,0.0
4385,0,4385,[ 22  28 195 153  89],543,3,15792,3.600547195622435,0.0,0.0
4386,0,4386,[238 237 186 435 100],6,4,15796,3.600638249373148,0.0,20.0
4387,0,4387,[181 300  96  15 276],378,5,15801,3.600957155879672,0.0,0.0
4388,0,4388,[111  82 179 174 265],648,5,15806,3.601275917065391,0.0,20.0
4389,0,4389,[302 427 603  50 313],14,4,15810,3.6013667425968108,20.0,20.0
4390,0,4390,[302 427 603  50 313],271,5,15815,3.601685265315418,20.0,20.0
4391,0,4391,[302 427 603  50 313],14,4,15819,3.601775956284153,20.0,20.0
4392,0,4392,[179 238   8 435 496],458,4,15823,3.601866605964034,0.0,0.0
4393,0,4393,[318 144 121 475  89],479,4,15827,3.60195721438325,20.0,0.0
4394,0,4394,[ 89 215 132 172 289],85,4,15831,3.602047781569966,0.0,0.0
4395,0,4395,[ 97   8 187 237  25],313,2,15833,3.6016833484986353,0.0,0.0
4396,0,4396,[357 181 216 183 211],60,5,15838,3.60200136456675,20.0,0.0
4397,0,4397,[302 427 603  50 313],14,4,15842,3.6020918599363347,20.0,20.0
4398,0,4398,[302 427 603  50 313],334,5,15847,3.602409638554217,20.0,20.0
4399,0,4399,[132 204 151 588 228],148,4,15851,3.6025,0.0,0.0
4400,0,4400,[185  11 286 191 483],184,4,15855,3.6025903203817315,20.0,0.0
4401,0,4401,[100 211  12   9 282],788,5,15860,3.60290776919582,20.0,20.0
4402,0,4402,[302 427 603  50 313],537,5,15865,3.603225073813309,20.0,20.0
4403,0,4403,[435 172 222  82 508],387,4,15869,3.6033151680290647,0.0,0.0
4404,0,4404,[200  22 603 144 210],650,2,15871,3.6029511918274686,20.0,0.0
4405,0,4405,[187 302 186  50 175],6,5,15876,3.6032682705401724,0.0,20.0
4406,0,4406,[194 286 176 265 294],271,3,15879,3.6031313818924438,0.0,0.0
4407,0,4407,[475 328  71   1 471],92,4,15883,3.6032214156079854,0.0,0.0
4408,0,4408,[  8 182 185 515 405],7,3,15886,3.6030845996824676,0.0,0.0
4409,0,4409,[273 181 385  97 328],479,3,15889,3.6029478458049886,0.0,0.0
4410,0,4410,[286 588 228 508  98],537,1,15890,3.602357742008615,0.0,20.0
4411,0,4411,[302 427 603  50 313],454,5,15895,3.6026745240253852,20.0,20.0
4412,0,4412,[176 183 435 161 210],643,4,15899,3.6027645592567414,0.0,0.0
4413,0,4413,[181 204 588  89  50],843,1,15900,3.6021748980516537,0.0,20.0
4414,0,4414,[302 427 603  50 313],454,5,15905,3.6024915062287657,20.0,20.0
4415,0,4415,[385  22 235 132 405],343,4,15909,3.6025815217391304,0.0,0.0
4416,0,4416,[ 79  98 427 111 168],666,3,15912,3.6024450984831335,0.0,20.0
4417,0,4417,[655 216 286 179 143],334,3,15915,3.6023087369850613,0.0,0.0
4418,0,4418,[302 427 603  50 313],334,5,15920,3.6026250282869428,20.0,20.0
4419,0,4419,[302 427 603  50 313],14,4,15924,3.602714932126697,20.0,20.0
4420,0,4420,[302 427 603  50 313],474,5,15929,3.6030309884641483,20.0,20.0
4421,0,4421,[238   4 275 405 183],406,1,15930,3.6024423337856173,0.0,0.0
4422,0,4422,[302 427 603  50 313],13,5,15935,3.6027583088401536,20.0,20.0
4423,0,4423,[180 210 237 435 197],288,4,15939,3.6028481012658227,0.0,0.0
4424,0,4424,[153 127 215  64 187],659,5,15944,3.6031638418079095,0.0,20.0
4425,0,4425,[496 275 286 515 151],474,3,15947,3.6030275643922276,0.0,0.0
4426,0,4426,[ 70 215 289 182 427],788,2,15949,3.602665461938107,0.0,0.0
4427,0,4427,[302 427 603  50 313],14,4,15953,3.602755194218609,20.0,20.0
4428,0,4428,[313  15 182 180  79],234,1,15954,3.6021675321743056,0.0,0.0
4429,0,4429,[655 385 294 496  79],749,3,15957,3.6020316027088035,0.0,0.0
4430,0,4430,[302 427 603  50 313],669,5,15962,3.6023470999774316,20.0,20.0
4431,0,4431,[483 181 182 258 265],7,4,15966,3.6024368231046933,20.0,0.0
4432,0,4432,[200 238 318 174 655],848,4,15970,3.602526505752312,20.0,20.0
4433,0,4433,[ 69 423 153 323  79],378,3,15973,3.602390617952188,0.0,0.0
4434,0,4434,[181  28 151 211 210],843,0,15973,3.601578354002255,0.0,0.0
4435,0,4435,[181 182 245  25  28],533,3,15976,3.6014427412082957,0.0,0.0
4436,0,4436,[302 427 603  50 313],474,5,15981,3.601757944557133,20.0,20.0
4437,0,4437,[302  69 546 245  28],328,4,15985,3.6018476791347456,0.0,0.0
4438,0,4438,[200 435 179 127  82],10,5,15990,3.6021626492453254,0.0,20.0
4439,0,4439,[655   7 603 268 234],234,2,15992,3.601801801801802,20.0,0.0
4440,0,4440,[202 135   4 423  50],343,5,15997,3.602116640396307,0.0,20.0
4441,0,4441,[ 79 100   8 144 174],158,5,16002,3.6024313372354797,0.0,40.0
4442,0,4442,[302 427 603  50 313],13,5,16007,3.602745892415035,20.0,20.0
4443,0,4443,[ 50 172   9   1 125],200,5,16012,3.6030603060306032,0.0,20.0
4444,0,4444,[135  96  98 234  56],659,4,16016,3.6031496062992128,0.0,20.0
4445,0,4445,[183 508  88  89 265],339,4,16020,3.603238866396761,0.0,0.0
4446,0,4446,[194 118 100 423  82],313,4,16024,3.6033280863503485,0.0,20.0
4447,0,4447,[588 294 678 172  64],881,2,16026,3.6029676258992804,0.0,0.0
4448,0,4448,[ 89 238 174 135 245],334,4,16030,3.6030568667116207,0.0,20.0
4449,0,4449,[302 427 603  50 313],474,5,16035,3.603370786516854,20.0,20.0
4450,0,4450,[546 118 211 132 181],447,4,16039,3.6034598966524376,0.0,0.0
4451,0,4451,[302 427 603  50 313],454,5,16044,3.6037735849056602,20.0,20.0
4452,0,4452,[179 597 185 161 265],13,2,16046,3.603413429148888,0.0,0.0
4453,0,4453,[  4 265 132 301 275],334,1,16047,3.6028289178266726,0.0,0.0
4454,0,4454,[222 182  56 546 173],897,3,16050,3.6026936026936025,0.0,0.0
4455,0,4455,[181 294 655 471  12],13,3,16053,3.6025583482944343,20.0,0.0
4456,0,4456,[144 143 423 186 282],666,0,16053,3.601750056091541,0.0,0.0
4457,0,4457,[302 427 603  50 313],13,5,16058,3.6020637056976224,20.0,20.0
4458,0,4458,[ 98 211  96  88 546],13,4,16062,3.6021529490917246,0.0,20.0
4459,0,4459,[ 64 301 385 603  69],90,4,16066,3.602242152466368,20.0,0.0
4460,0,4460,[302 427 603  50 313],271,5,16071,3.6025554808338938,20.0,20.0
4461,0,4461,[588 175 173 204 210],840,4,16075,3.602644554011654,0.0,0.0
4462,0,4462,[187 191  56 153  64],313,3,16078,3.6025095227425497,0.0,0.0
4463,0,4463,[742 211  28 202 185],454,1,16079,3.601926523297491,0.0,0.0
4464,0,4464,[302 427 603  50 313],537,5,16084,3.602239641657335,20.0,20.0
4465,0,4465,[ 15 588 294  88 483],537,1,16085,3.601656963725929,20.0,0.0
4466,0,4466,[191 111 121 174 508],533,5,16090,3.6019700022386387,0.0,20.0
4467,0,4467,[302 427 603  50 313],13,5,16095,3.6022829006266788,20.0,20.0
4468,0,4468,[302 427 603  50 313],537,5,16100,3.6025956589841126,20.0,20.0
4469,0,4469,[204 185 127 132 125],406,4,16104,3.6026845637583893,0.0,20.0
4470,0,4470,[237 289  25 144  70],234,1,16105,3.602102437933348,0.0,0.0
4471,0,4471,[111  97 282 210  56],378,4,16109,3.6021914132379247,0.0,0.0
4472,0,4472,[603 173 111 151 286],524,3,16112,3.602056785155377,20.0,0.0
4473,0,4473,[  7 132 127 179 187],643,5,16117,3.602369244523916,0.0,20.0
4474,0,4474,[268 282 475 300 405],119,5,16122,3.60268156424581,0.0,0.0
4475,0,4475,[385 235 204 313 273],92,4,16126,3.602770330652368,0.0,0.0
4476,0,4476,[234 322 182 197 228],374,5,16131,3.6030824212642396,0.0,0.0
4477,0,4477,[172  50 257  97 313],738,4,16135,3.603171058508263,0.0,20.0
4478,0,4478,[143  82 153 216 286],452,2,16137,3.6028131279303417,0.0,0.0
4479,0,4479,[172 435 215  98 202],406,3,16140,3.6026785714285716,0.0,20.0
4480,0,4480,[357 132 403 238  56],385,4,16144,3.6027672394554786,20.0,0.0
4481,0,4481,[245  97 301 300  98],378,3,16147,3.602632753235163,0.0,20.0
4482,0,4482,[245 204 144  56 742],804,4,16151,3.60272139192505,0.0,0.0
4483,0,4483,[328 258 275 597  22],119,4,16155,3.6028099910793934,0.0,0.0
4484,0,4484,[175 180 237 195 318],524,2,16157,3.602452619843924,20.0,0.0
4485,0,4485,[302 427 603  50 313],334,5,16162,3.6027641551493534,20.0,20.0
4486,0,4486,[405  89 568 175  15],189,3,16165,3.6026298194784934,0.0,0.0
4487,0,4487,[276 515  71 301 168],234,1,16166,3.6020499108734403,0.0,0.0
4488,0,4488,[228 143  89  56  70],59,3,16169,3.601915794163511,0.0,0.0
4489,0,4489,[568 546   1 117 186],158,2,16171,3.6015590200445433,0.0,0.0
4490,0,4490,[302 427 603  50 313],669,5,16176,3.60187040748163,20.0,20.0
4491,0,4491,[302 427 603  50 313],454,5,16181,3.602181656277827,20.0,20.0
4492,0,4492,[302 427 603  50 313],669,5,16186,3.6024927665257067,20.0,20.0
4493,0,4493,[151 588 238 300  82],378,3,16189,3.6023587004895417,0.0,0.0
4494,0,4494,[289 300 323  50 237],537,1,16190,3.6017797552836486,0.0,20.0
4495,0,4495,[318  69  56 179 172],13,3,16193,3.60164590747331,20.0,0.0
4496,0,4496,[121 216   9 237 228],533,4,16197,3.601734489659773,0.0,0.0
4497,0,4497,[742 273 204  96 194],833,1,16198,3.601156069364162,0.0,0.0
4498,0,4498,[301 475 276   7 135],13,2,16200,3.600800177817293,0.0,0.0
4499,0,4499,[302 427 603  50 313],537,5,16205,3.601111111111111,20.0,20.0
4500,0,4500,[196  89 186 200 143],13,3,16208,3.600977560542102,0.0,0.0
4501,0,4501,[ 82 194 100 176   8],64,4,16212,3.6010661928031986,0.0,20.0
4502,0,4502,[222 282 269 245  22],334,3,16215,3.6009327115256498,0.0,0.0
4503,0,4503,[302 427 603  50 313],14,4,16219,3.601021314387211,20.0,20.0
4504,0,4504,[271  25 179 268 216],92,2,16221,3.6006659267480576,0.0,0.0
4505,0,4505,[302 427 603  50 313],454,5,16226,3.600976475810031,20.0,20.0
4506,0,4506,[172 111 181 288  28],533,4,16230,3.6010650099844685,0.0,0.0
4507,0,4507,[ 22   1 276 127  88],308,5,16235,3.6013753327417923,0.0,20.0
4508,0,4508,[302 427 603  50 313],271,5,16240,3.6016855178531824,20.0,20.0
4509,0,4509,[302 427 603  50 313],537,5,16245,3.6019955654101996,20.0,20.0
4510,0,4510,[328 216 191  97  82],313,4,16249,3.6020837951673688,0.0,0.0
4511,0,4511,[273 322  25  82 257],749,4,16253,3.6021719858156027,0.0,0.0
4512,0,4512,[183 216  64 195 210],42,5,16258,3.6024817194770664,0.0,0.0
4513,0,4513,[475 127 180 294  15],479,2,16260,3.6021267168808153,0.0,20.0
4514,0,4514,[302 427 603  50 313],474,5,16265,3.6024363233665557,20.0,20.0
4515,0,4515,[196 276 202 328 132],234,1,16266,3.6018600531443754,0.0,0.0
4516,0,4516,[211  50 185 423  64],749,5,16271,3.602169581580695,0.0,20.0
4517,0,4517,[200 435  50  69 181],474,4,16275,3.602257636122178,0.0,20.0
4518,0,4518,[403 187 200 222 118],343,3,16278,3.6021243637973,0.0,0.0
4519,0,4519,[ 56 186 568 174 234],7,5,16283,3.6024336283185843,0.0,20.0
4520,0,4520,[313 294   7 183  11],13,2,16285,3.602079186020792,0.0,0.0
4521,0,4521,[508 228 322 678 475],92,3,16288,3.6019460415745246,0.0,0.0
4522,0,4522,[403  96 435 678 288],7,4,16292,3.6020340481980986,0.0,0.0
4523,0,4523,[ 56 202 125 100 588],194,3,16295,3.6019009725906277,0.0,20.0
4524,0,4524,[302 427 603  50 313],669,5,16300,3.6022099447513813,20.0,20.0
4525,0,4525,[211 215 546 194 182],650,2,16302,3.6018559434379145,0.0,0.0
4526,0,4526,[302 427 603  50 313],14,4,16306,3.6019438922023417,20.0,20.0
4527,0,4527,[  4 118   1  95 568],648,3,16309,3.601810954063604,0.0,0.0
4528,0,4528,[302 427 603  50 313],669,5,16314,3.6021196732170457,20.0,20.0
4529,0,4529,[173 127 143 132 186],13,3,16317,3.6019867549668874,0.0,20.0
4530,0,4530,[302 258  69 204  28],474,5,16322,3.602295299050982,0.0,0.0
4531,0,4531,[202 204 161 118 568],804,5,16327,3.602603706972639,0.0,0.0
4532,0,4532,[302 427 603  50 313],13,5,16332,3.602911978821972,20.0,20.0
4533,0,4533,[302 427 603  50 313],474,5,16337,3.6032201146890164,20.0,20.0
4534,0,4534,[121 168  88 191  50],308,4,16341,3.6033076074972437,0.0,20.0
4535,0,4535,[183 200  11  97  12],59,5,16346,3.603615520282187,20.0,0.0
4536,0,4536,[385 222 403 174 271],883,2,16348,3.6032620674454487,0.0,20.0
4537,0,4537,[183 603 385 237  50],313,4,16352,3.603349493168797,20.0,20.0
4538,0,4538,[127 515  50 405 118],328,4,16356,3.6034368803701256,0.0,40.0
4539,0,4539,[182  22  12 275 257],378,5,16361,3.6037444933920706,20.0,0.0
4540,0,4540,[  1  22  70 515  71],406,1,16362,3.6031711076855317,0.0,0.0
4541,0,4541,[  9  88 100 117 118],13,3,16365,3.603038309114927,0.0,20.0
4542,0,4542,[302 427 603  50 313],669,5,16370,3.6033458067356374,20.0,20.0
4543,0,4543,[302 427 603  50 313],14,4,16374,3.6034330985915495,20.0,20.0
4544,0,4544,[121 211 302  97  96],13,5,16379,3.603740374037404,0.0,0.0
4545,0,4545,[427   1  69 289 216],271,4,16383,3.6038275406951166,0.0,0.0
4546,0,4546,[182 435 176 204 181],897,3,16386,3.6036947437871123,0.0,0.0
4547,0,4547,[172 197 333 151 385],533,4,16390,3.603781882145998,0.0,0.0
4548,0,4548,[168 187 176 427   8],326,2,16392,3.6034293251264016,0.0,0.0
4549,0,4549,[135 257 151 210 333],533,3,16395,3.6032967032967034,0.0,0.0
4550,0,4550,[183   4 195 127 273],774,2,16397,3.6029444078224566,0.0,20.0
4551,0,4551,[ 69  25  95 118 196],59,4,16401,3.6030316344463973,0.0,0.0
4552,0,4552,[196 508 215 385  56],13,3,16404,3.6028991873490006,0.0,0.0
4553,0,4553,[302 427 603  50 313],537,5,16409,3.6032059727711903,20.0,20.0
4554,0,4554,[ 88 228 186 117   9],92,4,16413,3.6032930845225026,0.0,0.0
4555,0,4555,[211 655 173 181   4],210,5,16418,3.60359964881475,0.0,0.0
4556,0,4556,[118 294 435 202 127],690,3,16421,3.6034671933289446,0.0,20.0
4557,0,4557,[  4 318 238 603 194],537,3,16424,3.603334795963142,40.0,0.0
4558,0,4558,[ 64  98  79 100  88],454,4,16428,3.6034218030269796,0.0,40.0
4559,0,4559,[471  82   9  15 161],648,2,16430,3.6030701754385963,0.0,0.0
4560,0,4560,[588  95 210 655  25],308,5,16435,3.6033764525323395,0.0,0.0
4561,0,4561,[313 403  11 271 181],13,2,16437,3.603024989039895,0.0,0.0
4562,0,4562,[515 195 318 385   1],326,3,16440,3.6028928336620645,20.0,0.0
4563,0,4563,[117 273  95 204 328],92,3,16443,3.602760736196319,0.0,0.0
4564,0,4564,[302 427 603  50 313],669,5,16448,3.603066812705367,20.0,20.0
4565,0,4565,[301 289  50 194 187],328,3,16451,3.60293473499781,0.0,20.0
4566,0,4566,[  9  50  11 117 222],474,5,16456,3.603240639369389,0.0,20.0
4567,0,4567,[216 181  97 200  15],308,2,16458,3.602889667250438,0.0,0.0
4568,0,4568,[302 427 603  50 313],474,5,16463,3.6031954475815278,20.0,20.0
4569,0,4569,[183 194 118 179  11],833,3,16466,3.603063457330416,0.0,0.0
4570,0,4570,[385 258 318 175  25],90,3,16469,3.6029315248304528,20.0,0.0
4571,0,4571,[302 427 603  50 313],14,4,16473,3.603018372703412,20.0,20.0
4572,0,4572,[302 427 603  50 313],669,5,16478,3.6033238574240105,20.0,20.0
4573,0,4573,[ 50 216 678 172 238],749,3,16481,3.6031919545255793,0.0,20.0
4574,0,4574,[313   9 323 328 385],119,5,16486,3.603497267759563,0.0,0.0
4575,0,4575,[302 427 603  50 313],13,5,16491,3.6038024475524475,20.0,20.0
4576,0,4576,[238 273 118  69 222],213,3,16494,3.6036705265457725,0.0,0.0
4577,0,4577,[  4 275 168 175 179],13,3,16497,3.603538663171691,0.0,0.0
4578,0,4578,[302 427 603  50 313],13,5,16502,3.6038436339812185,20.0,20.0
4579,0,4579,[302 427 603  50 313],669,5,16507,3.6041484716157206,20.0,20.0
4580,0,4580,[ 64 197 403 210 168],738,3,16510,3.6040165902641346,0.0,0.0
4581,0,4581,[302 427 603  50 313],334,5,16515,3.6043212570929724,20.0,20.0
4582,0,4582,[302 427 603  50 313],454,5,16520,3.6046257909666157,20.0,20.0
4583,0,4583,[496 195  79 238 168],648,4,16524,3.6047120418848166,0.0,0.0
4584,0,4584,[ 89 186 234  82 200],843,2,16526,3.604362050163577,0.0,0.0
4585,0,4585,[483 496 357   4  25],398,4,16530,3.604448320976886,40.0,0.0
4586,0,4586,[132  79 186 273 748],13,3,16533,3.6043165467625897,0.0,0.0
4587,0,4587,[ 22 100 235 185  96],64,5,16538,3.60462074978204,0.0,20.0
4588,0,4588,[302 427 603  50 313],13,5,16543,3.6049248202222706,20.0,20.0
4589,0,4589,[678 471  50 748 195],454,3,16546,3.6047930283224403,0.0,20.0
4590,0,4590,[483 117 172 288 174],13,3,16549,3.6046612938357656,20.0,20.0
4591,0,4591,[191 143 117 211 515],6,3,16552,3.6045296167247387,0.0,0.0
4592,0,4592,[302 427 603  50 313],334,5,16557,3.604833442194644,20.0,20.0
4593,0,4593,[216 405 168 603 210],271,3,16560,3.604701784936874,20.0,0.0
4594,0,4594,[275  95 135 153 185],13,3,16563,3.604570184983678,0.0,0.0
4595,0,4595,[ 50 197 127 228   8],85,4,16567,3.604656222802437,0.0,40.0
4596,0,4596,[302 427 603  50 313],537,5,16572,3.6049597563628453,20.0,20.0
4597,0,4597,[179 215 275 191  97],474,4,16576,3.6050456720313178,0.0,0.0
4598,0,4598,[302 427 603  50 313],454,5,16581,3.6053489889106327,20.0,20.0
4599,0,4599,[655 185 265 200 286],537,1,16582,3.6047826086956523,0.0,0.0
4600,0,4600,[211 125 515 546 143],804,3,16585,3.604651162790698,0.0,0.0
4601,0,4601,[496 211 204  12 269],524,2,16587,3.604302477183833,20.0,0.0
4602,0,4602,[302 427 603  50 313],14,4,16591,3.604388442320226,20.0,20.0
4603,0,4603,[185 385 143  96 204],843,0,16591,3.603605560382276,0.0,0.0
4604,0,4604,[435 496 191 603 153],840,4,16595,3.6036916395222582,20.0,0.0
4605,0,4605,[302 427 603  50 313],474,5,16600,3.6039947894051236,20.0,20.0
4606,0,4606,[655 269 597  28   9],119,4,16604,3.60408074668982,0.0,0.0
4607,0,4607,[210 423 289 117   7],194,0,16604,3.603298611111111,0.0,0.0
4608,0,4608,[302 427 603  50 313],271,5,16609,3.603601648947711,20.0,20.0
4609,0,4609,[423 357  88 186 234],13,4,16613,3.6036876355748375,20.0,0.0
4610,0,4610,[234 496 181 483 174],533,4,16617,3.6037735849056602,20.0,20.0
4611,0,4611,[597 245 202  98  69],200,4,16621,3.6038594969644406,0.0,20.0
4612,0,4612,[151 191 153 174 471],940,3,16624,3.6037285931064384,0.0,20.0
4613,0,4613,[174 475 742  71 323],506,3,16627,3.603597745990464,0.0,20.0
4614,0,4614,[302 427 603  50 313],271,5,16632,3.6039003250270856,20.0,20.0
4615,0,4615,[302 427 603  50 313],334,5,16637,3.604202772963605,20.0,20.0
4616,0,4616,[427 200 194 211 603],474,4,16641,3.604288499025341,20.0,0.0
4617,0,4617,[271 183 294 235 322],92,1,16642,3.6037245560848854,0.0,0.0
4618,0,4618,[483 118 385 173 172],804,5,16647,3.6040268456375837,20.0,0.0
4619,0,4619,[435 202 515 333  95],263,4,16651,3.6041125541125543,0.0,0.0
4620,0,4620,[276 245 117   1 269],605,3,16654,3.603981822116425,0.0,0.0
4621,0,4621,[143 183 483 191 186],804,4,16658,3.604067503245348,20.0,0.0
4622,0,4622,[ 79 294  22 258  64],311,5,16663,3.6043694570625133,0.0,0.0
4623,0,4623,[ 79 471 258 173 423],455,5,16668,3.6046712802768166,0.0,0.0
4624,0,4624,[187 268 238 288 161],334,3,16671,3.6045405405405404,0.0,0.0
4625,0,4625,[ 96 194 508 197  22],207,3,16674,3.6044098573281453,0.0,0.0
4626,0,4626,[302 427 603  50 313],271,5,16679,3.6047114761184353,20.0,20.0
4627,0,4627,[  8 435 655 127 194],13,5,16684,3.6050129645635263,0.0,20.0
4628,0,4628,[302 427 603  50 313],537,5,16689,3.6053143227478937,20.0,20.0
4629,0,4629,[496 405 204  50 294],882,5,16694,3.6056155507559393,0.0,20.0
4630,0,4630,[302 427 603  50 313],14,4,16698,3.6057007125890737,20.0,20.0
4631,0,4631,[234 403   4 185 289],524,5,16703,3.6060017271157165,0.0,0.0
4632,0,4632,[302 427 603  50 313],474,5,16708,3.606302611698683,20.0,20.0
4633,0,4633,[302 427 603  50 313],537,5,16713,3.6066033664220973,20.0,20.0
4634,0,4634,[183  88 655 238  50],308,5,16718,3.606903991370011,0.0,20.0
4635,0,4635,[302 427 603  50 313],474,5,16723,3.607204486626402,20.0,20.0
4636,0,4636,[302 427 603  50 313],537,5,16728,3.607504852275178,20.0,20.0
4637,0,4637,[ 28  70 168  50 258],271,3,16731,3.607373868046572,0.0,20.0
4638,0,4638,[187  89 435 117 168],308,4,16735,3.6074585039879286,0.0,0.0
4639,0,4639,[222  25 151  97  98],843,0,16735,3.6066810344827585,0.0,20.0
4640,0,4640,[302 427 603  50 313],13,5,16740,3.6069812540400776,20.0,20.0
4641,0,4641,[195 403  71 568 117],543,3,16743,3.606850495476088,0.0,0.0
4642,0,4642,[ 88 121 191  50 258],659,3,16746,3.606719793237131,0.0,20.0
4643,0,4643,[222 273 144 174 323],378,3,16749,3.606589147286822,0.0,20.0
4644,0,4644,[176 194 127  88  22],308,5,16754,3.6068891280947257,0.0,20.0
4645,0,4645,[176 258   1 423 313],92,4,16758,3.606973740852346,0.0,0.0
4646,0,4646,[302 427 603  50 313],537,5,16763,3.607273509791263,20.0,20.0
4647,0,4647,[302 427 603  50 313],13,5,16768,3.6075731497418246,20.0,20.0
4648,0,4648,[435  22 135  96  56],901,4,16772,3.607657560765756,0.0,0.0
4649,0,4649,[302 427 603  50 313],14,4,16776,3.607741935483871,20.0,20.0
4650,0,4650,[ 89 268 151 288 185],334,4,16780,3.607826273919587,0.0,0.0
4651,0,4651,[ 79 228  25 191   9],343,4,16784,3.6079105760963026,0.0,0.0
4652,0,4652,[302 427 603  50 313],669,5,16789,3.6082097571459273,20.0,20.0
4653,0,4653,[235 186 655 286 300],378,4,16793,3.6082939406961754,0.0,0.0
4654,0,4654,[302 427 603  50 313],454,5,16798,3.60859291084855,20.0,20.0
4655,0,4655,[302 427 603  50 313],669,5,16803,3.6088917525773194,20.0,20.0
4656,0,4656,[ 79 405 269  71 258],334,2,16805,3.608546274425596,0.0,0.0
4657,0,4657,[302 427 603  50 313],537,5,16810,3.608844997853156,20.0,20.0
4658,0,4658,[302 427 603  50 313],474,5,16815,3.609143593045718,20.0,20.0
4659,0,4659,[172 191 403  69 742],144,4,16819,3.609227467811159,0.0,0.0
4660,0,4660,[302 427 603  50 313],14,4,16823,3.6093113065865694,20.0,20.0
4661,0,4661,[174 435   8  96 121],850,5,16828,3.6096096096096097,0.0,20.0
4662,0,4662,[187 328   8 135 301],85,4,16832,3.609693330473944,0.0,0.0
4663,0,4663,[174 265 423 181 282],334,4,16836,3.609777015437393,0.0,20.0
4664,0,4664,[215 197  79 196 175],7,5,16841,3.610075026795284,0.0,0.0
4665,0,4665,[423   4 202 268 678],7,2,16843,3.6097299614230605,0.0,0.0
4666,0,4666,[ 11   7 328 357 181],328,4,16847,3.609813584743947,20.0,0.0
4667,0,4667,[302 427 603  50 313],14,4,16851,3.609897172236504,20.0,20.0
4668,0,4668,[302 427 603  50 313],474,5,16856,3.6101949025487254,20.0,20.0
4669,0,4669,[ 64 294 168 151 186],666,2,16858,3.6098501070663813,0.0,0.0
4670,0,4670,[302 187   7 194 216],474,5,16863,3.6101477199743095,0.0,0.0
4671,0,4671,[215  82  71 258  96],533,5,16868,3.610445205479452,0.0,0.0
4672,0,4672,[302 427 603  50 313],13,5,16873,3.6107425636635995,20.0,20.0
4673,0,4673,[ 12 118 202 597  11],145,4,16877,3.6108258451005564,20.0,0.0
4674,0,4674,[276  89 121 127 234],343,2,16879,3.6104812834224598,0.0,20.0
4675,0,4675,[678 118 200 328 275],13,1,16880,3.6099230111206158,0.0,0.0
4676,0,4676,[302 427 603  50 313],537,5,16885,3.610220226641009,20.0,20.0
4677,0,4677,[ 88 257 271 216  89],479,3,16888,3.6100897819581017,0.0,0.0
4678,0,4678,[191 257 135  79 194],271,5,16893,3.6103868347937595,0.0,0.0
4679,0,4679,[181  56   9 182 385],234,0,16893,3.6096153846153847,0.0,0.0
4680,0,4680,[ 69 100 357 181  96],458,2,16895,3.609271523178808,20.0,20.0
4681,0,4681,[423 222 161 180 200],774,1,16896,3.6087142246903032,0.0,0.0
4682,0,4682,[258   1 273 475 300],294,3,16899,3.6085842408712363,0.0,0.0
4683,0,4683,[302 427 603  50 313],13,5,16904,3.608881298035867,20.0,20.0
4684,0,4684,[ 82 211 568 235 238],313,3,16907,3.608751334044824,0.0,0.0
4685,0,4685,[302 427 603  50 313],271,5,16912,3.6090482287665386,20.0,20.0
4686,0,4686,[603 121  56  95 222],313,2,16914,3.6087049285257096,20.0,0.0
4687,0,4687,[ 70  64 294 385 597],804,4,16918,3.608788395904437,0.0,0.0
4688,0,4688,[127 655 357 194 300],840,3,16921,3.6086585625933036,20.0,20.0
4689,0,4689,[211  56 197 183  98],738,4,16925,3.6087420042643923,0.0,20.0
4690,0,4690,[546 185 328 117 282],328,3,16928,3.608612236196973,0.0,0.0
4691,0,4691,[302 427 603  50 313],454,5,16933,3.6089087809036657,20.0,20.0
4692,0,4692,[196 245 161 202 127],653,3,16936,3.6087790326017473,0.0,20.0
4693,0,4693,[302 427 603  50 313],669,5,16941,3.6090754154239453,20.0,20.0
4694,0,4694,[100 328 118  95  79],804,4,16945,3.6091586794462196,0.0,20.0
4695,0,4695,[385 403 186 603  69],650,3,16948,3.6090289608177173,20.0,0.0
4696,0,4696,[302 427 603  50 313],13,5,16953,3.60932510112838,20.0,20.0
4697,0,4697,[196 318 151  88  64],474,4,16957,3.6094082588335463,20.0,0.0
4698,0,4698,[678  96  95 181 268],92,3,16960,3.6092785699084913,0.0,0.0
4699,0,4699,[ 56 515 496 179 117],650,3,16963,3.6091489361702127,0.0,0.0
4700,0,4700,[302 427 603  50 313],14,4,16967,3.6092320782812166,20.0,20.0
4701,0,4701,[ 56 181 200 546 100],339,5,16972,3.6095278604849,0.0,20.0
4702,0,4702,[210 234 257 228 127],749,4,16976,3.6096108866680843,0.0,20.0
4703,0,4703,[  1 288 135 202 143],343,4,16980,3.6096938775510203,0.0,0.0
4704,0,4704,[216 176 185 196  71],13,2,16982,3.6093517534537725,0.0,0.0
4705,0,4705,[202 179 496 423 294],194,3,16985,3.609222269443264,0.0,0.0
4706,0,4706,[435 196  56 204 237],295,5,16990,3.60951773953686,0.0,0.0
4707,0,4707,[288 172 176  82 132],643,4,16994,3.609600679694138,0.0,0.0
4708,0,4708,[  4  97 288 588 222],804,4,16998,3.609683584625186,0.0,0.0
4709,0,4709,[197 289 288 318 423],374,2,17000,3.6093418259023355,20.0,0.0
4710,0,4710,[ 28 597 194  56 568],774,0,17000,3.6085756739545745,0.0,0.0
4711,0,4711,[300 405  69  89 597],145,3,17003,3.608446519524618,0.0,0.0
4712,0,4712,[302 427 603  50 313],334,5,17008,3.608741778060683,20.0,20.0
4713,0,4713,[135 185 568   4 211],788,2,17010,3.608400509121765,0.0,0.0
4714,0,4714,[302 427 603  50 313],14,4,17014,3.6084835630965006,20.0,20.0
4715,0,4715,[127 183  50 258 202],749,5,17019,3.6087786259541983,0.0,40.0
4716,0,4716,[302 427 603  50 313],13,5,17024,3.609073563705745,20.0,20.0
4717,0,4717,[ 79  71 288 222  89],897,5,17029,3.609368376430691,0.0,0.0
4718,0,4718,[302 427 603  50 313],454,5,17034,3.609663064208519,20.0,20.0
4719,0,4719,[ 56   4 181 603 269],537,2,17036,3.609322033898305,20.0,0.0
4720,0,4720,[483  96 183 211 168],308,4,17040,3.6094047871213726,20.0,0.0
4721,0,4721,[ 12 211 174 204 515],6,4,17044,3.609487505294367,20.0,20.0
4722,0,4722,[183 288 423 168 222],882,4,17048,3.6095701884395512,0.0,0.0
4723,0,4723,[ 69 117 176 182 202],538,4,17052,3.60965283657917,0.0,0.0
4724,0,4724,[143   4 180 204 405],882,5,17057,3.60994708994709,0.0,0.0
4725,0,4725,[318 655 282 228 153],328,2,17059,3.609606432501058,20.0,0.0
4726,0,4726,[191 318 195 313  50],234,4,17063,3.6096890205204146,20.0,20.0
4727,0,4727,[286 211 483 175 153],7,5,17068,3.6099830795262267,20.0,0.0
4728,0,4728,[301  79  95 238  97],184,2,17070,3.609642630577289,0.0,0.0
4729,0,4729,[655  22  71  96 135],13,5,17075,3.609936575052854,0.0,0.0
4730,0,4730,[515 435 483 185 197],194,5,17080,3.6102303952652717,20.0,0.0
4731,0,4731,[265 237 143  97 183],263,4,17084,3.610312764158918,0.0,0.0
4732,0,4732,[  7 228  88  89 257],815,4,17088,3.6103950982463555,0.0,0.0
4733,0,4733,[182 678 471  64 168],7,4,17092,3.6104773975496407,0.0,0.0
4734,0,4734,[289 153 435  25 286],387,1,17093,3.6099260823653645,0.0,0.0
4735,0,4735,[289   8  98 748 144],454,3,17096,3.6097972972972974,0.0,20.0
4736,0,4736,[118  88 176 161 257],533,4,17100,3.609879670677644,0.0,0.0
4737,0,4737,[  7  97 211  22 238],95,4,17104,3.609962009286619,0.0,0.0
4738,0,4738,[258 546 173 237 216],666,3,17107,3.60983329816417,0.0,0.0
4739,0,4739,[185 235 186  12 180],833,4,17111,3.609915611814346,20.0,0.0
4740,0,4740,[588 183  82 515  97],387,3,17114,3.6097869647753638,0.0,0.0
4741,0,4741,[215 200  28   8 496],378,3,17117,3.609658371994939,0.0,0.0
4742,0,4742,[328   1  56 301  82],537,1,17118,3.609108159392789,0.0,0.0
4743,0,4743,[546 403 144  25 237],899,1,17119,3.6085581787521077,0.0,0.0
4744,0,4744,[588  50  79  95 568],64,5,17124,3.6088514225500528,0.0,20.0
4745,0,4745,[191 275  82 237 185],694,5,17129,3.6091445427728615,0.0,0.0
4746,0,4746,[302 427 603  50 313],334,5,17134,3.609437539498631,20.0,20.0
4747,0,4747,[ 98 181 202 568 194],650,3,17137,3.609309182813816,0.0,20.0
4748,0,4748,[302 427 603  50 313],334,5,17142,3.609602021478206,20.0,20.0
4749,0,4749,[ 15 181  50  98 282],474,5,17147,3.6098947368421053,0.0,40.0
4750,0,4750,[183   9  56 496 151],6,4,17151,3.6099768469795834,0.0,0.0
4751,0,4751,[302 427 603  50 313],474,5,17156,3.6102693602693603,20.0,20.0
4752,0,4752,[161   9  50  12 269],334,3,17159,3.6101409636019355,20.0,20.0
4753,0,4753,[ 56 588 185 222  11],897,3,17162,3.610012620950778,0.0,0.0
4754,0,4754,[  7  98 202 286 237],194,1,17163,3.6094637223974764,0.0,20.0
4755,0,4755,[135 210 357 117   7],815,2,17165,3.609125315391085,20.0,0.0
4756,0,4756,[211 237  69  25 174],85,3,17168,3.6089972671852006,0.0,20.0
4757,0,4757,[385 435  82 173  95],378,5,17173,3.609289617486339,0.0,0.0
4758,0,4758,[302 427 603  50 313],474,5,17178,3.6095818449254047,20.0,20.0
4759,0,4759,[237 275 191  50  22],184,4,17182,3.6096638655462185,0.0,20.0
4760,0,4760,[196 187   8 471 237],533,3,17185,3.6095358118042427,0.0,0.0
4761,0,4761,[302 427 603  50 313],474,5,17190,3.609827803443931,20.0,20.0
4762,0,4762,[ 25 403 483 313 175],59,5,17195,3.6101196724753306,20.0,0.0
4763,0,4763,[ 69 196 215  98 176],184,4,17199,3.6102015113350125,0.0,20.0
4764,0,4764,[748 187 313 435 168],533,4,17203,3.610283315844701,0.0,0.0
4765,0,4765,[235 168 546 216  25],339,3,17206,3.610155266470835,0.0,0.0
4766,0,4766,[211  96  88 276  70],533,4,17210,3.6102370463603943,0.0,0.0
4767,0,4767,[ 15 118 143 435 238],650,4,17214,3.610318791946309,0.0,0.0
4768,0,4768,[282 328 588 143 357],95,4,17218,3.6104005032501574,20.0,0.0
4769,0,4769,[215 496 405 546 153],95,3,17221,3.610272536687631,0.0,0.0
4770,0,4770,[302 427 603  50 313],271,5,17226,3.610563823097883,20.0,20.0
4771,0,4771,[471 423 118 216 180],92,2,17228,3.6102263202011735,0.0,0.0
4772,0,4772,[ 97   9 508 127 135],455,5,17233,3.6105174942384246,0.0,20.0
4773,0,4773,[111 271 597 181 269],145,4,17237,3.610599078341014,0.0,0.0
4774,0,4774,[180 678 515 168  79],263,4,17241,3.6106806282722514,0.0,0.0
4775,0,4775,[603  12 238 182 194],13,4,17245,3.6107621440536013,40.0,0.0
4776,0,4776,[302 427 603  50 313],454,5,17250,3.611052962110111,20.0,20.0
4777,0,4777,[121  50 276 117 183],346,4,17254,3.611134365843449,0.0,20.0
4778,0,4778,[ 69 496  95 405  22],536,4,17258,3.611215735509521,0.0,0.0
4779,0,4779,[238 302 135 234 182],537,4,17262,3.611297071129707,0.0,0.0
4780,0,4780,[302 427 603  50 313],271,5,17267,3.6115875339887054,20.0,20.0
4781,0,4781,[ 28  95 286 191 179],59,3,17270,3.6114596403178587,0.0,0.0
4782,0,4782,[546 172  71 168 273],13,3,17273,3.6113318001254444,0.0,0.0
4783,0,4783,[ 22 597 144  97 273],378,4,17277,3.6114130434782608,0.0,0.0
4784,0,4784,[168 228  98 385 179],234,1,17278,3.6108672936259145,0.0,20.0
4785,0,4785,[174 191 275  98  79],85,3,17281,3.6107396573338906,0.0,40.0
4786,0,4786,[515 118 186 121 496],194,3,17284,3.6106120743680803,0.0,0.0
4787,0,4787,[ 96 161 180 179  11],543,4,17288,3.6106934001670843,0.0,0.0
4788,0,4788,[288 508 318 100 168],676,3,17291,3.610565880141992,20.0,20.0
4789,0,4789,[302 427 603  50 313],271,5,17296,3.610855949895616,20.0,20.0
4790,0,4790,[302 427 603  50 313],13,5,17301,3.6111458985597995,20.0,20.0
4791,0,4791,[302 427 603  50 313],537,5,17306,3.6114357262103507,20.0,20.0
4792,0,4792,[302 427 603  50 313],669,5,17311,3.611725432923013,20.0,20.0
4793,0,4793,[  8 153 127  97 211],13,5,17316,3.6120150187734668,0.0,20.0
4794,0,4794,[258 234 127 216  25],90,4,17320,3.6120959332638165,0.0,20.0
4795,0,4795,[135  70 187 216 289],234,3,17323,3.6119683069224355,0.0,0.0
4796,0,4796,[302 427 603  50 313],454,5,17328,3.6122576610381487,20.0,20.0
4797,0,4797,[144 385 135 127 196],398,3,17331,3.6121300541892456,0.0,20.0
4798,0,4798,[228 187 118 322 210],313,3,17334,3.612002500520942,0.0,0.0
4799,0,4799,[132 471  70 125 273],7,3,17337,3.611875,0.0,0.0
4800,0,4800,[121 143  98  79  56],59,4,17341,3.6119558425328058,0.0,20.0
4801,0,4801,[427 179 173 588  69],234,2,17343,3.611620158267389,0.0,0.0
4802,0,4802,[302 427 603  50 313],271,5,17348,3.6119092234020402,20.0,20.0
4803,0,4803,[210 181  79 175 678],13,2,17350,3.611573688592839,0.0,0.0
4804,0,4804,[302 427 603  50 313],13,5,17355,3.611862643080125,20.0,20.0
4805,0,4805,[302 427 603  50 313],13,5,17360,3.6121514773200167,20.0,20.0
4806,0,4806,[302 427 603  50 313],669,5,17365,3.61244019138756,20.0,20.0
4807,0,4807,[ 70 588  71 313 180],59,2,17367,3.612104825291181,0.0,0.0
4808,0,4808,[257 328 180 318 135],804,4,17371,3.612185485547931,20.0,0.0
4809,0,4809,[748 496 288 405 603],648,4,17375,3.6122661122661124,20.0,0.0
4810,0,4810,[435 568 405 211 403],901,4,17379,3.612346705466639,0.0,0.0
4811,0,4811,[435 174 182 186 187],506,5,17384,3.6126350789692436,0.0,20.0
4812,0,4812,[302 427 603  50 313],14,4,17388,3.6127155620195306,20.0,20.0
4813,0,4813,[302 427 603  50 313],271,5,17393,3.6130037390943084,20.0,20.0
4814,0,4814,[127 333 318 172 286],85,4,17397,3.6130841121495325,20.0,20.0
4815,0,4815,[546 191 508 127 204],207,3,17400,3.6129568106312293,0.0,20.0
4816,0,4816,[302 427 603  50 313],14,4,17404,3.6130371600581275,20.0,20.0
4817,0,4817,[423  96 294  82 300],533,5,17409,3.6133250311332503,0.0,0.0
4818,0,4818,[ 89 191 211  64 144],804,5,17414,3.6136127827350073,0.0,0.0
4819,0,4819,[300  22  12 132 265],234,2,17416,3.6132780082987552,20.0,0.0
4820,0,4820,[196  98 235  56 168],64,5,17421,3.613565650280025,0.0,20.0
4821,0,4821,[302 427 603  50 313],271,5,17426,3.613853172957279,20.0,20.0
4822,0,4822,[515 196 204 183 403],326,3,17429,3.6137258967447647,0.0,0.0
4823,0,4823,[257  96 228 385 333],881,3,17432,3.613598673300166,0.0,0.0
4824,0,4824,[289  98 117 143 185],234,2,17434,3.613264248704663,0.0,20.0
4825,0,4825,[179 427 191 187 234],833,3,17437,3.613137173642768,0.0,0.0
4826,0,4826,[121 603 300  98  96],7,5,17442,3.613424487259167,20.0,20.0
4827,0,4827,[496 318 301 197  12],234,3,17445,3.6132974316487156,40.0,0.0
4828,0,4828,[100 195 282 161 245],207,2,17447,3.6129633464485402,0.0,20.0
4829,0,4829,[182   4 185 168 286],10,5,17452,3.6132505175983436,0.0,0.0
4830,0,4830,[  7 568 135 186 385],892,3,17455,3.6131235768991927,0.0,0.0
4831,0,4831,[ 89 144  56  95 191],13,4,17459,3.613203642384106,0.0,0.0
4832,0,4832,[403 180  64 655 182],92,5,17464,3.6134905855576247,0.0,0.0
4833,0,4833,[385 191 161 597  25],92,2,17466,3.6131568059577988,0.0,0.0
4834,0,4834,[748 187 210  56 265],543,3,17469,3.6130299896587386,0.0,0.0
4835,0,4835,[175 204 117 475  15],537,2,17471,3.6126964433416044,0.0,0.0
4836,0,4836,[302 427 603  50 313],14,4,17475,3.6127765143684103,20.0,20.0
4837,0,4837,[302 427 603  50 313],474,5,17480,3.6130632492765606,20.0,20.0
4838,0,4838,[302 427 603  50 313],13,5,17485,3.613349865674726,20.0,20.0
4839,0,4839,[483  22 143  50 186],311,3,17488,3.613223140495868,20.0,20.0
4840,0,4840,[302 427 603  50 313],14,4,17492,3.6133030365626935,20.0,20.0
4841,0,4841,[195  95   1 423 322],313,3,17495,3.6131763733994218,0.0,0.0
4842,0,4842,[144 265 238 195 151],7,5,17500,3.613462729712988,0.0,0.0
4843,0,4843,[127 423 185  64  71],6,4,17504,3.6135425268373247,0.0,20.0
4844,0,4844,[302 427 603  50  64],13,5,17509,3.613828689370485,20.0,20.0
4845,0,4845,[302 427 603  50  64],271,5,17514,3.614114733801073,20.0,20.0
4846,0,4846,[302 427 603  50  64],370,5,17519,3.614400660202187,20.0,20.0
4847,0,4847,[121 118  97 191 288],650,2,17521,3.6140676567656764,0.0,0.0
4848,0,4848,[302 427 603  50  64],370,5,17526,3.6143534749432873,20.0,20.0
4849,0,4849,[168 195 271  22 100],833,4,17530,3.6144329896907217,0.0,20.0
4850,0,4850,[508 286 435 127  89],406,4,17534,3.614512471655329,0.0,20.0
4851,0,4851,[ 15   8  25 194 323],474,4,17538,3.6145919208573782,0.0,0.0
4852,0,4852,[  9 423  11 117 289],788,4,17542,3.6146713373171235,0.0,0.0
4853,0,4853,[245 132 273 175 180],92,4,17546,3.6147507210548,0.0,0.0
4854,0,4854,[ 71 121  69 195 276],308,3,17549,3.6146240988671474,0.0,0.0
4855,0,4855,[238 118   1 748 153],653,2,17551,3.614291598023064,0.0,0.0
4856,0,4856,[ 70 196   4 127 185],334,3,17554,3.614165122503603,0.0,20.0
4857,0,4857,[ 70 211  12 546 118],524,4,17558,3.61424454508028,20.0,0.0
4858,0,4858,[183 210 222 195 318],406,4,17562,3.6143239349660425,20.0,0.0
4859,0,4859,[403 234 258 333 328],506,5,17567,3.6146090534979423,0.0,0.0
4860,0,4860,[195 161 153 127 132],308,3,17570,3.6144826167455255,0.0,20.0
4861,0,4861,[153 176 471 228 161],7,3,17573,3.6143562320032907,0.0,0.0
4862,0,4862,[302 427 603  50  64],745,4,17577,3.6144355336212213,20.0,20.0
4863,0,4863,[302 427 603  50  64],666,4,17581,3.6145148026315788,20.0,20.0
4864,0,4864,[173  25 275  96 180],406,2,17583,3.6141829393627956,0.0,0.0
4865,0,4865,[357 423 121 174  79],840,4,17587,3.614262227702425,20.0,20.0
4866,0,4866,[302 427 603  50  64],666,4,17591,3.614341483460037,20.0,20.0
4867,0,4867,[176 161 318  70 275],184,4,17595,3.614420706655711,20.0,0.0
4868,0,4868,[194 546  50 288  98],833,0,17595,3.613678373382625,0.0,40.0
4869,0,4869,[302 427 603  50  64],664,5,17600,3.6139630390143735,20.0,20.0
4870,0,4870,[405 403 118 483   1],804,4,17604,3.614042291110655,20.0,0.0
4871,0,4871,[302 427 603  50  64],271,5,17609,3.6143267651888342,20.0,20.0
4872,0,4872,[132 161  28 237 200],313,2,17611,3.613995485327314,0.0,0.0
4873,0,4873,[173  71 216 271 135],749,5,17616,3.6142798522773902,0.0,0.0
4874,0,4874,[357 742 210 161 185],804,5,17621,3.6145641025641027,20.0,0.0
4875,0,4875,[302 427 603  50  64],669,5,17626,3.614848236259229,20.0,20.0
4876,0,4876,[ 69 435 121 153 194],454,2,17628,3.614517121181054,0.0,0.0
4877,0,4877,[302 427 603  50  64],537,4,17632,3.6145961459614595,20.0,20.0
4878,0,4878,[302 427 603  50  64],370,5,17637,3.614880098380816,20.0,20.0
4879,0,4879,[302 427 603  50  64],454,5,17642,3.6151639344262296,20.0,20.0
4880,0,4880,[302 427 603  50  64],669,5,17647,3.6154476541692278,20.0,20.0
4881,0,4881,[121 143   4 144  69],749,4,17651,3.6155264235968865,0.0,0.0
4882,0,4882,[  4 196 132 655   8],343,5,17656,3.6158099528978087,0.0,0.0
4883,0,4883,[204  82 161 496  71],524,2,17658,3.6154791154791153,0.0,0.0
4884,0,4884,[ 89 515 237 403 187],234,2,17660,3.615148413510747,0.0,0.0
4885,0,4885,[245 286 117 333 181],653,5,17665,3.615431846090872,0.0,0.0
4886,0,4886,[546 678   1 100 742],168,3,17668,3.615305913648455,0.0,20.0
4887,0,4887,[257 508 127 144 216],339,3,17671,3.615180032733224,0.0,20.0
4888,0,4888,[182 121 210  95 265],374,5,17676,3.6154632849253425,0.0,0.0
4889,0,4889,[127 475   4   1 202],374,2,17678,3.6151329243353785,0.0,20.0
4890,0,4890,[588  15 496 153 275],454,1,17679,3.6145982416683706,0.0,0.0
4891,0,4891,[273 183 403  82 235],13,1,17680,3.6140637775960753,0.0,0.0
4892,0,4892,[748 196 385 187 121],533,4,17684,3.6141426527692624,0.0,0.0
4893,0,4893,[197 173 427 143  70],452,4,17688,3.6142214957090313,0.0,0.0
4894,0,4894,[302 427 603  50  64],666,4,17692,3.6143003064351378,20.0,20.0
4895,0,4895,[210 333 273 135 187],537,2,17694,3.613970588235294,0.0,0.0
4896,0,4896,[302 427 603  50  64],271,5,17699,3.614253624668164,20.0,20.0
4897,0,4897,[302 427 603  50  64],669,5,17704,3.6145365455287872,20.0,20.0
4898,0,4898,[ 25 234   4 265 216],83,3,17707,3.6144111043070013,0.0,0.0
4899,0,4899,[302 427 603  50  64],454,5,17712,3.6146938775510202,20.0,20.0
4900,0,4900,[234 182 196  50 597],144,4,17716,3.6147724954091003,0.0,20.0
4901,0,4901,[117  95  22 435 403],881,3,17719,3.6146470828233372,0.0,0.0
4902,0,4902,[357 161 191 301  89],650,3,17722,3.6145217213950644,20.0,0.0
4903,0,4903,[ 88 127 435 173 204],452,2,17724,3.6141924959216967,0.0,20.0
4904,0,4904,[173  56 588 286 515],200,5,17729,3.6144750254841997,0.0,0.0
4905,0,4905,[  4 132 185 127 117],398,4,17733,3.6145536078271503,0.0,20.0
4906,0,4906,[100 286 204  96 385],59,4,17737,3.6146321581414305,0.0,20.0
4907,0,4907,[  4 197 210 215 435],537,1,17738,3.6140994295028523,0.0,0.0
4908,0,4908,[ 89 318 546 117  50],290,2,17740,3.6137706253819517,20.0,20.0
4909,0,4909,[174  79 204  70 185],311,4,17744,3.613849287169043,0.0,20.0
4910,0,4910,[168  50 210 294 127],308,4,17748,3.6139279169211975,0.0,40.0
4911,0,4911,[197 508 268 200 174],537,3,17751,3.613802931596091,0.0,20.0
4912,0,4912,[302 427 603  50  64],664,5,17756,3.6140850803989415,20.0,20.0
4913,0,4913,[186 175 210  56  88],326,1,17757,3.6135531135531136,0.0,0.0
4914,0,4914,[151  95 100 748 174],749,2,17759,3.6132248219735503,0.0,40.0
4915,0,4915,[  8 182 483 185 168],194,3,17762,3.613100081366965,20.0,0.0
4916,0,4916,[302 427 603  50  64],458,4,17766,3.6131787675411835,20.0,20.0
4917,0,4917,[302 427 603  50  64],339,5,17771,3.6134607564050425,20.0,20.0
4918,0,4918,[302 427 603  50  64],669,5,17776,3.613742630615979,20.0,20.0
4919,0,4919,[302 427 603  50  64],666,4,17780,3.613821138211382,20.0,20.0
4920,0,4920,[515 286 357 269 183],666,5,17785,3.6141028246291405,20.0,0.0
4921,0,4921,[302 427 603  50  64],271,5,17790,3.6143843965867535,20.0,20.0
4922,0,4922,[302 427 603  50  64],669,5,17795,3.614665854153971,20.0,20.0
4923,0,4923,[181 318 403 357 132],533,3,17798,3.614541023558083,40.0,0.0
4924,0,4924,[302 427 603  50  64],13,5,17803,3.6148223350253805,20.0,20.0
4925,0,4925,[302 427 603  50  64],745,4,17807,3.6149005278116118,20.0,20.0
4926,0,4926,[302 427 603  50  64],370,5,17812,3.6151816521209663,20.0,20.0
4927,0,4927,[215 132 100  88 655],378,5,17817,3.6154626623376624,0.0,20.0
4928,0,4928,[302 427 603  50  64],474,5,17822,3.6157435585311424,20.0,20.0
4929,0,4929,[ 64 508 117 275  22],125,3,17825,3.6156186612576064,0.0,0.0
4930,0,4930,[204 403 328  28 435],328,3,17828,3.6154938146420603,0.0,0.0
4931,0,4931,[322 603   8   4 588],308,4,17832,3.6155717761557176,20.0,0.0
4932,0,4932,[302 427 603  50  64],664,5,17837,3.615852422460977,20.0,20.0
4933,0,4933,[  9  12  89 197 181],60,5,17842,3.6161329550060803,20.0,0.0
4934,0,4934,[357 132 216   7 175],465,4,17846,3.6162107396149947,20.0,0.0
4935,0,4935,[427  79 186   7  98],374,3,17849,3.6160858995137763,0.0,20.0
4936,0,4936,[302 427 603  50  64],745,4,17853,3.616163662143002,20.0,20.0
4937,0,4937,[508 172 176 194 182],378,5,17858,3.616443904414743,0.0,0.0
4938,0,4938,[ 56 235  97 179 111],64,4,17862,3.616521563069447,0.0,0.0
4939,0,4939,[ 95 118 265 202   4],308,3,17865,3.616396761133603,0.0,0.0
4940,0,4940,[216 180 265 318 168],479,4,17869,3.616474397895163,20.0,0.0
4941,0,4941,[ 25  69 742   4 185],374,4,17873,3.6165520032375555,0.0,0.0
4942,0,4942,[  4   7 100 144 237],64,3,17876,3.6164272708881247,0.0,20.0
4943,0,4943,[302 427 603  50  64],13,5,17881,3.6167071197411005,20.0,20.0
4944,0,4944,[302 427 603  50  64],454,5,17886,3.6169868554095044,20.0,20.0
4945,0,4945,[302 427 603  50  64],454,5,17891,3.6172664779619894,20.0,20.0
4946,0,4946,[ 50  96 174 742 273],387,4,17895,3.6173438447543966,0.0,40.0
4947,0,4947,[302 427 603  50  64],537,4,17899,3.6174211802748584,20.0,20.0
4948,0,4948,[302 427 603  50  64],474,5,17904,3.6177005455647606,20.0,20.0
4949,0,4949,[302 427 603  50  64],664,5,17909,3.617979797979798,20.0,20.0
4950,0,4950,[385  56 135 202  22],13,4,17913,3.6180569581902646,0.0,0.0
4951,0,4951,[302 427 603  50  64],458,4,17917,3.61813408723748,20.0,20.0
4952,0,4952,[153 403  95 588 258],899,3,17920,3.6180092873006258,0.0,0.0
4953,0,4953,[ 56 186 357 216 204],207,4,17924,3.6180863948324586,20.0,0.0
4954,0,4954,[ 50 742  25 204 173],378,5,17929,3.618365287588295,0.0,20.0
4955,0,4955,[ 69 496 301 195 175],378,1,17930,3.6178369652945923,0.0,0.0
4956,0,4956,[302 427 603  50  64],458,4,17934,3.6179140609239457,20.0,20.0
4957,0,4957,[258 328   7 143 405],653,1,17935,3.6173860427591773,0.0,0.0
4958,0,4958,[403   9 135  64 111],13,3,17938,3.6172615446662633,0.0,0.0
4959,0,4959,[546 117  98 423  64],378,3,17941,3.6171370967741936,0.0,20.0
4960,0,4960,[302 427 603  50  64],537,4,17945,3.617214271316267,20.0,20.0
4961,0,4961,[302 427 603  50  64],339,5,17950,3.617492946392584,20.0,20.0
4962,0,4962,[302 427 603  50  64],339,5,17955,3.617771509167842,20.0,20.0
4963,0,4963,[187 182 153 234 288],833,2,17957,3.6174456083803386,0.0,0.0
4964,0,4964,[204 238 234 182  25],537,2,17959,3.617119838872105,0.0,0.0
4965,0,4965,[318 135 181  50 385],92,4,17963,3.617196939186468,20.0,20.0
4966,0,4966,[127 185 215 174 168],650,2,17965,3.6168713509160457,0.0,40.0
4967,0,4967,[ 88 427 210 194  82],533,5,17970,3.617149758454106,0.0,0.0
4968,0,4968,[235 179  15 111 234],537,1,17971,3.6166230629905414,0.0,0.0
4969,0,4969,[302 427 603  50  64],454,5,17976,3.6169014084507043,20.0,20.0
4970,0,4970,[202  69 173   1  15],271,3,17979,3.616777308388654,0.0,0.0
4971,0,4971,[ 28 215 323 742 175],648,3,17982,3.6166532582461786,0.0,0.0
4972,0,4972,[288  69 186 435  56],533,2,17984,3.6163281721294993,0.0,0.0
4973,0,4973,[385 144 257 127  25],374,4,17988,3.6164053075995173,0.0,20.0
4974,0,4974,[187 288   9  22 144],308,4,17992,3.6164824120603014,0.0,0.0
4975,0,4975,[302 427 603  50  64],669,5,17997,3.6167604501607715,20.0,20.0
4976,0,4976,[ 22  98 238 313 204],650,4,18001,3.6168374522804903,0.0,20.0
4977,0,4977,[ 82 202  12 182 228],92,3,18004,3.616713539574126,20.0,0.0
4978,0,4978,[ 69 202 172 168 144],527,4,18008,3.616790520184776,0.0,0.0
4979,0,4979,[302 427 603  50  64],271,5,18013,3.6170682730923693,20.0,20.0
4980,0,4980,[ 97 294 183 328 100],488,4,18017,3.617145151575989,0.0,20.0
4981,0,4981,[216 174  96 302   8],13,4,18021,3.6172219991971097,0.0,20.0
4982,0,4982,[302 427 603  50  64],745,4,18025,3.6172988159743125,20.0,20.0
4983,0,4983,[265 181 186 211 182],64,5,18030,3.6175762439807384,0.0,0.0
4984,0,4984,[568 546 179  56 294],7,4,18034,3.6176529588766297,0.0,0.0
4985,0,4985,[302 427 603  50  64],271,5,18039,3.617930204572804,20.0,20.0
4986,0,4986,[269 196 204 216 423],339,2,18041,3.617605775015039,0.0,0.0
4987,0,4987,[118 215 176 286 175],7,3,18044,3.6174819566960705,0.0,0.0
4988,0,4988,[302 427 603  50  64],454,5,18049,3.6177590699538986,20.0,20.0
4989,0,4989,[  8  98 268 117 427],90,4,18053,3.6178356713426854,0.0,20.0
4990,0,4990,[302 427 603  50  64],745,4,18057,3.6179122420356644,20.0,20.0
4991,0,4991,[302 427 603  50  64],271,5,18062,3.6181891025641026,20.0,20.0
4992,0,4992,[269 135 385 423 174],64,5,18067,3.6184658521930704,0.0,20.0
4993,0,4993,[215 471  97 153 100],13,4,18071,3.618542250700841,0.0,20.0
4994,0,4994,[ 82 144 181   1 597],95,3,18074,3.6184184184184183,0.0,0.0
4995,0,4995,[678 405 294  12 143],605,2,18076,3.6180944755804645,20.0,0.0
4996,0,4996,[302 427 603  50  64],13,5,18081,3.618371022613568,20.0,20.0
4997,0,4997,[603 237 182 202 228],313,3,18084,3.618247298919568,20.0,0.0
4998,0,4998,[302 427 603  50  64],339,5,18089,3.618523704740948,20.0,20.0
4999,0,4999,[234 269 195 385 183],10,5,18094,3.6188,0.0,0.0
5000,0,5000,[597 288 161 196 132],59,3,18097,3.6186762647470507,0.0,0.0
5001,0,5001,[302 427 603  50  64],664,5,18102,3.618952419032387,20.0,20.0
5002,0,5002,[302 427 603  50  64],666,4,18106,3.61902858285029,20.0,20.0
5003,0,5003,[257 546 210 268 222],92,3,18109,3.6189048760991205,0.0,0.0
5004,0,5004,[176 289  89 568 597],13,1,18110,3.618381618381618,0.0,0.0
5005,0,5005,[357 118 121 275  28],882,5,18115,3.6186576108669595,20.0,0.0
5006,0,5006,[196  88 210 172 194],298,5,18120,3.6189334931096466,0.0,0.0
5007,0,5007,[302 427 603  50  64],13,5,18125,3.619209265175719,20.0,20.0
5008,0,5008,[173 222 235 237 546],64,4,18129,3.6192852864843283,0.0,0.0
5009,0,5009,[186   9 125 603 181],749,4,18133,3.6193612774451096,20.0,0.0
5010,0,5010,[265 323 276 181 385],59,5,18138,3.6196367990421074,0.0,0.0
5011,0,5011,[302 427 603  50  64],745,4,18142,3.619712689545092,20.0,20.0
5012,0,5012,[302 427 603  50  64],458,4,18146,3.6197885497705964,20.0,20.0
5013,0,5013,[237  15 204 202 603],234,1,18147,3.6192660550458715,20.0,0.0
5014,0,5014,[ 69 235 111 515 483],833,2,18149,3.618943170488534,20.0,0.0
5015,0,5015,[161 118  64   1 655],804,5,18154,3.619218500797448,0.0,0.0
5016,0,5016,[423 318 269  12 257],334,4,18158,3.619294399043253,40.0,0.0
5017,0,5017,[302 427 603  50  64],669,5,18163,3.619569549621363,20.0,20.0
5018,0,5018,[302 427 603  50  64],745,4,18167,3.6196453476788206,20.0,20.0
5019,0,5019,[302 427 603  50  64],474,5,18172,3.6199203187250997,20.0,20.0
5020,0,5020,[302 427 603  50  64],537,4,18176,3.619996016729735,20.0,20.0
5021,0,5021,[197 125 385 180 172],881,4,18180,3.620071684587814,0.0,0.0
5022,0,5022,[182 357 175   8 215],474,5,18185,3.620346406529962,20.0,0.0
5023,0,5023,[273  82 195 194 357],666,1,18186,3.6198248407643314,20.0,0.0
5024,0,5024,[302 427 603  50  64],458,4,18190,3.619900497512438,20.0,20.0
5025,0,5025,[302 427 603  50  64],666,4,18194,3.6199761241543973,20.0,20.0
5026,0,5026,[302 427 603  50  64],745,4,18198,3.620051720708176,20.0,20.0
5027,0,5027,[187 588 301 300 197],234,2,18200,3.6197295147175814,0.0,0.0
5028,0,5028,[302 427 603  50  64],370,5,18205,3.620003976933784,20.0,20.0
5029,0,5029,[302 427 603  50  64],370,5,18210,3.6202783300198806,20.0,20.0
5030,0,5030,[546 100 427   7  22],650,3,18213,3.62015503875969,0.0,20.0
5031,0,5031,[302 427 603  50  64],664,5,18218,3.620429252782194,20.0,20.0
5032,0,5032,[117  89 202 111 568],749,4,18222,3.6205046691833895,0.0,0.0
5033,0,5033,[181  50 100 265 121],13,5,18227,3.6207787048073103,0.0,40.0
5034,0,5034,[132 435  89 427  96],7,5,18232,3.6210526315789475,0.0,0.0
5035,0,5035,[313 496 235 143  98],308,1,18233,3.620532168387609,0.0,20.0
5036,0,5036,[258 289 132  25 288],533,3,18236,3.620408973595394,0.0,0.0
5037,0,5037,[175 197  69 508 385],326,0,18236,3.6196903533148075,0.0,0.0
5038,0,5038,[179 197 173 496 181],738,4,18240,3.6197658265528876,0.0,0.0
5039,0,5039,[ 56 742 121 143 288],92,2,18242,3.6194444444444445,0.0,0.0
5040,0,5040,[ 98 237 181 300 117],346,4,18246,3.6195199365205317,0.0,20.0
5041,0,5041,[182 271 143  96 194],537,1,18247,3.619000396667989,0.0,0.0
5042,0,5042,[515  12  25 237 427],90,5,18252,3.619274241522903,20.0,0.0
5043,0,5043,[302 427 603  50  64],664,5,18257,3.6195479777954005,20.0,20.0
5044,0,5044,[302 427 603  50  64],745,4,18261,3.619623389494549,20.0,20.0
5045,0,5045,[144 181 210 403  89],7,4,18265,3.619698771304003,0.0,0.0
5046,0,5046,[180 405 174 222 211],749,3,18268,3.6195759857340994,0.0,20.0
5047,0,5047,[161 322 100 125 257],334,2,18270,3.6192551505546753,0.0,20.0
5048,0,5048,[471  82 211 275 258],533,5,18275,3.6195286195286194,0.0,0.0
5049,0,5049,[302 427 603  50  64],664,5,18280,3.61980198019802,20.0,20.0
5050,0,5050,[275 180  64  71  89],328,5,18285,3.6200752326272023,0.0,0.0
5051,0,5051,[132 234 200 176   9],881,1,18286,3.619556611243072,0.0,0.0
5052,0,5052,[302 427 603  50  64],271,5,18291,3.6198298040767862,20.0,20.0
5053,0,5053,[  8 405 301 125 144],455,1,18292,3.6193114364859515,0.0,0.0
5054,0,5054,[302 427 603  50  64],13,5,18297,3.619584569732938,20.0,20.0
5055,0,5055,[302 427 603  50  64],664,5,18302,3.619857594936709,20.0,20.0
5056,0,5056,[183 496 228  70 483],334,3,18305,3.6197350207632986,20.0,0.0
5057,0,5057,[302 427 603  50  64],745,4,18309,3.6198102016607354,20.0,20.0
5058,0,5058,[222  95 483 288 186],892,4,18313,3.619885352836529,20.0,0.0
5059,0,5059,[  7  11 180 202 179],92,4,18317,3.6199604743083005,0.0,0.0
5060,0,5060,[302 427 603  50  64],339,5,18322,3.620233155502865,20.0,20.0
5061,0,5061,[302 427 603  50  64],454,5,18327,3.620505728960885,20.0,20.0
5062,0,5062,[302 427 603  50  64],339,5,18332,3.620778194746198,20.0,20.0
5063,0,5063,[121  28 175 143 515],313,3,18335,3.6206556082148498,0.0,0.0
5064,0,5064,[302 427 603  50  64],474,5,18340,3.6209279368213227,20.0,20.0
5065,0,5065,[302 427 603  50  64],474,5,18345,3.6212001579155153,20.0,20.0
5066,0,5066,[302 427 603  50  64],370,5,18350,3.6214722715610814,20.0,20.0
5067,0,5067,[302 427 603  50  64],474,5,18355,3.621744277821626,20.0,20.0
5068,0,5068,[302 427 603  50  64],370,5,18360,3.6220161767607024,20.0,20.0
5069,0,5069,[118  88 294  22 405],145,3,18363,3.6218934911242604,0.0,0.0
5070,0,5070,[385 135  79 403 125],64,4,18367,3.621968053638336,0.0,0.0
5071,0,5071,[197 196 216  12  79],378,4,18371,3.622042586750789,20.0,0.0
5072,0,5072,[302 427 603  50  64],370,5,18376,3.622314212497536,20.0,20.0
5073,0,5073,[275 603 257  79 234],308,4,18380,3.62238864800946,20.0,0.0
5074,0,5074,[318  25 423  12 237],666,2,18382,3.6220689655172413,40.0,0.0
5075,0,5075,[ 88  69 197 127 186],398,5,18387,3.622340425531915,0.0,20.0
5076,0,5076,[475   7 125 237 508],6,1,18388,3.621823911758913,0.0,0.0
5077,0,5077,[144 288 183  97 173],339,3,18391,3.6217014572666404,0.0,0.0
5078,0,5078,[302 427 603  50  64],339,5,18396,3.6219728292971056,20.0,20.0
5079,0,5079,[153 286 179 603 265],650,3,18399,3.6218503937007873,20.0,0.0
5080,0,5080,[132 275  25 302 238],13,2,18401,3.6215311946467232,0.0,0.0
5081,0,5081,[427 210  12 211 333],666,3,18404,3.621408894136167,20.0,0.0
5082,0,5082,[135 174 197 748 186],313,3,18407,3.621286641747,0.0,20.0
5083,0,5083,[302 427 603  50  64],474,5,18412,3.6215578284815106,20.0,20.0
5084,0,5084,[276 216 271  95 288],334,1,18413,3.6210422812192724,0.0,0.0
5085,0,5085,[302 427 603  50  64],370,5,18418,3.6213134093590247,20.0,20.0
5086,0,5086,[118  82 211 174  56],653,3,18421,3.621191271869471,0.0,20.0
5087,0,5087,[ 50   4 182 322 127],13,4,18425,3.62126572327044,0.0,40.0
5088,0,5088,[173 182 175   7 180],378,4,18429,3.621340145411672,0.0,0.0
5089,0,5089,[235 508 318 183 181],59,4,18433,3.6214145383104124,20.0,0.0
5090,0,5090,[302 427 603  50  64],339,5,18438,3.6216853270477314,20.0,20.0
5091,0,5091,[ 56 273 144 323  11],374,3,18441,3.621563236449332,0.0,0.0
5092,0,5092,[183 678 135  69 322],881,3,18444,3.6214411937954054,0.0,0.0
5093,0,5093,[302 427 603  50  64],537,4,18448,3.6215155084413033,20.0,20.0
5094,0,5094,[427 235 117  15 288],374,2,18450,3.621197252208047,0.0,0.0
5095,0,5095,[435 187 568 496 161],59,4,18454,3.6212715855572997,0.0,0.0
5096,0,5096,[302 603 427  50  64],13,5,18459,3.6215420835785754,20.0,20.0
5097,0,5097,[258 423  96 185 235],479,3,18462,3.621420164770498,0.0,0.0
5098,0,5098,[302 603 427  50  64],664,5,18467,3.6216905275544224,20.0,20.0
5099,0,5099,[174 357 265 405 132],892,5,18472,3.6219607843137256,20.0,20.0
5100,0,5100,[143 161 273 275 234],13,2,18474,3.621642815134287,0.0,0.0
5101,0,5101,[181 211 483  22  56],648,4,18478,3.62171697373579,20.0,0.0
5102,0,5102,[ 96  88  97 210 322],313,3,18481,3.6215951401136586,0.0,0.0
5103,0,5103,[ 64 127 568 182 748],804,4,18485,3.6216692789968654,0.0,20.0
5104,0,5104,[ 11 742 435 568  97],59,4,18489,3.621743388834476,0.0,0.0
5105,0,5105,[597  56 508 357 268],643,4,18493,3.6218174696435566,20.0,0.0
5106,0,5106,[302 603 427  50  64],666,4,18497,3.6218915214411593,20.0,20.0
5107,0,5107,[318 191  96 187 202],308,5,18502,3.6221613155833987,20.0,0.0
5108,0,5108,[175  96  95 180 655],843,1,18503,3.6216480720297515,0.0,0.0
5109,0,5109,[ 15 132 265 435 228],533,4,18507,3.6217221135029356,0.0,0.0
5110,0,5110,[ 56 475   4   8  12],115,5,18512,3.6219917824300527,20.0,0.0
5111,0,5111,[302 603 427  50  64],339,5,18517,3.622261345852895,20.0,20.0
5112,0,5112,[302 603 427  50  64],666,4,18521,3.622335223938979,20.0,20.0
5113,0,5113,[655 173 202 181 237],92,3,18524,3.6222135314822057,0.0,0.0
5114,0,5114,[202 144  12   8 197],379,5,18529,3.6224828934506355,20.0,0.0
5115,0,5115,[508 286 151 100 175],59,4,18533,3.622556684910086,0.0,20.0
5116,0,5116,[ 69 191  22 204 496],194,5,18538,3.622825874535861,0.0,0.0
5117,0,5117,[153 185 268 483 228],234,1,18539,3.62231340367331,20.0,0.0
5118,0,5118,[302 603 427  50  64],669,5,18544,3.6225825356514942,20.0,20.0
5119,0,5119,[ 56 153 121 204 168],833,2,18546,3.622265625,0.0,0.0
5120,0,5120,[302 603 427  50  64],458,4,18550,3.622339386838508,20.0,20.0
5121,0,5121,[181 186 182  69 318],488,4,18554,3.622413119875049,20.0,0.0
5122,0,5122,[302 603 427  50  64],271,5,18559,3.622682022252586,20.0,20.0
5123,0,5123,[435  22 111  64 172],125,4,18563,3.6227556596409056,0.0,0.0
5124,0,5124,[ 15 121 275 172 427],406,4,18567,3.622829268292683,0.0,0.0
5125,0,5125,[186 427 175 403 546],833,1,18568,3.6223175965665235,0.0,0.0
5126,0,5126,[508 276  82  88  12],533,4,18572,3.6223912619465573,20.0,0.0
5127,0,5127,[302 603 427  50  64],370,5,18577,3.622659906396256,20.0,20.0
5128,0,5128,[276 286 197 216 183],871,1,18578,3.622148566972119,0.0,0.0
5129,0,5129,[405 187   8 265 483],488,1,18579,3.621637426900585,20.0,0.0
5130,0,5130,[118 117 196  96 275],311,4,18583,3.6217111674137596,0.0,0.0
5131,0,5131,[302 603 427  50  64],370,5,18588,3.6219797349961027,20.0,20.0
5132,0,5132,[302 603 427  50  64],669,5,18593,3.622248197934931,20.0,20.0
5133,0,5133,[289  71 153 204 143],334,2,18595,3.6219322165952472,0.0,0.0
5134,0,5134,[302 603 427  50  64],474,5,18600,3.622200584225901,20.0,20.0
5135,0,5135,[302 603 427  50  64],666,4,18604,3.622274143302181,20.0,20.0
5136,0,5136,[271 183 273 172 200],479,4,18608,3.6223476737395366,0.0,0.0
5137,0,5137,[132   1 546  88 435],13,3,18611,3.6222265472946673,0.0,0.0
5138,0,5138,[ 69 403 181 186 196],378,3,18614,3.6221054679898814,0.0,0.0
5139,0,5139,[  8 216 187 257 175],479,4,18618,3.6221789883268483,0.0,0.0
5140,0,5140,[ 97 748 546   8 427],328,0,18618,3.6214744213188097,0.0,0.0
5141,0,5141,[302 603 427  50  64],271,5,18623,3.6217425126409957,20.0,20.0
5142,0,5142,[302 603 427  50  64],745,4,18627,3.6218160606649814,20.0,20.0
5143,0,5143,[302 603 427  50  64],271,5,18632,3.6220839813374806,20.0,20.0
5144,0,5144,[302 603 427  50  64],666,4,18636,3.6221574344023324,20.0,20.0
5145,0,5145,[302 603 427  50  64],370,5,18641,3.6224251846094053,20.0,20.0
5146,0,5146,[302 603 427  50  64],537,4,18645,3.6224985428404897,20.0,20.0
5147,0,5147,[100 144  15 265 318],479,3,18648,3.6223776223776225,20.0,20.0
5148,0,5148,[ 12 483 187 172 168],537,3,18651,3.622256748883278,40.0,0.0
5149,0,5149,[202 269 288 237 276],378,3,18654,3.6221359223300973,0.0,0.0
5150,0,5150,[ 25 328 257 258 508],413,3,18657,3.62201514269074,0.0,0.0
5151,0,5151,[748 300 546  70 127],653,3,18660,3.6218944099378882,0.0,20.0
5152,0,5152,[127 546 195 405  69],524,3,18663,3.621773724044246,0.0,20.0
5153,0,5153,[302 603 427  50  64],370,5,18668,3.6220411331005047,20.0,20.0
5154,0,5154,[588  50 191  70 172],537,3,18671,3.62192046556741,0.0,20.0
5155,0,5155,[202 222 100 333 268],699,2,18673,3.6216058960434445,0.0,20.0
5156,0,5156,[191 179 187 269 174],452,4,18677,3.6216792708939307,0.0,20.0
5157,0,5157,[216 318  89  98 273],395,3,18680,3.6215587436991084,20.0,20.0
5158,0,5158,[118  79 195 174 322],454,4,18684,3.6216320992440396,0.0,20.0
5159,0,5159,[302 603 427  50  64],271,5,18689,3.6218992248062016,20.0,20.0
5160,0,5160,[173 125 568  71 127],897,4,18693,3.621972485952335,0.0,20.0
5161,0,5161,[ 69  12 121  25 265],387,2,18695,3.621658271987602,20.0,0.0
5162,0,5162,[302 603 427  50  64],370,5,18700,3.621925237265156,20.0,20.0
5163,0,5163,[302 603 427  50  64],454,5,18705,3.6221920991479473,20.0,20.0
5164,0,5164,[ 70 174 742 288 215],488,3,18708,3.6220716360116167,0.0,20.0
5165,0,5165,[302 603 427  50  64],666,4,18712,3.6221447928765,20.0,20.0
5166,0,5166,[302 603 427  50  64],666,4,18716,3.6222179214244243,20.0,20.0
5167,0,5167,[302 603 427  50  64],271,5,18721,3.622484520123839,20.0,20.0
5168,0,5168,[228 289 276  12   7],406,3,18724,3.6223640936351327,20.0,0.0
5169,0,5169,[302 603 427  50  64],454,5,18729,3.622630560928433,20.0,20.0
5170,0,5170,[161 204 153  79 435],295,5,18734,3.6228969251595435,0.0,0.0
5171,0,5171,[168 357   1 405 276],271,1,18735,3.6223897911832945,20.0,0.0
5172,0,5172,[ 82 200 111 483 176],13,2,18737,3.6220761647013338,20.0,0.0
5173,0,5173,[302 603 427  50  64],339,5,18742,3.622342481638964,20.0,20.0
5174,0,5174,[546  79  15 117 238],749,3,18745,3.6222222222222222,0.0,0.0
5175,0,5175,[318 210 132 135 405],536,4,18749,3.6222952086553324,20.0,0.0
5176,0,5176,[302 603 427  50  64],454,5,18754,3.622561328954993,20.0,20.0
5177,0,5177,[153 117 202 175  98],13,4,18758,3.622634221707223,0.0,20.0
5178,0,5178,[ 79 275 357 202 678],308,4,18762,3.6227070863100983,20.0,0.0
5179,0,5179,[  7 121 568 258   4],64,2,18764,3.6223938223938226,0.0,0.0
5180,0,5180,[302 603 427  50  64],339,5,18769,3.6226597182011195,20.0,20.0
5181,0,5181,[ 69 186 483 135  22],313,3,18772,3.622539560015438,20.0,0.0
5182,0,5182,[427 168 496 186 182],313,3,18775,3.6224194481960255,0.0,0.0
5183,0,5183,[483 215  98 423 282],643,2,18777,3.6221064814814814,20.0,20.0
5184,0,5184,[269   7 238 423 748],13,2,18779,3.6217936354869815,0.0,0.0
5185,0,5185,[302 603 427  50  64],474,5,18784,3.622059390667181,20.0,20.0
5186,0,5186,[423 186 135 471 144],13,4,18788,3.622132253711201,0.0,0.0
5187,0,5187,[100  15 322 187 153],749,3,18791,3.62201233616037,0.0,20.0
5188,0,5188,[ 89 568   1  79  98],308,4,18795,3.622085180188861,0.0,20.0
5189,0,5189,[ 50 151 194 483 118],524,4,18799,3.6221579961464356,20.0,20.0
5190,0,5190,[ 11 496 182  82 423],653,1,18800,3.6216528607204777,0.0,0.0
5191,0,5191,[318 211 286 185 269],883,3,18803,3.62153312788906,20.0,0.0
5192,0,5192,[302 603 427  50  64],13,5,18808,3.621798575004814,20.0,20.0
5193,0,5193,[302 603 427  50  64],474,5,18813,3.6220639199075855,20.0,20.0
5194,0,5194,[302 603 427  50  64],454,5,18818,3.6223291626564005,20.0,20.0
5195,0,5195,[187 234 180 181  28],881,4,18822,3.6224018475750577,0.0,0.0
5196,0,5196,[210  88 496 176 235],313,3,18825,3.6222820858187417,0.0,0.0
5197,0,5197,[302 603 427  50  64],271,5,18830,3.6225471335128896,20.0,20.0
5198,0,5198,[302 603 427  50  64],666,4,18834,3.6226197345643394,20.0,20.0
5199,0,5199,[196 318 216  71 185],488,2,18836,3.6223076923076922,20.0,0.0
5200,0,5200,[385   7 678 269   1],13,0,18836,3.6216112286098827,0.0,0.0
5201,0,5201,[597 328 161 176  98],13,2,18838,3.621299500192234,0.0,20.0
5202,0,5202,[153 300  25 172  71],749,5,18843,3.6215644820295982,0.0,0.0
5203,0,5203,[174 588  89  25  88],234,0,18843,3.62086856264412,0.0,20.0
5204,0,5204,[ 88 204 211 182  56],650,2,18845,3.6205571565802113,0.0,0.0
5205,0,5205,[ 11 197  79 117 202],184,1,18846,3.620053784095275,0.0,0.0
5206,0,5206,[234  56 187 357 143],234,3,18849,3.6199347032840405,20.0,0.0
5207,0,5207,[ 15 228 174   8 216],215,3,18852,3.619815668202765,0.0,20.0
5208,0,5208,[187 180 318 385 100],7,5,18857,3.6200806296794013,20.0,20.0
5209,0,5209,[258 385 174 172 273],8,3,18860,3.619961612284069,0.0,20.0
5210,0,5210,[194 195 515 405  25],313,3,18863,3.619842640568029,0.0,0.0
5211,0,5211,[302 603 427  50  64],13,5,18868,3.620107444359171,20.0,20.0
5212,0,5212,[265 132 546 176 195],92,3,18871,3.61998849031268,0.0,0.0
5213,0,5213,[302 603 427  50  64],474,5,18876,3.6202531645569622,20.0,20.0
5214,0,5214,[176  70 323 276 182],474,4,18880,3.62032598274209,0.0,0.0
5215,0,5215,[302 603 427  50  64],13,5,18885,3.620590490797546,20.0,20.0
5216,0,5216,[302 603 427  50  64],745,4,18889,3.6206632164078973,20.0,20.0
5217,0,5217,[200 238  28 427 405],271,4,18893,3.6207359141433497,0.0,0.0
5218,0,5218,[302 603 427  50  64],664,5,18898,3.6210001916075876,20.0,20.0
5219,0,5219,[302 603 427  50  64],458,4,18902,3.621072796934866,20.0,20.0
5220,0,5220,[423 111 161  64 237],95,3,18905,3.6209538402604866,0.0,0.0
5221,0,5221,[186 175 132 204 125],334,2,18907,3.6206434316353886,0.0,0.0
5222,0,5222,[237  97 222  89 100],804,5,18912,3.620907524411258,0.0,20.0
5223,0,5223,[257  22 181  56 245],334,4,18916,3.620980091883614,0.0,0.0
5224,0,5224,[132 144 357 257 175],95,4,18920,3.6210526315789475,20.0,0.0
5225,0,5225,[172 435  79 427 234],326,3,18923,3.620933792575584,0.0,0.0
5226,0,5226,[302 603 427  50  64],339,5,18928,3.621197627702315,20.0,20.0
5227,0,5227,[546  70 245 385 204],378,3,18931,3.6210788064269317,0.0,0.0
5228,0,5228,[183 179 678  89 202],387,3,18934,3.6209600305985847,0.0,0.0
5229,0,5229,[234 678 172 100  79],455,4,18938,3.6210325047801146,0.0,20.0
5230,0,5230,[302 603 427  50  64],458,4,18942,3.6211049512521507,20.0,20.0
5231,0,5231,[302 603 427  50  64],370,5,18947,3.621368501529052,20.0,20.0
5232,0,5232,[195 294  50 322  12],901,4,18951,3.6214408561054845,20.0,20.0
5233,0,5233,[496 403 173 427 204],379,5,18956,3.6217042414978984,0.0,0.0
5234,0,5234,[357 200 182  12 269],10,5,18961,3.6219675262655207,40.0,0.0
5235,0,5235,[ 95 132 153  22 196],749,4,18965,3.6220397249809015,0.0,0.0
5236,0,5236,[302 603 427  50  64],664,5,18970,3.6223028451403474,20.0,20.0
5237,0,5237,[302 603 427  50  64],370,5,18975,3.622565864833906,20.0,20.0
5238,0,5238,[302 603 427  50  64],454,5,18980,3.6228287841191067,20.0,20.0
5239,0,5239,[132 135 197 173 435],6,5,18985,3.6230916030534353,0.0,0.0
5240,0,5240,[235 196   9   4 132],194,2,18987,3.6227819118488838,0.0,0.0
5241,0,5241,[302 603 427  50  64],271,5,18992,3.6230446394505913,20.0,20.0
5242,0,5242,[515  79  11 385 195],64,5,18997,3.6233072668319664,0.0,0.0
5243,0,5243,[173 180 196 168 197],749,5,19002,3.623569794050343,0.0,0.0
5244,0,5244,[117 423  64 405 195],6,2,19004,3.6232602478551,0.0,0.0
5245,0,5245,[515 475 427 286 276],458,5,19009,3.623522683949676,0.0,0.0
5246,0,5246,[302 603 427  50  64],666,4,19013,3.62359443491519,20.0,20.0
5247,0,5247,[  1 182 742   8 186],533,2,19015,3.6232850609756095,0.0,0.0
5248,0,5248,[302 603 427  50  64],664,5,19020,3.623547342350924,20.0,20.0
5249,0,5249,[302 603 427  50  64],271,5,19025,3.623809523809524,20.0,20.0
5250,0,5250,[ 79 257 289 144  88],95,4,19029,3.6238811654922873,0.0,0.0
5251,0,5251,[132   9 183  15  11],881,2,19031,3.6235719725818734,0.0,0.0
5252,0,5252,[195 427 127 187  28],537,3,19034,3.623453264801066,0.0,20.0
5253,0,5253,[275  69 318 173  95],406,3,19037,3.6233346022078416,20.0,0.0
5254,0,5254,[273 180 204 161 174],833,1,19038,3.622835394862036,0.0,20.0
5255,0,5255,[183  88 234  28   4],379,5,19043,3.6230974124809743,0.0,0.0
5256,0,5256,[302 603 427  50  64],664,5,19048,3.623359330416587,20.0,20.0
5257,0,5257,[235 117  98 168 183],374,3,19051,3.6232407759604413,0.0,20.0
5258,0,5258,[172 435 143 588 496],295,5,19056,3.623502567027952,0.0,0.0
5259,0,5259,[ 69  56 144 258 180],749,4,19060,3.623574144486692,0.0,0.0
5260,0,5260,[172 568 173 135  11],897,2,19062,3.623265538870937,0.0,0.0
5261,0,5261,[235 322 215 191  79],308,2,19064,3.622957050551121,0.0,0.0
5262,0,5262,[302 603 427  50  64],13,5,19069,3.623218696560897,20.0,20.0
5263,0,5263,[153 204 174 210 194],454,3,19072,3.6231003039513676,0.0,20.0
5264,0,5264,[238  15 176 121  79],184,2,19074,3.622792022792023,0.0,0.0
5265,0,5265,[483  71 265 125 144],892,4,19078,3.6228636536270415,20.0,0.0
5266,0,5266,[174 357 328 211 191],537,3,19081,3.6227453958610214,20.0,20.0
5267,0,5267,[ 82 187 323 175 405],788,2,19083,3.6224373576309796,0.0,0.0
5268,0,5268,[271 121 176 132 210],650,2,19085,3.6221294363256784,0.0,0.0
5269,0,5269,[313 186  82 135 176],738,5,19090,3.6223908918406074,0.0,0.0
5270,0,5270,[483  22 143 118 168],881,4,19094,3.6224625308290648,20.0,0.0
5271,0,5271,[302 603 427  50  64],474,5,19099,3.6227238239757207,20.0,20.0
5272,0,5272,[302 603 427  50  64],664,5,19104,3.6229850180163097,20.0,20.0
5273,0,5273,[302 603 427  50  64],271,5,19109,3.6232461130072053,20.0,20.0
5274,0,5274,[294 318 191 289 215],13,1,19110,3.6227488151658767,20.0,0.0
5275,0,5275,[302 603 427  50  64],537,4,19114,3.622820318423048,20.0,20.0
5276,0,5276,[132 182   7 403  82],234,1,19115,3.6223232897479627,0.0,0.0
5277,0,5277,[302 603 427  50  64],666,4,19119,3.6223948465327775,20.0,20.0
5278,0,5278,[302 603 427  50  64],458,4,19123,3.622466376207615,20.0,20.0
5279,0,5279,[  7 182 235 144 180],788,3,19126,3.622348484848485,0.0,0.0
5280,0,5280,[ 25  88 515 265  11],92,3,19129,3.6222306381367164,0.0,0.0
5281,0,5281,[100 294  28 237  25],537,1,19130,3.621734191594093,0.0,20.0
5282,0,5282,[183 118 181 427 228],194,1,19131,3.6212379329926176,0.0,0.0
5283,0,5283,[ 64 603  22 258 237],474,5,19136,3.6214988644965933,20.0,0.0
5284,0,5284,[202 228 234 483  28],899,4,19140,3.621570482497635,20.0,0.0
5285,0,5285,[268 216 191 111 235],92,2,19142,3.6212637154748393,0.0,0.0
5286,0,5286,[302 603 427  50  64],666,4,19146,3.6213353508606017,20.0,20.0
5287,0,5287,[153  98 423 568  11],7,4,19150,3.621406959152799,0.0,20.0
5288,0,5288,[603 245 181 508 187],334,3,19153,3.6212894687086408,20.0,0.0
5289,0,5289,[ 97 323 135 322 546],804,3,19156,3.62117202268431,0.0,0.0
5290,0,5290,[168  96 179  71 125],92,5,19161,3.6214326214326213,0.0,0.0
5291,0,5291,[204  71 515 294 176],804,5,19166,3.621693121693122,0.0,0.0
5292,0,5292,[289 322 216  71 143],881,4,19170,3.62176459474778,0.0,0.0
5293,0,5293,[144 117 273  12 174],538,3,19173,3.6216471477143934,20.0,20.0
5294,0,5294,[ 12 357 153 265 222],339,4,19177,3.621718602455146,40.0,0.0
5295,0,5295,[ 98 483 200   4 191],59,5,19182,3.621978851963746,20.0,20.0
5296,0,5296,[204 313 210 282 475],334,4,19186,3.622050217104021,0.0,0.0
5297,0,5297,[ 71  95 195  69 117],881,4,19190,3.622121555303888,0.0,0.0
5298,0,5298,[238 286 196 546 175],7,5,19195,3.6223815814304587,0.0,0.0
5299,0,5299,[  8 655 282 200 515],311,5,19200,3.6226415094339623,0.0,0.0
5300,0,5300,[  7 195 125 215 181],92,5,19205,3.62290133936993,0.0,0.0
5301,0,5301,[302 603 427  50  64],458,4,19209,3.622972463221426,20.0,20.0
5302,0,5302,[323 588 200 197  82],537,1,19210,3.6224778427305298,0.0,0.0
5303,0,5303,[302 603 427  50  64],669,5,19215,3.622737556561086,20.0,20.0
5304,0,5304,[100 282 322  56 118],328,2,19217,3.6224316682375117,0.0,20.0
5305,0,5305,[202 475 194  98 258],387,2,19219,3.6221258952129665,0.0,20.0
5306,0,5306,[403 210  82 161 187],184,2,19221,3.6218202374222725,0.0,0.0
5307,0,5307,[ 97 357 300  15 151],892,5,19226,3.6220798794272797,20.0,0.0
5308,0,5308,[ 70 282 173 546  11],554,2,19228,3.621774345451121,0.0,0.0
5309,0,5309,[328 742 313 237 204],328,4,19232,3.6218455743879474,0.0,0.0
5310,0,5310,[ 12  95 275 161  89],271,3,19235,3.621728488043683,20.0,0.0
5311,0,5311,[603 546 187 483  69],213,4,19239,3.6217996987951806,40.0,0.0
5312,0,5312,[302 603 427  50  64],13,5,19244,3.62205910031997,20.0,20.0
5313,0,5313,[ 28  15 603 168 161],474,4,19248,3.6221302220549494,20.0,0.0
5314,0,5314,[161  96  79 172 185],7,4,19252,3.6222013170272813,0.0,0.0
5315,0,5315,[132 385 323 127 211],311,3,19255,3.622084273890143,0.0,20.0
5316,0,5316,[  1 183  82   9 121],455,5,19260,3.6223434267444046,0.0,0.0
5317,0,5317,[176 222 185 216 318],234,1,19261,3.6218503196690484,20.0,0.0
5318,0,5318,[302 603 427  50  64],669,5,19266,3.622109419063734,20.0,20.0
5319,0,5319,[257  71 288 234 174],479,3,19269,3.6219924812030073,0.0,20.0
5320,0,5320,[ 56 496 742  82 269],650,2,19271,3.6216876526968615,0.0,0.0
5321,0,5321,[195 117 197  12 385],533,5,19276,3.621946636602781,20.0,0.0
5322,0,5322,[515 181 182 234  11],474,5,19281,3.6222055232012025,0.0,0.0
5323,0,5323,[179 180 202 210  79],543,4,19285,3.622276483846732,0.0,0.0
5324,0,5324,[121 323 215 286 678],648,2,19287,3.6219718309859155,0.0,0.0
5325,0,5325,[161 111  64 202 100],13,5,19292,3.622230567029666,0.0,20.0
5326,0,5326,[187  28 174  12   9],458,3,19295,3.622113760090107,20.0,20.0
5327,0,5327,[118 161 597 515  98],308,0,19295,3.621433933933934,0.0,20.0
5328,0,5328,[742  25 211 181 195],387,3,19298,3.6213173203227624,0.0,0.0
5329,0,5329,[ 64 118 423   9 322],374,3,19301,3.6212007504690433,0.0,0.0
5330,0,5330,[204  95 161  12  56],92,3,19304,3.6210842243481522,20.0,0.0
5331,0,5331,[302 603 427  50  64],370,5,19309,3.6213428357089272,20.0,20.0
5332,0,5332,[100 234 151 276 322],881,3,19312,3.621226326645415,0.0,20.0
5333,0,5333,[302 603 427  50  64],666,4,19316,3.621297337832771,20.0,20.0
5334,0,5334,[ 11  79 191  71 196],804,5,19321,3.621555763823805,0.0,0.0
5335,0,5335,[174  64   8 127 294],474,4,19325,3.6216266866566715,0.0,40.0
5336,0,5336,[202 427 258  71   7],6,2,19327,3.621322840547124,0.0,0.0
5337,0,5337,[302 603 427  50  64],271,5,19332,3.6215811165230423,20.0,20.0
5338,0,5338,[ 11 117 210 197 235],643,4,19336,3.621651994755572,0.0,0.0
5339,0,5339,[302 603 427  50  64],454,5,19341,3.6219101123595507,20.0,20.0
5340,0,5340,[ 28  56 191 186 127],881,3,19344,3.621793671597079,0.0,20.0
5341,0,5341,[323  89  15  96 181],474,4,19348,3.6218644702358667,0.0,0.0
5342,0,5342,[135 357 187 588 435],840,4,19352,3.6219352423731985,20.0,0.0
5343,0,5343,[302 603 427  50  64],13,5,19357,3.6221931137724552,20.0,20.0
5344,0,5344,[302 603 427  50  64],537,4,19361,3.622263797942002,20.0,20.0
5345,0,5345,[ 50 288 237   9 173],59,4,19365,3.622334455667789,0.0,20.0
5346,0,5346,[302 603 427  50  64],664,5,19370,3.6225921077239573,20.0,20.0
5347,0,5347,[182  12 273 153 475],64,3,19373,3.6224756918474195,20.0,0.0
5348,0,5348,[302 603 427  50  64],13,5,19378,3.622733221162834,20.0,20.0
5349,0,5349,[237 196 282 546  96],92,4,19382,3.622803738317757,0.0,0.0
5350,0,5350,[181 234 210 180 322],804,5,19387,3.6230611100728836,0.0,0.0
5351,0,5351,[275 180 127 215  28],13,4,19391,3.6231315396113604,0.0,20.0
5352,0,5352,[302 603 427  50  64],454,5,19396,3.6233887539697367,20.0,20.0
5353,0,5353,[100 245 127  69 186],533,3,19399,3.6232723197609262,0.0,40.0
5354,0,5354,[302 603 427  50  64],474,5,19404,3.623529411764706,20.0,20.0
5355,0,5355,[  8 204 313 191   9],200,5,19409,3.6237864077669903,0.0,0.0
5356,0,5356,[195 300  22 174 191],7,5,19414,3.624043307821542,0.0,20.0
5357,0,5357,[302 603 427  50  64],370,5,19419,3.624300111982083,20.0,20.0
5358,0,5358,[323 300 333 237 118],328,2,19421,3.6239970143683524,0.0,0.0
5359,0,5359,[144 313 204 195  50],92,5,19426,3.6242537313432837,0.0,20.0
5360,0,5360,[194  89 191 423 222],64,4,19430,3.6243238201828016,0.0,0.0
5361,0,5361,[ 69   1 483 403  79],804,4,19434,3.6243938828795224,20.0,0.0
5362,0,5362,[172 197  56 258 125],749,4,19438,3.62446391944807,0.0,0.0
5363,0,5363,[144  82 216 403  96],815,4,19442,3.6245339299030572,0.0,0.0
5364,0,5364,[302 603 427  50  64],537,4,19446,3.6246039142590867,20.0,20.0
5365,0,5365,[302 603 427  50  64],271,5,19451,3.624860231084607,20.0,20.0
5366,0,5366,[302 603 427  50  64],474,5,19456,3.6251164523942614,20.0,20.0
5367,0,5367,[100  88 678 121 172],537,1,19457,3.6246274217585692,0.0,20.0
5368,0,5368,[300  88  15  98  25],313,2,19459,3.6243248277146582,0.0,20.0
5369,0,5369,[357  97 748   8 204],533,1,19460,3.623836126629423,20.0,0.0
5370,0,5370,[ 97 172   9 655 288],474,4,19464,3.6239061627257496,0.0,0.0
5371,0,5371,[135  70 268  22 196],7,3,19467,3.6237900223380493,0.0,0.0
5372,0,5372,[183 143  82 180 483],59,4,19471,3.623860040945468,20.0,0.0
5373,0,5373,[195 269 181 238  64],360,4,19475,3.6239300334946036,0.0,0.0
5374,0,5374,[302 603 427  50  64],666,4,19479,3.624,20.0,20.0
5375,0,5375,[  4  12 405 186 125],533,2,19481,3.6236979166666665,20.0,0.0
5376,0,5376,[302 603 427  50  64],271,5,19486,3.6239538776269296,20.0,20.0
5377,0,5377,[302 603 427  50  64],745,4,19490,3.6240238006693937,20.0,20.0
5378,0,5378,[187 403  50  56 318],194,3,19493,3.623907789551961,20.0,20.0
5379,0,5379,[322  12  50 168 265],13,4,19497,3.6239776951672864,20.0,20.0
5380,0,5380,[197  96 183 216 172],881,3,19500,3.623861735736852,0.0,0.0
5381,0,5381,[228 258 202 179 282],653,2,19502,3.6235600148643625,0.0,0.0
5382,0,5382,[568 211 294 127 603],648,3,19505,3.623444176109976,20.0,20.0
5383,0,5383,[257 172 216 143 179],374,1,19506,3.62295690936107,0.0,0.0
5384,0,5384,[302 603 427  50  64],669,5,19511,3.623212627669452,20.0,20.0
5385,0,5385,[237 265 215 286  70],524,3,19514,3.623096917935388,0.0,0.0
5386,0,5386,[211   4 210 328 173],102,0,19514,3.6224243549285315,0.0,0.0
5387,0,5387,[234 546 168 483 328],95,2,19516,3.622123236822569,20.0,0.0
5388,0,5388,[228  22  28 276 151],881,3,19519,3.622007793653739,0.0,0.0
5389,0,5389,[222 202 132  11 323],200,4,19523,3.622077922077922,0.0,0.0
5390,0,5390,[302 603 427  50  64],458,4,19527,3.622148024485253,20.0,20.0
5391,0,5391,[ 69 143 655  98  79],843,0,19527,3.6214762611275964,0.0,20.0
5392,0,5392,[245 215 185 322 210],454,2,19529,3.621175597997404,0.0,0.0
5393,0,5393,[ 50 276 127 271 273],883,4,19533,3.621245828698554,0.0,40.0
5394,0,5394,[302 603 427  50  64],669,5,19538,3.621501390176089,20.0,20.0
5395,0,5395,[216 127 197 300 200],334,3,19541,3.6213862120088955,0.0,20.0
5396,0,5396,[385 185 234 125  79],804,5,19546,3.6216416527700575,0.0,0.0
5397,0,5397,[238 211  98 546  79],749,3,19549,3.6215264912930714,0.0,20.0
5398,0,5398,[235 238  12 195 271],13,1,19550,3.621040933506205,20.0,0.0
5399,0,5399,[121  12 302 132 508],605,4,19554,3.621111111111111,20.0,0.0
5400,0,5400,[302 603 427  50  64],745,4,19558,3.621181262729124,20.0,20.0
5401,0,5401,[191   8 200   7 175],387,5,19563,3.6214365049981487,0.0,0.0
5402,0,5402,[ 12 288  25 127 748],533,3,19566,3.6213214880621876,20.0,20.0
5403,0,5403,[182 135 211 181 175],537,4,19570,3.6213915618060697,0.0,0.0
5404,0,5404,[302 603 427  50  64],474,5,19575,3.6216466234967624,20.0,20.0
5405,0,5405,[181 234 202 179 742],666,2,19577,3.6213466518682944,0.0,0.0
5406,0,5406,[302 603 427  50  64],370,5,19582,3.6216016275198815,20.0,20.0
5407,0,5407,[ 64 175  79 228 515],64,5,19587,3.6218565088757395,0.0,0.0
5408,0,5408,[302 603 427  50  64],669,5,19592,3.622111295988168,20.0,20.0
5409,0,5409,[ 50 237 195 143 300],188,3,19595,3.6219963031423292,0.0,20.0
5410,0,5410,[238 161 211  88 186],339,4,19599,3.622066161522824,0.0,0.0
5411,0,5411,[182 173 151 117 215],479,3,19602,3.6219512195121952,0.0,0.0
5412,0,5412,[238  50 144  71 202],738,4,19606,3.6220210604101237,0.0,20.0
5413,0,5413,[  9 268  22 204  11],7,3,19609,3.621906169190986,0.0,0.0
5414,0,5414,[258 568 172 271  95],940,3,19612,3.621791320406279,0.0,0.0
5415,0,5415,[302 603 427  50  64],669,5,19617,3.6220457902511076,20.0,20.0
5416,0,5416,[302 603 427  50  64],664,5,19622,3.622300166143622,20.0,20.0
5417,0,5417,[302 603 427  50  64],664,5,19627,3.6225544481358436,20.0,20.0
5418,0,5418,[302 603 427  50  64],271,5,19632,3.6228086362797565,20.0,20.0
5419,0,5419,[568  28 435 182 276],378,5,19637,3.623062730627306,0.0,0.0
5420,0,5420,[186 405 135  22 318],378,2,19639,3.622763327799299,20.0,0.0
5421,0,5421,[302 603 427  50  64],666,4,19643,3.6228329029878275,20.0,20.0
5422,0,5422,[161 132 288 597 568],59,3,19646,3.6227180527383367,0.0,0.0
5423,0,5423,[ 95 265  56 194 185],524,4,19650,3.622787610619469,0.0,0.0
5424,0,5424,[ 69 197 328 471 185],271,2,19652,3.622488479262673,0.0,0.0
5425,0,5425,[182 132  11 655   8],488,0,19652,3.621820862513822,0.0,0.0
5426,0,5426,[228 194 172 168 496],311,5,19657,3.6220748111295373,0.0,0.0
5427,0,5427,[258  79 179 357 135],666,4,19661,3.622144436256448,20.0,0.0
5428,0,5428,[ 98   7  64 286 173],339,5,19666,3.6223982317185484,0.0,20.0
5429,0,5429,[ 50 508 294 678  88],537,2,19668,3.622099447513812,0.0,20.0
5430,0,5430,[269 276 597  25 742],26,2,19670,3.6218007733382436,0.0,0.0
5431,0,5431,[210 228  11 597 195],804,4,19674,3.6218703976435935,0.0,0.0
5432,0,5432,[174   9 235 257 161],308,3,19677,3.6217559359469904,0.0,20.0
5433,0,5433,[183 403 176 194 742],749,5,19682,3.6220095693779903,0.0,0.0
5434,0,5434,[385  28  95 222 195],804,4,19686,3.6220791168353266,0.0,0.0
5435,0,5435,[186 238 143 515 127],843,0,19686,3.621412803532009,0.0,20.0
5436,0,5436,[302 603 427  50  64],370,5,19691,3.621666360125069,20.0,20.0
5437,0,5437,[237 172  95 302  69],378,4,19695,3.6217359323280616,0.0,0.0
5438,0,5438,[275 135 276 603 117],533,3,19698,3.6216216216216215,20.0,0.0
5439,0,5439,[333 483 258 273 275],537,3,19701,3.6215073529411765,20.0,0.0
5440,0,5440,[328 423 176 282 288],804,3,19704,3.6213931262635546,0.0,0.0
5441,0,5441,[ 50 180 194 265 197],474,5,19709,3.6216464535097392,0.0,20.0
5442,0,5442,[568 181  82   8 175],385,2,19711,3.621348521036193,0.0,0.0
5443,0,5443,[273  64  15 357  82],892,4,19715,3.6214180749448937,20.0,0.0
5444,0,5444,[222 405  96 117 175],788,2,19717,3.6211202938475666,0.0,0.0
5445,0,5445,[132  71 168 100 127],313,4,19721,3.6211898641204554,0.0,40.0
5446,0,5446,[568 161 183 168 200],374,4,19725,3.621259408848908,0.0,0.0
5447,0,5447,[322 194 294 471 289],234,2,19727,3.6209618208516887,0.0,0.0
5448,0,5448,[302 603 427  50  64],339,5,19732,3.621214901816847,20.0,20.0
5449,0,5449,[  1 294 195  69  64],125,5,19737,3.621467889908257,0.0,0.0
5450,0,5450,[ 28 318 678  11 211],188,3,19740,3.6213538800220144,20.0,0.0
5451,0,5451,[302 603 427  50  64],13,5,19745,3.621606749816581,20.0,20.0
5452,0,5452,[197 181 222 180 111],13,4,19749,3.6216761415734458,0.0,0.0
5453,0,5453,[258 357 423 655 174],7,5,19754,3.621928859552622,20.0,20.0
5454,0,5454,[313  88 483  95 197],537,3,19757,3.621814848762603,20.0,0.0
5455,0,5455,[302 603 427  50  64],664,5,19762,3.622067448680352,20.0,20.0
5456,0,5456,[302 603 427  50  64],474,5,19767,3.622319956019791,20.0,20.0
5457,0,5457,[423 200  15 357 211],234,3,19770,3.622205936240381,20.0,0.0
5458,0,5458,[ 64 196 655 222   8],343,5,19775,3.622458325700678,0.0,0.0
5459,0,5459,[ 50 313 678  15 216],145,3,19778,3.6223443223443224,0.0,20.0
5460,0,5460,[111 238 357  95 202],899,4,19782,3.6224134773850944,20.0,0.0
5461,0,5461,[ 89   4 282  95 183],455,2,19784,3.6221164408641524,0.0,0.0
5462,0,5462,[187 151  88  98 200],650,2,19786,3.621819513088047,0.0,20.0
5463,0,5463,[302 603 427  50  64],13,5,19791,3.6220717423133237,20.0,20.0
5464,0,5464,[194 211 135  22 405],82,2,19793,3.621774931381519,0.0,0.0
5465,0,5465,[302 603 427  50  64],370,5,19798,3.6220270764727407,20.0,20.0
5466,0,5466,[302 603 427  50  64],271,5,19803,3.6222791293213827,20.0,20.0
5467,0,5467,[180 173 228 655 275],406,1,19804,3.6217995610826628,0.0,0.0
5468,0,5468,[121  88   9 546 153],339,4,19808,3.621868714573048,0.0,0.0
5469,0,5469,[302 603 427  50  64],474,5,19813,3.6221206581352834,20.0,20.0
5470,0,5470,[588 196 288   9 423],144,4,19817,3.6221897276549075,0.0,0.0
5471,0,5471,[302 603 427  50  64],454,5,19822,3.622441520467836,20.0,20.0
5472,0,5472,[151 275 200 194 215],474,2,19824,3.622145075826786,0.0,0.0
5473,0,5473,[ 71   1 100  96  22],788,2,19826,3.6218487394957983,0.0,20.0
5474,0,5474,[302 603 427  50  64],13,5,19831,3.6221004566210047,20.0,20.0
5475,0,5475,[237 195 118 127 143],313,3,19834,3.6219868517165814,0.0,20.0
5476,0,5476,[235 210 475 194 302],537,2,19836,3.6216907065911994,0.0,0.0
5477,0,5477,[302 603 427  50  64],745,4,19840,3.6217597663380796,20.0,20.0
5478,0,5478,[302 603 427  50  64],339,5,19845,3.6220113159335647,20.0,20.0
5479,0,5479,[301 318  82   8   9],334,4,19849,3.622080291970803,20.0,0.0
5480,0,5480,[302 603 427  50  64],339,5,19854,3.6223316912972083,20.0,20.0
5481,0,5481,[302 603 427  50  64],666,4,19858,3.622400583728566,20.0,20.0
5482,0,5482,[200 655  98 210  50],890,4,19862,3.6224694510304576,0.0,40.0
5483,0,5483,[515  97 196 211   1],194,3,19865,3.62235594456601,0.0,0.0
5484,0,5484,[ 71 118 546 475 172],479,1,19866,3.6218778486782135,0.0,0.0
5485,0,5485,[302 603 427  50  64],339,5,19871,3.6221290557783448,20.0,20.0
5486,0,5486,[202 195 197 176  71],830,3,19874,3.622015673409878,0.0,0.0
5487,0,5487,[302 603 427  50  64],537,4,19878,3.622084548104956,20.0,20.0
5488,0,5488,[302 603 427  50  64],454,5,19883,3.622335580251412,20.0,20.0
5489,0,5489,[ 12 357 318  50 132],499,4,19887,3.6224043715846994,60.0,20.0
5490,0,5490,[385 276 174   9 172],13,3,19890,3.6222910216718267,0.0,20.0
5491,0,5491,[151 427 300 132 186],666,2,19892,3.6219956300072833,0.0,0.0
5492,0,5492,[265 273 603 143 655],42,2,19894,3.621700345894775,20.0,0.0
5493,0,5493,[302 603 427  50  64],454,5,19899,3.6219512195121952,20.0,20.0
5494,0,5494,[168 183  70 176  82],479,5,19904,3.6222020018198364,0.0,0.0
5495,0,5495,[194  70   8 475 288],213,3,19907,3.622088791848617,0.0,0.0
5496,0,5496,[186  82 300 427  25],13,2,19909,3.6217937056576313,0.0,0.0
5497,0,5497,[185 121 204 195  79],339,2,19911,3.621498726809749,0.0,0.0
5498,0,5498,[302 603 427  50  64],370,5,19916,3.6217494089834514,20.0,20.0
5499,0,5499,[423  96 135 588 181],13,5,19921,3.622,0.0,0.0
5500,0,5500,[ 98 202 496 204 181],738,5,19926,3.6222504999091076,0.0,20.0
5501,0,5501,[204  79  50  28 496],506,5,19931,3.622500908760451,0.0,20.0
5502,0,5502,[176 211 471 222 238],313,4,19935,3.622569507541341,0.0,0.0
5503,0,5503,[302 603 427  50  64],669,5,19940,3.6228197674418605,20.0,20.0
5504,0,5504,[196  95 210 197 143],334,2,19942,3.6225249772933696,0.0,0.0
5505,0,5505,[302 603 427  50  64],271,5,19947,3.622775154377043,20.0,20.0
5506,0,5506,[228  22 435  82 172],830,3,19950,3.622662066460868,0.0,0.0
5507,0,5507,[  1 313 173   4 194],378,4,19954,3.622730573710966,0.0,0.0
5508,0,5508,[302 603 427  50  64],664,5,19959,3.6229805772372483,20.0,20.0
5509,0,5509,[ 64 202 403  70 211],234,1,19960,3.6225045372050815,0.0,0.0
5510,0,5510,[257 288 200 204 234],455,4,19964,3.6225730357466883,0.0,0.0
5511,0,5511,[210  98 288 191 204],882,4,19968,3.6226415094339623,0.0,20.0
5512,0,5512,[174 182 257  25 318],533,4,19972,3.6227099582804283,20.0,20.0
5513,0,5513,[302 603 427  50  64],271,5,19977,3.622959738846572,20.0,20.0
5514,0,5514,[302 603 427  50  64],13,5,19982,3.6232094288304624,20.0,20.0
5515,0,5515,[318 204 111 238 135],474,5,19987,3.6234590282813635,20.0,0.0
5516,0,5516,[302 603 427  50  64],669,5,19992,3.6237085372485045,20.0,20.0
5517,0,5517,[302 603 427  50  64],669,5,19997,3.62395795578108,20.0,20.0
5518,0,5518,[302 603 427  50  64],669,5,20002,3.6242072839282478,20.0,20.0
5519,0,5519,[ 97  71 222 496 195],536,4,20006,3.6242753623188406,0.0,0.0
5520,0,5520,[302 603 427  50  64],537,4,20010,3.6243434160478176,20.0,20.0
5521,0,5521,[302 603 427  50  64],666,4,20014,3.6244114451285765,20.0,20.0
5522,0,5522,[237 121 405  88 100],537,1,20015,3.623936266521818,0.0,20.0
5523,0,5523,[179 288 191  50 151],7,5,20020,3.624185372918175,0.0,20.0
5524,0,5524,[ 95 186 435  69 568],804,3,20023,3.6240723981900453,0.0,0.0
5525,0,5525,[302 603 427  50  64],745,4,20027,3.624140427072023,20.0,20.0
5526,0,5526,[194 245 186  71 237],378,3,20030,3.624027501356975,0.0,0.0
5527,0,5527,[265  15 135 546 215],533,2,20032,3.6237337192474675,0.0,0.0
5528,0,5528,[302 603 427  50  64],339,5,20037,3.6239826370048833,20.0,20.0
5529,0,5529,[ 12 258  88 265 238],378,4,20041,3.6240506329113926,20.0,0.0
5530,0,5530,[  7 228 318  98  12],664,4,20045,3.6241186042307,40.0,20.0
5531,0,5531,[204 174   8 603 135],385,2,20047,3.623825018076645,20.0,20.0
5532,0,5532,[302 603 427  50  64],271,5,20052,3.6240737393818905,20.0,20.0
5533,0,5533,[151 183 257 300  98],749,4,20056,3.624141669678352,0.0,20.0
5534,0,5534,[302 603 427  50  64],537,4,20060,3.6242095754290875,20.0,20.0
5535,0,5535,[187   8 228 200 276],881,3,20063,3.6240968208092488,0.0,0.0
5536,0,5536,[302 603 427  50  64],669,5,20068,3.6243453133465775,20.0,20.0
5537,0,5537,[ 71  96 197 403 678],648,2,20070,3.6240520043336946,0.0,0.0
5538,0,5538,[ 82 180 234 322 161],524,5,20075,3.6243004152374074,0.0,0.0
5539,0,5539,[302 603 427  50  64],339,5,20080,3.624548736462094,20.0,20.0
5540,0,5540,[423  70 135   7  50],474,5,20085,3.6247969680563075,0.0,20.0
5541,0,5541,[302 603 427  50  64],454,5,20090,3.6250451100685672,20.0,20.0
5542,0,5542,[235  82  79 194  96],308,4,20094,3.6251127548259063,0.0,0.0
5543,0,5543,[127 288 742 748 111],533,3,20097,3.625,0.0,20.0
5544,0,5544,[302 603 427  50  64],669,5,20102,3.6252479711451757,20.0,20.0
5545,0,5545,[117 294 161 179  69],749,3,20105,3.6251352326000723,0.0,0.0
5546,0,5546,[302 603 427  50  64],370,5,20110,3.625383089958536,20.0,20.0
5547,0,5547,[302 603 427  50  64],664,5,20115,3.625630857966835,20.0,20.0
5548,0,5548,[282 515 132 235 172],334,2,20117,3.62533789872049,0.0,0.0
5549,0,5549,[ 64 175 186 678 273],308,3,20120,3.625225225225225,0.0,0.0
5550,0,5550,[  1  25  96 175  15],537,1,20121,3.6247522968834445,0.0,0.0
5551,0,5551,[132 300 403 144  11],749,5,20126,3.625,0.0,0.0
5552,0,5552,[183 100 135 276  97],881,4,20130,3.6250675310642895,0.0,20.0
5553,0,5553,[183  98  69 179 210],60,5,20135,3.6253150882247027,0.0,20.0
5554,0,5554,[ 11  98  96 215 328],13,3,20138,3.6252025202520253,0.0,20.0
5555,0,5555,[302 603 427  50  64],474,5,20143,3.62544996400288,20.0,20.0
5556,0,5556,[132 143 121 179 185],897,4,20147,3.6255173654849737,0.0,0.0
5557,0,5557,[471 238 215 655 282],92,5,20152,3.625764663548039,0.0,0.0
5558,0,5558,[151 289 143   9 568],881,2,20154,3.6254722072315166,0.0,0.0
5559,0,5559,[597 282 174  22 322],804,4,20158,3.6255395683453235,0.0,20.0
5560,0,5560,[179 546 234 508  22],653,2,20160,3.6252472576874664,0.0,0.0
5561,0,5561,[546 313 195 655 132],234,2,20162,3.624955052139518,0.0,0.0
5562,0,5562,[228 286 135  70 216],85,3,20165,3.6248427107675716,0.0,0.0
5563,0,5563,[183 235 483 121 187],833,4,20169,3.6249101365923795,20.0,0.0
5564,0,5564,[435   1 176  71 245],378,4,20173,3.6249775381850853,0.0,0.0
5565,0,5565,[385 228 357  28   8],899,3,20176,3.6248652533237515,20.0,0.0
5566,0,5566,[265  64 515 237 286],60,5,20181,3.6251122687264234,0.0,0.0
5567,0,5567,[302 603 427  50  64],474,5,20186,3.625359195402299,20.0,20.0
5568,0,5568,[515 191  82  70   7],194,2,20188,3.6250673370443525,0.0,0.0
5569,0,5569,[276 194 294 265   4],194,4,20192,3.6251346499102333,0.0,0.0
5570,0,5570,[302 603 427  50  64],454,5,20197,3.6253814395979176,20.0,20.0
5571,0,5571,[180  64 153 117 197],738,4,20201,3.625448671931084,0.0,0.0
5572,0,5572,[302 603 427  50  64],339,5,20206,3.625695316705545,20.0,20.0
5573,0,5573,[302 603 427  50  64],537,4,20210,3.625762468604234,20.0,20.0
5574,0,5574,[302 603 427  50  64],454,5,20215,3.6260089686098653,20.0,20.0
5575,0,5575,[302 603 427  50  64],664,5,20220,3.626255380200861,20.0,20.0
5576,0,5576,[175 294 118 748  50],653,2,20222,3.6259637798099336,0.0,20.0
5577,0,5577,[603 742 185 257  64],308,5,20227,3.62621011115095,20.0,0.0
5578,0,5578,[ 71 265 185  89 275],474,4,20231,3.6262771105932963,0.0,0.0
5579,0,5579,[318 204  82 475 294],374,2,20233,3.6259856630824374,20.0,0.0
5580,0,5580,[197 135 742   9 185],374,4,20237,3.6260526787314102,0.0,0.0
5581,0,5581,[ 96  15  98  88 125],648,3,20240,3.6259405231099966,0.0,20.0
5582,0,5582,[ 50 194 135 405  22],64,4,20244,3.626007522837184,0.0,20.0
5583,0,5583,[183  71 143 195 300],892,3,20247,3.625895415472779,0.0,0.0
5584,0,5584,[546 275  28  96  22],279,1,20248,3.6254252461951655,0.0,0.0
5585,0,5585,[403  88  89 197  69],326,1,20249,3.624955245255997,0.0,0.0
5586,0,5586,[357  96 215 100 302],940,3,20252,3.6248433864327905,20.0,20.0
5587,0,5587,[197 313 655  98 237],64,4,20256,3.624910522548318,0.0,20.0
5588,0,5588,[302 603 427  50  64],370,5,20261,3.6251565575237072,20.0,20.0
5589,0,5589,[302 603 427  50  64],13,5,20266,3.6254025044722717,20.0,20.0
5590,0,5590,[302 603 427  50  64],271,5,20271,3.6256483634412446,20.0,20.0
5591,0,5591,[183 210  95 144 357],95,4,20275,3.6257153075822606,20.0,0.0
5592,0,5592,[286 300 197 289 588],13,2,20277,3.6254246379402826,0.0,0.0
5593,0,5593,[269 568 186 197 132],650,4,20281,3.625491598140865,0.0,0.0
5594,0,5594,[179   1  89 125  82],378,3,20284,3.625379803395889,0.0,0.0
5595,0,5595,[302 603 427  50  64],537,4,20288,3.625446747676912,20.0,20.0
5596,0,5596,[302 603 427  50  64],458,4,20292,3.625513668036448,20.0,20.0
5597,0,5597,[127 197 183  89 161],334,4,20296,3.6255805644873167,0.0,20.0
5598,0,5598,[302 603 427  50  64],537,4,20300,3.625647437042329,20.0,20.0
5599,0,5599,[302 603 427  50  64],271,5,20305,3.625892857142857,20.0,20.0
5600,0,5600,[302 603 427  50  64],370,5,20310,3.6261381896089984,20.0,20.0
5601,0,5601,[153  12  69  88 655],308,4,20314,3.626204926811853,20.0,0.0
5602,0,5602,[176  88  64 216  28],60,5,20319,3.6264501160092806,0.0,0.0
5603,0,5603,[302 603 427  50  64],271,5,20324,3.626695217701642,20.0,20.0
5604,0,5604,[234 215 168 508 318],85,4,20328,3.626761819803747,20.0,0.0
5605,0,5605,[302 603 427  50  64],458,4,20332,3.626828398144845,20.0,20.0
5606,0,5606,[ 95   9 268 357   7],234,1,20333,3.6263599072587835,20.0,0.0
5607,0,5607,[144   4 176  98 300],102,1,20334,3.625891583452211,0.0,20.0
5608,0,5608,[  1 118 300 181 471],294,4,20338,3.625958281333571,0.0,0.0
5609,0,5609,[302 603 427  50  64],458,4,20342,3.62602495543672,20.0,20.0
5610,0,5610,[302 603 427  50  64],271,5,20347,3.62626982712529,20.0,20.0
5611,0,5611,[302 603 427  50  64],458,4,20351,3.626336421952958,20.0,20.0
5612,0,5612,[678 172 276 328 313],145,3,20354,3.6262248352039905,0.0,0.0
5613,0,5613,[300 180 515 357  15],234,2,20356,3.625935162094763,20.0,0.0
5614,0,5614,[302 603 427  50  64],458,4,20360,3.6260017809439002,20.0,20.0
5615,0,5615,[191 282 183 234 286],95,4,20364,3.626068376068376,0.0,0.0
5616,0,5616,[ 79 183 483 322 228],749,5,20369,3.6263129784582517,20.0,0.0
5617,0,5617,[302 603 427  50  64],454,5,20374,3.626557493770025,20.0,20.0
5618,0,5618,[ 89 179  70 210 435],666,4,20378,3.626623954440292,0.0,0.0
5619,0,5619,[302 603 427  50  64],666,4,20382,3.626690391459075,20.0,20.0
5620,0,5620,[742 204 100 234 211],666,2,20384,3.62640099626401,0.0,20.0
5621,0,5621,[ 96 385  64  71  28],59,4,20388,3.6264674493062965,0.0,0.0
5622,0,5622,[323 245   9 111 235],825,2,20390,3.626178196692157,0.0,0.0
5623,0,5623,[302 603 427  50  64],474,5,20395,3.626422475106686,20.0,20.0
5624,0,5624,[95  4 97  9  8],64,3,20398,3.6263111111111113,0.0,0.0
5625,0,5625,[132 603 197 403  88],308,3,20401,3.6261997867045856,20.0,0.0
5626,0,5626,[302 603 427  50  64],664,5,20406,3.626443931046739,20.0,20.0
5627,0,5627,[302 603 427  50  64],458,4,20410,3.6265103056147834,20.0,20.0
5628,0,5628,[515 210  71   1  28],200,5,20415,3.6267543080476106,0.0,0.0
5629,0,5629,[302 603 427  50  64],271,5,20420,3.6269982238010656,20.0,20.0
5630,0,5630,[302 515 318 257   8],474,4,20424,3.627064464571124,20.0,0.0
5631,0,5631,[405 143 294 182 210],7,2,20426,3.6267755681818183,0.0,0.0
5632,0,5632,[288 276 234 211   1],643,5,20431,3.6270193502574117,0.0,0.0
5633,0,5633,[144  12  96 132 234],795,3,20434,3.6269080582179622,20.0,0.0
5634,0,5634,[302 603 427  50  64],474,5,20439,3.6271517302573204,20.0,20.0
5635,0,5635,[118 289 403 234  98],788,2,20441,3.626863023420866,0.0,20.0
5636,0,5636,[183 215 143 282 546],95,4,20445,3.6269292176689727,0.0,0.0
5637,0,5637,[228 161 276 403 143],339,3,20448,3.626818020574672,0.0,0.0
5638,0,5638,[405 597  64 238 187],458,4,20452,3.626884199326122,0.0,0.0
5639,0,5639,[ 64 127  97 496  28],387,2,20454,3.626595744680851,0.0,20.0
5640,0,5640,[302 603 427  50  64],13,5,20459,3.626839212905513,20.0,20.0
5641,0,5641,[471 258 357 179  22],311,4,20463,3.6269053527118045,20.0,0.0
5642,0,5642,[302 603 427  50  64],271,5,20468,3.627148679780259,20.0,20.0
5643,0,5643,[302 234 194 403 496],343,4,20472,3.627214741318214,0.0,0.0
5644,0,5644,[275 182  70  71 196],533,4,20476,3.6272807794508415,0.0,0.0
5645,0,5645,[302 603 427  50  64],458,4,20480,3.6273467941905775,20.0,20.0
5646,0,5646,[210 200  64 195  89],374,3,20483,3.627235700371879,0.0,0.0
5647,0,5647,[ 25 228   8 144 197],398,4,20487,3.627301699716714,0.0,0.0
5648,0,5648,[302 603 427  50  64],664,5,20492,3.6275446981766684,20.0,20.0
5649,0,5649,[ 56  89 135 300  22],334,4,20496,3.6276106194690265,0.0,0.0
5650,0,5650,[237   8 173 176  15],144,5,20501,3.6278534772606617,0.0,0.0
5651,0,5651,[ 69 100 181 174  98],59,5,20506,3.6280962491153574,0.0,60.0
5652,0,5652,[423 471 228 483 286],13,3,20509,3.627985140633292,20.0,0.0
5653,0,5653,[215 153 289 546 143],13,2,20511,3.627697205518217,0.0,0.0
5654,0,5654,[183 273 194 210 435],537,0,20511,3.627055702917772,0.0,0.0
5655,0,5655,[302 603 427  50  64],537,4,20515,3.6271216407355023,20.0,20.0
5656,0,5656,[ 82 508  69 282 125],207,4,20519,3.627187555241294,0.0,0.0
5657,0,5657,[ 25 172 385  50  28],881,3,20522,3.627076705549664,0.0,20.0
5658,0,5658,[302 603 427  50  64],454,5,20527,3.627319314366496,20.0,20.0
5659,0,5659,[302 603 427  50  64],271,5,20532,3.6275618374558305,20.0,20.0
5660,0,5660,[483 603 288 265 210],650,3,20535,3.627450980392157,40.0,0.0
5661,0,5661,[302 603 427  50  64],13,5,20540,3.627693394560226,20.0,20.0
5662,0,5662,[301 471 288 179 194],537,1,20541,3.627229383718877,0.0,0.0
5663,0,5663,[302 603 427  50  64],458,4,20545,3.627295197740113,20.0,20.0
5664,0,5664,[  7 181 276  71 405],474,5,20550,3.627537511032657,0.0,0.0
5665,0,5665,[302 603 427  50  64],537,4,20554,3.6276032474408755,20.0,20.0
5666,0,5666,[191 200 186 328 427],313,3,20557,3.6274925004411505,0.0,0.0
5667,0,5667,[302 603 427  50  64],339,5,20562,3.6277346506704307,20.0,20.0
5668,0,5668,[222 302  25 191 423],378,4,20566,3.627800317516317,0.0,0.0
5669,0,5669,[ 88 179 202  56   8],194,2,20568,3.6275132275132274,0.0,0.0
5670,0,5670,[302 603 427  50  64],537,4,20572,3.6275789102451066,20.0,20.0
5671,0,5671,[302 603 427  50  64],666,4,20576,3.6276445698166433,20.0,20.0
5672,0,5672,[ 25  96   8 238 168],881,1,20577,3.627181385510312,0.0,0.0
5673,0,5673,[144 427  28 483 228],312,3,20580,3.627070849488897,20.0,0.0
5674,0,5674,[173 176 568 191  82],882,5,20585,3.6273127753303966,0.0,0.0
5675,0,5675,[245  56  11 265 222],378,2,20587,3.627026074700493,0.0,0.0
5676,0,5676,[ 22  56 200 238 603],543,3,20590,3.6269156244495333,20.0,0.0
5677,0,5677,[ 22 265 173 483 172],295,5,20595,3.62715744980627,20.0,0.0
5678,0,5678,[302 603 427  50  64],666,4,20599,3.627223102658919,20.0,20.0
5679,0,5679,[ 96 117 483 245  69],263,4,20603,3.627288732394366,20.0,0.0
5680,0,5680,[302 603 427  50  64],370,5,20608,3.6275303643724697,20.0,20.0
5681,0,5681,[302 603 427  50  64],271,5,20613,3.6277719112988382,20.0,20.0
5682,0,5682,[302 603 427  50  64],13,5,20618,3.6280133732183706,20.0,20.0
5683,0,5683,[ 71 210 385 603  88],13,3,20621,3.627902885292048,20.0,0.0
5684,0,5684,[ 50 265 568 174 222],774,1,20622,3.627440633245383,0.0,40.0
5685,0,5685,[195 211 194 187 215],311,4,20626,3.6275061554695744,0.0,0.0
5686,0,5686,[196   8 588  56 173],326,3,20629,3.6273958150167047,0.0,0.0
5687,0,5687,[302 603 427  50  64],271,5,20634,3.6276371308016877,20.0,20.0
5688,0,5688,[ 56 318 187  70 238],311,5,20639,3.627878361750747,20.0,0.0
5689,0,5689,[302 603 427  50  64],458,4,20643,3.627943760984183,20.0,20.0
5690,0,5690,[435 117 191   7  89],194,2,20645,3.62765770514848,0.0,0.0
5691,0,5691,[302 603 427  50  64],370,5,20650,3.627898805340829,20.0,20.0
5692,0,5692,[127  56  25 186 173],387,3,20653,3.6277885122079745,0.0,20.0
5693,0,5693,[100  79 187 176  70],479,4,20657,3.627853881278539,0.0,20.0
5694,0,5694,[12  7 82 89  4],883,4,20661,3.6279192273924497,20.0,0.0
5695,0,5695,[302 603 427  50  64],664,5,20666,3.6281601123595504,20.0,20.0
5696,0,5696,[ 25  97 151 175 237],934,4,20670,3.628225381779884,0.0,0.0
5697,0,5697,[216 257  98 265 185],308,2,20672,3.627939627939628,0.0,20.0
5698,0,5698,[96 89 28 12 71],279,2,20674,3.6276539743814706,20.0,0.0
5699,0,5699,[ 79 546 258 215 300],7,5,20679,3.627894736842105,0.0,0.0
5700,0,5700,[210  98  82 195 471],194,1,20680,3.627433783546746,0.0,20.0
5701,0,5701,[302 603 427  50  64],271,5,20685,3.627674500175377,20.0,20.0
5702,0,5702,[302 603 427  50  64],458,4,20689,3.627739786077503,20.0,20.0
5703,0,5703,[ 22  79 187 180 196],90,5,20694,3.6279803646563815,0.0,0.0
5704,0,5704,[176 100 195 238 257],213,5,20699,3.6282208588957054,0.0,20.0
5705,0,5705,[ 98 196 111 423  88],653,0,20699,3.6275849982474586,0.0,20.0
5706,0,5706,[302 603 427  50  64],458,4,20703,3.627650254073944,20.0,20.0
5707,0,5707,[588 483  96 204 515],200,5,20708,3.6278906797477224,20.0,0.0
5708,0,5708,[302 603 427  50  64],454,5,20713,3.628131021194605,20.0,20.0
5709,0,5709,[ 28   7 385 100 318],343,4,20717,3.628196147110333,20.0,20.0
5710,0,5710,[173 268  69  82 187],643,3,20720,3.6280861495359833,0.0,0.0
5711,0,5711,[111  82 195 174 597],452,3,20723,3.6279761904761907,0.0,20.0
5712,0,5712,[328  89 282 185 151],788,4,20727,3.6280413092945913,0.0,0.0
5713,0,5713,[121 182  15 210 143],374,3,20730,3.6279313965698283,0.0,0.0
5714,0,5714,[328 117 215 568  79],90,2,20732,3.627646544181977,0.0,0.0
5715,0,5715,[405 273 275 118  98],554,4,20736,3.627711686494052,0.0,20.0
5716,0,5716,[235 294 174 215 568],650,1,20737,3.627252055273745,0.0,20.0
5717,0,5717,[210 179 546 100 294],378,2,20739,3.6269674711437565,0.0,20.0
5718,0,5718,[ 79 186 172 194  71],840,2,20741,3.6266829865361077,0.0,0.0
5719,0,5719,[181  69  97 275 289],13,3,20744,3.6265734265734264,0.0,0.0
5720,0,5720,[202 161 403 100 185],881,3,20747,3.626463904911729,0.0,20.0
5721,0,5721,[132 496 357 174 546],271,4,20751,3.626529185599441,20.0,20.0
5722,0,5722,[302 603 427  50  64],537,4,20755,3.6265944434737025,20.0,20.0
5723,0,5723,[168 161  25  79 186],881,1,20756,3.626135569531796,0.0,0.0
5724,0,5724,[302 603 427  50  64],458,4,20760,3.6262008733624453,20.0,20.0
5725,0,5725,[302 603 427  50  64],537,4,20764,3.6262661543835137,20.0,20.0
5726,0,5726,[333 286 183  15 181],537,0,20764,3.6256329666492055,0.0,0.0
5727,0,5727,[302 603 427  50  64],537,4,20768,3.625698324022346,20.0,20.0
5728,0,5728,[ 12 235 357 483  95],537,2,20770,3.6254145575144006,60.0,0.0
5729,0,5729,[302 603 427  50  64],13,5,20775,3.6256544502617802,20.0,20.0
5730,0,5730,[265 100 216 273 300],13,2,20777,3.625370790437969,0.0,20.0
5731,0,5731,[302 603 427  50  64],745,4,20781,3.625436147941382,20.0,20.0
5732,0,5732,[222 265 118 427 181],42,4,20785,3.62550148264434,0.0,0.0
5733,0,5733,[423 216  28 182 357],95,4,20789,3.625566794558772,20.0,0.0
5734,0,5734,[302 603 427  50  64],474,5,20794,3.6258064516129034,20.0,20.0
5735,0,5735,[302 603 427  50  64],664,5,20799,3.6260460251046025,20.0,20.0
5736,0,5736,[202 168 174  70 273],7,2,20801,3.625762593690082,0.0,20.0
5737,0,5737,[302 603 427  50  64],454,5,20806,3.6260020913210176,20.0,20.0
5738,0,5738,[151 678 121  96  15],474,3,20809,3.625893012719986,0.0,0.0
5739,0,5739,[ 69 282 427 100   4],533,4,20813,3.62595818815331,0.0,20.0
5740,0,5740,[302 603 427  50  64],370,5,20818,3.6261975265633164,20.0,20.0
5741,0,5741,[302 603 427  50  64],339,5,20823,3.6264367816091956,20.0,20.0
5742,0,5742,[302 603 427  50  64],370,5,20828,3.626675953334494,20.0,20.0
5743,0,5743,[302 603 427  50  64],370,5,20833,3.6269150417827296,20.0,20.0
5744,0,5744,[228  71 187 265 185],328,4,20837,3.62697998259356,0.0,0.0
5745,0,5745,[ 98 196  88 403 508],339,4,20841,3.627044900800557,0.0,20.0
5746,0,5746,[403 471 111 222   7],648,4,20845,3.627109796415521,0.0,0.0
5747,0,5747,[  8 151  50  79 603],82,3,20848,3.6270006958942242,20.0,20.0
5748,0,5748,[302 603 427  50  64],745,4,20852,3.6270655766220212,20.0,20.0
5749,0,5749,[144   7 222 195  98],374,3,20855,3.6269565217391304,0.0,20.0
5750,0,5750,[144 403 603  25  82],308,4,20859,3.627021387584768,20.0,0.0
5751,0,5751,[302 603 427  50  64],669,5,20864,3.6272600834492352,20.0,20.0
5752,0,5752,[185 597 135 121  89],328,3,20867,3.627151051625239,0.0,0.0
5753,0,5753,[302 603 427  50  64],370,5,20872,3.627389641988182,20.0,20.0
5754,0,5754,[181  64 121  11  25],271,3,20875,3.627280625543006,0.0,0.0
5755,0,5755,[234 172 238 302 125],378,3,20878,3.6271716469770676,0.0,0.0
5756,0,5756,[302 603 427  50  64],745,4,20882,3.6272364078513113,20.0,20.0
5757,0,5757,[302 603 427  50  64],666,4,20886,3.6273011462313303,20.0,20.0
5758,0,5758,[132 475  95 655 127],537,2,20888,3.6270185796145165,0.0,20.0
5759,0,5759,[302 603 427  50  64],13,5,20893,3.6272569444444445,20.0,20.0
5760,0,5760,[ 69 194 191 181 179],235,4,20897,3.627321645547648,0.0,0.0
5761,0,5761,[423 228 546   9 215],200,4,20901,3.6273863241929885,0.0,0.0
5762,0,5762,[204   9 197 100 196],85,4,20905,3.627450980392157,0.0,20.0
5763,0,5763,[475   7  11 197 187],474,5,20910,3.6276891047883413,0.0,0.0
5764,0,5764,[655 176 238 294  96],666,3,20913,3.627580225498699,0.0,0.0
5765,0,5765,[302 603 427  50  64],669,5,20918,3.6278182448838017,20.0,20.0
5766,0,5766,[655 228 175 186 211],102,3,20921,3.627709380960638,0.0,0.0
5767,0,5767,[302 603 427  50  64],664,5,20926,3.6279472954230236,20.0,20.0
5768,0,5768,[302 603 427  50  64],664,5,20931,3.628185127405096,20.0,20.0
5769,0,5769,[302 603 427  50  64],537,4,20935,3.6282495667244365,20.0,20.0
5770,0,5770,[302 603 427  50  64],745,4,20939,3.628313983711662,20.0,20.0
5771,0,5771,[405 265  97 322 245],313,2,20941,3.628031878031878,0.0,0.0
5772,0,5772,[302 603 427  50  64],474,5,20946,3.6282695305733585,20.0,20.0
5773,0,5773,[483   8  28  96   1],406,4,20950,3.628333910633876,20.0,0.0
5774,0,5774,[302 603 427  50  64],13,5,20955,3.6285714285714286,20.0,20.0
5775,0,5775,[302 603 427  50  64],458,4,20959,3.6286357340720223,20.0,20.0
5776,0,5776,[302 603 427  50  64],537,4,20963,3.6287000173100226,20.0,20.0
5777,0,5777,[183 202  97 185 515],326,5,20968,3.628937348563517,0.0,0.0
5778,0,5778,[ 50 237 748  69  56],533,2,20970,3.628655476726077,0.0,20.0
5779,0,5779,[202 265 211  50 185],298,3,20973,3.628546712802768,0.0,20.0
5780,0,5780,[302 603 427  50  64],669,5,20978,3.6287839474139423,20.0,20.0
5781,0,5781,[186  56 546 435 210],749,3,20981,3.6286751988931165,0.0,0.0
5782,0,5782,[127 257 173 174  71],804,4,20985,3.6287394086114473,0.0,40.0
5783,0,5783,[196  64 186 191 597],452,4,20989,3.6288035961272476,0.0,0.0
5784,0,5784,[197  70  15 275  89],455,2,20991,3.628522039757995,0.0,0.0
5785,0,5785,[302 603 427  50  64],669,5,20996,3.628759073625994,20.0,20.0
5786,0,5786,[302 269 237 427  97],537,2,20998,3.6284776222567823,0.0,0.0
5787,0,5787,[ 97 185 111 215 179],271,4,21002,3.628541810642709,0.0,0.0
5788,0,5788,[185  56 200  70 483],308,4,21006,3.6286059768526515,20.0,0.0
5789,0,5789,[ 28 228  56 197   1],374,5,21011,3.6288428324697755,0.0,0.0
5790,0,5790,[302 603 427  50  64],370,5,21016,3.6290796062856154,20.0,20.0
5791,0,5791,[ 64  15 357 245 655],313,3,21019,3.628970994475138,20.0,0.0
5792,0,5792,[173  11  79 174   4],537,1,21020,3.6285171759019508,0.0,20.0
5793,0,5793,[302 603 427  50  64],745,4,21024,3.62858129099068,20.0,20.0
5794,0,5794,[202  12  70 197  79],398,3,21027,3.628472821397757,20.0,0.0
5795,0,5795,[423   4  56 318  89],64,3,21030,3.6283643892339543,20.0,0.0
5796,0,5796,[195 235 597   7  71],882,4,21034,3.628428497498706,0.0,0.0
5797,0,5797,[135 234  50 174 268],85,5,21039,3.628665056916178,0.0,40.0
5798,0,5798,[ 89  50 546  22 151],64,2,21041,3.628384204173133,0.0,20.0
5799,0,5799,[ 79 597  64 175 117],308,3,21044,3.6282758620689655,0.0,0.0
5800,0,5800,[ 22 568 546 195 132],339,3,21047,3.628167557317704,0.0,0.0
5801,0,5801,[197 238  82  22 216],313,3,21050,3.6280592899000346,0.0,0.0
5802,0,5802,[302 603 427  50  64],454,5,21055,3.6282957091159744,20.0,20.0
5803,0,5803,[286   7 318 172  95],184,4,21059,3.628359751895245,20.0,0.0
5804,0,5804,[742 202  69 195 179],59,4,21063,3.628423772609819,0.0,0.0
5805,0,5805,[234  70 313 294 475],533,3,21066,3.628315535652773,0.0,0.0
5806,0,5806,[ 28 216 222 435  70],666,2,21068,3.6280351300154985,0.0,0.0
5807,0,5807,[ 15 237 238 111 286],605,2,21070,3.627754820936639,0.0,0.0
5808,0,5808,[302 603 427  50  64],13,5,21075,3.627991048373214,20.0,20.0
5809,0,5809,[195 276 175 435 185],883,5,21080,3.6282271944922546,0.0,0.0
5810,0,5810,[  1  56 515 125 135],455,4,21084,3.628291171915333,0.0,0.0
5811,0,5811,[258 174 385  28 202],899,4,21088,3.6283551273227803,0.0,20.0
5812,0,5812,[ 98 187  11 655 196],234,2,21090,3.6280750043007055,0.0,20.0
5813,0,5813,[180  64 222 282  96],666,2,21092,3.6277949776401788,0.0,0.0
5814,0,5814,[ 22 323 135 143 172],290,4,21096,3.6278589853826313,0.0,0.0
5815,0,5815,[202 183 179 603 143],308,5,21101,3.628094910591472,20.0,0.0
5816,0,5816,[176 182 435 143 228],13,3,21104,3.6279869348461404,0.0,0.0
5817,0,5817,[302 603 427  50  64],13,5,21109,3.628222756961155,20.0,20.0
5818,0,5818,[117 275  11  79 405],145,3,21112,3.6281147963567624,0.0,0.0
5819,0,5819,[121 405 196 210  22],119,5,21117,3.6283505154639175,0.0,0.0
5820,0,5820,[ 50 245 742 194  56],666,1,21118,3.6278989864284488,0.0,20.0
5821,0,5821,[210  70  64 183 196],194,1,21119,3.627447612504294,0.0,0.0
5822,0,5822,[ 97 546  98  64 117],343,3,21122,3.6273398591791173,0.0,20.0
5823,0,5823,[302 603 427  50  64],666,4,21126,3.6274038461538463,20.0,20.0
5824,0,5824,[483 161 168 204 385],881,3,21129,3.627296137339056,20.0,0.0
5825,0,5825,[302 603 427  50  64],370,5,21134,3.6275317542052865,20.0,20.0
5826,0,5826,[161 333  64 183   9],64,3,21137,3.6274240604084436,0.0,0.0
5827,0,5827,[186 172 215 385  98],897,4,21141,3.6274879890185314,0.0,20.0
5828,0,5828,[302 603 427  50  64],669,5,21146,3.6277234517069825,20.0,20.0
5829,0,5829,[289 268 405 322 471],486,2,21148,3.6274442538593483,0.0,0.0
5830,0,5830,[258 515   1  70 194],882,2,21150,3.627165151774996,0.0,0.0
5831,0,5831,[204 357 265   1 183],653,4,21154,3.6272290809327847,20.0,0.0
5832,0,5832,[194 597  11 546  88],207,1,21155,3.6267786730670326,0.0,0.0
5833,0,5833,[302 603 427  50  64],271,5,21160,3.62701405553651,20.0,20.0
5834,0,5834,[302 603 427  50  64],13,5,21165,3.627249357326478,20.0,20.0
5835,0,5835,[258 125  98 515 173],234,2,21167,3.626970527758739,0.0,20.0
5836,0,5836,[302 603 427  50  64],669,5,21172,3.627205756381703,20.0,20.0
5837,0,5837,[143   4  69 515 153],13,3,21175,3.6270983213429258,0.0,0.0
5838,0,5838,[597 180  28 111  56],533,2,21177,3.626819660900839,0.0,0.0
5839,0,5839,[294 496 405 204 194],653,1,21178,3.6263698630136987,0.0,0.0
5840,0,5840,[ 97 435 210  89 100],454,3,21181,3.6262626262626263,0.0,20.0
5841,0,5841,[ 69 186 179 210 168],664,4,21185,3.626326600479288,0.0,0.0
5842,0,5842,[174  69 275 195 508],533,5,21190,3.626561697758001,0.0,20.0
5843,0,5843,[357 195 322 323  69],311,4,21194,3.6266255989048597,20.0,0.0
5844,0,5844,[302 603 427  50  64],669,5,21199,3.6268605645851153,20.0,20.0
5845,0,5845,[302 603 427  50  64],13,5,21204,3.62709544988026,20.0,20.0
5846,0,5846,[168 127 202 111 265],59,5,21209,3.6273302548315374,0.0,20.0
5847,0,5847,[546 357  88   4 144],295,5,21214,3.627564979480164,20.0,0.0
5848,0,5848,[313 222  12 245 216],334,3,21217,3.6274576850743716,20.0,0.0
5849,0,5849,[282  79 273 132 588],42,4,21221,3.6275213675213673,0.0,0.0
5850,0,5850,[302 603 427  50  64],537,4,21225,3.6275850282003077,20.0,20.0
5851,0,5851,[588 215 269 546 168],13,3,21228,3.6274777853725224,0.0,0.0
5852,0,5852,[302 603 427  50  64],664,5,21233,3.6277122842986502,20.0,20.0
5853,0,5853,[ 15 323 282 423 234],374,2,21235,3.6274342330030747,0.0,0.0
5854,0,5854,[302 603 427  50  64],745,4,21239,3.6274978650725873,20.0,20.0
5855,0,5855,[496 435 173 405 302],524,3,21242,3.627390710382514,0.0,0.0
5856,0,5856,[302 603 427  50  64],458,4,21246,3.627454328154345,20.0,20.0
5857,0,5857,[302 603 427  50  64],537,4,21250,3.627517924206214,20.0,20.0
5858,0,5858,[302 603 427  50  64],537,4,21254,3.6275814985492403,20.0,20.0
5859,0,5859,[210 180 483  15 195],650,2,21256,3.6273037542662117,20.0,0.0
5860,0,5860,[302 603 427  50  64],537,4,21260,3.627367343456748,20.0,20.0
5861,0,5861,[  7 202  70 748 271],102,1,21261,3.626919140225179,0.0,0.0
5862,0,5862,[ 15 222  64   9 161],749,2,21263,3.626641651031895,0.0,0.0
5863,0,5863,[168 194  64 195 403],311,5,21268,3.6268758526603,0.0,0.0
5864,0,5864,[235 100  64 258 196],119,4,21272,3.62693947144075,0.0,20.0
5865,0,5865,[302 603 427  50  64],271,5,21277,3.6271735424480056,20.0,20.0
5866,0,5866,[151 196   1 294 143],42,5,21282,3.62740753366286,0.0,0.0
5867,0,5867,[179 294 515 357   7],387,4,21286,3.62747102931152,20.0,0.0
5868,0,5868,[302 603 427  50  64],13,5,21291,3.627704890100528,20.0,20.0
5869,0,5869,[328 742 118 245 168],92,2,21293,3.627427597955707,0.0,0.0
5870,0,5870,[322 175 228 288 135],804,3,21296,3.6273207290069833,0.0,0.0
5871,0,5871,[655  64  11 405  79],749,4,21300,3.627384196185286,0.0,0.0
5872,0,5872,[117  79 183 168  98],653,2,21302,3.6271071002894604,0.0,20.0
5873,0,5873,[302 603 427  50  64],370,5,21307,3.6273408239700373,20.0,20.0
5874,0,5874,[302 603 427  50  64],13,5,21312,3.6275744680851063,20.0,20.0
5875,0,5875,[265 515  56 118 191],13,3,21315,3.6274676650782847,0.0,0.0
5876,0,5876,[302 603 427  50  64],537,4,21319,3.627531053258465,20.0,20.0
5877,0,5877,[302 603 427  50  64],271,5,21324,3.627764545763865,20.0,20.0
5878,0,5878,[302 603 427  50  64],339,5,21329,3.627997958836537,20.0,20.0
5879,0,5879,[183 197 603 258 153],64,1,21330,3.627551020408163,20.0,0.0
5880,0,5880,[237 655  71 235 568],59,2,21332,3.627274273082809,0.0,0.0
5881,0,5881,[302 603 427  50  64],339,5,21337,3.6275076504590276,20.0,20.0
5882,0,5882,[302 603 427  50  64],669,5,21342,3.6277409484956653,20.0,20.0
5883,0,5883,[180  70   4 185 385],543,4,21346,3.6278042148198506,0.0,0.0
5884,0,5884,[202  69  95 276 216],233,5,21351,3.62803738317757,0.0,0.0
5885,0,5885,[204 182 265 742 174],271,3,21354,3.6279306829765545,0.0,20.0
5886,0,5886,[302 603 427  50  64],537,4,21358,3.6279938848309836,20.0,20.0
5887,0,5887,[238 175 237 196 245],207,2,21360,3.6277173913043477,0.0,0.0
5888,0,5888,[202  82 238 143 313],537,2,21362,3.627440991679402,0.0,0.0
5889,0,5889,[143 127 132 508 197],13,3,21365,3.627334465195246,0.0,20.0
5890,0,5890,[302 603 427  50  64],370,5,21370,3.6275674758105585,20.0,20.0
5891,0,5891,[238  97 275  89 204],454,2,21372,3.6272912423625256,0.0,0.0
5892,0,5892,[186  88 181 435 135],406,3,21375,3.6271847955201086,0.0,0.0
5893,0,5893,[ 12 265 181 210 151],379,5,21380,3.627417712928402,20.0,0.0
5894,0,5894,[405 265 222 483 237],328,4,21384,3.6274809160305344,20.0,0.0
5895,0,5895,[  4 210  15 228 385],648,3,21387,3.6273744911804613,0.0,0.0
5896,0,5896,[302 603 427  50  64],537,4,21391,3.627437680176361,20.0,20.0
5897,0,5897,[302 603 427  50  64],454,5,21396,3.627670396744659,20.0,20.0
5898,0,5898,[423 121 294 475   4],387,0,21396,3.627055433124258,0.0,0.0
5899,0,5899,[204 197 222 100 276],455,4,21400,3.6271186440677967,0.0,20.0
5900,0,5900,[302 603 427  50  64],13,5,21405,3.6273512963904424,20.0,20.0
5901,0,5901,[168 118 301 185 121],102,0,21405,3.6267366994239243,0.0,0.0
5902,0,5902,[302 603 427  50  64],370,5,21410,3.6269693376249363,20.0,20.0
5903,0,5903,[302 603 427  50  64],669,5,21415,3.62720189701897,20.0,20.0
5904,0,5904,[ 50 257 238 121 187],213,5,21420,3.6274343776460625,0.0,20.0
5905,0,5905,[176 197 568 275 180],648,3,21423,3.6273281408736877,0.0,0.0
5906,0,5906,[ 71 515 135  64 173],194,4,21427,3.627391230743186,0.0,0.0
5907,0,5907,[302 603 427  50  64],271,5,21432,3.6276235612728502,20.0,20.0
5908,0,5908,[ 56 161 196 186 322],533,3,21435,3.627517346420714,0.0,0.0
5909,0,5909,[ 96 161   7 196 228],87,5,21440,3.6277495769881556,0.0,0.0
5910,0,5910,[187 132 257  70 333],533,5,21445,3.627981728979868,0.0,0.0
5911,0,5911,[258 289 294 153 202],378,3,21448,3.6278755074424898,0.0,0.0
5912,0,5912,[182 194 211 222  98],843,0,21448,3.6272619651615083,0.0,20.0
5913,0,5913,[302 603 427  50  64],13,5,21453,3.6274940818397026,20.0,20.0
5914,0,5914,[302 603 427  50  64],271,5,21458,3.6277261200338122,20.0,20.0
5915,0,5915,[  1 322 180 186   8],308,4,21462,3.627789046653144,0.0,0.0
5916,0,5916,[405 515 182 234   7],474,5,21467,3.6280209565658272,0.0,0.0
5917,0,5917,[515 427  11 238   8],271,5,21472,3.6282527881040894,0.0,0.0
5918,0,5918,[302 603 427  50  64],271,5,21477,3.628484541307653,20.0,20.0
5919,0,5919,[405 268  25   1  50],637,3,21480,3.6283783783783785,0.0,20.0
5920,0,5920,[294 194 181 111 168],474,3,21483,3.6282722513089007,0.0,0.0
5921,0,5921,[135  15 568 234 273],59,4,21487,3.628335021952043,0.0,0.0
5922,0,5922,[289 678 568 268 173],537,2,21489,3.6280601046766843,0.0,0.0
5923,0,5923,[302 603 427  50  64],370,5,21494,3.62829169480081,20.0,20.0
5924,0,5924,[302 603 427  50  64],339,5,21499,3.628523206751055,20.0,20.0
5925,0,5925,[ 12  15 318 568 125],378,4,21503,3.6285858926763415,40.0,0.0
5926,0,5926,[302 603 427  50  64],458,4,21507,3.628648557448962,20.0,20.0
5927,0,5927,[153 200 275 176 234],10,5,21512,3.6288798920377867,0.0,0.0
5928,0,5928,[ 69 194 357 182  22],234,4,21516,3.6289424860853434,20.0,0.0
5929,0,5929,[179 357 568 194 185],749,5,21521,3.6291736930860035,20.0,0.0
5930,0,5930,[ 69 144 187 357  12],343,5,21526,3.629404822121059,40.0,0.0
5931,0,5931,[111 235 435  64 194],82,4,21530,3.629467296021578,0.0,0.0
5932,0,5932,[ 11 318  70 597 168],7,2,21532,3.629192651272543,20.0,0.0
5933,0,5933,[  9 678 273 300 100],145,2,21534,3.62891809908999,0.0,20.0
5934,0,5934,[302 603 427  50  64],271,5,21539,3.6291491154170177,20.0,20.0
5935,0,5935,[210 118 234 215 196],59,5,21544,3.629380053908356,0.0,0.0
5936,0,5936,[265  95 385 196 475],92,4,21548,3.6294424793666833,0.0,0.0
5937,0,5937,[182 204   9  15 286],474,5,21553,3.6296732906702593,0.0,0.0
5938,0,5938,[196 273  89   7 172],892,5,21558,3.629904024246506,0.0,0.0
5939,0,5939,[302 603 427  50  64],370,5,21563,3.63013468013468,20.0,20.0
5940,0,5940,[318 161  89 678 289],387,1,21564,3.629691971048645,20.0,0.0
5941,0,5941,[385 202  89  88 200],13,3,21567,3.629585997980478,0.0,0.0
5942,0,5942,[302 603 427  50  64],370,5,21572,3.6298165909473328,20.0,20.0
5943,0,5943,[273 385   7 176 135],64,4,21576,3.629878869448183,0.0,0.0
5944,0,5944,[161 568 333  22 153],387,2,21578,3.629604709840202,0.0,0.0
5945,0,5945,[182 216 405  98 143],64,4,21582,3.629667003027245,0.0,20.0
5946,0,5946,[302 603 427  50  64],370,5,21587,3.629897427274256,20.0,20.0
5947,0,5947,[ 98  50  70 282 271],334,3,21590,3.629791526563551,0.0,40.0
5948,0,5948,[176 187 175  88 357],537,3,21593,3.629685661455707,20.0,0.0
5949,0,5949,[302 603 427  50  64],339,5,21598,3.629915966386555,20.0,20.0
5950,0,5950,[294 216 301  25  50],234,1,21599,3.6294740379768107,0.0,20.0
5951,0,5951,[302 603 427  50  64],458,4,21603,3.6295362903225805,20.0,20.0
5952,0,5952,[357   4 100 515 168],387,4,21607,3.6295985217537376,20.0,20.0
5953,0,5953,[403 173 257  69 127],804,3,21610,3.6294927779643937,0.0,20.0
5954,0,5954,[173   9 168 423 174],13,3,21613,3.629387069689337,0.0,20.0
5955,0,5955,[302 603 427  50  64],458,4,21617,3.6294492948287442,20.0,20.0
5956,0,5956,[257 655 588  69 265],308,3,21620,3.629343629343629,0.0,0.0
5957,0,5957,[302 603 427  50  64],669,5,21625,3.629573682443773,20.0,20.0
5958,0,5958,[ 88 288   1 180  56],13,3,21628,3.6294680315489174,0.0,0.0
5959,0,5959,[  1 197  12  22 475],533,4,21632,3.629530201342282,20.0,0.0
5960,0,5960,[302 603 427  50  64],339,5,21637,3.629760107364536,20.0,20.0
5961,0,5961,[121 174 435 100   4],666,3,21640,3.6296544783629656,0.0,40.0
5962,0,5962,[175 405 215 357  82],60,4,21644,3.6297165856112694,20.0,0.0
5963,0,5963,[273 237  28 143 111],42,3,21647,3.629610999329309,0.0,0.0
5964,0,5964,[405 117 118 200  28],343,2,21649,3.6293378038558255,0.0,0.0
5965,0,5965,[302 603 427  50  64],458,4,21653,3.629399932953403,20.0,20.0
5966,0,5966,[180 143  71  82  22],533,4,21657,3.629462041226747,0.0,0.0
5967,0,5967,[180 269 222 385 228],738,4,21661,3.629524128686327,0.0,0.0
5968,0,5968,[135 471 186 127 172],311,4,21665,3.6295861953426036,0.0,20.0
5969,0,5969,[302 603 427  50  64],745,4,21669,3.6296482412060302,20.0,20.0
5970,0,5970,[210 238 313 143 294],653,2,21671,3.6293753140177523,0.0,0.0
5971,0,5971,[ 64 118 161 182 238],774,2,21673,3.629102478231748,0.0,0.0
5972,0,5972,[288 546 191  22 268],92,2,21675,3.6288297338021094,0.0,0.0
5973,0,5973,[302 603 427  50  64],339,5,21680,3.629059256779377,20.0,20.0
5974,0,5974,[286 100  98 151  25],382,2,21682,3.6287866108786613,0.0,40.0
5975,0,5975,[168 423 183 200 302],543,3,21685,3.628681392235609,0.0,0.0
5976,0,5976,[302 603 427  50  64],537,4,21689,3.6287435168144553,20.0,20.0
5977,0,5977,[322 385 118 748 568],533,4,21693,3.628805620608899,0.0,0.0
5978,0,5978,[403 405   1 748 475],92,3,21696,3.628700451580532,0.0,0.0
5979,0,5979,[678 202  28 405  22],554,4,21700,3.62876254180602,0.0,0.0
5980,0,5980,[ 96 289 186 265 546],524,4,21704,3.6288246112690183,0.0,0.0
5981,0,5981,[135  15 196 742 180],650,2,21706,3.6285523236375794,0.0,0.0
5982,0,5982,[289 403 597 742   9],374,2,21708,3.628280127026575,0.0,0.0
5983,0,5983,[302 603 427  50  64],458,4,21712,3.628342245989305,20.0,20.0
5984,0,5984,[172 268 175 196  82],334,4,21716,3.628404344193818,0.0,0.0
5985,0,5985,[  9 222 603 423 483],648,4,21720,3.628466421650518,40.0,0.0
5986,0,5986,[508 211 483 234 176],833,2,21722,3.628194421246033,20.0,0.0
5987,0,5987,[302 603 427  50  64],664,5,21727,3.6284235136940546,20.0,20.0
5988,0,5988,[302 603 427  50  64],745,4,21731,3.628485556854233,20.0,20.0
5989,0,5989,[302 603 427  50  64],474,5,21736,3.6287145242070116,20.0,20.0
5990,0,5990,[182 132 127 100   8],87,5,21741,3.628943415122684,0.0,40.0
5991,0,5991,[125 143 288  25 144],374,4,21745,3.6290053404539386,0.0,0.0
5992,0,5992,[ 56 153 286  88 174],379,5,21750,3.6292341064575337,0.0,20.0
5993,0,5993,[302 603 427  50  64],669,5,21755,3.629462796129463,20.0,20.0
5994,0,5994,[210 496 211 427 568],385,1,21756,3.629024186822352,0.0,0.0
5995,0,5995,[302 603 427  50  64],537,4,21760,3.629086057371581,20.0,20.0
5996,0,5996,[172 216 257 318 678],804,5,21765,3.6293146573286643,20.0,0.0
5997,0,5997,[127 238  79 187 168],881,3,21768,3.6292097365788596,0.0,20.0
5998,0,5998,[302 603 427  50  64],745,4,21772,3.629271545257543,20.0,20.0
5999,0,5999,[235 245 172 174 269],378,4,21776,3.6293333333333333,0.0,20.0
6000,0,6000,[300 265  97 196  71],533,3,21779,3.6292284619230126,0.0,0.0
6001,0,6001,[302 603 427  50  64],13,5,21784,3.6294568477174276,20.0,20.0
6002,0,6002,[210 597  89 271 385],13,1,21785,3.6290188239213728,0.0,0.0
6003,0,6003,[228 427 597 269 276],13,3,21788,3.6289140572951366,0.0,0.0
6004,0,6004,[ 95  98 182  11  50],374,4,21792,3.628975853455454,0.0,40.0
6005,0,6005,[357 153 204 182 125],6,3,21795,3.628871128871129,20.0,0.0
6006,0,6006,[265 357 216  56   1],488,3,21798,3.62876643915432,20.0,0.0
6007,0,6007,[302 603 427  50  64],458,4,21802,3.6288282290279628,20.0,20.0
6008,0,6008,[302 603 427  50  64],370,5,21807,3.6290564153769345,20.0,20.0
6009,0,6009,[302 603 427  50  64],13,5,21812,3.629284525790349,20.0,20.0
6010,0,6010,[603 181 655 127  79],659,4,21816,3.6293461986358344,20.0,20.0
6011,0,6011,[302 603 427  50  64],13,5,21821,3.6295741849634067,20.0,20.0
6012,0,6012,[200 179  97 183 151],815,4,21825,3.6296357891235655,0.0,0.0
6013,0,6013,[ 12  79  69   7 508],774,1,21826,3.6291985367475887,20.0,0.0
6014,0,6014,[515 118 211 300 405],328,4,21830,3.629260182876143,0.0,0.0
6015,0,6015,[187 195 515 265  97],7,4,21834,3.6293218085106385,0.0,0.0
6016,0,6016,[302  96  56 200   7],537,3,21837,3.629217217882666,0.0,0.0
6017,0,6017,[294  70 143 269 132],13,1,21838,3.628780325689598,0.0,0.0
6018,0,6018,[ 98 197  82  64 655],13,4,21842,3.628842000332281,0.0,20.0
6019,0,6019,[175 197 202 328  22],479,5,21847,3.6290697674418606,0.0,0.0
6020,0,6020,[ 71  98 202 313   8],92,4,21851,3.6291313735259925,0.0,20.0
6021,0,6021,[ 96 182  71  25 216],308,4,21855,3.6291929591497842,0.0,0.0
6022,0,6022,[185   8  50 302 200],271,4,21859,3.629254524323427,0.0,20.0
6023,0,6023,[235 202 121 183 515],87,4,21863,3.629316069057105,0.0,0.0
6024,0,6024,[276 202 405 161 197],194,2,21865,3.629045643153527,0.0,0.0
6025,0,6025,[302 603 427  50  64],474,5,21870,3.6292731496846997,20.0,20.0
6026,0,6026,[568 403 588 111  82],13,2,21872,3.6290028206404514,0.0,0.0
6027,0,6027,[302 603 427  50  64],669,5,21877,3.6292302587923024,20.0,20.0
6028,0,6028,[302 603 427  50  64],664,5,21882,3.629457621496102,20.0,20.0
6029,0,6029,[ 98 100 179 597 238],833,2,21884,3.6291873963515755,0.0,40.0
6030,0,6030,[194 276 302 357 186],232,5,21889,3.629414690764384,20.0,0.0
6031,0,6031,[302 603 427  50  64],339,5,21894,3.6296419098143238,20.0,20.0
6032,0,6032,[286 289 143  11 195],13,0,21894,3.6290402784684237,0.0,0.0
6033,0,6033,[302 603 427  50  64],664,5,21899,3.6292674842558834,20.0,20.0
6034,0,6034,[222 195 237   1 294],901,3,21902,3.6291632145816073,0.0,0.0
6035,0,6035,[ 69 204   9 603 176],60,5,21907,3.6293903247183565,20.0,0.0
6036,0,6036,[168   1 153 135 222],883,3,21910,3.6292860692396887,0.0,0.0
6037,0,6037,[302 603 427  50  64],666,4,21914,3.6293474660483604,20.0,20.0
6038,0,6038,[282 301 237 197 187],318,5,21919,3.629574432853121,0.0,0.0
6039,0,6039,[302 603 427  50  64],13,5,21924,3.6298013245033114,20.0,20.0
6040,0,6040,[302 603 427  50  64],669,5,21929,3.6300281410362523,20.0,20.0
6041,0,6041,[302 603 427  50  64],745,4,21933,3.6300893743793448,20.0,20.0
6042,0,6042,[  1 215 515 127 318],194,4,21937,3.630150587456561,20.0,20.0
6043,0,6043,[302 603 427  50  64],666,4,21941,3.6302117802779614,20.0,20.0
6044,0,6044,[302 603 427  50  64],370,5,21946,3.6304383788254757,20.0,20.0
6045,0,6045,[302 603 427  50  64],454,5,21951,3.6306649024148197,20.0,20.0
6046,0,6046,[ 28 471 176 194 100],313,4,21955,3.6307259798247067,0.0,20.0
6047,0,6047,[568  56  12 175 496],387,3,21958,3.630621693121693,20.0,0.0
6048,0,6048,[302 603 427  50  64],13,5,21963,3.6308480740618285,20.0,20.0
6049,0,6049,[302 603 427  50  64],370,5,21968,3.6310743801652894,20.0,20.0
6050,0,6050,[210 197  56 257 258],334,4,21972,3.6311353495290035,0.0,0.0
6051,0,6051,[302 603 427  50  64],458,4,21976,3.6311962987442166,20.0,20.0
6052,0,6052,[181 678 135 194  25],213,5,21981,3.631422435156121,0.0,0.0
6053,0,6053,[186 180 423 294 333],537,2,21983,3.631152956722828,0.0,0.0
6054,0,6054,[302 603 427  50  64],370,5,21988,3.6313790255986786,20.0,20.0
6055,0,6055,[210 187  82 161 175],774,0,21988,3.630779392338177,0.0,0.0
6056,0,6056,[  8 318 200 313   1],234,4,21992,3.630840350008255,20.0,0.0
6057,0,6057,[568 111  96 181 322],454,2,21994,3.630571145592605,0.0,0.0
6058,0,6058,[302 603 427  50  64],454,5,21999,3.6307971612477306,20.0,20.0
6059,0,6059,[  9 515 194 508  98],543,4,22003,3.630858085808581,0.0,20.0
6060,0,6060,[ 96 271 258 185 357],749,5,22008,3.6310839795413297,20.0,0.0
6061,0,6061,[258 515   8 294 117],13,2,22010,3.630814912570109,0.0,0.0
6062,0,6062,[286 588 181 186 175],881,1,22011,3.6303809995051957,0.0,0.0
6063,0,6063,[302 603 427  50  64],13,5,22016,3.6306068601583115,20.0,20.0
6064,0,6064,[  4 423  95 196 181],378,4,22020,3.6306677658697444,0.0,0.0
6065,0,6065,[245  82 191 275  28],554,4,22024,3.630728651500165,0.0,0.0
6066,0,6066,[132 275 257   7 121],474,3,22027,3.6306246909510467,0.0,0.0
6067,0,6067,[302 603 427  50  64],537,4,22031,3.630685563612393,20.0,20.0
6068,0,6068,[318  28 288 333 186],64,4,22035,3.6307464162135443,20.0,0.0
6069,0,6069,[403  97  79 168 483],210,5,22040,3.6309719934102143,20.0,0.0
6070,0,6070,[ 15 174 100 194  82],830,4,22044,3.631032778784385,0.0,40.0
6071,0,6071,[127 151 271 135 173],890,4,22048,3.6310935441370225,0.0,20.0
6072,0,6072,[302 603 427  50  64],13,5,22053,3.631318952741643,20.0,20.0
6073,0,6073,[216 196 187 182  98],326,2,22055,3.6310503786631543,0.0,20.0
6074,0,6074,[127 211 180  12  50],346,5,22060,3.631275720164609,20.0,40.0
6075,0,6075,[ 98 318 195 275 276],883,4,22064,3.6313364055299537,20.0,20.0
6076,0,6076,[194 357 180 151 228],215,4,22068,3.631397070923153,20.0,0.0
6077,0,6077,[ 56 172 100 568 176],538,4,22072,3.631457716354064,0.0,20.0
6078,0,6078,[222 180 289 515 173],85,2,22074,3.6311893403520314,0.0,0.0
6079,0,6079,[186  88  50 313 127],102,2,22076,3.630921052631579,0.0,40.0
6080,0,6080,[265  88 328 678 385],537,0,22076,3.6303239598750205,0.0,0.0
6081,0,6081,[496  64 144 187 234],527,4,22080,3.63038474186123,0.0,0.0
6082,0,6082,[135  97 144 117 143],234,1,22081,3.6299523261548576,0.0,0.0
6083,0,6083,[302 603 427  50  64],339,5,22086,3.6301775147928996,20.0,20.0
6084,0,6084,[118 235 597  79 176],213,4,22090,3.6302382908792112,0.0,0.0
6085,0,6085,[180  64   4 127  70],533,3,22093,3.6301347354584292,0.0,20.0
6086,0,6086,[302 603 427  50  64],13,5,22098,3.630359783144406,20.0,20.0
6087,0,6087,[269 275  50 588 265],452,3,22101,3.630256241787122,0.0,20.0
6088,0,6088,[ 71 202 403 678 568],804,4,22105,3.6303169650188867,0.0,0.0
6089,0,6089,[302 603 427  50  64],666,4,22109,3.630377668308703,20.0,20.0
6090,0,6090,[100 385   1 475 179],64,5,22114,3.630602528320473,0.0,20.0
6091,0,6091,[302 603 427  50  64],666,4,22118,3.6306631648063035,20.0,20.0
6092,0,6092,[302 603 427  50  64],537,4,22122,3.6307237813884785,20.0,20.0
6093,0,6093,[302 603 427  50  64],664,5,22127,3.6309484739087625,20.0,20.0
6094,0,6094,[71 79 82 96 70],311,5,22132,3.6311730926989334,0.0,0.0
6095,0,6095,[132 117 322  96 191],90,4,22136,3.631233595800525,0.0,0.0
6096,0,6096,[302 603 427  50  64],669,5,22141,3.6314580941446613,20.0,20.0
6097,0,6097,[ 12  64 182   7 187],13,4,22145,3.631518530665792,20.0,0.0
6098,0,6098,[197   4 268 168 182],334,3,22148,3.631414986063289,0.0,0.0
6099,0,6099,[483 603 294 588 288],650,2,22150,3.6311475409836067,40.0,0.0
6100,0,6100,[ 64 182  97 423 289],95,3,22153,3.631044091132601,0.0,0.0
6101,0,6101,[294  88 238  15 385],749,2,22155,3.6307767944936087,0.0,0.0
6102,0,6102,[222 276 385 100  96],455,3,22158,3.6306734392921514,0.0,20.0
6103,0,6103,[302 603 427  50  64],13,5,22163,3.6308977719528177,20.0,20.0
6104,0,6104,[302 603 427  50  64],370,5,22168,3.631122031122031,20.0,20.0
6105,0,6105,[ 96 603  71 318 195],543,4,22172,3.6311824434981985,40.0,0.0
6106,0,6106,[405  15 294   7  69],6,0,22172,3.630587850008187,0.0,0.0
6107,0,6107,[204  56 313 483 427],13,5,22177,3.6308120497707925,20.0,0.0
6108,0,6108,[ 12 194 195  82 151],892,4,22181,3.6308724832214767,20.0,0.0
6109,0,6109,[161  64   9  11   7],7,3,22184,3.6307692307692307,0.0,0.0
6110,0,6110,[215 475 216 228 181],533,4,22188,3.630829651448208,0.0,0.0
6111,0,6111,[302 603 427  50  64],664,5,22193,3.631053664921466,20.0,20.0
6112,0,6112,[515 427   9 153 423],308,4,22197,3.6311140193031246,0.0,0.0
6113,0,6113,[302 603 427  50  64],666,4,22201,3.631174353941773,20.0,20.0
6114,0,6114,[508 471   7  96 211],653,1,22202,3.630744071954211,0.0,0.0
6115,0,6115,[302 603 427  50  64],13,5,22207,3.630967952910399,20.0,20.0
6116,0,6116,[121 289 197 322 237],334,2,22209,3.630701324178519,0.0,0.0
6117,0,6117,[196 302 294 182 301],666,3,22212,3.630598234717228,0.0,0.0
6118,0,6118,[496 211 168 161 257],653,1,22213,3.6301683281581956,0.0,0.0
6119,0,6119,[194 204 168  97 118],840,2,22215,3.6299019607843137,0.0,0.0
6120,0,6120,[302 603 427  50  64],745,4,22219,3.6299624244404507,20.0,20.0
6121,0,6121,[174 161  96  98 173],13,4,22223,3.6300228683436786,0.0,40.0
6122,0,6122,[302 603 427  50  64],669,5,22228,3.6302466111383307,20.0,20.0
6123,0,6123,[302 603 427  50  64],370,5,22233,3.6304702808621814,20.0,20.0
6124,0,6124,[302 603 427  50  64],454,5,22238,3.6306938775510202,20.0,20.0
6125,0,6125,[204  69 385 121 216],653,4,22242,3.6307541625857005,0.0,0.0
6126,0,6126,[118 265 111 257 475],533,3,22245,3.6306512159294924,0.0,0.0
6127,0,6127,[302 603 427  50  64],339,5,22250,3.630874673629243,20.0,20.0
6128,0,6128,[176 196  98 202 174],275,3,22253,3.6307717409038993,0.0,40.0
6129,0,6129,[302 603 427  50  64],669,5,22258,3.630995106035889,20.0,20.0
6130,0,6130,[228 183 302  50 215],328,3,22261,3.6308921872451476,0.0,20.0
6131,0,6131,[ 89 289 181 328  96],13,3,22264,3.630789302022179,0.0,0.0
6132,0,6132,[174 210 191 143 144],295,5,22269,3.6310125550301646,0.0,20.0
6133,0,6133,[174 238 323 265 143],537,1,22270,3.63058363221389,0.0,20.0
6134,0,6134,[302 603 427  50  64],745,4,22274,3.630643846780766,20.0,20.0
6135,0,6135,[302 603 427  50  64],339,5,22279,3.6308670143415904,20.0,20.0
6136,0,6136,[496 174 215 204 181],650,4,22283,3.630927163109011,0.0,20.0
6137,0,6137,[302 603 427  50  64],664,5,22288,3.631150211795373,20.0,20.0
6138,0,6138,[302 603 427  50  64],271,5,22293,3.6313731878156053,20.0,20.0
6139,0,6139,[191 237 180 204 182],234,1,22294,3.630944625407166,0.0,0.0
6140,0,6140,[302 603 427  50  64],669,5,22299,3.6311675622862727,20.0,20.0
6141,0,6141,[302 603 427  50  64],454,5,22304,3.6313904265711496,20.0,20.0
6142,0,6142,[ 64 176 216 182 748],13,3,22307,3.6312876444733844,0.0,0.0
6143,0,6143,[172 151 403 143 234],290,2,22309,3.6310221354166665,0.0,0.0
6144,0,6144,[302 603 427  50  64],664,5,22314,3.631244914564687,20.0,20.0
6145,0,6145,[143 282 132 313 111],653,1,22315,3.6308167914090466,0.0,0.0
6146,0,6146,[ 50 288  64  82  69],339,4,22319,3.630876850496177,0.0,20.0
6147,0,6147,[302 603 427  50  64],669,5,22324,3.631099544567339,20.0,20.0
6148,0,6148,[403 121 588 186 222],378,3,22327,3.6309969100666777,0.0,0.0
6149,0,6149,[483  79 173 508 313],474,4,22331,3.6310569105691055,20.0,0.0
6150,0,6150,[286 127  79 117 195],387,3,22334,3.6309543163713216,0.0,20.0
6151,0,6151,[302 603 427  50  64],13,5,22339,3.631176853055917,20.0,20.0
6152,0,6152,[175 195 151 135 323],537,2,22341,3.630911750365675,0.0,0.0
6153,0,6153,[215 289 185 678 204],474,3,22344,3.630809229769256,0.0,0.0
6154,0,6154,[302 603 427  50  64],664,5,22349,3.6310316815597075,20.0,20.0
6155,0,6155,[603 427 204 385 200],843,0,22349,3.630441845354126,20.0,0.0
6156,0,6156,[302 423 197   8 275],454,4,22353,3.630501867792756,0.0,0.0
6157,0,6157,[144 265 435 179  15],60,5,22358,3.6307242611237416,0.0,0.0
6158,0,6158,[ 28  22 111 180 181],653,4,22362,3.630784218217243,0.0,0.0
6159,0,6159,[302 603 427  50  64],666,4,22366,3.630844155844156,20.0,20.0
6160,0,6160,[302 603 427  50  64],13,5,22371,3.6310663853270575,20.0,20.0
6161,0,6161,[174   4 742 181 475],308,5,22376,3.631288542680948,0.0,20.0
6162,0,6162,[302 603 427  50  64],454,5,22381,3.631510627940938,20.0,20.0
6163,0,6163,[302 603 427  50  64],454,5,22386,3.6317326411421154,20.0,20.0
6164,0,6164,[302 603 427  50  64],664,5,22391,3.631954582319546,20.0,20.0
6165,0,6165,[195 153  82   1 121],815,4,22395,3.632014271813169,0.0,0.0
6166,0,6166,[238 187 144 100 496],527,5,22400,3.6322360953461974,0.0,20.0
6167,0,6167,[  4   1 597 204 237],788,1,22401,3.6318093385214008,0.0,0.0
6168,0,6168,[302 603 427  50  64],474,5,22406,3.632031123358729,20.0,20.0
6169,0,6169,[210  96 194  64 187],234,3,22409,3.63192868719611,0.0,0.0
6170,0,6170,[403 300  12 294 405],378,3,22412,3.631826284232701,20.0,0.0
6171,0,6171,[323 235 191 151 200],804,3,22415,3.6317239144523654,0.0,0.0
6172,0,6172,[ 56 282 117 121  15],447,4,22419,3.631783573627086,0.0,0.0
6173,0,6173,[302 603 427  50  64],474,5,22424,3.632005183025591,20.0,20.0
6174,0,6174,[302 603 427  50  64],474,5,22429,3.632226720647773,20.0,20.0
6175,0,6175,[282 568 143 238 423],311,4,22433,3.6322862694300517,0.0,0.0
6176,0,6176,[302 603 427  50  64],669,5,22438,3.6325076898170634,20.0,20.0
6177,0,6177,[ 64  28 276 222   4],339,5,22443,3.6327290385237943,0.0,0.0
6178,0,6178,[302 603 427  50  64],474,5,22448,3.632950315585046,20.0,20.0
6179,0,6179,[ 15 483 258 271 210],360,3,22451,3.6328478964401296,20.0,0.0
6180,0,6180,[302 603 427  50  64],669,5,22456,3.633069082672707,20.0,20.0
6181,0,6181,[216 357 258   4  56],474,5,22461,3.633290197347137,20.0,0.0
6182,0,6182,[237 197  56 180 333],343,4,22465,3.6333495067119523,0.0,0.0
6183,0,6183,[237 546 435 271 172],13,3,22468,3.633247089262613,0.0,0.0
6184,0,6184,[ 28 132  95  25 588],13,4,22472,3.633306386418755,0.0,0.0
6185,0,6185,[302 603 427  50  64],13,5,22477,3.633527319754284,20.0,20.0
6186,0,6186,[173 182 318  71 132],892,4,22481,3.6335865524486826,20.0,0.0
6187,0,6187,[328 197  71 405 323],488,1,22482,3.6331609566903684,0.0,0.0
6188,0,6188,[258 655 318 117 302],454,3,22485,3.6330586524478914,20.0,0.0
6189,0,6189,[302 603 427  50  64],370,5,22490,3.633279483037157,20.0,20.0
6190,0,6190,[175 180  56 176 423],653,2,22492,3.6330156679050236,0.0,0.0
6191,0,6191,[302 603 427  50  64],537,4,22496,3.6330749354005167,20.0,20.0
6192,0,6192,[181 655 268 197  69],387,1,22497,3.632649765864686,0.0,0.0
6193,0,6193,[302 603 427  50  64],664,5,22502,3.632870519857927,20.0,20.0
6194,0,6194,[ 25  22 125 111 185],271,2,22504,3.632606941081517,0.0,0.0
6195,0,6195,[302 603 427  50  64],474,5,22509,3.632827630729503,20.0,20.0
6196,0,6196,[100 748  97  95 238],454,3,22512,3.632725512344683,0.0,20.0
6197,0,6197,[302 603 427  50  64],669,5,22517,3.632946111648919,20.0,20.0
6198,0,6198,[  4  96   7 181 427],295,4,22521,3.6330053234392645,0.0,0.0
6199,0,6199,[ 15 403  56  64  69],92,4,22525,3.6330645161290325,0.0,0.0
6200,0,6200,[161 185 186 276 357],13,3,22528,3.6329624254152555,20.0,0.0
6201,0,6201,[323   9 127 475  56],474,4,22532,3.63302160593357,0.0,20.0
6202,0,6202,[302 603 427  50  64],339,5,22537,3.633241979687248,20.0,20.0
6203,0,6203,[302 603 427  50  64],474,5,22542,3.633462282398453,20.0,20.0
6204,0,6204,[603   9 187 144 194],648,3,22545,3.6333601933924253,20.0,0.0
6205,0,6205,[302 603 427  50  64],474,5,22550,3.6335804060586527,20.0,20.0
6206,0,6206,[423 237 282 385 111],92,3,22553,3.633478330916707,0.0,0.0
6207,0,6207,[153 135 301 268   8],13,4,22557,3.6335373711340204,0.0,0.0
6208,0,6208,[286  70 678 153 475],648,1,22558,3.633113222741182,0.0,0.0
6209,0,6209,[211 143  89  64 323],90,4,22562,3.63317230273752,0.0,0.0
6210,0,6210,[288 265  79 180 168],452,3,22565,3.633070359040412,0.0,0.0
6211,0,6211,[234   7 143 228 268],13,3,22568,3.632968448164842,0.0,0.0
6212,0,6212,[117 183 405 245  28],200,3,22571,3.6328665700949623,0.0,0.0
6213,0,6213,[194  82 483 117  69],234,3,22574,3.632764724814934,20.0,0.0
6214,0,6214,[302 603 427  50  64],271,5,22579,3.6329847144006435,20.0,20.0
6215,0,6215,[176  69 186 588 496],10,5,22584,3.6332046332046333,0.0,0.0
6216,0,6216,[237 135   7 471 204],447,5,22589,3.6334244812610583,0.0,0.0
6217,0,6217,[302 603 427  50  64],664,5,22594,3.6336442586040527,20.0,20.0
6218,0,6218,[318 173   9 234 183],311,5,22599,3.633863965267728,20.0,0.0
6219,0,6219,[228  64 423 235  28],339,3,22602,3.6337620578778136,0.0,0.0
6220,0,6220,[ 98 282 265  50 568],328,3,22605,3.6336601832502815,0.0,40.0
6221,0,6221,[318 168 289 100 196],85,3,22608,3.6335583413693344,20.0,20.0
6222,0,6222,[210 185 175 234 168],527,4,22612,3.633617226418126,0.0,0.0
6223,0,6223,[ 88 238  95 132  22],13,4,22616,3.633676092544987,0.0,0.0
6224,0,6224,[ 50 216   9 194 183],7,5,22621,3.633895582329317,0.0,20.0
6225,0,6225,[238 271 151  82 210],749,4,22625,3.633954384837777,0.0,0.0
6226,0,6226,[302 603 427  50  64],666,4,22629,3.6340131684599326,20.0,20.0
6227,0,6227,[302 603 427  50  64],271,5,22634,3.634232498394348,20.0,20.0
6228,0,6228,[186 222 125 172 234],254,3,22637,3.6341306790817147,0.0,0.0
6229,0,6229,[ 98  69  28 161 180],308,1,22638,3.6337078651685393,0.0,20.0
6230,0,6230,[302 603 427  50  64],454,5,22643,3.633927138501043,20.0,20.0
6231,0,6231,[258 186 173  69  79],334,3,22646,3.6338254172015403,0.0,0.0
6232,0,6232,[179   8  89 100  15],271,3,22649,3.633723728541633,0.0,20.0
6233,0,6233,[302 603 427  50  64],669,5,22654,3.633942893808149,20.0,20.0
6234,0,6234,[182 196 194 238 357],537,3,22657,3.6338412189254212,20.0,0.0
6235,0,6235,[ 71 195 427 300  79],454,4,22661,3.633899935856318,0.0,0.0
6236,0,6236,[471 132 238 483 174],7,5,22666,3.634118967452301,20.0,20.0
6237,0,6237,[173 471 174 180 234],95,3,22669,3.6340173132414235,0.0,20.0
6238,0,6238,[603 168 211 238 588],234,1,22670,3.633595127424267,20.0,0.0
6239,0,6239,[302 603 427  50  64],454,5,22675,3.6338141025641026,20.0,20.0
6240,0,6240,[ 88  50  11 118 748],13,4,22679,3.63387277679859,0.0,20.0
6241,0,6241,[302 603 427  50  64],370,5,22684,3.6340916372957386,20.0,20.0
6242,0,6242,[302 603 427  50  64],664,5,22689,3.6343104276790004,20.0,20.0
6243,0,6243,[ 95  98 238 197 588],899,3,22692,3.6342088404868673,0.0,20.0
6244,0,6244,[182 211  50 483 588],95,1,22693,3.633787029623699,20.0,20.0
6245,0,6245,[187 483  50 475 276],334,5,22698,3.634005763688761,20.0,20.0
6246,0,6246,[302 603 427  50  64],537,4,22702,3.6340643508884263,20.0,20.0
6247,0,6247,[286 174  82 318 435],537,1,22703,3.6336427656850194,20.0,20.0
6248,0,6248,[191 204 496 211 234],666,3,22706,3.633541366618659,0.0,0.0
6249,0,6249,[237 194 153 405  50],804,5,22711,3.63376,0.0,20.0
6250,0,6250,[ 69 111 588 211 100],452,2,22713,3.633498640217565,0.0,20.0
6251,0,6251,[  4 515 302 273  96],328,3,22716,3.6333973128598847,0.0,0.0
6252,0,6252,[144  22 185  89 204],13,4,22720,3.6334559411482488,0.0,0.0
6253,0,6253,[302 603 427  50  64],474,5,22725,3.633674448353054,20.0,20.0
6254,0,6254,[258 271 275   1 603],64,2,22727,3.6334132693844925,20.0,0.0
6255,0,6255,[186 235  98 546 176],882,3,22730,3.633312020460358,0.0,20.0
6256,0,6256,[742 210 588 289 191],387,2,22732,3.633050982899153,0.0,0.0
6257,0,6257,[175 195 748 245 322],804,5,22737,3.6332694151486096,0.0,0.0
6258,0,6258,[302 603 427  50  64],666,4,22741,3.6333280076689567,20.0,20.0
6259,0,6259,[ 82 168 423 186   1],59,4,22745,3.6333865814696487,0.0,0.0
6260,0,6260,[181 385  50  11 100],378,4,22749,3.633445136559655,0.0,40.0
6261,0,6261,[194 173 197 186 546],804,4,22753,3.6335036729479397,0.0,0.0
6262,0,6262,[357 151 588  71  22],298,4,22757,3.6335621906434614,20.0,0.0
6263,0,6263,[302 603 427  50  64],13,5,22762,3.6337803320561943,20.0,20.0
6264,0,6264,[197 238 215 288 435],64,4,22766,3.633838786911413,0.0,0.0
6265,0,6265,[  9 603 196 435 174],533,5,22771,3.63405681455474,20.0,20.0
6266,0,6266,[302 603 427  50  64],664,5,22776,3.6342747726184776,20.0,20.0
6267,0,6267,[ 15 318 211 742 185],653,1,22777,3.633854499042757,20.0,0.0
6268,0,6268,[302 603 427  50  64],474,5,22782,3.634072419843675,20.0,20.0
6269,0,6269,[289 111  25 118 568],533,4,22786,3.6341307814992025,0.0,0.0
6270,0,6270,[161   9 258   7 197],64,2,22788,3.6338701961409665,0.0,0.0
6271,0,6271,[483   7 174 180 222],788,3,22791,3.633769132653061,20.0,20.0
6272,0,6272,[176 181  79 286 135],479,4,22795,3.6338275147457355,0.0,0.0
6273,0,6273,[678  71 187 204 234],308,3,22798,3.633726490277335,0.0,0.0
6274,0,6274,[333 186 118 202 211],13,4,22802,3.633784860557769,0.0,0.0
6275,0,6275,[234  82 405 385 237],343,3,22805,3.6336838750796687,0.0,0.0
6276,0,6276,[515 118 276 323  98],200,4,22809,3.6337422335510596,0.0,20.0
6277,0,6277,[ 25 202 191  79  96],648,4,22813,3.633800573431029,0.0,0.0
6278,0,6278,[187 475 125  15 471],6,2,22815,3.6335403726708075,0.0,0.0
6279,0,6279,[302 603 427  50  64],537,4,22819,3.63359872611465,20.0,20.0
6280,0,6280,[302 603 427  50  64],664,5,22824,3.63381627129438,20.0,20.0
6281,0,6281,[197 117  89 135 238],474,5,22829,3.634033747214263,0.0,0.0
6282,0,6282,[302 603 427  50  64],370,5,22834,3.634251153907369,20.0,20.0
6283,0,6283,[195 258 144  15 161],234,0,22834,3.633672819859962,0.0,0.0
6284,0,6284,[ 79 265 185 216 235],537,1,22835,3.633253778838504,0.0,0.0
6285,0,6285,[302 603 427  50  64],474,5,22840,3.6334712058542795,20.0,20.0
6286,0,6286,[302 603 427  50  64],669,5,22845,3.633688563702879,20.0,20.0
6287,0,6287,[302 603 427  50  64],271,5,22850,3.633905852417303,20.0,20.0
6288,0,6288,[302 603 427  50  64],339,5,22855,3.6341230720305293,20.0,20.0
6289,0,6289,[655 323 196 179  71],474,4,22859,3.634181240063593,0.0,0.0
6290,0,6290,[302 603 427  50  64],537,4,22863,3.6342393896041965,20.0,20.0
6291,0,6291,[302 603 427  50  64],745,4,22867,3.634297520661157,20.0,20.0
6292,0,6292,[185 180 127 121 144],833,4,22871,3.634355633243286,0.0,20.0
6293,0,6293,[ 22 180  28 196   1],339,5,22876,3.63457260883381,0.0,0.0
6294,0,6294,[302 603 427  50  64],339,5,22881,3.634789515488483,20.0,20.0
6295,0,6295,[195 238 357 191 200],59,5,22886,3.6350063532401524,20.0,0.0
6296,0,6296,[144 294 197 127 257],650,1,22887,3.6345878989995235,0.0,20.0
6297,0,6297,[143 176 423  15 100],378,5,22892,3.634804699904732,0.0,20.0
6298,0,6298,[302 603 427  50  64],537,4,22896,3.634862676615336,20.0,20.0
6299,0,6299,[ 70 313 471 357 195],454,3,22899,3.6347619047619046,20.0,0.0
6300,0,6300,[302 603 427  50  64],664,5,22904,3.6349785748293924,20.0,20.0
6301,0,6301,[313   1 258 215 121],271,2,22906,3.634719136781974,0.0,0.0
6302,0,6302,[ 95 423  98 245 196],378,4,22910,3.6347770902744725,0.0,20.0
6303,0,6303,[302 603 427  50  64],370,5,22915,3.634993654822335,20.0,20.0
6304,0,6304,[202 117 423 237  82],882,5,22920,3.635210150674068,0.0,0.0
6305,0,6305,[ 79  50 237 196  95],378,5,22925,3.6354265778623533,0.0,20.0
6306,0,6306,[288 204 302 234 185],474,4,22929,3.6354843824322183,0.0,0.0
6307,0,6307,[111 216  89 132 238],653,1,22930,3.6350665821179455,0.0,0.0
6308,0,6308,[301 403 496 289 300],234,2,22932,3.6348074179743226,0.0,0.0
6309,0,6309,[ 70 302 132 151 180],524,4,22936,3.63486529318542,0.0,0.0
6310,0,6310,[302 603 427  50  64],664,5,22941,3.635081603549358,20.0,20.0
6311,0,6311,[234   4 515  70 135],59,4,22945,3.6351394169835234,0.0,0.0
6312,0,6312,[508 323 237 405 328],63,2,22947,3.6348804055124346,0.0,0.0
6313,0,6313,[302 603 427  50  64],664,5,22952,3.6350966107063667,20.0,20.0
6314,0,6314,[182 197 111 546 127],64,3,22955,3.634996041171813,0.0,20.0
6315,0,6315,[ 71 237  56 238 435],378,4,22959,3.635053831538949,0.0,0.0
6316,0,6316,[275 121 216 204 471],13,2,22961,3.634794997625455,0.0,0.0
6317,0,6317,[588 322 238 168 135],308,4,22965,3.634852801519468,0.0,0.0
6318,0,6318,[302 603 427  50  64],745,4,22969,3.634910587118215,20.0,20.0
6319,0,6319,[302 603 427  50  64],666,4,22973,3.63496835443038,20.0,20.0
6320,0,6320,[ 89 200   4   9  95],543,4,22977,3.6350261034646416,0.0,0.0
6321,0,6321,[ 25 183 515 403 603],13,2,22979,3.634767478645998,20.0,0.0
6322,0,6322,[302 603 427  50  64],669,5,22984,3.634983393958564,20.0,20.0
6323,0,6323,[185 568 111 196 222],64,5,22989,3.6351992409867173,0.0,0.0
6324,0,6324,[302 603 427  50  64],13,5,22994,3.6354150197628456,20.0,20.0
6325,0,6325,[195 258  56 313 161],207,4,22998,3.6354726525450523,0.0,0.0
6326,0,6326,[275 385 276  82 235],119,3,23001,3.635372214319583,0.0,0.0
6327,0,6327,[302 603 427  50  64],669,5,23006,3.63558786346397,20.0,20.0
6328,0,6328,[603 483 187  79  64],452,4,23010,3.635645441617949,40.0,0.0
6329,0,6329,[222  25   4 603   9],234,2,23012,3.635387045813586,20.0,0.0
6330,0,6330,[471  12 313 322 135],454,1,23013,3.634970778707945,20.0,0.0
6331,0,6331,[302 603 427  50  64],745,4,23017,3.635028427037271,20.0,20.0
6332,0,6332,[237 313  12  15  79],92,4,23021,3.6350860571609034,20.0,0.0
6333,0,6333,[302 603 427  50  64],537,4,23025,3.6351436690874643,20.0,20.0
6334,0,6334,[302 603 427  50  64],370,5,23030,3.6353591160220993,20.0,20.0
6335,0,6335,[168 742 471 174 300],271,1,23031,3.6349431818181817,0.0,20.0
6336,0,6336,[302 603 427  50  64],458,4,23035,3.635000789016885,20.0,20.0
6337,0,6337,[210  96 161 191  25],295,4,23039,3.6350583780372356,0.0,0.0
6338,0,6338,[168 185 211 748 197],653,1,23040,3.6346426881211547,0.0,0.0
6339,0,6339,[185 234  98  11  69],643,3,23043,3.6345425867507886,0.0,20.0
6340,0,6340,[258 180 427 288 235],882,2,23045,3.6342848131209586,0.0,0.0
6341,0,6341,[ 71 234 276  70 151],533,2,23047,3.6340271207820876,0.0,0.0
6342,0,6342,[ 96 176 323  82  11],378,3,23050,3.633927163802617,0.0,0.0
6343,0,6343,[172 202  95 357 182],406,4,23054,3.633984867591425,20.0,0.0
6344,0,6344,[222 132 215 175 385],650,4,23058,3.6340425531914895,0.0,0.0
6345,0,6345,[ 71  79 121 183 742],788,3,23061,3.633942641033722,0.0,0.0
6346,0,6346,[302 603 427  50  64],669,5,23066,3.6341578698597763,20.0,20.0
6347,0,6347,[200 174  89  71 475],479,3,23069,3.6340579710144927,0.0,20.0
6348,0,6348,[237 118 238 194   7],666,2,23071,3.6338005985194517,0.0,0.0
6349,0,6349,[ 50  11 328  22  79],653,4,23075,3.6338582677165356,0.0,20.0
6350,0,6350,[100 742  69  79  89],881,4,23079,3.6339159187529524,0.0,20.0
6351,0,6351,[186   9 496  28  12],234,2,23081,3.6336586901763224,20.0,0.0
6352,0,6352,[127 117 182 168 300],346,5,23086,3.6338737604281444,0.0,20.0
6353,0,6353,[ 82 265 603 313 132],234,3,23089,3.6337740006295247,20.0,0.0
6354,0,6354,[194  71 143  64 234],474,5,23094,3.6339889850511407,0.0,0.0
6355,0,6355,[302 603 427  50  64],339,5,23099,3.6342039018250474,20.0,20.0
6356,0,6356,[187 196 135 435   8],308,4,23103,3.634261444077395,0.0,0.0
6357,0,6357,[385   7 100 161 234],881,3,23106,3.6341616860648003,0.0,20.0
6358,0,6358,[ 15 168 294 173 174],648,3,23109,3.634061959427583,0.0,20.0
6359,0,6359,[282  11   7 143 127],881,5,23114,3.6342767295597485,0.0,20.0
6360,0,6360,[ 95 568   4 172 117],374,3,23117,3.6341770161924227,0.0,0.0
6361,0,6361,[302 603 427  50  64],271,5,23122,3.634391700723043,20.0,20.0
6362,0,6362,[257 121 258 289 174],825,4,23126,3.6344491592016346,0.0,20.0
6363,0,6363,[748 300 496 245   7],653,3,23129,3.6343494657448145,0.0,0.0
6364,0,6364,[302 603 427  50  64],666,4,23133,3.634406912804399,20.0,20.0
6365,0,6365,[  9 200 385 235 483],648,3,23136,3.63430725730443,20.0,0.0
6366,0,6366,[385 237  50 423 127],666,1,23137,3.633893513428616,0.0,40.0
6367,0,6367,[302 603 427  50  64],271,5,23142,3.634108040201005,20.0,20.0
6368,0,6368,[204 202 121 588 179],13,4,23146,3.634165489087769,0.0,0.0
6369,0,6369,[ 98 323 135   1 144],788,2,23148,3.6339089481946623,0.0,20.0
6370,0,6370,[302 603 427  50  64],537,4,23152,3.6339664102966567,20.0,20.0
6371,0,6371,[191 471 496   9 194],378,3,23155,3.6338669177652227,0.0,0.0
6372,0,6372,[ 96 187 385  28 286],474,5,23160,3.634081280401695,0.0,0.0
6373,0,6373,[273 111 322 191 328],537,1,23161,3.6336680263570758,0.0,0.0
6374,0,6374,[258 135  28 168   8],7,5,23166,3.6338823529411766,0.0,0.0
6375,0,6375,[302 603 427  50  64],745,4,23170,3.633939774153074,20.0,20.0
6376,0,6376,[302 603 427  50  64],745,4,23174,3.6339971773561235,20.0,20.0
6377,0,6377,[216 186 508 144  95],60,5,23179,3.634211351520853,0.0,0.0
6378,0,6378,[258 197  88 318 588],313,3,23182,3.6341119297695563,20.0,0.0
6379,0,6379,[ 12 269 111 323 200],378,2,23184,3.6338557993730407,20.0,0.0
6380,0,6380,[302 603 427  50  64],13,5,23189,3.6340698950007835,20.0,20.0
6381,0,6381,[  9  22 161 200 385],694,5,23194,3.6342839235349422,0.0,0.0
6382,0,6382,[302 603 427  50  64],664,5,23199,3.63449788500705,20.0,20.0
6383,0,6383,[302 603 427  50  64],474,5,23204,3.6347117794486214,20.0,20.0
6384,0,6384,[302 603 427  50  64],664,5,23209,3.634925606891151,20.0,20.0
6385,0,6385,[196 135 125 180 742],59,3,23212,3.6348261822737236,0.0,0.0
6386,0,6386,[258  88 195 294 423],13,3,23215,3.634726788789729,0.0,0.0
6387,0,6387,[302 603 427  50  64],745,4,23219,3.634783969943644,20.0,20.0
6388,0,6388,[302 603 427  50  64],664,5,23224,3.6349976522147442,20.0,20.0
6389,0,6389,[302 603 427  50  64],458,4,23228,3.635054773082942,20.0,20.0
6390,0,6390,[302 603 427  50  64],339,5,23233,3.6352683461117197,20.0,20.0
6391,0,6391,[ 50 151 187 200 288],666,2,23235,3.6350125156445556,0.0,20.0
6392,0,6392,[302 603 427  50  64],339,5,23240,3.6352260284686375,20.0,20.0
6393,0,6393,[ 28 172 215  96 257],308,3,23243,3.6351266812636847,0.0,0.0
6394,0,6394,[ 79 181 172 180 568],897,4,23247,3.6351837372947617,0.0,0.0
6395,0,6395,[210 191 748 302 183],543,3,23250,3.6350844277673544,0.0,0.0
6396,0,6396,[496 210 185 200 268],234,2,23252,3.634828826012193,0.0,0.0
6397,0,6397,[302 603 427  50  64],458,4,23256,3.6348859018443265,20.0,20.0
6398,0,6398,[238 313 161  25 268],85,3,23259,3.6347866854195967,0.0,0.0
6399,0,6399,[204 194  15 294 508],533,5,23264,3.635,0.0,0.0
6400,0,6400,[257   1 179 357 175],339,5,23269,3.635213247930011,20.0,0.0
6401,0,6401,[ 22  95 191 357 294],766,2,23271,3.634957825679475,20.0,0.0
6402,0,6402,[282 200 125 435 289],788,3,23274,3.6348586600031236,0.0,0.0
6403,0,6403,[302 603 427  50  64],666,4,23278,3.6349156777014366,20.0,20.0
6404,0,6404,[276 135 175 483  12],343,5,23283,3.635128805620609,40.0,0.0
6405,0,6405,[302 603 427  50  64],669,5,23288,3.635341866999688,20.0,20.0
6406,0,6406,[235 318 175   8 508],92,3,23291,3.635242703293273,20.0,0.0
6407,0,6407,[234 483 215 294 182],766,2,23293,3.634987515605493,20.0,0.0
6408,0,6408,[258 135 385 597 742],92,3,23296,3.634888438133874,0.0,0.0
6409,0,6409,[275 195 153   8 210],60,3,23299,3.634789391575663,0.0,0.0
6410,0,6410,[423 144 235 475  71],64,3,23302,3.6346903759163935,0.0,0.0
6411,0,6411,[  8 286 265 172  11],488,1,23303,3.6342794759825328,0.0,0.0
6412,0,6412,[ 89 678 515 228  64],881,3,23306,3.6341805707157335,0.0,0.0
6413,0,6413,[ 64 276 275 282 182],271,2,23308,3.633925787340193,0.0,0.0
6414,0,6414,[276  97 286 204 496],474,5,23313,3.6341387373343728,0.0,0.0
6415,0,6415,[302 603 427  50  64],339,5,23318,3.6343516209476308,20.0,20.0
6416,0,6416,[302 603 427  50  64],271,5,23323,3.634564438211002,20.0,20.0
6417,0,6417,[742 197 403 179 210],543,3,23326,3.6344655655967593,0.0,0.0
6418,0,6418,[185  69 172 121  25],881,3,23329,3.634366723788752,0.0,0.0
6419,0,6419,[175 234  71  96 197],524,3,23332,3.634267912772586,0.0,0.0
6420,0,6420,[  4 385  15  82  70],533,4,23336,3.6343248715153402,0.0,0.0
6421,0,6421,[289 179 174  69 265],554,4,23340,3.6343818125194645,0.0,20.0
6422,0,6422,[237 282 118  12 273],42,4,23344,3.634438735793243,20.0,0.0
6423,0,6423,[288 678 127  22  88],13,3,23347,3.6343399750933996,0.0,20.0
6424,0,6424,[568  15 153  64  71],374,4,23351,3.634396887159533,0.0,0.0
6425,0,6425,[302 603 427  50  64],537,4,23355,3.634453781512605,20.0,20.0
6426,0,6426,[302 603 427  50  64],458,4,23359,3.6345106581608837,20.0,20.0
6427,0,6427,[302 603 427  50  64],669,5,23364,3.6347230864965776,20.0,20.0
6428,0,6428,[ 88 182 181 228 276],533,3,23367,3.6346243583761084,0.0,0.0
6429,0,6429,[435 181  22 588 143],378,5,23372,3.6348367029548987,0.0,0.0
6430,0,6430,[228   4 655 294 204],881,2,23374,3.6345824910589335,0.0,0.0
6431,0,6431,[202  56 186 182 216],234,0,23374,3.6340174129353233,0.0,0.0
6432,0,6432,[302 603 427  50  64],537,4,23378,3.634074304368102,20.0,20.0
6433,0,6433,[183 168 181 228 328],92,4,23382,3.6341311781162573,0.0,0.0
6434,0,6434,[302 603 427  50  64],537,4,23386,3.634188034188034,20.0,20.0
6435,0,6435,[237 323  98 273 603],548,5,23391,3.634400248601616,20.0,20.0
6436,0,6436,[ 98  56   1 282  50],271,2,23393,3.6341463414634148,0.0,40.0
6437,0,6437,[302 603 427  50  64],669,5,23398,3.634358496427462,20.0,20.0
6438,0,6438,[144  28 176 271 185],379,4,23402,3.6344152818760675,0.0,0.0
6439,0,6439,[405 182 471 135 195],95,2,23404,3.63416149068323,0.0,0.0
6440,0,6440,[ 97  70 302 300 202],537,2,23406,3.6339077782952955,0.0,0.0
6441,0,6441,[302 603 427  50  64],474,5,23411,3.6341198385594535,20.0,20.0
6442,0,6442,[215 322   7  79 211],474,5,23416,3.634331832997051,0.0,0.0
6443,0,6443,[ 79 121 183 515 508],833,2,23418,3.6340782122905027,0.0,0.0
6444,0,6444,[125 121  25 173  15],271,1,23419,3.63366951124903,0.0,0.0
6445,0,6445,[302 603 427  50  64],370,5,23424,3.63388147688489,20.0,20.0
6446,0,6446,[289 742 174 100 111],92,2,23426,3.633628044051497,0.0,40.0
6447,0,6447,[276 228   8  82 191],92,4,23430,3.6336848635235732,0.0,0.0
6448,0,6448,[234 180 183 100  22],313,4,23434,3.6337416653744765,0.0,20.0
6449,0,6449,[195 258 211 187 288],64,4,23438,3.633798449612403,0.0,0.0
6450,0,6450,[191 197 185 496 200],7,5,23443,3.6340102309719424,0.0,0.0
6451,0,6451,[144 186   4 183 435],833,2,23445,3.6337569745815252,0.0,0.0
6452,0,6452,[483  12   4 435 475],533,3,23448,3.6336587633658763,40.0,0.0
6453,0,6453,[302 603 427  50  64],537,4,23452,3.6337155252556554,20.0,20.0
6454,0,6454,[742 258   4 197 508],207,5,23457,3.633927188226181,0.0,0.0
6455,0,6455,[275 301 405 228  97],145,3,23460,3.633828996282528,0.0,0.0
6456,0,6456,[196 435 194   7  96],87,5,23465,3.6340405761189407,0.0,0.0
6457,0,6457,[257 200 275   1 508],6,2,23467,3.633787550325178,0.0,0.0
6458,0,6458,[237  95 276 173  12],334,4,23471,3.633844248335656,20.0,0.0
6459,0,6459,[234  28 172  64 286],59,4,23475,3.6339009287925697,0.0,0.0
6460,0,6460,[475 271 197 286 318],334,4,23479,3.6339575917040707,20.0,0.0
6461,0,6461,[302 603 427  50  64],537,4,23483,3.6340142370783037,20.0,20.0
6462,0,6462,[135 210 186 174 100],87,5,23488,3.634225591830419,0.0,40.0
6463,0,6463,[302 603 427  50  64],666,4,23492,3.6342821782178216,20.0,20.0
6464,0,6464,[385 191 168 603 405],533,4,23496,3.634338747099768,20.0,0.0
6465,0,6465,[515 265 187  56 182],91,4,23500,3.63439529848438,0.0,0.0
6466,0,6466,[302 603 427  50  64],458,4,23504,3.6344518323797743,20.0,20.0
6467,0,6467,[ 79 173 237 144 183],295,4,23508,3.6345083487940633,0.0,0.0
6468,0,6468,[302 603 427  50  64],669,5,23513,3.6347194311330964,20.0,20.0
6469,0,6469,[125 216  79 282 215],378,4,23517,3.634775888717156,0.0,0.0
6470,0,6470,[258  89 405 176 496],184,3,23520,3.6346777932313397,0.0,0.0
6471,0,6471,[235   9 215  11 265],343,4,23524,3.634734239802225,0.0,0.0
6472,0,6472,[176   4 313  79 475],13,2,23526,3.6344816931870847,0.0,0.0
6473,0,6473,[ 79 143 294 117   4],234,1,23527,3.6340747605807846,0.0,0.0
6474,0,6474,[302 603 427  50  64],458,4,23531,3.634131274131274,20.0,20.0
6475,0,6475,[302 603 427  50  64],664,5,23536,3.634342186534898,20.0,20.0
6476,0,6476,[302 603 427  50  64],339,5,23541,3.63455303381195,20.0,20.0
6477,0,6477,[302 603 427  50  64],13,5,23546,3.6347638159925904,20.0,20.0
6478,0,6478,[  9 194 597  28  25],59,3,23549,3.6346658434943664,0.0,0.0
6479,0,6479,[196 318 118 515 125],7,3,23552,3.634567901234568,20.0,0.0
6480,0,6480,[302 603 427  50  64],454,5,23557,3.634778583551921,20.0,20.0
6481,0,6481,[100 234 187 204 216],315,4,23561,3.634834927491515,0.0,20.0
6482,0,6482,[302 603 427  50  64],271,5,23566,3.6350455036248652,20.0,20.0
6483,0,6483,[125 568 257 268 121],119,5,23571,3.6352560148056754,0.0,0.0
6484,0,6484,[328 508  82 204 143],85,2,23573,3.635003855050116,0.0,0.0
6485,0,6485,[302 603 427  50  64],669,5,23578,3.635214307739747,20.0,20.0
6486,0,6486,[471  15 508 269 174],207,4,23582,3.635270541082164,0.0,20.0
6487,0,6487,[302 603 427  50  64],13,5,23587,3.6354808877928484,20.0,20.0
6488,0,6488,[302 603 427  50  64],664,5,23592,3.635691169671752,20.0,20.0
6489,0,6489,[302 603 427  50  64],474,5,23597,3.6359013867488446,20.0,20.0
6490,0,6490,[ 12 194 471  98 271],328,2,23599,3.635649360653212,20.0,20.0
6491,0,6491,[  1 588 228 318 210],664,4,23603,3.635705483672212,20.0,0.0
6492,0,6492,[ 69 405 546  96 588],295,4,23607,3.6357615894039736,0.0,0.0
6493,0,6493,[ 88 143   9 515  70],308,4,23611,3.635817677856483,0.0,0.0
6494,0,6494,[ 56 168  70 508 435],537,4,23615,3.6358737490377213,0.0,0.0
6495,0,6495,[748 300 216 204  22],533,4,23619,3.635929802955665,0.0,0.0
6496,0,6496,[175 423 111 258 183],653,0,23619,3.6353701708480837,0.0,0.0
6497,0,6497,[282 181   9  15 258],533,5,23624,3.6355801785164665,0.0,0.0
6498,0,6498,[313 187 235  96 275],328,4,23628,3.6356362517310354,0.0,0.0
6499,0,6499,[302 603 427  50  64],537,4,23632,3.635692307692308,20.0,20.0
6500,0,6500,[302 603 427  50  64],370,5,23637,3.635902168897093,20.0,20.0
6501,0,6501,[302 603 427  50  64],339,5,23642,3.6361119655490617,20.0,20.0
6502,0,6502,[ 89 273 215 508 197],59,4,23646,3.636167922497309,0.0,0.0
6503,0,6503,[423 181 174 588 196],263,4,23650,3.6362238622386225,0.0,20.0
6504,0,6504,[238   8 175 204 301],234,1,23651,3.635818601076095,0.0,0.0
6505,0,6505,[302 603 427  50  64],458,4,23655,3.6358745773132495,20.0,20.0
6506,0,6506,[  8 215  82 183 294],234,2,23657,3.6356231750422623,0.0,0.0
6507,0,6507,[118 318  22  28  97],653,3,23660,3.6355255070682237,20.0,0.0
6508,0,6508,[ 50 275 153  97 202],694,5,23665,3.6357351359655863,0.0,20.0
6509,0,6509,[302 603 427  50  64],664,5,23670,3.6359447004608296,20.0,20.0
6510,0,6510,[ 25 313   9  56 385],92,4,23674,3.6360006143449546,0.0,0.0
6511,0,6511,[742  69  12 204 182],833,2,23676,3.635749385749386,20.0,0.0
6512,0,6512,[302 603 427  50  64],745,4,23680,3.635805312452019,20.0,20.0
6513,0,6513,[118 182  22  15  79],653,2,23682,3.6355541909732882,0.0,0.0
6514,0,6514,[302 603 427  50  64],666,4,23686,3.6356101304681503,20.0,20.0
6515,0,6515,[265 204 423 403 195],543,4,23690,3.6356660527931246,0.0,0.0
6516,0,6516,[143 271 228 234 121],64,3,23693,3.6355685131195337,0.0,0.0
6517,0,6517,[271 483   4 143 265],334,1,23694,3.635164160785517,20.0,0.0
6518,0,6518,[568 143 427  22 288],537,1,23695,3.6347599325049855,0.0,0.0
6519,0,6519,[588 175 318 403  88],326,1,23696,3.634355828220859,20.0,0.0
6520,0,6520,[276  56 187 179 678],339,4,23700,3.634411900015335,0.0,0.0
6521,0,6521,[ 82 742 385  56  97],543,2,23702,3.634161300214658,0.0,0.0
6522,0,6522,[742 333 143 234 117],313,3,23705,3.6340640809443507,0.0,0.0
6523,0,6523,[405  11  12 742 289],374,4,23709,3.63412017167382,20.0,0.0
6524,0,6524,[179 117 176 172  98],650,4,23713,3.634176245210728,0.0,20.0
6525,0,6525,[302 603 427  50  64],13,5,23718,3.634385534783941,20.0,20.0
6526,0,6526,[302 603 427  50  64],474,5,23723,3.6345947602267503,20.0,20.0
6527,0,6527,[127 265 187 234 168],311,5,23728,3.6348039215686274,0.0,20.0
6528,0,6528,[302 603 427  50  64],474,5,23733,3.6350130188390257,20.0,20.0
6529,0,6529,[ 97 237 568 216  69],90,4,23737,3.6350689127105666,0.0,0.0
6530,0,6530,[111 117 196  64 508],378,3,23740,3.6349716735568824,0.0,0.0
6531,0,6531,[ 12 127 333   7 118],328,3,23743,3.6348744641763626,20.0,20.0
6532,0,6532,[111  12 176 180  98],533,3,23746,3.6347772845553346,20.0,20.0
6533,0,6533,[302 603 427  50  64],666,4,23750,3.6348331802877256,20.0,20.0
6534,0,6534,[210  95 144  70 294],479,4,23754,3.6348890589135423,0.0,0.0
6535,0,6535,[302 603 427  50  64],537,4,23758,3.6349449204406366,20.0,20.0
6536,0,6536,[195 151 235 588  95],897,3,23761,3.6348477895058897,0.0,0.0
6537,0,6537,[515  56 265 143  64],59,4,23765,3.6349036402569594,0.0,0.0
6538,0,6538,[275 153  69  11 197],406,3,23768,3.6348065453433245,0.0,0.0
6539,0,6539,[185 322  50 228 568],524,4,23772,3.634862385321101,0.0,20.0
6540,0,6540,[302 603 427  50  64],745,4,23776,3.634918208225042,20.0,20.0
6541,0,6541,[ 88 471  12 282 173],311,5,23781,3.63512687251605,20.0,0.0
6542,0,6542,[302 603 427  50  64],474,5,23786,3.6353354730246066,20.0,20.0
6543,0,6543,[268 211  69  70  64],13,4,23790,3.63539119804401,0.0,0.0
6544,0,6544,[ 28 135 385 238 301],85,3,23793,3.635294117647059,0.0,0.0
6545,0,6545,[302 603 427  50  64],13,5,23798,3.635502597005805,20.0,20.0
6546,0,6546,[200  96 275 118 117],455,4,23802,3.6355582709638004,0.0,0.0
6547,0,6547,[215 678   1   9 181],749,3,23805,3.6354612095296273,0.0,0.0
6548,0,6548,[302 603 427  50  64],370,5,23810,3.6356695678729576,20.0,20.0
6549,0,6549,[302 603 427  50  64],370,5,23815,3.63587786259542,20.0,20.0
6550,0,6550,[276  96 176 111 180],13,4,23819,3.6359334452755303,0.0,0.0
6551,0,6551,[196 111  98 546 508],378,3,23822,3.635836385836386,0.0,20.0
6552,0,6552,[302 603 427  50  64],454,5,23827,3.636044559743629,20.0,20.0
6553,0,6553,[183 151 265 222 273],666,1,23828,3.635642355813244,0.0,0.0
6554,0,6554,[132   1  12 313  79],59,4,23832,3.6356979405034324,20.0,0.0
6555,0,6555,[100 265 508 111 132],537,2,23834,3.635448444173276,0.0,20.0
6556,0,6556,[302 603 427  50  64],666,4,23838,3.635504041482385,20.0,20.0
6557,0,6557,[302 603 427  50  64],370,5,23843,3.6357121073498018,20.0,20.0
6558,0,6558,[302 603 427  50  64],474,5,23848,3.6359201097728313,20.0,20.0
6559,0,6559,[302 603 427  50  64],458,4,23852,3.6359756097560973,20.0,20.0
6560,0,6560,[302 603 427  64  50],271,5,23857,3.636183508611492,20.0,20.0
6561,0,6561,[257 568 546 496 742],533,4,23861,3.636238951539165,0.0,0.0
6562,0,6562,[168 588 294 216 269],537,1,23862,3.6358372695413683,0.0,0.0
6563,0,6563,[742 181  69 318 546],328,4,23866,3.6358927483241925,20.0,0.0
6564,0,6564,[302 603 427  64  50],666,4,23870,3.635948210205636,20.0,20.0
6565,0,6565,[121  70 286 238  15],82,3,23873,3.63585135546756,0.0,0.0
6566,0,6566,[302 603 427  64  50],339,5,23878,3.6360590832952644,20.0,20.0
6567,0,6567,[276 144 405 435 210],406,3,23881,3.6359622411693056,0.0,0.0
6568,0,6568,[655 100 423 215 200],788,3,23884,3.6358654285279344,0.0,20.0
6569,0,6569,[742 222 328 235 568],328,2,23886,3.6356164383561644,0.0,0.0
6570,0,6570,[215  56  96 423 183],13,5,23891,3.6358240754831836,0.0,0.0
6571,0,6571,[ 28 197 313 186 273],308,1,23892,3.63542300669507,0.0,0.0
6572,0,6572,[302 603 427  64  50],339,5,23897,3.635630610071505,20.0,20.0
6573,0,6573,[273  28   9   1 483],458,4,23901,3.635686035898996,20.0,0.0
6574,0,6574,[302 603 427  64  50],13,5,23906,3.635893536121673,20.0,20.0
6575,0,6575,[161  95 475 286 237],334,3,23909,3.6357968369829683,0.0,0.0
6576,0,6576,[144 153 215 127 168],343,5,23914,3.636004257260149,0.0,20.0
6577,0,6577,[302 603 427  64  50],537,4,23918,3.6360595925813315,20.0,20.0
6578,0,6578,[ 50 258 173 197 515],59,4,23922,3.6361149110807114,0.0,20.0
6579,0,6579,[302 603 427  64  50],745,4,23926,3.6361702127659576,20.0,20.0
6580,0,6580,[185 403 302 204 328],334,4,23930,3.636225497644735,0.0,0.0
6581,0,6581,[111 238 176 211 258],64,4,23934,3.636280765724704,0.0,0.0
6582,0,6582,[183 186 117 515 237],543,3,23937,3.636184110587878,0.0,0.0
6583,0,6583,[210  88  64  71  28],892,4,23941,3.636239368165249,0.0,0.0
6584,0,6584,[ 22 357  28 186 195],533,3,23944,3.6361427486712223,20.0,0.0
6585,0,6585,[ 97 597 323 228 118],788,0,23944,3.6355906468266017,0.0,0.0
6586,0,6586,[172 655 234  71   1],398,5,23949,3.63579778351298,0.0,0.0
6587,0,6587,[175 588  79 187 210],102,2,23951,3.6355494839101397,0.0,0.0
6588,0,6588,[187 127 483 216  22],804,4,23955,3.6356047958719078,20.0,20.0
6589,0,6589,[300  12 234 135 271],788,2,23957,3.6353566009104705,20.0,0.0
6590,0,6590,[302 603 427  64  50],664,5,23962,3.635563647397967,20.0,20.0
6591,0,6591,[302 603 427  64  50],474,5,23967,3.635770631067961,20.0,20.0
6592,0,6592,[179 216 153 237 222],234,0,23967,3.635219171848931,0.0,0.0
6593,0,6593,[187 144 546  89 405],194,2,23969,3.6349711859266,0.0,0.0
6594,0,6594,[302 603 427  64  50],537,4,23973,3.63502653525398,20.0,20.0
6595,0,6595,[302 603 427  50  64],537,4,23977,3.635081867798666,20.0,20.0
6596,0,6596,[515 172 742  50 173],899,3,23980,3.634985599514931,0.0,20.0
6597,0,6597,[385 222  71 121 258],788,2,23982,3.634737799333131,0.0,0.0
6598,0,6598,[603   4 288 172 100],804,4,23986,3.634793150477345,20.0,20.0
6599,0,6599,[143 173 172 195 546],378,3,23989,3.6346969696969698,0.0,0.0
6600,0,6600,[302 603 427  50  64],454,5,23994,3.6349038024541738,20.0,20.0
6601,0,6601,[ 50 318 655 210 211],318,4,23998,3.63495910330203,20.0,20.0
6602,0,6602,[ 95  79 180 276 289],234,1,23999,3.63456004846282,0.0,0.0
6603,0,6603,[175 268 197 186 228],387,2,24001,3.6343125378558447,0.0,0.0
6604,0,6604,[302 603 427  50  64],537,4,24005,3.6343679031037093,20.0,20.0
6605,0,6605,[185 234 151 187 271],788,2,24007,3.6341204965183165,0.0,0.0
6606,0,6606,[ 89 435   4   7 168],234,1,24008,3.6337218102013016,0.0,0.0
6607,0,6607,[ 89  69 273 121 238],308,2,24010,3.6334745762711864,0.0,0.0
6608,0,6608,[302 603 427  50  64],666,4,24014,3.633530034801029,20.0,20.0
6609,0,6609,[176 143 204 403 175],650,4,24018,3.6335854765506808,0.0,0.0
6610,0,6610,[515 179 151 234  88],200,4,24022,3.6336409015277567,0.0,0.0
6611,0,6611,[302 603 427  50  64],13,5,24027,3.6338475499092557,20.0,20.0
6612,0,6612,[302 603 427  50  64],669,5,24032,3.634054135793135,20.0,20.0
6613,0,6613,[302 603 427  50  64],664,5,24037,3.634260659207741,20.0,20.0
6614,0,6614,[302 603 427  50  64],271,5,24042,3.634467120181406,20.0,20.0
6615,0,6615,[515 385 275 183 127],95,4,24046,3.634522370012092,0.0,20.0
6616,0,6616,[143 515 237 111  98],524,2,24048,3.6342753513676893,0.0,20.0
6617,0,6617,[403 135  95 176 385],843,2,24050,3.634028407373829,0.0,0.0
6618,0,6618,[588 357 748 183 435],804,4,24054,3.634083698443874,20.0,0.0
6619,0,6619,[ 70 268 186 271 405],13,2,24056,3.6338368580060423,0.0,0.0
6620,0,6620,[121 258 597 300 475],486,3,24059,3.6337411267180184,0.0,0.0
6621,0,6621,[153 471 176 235 202],648,5,24064,3.6339474479009364,0.0,0.0
6622,0,6622,[302 603 427  50  64],370,5,24069,3.634153706779405,20.0,20.0
6623,0,6623,[302 603 427  50  64],370,5,24074,3.6343599033816427,20.0,20.0
6624,0,6624,[302 603 427  50  64],370,5,24079,3.634566037735849,20.0,20.0
6625,0,6625,[435 197 117 173 286],537,2,24081,3.63431934802294,0.0,0.0
6626,0,6626,[151 515 210  11  56],59,5,24086,3.634525426286404,0.0,0.0
6627,0,6627,[173 288   1 496  71],897,4,24090,3.634580567290284,0.0,0.0
6628,0,6628,[483 427 197 161 546],374,3,24093,3.6344848393422837,20.0,0.0
6629,0,6629,[302 603 427  50  64],537,4,24097,3.6345399698340874,20.0,20.0
6630,0,6630,[302 603 427  50  64],458,4,24101,3.634595083697783,20.0,20.0
6631,0,6631,[174  79  50 216 144],64,4,24105,3.6346501809408926,0.0,40.0
6632,0,6632,[153  70 302 211 187],328,4,24109,3.634705261570933,0.0,0.0
6633,0,6633,[196  22 748  96 496],346,4,24113,3.6347603255954177,0.0,0.0
6634,0,6634,[202 182 179  56 210],7,4,24117,3.634815373021854,0.0,0.0
6635,0,6635,[275  95 202 546  88],648,4,24121,3.6348704038577457,0.0,0.0
6636,0,6636,[302 603 427  50  64],339,5,24126,3.6350760885942446,20.0,20.0
6637,0,6637,[211 174 546 471 357],298,4,24130,3.6351310635733656,20.0,20.0
6638,0,6638,[302 603 427  50  64],745,4,24134,3.635186021991264,20.0,20.0
6639,0,6639,[588 197  79 196  88],308,3,24137,3.635090361445783,0.0,0.0
6640,0,6640,[ 97 286  95 568 183],13,3,24140,3.634994729709381,0.0,0.0
6641,0,6641,[288 175 597 228  25],13,2,24142,3.634748569707919,0.0,0.0
6642,0,6642,[302 603 427  50  64],339,5,24147,3.6349540870088815,20.0,20.0
6643,0,6643,[135  56 496 385  22],533,3,24150,3.6348585189644793,0.0,0.0
6644,0,6644,[603  12 111 328  50],533,5,24155,3.635063957863055,40.0,20.0
6645,0,6645,[ 79 289 471 168 161],524,4,24159,3.6351188684923263,0.0,0.0
6646,0,6646,[111 546 183  98 127],207,2,24161,3.6348728749811947,0.0,40.0
6647,0,6647,[ 95 423  97 471 181],83,4,24165,3.634927797833935,0.0,0.0
6648,0,6648,[302 603 427  50  64],745,4,24169,3.63498270416604,20.0,20.0
6649,0,6649,[302 603 427  64  50],664,5,24174,3.635187969924812,20.0,20.0
6650,0,6650,[161   9  28 282  95],271,3,24177,3.6350924672981506,0.0,0.0
6651,0,6651,[302 603 427  64  50],370,5,24182,3.6352976548406493,20.0,20.0
6652,0,6652,[ 50 111 143 222 546],378,2,24184,3.635051856305426,0.0,20.0
6653,0,6653,[302 603 427  64  50],474,5,24189,3.6352569882777277,20.0,20.0
6654,0,6654,[302 603 427  64  50],13,5,24194,3.6354620586025543,20.0,20.0
6655,0,6655,[302 603 427  64  50],664,5,24199,3.6356670673076925,20.0,20.0
6656,0,6656,[173 748 118 357 132],13,3,24202,3.635571578789244,20.0,0.0
6657,0,6657,[302 603 427  64  50],370,5,24207,3.635776509462301,20.0,20.0
6658,0,6658,[471 121 127  28 496],194,3,24210,3.6356810331881664,0.0,20.0
6659,0,6659,[195 179  50 597 235],643,4,24214,3.635735735735736,0.0,20.0
6660,0,6660,[302 603 427  64  50],271,5,24219,3.635940549467047,20.0,20.0
6661,0,6661,[302 603 427  64  50],669,5,24224,3.6361453017111978,20.0,20.0
6662,0,6662,[302 603 427  64  50],458,4,24228,3.6361999099504727,20.0,20.0
6663,0,6663,[185 191  82 197 427],59,5,24233,3.63640456182473,0.0,0.0
6664,0,6664,[546  71 187 515 185],194,4,24237,3.636459114778695,0.0,0.0
6665,0,6665,[168 182  97 423 237],271,3,24240,3.6363636363636362,0.0,0.0
6666,0,6666,[328 258 234 182 175],85,4,24244,3.6364181790910455,0.0,0.0
6667,0,6667,[176 216 515 568 210],64,4,24248,3.636472705458908,0.0,0.0
6668,0,6668,[302 603 427  64  50],666,4,24252,3.636527215474584,20.0,20.0
6669,0,6669,[302 603 427  64  50],271,5,24257,3.6367316341829086,20.0,20.0
6670,0,6670,[302 603 427  64  50],271,5,24262,3.6369359916054567,20.0,20.0
6671,0,6671,[211 269 475 176 234],339,5,24267,3.637140287769784,0.0,0.0
6672,0,6672,[132 211 183 181  98],843,1,24268,3.6367450921624456,0.0,20.0
6673,0,6673,[ 70 182  15  22  50],215,1,24269,3.636350014983518,0.0,20.0
6674,0,6674,[135 588 222  28 181],254,4,24273,3.6364044943820226,0.0,0.0
6675,0,6675,[215 228 210 405 121],882,5,24278,3.6366087477531455,0.0,0.0
6676,0,6676,[302 603 427  64  50],370,5,24283,3.636812939943088,20.0,20.0
6677,0,6677,[235  95 210  88 168],290,3,24286,3.6367175801138067,0.0,0.0
6678,0,6678,[423 197 176 180  70],60,5,24291,3.6369216948645007,0.0,0.0
6679,0,6679,[302 603 427  64  50],271,5,24296,3.637125748502994,20.0,20.0
6680,0,6680,[127 427 282 405  70],328,3,24299,3.6370303846729533,0.0,20.0
6681,0,6681,[127 197   1 174 515],59,4,24303,3.6370847051780903,0.0,40.0
6682,0,6682,[ 12  71  95   4 135],92,4,24307,3.637139009426904,20.0,0.0
6683,0,6683,[194 211 357 588 597],95,2,24309,3.6368940754039496,20.0,0.0
6684,0,6684,[302 603 427  64  50],669,5,24314,3.6370979805534778,20.0,20.0
6685,0,6685,[ 28  12 179 197 265],13,4,24318,3.6371522584504934,20.0,0.0
6686,0,6686,[ 28 176 742 515 238],95,4,24322,3.6372065201136534,0.0,0.0
6687,0,6687,[302 603 427  64  50],664,5,24327,3.6374102870813396,20.0,20.0
6688,0,6688,[515 200  11 204  71],13,2,24329,3.637165495589774,0.0,0.0
6689,0,6689,[302 603 427  64  50],454,5,24334,3.637369207772795,20.0,20.0
6690,0,6690,[288  28 204  96 173],455,4,24338,3.6374234045733074,0.0,0.0
6691,0,6691,[302 603 427  64  50],664,5,24343,3.6376270173341303,20.0,20.0
6692,0,6692,[302 603 427  64  50],458,4,24347,3.63768115942029,20.0,20.0
6693,0,6693,[496  11  79 423 276],334,4,24351,3.6377352853301463,0.0,0.0
6694,0,6694,[655 204 238 313 127],59,5,24356,3.6379387602688573,0.0,20.0
6695,0,6695,[302 603 427  64  50],454,5,24361,3.638142174432497,20.0,20.0
6696,0,6696,[100 234 172 385 301],537,1,24362,3.6377482454830523,0.0,20.0
6697,0,6697,[ 11   7 237 276 603],308,4,24366,3.6378023290534487,20.0,0.0
6698,0,6698,[202 153 289  95 191],387,2,24368,3.6375578444543963,0.0,0.0
6699,0,6699,[ 70 180 151 187 185],234,1,24369,3.6371641791044778,0.0,0.0
6700,0,6700,[302 603 427  64  50],745,4,24373,3.6372183256230413,20.0,20.0
6701,0,6701,[302 603 427  64  50],458,4,24377,3.6372724559832887,20.0,20.0
6702,0,6702,[  7  69 357 100 186],833,2,24379,3.6370281963300015,20.0,20.0
6703,0,6703,[ 12  79  15  96 257],378,5,24384,3.6372315035799523,20.0,0.0
6704,0,6704,[302 603 427  64  50],458,4,24388,3.6372856077554063,20.0,20.0
6705,0,6705,[302 603 427  64  50],370,5,24393,3.6374888159856846,20.0,20.0
6706,0,6706,[183 196 323 423 181],474,4,24397,3.6375428656627404,0.0,0.0
6707,0,6707,[100 168 403 179 151],653,2,24399,3.637298747763864,0.0,20.0
6708,0,6708,[302 603 427  64  50],666,4,24403,3.6373528096586676,20.0,20.0
6709,0,6709,[302 603 427  64  50],745,4,24407,3.637406855439642,20.0,20.0
6710,0,6710,[168 182 111  98   1],6,4,24411,3.637460885113992,0.0,20.0
6711,0,6711,[302 603 427  64 191],458,5,24416,3.637663885578069,20.0,0.0
6712,0,6712,[302 603 427  64 191],271,5,24421,3.637866825562342,20.0,0.0
6713,0,6713,[302 603 427  64 191],474,5,24426,3.6380697050938338,20.0,0.0
6714,0,6714,[265 186 333 211 143],537,2,24428,3.637825763216679,0.0,0.0
6715,0,6715,[302 603 427  64 191],271,5,24433,3.6380285884455033,20.0,0.0
6716,0,6716,[ 89 127 185 200  15],479,4,24437,3.638082477296412,0.0,20.0
6717,0,6717,[276 302  69 174 471],605,3,24440,3.6379874962786545,0.0,20.0
6718,0,6718,[302 603 427  64 191],537,4,24444,3.6380413752046437,20.0,0.0
6719,0,6719,[161  95 196 328 222],234,0,24444,3.6375,0.0,0.0
6720,0,6720,[403 515 183 237 301],328,3,24447,3.6374051480434457,0.0,0.0
6721,0,6721,[172  56 313  22  25],271,3,24450,3.6373103243082414,0.0,0.0
6722,0,6722,[302 603 427  64 191],537,4,24454,3.6373642719024244,20.0,0.0
6723,0,6723,[ 12 185  88 143 127],406,3,24457,3.637269482450922,20.0,20.0
6724,0,6724,[427 161 117 174 294],194,4,24461,3.6373234200743494,0.0,20.0
6725,0,6725,[322 471 172 265 118],313,4,24465,3.6373773416592328,0.0,0.0
6726,0,6726,[191 273 568 180 135],524,3,24468,3.6372825925375354,0.0,0.0
6727,0,6727,[174 151  71 597 568],95,4,24472,3.6373365041617123,0.0,20.0
6728,0,6728,[302 603 427  64 191],90,5,24477,3.637539010254124,20.0,0.0
6729,0,6729,[238  56 179 191 234],738,4,24481,3.637592867756315,0.0,0.0
6730,0,6730,[211 276 483 200  50],409,4,24485,3.637646709255683,20.0,20.0
6731,0,6731,[302 603 427  64 191],537,4,24489,3.6377005347593583,20.0,0.0
6732,0,6732,[185 121  11 187 211],7,4,24493,3.637754344274469,0.0,0.0
6733,0,6733,[405  64 275 508  12],474,3,24496,3.6376596376596377,20.0,0.0
6734,0,6734,[238 385 234 185 179],774,2,24498,3.6374164810690424,0.0,0.0
6735,0,6735,[111 185   8 121 216],271,3,24501,3.6373218527315916,0.0,0.0
6736,0,6736,[174 172 546  95   7],881,5,24506,3.637524120528425,0.0,20.0
6737,0,6737,[200  97 603 568 100],738,2,24508,3.637281092312259,20.0,20.0
6738,0,6738,[238 210  89 144  69],77,2,24510,3.6370381362219915,0.0,0.0
6739,0,6739,[132  89 118 196 179],749,4,24514,3.637091988130564,0.0,0.0
6740,0,6740,[302 603 427 191  64],669,4,24518,3.637145824061712,20.0,0.0
6741,0,6741,[302 603 427  64 191],458,5,24523,3.637347967962029,20.0,0.0
6742,0,6742,[748 174 127 286 238],524,4,24527,3.6374017499629243,0.0,40.0
6743,0,6743,[ 28 151  64 238  89],59,5,24532,3.6376037959667853,0.0,0.0
6744,0,6744,[302 603 427  64 191],666,5,24537,3.6378057820607856,20.0,0.0
6745,0,6745,[228  98 678 187 173],664,4,24541,3.6378594722798696,0.0,20.0
6746,0,6746,[ 64 333 117 215 508],343,3,24544,3.6377649325626202,0.0,0.0
6747,0,6747,[302 603 427  64 191],339,5,24549,3.637966804979253,20.0,0.0
6748,0,6748,[  4  89  97 111 125],378,2,24551,3.637724107275152,0.0,0.0
6749,0,6749,[117 179 496 215 168],524,1,24552,3.6373333333333333,0.0,0.0
6750,0,6750,[302 603 427  64 191],458,5,24557,3.6375351799733373,20.0,0.0
6751,0,6751,[302 603 427  64 191],13,4,24561,3.637588862559242,20.0,0.0
6752,0,6752,[302 603 427  64  50],458,4,24565,3.637642529246261,20.0,20.0
6753,0,6753,[302 603 427  64  50],745,4,24569,3.637696180041457,20.0,20.0
6754,0,6754,[496 475 405  15 265],533,2,24571,3.6374537379718728,0.0,0.0
6755,0,6755,[302 603 427  64  50],537,4,24575,3.637507400828893,20.0,20.0
6756,0,6756,[180 313 222 168  22],380,3,24578,3.6374130531300874,0.0,0.0
6757,0,6757,[302 603 427  64  50],458,4,24582,3.6374667061260726,20.0,20.0
6758,0,6758,[180 742 215  96  98],313,4,24586,3.637520343246042,0.0,20.0
6759,0,6759,[302 603 427  64  50],664,5,24591,3.637721893491124,20.0,20.0
6760,0,6760,[ 64 257 318 742  69],899,4,24595,3.6377754770004436,20.0,0.0
6761,0,6761,[185 423 282 265 357],271,3,24598,3.63768115942029,20.0,0.0
6762,0,6762,[  1  56 216 235 288],374,4,24602,3.6377347331066097,0.0,0.0
6763,0,6763,[175 135 403 173 238],59,5,24607,3.6379361324659962,0.0,0.0
6764,0,6764,[135  28  89 742 294],374,3,24610,3.637841832963784,0.0,0.0
6765,0,6765,[423 191 269 185 175],524,4,24614,3.6378953591486844,0.0,0.0
6766,0,6766,[302 603 427  64 191],90,5,24619,3.638096645485444,20.0,0.0
6767,0,6767,[196 143 211 265  71],194,3,24622,3.638002364066194,0.0,0.0
6768,0,6768,[568 185 323 180 216],328,2,24624,3.637760378194711,0.0,0.0
6769,0,6769,[238 179 187 678 210],13,1,24625,3.637370753323486,0.0,0.0
6770,0,6770,[276 168 211 127 271],13,4,24629,3.637424309555457,0.0,20.0
6771,0,6771,[ 22 385 143 313  88],92,2,24631,3.637182516243355,0.0,0.0
6772,0,6772,[135 186 176 216 748],749,4,24635,3.637236084452975,0.0,0.0
6773,0,6773,[588   9  11  79 127],406,4,24639,3.637289636846767,0.0,20.0
6774,0,6774,[235 127 173 288  88],897,3,24642,3.6371955719557194,0.0,20.0
6775,0,6775,[175 168 179  56 216],60,5,24647,3.637396694214876,0.0,0.0
6776,0,6776,[302 603 427  64 191],339,5,24652,3.6375977571196696,20.0,0.0
6777,0,6777,[302 603 427  64 191],664,4,24656,3.6376512245500146,20.0,0.0
6778,0,6778,[216 238 265 191 222],82,3,24659,3.6375571618232776,0.0,0.0
6779,0,6779,[ 12  88 132 423   7],343,5,24664,3.6377581120943954,20.0,0.0
6780,0,6780,[302 603 427  64  50],537,4,24668,3.6378115322223863,20.0,20.0
6781,0,6781,[302 603 427  64  50],669,5,24673,3.6380123857269244,20.0,20.0
6782,0,6782,[302 603 427  64  50],271,5,24678,3.6382131800088455,20.0,20.0
6783,0,6783,[302 603 427  64  50],339,5,24683,3.6384139150943398,20.0,20.0
6784,0,6784,[302 603 427  64  50],271,5,24688,3.63861459100958,20.0,20.0
6785,0,6785,[302 603 427  64  50],666,4,24692,3.6386678455643975,20.0,20.0
6786,0,6786,[172 117 275 185 196],308,3,24695,3.6385737439222043,0.0,0.0
6787,0,6787,[302 603 427  64  50],454,5,24700,3.63877430760165,20.0,20.0
6788,0,6788,[302 603 427  64  50],669,5,24705,3.6389748121962,20.0,20.0
6789,0,6789,[302 603 427  64  50],666,4,24709,3.6390279823269513,20.0,20.0
6790,0,6790,[258  22 300  56 265],313,2,24711,3.6387866293623916,0.0,0.0
6791,0,6791,[238 300 423 179 196],843,1,24712,3.6383981154299176,0.0,0.0
6792,0,6792,[302 603 427  64  50],458,4,24716,3.638451346974827,20.0,20.0
6793,0,6793,[302 603 427  64  50],271,5,24721,3.6386517515454813,20.0,20.0
6794,0,6794,[ 95 655  12 172  28],42,4,24725,3.6387049300956584,20.0,0.0
6795,0,6795,[269 423 172  98 132],85,4,24729,3.63875809299588,0.0,20.0
6796,0,6796,[301 268 333  15 228],145,3,24732,3.638664116521995,0.0,0.0
6797,0,6797,[153 173 144 471  98],234,1,24733,3.638275963518682,0.0,20.0
6798,0,6798,[ 96 111 286 196 202],207,1,24734,3.637887924694808,0.0,0.0
6799,0,6799,[302 603 427  64  50],474,5,24739,3.6380882352941177,20.0,20.0
6800,0,6800,[302 603 427  64  50],537,4,24743,3.638141449786796,20.0,20.0
6801,0,6801,[302 603 427  64  50],537,4,24747,3.638194648632755,20.0,20.0
6802,0,6802,[302 603 427  64  50],669,5,24752,3.6383948258121417,20.0,20.0
6803,0,6803,[216 176 286 175   7],234,0,24752,3.6378600823045266,0.0,0.0
6804,0,6804,[ 56 210 127 483 196],85,4,24756,3.63791329904482,20.0,20.0
6805,0,6805,[181 271 144 121 168],102,0,24756,3.6373787834263887,0.0,0.0
6806,0,6806,[143 121 435 333 211],533,5,24761,3.6375789628323782,0.0,0.0
6807,0,6807,[197 294 191 211  28],648,3,24764,3.637485311398355,0.0,0.0
6808,0,6808,[405 275   8 117  64],474,4,24768,3.637538551916581,0.0,0.0
6809,0,6809,[265  12 385  70  15],234,0,24768,3.6370044052863437,20.0,0.0
6810,0,6810,[515  96 265 185 238],881,3,24771,3.6369108794596974,0.0,0.0
6811,0,6811,[515 215 127 181 204],643,2,24773,3.6366705813270697,0.0,20.0
6812,0,6812,[302 603 427  64  50],271,5,24778,3.636870688389843,20.0,20.0
6813,0,6813,[302 603 427  64  50],13,5,24783,3.637070736718521,20.0,20.0
6814,0,6814,[237 210 100 143 748],13,3,24786,3.6369772560528246,0.0,20.0
6815,0,6815,[179 427 423  15 202],234,2,24788,3.636737089201878,0.0,0.0
6816,0,6816,[ 79  95 174 215 195],479,4,24792,3.63679037699868,0.0,20.0
6817,0,6817,[143 215 300   8 211],7,4,24796,3.6368436491639775,0.0,0.0
6818,0,6818,[ 22 276 132 405 173],537,2,24798,3.636603607567092,0.0,0.0
6819,0,6819,[204 179 294 172 568],378,3,24801,3.636510263929619,0.0,0.0
6820,0,6820,[302 603 427  64  50],666,4,24805,3.6365635537311243,20.0,20.0
6821,0,6821,[216 204 118  50 435],59,5,24810,3.6367634124890063,0.0,20.0
6822,0,6822,[144   1 515 118 174],275,3,24813,3.6366700864722263,0.0,20.0
6823,0,6823,[302 603 427  64  50],745,4,24817,3.636723329425557,20.0,20.0
6824,0,6824,[ 88 318 257 258 121],343,3,24820,3.6366300366300366,20.0,0.0
6825,0,6825,[153 151 185 216 182],815,2,24822,3.6363902724875476,0.0,0.0
6826,0,6826,[568 496  88  64 117],308,3,24825,3.636297055807822,0.0,0.0
6827,0,6827,[302 603 427  64 191],13,4,24829,3.636350322202695,20.0,0.0
6828,0,6828,[302 603 427  64  50],370,5,24834,3.6365500073217163,20.0,20.0
6829,0,6829,[302 603 427  64  50],474,5,24839,3.6367496339677894,20.0,20.0
6830,0,6830,[515  56 228  69 435],883,4,24843,3.6368028107158543,0.0,0.0
6831,0,6831,[176 265  22 151 175],346,5,24848,3.6370023419203745,0.0,0.0
6832,0,6832,[191  22  98 144 151],7,5,24853,3.6372018147226695,0.0,20.0
6833,0,6833,[302 603 427  64  50],669,5,24858,3.637401229148376,20.0,20.0
6834,0,6834,[ 11 333 289   1 423],387,1,24859,3.637015362106803,0.0,0.0
6835,0,6835,[302 603 427  64  50],339,5,24864,3.6372147454651844,20.0,20.0
6836,0,6836,[302 603 427  64  50],664,5,24869,3.6374140704987568,20.0,20.0
6837,0,6837,[302 603 427  64  50],271,5,24874,3.637613337233109,20.0,20.0
6838,0,6838,[ 79 185  95 405 179],13,1,24875,3.637227664863284,0.0,0.0
6839,0,6839,[191 216 211 179 603],308,4,24879,3.637280701754386,20.0,0.0
6840,0,6840,[302 603 427  64  50],745,4,24883,3.637333723139892,20.0,20.0
6841,0,6841,[302 603 427  64  50],458,4,24887,3.6373867290266,20.0,20.0
6842,0,6842,[515 405 175   8  69],334,3,24890,3.6372935846850796,0.0,0.0
6843,0,6843,[318 143  25 215 187],90,4,24894,3.6373465809468146,20.0,0.0
6844,0,6844,[  1  28 405 238 234],189,4,24898,3.637399561723886,0.0,0.0
6845,0,6845,[ 15 323 271 322 173],537,1,24899,3.6370143149284253,0.0,0.0
6846,0,6846,[302 603 427  64  50],669,5,24904,3.637213378121805,20.0,20.0
6847,0,6847,[237 423 655 268 181],334,5,24909,3.63741238317757,0.0,0.0
6848,0,6848,[302 603 427  64  50],13,5,24914,3.6376113301211856,20.0,20.0
6849,0,6849,[294   4 289 194 182],788,2,24916,3.637372262773723,0.0,0.0
6850,0,6850,[265  82 748 258  88],102,1,24917,3.6369873011239235,0.0,0.0
6851,0,6851,[174 294 195 132 186],533,4,24921,3.6370402802101576,0.0,20.0
6852,0,6852,[216  89 175 100 196],346,2,24923,3.6368014008463447,0.0,20.0
6853,0,6853,[318  71  50 215 257],474,4,24927,3.6368543915961484,20.0,20.0
6854,0,6854,[235  88   7 181 403],774,0,24927,3.636323851203501,0.0,0.0
6855,0,6855,[302 603 427  64  50],271,5,24932,3.6365227537922986,20.0,20.0
6856,0,6856,[302 603 427  64  50],339,5,24937,3.636721598366633,20.0,20.0
6857,0,6857,[302 603 427  64  50],271,5,24942,3.636920384951881,20.0,20.0
6858,0,6858,[483 405  50 182  11],328,3,24945,3.6368275258784077,20.0,20.0
6859,0,6859,[180 597 222 168 568],899,3,24948,3.636734693877551,0.0,0.0
6860,0,6860,[655  28 328 186 194],788,3,24951,3.6366418889374725,0.0,0.0
6861,0,6861,[302 603 427  64  50],537,4,24955,3.6366948411541826,20.0,20.0
6862,0,6862,[302 603 427  64  50],745,4,24959,3.6367477779396764,20.0,20.0
6863,0,6863,[302 603 427  64  50],664,5,24964,3.636946386946387,20.0,20.0
6864,0,6864,[302 603 427  64  50],666,4,24968,3.6369992716678805,20.0,20.0
6865,0,6865,[302 603 427  64  50],271,5,24973,3.6371977861928344,20.0,20.0
6866,0,6866,[ 70 216   4 435  50],474,5,24978,3.63739624290083,0.0,20.0
6867,0,6867,[ 28 300 179 515  79],380,3,24981,3.6373034362259755,0.0,0.0
6868,0,6868,[ 28  11 597 289  69],92,2,24983,3.6370650749745232,0.0,0.0
6869,0,6869,[302 603 427  64  50],745,4,24987,3.637117903930131,20.0,20.0
6870,0,6870,[228 273   1 405 161],64,2,24989,3.6368796390627276,0.0,0.0
6871,0,6871,[185 568  50 202 200],308,5,24994,3.637077997671711,0.0,20.0
6872,0,6872,[302 603 427  64  50],339,5,24999,3.637276298559581,20.0,20.0
6873,0,6873,[195 185 196 603 127],749,5,25004,3.6374745417515273,20.0,20.0
6874,0,6874,[117   9 100  11 161],234,1,25005,3.637090909090909,0.0,20.0
6875,0,6875,[111  12 135 132  70],64,5,25010,3.6372891215823153,20.0,0.0
6876,0,6876,[385  12  97 143  89],454,2,25012,3.6370510396975426,20.0,0.0
6877,0,6877,[151 175 405 144 210],932,3,25015,3.6369584181448094,0.0,0.0
6878,0,6878,[302 603 427  64  50],745,4,25019,3.6370111934874254,20.0,20.0
6879,0,6879,[151 127 301 271 435],537,1,25020,3.636627906976744,0.0,20.0
6880,0,6880,[282 475 257  82 181],533,4,25024,3.636680715012353,0.0,0.0
6881,0,6881,[302 603 427  64  50],370,5,25029,3.636878814298169,20.0,20.0
6882,0,6882,[302 603 427  64  50],370,5,25034,3.6370768560220834,20.0,20.0
6883,0,6883,[ 96 385 597 204  25],378,4,25038,3.637129575828007,0.0,0.0
6884,0,6884,[289 286 385 175 318],524,3,25041,3.637037037037037,20.0,0.0
6885,0,6885,[302 603 427  64  50],458,4,25045,3.6370897473133894,20.0,20.0
6886,0,6886,[176 127 132 286 258],666,5,25050,3.63728764338609,0.0,20.0
6887,0,6887,[176 195 435 508 132],406,5,25055,3.637485481997677,0.0,0.0
6888,0,6888,[515 191 289 678 286],537,2,25057,3.637247786326027,0.0,0.0
6889,0,6889,[302 603 427  64 191],454,5,25062,3.63744557329463,20.0,0.0
6890,0,6890,[385 237  71 121 228],749,2,25064,3.6372079524016834,0.0,0.0
6891,0,6891,[196 186 187 143 172],234,1,25065,3.6368253047011025,0.0,0.0
6892,0,6892,[216 153 121 185  64],452,4,25069,3.6368779921659655,0.0,0.0
6893,0,6893,[ 95   1 121 195 496],42,5,25074,3.637075718015666,0.0,0.0
6894,0,6894,[258 235 269   8 276],13,3,25077,3.6369833212472806,0.0,0.0
6895,0,6895,[302 603 427  64 191],13,4,25081,3.63703596287703,20.0,0.0
6896,0,6896,[200 100 210  69 196],774,1,25082,3.6366536175148614,0.0,20.0
6897,0,6897,[302 603 427  64 313],271,5,25087,3.6368512612351407,20.0,0.0
6898,0,6898,[515 195 286 117 268],6,2,25089,3.6366140020292796,0.0,0.0
6899,0,6899,[302 603 427  64 313],454,5,25094,3.6368115942028987,20.0,0.0
6900,0,6900,[275 333 215   8 118],298,4,25098,3.6368642225764383,0.0,0.0
6901,0,6901,[176 496 117 237 385],533,3,25101,3.6367719501593743,0.0,0.0
6902,0,6902,[202 655  97 742 403],95,4,25105,3.636824569027959,0.0,0.0
6903,0,6903,[ 89 678 603   1 132],454,1,25106,3.6364426419466978,20.0,0.0
6904,0,6904,[302 196 179 322 301],90,5,25111,3.6366401158580737,0.0,0.0
6905,0,6905,[222 385  64 289 273],387,2,25113,3.6364031277150306,0.0,0.0
6906,0,6906,[302 603 427  64 313],537,4,25117,3.6364557695091935,20.0,0.0
6907,0,6907,[276 168 300  69 318],239,2,25119,3.6362188766647368,20.0,0.0
6908,0,6908,[238  15 183  69  22],311,5,25124,3.636416268635114,0.0,0.0
6909,0,6909,[302 603 427  64 313],271,5,25129,3.636613603473227,20.0,0.0
6910,0,6910,[302 603 427  64 313],454,5,25134,3.636810881203878,20.0,0.0
6911,0,6911,[603 200 172 655 427],313,4,25138,3.636863425925926,20.0,0.0
6912,0,6912,[111   9   8 328 187],488,3,25141,3.6367713004484306,0.0,0.0
6913,0,6913,[294 245  69 258 179],200,4,25145,3.63682383569569,0.0,0.0
6914,0,6914,[161  82  95 182  79],64,3,25148,3.6367317425885757,0.0,0.0
6915,0,6915,[302 603 427  64 313],537,4,25152,3.6367842683632157,20.0,0.0
6916,0,6916,[357 153 328 173 435],804,4,25156,3.636836778950412,20.0,0.0
6917,0,6917,[282 515 204 196 210],85,3,25159,3.636744723908644,0.0,0.0
6918,0,6918,[ 89 748  88 328 322],13,3,25162,3.636652695476225,0.0,0.0
6919,0,6919,[508 568  97 322   8],533,3,25165,3.6365606936416186,0.0,0.0
6920,0,6920,[496 153 288 423 357],387,2,25167,3.636324230602514,20.0,0.0
6921,0,6921,[186  12  79 597 546],788,2,25169,3.6360878358855824,20.0,0.0
6922,0,6922,[483  98 496 271 318],536,4,25173,3.6361404015600174,40.0,20.0
6923,0,6923,[215  28 597 234  70],7,3,25176,3.636048526863085,0.0,0.0
6924,0,6924,[257 588 357 328  15],144,4,25180,3.636101083032491,20.0,0.0
6925,0,6925,[302 603 427  64 313],13,5,25185,3.636298007507941,20.0,0.0
6926,0,6926,[234 237 742   9 187],788,3,25188,3.636206149848419,0.0,0.0
6927,0,6927,[111 204  97  82 185],537,1,25189,3.635825635103926,0.0,0.0
6928,0,6928,[302 603 427  64 313],669,5,25194,3.6360225140712945,20.0,0.0
6929,0,6929,[151  22 271  98 121],650,1,25195,3.6356421356421356,0.0,20.0
6930,0,6930,[ 70 289 172 269 200],537,1,25196,3.6352618669744627,0.0,0.0
6931,0,6931,[216  50 117 405 483],749,4,25200,3.63531448355453,20.0,20.0
6932,0,6932,[ 11 508 200  82 403],543,4,25204,3.6353670849560076,0.0,0.0
6933,0,6933,[427 322 568 483 185],374,3,25207,3.635275454283242,20.0,0.0
6934,0,6934,[ 69 127 100  50   4],234,5,25212,3.635472242249459,0.0,60.0
6935,0,6935,[215  11 271 172 427],328,1,25213,3.635092272202999,0.0,0.0
6936,0,6936,[655  12 515 357 385],234,2,25215,3.634856566239008,40.0,0.0
6937,0,6937,[ 79  70 742 234 125],59,2,25217,3.6346209282213895,0.0,0.0
6938,0,6938,[597 333 121 748 603],13,3,25220,3.6345294711053464,20.0,0.0
6939,0,6939,[245 357 228 117 195],653,5,25225,3.634726224783862,20.0,0.0
6940,0,6940,[228  11 268 515 257],334,5,25230,3.6349229217691974,0.0,0.0
6941,0,6941,[748 275 135 228 357],533,2,25232,3.6346874099683086,20.0,0.0
6942,0,6942,[302 603 427  64 313],474,5,25237,3.634884055883624,20.0,0.0
6943,0,6943,[161 118 742 483 515],184,2,25239,3.634648617511521,20.0,0.0
6944,0,6944,[323 202 100 161   1],650,1,25240,3.6342692584593235,0.0,20.0
6945,0,6945,[302 603 427  64 313],474,5,25245,3.63446587964296,20.0,0.0
6946,0,6946,[181 197 222 435 588],881,2,25247,3.6342306031380454,0.0,0.0
6947,0,6947,[187 111 132  11 333],488,2,25249,3.6339953943580885,0.0,0.0
6948,0,6948,[302 603 427  64 313],474,5,25254,3.6341919700676355,20.0,0.0
6949,0,6949,[302 603 427  64 313],669,5,25259,3.634388489208633,20.0,0.0
6950,0,6950,[228 276 294 175 678],537,2,25261,3.634153359228888,0.0,0.0
6951,0,6951,[172  64 100 143  98],452,4,25265,3.634205983889528,0.0,40.0
6952,0,6952,[333  15 234   4 187],144,4,25269,3.6342585934129152,0.0,0.0
6953,0,6953,[194 196 603 176 151],42,4,25273,3.6343111878055794,20.0,0.0
6954,0,6954,[302 603 427  64 313],90,5,25278,3.63450754852624,20.0,0.0
6955,0,6955,[265 194 234 186 483],13,5,25283,3.634703852788959,20.0,0.0
6956,0,6956,[322 483 173 237 204],474,5,25288,3.6349001006180823,20.0,0.0
6957,0,6957,[174 294 172 179 568],374,2,25290,3.6346651336590976,0.0,20.0
6958,0,6958,[282 588 111  28 132],42,4,25294,3.634717631843656,0.0,0.0
6959,0,6959,[215 405 121 117 153],536,4,25298,3.634770114942529,0.0,0.0
6960,0,6960,[182 238 195 483  12],6,5,25303,3.6349662404826892,40.0,0.0
6961,0,6961,[125 182  12 200 275],378,3,25306,3.6348750359092215,20.0,0.0
6962,0,6962,[234  89  98 187  25],85,4,25310,3.6349274737900332,0.0,20.0
6963,0,6963,[175 202 289 318 313],883,4,25314,3.634979896611143,20.0,0.0
6964,0,6964,[302 603 427  64 313],537,4,25318,3.6350323043790382,20.0,0.0
6965,0,6965,[302 603 427  64 313],474,5,25323,3.6352282515073213,20.0,0.0
6966,0,6966,[ 96 125   1 234 742],648,4,25327,3.6352806085833214,0.0,0.0
6967,0,6967,[  1  50 294   9 286],676,4,25331,3.635332950631458,0.0,20.0
6968,0,6968,[197 496 172  96 515],643,5,25336,3.635528770268331,0.0,0.0
6969,0,6969,[179 333 318 175 216],537,3,25339,3.635437589670014,20.0,0.0
6970,0,6970,[ 69 186 180 273  97],13,4,25343,3.635489886673361,0.0,0.0
6971,0,6971,[302 603 427  64 313],271,5,25348,3.6356855995410213,20.0,0.0
6972,0,6972,[175 135 385 117 182],650,4,25352,3.6357378459773413,0.0,0.0
6973,0,6973,[180 195  22  56  25],13,3,25355,3.635646687697161,0.0,0.0
6974,0,6974,[403 168 323 435 546],804,2,25357,3.6354121863799285,0.0,0.0
6975,0,6975,[144 176  82 265   1],488,3,25360,3.635321100917431,0.0,0.0
6976,0,6976,[117 151 748 275 403],901,2,25362,3.6350867134871723,0.0,0.0
6977,0,6977,[323 135 403 168 496],59,5,25367,3.6352823158498135,0.0,0.0
6978,0,6978,[302 603 427  64 313],669,5,25372,3.6354778621579023,20.0,0.0
6979,0,6979,[181 168 100 333  28],263,3,25375,3.6353868194842405,0.0,20.0
6980,0,6980,[385 179 132 515 127],537,3,25378,3.6352958028935682,0.0,20.0
6981,0,6981,[302 603 427  64 313],454,5,25383,3.635491263248353,20.0,0.0
6982,0,6982,[186  56   7 172 174],14,5,25388,3.6356866676213664,0.0,20.0
6983,0,6983,[328  15 748 222  71],749,3,25391,3.6355956471935853,0.0,0.0
6984,0,6984,[288 286 313  11 151],59,4,25395,3.635647816750179,0.0,0.0
6985,0,6985,[ 79   7   9 179 483],60,5,25400,3.635843114801031,20.0,0.0
6986,0,6986,[275 568 282 508 238],378,4,25404,3.635895234006011,0.0,0.0
6987,0,6987,[186 195   8 210 245],452,3,25407,3.635804235832856,0.0,0.0
6988,0,6988,[  4 423 597  70 204],374,3,25410,3.6357132637001,0.0,0.0
6989,0,6989,[403 258  70 237 216],144,4,25414,3.6357653791130184,0.0,0.0
6990,0,6990,[328 515   7 546 323],26,1,25415,3.6353883564583036,0.0,0.0
6991,0,6991,[135 196  56 228  69],343,5,25420,3.63558352402746,0.0,0.0
6992,0,6992,[197 215 195   9 200],60,5,25425,3.6357786357786357,0.0,0.0
6993,0,6993,[238  11 258 318 405],653,1,25426,3.6354017729482413,20.0,0.0
6994,0,6994,[286  25 187 435   8],452,2,25428,3.635167977126519,0.0,0.0
6995,0,6995,[289 183 197   9 435],13,3,25431,3.6350771869639793,0.0,0.0
6996,0,6996,[143 195 118 234 435],313,4,25435,3.6351293411462056,0.0,0.0
6997,0,6997,[271 546 183 117 211],290,1,25436,3.6347527865104317,0.0,0.0
6998,0,6998,[ 69 269 179 187 603],13,3,25439,3.634662094584941,20.0,0.0
6999,0,6999,[ 88 385 678 357 153],308,4,25443,3.634714285714286,20.0,0.0
7000,0,7000,[302 603 427  64 313],271,5,25448,3.6349092986716185,20.0,0.0
7001,0,7001,[200 151 271 655 144],479,4,25452,3.634961439588689,0.0,0.0
7002,0,7002,[546 172 191 222 423],92,3,25455,3.634870769670141,0.0,0.0
7003,0,7003,[181 258 216 318 235],144,4,25459,3.6349229011993147,20.0,0.0
7004,0,7004,[302 603 427  64 313],537,4,25463,3.634975017844397,20.0,0.0
7005,0,7005,[423 181 328 216   1],144,4,25467,3.6350271196117614,0.0,0.0
7006,0,7006,[168 546 323  70 143],374,2,25469,3.6347937776509207,0.0,0.0
7007,0,7007,[302 603 427  64 313],271,5,25474,3.6349885844748857,20.0,0.0
7008,0,7008,[ 50 405  82  71 183],313,3,25477,3.6348979883007564,0.0,20.0
7009,0,7009,[181 222  50 655  98],749,4,25481,3.634950071326676,0.0,40.0
7010,0,7010,[302 603 427  64 313],537,4,25485,3.635002139495079,20.0,0.0
7011,0,7011,[204  79 423 294  88],271,4,25489,3.635054192812322,0.0,0.0
7012,0,7012,[200 125 127  79 202],298,2,25491,3.6348210466276916,0.0,20.0
7013,0,7013,[302 603 427  64 313],474,5,25496,3.6350156829198745,20.0,0.0
7014,0,7014,[175 234 655 197 204],527,3,25499,3.6349251603706345,0.0,0.0
7015,0,7015,[182  22 194 508   9],59,4,25503,3.634977194982896,0.0,0.0
7016,0,7016,[ 50 211 191 328  82],749,5,25508,3.63517172580875,0.0,20.0
7017,0,7017,[200 185 181 204 257],474,3,25511,3.635081219720718,0.0,0.0
7018,0,7018,[302 603 427  64 313],454,5,25516,3.6352756802963384,20.0,0.0
7019,0,7019,[ 25 588  50   8 276],13,4,25520,3.635327635327635,0.0,20.0
7020,0,7020,[357 153 144 435 748],13,4,25524,3.6353795755590372,20.0,0.0
7021,0,7021,[286 475  95 678 181],455,4,25528,3.635431500996867,0.0,0.0
7022,0,7022,[172 234 111 197  56],653,1,25529,3.6350562437704683,0.0,0.0
7023,0,7023,[302 603 427  64 313],271,5,25534,3.635250569476082,20.0,0.0
7024,0,7024,[ 71 111 210 168  22],95,5,25539,3.635444839857651,0.0,0.0
7025,0,7025,[222 161 483 187 288],334,3,25542,3.63535439795047,20.0,0.0
7026,0,7026,[302 603 427  64 313],13,5,25547,3.6355485982638394,20.0,0.0
7027,0,7027,[427 275 238 655 288],334,4,25551,3.635600455321571,0.0,0.0
7028,0,7028,[186  71 475  97 301],13,3,25554,3.635510029876227,0.0,0.0
7029,0,7029,[265 546 194 200 222],653,2,25556,3.635277382645804,0.0,0.0
7030,0,7030,[111 275   1 153 185],6,4,25560,3.63532925615133,0.0,0.0
7031,0,7031,[302 603 427  64 313],537,4,25564,3.635381114903299,20.0,0.0
7032,0,7032,[ 82 210 196   8 194],901,4,25568,3.635432958908005,0.0,0.0
7033,0,7033,[423 185 282 216 175],334,4,25572,3.635484788171737,0.0,0.0
7034,0,7034,[302 603 427  64 313],271,5,25577,3.6356787491115847,20.0,0.0
7035,0,7035,[153 313 403 161 182],13,4,25581,3.635730528709494,0.0,0.0
7036,0,7036,[179 111 357 135 197],95,3,25584,3.6356401875799347,20.0,0.0
7037,0,7037,[275  89 168 273 515],524,2,25586,3.635407786302927,0.0,0.0
7038,0,7038,[200 322 423  88 357],474,4,25590,3.635459582327035,20.0,0.0
7039,0,7039,[185 385 187 228 211],694,5,25595,3.635653409090909,0.0,0.0
7040,0,7040,[273 168 111 121 423],64,3,25598,3.6355631302371822,0.0,0.0
7041,0,7041,[323 237 215 211 568],59,4,25602,3.635614882135757,0.0,0.0
7042,0,7042,[302 603 427  64 313],90,5,25607,3.6358086042879454,20.0,0.0
7043,0,7043,[ 96 181 176  64  28],892,5,25612,3.6360022714366838,0.0,0.0
7044,0,7044,[288  25  82 597 742],897,3,25615,3.6359119943222145,0.0,0.0
7045,0,7045,[300 275   9 196 121],13,2,25617,3.6356798183366448,0.0,0.0
7046,0,7046,[678 275 357 118   1],13,1,25618,3.6353058038881794,20.0,0.0
7047,0,7047,[302 603 427  64 313],13,5,25623,3.63549943246311,20.0,0.0
7048,0,7048,[  1 185  82 118   9],788,2,25625,3.6352674138175627,0.0,0.0
7049,0,7049,[204 100  97 194 118],380,2,25627,3.6350354609929076,0.0,20.0
7050,0,7050,[ 71 515  12 117   7],334,3,25630,3.6349453978159127,20.0,0.0
7051,0,7051,[405 173 257  79 300],455,4,25634,3.6349971639251275,0.0,0.0
7052,0,7052,[302 603 427  64 313],537,4,25638,3.635048915355168,20.0,0.0
7053,0,7053,[435 222  96  70 228],447,3,25641,3.6349588885738586,0.0,0.0
7054,0,7054,[118 385  71  95 288],13,3,25644,3.634868887313962,0.0,0.0
7055,0,7055,[ 96  79  95 151 176],279,2,25646,3.634637188208617,0.0,0.0
7056,0,7056,[ 64 186 215 269 405],524,1,25647,3.6342638514949694,0.0,0.0
7057,0,7057,[185 153 300 515 135],488,4,25651,3.6343156701615187,0.0,0.0
7058,0,7058,[302 603 427  64 313],454,5,25656,3.6345091372715683,20.0,0.0
7059,0,7059,[ 82 182 151 194 265],59,4,25660,3.634560906515581,0.0,0.0
7060,0,7060,[302 603 427  64 313],13,5,25665,3.634754284095737,20.0,0.0
7061,0,7061,[ 64 127 168  98 496],406,4,25669,3.6348060039648824,0.0,40.0
7062,0,7062,[ 97 603  96 143 121],804,4,25673,3.63485770918873,20.0,0.0
7063,0,7063,[216 127 181 100 273],385,2,25675,3.634626274065685,0.0,40.0
7064,0,7064,[200  89  69 288   9],488,3,25678,3.6345364472753006,0.0,0.0
7065,0,7065,[ 50 117  96 196  88],479,4,25682,3.63458816869516,0.0,20.0
7066,0,7066,[132 179 245 182 405],653,2,25684,3.6343568699589643,0.0,0.0
7067,0,7067,[235  25 265  82 202],308,3,25687,3.6342671194114318,0.0,0.0
7068,0,7068,[ 69 597 405 200 210],374,5,25692,3.6344603197057577,0.0,0.0
7069,0,7069,[405 185 127 204 143],406,3,25695,3.6343705799151342,0.0,20.0
7070,0,7070,[ 97 161  11 174 748],474,4,25699,3.634422288219488,0.0,20.0
7071,0,7071,[  9 185  79 300 117],13,0,25699,3.633908371040724,0.0,0.0
7072,0,7072,[302 603 427  64 313],271,5,25704,3.6341015127951364,20.0,0.0
7073,0,7073,[302 603 427  64 313],13,5,25709,3.634294599943455,20.0,0.0
7074,0,7074,[ 56 100 117 153 228],398,4,25713,3.63434628975265,0.0,20.0
7075,0,7075,[302 603 427  64 313],271,5,25718,3.634539287733183,20.0,0.0
7076,0,7076,[127 196 187 403 194],234,3,25721,3.6344496255475485,0.0,20.0
7077,0,7077,[302 603 427  64 313],271,5,25726,3.6346425543938965,20.0,0.0
7078,0,7078,[276 117 216 288 603],537,2,25728,3.634411640062156,20.0,0.0
7079,0,7079,[302 603 427  64 313],669,5,25733,3.6346045197740113,20.0,0.0
7080,0,7080,[471 222 300 655 318],666,3,25736,3.6345148990255614,20.0,0.0
7081,0,7081,[168 179 100  22 196],64,5,25741,3.6347077096865292,0.0,20.0
7082,0,7082,[238 508  12 176 200],643,3,25744,3.634618099675279,20.0,0.0
7083,0,7083,[302 603 427  64 313],474,5,25749,3.6348108413325804,20.0,0.0
7084,0,7084,[435 196 182 215 183],506,5,25754,3.6350035285815103,0.0,0.0
7085,0,7085,[275  70 568  98 135],882,4,25758,3.635055038103302,0.0,20.0
7086,0,7086,[508 161 185 215 546],774,0,25758,3.6345421193735006,0.0,0.0
7087,0,7087,[302 603 427  64 313],669,5,25763,3.634734762979684,20.0,0.0
7088,0,7088,[  1  28 196 174 135],234,2,25765,3.634504161376781,0.0,20.0
7089,0,7089,[204 186 603 508 194],385,1,25766,3.634132581100141,20.0,0.0
7090,0,7090,[302 603 427  64 313],537,4,25770,3.6341841771259342,20.0,0.0
7091,0,7091,[302 603 427  64 313],13,5,25775,3.6343767625493513,20.0,0.0
7092,0,7092,[121 191 173 195 238],843,1,25776,3.6340053573946145,0.0,0.0
7093,0,7093,[202 180 132 322 328],90,3,25779,3.6339159853397236,0.0,0.0
7094,0,7094,[302 603 427  64 313],474,5,25784,3.634108527131783,20.0,0.0
7095,0,7095,[194 235  22  82 200],378,4,25788,3.6341600901916573,0.0,0.0
7096,0,7096,[302 603 427  64 313],454,5,25793,3.6343525433281667,20.0,0.0
7097,0,7097,[176 748 237 216 172],883,4,25797,3.6344040574809804,0.0,0.0
7098,0,7098,[ 28 181 288 185 175],648,4,25801,3.634455557120721,0.0,0.0
7099,0,7099,[357 121 182 300 100],479,3,25804,3.6343661971830987,20.0,20.0
7100,0,7100,[568 323 118  50 176],804,5,25809,3.634558512885509,0.0,20.0
7101,0,7101,[ 69  88 269  82   8],343,5,25814,3.634750774429738,0.0,0.0
7102,0,7102,[161  89 302 191 269],378,5,25819,3.63494298183866,0.0,0.0
7103,0,7103,[186 168 153  70 202],804,5,25824,3.635135135135135,0.0,0.0
7104,0,7104,[302 603 427  64 313],537,4,25828,3.635186488388459,20.0,0.0
7105,0,7105,[ 69 271  95 357 471],537,1,25829,3.634815648747537,20.0,0.0
7106,0,7106,[ 71 176  11 276 234],13,3,25832,3.6347263261573097,0.0,0.0
7107,0,7107,[ 22 323  69 435 496],125,4,25836,3.634777715250422,0.0,0.0
7108,0,7108,[357 471 423 333 200],343,3,25839,3.6346884231256156,20.0,0.0
7109,0,7109,[144 210  28 202 132],378,4,25843,3.6347398030942335,0.0,0.0
7110,0,7110,[  7 185  12 222 181],60,5,25848,3.6349317958093095,20.0,0.0
7111,0,7111,[302 603 427  64 313],454,5,25853,3.6351237345331833,20.0,0.0
7112,0,7112,[357 185   1 143 385],749,4,25857,3.635175031632223,20.0,0.0
7113,0,7113,[143   4 471 289  98],378,3,25860,3.635085746415519,0.0,20.0
7114,0,7114,[196 215  69  71  22],804,5,25865,3.635277582572031,0.0,0.0
7115,0,7115,[302 603 427  64 313],454,5,25870,3.635469364811692,20.0,0.0
7116,0,7116,[135 215 483  98  50],406,4,25874,3.6355205845159477,20.0,40.0
7117,0,7117,[302 603 427  64 313],271,5,25879,3.6357122787299803,20.0,0.0
7118,0,7118,[ 64  98 174  12 357],233,4,25883,3.635763449922742,40.0,40.0
7119,0,7119,[302 603 427  64 313],454,5,25888,3.635955056179775,20.0,0.0
7120,0,7120,[ 82 238 202 172 216],59,5,25893,3.6361466086223846,0.0,0.0
7121,0,7121,[111 357 202 172 427],42,4,25897,3.636197697276046,20.0,0.0
7122,0,7122,[333 328 258 276 597],26,1,25898,3.6358276007300296,0.0,0.0
7123,0,7123,[173 655 313 508 197],378,4,25902,3.6358787198203255,0.0,0.0
7124,0,7124,[603  88 182 161 204],339,3,25905,3.6357894736842105,20.0,0.0
7125,0,7125,[181 144 748 273 385],346,5,25910,3.635980914959304,0.0,0.0
7126,0,7126,[ 96  79  56 215 121],200,5,25915,3.6361723025115755,0.0,0.0
7127,0,7127,[ 82 111 187 132 127],653,3,25918,3.6360830527497194,0.0,20.0
7128,0,7128,[282 265  97  64 568],328,2,25920,3.635853555898443,0.0,0.0
7129,0,7129,[100  89 273  64 655],59,4,25924,3.6359046283309957,0.0,20.0
7130,0,7130,[237 269 275 258 234],455,4,25928,3.6359556864394897,0.0,0.0
7131,0,7131,[ 22 228 125 234 176],200,5,25933,3.6361469433538978,0.0,0.0
7132,0,7132,[200 508 185 143  69],213,4,25937,3.636197953175382,0.0,0.0
7133,0,7133,[125 211 191  79 181],653,3,25940,3.636108774880852,0.0,0.0
7134,0,7134,[ 69  28   8 173 174],454,4,25944,3.636159775753329,0.0,20.0
7135,0,7135,[ 22 172 286  11 132],653,2,25946,3.6359304932735426,0.0,0.0
7136,0,7136,[127  89 742 175 215],346,4,25950,3.6359815048339637,0.0,20.0
7137,0,7137,[186 196 216 294 275],271,4,25954,3.636032502101429,0.0,0.0
7138,0,7138,[174 603 194 546 234],213,5,25959,3.63622356072279,20.0,20.0
7139,0,7139,[182 322  71 176 508],474,4,25963,3.6362745098039215,0.0,0.0
7140,0,7140,[302 603 427  64 313],271,5,25968,3.6364654810250667,20.0,0.0
7141,0,7141,[748 286  50 176 121],474,4,25972,3.6365163819658357,0.0,20.0
7142,0,7142,[655 318  69  82  71],311,5,25977,3.636707265854683,20.0,0.0
7143,0,7143,[135 144 194 161 435],833,2,25979,3.636478163493841,0.0,0.0
7144,0,7144,[742 168 143 228  82],290,3,25982,3.6363890832750174,0.0,0.0
7145,0,7145,[179 191 423 186  98],749,5,25987,3.6365799048418697,0.0,20.0
7146,0,7146,[ 79 742 180 125 194],899,3,25990,3.636490835315517,0.0,0.0
7147,0,7147,[302 603 427  64 313],13,5,25995,3.636681589255736,20.0,0.0
7148,0,7148,[302 603 427  64 313],271,5,26000,3.6368722898307455,20.0,0.0
7149,0,7149,[276 515 174 265 294],194,4,26004,3.6369230769230767,0.0,20.0
7150,0,7150,[515 568 222 258 144],313,3,26007,3.6368340092294784,0.0,0.0
7151,0,7151,[197  88 118 175 265],308,2,26009,3.63660514541387,0.0,0.0
7152,0,7152,[265  50 496 313 471],308,1,26010,3.6362365441073674,0.0,20.0
7153,0,7153,[282  70 742 357 435],533,4,26014,3.636287391668996,20.0,0.0
7154,0,7154,[302 603 427  64 313],454,5,26019,3.6364779874213835,20.0,0.0
7155,0,7155,[ 64 215 183   7 216],13,3,26022,3.636389044158748,0.0,0.0
7156,0,7156,[228 132 174 403 195],234,1,26023,3.6360206790554703,0.0,20.0
7157,0,7157,[  8 121  64 127  12],271,4,26027,3.636071528359877,20.0,20.0
7158,0,7158,[135 121 132 258 546],749,3,26030,3.635982679145132,0.0,0.0
7159,0,7159,[403 508  95 655 215],378,5,26035,3.636173184357542,0.0,0.0
7160,0,7160,[302 603 427  64 313],90,5,26040,3.6363636363636362,20.0,0.0
7161,0,7161,[191 228  12  79 185],64,5,26045,3.636554035185702,20.0,0.0
7162,0,7162,[161 204 258 111 238],13,4,26049,3.636604774535809,0.0,0.0
7163,0,7163,[405  79 202 748 245],102,1,26050,3.6362367392518147,0.0,0.0
7164,0,7164,[ 11 174 202 211   1],64,5,26055,3.636427076064201,0.0,20.0
7165,0,7165,[216 195 568   1   4],749,5,26060,3.636617359754396,0.0,0.0
7166,0,7166,[546 423 176 313   9],533,3,26063,3.6365285335565787,0.0,0.0
7167,0,7167,[357 151  11 135  71],387,2,26065,3.6363002232142856,20.0,0.0
7168,0,7168,[200 294  96 100 405],474,3,26068,3.6362114660343146,0.0,20.0
7169,0,7169,[302 603 427  64 313],474,5,26073,3.6364016736401674,20.0,0.0
7170,0,7170,[127 210 603  11 132],7,4,26077,3.6364523776321294,20.0,20.0
7171,0,7171,[194  96 127 269  70],452,4,26081,3.6365030674846626,0.0,20.0
7172,0,7172,[  7  11 496 423 385],7,4,26085,3.6365537432036805,0.0,0.0
7173,0,7173,[197 357 168 496 195],409,4,26089,3.6366044047950936,20.0,0.0
7174,0,7174,[588 323   9 265  11],881,2,26091,3.636376306620209,0.0,0.0
7175,0,7175,[144 546 204 228 185],648,5,26096,3.6365663322185062,0.0,0.0
7176,0,7176,[ 95  64 273   8 197],378,4,26100,3.6366169708791976,0.0,0.0
7177,0,7177,[655 183  25 286 127],184,4,26104,3.636667595430482,0.0,20.0
7178,0,7178,[182  11 322 191 180],308,4,26108,3.636718205878256,0.0,0.0
7179,0,7179,[135  96 269  89 132],666,4,26112,3.636768802228412,0.0,0.0
7180,0,7180,[172 313 135 268 471],537,3,26115,3.636680128115861,0.0,0.0
7181,0,7181,[ 11 323  50 568 174],197,3,26118,3.636591478696742,0.0,40.0
7182,0,7182,[273 111  71 678  12],92,3,26121,3.6365028539607405,20.0,0.0
7183,0,7183,[302 603 427  64 313],454,5,26126,3.6366926503340755,20.0,0.0
7184,0,7184,[182 161  96 228 195],197,4,26130,3.636743215031315,0.0,0.0
7185,0,7185,[276 215 655 237 286],537,1,26131,3.63637628722516,0.0,0.0
7186,0,7186,[191  95 282 405 186],406,2,26133,3.636148601641853,0.0,0.0
7187,0,7187,[180 100  69 186  82],234,2,26135,3.635920979410128,0.0,20.0
7188,0,7188,[196 135 235 181 117],378,3,26138,3.6358325219084713,0.0,0.0
7189,0,7189,[302 603 427  64 313],537,4,26142,3.635883171070932,20.0,0.0
7190,0,7190,[ 70 127 275 211 294],474,3,26145,3.6357947434292868,0.0,20.0
7191,0,7191,[200  64 286 655 302],666,5,26150,3.6359844271412682,0.0,0.0
7192,0,7192,[302 603 427  64 313],474,5,26155,3.6361740581120534,20.0,0.0
7193,0,7193,[ 69 483 143 748  82],648,3,26158,3.636085626911315,20.0,0.0
7194,0,7194,[300 323 153  12 322],90,3,26161,3.6359972202918693,20.0,0.0
7195,0,7195,[275   4 127 289 655],328,4,26165,3.636047804335742,0.0,20.0
7196,0,7196,[161 385 282 471 748],899,4,26169,3.6360983743226343,0.0,0.0
7197,0,7197,[302 603 427  64 313],474,5,26174,3.6362878577382607,20.0,0.0
7198,0,7198,[172  98 173 196  25],92,3,26177,3.6361994721489097,0.0,20.0
7199,0,7199,[210 181 515 333 282],334,4,26181,3.63625,0.0,0.0
7200,0,7200,[168 286 191 210 546],234,1,26182,3.6358839050131926,0.0,0.0
7201,0,7201,[302 603 427  64 313],474,5,26187,3.63607331296862,20.0,0.0
7202,0,7202,[655 144 132 222 182],795,2,26189,3.635846175204776,0.0,0.0
7203,0,7203,[269 194 483  11 234],666,3,26192,3.6357579122709605,20.0,0.0
7204,0,7204,[302 603 427  64 313],669,5,26197,3.6359472588480224,20.0,0.0
7205,0,7205,[302 603 427  64 313],13,5,26202,3.636136552872606,20.0,0.0
7206,0,7206,[ 88  79 100 121 423],454,5,26207,3.636325794366588,0.0,20.0
7207,0,7207,[ 96 318 603 385 215],234,2,26209,3.6360987791342954,40.0,0.0
7208,0,7208,[185 546 515   8 215],308,2,26211,3.6358718268830628,0.0,0.0
7209,0,7209,[483 496  82 357 179],659,4,26215,3.6359223300970873,40.0,0.0
7210,0,7210,[151 185 127  82 182],59,5,26220,3.636111496325059,0.0,20.0
7211,0,7211,[  9 210 215 655 183],13,3,26223,3.6360232945091515,0.0,0.0
7212,0,7212,[435 496 172 405 196],7,4,26227,3.636073755718841,0.0,0.0
7213,0,7213,[302 603 427  64 313],271,5,26232,3.6362628222899915,20.0,0.0
7214,0,7214,[275 127 121 257 194],343,3,26235,3.636174636174636,0.0,20.0
7215,0,7215,[ 97 143  95 300 182],479,2,26237,3.6359478935698446,0.0,0.0
7216,0,7216,[228 143 546  70  64],95,4,26241,3.635998337259249,0.0,0.0
7217,0,7217,[210 357 174 173  69],59,5,26246,3.6361873095040176,20.0,20.0
7218,0,7218,[302 603 427  64 313],271,5,26251,3.636376229394653,20.0,0.0
7219,0,7219,[302 603 427  64 313],474,5,26256,3.6365650969529084,20.0,0.0
7220,0,7220,[435 235 172 237 265],378,5,26261,3.6367539122005264,0.0,0.0
7221,0,7221,[302 603 427  64 313],669,5,26266,3.6369426751592355,20.0,0.0
7222,0,7222,[ 64 202  12 318  70],64,5,26271,3.6371313858507546,40.0,0.0
7223,0,7223,[300 172 234  88  56],215,3,26274,3.6370431893687707,0.0,0.0
7224,0,7224,[655  71  88 328 216],378,4,26278,3.6370934256055363,0.0,0.0
7225,0,7225,[210  95 483 216 187],85,3,26281,3.637005258787711,20.0,0.0
7226,0,7226,[222  71 176 238   1],892,4,26285,3.6370554863705546,0.0,0.0
7227,0,7227,[ 22 385 211 294 161],479,2,26287,3.63682899833979,0.0,0.0
7228,0,7228,[237 286   9 180 181],13,3,26290,3.636740904689445,0.0,0.0
7229,0,7229,[302 603 427  64 313],454,5,26295,3.636929460580913,20.0,0.0
7230,0,7230,[132 183 323 228 216],328,2,26297,3.6367030839441292,0.0,0.0
7231,0,7231,[ 71  70 655 100 161],308,4,26301,3.636753318584071,0.0,20.0
7232,0,7232,[179  50  56 182 135],897,2,26303,3.636527028895341,0.0,20.0
7233,0,7233,[302 603 427  64 313],271,5,26308,3.6367155100912356,20.0,0.0
7234,0,7234,[294   1 187 258 185],271,1,26309,3.6363510711817555,0.0,0.0
7235,0,7235,[ 95 546 151 215 222],64,3,26312,3.6362631288004423,0.0,0.0
7236,0,7236,[135 195 197  89 174],694,5,26317,3.6364515683294183,0.0,20.0
7237,0,7237,[302 603 427  64 313],669,5,26322,3.6366399557888918,20.0,0.0
7238,0,7238,[302 603 427  64 313],271,5,26327,3.636828291200442,20.0,0.0
7239,0,7239,[300 168 405 161 173],346,2,26329,3.6366022099447513,0.0,0.0
7240,0,7240,[ 82  11 215 196  12],892,3,26332,3.6365142936058557,20.0,0.0
7241,0,7241,[258 202 210 179 211],666,4,26336,3.636564484948909,0.0,0.0
7242,0,7242,[288 174 175 179  89],474,4,26340,3.636614662432694,0.0,20.0
7243,0,7243,[568 273  89 151 180],90,3,26343,3.6365267807840973,0.0,0.0
7244,0,7244,[ 71 176   8  79 294],506,5,26348,3.6367149758454107,0.0,0.0
7245,0,7245,[302 603 427  64 313],537,4,26352,3.636765111785813,20.0,0.0
7246,0,7246,[302 603 427  64 313],90,5,26357,3.636953222022906,20.0,0.0
7247,0,7247,[302 603 427  64 313],454,5,26362,3.637141280353201,20.0,0.0
7248,0,7248,[385  56 186 153  28],279,4,26366,3.6371913367361017,0.0,0.0
7249,0,7249,[302 603 427  64 313],13,5,26371,3.6373793103448278,20.0,0.0
7250,0,7250,[322 204 186 273 423],308,3,26374,3.637291408081644,0.0,0.0
7251,0,7251,[ 98 200 100  97 508],213,5,26379,3.6374793160507446,0.0,40.0
7252,0,7252,[  7   9  15 234 235],548,2,26381,3.6372535502550667,0.0,0.0
7253,0,7253,[ 88 121 202 313 195],378,3,26384,3.637165701681831,0.0,0.0
7254,0,7254,[302 603 427  64 313],271,5,26389,3.6373535492763613,20.0,0.0
7255,0,7255,[302 603 427  64 313],13,5,26394,3.6375413450937155,20.0,0.0
7256,0,7256,[ 79  88 235 237 197],398,3,26397,3.6374534931789997,0.0,0.0
7257,0,7257,[234 174 161 568 215],804,5,26402,3.637641223477542,0.0,20.0
7258,0,7258,[ 89 471 294 678 276],13,2,26404,3.6374156219864995,0.0,0.0
7259,0,7259,[515 135 568  50 357],290,2,26406,3.637190082644628,20.0,20.0
7260,0,7260,[151 294 483 515  88],881,2,26408,3.63696460542625,20.0,0.0
7261,0,7261,[568 216 135  89  71],766,2,26410,3.636739190305701,0.0,0.0
7262,0,7262,[269 182 144 191 153],10,5,26415,3.636926889714994,0.0,0.0
7263,0,7263,[117 603 181 385 111],899,3,26418,3.636839207048458,20.0,0.0
7264,0,7264,[333 202 288 258 100],13,3,26421,3.636751548520303,0.0,20.0
7265,0,7265,[ 69 222 143 196 100],666,1,26422,3.6363886595100468,0.0,20.0
7266,0,7266,[194  96 237 294 276],378,4,26426,3.636438695472685,0.0,0.0
7267,0,7267,[174 597 265 496  82],452,3,26429,3.636351128233352,0.0,20.0
7268,0,7268,[302 603 427  64 313],474,5,26434,3.636538726097125,20.0,0.0
7269,0,7269,[ 82 568 216 151 175],749,4,26438,3.636588720770289,0.0,0.0
7270,0,7270,[294  12 313 748 197],207,2,26440,3.6363636363636362,20.0,0.0
7271,0,7271,[185 181 182 210 215],13,3,26443,3.6362761276127613,0.0,0.0
7272,0,7272,[302 603 427  64 313],13,5,26448,3.636463632613777,20.0,0.0
7273,0,7273,[  1 210 222 143  28],200,5,26453,3.6366510860599397,0.0,0.0
7274,0,7274,[118 238  95 173   9],378,4,26457,3.636701030927835,0.0,0.0
7275,0,7275,[313 286 275 258 111],119,4,26461,3.6367509620670697,0.0,0.0
7276,0,7276,[ 56 118 196 174 323],311,3,26464,3.6366634602171226,0.0,20.0
7277,0,7277,[302 603 427  64 313],537,4,26468,3.636713382797472,20.0,0.0
7278,0,7278,[215 603 175  82 483],385,3,26471,3.6366259101524934,40.0,0.0
7279,0,7279,[289 333 357 276 182],881,3,26474,3.6365384615384615,20.0,0.0
7280,0,7280,[ 56 234 121 423 196],881,2,26476,3.6363136931740145,0.0,0.0
7281,0,7281,[302 603 427 313  64],13,5,26481,3.636500961274375,20.0,0.0
7282,0,7282,[174 496 117  69 121],95,5,26486,3.6366881779486477,0.0,20.0
7283,0,7283,[302 603 427 313  64],90,5,26491,3.636875343218012,20.0,0.0
7284,0,7284,[  4 237  11 143  25],13,2,26493,3.6366506520247084,0.0,0.0
7285,0,7285,[ 22  28 357 202  79],234,3,26496,3.636563272028548,20.0,0.0
7286,0,7286,[182   9 175 173 186],334,3,26499,3.636475916014821,0.0,0.0
7287,0,7287,[302 603 427 313  64],454,5,26504,3.6366630076838637,20.0,0.0
7288,0,7288,[ 89 117 202 195 161],749,4,26508,3.6367128549869667,0.0,0.0
7289,0,7289,[ 64 216 546 435  56],60,5,26513,3.6368998628257887,0.0,0.0
7290,0,7290,[ 15 180 174   9 181],378,4,26517,3.6369496639692773,0.0,20.0
7291,0,7291,[302 603 427 313  64],474,5,26522,3.6371365880416895,20.0,0.0
7292,0,7292,[ 98 143 175 405  89],524,1,26523,3.6367749897161663,0.0,20.0
7293,0,7293,[202 357 179 100 191],59,5,26528,3.63696188648204,20.0,20.0
7294,0,7294,[175 496 174 173 435],840,5,26533,3.637148732008225,0.0,20.0
7295,0,7295,[215  89  22 471 194],271,3,26536,3.637061403508772,0.0,0.0
7296,0,7296,[143 196 168 222   1],406,1,26537,3.636700013704262,0.0,0.0
7297,0,7297,[302 603 427  64 313],90,5,26542,3.6368868183063854,20.0,0.0
7298,0,7298,[302 603 427  64 313],271,5,26547,3.6370735717221536,20.0,0.0
7299,0,7299,[ 82 210 300 185 257],666,1,26548,3.6367123287671235,0.0,0.0
7300,0,7300,[ 98 144  28  22 483],95,4,26552,3.6367620873852897,20.0,20.0
7301,0,7301,[405 237 174 196  25],59,3,26555,3.636674883593536,0.0,20.0
7302,0,7302,[313 100   1 546  28],234,3,26558,3.6365877036834178,0.0,20.0
7303,0,7303,[302 603 427 313  64],474,5,26563,3.636774370208105,20.0,0.0
7304,0,7304,[172 168 100  56  22],387,5,26568,3.6369609856262834,0.0,20.0
7305,0,7305,[172 211  96 183 215],474,5,26573,3.637147549958938,0.0,0.0
7306,0,7306,[197 471 265 222 237],537,1,26574,3.636786642945121,0.0,0.0
7307,0,7307,[265 323 234 435 172],13,4,26578,3.6368363437328957,0.0,0.0
7308,0,7308,[286 603 237 185 211],59,3,26581,3.636749213298673,20.0,0.0
7309,0,7309,[151 742 168   7 496],666,3,26584,3.636662106703146,0.0,0.0
7310,0,7310,[302 603 427 313  64],271,5,26589,3.63684858432499,20.0,0.0
7311,0,7311,[202   9  69 194 168],881,1,26590,3.636487964989059,0.0,0.0
7312,0,7312,[475  82 357 197 180],343,5,26595,3.6366744154245865,20.0,0.0
7313,0,7313,[ 50  64 748 385 168],749,3,26598,3.6365873666940116,0.0,20.0
7314,0,7314,[235 211 187 357 269],271,4,26602,3.636637047163363,20.0,0.0
7315,0,7315,[471  12 216 186 288],378,2,26604,3.6364133406232915,20.0,0.0
7316,0,7316,[135 471  12 127 235],374,4,26608,3.6364630312969797,20.0,20.0
7317,0,7317,[300 568 182  28 546],533,3,26611,3.6363760590325227,0.0,0.0
7318,0,7318,[268 228 181 496   8],387,3,26614,3.636289110534226,0.0,0.0
7319,0,7319,[318 187 483 186 117],334,3,26617,3.63620218579235,40.0,0.0
7320,0,7320,[302 603 427  64 313],474,5,26622,3.6363884715202843,20.0,0.0
7321,0,7321,[183   4 121 318  12],59,5,26627,3.636574706364381,40.0,0.0
7322,0,7322,[546 200 245 174 191],92,3,26630,3.6364877782329645,0.0,20.0
7323,0,7323,[302 603 427  64 313],13,5,26635,3.6366739486619335,20.0,0.0
7324,0,7324,[183  96 471 318 143],92,3,26638,3.6365870307167234,20.0,0.0
7325,0,7325,[302 603 427  64 313],537,4,26642,3.6366366366366365,20.0,0.0
7326,0,7326,[678  98 187  71 435],881,3,26645,3.6365497475092123,0.0,20.0
7327,0,7327,[151 179  25 176 483],7,3,26648,3.63646288209607,20.0,0.0
7328,0,7328,[423 323 282 197 471],474,3,26651,3.6363760403875016,0.0,0.0
7329,0,7329,[273 333 153 127  56],328,2,26653,3.6361527967257845,0.0,20.0
7330,0,7330,[ 56 328  89 180  22],664,3,26656,3.636066021006684,0.0,0.0
7331,0,7331,[143 289 471  11 385],454,1,26657,3.635706492089471,0.0,0.0
7332,0,7332,[268 269 168  12 182],537,3,26660,3.635619800900041,20.0,0.0
7333,0,7333,[276 313 174 275 403],883,4,26664,3.63566948459231,0.0,20.0
7334,0,7334,[427 174 173 211 172],85,3,26667,3.6355828220858895,0.0,20.0
7335,0,7335,[302 603 427 313  64],454,5,26672,3.6357688113413302,20.0,0.0
7336,0,7336,[302 603 427 313  64],271,5,26677,3.6359547498977784,20.0,0.0
7337,0,7337,[228 194 132 179 546],95,2,26679,3.6357318070318887,0.0,0.0
7338,0,7338,[153 151 288  22 144],447,4,26683,3.635781441613299,0.0,0.0
7339,0,7339,[ 25 328 294 515 245],804,5,26688,3.635967302452316,0.0,0.0
7340,0,7340,[302 603 427 313  64],13,5,26693,3.636153112654952,20.0,0.0
7341,0,7341,[302 603 427 313  64],13,5,26698,3.636338872241896,20.0,0.0
7342,0,7342,[302 603 427 313  64],474,5,26703,3.6365245812338283,20.0,0.0
7343,0,7343,[111 257 210 180  97],653,2,26705,3.63630174291939,0.0,0.0
7344,0,7344,[ 88 222 121 300  56],378,4,26709,3.636351259360109,0.0,0.0
7345,0,7345,[302 603 427 313  64],90,5,26714,3.6365368908249387,20.0,0.0
7346,0,7346,[300 318 132 216 153],653,2,26716,3.636314141826596,20.0,0.0
7347,0,7347,[268 153 196 127 678],13,4,26720,3.6363636363636362,0.0,20.0
7348,0,7348,[258  25 435 211 228],749,5,26725,3.6365491903660363,0.0,0.0
7349,0,7349,[302 603 427 313  64],13,5,26730,3.636734693877551,20.0,0.0
7350,0,7350,[ 22   7 235 273 597],308,2,26732,3.636512039178343,0.0,0.0
7351,0,7351,[183 194 423 176 235],144,4,26736,3.6365614798694232,0.0,0.0
7352,0,7352,[174  88 276 151 275],533,3,26739,3.6364749082007344,0.0,20.0
7353,0,7353,[302 603 427 313  64],13,5,26744,3.6366603209137884,20.0,0.0
7354,0,7354,[258 333  97  69 118],533,4,26748,3.636709721278042,0.0,0.0
7355,0,7355,[302 603 427 313  64],13,5,26753,3.63689505165851,20.0,0.0
7356,0,7356,[202 204 275 222  82],537,1,26754,3.636536631779258,0.0,0.0
7357,0,7357,[286 197   1 302 100],883,3,26757,3.6364501223158467,0.0,20.0
7358,0,7358,[302 603 427  64 313],271,5,26762,3.6366354124201656,20.0,0.0
7359,0,7359,[222 182  82  64 288],488,3,26765,3.636548913043478,0.0,0.0
7360,0,7360,[191 185 276  12 196],271,3,26768,3.6364624371688627,20.0,0.0
7361,0,7361,[ 89 194 187 289 168],537,3,26771,3.636375984786743,0.0,0.0
7362,0,7362,[588 742 100 289 202],454,1,26772,3.636017927475214,0.0,20.0
7363,0,7363,[ 71 405  22 222 588],804,5,26777,3.6362031504617054,0.0,0.0
7364,0,7364,[496 168  22 655 200],387,3,26780,3.6361167684996607,0.0,0.0
7365,0,7365,[132 288 546  11 333],343,2,26782,3.635894651099647,0.0,0.0
7366,0,7366,[168  22 172 179 202],479,4,26786,3.6359440749287364,0.0,0.0
7367,0,7367,[175 568 117   8  98],92,4,26790,3.6359934853420195,0.0,20.0
7368,0,7368,[302 603 427  64 313],13,5,26795,3.636178585968245,20.0,0.0
7369,0,7369,[179 143  11 216 276],90,5,26800,3.6363636363636362,0.0,0.0
7370,0,7370,[258  88 435 215 276],343,5,26805,3.6365486365486364,0.0,0.0
7371,0,7371,[328 118  79 273 515],833,0,26805,3.6360553445469344,0.0,0.0
7372,0,7372,[174 111 204   7 273],378,4,26809,3.636104706361047,0.0,20.0
7373,0,7373,[302 603 427  64 313],669,5,26814,3.6362896663954434,20.0,0.0
7374,0,7374,[228 245 597 483 186],328,3,26817,3.6362033898305084,20.0,0.0
7375,0,7375,[302 603 427  64 313],90,5,26822,3.636388286334056,20.0,0.0
7376,0,7376,[181 194 228 597 546],804,3,26825,3.636302019791243,0.0,0.0
7377,0,7377,[302 603 427  64 313],537,4,26829,3.636351314719436,20.0,0.0
7378,0,7378,[302 603 427 313  64],454,5,26834,3.6365361160048786,20.0,0.0
7379,0,7379,[211 323 678  98 301],537,1,26835,3.636178861788618,0.0,20.0
7380,0,7380,[187 210 475 127 153],409,4,26839,3.6362281533667526,0.0,20.0
7381,0,7381,[180  69 168 151 245],749,5,26844,3.636412896234083,0.0,0.0
7382,0,7382,[195 275  11  96 179],406,4,26848,3.6364621427603954,0.0,0.0
7383,0,7383,[302 603 427 313  64],13,5,26853,3.6366468039003252,20.0,0.0
7384,0,7384,[597  79 678 289 273],92,2,26855,3.6364251861882195,0.0,0.0
7385,0,7385,[ 82 197  50 238 186],666,2,26857,3.6362036284863253,0.0,20.0
7386,0,7386,[257 180 603 313 174],533,4,26861,3.63625287667524,20.0,20.0
7387,0,7387,[302 603 427 313  64],537,4,26865,3.6363021115322143,20.0,0.0
7388,0,7388,[195 222 515 185 151],406,2,26867,3.636080660441196,0.0,0.0
7389,0,7389,[496  64 125 216 132],311,5,26872,3.6362652232746955,0.0,0.0
7390,0,7390,[273 187  28  97 121],666,2,26874,3.636043837099175,0.0,0.0
7391,0,7391,[121 508 235 211 187],343,4,26878,3.6360930735930737,0.0,0.0
7392,0,7392,[ 22 186 258 385 546],234,1,26879,3.6357365075071013,0.0,0.0
7393,0,7393,[ 12 228 144 182  69],454,2,26881,3.6355152826616175,20.0,0.0
7394,0,7394,[302 603 427 313  64],537,4,26885,3.6355645706558484,20.0,0.0
7395,0,7395,[302 603 427 313  64],669,5,26890,3.6357490535424555,20.0,0.0
7396,0,7396,[181 191 322 269 318],537,2,26892,3.635527916722996,20.0,0.0
7397,0,7397,[302 603 427 313  64],13,5,26897,3.635712354690457,20.0,0.0
7398,0,7398,[385   4 187 258  25],7,4,26901,3.6357615894039736,0.0,0.0
7399,0,7399,[276  69  11 289 173],92,3,26904,3.635675675675676,0.0,0.0
7400,0,7400,[125 183  25  56 235],92,3,26907,3.635589785164167,0.0,0.0
7401,0,7401,[323 403 515 179 435],650,2,26909,3.635368819238044,0.0,0.0
7402,0,7402,[302 603 427 313  64],13,5,26914,3.6355531541267054,20.0,0.0
7403,0,7403,[302 603 427 313  64],474,5,26919,3.635737439222042,20.0,0.0
7404,0,7404,[268 237 302 515 258],486,4,26923,3.635786630654963,0.0,0.0
7405,0,7405,[ 79 276 172 176 181],474,5,26928,3.635970834458547,0.0,0.0
7406,0,7406,[276 237  96  71 195],378,4,26932,3.6360199810989604,0.0,0.0
7407,0,7407,[ 64 211 183 172 333],537,1,26933,3.6356641468682507,0.0,0.0
7408,0,7408,[ 70 187  88  15 302],543,4,26937,3.635713321635848,0.0,0.0
7409,0,7409,[258 423 187 168 357],13,4,26941,3.6357624831309043,20.0,0.0
7410,0,7410,[ 50  97 568 175 172],64,4,26945,3.635811631358791,0.0,20.0
7411,0,7411,[288 235 275  79 173],13,0,26945,3.635321100917431,0.0,0.0
7412,0,7412,[748 286 234 125 176],648,2,26947,3.635100499123162,0.0,0.0
7413,0,7413,[302 603 427 313  64],669,5,26952,3.635284596708929,20.0,0.0
7414,0,7414,[210 181 238 204 182],537,2,26954,3.6350640593391774,0.0,0.0
7415,0,7415,[  8 187 483 185 318],207,4,26958,3.635113268608414,40.0,0.0
7416,0,7416,[302 603 427 313  64],13,5,26963,3.635297290009438,20.0,0.0
7417,0,7417,[ 28  96 403 237 172],883,3,26966,3.6352116473442977,0.0,0.0
7418,0,7418,[302 603 427 313  64],271,5,26971,3.635395605876803,20.0,0.0
7419,0,7419,[302 603 427 313  64],474,5,26976,3.635579514824798,20.0,0.0
7420,0,7420,[197 273 151 288 238],7,4,26980,3.6356286214795848,0.0,0.0
7421,0,7421,[191 234 196 318  69],59,5,26985,3.635812449474535,20.0,0.0
7422,0,7422,[427 423 111 210 132],454,3,26988,3.635726795096322,0.0,0.0
7423,0,7423,[302 603 427 313  64],537,4,26992,3.6357758620689653,20.0,0.0
7424,0,7424,[313 216 153 135 234],308,2,26994,3.6355555555555554,0.0,0.0
7425,0,7425,[215 185 597   8 322],328,1,26995,3.635200646377592,0.0,0.0
7426,0,7426,[289 125  98   7  11],374,3,26998,3.635115120506261,0.0,20.0
7427,0,7427,[301 568 323 313 603],90,4,27002,3.635164243403339,20.0,0.0
7428,0,7428,[ 97 603 173 197   4],666,5,27007,3.6353479606945753,20.0,0.0
7429,0,7429,[132  28 435 197  69],843,0,27007,3.6348586810228802,0.0,0.0
7430,0,7430,[294  50 405  70   7],374,2,27009,3.6346386758175213,0.0,20.0
7431,0,7431,[204  56 118 117 234],788,1,27010,3.6342841765339076,0.0,0.0
7432,0,7432,[216  89  82 748 318],648,3,27013,3.634198842997444,20.0,0.0
7433,0,7433,[ 25 210 191 215 143],194,1,27014,3.633844498251278,0.0,0.0
7434,0,7434,[238 127 211 161 196],387,3,27017,3.6337592468056488,0.0,20.0
7435,0,7435,[195 132 197 161 333],10,5,27022,3.633942980096826,0.0,0.0
7436,0,7436,[183   1  71  25 435],804,4,27026,3.63399220115638,0.0,0.0
7437,0,7437,[ 88 288 269 179 186],579,2,27028,3.633772519494488,0.0,0.0
7438,0,7438,[302 603 427 313  64],537,4,27032,3.6338217502352466,20.0,0.0
7439,0,7439,[302 603 427 313  64],669,5,27037,3.634005376344086,20.0,0.0
7440,0,7440,[328  22 271  69 282],334,2,27039,3.6337857814809835,0.0,0.0
7441,0,7441,[302 603 427 313  64],669,5,27044,3.6339693630744425,20.0,0.0
7442,0,7442,[302 603 427 313  64],13,5,27049,3.6341528953379014,20.0,0.0
7443,0,7443,[597 127 288 185 265],308,3,27052,3.6340677055346586,0.0,20.0
7444,0,7444,[100 180  50 300 265],479,3,27055,3.633982538616521,0.0,40.0
7445,0,7445,[273  96 132 515 200],234,3,27058,3.633897394574268,0.0,0.0
7446,0,7446,[515 597 748  70 172],882,4,27062,3.6339465556599975,0.0,0.0
7447,0,7447,[302 603 427 313  64],13,5,27067,3.6341299677765844,20.0,0.0
7448,0,7448,[181 172  71 423 403],378,5,27072,3.6343133306484092,0.0,0.0
7449,0,7449,[127 111 234 174 385],64,5,27077,3.634496644295302,0.0,40.0
7450,0,7450,[403 182 174 222  69],374,4,27081,3.6345456985639513,0.0,20.0
7451,0,7451,[302 603 427 313  64],474,5,27086,3.6347289318303813,20.0,0.0
7452,0,7452,[302 603 427 313  64],669,5,27091,3.6349121159264723,20.0,0.0
7453,0,7453,[238  89 475 204  50],479,4,27095,3.634961094714247,0.0,20.0
7454,0,7454,[302 603 427 313  64],90,5,27100,3.6351441985244803,20.0,0.0
7455,0,7455,[300  22 318 215 196],653,3,27103,3.6350590128755367,20.0,0.0
7456,0,7456,[302 603 427 313  64],13,5,27108,3.6352420544454875,20.0,0.0
7457,0,7457,[302 603 427 313  64],669,5,27113,3.6354250469294715,20.0,0.0
7458,0,7458,[ 95 301   4 111 200],334,1,27114,3.6350717254323635,0.0,0.0
7459,0,7459,[172 132 515 403  50],815,5,27119,3.635254691689008,0.0,20.0
7460,0,7460,[302 603 427 313  64],537,4,27123,3.6353035786087657,20.0,0.0
7461,0,7461,[181 655  71 546 132],7,4,27127,3.6353524524256233,0.0,0.0
7462,0,7462,[302 603 427 313  64],90,5,27132,3.635535307517084,20.0,0.0
7463,0,7463,[100  95   1 151 161],804,3,27135,3.635450160771704,0.0,20.0
7464,0,7464,[200 210   7 186 265],374,4,27139,3.6354989953114534,0.0,0.0
7465,0,7465,[186 678  88  97 117],881,1,27140,3.635145995178141,0.0,0.0
7466,0,7466,[302 603 427 313  64],454,5,27145,3.6353287799651803,20.0,0.0
7467,0,7467,[222 200  28 403 257],881,3,27148,3.6352437064809857,0.0,0.0
7468,0,7468,[ 25 196  15  82 318],892,4,27152,3.6352925425090374,20.0,0.0
7469,0,7469,[144 196 237  56 161],194,3,27155,3.6352074966532797,0.0,0.0
7470,0,7470,[302 603 427 313  64],669,5,27160,3.635390175344666,20.0,0.0
7471,0,7471,[357 168 275 181 237],537,3,27163,3.6353051391862956,20.0,0.0
7472,0,7472,[471  11  64 568 496],90,5,27168,3.6354877559213166,0.0,0.0
7473,0,7473,[132  98  56 228 183],313,3,27171,3.6354027294621356,0.0,20.0
7474,0,7474,[546   8 403 322   4],881,3,27174,3.6353177257525084,0.0,0.0
7475,0,7475,[318 471 100 185 191],666,5,27179,3.6355002675227395,20.0,20.0
7476,0,7476,[132 258 216 194 237],313,3,27182,3.6354152735054166,0.0,0.0
7477,0,7477,[180 181 144 234 179],659,3,27185,3.635330302219845,0.0,0.0
7478,0,7478,[  1 655 175  64  97],371,4,27189,3.6353790613718413,0.0,0.0
7479,0,7479,[302 603 427 313  64],90,5,27194,3.6355614973262034,20.0,0.0
7480,0,7480,[172 496 423 742 276],533,4,27198,3.6356102125384306,0.0,0.0
7481,0,7481,[174 111 179 496 118],524,4,27202,3.635658914728682,0.0,20.0
7482,0,7482,[151 195 176  71   1],882,5,27207,3.635841240144327,0.0,0.0
7483,0,7483,[271 168 471 268  25],119,5,27212,3.6360235168359165,0.0,0.0
7484,0,7484,[302 603 427 313  64],90,5,27217,3.636205744822979,20.0,0.0
7485,0,7485,[ 28  88 181  15 496],311,5,27222,3.6363879241250334,0.0,0.0
7486,0,7486,[597 269 275  12 118],378,4,27226,3.6364364899158543,20.0,0.0
7487,0,7487,[182 276   4  56 174],334,3,27229,3.6363514957264957,0.0,20.0
7488,0,7488,[302 603 427 313  64],90,5,27234,3.6365335825877954,20.0,0.0
7489,0,7489,[180  69  25 742 118],271,2,27236,3.6363150867823766,0.0,0.0
7490,0,7490,[ 28 496 135 568 125],7,5,27241,3.6364971298892,0.0,0.0
7491,0,7491,[135 127 271 173 194],749,5,27246,3.6366791243993593,0.0,20.0
7492,0,7492,[191  97 183 173 748],474,4,27250,3.6367276124382757,0.0,0.0
7493,0,7493,[204 144  96  11 181],295,4,27254,3.636776087536696,0.0,0.0
7494,0,7494,[186 216 191 200 423],749,5,27259,3.636957971981321,0.0,0.0
7495,0,7495,[197 144  89 100  56],343,4,27263,3.6370064034151546,0.0,20.0
7496,0,7496,[111 405  96 483 180],533,3,27266,3.636921435240763,20.0,0.0
7497,0,7497,[117 132 182  69  64],378,3,27269,3.636836489730595,0.0,0.0
7498,0,7498,[ 97 403 132 588 179],308,3,27272,3.636751566875583,0.0,0.0
7499,0,7499,[302 603 427 313  64],474,5,27277,3.6369333333333334,20.0,0.0
7500,0,7500,[302 603 427 313  64],474,5,27282,3.63711505132649,20.0,0.0
7501,0,7501,[ 96 215 182 172  69],537,1,27283,3.6367635297254064,0.0,0.0
7502,0,7502,[300  79 195 132 111],454,3,27286,3.636678661868586,0.0,0.0
7503,0,7503,[302 603 427 313  64],474,5,27291,3.636860341151386,20.0,0.0
7504,0,7504,[191  88 210 194  50],13,3,27294,3.6367754830113257,0.0,20.0
7505,0,7505,[195 546  11 182 202],653,1,27295,3.6364241939781508,0.0,0.0
7506,0,7506,[302 603 427 313  64],669,5,27300,3.6366058345544157,20.0,0.0
7507,0,7507,[302 603 427 313  64],537,4,27304,3.6366542354821525,20.0,0.0
7508,0,7508,[185 168 515 194 210],7,4,27308,3.6367026235184445,0.0,0.0
7509,0,7509,[182 301 289 475 179],458,3,27311,3.636617842876165,0.0,0.0
7510,0,7510,[194 185 210 403 515],883,4,27315,3.6366662228731195,0.0,0.0
7511,0,7511,[237 265 191 135 515],543,5,27320,3.6368477103301386,0.0,0.0
7512,0,7512,[302 603 427 313  64],537,4,27324,3.636896046852123,20.0,0.0
7513,0,7513,[568 588 265  95  50],290,4,27328,3.636944370508384,0.0,20.0
7514,0,7514,[318 173  69 191 228],387,3,27331,3.636859614105123,20.0,0.0
7515,0,7515,[286 173 265 333 475],537,2,27333,3.636641830761043,0.0,0.0
7516,0,7516,[313 234  22  25 151],200,4,27337,3.636690168950379,0.0,0.0
7517,0,7517,[ 70 144 204  56 211],328,4,27341,3.6367384942803938,0.0,0.0
7518,0,7518,[197  22 174 196 172],694,5,27346,3.6369198031653145,0.0,20.0
7519,0,7519,[222 153  89 174 483],77,5,27351,3.637101063829787,20.0,20.0
7520,0,7520,[117 186 185 405 179],524,2,27353,3.6368833931658022,0.0,0.0
7521,0,7521,[568 182  28 132 204],454,3,27356,3.636798723743685,0.0,0.0
7522,0,7522,[194 185 234 273 211],13,3,27359,3.6367140768310513,0.0,0.0
7523,0,7523,[302 603 427 313  64],669,5,27364,3.6368952684742157,20.0,0.0
7524,0,7524,[427 161 153   9  28],328,3,27367,3.636810631229236,0.0,0.0
7525,0,7525,[603 100 176 168 748],313,3,27370,3.636726016476216,20.0,20.0
7526,0,7526,[195 385  25 211  97],387,2,27372,3.636508569151056,0.0,0.0
7527,0,7527,[302 603 427 313  64],537,4,27376,3.636556854410202,20.0,0.0
7528,0,7528,[215 475 195 385 228],479,2,27378,3.6363394873157127,0.0,0.0
7529,0,7529,[302 603 427 313  64],474,5,27383,3.6365205843293493,20.0,0.0
7530,0,7530,[302 603 427 313  64],454,5,27388,3.6367016332492366,20.0,0.0
7531,0,7531,[ 11 179 300 191 211],90,4,27392,3.6367498672331386,0.0,0.0
7532,0,7532,[496 144 546 194 588],308,2,27394,3.636532589937608,0.0,0.0
7533,0,7533,[302 603 427 313  64],537,4,27398,3.636580833554553,20.0,0.0
7534,0,7534,[238 161  89 282 175],653,2,27400,3.6363636363636362,0.0,0.0
7535,0,7535,[435  79 194   7 289],524,4,27404,3.636411889596603,0.0,0.0
7536,0,7536,[ 79 515 222 273 588],387,4,27408,3.636460130025209,0.0,0.0
7537,0,7537,[515 135 168 180  71],60,4,27412,3.6365083576545505,0.0,0.0
7538,0,7538,[496 179 153 228 268],387,3,27415,3.6364239289030373,0.0,0.0
7539,0,7539,[ 70  11 294 153  56],234,0,27415,3.635941644562334,0.0,0.0
7540,0,7540,[179 655 323  98  71],13,3,27418,3.6358573133536667,0.0,20.0
7541,0,7541,[180 475 153 257 183],339,5,27423,3.636038186157518,0.0,0.0
7542,0,7542,[ 97 258 435 423 100],328,4,27427,3.6360864377568607,0.0,20.0
7543,0,7543,[265 276  25 228 286],194,1,27428,3.6357370095440085,0.0,0.0
7544,0,7544,[302 603 427 313 127],90,5,27433,3.6359178263750827,20.0,20.0
7545,0,7545,[302 603 427 313 127],334,5,27438,3.636098595282269,20.0,20.0
7546,0,7546,[ 96 385 204 323 286],378,4,27442,3.6361468133032995,0.0,0.0
7547,0,7547,[302 603 427 313 127],537,5,27447,3.6363275039745626,20.0,20.0
7548,0,7548,[173 100 195 144  12],13,3,27450,3.6362432110213274,20.0,20.0
7549,0,7549,[265 125 405 100 176],271,2,27452,3.636026490066225,0.0,20.0
7550,0,7550,[118 135 210 588  28],804,4,27456,3.6360746920937626,0.0,0.0
7551,0,7551,[302 603 427 313 127],537,5,27461,3.6362552966101696,20.0,20.0
7552,0,7552,[161 678 196 273 515],13,2,27463,3.636038660135046,0.0,0.0
7553,0,7553,[302 603 427 313 127],14,3,27466,3.6359544612126027,20.0,20.0
7554,0,7554,[302 603 427 313  64],454,5,27471,3.6361350099272007,20.0,0.0
7555,0,7555,[100 323 258 172 195],537,2,27473,3.635918475383801,0.0,20.0
7556,0,7556,[204 302  89 183  96],666,3,27476,3.6358343257906576,0.0,0.0
7557,0,7557,[271 294 175 237 289],92,2,27478,3.635617888330246,0.0,0.0
7558,0,7558,[423 748 238 385 568],804,4,27482,3.635666093398598,0.0,0.0
7559,0,7559,[302 603 427 313  64],90,5,27487,3.6358465608465607,20.0,0.0
7560,0,7560,[288 234   4 271 151],537,0,27487,3.635365692368734,0.0,0.0
7561,0,7561,[302 603 427 313  64],474,5,27492,3.63554615181169,20.0,0.0
7562,0,7562,[435 196 215  64  98],232,4,27496,3.6355943408700253,0.0,20.0
7563,0,7563,[302 603 427 313  64],13,5,27501,3.635774722369117,20.0,0.0
7564,0,7564,[237  22  97 204   9],378,5,27506,3.635955056179775,0.0,0.0
7565,0,7565,[187 127 282 238 286],85,3,27509,3.6358710018503833,0.0,20.0
7566,0,7566,[100  50 294  96 118],653,3,27512,3.635786969737016,0.0,40.0
7567,0,7567,[118 176 385  89 202],666,3,27515,3.635702959830867,0.0,0.0
7568,0,7568,[185  95 328  98 318],271,3,27518,3.635618972123134,20.0,20.0
7569,0,7569,[471 265 258 427   7],666,4,27522,3.635667107001321,0.0,0.0
7570,0,7570,[302 603 427 313  64],474,5,27527,3.6358473121120065,20.0,0.0
7571,0,7571,[357  82  11 301 182],328,2,27529,3.6356312731114633,20.0,0.0
7572,0,7572,[144 742 183 288 204],378,4,27533,3.635679387296976,0.0,0.0
7573,0,7573,[  7 183 300 172 174],7,5,27538,3.635859519408503,0.0,20.0
7574,0,7574,[ 22 234 197 174 475],343,4,27542,3.635907590759076,0.0,20.0
7575,0,7575,[357 282 294   7   4],144,4,27546,3.6359556494192184,20.0,0.0
7576,0,7576,[302 603 427 313  64],13,5,27551,3.636135673749505,20.0,0.0
7577,0,7577,[  4 228 132 180 135],194,1,27552,3.6357878068091845,0.0,0.0
7578,0,7578,[302 603 427 313  64],669,5,27557,3.6359678057791265,20.0,0.0
7579,0,7579,[  1 172 197 496 181],326,3,27560,3.6358839050131926,0.0,0.0
7580,0,7580,[ 12 313 357 508 228],59,5,27565,3.6360638438200765,40.0,0.0
7581,0,7581,[302 603 427 313  64],271,5,27570,3.6362437351622265,20.0,0.0
7582,0,7582,[385  79 191 197 194],452,5,27575,3.63642357905842,0.0,0.0
7583,0,7583,[ 71  79 742   1 173],42,5,27580,3.636603375527426,0.0,0.0
7584,0,7584,[ 98   7 273 216 603],145,5,27585,3.6367831245880025,20.0,20.0
7585,0,7585,[302 603 427 313  64],669,5,27590,3.6369628262588978,20.0,0.0
7586,0,7586,[678 546 182 475 568],339,3,27593,3.6368788717543166,0.0,0.0
7587,0,7587,[182  95  70 211 135],454,1,27594,3.6365313653136533,0.0,0.0
7588,0,7588,[302 603 427 313  64],90,5,27599,3.6367110291210962,20.0,0.0
7589,0,7589,[302 603 427 313  64],13,5,27604,3.636890645586298,20.0,0.0
7590,0,7590,[302 603 427 313  64],537,4,27608,3.6369384797786855,20.0,0.0
7591,0,7591,[328 185 282 175  12],207,2,27610,3.636722866174921,20.0,0.0
7592,0,7592,[265 322 100 216 172],311,4,27614,3.636770709864349,0.0,20.0
7593,0,7593,[302 603 427 313  64],537,4,27618,3.636818540953384,20.0,0.0
7594,0,7594,[172 423 202 483  98],454,1,27619,3.636471362738644,20.0,20.0
7595,0,7595,[ 50 403 597 588 515],804,3,27622,3.6363875724065298,0.0,20.0
7596,0,7596,[153 176 210 216 121],650,3,27625,3.6363038041332105,0.0,0.0
7597,0,7597,[215 403 258 182 568],533,3,27628,3.636220057909976,0.0,0.0
7598,0,7598,[302 603 427 313  64],669,5,27633,3.6363995262534545,20.0,0.0
7599,0,7599,[288 313 121  82 204],537,1,27634,3.636052631578947,0.0,0.0
7600,0,7600,[302 603 427 313  64],90,5,27639,3.6362320747270096,20.0,0.0
7601,0,7601,[195 153 176 179 238],650,4,27643,3.636279926335175,0.0,0.0
7602,0,7602,[222 215 294  98 195],378,2,27645,3.6360647112981717,0.0,20.0
7603,0,7603,[ 56 181 403 100 238],234,1,27646,3.635718043135192,0.0,20.0
7604,0,7604,[174 202  12 237 228],398,2,27648,3.6355029585798815,20.0,20.0
7605,0,7605,[ 28 655 215 151 179],59,5,27653,3.6356823560347094,0.0,0.0
7606,0,7606,[181  89 588 180 185],537,3,27656,3.6355987905876166,0.0,0.0
7607,0,7607,[302 603 427 313  64],669,5,27661,3.635778128286015,20.0,0.0
7608,0,7608,[216 496 483 238  22],538,5,27666,3.6359574188461035,20.0,0.0
7609,0,7609,[  9 195 234 508 210],474,4,27670,3.6360052562417873,0.0,0.0
7610,0,7610,[302 603 427 313  64],474,5,27675,3.6361844698462753,20.0,0.0
7611,0,7611,[127 588  79 289 546],458,3,27678,3.636100893326327,0.0,20.0
7612,0,7612,[100   1 405 385 323],488,1,27679,3.6357546302377513,0.0,20.0
7613,0,7613,[603 742  56 191 187],804,4,27683,3.6358024691358026,20.0,0.0
7614,0,7614,[302 603 427 313  64],454,5,27688,3.6359816152330926,20.0,0.0
7615,0,7615,[194 234  71 180 588],85,4,27692,3.636029411764706,0.0,0.0
7616,0,7616,[427 289 132  97 179],537,2,27694,3.6358146251805175,0.0,0.0
7617,0,7617,[ 95  25 235 216 282],92,1,27695,3.6354686269362038,0.0,0.0
7618,0,7618,[181   4 245 238 215],554,2,27697,3.6352539703373146,0.0,0.0
7619,0,7619,[603 273 508 143 168],643,4,27701,3.635301837270341,20.0,0.0
7620,0,7620,[222 174 194 403 111],158,4,27705,3.6353496916415167,0.0,20.0
7621,0,7621,[423 186 210 183 174],848,4,27709,3.635397533455786,0.0,20.0
7622,0,7622,[168 678 176 237 179],13,2,27711,3.6351829988193622,0.0,0.0
7623,0,7623,[313 161 172   7 200],378,4,27715,3.635230849947534,0.0,0.0
7624,0,7624,[ 70  64 435 144 588],7,4,27719,3.6352786885245902,0.0,0.0
7625,0,7625,[194 234 496 187  64],474,5,27724,3.6354576448990295,0.0,0.0
7626,0,7626,[ 25 238 357  71 265],308,4,27728,3.635505441195752,20.0,0.0
7627,0,7627,[ 70 174 603 269  22],537,2,27730,3.6352910330361823,20.0,20.0
7628,0,7628,[302 603 427 313  64],537,4,27734,3.635338838642024,20.0,0.0
7629,0,7629,[302 603 427 313 127],13,5,27739,3.6355176933158586,20.0,20.0
7630,0,7630,[  8  56 222 197 318],455,3,27742,3.635434412265758,20.0,0.0
7631,0,7631,[302 603 427 313 127],669,5,27747,3.63561320754717,20.0,20.0
7632,0,7632,[204 132 202  79 200],234,2,27749,3.63539892571728,0.0,0.0
7633,0,7633,[ 12   9 294 118 546],605,3,27752,3.6353156929525805,20.0,0.0
7634,0,7634,[191 176   9 568  22],343,4,27756,3.6353634577603144,0.0,0.0
7635,0,7635,[195 328 176 175 268],92,4,27760,3.635411210057622,0.0,0.0
7636,0,7636,[ 12 144 204 187  50],234,2,27762,3.6351970669110907,20.0,20.0
7637,0,7637,[302 603 427 313 127],14,3,27765,3.6351139041633935,20.0,20.0
7638,0,7638,[302 603 427 313  64],454,5,27770,3.6352925775625082,20.0,0.0
7639,0,7639,[ 70 135 748 405 257],653,2,27772,3.635078534031414,0.0,0.0
7640,0,7640,[216 258 238  79 385],7,5,27777,3.635257165292501,0.0,0.0
7641,0,7641,[385 234 322 183 173],749,4,27781,3.6353048940068047,0.0,0.0
7642,0,7642,[182 195  22  11 496],538,5,27786,3.635483448907497,0.0,0.0
7643,0,7643,[302 603 427 313  64],474,5,27791,3.6356619570905284,20.0,0.0
7644,0,7644,[302 603 427 313  64],474,5,27796,3.6358404185742317,20.0,0.0
7645,0,7645,[302 603 427 313  64],669,5,27801,3.636018833376929,20.0,0.0
7646,0,7646,[302 603 427 313  64],90,5,27806,3.636197201516935,20.0,0.0
7647,0,7647,[ 89 496   9  98 269],334,3,27809,3.6361140167364017,0.0,20.0
7648,0,7648,[  8 143 222  79  15],378,4,27813,3.6361615897502944,0.0,0.0
7649,0,7649,[302 603 427 313  64],454,5,27818,3.636339869281046,20.0,0.0
7650,0,7650,[180 294  82  50 269],666,2,27820,3.6361259966017516,0.0,20.0
7651,0,7651,[405 180 195 546  15],653,2,27822,3.635912179822269,0.0,0.0
7652,0,7652,[302 603 427 313  64],271,5,27827,3.63609042205671,20.0,0.0
7653,0,7653,[302 603 427 313  64],474,5,27832,3.636268617716227,20.0,0.0
7654,0,7654,[ 56 121  71  64 496],533,4,27836,3.636316133246244,0.0,0.0
7655,0,7655,[302 603 427 313  64],13,5,27841,3.6364942528735633,20.0,0.0
7656,0,7656,[ 50 228 515  12 127],339,5,27846,3.636672325976231,20.0,40.0
7657,0,7657,[ 50 176 435  97  95],271,4,27850,3.6367197701749805,0.0,20.0
7658,0,7658,[257 423 100 258 269],339,3,27853,3.6366366366366365,0.0,20.0
7659,0,7659,[ 64  97 318 333  82],653,4,27857,3.6366840731070496,20.0,0.0
7660,0,7660,[180  50 427 175 121],339,4,27861,3.636731497193578,0.0,20.0
7661,0,7661,[273  96 175   9 121],207,2,27863,3.636517880448969,0.0,0.0
7662,0,7662,[ 12 132  79 286 173],60,5,27868,3.6366958110400627,20.0,0.0
7663,0,7663,[194 168 568  82 475],343,4,27872,3.636743215031315,0.0,0.0
7664,0,7664,[597  28 135  56 235],374,4,27876,3.63679060665362,0.0,0.0
7665,0,7665,[204  79  15  82 228],653,4,27880,3.6368379859118183,0.0,0.0
7666,0,7666,[200 197 176 323  70],13,1,27881,3.6364940654754143,0.0,0.0
7667,0,7667,[302 603 427 313  64],271,5,27886,3.6366718831507563,20.0,0.0
7668,0,7668,[100  15  98 568 186],207,4,27890,3.636719259355848,0.0,40.0
7669,0,7669,[286 118 294 357 235],200,4,27894,3.636766623207301,20.0,0.0
7670,0,7670,[ 50   1 228  95 302],454,2,27896,3.6365532525094513,0.0,20.0
7671,0,7671,[135  28 202  11 174],387,3,27899,3.636470281543274,0.0,20.0
7672,0,7672,[216 183 357 385 135],328,2,27901,3.636257005082758,20.0,0.0
7673,0,7673,[302 603 427 313  64],669,5,27906,3.6364347146207976,20.0,0.0
7674,0,7674,[328 143 185  69   8],334,2,27908,3.6362214983713357,0.0,0.0
7675,0,7675,[211 289 210 174 405],271,4,27912,3.6362688900468996,0.0,20.0
7676,0,7676,[302 603 427 313  64],271,5,27917,3.636446528591898,20.0,0.0
7677,0,7677,[234  69 238 273 237],64,4,27921,3.6364938786142225,0.0,0.0
7678,0,7678,[302 603 427 313  64],271,5,27926,3.6366714415939576,20.0,0.0
7679,0,7679,[302 603 427 313  64],90,5,27931,3.636848958333333,20.0,0.0
7680,0,7680,[302 603 427 313  64],454,5,27936,3.63702642885041,20.0,0.0
7681,0,7681,[302 603 427 313  64],454,5,27941,3.6372038531632387,20.0,0.0
7682,0,7682,[195   7  12  88 282],92,4,27945,3.6372510737992974,20.0,0.0
7683,0,7683,[ 64 194 423   1 568],537,0,27945,3.6367777199375326,0.0,0.0
7684,0,7684,[302 603 427 313  64],669,5,27950,3.6369551073519846,20.0,0.0
7685,0,7685,[ 50  22 313 275  88],184,3,27953,3.636872235232891,0.0,20.0
7686,0,7686,[405   1 143 276  28],406,2,27955,3.6366592949134904,0.0,0.0
7687,0,7687,[ 88 228 313 258 161],102,2,27957,3.636446409989594,0.0,0.0
7688,0,7688,[496 121 180 127   9],533,4,27961,3.636493692287684,0.0,20.0
7689,0,7689,[302 603 427 313  64],13,5,27966,3.6366710013003902,20.0,0.0
7690,0,7690,[ 97 234 603  56 168],308,3,27969,3.6365882199973996,20.0,0.0
7691,0,7691,[125  69 186  12 187],892,4,27973,3.6366354654186166,20.0,0.0
7692,0,7692,[318  69 323 515 125],59,4,27977,3.63668269855713,20.0,0.0
7693,0,7693,[302 603 427 313  64],669,5,27982,3.636859890824019,20.0,0.0
7694,0,7694,[194 655 597 286 475],144,4,27986,3.636907082521118,0.0,0.0
7695,0,7695,[508 568 215 191   9],59,5,27991,3.6370841995841996,0.0,0.0
7696,0,7696,[180   1 168 216  79],881,4,27995,3.6371313498765754,0.0,0.0
7697,0,7697,[273 175  97  95   8],479,4,27999,3.63717848791894,0.0,0.0
7698,0,7698,[289 181  98 202  25],374,2,28001,3.636965839719444,0.0,20.0
7699,0,7699,[302 603 427 313  64],454,5,28006,3.637142857142857,20.0,0.0
7700,0,7700,[405 183 216 357  28],882,5,28011,3.637319828593689,20.0,0.0
7701,0,7701,[ 25  88 187 333 515],537,2,28013,3.637107244871462,0.0,0.0
7702,0,7702,[100 265 302 186 153],207,3,28016,3.637024535895106,0.0,20.0
7703,0,7703,[ 28 183 276 237  97],378,5,28021,3.637201453790239,0.0,0.0
7704,0,7704,[302 603 427 313  64],669,5,28026,3.637378325762492,20.0,0.0
7705,0,7705,[ 50 118  28  15   1],479,3,28029,3.6372956138074226,0.0,20.0
7706,0,7706,[302 603 427 313  64],474,5,28034,3.6374724276631634,20.0,0.0
7707,0,7707,[273 143  89 153 132],892,4,28038,3.637519460300986,0.0,0.0
7708,0,7708,[302 603 427 313  64],454,5,28043,3.6376961992476327,20.0,0.0
7709,0,7709,[302 603 427 313  64],90,5,28048,3.6378728923476005,20.0,0.0
7710,0,7710,[182 143 168  79 275],308,5,28053,3.6380495396187267,0.0,0.0
7711,0,7711,[210 200  22 258 151],479,5,28058,3.6382261410788383,0.0,0.0
7712,0,7712,[302 603 427 313  64],271,5,28063,3.638402696745754,20.0,0.0
7713,0,7713,[ 56 302 195 427 202],6,4,28067,3.638449572206378,0.0,0.0
7714,0,7714,[175 742 282 483 196],207,4,28071,3.63849643551523,20.0,0.0
7715,0,7715,[302 603 427 313  64],454,5,28076,3.63867288750648,20.0,0.0
7716,0,7716,[  4  98  69 180  64],524,3,28079,3.6385901256965143,0.0,20.0
7717,0,7717,[174 588 258 496 215],85,4,28083,3.638636952578388,0.0,20.0
7718,0,7718,[211 176  69 135 204],60,5,28088,3.638813317787278,0.0,0.0
7719,0,7719,[ 97 318  11  96 176],59,5,28093,3.6389896373056994,20.0,0.0
7720,0,7720,[655 125 161  12 323],59,3,28096,3.6389068773474937,20.0,0.0
7721,0,7721,[302 603 427 313  64],454,5,28101,3.639083139083139,20.0,0.0
7722,0,7722,[302 210 508  50 238],13,2,28103,3.6388709050886963,0.0,20.0
7723,0,7723,[302 603 427 313  64],669,5,28108,3.639047125841533,20.0,0.0
7724,0,7724,[302 603 427 313  64],90,5,28113,3.639223300970874,20.0,0.0
7725,0,7725,[ 97 301 175 197 132],234,2,28115,3.6390111312451463,0.0,0.0
7726,0,7726,[204 300 135 111  97],13,4,28119,3.6390578491005563,0.0,0.0
7727,0,7727,[427 288 179 238 318],458,4,28123,3.6391045548654244,20.0,0.0
7728,0,7728,[302 603 427 313  64],537,4,28127,3.639151248544443,20.0,0.0
7729,0,7729,[282 144  28   9 215],328,3,28130,3.6390685640362226,0.0,0.0
7730,0,7730,[435  71 143 215 173],892,3,28133,3.6389859009183807,0.0,0.0
7731,0,7731,[286 597   8 568 275],455,4,28137,3.6390325918261768,0.0,0.0
7732,0,7732,[135 186 403  79  22],343,5,28142,3.6392085865770074,0.0,0.0
7733,0,7733,[200 121 195 546 603],145,3,28145,3.639125937419188,20.0,0.0
7734,0,7734,[ 98 211 403  56   7],648,3,28148,3.639043309631545,0.0,20.0
7735,0,7735,[ 56 435  69 194 427],313,4,28152,3.639089968976215,0.0,0.0
7736,0,7736,[117 210 132 216 176],346,4,28156,3.639136616259532,0.0,0.0
7737,0,7737,[187 186 200 742 273],328,4,28160,3.639183251486172,0.0,0.0
7738,0,7738,[515 222  50 655 257],92,4,28164,3.639229874660809,0.0,20.0
7739,0,7739,[302 603 427 313  64],537,4,28168,3.639276485788114,20.0,0.0
7740,0,7740,[132 211 181 265 200],650,5,28173,3.6394522671489473,0.0,0.0
7741,0,7741,[515 161 271 546 185],102,0,28173,3.6389821751485405,0.0,0.0
7742,0,7742,[ 22 265 282 173 186],474,5,28178,3.63915794911533,0.0,0.0
7743,0,7743,[200 195  79 275 135],328,3,28181,3.6390754132231407,0.0,0.0
7744,0,7744,[135  88 568 403 318],774,0,28181,3.6386055519690124,20.0,0.0
7745,0,7745,[302 603 427 313  50],454,5,28186,3.638781306480764,20.0,20.0
7746,0,7746,[216 197  25 288 196],13,2,28188,3.6385697689428165,0.0,0.0
7747,0,7747,[313   7 234 172 161],474,5,28193,3.638745482705214,0.0,0.0
7748,0,7748,[302 603 427 313  50],13,5,28198,3.638921151116273,20.0,20.0
7749,0,7749,[187 211 204  69 179],13,4,28202,3.638967741935484,0.0,0.0
7750,0,7750,[322 405 273 258 508],825,5,28207,3.6391433363436976,0.0,0.0
7751,0,7751,[302 603 427 313  50],13,5,28212,3.6393188854489162,20.0,20.0
7752,0,7752,[302 603 427 313  50],14,4,28216,3.639365406939249,20.0,20.0
7753,0,7753,[ 82 182  64 588  96],840,3,28219,3.6392829507351045,0.0,0.0
7754,0,7754,[748 234 187 588 235],64,4,28223,3.6393294648613796,0.0,0.0
7755,0,7755,[302 603 427 313  50],14,4,28227,3.6393759669932955,20.0,20.0
7756,0,7756,[678 269 181  28  88],13,3,28230,3.6392935413175196,0.0,0.0
7757,0,7757,[405 176  50  64 132],60,5,28235,3.639468935292601,0.0,20.0
7758,0,7758,[215 132 597 237 195],378,3,28238,3.6393865188812993,0.0,0.0
7759,0,7759,[238 168 483 196 202],537,3,28241,3.6393041237113404,20.0,0.0
7760,0,7760,[  1  88 153  50 588],298,4,28245,3.6393505991495942,0.0,20.0
7761,0,7761,[302 603 427 313  50],474,5,28250,3.6395258953877865,20.0,20.0
7762,0,7762,[ 96 471 151 195   4],788,0,28250,3.6390570655674352,0.0,0.0
7763,0,7763,[302 603 427 313  50],454,5,28255,3.6392323544564658,20.0,20.0
7764,0,7764,[195 276 403 135 151],378,2,28257,3.6390212491951064,0.0,0.0
7765,0,7765,[238 194 276 269 258],343,5,28262,3.639196497553438,0.0,0.0
7766,0,7766,[302 603 427 313  50],669,5,28267,3.639371700785374,20.0,20.0
7767,0,7767,[185 234   9  11  88],881,2,28269,3.639160659114315,0.0,0.0
7768,0,7768,[ 82 237 289 288 215],533,2,28271,3.638949671772429,0.0,0.0
7769,0,7769,[153   1  95 268 288],13,3,28274,3.6388674388674387,0.0,0.0
7770,0,7770,[546 180 405 182 216],328,2,28276,3.6386565435593874,0.0,0.0
7771,0,7771,[237 174 508  82  98],59,4,28280,3.638703036541431,0.0,40.0
7772,0,7772,[302 603 427 313  50],537,5,28285,3.6388781680174964,20.0,20.0
7773,0,7773,[121 318 182  64 200],308,4,28289,3.6389246205299717,20.0,0.0
7774,0,7774,[ 70 125 294 185  96],42,4,28293,3.6389710610932475,0.0,0.0
7775,0,7775,[ 22  28 175 211 111],537,2,28295,3.6387602880658436,0.0,0.0
7776,0,7776,[175 176 508  25 475],537,3,28298,3.638678153529639,0.0,0.0
7777,0,7777,[302 603 427 313  50],14,4,28302,3.6387246078683466,20.0,20.0
7778,0,7778,[  1 496 234  71 357],59,3,28305,3.638642499035866,20.0,0.0
7779,0,7779,[302 603 427 313  50],474,5,28310,3.638817480719794,20.0,20.0
7780,0,7780,[302 603 427 313  50],454,5,28315,3.638992417427066,20.0,20.0
7781,0,7781,[ 69 135  95 118 423],524,3,28318,3.638910305833976,0.0,0.0
7782,0,7782,[168 289 174 161 211],95,2,28320,3.638699730181164,0.0,20.0
7783,0,7783,[302 603 427 313  50],669,5,28325,3.638874614594039,20.0,20.0
7784,0,7784,[194  28  64   9 294],378,4,28329,3.638921001926782,0.0,0.0
7785,0,7785,[127 546 182 100  15],653,2,28331,3.638710506036476,0.0,40.0
7786,0,7786,[302 603 427 313  50],474,5,28336,3.638885321689996,20.0,20.0
7787,0,7787,[301 385 215 568 603],13,2,28338,3.6386748844375965,20.0,0.0
7788,0,7788,[302 603 427 313  50],334,5,28343,3.638849659776608,20.0,20.0
7789,0,7789,[302 603 427 313  50],474,5,28348,3.6390243902439026,20.0,20.0
7790,0,7790,[ 12 179   7 258  64],234,1,28349,3.638685662944423,20.0,0.0
7791,0,7791,[185  70 228 318  89],374,3,28352,3.6386036960985626,20.0,0.0
7792,0,7792,[186 118  70  50 546],882,3,28355,3.638521750288721,0.0,20.0
7793,0,7793,[172 318 597 302 294],788,2,28357,3.638311521683346,20.0,0.0
7794,0,7794,[322 172 423   4 328],328,3,28360,3.6382296343810134,0.0,0.0
7795,0,7795,[174 323 194 385  97],90,4,28364,3.638276038994356,0.0,20.0
7796,0,7796,[302 603 427 313  50],271,5,28369,3.638450686161344,20.0,20.0
7797,0,7797,[302 603 427 313  50],334,5,28374,3.638625288535522,20.0,20.0
7798,0,7798,[301 182  11 286 471],666,5,28379,3.6387998461341198,0.0,0.0
7799,0,7799,[302 603 427 313  50],14,4,28383,3.638846153846154,20.0,20.0
7800,0,7800,[111 423 174 405 173],524,4,28387,3.6388924496859376,0.0,20.0
7801,0,7801,[ 95 182  88   4 185],308,5,28392,3.639066905921559,0.0,0.0
7802,0,7802,[ 56 678  69 471 275],7,4,28396,3.639113161604511,0.0,0.0
7803,0,7803,[176  95  50 286 121],479,4,28400,3.6391594054331113,0.0,20.0
7804,0,7804,[268 151 132 238 200],7,4,28404,3.6392056374119153,0.0,0.0
7805,0,7805,[202 179  11 185 194],897,2,28406,3.638995644376121,0.0,0.0
7806,0,7806,[173 202 228 216 182],374,3,28409,3.6389137953118995,0.0,0.0
7807,0,7807,[ 88  82 179 117 435],339,4,28413,3.6389600409836067,0.0,0.0
7808,0,7808,[151 471 427 568 273],308,3,28416,3.638878217441414,0.0,0.0
7809,0,7809,[597 204 117 200 678],308,2,28418,3.6386683738796415,0.0,0.0
7810,0,7810,[176 125 180 237 187],749,3,28421,3.6385866086288567,0.0,0.0
7811,0,7811,[318 100 385 143 182],64,5,28426,3.6387608806963647,20.0,20.0
7812,0,7812,[302 603 427 313  50],474,5,28431,3.638935108153078,20.0,20.0
7813,0,7813,[302 603 427 313  50],474,5,28436,3.639109291016125,20.0,20.0
7814,0,7814,[300 100 435 423 588],64,4,28440,3.6391554702495204,0.0,20.0
7815,0,7815,[302 603 427 313  50],14,4,28444,3.6392016376663254,20.0,20.0
7816,0,7816,[161 234  70 216 202],804,5,28449,3.6393757195855185,0.0,0.0
7817,0,7817,[286 301 200 191 289],940,1,28450,3.6390381171655153,0.0,0.0
7818,0,7818,[ 89 427 172 508 268],13,4,28454,3.639084281877478,0.0,0.0
7819,0,7819,[  9  64  97 204   1],380,1,28455,3.6387468030690537,0.0,0.0
7820,0,7820,[302 603 427 313  50],13,5,28460,3.6389208541107276,20.0,20.0
7821,0,7821,[302 603 427 313  50],537,5,28465,3.6390948606494504,20.0,20.0
7822,0,7822,[302 603 427 313  50],334,5,28470,3.639268822702288,20.0,20.0
7823,0,7823,[117   1 161 144 127],339,2,28472,3.6390593047034763,0.0,20.0
7824,0,7824,[ 12 322 269 323  50],883,4,28476,3.639105431309904,20.0,20.0
7825,0,7825,[191  96 238  25 496],666,3,28479,3.6390237669307437,0.0,0.0
7826,0,7826,[568 197 161 655 175],95,4,28483,3.6390698862910438,0.0,0.0
7827,0,7827,[127 121 234  70 258],311,5,28488,3.6392437404190088,0.0,20.0
7828,0,7828,[ 88  28 174  97 318],694,5,28493,3.639417550134117,20.0,20.0
7829,0,7829,[194 655 215 121 187],311,5,28498,3.6395913154533845,0.0,0.0
7830,0,7830,[302 603 427 313  50],14,4,28502,3.639637338781765,20.0,20.0
7831,0,7831,[268 204 191  12 215],537,2,28504,3.6394279877425944,20.0,0.0
7832,0,7832,[ 56  70  88 172 194],60,5,28509,3.639601685178093,0.0,0.0
7833,0,7833,[117 273  69 195 357],643,2,28511,3.6393923921368394,20.0,0.0
7834,0,7834,[302 603 427 313  50],14,4,28515,3.6394384173580088,20.0,20.0
7835,0,7835,[117 173   4 168 200],738,2,28517,3.6392291985706993,0.0,0.0
7836,0,7836,[302 603 427 313  50],271,5,28522,3.6394028327166006,20.0,20.0
7837,0,7837,[568 515 187  15  50],311,5,28527,3.639576422556775,0.0,20.0
7838,0,7838,[118  71 597  12 655],788,1,28528,3.6392396989411915,20.0,0.0
7839,0,7839,[302 603 427 313  50],334,5,28533,3.6394132653061226,20.0,20.0
7840,0,7840,[187 435   4 210  12],666,4,28537,3.639459252646346,20.0,0.0
7841,0,7841,[182 301 238 603 258],13,3,28540,3.6393777097679165,20.0,0.0
7842,0,7842,[603 180   8  11 187],13,4,28544,3.6394236899145733,20.0,0.0
7843,0,7843,[ 56 211 302 235 282],328,3,28547,3.63934217236104,0.0,0.0
7844,0,7844,[302 603 427 313  50],669,5,28552,3.639515615041428,20.0,20.0
7845,0,7845,[132 144 235 496 245],313,3,28555,3.639434106551109,0.0,0.0
7846,0,7846,[603  11 173  89 202],387,3,28558,3.6393526188352237,20.0,0.0
7847,0,7847,[172 135  82 742 161],378,4,28562,3.6393985728848115,0.0,0.0
7848,0,7848,[ 12 265 176  25 300],271,2,28564,3.639189705694993,20.0,0.0
7849,0,7849,[ 12 187 179 186 175],339,5,28569,3.6393630573248408,20.0,0.0
7850,0,7850,[ 15 385  98 151  88],378,4,28573,3.6394089924850337,0.0,20.0
7851,0,7851,[ 50 182  79 125 276],234,1,28574,3.6390728476821192,0.0,20.0
7852,0,7852,[302 603 427 313  50],334,5,28579,3.639246147968929,20.0,20.0
7853,0,7853,[183 235  70 301 117],334,1,28580,3.6389101094983447,0.0,0.0
7854,0,7854,[302 603 427 313  50],537,5,28585,3.639083386378103,20.0,20.0
7855,0,7855,[ 70 172 289  50  98],378,5,28590,3.6392566191446027,0.0,40.0
7856,0,7856,[302 603 427 313  50],334,5,28595,3.6394298078146874,20.0,20.0
7857,0,7857,[286 300 181 271  56],537,1,28596,3.639093917027233,0.0,0.0
7858,0,7858,[ 71 237  28 588  64],194,4,28600,3.6391398396742587,0.0,0.0
7859,0,7859,[202 161  25 257 197],533,5,28605,3.6393129770992365,0.0,0.0
7860,0,7860,[655  97 168 176 211],506,5,28610,3.6394860704744945,0.0,0.0
7861,0,7861,[ 50 135 588  79  98],536,4,28614,3.6395319257186465,0.0,40.0
7862,0,7862,[302 603 427 313  50],334,5,28619,3.6397049472211624,20.0,20.0
7863,0,7863,[302 603 427 313  50],334,5,28624,3.639877924720244,20.0,20.0
7864,0,7864,[135  56 161  82 194],653,4,28628,3.6399237126509854,0.0,0.0
7865,0,7865,[202 153 144  64 333],387,1,28629,3.639588100686499,0.0,0.0
7866,0,7866,[153 301  89 515 204],234,1,28630,3.6392525740434727,0.0,0.0
7867,0,7867,[ 28 195 176 187  11],538,4,28634,3.6392984239959327,0.0,0.0
7868,0,7868,[ 95 144 294 186 423],92,2,28636,3.639090100393951,0.0,0.0
7869,0,7869,[186 546 286  79 172],95,4,28640,3.639135959339263,0.0,0.0
7870,0,7870,[127 515   7 257 197],343,4,28644,3.63918180663194,0.0,20.0
7871,0,7871,[302 603 427 313  50],334,5,28649,3.639354674796748,20.0,20.0
7872,0,7872,[258 515  11 200 265],59,4,28653,3.6394004826622632,0.0,0.0
7873,0,7873,[515 176 151  70  96],59,4,28657,3.639446278892558,0.0,0.0
7874,0,7874,[302 603 427 313  50],474,5,28662,3.6396190476190475,20.0,20.0
7875,0,7875,[302 603 427 313  50],13,5,28667,3.6397917724733366,20.0,20.0
7876,0,7876,[302 603 427 313  50],13,5,28672,3.639964453472134,20.0,20.0
7877,0,7877,[173  82 135 176  98],60,4,28676,3.64001015486164,0.0,20.0
7878,0,7878,[135 179 182 234 168],840,5,28681,3.640182764310192,0.0,0.0
7879,0,7879,[194 187 496 195 222],892,5,28686,3.6403553299492386,0.0,0.0
7880,0,7880,[191 168 210 174 215],488,4,28690,3.6404009643446265,0.0,20.0
7881,0,7881,[268 100   7 269  15],145,4,28694,3.640446587160619,0.0,20.0
7882,0,7882,[135 181  28 313 228],653,5,28699,3.640619053659774,0.0,0.0
7883,0,7883,[302 603 427 313  50],14,4,28703,3.6406646372399796,20.0,20.0
7884,0,7884,[302 603 427 313  50],334,5,28708,3.6408370323398858,20.0,20.0
7885,0,7885,[144 222 121 271  96],158,4,28712,3.640882576718235,0.0,0.0
7886,0,7886,[302 603 427 313  50],271,5,28717,3.6410549004691264,20.0,20.0
7887,0,7887,[302 603 427 313  50],334,5,28722,3.6412271805273835,20.0,20.0
7888,0,7888,[302 603 427 313  50],14,4,28726,3.6412726581315757,20.0,20.0
7889,0,7889,[302 603 427 313  50],334,5,28731,3.641444866920152,20.0,20.0
7890,0,7890,[286 125 515  82 268],7,2,28733,3.6412368521099987,0.0,0.0
7891,0,7891,[423 196  28 204 238],59,5,28738,3.641409021794222,0.0,0.0
7892,0,7892,[228 385 187 546  69],749,2,28740,3.6412010642341315,0.0,0.0
7893,0,7893,[515  69  96 144 289],13,3,28743,3.641119837851533,0.0,0.0
7894,0,7894,[294  25 222 172 269],13,1,28744,3.640785307156428,0.0,0.0
7895,0,7895,[ 69 405 197  79 191],524,4,28748,3.6408308004052685,0.0,0.0
7896,0,7896,[143 179 333 118 176],666,2,28750,3.6406230214005317,0.0,0.0
7897,0,7897,[269  89  28 168  96],13,4,28754,3.6406685236768803,0.0,0.0
7898,0,7898,[100 204 144  82 385],643,2,28756,3.640460817825041,0.0,20.0
7899,0,7899,[211  12 588 435 228],59,4,28760,3.640506329113924,20.0,0.0
7900,0,7900,[197 182 234 127  96],664,3,28763,3.640425262624984,0.0,20.0
7901,0,7901,[183 174 515   4  88],308,4,28767,3.640470766894457,0.0,20.0
7902,0,7902,[313  22 405   1 185],13,2,28769,3.6402631911932177,0.0,0.0
7903,0,7903,[282 111 183 197 168],374,3,28772,3.6401821862348176,0.0,0.0
7904,0,7904,[176 182 603 496 175],527,3,28775,3.640101201771031,20.0,0.0
7905,0,7905,[302 603 427 313  50],334,5,28780,3.640273210220086,20.0,20.0
7906,0,7906,[302 603 427 313  50],13,5,28785,3.6404451751612497,20.0,20.0
7907,0,7907,[323 197 204 200  25],804,4,28789,3.640490642387456,0.0,0.0
7908,0,7908,[257 235 357 471 197],343,4,28793,3.6405360981160704,20.0,0.0
7909,0,7909,[ 64 546 168 182 121],313,4,28797,3.640581542351454,0.0,0.0
7910,0,7910,[176   1 228 182 282],653,2,28799,3.6403741625584627,0.0,0.0
7911,0,7911,[302 603 427 313  50],334,5,28804,3.6405460060667343,20.0,20.0
7912,0,7912,[265 172 257 496 117],95,4,28808,3.640591431821054,0.0,0.0
7913,0,7913,[302 603 427 313  50],271,5,28813,3.640763204447814,20.0,20.0
7914,0,7914,[515 742  69 313 204],328,4,28817,3.6408085912823753,0.0,0.0
7915,0,7915,[302 603 427 313  50],669,5,28822,3.6409802930773116,20.0,20.0
7916,0,7916,[294 234 483 228 179],234,2,28824,3.640773020083365,20.0,0.0
7917,0,7917,[ 96   8 175 121 144],60,4,28828,3.64081838848194,0.0,0.0
7918,0,7918,[ 28 161 200 180 435],380,2,28830,3.6406111882813486,0.0,0.0
7919,0,7919,[318 185  50   1 748],311,4,28834,3.6406565656565655,20.0,20.0
7920,0,7920,[161  22   1  88 194],830,5,28839,3.6408281782603207,0.0,0.0
7921,0,7921,[302 603 427 313  50],474,5,28844,3.6409997475385003,20.0,20.0
7922,0,7922,[258 475 286   9 174],90,3,28847,3.6409188438722704,0.0,20.0
7923,0,7923,[678 194  50 183 144],387,2,28849,3.6407117617364966,0.0,20.0
7924,0,7924,[181 471  50 127 300],328,4,28853,3.640757097791798,0.0,40.0
7925,0,7925,[ 64 210 289 180 202],13,3,28856,3.6406762553620995,0.0,0.0
7926,0,7926,[302 603 427 313  50],271,5,28861,3.6408477355872333,20.0,20.0
7927,0,7927,[200  97  95  71 288],378,3,28864,3.6407669021190716,0.0,0.0
7928,0,7928,[161 195   4 100 234],833,2,28866,3.640559969731366,0.0,20.0
7929,0,7929,[302 603 427 313  50],537,5,28871,3.6407313997477933,20.0,20.0
7930,0,7930,[302 603 427 313  50],537,5,28876,3.6409027865338546,20.0,20.0
7931,0,7931,[302 603 427 313  50],669,5,28881,3.6410741301059,20.0,20.0
7932,0,7932,[181  64 496 748 238],125,3,28884,3.640993319047019,0.0,0.0
7933,0,7933,[185 127 742 210 176],308,5,28889,3.6411646080161333,0.0,20.0
7934,0,7934,[ 89 117  98 275 265],334,3,28892,3.641083805923125,0.0,20.0
7935,0,7935,[302 603 427 313  50],271,5,28897,3.6412550403225805,20.0,20.0
7936,0,7936,[187  56 655 173 143],643,5,28902,3.6414262315736425,0.0,0.0
7937,0,7937,[168 210 200 176 186],890,4,28906,3.6414714033761655,0.0,0.0
7938,0,7938,[216 143 197 237 318],308,2,28908,3.641264642902129,20.0,0.0
7939,0,7939,[135   7  89 546 568],92,3,28911,3.641183879093199,0.0,0.0
7940,0,7940,[ 98 222 194 234 180],524,3,28914,3.641103135625236,0.0,20.0
7941,0,7941,[  4  97 405 194 234],7,4,28918,3.6411483253588517,0.0,0.0
7942,0,7942,[173 302   4 423 125],378,3,28921,3.6410676066977214,0.0,0.0
7943,0,7943,[202  89  88  96  97],13,5,28926,3.641238670694864,0.0,0.0
7944,0,7944,[302 603 427 313  50],271,5,28931,3.641409691629956,20.0,20.0
7945,0,7945,[ 22 216 405 161 183],92,1,28932,3.6410772715831867,0.0,0.0
7946,0,7946,[435 186 127 234 196],406,3,28935,3.6409966024915064,0.0,20.0
7947,0,7947,[132 197 265 496 215],533,4,28939,3.6410417715148466,0.0,0.0
7948,0,7948,[302 603 427 313  50],14,4,28943,3.641086929173481,20.0,20.0
7949,0,7949,[121 234  82 151 265],60,4,28947,3.641132075471698,0.0,0.0
7950,0,7950,[258 135  64 176 186],380,1,28948,3.640799899383725,0.0,0.0
7951,0,7951,[ 89 185 403 186 300],774,0,28948,3.6403420523138834,0.0,0.0
7952,0,7952,[515 143 237 161  28],804,4,28952,3.640387275242047,0.0,0.0
7953,0,7953,[  8 678 194 286 204],213,3,28955,3.640306763892381,0.0,0.0
7954,0,7954,[318 678  79  96 234],488,3,28958,3.640226272784412,20.0,0.0
7955,0,7955,[588   1 496   9 405],200,4,28962,3.6402714932126696,0.0,0.0
7956,0,7956,[302 603 427 313  50],334,5,28967,3.6404423777805706,20.0,20.0
7957,0,7957,[117 182  11 153 294],13,2,28969,3.6402362402613724,0.0,0.0
7958,0,7958,[121 127 313 161 182],650,1,28970,3.639904510616912,0.0,20.0
7959,0,7959,[ 28 127  70 300   8],479,4,28974,3.6399497487437187,0.0,20.0
7960,0,7960,[748 318 471 168 183],92,3,28977,3.6398693631453334,20.0,0.0
7961,0,7961,[435 234 144 568 228],648,5,28982,3.640040190906807,0.0,0.0
7962,0,7962,[135   8 322 273  97],328,0,28982,3.6395830717066433,0.0,0.0
7963,0,7963,[302 603 427 313  50],669,5,28987,3.6397538925163233,20.0,20.0
7964,0,7964,[302 603 427 313  50],537,5,28992,3.639924670433145,20.0,20.0
7965,0,7965,[153 216 235 258   4],328,1,28993,3.6395932714034647,0.0,0.0
7966,0,7966,[313 173 153 186 135],659,3,28996,3.639512991088239,0.0,0.0
7967,0,7967,[302 603 427 313  50],537,5,29001,3.639683734939759,20.0,20.0
7968,0,7968,[302 603 427 313  50],454,5,29006,3.639854435939265,20.0,20.0
7969,0,7969,[302 603 427 313  50],271,5,29011,3.640025094102886,20.0,20.0
7970,0,7970,[257 161  79 655  56],92,3,29014,3.639944799899636,0.0,0.0
7971,0,7971,[258  64 197  56 135],13,5,29019,3.640115403913698,0.0,0.0
7972,0,7972,[ 56   7  98 515 678],13,2,29021,3.6399096952213723,0.0,20.0
7973,0,7973,[210 121 237  22 186],95,4,29025,3.639954853273138,0.0,0.0
7974,0,7974,[302 603 427 313  50],14,4,29029,3.64,20.0,20.0
7975,0,7975,[318 294 144  15 180],207,2,29031,3.6397943831494484,20.0,0.0
7976,0,7976,[302 603 427 313  50],271,5,29036,3.639964899084869,20.0,20.0
7977,0,7977,[228 742 289 172 153],387,3,29039,3.639884682877914,0.0,0.0
7978,0,7978,[471 132 186 234 173],474,4,29043,3.639929815766387,0.0,0.0
7979,0,7979,[302 603 427 313  50],271,5,29048,3.6401002506265665,20.0,20.0
7980,0,7980,[211 403 182 179 210],325,1,29049,3.639769452449568,0.0,0.0
7981,0,7981,[237 100  11 187 742],749,2,29051,3.6395640190428464,0.0,20.0
7982,0,7982,[302 603 427 313  50],454,5,29056,3.6397344356758112,20.0,20.0
7983,0,7983,[302 603 427 313  50],14,4,29060,3.6397795591182365,20.0,20.0
7984,0,7984,[655 357  82 143 121],804,4,29064,3.63982467125861,20.0,0.0
7985,0,7985,[302 603 427 313  50],271,5,29069,3.6399949912346607,20.0,20.0
7986,0,7986,[204 235 118   4   7],87,4,29073,3.640040065105797,0.0,0.0
7987,0,7987,[588 161  22  12 144],13,5,29078,3.64021031547321,20.0,0.0
7988,0,7988,[ 98  28  79 183  25],339,5,29083,3.640380523219427,0.0,20.0
7989,0,7989,[186 194   4 182 678],308,4,29087,3.6404255319148935,0.0,0.0
7990,0,7990,[302 603 427 313  50],13,5,29092,3.640595670128895,20.0,20.0
7991,0,7991,[174  69  82  89 385],488,5,29097,3.640765765765766,0.0,20.0
7992,0,7992,[ 82 179 180 748 121],207,1,29098,3.6404353809583387,0.0,0.0
7993,0,7993,[423 117 276  70 202],537,2,29100,3.640230172629472,0.0,0.0
7994,0,7994,[302  15  56  79 269],537,2,29102,3.6400250156347718,0.0,0.0
7995,0,7995,[603 191 483 323  96],669,1,29103,3.639694847423712,40.0,0.0
7996,0,7996,[302 603 427 313  50],537,5,29108,3.6398649493560087,20.0,20.0
7997,0,7997,[ 50 423 200  28 176],234,4,29112,3.6399099774943737,0.0,20.0
7998,0,7998,[175 180 357 238 174],95,4,29116,3.6399549943742966,20.0,20.0
7999,0,7999,[176  89  79 194  56],643,4,29120,3.64,0.0,0.0
8000,0,8000,[185 234 132 313  64],474,5,29125,3.640169978752656,0.0,0.0
8001,0,8001,[483 546 197 194 318],899,4,29129,3.640214946263434,40.0,0.0
8002,0,8002,[403 508  28 151 161],533,3,29132,3.6401349493939774,0.0,0.0
8003,0,8003,[302 603 427 313  50],13,5,29137,3.640304847576212,20.0,20.0
8004,0,8004,[318 196 204 742 186],92,3,29140,3.640224859462836,20.0,0.0
8005,0,8005,[302 603 427 313  50],13,5,29145,3.640394703972021,20.0,20.0
8006,0,8006,[471 483 132 228   9],447,4,29149,3.6404396153365806,20.0,0.0
8007,0,8007,[282 185 471 238  96],145,5,29154,3.6406093906093906,0.0,0.0
8008,0,8008,[118  71  89  64  25],892,4,29158,3.640654263953053,0.0,0.0
8009,0,8009,[302 603 427 313  50],669,5,29163,3.640823970037453,20.0,20.0
8010,0,8010,[302 603 427 313  50],537,5,29168,3.6409936337535886,20.0,20.0
8011,0,8011,[302 603 427 313  50],474,5,29173,3.641163255117324,20.0,20.0
8012,0,8012,[ 69 357 237 322 181],474,5,29178,3.641332834144515,20.0,0.0
8013,0,8013,[ 11 546 211 515 175],308,3,29181,3.6412528075867234,0.0,0.0
8014,0,8014,[191 100  11 196 403],339,4,29185,3.641297567061759,0.0,20.0
8015,0,8015,[127 215 210   9 187],59,5,29190,3.6414670658682633,0.0,20.0
8016,0,8016,[302 603 427 313  50],537,5,29195,3.6416365223899216,20.0,20.0
8017,0,8017,[176 111 228 289 185],234,1,29196,3.6413070591169867,0.0,0.0
8018,0,8018,[ 25   9 185 603  82],648,3,29199,3.64122708567153,20.0,0.0
8019,0,8019,[286 508  64 200 427],60,5,29204,3.6413965087281794,0.0,0.0
8020,0,8020,[302 603 427 313  50],13,5,29209,3.6415658895399576,20.0,20.0
8021,0,8021,[  4 235 423 276 118],308,3,29212,3.6414859137372226,0.0,0.0
8022,0,8022,[302 603 427 313  50],14,4,29216,3.641530599526362,20.0,20.0
8023,0,8023,[ 98 172 475 204   7],144,2,29218,3.6413260219341974,0.0,20.0
8024,0,8024,[603 483 257  22 403],339,4,29222,3.6413707165109033,40.0,0.0
8025,0,8025,[174 385 273 403 183],158,2,29224,3.641166209818091,0.0,20.0
8026,0,8026,[302 603 427 313  50],537,5,29229,3.6413354927120967,20.0,20.0
8027,0,8027,[175 118  98 301 187],788,2,29231,3.6411310413552567,0.0,20.0
8028,0,8028,[302 603 427 313  50],271,5,29236,3.641300286461577,20.0,20.0
8029,0,8029,[196   4 173 183 302],378,4,29240,3.6413449564134495,0.0,0.0
8030,0,8030,[302 603 427 313  50],474,5,29245,3.6415141327356495,20.0,20.0
8031,0,8031,[132 405  50 153  79],749,4,29249,3.641558764940239,0.0,20.0
8032,0,8032,[302 603 427 313  50],13,5,29254,3.641727872525831,20.0,20.0
8033,0,8033,[216  15  69 318 597],207,4,29258,3.6417724670151856,20.0,0.0
8034,0,8034,[174 301 197 210 655],537,1,29259,3.6414436838830118,0.0,20.0
8035,0,8035,[302 603 427 313  50],14,4,29263,3.6414883026381286,20.0,20.0
8036,0,8036,[588 180 151  71 118],650,1,29264,3.6411596366803534,0.0,0.0
8037,0,8037,[200  28  82 197 196],537,1,29265,3.640831052500622,0.0,0.0
8038,0,8038,[186 168 238 276 403],892,3,29268,3.640751337230999,0.0,0.0
8039,0,8039,[ 22  98 173 333 195],537,1,29269,3.6404228855721392,0.0,20.0
8040,0,8040,[143  12 423  98 483],207,4,29273,3.640467603531899,40.0,20.0
8041,0,8041,[302 603 427 313  50],474,5,29278,3.6406366575478737,20.0,20.0
8042,0,8042,[302 603 427 313  50],13,5,29283,3.640805669526296,20.0,20.0
8043,0,8043,[302 603 427 313  50],271,5,29288,3.6409746394828444,20.0,20.0
8044,0,8044,[174  69 357 202  96],738,5,29293,3.6411435674331885,20.0,20.0
8045,0,8045,[ 12 357 191 183  69],59,5,29298,3.6413124533929904,40.0,0.0
8046,0,8046,[748 187 333  79 546],346,4,29302,3.641357027463651,0.0,0.0
8047,0,8047,[302 603 427 313  50],271,5,29307,3.6415258449304173,20.0,20.0
8048,0,8048,[ 70 294 216 180 100],311,4,29311,3.6415703814138403,0.0,20.0
8049,0,8049,[597 172 294 200   4],774,0,29311,3.64111801242236,0.0,0.0
8050,0,8050,[302 603 427 313  50],271,5,29316,3.641286796671221,20.0,20.0
8051,0,8051,[100 180   9 678 515],881,3,29319,3.6412071535022354,0.0,20.0
8052,0,8052,[302 603 427 313  50],537,5,29324,3.641375884763442,20.0,20.0
8053,0,8053,[ 98 215 183  25 132],313,4,29328,3.6414204122175318,0.0,20.0
8054,0,8054,[200 216 111 117 546],749,3,29331,3.641340782122905,0.0,0.0
8055,0,8055,[121 194  28  12  64],119,4,29335,3.6413853028798413,20.0,0.0
8056,0,8056,[  1 385 496  15 210],59,4,29339,3.6414298125853297,0.0,0.0
8057,0,8057,[515 204 475 238 748],474,4,29343,3.641474311243485,0.0,0.0
8058,0,8058,[127 210 181 300 121],774,1,29344,3.6411465442362574,0.0,20.0
8059,0,8059,[302 603 427 313  50],334,5,29349,3.6413151364764267,20.0,20.0
8060,0,8060,[302 603 427 313  50],474,5,29354,3.641483686887483,20.0,20.0
8061,0,8061,[127 288 273 286 100],227,2,29356,3.641280079384768,0.0,40.0
8062,0,8062,[435 200 202  82 143],378,3,29359,3.641200545702592,0.0,0.0
8063,0,8063,[258 655  70 435 144],102,1,29360,3.640873015873016,0.0,0.0
8064,0,8064,[117 202  69 222 276],311,5,29365,3.6410415375077494,0.0,0.0
8065,0,8065,[742 385 216 210 186],533,4,29369,3.641086040168609,0.0,0.0
8066,0,8066,[  7 127 237 135  50],883,4,29373,3.6411305317962066,0.0,40.0
8067,0,8067,[302 313 597 385   4],13,3,29376,3.6410510659395143,0.0,0.0
8068,0,8068,[257 234 172 118 143],840,2,29378,3.640847688685091,0.0,0.0
8069,0,8069,[202  15  82  97 175],194,1,29379,3.6405204460966543,0.0,0.0
8070,0,8070,[210 174 678 294 182],387,3,29382,3.6404410853673648,0.0,20.0
8071,0,8071,[301  70 222   7 471],537,2,29384,3.6402378592666005,0.0,0.0
8072,0,8072,[ 82 742 132 202 181],454,1,29385,3.639910813823857,0.0,0.0
8073,0,8073,[302 603 427 313  50],454,5,29390,3.640079266782264,20.0,20.0
8074,0,8074,[202 588 181 132  12],308,4,29394,3.640123839009288,20.0,0.0
8075,0,8075,[194 269  88 245 111],579,3,29397,3.640044576523031,0.0,0.0
8076,0,8076,[176  50 222 183 568],25,5,29402,3.6402129503528537,0.0,20.0
8077,0,8077,[135 132 183 427  69],536,4,29406,3.6402574894775936,0.0,0.0
8078,0,8078,[748 286 405 435 597],102,0,29406,3.6398069067953953,0.0,0.0
8079,0,8079,[ 79 121 125 127  95],83,5,29411,3.6399752475247524,0.0,20.0
8080,0,8080,[302 603 427 313  50],454,5,29416,3.6401435465907683,20.0,20.0
8081,0,8081,[ 28  56 275 385 294],474,3,29419,3.640064340509775,0.0,0.0
8082,0,8082,[742 289  64 237  69],533,3,29422,3.63998515402697,0.0,0.0
8083,0,8083,[172  71 174 427 196],664,5,29427,3.6401533894111826,0.0,20.0
8084,0,8084,[118 197 215 328 204],313,5,29432,3.640321583178726,0.0,0.0
8085,0,8085,[235 423 471  64 475],92,3,29435,3.640242394261687,0.0,0.0
8086,0,8086,[289 496 275 678 508],82,1,29436,3.6399159144305675,0.0,0.0
8087,0,8087,[471 588 175  50 313],308,3,29439,3.6398367952522257,0.0,20.0
8088,0,8088,[302 603 427 313  50],14,4,29443,3.639881320311534,20.0,20.0
8089,0,8089,[143 276 196 742 435],298,3,29446,3.6398022249690976,0.0,0.0
8090,0,8090,[118 197   8  79  25],194,1,29447,3.639475960944259,0.0,0.0
8091,0,8091,[302 603 427 313  50],537,5,29452,3.6396440929312903,20.0,20.0
8092,0,8092,[269 603 678   4  64],7,3,29455,3.639565056221426,20.0,0.0
8093,0,8093,[  9 135 276  11 118],121,2,29457,3.639362490733877,0.0,0.0
8094,0,8094,[302 603 427 313  50],537,5,29462,3.6395305744286595,20.0,20.0
8095,0,8095,[117  50 385 143   4],537,1,29463,3.6392045454545454,0.0,20.0
8096,0,8096,[302 603 427 313  50],334,5,29468,3.6393726071384465,20.0,20.0
8097,0,8097,[275 153 181  88 161],452,4,29472,3.6394171400345763,0.0,0.0
8098,0,8098,[  7 174   1 200 748],92,3,29475,3.6393381898999877,0.0,20.0
8099,0,8099,[111  22 515  64 301],524,3,29478,3.6392592592592594,0.0,0.0
8100,0,8100,[202   1 238 423  64],6,3,29481,3.6391803481051723,0.0,0.0
8101,0,8101,[302 603 427 313  50],454,5,29486,3.6393483090594914,20.0,20.0
8102,0,8102,[302 603 427 313  50],13,5,29491,3.6395162285573246,20.0,20.0
8103,0,8103,[ 50 496 271 185 655],890,3,29494,3.6394373149062194,0.0,20.0
8104,0,8104,[302 603 427 313  50],13,5,29499,3.639605181986428,20.0,20.0
8105,0,8105,[302 603 427 313  50],334,5,29504,3.6397730076486554,20.0,20.0
8106,0,8106,[323 258 282 194 204],119,4,29508,3.639817441717035,0.0,0.0
8107,0,8107,[302 603 427 313  50],669,5,29513,3.639985199802664,20.0,20.0
8108,0,8108,[182 328 197 300  97],234,1,29514,3.6396596374398817,0.0,0.0
8109,0,8109,[172 197 403 185 153],883,5,29519,3.6398273736128237,0.0,0.0
8110,0,8110,[ 22 100 195  56 471],6,3,29522,3.6397484897053385,0.0,20.0
8111,0,8111,[289 515 127 181 202],387,3,29525,3.6396696252465484,0.0,20.0
8112,0,8112,[302 603 427 313  50],669,5,29530,3.6398372981634415,20.0,20.0
8113,0,8113,[ 88 121 176 127 282],474,5,29535,3.6400049297510475,0.0,20.0
8114,0,8114,[313  15 318 210 100],207,3,29538,3.6399260628465804,20.0,20.0
8115,0,8115,[496 238 742 322 174],308,3,29541,3.639847215377033,0.0,20.0
8116,0,8116,[176 187 127 515 132],537,3,29544,3.6397683873352222,0.0,20.0
8117,0,8117,[286 588  15  12 180],194,3,29547,3.639689578713969,20.0,0.0
8118,0,8118,[ 79 235 603 423 515],804,4,29551,3.6397339573839145,20.0,0.0
8119,0,8119,[ 88 294 282  69  15],200,5,29556,3.6399014778325123,0.0,0.0
8120,0,8120,[302 603 427 313  50],669,5,29561,3.640068957024997,20.0,20.0
8121,0,8121,[302 603 427 313  50],334,5,29566,3.640236394976607,20.0,20.0
8122,0,8122,[302 603 427 313  50],13,5,29571,3.640403791702573,20.0,20.0
8123,0,8123,[471 289 318 403 302],378,4,29575,3.6404480551452485,20.0,0.0
8124,0,8124,[588 121 187 182   1],102,1,29576,3.640123076923077,0.0,0.0
8125,0,8125,[508  22 216 132   4],474,4,29580,3.6401673640167362,0.0,0.0
8126,0,8126,[496 286 483 210 100],385,2,29582,3.639965546942291,20.0,20.0
8127,0,8127,[211 294 173  15 275],311,4,29586,3.640009842519685,0.0,0.0
8128,0,8128,[302 603 427 313  50],334,5,29591,3.6401771435600936,20.0,20.0
8129,0,8129,[195 471 289 435 187],537,1,29592,3.6398523985239852,0.0,0.0
8130,0,8130,[655 135  88  50 173],311,5,29597,3.640019677776411,0.0,20.0
8131,0,8131,[302 603 427 313  50],669,5,29602,3.6401869158878504,20.0,20.0
8132,0,8132,[ 95 183 135  15  97],378,4,29606,3.640231157014632,0.0,0.0
8133,0,8133,[127 568  50 475 427],533,4,29610,3.640275387263339,0.0,40.0
8134,0,8134,[216 273  25  88  95],279,1,29611,3.6399508297480025,0.0,0.0
8135,0,8135,[153 483 275 471  71],454,0,29611,3.639503441494592,20.0,0.0
8136,0,8136,[496 515  96 132 257],804,5,29616,3.6396706402851176,0.0,0.0
8137,0,8137,[195 300 151 271 121],788,2,29618,3.639469157041042,0.0,0.0
8138,0,8138,[273 202 265   9   4],13,3,29621,3.639390588524389,0.0,0.0
8139,0,8139,[ 50  11 265 125 286],82,4,29625,3.6394348894348894,0.0,20.0
8140,0,8140,[302 603 427 313  50],13,5,29630,3.639602014494534,20.0,20.0
8141,0,8141,[269 597 301 215 435],650,2,29632,3.639400638663719,0.0,0.0
8142,0,8142,[211 403 132 300  89],788,4,29636,3.639444922018912,0.0,0.0
8143,0,8143,[302 603 427 313  50],14,4,29640,3.6394891944990175,20.0,20.0
8144,0,8144,[161 235  50 143 174],479,2,29642,3.6392879066912216,0.0,40.0
8145,0,8145,[405   9  22 742 132],200,4,29646,3.639332187576725,0.0,0.0
8146,0,8146,[185 121 191   1 403],650,1,29647,3.6390082238860932,0.0,0.0
8147,0,8147,[161 132 183 257 271],290,3,29650,3.638929798723613,0.0,0.0
8148,0,8148,[302 603 427  50 313],334,5,29655,3.6390968216959134,20.0,20.0
8149,0,8149,[302 603 427  50 313],474,5,29660,3.6392638036809815,20.0,20.0
8150,0,8150,[302 603 427  50 313],334,5,29665,3.6394307446939025,20.0,20.0
8151,0,8151,[196 322 508 258 127],207,4,29669,3.6394749754661433,0.0,20.0
8152,0,8152,[ 64 191 288 151 323],474,2,29671,3.6392738869127927,0.0,0.0
8153,0,8153,[174  82 204 496 508],643,3,29674,3.639195486877606,0.0,20.0
8154,0,8154,[302 603 427  50 313],13,5,29679,3.6393623543838136,20.0,20.0
8155,0,8155,[ 69 111 427  98 143],533,5,29684,3.6395291809710644,0.0,20.0
8156,0,8156,[328 195 194 385  95],537,0,29684,3.639082996199583,0.0,0.0
8157,0,8157,[200 435 234 568  70],881,1,29685,3.638759499877421,0.0,0.0
8158,0,8158,[597 100 588 228 200],13,3,29688,3.6386812109327122,0.0,20.0
8159,0,8159,[ 28   4 588  89 238],378,3,29691,3.6386029411764707,0.0,0.0
8160,0,8160,[174 210  56 238 357],210,4,29695,3.638647224604828,20.0,20.0
8161,0,8161,[302 603 427  50 313],14,4,29699,3.638691497182063,20.0,20.0
8162,0,8162,[603 180 176 182 144],13,4,29703,3.6387357589121647,20.0,0.0
8163,0,8163,[405 655 179   7 258],378,3,29706,3.6386575208231258,0.0,0.0
8164,0,8164,[197   8 181 168 483],406,4,29710,3.638701775872627,20.0,0.0
8165,0,8165,[275 427 483  15 215],454,2,29712,3.6385011021307863,20.0,0.0
8166,0,8166,[318  25 228 204 300],892,4,29716,3.6385453654952857,20.0,0.0
8167,0,8167,[403  11 185 546 435],64,4,29720,3.6385896180215473,0.0,0.0
8168,0,8168,[175 181 475 515 144],339,4,29724,3.638633859713551,0.0,0.0
8169,0,8169,[182 215 100 186 496],64,5,29729,3.638800489596083,0.0,20.0
8170,0,8170,[197 174 153  98 546],7,5,29734,3.6389670786929385,0.0,40.0
8171,0,8171,[302 603 427  50 313],474,5,29739,3.6391336270190897,20.0,20.0
8172,0,8172,[302 603 427  50 313],669,5,29744,3.639300134589502,20.0,20.0
8173,0,8173,[302 603 427  50 313],271,5,29749,3.6394666014191337,20.0,20.0
8174,0,8174,[603 153 187 191 301],334,4,29753,3.6395107033639142,20.0,0.0
8175,0,8175,[  9 471 282  12   4],271,3,29756,3.6394324853228963,20.0,0.0
8176,0,8176,[ 50 202 144 174  88],659,3,29759,3.63935428641311,0.0,40.0
8177,0,8177,[194 132 313  15 175],59,4,29763,3.6393983859134265,0.0,0.0
8178,0,8178,[302 603 427  50 313],13,5,29768,3.639564738965644,20.0,20.0
8179,0,8179,[143 161 483 546 385],95,2,29770,3.639364303178484,20.0,0.0
8180,0,8180,[302 603 427  50 313],334,5,29775,3.6395306197286397,20.0,20.0
8181,0,8181,[  7 357 132 186 180],653,3,29778,3.639452456612075,20.0,0.0
8182,0,8182,[288  64  70 183 216],804,4,29782,3.639496517169742,0.0,0.0
8183,0,8183,[ 69  97  50 313 483],454,4,29786,3.639540566959922,20.0,20.0
8184,0,8184,[173 228 168 174 135],339,5,29791,3.639706780696396,0.0,20.0
8185,0,8185,[302 603 427  50 313],13,5,29796,3.6398729538236014,20.0,20.0
8186,0,8186,[143 161  11  98 173],346,1,29797,3.639550506901185,0.0,20.0
8187,0,8187,[302 603 427  50 313],669,5,29802,3.6397166585246703,20.0,20.0
8188,0,8188,[302 603 427  50 313],271,5,29807,3.639882769568934,20.0,20.0
8189,0,8189,[127 288 405 100 423],374,4,29811,3.63992673992674,0.0,40.0
8190,0,8190,[258 294 204 276  56],207,2,29813,3.6397265291173238,0.0,0.0
8191,0,8191,[175  89 121  22 204],59,5,29818,3.639892578125,0.0,0.0
8192,0,8192,[135 597 182 118 568],213,5,29823,3.6400585865983155,0.0,0.0
8193,0,8193,[302 603 427  50 313],271,5,29828,3.6402245545521112,20.0,20.0
8194,0,8194,[742 117  71 245 216],378,3,29831,3.6401464307504576,0.0,0.0
8195,0,8195,[153 301 161 216  56],378,4,29835,3.640190336749634,0.0,0.0
8196,0,8196,[215 405 187 185 496],64,4,29839,3.6402342320361107,0.0,0.0
8197,0,8197,[  8  28 318 508 196],387,3,29842,3.64015613564284,20.0,0.0
8198,0,8198,[ 11 121 597 588   8],7,3,29845,3.6400780582997925,0.0,0.0
8199,0,8199,[ 12 161  97 323   1],455,3,29848,3.64,20.0,0.0
8200,0,8200,[289 194 257 483 318],533,4,29852,3.640043897085721,40.0,0.0
8201,0,8201,[302 603 427  50 313],13,5,29857,3.640209704950012,20.0,20.0
8202,0,8202,[302 603 427  50 313],669,5,29862,3.6403754723881505,20.0,20.0
8203,0,8203,[186 204 471 588  96],378,3,29865,3.6402974158946857,0.0,0.0
8204,0,8204,[ 98 176 546  64 151],881,4,29869,3.6403412553321144,0.0,20.0
8205,0,8205,[174 289 275 257 286],318,3,29872,3.640263222032659,0.0,20.0
8206,0,8206,[678 117 100  89  95],334,2,29874,3.6400633605458754,0.0,20.0
8207,0,8207,[ 89  64  96  12 403],60,4,29878,3.6401072124756335,20.0,0.0
8208,0,8208,[185 135 588 179 153],843,2,29880,3.639907418686807,0.0,0.0
8209,0,8209,[132 202 588 323 187],537,1,29881,3.6395858708891597,0.0,0.0
8210,0,8210,[100 405 197 211 182],524,4,29885,3.6396297649494582,0.0,20.0
8211,0,8211,[357 132  64 265 125],533,3,29888,3.6395518753044325,20.0,0.0
8212,0,8212,[ 50 216 237  71 174],804,5,29893,3.6397175210032873,0.0,40.0
8213,0,8213,[ 69 127 183 294 174],749,4,29897,3.6397613830046263,0.0,40.0
8214,0,8214,[  7 121 117 153 405],840,2,29899,3.639561777236762,0.0,0.0
8215,0,8215,[302 603 427  50 313],454,5,29904,3.6397273612463485,20.0,20.0
8216,0,8216,[403 268 483 175 185],234,1,29905,3.6394061092856274,20.0,0.0
8217,0,8217,[125 127  50  98 143],6,3,29908,3.6393283037235338,0.0,60.0
8218,0,8218,[302 603 427  50 313],474,5,29913,3.639493855700207,20.0,20.0
8219,0,8219,[385 176 111 202 197],64,4,29917,3.639537712895377,0.0,0.0
8220,0,8220,[302 603 427  50 313],13,5,29922,3.639703199124194,20.0,20.0
8221,0,8221,[ 71 216  95 515 483],234,2,29924,3.639503770372172,20.0,0.0
8222,0,8222,[100 118  28 228  82],881,4,29928,3.639547610361182,0.0,20.0
8223,0,8223,[302 603 427  50 313],14,4,29932,3.639591439688716,20.0,20.0
8224,0,8224,[ 71 182 318 195  28],308,4,29936,3.6396352583586626,20.0,0.0
8225,0,8225,[302 603 427  50 313],14,4,29940,3.639679066374909,20.0,20.0
8226,0,8226,[302 603 427  50 313],334,5,29945,3.63984441473198,20.0,20.0
8227,0,8227,[302 603 427  50 313],13,5,29950,3.6400097228974233,20.0,20.0
8228,0,8228,[ 69  89 216  88  50],271,4,29954,3.6400534694373556,0.0,20.0
8229,0,8229,[222 176 181 183  69],830,3,29957,3.6399756986634264,0.0,0.0
8230,0,8230,[302 603 427  50 313],454,5,29962,3.6401409306281134,20.0,20.0
8231,0,8231,[257 271 197  22 173],334,4,29966,3.640184645286686,0.0,0.0
8232,0,8232,[182 282 197 135 742],144,4,29970,3.640228349325884,0.0,0.0
8233,0,8233,[143  22 294  97 289],474,3,29973,3.6401505950935147,0.0,0.0
8234,0,8234,[174   7 403 257 125],144,3,29976,3.6400728597449907,0.0,20.0
8235,0,8235,[ 50 153 151 175 211],313,3,29979,3.639995143273434,0.0,20.0
8236,0,8236,[302 603 427  50 313],537,5,29984,3.640160252519121,20.0,20.0
8237,0,8237,[127 183 173 197 288],7,5,29989,3.6403253216800193,0.0,20.0
8238,0,8238,[100 234 276 195 168],59,5,29994,3.6404903507707247,0.0,20.0
8239,0,8239,[228  82  69   9 181],194,2,29996,3.6402912621359222,0.0,0.0
8240,0,8240,[ 69 265 100 175   1],653,4,30000,3.6403349108117946,0.0,20.0
8241,0,8241,[186 322 546 483 210],524,3,30003,3.6402572191215725,20.0,0.0
8242,0,8242,[ 71 180  82 172 235],194,1,30004,3.6399369161712967,0.0,0.0
8243,0,8243,[313 357 228 195  95],13,3,30007,3.6398592916060166,20.0,0.0
8244,0,8244,[132 276 176 174 186],378,4,30011,3.6399029714978774,0.0,20.0
8245,0,8245,[187 238 182 328 405],804,5,30016,3.640067911714771,0.0,0.0
8246,0,8246,[568 475 186  56  69],533,2,30018,3.6398690432884684,0.0,0.0
8247,0,8247,[132 603 183 265 237],13,5,30023,3.6400339476236665,20.0,0.0
8248,0,8248,[196 175 357 185 174],843,2,30025,3.6398351315310946,20.0,20.0
8249,0,8249,[ 82 179 655 117 357],95,3,30028,3.6397575757575757,20.0,0.0
8250,0,8250,[174 300 153 427 187],85,2,30030,3.6395588413525632,0.0,20.0
8251,0,8251,[228  50 294 191  79],311,5,30035,3.639723703344644,0.0,20.0
8252,0,8252,[302 603 427  50 313],271,5,30040,3.6398885253847086,20.0,20.0
8253,0,8253,[333 322 222 678 216],881,4,30044,3.6399321541070995,0.0,0.0
8254,0,8254,[ 69 100  22 185  11],7,4,30048,3.6399757722592367,0.0,20.0
8255,0,8255,[ 11 282 258 237   7],447,5,30053,3.640140503875969,0.0,0.0
8256,0,8256,[300 273 111 125   9],378,3,30056,3.640062976868112,0.0,0.0
8257,0,8257,[197  89 286  79  98],271,4,30060,3.6401065633325262,0.0,20.0
8258,0,8258,[302 603 427  50 313],334,5,30065,3.640271219275941,20.0,20.0
8259,0,8259,[282 423  98 151 245],554,3,30068,3.640193704600484,0.0,20.0
8260,0,8260,[121 235 403 186 357],738,3,30071,3.640116208691442,20.0,0.0
8261,0,8261,[405 132  70 181  28],279,0,30071,3.639675623335754,0.0,0.0
8262,0,8262,[403  88 216 302 515],13,2,30073,3.6394771874621807,0.0,0.0
8263,0,8263,[  1 286 748 153 176],488,2,30075,3.6392787996127782,0.0,0.0
8264,0,8264,[302 603 427  50 313],13,5,30080,3.6394434361766486,20.0,20.0
8265,0,8265,[318 289 257  56 204],455,3,30083,3.639366077909509,20.0,0.0
8266,0,8266,[603 483  64 194   9],82,5,30088,3.6395306640861254,40.0,0.0
8267,0,8267,[135  82  28 275 118],694,5,30093,3.6396952104499274,0.0,0.0
8268,0,8268,[ 69 172 195 202  25],648,3,30096,3.6396178498004597,0.0,0.0
8269,0,8269,[175  95 234  88  11],543,2,30098,3.6394195888754535,0.0,0.0
8270,0,8270,[302 603 427  50 313],14,4,30102,3.639463184620965,20.0,20.0
8271,0,8271,[ 50  79 496 204  25],7,4,30106,3.639506769825919,0.0,20.0
8272,0,8272,[211  70 185 515 135],452,3,30109,3.639429469358153,0.0,0.0
8273,0,8273,[185 655 435 483 144],788,3,30112,3.639352187575538,20.0,0.0
8274,0,8274,[302 603 427  50 313],271,5,30117,3.639516616314199,20.0,20.0
8275,0,8275,[228 183 174 168 322],881,3,30120,3.639439342677622,0.0,20.0
8276,0,8276,[  7  70 176 174 175],788,3,30123,3.6393620877129393,0.0,20.0
8277,0,8277,[302 603 427  50 313],669,5,30128,3.6395264556656195,20.0,20.0
8278,0,8278,[ 88 174 204  12 100],234,1,30129,3.6392076337721946,20.0,40.0
8279,0,8279,[ 89   7 288 222  97],455,2,30131,3.6390096618357486,0.0,0.0
8280,0,8280,[ 11 117 181 257 132],334,3,30134,3.6389324960753533,0.0,0.0
8281,0,8281,[132 258 200 238 204],313,3,30137,3.6388553489495292,0.0,0.0
8282,0,8282,[118 195 183  96  89],653,3,30140,3.638778220451527,0.0,0.0
8283,0,8283,[151 403 100 117 234],788,2,30142,3.6385803959439884,0.0,20.0
8284,0,8284,[ 97  98  22 111 678],488,4,30146,3.63862401931201,0.0,20.0
8285,0,8285,[204 143  11 182 210],537,1,30147,3.6383055756698046,0.0,0.0
8286,0,8286,[271   4 181 328  79],328,3,30150,3.6382285507421264,0.0,0.0
8287,0,8287,[195  50 168 276 322],308,4,30154,3.638272200772201,0.0,20.0
8288,0,8288,[300 271 301  64  56],145,4,30158,3.638315840270238,0.0,0.0
8289,0,8289,[222 153  70 357 183],488,3,30161,3.638238841978287,20.0,0.0
8290,0,8290,[282 742  89 210 258],200,5,30166,3.638403087685442,0.0,0.0
8291,0,8291,[  4 176 403 191 216],378,4,30170,3.638446695610227,0.0,0.0
8292,0,8292,[286 100 423  69 318],233,4,30174,3.638490293018208,20.0,20.0
8293,0,8293,[182 180 222 118 127],533,3,30177,3.638413310827104,0.0,20.0
8294,0,8294,[182 742  98 423   1],804,4,30181,3.638456901748041,0.0,20.0
8295,0,8295,[302 603 427  50 313],474,5,30186,3.6386210221793633,20.0,20.0
8296,0,8296,[172 546  89  71 181],804,4,30190,3.6386645775581536,0.0,0.0
8297,0,8297,[302 603 427  50 313],334,5,30195,3.63882863340564,20.0,20.0
8298,0,8298,[204 194  50 496 588],650,4,30199,3.6388721532714783,0.0,20.0
8299,0,8299,[302 603 427  50 313],13,5,30204,3.6390361445783133,20.0,20.0
8300,0,8300,[ 11 318 568 153 151],308,5,30209,3.639200096373931,20.0,0.0
8301,0,8301,[ 56 483 144 173  12],385,3,30212,3.639123102866779,40.0,0.0
8302,0,8302,[172 144 182 191  50],92,5,30217,3.6392870046970973,0.0,20.0
8303,0,8303,[180 182 235  96 204],92,4,30221,3.6393304431599227,0.0,0.0
8304,0,8304,[318 100 182   9 121],474,5,30226,3.6394942805538832,20.0,20.0
8305,0,8305,[222 118 258 471 435],343,4,30230,3.639537683602215,0.0,0.0
8306,0,8306,[174 194 423  15 143],749,5,30235,3.639701456602865,0.0,20.0
8307,0,8307,[302 603 427  50 313],454,5,30240,3.6398651901781416,20.0,20.0
8308,0,8308,[ 25  50 175 300 271],13,2,30242,3.6396678300637864,0.0,20.0
8309,0,8309,[ 56  70  97 143 597],653,2,30244,3.639470517448857,0.0,0.0
8310,0,8310,[302 603 427  50 313],13,5,30249,3.6396342197088196,20.0,20.0
8311,0,8311,[144 275  28 471  25],119,5,30254,3.639797882579403,0.0,0.0
8312,0,8312,[742 294 322 185  25],548,3,30257,3.6397209190424635,0.0,0.0
8313,0,8313,[302 603 427  50 313],271,5,30262,3.6398845321145057,20.0,20.0
8314,0,8314,[313 271   9   4 318],334,3,30265,3.6398075766686713,20.0,0.0
8315,0,8315,[655   7 144 111 200],92,3,30268,3.6397306397306397,0.0,0.0
8316,0,8316,[118 180 238 546 187],650,2,30270,3.6395334856318384,0.0,0.0
8317,0,8317,[302 603 427  50 313],271,5,30275,3.6396970425583075,20.0,20.0
8318,0,8318,[181 180   1 302 121],537,2,30277,3.639499939896622,0.0,0.0
8319,0,8319,[655 176 215 153 195],313,4,30281,3.6395432692307694,0.0,0.0
8320,0,8320,[143 215 202 216   7],840,5,30286,3.6397067660137004,0.0,0.0
8321,0,8321,[483 117 742  56 286],648,2,30288,3.6395097332372024,20.0,0.0
8322,0,8322,[195  28 257 173  15],374,1,30289,3.63919259882254,0.0,0.0
8323,0,8323,[423 191 196 405 195],882,5,30294,3.639356078808265,0.0,0.0
8324,0,8324,[ 71 195  22 275  88],298,4,30298,3.6393993993993994,0.0,0.0
8325,0,8325,[ 96  97 245 288 182],666,2,30300,3.6392024981984146,0.0,0.0
8326,0,8326,[257 385 187 176 121],666,2,30302,3.6390056442896603,0.0,0.0
8327,0,8327,[313 132   8   7 121],189,2,30304,3.6388088376561,0.0,0.0
8328,0,8328,[ 64   8 515 603 197],64,3,30307,3.638732140713171,20.0,0.0
8329,0,8329,[302 603 427  50 313],474,5,30312,3.638895558223289,20.0,20.0
8330,0,8330,[302 603 427  50 313],13,5,30317,3.6390589365022206,20.0,20.0
8331,0,8331,[276 186 194 655   9],59,4,30321,3.6391022563610176,0.0,0.0
8332,0,8332,[302 603 427  50 313],334,5,30326,3.639265570622825,20.0,20.0
8333,0,8333,[ 97 200 210 176 234],379,4,30330,3.639308855291577,0.0,0.0
8334,0,8334,[302 603 427  50 313],334,5,30335,3.6394721055788843,20.0,20.0
8335,0,8335,[302 603 427  50 313],334,5,30340,3.6396353166986564,20.0,20.0
8336,0,8336,[185 215 172 182 210],7,5,30345,3.6397984886649875,0.0,0.0
8337,0,8337,[181 215 655 121 179],194,2,30347,3.639601822979132,0.0,0.0
8338,0,8338,[135 588  71 204  79],387,2,30349,3.6394052044609664,0.0,0.0
8339,0,8339,[302 603 427  50 313],14,4,30353,3.6394484412470023,20.0,20.0
8340,0,8340,[194 172  15 195  82],59,4,30357,3.6394916676657476,0.0,0.0
8341,0,8341,[302 603 427  50 313],669,5,30362,3.6396547590505874,20.0,20.0
8342,0,8342,[200 300 403  25 234],749,5,30367,3.639817811338847,0.0,0.0
8343,0,8343,[153  89  64 117  88],184,2,30369,3.639621284755513,0.0,0.0
8344,0,8344,[ 12   1 182 483  79],213,4,30373,3.639664469742361,40.0,0.0
8345,0,8345,[191 748 322 210  56],13,2,30375,3.639468008626887,0.0,0.0
8346,0,8346,[143 121 151 300 168],334,2,30377,3.639271594584881,0.0,0.0
8347,0,8347,[ 98 597  95 546 273],84,3,30380,3.639195016770484,0.0,20.0
8348,0,8348,[144 313 182 289 211],328,4,30384,3.6392382321236076,0.0,0.0
8349,0,8349,[597 508 276 180 237],378,3,30387,3.6391616766467068,0.0,0.0
8350,0,8350,[111  69 483 294 405],474,4,30391,3.639204885642438,20.0,0.0
8351,0,8351,[ 22 258   9 127 603],13,4,30395,3.6392480842911876,20.0,20.0
8352,0,8352,[427 268  56 483  69],334,4,30399,3.639291272596672,20.0,0.0
8353,0,8353,[  7 111  28  89  82],648,4,30403,3.639334450562605,0.0,0.0
8354,0,8354,[173 265 210  98  25],42,3,30406,3.6392579293836027,0.0,20.0
8355,0,8355,[  1 100 185 144 496],379,5,30411,3.6394207754906653,0.0,20.0
8356,0,8356,[302 603 427  50 313],454,5,30416,3.639583582625344,20.0,20.0
8357,0,8357,[ 64  89 265   7 238],653,3,30419,3.639507059105049,0.0,0.0
8358,0,8358,[318  56 153 496 302],334,4,30423,3.639550185428879,20.0,0.0
8359,0,8359,[180 182 144 174 228],95,3,30426,3.639473684210526,0.0,20.0
8360,0,8360,[ 11  88 210 328 204],92,3,30429,3.6393972012917115,0.0,0.0
8361,0,8361,[302 603 427  50 313],13,5,30434,3.639559913896197,20.0,20.0
8362,0,8362,[302 603 427  50 313],14,4,30438,3.639603013272749,20.0,20.0
8363,0,8363,[  9 286 132 234 111],474,5,30443,3.639765662362506,0.0,0.0
8364,0,8364,[197 204   7 179   4],374,2,30445,3.639569635385535,0.0,0.0
8365,0,8365,[186 258 288  56 176],13,3,30448,3.6394931867081044,0.0,0.0
8366,0,8366,[ 97 153 603 294 191],308,3,30451,3.63941675630453,20.0,0.0
8367,0,8367,[211 333 135 313  25],85,3,30454,3.63934034416826,0.0,0.0
8368,0,8368,[238 288  70 235 197],64,4,30458,3.6393834388815867,0.0,0.0
8369,0,8369,[302 603 427  50 313],537,5,30463,3.639545997610514,20.0,20.0
8370,0,8370,[ 56  98 180 191   4],804,4,30467,3.6395890574602796,0.0,20.0
8371,0,8371,[302 603 427  50 313],537,5,30472,3.639751552795031,20.0,20.0
8372,0,8372,[197 196 200 257 405],379,4,30476,3.639794577809626,0.0,0.0
8373,0,8373,[302 603 427  50 313],474,5,30481,3.639957009792214,20.0,20.0
8374,0,8374,[100 234 357  70 187],643,4,30485,3.64,20.0,20.0
8375,0,8375,[403 100  95  50 187],749,2,30487,3.6398042024832855,0.0,40.0
8376,0,8376,[496 655 300 210 100],666,3,30490,3.6397278261907604,0.0,20.0
8377,0,8377,[427 197 143 273 289],374,1,30491,3.6394127476724756,0.0,0.0
8378,0,8378,[135 515   9 588  22],881,3,30494,3.6393364363289176,0.0,0.0
8379,0,8379,[ 69 385 427 100  70],234,3,30497,3.639260143198091,0.0,20.0
8380,0,8380,[ 95 144 179  28 176],406,3,30500,3.639183868273476,0.0,0.0
8381,0,8381,[132 318  15 204 182],6,3,30503,3.6391076115485563,20.0,0.0
8382,0,8382,[302 603 427  50 313],454,5,30508,3.6392699510914945,20.0,20.0
8383,0,8383,[302 603 427  50 313],669,5,30513,3.639432251908397,20.0,20.0
8384,0,8384,[111  50 228 125 265],554,4,30517,3.639475253428742,0.0,20.0
8385,0,8385,[194 173 286 483   9],6,4,30521,3.639518244693537,20.0,0.0
8386,0,8386,[ 22 210 588 180 275],452,4,30525,3.6395612257064505,0.0,0.0
8387,0,8387,[301 403 183   1 235],378,4,30529,3.6396041964711494,0.0,0.0
8388,0,8388,[ 69 294 174 228 180],788,2,30531,3.639408749552986,0.0,20.0
8389,0,8389,[286 258  56  28 385],488,4,30535,3.639451728247914,0.0,0.0
8390,0,8390,[100  97 515 196  56],85,3,30538,3.6393755213919676,0.0,20.0
8391,0,8391,[302 603 427  50 313],454,5,30543,3.6395376549094376,20.0,20.0
8392,0,8392,[  1 180 300 200 183],378,3,30546,3.6394614559752174,0.0,0.0
8393,0,8393,[405 228  96 435 235],524,2,30548,3.6392661424827257,0.0,0.0
8394,0,8394,[173 597   8 143 238],92,2,30550,3.6390708755211434,0.0,0.0
8395,0,8395,[282  97   4 313 197],474,5,30555,3.639232968080038,0.0,0.0
8396,0,8396,[302 603 427  50 313],474,5,30560,3.639395022031678,20.0,20.0
8397,0,8397,[288 117 234 210   4],474,4,30564,3.6394379614193855,0.0,0.0
8398,0,8398,[282  50 603 294 435],804,4,30568,3.6394808905822122,20.0,20.0
8399,0,8399,[ 95 135 153 100   9],334,4,30572,3.6395238095238094,0.0,20.0
8400,0,8400,[ 11 121 187 117 186],207,2,30574,3.6393286513510295,0.0,0.0
8401,0,8401,[271 200 357 588  96],537,1,30575,3.639014520352297,20.0,0.0
8402,0,8402,[302 603 427  50 313],14,4,30579,3.6390574794716173,20.0,20.0
8403,0,8403,[302 603 427  50 313],14,4,30583,3.639100428367444,20.0,20.0
8404,0,8404,[182 483   7 196 174],13,4,30587,3.6391433670434266,20.0,20.0
8405,0,8405,[333 179 175 174 197],537,3,30590,3.6390673328574827,0.0,20.0
8406,0,8406,[174 180 265 195 655],207,2,30592,3.6388723682645416,0.0,20.0
8407,0,8407,[234 180 185  11 200],328,4,30596,3.6389153187440533,0.0,0.0
8408,0,8408,[423 121  82  11 496],804,4,30600,3.6389582590082057,0.0,0.0
8409,0,8409,[588 333 196  97 286],387,0,30600,3.638525564803805,0.0,0.0
8410,0,8410,[546 588 202 172 204],479,3,30603,3.6384496492688148,0.0,0.0
8411,0,8411,[ 71 161 132 204 185],13,4,30607,3.638492629576795,0.0,0.0
8412,0,8412,[143 191  71 173  25],843,0,30607,3.6380601450136694,0.0,0.0
8413,0,8413,[275 597 175 471 200],378,2,30609,3.637865462324697,0.0,0.0
8414,0,8414,[294 423 200 318 191],234,4,30613,3.637908496732026,20.0,0.0
8415,0,8415,[603 385 100 286  69],454,3,30616,3.637832699619772,20.0,20.0
8416,0,8416,[333 276   9 423 100],881,4,30620,3.637875727693953,0.0,20.0
8417,0,8417,[234 161  11 172 168],308,3,30623,3.637799952482775,0.0,0.0
8418,0,8418,[302 603 427  50 313],669,5,30628,3.637961753177337,20.0,20.0
8419,0,8419,[182 405 195  12 655],13,3,30631,3.6378859857482184,20.0,0.0
8420,0,8420,[546 257 328 269 176],378,3,30634,3.637810236313977,0.0,0.0
8421,0,8421,[100 322 228  64 678],13,3,30637,3.6377345048682024,0.0,20.0
8422,0,8422,[405 271 215 235 328],144,2,30639,3.637540068859076,0.0,0.0
8423,0,8423,[302 603 427  50 313],14,4,30643,3.6375830959164293,20.0,20.0
8424,0,8424,[748 144  11 288 197],64,2,30645,3.6373887240356084,0.0,0.0
8425,0,8425,[302 603 427  50 313],474,5,30650,3.637550439117019,20.0,20.0
8426,0,8426,[195 405  64 546 187],7,4,30654,3.6375934496262015,0.0,0.0
8427,0,8427,[302 603 427  50 313],14,4,30658,3.6376364499288085,20.0,20.0
8428,0,8428,[174 194 275 228  56],406,3,30661,3.637560801993119,0.0,20.0
8429,0,8429,[302 603 427  50 313],474,5,30666,3.6377224199288256,20.0,20.0
8430,0,8430,[143  96 237  82 234],42,5,30671,3.6378839995255605,0.0,0.0
8431,0,8431,[302 603 427  50 313],271,5,30676,3.638045540796964,20.0,20.0
8432,0,8432,[  7 143  79 216 423],234,1,30677,3.6377327167081703,0.0,0.0
8433,0,8433,[195 118 144 222 179],666,1,30678,3.637419966801043,0.0,0.0
8434,0,8434,[202 427   9 268 215],7,3,30681,3.637344398340249,0.0,0.0
8435,0,8435,[302 603 427  50 313],14,4,30685,3.6373873873873874,20.0,20.0
8436,0,8436,[302 603 427  50 313],454,5,30690,3.63754889178618,20.0,20.0
8437,0,8437,[475  79  22 144 508],387,3,30693,3.6374733349134867,0.0,0.0
8438,0,8438,[ 28 568 194 603 385],308,4,30697,3.637516293399692,20.0,0.0
8439,0,8439,[118 197 194  79 180],804,5,30702,3.6376777251184835,0.0,0.0
8440,0,8440,[195 471 182  69 168],194,2,30704,3.6374837104608457,0.0,0.0
8441,0,8441,[302 603 427  50 313],14,4,30708,3.6375266524520256,20.0,20.0
8442,0,8442,[302 603 427  50 313],474,5,30713,3.6376880255833233,20.0,20.0
8443,0,8443,[197 132 143 100 475],452,2,30715,3.6374940786357177,0.0,20.0
8444,0,8444,[302 603 427  50 313],454,5,30720,3.6376554174067497,20.0,20.0
8445,0,8445,[302 603 427  50 313],474,5,30725,3.637816717973005,20.0,20.0
8446,0,8446,[ 89  97 135  79 173],64,3,30728,3.637741209897005,0.0,0.0
8447,0,8447,[302 603 427  50 313],13,5,30733,3.637902462121212,20.0,20.0
8448,0,8448,[ 97 258  11 135 195],474,5,30738,3.638063676174695,0.0,0.0
8449,0,8449,[222 153 200  69 179],387,4,30742,3.63810650887574,0.0,0.0
8450,0,8450,[200 289 174   9 204],13,2,30744,3.637912673056443,0.0,20.0
8451,0,8451,[222 181  25 405 172],406,2,30746,3.637718883104591,0.0,0.0
8452,0,8452,[302 603 427  50 313],537,5,30751,3.63788004258843,20.0,20.0
8453,0,8453,[435  25  96 200  97],804,3,30754,3.6378045895434115,0.0,0.0
8454,0,8454,[ 11 268 313 597   7],119,5,30759,3.637965700768776,0.0,0.0
8455,0,8455,[ 70  12 183 597 135],447,3,30762,3.6378902554399244,20.0,0.0
8456,0,8456,[302 603 427  50 313],271,5,30767,3.638051318434433,20.0,20.0
8457,0,8457,[204  79 276 185 258],234,0,30767,3.6376211870418538,0.0,0.0
8458,0,8458,[471 172  64 173 385],374,3,30770,3.6375458091973045,0.0,0.0
8459,0,8459,[403 742 302  89 185],788,3,30773,3.637470449172577,0.0,0.0
8460,0,8460,[302 603 427  50 313],14,4,30777,3.6375132963006735,20.0,20.0
8461,0,8461,[183 301 222   7 181],378,3,30780,3.6374379579295675,0.0,0.0
8462,0,8462,[302 603 427  50 313],271,5,30785,3.6375989601796053,20.0,20.0
8463,0,8463,[202 191 210 168 282],666,3,30788,3.637523629489603,0.0,0.0
8464,0,8464,[ 22 125 423 183 176],311,5,30793,3.637684583579445,0.0,0.0
8465,0,8465,[187 496 195 588 175],360,1,30794,3.6373730214977558,0.0,0.0
8466,0,8466,[ 98 127 235 357 161],643,3,30797,3.6372977441832997,20.0,40.0
8467,0,8467,[ 97 427 179 294 117],537,2,30799,3.637104393008975,0.0,0.0
8468,0,8468,[300 118 276 385  22],455,4,30803,3.6371472428858187,0.0,0.0
8469,0,8469,[302 603 427  50 127],334,5,30808,3.6373081463990555,20.0,40.0
8470,0,8470,[ 28 179 172 301 215],13,3,30811,3.637232912288986,0.0,0.0
8471,0,8471,[302 603 427  50 127],664,5,30816,3.6373937677053823,20.0,40.0
8472,0,8472,[302 603 427  50 127],474,5,30821,3.6375545851528384,20.0,40.0
8473,0,8473,[143 176 125  28   8],64,4,30825,3.63759735662025,0.0,0.0
8474,0,8474,[427  15  82 127 483],650,2,30827,3.6374041297935102,20.0,20.0
8475,0,8475,[403 153 135  82 568],194,0,30827,3.636974988201982,0.0,0.0
8476,0,8476,[ 22  96 202 603 515],90,4,30831,3.637017812905509,20.0,0.0
8477,0,8477,[ 98 435 496 228 515],339,5,30836,3.6371785798537393,0.0,20.0
8478,0,8478,[257 471 245  89 215],653,2,30838,3.636985493572355,0.0,0.0
8479,0,8479,[302 603 427  50 313],669,5,30843,3.637146226415094,20.0,20.0
8480,0,8480,[ 15 183 202 238 194],537,1,30844,3.636835278858625,0.0,0.0
8481,0,8481,[143 655 181 161 228],749,4,30848,3.636878094788965,0.0,0.0
8482,0,8482,[302 603 427  50 313],271,5,30853,3.6370387834492512,20.0,20.0
8483,0,8483,[302 603 427  50 313],334,5,30858,3.6371994342291374,20.0,20.0
8484,0,8484,[ 56 405  70 288 483],13,2,30860,3.6370064820271066,20.0,0.0
8485,0,8485,[144 385 245 182  50],328,3,30863,3.6369314164506243,0.0,20.0
8486,0,8486,[302 603 427  50 313],271,5,30868,3.637092023094144,20.0,20.0
8487,0,8487,[257 475 111 174  64],92,3,30871,3.6370169651272386,0.0,20.0
8488,0,8488,[ 28 191 179 186  88],92,3,30874,3.636941924843916,0.0,0.0
8489,0,8489,[215  82 125  88 403],533,4,30878,3.6369846878680803,0.0,0.0
8490,0,8490,[302 603 427  50 313],537,5,30883,3.637145212578024,20.0,20.0
8491,0,8491,[483 216 202  79 181],659,4,30887,3.6371879415920865,20.0,0.0
8492,0,8492,[273 333 196 143 234],346,2,30889,3.636995172494996,0.0,0.0
8493,0,8493,[ 22 176 197 180 423],774,2,30891,3.636802448787379,0.0,0.0
8494,0,8494,[ 88 179  25 603 117],474,5,30896,3.636962919364332,20.0,0.0
8495,0,8495,[302 603 427  50 313],13,5,30901,3.637123352165725,20.0,20.0
8496,0,8496,[302 603 427  50 313],669,5,30906,3.637283747204896,20.0,20.0
8497,0,8497,[153 427 168 181 143],295,5,30911,3.6374441044951755,0.0,0.0
8498,0,8498,[ 11 427 269 289 175],537,2,30913,3.6372514413460406,0.0,0.0
8499,0,8499,[117 176  82 161 678],387,1,30914,3.636941176470588,0.0,0.0
8500,0,8500,[ 22 286 181 111 275],95,4,30918,3.6369838842489117,0.0,0.0
8501,0,8501,[176 187  97 357 294],659,5,30923,3.637144201364385,20.0,0.0
8502,0,8502,[151 210 144 496 748],64,1,30924,3.6368340585675645,0.0,0.0
8503,0,8503,[302 603 427  50 313],13,5,30929,3.636994355597366,20.0,20.0
8504,0,8504,[302 603 427  50 313],271,5,30934,3.637154614932393,20.0,20.0
8505,0,8505,[202 257   9   1  96],447,1,30935,3.6368445802962617,0.0,0.0
8506,0,8506,[302 603 427  50 313],454,5,30940,3.637004819560362,20.0,20.0
8507,0,8507,[172 195  56   8  97],7,5,30945,3.6371650211565587,0.0,0.0
8508,0,8508,[546 195 144 216 197],479,3,30948,3.6370901398519213,0.0,0.0
8509,0,8509,[508 471 191 181 318],474,3,30951,3.637015276145711,20.0,0.0
8510,0,8510,[302 603 427  50 313],13,5,30956,3.637175420044648,20.0,20.0
8511,0,8511,[302 603 427  50 313],334,5,30961,3.6373355263157894,20.0,20.0
8512,0,8512,[ 12 195 161 197 211],379,3,30964,3.637260660166804,20.0,0.0
8513,0,8513,[302 603 427  50 313],669,5,30969,3.6374207188160677,20.0,20.0
8514,0,8514,[302 603 427  50 313],669,5,30974,3.6375807398708164,20.0,20.0
8515,0,8515,[ 28 228 568  50  96],892,4,30978,3.6376232973226865,0.0,20.0
8516,0,8516,[ 89  98  79 322 182],474,5,30983,3.637783257015381,0.0,20.0
8517,0,8517,[302 603 427  50 313],454,5,30988,3.637943179150035,20.0,20.0
8518,0,8518,[ 88 175  70  22  50],479,5,30993,3.6381030637398757,0.0,20.0
8519,0,8519,[183 597 132  98 125],788,3,30996,3.6380281690140843,0.0,20.0
8520,0,8520,[153 483   1 195  70],210,5,31001,3.63818800610257,20.0,0.0
8521,0,8521,[655  56 258  88 288],13,4,31005,3.638230462332786,0.0,0.0
8522,0,8522,[197 135  64 273 258],207,4,31009,3.6382729086002583,0.0,0.0
8523,0,8523,[237  88 200 185 187],313,2,31011,3.63808071328015,0.0,0.0
8524,0,8524,[ 71 135 238   8 603],334,4,31015,3.6381231671554253,20.0,0.0
8525,0,8525,[588 144  15 405 423],378,4,31019,3.638165611072015,0.0,0.0
8526,0,8526,[185 210 183 423 294],194,2,31021,3.637973495954028,0.0,0.0
8527,0,8527,[333 195 196 403 179],815,3,31024,3.6378986866791743,0.0,0.0
8528,0,8528,[196 186 204 180   1],311,4,31028,3.6379411419861647,0.0,0.0
8529,0,8529,[269 222 258  15 588],537,1,31029,3.6376318874560374,0.0,0.0
8530,0,8530,[258 210 191 179  82],537,3,31032,3.637557144531708,0.0,0.0
8531,0,8531,[172  79  70 568  97],524,4,31036,3.637599624941397,0.0,0.0
8532,0,8532,[423 200 204 238   8],543,3,31039,3.6375249033165358,0.0,0.0
8533,0,8533,[173 144 125 423 228],398,4,31043,3.637567377548629,0.0,0.0
8534,0,8534,[258 403 143 322  11],749,5,31048,3.637727006444054,0.0,0.0
8535,0,8535,[211 215  64  95 300],749,4,31052,3.6377694470477975,0.0,0.0
8536,0,8536,[132 196  79 181   7],295,5,31057,3.6379290148764203,0.0,0.0
8537,0,8537,[121 176 211  71 655],406,3,31060,3.637854298430546,0.0,0.0
8538,0,8538,[302 603 427  50 313],13,5,31065,3.6380138189483544,20.0,20.0
8539,0,8539,[180 111 186 173  71],749,4,31069,3.638056206088993,0.0,0.0
8540,0,8540,[127 185  79 333 143],313,4,31073,3.6380985833040627,0.0,20.0
8541,0,8541,[238 234 222  69 318],537,2,31075,3.637906813392648,20.0,0.0
8542,0,8542,[302 603 427  50 313],669,5,31080,3.638066253072691,20.0,20.0
8543,0,8543,[ 98 282 269 181 182],666,3,31083,3.637991573033708,0.0,20.0
8544,0,8544,[186  28 483 286  22],380,4,31087,3.638033937975424,20.0,0.0
8545,0,8545,[678 588 191  89  64],664,2,31089,3.6378422653873157,0.0,0.0
8546,0,8546,[168 568 153  28 180],387,4,31093,3.6378846378846377,0.0,0.0
8547,0,8547,[302 603 427  50 313],271,5,31098,3.63804398689752,20.0,20.0
8548,0,8548,[ 11 100 195 210 222],454,3,31101,3.637969353140718,0.0,20.0
8549,0,8549,[328 194  79 153 151],313,3,31104,3.6378947368421053,0.0,0.0
8550,0,8550,[302 603 427  50 313],271,5,31109,3.638054028768565,20.0,20.0
8551,0,8551,[172 121 403 423 234],308,3,31112,3.637979420018709,0.0,0.0
8552,0,8552,[302 603 427  50 313],14,4,31116,3.6380217467555243,20.0,20.0
8553,0,8553,[186 286 202 300 322],409,2,31118,3.6378302548515316,0.0,0.0
8554,0,8554,[179 161 180 100 302],380,2,31120,3.6376388077147865,0.0,20.0
8555,0,8555,[ 12 200 195 228 546],374,4,31124,3.63768115942029,20.0,0.0
8556,0,8556,[197 546 204 238 216],749,3,31127,3.6376066378403644,0.0,0.0
8557,0,8557,[ 28 276 182  71   9],308,4,31131,3.637648983407338,0.0,0.0
8558,0,8558,[175  56 176 546 143],804,2,31133,3.6374576469213693,0.0,0.0
8559,0,8559,[  1 100 153 322 161],749,3,31136,3.6373831775700936,0.0,20.0
8560,0,8560,[235  50  95   1 144],125,4,31140,3.6374255344001867,0.0,20.0
8561,0,8561,[202  79 216  82 435],815,4,31144,3.6374678813361365,0.0,0.0
8562,0,8562,[ 82 197 180 183 423],536,3,31147,3.637393436879598,0.0,0.0
8563,0,8563,[302 603 427  50 313],334,5,31152,3.6375525455394677,20.0,20.0
8564,0,8564,[302 603 427  50 313],334,5,31157,3.637711617046118,20.0,20.0
8565,0,8565,[515 195  97 153 265],308,2,31159,3.637520429605417,0.0,0.0
8566,0,8566,[515  96 546 294 588],13,2,31161,3.6373292867981792,0.0,0.0
8567,0,8567,[588  97 228 172 496],650,3,31164,3.6372549019607843,0.0,0.0
8568,0,8568,[302 603 427  50 313],334,5,31169,3.637413933947952,20.0,20.0
8569,0,8569,[302 603 427  50 313],271,5,31174,3.6375729288214704,20.0,20.0
8570,0,8570,[313 288 187 328 174],537,2,31176,3.6373818690934545,0.0,20.0
8571,0,8571,[302 603 427  50 313],474,5,31181,3.6375408306112926,20.0,20.0
8572,0,8572,[182 234 179 405 269],13,2,31183,3.6373498191998133,0.0,0.0
8573,0,8573,[471  89 172 238 603],454,1,31184,3.637042220667133,20.0,0.0
8574,0,8574,[405 173 202 245  88],200,3,31187,3.6369679300291544,0.0,0.0
8575,0,8575,[202 289 748 322   7],92,1,31188,3.636660447761194,0.0,0.0
8576,0,8576,[174 204 275 121 357],899,5,31193,3.6368194007228634,20.0,20.0
8577,0,8577,[322 313  69 151 748],533,3,31196,3.636745162042434,0.0,0.0
8578,0,8578,[302 603 427  50 313],454,5,31201,3.636904068073202,20.0,20.0
8579,0,8579,[161 197 153 202 117],234,1,31202,3.6365967365967364,0.0,0.0
8580,0,8580,[127 215 194 196 313],215,4,31206,3.636639086353572,0.0,20.0
8581,0,8581,[ 25 121 180 187 179],897,3,31209,3.6365649032859473,0.0,0.0
8582,0,8582,[ 56 678 121  82  22],92,2,31211,3.636374228125364,0.0,0.0
8583,0,8583,[385   1 196 288 234],804,4,31215,3.636416589002796,0.0,0.0
8584,0,8584,[ 50 273 144 174 435],102,2,31217,3.6362259755387303,0.0,40.0
8585,0,8585,[302 603 427  50 313],334,5,31222,3.636384812485441,20.0,20.0
8586,0,8586,[508 234 181 313  56],232,2,31224,3.636194247117736,0.0,0.0
8587,0,8587,[118 276 271 294 173],13,2,31226,3.636003726129483,0.0,0.0
8588,0,8588,[302 603 427  50 313],14,4,31230,3.6360461054837585,20.0,20.0
8589,0,8589,[258 265 282  69 318],378,4,31234,3.6360884749708964,20.0,0.0
8590,0,8590,[125 180 403 237 289],194,0,31234,3.6356652310557562,0.0,0.0
8591,0,8591,[176 111 204 748  71],474,4,31238,3.635707635009311,0.0,0.0
8592,0,8592,[302 603 427  50 313],271,5,31243,3.63586640288607,20.0,20.0
8593,0,8593,[603 197 568 153  89],650,4,31247,3.6359087735629507,20.0,0.0
8594,0,8594,[180 289 100  82 403],788,3,31250,3.6358347876672483,0.0,20.0
8595,0,8595,[403 135   8 228 191],533,2,31252,3.635644485807352,0.0,0.0
8596,0,8596,[  4 294 117 161 568],378,2,31254,3.6354542282191464,0.0,0.0
8597,0,8597,[403 121 318 153 111],378,4,31258,3.6354966271225866,20.0,0.0
8598,0,8598,[100 228 483  96 588],881,2,31260,3.6353064309803464,20.0,20.0
8599,0,8599,[100 483  12  28 403],7,5,31265,3.63546511627907,40.0,20.0
8600,0,8600,[228 197 172 275 475],455,5,31270,3.6356237646785257,0.0,0.0
8601,0,8601,[196  82  70 175 153],659,5,31275,3.6357823761915835,0.0,0.0
8602,0,8602,[302 275 196  11  79],13,2,31277,3.6355922352667673,0.0,0.0
8603,0,8603,[302 603 427  50 313],474,5,31282,3.6357508135750813,20.0,20.0
8604,0,8604,[302 603 427  50 313],14,4,31286,3.6357931435212087,20.0,20.0
8605,0,8605,[302 603 427  50 313],669,5,31291,3.63595166163142,20.0,20.0
8606,0,8606,[185 475 289  50 228],334,4,31295,3.635993958405949,0.0,20.0
8607,0,8607,[ 28 186 194  88 603],308,4,31299,3.63603624535316,20.0,0.0
8608,0,8608,[302 603 427  50 313],669,5,31304,3.636194679986061,20.0,20.0
8609,0,8609,[179 161 121   7 222],932,3,31307,3.6361207897793264,0.0,0.0
8610,0,8610,[302 603 427  50 313],454,5,31312,3.6362791777958425,20.0,20.0
8611,0,8611,[302 603 427  50 313],537,5,31317,3.6364375290292617,20.0,20.0
8612,0,8612,[275  71  88  89 323],648,4,31321,3.6364797399280158,0.0,0.0
8613,0,8613,[168 176  69 194  88],653,1,31322,3.636173670768516,0.0,0.0
8614,0,8614,[194 286 182  98  50],653,2,31324,3.635983749274521,0.0,40.0
8615,0,8615,[143 403 234 496 125],59,3,31327,3.6359099350046424,0.0,0.0
8616,0,8616,[302 603 427  50 313],271,5,31332,3.636068237205524,20.0,20.0
8617,0,8617,[302 603 427  50 313],14,4,31336,3.6361104664655373,20.0,20.0
8618,0,8618,[302 603 427  50 313],271,5,31341,3.6362687086668988,20.0,20.0
8619,0,8619,[185 328  88  79 245],102,0,31341,3.63584686774942,0.0,0.0
8620,0,8620,[302 603 427  50 313],334,5,31346,3.6360051038162626,20.0,20.0
8621,0,8621,[678 216  69 100   7],474,4,31350,3.6360473208072372,0.0,20.0
8622,0,8622,[294  88 238 568 222],648,3,31353,3.635973559086165,0.0,0.0
8623,0,8623,[ 96 197 427 125 483],313,4,31357,3.636015769944341,20.0,0.0
8624,0,8624,[211 385 357 185 168],774,0,31357,3.6355942028985506,20.0,0.0
8625,0,8625,[237 172 127  12 179],64,5,31362,3.635752376536054,20.0,20.0
8626,0,8626,[515 174 318 195 228],537,2,31364,3.6355627680537848,20.0,20.0
8627,0,8627,[182  12 427 216 423],666,3,31367,3.6354891052387575,20.0,0.0
8628,0,8628,[195 508 215 568  22],13,2,31369,3.6352995712133502,0.0,0.0
8629,0,8629,[228 515 211 210 168],406,2,31371,3.6351100811123986,0.0,0.0
8630,0,8630,[273 405 475 282 183],92,4,31375,3.635152357780095,0.0,0.0
8631,0,8631,[234 289 268 172 385],234,2,31377,3.6349629286376275,0.0,0.0
8632,0,8632,[357 603 318 202 496],899,5,31382,3.6351210471446773,60.0,0.0
8633,0,8633,[302 603 427  50 313],474,5,31387,3.6352791290247857,20.0,20.0
8634,0,8634,[515 357 546  11 153],343,4,31391,3.635321366531558,20.0,0.0
8635,0,8635,[151 475  56 196 222],537,2,31393,3.6351320055581287,0.0,0.0
8636,0,8636,[121 210   9 161  64],932,2,31395,3.6349426884334837,0.0,0.0
8637,0,8637,[111  69 175 276 228],447,3,31398,3.634869182681176,0.0,0.0
8638,0,8638,[ 88 222 245  70 211],102,0,31398,3.6344484315314274,0.0,0.0
8639,0,8639,[100 228 180  12 181],239,2,31400,3.634259259259259,20.0,20.0
8640,0,8640,[273 174 423 143  15],374,1,31401,3.6339544034255296,0.0,20.0
8641,0,8641,[194   8 322 144 200],313,2,31403,3.6337653320990513,0.0,0.0
8642,0,8642,[435 237 173 135 276],144,4,31407,3.6338077056577576,0.0,0.0
8643,0,8643,[302 603 427  50 313],474,5,31412,3.6339657565941694,20.0,20.0
8644,0,8644,[ 89   4 204 318 269],271,4,31416,3.634008097165992,20.0,0.0
8645,0,8645,[403 427 322 222 588],13,2,31418,3.6338191071015498,0.0,0.0
8646,0,8646,[302 603 427  50 313],537,5,31423,3.633977101885047,20.0,20.0
8647,0,8647,[173 182 655  97 121],210,5,31428,3.63413506012951,0.0,0.0
8648,0,8648,[302 603 427  50 313],271,5,31433,3.6342929818476124,20.0,20.0
8649,0,8649,[603 403 323 328 282],804,4,31437,3.634335260115607,20.0,0.0
8650,0,8650,[111 132 135  11  95],13,4,31441,3.6343775286094093,0.0,0.0
8651,0,8651,[427 435 118 385 183],890,3,31444,3.634304207119741,0.0,0.0
8652,0,8652,[ 97  28  69 302 100],615,4,31448,3.634346469432567,0.0,20.0
8653,0,8653,[174 183 405  15 111],653,1,31449,3.634042061474463,0.0,20.0
8654,0,8654,[ 12 222 546  96   7],328,3,31452,3.6339688041594456,20.0,0.0
8655,0,8655,[302 603 427  50 313],334,5,31457,3.634126617375231,20.0,20.0
8656,0,8656,[405 181 185 197  64],82,3,31460,3.634053367217281,0.0,0.0
8657,0,8657,[ 88 742 276 117  15],308,3,31463,3.633980133980134,0.0,0.0
8658,0,8658,[515 185 603 204 385],13,2,31465,3.633791430881164,20.0,0.0
8659,0,8659,[ 97  71 302   7 322],13,3,31468,3.633718244803695,0.0,0.0
8660,0,8660,[228 385 125 286  69],648,2,31470,3.6335296155178387,0.0,0.0
8661,0,8661,[302 603 427  50 313],334,5,31475,3.6336873701223737,20.0,20.0
8662,0,8662,[294 143 172 173   4],749,4,31479,3.6337296548539766,0.0,0.0
8663,0,8663,[ 88 328   4 282 286],653,2,31481,3.6335410895660205,0.0,0.0
8664,0,8664,[ 25  69 235  70 286],648,1,31482,3.6332371609924987,0.0,0.0
8665,0,8665,[125 238 194 215  15],653,0,31482,3.6328179090699284,0.0,0.0
8666,0,8666,[257 181 237 286 196],271,5,31487,3.6329756547825083,0.0,0.0
8667,0,8667,[568 182  50  82 245],378,4,31491,3.633017997231195,0.0,20.0
8668,0,8668,[483  70 196  88 423],840,4,31495,3.633060329911178,20.0,0.0
8669,0,8669,[302 603 427  50 313],334,5,31500,3.633217993079585,20.0,20.0
8670,0,8670,[135 194 144 568 405],87,5,31505,3.6333756198823663,0.0,0.0
8671,0,8671,[302 603 427  50 313],454,5,31510,3.633533210332103,20.0,20.0
8672,0,8672,[302 603 427  50 313],454,5,31515,3.63369076444137,20.0,20.0
8673,0,8673,[216 238 125  82 385],295,5,31520,3.6338482822227345,0.0,0.0
8674,0,8674,[197 385 153 568  98],13,3,31523,3.6337752161383285,0.0,20.0
8675,0,8675,[302 603 427  50 313],271,5,31528,3.6339326878745966,20.0,20.0
8676,0,8676,[475 235 153  70  82],13,1,31529,3.6336291344934883,0.0,0.0
8677,0,8677,[333  98 322 194 286],329,3,31532,3.6335561189214105,0.0,20.0
8678,0,8678,[182 194  69  98 196],650,3,31535,3.633483120175135,0.0,20.0
8679,0,8679,[302 603 427  50 313],271,5,31540,3.633640552995392,20.0,20.0
8680,0,8680,[302 603 427  50 313],454,5,31545,3.6337979495449835,20.0,20.0
8681,0,8681,[  7 273 237 300 125],190,4,31549,3.633840129002534,0.0,0.0
8682,0,8682,[302 603 427  50 313],14,4,31553,3.6338822987446733,20.0,20.0
8683,0,8683,[302 603 427  50 313],474,5,31558,3.634039613081529,20.0,20.0
8684,0,8684,[289 117 194 286  82],378,4,31562,3.634081750143926,0.0,0.0
8685,0,8685,[202 237  89 127 180],452,3,31565,3.6340087497121805,0.0,20.0
8686,0,8686,[161 187  98 322   4],328,3,31568,3.633935766087257,0.0,20.0
8687,0,8687,[403 143 237 195 173],42,4,31572,3.633977900552486,0.0,0.0
8688,0,8688,[403 471 175 265  69],378,3,31575,3.633904937277017,0.0,0.0
8689,0,8689,[151 265 228 568 121],536,4,31579,3.6339470655926354,0.0,0.0
8690,0,8690,[  8  64  50 151 275],95,4,31583,3.6339891842135543,0.0,20.0
8691,0,8691,[302 603 427  50 313],271,5,31588,3.6341463414634148,20.0,20.0
8692,0,8692,[302 603 427  50 313],537,5,31593,3.6343034625560797,20.0,20.0
8693,0,8693,[515 174 216 228 222],488,4,31597,3.6343455256498736,0.0,20.0
8694,0,8694,[235 328  97 588 180],313,4,31601,3.6343875790684304,0.0,0.0
8695,0,8695,[228  82  98 191 187],892,3,31604,3.6343146274149034,0.0,20.0
8696,0,8696,[302 603 427  50 313],14,4,31608,3.634356674715419,20.0,20.0
8697,0,8697,[427  82  89 403 483],339,4,31612,3.634398712347666,20.0,0.0
8698,0,8698,[117 200  22  50 211],897,4,31616,3.6344407403149788,0.0,20.0
8699,0,8699,[302 603 427  50 127],14,4,31620,3.6344827586206896,20.0,40.0
8700,0,8700,[302 603 427  50 313],537,5,31625,3.634639696586599,20.0,20.0
8701,0,8701,[ 97  25 100 172 300],892,5,31630,3.634796598483107,0.0,20.0
8702,0,8702,[ 98 216  56 144 742],648,4,31634,3.634838561415604,0.0,20.0
8703,0,8703,[ 11  98 180 143 197],59,4,31638,3.6348805147058822,0.0,20.0
8704,0,8704,[ 98 132 182 403   4],210,5,31643,3.6350373348650202,0.0,20.0
8705,0,8705,[121 294 215  79  22],311,5,31648,3.635194118998392,0.0,0.0
8706,0,8706,[ 79 318   1 742 222],84,3,31651,3.635121166877225,20.0,0.0
8707,0,8707,[  4 191 385 121 258],474,5,31656,3.6352779053743682,0.0,0.0
8708,0,8708,[496 423 276   7 483],234,3,31659,3.6352049603858076,20.0,0.0
8709,0,8709,[216 257  89 273 427],374,1,31660,3.634902411021814,0.0,0.0
8710,0,8710,[ 79 172 234 200 603],899,5,31665,3.6350591206520493,20.0,0.0
8711,0,8711,[127 322  56 222 385],537,2,31667,3.6348714416896235,0.0,20.0
8712,0,8712,[328  25  69 172 174],13,3,31670,3.6347985768392057,0.0,20.0
8713,0,8713,[143 269 496 185 258],6,3,31673,3.6347257287124166,0.0,0.0
8714,0,8714,[216  71 181 496 294],648,3,31676,3.6346528973034995,0.0,0.0
8715,0,8715,[180 322 475 117 276],474,5,31681,3.634809545663148,0.0,0.0
8716,0,8716,[302 603 427  50 313],537,5,31686,3.634966158081909,20.0,20.0
8717,0,8717,[302 603 427  50 313],537,5,31691,3.6351227345721497,20.0,20.0
8718,0,8718,[151 265   9 118  56],200,4,31695,3.6351645830943915,0.0,0.0
8719,0,8719,[302 603 427  50 313],271,5,31700,3.635321100917431,20.0,20.0
8720,0,8720,[215  70   4 237  22],537,1,31701,3.6350189198486413,0.0,0.0
8721,0,8721,[282 471  79   1 196],455,4,31705,3.6350607658793854,0.0,0.0
8722,0,8722,[ 97 176 135 423 742],666,3,31708,3.6349879628568154,0.0,0.0
8723,0,8723,[302 603 427  50 313],13,5,31713,3.635144429160935,20.0,20.0
8724,0,8724,[235 288  89 153 125],378,3,31716,3.6350716332378226,0.0,0.0
8725,0,8725,[302 603 427  50 313],454,5,31721,3.635228054091222,20.0,20.0
8726,0,8726,[100 496 204 174 111],87,5,31726,3.6353844390970553,0.0,40.0
8727,0,8727,[ 88  97 143 288   8],452,2,31728,3.6351970669110907,0.0,0.0
8728,0,8728,[ 82 276 234 176  95],537,1,31729,3.6348951769962197,0.0,0.0
8729,0,8729,[  7   1  95  69 183],295,4,31733,3.6349369988545246,0.0,0.0
8730,0,8730,[235 118 423 515 202],271,3,31736,3.634864276715153,0.0,0.0
8731,0,8731,[185 172 313 194 294],102,0,31736,3.6344480073293632,0.0,0.0
8732,0,8732,[238 172 175 210 182],892,5,31741,3.6346043742127563,0.0,0.0
8733,0,8733,[185 655 294  64  22],881,4,31745,3.634646210212961,0.0,0.0
8734,0,8734,[302 603 427  50 313],14,4,31749,3.63468803663423,20.0,20.0
8735,0,8735,[302 603 427  50 313],271,5,31754,3.6348443223443225,20.0,20.0
8736,0,8736,[302 603 427  50 313],271,5,31759,3.6350005722788143,20.0,20.0
8737,0,8737,[191 405 181 118 202],833,2,31761,3.634813458457313,0.0,0.0
8738,0,8738,[302 603 427  50 313],537,5,31766,3.634969676164321,20.0,20.0
8739,0,8739,[302 603 427  50 313],669,5,31771,3.63512585812357,20.0,20.0
8740,0,8740,[ 88 300   8 197 182],454,4,31775,3.6351676009609886,0.0,0.0
8741,0,8741,[70 79 89 15 88],653,2,31777,3.6349805536490507,0.0,0.0
8742,0,8742,[175 197 265 333 210],666,2,31779,3.6347935491250145,0.0,0.0
8743,0,8743,[302 603 427  50 313],474,5,31784,3.634949679780421,20.0,20.0
8744,0,8744,[  9 179  25 403 191],92,4,31788,3.634991423670669,0.0,0.0
8745,0,8745,[302 603 427  50 313],669,5,31793,3.6351474959981704,20.0,20.0
8746,0,8746,[  9 588 202  50 403],311,5,31798,3.635303532639762,0.0,20.0
8747,0,8747,[302 603 427  50 313],454,5,31803,3.6354595336076816,20.0,20.0
8748,0,8748,[191 210   1  25 135],92,4,31807,3.6355012001371585,0.0,0.0
8749,0,8749,[289 234   4 483 132],232,4,31811,3.635542857142857,20.0,0.0
8750,0,8750,[323 181 127 546  95],804,2,31813,3.635355959318935,0.0,20.0
8751,0,8751,[423 216 508 143 174],339,3,31816,3.6352833638025595,0.0,20.0
8752,0,8752,[  8 204 515 168  70],271,4,31820,3.6353250314177994,0.0,0.0
8753,0,8753,[302 603 427  50 313],454,5,31825,3.6354809230066256,20.0,20.0
8754,0,8754,[302 603 427  50 313],271,5,31830,3.635636778983438,20.0,20.0
8755,0,8755,[302 603 427  50 313],537,5,31835,3.6357925993604385,20.0,20.0
8756,0,8756,[  1 183  79 135 173],64,5,31840,3.635948384149823,0.0,0.0
8757,0,8757,[597 186  97 153 176],328,2,31842,3.6357615894039736,0.0,0.0
8758,0,8758,[117  11 568 200 483],897,2,31844,3.635574837310195,20.0,0.0
8759,0,8759,[222 186 161  12   4],524,2,31846,3.635388127853881,20.0,0.0
8760,0,8760,[300  79  88 302 202],271,4,31850,3.635429745462847,0.0,0.0
8761,0,8761,[187 168 153 435 176],102,0,31850,3.635014836795252,0.0,0.0
8762,0,8762,[385 302 200 258 357],13,2,31852,3.6348282551637565,20.0,0.0
8763,0,8763,[ 82 197 423  71 435],398,5,31857,3.6349840255591053,0.0,0.0
8764,0,8764,[302 603 427  50 313],14,4,31861,3.635025670279521,20.0,20.0
8765,0,8765,[427   7 234  25 151],308,4,31865,3.635067305498517,0.0,0.0
8766,0,8766,[302 603 427  50 313],454,5,31870,3.635222995323372,20.0,20.0
8767,0,8767,[180  79 161 265  95],308,3,31873,3.6351505474452557,0.0,0.0
8768,0,8768,[127   7 185  12 195],666,4,31877,3.635192154179496,20.0,20.0
8769,0,8769,[302 603 427  50 313],454,5,31882,3.6353477765108324,20.0,20.0
8770,0,8770,[302 603 427  50 313],669,5,31887,3.635503363356516,20.0,20.0
8771,0,8771,[302 603 427  50 313],474,5,31892,3.635658914728682,20.0,20.0
8772,0,8772,[302 603 427  50 313],14,4,31896,3.6357004445457655,20.0,20.0
8773,0,8773,[302 603 427  50 313],271,5,31901,3.6358559379986324,20.0,20.0
8774,0,8774,[302 603 427  50 313],454,5,31906,3.636011396011396,20.0,20.0
8775,0,8775,[302 603 427  50 313],271,5,31911,3.6361668185961715,20.0,20.0
8776,0,8776,[403 435 195  28   9],60,4,31915,3.636208271619004,0.0,0.0
8777,0,8777,[302 603 427  50 313],13,5,31920,3.6363636363636362,20.0,20.0
8778,0,8778,[302 603 427  50 313],669,5,31925,3.636518965713635,20.0,20.0
8779,0,8779,[257 111 245 172  56],533,3,31928,3.6364464692482916,0.0,0.0
8780,0,8780,[234  15 515 182  97],271,3,31931,3.636373989295069,0.0,0.0
8781,0,8781,[ 96 182 568 323 100],881,2,31933,3.6361876565702573,0.0,20.0
8782,0,8782,[197 603 182  11 135],90,4,31937,3.636229078902425,20.0,0.0
8783,0,8783,[302 603 427  50 313],271,5,31942,3.636384335154827,20.0,20.0
8784,0,8784,[471 235  89  95 100],537,2,31944,3.636198064883324,0.0,20.0
8785,0,8785,[322 153 172 111 144],488,1,31945,3.635898019576599,0.0,0.0
8786,0,8786,[210 195 655 357 176],815,3,31948,3.6358256515306704,20.0,0.0
8787,0,8787,[204  88  64  71  12],92,4,31952,3.635867091488393,20.0,0.0
8788,0,8788,[179 186 294 742  11],881,3,31955,3.6357947434292868,0.0,0.0
8789,0,8789,[302 603 427  50 313],454,5,31960,3.6359499431171787,20.0,20.0
8790,0,8790,[258 405 161 151 172],533,3,31963,3.63587760209305,0.0,0.0
8791,0,8791,[204 265 385 318 215],194,3,31966,3.635805277525023,20.0,0.0
8792,0,8792,[216  11 168 179  98],339,4,31970,3.635846696235642,0.0,20.0
8793,0,8793,[127 200   7 405  56],804,2,31972,3.635660677734819,0.0,20.0
8794,0,8794,[174 655 172   8 187],213,4,31976,3.6357021034678794,0.0,20.0
8795,0,8795,[ 12  70 111 508 174],6,2,31978,3.6355161437016825,20.0,20.0
8796,0,8796,[  7  70  96 191 294],7,3,31981,3.635443901329999,0.0,0.0
8797,0,8797,[ 69 483  70  12 172],664,3,31984,3.6353716753807683,40.0,0.0
8798,0,8798,[403   4 179 135 546],650,1,31985,3.635072167291738,0.0,0.0
8799,0,8799,[200  28 245 300 211],666,2,31987,3.6348863636363635,0.0,0.0
8800,0,8800,[196 588 151 483 427],537,2,31989,3.634700602204295,20.0,0.0
8801,0,8801,[302 603 427  50 313],537,5,31994,3.6348557146103158,20.0,20.0
8802,0,8802,[302 603 427  50 313],537,5,31999,3.635010791775531,20.0,20.0
8803,0,8803,[127 194  69  12 427],398,4,32003,3.6350522489777375,20.0,20.0
8804,0,8804,[174 185 423 121 197],184,3,32006,3.6349801249290175,0.0,20.0
8805,0,8805,[302 603 427  50 313],537,5,32011,3.635135135135135,20.0,20.0
8806,0,8806,[ 64  79 427  11 181],271,5,32016,3.6352901101396617,0.0,0.0
8807,0,8807,[153 211  97 174 318],488,4,32020,3.6353315168029066,20.0,20.0
8808,0,8808,[111 185 282 742 265],207,3,32023,3.6352593938017934,0.0,0.0
8809,0,8809,[302 603 427  50 313],669,5,32028,3.6354143019296252,20.0,20.0
8810,0,8810,[143  64 588 546 200],313,3,32031,3.635342185903984,0.0,0.0
8811,0,8811,[161 174 423 153 121],804,4,32035,3.6353835678620063,0.0,20.0
8812,0,8812,[168 153 515 161 234],326,2,32037,3.635198002950187,0.0,0.0
8813,0,8813,[302 603 427  50 313],454,5,32042,3.635352847742228,20.0,20.0
8814,0,8814,[182 597 172 286 194],7,4,32046,3.63539421440726,0.0,0.0
8815,0,8815,[174 222 200  25 405],648,3,32049,3.6353221415607986,0.0,20.0
8816,0,8816,[302 603 427  50 313],334,5,32054,3.6354769195871612,20.0,20.0
8817,0,8817,[132  15 100 161  98],881,2,32056,3.6352914493082333,0.0,40.0
8818,0,8818,[118 174 173 286 222],454,2,32058,3.635106021090827,0.0,20.0
8819,0,8819,[328   8 211 174 179],207,3,32061,3.635034013605442,0.0,20.0
8820,0,8820,[265 135 172 168  97],313,4,32065,3.635075388277973,0.0,0.0
8821,0,8821,[117 191 195 173  82],882,5,32070,3.6352301065518025,0.0,0.0
8822,0,8822,[  8 403   4 161 168],533,2,32072,3.635044769352828,0.0,0.0
8823,0,8823,[508  28  50 181 289],387,4,32076,3.6350861287398004,0.0,20.0
8824,0,8824,[  8  70 168 202 211],479,5,32081,3.6352407932011332,0.0,0.0
8825,0,8825,[181 289   9 117  70],881,2,32083,3.6350555177883526,0.0,0.0
8826,0,8826,[302 603 427  50 313],13,5,32088,3.635210150674068,20.0,20.0
8827,0,8827,[742 275  69 132 289],554,4,32092,3.6352514725872225,0.0,0.0
8828,0,8828,[403   4 200  98 176],59,5,32097,3.635406048250085,0.0,20.0
8829,0,8829,[742  25 127 194  82],59,3,32100,3.6353340883352208,0.0,20.0
8830,0,8830,[ 82 286 197 186 238],194,3,32103,3.6352621447174727,0.0,0.0
8831,0,8831,[273 194 289  70 161],10,5,32108,3.6354166666666665,0.0,0.0
8832,0,8832,[228 385 222   1 271],536,4,32112,3.635457941809125,0.0,0.0
8833,0,8833,[302 603 427  50 313],14,4,32116,3.635499207606973,20.0,20.0
8834,0,8834,[172 202  28  50 546],648,5,32121,3.635653650254669,0.0,20.0
8835,0,8835,[172   7 194 385   4],881,3,32124,3.6355817111815303,0.0,0.0
8836,0,8836,[302 603 427  50 313],14,4,32128,3.635622948964581,20.0,20.0
8837,0,8837,[187  22  50 678 508],339,4,32132,3.635664177415705,0.0,20.0
8838,0,8838,[216 603  89 153 211],385,3,32135,3.6355922615680507,20.0,0.0
8839,0,8839,[197 258 143  70 118],666,3,32138,3.63552036199095,0.0,0.0
8840,0,8840,[ 69 515 742 196 568],881,3,32141,3.6354484786788825,0.0,0.0
8841,0,8841,[588 144  79  50 183],843,1,32142,3.6351504184573624,0.0,20.0
8842,0,8842,[132   8 515 176  64],271,4,32146,3.6351916770326813,0.0,0.0
8843,0,8843,[302 603 427  50 313],669,5,32151,3.635345997286296,20.0,20.0
8844,0,8844,[302 603 427  50 313],334,5,32156,3.6355002826455625,20.0,20.0
8845,0,8845,[135  64 194 471 403],234,3,32159,3.635428442233778,0.0,0.0
8846,0,8846,[179 318 603 588 174],465,3,32162,3.63535661806262,40.0,20.0
8847,0,8847,[302 603 427  50 313],14,4,32166,3.6353978300180834,20.0,20.0
8848,0,8848,[302 603 427  50 313],669,5,32171,3.635552039778506,20.0,20.0
8849,0,8849,[ 69 185 655 143   9],406,3,32174,3.6354802259887005,0.0,0.0
8850,0,8850,[302 603 427  50 313],13,5,32179,3.63563439159417,20.0,20.0
8851,0,8851,[302 603 427  50 313],14,4,32183,3.635675553547221,20.0,20.0
8852,0,8852,[568   7  96 121   4],13,3,32186,3.635603750141195,0.0,0.0
8853,0,8853,[302 603 427  50 313],13,5,32191,3.6357578495595213,20.0,20.0
8854,0,8854,[215 161  50 265 289],234,2,32193,3.635573122529644,0.0,20.0
8855,0,8855,[210  64  97  95  28],85,3,32196,3.63550135501355,0.0,0.0
8856,0,8856,[210 118 182  70 195],840,2,32198,3.63531669865643,0.0,0.0
8857,0,8857,[357 300 435 176   8],328,4,32202,3.635357868593362,20.0,0.0
8858,0,8858,[385 258 176  89 111],899,4,32206,3.6353990292358054,0.0,0.0
8859,0,8859,[483 235   4 282 546],374,2,32208,3.6352144469525958,20.0,0.0
8860,0,8860,[302 603 427  50 313],669,5,32213,3.635368468570139,20.0,20.0
8861,0,8861,[183 265 187 385 196],766,2,32215,3.6351839313924623,0.0,0.0
8862,0,8862,[288 276 588 197 173],59,4,32219,3.635225093083606,0.0,0.0
8863,0,8863,[196 286 168 151 127],666,3,32222,3.6351534296028882,0.0,20.0
8864,0,8864,[508 191  56 182 288],378,4,32226,3.6351945854483927,0.0,0.0
8865,0,8865,[135 313 678 185 228],454,1,32227,3.634897360703812,0.0,0.0
8866,0,8866,[ 22 238  96 185 403],13,2,32229,3.634712980715011,0.0,0.0
8867,0,8867,[302 603 427  50 313],334,5,32234,3.6348669373026614,20.0,20.0
8868,0,8868,[288 475 258 161  11],474,4,32238,3.6349081068891644,0.0,0.0
8869,0,8869,[211 271 183  96 222],650,4,32242,3.6349492671927845,0.0,0.0
8870,0,8870,[ 69 234 174  98 153],890,4,32246,3.634990418216661,0.0,40.0
8871,0,8871,[385 183 215  89  88],881,3,32249,3.634918845807033,0.0,0.0
8872,0,8872,[302 603 427  50 313],271,5,32254,3.6350726924377326,20.0,20.0
8873,0,8873,[302 603 427  50 313],537,5,32259,3.6352265043948613,20.0,20.0
8874,0,8874,[302 603 427  50 313],13,5,32264,3.635380281690141,20.0,20.0
8875,0,8875,[302 603 427  50 313],13,5,32269,3.635534024335286,20.0,20.0
8876,0,8876,[302 603 427  50 313],13,5,32274,3.6356877323420074,20.0,20.0
8877,0,8877,[302 603 427  50 313],669,5,32279,3.6358414057220094,20.0,20.0
8878,0,8878,[211 288 175 173  25],279,4,32283,3.6358824191913506,0.0,0.0
8879,0,8879,[302 603 427  50 313],537,5,32288,3.636036036036036,20.0,20.0
8880,0,8880,[302 603 427  50 313],334,5,32293,3.636189618286229,20.0,20.0
8881,0,8881,[144 435 132 174 216],650,4,32297,3.636230578698491,0.0,20.0
8882,0,8882,[302 603 427  50 313],13,5,32302,3.6363841044692107,20.0,20.0
8883,0,8883,[182 135  64 210 195],87,5,32307,3.636537595677623,0.0,0.0
8884,0,8884,[200 127 288 515 185],334,4,32311,3.636578503095104,0.0,20.0
8885,0,8885,[471   1  79 475  50],548,5,32316,3.636731937879811,0.0,20.0
8886,0,8886,[ 79 210 405 100  71],524,2,32318,3.6365477664003603,0.0,20.0
8887,0,8887,[194 318 546 273 161],13,2,32320,3.6363636363636362,20.0,0.0
8888,0,8888,[302 603 427  50 313],474,5,32325,3.636517043536956,20.0,20.0
8889,0,8889,[174 202  25 117 153],308,4,32329,3.636557930258718,0.0,20.0
8890,0,8890,[271 195 185 603 100],650,3,32332,3.636486334495557,20.0,20.0
8891,0,8891,[302 603 427  50 313],537,5,32337,3.63663967611336,20.0,20.0
8892,0,8892,[194 405 127  96 195],406,4,32341,3.6366805352524456,0.0,20.0
8893,0,8893,[496  56 196 328  28],506,5,32346,3.636833820553182,0.0,0.0
8894,0,8894,[742 200 161 143 118],378,4,32350,3.6368746486790333,0.0,0.0
8895,0,8895,[ 12  69 187 234 111],666,2,32352,3.6366906474820144,20.0,0.0
8896,0,8896,[302 603 427  50 313],537,5,32357,3.636843879959537,20.0,20.0
8897,0,8897,[471 286 427 300 211],328,3,32360,3.6367723083839065,0.0,0.0
8898,0,8898,[302 603 427  50 313],14,4,32364,3.6368131250702325,20.0,20.0
8899,0,8899,[143  98 202 258 286],200,5,32369,3.6369662921348316,0.0,20.0
8900,0,8900,[302 603 427  50 313],271,5,32374,3.637119424783732,20.0,20.0
8901,0,8901,[187 483 186 176 215],766,1,32375,3.6368231858009437,20.0,0.0
8902,0,8902,[302 603 427  50 313],271,5,32380,3.6369763001235538,20.0,20.0
8903,0,8903,[302 603 427  50 313],454,5,32385,3.637129380053908,20.0,20.0
8904,0,8904,[435   8 427 204 195],409,3,32388,3.6370578326782708,0.0,0.0
8905,0,8905,[302  11 258 423 144],13,4,32392,3.6370985852234448,0.0,0.0
8906,0,8906,[ 96 117 127   1 237],533,4,32396,3.6371393286179408,0.0,20.0
8907,0,8907,[655 100 196 215 200],479,3,32399,3.637067804220925,0.0,20.0
8908,0,8908,[100 235  50 328 245],486,2,32401,3.6368840498372434,0.0,40.0
8909,0,8909,[265 273 111  96 182],207,1,32402,3.6365881032547698,0.0,0.0
8910,0,8910,[204 603  71 237 568],533,4,32406,3.636628885646953,20.0,0.0
8911,0,8911,[117 186 202  64 175],738,4,32410,3.636669658886894,0.0,0.0
8912,0,8912,[135  25 276 118  64],308,4,32414,3.636710422977673,0.0,0.0
8913,0,8913,[423  50 153 222 234],28,3,32417,3.6366389948395783,0.0,20.0
8914,0,8914,[135 234 187  28 496],379,5,32422,3.6367919237240605,0.0,0.0
8915,0,8915,[302 603 427  50 313],271,5,32427,3.636944818304172,20.0,20.0
8916,0,8916,[196 111   8 144 483],95,4,32431,3.6369855332510936,20.0,0.0
8917,0,8917,[179 121 151 269 568],64,3,32434,3.6369141063018615,0.0,0.0
8918,0,8918,[185 153 271 258 313],334,4,32438,3.636954815562283,0.0,0.0
8919,0,8919,[228 179  56 195 194],537,2,32440,3.6367713004484306,0.0,0.0
8920,0,8920,[302 603 427  50 313],669,5,32445,3.6369241116466764,20.0,20.0
8921,0,8921,[ 69 546  22 228  28],194,3,32448,3.636852723604573,0.0,0.0
8922,0,8922,[435 195 471 204 496],378,2,32450,3.6366692816317383,0.0,0.0
8923,0,8923,[ 70 275 185  69 435],13,2,32452,3.636485880770955,0.0,0.0
8924,0,8924,[132 180 215 286 265],537,1,32453,3.636190476190476,0.0,0.0
8925,0,8925,[ 69  71  15 181 238],184,3,32456,3.636119202330271,0.0,0.0
8926,0,8926,[ 70 288 168 222 237],882,3,32459,3.636047944438221,0.0,0.0
8927,0,8927,[257 161 234 271 132],92,1,32460,3.635752688172043,0.0,0.0
8928,0,8928,[302 603 427  50 313],334,5,32465,3.6359054765371264,20.0,20.0
8929,0,8929,[302 603 427  50 313],334,5,32470,3.6360582306830906,20.0,20.0
8930,0,8930,[423  11  28   9 546],455,3,32473,3.635987011532863,0.0,0.0
8931,0,8931,[655 427 183 168 172],537,2,32475,3.635803851321093,0.0,0.0
8932,0,8932,[179 143 276 603 568],59,4,32479,3.6358446210679505,20.0,0.0
8933,0,8933,[191 385 228  28  25],892,3,32482,3.6357734497425565,0.0,0.0
8934,0,8934,[302 603 427  50 313],334,5,32487,3.6359261331841073,20.0,20.0
8935,0,8935,[302 603 427  50 313],669,5,32492,3.636078782452999,20.0,20.0
8936,0,8936,[357 678 237  79 483],749,3,32495,3.6360076088172764,40.0,0.0
8937,0,8937,[655 748 118  64 182],749,2,32497,3.6358245692548667,0.0,0.0
8938,0,8938,[175  88  89 273 238],892,5,32502,3.6359771786553305,0.0,0.0
8939,0,8939,[302 603 427  50 313],537,5,32507,3.6361297539149886,20.0,20.0
8940,0,8940,[183  98 435  79  50],371,4,32511,3.63617045073258,0.0,40.0
8941,0,8941,[ 95 172 204 273 403],524,1,32512,3.6358756430328785,0.0,0.0
8942,0,8942,[289  15 483 175 168],474,3,32515,3.6358045398635803,20.0,0.0
8943,0,8943,[195 175 603  70 508],543,4,32519,3.635845259391771,20.0,0.0
8944,0,8944,[302 603 427  50 313],537,5,32524,3.63599776411403,20.0,20.0
8945,0,8945,[302 603 427  50 313],271,5,32529,3.636150234741784,20.0,20.0
8946,0,8946,[302 603 427  50 313],334,5,32534,3.636302671286465,20.0,20.0
8947,0,8947,[302 603 427  50 313],669,5,32539,3.636455073759499,20.0,20.0
8948,0,8948,[168  69 181  89 204],295,5,32544,3.6366074421723096,0.0,0.0
8949,0,8949,[300  88 313  82 187],533,5,32549,3.6367597765363127,0.0,0.0
8950,0,8950,[121 655 175 117 182],815,0,32549,3.636353480058094,0.0,0.0
8951,0,8951,[385 180 496 200 268],7,4,32553,3.6363941018766757,0.0,0.0
8952,0,8952,[204 185 187 161   4],749,3,32556,3.636323020216687,0.0,0.0
8953,0,8953,[302 603 427  50 313],271,5,32561,3.6364753182935,20.0,20.0
8954,0,8954,[302 603 427  50 313],334,5,32566,3.6366275823562257,20.0,20.0
8955,0,8955,[742 568 496 237 603],524,1,32567,3.636333184457347,20.0,0.0
8956,0,8956,[302 603 427  50 313],13,5,32572,3.6364854303896395,20.0,20.0
8957,0,8957,[508  97  96 182 302],524,5,32577,3.6366376423308773,0.0,0.0
8958,0,8958,[127 186 175 435  50],10,4,32581,3.6366782006920415,0.0,40.0
8959,0,8959,[135 273 222 508 121],774,0,32581,3.6362723214285713,0.0,0.0
8960,0,8960,[302 603 427  50 313],13,5,32586,3.636424506193505,20.0,20.0
8961,0,8961,[275 286  22   4 168],406,0,32586,3.636018745815666,0.0,0.0
8962,0,8962,[257 385 183 111 153],385,1,32587,3.6357246457659267,0.0,0.0
8963,0,8963,[302 603 427  50 313],14,4,32591,3.635765283355645,20.0,20.0
8964,0,8964,[ 89 161 186 289 238],92,3,32594,3.6356943669827104,0.0,0.0
8965,0,8965,[302 603 427  50 313],537,5,32599,3.6358465313406203,20.0,20.0
8966,0,8966,[302 603 427  50 313],271,5,32604,3.635998661759786,20.0,20.0
8967,0,8967,[357 211  88 258  25],749,5,32609,3.6361507582515613,20.0,0.0
8968,0,8968,[ 25 211 508 182 282],533,4,32613,3.636191325677333,0.0,0.0
8969,0,8969,[127 204 282 546 117],95,4,32617,3.636231884057971,0.0,20.0
8970,0,8970,[302 603 427  50 313],334,5,32622,3.6363839036896666,20.0,20.0
8971,0,8971,[302 603 427  50 313],669,5,32627,3.636535889433794,20.0,20.0
8972,0,8972,[228  56 100 276 144],92,5,32632,3.6366878413016828,0.0,20.0
8973,0,8973,[302 603 427  50 313],271,5,32637,3.636839759304658,20.0,20.0
8974,0,8974,[194 286 211 180  25],207,3,32640,3.636768802228412,0.0,0.0
8975,0,8975,[302 603 427  50 313],334,5,32645,3.6369206773618536,20.0,20.0
8976,0,8976,[174  50   9  79 153],339,5,32650,3.637072518658795,0.0,40.0
8977,0,8977,[588 161 216  50 204],95,3,32653,3.6370015593673424,0.0,20.0
8978,0,8978,[194 172 144  97  69],454,3,32656,3.6369306158815013,0.0,0.0
8979,0,8979,[183 300   9 196 173],7,5,32661,3.6370824053452115,0.0,0.0
8980,0,8980,[215 211 258 204 515],7,4,32665,3.6371228148313106,0.0,0.0
8981,0,8981,[300  89  88 181 427],537,2,32667,3.6369405477621912,0.0,0.0
8982,0,8982,[ 97  69  28  82 153],7,4,32671,3.6369809640431927,0.0,0.0
8983,0,8983,[423 289  50 568 471],537,1,32672,3.6366874443455033,0.0,20.0
8984,0,8984,[228 125 435 222 385],64,4,32676,3.636727879799666,0.0,0.0
8985,0,8985,[302 603 427  50 313],454,5,32681,3.636879590474071,20.0,20.0
8986,0,8986,[282  79 210 508  82],85,0,32681,3.6364749082007344,0.0,0.0
8987,0,8987,[282 286 301 265 176],145,4,32685,3.6365153538050734,0.0,0.0
8988,0,8988,[302 603 427  50 313],271,5,32690,3.636667037490266,20.0,20.0
8989,0,8989,[288 427 515 200 210],843,1,32691,3.636373748609566,0.0,0.0
8990,0,8990,[185 111 215 196 125],64,4,32695,3.6364141919697475,0.0,0.0
8991,0,8991,[132  79 403  98  25],843,0,32695,3.636009786476868,0.0,20.0
8992,0,8992,[127 121 194 195 385],387,2,32697,3.635827866118092,0.0,20.0
8993,0,8993,[ 71   4  88 257 182],881,2,32699,3.635645986213031,0.0,0.0
8994,0,8994,[151 286 268   7 748],294,4,32703,3.635686492495831,0.0,0.0
8995,0,8995,[196 268  69 286 194],537,1,32704,3.6353935082258784,0.0,0.0
8996,0,8996,[168  25 228 238 183],59,5,32709,3.6355451817272426,0.0,0.0
8997,0,8997,[302 603 427  50 313],474,5,32714,3.6356968215158925,20.0,20.0
8998,0,8998,[186 172 275 196 117],406,2,32716,3.635515057228581,0.0,0.0
8999,0,8999,[175 508 143 187 427],343,5,32721,3.635666666666667,0.0,0.0
9000,0,9000,[301  12 185 603 215],13,3,32724,3.635596044883902,40.0,0.0
9001,0,9001,[302 603 427  50 313],271,5,32729,3.6357476116418574,20.0,20.0
9002,0,9002,[302 603 427  50 313],537,5,32734,3.635899144729535,20.0,20.0
9003,0,9003,[302 603 427  50 313],454,5,32739,3.6360506441581517,20.0,20.0
9004,0,9004,[ 50   1 153 257 210],738,4,32743,3.6360910605219323,0.0,20.0
9005,0,9005,[153 181 403 187 271],479,3,32746,3.636020430823895,0.0,0.0
9006,0,9006,[181 216  98 238 197],481,4,32750,3.6360608415676694,0.0,20.0
9007,0,9007,[180 181 125 603  50],7,4,32754,3.636101243339254,20.0,20.0
9008,0,9008,[268 144  89 546  11],7,3,32757,3.636030636030636,0.0,0.0
9009,0,9009,[ 12 182  98 603 328],13,4,32761,3.6360710321864596,40.0,20.0
9010,0,9010,[228 655  50 210 588],326,3,32764,3.6360004439018976,0.0,20.0
9011,0,9011,[302 603 427  50 313],474,5,32769,3.636151797603196,20.0,20.0
9012,0,9012,[655 546 127  11 183],7,4,32773,3.6361921668700767,0.0,20.0
9013,0,9013,[302 603 427  50 313],454,5,32778,3.636343465719991,20.0,20.0
9014,0,9014,[117 423 144 323 546],788,3,32781,3.636272878535774,0.0,0.0
9015,0,9015,[302 603 427  50 313],271,5,32786,3.6364241348713398,20.0,20.0
9016,0,9016,[302 603 427  50 313],334,5,32791,3.6365753576577577,20.0,20.0
9017,0,9017,[173   7 179 288 228],650,3,32794,3.636504768241295,0.0,0.0
9018,0,9018,[588 187   1  98  15],234,2,32796,3.636323317440958,0.0,20.0
9019,0,9019,[568  25   7 197 234],650,3,32799,3.6362527716186253,0.0,0.0
9020,0,9020,[475 328 271   9 405],13,0,32799,3.6358496840705024,0.0,0.0
9021,0,9021,[228 144 174 204 515],234,1,32800,3.6355575260474398,0.0,20.0
9022,0,9022,[302 603 427  50 313],669,5,32805,3.635708744320071,20.0,20.0
9023,0,9023,[ 64 153 195   1 471],234,1,32806,3.6354166666666665,0.0,0.0
9024,0,9024,[288 202 423 187 427],59,5,32811,3.635567867036011,0.0,0.0
9025,0,9025,[302 603 427  50 313],669,5,32816,3.6357190339020606,20.0,20.0
9026,0,9026,[302 603 427  50 313],669,5,32821,3.63587016727595,20.0,20.0
9027,0,9027,[ 95 210 181 204  97],125,4,32825,3.635910500664599,0.0,0.0
9028,0,9028,[302 603 427  50 313],537,5,32830,3.6360615793554105,20.0,20.0
9029,0,9029,[403  25 181 435 323],13,2,32832,3.6358803986710964,0.0,0.0
9030,0,9030,[302 603 427  50 313],474,5,32837,3.636031447237294,20.0,20.0
9031,0,9031,[ 22  64 215   8   9],7,5,32842,3.6361824623560675,0.0,0.0
9032,0,9032,[ 71 118 187 179  11],59,4,32846,3.636222738846452,0.0,0.0
9033,0,9033,[302 603 427  50 313],537,5,32851,3.636373699357981,20.0,20.0
9034,0,9034,[302 603 427  50 313],13,5,32856,3.636524626452684,20.0,20.0
9035,0,9035,[111  69  12  15 216],474,5,32861,3.6366755201416554,20.0,0.0
9036,0,9036,[385 286 185   1 186],650,2,32863,3.6364944118623437,0.0,0.0
9037,0,9037,[234 121 237  89 313],59,4,32867,3.6365346315556537,0.0,0.0
9038,0,9038,[ 64 194   9  96 204],308,5,32872,3.636685474056865,0.0,0.0
9039,0,9039,[496  98   7 143 135],537,3,32875,3.6366150442477876,0.0,20.0
9040,0,9040,[302 435 357  96  25],90,5,32880,3.6367658444862294,20.0,0.0
9041,0,9041,[211 289 191 144 180],387,3,32883,3.6366954213669542,0.0,0.0
9042,0,9042,[237 238 328 515 172],804,5,32888,3.636846179365255,0.0,0.0
9043,0,9043,[302 603 427  50 313],271,5,32893,3.636996904024768,20.0,20.0
9044,0,9044,[423  25   4 568 234],378,4,32897,3.637037037037037,0.0,0.0
9045,0,9045,[132 135 268 322 286],13,3,32900,3.636966615078488,0.0,0.0
9046,0,9046,[318 405 191  50 187],271,4,32904,3.6370067425665966,20.0,20.0
9047,0,9047,[121 174  97 204 179],194,3,32907,3.6369363395225465,0.0,20.0
9048,0,9048,[282 204 237 423 483],95,3,32910,3.6368659520388995,20.0,0.0
9049,0,9049,[132  71 151 603 742],749,5,32915,3.6370165745856355,20.0,0.0
9050,0,9050,[ 79 135 385 176  71],536,4,32919,3.63705667882002,0.0,0.0
9051,0,9051,[568 222  98  69  64],774,2,32921,3.6368758285461777,0.0,20.0
9052,0,9052,[194 475  89 191 186],6,5,32926,3.6370264000883683,0.0,0.0
9053,0,9053,[176  96 318 174 286],666,3,32929,3.636956041528606,20.0,20.0
9054,0,9054,[191 483 143 210 322],311,4,32933,3.636996134732192,20.0,0.0
9055,0,9055,[302 603 427  50 313],334,5,32938,3.6371466431095407,20.0,20.0
9056,0,9056,[302 603 427  50 313],334,5,32943,3.6372971182510767,20.0,20.0
9057,0,9057,[302 603 427  50 313],13,5,32948,3.6374475601678076,20.0,20.0
9058,0,9058,[301 151 289 200 121],537,0,32948,3.6370460315708137,0.0,0.0
9059,0,9059,[ 69 127 182  70 197],59,4,32952,3.637086092715232,0.0,20.0
9060,0,9060,[ 69   7  25 496 183],537,2,32954,3.636905418827944,0.0,0.0
9061,0,9061,[151 655 187 483 228],537,2,32956,3.636724784815714,20.0,0.0
9062,0,9062,[200 235 313 168 211],650,4,32960,3.636764868145206,0.0,0.0
9063,0,9063,[483  56 168 172 288],666,3,32963,3.636694616063548,20.0,0.0
9064,0,9064,[132 405  97 282  69],788,4,32967,3.636734693877551,0.0,0.0
9065,0,9065,[ 70 323 210  96 405],87,4,32971,3.6367747628502096,0.0,0.0
9066,0,9066,[174 301 655 323 245],378,2,32973,3.6365942428587186,0.0,20.0
9067,0,9067,[125 483 180  70 508],59,3,32976,3.6365240405822674,20.0,0.0
9068,0,9068,[ 64 237 216 174 211],318,5,32981,3.6366743852684973,0.0,20.0
9069,0,9069,[302 603 427  50 313],454,5,32986,3.636824696802646,20.0,20.0
9070,0,9070,[ 64  12 187  95  88],406,3,32989,3.6367544923382207,20.0,0.0
9071,0,9071,[175 197 385  88 286],207,1,32990,3.636463844797178,0.0,0.0
9072,0,9072,[234 172 282 323  50],474,4,32994,3.6365039127080347,0.0,20.0
9073,0,9073,[302 603 427  50 313],474,5,32999,3.63665417676879,20.0,20.0
9074,0,9074,[151 186 403 211 200],313,1,33000,3.6363636363636362,0.0,0.0
9075,0,9075,[423 546  69 655 294],881,3,33003,3.636293521375055,0.0,0.0
9076,0,9076,[313 183 216 742 127],650,3,33006,3.636223421835408,0.0,20.0
9077,0,9077,[144 427 238 143  28],458,4,33010,3.63626349416171,0.0,0.0
9078,0,9078,[ 56 179 423  69 143],648,3,33013,3.6361934133715166,0.0,0.0
9079,0,9079,[135 200 405 176 172],60,5,33018,3.6363436123348016,0.0,0.0
9080,0,9080,[237 289 328 276 323],90,2,33020,3.636163418125757,0.0,0.0
9081,0,9081,[496 195 237 202 179],215,5,33025,3.6363135873155694,0.0,0.0
9082,0,9082,[ 15 275 423 568 210],311,5,33030,3.6364637234393924,0.0,0.0
9083,0,9083,[302 603 427  50 313],14,4,33034,3.6365037428445617,20.0,20.0
9084,0,9084,[483  56 471 508 273],13,2,33036,3.6363236103467256,20.0,0.0
9085,0,9085,[  8 180 515 603 173],13,3,33039,3.636253576931543,20.0,0.0
9086,0,9086,[496 483 173 196 508],326,4,33043,3.6362936062506876,20.0,0.0
9087,0,9087,[318   1 300  12 183],788,4,33047,3.6363336267605635,40.0,0.0
9088,0,9088,[302 603 427  50 313],474,5,33052,3.6364836615689295,20.0,20.0
9089,0,9089,[204 174 176 748 161],200,4,33056,3.6365236523652364,0.0,20.0
9090,0,9090,[302 603 427  50 313],14,4,33060,3.6365636343636565,20.0,20.0
9091,0,9091,[ 28 194 301  71 237],328,3,33063,3.636493620765508,0.0,0.0
9092,0,9092,[ 12   4 655 143 265],474,5,33068,3.636643571978445,20.0,0.0
9093,0,9093,[ 98 121  50 286 258],474,5,33073,3.6367934902133277,0.0,40.0
9094,0,9094,[322 216 588  70 132],881,2,33075,3.6366135239142388,0.0,0.0
9095,0,9095,[202 181 194 216 173],379,5,33080,3.6367634124890063,0.0,0.0
9096,0,9096,[ 64 405 435 117 475],474,5,33085,3.636913268110366,0.0,0.0
9097,0,9097,[222 435 216 181 496],290,4,33089,3.6369531765223124,0.0,0.0
9098,0,9098,[194 144  11   7 273],308,3,33092,3.636883173975162,0.0,0.0
9099,0,9099,[257  22 185  79 237],298,4,33096,3.6369230769230767,0.0,0.0
9100,0,9100,[475 427 202 183 204],452,2,33098,3.636743215031315,0.0,0.0
9101,0,9101,[100 288   4 508 234],537,2,33100,3.6365633926609537,0.0,20.0
9102,0,9102,[289 153 265 276 186],374,4,33104,3.6366033175876087,0.0,0.0
9103,0,9103,[196 204 183 238 546],881,3,33107,3.6365333919156413,0.0,0.0
9104,0,9104,[ 95 182  82 127 322],537,2,33109,3.6363536518396486,0.0,20.0
9105,0,9105,[515  95 204 271 100],650,3,33112,3.636283768943554,0.0,20.0
9106,0,9106,[302 603 427  50 313],334,5,33117,3.6364335126825518,20.0,20.0
9107,0,9107,[194  89 180 182 276],537,4,33121,3.6364734299516908,0.0,0.0
9108,0,9108,[302 603 427  50 313],454,5,33126,3.6366231199912176,20.0,20.0
9109,0,9109,[228 153  97  71 385],788,0,33126,3.6362239297475303,0.0,0.0
9110,0,9110,[302 603 427  50 313],13,5,33131,3.6363736143123697,20.0,20.0
9111,0,9111,[161 385 282 210 194],378,5,33136,3.636523266022827,0.0,0.0
9112,0,9112,[302 603 427  50 313],13,5,33141,3.636672884889718,20.0,20.0
9113,0,9113,[294 678  12 176 151],7,2,33143,3.636493307000219,20.0,0.0
9114,0,9114,[173 588 172 515 187],406,2,33145,3.6363137685134395,0.0,0.0
9115,0,9115,[ 22 195 200 603 385],59,5,33150,3.6364633611232997,20.0,0.0
9116,0,9116,[132 127 117 234 475],474,5,33155,3.6366129209169684,0.0,20.0
9117,0,9117,[  8 173 288 234 328],488,3,33158,3.636543101557359,0.0,0.0
9118,0,9118,[173 427 471 603 273],7,4,33162,3.6365829586577476,20.0,0.0
9119,0,9119,[202 211 187 655 235],102,1,33163,3.6362938596491228,0.0,0.0
9120,0,9120,[282 228 508  11 568],455,3,33166,3.636224098234843,0.0,0.0
9121,0,9121,[ 64 286 191 234 125],271,4,33170,3.636263977197983,0.0,0.0
9122,0,9122,[153 186   4 196 151],308,4,33174,3.6363038474186125,0.0,0.0
9123,0,9123,[ 71 403  28 289 197],533,3,33177,3.6362341078474354,0.0,0.0
9124,0,9124,[135 228 144 204 568],788,1,33178,3.635945205479452,0.0,0.0
9125,0,9125,[322 215  15 191 435],234,1,33179,3.635656366425597,0.0,0.0
9126,0,9126,[483 173   7   9 257],815,4,33183,3.63569628574559,20.0,0.0
9127,0,9127,[302 603 427  50 313],669,5,33188,3.635845749342682,20.0,20.0
9128,0,9128,[186  89  98 161 471],543,3,33191,3.6357760981487566,0.0,20.0
9129,0,9129,[ 71 483 117 180 202],13,4,33195,3.635815991237678,20.0,0.0
9130,0,9130,[238 132 237 515 204],6,3,33198,3.6357463585587557,0.0,0.0
9131,0,9131,[302 603 427  50 313],474,5,33203,3.6358957512045555,20.0,20.0
9132,0,9132,[132 135 508 423 186],13,4,33207,3.6359356180882516,0.0,0.0
9133,0,9133,[197 427 118 143 423],13,4,33211,3.63597547624261,0.0,0.0
9134,0,9134,[471 257  28 237 100],271,4,33215,3.636015325670498,0.0,20.0
9135,0,9135,[ 56  96 172 385  95],60,5,33220,3.6361646234676006,0.0,0.0
9136,0,9136,[174  69  89 197 204],85,5,33225,3.6363138885848745,0.0,20.0
9137,0,9137,[173 143 483 403 191],339,4,33229,3.6363536878966953,20.0,0.0
9138,0,9138,[435 172 515  82 238],87,4,33233,3.6363934784987415,0.0,0.0
9139,0,9139,[143  64 168  22  15],406,2,33235,3.636214442013129,0.0,0.0
9140,0,9140,[179  56 294 143 186],374,2,33237,3.6360354446997047,0.0,0.0
9141,0,9141,[302 603 427  50 313],14,4,33241,3.636075257055349,20.0,20.0
9142,0,9142,[179  89   1 313  50],738,4,33245,3.6361150607021764,0.0,20.0
9143,0,9143,[191 235 238 135 182],537,4,33249,3.6361548556430447,0.0,0.0
9144,0,9144,[302 603 427  50 313],271,5,33254,3.6363039912520505,20.0,20.0
9145,0,9145,[196 135  28 748 318],64,4,33258,3.6363437568335883,20.0,0.0
9146,0,9146,[302 603 427  50 313],454,5,33263,3.6364928391822455,20.0,20.0
9147,0,9147,[323 195 357 168 200],311,4,33267,3.636532575426323,20.0,0.0
9148,0,9148,[286   9 183 144 257],447,2,33269,3.636353699857908,0.0,0.0
9149,0,9149,[  7 403 300 100 271],328,3,33272,3.6362841530054646,0.0,20.0
9150,0,9150,[302 603 427  50 313],271,5,33277,3.636433176702,20.0,20.0
9151,0,9151,[143 211  11 546 187],234,1,33278,3.636145104895105,0.0,0.0
9152,0,9152,[ 28 117 546 288 257],533,3,33281,3.636075603627226,0.0,0.0
9153,0,9153,[302 603 427  50 313],13,5,33286,3.6362246012672057,20.0,20.0
9154,0,9154,[302 603 427  50 313],474,5,33291,3.636373566357182,20.0,20.0
9155,0,9155,[ 89 289  50 257  22],378,5,33296,3.63652249890782,0.0,20.0
9156,0,9156,[588 153 202 286 195],194,1,33297,3.63623457464235,0.0,0.0
9157,0,9157,[403  50 172 179 258],387,4,33301,3.6362742956977505,0.0,20.0
9158,0,9158,[100 175   9  71 597],378,4,33305,3.6363140080794847,0.0,20.0
9159,0,9159,[  4 483 143 118 655],343,4,33309,3.636353711790393,20.0,0.0
9160,0,9160,[194 597   1 275  28],882,4,33313,3.636393406833315,0.0,0.0
9161,0,9161,[302 603 427  50 313],334,5,33318,3.6365422396856584,20.0,20.0
9162,0,9162,[ 97  56 204 185  22],537,2,33320,3.6363636363636362,0.0,0.0
9163,0,9163,[127 515  22 118 237],804,4,33324,3.6364033173286776,0.0,20.0
9164,0,9164,[302 603 427  50 313],13,5,33329,3.6365521003818877,20.0,20.0
9165,0,9165,[194 282   4  95 318],378,4,33333,3.6365917521274276,20.0,0.0
9166,0,9166,[ 70 237 403  98 228],533,3,33336,3.636522308279699,0.0,20.0
9167,0,9167,[238 121  82   1  22],653,4,33340,3.636561954624782,0.0,0.0
9168,0,9168,[302 603 427  50 313],537,5,33345,3.6367106554695168,20.0,20.0
9169,0,9169,[302 603 427  50 313],14,4,33349,3.6367502726281353,20.0,20.0
9170,0,9170,[187  28  97 423 195],210,5,33354,3.6368989205103044,0.0,0.0
9171,0,9171,[302 603 427  50 313],14,4,33358,3.636938508504143,20.0,20.0
9172,0,9172,[200 403 288 121 405],479,3,33361,3.6368690722773356,0.0,0.0
9173,0,9173,[423 216 471  96 655],92,3,33364,3.63679965118814,0.0,0.0
9174,0,9174,[237 161 235  56  96],313,2,33366,3.6366212534059947,0.0,0.0
9175,0,9175,[265  70 174 121 603],452,4,33370,3.63666085440279,20.0,20.0
9176,0,9176,[180   4 742 194 385],749,4,33374,3.6367004467690967,0.0,0.0
9177,0,9177,[211 117 186 318 588],387,1,33375,3.6364131619089126,20.0,0.0
9178,0,9178,[  1 191 185 294 257],804,5,33380,3.6365617169626323,0.0,0.0
9179,0,9179,[  1 132 181  69 435],406,5,33385,3.636710239651416,0.0,0.0
9180,0,9180,[183 173 423   7 202],378,4,33389,3.6367498093889554,0.0,0.0
9181,0,9181,[  4 183 403 168 273],13,3,33392,3.636680461773034,0.0,0.0
9182,0,9182,[  8 286  50 603 268],239,3,33395,3.63661112926059,20.0,20.0
9183,0,9183,[302 603 427  50 313],454,5,33400,3.6367595818815333,20.0,20.0
9184,0,9184,[234 186 742 655 275],899,5,33405,3.636908002177463,0.0,0.0
9185,0,9185,[215 176 301 228 471],13,2,33407,3.636729806226867,0.0,0.0
9186,0,9186,[215 405 204   8 211],479,4,33411,3.6367693479917276,0.0,0.0
9187,0,9187,[268 175  56 132 176],234,1,33412,3.6364823683064866,0.0,0.0
9188,0,9188,[ 25 496  22 196 180],749,5,33417,3.6366307541625855,0.0,0.0
9189,0,9189,[181 275 151 288 135],82,1,33418,3.6363438520130575,0.0,0.0
9190,0,9190,[183 603 289 588 333],10,5,33423,3.6364922206506365,20.0,0.0
9191,0,9191,[185  12  69 202 168],59,5,33428,3.6366405570060922,20.0,0.0
9192,0,9192,[302 603 427  50 313],13,5,33433,3.63678886108996,20.0,20.0
9193,0,9193,[211 222   4 182 153],210,5,33438,3.6369371329127693,0.0,0.0
9194,0,9194,[568 597 427 235 151],59,3,33441,3.6368678629690048,0.0,0.0
9195,0,9195,[117 483 435   8 318],536,4,33445,3.6369073510221837,40.0,0.0
9196,0,9196,[302 603 427  50 313],537,5,33450,3.637055561596173,20.0,20.0
9197,0,9197,[276 234 117 174 210],474,5,33455,3.637203739943466,0.0,20.0
9198,0,9198,[269 195 100 357 204],666,3,33458,3.6371344711381672,20.0,20.0
9199,0,9199,[302 603 427  50 313],537,5,33463,3.637282608695652,20.0,20.0
9200,0,9200,[235  11 275 405 194],271,3,33466,3.637213346375394,0.0,0.0
9201,0,9201,[302 603 427  50 313],454,5,33471,3.6373614431645294,20.0,20.0
9202,0,9202,[  9 197 403  79 748],64,3,33474,3.6372921873302184,0.0,0.0
9203,0,9203,[ 96 357 173 275 288],14,4,33478,3.6373315949587135,20.0,0.0
9204,0,9204,[ 79 211 423 333 435],91,4,33482,3.6373709940249865,0.0,0.0
9205,0,9205,[302 603 427  50 313],669,5,33487,3.6375190093417338,20.0,20.0
9206,0,9206,[603 135  50  89 211],694,5,33492,3.6376669925057024,20.0,20.0
9207,0,9207,[144  96 496   8  82],387,3,33495,3.6375977410947002,0.0,0.0
9208,0,9208,[302 603 427  50 313],334,5,33500,3.63774568357042,20.0,20.0
9209,0,9209,[302 603 427  50 313],334,5,33505,3.6378935939196526,20.0,20.0
9210,0,9210,[ 69   8 181  71 216],882,5,33510,3.6380414721528607,0.0,0.0
9211,0,9211,[302 603 427  50 313],14,4,33514,3.638080764220582,20.0,20.0
9212,0,9212,[302 603 427  50 313],13,5,33519,3.638228590035819,20.0,20.0
9213,0,9213,[144 258  71 655  89],7,5,33524,3.6383763837638377,0.0,0.0
9214,0,9214,[302 603 427  50 313],474,5,33529,3.6385241454150843,20.0,20.0
9215,0,9215,[100 204 273 268 546],7,3,33532,3.638454861111111,0.0,20.0
9216,0,9216,[588 179 186 174 183],452,3,33535,3.638385591841163,0.0,20.0
9217,0,9217,[302 603 427  50 313],454,5,33540,3.638533304404426,20.0,20.0
9218,0,9218,[302 603 427  50 313],474,5,33545,3.6386809849224426,20.0,20.0
9219,0,9219,[568 496 127  82  28],643,4,33549,3.6387201735357917,0.0,20.0
9220,0,9220,[302 603 427  50 313],14,4,33553,3.6387593536492786,20.0,20.0
9221,0,9221,[ 88 323  96 118 273],87,3,33556,3.638690088917805,0.0,0.0
9222,0,9222,[237  28 127 185 151],804,3,33559,3.638620839206332,0.0,20.0
9223,0,9223,[174 328  88 288 117],92,2,33561,3.638443191673894,0.0,20.0
9224,0,9224,[ 15 273 237 211 180],308,2,33563,3.638265582655827,0.0,0.0
9225,0,9225,[215 423 427  22 196],474,5,33568,3.638413180143074,0.0,0.0
9226,0,9226,[423  11 182  25 186],378,3,33571,3.638343990462772,0.0,0.0
9227,0,9227,[301 183 202 117 197],6,2,33573,3.6381664499349804,0.0,0.0
9228,0,9228,[ 28  96 496  82 403],95,3,33576,3.63809730198288,0.0,0.0
9229,0,9229,[302 603 427  50 313],474,5,33581,3.6382448537378114,20.0,20.0
9230,0,9230,[302 603 427  50 313],334,5,33586,3.6383923735239954,20.0,20.0
9231,0,9231,[ 98 385 435  96 151],234,1,33587,3.6381065857885617,0.0,20.0
9232,0,9232,[195 603 333 483 269],13,2,33589,3.6379291671179463,40.0,0.0
9233,0,9233,[118 328  15  64 597],533,4,33593,3.6379683777344596,0.0,0.0
9234,0,9234,[143 300 118 185 222],666,1,33594,3.6376827287493234,0.0,0.0
9235,0,9235,[286 385  22 603 187],524,2,33596,3.6375054135989604,20.0,0.0
9236,0,9236,[187 183 121 257 143],804,4,33600,3.6375446573562846,0.0,0.0
9237,0,9237,[302 603 427  50 313],13,5,33605,3.6376921411560943,20.0,20.0
9238,0,9238,[135 471  70 268 143],13,2,33607,3.637514882563048,0.0,0.0
9239,0,9239,[333 496 179 258 202],666,4,33611,3.6375541125541124,0.0,0.0
9240,0,9240,[286 403 333  22 427],334,5,33616,3.6377015474515746,0.0,0.0
9241,0,9241,[603  69  64   7 385],452,5,33621,3.637848950443627,20.0,0.0
9242,0,9242,[302 603 427  50 313],537,5,33626,3.6379963215406255,20.0,20.0
9243,0,9243,[302 603 427  50 313],14,4,33630,3.638035482475119,20.0,20.0
9244,0,9244,[597 125 568  88 172],897,5,33635,3.6381828015143323,0.0,0.0
9245,0,9245,[195 168 172 174 175],843,3,33638,3.6381137789314297,0.0,20.0
9246,0,9246,[172  11  79 318 655],537,1,33639,3.637828484914026,20.0,0.0
9247,0,9247,[288 194 204 405 275],13,2,33641,3.637651384083045,0.0,0.0
9248,0,9248,[ 56 483 515   9   8],90,5,33646,3.63779868093848,20.0,0.0
9249,0,9249,[186 180  70 183  98],659,4,33650,3.637837837837838,0.0,20.0
9250,0,9250,[202 132 323 144 237],378,3,33653,3.637768889849746,0.0,0.0
9251,0,9251,[215  97 180  70  11],271,5,33658,3.6379161262429744,0.0,0.0
9252,0,9252,[185   4  79 282 197],474,5,33663,3.6380633308116286,0.0,0.0
9253,0,9253,[210 286 144 174  12],666,2,33665,3.6378863194294357,20.0,20.0
9254,0,9254,[302 603 427  50 313],14,4,33669,3.6379254457050245,20.0,20.0
9255,0,9255,[ 97 118  98  88 181],194,1,33670,3.6376404494382024,0.0,20.0
9256,0,9256,[302 603 427  50 313],454,5,33675,3.6377876201793238,20.0,20.0
9257,0,9257,[195 496 185  28 194],666,2,33677,3.6376107150572476,0.0,0.0
9258,0,9258,[302 603 427  50 313],537,5,33682,3.6377578572200022,20.0,20.0
9259,0,9259,[301 318 508 423  28],537,2,33684,3.6375809935205186,20.0,0.0
9260,0,9260,[185 200 135 194 176],234,3,33687,3.6375121477162295,0.0,0.0
9261,0,9261,[302 603 427  50 313],334,5,33692,3.637659252861153,20.0,20.0
9262,0,9262,[435  12  79 357 132],6,4,33696,3.637698369858577,40.0,0.0
9263,0,9263,[496  56  97 195 294],650,2,33698,3.6375215889464596,0.0,0.0
9264,0,9264,[ 71 135 176 125 211],64,3,33701,3.6374527792768485,0.0,0.0
9265,0,9265,[ 69  88 385 318  97],536,4,33705,3.63749190589251,20.0,0.0
9266,0,9266,[302 603 427  50 313],334,5,33710,3.6376389338513,20.0,20.0
9267,0,9267,[302 603 427  50 313],454,5,33715,3.6377859300820026,20.0,20.0
9268,0,9268,[318   8 435  95 202],387,1,33716,3.6375013485812926,20.0,0.0
9269,0,9269,[118  96 568 216 179],374,4,33720,3.6375404530744335,0.0,0.0
9270,0,9270,[302 603 427  50 313],454,5,33725,3.6376874123611262,20.0,20.0
9271,0,9271,[202 216 125 423 318],653,1,33726,3.6374029335634166,20.0,0.0
9272,0,9272,[302 603 427  50 313],669,5,33731,3.63754987598404,20.0,20.0
9273,0,9273,[318 403 180 471 301],234,1,33732,3.6372654733664005,20.0,0.0
9274,0,9274,[286 183 182  22  97],788,3,33735,3.6371967654986523,0.0,0.0
9275,0,9275,[ 82  22  97 234 403],738,3,33738,3.6371280724450195,0.0,0.0
9276,0,9276,[302 603 427  50 313],669,5,33743,3.637274981136143,20.0,20.0
9277,0,9277,[135 100 273  56 313],92,5,33748,3.637421858159086,0.0,20.0
9278,0,9278,[ 69 288 423 172  96],643,4,33752,3.637460933290225,0.0,0.0
9279,0,9279,[302 603 427  50 313],334,5,33757,3.63760775862069,20.0,20.0
9280,0,9280,[546 483 568 118   7],788,2,33759,3.637431311281112,20.0,0.0
9281,0,9281,[405  82 471 125  88],374,4,33763,3.6374703727644904,0.0,0.0
9282,0,9282,[546  82  98 234 568],881,4,33767,3.6375094258321665,0.0,20.0
9283,0,9283,[328 204 194 318 186],328,3,33770,3.637440758293839,20.0,0.0
9284,0,9284,[161   4 385  11 195],653,3,33773,3.6373721055465804,0.0,0.0
9285,0,9285,[181 176 132 234 180],650,4,33777,3.6374111565797977,0.0,0.0
9286,0,9286,[302 603 427  50 313],334,5,33782,3.637557876601701,20.0,20.0
9287,0,9287,[  9 100 678  64 127],7,4,33786,3.637596899224806,0.0,40.0
9288,0,9288,[302 603 427  50 313],669,5,33791,3.637743567660674,20.0,20.0
9289,0,9289,[403  69 100 286   4],387,1,33792,3.63745963401507,0.0,20.0
9290,0,9290,[302 603 427  50 313],669,5,33797,3.637606285652782,20.0,20.0
9291,0,9291,[132 588 182 153 286],10,5,33802,3.637752905725355,0.0,0.0
9292,0,9292,[403 282   9  22 238],194,3,33805,3.6376842784891856,0.0,0.0
9293,0,9293,[471 125 161 385 135],234,1,33806,3.6374004734237144,0.0,0.0
9294,0,9294,[385 546 568 127 182],158,3,33809,3.6373318988703605,0.0,20.0
9295,0,9295,[268   4 194  22  89],664,3,33812,3.637263339070568,0.0,0.0
9296,0,9296,[302 603 427  50 313],13,5,33817,3.637409917177584,20.0,20.0
9297,0,9297,[302 603 427  50 313],669,5,33822,3.6375564637556463,20.0,20.0
9298,0,9298,[318 204 179 258  69],92,4,33826,3.637595440369932,20.0,0.0
9299,0,9299,[403  64   8 132 222],194,1,33827,3.637311827956989,0.0,0.0
9300,0,9300,[496  88 222 100 161],749,2,33829,3.637135791850339,0.0,20.0
9301,0,9301,[ 98 200  89  88 144],815,5,33834,3.637282304880671,0.0,20.0
9302,0,9302,[302 603 427  50 313],334,5,33839,3.637428786412985,20.0,20.0
9303,0,9303,[265 100 211 185 546],82,3,33842,3.6373602751504728,0.0,20.0
9304,0,9304,[ 25 405 125 216 286],881,3,33845,3.6372917786136485,0.0,0.0
9305,0,9305,[385 204  97 180 423],537,1,33846,3.637008381689233,0.0,0.0
9306,0,9306,[302 603 427  50 313],537,5,33851,3.6371548296980767,20.0,20.0
9307,0,9307,[ 64  22 508   7 144],92,4,33855,3.6371938117748175,0.0,0.0
9308,0,9308,[144 235 222 174  28],119,5,33860,3.6373402084004725,0.0,20.0
9309,0,9309,[435 194 204 185 196],650,4,33864,3.637379162191192,0.0,0.0
9310,0,9310,[302 603 427  50 313],669,5,33869,3.6375255074642894,20.0,20.0
9311,0,9311,[234 405 176 118 216],881,4,33873,3.6375644329896906,0.0,0.0
9312,0,9312,[302 603 427  50 313],474,5,33878,3.6377107269408353,20.0,20.0
9313,0,9313,[185 568  88 275 111],648,5,33883,3.637856989478205,0.0,0.0
9314,0,9314,[302 603 427  50 313],537,5,33888,3.638003220611916,20.0,20.0
9315,0,9315,[385  22 238 273 181],234,1,33889,3.6377200515242594,0.0,0.0
9316,0,9316,[302 603 427  50 313],474,5,33894,3.6378662659654397,20.0,20.0
9317,0,9317,[196 423 588  97 168],95,4,33898,3.6379051298561924,0.0,0.0
9318,0,9318,[ 79 546 117 318 215],313,5,33903,3.638051293057195,20.0,0.0
9319,0,9319,[568 678  79  88 168],339,3,33906,3.6379828326180257,0.0,0.0
9320,0,9320,[302 603 427  50 313],669,5,33911,3.638128956120588,20.0,20.0
9321,0,9321,[237 182 427 191 176],664,3,33914,3.638060502038189,0.0,0.0
9322,0,9322,[302 603 427  50 313],669,5,33919,3.63820658586292,20.0,20.0
9323,0,9323,[173 179  98 742 568],897,2,33921,3.638030888030888,0.0,20.0
9324,0,9324,[111  64  22 423 135],64,5,33926,3.6381769436997318,0.0,0.0
9325,0,9325,[588 269 194 174 385],452,4,33930,3.6382157409393097,0.0,20.0
9326,0,9326,[302 603 427  50 313],334,5,33935,3.6383617454701405,20.0,20.0
9327,0,9327,[174  79 195 588  88],194,2,33937,3.6381861063464838,0.0,20.0
9328,0,9328,[215 185 275  95  25],13,2,33939,3.6380105048772644,0.0,0.0
9329,0,9329,[405 118  88  95 180],313,2,33941,3.637834941050375,0.0,0.0
9330,0,9330,[174  50 210 222   1],194,2,33943,3.6376594148537134,0.0,40.0
9331,0,9331,[195  11 168 288 289],13,1,33944,3.6373767681097298,0.0,0.0
9332,0,9332,[196 118 191  89 121],653,3,33947,3.637308475302689,0.0,0.0
9333,0,9333,[197 153  22   7 258],387,4,33951,3.637347332333405,0.0,0.0
9334,0,9334,[282  22 515   1 423],92,3,33954,3.6372790573111944,0.0,0.0
9335,0,9335,[183  89 143 172 211],346,4,33958,3.637317909168809,0.0,0.0
9336,0,9336,[211 385 323 275  69],883,3,33961,3.637249651922459,0.0,0.0
9337,0,9337,[ 70 515  79 197   9],488,3,33964,3.6371814092953523,0.0,0.0
9338,0,9338,[151   9 427 186  11],334,4,33968,3.6372202591283864,0.0,0.0
9339,0,9339,[405 603 125 197  98],648,3,33971,3.637152034261242,20.0,20.0
9340,0,9340,[183 483 197 153 385],398,4,33975,3.637190878920886,20.0,0.0
9341,0,9341,[234 238 186 174 286],85,3,33978,3.637122671804753,0.0,20.0
9342,0,9342,[183 195 597 268 168],13,3,33981,3.6370544792893074,0.0,0.0
9343,0,9343,[302 603 427  50 313],669,5,33986,3.6372003424657535,20.0,20.0
9344,0,9344,[195  82 275 191  89],537,3,33989,3.63713215623328,0.0,0.0
9345,0,9345,[238 121  50  79 385],378,4,33993,3.637170982238391,0.0,20.0
9346,0,9346,[405 385  95 121  96],92,3,33996,3.637102813737028,0.0,0.0
9347,0,9347,[357 117  50 197 423],343,4,34000,3.6371416345742404,20.0,20.0
9348,0,9348,[435 161 211  64  89],339,4,34004,3.6371804471066422,0.0,0.0
9349,0,9349,[ 69 357   7 228 678],648,1,34005,3.636898395721925,20.0,0.0
9350,0,9350,[195   1 275  96 427],899,4,34009,3.6369372259651374,0.0,0.0
9351,0,9351,[515 655 179  97  88],881,3,34012,3.636869118905047,0.0,0.0
9352,0,9352,[181 300 237 271 216],215,4,34016,3.6369079439751952,0.0,0.0
9353,0,9353,[546 265  98   9 471],533,3,34019,3.6368398546076546,0.0,20.0
9354,0,9354,[403 174 186 328  15],234,0,34019,3.6364510956707643,0.0,20.0
9355,0,9355,[302 603 427  50 313],474,5,34024,3.63659683625481,20.0,20.0
9356,0,9356,[302 603 427  50 313],13,5,34029,3.6367425456877203,20.0,20.0
9357,0,9357,[182   7 301 200 483],650,3,34032,3.636674503098953,20.0,0.0
9358,0,9358,[121 405 271 117 100],479,2,34034,3.6364996260284217,0.0,20.0
9359,0,9359,[ 98 423 286 197 135],881,3,34037,3.636431623931624,0.0,20.0
9360,0,9360,[ 71  79 333 403 748],313,3,34040,3.6363636363636362,0.0,0.0
9361,0,9361,[302 603 427  50 313],537,5,34045,3.6365092928861356,20.0,20.0
9362,0,9362,[187 100 132 269 655],343,5,34050,3.636654918295418,0.0,20.0
9363,0,9363,[  4  98 179 588 121],59,4,34054,3.6366937206322083,0.0,20.0
9364,0,9364,[181  89 483  96  79],833,3,34057,3.636625734116391,20.0,0.0
9365,0,9365,[300 546  96 515 655],774,0,34057,3.636237454623105,0.0,0.0
9366,0,9366,[  4 172   7  82 546],881,4,34061,3.636276289100032,0.0,0.0
9367,0,9367,[  8 202  22 153  98],850,4,34065,3.6363151152860804,0.0,20.0
9368,0,9368,[568  97 182  82 257],374,4,34069,3.6363539331839045,0.0,0.0
9369,0,9369,[357 161 196 222 181],479,4,34073,3.6363927427961578,20.0,0.0
9370,0,9370,[302 603 427  50 313],271,5,34078,3.6365382563226976,20.0,20.0
9371,0,9371,[318 742  70  69   4],524,4,34082,3.6365770379854885,20.0,0.0
9372,0,9372,[302 603 427  50 313],454,5,34087,3.636722500800171,20.0,20.0
9373,0,9373,[258 215 483 357 496],659,5,34092,3.636867932579475,40.0,0.0
9374,0,9374,[ 28 100  98 265  71],92,4,34096,3.6369066666666665,0.0,40.0
9375,0,9375,[302 603 427  50 313],669,5,34101,3.63705204778157,20.0,20.0
9376,0,9376,[265 173 118  98 546],524,4,34105,3.637090753972486,0.0,20.0
9377,0,9377,[151  70 515 183 196],7,3,34108,3.63702281936447,0.0,0.0
9378,0,9378,[302 603 427  50 313],271,5,34113,3.6371681415929205,20.0,20.0
9379,0,9379,[302 603 427  50 313],474,5,34118,3.6373134328358208,20.0,20.0
9380,0,9380,[483 273 143 191 185],385,2,34120,3.6371388977720924,20.0,0.0
9381,0,9381,[143 183 748 228 121],64,3,34123,3.637070986996376,0.0,0.0
9382,0,9382,[282  12 100 204 181],533,5,34128,3.6372162421400405,20.0,20.0
9383,0,9383,[265 127 273 286 234],234,2,34130,3.6370417732310316,0.0,20.0
9384,0,9384,[323 222  88  71 216],881,3,34133,3.63697389451252,0.0,0.0
9385,0,9385,[302 603 427  50 313],13,5,34138,3.6371191135734073,20.0,20.0
9386,0,9386,[ 97 357 121  11 181],406,5,34143,3.6372643016938317,20.0,0.0
9387,0,9387,[282  95 275 191 174],271,4,34147,3.6373029399233063,0.0,20.0
9388,0,9388,[132 174 427 357 196],7,5,34152,3.637448077537544,20.0,20.0
9389,0,9389,[135 215 153 132 268],85,4,34156,3.637486687965921,0.0,0.0
9390,0,9390,[302 603 427  50 313],13,5,34161,3.6376317751038227,20.0,20.0
9391,0,9391,[186 194 423 118 273],892,4,34165,3.637670357751278,0.0,0.0
9392,0,9392,[301 257  89 546 568],119,5,34170,3.63781539444267,0.0,0.0
9393,0,9393,[ 22 318 204   7  96],7,5,34175,3.637960400255482,20.0,0.0
9394,0,9394,[ 15 496  11 275 288],378,2,34177,3.6377860564129856,0.0,0.0
9395,0,9395,[302 603 427  50 313],669,5,34182,3.6379310344827585,20.0,20.0
9396,0,9396,[328 135  70 125 286],653,3,34185,3.637863147813132,0.0,0.0
9397,0,9397,[302 603 427  50 313],13,5,34190,3.6380080868269844,20.0,20.0
9398,0,9398,[211  22 194 121 186],380,2,34192,3.637833812107671,0.0,0.0
9399,0,9399,[234  64 475 385 168],932,2,34194,3.6376595744680853,0.0,0.0
9400,0,9400,[302 603 427  50 313],14,4,34198,3.6376981172215723,20.0,20.0
9401,0,9401,[302 603 427  50 313],474,5,34203,3.6378430121250798,20.0,20.0
9402,0,9402,[245 257 475  50 204],119,5,34208,3.63798787620972,0.0,20.0
9403,0,9403,[228 174 204 385 237],92,5,34213,3.6381327094853253,0.0,20.0
9404,0,9404,[268  25 100 228 200],13,3,34216,3.638064859117491,0.0,20.0
9405,0,9405,[222 215 173 276  22],234,1,34217,3.6377843929406763,0.0,0.0
9406,0,9406,[302 603 427  50 313],537,5,34222,3.6379292016583396,20.0,20.0
9407,0,9407,[ 12 288 132  96 135],64,5,34227,3.638073979591837,20.0,0.0
9408,0,9408,[194   1 271 144 182],158,5,34232,3.638218726750983,0.0,0.0
9409,0,9409,[234 200   1 300  89],488,3,34235,3.6381509032943677,0.0,0.0
9410,0,9410,[748 423 143 237 210],13,3,34238,3.638083094251408,0.0,0.0
9411,0,9411,[ 82 200  15 143 194],60,3,34241,3.6380152996175097,0.0,0.0
9412,0,9412,[588 173  70 655  22],454,2,34243,3.6378412833315625,0.0,0.0
9413,0,9413,[483  15 185 318 228],406,4,34247,3.6378797535585297,40.0,0.0
9414,0,9414,[271 245 161  56 216],92,2,34249,3.6377057886351567,0.0,0.0
9415,0,9415,[302 603 427  50 313],454,5,34254,3.6378504672897196,20.0,20.0
9416,0,9416,[423 294 183  88 273],234,2,34256,3.637676542423277,0.0,0.0
9417,0,9417,[125 238 174  12 194],213,5,34261,3.637821193459333,20.0,20.0
9418,0,9418,[ 69 286 175  95  71],378,4,34265,3.6378596453976004,0.0,0.0
9419,0,9419,[302 603 427  50 313],474,5,34270,3.6380042462845013,20.0,20.0
9420,0,9420,[423 180   7  50 186],650,3,34273,3.637936524785055,0.0,20.0
9421,0,9421,[ 22 132 172 153 603],454,2,34275,3.637762683082148,20.0,0.0
9422,0,9422,[144 742  69 318 286],387,0,34275,3.6373766316459726,20.0,0.0
9423,0,9423,[257 151 328 313 276],378,3,34278,3.637308998302207,0.0,0.0
9424,0,9424,[ 22  89 216 318 173],474,5,34283,3.6374535809018567,20.0,0.0
9425,0,9425,[302 603 427  50 313],454,5,34288,3.6375981328241034,20.0,20.0
9426,0,9426,[588 197 235 125 282],406,3,34291,3.6375304975071603,0.0,0.0
9427,0,9427,[ 98  28  50 117 300],125,4,34295,3.6375689435723375,0.0,40.0
9428,0,9428,[385 276  97  96   8],452,3,34298,3.637501325697317,0.0,0.0
9429,0,9429,[289 194 197 328 200],833,1,34299,3.637221633085896,0.0,0.0
9430,0,9430,[273  82 748 180 271],749,4,34303,3.637260099671297,0.0,0.0
9431,0,9431,[228 405 333 222 200],537,0,34303,3.636874469889737,0.0,0.0
9432,0,9432,[265 357 216 144  22],543,4,34307,3.6369129651224426,20.0,0.0
9433,0,9433,[302 603 427  50 313],14,4,34311,3.6369514521941912,20.0,20.0
9434,0,9434,[100  50  11 127 655],527,4,34315,3.636989931107578,0.0,60.0
9435,0,9435,[515 603 143 182 655],13,3,34318,3.6369224247562526,20.0,0.0
9436,0,9436,[187 204 185 748 228],328,2,34320,3.63674896683268,0.0,0.0
9437,0,9437,[234 196 181 508  25],59,5,34325,3.6368934096206824,0.0,0.0
9438,0,9438,[ 56 135  89 180 222],892,5,34330,3.637037821803157,0.0,0.0
9439,0,9439,[ 98 546 185  88 237],234,1,34331,3.636758474576271,0.0,20.0
9440,0,9440,[302 603 427  50 313],454,5,34336,3.6369028704586377,20.0,20.0
9441,0,9441,[423  69  12 403 100],318,4,34340,3.6369413259902563,20.0,20.0
9442,0,9442,[100 186 300  82 191],840,3,34343,3.636873874827915,0.0,20.0
9443,0,9443,[234 228 435 100 191],804,4,34347,3.6369123252858957,0.0,20.0
9444,0,9444,[  4 302  28  70 234],788,3,34350,3.6368448914769718,0.0,0.0
9445,0,9445,[302 603 427  50 313],13,5,34355,3.6369892017785306,20.0,20.0
9446,0,9446,[302 603 427  50 313],474,5,34360,3.6371334815285277,20.0,20.0
9447,0,9447,[403 289  89 174 597],833,1,34361,3.636854360711262,0.0,20.0
9448,0,9448,[257 204 318 197 143],454,5,34366,3.636998624193036,20.0,0.0
9449,0,9449,[185  70  89 182 515],194,2,34368,3.636825396825397,0.0,0.0
9450,0,9450,[748 328 117 258 405],294,3,34371,3.6367580150248653,0.0,0.0
9451,0,9451,[302 603 427  50 313],669,5,34376,3.636902242911553,20.0,20.0
9452,0,9452,[302 603 427  50 313],537,5,34381,3.637046440283508,20.0,20.0
9453,0,9453,[302 603 427  50 313],271,5,34386,3.6371906071504125,20.0,20.0
9454,0,9454,[302 603 427  50 313],271,5,34391,3.637334743521946,20.0,20.0
9455,0,9455,[568 234  22 194 515],650,3,34394,3.6372673434856178,0.0,0.0
9456,0,9456,[196 385  22 121 186],533,4,34398,3.6373056994818653,0.0,0.0
9457,0,9457,[ 89 222 294 151 385],749,2,34400,3.6371325861704378,0.0,0.0
9458,0,9458,[125 568 117 172 228],290,2,34402,3.6369595094618883,0.0,0.0
9459,0,9459,[302 603 427  50 313],474,5,34407,3.6371035940803385,20.0,20.0
9460,0,9460,[100 655 204 121 357],85,2,34409,3.6369305570235704,20.0,20.0
9461,0,9461,[302 603 427  50 313],669,5,34414,3.6370746142464596,20.0,20.0
9462,0,9462,[ 82 132 187 238  22],892,4,34418,3.6371129662897603,0.0,0.0
9463,0,9463,[ 50 276 385 294 603],13,3,34421,3.6370456466610315,20.0,20.0
9464,0,9464,[588 117  82 186 496],308,3,34424,3.6369783412572634,0.0,0.0
9465,0,9465,[483 197 427 423 385],308,3,34427,3.636911050073949,20.0,0.0
9466,0,9466,[175 385  89 597 405],774,0,34427,3.6365268828562374,0.0,0.0
9467,0,9467,[302 603 427  50 313],669,5,34432,3.6366708914237433,20.0,20.0
9468,0,9468,[ 96 423 175  71 269],738,3,34435,3.6366036540289364,0.0,0.0
9469,0,9469,[238  56 496 210   9],184,4,34439,3.6366420274551214,0.0,0.0
9470,0,9470,[186 597 196 117 328],378,1,34440,3.6363636363636362,0.0,0.0
9471,0,9471,[313 568 235 196 237],13,3,34443,3.6362964527027026,0.0,0.0
9472,0,9472,[302 603 427  50 313],14,4,34447,3.636334846405574,20.0,20.0
9473,0,9473,[483   4 202 210  15],234,2,34449,3.6361621279290692,20.0,0.0
9474,0,9474,[ 97   7 151 210  56],295,5,34454,3.636306068601583,0.0,0.0
9475,0,9475,[ 25 435 175 151  56],308,5,34459,3.6364499788940483,0.0,0.0
9476,0,9476,[197 132 200 187  89],6,4,34463,3.636488340192044,0.0,0.0
9477,0,9477,[302 603 427  50 313],537,5,34468,3.636632200886263,20.0,20.0
9478,0,9478,[302 603 427  50 313],271,5,34473,3.6367760312269226,20.0,20.0
9479,0,9479,[143 196  25 144  11],406,1,34474,3.6364978902953586,0.0,0.0
9480,0,9480,[180   9 127  64 153],749,4,34478,3.6365362303554476,0.0,20.0
9481,0,9481,[748 323 228  71 300],311,4,34482,3.6365745623286228,0.0,0.0
9482,0,9482,[204 211 222 300 175],506,4,34486,3.6366128862174416,0.0,0.0
9483,0,9483,[176 234  69 173 100],379,5,34491,3.6367566427667652,0.0,20.0
9484,0,9484,[302 603 427  50 313],271,5,34496,3.63690036900369,20.0,20.0
9485,0,9485,[ 89 183  95 132 172],184,5,34501,3.637044064937803,0.0,0.0
9486,0,9486,[302 603 427  50 313],271,5,34506,3.637187730578687,20.0,20.0
9487,0,9487,[302 603 427  50 313],669,5,34511,3.637331365935919,20.0,20.0
9488,0,9488,[302 603 427  50 313],474,5,34516,3.6374749710190746,20.0,20.0
9489,0,9489,[302 603 427  50 313],474,5,34521,3.6376185458377237,20.0,20.0
9490,0,9490,[588 127 222  15 286],881,2,34523,3.6374460014750816,0.0,20.0
9491,0,9491,[302 603 427  50 313],271,5,34528,3.637589549093974,20.0,20.0
9492,0,9492,[289 161 175  89 286],524,4,34532,3.6376277256926155,0.0,0.0
9493,0,9493,[546 100 271 286 202],145,3,34535,3.637560564567095,0.0,20.0
9494,0,9494,[318   4 132  11 216],653,1,34536,3.6372827804107426,20.0,0.0
9495,0,9495,[302 603 427  50 313],14,4,34540,3.6373209772535806,20.0,20.0
9496,0,9496,[302 603 427  50 313],271,5,34545,3.63746446246183,20.0,20.0
9497,0,9497,[151 172 176  96 210],200,4,34549,3.6375026321330806,0.0,0.0
9498,0,9498,[ 97  15 196  64 135],455,4,34553,3.637540793767765,0.0,0.0
9499,0,9499,[179 117 151 603 132],474,4,34557,3.637578947368421,20.0,0.0
9500,0,9500,[ 89  82  70 173 210],840,2,34559,3.6374065887801286,0.0,0.0
9501,0,9501,[151 127 234 216 181],749,5,34564,3.6375499894759,0.0,20.0
9502,0,9502,[ 22 275 235  50  95],64,5,34569,3.6376933599915815,0.0,20.0
9503,0,9503,[475  89 172 191  96],144,3,34572,3.6376262626262625,0.0,0.0
9504,0,9504,[273 257  69 179 121],308,2,34574,3.637453971593898,0.0,0.0
9505,0,9505,[423 435  79 151  28],308,4,34578,3.63749211024616,0.0,0.0
9506,0,9506,[ 15 151 597  97  28],821,4,34582,3.6375302408751446,0.0,0.0
9507,0,9507,[515 228 276   8 403],334,5,34587,3.6376735380732015,0.0,0.0
9508,0,9508,[176 117 385 403 483],643,2,34589,3.637501314544116,20.0,0.0
9509,0,9509,[ 79 185 181 318 603],454,3,34592,3.637434279705573,40.0,0.0
9510,0,9510,[143 496 234 132 265],7,4,34596,3.6374724003785093,0.0,0.0
9511,0,9511,[496  79  50 546 144],536,4,34600,3.637510513036165,0.0,20.0
9512,0,9512,[302 603 427  50 313],537,5,34605,3.6376537369914854,20.0,20.0
9513,0,9513,[ 11  88 176 234  98],343,4,34609,3.6376918225772545,0.0,20.0
9514,0,9514,[276  98 515 172 161],643,3,34612,3.637624802942722,0.0,20.0
9515,0,9515,[423 276 144 187 180],385,2,34614,3.637452711223203,0.0,0.0
9516,0,9516,[194  82 121 118  70],308,3,34617,3.6373857307975204,0.0,0.0
9517,0,9517,[289  56 168 176 144],13,3,34620,3.637318764446312,0.0,0.0
9518,0,9518,[135 194 202 222  96],749,4,34624,3.6373568652169346,0.0,0.0
9519,0,9519,[  8 302  56  12 194],940,5,34629,3.6375,20.0,0.0
9520,0,9520,[197 175 174 265 568],13,4,34633,3.637538073731751,0.0,20.0
9521,0,9521,[186  64 182 655 195],774,1,34634,3.637261079605125,0.0,0.0
9522,0,9522,[302 603 427  50 313],537,5,34639,3.6374041793552454,20.0,20.0
9523,0,9523,[302 603 427  50 313],271,5,34644,3.637547249055019,20.0,20.0
9524,0,9524,[222   7  88 471 282],194,0,34644,3.6371653543307088,0.0,0.0
9525,0,9525,[301 210 187 269 180],13,2,34646,3.6369934914969555,0.0,0.0
9526,0,9526,[301 210 151 300 135],234,1,34647,3.6367166999055316,0.0,0.0
9527,0,9527,[204 191 168 185 435],385,1,34648,3.6364399664147773,0.0,0.0
9528,0,9528,[423   8 135 546 117],533,2,34650,3.6362682338125722,0.0,0.0
9529,0,9529,[302 603 427  50 313],537,5,34655,3.636411332633788,20.0,20.0
9530,0,9530,[143  98  69 483 258],263,4,34659,3.6364494806421153,20.0,20.0
9531,0,9531,[ 98 173   4 186  69],804,5,34664,3.6365925304238353,0.0,20.0
9532,0,9532,[ 15 271 282  98 179],92,3,34667,3.636525752648694,0.0,20.0
9533,0,9533,[302 603 427  50 313],474,5,34672,3.6366687644220685,20.0,20.0
9534,0,9534,[ 56 508 196 603 161],334,3,34675,3.636601992658626,20.0,0.0
9535,0,9535,[183 215 179 216 294],653,1,34676,3.6363255033557045,0.0,0.0
9536,0,9536,[302 603 427  50 313],13,5,34681,3.6364684911397713,20.0,20.0
9537,0,9537,[ 79 269 181 121 257],666,1,34682,3.636192073810023,0.0,0.0
9538,0,9538,[ 98  71 176  89  70],543,5,34687,3.6363350456022645,0.0,20.0
9539,0,9539,[405  56  70 301 385],279,3,34690,3.6362683438155137,0.0,0.0
9540,0,9540,[302 603 427  50 313],13,5,34695,3.6364112776438526,20.0,20.0
9541,0,9541,[211  28 328 118 185],328,4,34699,3.6364493816809893,0.0,0.0
9542,0,9542,[289 174 195  98  64],234,3,34702,3.636382688881903,0.0,40.0
9543,0,9543,[191 151 172 196 173],7,5,34707,3.636525565800503,0.0,0.0
9544,0,9544,[182  89 403 153 235],833,3,34710,3.636458878994238,0.0,0.0
9545,0,9545,[302 603 427  50 313],669,5,34715,3.636601717997067,20.0,20.0
9546,0,9546,[222 161 187 173  50],194,3,34718,3.636535037184456,0.0,20.0
9547,0,9547,[ 97 202  12 385 174],537,0,34718,3.636154168412233,20.0,20.0
9548,0,9548,[302 603 427  50 313],271,5,34723,3.6362969944496806,20.0,20.0
9549,0,9549,[143 197 187 210 180],311,4,34727,3.6363350785340316,0.0,0.0
9550,0,9550,[100 234 132 678 121],92,3,34730,3.6362684535650716,0.0,20.0
9551,0,9551,[257  96 222 471 245],454,2,34732,3.636097152428811,0.0,0.0
9552,0,9552,[ 25 333 423 202   8],533,4,34736,3.6361352454726266,0.0,0.0
9553,0,9553,[ 82  15   4 144 191],92,3,34739,3.636068662340381,0.0,0.0
9554,0,9554,[302 603 427  50 313],669,5,34744,3.636211407639979,20.0,20.0
9555,0,9555,[385 183 118 322 289],881,4,34748,3.6362494767685223,0.0,0.0
9556,0,9556,[275 127 357 125 222],648,2,34750,3.6360782672386733,20.0,20.0
9557,0,9557,[179 588  22 180  15],650,0,34750,3.635697844737393,0.0,0.0
9558,0,9558,[216  70 265 174 172],378,5,34755,3.635840569097186,0.0,20.0
9559,0,9559,[302 174 405 121 200],474,4,34759,3.635878661087866,0.0,20.0
9560,0,9560,[475 300 235 222 597],119,5,34764,3.6360213366802636,0.0,0.0
9561,0,9561,[678  50 238 357 496],82,3,34767,3.63595482116712,20.0,20.0
9562,0,9562,[ 69 385 195  71 318],374,3,34770,3.63588831956499,20.0,0.0
9563,0,9563,[286 196 222 118 302],343,4,34774,3.635926390631535,0.0,0.0
9564,0,9564,[265 423 238 175 475],92,4,34778,3.635964453737585,0.0,0.0
9565,0,9565,[176 194 121 111 276],643,5,34783,3.636107045787163,0.0,0.0
9566,0,9566,[405  96 176 135   1],536,3,34786,3.636040556078185,0.0,0.0
9567,0,9567,[302 603 427  50 313],474,5,34791,3.636183110367893,20.0,20.0
9568,0,9568,[302 603 427  50 313],271,5,34796,3.636325634862577,20.0,20.0
9569,0,9569,[302 603 427  50 313],454,5,34801,3.6364681295715777,20.0,20.0
9570,0,9570,[302  50 210  96 179],934,4,34805,3.6365061122139797,0.0,20.0
9571,0,9571,[265 269 603 568 515],7,3,34808,3.6364396155453407,20.0,0.0
9572,0,9572,[ 50 183  12 288 222],234,2,34810,3.6362686723075317,20.0,20.0
9573,0,9573,[185 405 161 211 435],7,3,34813,3.636202214330478,0.0,0.0
9574,0,9574,[483 100 194 172 427],385,3,34816,3.636135770234987,20.0,20.0
9575,0,9575,[302 603 427  50 313],13,5,34821,3.636278195488722,20.0,20.0
9576,0,9576,[357  11  97 216 655],184,2,34823,3.636107340503289,20.0,0.0
9577,0,9577,[302 603 427  50 313],454,5,34828,3.6362497389851742,20.0,20.0
9578,0,9578,[302 603 427  50 313],13,5,34833,3.636392107735672,20.0,20.0
9579,0,9579,[496 172 186 282 173],326,4,34837,3.63643006263048,0.0,0.0
9580,0,9580,[603 173 238 258 289],454,2,34839,3.6362592631249346,20.0,0.0
9581,0,9581,[302 603 427  50 313],669,5,34844,3.6364015863076604,20.0,20.0
9582,0,9582,[ 12 151 135  15 546],378,2,34846,3.6362308254200144,20.0,0.0
9583,0,9583,[302 603 427  50 313],14,4,34850,3.6362687813021703,20.0,20.0
9584,0,9584,[302 603 427  50 313],271,5,34855,3.6364110589462704,20.0,20.0
9585,0,9585,[ 79 100 153 258  71],738,2,34857,3.6362403505111622,0.0,20.0
9586,0,9586,[161 135  69 172  96],200,5,34862,3.636382601439449,0.0,0.0
9587,0,9587,[302 603 427  50 313],14,4,34866,3.6364205256570714,20.0,20.0
9588,0,9588,[ 28  71 269 313 265],254,2,34868,3.6362498696422985,0.0,0.0
9589,0,9589,[180 144 276 216  70],406,2,34870,3.6360792492179352,0.0,0.0
9590,0,9590,[302 603 427  50 313],669,5,34875,3.6362214576165153,20.0,20.0
9591,0,9591,[302 603 427  50 313],537,5,34880,3.6363636363636362,20.0,20.0
9592,0,9592,[742 183  12 187 175],666,4,34884,3.636401542791619,20.0,0.0
9593,0,9593,[174  11 333 496 222],334,4,34888,3.6364394413174903,0.0,20.0
9594,0,9594,[546 111   4 173 222],378,1,34889,3.636164669098489,0.0,0.0
9595,0,9595,[302 603 427  50 313],334,5,34894,3.6363067944977074,20.0,20.0
9596,0,9596,[174 257 191   7 172],474,4,34898,3.636344691049286,0.0,20.0
9597,0,9597,[302 603 427  50 313],669,5,34903,3.636486768076683,20.0,20.0
9598,0,9598,[ 98 515 187 597 211],650,3,34906,3.6364204604646315,0.0,20.0
9599,0,9599,[ 97 216 175  95  64],308,3,34909,3.6363541666666666,0.0,0.0
9600,0,9600,[183   9 294 237 483],788,4,34913,3.6363920424955736,20.0,0.0
9601,0,9601,[228 385 183 168 234],932,3,34916,3.636325765465528,0.0,0.0
9602,0,9602,[302 603 427  50 313],669,5,34921,3.636467770488389,20.0,20.0
9603,0,9603,[ 28 204   1 508 483],537,2,34923,3.6362973760932946,20.0,0.0
9604,0,9604,[302 603 427  50 313],13,5,34928,3.6364393545028633,20.0,20.0
9605,0,9605,[ 82 172  71  79   7],554,4,34932,3.636477201748907,0.0,0.0
9606,0,9606,[323 275  96   9 273],13,1,34933,3.6362027688144063,0.0,0.0
9607,0,9607,[302 603 427  50 313],13,5,34938,3.6363447127393838,20.0,20.0
9608,0,9608,[603 568  69 357 100],387,3,34941,3.636278488916641,40.0,20.0
9609,0,9609,[471   8 211 333 427],328,1,34942,3.6360041623309054,0.0,0.0
9610,0,9610,[302 603 427  50 313],13,5,34947,3.636146082613672,20.0,20.0
9611,0,9611,[322  64  71 222 176],533,4,34951,3.6361839367457347,0.0,0.0
9612,0,9612,[ 64 100  96 238  79],378,4,34955,3.6362217830021843,0.0,20.0
9613,0,9613,[302 603 427  50 313],271,5,34960,3.6363636363636362,20.0,20.0
9614,0,9614,[ 25  88 196 180 183],650,2,34962,3.6361934477379094,0.0,0.0
9615,0,9615,[168  98 322 748 237],749,3,34965,3.6361272878535775,0.0,20.0
9616,0,9616,[234 215  89 475 161],13,4,34969,3.6361651242591244,0.0,0.0
9617,0,9617,[483 678 508 176 323],537,2,34971,3.6359950093574547,20.0,0.0
9618,0,9618,[182  28 597  71 127],308,3,34974,3.635928890737083,0.0,20.0
9619,0,9619,[182 180 174 179 234],653,3,34977,3.635862785862786,0.0,20.0
9620,0,9620,[ 82 194 210 179 135],308,5,34982,3.636004573329176,0.0,0.0
9621,0,9621,[161  89 435 127 187],830,4,34986,3.636042402826855,0.0,20.0
9622,0,9622,[302 603 427  50 313],334,5,34991,3.6361841421594097,20.0,20.0
9623,0,9623,[302 603 427  50 313],334,5,34996,3.6363258520365753,20.0,20.0
9624,0,9624,[ 11 215   1 175 168],881,2,34998,3.6361558441558444,0.0,0.0
9625,0,9625,[181  56  88 161 118],378,5,35003,3.6362975275296074,0.0,0.0
9626,0,9626,[144 175 483 597 475],207,1,35004,3.6360236833904644,20.0,0.0
9627,0,9627,[302 603 427  50 313],271,5,35009,3.63616535105941,20.0,20.0
9628,0,9628,[204 176 405  98   7],643,2,35011,3.635995430470454,0.0,20.0
9629,0,9629,[302 603 427  50 313],271,5,35016,3.63613707165109,20.0,20.0
9630,0,9630,[ 64 174 111 742 496],378,3,35019,3.636071020662444,0.0,20.0
9631,0,9631,[475 288  97 196 678],455,3,35022,3.6360049833887045,0.0,0.0
9632,0,9632,[ 88 127 117 161  56],234,1,35023,3.6357313401847815,0.0,20.0
9633,0,9633,[302 603 427  50 313],474,5,35028,3.6358729499688605,20.0,20.0
9634,0,9634,[204 588  82  89 182],892,4,35032,3.635910742086144,0.0,0.0
9635,0,9635,[302 603 427  50 313],271,5,35037,3.6360523038605232,20.0,20.0
9636,0,9636,[678 202  50 333  11],537,1,35038,3.6357787693265537,0.0,20.0
9637,0,9637,[  9 238 265 144 282],378,4,35042,3.6358165594521683,0.0,0.0
9638,0,9638,[742 143 275 588 276],184,3,35045,3.63575059653491,0.0,0.0
9639,0,9639,[302 603 427  50 313],474,5,35050,3.6358921161825726,20.0,20.0
9640,0,9640,[483 168 197  11 175],59,5,35055,3.6360336064723575,20.0,0.0
9641,0,9641,[182 183 175 197 185],406,5,35060,3.6361750674134,0.0,0.0
9642,0,9642,[168 210 195 181   4],738,4,35064,3.6362127968474542,0.0,0.0
9643,0,9643,[302 603 427  50 313],13,5,35069,3.6363542098714228,20.0,20.0
9644,0,9644,[127 187   1 258 210],234,2,35071,3.63618455158113,0.0,20.0
9645,0,9645,[215 328 678 175  89],92,3,35074,3.6361185983827493,0.0,0.0
9646,0,9646,[294 603 269 216 174],537,1,35075,3.635845340520369,20.0,20.0
9647,0,9647,[508 210 174 313 151],474,3,35078,3.6357794361525704,0.0,20.0
9648,0,9648,[179  12 742 127 294],374,3,35081,3.6357135454451237,20.0,20.0
9649,0,9649,[302 603 427  50 313],669,5,35086,3.6358549222797927,20.0,20.0
9650,0,9650,[288 174 289 328 318],234,2,35088,3.6356854211998755,20.0,20.0
9651,0,9651,[ 64  82 151 496  95],64,3,35091,3.6356195607128057,0.0,0.0
9652,0,9652,[302 603 427  50 313],13,5,35096,3.63576090334611,20.0,20.0
9653,0,9653,[546 153 143 195 228],339,4,35100,3.6357986326911127,0.0,0.0
9654,0,9654,[471 216   8 318  88],308,3,35103,3.635732780942517,20.0,0.0
9655,0,9655,[234 508 405  56 282],643,3,35106,3.6356669428334714,0.0,0.0
9656,0,9656,[200 191 228   4 258],738,4,35110,3.6357046701874287,0.0,0.0
9657,0,9657,[194 427 289  25  56],537,2,35112,3.635535307517084,0.0,0.0
9658,0,9658,[294 300 289  15 282],63,1,35113,3.6352624495289367,0.0,0.0
9659,0,9659,[302 603 427  50 313],13,5,35118,3.6354037267080743,20.0,20.0
9660,0,9660,[191 237  70 748 196],207,3,35121,3.6353379567332573,0.0,0.0
9661,0,9661,[182 180 195   8  88],892,5,35126,3.6354791968536535,0.0,0.0
9662,0,9662,[216 265 204 174 211],543,5,35131,3.635620407740867,0.0,20.0
9663,0,9663,[  1 135 423 182 143],6,3,35134,3.6355546357615895,0.0,0.0
9664,0,9664,[302 603 427  50 313],334,5,35139,3.635695809622349,20.0,20.0
9665,0,9665,[302 603 427  50 313],454,5,35144,3.6358369542727083,20.0,20.0
9666,0,9666,[302 603 427  50 313],537,5,35149,3.635978069721734,20.0,20.0
9667,0,9667,[302 603 427  50 313],474,5,35154,3.6361191559784856,20.0,20.0
9668,0,9668,[302 603 427  50 313],14,4,35158,3.6361567897404075,20.0,20.0
9669,0,9669,[118 216  98  50 180],378,4,35162,3.636194415718718,0.0,40.0
9670,0,9670,[187 176 153 328 194],833,1,35163,3.6359218281460035,0.0,0.0
9671,0,9671,[302 603 427  50 313],669,5,35168,3.6360628618693136,20.0,20.0
9672,0,9672,[302 603 427  50 313],537,5,35173,3.6362038664323375,20.0,20.0
9673,0,9673,[302 603 427  50 313],454,5,35178,3.636344841844118,20.0,20.0
9674,0,9674,[302 603 427  50 313],537,5,35183,3.636485788113695,20.0,20.0
9675,0,9675,[302 603 427  50 313],14,4,35187,3.636523356758991,20.0,20.0
9676,0,9676,[302 318 405 546 144],458,4,35191,3.6365609176397644,20.0,0.0
9677,0,9677,[135 300 200   9 597],7,4,35195,3.6365984707584214,0.0,0.0
9678,0,9678,[  1   7 265   8 268],13,3,35198,3.636532699659056,0.0,0.0
9679,0,9679,[  1 197 182 196 294],308,2,35200,3.6363636363636362,0.0,0.0
9680,0,9680,[385  82 257  71  70],533,5,35205,3.636504493337465,0.0,0.0
9681,0,9681,[302 603 427  50 313],474,5,35210,3.6366453212146252,20.0,20.0
9682,0,9682,[302 603 427  50 313],13,5,35215,3.636786120004131,20.0,20.0
9683,0,9683,[313 289 197  64 318],537,3,35218,3.636720363486163,20.0,0.0
9684,0,9684,[ 22 125 748 435 603],64,2,35220,3.636551368094992,20.0,0.0
9685,0,9685,[302 603 427  50 313],537,5,35225,3.6366921329754285,20.0,20.0
9686,0,9686,[ 88  64 182 471  28],207,2,35227,3.6365231753896974,0.0,0.0
9687,0,9687,[187 197  71 127 175],881,3,35230,3.6364574731626753,0.0,20.0
9688,0,9688,[268 328 496  25 269],90,4,35234,3.6364949943234595,0.0,0.0
9689,0,9689,[302 603 427  50 313],537,5,35239,3.636635706914345,20.0,20.0
9690,0,9690,[117 269 508  97  79],378,4,35243,3.6366732019399444,0.0,0.0
9691,0,9691,[132 286 333 568 273],328,2,35245,3.6365043334709037,0.0,0.0
9692,0,9692,[302 603 427  50 313],474,5,35250,3.6366450015475085,20.0,20.0
9693,0,9693,[302 603 427  50 313],13,5,35255,3.6367856406024344,20.0,20.0
9694,0,9694,[195  88 191 117  28],308,3,35258,3.6367199587416192,0.0,0.0
9695,0,9695,[195  98  69 385  82],648,4,35262,3.6367574257425743,0.0,20.0
9696,0,9696,[125  25 265   1 187],194,3,35265,3.636691760338249,0.0,0.0
9697,0,9697,[302 603 427  50 313],13,5,35270,3.63683233656424,20.0,20.0
9698,0,9698,[ 15 678 174 127  25],881,2,35272,3.636663573564285,0.0,40.0
9699,0,9699,[294 175 185  88  79],406,2,35274,3.636494845360825,0.0,0.0
9700,0,9700,[655  22 204 268 313],92,4,35278,3.636532316256056,0.0,0.0
9701,0,9701,[197 161 151  88 204],881,1,35279,3.6362605648319932,0.0,0.0
9702,0,9702,[ 88 275  97  50 186],452,3,35282,3.636194991239823,0.0,20.0
9703,0,9703,[302 603 427  50 313],13,5,35287,3.6363355317394888,20.0,20.0
9704,0,9704,[435  22 323 215  89],13,4,35291,3.6363730036063884,0.0,0.0
9705,0,9705,[603 185   1 496 238],749,4,35295,3.6364104677519062,20.0,0.0
9706,0,9706,[302 603 427  50 313],669,5,35300,3.6365509426187286,20.0,20.0
9707,0,9707,[275   4   8 176 132],533,2,35302,3.6363823650597444,0.0,0.0
9708,0,9708,[ 56 172  11 300 210],346,5,35307,3.6365228138840253,0.0,0.0
9709,0,9709,[515 508   1 269 200],13,0,35307,3.6361483007209063,0.0,0.0
9710,0,9710,[258 185 302 121 515],474,5,35312,3.6362887447224796,0.0,0.0
9711,0,9711,[302 603 427  50 313],14,4,35316,3.636326194398682,20.0,20.0
9712,0,9712,[271 172  88  56 174],537,1,35317,3.6360547719551115,0.0,20.0
9713,0,9713,[ 25 405 183 238 496],648,3,35320,3.635989293802759,0.0,0.0
9714,0,9714,[196 180 181 111 301],537,1,35321,3.635717961914565,0.0,0.0
9715,0,9715,[ 25 742 588 597 176],650,1,35322,3.6354466858789625,0.0,0.0
9716,0,9716,[194 211 385   1 678],804,5,35327,3.6355871153648245,0.0,0.0
9717,0,9717,[222 228  71 182 127],374,5,35332,3.635727515949784,0.0,20.0
9718,0,9718,[ 28 328  56  11 265],334,2,35334,3.6355592139108963,0.0,0.0
9719,0,9719,[435  28 405 222 143],254,3,35337,3.6354938271604937,0.0,0.0
9720,0,9720,[323 265  96   7 195],648,4,35341,3.6355313239378666,0.0,0.0
9721,0,9721,[294 222 318 211 174],479,4,35345,3.63556881300144,20.0,20.0
9722,0,9722,[  8  71 200 185 187],308,5,35350,3.6357091432685387,0.0,0.0
9723,0,9723,[423 257 322 196 187],881,4,35354,3.6357466063348416,0.0,0.0
9724,0,9724,[185 357   4  64 748],804,5,35359,3.635886889460154,20.0,0.0
9725,0,9725,[302 603 427  50 313],454,5,35364,3.636027143738433,20.0,20.0
9726,0,9726,[202 323  28 118  98],200,4,35368,3.6360645625578285,0.0,20.0
9727,0,9727,[302 603 427  50 313],454,5,35373,3.636204769736842,20.0,20.0
9728,0,9728,[302 603 427  50 313],537,5,35378,3.6363449480933294,20.0,20.0
9729,0,9729,[  1 215  96 313 186],92,5,35383,3.636485097636177,0.0,0.0
9730,0,9730,[427 300  88 195 153],87,4,35387,3.6365224540129484,0.0,0.0
9731,0,9731,[ 96 405 318 161  56],7,3,35390,3.6364570489108097,20.0,0.0
9732,0,9732,[435 288 405  15 294],82,2,35392,3.636288914003904,0.0,0.0
9733,0,9733,[182 603 127 173 211],650,3,35395,3.636223546332443,20.0,20.0
9734,0,9734,[302 603 427  50 313],14,4,35399,3.636260914227016,20.0,20.0
9735,0,9735,[403  97 210 197 427],934,5,35404,3.6364009860312243,0.0,0.0
9736,0,9736,[302 603 427  50 313],454,5,35409,3.6365410290643934,20.0,20.0
9737,0,9737,[204 655 185 202 294],234,0,35409,3.6361675908810844,0.0,0.0
9738,0,9738,[328 405 318 180 294],804,5,35414,3.636307629120033,20.0,0.0
9739,0,9739,[238 153 185 269  22],488,2,35416,3.6361396303901437,0.0,0.0
9740,0,9740,[143 210 196 357 265],379,5,35421,3.636279642747151,20.0,0.0
9741,0,9741,[302 603 427  50 313],474,5,35426,3.6364196263600905,20.0,20.0
9742,0,9742,[  1 182 183 300  71],488,2,35428,3.6362516678641077,0.0,0.0
9743,0,9743,[302 603 427  50 313],474,5,35433,3.6363916256157633,20.0,20.0
9744,0,9744,[200 174 186  79 435],749,5,35438,3.636531554643407,0.0,20.0
9745,0,9745,[655   1   4 194 603],339,5,35443,3.6366714549558794,20.0,0.0
9746,0,9746,[ 25 182 405 483 234],537,2,35445,3.636503539550631,20.0,0.0
9747,0,9747,[200  88 238 117 191],650,4,35449,3.636540828887977,0.0,0.0
9748,0,9748,[288 173 143 588  64],452,2,35451,3.636372961329367,0.0,0.0
9749,0,9749,[211 135 403 289 655],328,3,35454,3.6363076923076925,0.0,0.0
9750,0,9750,[ 50 196  96 211   7],64,5,35459,3.6364475438416575,0.0,20.0
9751,0,9751,[302 603 427  50 313],334,5,35464,3.6365873666940116,20.0,20.0
9752,0,9752,[ 82 222   4 175 196],537,1,35465,3.6363170306572337,0.0,0.0
9753,0,9753,[151 237 597  11 117],346,4,35469,3.6363543161779783,0.0,0.0
9754,0,9754,[546 215   1 135  88],95,3,35472,3.6362890825217837,0.0,0.0
9755,0,9755,[125 175 117  69 385],653,3,35475,3.6362238622386225,0.0,0.0
9756,0,9756,[  7 181 135  95 183],537,2,35477,3.6360561648047556,0.0,0.0
9757,0,9757,[222 127 275 121 318],311,5,35482,3.6361959417913505,20.0,20.0
9758,0,9758,[275 471 185  82  71],454,1,35483,3.635925812070909,0.0,0.0
9759,0,9759,[ 50 186 238 276   7],406,3,35486,3.635860655737705,0.0,20.0
9760,0,9760,[ 12 211  71 168 405],60,4,35490,3.6358979612744595,20.0,0.0
9761,0,9761,[385  79 183 194 318],64,5,35495,3.6360376971931982,20.0,0.0
9762,0,9762,[172 194  97 176 197],804,5,35500,3.6361774044863258,0.0,0.0
9763,0,9763,[111  50  88 204 323],374,1,35501,3.635907414993855,0.0,20.0
9764,0,9764,[748  12 300 313  25],533,4,35505,3.6359447004608296,20.0,0.0
9765,0,9765,[222 475  11 168  56],92,5,35510,3.6360843743600246,0.0,0.0
9766,0,9766,[322 197 175 748  70],883,4,35514,3.6361216340739224,0.0,0.0
9767,0,9767,[100 143 237  96 275],308,4,35518,3.6361588861588863,0.0,20.0
9768,0,9768,[302 603 427  50 313],13,5,35523,3.636298495240045,20.0,20.0
9769,0,9769,[ 95 182 235 100 174],795,4,35527,3.6363357215967245,0.0,40.0
9770,0,9770,[302 603 427  50 313],334,5,35532,3.6364752840036845,20.0,20.0
9771,0,9771,[302 603 427  50 313],13,5,35537,3.6366148178469095,20.0,20.0
9772,0,9772,[194  79  96 597 588],308,4,35541,3.636652000409291,0.0,0.0
9773,0,9773,[286   8 185 318 357],90,5,35546,3.6367914876202168,40.0,0.0
9774,0,9774,[302 603 427  50 313],14,4,35550,3.636828644501279,20.0,20.0
9775,0,9775,[302 603 427  50 313],334,5,35555,3.636968085106383,20.0,20.0
9776,0,9776,[302 603 427  50 313],474,5,35560,3.637107497187276,20.0,20.0
9777,0,9777,[302 603 427  50 313],537,5,35565,3.63724688075271,20.0,20.0
9778,0,9778,[ 12  11   7  88 202],406,3,35568,3.6371817159218733,20.0,0.0
9779,0,9779,[302 603 427  50 313],537,5,35573,3.637321063394683,20.0,20.0
9780,0,9780,[302 603 427  50 313],271,5,35578,3.6374603823739906,20.0,20.0
9781,0,9781,[211 748 405  70  95],64,3,35581,3.6373952157023104,0.0,0.0
9782,0,9782,[181 132 603 186 210],313,4,35585,3.6374322804865584,20.0,0.0
9783,0,9783,[302 603 427  50 313],13,5,35590,3.6375715453802124,20.0,20.0
9784,0,9784,[302 603 427  50 313],537,5,35595,3.637710781808891,20.0,20.0
9785,0,9785,[483   1  22 151 568],536,4,35599,3.6377478029838546,20.0,0.0
9786,0,9786,[302 603 427  50 313],669,5,35604,3.637886992949831,20.0,20.0
9787,0,9787,[ 56  71 515  97  96],474,5,35609,3.638026154474867,0.0,0.0
9788,0,9788,[245 257  12 318 234],454,2,35611,3.637858821125753,40.0,0.0
9789,0,9789,[  9  28 234 187 275],328,5,35616,3.637997957099081,0.0,0.0
9790,0,9790,[ 11 173 135  89 238],145,5,35621,3.63813706465121,0.0,0.0
9791,0,9791,[302 603 427  50 313],474,5,35626,3.6382761437908497,20.0,20.0
9792,0,9792,[302 603 427  50 313],474,5,35631,3.638415194526703,20.0,20.0
9793,0,9793,[  8 333  12 269 153],13,3,35634,3.638350010210333,20.0,0.0
9794,0,9794,[435  11 200 333 121],13,2,35636,3.6381827462991323,0.0,0.0
9795,0,9795,[302 603 427  50 313],271,5,35641,3.6383217639853003,20.0,20.0
9796,0,9796,[357 475  82 197 183],537,3,35644,3.638256609166071,20.0,0.0
9797,0,9797,[ 28 546 228 118  64],455,4,35648,3.6382935292916923,0.0,0.0
9798,0,9798,[302 603 427  50 313],13,5,35653,3.638432493111542,20.0,20.0
9799,0,9799,[ 69 215 173 228 234],406,2,35655,3.638265306122449,0.0,0.0
9800,0,9800,[403 588 200 172 318],804,3,35658,3.638200183654729,20.0,0.0
9801,0,9801,[289 483  88 282 275],406,1,35659,3.6379310344827585,20.0,0.0
9802,0,9802,[288 100  56 118 127],188,4,35663,3.637967968989085,0.0,40.0
9803,0,9803,[210 127  64 328 215],85,3,35666,3.6379028967768257,0.0,20.0
9804,0,9804,[597 238  25 385 127],13,1,35667,3.6376338602753697,0.0,20.0
9805,0,9805,[ 79  96  71 546 195],313,5,35672,3.6377727921680605,0.0,0.0
9806,0,9806,[ 79 204 187 194 121],315,4,35676,3.6378097277454877,0.0,0.0
9807,0,9807,[302 603 427  50 313],537,5,35681,3.6379486133768353,20.0,20.0
9808,0,9808,[302 603 427  50 313],537,5,35686,3.6380874706901825,20.0,20.0
9809,0,9809,[125 357 483 405  89],892,5,35691,3.6382262996941894,40.0,0.0
9810,0,9810,[143 191 174 183 265],339,4,35695,3.6382631739883804,0.0,20.0
9811,0,9811,[196 135 181  97  56],13,5,35700,3.638401956787607,0.0,0.0
9812,0,9812,[197  71 222 546 194],313,4,35704,3.6384388056659533,0.0,0.0
9813,0,9813,[655 176 222 546 258],666,4,35708,3.638475647034848,0.0,0.0
9814,0,9814,[  1 118  50 125 655],194,2,35710,3.638308711156393,0.0,20.0
9815,0,9815,[603 187 172 118  28],897,5,35715,3.638447432762836,20.0,0.0
9816,0,9816,[302 603 427  50 313],537,5,35720,3.6385861261077723,20.0,20.0
9817,0,9817,[302 603 427  50 313],271,5,35725,3.638724791199837,20.0,20.0
9818,0,9818,[195 194  96 182 603],234,2,35727,3.6385578979529485,20.0,0.0
9819,0,9819,[174 385 143 204 118],694,5,35732,3.6386965376782077,0.0,20.0
9820,0,9820,[678 216 117  15  98],474,4,35736,3.6387333265451582,0.0,20.0
9821,0,9821,[174  56   1 100 258],465,3,35739,3.638668295662798,0.0,40.0
9822,0,9822,[258 182 174 183 288],13,4,35743,3.6387050799144864,0.0,20.0
9823,0,9823,[357 183 191 288 471],882,4,35747,3.6387418566775245,20.0,0.0
9824,0,9824,[302 603 427  50 313],537,5,35752,3.638880407124682,20.0,20.0
9825,0,9825,[237  79 210 427 276],13,3,35755,3.6388153877467944,0.0,0.0
9826,0,9826,[496 185 176  79  12],308,4,35759,3.6388521420575963,20.0,0.0
9827,0,9827,[302 603 427  50 313],454,5,35764,3.638990638990639,20.0,20.0
9828,0,9828,[271 357  22 435 237],537,1,35765,3.638722148743514,20.0,0.0
9829,0,9829,[302 603 427  50 313],334,5,35770,3.6388606307222786,20.0,20.0
9830,0,9830,[273  82  25 186 135],374,4,35774,3.638897365476554,0.0,0.0
9831,0,9831,[202 204  88 288 161],92,1,35775,3.638628966639544,0.0,0.0
9832,0,9832,[216 202 568 197 194],326,3,35778,3.638564019119292,0.0,0.0
9833,0,9833,[300 200 143 655 196],234,1,35779,3.6382957087655075,0.0,0.0
9834,0,9834,[302 603 427  50 313],474,5,35784,3.6384341637010675,20.0,20.0
9835,0,9835,[302 603 427  50 313],669,5,35789,3.6385725904839368,20.0,20.0
9836,0,9836,[357 265  12 322  56],328,4,35793,3.6386093321134494,40.0,0.0
9837,0,9837,[302 603 427  50 313],271,5,35798,3.6387477129497867,20.0,20.0
9838,0,9838,[302 603 427  50 313],474,5,35803,3.638886065657079,20.0,20.0
9839,0,9839,[273 322 288 276 117],486,2,35805,3.638719512195122,0.0,0.0
9840,0,9840,[302 603 427  50 313],334,5,35810,3.638857839650442,20.0,20.0
9841,0,9841,[185   4 174  56 597],102,1,35811,3.638589717537086,0.0,20.0
9842,0,9842,[  7 748 271 328 195],116,2,35813,3.638423244945647,0.0,0.0
9843,0,9843,[ 79 483  28  89  97],339,5,35818,3.6385615603413246,20.0,0.0
9844,0,9844,[655 185 273 483  97],13,3,35821,3.6384966988318945,20.0,0.0
9845,0,9845,[302 603 427  50 313],14,4,35825,3.638533414584603,20.0,20.0
9846,0,9846,[302 603 427  50 313],669,5,35830,3.6386716766527876,20.0,20.0
9847,0,9847,[238 257  12 568   7],378,4,35834,3.6387083671811533,20.0,0.0
9848,0,9848,[ 71 222 496 127  12],311,5,35839,3.6388465834094834,20.0,20.0
9849,0,9849,[196 111 385 191 405],13,2,35841,3.638680203045685,0.0,0.0
9850,0,9850,[302 603 427  50 313],271,5,35846,3.638818394071668,20.0,20.0
9851,0,9851,[118 185  82 405  25],897,4,35850,3.6388550548112057,0.0,0.0
9852,0,9852,[302 603 427  50 313],669,5,35855,3.6389932000405967,20.0,20.0
9853,0,9853,[302 603 427  50 313],537,5,35860,3.639131317231581,20.0,20.0
9854,0,9854,[215 546 161 153 176],234,0,35860,3.638762049720954,0.0,0.0
9855,0,9855,[174 655   7 238  96],643,4,35864,3.6387987012987013,0.0,20.0
9856,0,9856,[515 435   7 200  82],234,2,35866,3.638632443948463,0.0,0.0
9857,0,9857,[204 185 588 234 196],406,4,35870,3.6386691012375736,0.0,0.0
9858,0,9858,[183 179 174 423 197],452,5,35875,3.6388071812557055,0.0,20.0
9859,0,9859,[168  89 172 185 318],239,4,35879,3.638843813387424,20.0,0.0
9860,0,9860,[294 182 211  70 257],318,5,35884,3.638981847682791,0.0,0.0
9861,0,9861,[ 97 237 588 153 496],892,5,35889,3.639119853984993,0.0,0.0
9862,0,9862,[195 423 151 174 194],215,5,35894,3.639257832302545,0.0,20.0
9863,0,9863,[302 603 427  50 313],334,5,35899,3.639395782643958,20.0,20.0
9864,0,9864,[ 71 508 294 173 237],474,3,35902,3.6393309680689305,0.0,0.0
9865,0,9865,[237  98 302 496 286],454,3,35905,3.6392661666328805,0.0,20.0
9866,0,9866,[427 125 197 195 135],374,3,35908,3.639201378331813,0.0,0.0
9867,0,9867,[678 748 111 135  11],488,3,35911,3.639136603161735,0.0,0.0
9868,0,9868,[238 153 161 187 286],379,4,35915,3.6391731685074475,0.0,0.0
9869,0,9869,[180 228  95  71 196],738,4,35919,3.639209726443769,0.0,0.0
9870,0,9870,[302 603 427  50 313],334,5,35924,3.6393475838314253,20.0,20.0
9871,0,9871,[258 568 211 125 168],59,3,35927,3.639282820097245,0.0,0.0
9872,0,9872,[328 357 118 186 135],788,2,35929,3.6391167831459534,20.0,0.0
9873,0,9873,[471 276 222 173 185],13,1,35930,3.638849503747215,0.0,0.0
9874,0,9874,[302 603 427  50 313],454,5,35935,3.638987341772152,20.0,20.0
9875,0,9875,[ 89 186 588 357 222],234,1,35936,3.6387201296071283,20.0,0.0
9876,0,9876,[191   1 135  69 508],653,4,35940,3.638756707502278,0.0,0.0
9877,0,9877,[405 302 144  88  22],378,4,35944,3.638793277991496,0.0,0.0
9878,0,9878,[151  56 210 423 100],533,3,35947,3.638728616256706,0.0,20.0
9879,0,9879,[302 603 427  50 313],474,5,35952,3.6388663967611334,20.0,20.0
9880,0,9880,[475 151 180 216  22],479,3,35955,3.6388017407145026,0.0,0.0
9881,0,9881,[302 333  25  88 151],537,1,35956,3.6385347095729608,0.0,0.0
9882,0,9882,[515 588 328 175 194],95,4,35960,3.6385712840230697,0.0,0.0
9883,0,9883,[328 143 186 175 168],334,2,35962,3.6384055038445973,0.0,0.0
9884,0,9884,[121  64   9 471  25],194,2,35964,3.6382397572078906,0.0,0.0
9885,0,9885,[302 603 427  50 313],669,5,35969,3.6383775035403603,20.0,20.0
9886,0,9886,[168  11 118 435 273],102,0,35969,3.6380095074340044,0.0,0.0
9887,0,9887,[ 97 276 172 121 568],59,5,35974,3.6381472491909386,0.0,0.0
9888,0,9888,[211 403  50 180 202],210,5,35979,3.6382849630903022,0.0,20.0
9889,0,9889,[197 135 191   7 423],343,5,35984,3.638422649140546,0.0,0.0
9890,0,9890,[302 603 427  50 313],669,5,35989,3.6385603073501165,20.0,20.0
9891,0,9891,[222 215  22  25 288],892,5,35994,3.6386979377274566,0.0,0.0
9892,0,9892,[273 191  15 153 300],378,5,35999,3.638835540281007,0.0,0.0
9893,0,9893,[302 603 427  50 313],537,5,36004,3.6389731150192035,20.0,20.0
9894,0,9894,[385 135 144 515  98],666,3,36007,3.6389085396664984,0.0,20.0
9895,0,9895,[125 333 175   1 748],64,2,36009,3.638742926434923,0.0,0.0
9896,0,9896,[186 211 603  64  89],64,3,36012,3.6386783873901183,20.0,0.0
9897,0,9897,[200 121 175 276 269],13,3,36015,3.6386138613861387,0.0,0.0
9898,0,9898,[471 435  56  89 234],378,4,36019,3.6386503687241136,0.0,0.0
9899,0,9899,[222 195 194 508 180],13,2,36021,3.6384848484848487,0.0,0.0
9900,0,9900,[  8 175 323 111 748],125,1,36022,3.638218361781638,0.0,0.0
9901,0,9901,[194  50  96  89 204],97,4,36026,3.638254898000404,0.0,20.0
9902,0,9902,[117 234 211 185 143],454,1,36027,3.637988488336868,0.0,0.0
9903,0,9903,[161 748 187 222 357],804,5,36032,3.638126009693053,20.0,0.0
9904,0,9904,[168  82  70 423 185],479,4,36036,3.6381625441696115,0.0,0.0
9905,0,9905,[302 603 427  50 313],454,5,36041,3.638300020189784,20.0,20.0
9906,0,9906,[302 603 427  50 313],474,5,36046,3.638437468456647,20.0,20.0
9907,0,9907,[302 603 427  50 313],14,4,36050,3.6384739604360115,20.0,20.0
9908,0,9908,[286 197 276  79 588],537,2,36052,3.6383086083358562,0.0,0.0
9909,0,9909,[234 222 180 286 185],881,3,36055,3.63824419778002,0.0,0.0
9910,0,9910,[257   8 204 655 237],144,4,36059,3.6382806982141056,0.0,0.0
9911,0,9911,[215 127   1 300 403],653,3,36062,3.6382163034705406,0.0,20.0
9912,0,9912,[175 748  71 237  97],804,5,36067,3.6383536769898113,0.0,0.0
9913,0,9913,[ 56 210   1 294 275],13,1,36068,3.6380875529554166,0.0,0.0
9914,0,9914,[180 143 385 288 197],804,3,36071,3.638023197175996,0.0,0.0
9915,0,9915,[185  11 161 168 172],881,3,36074,3.6379588543767647,0.0,0.0
9916,0,9916,[ 98 125 174 127 175],648,2,36076,3.637793687607139,0.0,60.0
9917,0,9917,[211 286 275 200 144],298,3,36079,3.6377293809235733,0.0,0.0
9918,0,9918,[302 603 427  50 313],454,5,36084,3.637866720435528,20.0,20.0
9919,0,9919,[211 294 357 161 423],13,3,36087,3.6378024193548386,20.0,0.0
9920,0,9920,[117 180 385 742 496],653,3,36090,3.6377381312367705,0.0,0.0
9921,0,9921,[215 161 471 313   8],454,4,36094,3.637774642209232,0.0,0.0
9922,0,9922,[302 603 427  50 313],13,5,36099,3.6379119217978433,20.0,20.0
9923,0,9923,[302  15 183  70 181],207,2,36101,3.637746876259573,0.0,0.0
9924,0,9924,[302 245 748 282 276],190,3,36104,3.637682619647355,0.0,0.0
9925,0,9925,[ 98 144 125  97 423],290,2,36106,3.637517630465444,0.0,20.0
9926,0,9926,[294 132   7 313 195],13,2,36108,3.6373526745240254,0.0,0.0
9927,0,9927,[302 603 427  50 313],13,5,36113,3.6374899274778403,20.0,20.0
9928,0,9928,[161 127  50 423  79],648,3,36116,3.637425722630678,0.0,40.0
9929,0,9929,[302 603 427  50 313],454,5,36121,3.637562940584089,20.0,20.0
9930,0,9930,[301 197 168 271 245],334,2,36123,3.6373980465209947,0.0,0.0
9931,0,9931,[228 238  96 143  69],13,3,36126,3.6373338703181637,0.0,0.0
9932,0,9932,[222 194 300 282 200],311,5,36131,3.6374710560757073,0.0,0.0
9933,0,9933,[237  15 603  12 496],474,5,36136,3.6376082142138113,40.0,0.0
9934,0,9934,[ 89 257  70  96 237],883,3,36139,3.637544036235531,0.0,0.0
9935,0,9935,[475  96 286  15 276],455,4,36143,3.6375805152979064,0.0,0.0
9936,0,9936,[153 568 117 196 275],308,3,36146,3.6375163530240515,0.0,0.0
9937,0,9937,[302 603 427  50 313],14,4,36150,3.63755282753069,20.0,20.0
9938,0,9938,[176 655 181 403 125],313,3,36153,3.6374886809538185,0.0,0.0
9939,0,9939,[111 197 176 655 204],95,4,36157,3.6375251509054327,0.0,0.0
9940,0,9940,[302 603 427  50 313],13,5,36162,3.6376622070214264,20.0,20.0
9941,0,9941,[215 496 568  50 275],95,4,36166,3.6376986521826593,0.0,20.0
9942,0,9942,[180 288 143 496 423],533,3,36169,3.637634516745449,0.0,0.0
9943,0,9943,[302 603 427  50 313],454,5,36174,3.6377715205148835,20.0,20.0
9944,0,9944,[ 15 588 427  70 357],882,4,36178,3.6378079436902966,20.0,0.0
9945,0,9945,[ 56 237  15 176 185],59,4,36182,3.6378443595415244,0.0,0.0
9946,0,9946,[302 603 427  50 313],669,5,36187,3.637981300894742,20.0,20.0
9947,0,9947,[215  71 153  22  88],378,5,36192,3.638118214716526,0.0,0.0
9948,0,9948,[655  96 180  28  69],527,3,36195,3.638054075786511,0.0,0.0
9949,0,9949,[302 603 427  50 313],13,5,36200,3.6381909547738696,20.0,20.0
9950,0,9950,[235  71 275  25 175],378,5,36205,3.638327806250628,0.0,0.0
9951,0,9951,[302 603 427  50 313],474,5,36210,3.6384646302250805,20.0,20.0
9952,0,9952,[121 323   7 318  79],59,5,36215,3.638601426705516,20.0,0.0
9953,0,9953,[216  15 475 286 427],537,2,36217,3.638436809322885,0.0,0.0
9954,0,9954,[ 11 180 100 117 222],474,5,36222,3.6385735811150175,0.0,20.0
9955,0,9955,[ 96  79  15 235 403],313,2,36224,3.6384089995982323,0.0,0.0
9956,0,9956,[ 97 211 427 195 161],87,5,36229,3.638545746710857,0.0,0.0
9957,0,9957,[ 88 427 181 168 135],934,5,36234,3.6386824663587065,0.0,0.0
9958,0,9958,[ 28 175   4 385 180],738,5,36239,3.638819158550055,0.0,0.0
9959,0,9959,[302 603 427  50 313],14,4,36243,3.638855421686747,20.0,20.0
9960,0,9960,[742 100 200 268 655],387,2,36245,3.638690894488505,0.0,20.0
9961,0,9961,[  1 186 318 183 258],64,4,36249,3.6387271632202367,20.0,0.0
9962,0,9962,[302 603 427  50 313],669,5,36254,3.638863796045368,20.0,20.0
9963,0,9963,[180 655 265 742 195],804,5,36259,3.6390004014452026,0.0,0.0
9964,0,9964,[  1  56 276 294 515],308,3,36262,3.638936276969393,0.0,0.0
9965,0,9965,[385 475 196 187  12],533,4,36266,3.638972506522175,20.0,0.0
9966,0,9966,[195  64 100 215  79],194,2,36268,3.6388080666198457,0.0,20.0
9967,0,9967,[183 423 333 568  71],328,3,36271,3.638743980738363,0.0,0.0
9968,0,9968,[144   1 135  98 568],749,5,36276,3.63888052964189,0.0,20.0
9969,0,9969,[100 300  11  79 471],788,3,36279,3.638816449348044,0.0,20.0
9970,0,9970,[302 603 427  50 313],454,5,36284,3.638952963594424,20.0,20.0
9971,0,9971,[302 603 427  50 313],669,5,36289,3.6390894504612916,20.0,20.0
9972,0,9972,[222  89 294 200 125],749,3,36292,3.6390253684949365,0.0,0.0
9973,0,9973,[183  89  79 153  82],13,3,36295,3.638961299378384,0.0,0.0
9974,0,9974,[294  69 100 187  50],452,3,36298,3.6388972431077695,0.0,40.0
9975,0,9975,[302 603 427  50 313],334,5,36303,3.6390336808340016,20.0,20.0
9976,0,9976,[196  98  12   9  82],343,5,36308,3.6391700912097824,20.0,20.0
9977,0,9977,[235 742 153 216  82],308,3,36311,3.639106033273201,0.0,0.0
9978,0,9978,[ 82 196 127 294 265],452,2,36313,3.63894177773324,0.0,20.0
9979,0,9979,[258 234 568 215 196],92,4,36317,3.6389779559118236,0.0,0.0
9980,0,9980,[ 12 175 405 313 275],378,4,36321,3.6390141268409977,20.0,0.0
9981,0,9981,[ 79 144  70 180  69],536,4,36325,3.6390502905229414,0.0,0.0
9982,0,9982,[228 471 182 427 194],454,1,36326,3.6387859360913555,0.0,0.0
9983,0,9983,[302 603 427  50 313],13,5,36331,3.6389222756410255,20.0,20.0
9984,0,9984,[265 197 100   4 322],13,4,36335,3.6389584376564845,0.0,20.0
9985,0,9985,[132  56 144  82 186],666,2,36337,3.6387943120368518,0.0,0.0
9986,0,9986,[302 603 427  50 313],13,5,36342,3.6389306097927308,20.0,20.0
9987,0,9987,[302 603 427  50 313],474,5,36347,3.6390668802563075,20.0,20.0
9988,0,9988,[  1  95 403 475 496],64,5,36352,3.6392031234357796,0.0,0.0
9989,0,9989,[ 71   1 168 235 100],64,4,36356,3.6392392392392394,0.0,20.0
9990,0,9990,[235 427 234 496 210],650,3,36359,3.6391752577319587,0.0,0.0
9991,0,9991,[181  97 655 127 234],479,4,36363,3.639211369095276,0.0,20.0
9992,0,9992,[234 121  11 678 405],447,3,36366,3.6391474031822275,0.0,0.0
9993,0,9993,[568 117 215 161 234],749,4,36370,3.6391835101060637,0.0,0.0
9994,0,9994,[302 603 427  50 313],474,5,36375,3.639319659829915,20.0,20.0
9995,0,9995,[204 257 174  25 210],271,4,36379,3.6393557422969187,0.0,20.0
9996,0,9996,[302 603 427  50 313],334,5,36384,3.6394918475542664,20.0,20.0
9997,0,9997,[245  25 289 258  88],533,3,36387,3.6394278855771156,0.0,0.0
9998,0,9998,[117  25 228 318 183],892,4,36391,3.6394639463946397,20.0,0.0
9999,0,9999,[302 603 427  50 313],454,5,36396,3.6396,20.0,20.0
10000,1,0,[302 175  56 127 271],13,4,4,4.0,0.0,20.0
10001,1,1,[302 127 175  56 678],664,4,8,4.0,0.0,20.0
10002,1,2,[  9 144  71 405  15],455,1,9,3.0,0.0,0.0
10003,1,3,[127  56 302   9 175],343,5,14,3.5,0.0,20.0
10004,1,4,[127  56 302   9 175],14,4,18,3.6,0.0,20.0
10005,1,5,[ 56 302   9 175 127],10,4,22,3.6666666666666665,0.0,20.0
10006,1,6,[ 56 302   9 127 175],334,5,27,3.857142857142857,0.0,20.0
10007,1,7,[179 175 403   1 235],13,1,28,3.5,0.0,0.0
10008,1,8,[100 265 471 603 121],533,4,32,3.5555555555555554,20.0,20.0
10009,1,9,[204  97 176 603 385],543,3,35,3.5,20.0,0.0
10010,1,10,[ 56 471 176 302 100],474,4,39,3.5454545454545454,0.0,20.0
10011,1,11,[168 271 405 183 385],379,2,41,3.4166666666666665,0.0,0.0
10012,1,12,[ 50 234 172  64 333],533,4,45,3.4615384615384617,0.0,20.0
10013,1,13,[168  50  56 172 176],940,4,49,3.5,0.0,20.0
10014,1,14,[483 215 471 273 195],479,4,53,3.533333333333333,20.0,0.0
10015,1,15,[742  69 508 427 655],59,4,57,3.5625,0.0,0.0
10016,1,16,[235  25 161  98  50],295,5,62,3.6470588235294117,0.0,40.0
10017,1,17,[655 100  69 483 183],194,4,66,3.6666666666666665,20.0,20.0
10018,1,18,[655 100 121  69 483],664,2,68,3.5789473684210527,20.0,20.0
10019,1,19,[182 161 603 186 144],7,4,72,3.6,20.0,0.0
10020,1,20,[483 508 153  56 117],207,4,76,3.619047619047619,20.0,0.0
10021,1,21,[385 168 181 194 210],313,4,80,3.6363636363636362,0.0,0.0
10022,1,22,[ 88 435 202  82 603],533,5,85,3.6956521739130435,20.0,0.0
10023,1,23,[204  56 176 302 100],537,3,88,3.6666666666666665,0.0,20.0
10024,1,24,[568  98 265 168 655],387,3,91,3.64,0.0,20.0
10025,1,25,[118  12 302 185   9],788,4,95,3.6538461538461537,20.0,0.0
10026,1,26,[603  64  98  12 181],387,4,99,3.6666666666666665,40.0,20.0
10027,1,27,[ 64  89 197 168 179],537,4,103,3.6785714285714284,0.0,0.0
10028,1,28,[204  71 183 194 144],313,5,108,3.7241379310344827,0.0,0.0
10029,1,29,[ 89 302 333 172  50],346,4,112,3.7333333333333334,0.0,20.0
10030,1,30,[475 216 435 275 118],13,2,114,3.6774193548387095,0.0,0.0
10031,1,31,[ 89 185  82 181 195],666,2,116,3.625,0.0,0.0
10032,1,32,[211  88 228 117 234],406,3,119,3.606060606060606,0.0,0.0
10033,1,33,[180 118 211  11  64],308,4,123,3.6176470588235294,0.0,0.0
10034,1,34,[300 333 483 127 187],91,5,128,3.657142857142857,20.0,20.0
10035,1,35,[515 322  22 427 194],234,4,132,3.6666666666666665,0.0,0.0
10036,1,36,[211 385 603  96 302],666,3,135,3.6486486486486487,20.0,0.0
10037,1,37,[ 12 187 215 200  96],311,5,140,3.6842105263157894,20.0,0.0
10038,1,38,[483 273 515 180  98],234,3,143,3.6666666666666665,20.0,20.0
10039,1,39,[483  98  12 300  11],334,4,147,3.675,40.0,20.0
10040,1,40,[748 423   8 197 185],881,3,150,3.658536585365854,0.0,0.0
10041,1,41,[135 403 257  89  95],92,3,153,3.642857142857143,0.0,0.0
10042,1,42,[174  28 195  11 265],308,3,156,3.627906976744186,0.0,20.0
10043,1,43,[ 12 546 182 238   8],308,4,160,3.6363636363636362,20.0,0.0
10044,1,44,[185 423 515  22  50],59,5,165,3.6666666666666665,0.0,20.0
10045,1,45,[185 423 515  22  50],452,5,170,3.6956521739130435,0.0,20.0
10046,1,46,[742 191 318 289 323],378,4,174,3.702127659574468,20.0,0.0
10047,1,47,[427 211 515 423 153],87,4,178,3.7083333333333335,0.0,0.0
10048,1,48,[ 79  12 200 288 182],666,3,181,3.693877551020408,20.0,0.0
10049,1,49,[ 98  11 286 568 194],378,4,185,3.7,0.0,20.0
10050,1,50,[403 172 515 508 655],833,1,186,3.6470588235294117,0.0,0.0
10051,1,51,[405 196  25 144 180],194,1,187,3.5961538461538463,0.0,0.0
10052,1,52,[200  12 508  50 100],833,4,191,3.6037735849056602,20.0,40.0
10053,1,53,[  7 276 238  22 357],184,3,194,3.5925925925925926,20.0,0.0
10054,1,54,[275 286  50  82  97],537,2,196,3.5636363636363635,0.0,20.0
10055,1,55,[237 318 282 257 174],144,5,201,3.5892857142857144,20.0,20.0
10056,1,56,[172 111  12 176 568],537,0,201,3.526315789473684,20.0,0.0
10057,1,57,[276 508  56 237 200],334,4,205,3.5344827586206895,0.0,0.0
10058,1,58,[172 245 313   7 197],653,2,207,3.5084745762711864,0.0,0.0
10059,1,59,[276 603 237 200  56],13,4,211,3.5166666666666666,20.0,0.0
10060,1,60,[  1 125 161  71 191],194,4,215,3.5245901639344264,0.0,0.0
10061,1,61,[276  98  56 237 282],374,5,220,3.5483870967741935,0.0,20.0
10062,1,62,[180   9  98 183 185],7,5,225,3.5714285714285716,0.0,20.0
10063,1,63,[ 69 357  15 210 546],653,3,228,3.5625,20.0,0.0
10064,1,64,[276  98  56 237 282],194,2,230,3.5384615384615383,0.0,20.0
10065,1,65,[294   8 276   1 179],13,2,232,3.515151515151515,0.0,0.0
10066,1,66,[191 313  89 187 100],234,4,236,3.5223880597014925,0.0,20.0
10067,1,67,[515 197  96 333 655],537,2,238,3.5,0.0,0.0
10068,1,68,[151 228 546 191 333],64,2,240,3.4782608695652173,0.0,0.0
10069,1,69,[211 194  56   9 427],194,5,245,3.5,0.0,0.0
10070,1,70,[211 194  56   9 427],6,5,250,3.5211267605633805,0.0,0.0
10071,1,71,[211 194  56   9 427],326,3,253,3.513888888888889,0.0,0.0
10072,1,72,[211 153 427 100 174],379,5,258,3.5342465753424657,0.0,40.0
10073,1,73,[211 153 427 100 174],339,5,263,3.554054054054054,0.0,40.0
10074,1,74,[211 153 427 100 174],85,2,265,3.533333333333333,0.0,40.0
10075,1,75,[483 182 357 174 210],537,3,268,3.526315789473684,40.0,20.0
10076,1,76,[483 202  98 357 185],406,4,272,3.5324675324675323,40.0,20.0
10077,1,77,[ 22 588   1 161 496],200,5,277,3.551282051282051,0.0,0.0
10078,1,78,[318 182 187 357  98],6,5,282,3.569620253164557,40.0,20.0
10079,1,79,[318 182 187 357  98],91,5,287,3.5875,40.0,20.0
10080,1,80,[318 182 187 357  98],7,5,292,3.6049382716049383,40.0,20.0
10081,1,81,[204 546 118 197 100],804,4,296,3.6097560975609757,0.0,20.0
10082,1,82,[318 182 187 357  98],804,5,301,3.6265060240963853,40.0,20.0
10083,1,83,[318 182 187 357  98],184,5,306,3.642857142857143,40.0,20.0
10084,1,84,[318 182 187 357  98],90,4,310,3.6470588235294117,40.0,20.0
10085,1,85,[318 435 187 357  98],90,5,315,3.6627906976744184,40.0,20.0
10086,1,86,[318 435 187 357  98],6,5,320,3.67816091954023,40.0,20.0
10087,1,87,[144 483 237 121   9],343,4,324,3.6818181818181817,20.0,0.0
10088,1,88,[483  98  70 202 210],804,5,329,3.696629213483146,20.0,20.0
10089,1,89,[ 97 173 300 121 258],537,2,331,3.6777777777777776,0.0,0.0
10090,1,90,[202 403  70 144  50],308,4,335,3.681318681318681,0.0,20.0
10091,1,91,[144 172 117 322 196],749,5,340,3.6956521739130435,0.0,0.0
10092,1,92,[ 28 185 423 132 288],666,2,342,3.6774193548387095,0.0,0.0
10093,1,93,[357 125  28 508 176],406,3,345,3.6702127659574466,20.0,0.0
10094,1,94,[187 357 313 186  98],533,3,348,3.663157894736842,20.0,20.0
10095,1,95,[435 191 187 132 185],6,5,353,3.6770833333333335,0.0,0.0
10096,1,96,[238 143 194 204 215],840,4,357,3.6804123711340204,0.0,0.0
10097,1,97,[568 302 191 151 183],537,2,359,3.663265306122449,0.0,0.0
10098,1,98,[ 96 185 403 655 153],102,0,359,3.6262626262626263,0.0,0.0
10099,1,99,[237 385 181 275  64],64,5,364,3.64,0.0,0.0
10100,1,100,[135 187 173 435 313],234,3,367,3.633663366336634,0.0,0.0
10101,1,101,[ 98   8 132 211 143],60,3,370,3.627450980392157,0.0,20.0
10102,1,102,[117  98 174 111 172],271,4,374,3.6310679611650487,0.0,40.0
10103,1,103,[597 204  64  11 546],653,3,377,3.625,0.0,0.0
10104,1,104,[ 70  89  97 118 483],13,4,381,3.6285714285714286,20.0,0.0
10105,1,105,[135 588 132  98 191],882,5,386,3.641509433962264,0.0,20.0
10106,1,106,[173 186   1 118  25],295,4,390,3.6448598130841123,0.0,0.0
10107,1,107,[135 588 132  98 191],815,4,394,3.6481481481481484,0.0,20.0
10108,1,108,[195 496 181  82  88],42,5,399,3.6605504587155964,0.0,0.0
10109,1,109,[423 471  15 174 483],95,4,403,3.6636363636363636,20.0,20.0
10110,1,110,[333 588 215 121 235],313,4,407,3.6666666666666665,0.0,0.0
10111,1,111,[333 234 301 294 302],666,2,409,3.6517857142857144,0.0,0.0
10112,1,112,[ 69 216 276 357  50],537,3,412,3.646017699115044,20.0,20.0
10113,1,113,[194 238 118  71   1],82,3,415,3.6403508771929824,0.0,0.0
10114,1,114,[603 191 289 496 245],10,5,420,3.652173913043478,20.0,0.0
10115,1,115,[385 568 179  89 127],387,3,423,3.646551724137931,0.0,20.0
10116,1,116,[ 96 423  89 197  11],804,4,427,3.6495726495726495,0.0,0.0
10117,1,117,[121 168 508 135 483],474,3,430,3.6440677966101696,20.0,0.0
10118,1,118,[496  28 435 234 179],312,5,435,3.6554621848739495,0.0,0.0
10119,1,119,[179 300 191 151  97],537,2,437,3.6416666666666666,0.0,0.0
10120,1,120,[  1 143 515 180  88],234,1,438,3.6198347107438016,0.0,0.0
10121,1,121,[471  96  98  89  82],454,2,440,3.6065573770491803,0.0,20.0
10122,1,122,[191 603 289 496 245],90,3,443,3.6016260162601625,20.0,0.0
10123,1,123,[313 132 211 191 603],59,5,448,3.6129032258064515,20.0,0.0
10124,1,124,[313 132 211 191 603],90,5,453,3.624,20.0,0.0
10125,1,125,[185 276 173  69 508],643,4,457,3.626984126984127,0.0,0.0
10126,1,126,[172 237  82  79 175],234,0,457,3.5984251968503935,0.0,0.0
10127,1,127,[100 286 197  79 265],13,3,460,3.59375,0.0,20.0
10128,1,128,[132  25 318 288   7],666,3,463,3.5891472868217056,20.0,0.0
10129,1,129,[313 257 135 210 234],378,4,467,3.5923076923076924,0.0,0.0
10130,1,130,[144 435  64 235 515],328,4,471,3.595419847328244,0.0,0.0
10131,1,131,[127 111 289 187 161],524,5,476,3.606060606060606,0.0,20.0
10132,1,132,[135 289  11  79 172],328,3,479,3.601503759398496,0.0,0.0
10133,1,133,[  8 202 323 258 172],13,4,483,3.6044776119402986,0.0,0.0
10134,1,134,[182  97 515 127  82],339,5,488,3.6148148148148147,0.0,20.0
10135,1,135,[187 496  56 237 234],59,4,492,3.6176470588235294,0.0,0.0
10136,1,136,[222  95 385 186 300],843,0,492,3.591240875912409,0.0,0.0
10137,1,137,[323  11 176 172  89],13,2,494,3.579710144927536,0.0,0.0
10138,1,138,[ 12 588 182 185 234],406,5,499,3.5899280575539567,20.0,0.0
10139,1,139,[118 194 289  56  12],788,3,502,3.585714285714286,20.0,0.0
10140,1,140,[210  69 197 483 318],184,4,506,3.5886524822695036,40.0,0.0
10141,1,141,[185 302 187 210  12],13,3,509,3.584507042253521,20.0,0.0
10142,1,142,[238 210 423 187 302],334,4,513,3.5874125874125875,0.0,0.0
10143,1,143,[187 403 286 127 655],881,3,516,3.5833333333333335,0.0,20.0
10144,1,144,[216 210  82  69 237],13,2,518,3.5724137931034483,0.0,0.0
10145,1,145,[302 282 183 200 333],145,4,522,3.5753424657534247,0.0,0.0
10146,1,146,[496 588 132 301 211],234,2,524,3.564625850340136,0.0,0.0
10147,1,147,[121 132 174  50 237],7,5,529,3.574324324324324,0.0,40.0
10148,1,148,[  8 427 197 202 318],234,4,533,3.577181208053691,20.0,0.0
10149,1,149,[186 655 282 127 568],95,5,538,3.5866666666666664,0.0,20.0
10150,1,150,[496 313 258 318 132],271,4,542,3.589403973509934,20.0,0.0
10151,1,151,[121 275  69 185 357],308,3,545,3.585526315789474,20.0,0.0
10152,1,152,[187 568 182 176 127],537,3,548,3.581699346405229,0.0,20.0
10153,1,153,[294 508   8   1 318],533,4,552,3.5844155844155843,20.0,0.0
10154,1,154,[515 234 210 235 357],643,5,557,3.5935483870967744,20.0,0.0
10155,1,155,[151 237 427 268 204],234,1,558,3.576923076923077,0.0,0.0
10156,1,156,[196 515  97 121 216],233,5,563,3.5859872611464967,0.0,0.0
10157,1,157,[215  50 435 161 179],308,3,566,3.5822784810126582,0.0,20.0
10158,1,158,[194 182  12 234  50],398,4,570,3.5849056603773586,20.0,20.0
10159,1,159,[210 508 172 216 275],780,4,574,3.5875,0.0,0.0
10160,1,160,[ 82 100 269 302   9],883,3,577,3.5838509316770186,0.0,20.0
10161,1,161,[181  25 603 276  82],13,3,580,3.580246913580247,20.0,0.0
10162,1,162,[204 191 483 496  15],537,3,583,3.576687116564417,20.0,0.0
10163,1,163,[187 603 313 191 132],650,4,587,3.5792682926829267,20.0,0.0
10164,1,164,[603 313 191 132 318],90,5,592,3.587878787878788,40.0,0.0
10165,1,165,[196  79  88  69 496],815,5,597,3.5963855421686746,0.0,0.0
10166,1,166,[121  11  70 423 100],666,3,600,3.592814371257485,0.0,20.0
10167,1,167,[181 179  22 143 197],207,3,603,3.5892857142857144,0.0,0.0
10168,1,168,[204  12 268 202 269],13,4,607,3.591715976331361,20.0,0.0
10169,1,169,[273 173 151 187 180],666,3,610,3.588235294117647,0.0,0.0
10170,1,170,[597 403 568 294 180],788,1,611,3.573099415204678,0.0,0.0
10171,1,171,[ 70 588 435 172 286],537,1,612,3.558139534883721,0.0,0.0
10172,1,172,[597 475 195 405  56],833,2,614,3.5491329479768785,0.0,0.0
10173,1,173,[191 313 318 603 496],334,4,618,3.5517241379310347,40.0,0.0
10174,1,174,[127 302 238 181 483],334,5,623,3.56,20.0,20.0
10175,1,175,[125 588 282 176  96],378,4,627,3.5625,0.0,0.0
10176,1,176,[132 318 603 191 313],474,5,632,3.5706214689265536,40.0,0.0
10177,1,177,[132 318 603 191 313],537,4,636,3.5730337078651684,40.0,0.0
10178,1,178,[238 323  95 483 176],59,4,640,3.5754189944134076,20.0,0.0
10179,1,179,[ 22 546 187  70  71],533,4,644,3.577777777777778,0.0,0.0
10180,1,180,[275 471 597  96 179],7,4,648,3.5801104972375692,0.0,0.0
10181,1,181,[427 135 168 143  79],194,2,650,3.5714285714285716,0.0,0.0
10182,1,182,[423  95 475 300 185],479,2,652,3.5628415300546448,0.0,0.0
10183,1,183,[313 318 191 603  98],59,5,657,3.5706521739130435,40.0,20.0
10184,1,184,[313 318 191 603  98],334,5,662,3.5783783783783782,40.0,20.0
10185,1,185,[313 318 191 603  98],815,4,666,3.5806451612903225,40.0,20.0
10186,1,186,[313 318 191  98 187],59,5,671,3.588235294117647,20.0,20.0
10187,1,187,[313 318 191  98 187],144,5,676,3.595744680851064,20.0,20.0
10188,1,188,[216 515 186 144  97],650,3,679,3.5925925925925926,0.0,0.0
10189,1,189,[318 313 191  98 187],308,3,682,3.5894736842105264,20.0,20.0
10190,1,190,[318 191 187 603 313],233,5,687,3.5968586387434556,40.0,0.0
10191,1,191,[172  56 117  50  97],738,4,691,3.5989583333333335,0.0,20.0
10192,1,192,[ 97 173 161 210 194],60,4,695,3.6010362694300517,0.0,0.0
10193,1,193,[185 161 475 228 289],334,3,698,3.597938144329897,0.0,0.0
10194,1,194,[191 318 187 603 313],90,5,703,3.605128205128205,40.0,0.0
10195,1,195,[186 202 313 471  88],308,3,706,3.6020408163265305,0.0,0.0
10196,1,196,[328 742   8 180 483],95,3,709,3.598984771573604,20.0,0.0
10197,1,197,[121 568 187 405 318],59,4,713,3.601010101010101,20.0,0.0
10198,1,198,[405  79  64 143 127],7,3,716,3.5979899497487438,0.0,20.0
10199,1,199,[186 181 179  56 185],311,2,718,3.59,0.0,0.0
10200,1,200,[333 385 313   9 275],328,3,721,3.5870646766169156,0.0,0.0
10201,1,201,[200 222 357 289 328],13,0,721,3.5693069306930694,20.0,0.0
10202,1,202,[  9 215  12 117  50],406,4,725,3.5714285714285716,20.0,20.0
10203,1,203,[215 172 237 678 202],7,3,728,3.5686274509803924,0.0,0.0
10204,1,204,[228 216 181 328   7],804,5,733,3.575609756097561,0.0,0.0
10205,1,205,[191 318 187 603 302],334,5,738,3.5825242718446604,40.0,0.0
10206,1,206,[191 318 187 603 302],13,3,741,3.579710144927536,40.0,0.0
10207,1,207,[235 322 174 588 483],537,1,742,3.5673076923076925,20.0,20.0
10208,1,208,[273 568 181  70 168],158,3,745,3.5645933014354068,0.0,0.0
10209,1,209,[216  95 222  56 202],378,3,748,3.5619047619047617,0.0,0.0
10210,1,210,[204 180 357 210   7],774,1,749,3.5497630331753554,20.0,0.0
10211,1,211,[211 385 182 215 234],64,5,754,3.556603773584906,0.0,0.0
10212,1,212,[135 200 357 121 194],890,4,758,3.5586854460093895,20.0,0.0
10213,1,213,[172 182 210 385 216],234,0,758,3.542056074766355,0.0,0.0
10214,1,214,[174 588  96 197 423],479,3,761,3.5395348837209304,0.0,20.0
10215,1,215,[187 318 191 603 302],474,5,766,3.5462962962962963,40.0,0.0
10216,1,216,[118 202 678 245 483],454,1,767,3.5345622119815667,20.0,0.0
10217,1,217,[286  11  71 276 100],82,5,772,3.541284403669725,0.0,20.0
10218,1,218,[187 318 191 603 302],13,3,775,3.538812785388128,40.0,0.0
10219,1,219,[187 603 302 318 191],474,5,780,3.5454545454545454,40.0,0.0
10220,1,220,[187 603 302 318 191],458,5,785,3.5520361990950224,40.0,0.0
10221,1,221,[195  70  64  11 302],537,2,787,3.545045045045045,0.0,0.0
10222,1,222,[187 603 302 318 191],458,5,792,3.5515695067264574,40.0,0.0
10223,1,223,[200 153 222 475 403],334,5,797,3.5580357142857144,0.0,0.0
10224,1,224,[187 603 302 318 191],458,5,802,3.5644444444444443,40.0,0.0
10225,1,225,[187 603 302 318 191],334,5,807,3.5707964601769913,40.0,0.0
10226,1,226,[ 88 313 125 180 385],92,4,811,3.5726872246696035,0.0,0.0
10227,1,227,[187 603 302 318 191],90,5,816,3.5789473684210527,40.0,0.0
10228,1,228,[204 427 286  89 117],454,2,818,3.572052401746725,0.0,0.0
10229,1,229,[100 195 196 258 238],339,3,821,3.5695652173913044,0.0,20.0
10230,1,230,[  7 289 197 515 182],524,4,825,3.5714285714285716,0.0,0.0
10231,1,231,[135 211 168 265 172],897,2,827,3.564655172413793,0.0,0.0
10232,1,232,[ 79 176 568 121 197],25,4,831,3.5665236051502145,0.0,0.0
10233,1,233,[187 603 302 318 191],458,5,836,3.572649572649573,40.0,0.0
10234,1,234,[187 603 302 318 191],524,4,840,3.574468085106383,40.0,0.0
10235,1,235,[ 69 172 168  64 176],738,4,844,3.5762711864406778,0.0,0.0
10236,1,236,[117 471  12 328   1],548,5,849,3.5822784810126582,20.0,0.0
10237,1,237,[187 302 318 191 603],524,4,853,3.5840336134453783,40.0,0.0
10238,1,238,[187 302 318 191 211],666,5,858,3.589958158995816,20.0,0.0
10239,1,239,[322 117 301 286 172],524,3,861,3.5875,0.0,0.0
10240,1,240,[ 15 168  95 117 357],194,3,864,3.5850622406639006,20.0,0.0
10241,1,241,[268 276 181 273  25],145,3,867,3.5826446280991737,0.0,0.0
10242,1,242,[273 222 100 121 483],666,2,869,3.5761316872427984,20.0,20.0
10243,1,243,[237 403  98 200 135],234,3,872,3.5737704918032787,0.0,20.0
10244,1,244,[ 71  50 151 183  15],650,2,874,3.5673469387755103,0.0,20.0
10245,1,245,[187 302 318 191 211],524,5,879,3.573170731707317,20.0,0.0
10246,1,246,[238 475 294 181 191],474,4,883,3.574898785425101,0.0,0.0
10247,1,247,[ 96 191  64 183 333],64,4,887,3.5766129032258065,0.0,0.0
10248,1,248,[111 118 273 183  88],749,3,890,3.57429718875502,0.0,0.0
10249,1,249,[405 121 597 215 322],346,1,891,3.564,0.0,0.0
10250,1,250,[238 186  97 286 483],406,2,893,3.557768924302789,20.0,0.0
10251,1,251,[182 185 187 471 183],653,1,894,3.5476190476190474,0.0,0.0
10252,1,252,[187 302 191 318 211],474,5,899,3.5533596837944663,20.0,0.0
10253,1,253,[161 273  89   7 322],308,2,901,3.547244094488189,0.0,0.0
10254,1,254,[187 302 191 318 211],343,5,906,3.552941176470588,20.0,0.0
10255,1,255,[125  69 132 143   4],194,2,908,3.546875,0.0,0.0
10256,1,256,[  4 187 302 191 318],543,4,912,3.5486381322957197,20.0,0.0
10257,1,257,[ 12 194 288 168 202],643,4,916,3.550387596899225,20.0,0.0
10258,1,258,[127 385 357 125 234],398,3,919,3.548262548262548,20.0,20.0
10259,1,259,[271 427  89  11 228],328,1,920,3.5384615384615383,0.0,0.0
10260,1,260,[222 655   7 286 186],328,4,924,3.5402298850574714,0.0,0.0
10261,1,261,[257  95 235 135 318],378,4,928,3.5419847328244276,20.0,0.0
10262,1,262,[153 144 257 265 276],343,3,931,3.5399239543726235,0.0,0.0
10263,1,263,[  4 187 302 191 211],537,4,935,3.5416666666666665,0.0,0.0
10264,1,264,[187 302 191 211 100],90,5,940,3.547169811320755,0.0,20.0
10265,1,265,[151 257 172  71  28],290,4,944,3.5488721804511276,0.0,0.0
10266,1,266,[282 151 222  88 423],653,0,944,3.5355805243445695,0.0,0.0
10267,1,267,[318 135   9 237 245],328,4,948,3.537313432835821,20.0,0.0
10268,1,268,[196 187 655 496 173],311,5,953,3.54275092936803,0.0,0.0
10269,1,269,[228  28 234 121 153],7,5,958,3.5481481481481483,0.0,0.0
10270,1,270,[187 302 191 211 100],271,5,963,3.5535055350553506,0.0,20.0
10271,1,271,[234 151 269  96 273],883,4,967,3.5551470588235294,0.0,0.0
10272,1,272,[258 228 313 182 265],653,3,970,3.553113553113553,0.0,0.0
10273,1,273,[483 216 100 183  89],749,4,974,3.5547445255474455,20.0,20.0
10274,1,274,[121 265   4 194 211],650,3,977,3.5527272727272727,0.0,0.0
10275,1,275,[187  28 216 300 127],234,3,980,3.550724637681159,0.0,20.0
10276,1,276,[174 403  97 483 210],7,5,985,3.555956678700361,20.0,20.0
10277,1,277,[204  56 211 215 588],406,4,989,3.5575539568345325,0.0,0.0
10278,1,278,[228 176 288   7 435],455,3,992,3.5555555555555554,0.0,0.0
10279,1,279,[187 302 191 211 127],615,5,997,3.5607142857142855,0.0,20.0
10280,1,280,[187 302 211 191 127],271,5,1002,3.565836298932384,0.0,20.0
10281,1,281,[187 302 211 191 127],207,5,1007,3.5709219858156027,0.0,20.0
10282,1,282,[187 302 211 191 127],271,5,1012,3.5759717314487633,0.0,20.0
10283,1,283,[187 302 211 191 127],343,5,1017,3.5809859154929575,0.0,20.0
10284,1,284,[ 98  70  15   7 180],882,4,1021,3.5824561403508772,0.0,20.0
10285,1,285,[475 742 300 403 176],334,2,1023,3.576923076923077,0.0,0.0
10286,1,286,[117 176 135 182 245],328,3,1026,3.5749128919860627,0.0,0.0
10287,1,287,[204 568 127 168 215],774,1,1027,3.5659722222222223,0.0,20.0
10288,1,288,[185 271 173 210  28],537,2,1029,3.5605536332179932,0.0,0.0
10289,1,289,[197  12 423 603 211],474,5,1034,3.56551724137931,40.0,0.0
10290,1,290,[265 235  82 483 222],804,5,1039,3.570446735395189,20.0,0.0
10291,1,291,[187 302 211 191 127],474,5,1044,3.5753424657534247,0.0,20.0
10292,1,292,[546 144 216  71  95],804,3,1047,3.573378839590444,0.0,0.0
10293,1,293,[ 12 182 191 268 294],7,3,1050,3.5714285714285716,20.0,0.0
10294,1,294,[228 195  96 100 185],881,3,1053,3.5694915254237287,0.0,20.0
10295,1,295,[603   7 302  22  89],145,5,1058,3.574324324324324,20.0,0.0
10296,1,296,[483  96  56 187  11],234,2,1060,3.569023569023569,20.0,0.0
10297,1,297,[515 228  12 496  64],537,2,1062,3.563758389261745,20.0,0.0
10298,1,298,[  8 655 289  50  70],940,3,1065,3.5618729096989967,0.0,20.0
10299,1,299,[ 25 357 153 125 168],648,2,1067,3.5566666666666666,20.0,0.0
10300,1,300,[216   7 196 333 328],334,3,1070,3.5548172757475083,0.0,0.0
10301,1,301,[275  22  97 180 588],95,2,1072,3.5496688741721854,0.0,0.0
10302,1,302,[187 302 211 191 127],90,5,1077,3.5544554455445545,0.0,20.0
10303,1,303,[172 181 483  98 173],650,5,1082,3.5592105263157894,20.0,20.0
10304,1,304,[568 403 182 318  22],184,2,1084,3.554098360655738,20.0,0.0
10305,1,305,[508 475 258 678 183],13,2,1086,3.549019607843137,0.0,0.0
10306,1,306,[191  88 597   8 435],378,4,1090,3.550488599348534,0.0,0.0
10307,1,307,[294  79   8 655 405],474,4,1094,3.551948051948052,0.0,0.0
10308,1,308,[187 302 211 191 127],343,5,1099,3.55663430420712,0.0,20.0
10309,1,309,[187 302 211 191 127],343,5,1104,3.5612903225806454,0.0,20.0
10310,1,310,[ 97 269 235 194 118],13,3,1107,3.559485530546624,0.0,0.0
10311,1,311,[195 197 286  50 202],881,2,1109,3.5544871794871793,0.0,20.0
10312,1,312,[187 302 211 191 127],537,5,1114,3.559105431309904,0.0,20.0
10313,1,313,[183 195 187 435 204],350,4,1118,3.5605095541401273,0.0,0.0
10314,1,314,[168  64 172 175 423],892,5,1123,3.5650793650793653,0.0,0.0
10315,1,315,[271 211 222  88  82],479,4,1127,3.5664556962025316,0.0,0.0
10316,1,316,[ 71 215 216  95 318],295,5,1132,3.5709779179810726,20.0,0.0
10317,1,317,[187 302 211 191 127],271,5,1137,3.5754716981132075,0.0,20.0
10318,1,318,[187 302 211 191 127],339,5,1142,3.579937304075235,0.0,20.0
10319,1,319,[ 70  50 210  89 257],653,3,1145,3.578125,0.0,20.0
10320,1,320,[132 176  95 357 100],537,2,1147,3.573208722741433,20.0,20.0
10321,1,321,[216  71 174 603 235],524,2,1149,3.5683229813664594,20.0,20.0
10322,1,322,[181 435 405  82 180],328,5,1154,3.5727554179566563,0.0,0.0
10323,1,323,[187 302 211 191 127],207,5,1159,3.5771604938271606,0.0,20.0
10324,1,324,[294 200 546  11   4],13,1,1160,3.5692307692307694,0.0,0.0
10325,1,325,[215 318  71   1 180],533,4,1164,3.5705521472392636,20.0,0.0
10326,1,326,[ 69 185 204 423 144],328,4,1168,3.5718654434250765,0.0,0.0
10327,1,327,[187 302 211 191 127],207,5,1173,3.576219512195122,0.0,20.0
10328,1,328,[288 515  12 282 195],474,4,1177,3.5775075987841944,20.0,0.0
10329,1,329,[313 117   8 515 173],334,4,1181,3.5787878787878786,0.0,0.0
10330,1,330,[210 216 135  70 117],840,2,1183,3.5740181268882174,0.0,0.0
10331,1,331,[187 302 211 191 127],207,5,1188,3.5783132530120483,0.0,20.0
10332,1,332,[187 302 211 191 127],833,3,1191,3.5765765765765765,0.0,20.0
10333,1,333,[187 191 127 302 211],524,5,1196,3.5808383233532934,0.0,20.0
10334,1,334,[187 127 191 302 211],615,5,1201,3.5850746268656715,0.0,20.0
10335,1,335,[ 12  70  95  64 100],194,3,1204,3.5833333333333335,20.0,20.0
10336,1,336,[427  96  97 132 211],313,5,1209,3.5875370919881306,0.0,0.0
10337,1,337,[187 127 191 302 211],833,3,1212,3.5857988165680474,0.0,20.0
10338,1,338,[187 127 191 302  98],271,5,1217,3.589970501474926,0.0,40.0
10339,1,339,[187 127 191 302  98],13,4,1221,3.5911764705882354,0.0,40.0
10340,1,340,[187 127 191 302  98],537,4,1225,3.592375366568915,0.0,40.0
10341,1,341,[187 127 191 302 318],474,5,1230,3.5964912280701755,20.0,20.0
10342,1,342,[  1 121  89 183 234],881,4,1234,3.597667638483965,0.0,0.0
10343,1,343,[187 127 191 302 318],666,5,1239,3.6017441860465116,20.0,20.0
10344,1,344,[385 322  96 245 275],328,3,1242,3.6,0.0,0.0
10345,1,345,[187 127 191 302 318],474,5,1247,3.6040462427745665,20.0,20.0
10346,1,346,[135 228  12 153 216],334,4,1251,3.605187319884726,20.0,0.0
10347,1,347,[202 282 161  95 195],881,4,1255,3.6063218390804597,0.0,0.0
10348,1,348,[496  89 238  82 237],454,3,1258,3.6045845272206303,0.0,0.0
10349,1,349,[143 597  15  97 174],95,4,1262,3.605714285714286,0.0,20.0
10350,1,350,[202  64 173 294 742],188,3,1265,3.6039886039886038,0.0,0.0
10351,1,351,[187 127 191 302 318],666,5,1270,3.6079545454545454,20.0,20.0
10352,1,352,[187 127 191 302 318],474,5,1275,3.6118980169971673,20.0,20.0
10353,1,353,[ 25 748 423 118 588],804,4,1279,3.6129943502824857,0.0,0.0
10354,1,354,[117 143 568 216  22],311,4,1283,3.6140845070422536,0.0,0.0
10355,1,355,[187 127 191 302 318],537,5,1288,3.6179775280898876,20.0,20.0
10356,1,356,[186  69 132 182 258],788,3,1291,3.61624649859944,0.0,0.0
10357,1,357,[357 211 132 186 196],650,5,1296,3.6201117318435756,20.0,0.0
10358,1,358,[ 98 483  89 194 403],328,3,1299,3.618384401114206,20.0,20.0
10359,1,359,[161 222  12 742 118],524,2,1301,3.613888888888889,20.0,0.0
10360,1,360,[187 127 191 302 318],271,5,1306,3.6177285318559558,20.0,20.0
10361,1,361,[187 127 191 302 318],207,5,1311,3.6215469613259668,20.0,20.0
10362,1,362,[ 64 228 423 135 182],87,4,1315,3.6225895316804406,0.0,0.0
10363,1,363,[132 515 200 197 318],666,5,1320,3.6263736263736264,20.0,0.0
10364,1,364,[118 271 471 195 121],92,3,1323,3.6246575342465754,0.0,0.0
10365,1,365,[187 127 191 302 318],474,5,1328,3.628415300546448,20.0,20.0
10366,1,366,[187 127 191 302 318],343,5,1333,3.6321525885558583,20.0,20.0
10367,1,367,[181 200  28 118  70],271,4,1337,3.6331521739130435,0.0,0.0
10368,1,368,[318  69 300  98 118],7,4,1341,3.6341463414634148,20.0,20.0
10369,1,369,[286 211 483 496 100],90,5,1346,3.637837837837838,20.0,20.0
10370,1,370,[ 50 187 194 132 588],312,5,1351,3.641509433962264,0.0,20.0
10371,1,371,[187 127 191 302 318],524,5,1356,3.6451612903225805,20.0,20.0
10372,1,372,[ 64 118 117 238 313],308,2,1358,3.640750670241287,0.0,0.0
10373,1,373,[180 258 427 288  95],234,1,1359,3.6336898395721926,0.0,0.0
10374,1,374,[187 127 191 302 318],207,5,1364,3.6373333333333333,20.0,20.0
10375,1,375,[288  82 215  96 496],378,3,1367,3.6356382978723403,0.0,0.0
10376,1,376,[ 28 403 194 228   7],64,5,1372,3.6392572944297084,0.0,0.0
10377,1,377,[234  11 302 403  79],339,4,1376,3.64021164021164,0.0,0.0
10378,1,378,[357 176 182 597 181],833,2,1378,3.6358839050131926,20.0,0.0
10379,1,379,[ 50 294 328 322   7],113,3,1381,3.6342105263157896,0.0,20.0
10380,1,380,[180  15 301 179 135],378,1,1382,3.627296587926509,0.0,0.0
10381,1,381,[121  28 168  82 143],339,4,1386,3.6282722513089007,0.0,0.0
10382,1,382,[127 174  15 197 655],406,4,1390,3.629242819843342,0.0,40.0
10383,1,383,[228  79 357 289  25],82,1,1391,3.6223958333333335,20.0,0.0
10384,1,384,[435 168 194  69 185],643,4,1395,3.6233766233766236,0.0,0.0
10385,1,385,[187 127 191 302 318],90,5,1400,3.626943005181347,20.0,20.0
10386,1,386,[187 127 191 302 318],474,5,1405,3.6304909560723515,20.0,20.0
10387,1,387,[187 127 191 302 318],666,5,1410,3.634020618556701,20.0,20.0
10388,1,388,[ 98 132 161  28 200],339,4,1414,3.634961439588689,0.0,20.0
10389,1,389,[187 127 191 302 318],343,5,1419,3.6384615384615384,20.0,20.0
10390,1,390,[180  56 300 269 313],90,4,1423,3.639386189258312,0.0,0.0
10391,1,391,[135 301 238 597 258],378,1,1424,3.63265306122449,0.0,0.0
10392,1,392,[ 88 144  79  11  50],454,4,1428,3.633587786259542,0.0,20.0
10393,1,393,[187 127 191 302 318],605,5,1433,3.6370558375634516,20.0,20.0
10394,1,394,[187 127 191 302 318],13,3,1436,3.6354430379746834,20.0,20.0
10395,1,395,[187 127 302 191 515],207,5,1441,3.638888888888889,0.0,20.0
10396,1,396,[118 289 125 294 132],92,1,1442,3.632241813602015,0.0,0.0
10397,1,397,[ 97 202 127 186 496],271,5,1447,3.635678391959799,0.0,20.0
10398,1,398,[179 286 172  69 143],60,4,1451,3.636591478696742,0.0,0.0
10399,1,399,[100 185   7 427 204],650,4,1455,3.6375,0.0,20.0
10400,1,400,[187 127 302 191 515],537,5,1460,3.6408977556109727,0.0,20.0
10401,1,401,[135 200  95 678 323],13,2,1462,3.63681592039801,0.0,0.0
10402,1,402,[ 56 194 187 301 175],13,4,1466,3.6377171215880892,0.0,0.0
10403,1,403,[202 357 294 423  79],537,1,1467,3.631188118811881,20.0,0.0
10404,1,404,[245  15 143 194 508],378,4,1471,3.6320987654320986,0.0,0.0
10405,1,405,[187 127 302 191 515],334,5,1476,3.6354679802955663,0.0,20.0
10406,1,406,[ 28 100  79  97 237],406,2,1478,3.6314496314496316,0.0,20.0
10407,1,407,[515 180 234 235 435],406,4,1482,3.6323529411764706,0.0,0.0
10408,1,408,[144 174 568 515 403],308,3,1485,3.63080684596577,0.0,20.0
10409,1,409,[187 127 302 191 318],666,5,1490,3.6341463414634148,20.0,20.0
10410,1,410,[ 69 125 257 127 508],533,5,1495,3.6374695863746958,0.0,20.0
10411,1,411,[187 127 302 191 318],6,5,1500,3.6407766990291264,20.0,20.0
10412,1,412,[546 228 742 323 185],788,1,1501,3.6343825665859564,0.0,0.0
10413,1,413,[187 127 302 191 318],13,3,1504,3.632850241545894,20.0,20.0
10414,1,414,[ 50 144 228  98 276],447,5,1509,3.636144578313253,0.0,40.0
10415,1,415,[282 475 180 215 204],144,3,1512,3.6346153846153846,0.0,0.0
10416,1,416,[187 127 302 191 211],666,5,1517,3.6378896882494005,0.0,20.0
10417,1,417,[187 127 302 191 211],207,5,1522,3.6411483253588517,0.0,20.0
10418,1,418,[265 597 423 216 286],533,3,1525,3.639618138424821,0.0,0.0
10419,1,419,[435 180 194 357 222],533,3,1528,3.638095238095238,20.0,0.0
10420,1,420,[187 127 302 191 211],666,5,1533,3.6413301662707838,0.0,20.0
10421,1,421,[187 127 302 191 211],537,5,1538,3.6445497630331753,0.0,20.0
10422,1,422,[187 127 302 191 211],271,5,1543,3.647754137115839,0.0,20.0
10423,1,423,[ 98 185 143 475  82],537,2,1545,3.643867924528302,0.0,20.0
10424,1,424,[127 403 161 655 328],804,3,1548,3.642352941176471,0.0,20.0
10425,1,425,[100 174 288 597  12],13,3,1551,3.640845070422535,20.0,40.0
10426,1,426,[187 127 302 191 211],207,5,1556,3.6440281030444965,0.0,20.0
10427,1,427,[187 127 302 191 211],13,4,1560,3.6448598130841123,0.0,20.0
10428,1,428,[405 302  28 182  95],271,3,1563,3.6433566433566433,0.0,0.0
10429,1,429,[ 98 228 748  70  89],648,3,1566,3.641860465116279,0.0,20.0
10430,1,430,[187 127 302 211 191],6,5,1571,3.645011600928074,0.0,20.0
10431,1,431,[187 127 302 211 191],339,5,1576,3.6481481481481484,0.0,20.0
10432,1,432,[  1 234 172 546  97],145,3,1579,3.6466512702078524,0.0,0.0
10433,1,433,[187 127 302 211 191],343,5,1584,3.6497695852534564,0.0,20.0
10434,1,434,[161  15 257   4 210],653,2,1586,3.645977011494253,0.0,0.0
10435,1,435,[483  89 194 191 385],234,3,1589,3.6444954128440368,20.0,0.0
10436,1,436,[187 127 302 211 191],6,5,1594,3.6475972540045767,0.0,20.0
10437,1,437,[403 187 238 118 322],308,3,1597,3.646118721461187,0.0,0.0
10438,1,438,[187 127 302 211 191],271,5,1602,3.6492027334851938,0.0,20.0
10439,1,439,[204 294 265 276 210],346,3,1605,3.647727272727273,0.0,0.0
10440,1,440,[265 515  79 286 222],380,3,1608,3.6462585034013606,0.0,0.0
10441,1,441,[273 423 475 196 172],92,4,1612,3.6470588235294117,0.0,0.0
10442,1,442,[ 50 200 191  64 176],804,4,1616,3.6478555304740405,0.0,20.0
10443,1,443,[286 268 276   1 118],699,2,1618,3.644144144144144,0.0,0.0
10444,1,444,[286 748 172 275 257],360,4,1622,3.6449438202247193,0.0,0.0
10445,1,445,[ 98 403 215  56  82],64,4,1626,3.6457399103139014,0.0,20.0
10446,1,446,[215 132 405 121  22],653,2,1628,3.6420581655480984,0.0,0.0
10447,1,447,[ 95  56 237 471  79],271,3,1631,3.640625,0.0,0.0
10448,1,448,[  1 234  11  56 180],447,4,1635,3.6414253897550113,0.0,0.0
10449,1,449,[118 258   8 173 286],454,3,1638,3.64,0.0,0.0
10450,1,450,[187 127 302 211 191],343,5,1643,3.6430155210643016,0.0,20.0
10451,1,451,[174 143 216 176 125],406,2,1645,3.6393805309734515,0.0,20.0
10452,1,452,[385 286 222 168 183],488,4,1649,3.6401766004415013,0.0,0.0
10453,1,453,[187 127 302 211 191],343,5,1654,3.643171806167401,0.0,20.0
10454,1,454,[187 127 302 211 191],833,3,1657,3.6417582417582417,0.0,20.0
10455,1,455,[423 215  98 172 175],7,5,1662,3.6447368421052633,0.0,20.0
10456,1,456,[475 603  82 168 234],452,2,1664,3.641137855579869,20.0,0.0
10457,1,457,[ 79 238 483  70 127],95,4,1668,3.6419213973799125,20.0,20.0
10458,1,458,[187 127 302 191 211],339,5,1673,3.644880174291939,0.0,20.0
10459,1,459,[508 742  70 125 265],334,0,1673,3.6369565217391306,0.0,0.0
10460,1,460,[187 127 302 191 211],339,5,1678,3.6399132321041217,0.0,20.0
10461,1,461,[257 546 258 323 294],650,0,1678,3.632034632034632,0.0,0.0
10462,1,462,[187 127 302 191 211],6,5,1683,3.634989200863931,0.0,20.0
10463,1,463,[187 127 302 191 211],524,5,1688,3.6379310344827585,0.0,20.0
10464,1,464,[546 288 181 151 238],279,2,1690,3.6344086021505375,0.0,0.0
10465,1,465,[322   4  88 318 313],13,3,1693,3.633047210300429,20.0,0.0
10466,1,466,[ 12 185  96 197 237],60,5,1698,3.6359743040685224,20.0,0.0
10467,1,467,[127 185 172 216 176],479,4,1702,3.6367521367521367,0.0,20.0
10468,1,468,[301 200 151  98 385],666,3,1705,3.6353944562899785,0.0,20.0
10469,1,469,[187 127 302 191 211],524,5,1710,3.6382978723404253,0.0,20.0
10470,1,470,[151 186 200 238 179],7,5,1715,3.641188959660297,0.0,0.0
10471,1,471,[423 118 173 174   4],374,2,1717,3.63771186440678,0.0,20.0
10472,1,472,[568 210 508 197  96],207,3,1720,3.6363636363636362,0.0,0.0
10473,1,473,[180 135 185 168  82],452,3,1723,3.6350210970464136,0.0,0.0
10474,1,474,[ 11 200 276 197 427],537,3,1726,3.6336842105263156,0.0,0.0
10475,1,475,[197 127 151 117  28],308,2,1728,3.630252100840336,0.0,20.0
10476,1,476,[187 127 302 191 211],339,5,1733,3.6331236897274635,0.0,20.0
10477,1,477,[  9 185  64 143 357],60,4,1737,3.6338912133891212,20.0,0.0
10478,1,478,[187 127 302 191 211],666,5,1742,3.636743215031315,0.0,20.0
10479,1,479,[435 174 483 215 153],788,1,1743,3.63125,20.0,20.0
10480,1,480,[742 273 180 234 200],897,3,1746,3.62993762993763,0.0,0.0
10481,1,481,[187 127 302 191 211],833,3,1749,3.628630705394191,0.0,20.0
10482,1,482,[187 127 302 191   9],90,5,1754,3.631469979296066,0.0,20.0
10483,1,483,[187 127 302 191   9],343,5,1759,3.634297520661157,0.0,20.0
10484,1,484,[117 168  28  88 127],479,4,1763,3.6350515463917525,0.0,20.0
10485,1,485,[323 174 222 173   7],537,2,1765,3.6316872427983538,0.0,20.0
10486,1,486,[187 127 302 191   9],334,5,1770,3.6344969199178645,0.0,20.0
10487,1,487,[301 151 135  97 202],378,1,1771,3.6290983606557377,0.0,0.0
10488,1,488,[187 127 302 191   9],13,3,1774,3.627811860940695,0.0,20.0
10489,1,489,[187 127 302 191 211],615,5,1779,3.630612244897959,0.0,20.0
10490,1,490,[318 597  28 168 237],533,3,1782,3.629327902240326,20.0,0.0
10491,1,491,[182 265 357  70   4],194,3,1785,3.6280487804878048,20.0,0.0
10492,1,492,[435 172 174 302 273],378,5,1790,3.630831643002028,0.0,20.0
10493,1,493,[187 127 302 191 211],90,5,1795,3.633603238866397,0.0,20.0
10494,1,494,[ 98  82 172 132 588],308,3,1798,3.632323232323232,0.0,20.0
10495,1,495,[204 318 385 515 211],804,5,1803,3.6350806451612905,20.0,0.0
10496,1,496,[194  88  97  25 222],533,4,1807,3.6358148893360163,0.0,0.0
10497,1,497,[546  71 289 174 202],92,2,1809,3.6325301204819276,0.0,20.0
10498,1,498,[210  97  95   1 132],536,4,1813,3.6332665330661325,0.0,0.0
10499,1,499,[187 127 302 191 211],474,5,1818,3.636,0.0,20.0
10500,1,500,[ 28 144 135 333  69],343,4,1822,3.636726546906188,0.0,0.0
10501,1,501,[127 215   1 588 313],537,2,1824,3.633466135458167,0.0,20.0
10502,1,502,[111  56 302 144 333],13,4,1828,3.6341948310139167,0.0,0.0
10503,1,503,[187 127 302 191 211],615,5,1833,3.636904761904762,0.0,20.0
10504,1,504,[496 196 508 143  89],59,4,1837,3.6376237623762377,0.0,0.0
10505,1,505,[187 127 302 191 211],615,5,1842,3.6403162055335967,0.0,20.0
10506,1,506,[172 294 286 475 100],474,4,1846,3.641025641025641,0.0,20.0
10507,1,507,[423 161 603 186 185],13,4,1850,3.641732283464567,20.0,0.0
10508,1,508,[182 245  89 174  98],666,3,1853,3.6404715127701377,0.0,40.0
10509,1,509,[286 515  22 238 282],334,5,1858,3.6431372549019607,0.0,0.0
10510,1,510,[143 603 588 183 172],815,4,1862,3.643835616438356,20.0,0.0
10511,1,511,[ 70 191 215   9 196],311,5,1867,3.646484375,0.0,0.0
10512,1,512,[153 125 655  25 271],749,5,1872,3.6491228070175437,0.0,0.0
10513,1,513,[655 127 313 183 515],207,4,1876,3.649805447470817,0.0,20.0
10514,1,514,[144  88 655  50 678],339,3,1879,3.6485436893203884,0.0,20.0
10515,1,515,[282 228 515 182  50],326,3,1882,3.647286821705426,0.0,20.0
10516,1,516,[187 127 302 191 211],537,5,1887,3.6499032882011604,0.0,20.0
10517,1,517,[187 127 302 191 211],474,5,1892,3.6525096525096523,0.0,20.0
10518,1,518,[328 180 210  22  98],263,4,1896,3.653179190751445,0.0,20.0
10519,1,519,[187 127 302 191 211],271,5,1901,3.6557692307692307,0.0,20.0
10520,1,520,[ 25 546 100 508 222],825,5,1906,3.658349328214971,0.0,20.0
10521,1,521,[ 71 289 357  97 313],474,4,1910,3.6590038314176243,20.0,0.0
10522,1,522,[181 211 265 183 143],648,5,1915,3.661567877629063,0.0,0.0
10523,1,523,[222 151  12 483 191],339,5,1920,3.66412213740458,40.0,0.0
10524,1,524,[187 127 302 191 211],343,5,1925,3.6666666666666665,0.0,20.0
10525,1,525,[187 127 302 191 211],90,5,1930,3.6692015209125475,0.0,20.0
10526,1,526,[ 98 195 143  15 153],406,3,1933,3.667931688804554,0.0,20.0
10527,1,527,[ 28  50 423 195 655],804,4,1937,3.668560606060606,0.0,20.0
10528,1,528,[ 71 275 405 288 135],378,2,1939,3.665406427221172,0.0,0.0
10529,1,529,[ 50 153 174  70 294],940,3,1942,3.6641509433962263,0.0,40.0
10530,1,530,[ 71   4 282 191  69],378,3,1945,3.662900188323917,0.0,0.0
10531,1,531,[385 313  69 197 186],378,2,1947,3.6597744360902253,0.0,0.0
10532,1,532,[748 181   4 100 323],13,4,1951,3.6604127579737336,0.0,20.0
10533,1,533,[187 127 302 191 211],90,5,1956,3.662921348314607,0.0,20.0
10534,1,534,[187 127 302 191 211],6,5,1961,3.6654205607476635,0.0,20.0
10535,1,535,[ 89 475 215   4 127],343,4,1965,3.666044776119403,0.0,20.0
10536,1,536,[187 127 302 191 211],474,5,1970,3.6685288640595903,0.0,20.0
10537,1,537,[403  79 515  89  25],843,1,1971,3.663568773234201,0.0,0.0
10538,1,538,[265 172  50 181 322],524,3,1974,3.6623376623376624,0.0,20.0
10539,1,539,[603  71 333 121 197],533,5,1979,3.664814814814815,20.0,0.0
10540,1,540,[ 96  15 508  98 179],207,4,1983,3.66543438077634,0.0,20.0
10541,1,541,[508 603 179 194 181],339,5,1988,3.6678966789667897,20.0,0.0
10542,1,542,[187 127 302 191 211],6,5,1993,3.6703499079189688,0.0,20.0
10543,1,543,[187 127 302 191 211],474,5,1998,3.672794117647059,0.0,20.0
10544,1,544,[176 403 357 655 180],210,5,2003,3.675229357798165,20.0,0.0
10545,1,545,[187 127 302 191 211],207,5,2008,3.6776556776556775,0.0,20.0
10546,1,546,[318 200 496  71 475],334,3,2011,3.6764168190127973,20.0,0.0
10547,1,547,[187 127 302 191 211],6,5,2016,3.678832116788321,0.0,20.0
10548,1,548,[187 127 302 191 211],537,5,2021,3.6812386156648453,0.0,20.0
10549,1,549,[294 471 265 117 111],479,3,2024,3.68,0.0,0.0
10550,1,550,[187 127 302 191 211],666,5,2029,3.6823956442831216,0.0,20.0
10551,1,551,[294 257 655 182 197],474,3,2032,3.681159420289855,0.0,0.0
10552,1,552,[237 742  96  71  70],308,4,2036,3.6817359855334537,0.0,0.0
10553,1,553,[187 127 302 191 211],271,5,2041,3.684115523465704,0.0,20.0
10554,1,554,[187 127 302 191 211],537,5,2046,3.6864864864864866,0.0,20.0
10555,1,555,[187 127 302 191 211],339,5,2051,3.6888489208633093,0.0,20.0
10556,1,556,[187 127 302 191 211],833,3,2054,3.687612208258528,0.0,20.0
10557,1,557,[187 127 302 191 211],537,5,2059,3.6899641577060933,0.0,20.0
10558,1,558,[187 127 302 191 211],537,5,2064,3.6923076923076925,0.0,20.0
10559,1,559,[187 127 302 191 211],833,3,2067,3.6910714285714286,0.0,20.0
10560,1,560,[271   8  82  22 202],64,3,2070,3.6898395721925135,0.0,0.0
10561,1,561,[187 127 191 302 100],271,5,2075,3.692170818505338,0.0,40.0
10562,1,562,[187 127 191 302 100],144,4,2079,3.6927175843694493,0.0,40.0
10563,1,563,[187 127 191 302 100],524,5,2084,3.6950354609929077,0.0,40.0
10564,1,564,[143  96 197 172 180],537,2,2086,3.6920353982300886,0.0,0.0
10565,1,565,[174 238  71 268 302],6,4,2090,3.6925795053003534,0.0,20.0
10566,1,566,[ 12 135 568 183 196],13,4,2094,3.693121693121693,20.0,0.0
10567,1,567,[100 258  96 172 265],666,2,2096,3.6901408450704225,0.0,20.0
10568,1,568,[  8   7 187  56 195],774,0,2096,3.6836555360281196,0.0,0.0
10569,1,569,[187 127 191 302 100],474,5,2101,3.685964912280702,0.0,40.0
10570,1,570,[187 127 191 302 100],6,5,2106,3.6882661996497372,0.0,40.0
10571,1,571,[187 127 191 302 100],271,5,2111,3.6905594405594404,0.0,40.0
10572,1,572,[496 191 357 289   7],194,3,2114,3.68935427574171,20.0,0.0
10573,1,573,[181 301 286 180 294],537,1,2115,3.6846689895470384,0.0,0.0
10574,1,574,[318 235 405 179  70],524,3,2118,3.683478260869565,20.0,0.0
10575,1,575,[187 127 191 302 100],458,5,2123,3.685763888888889,0.0,40.0
10576,1,576,[603 210 174 202 144],64,2,2125,3.682842287694974,20.0,20.0
10577,1,577,[187 127 191 302 100],458,5,2130,3.685121107266436,0.0,40.0
10578,1,578,[187 127 191 100 302],271,5,2135,3.687392055267703,0.0,40.0
10579,1,579,[175  11 187  22  28],833,3,2138,3.6862068965517243,0.0,0.0
10580,1,580,[187 127 191 100 302],343,5,2143,3.6884681583476766,0.0,40.0
10581,1,581,[195 237 294 211 215],7,4,2147,3.689003436426117,0.0,0.0
10582,1,582,[187 127 191 100 302],90,5,2152,3.6912521440823327,0.0,40.0
10583,1,583,[175 176 238 475 100],13,2,2154,3.6883561643835616,0.0,20.0
10584,1,584,[187 127 191 100 302],524,5,2159,3.690598290598291,0.0,40.0
10585,1,585,[496 183 144 405 385],295,4,2163,3.6911262798634814,0.0,0.0
10586,1,586,[172 181 210 318 211],87,5,2168,3.6933560477001706,20.0,0.0
10587,1,587,[187 127 191 100 302],13,4,2172,3.693877551020408,0.0,40.0
10588,1,588,[ 25  88   8 200  71],378,4,2176,3.694397283531409,0.0,0.0
10589,1,589,[135 238 200  98 194],379,5,2181,3.6966101694915254,0.0,20.0
10590,1,590,[187 127 100 191 302],207,4,2185,3.697123519458545,0.0,40.0
10591,1,591,[172 282 258 222  98],200,5,2190,3.699324324324324,0.0,20.0
10592,1,592,[603 215 187  96 655],64,4,2194,3.699831365935919,20.0,0.0
10593,1,593,[ 12 748 195 127 269],883,4,2198,3.7003367003367003,20.0,20.0
10594,1,594,[496 161 403 180 204],326,1,2199,3.6957983193277313,0.0,0.0
10595,1,595,[ 22 173 181 322 328],537,1,2200,3.6912751677852347,0.0,0.0
10596,1,596,[322 265  25 328 471],313,3,2203,3.6901172529313233,0.0,0.0
10597,1,597,[187 127 191 302 100],334,5,2208,3.6923076923076925,0.0,40.0
10598,1,598,[187 127 191 302 100],615,4,2212,3.692821368948247,0.0,40.0
10599,1,599,[427 748 172 191 175],13,4,2216,3.6933333333333334,0.0,0.0
10600,1,600,[328 176  89 153 210],653,3,2219,3.692179700499168,0.0,0.0
10601,1,601,[173  96 423 228 153],643,5,2224,3.6943521594684388,0.0,0.0
10602,1,602,[187 127 302 191 211],666,5,2229,3.6965174129353233,0.0,20.0
10603,1,603,[211  22 515  56  97],328,4,2233,3.697019867549669,0.0,0.0
10604,1,604,[182 168 286 132 127],95,3,2236,3.695867768595041,0.0,20.0
10605,1,605,[268  50 385 222  71],85,3,2239,3.6947194719471947,0.0,20.0
10606,1,606,[222 300 183 182 196],64,4,2243,3.6952224052718288,0.0,0.0
10607,1,607,[187 127 302 191  50],360,5,2248,3.6973684210526314,0.0,40.0
10608,1,608,[187 127 302 191  50],664,4,2252,3.6978653530377668,0.0,40.0
10609,1,609,[185 151  95 603  71],650,1,2253,3.6934426229508195,20.0,0.0
10610,1,610,[238 197 471 121 568],13,2,2255,3.690671031096563,0.0,0.0
10611,1,611,[187 127 302 191  50],664,4,2259,3.6911764705882355,0.0,40.0
10612,1,612,[187 127 302  50 191],13,4,2263,3.6916802610114194,0.0,40.0
10613,1,613,[245  22 186 204 742],328,4,2267,3.692182410423453,0.0,0.0
10614,1,614,[597 294 180 186 135],804,3,2270,3.6910569105691056,0.0,0.0
10615,1,615,[ 70  82   1 216  88],648,4,2274,3.6915584415584415,0.0,0.0
10616,1,616,[496 186 546 405 508],378,1,2275,3.6871961102106967,0.0,0.0
10617,1,617,[ 12  82 197  50 181],379,5,2280,3.6893203883495147,20.0,20.0
10618,1,618,[  7  50 234  97 257],881,2,2282,3.6865912762520194,0.0,20.0
10619,1,619,[210 194 496 182 322],308,3,2285,3.685483870967742,0.0,0.0
10620,1,620,[176 175 597 235 257],378,4,2289,3.685990338164251,0.0,0.0
10621,1,621,[276 318 568  15 282],207,4,2293,3.6864951768488745,20.0,0.0
10622,1,622,[483 357 175 323 234],474,4,2297,3.6869983948635636,40.0,0.0
10623,1,623,[286 496 183  69  12],7,5,2302,3.6891025641025643,20.0,0.0
10624,1,624,[ 70 313 237 176 228],455,2,2304,3.6864,0.0,0.0
10625,1,625,[132 215  79 435  95],295,5,2309,3.6884984025559104,0.0,0.0
10626,1,626,[496 211  15  98 183],406,5,2314,3.6905901116427433,0.0,20.0
10627,1,627,[210   1  22 121 235],650,0,2314,3.6847133757961785,0.0,0.0
10628,1,628,[ 50 168 175 179 222],648,4,2318,3.685214626391097,0.0,20.0
10629,1,629,[238 678 100 210 194],387,3,2321,3.684126984126984,0.0,20.0
10630,1,630,[187 127 302 211 191],537,5,2326,3.6862123613312203,0.0,20.0
10631,1,631,[187 127 302 211 191],474,5,2331,3.6882911392405062,0.0,20.0
10632,1,632,[195 515   4 403 183],13,2,2333,3.6856240126382307,0.0,0.0
10633,1,633,[  4  88 435   9 385],378,4,2337,3.686119873817035,0.0,0.0
10634,1,634,[423  71 385 403  22],788,2,2339,3.6834645669291337,0.0,0.0
10635,1,635,[ 50 275 174 161 546],95,2,2341,3.680817610062893,0.0,40.0
10636,1,636,[187 127 302 211 191],207,5,2346,3.682888540031397,0.0,20.0
10637,1,637,[187 127 302 211 191],343,5,2351,3.6849529780564265,0.0,20.0
10638,1,638,[238 118   4 234 568],795,2,2353,3.6823161189358373,0.0,0.0
10639,1,639,[265 204 143 196   4],533,3,2356,3.68125,0.0,0.0
10640,1,640,[187 127 302 211 191],271,5,2361,3.6833073322932917,0.0,20.0
10641,1,641,[ 64 276 181 515 265],92,5,2366,3.6853582554517135,0.0,0.0
10642,1,642,[742 678 173 183 235],334,2,2368,3.682737169517885,0.0,0.0
10643,1,643,[187 127 302 211 191],666,5,2373,3.6847826086956523,0.0,20.0
10644,1,644,[ 71 235 289 183 588],13,3,2376,3.683720930232558,0.0,0.0
10645,1,645,[257 515 211 235   1],271,3,2379,3.6826625386996903,0.0,0.0
10646,1,646,[180 234 132  98 194],788,4,2383,3.6831530139103554,0.0,20.0
10647,1,647,[172 222 271  82 475],92,3,2386,3.682098765432099,0.0,0.0
10648,1,648,[ 50 289 265   9  88],378,5,2391,3.684129429892142,0.0,20.0
10649,1,649,[194 357 187 282  56],311,5,2396,3.686153846153846,20.0,0.0
10650,1,650,[ 56   4 143  50 173],295,5,2401,3.6881720430107525,0.0,20.0
10651,1,651,[187 127 302 211 191],833,3,2404,3.687116564417178,0.0,20.0
10652,1,652,[  9 237 100  69 195],85,2,2406,3.684532924961715,0.0,20.0
10653,1,653,[153 328  97 202 234],653,1,2407,3.680428134556575,0.0,0.0
10654,1,654,[471 175 215 118 748],788,0,2407,3.6748091603053434,0.0,0.0
10655,1,655,[187 127 302 191 211],524,5,2412,3.676829268292683,0.0,20.0
10656,1,656,[187 127 302 191 211],524,5,2417,3.678843226788432,0.0,20.0
10657,1,657,[357 271 195   1 174],890,4,2421,3.6793313069908815,20.0,20.0
10658,1,658,[405 204 228 216 471],653,2,2423,3.676783004552352,0.0,0.0
10659,1,659,[245 118  82  22 742],92,1,2424,3.672727272727273,0.0,0.0
10660,1,660,[187 127 302 191 211],13,4,2428,3.6732223903177004,0.0,20.0
10661,1,661,[168 655 183 151  15],537,1,2429,3.6691842900302114,0.0,0.0
10662,1,662,[475  56 237 508 471],115,3,2432,3.668174962292609,0.0,0.0
10663,1,663,[187 127 302 191 211],343,5,2437,3.6701807228915664,0.0,20.0
10664,1,664,[403 161 168 111 187],59,4,2441,3.6706766917293234,0.0,0.0
10665,1,665,[187 127 302 211 191],90,5,2446,3.6726726726726726,0.0,20.0
10666,1,666,[174 483  22 313 237],334,5,2451,3.6746626686656674,20.0,20.0
10667,1,667,[405 180 125 132 423],533,3,2454,3.6736526946107784,0.0,0.0
10668,1,668,[172 180 204 194  56],537,2,2456,3.671150971599402,0.0,0.0
10669,1,669,[187 127 302 211 191],339,5,2461,3.6731343283582087,0.0,20.0
10670,1,670,[238 143 546 403   7],804,2,2463,3.670640834575261,0.0,0.0
10671,1,671,[191 187 403 181 151],653,3,2466,3.669642857142857,0.0,0.0
10672,1,672,[216 211 603 180 496],804,5,2471,3.6716196136701336,20.0,0.0
10673,1,673,[  9 294 483 655 127],7,4,2475,3.672106824925816,20.0,20.0
10674,1,674,[ 96 234  79  71 588],234,1,2476,3.668148148148148,0.0,0.0
10675,1,675,[187 127 302 211 191],13,4,2480,3.668639053254438,0.0,20.0
10676,1,676,[289  12  56 196 216],378,5,2485,3.6706056129985227,20.0,0.0
10677,1,677,[322  25 228 180 258],313,1,2486,3.6666666666666665,0.0,0.0
10678,1,678,[187 127 302 211 196],13,5,2491,3.6686303387334314,0.0,20.0
10679,1,679,[588 211 117 235   7],406,5,2496,3.6705882352941175,0.0,0.0
10680,1,680,[294  71 742  98 238],92,3,2499,3.6696035242290748,0.0,20.0
10681,1,681,[187 127 302 196 211],666,4,2503,3.6700879765395893,0.0,20.0
10682,1,682,[187 127 302 211 191],207,5,2508,3.67203513909224,0.0,20.0
10683,1,683,[187 127 302 211 191],524,5,2513,3.6739766081871346,0.0,20.0
10684,1,684,[ 88 151 211  64 275],308,5,2518,3.675912408759124,0.0,0.0
10685,1,685,[269 180 288 215 294],605,4,2522,3.676384839650146,0.0,0.0
10686,1,686,[187 127 302 211 191],666,5,2527,3.678311499272198,0.0,20.0
10687,1,687,[187 127 302 211 191],207,5,2532,3.6802325581395348,0.0,20.0
10688,1,688,[187 127 302 211 191],13,4,2536,3.6806966618287373,0.0,20.0
10689,1,689,[202 496  70 238 403],95,4,2540,3.681159420289855,0.0,0.0
10690,1,690,[ 25  15 273 289 268],537,1,2541,3.6772793053545585,0.0,0.0
10691,1,691,[187 127 302 211 318],666,5,2546,3.679190751445087,20.0,20.0
10692,1,692,[187 127 302 211 318],271,5,2551,3.681096681096681,20.0,20.0
10693,1,693,[  8  28 161 258  25],234,2,2553,3.6786743515850144,0.0,0.0
10694,1,694,[ 71 286  70 194 125],6,2,2555,3.676258992805755,0.0,0.0
10695,1,695,[  7 180 597 182 328],95,2,2557,3.6738505747126435,0.0,0.0
10696,1,696,[187 202 211 423 300],666,3,2560,3.672883787661406,0.0,0.0
10697,1,697,[ 56 182 210  28 176],533,2,2562,3.670487106017192,0.0,0.0
10698,1,698,[ 95  71 245 435 197],454,1,2563,3.6666666666666665,0.0,0.0
10699,1,699,[508 187  64 191 210],387,4,2567,3.6671428571428573,0.0,0.0
10700,1,700,[182 187 328  22 282],479,5,2572,3.6690442225392297,0.0,0.0
10701,1,701,[151 176  98 173 423],749,5,2577,3.6709401709401708,0.0,20.0
10702,1,702,[187 127 302 211 318],537,5,2582,3.6728307254623043,20.0,20.0
10703,1,703,[234 742  96 211  71],524,3,2585,3.671875,0.0,0.0
10704,1,704,[187 603 127 385 234],524,3,2588,3.670921985815603,20.0,20.0
10705,1,705,[187 127 302 211 318],271,5,2593,3.6728045325779037,20.0,20.0
10706,1,706,[187 127 302 211 318],346,3,2596,3.671852899575672,20.0,20.0
10707,1,707,[182 121  50 289 194],537,2,2598,3.669491525423729,0.0,20.0
10708,1,708,[127 187 302 211 318],524,5,2603,3.6713681241184766,20.0,20.0
10709,1,709,[385 180 286 179 176],13,1,2604,3.667605633802817,0.0,0.0
10710,1,710,[ 25 191 302  82 174],13,2,2606,3.6652601969057663,0.0,20.0
10711,1,711,[182   7 269 153 423],666,4,2610,3.6657303370786516,0.0,0.0
10712,1,712,[286 117 216 135 127],479,2,2612,3.6633941093969145,0.0,20.0
10713,1,713,[153 269 235  79 275],64,4,2616,3.6638655462184873,0.0,0.0
10714,1,714,[127 187 302 211 318],524,5,2621,3.6657342657342658,20.0,20.0
10715,1,715,[168 111 403 121 135],374,2,2623,3.6634078212290504,0.0,0.0
10716,1,716,[127 187 302 211 318],207,5,2628,3.6652719665271967,20.0,20.0
10717,1,717,[ 70 234 423 211 172],328,5,2633,3.667130919220056,0.0,0.0
10718,1,718,[200 228 210 237 403],374,4,2637,3.66759388038943,0.0,0.0
10719,1,719,[215 151 195 385  79],892,4,2641,3.6680555555555556,0.0,0.0
10720,1,720,[127 187 302 211 318],315,5,2646,3.6699029126213594,20.0,20.0
10721,1,721,[127 187 302 211 318],6,5,2651,3.6717451523545708,20.0,20.0
10722,1,722,[196 186 183 288 176],308,4,2655,3.672199170124481,0.0,0.0
10723,1,723,[245  98 546  22 175],804,4,2659,3.6726519337016574,0.0,20.0
10724,1,724,[127 187 302 211 318],343,5,2664,3.6744827586206896,20.0,20.0
10725,1,725,[174  95  71 258  82],200,5,2669,3.6763085399449036,0.0,20.0
10726,1,726,[ 96 237 403 176 196],653,1,2670,3.6726272352132048,0.0,0.0
10727,1,727,[546 132 597 471 405],328,2,2672,3.67032967032967,0.0,0.0
10728,1,728,[125 151 328 546 282],294,3,2675,3.6694101508916326,0.0,0.0
10729,1,729,[ 50 222 210 132 357],295,5,2680,3.671232876712329,20.0,20.0
10730,1,730,[127 187 302 211 318],537,5,2685,3.6730506155950753,20.0,20.0
10731,1,731,[742 475 748 276 288],533,1,2686,3.669398907103825,0.0,0.0
10732,1,732,[597 194 186 269 234],650,4,2690,3.669849931787176,0.0,0.0
10733,1,733,[127 187 302 211 318],315,5,2695,3.6716621253405997,20.0,20.0
10734,1,734,[ 70 300 195 237   9],328,4,2699,3.672108843537415,0.0,0.0
10735,1,735,[127 187 302 211 318],343,5,2704,3.6739130434782608,20.0,20.0
10736,1,736,[127 187 302 211 318],13,4,2708,3.674355495251018,20.0,20.0
10737,1,737,[127 187 302 211  50],102,1,2709,3.6707317073170733,0.0,40.0
10738,1,738,[127 187 302 211  50],339,5,2714,3.672530446549391,0.0,40.0
10739,1,739,[323   4 153 286 483],788,2,2716,3.67027027027027,20.0,0.0
10740,1,740,[435 318  12  95 403],892,4,2720,3.670715249662618,40.0,0.0
10741,1,741,[127 187 302 211  50],339,5,2725,3.6725067385444743,0.0,40.0
10742,1,742,[127 187 302 211  50],339,5,2730,3.674293405114401,0.0,40.0
10743,1,743,[173 172  89 161   7],452,5,2735,3.6760752688172045,0.0,0.0
10744,1,744,[127 187 302 211  50],328,5,2740,3.6778523489932886,0.0,40.0
10745,1,745,[181  50 228  69 185],7,4,2744,3.67828418230563,0.0,20.0
10746,1,746,[ 97  22 176  79 357],125,3,2747,3.677376171352075,20.0,0.0
10747,1,747,[196 176 748 655   7],64,4,2751,3.677807486631016,0.0,0.0
10748,1,748,[183   4 257   8 427],334,4,2755,3.678237650200267,0.0,0.0
10749,1,749,[151   9  22  64  69],533,4,2759,3.6786666666666665,0.0,0.0
10750,1,750,[174 210 483  12 100],207,2,2761,3.676431424766977,40.0,40.0
10751,1,751,[216 186 318  96 210],488,3,2764,3.675531914893617,20.0,0.0
10752,1,752,[  8   1 144 125 172],455,3,2767,3.6746347941567064,0.0,0.0
10753,1,753,[127 187 302 211  50],271,5,2772,3.676392572944297,0.0,40.0
10754,1,754,[127 187 302 211  50],210,5,2777,3.6781456953642384,0.0,40.0
10755,1,755,[127 187 302 211  50],343,5,2782,3.67989417989418,0.0,40.0
10756,1,756,[ 95 186 269 197  25],13,3,2785,3.678996036988111,0.0,0.0
10757,1,757,[ 70 423 210 204 100],804,4,2789,3.679419525065963,0.0,20.0
10758,1,758,[234 385 357 215 588],311,5,2794,3.681159420289855,20.0,0.0
10759,1,759,[  9  88 191 237 423],533,4,2798,3.681578947368421,0.0,0.0
10760,1,760,[423 515 496 258   9],7,4,2802,3.6819973718791066,0.0,0.0
10761,1,761,[127 187 302 211  50],210,5,2807,3.683727034120735,0.0,40.0
10762,1,762,[288 144   1 546 187],213,4,2811,3.6841415465268676,0.0,0.0
10763,1,763,[ 22  97 161  69 235],339,3,2814,3.683246073298429,0.0,0.0
10764,1,764,[183 475 179  89   8],13,3,2817,3.6823529411764704,0.0,0.0
10765,1,765,[153 265  70 111 318],648,3,2820,3.681462140992167,20.0,0.0
10766,1,766,[435 211 194 144 742],648,5,2825,3.6831812255541068,0.0,0.0
10767,1,767,[127 187 302 211  50],271,5,2830,3.6848958333333335,0.0,40.0
10768,1,768,[181 655 182 186 483],474,5,2835,3.6866059817945382,20.0,0.0
10769,1,769,[202 276 385  97  64],311,5,2840,3.688311688311688,0.0,0.0
10770,1,770,[265 127 185 228 435],881,3,2843,3.6874189364461736,0.0,20.0
10771,1,771,[222   8 234 111 357],474,5,2848,3.6891191709844557,20.0,0.0
10772,1,772,[182  95 475 258 153],64,3,2851,3.688227684346701,0.0,0.0
10773,1,773,[127 187 302  50 211],210,5,2856,3.689922480620155,0.0,40.0
10774,1,774,[161 195 276 302 211],474,5,2861,3.6916129032258063,0.0,0.0
10775,1,775,[215 191  79 318 483],892,5,2866,3.693298969072165,40.0,0.0
10776,1,776,[215  82  64  71 143],524,1,2867,3.6898326898326896,0.0,0.0
10777,1,777,[127   7   1 172 183],308,5,2872,3.691516709511568,0.0,20.0
10778,1,778,[216 268  22  28 176],234,2,2874,3.689345314505777,0.0,0.0
10779,1,779,[496  69 143 301  95],650,2,2876,3.687179487179487,0.0,0.0
10780,1,780,[  1 588 194 427  56],664,4,2880,3.6875800256081948,0.0,0.0
10781,1,781,[127 187 302  50 211],6,5,2885,3.6892583120204603,0.0,40.0
10782,1,782,[100 603  97  22  50],313,4,2889,3.689655172413793,20.0,40.0
10783,1,783,[127 187 302  50 211],210,5,2894,3.691326530612245,0.0,40.0
10784,1,784,[127 187 302  50 211],328,5,2899,3.6929936305732483,0.0,40.0
10785,1,785,[127 187 302  50 211],13,5,2904,3.6946564885496183,0.0,40.0
10786,1,786,[174 423 187  12 318],64,5,2909,3.6963151207115628,40.0,20.0
10787,1,787,[ 88  15  11  95 204],200,5,2914,3.697969543147208,0.0,0.0
10788,1,788,[222  64 568 228 301],13,2,2916,3.6958174904942966,0.0,0.0
10789,1,789,[269 333 111 121 180],666,2,2918,3.6936708860759495,0.0,0.0
10790,1,790,[168 328 144  79 197],234,1,2919,3.690265486725664,0.0,0.0
10791,1,791,[187  50 202 237 435],271,5,2924,3.691919191919192,0.0,20.0
10792,1,792,[294 143 269  12 300],378,4,2928,3.6923076923076925,20.0,0.0
10793,1,793,[127 187  50 302 211],6,5,2933,3.6939546599496222,0.0,40.0
10794,1,794,[ 82 216 118   4  98],881,4,2937,3.6943396226415093,0.0,20.0
10795,1,795,[603 161  70 294 238],271,3,2940,3.693467336683417,20.0,0.0
10796,1,796,[173 405 180 100 423],474,5,2945,3.695106649937265,0.0,20.0
10797,1,797,[496 216 204 228  95],537,1,2946,3.691729323308271,0.0,0.0
10798,1,798,[ 11  64 222 294 483],13,2,2948,3.6896120150187737,20.0,0.0
10799,1,799,[515 179 182  22 301],524,4,2952,3.69,0.0,0.0
10800,1,800,[127 187  50 302 211],328,5,2957,3.6916354556803994,0.0,40.0
10801,1,801,[127 187  50 302 211],339,5,2962,3.693266832917706,0.0,40.0
10802,1,802,[182 385 132 435 318],385,2,2964,3.6911581569115817,20.0,0.0
10803,1,803,[127 187  50 302 211],537,5,2969,3.692786069651741,0.0,40.0
10804,1,804,[127 187  50 302 211],271,5,2974,3.694409937888199,0.0,40.0
10805,1,805,[127 187  50 302 211],346,3,2977,3.693548387096774,0.0,40.0
10806,1,806,[127 187  50 211 302],537,5,2982,3.6951672862453533,0.0,40.0
10807,1,807,[475  96 182 204  12],387,3,2985,3.6943069306930694,20.0,0.0
10808,1,808,[ 50 271 237 196  88],13,4,2989,3.6946847960444993,0.0,20.0
10809,1,809,[496 238  96 276 181],892,5,2994,3.696296296296296,0.0,0.0
10810,1,810,[168 265 275 237 161],95,1,2995,3.6929716399506782,0.0,0.0
10811,1,811,[127 187  50 211 302],6,5,3000,3.6945812807881775,0.0,40.0
10812,1,812,[127 187  50 211 302],6,5,3005,3.6961869618696186,0.0,40.0
10813,1,813,[127 187  50 211 302],339,5,3010,3.697788697788698,0.0,40.0
10814,1,814,[127 187  50 211 302],537,5,3015,3.6993865030674846,0.0,40.0
10815,1,815,[168 742  98 258 174],313,2,3017,3.6973039215686274,0.0,40.0
10816,1,816,[216 117 300 271 100],479,0,3017,3.692778457772338,0.0,20.0
10817,1,817,[  9  69 197 216  70],60,5,3022,3.6943765281173593,0.0,0.0
10818,1,818,[127 187  50 211 302],346,3,3025,3.6935286935286937,0.0,40.0
10819,1,819,[127 187  50 211 302],102,1,3026,3.6902439024390246,0.0,40.0
10820,1,820,[275  22 435  64 211],474,4,3030,3.6906211936662605,0.0,0.0
10821,1,821,[289 588 323 191 172],13,2,3032,3.6885644768856447,0.0,0.0
10822,1,822,[222 151 258 234  25],537,1,3033,3.6852976913730253,0.0,0.0
10823,1,823,[127 187  50 211 302],6,5,3038,3.686893203883495,0.0,40.0
10824,1,824,[127 187  50 211 302],13,5,3043,3.6884848484848485,0.0,40.0
10825,1,825,[195 111 357  79 174],648,4,3047,3.688861985472155,20.0,20.0
10826,1,826,[127 187  50 211 302],833,2,3049,3.686819830713422,0.0,40.0
10827,1,827,[216   9  98   4  56],233,4,3053,3.6871980676328504,0.0,20.0
10828,1,828,[125 204 515 168 132],59,4,3057,3.6875753920386005,0.0,0.0
10829,1,829,[181 588 175 210 546],7,4,3061,3.6879518072289157,0.0,0.0
10830,1,830,[194  69 174 211 403],387,2,3063,3.6859205776173285,0.0,20.0
10831,1,831,[ 12 257 268  70 143],6,1,3064,3.6826923076923075,20.0,0.0
10832,1,832,[234 300 204   4 175],378,4,3068,3.6830732292917165,0.0,0.0
10833,1,833,[ 69  98   9 111 196],59,5,3073,3.684652278177458,0.0,20.0
10834,1,834,[127 187  50 211   9],474,5,3078,3.68622754491018,0.0,40.0
10835,1,835,[127 187  50 211   9],527,5,3083,3.687799043062201,0.0,40.0
10836,1,836,[ 97 215 196 403 288],892,4,3087,3.6881720430107525,0.0,0.0
10837,1,837,[182 202   1 216 471],378,3,3090,3.6873508353221958,0.0,0.0
10838,1,838,[515 196  95 265 183],892,5,3095,3.688915375446961,0.0,0.0
10839,1,839,[176  89 200 655  12],328,5,3100,3.6904761904761907,20.0,0.0
10840,1,840,[197 742 185  95 153],95,3,3103,3.689655172413793,0.0,0.0
10841,1,841,[  4 211 286 357 179],234,2,3105,3.687648456057007,20.0,0.0
10842,1,842,[197  71 100  98 127],474,5,3110,3.6892052194543297,0.0,60.0
10843,1,843,[174 546   9 237 568],378,4,3114,3.68957345971564,0.0,20.0
10844,1,844,[127 187  50   9 302],271,5,3119,3.6911242603550294,0.0,40.0
10845,1,845,[127 187  50   9 302],339,5,3124,3.692671394799054,0.0,40.0
10846,1,846,[588 174   7 168 435],804,4,3128,3.6930342384887838,0.0,20.0
10847,1,847,[191  64 423  97 405],892,5,3133,3.6945754716981134,0.0,0.0
10848,1,848,[186 183 597  88 742],92,2,3135,3.6925795053003534,0.0,0.0
10849,1,849,[127 187  50   9 302],13,4,3139,3.692941176470588,0.0,40.0
10850,1,850,[174 100 186 603  12],537,3,3142,3.6921269095182137,40.0,40.0
10851,1,851,[328 515 175 234 403],804,4,3146,3.692488262910798,0.0,0.0
10852,1,852,[127 187  50 302 211],271,5,3151,3.694021101992966,0.0,40.0
10853,1,853,[  8  71 175 144 228],892,3,3154,3.693208430913349,0.0,0.0
10854,1,854,[127 187  50 302 211],13,5,3159,3.694736842105263,0.0,40.0
10855,1,855,[127 187  50 302 211],210,5,3164,3.696261682242991,0.0,40.0
10856,1,856,[100  70 294 357 194],213,3,3167,3.6954492415402567,20.0,20.0
10857,1,857,[211 183 100 294 200],537,2,3169,3.6934731934731935,0.0,20.0
10858,1,858,[135 748  22 546   9],749,2,3171,3.691501746216531,0.0,0.0
10859,1,859,[603 174  82 143 228],454,4,3175,3.691860465116279,20.0,20.0
10860,1,860,[127 187  50 302 211],6,5,3180,3.6933797909407664,0.0,40.0
10861,1,861,[200 181  50  70 234],308,4,3184,3.6937354988399074,0.0,20.0
10862,1,862,[127 187  50 302 211],328,5,3189,3.695249130938586,0.0,40.0
10863,1,863,[127 187  50 302 211],102,1,3190,3.6921296296296298,0.0,40.0
10864,1,864,[127 187  50 302 211],6,5,3195,3.69364161849711,0.0,40.0
10865,1,865,[357  15  96 125 174],653,3,3198,3.69284064665127,20.0,20.0
10866,1,866,[603  12 483 423 496],666,4,3202,3.693194925028835,60.0,0.0
10867,1,867,[127 187  50 302 211],537,5,3207,3.694700460829493,0.0,40.0
10868,1,868,[127 187  50 302 211],537,5,3212,3.6962025316455698,0.0,40.0
10869,1,869,[127 187  50 302 211],537,5,3217,3.697701149425287,0.0,40.0
10870,1,870,[127 187  50 302 211],833,2,3219,3.695752009184845,0.0,40.0
10871,1,871,[  4 228 144 181 118],7,3,3222,3.694954128440367,0.0,0.0
10872,1,872,[127 187  50 302 211],328,5,3227,3.6964490263459338,0.0,40.0
10873,1,873,[742 222 275 200 234],145,4,3231,3.696796338672769,0.0,0.0
10874,1,874,[237 515 222  22 204],328,3,3234,3.696,0.0,0.0
10875,1,875,[127 187  50 302 211],537,5,3239,3.6974885844748857,0.0,40.0
10876,1,876,[ 25 496 100 118 300],271,2,3241,3.6955530216647663,0.0,20.0
10877,1,877,[127 187  50 302 211],210,5,3246,3.6970387243735763,0.0,40.0
10878,1,878,[603 118 180 127 182],840,4,3250,3.697383390216155,20.0,20.0
10879,1,879,[ 98 294 183 200 245],804,4,3254,3.6977272727272728,0.0,20.0
10880,1,880,[127 187  50 302 211],524,5,3259,3.699205448354143,0.0,40.0
10881,1,881,[127 151 181 216 435],339,4,3263,3.699546485260771,0.0,20.0
10882,1,882,[127 187  50 302 211],343,5,3268,3.7010192525481314,0.0,40.0
10883,1,883,[603 655 568 161 216],308,3,3271,3.7002262443438916,20.0,0.0
10884,1,884,[289 322 181 127 245],637,1,3272,3.697175141242938,0.0,20.0
10885,1,885,[ 82  88 496 179 186],234,1,3273,3.694130925507901,0.0,0.0
10886,1,886,[127 187  50 302 211],833,2,3275,3.692220969560316,0.0,40.0
10887,1,887,[597 322  98 179 568],13,1,3276,3.689189189189189,0.0,20.0
10888,1,888,[127 187  50 302 211],343,5,3281,3.69066366704162,0.0,40.0
10889,1,889,[273 597 234 546 385],374,4,3285,3.691011235955056,0.0,0.0
10890,1,890,[127 187  50 302 211],474,5,3290,3.6924803591470257,0.0,40.0
10891,1,891,[204 191 357  22 195],308,5,3295,3.6939461883408073,20.0,0.0
10892,1,892,[127 187  50 302 211],343,5,3300,3.6954087346024638,0.0,40.0
10893,1,893,[127 187  50 302 211],346,3,3303,3.6946308724832213,0.0,40.0
10894,1,894,[174 210 202  11 318],59,5,3308,3.69608938547486,20.0,20.0
10895,1,895,[132  82 121 515 508],669,3,3311,3.6953125,0.0,0.0
10896,1,896,[127 187  50 211 302],328,5,3316,3.6967670011148273,0.0,40.0
10897,1,897,[127 187  50 211 302],339,5,3321,3.698218262806236,0.0,40.0
10898,1,898,[ 22 546 144  96  50],87,4,3325,3.6985539488320356,0.0,20.0
10899,1,899,[127 187  50 211 302],102,1,3326,3.6955555555555555,0.0,40.0
10900,1,900,[127 187  50 211 302],339,5,3331,3.6970033296337403,0.0,40.0
10901,1,901,[  9 197  71 403 742],749,4,3335,3.697339246119734,0.0,0.0
10902,1,902,[ 22 151   1 168 282],95,5,3340,3.698781838316722,0.0,0.0
10903,1,903,[135  79  28 385  71],374,5,3345,3.700221238938053,0.0,0.0
10904,1,904,[127 187  50 211 302],271,5,3350,3.701657458563536,0.0,40.0
10905,1,905,[127 187  50 211 302],833,2,3352,3.6997792494481234,0.0,40.0
10906,1,906,[127 187  50  98 302],144,4,3356,3.7001102535832415,0.0,60.0
10907,1,907,[127 187  50  98 211],890,4,3360,3.700440528634361,0.0,60.0
10908,1,908,[127 187  50  98 191],188,3,3363,3.6996699669966997,0.0,60.0
10909,1,909,[127 187  50  98 302],458,3,3366,3.698901098901099,0.0,60.0
10910,1,910,[127 187  50 302 211],537,5,3371,3.7003293084522504,0.0,40.0
10911,1,911,[127 187  50 302 211],833,2,3373,3.6984649122807016,0.0,40.0
10912,1,912,[127 187  50 302 313],102,1,3374,3.695509309967141,0.0,40.0
10913,1,913,[127 187  50  98 191],776,5,3379,3.6969365426695844,0.0,60.0
10914,1,914,[127 187  50  98 191],85,5,3384,3.698360655737705,0.0,60.0
10915,1,915,[127 187  50  98 191],666,4,3388,3.6986899563318776,0.0,60.0
10916,1,916,[127 187  50  98 191],406,4,3392,3.699018538713195,0.0,60.0
10917,1,917,[ 69  82 282 323 748],881,2,3394,3.6971677559912854,0.0,0.0
10918,1,918,[127 187  50  98 191],343,5,3399,3.6985854189336234,0.0,60.0
10919,1,919,[127 187  98  50 191],538,5,3404,3.7,0.0,60.0
10920,1,920,[127 187  98  50 191],659,4,3408,3.7003257328990227,0.0,60.0
10921,1,921,[127 187  98 191 318],605,5,3413,3.7017353579175705,20.0,40.0
10922,1,922,[202  64 173 215   7],804,5,3418,3.7031419284940412,0.0,0.0
10923,1,923,[127 187  98 191 318],313,5,3423,3.7045454545454546,20.0,40.0
10924,1,924,[194  96 183 257 196],144,5,3428,3.705945945945946,0.0,0.0
10925,1,925,[127 187  98 191 318],144,5,3433,3.7073434125269977,20.0,40.0
10926,1,926,[127 187  98 191 318],334,5,3438,3.70873786407767,20.0,40.0
10927,1,927,[127 187  98 191 318],233,5,3443,3.7101293103448274,20.0,40.0
10928,1,928,[127 187  98 191 318],144,5,3448,3.7115177610333694,20.0,40.0
10929,1,929,[173  11 195  79 135],454,2,3450,3.7096774193548385,0.0,0.0
10930,1,930,[127 187  98 191 318],334,5,3455,3.711063372717508,20.0,40.0
10931,1,931,[127 187  98 191 318],387,4,3459,3.71137339055794,20.0,40.0
10932,1,932,[181 403  22 117 333],334,4,3463,3.7116827438370845,0.0,0.0
10933,1,933,[127 187  98 191 211],694,5,3468,3.7130620985010707,0.0,40.0
10934,1,934,[  8 237 265 187   9],328,4,3472,3.7133689839572193,0.0,0.0
10935,1,935,[127 187  98 191 211],343,5,3477,3.71474358974359,0.0,40.0
10936,1,936,[181 215  82 286 175],653,3,3480,3.713980789754536,0.0,0.0
10937,1,937,[127 187  98 191 211],694,5,3485,3.715351812366738,0.0,40.0
10938,1,938,[135 144  15 742 238],378,3,3488,3.714589989350373,0.0,0.0
10939,1,939,[127 187  98 191 211],308,4,3492,3.7148936170212767,0.0,40.0
10940,1,940,[127 187  98 191 211],7,5,3497,3.716259298618491,0.0,40.0
10941,1,941,[403  22 121 176 117],648,4,3501,3.71656050955414,0.0,0.0
10942,1,942,[427 180   1 175 655],59,4,3505,3.7168610816542946,0.0,0.0
10943,1,943,[127 187  98 191 211],524,4,3509,3.7171610169491527,0.0,40.0
10944,1,944,[127 187 191 211  50],339,5,3514,3.7185185185185183,0.0,40.0
10945,1,945,[127 187 191 211  50],343,5,3519,3.719873150105708,0.0,40.0
10946,1,946,[127 187 191 211  50],804,4,3523,3.720168954593453,0.0,40.0
10947,1,947,[127 187 191 211  50],650,3,3526,3.719409282700422,0.0,40.0
10948,1,948,[127 187 191 211  50],59,5,3531,3.720758693361433,0.0,40.0
10949,1,949,[127 187 191 211  50],188,3,3534,3.72,0.0,40.0
10950,1,950,[ 82 135 168  69 234],881,2,3536,3.718191377497371,0.0,0.0
10951,1,951,[127 187 191 211  50],524,5,3541,3.7195378151260505,0.0,40.0
10952,1,952,[235 183 258 211 210],102,2,3543,3.7177334732423923,0.0,0.0
10953,1,953,[196 195 275 181 111],901,3,3546,3.7169811320754715,0.0,0.0
10954,1,954,[301  82 228 238 211],13,2,3548,3.7151832460732983,0.0,0.0
10955,1,955,[127 187 191  50 211],188,3,3551,3.7144351464435146,0.0,40.0
10956,1,956,[127 187  50 191 211],452,3,3554,3.7136886102403346,0.0,40.0
10957,1,957,[234 125 187 228 196],653,2,3556,3.711899791231733,0.0,0.0
10958,1,958,[ 71 127 144 496 182],64,3,3559,3.711157455683003,0.0,20.0
10959,1,959,[ 97 121 423  96 111],537,0,3559,3.707291666666667,0.0,0.0
10960,1,960,[269 172 427 546 161],650,3,3562,3.7065556711758583,0.0,0.0
10961,1,961,[323 435  79 294 181],474,3,3565,3.7058212058212057,0.0,0.0
10962,1,962,[127 187  50 191 427],339,5,3570,3.707165109034268,0.0,40.0
10963,1,963,[127 187  50 427 191],666,4,3574,3.70746887966805,0.0,40.0
10964,1,964,[216  15 508  97 181],533,4,3578,3.707772020725389,0.0,0.0
10965,1,965,[127 187 427 191  50],474,5,3583,3.709109730848861,0.0,40.0
10966,1,966,[195 153 216 289 222],374,3,3586,3.7083764219234747,0.0,0.0
10967,1,967,[127 187 427 191  50],6,5,3591,3.709710743801653,0.0,40.0
10968,1,968,[301 191 323 194 300],90,3,3594,3.708978328173375,0.0,0.0
10969,1,969,[127 187 427 191  50],833,3,3597,3.7082474226804125,0.0,40.0
10970,1,970,[ 96 191 546 173  82],234,1,3598,3.705458290422245,0.0,0.0
10971,1,971,[127 187 191 302  98],207,5,3603,3.70679012345679,0.0,40.0
10972,1,972,[183   1  11 195  95],234,1,3604,3.7040082219938335,0.0,0.0
10973,1,973,[288 175 357 179  98],387,4,3608,3.704312114989733,20.0,20.0
10974,1,974,[127 187 191  98 302],664,4,3612,3.7046153846153844,0.0,40.0
10975,1,975,[300 435 302 135 127],537,3,3615,3.7038934426229506,0.0,20.0
10976,1,976,[ 70  56 200 238 210],234,1,3616,3.701125895598772,0.0,0.0
10977,1,977,[ 89 568 294  25 228],650,2,3618,3.6993865030674846,0.0,0.0
10978,1,978,[127 187 191  98 302],664,4,3622,3.699693564862104,0.0,40.0
10979,1,979,[127 187  98 302 191],524,4,3626,3.7,0.0,40.0
10980,1,980,[173  50 508 237 118],13,3,3629,3.6992864424057084,0.0,20.0
10981,1,981,[215 423 294 132 117],378,3,3632,3.69857433808554,0.0,0.0
10982,1,982,[ 11  96 187 385 271],13,2,3634,3.6968463886063074,0.0,0.0
10983,1,983,[508 655 174 132 161],339,4,3638,3.6971544715447155,0.0,20.0
10984,1,984,[127 187 302 191 211],339,5,3643,3.698477157360406,0.0,20.0
10985,1,985,[161 187 273  89 385],234,1,3644,3.6957403651115617,0.0,0.0
10986,1,986,[127 187 302 191 211],666,5,3649,3.697061803444782,0.0,20.0
10987,1,987,[132 161 117  22 118],308,1,3650,3.694331983805668,0.0,0.0
10988,1,988,[127 187 302 191 211],343,5,3655,3.6956521739130435,0.0,20.0
10989,1,989,[546 196 215 175 174],194,1,3656,3.6929292929292927,0.0,20.0
10990,1,990,[508 568 235 196 357],59,4,3660,3.693239152371342,20.0,0.0
10991,1,991,[127 187 302 191 211],13,4,3664,3.693548387096774,0.0,20.0
10992,1,992,[  1 144 176 200  11],643,4,3668,3.693856998992951,0.0,0.0
10993,1,993,[127 187 302 211 318],207,5,3673,3.6951710261569417,20.0,20.0
10994,1,994,[195 180 125  71 568],92,4,3677,3.6954773869346735,0.0,0.0
10995,1,995,[ 96  82 179 423 144],643,4,3681,3.6957831325301207,0.0,0.0
10996,1,996,[195 301 289 172 175],378,3,3684,3.6950852557673017,0.0,0.0
10997,1,997,[222  70 121  22 265],64,4,3688,3.6953907815631264,0.0,0.0
10998,1,998,[ 22 435 173  64 144],892,5,3693,3.6966966966966965,0.0,0.0
10999,1,999,[185 333 135 210  89],313,5,3698,3.698,0.0,0.0
11000,1,1000,[121 275  22  96 216],311,5,3703,3.699300699300699,0.0,0.0
11001,1,1001,[127 187 302 211 318],207,5,3708,3.7005988023952097,20.0,20.0
11002,1,1002,[748 258 222 275  22],533,4,3712,3.7008973080757728,0.0,0.0
11003,1,1003,[265 318  89 568 117],328,4,3716,3.701195219123506,20.0,0.0
11004,1,1004,[313 121 194  88 238],271,4,3720,3.701492537313433,0.0,0.0
11005,1,1005,[496 194 172 211  82],882,4,3724,3.701789264413519,0.0,0.0
11006,1,1006,[172 182 151 175 111],479,5,3729,3.7030784508440915,0.0,0.0
11007,1,1007,[117 423 210 405 168],290,2,3731,3.701388888888889,0.0,0.0
11008,1,1008,[127 187 302 211 318],315,5,3736,3.7026759167492567,20.0,20.0
11009,1,1009,[127 187 302 211 318],315,5,3741,3.703960396039604,20.0,20.0
11010,1,1010,[127 187 302 318 211],328,5,3746,3.705242334322453,20.0,20.0
11011,1,1011,[286   7 181 496 357],59,4,3750,3.705533596837945,20.0,0.0
11012,1,1012,[678 405 202 176 275],537,1,3751,3.702862783810464,0.0,0.0
11013,1,1013,[127 187 302 318 211],207,5,3756,3.7041420118343193,20.0,20.0
11014,1,1014,[121 180  64 568 328],749,4,3760,3.7044334975369457,0.0,0.0
11015,1,1015,[127 187 302 318 211],315,5,3765,3.7057086614173227,20.0,20.0
11016,1,1016,[403 237 210 185 211],7,5,3770,3.7069813176007864,0.0,0.0
11017,1,1017,[211 275  98  70 186],311,3,3773,3.706286836935167,0.0,20.0
11018,1,1018,[265 475   1 196 228],533,3,3776,3.705593719332679,0.0,0.0
11019,1,1019,[135  22 678 318  64],92,2,3778,3.703921568627451,20.0,0.0
11020,1,1020,[127 187 302 211 191],833,3,3781,3.703232125367287,0.0,20.0
11021,1,1021,[288 273   7 118 275],634,2,3783,3.7015655577299413,0.0,0.0
11022,1,1022,[127 187 302 191 318],144,4,3787,3.7018572825024436,20.0,20.0
11023,1,1023,[127 187 302 191 318],90,5,3792,3.703125,20.0,20.0
11024,1,1024,[  4  69 118 288 173],882,4,3796,3.7034146341463416,0.0,0.0
11025,1,1025,[ 22  11 748 194 182],64,4,3800,3.7037037037037037,0.0,0.0
11026,1,1026,[168 151 121 318  12],537,2,3802,3.7020447906523857,40.0,0.0
11027,1,1027,[200  88  70 748 423],543,3,3805,3.7013618677042803,0.0,0.0
11028,1,1028,[211 234 197 153 313],738,4,3809,3.7016520894071916,0.0,0.0
11029,1,1029,[127 187 318 302 191],343,5,3814,3.702912621359223,20.0,20.0
11030,1,1030,[127 187 318 302 191],664,4,3818,3.703200775945684,20.0,20.0
11031,1,1031,[127 187 318 302  50],474,5,3823,3.7044573643410854,20.0,40.0
11032,1,1032,[603  95 597  28 245],804,3,3826,3.70377541142304,20.0,0.0
11033,1,1033,[127 187 318 302  50],537,5,3831,3.7050290135396517,20.0,40.0
11034,1,1034,[194 186 181 168 191],506,5,3836,3.706280193236715,0.0,0.0
11035,1,1035,[127 187 318 302  50],328,5,3841,3.7075289575289574,20.0,40.0
11036,1,1036,[144 515 196 121 172],387,2,3843,3.7058823529411766,0.0,0.0
11037,1,1037,[168  56 300 195 144],749,4,3847,3.7061657032755297,0.0,0.0
11038,1,1038,[127 187 318 302  50],474,5,3852,3.707410972088547,20.0,40.0
11039,1,1039,[211 195 179 176 187],833,3,3855,3.706730769230769,0.0,0.0
11040,1,1040,[275  28 273 300  50],13,2,3857,3.7050912584053792,0.0,20.0
11041,1,1041,[603 100 427  96  89],666,4,3861,3.7053742802303264,20.0,20.0
11042,1,1042,[127 187 318 302  50],6,5,3866,3.706615532118888,20.0,40.0
11043,1,1043,[ 12 127 216 258  69],537,2,3868,3.7049808429118776,20.0,20.0
11044,1,1044,[168 143 508 515 655],406,1,3869,3.7023923444976075,0.0,0.0
11045,1,1045,[655 328 216 313 153],378,4,3873,3.702676864244742,0.0,0.0
11046,1,1046,[427 222 183 168 588],42,4,3877,3.702960840496657,0.0,0.0
11047,1,1047,[127 187 318 302  50],271,5,3882,3.704198473282443,20.0,40.0
11048,1,1048,[127 187 318 302  50],334,5,3887,3.7054337464251668,20.0,40.0
11049,1,1049,[127 187 318 302  50],13,4,3891,3.7057142857142855,20.0,40.0
11050,1,1050,[127 187 302  50 318],13,4,3895,3.7059942911512844,20.0,40.0
11051,1,1051,[275 168 191 515 435],64,5,3900,3.7072243346007605,0.0,0.0
11052,1,1052,[288 185 144 132 742],804,4,3904,3.707502374169041,0.0,0.0
11053,1,1053,[127 187 302  50 191],271,5,3909,3.708728652751423,0.0,40.0
11054,1,1054,[127 187  50 302 191],666,4,3913,3.709004739336493,0.0,40.0
11055,1,1055,[127 187 302 191  50],334,5,3918,3.710227272727273,0.0,40.0
11056,1,1056,[127 187 302  50 191],474,5,3923,3.7114474929044468,0.0,40.0
11057,1,1057,[197  96 111 496   1],234,2,3925,3.7098298676748582,0.0,0.0
11058,1,1058,[127 187 302  50 191],271,5,3930,3.7110481586402266,0.0,40.0
11059,1,1059,[127  97 202 187 427],271,5,3935,3.7122641509433962,0.0,20.0
11060,1,1060,[471 161 216  82 200],374,5,3940,3.713477851083883,0.0,0.0
11061,1,1061,[127 187 302  50 191],360,5,3945,3.714689265536723,0.0,40.0
11062,1,1062,[127 187 302  50 191],144,4,3949,3.7149576669802444,0.0,40.0
11063,1,1063,[276 173 313   7 191],92,4,3953,3.7152255639097747,0.0,0.0
11064,1,1064,[111 237  88 265 161],543,5,3958,3.716431924882629,0.0,0.0
11065,1,1065,[ 64 265 135  12 423],13,5,3963,3.717636022514071,20.0,0.0
11066,1,1066,[161  97 191 182 100],194,3,3966,3.7169634489222116,0.0,20.0
11067,1,1067,[275 186 121  71 546],298,3,3969,3.716292134831461,0.0,0.0
11068,1,1068,[204 180 176 191 127],13,3,3972,3.715622076707203,0.0,20.0
11069,1,1069,[127 187 302  50 191],524,5,3977,3.716822429906542,0.0,40.0
11070,1,1070,[127 187 302  50 191],334,5,3982,3.7180205415499534,0.0,40.0
11071,1,1071,[180 100 403   8 265],13,4,3986,3.718283582089552,0.0,20.0
11072,1,1072,[127 187 302  50 191],339,5,3991,3.7194780987884437,0.0,40.0
11073,1,1073,[265 313 197 300 568],64,3,3994,3.718808193668529,0.0,0.0
11074,1,1074,[127 187 302  50 191],334,5,3999,3.72,0.0,40.0
11075,1,1075,[127 187 302  50 191],339,5,4004,3.721189591078067,0.0,40.0
11076,1,1076,[238 742 268 174  96],189,4,4008,3.721448467966574,0.0,20.0
11077,1,1077,[127 187  50 302 191],664,4,4012,3.7217068645640072,0.0,40.0
11078,1,1078,[127 187  50 302 483],524,5,4017,3.7228915662650603,20.0,40.0
11079,1,1079,[257 288  88 180  97],533,2,4019,3.721296296296296,0.0,0.0
11080,1,1080,[238  96 202 187 403],7,4,4023,3.721554116558742,0.0,0.0
11081,1,1081,[127 187  50 302 483],210,5,4028,3.722735674676525,20.0,40.0
11082,1,1082,[127 187  50 302 483],343,5,4033,3.723915050784857,20.0,40.0
11083,1,1083,[174  96 742 191 568],524,4,4037,3.724169741697417,0.0,20.0
11084,1,1084,[475 175 172  64 237],13,4,4041,3.7244239631336407,0.0,0.0
11085,1,1085,[588 483 143   1 237],298,5,4046,3.7255985267034992,20.0,0.0
11086,1,1086,[127 187  50 483 302],458,4,4050,3.7258509659613614,20.0,40.0
11087,1,1087,[127 187 483 302  50],13,5,4055,3.7270220588235294,20.0,40.0
11088,1,1088,[127 187 483 302  50],458,4,4059,3.727272727272727,20.0,40.0
11089,1,1089,[ 12 403 144 357 176],328,4,4063,3.7275229357798163,40.0,0.0
11090,1,1090,[127 187 483 302  98],210,5,4068,3.7286892758936756,20.0,40.0
11091,1,1091,[127 187 483 302  98],334,5,4073,3.72985347985348,20.0,40.0
11092,1,1092,[127 187 483 302  98],458,4,4077,3.7301006404391583,20.0,40.0
11093,1,1093,[127 187 483 302 191],474,5,4082,3.7312614259597807,20.0,20.0
11094,1,1094,[127 187 483 302 191],474,5,4087,3.732420091324201,20.0,20.0
11095,1,1095,[282 196 183 182 273],666,2,4089,3.730839416058394,0.0,0.0
11096,1,1096,[357 234 288  22 153],343,3,4092,3.7301731996353693,20.0,0.0
11097,1,1097,[127 187 483 302 191],343,5,4097,3.731329690346084,20.0,20.0
11098,1,1098,[ 88 153   1  11  95],308,5,4102,3.732484076433121,0.0,0.0
11099,1,1099,[185  79 568 403 357],379,5,4107,3.7336363636363634,20.0,0.0
11100,1,1100,[238 333 127 211 275],13,2,4109,3.732061762034514,0.0,20.0
11101,1,1101,[127 187 483 302 191],334,5,4114,3.733212341197822,20.0,20.0
11102,1,1102,[173 161 288 153 742],387,2,4116,3.731640979147779,0.0,0.0
11103,1,1103,[191  98 127 195 288],7,5,4121,3.732789855072464,0.0,40.0
11104,1,1104,[194 275 180 258   1],271,3,4124,3.7321266968325792,0.0,0.0
11105,1,1105,[127 187 483 302 191],90,5,4129,3.733273056057866,20.0,20.0
11106,1,1106,[216 294 515 179   7],406,2,4131,3.731707317073171,0.0,0.0
11107,1,1107,[183 328 546 385 135],207,0,4131,3.7283393501805056,0.0,0.0
11108,1,1108,[385  50 496 318 483],313,5,4136,3.7294860234445446,40.0,20.0
11109,1,1109,[127 187 483 302 191],13,4,4140,3.72972972972973,20.0,20.0
11110,1,1110,[176 655 179 132 237],13,3,4143,3.729072907290729,0.0,0.0
11111,1,1111,[127 187 483 302  50],360,5,4148,3.7302158273381294,20.0,40.0
11112,1,1112,[ 98  11 202 275  15],145,3,4151,3.729559748427673,0.0,20.0
11113,1,1113,[196 323  12 187 117],669,2,4153,3.728007181328546,20.0,0.0
11114,1,1114,[127 187 483 302  50],458,4,4157,3.7282511210762332,20.0,40.0
11115,1,1115,[127 187 483 302 191],605,5,4162,3.729390681003584,20.0,20.0
11116,1,1116,[127 187 483 302 191],666,5,4167,3.730528200537153,20.0,20.0
11117,1,1117,[ 50  96  82 197  11],234,2,4169,3.728980322003578,0.0,20.0
11118,1,1118,[  9  98 186 403  12],308,4,4173,3.7292225201072386,20.0,20.0
11119,1,1119,[100 568  56 588 194],881,2,4175,3.7276785714285716,0.0,20.0
11120,1,1120,[176 180 228 175 471],92,5,4180,3.7288135593220337,0.0,0.0
11121,1,1121,[127 187 483 302 191],207,5,4185,3.729946524064171,20.0,20.0
11122,1,1122,[175  88 176 132 300],537,1,4186,3.727515583259127,0.0,0.0
11123,1,1123,[655 508 515  88 121],13,3,4189,3.7268683274021353,0.0,0.0
11124,1,1124,[127 187 483 302 191],13,4,4193,3.7271111111111113,20.0,20.0
11125,1,1125,[117 294  82 135 161],194,2,4195,3.725577264653641,0.0,0.0
11126,1,1126,[288  69 508 132 269],13,2,4197,3.7240461401952083,0.0,0.0
11127,1,1127,[237  88   1 179  22],194,3,4200,3.723404255319149,0.0,0.0
11128,1,1128,[127 187 483 302 318],207,5,4205,3.724534986713906,40.0,20.0
11129,1,1129,[ 50 153 191 117  82],454,3,4208,3.7238938053097344,0.0,20.0
11130,1,1130,[597  50 118 515 286],213,4,4212,3.7241379310344827,0.0,20.0
11131,1,1131,[172 748  79 496 288],64,4,4216,3.724381625441696,0.0,0.0
11132,1,1132,[238 515 471 235 117],145,5,4221,3.7255075022065314,0.0,0.0
11133,1,1133,[127 187 483 302 318],90,5,4226,3.72663139329806,40.0,20.0
11134,1,1134,[174 194  96 273 483],749,5,4231,3.7277533039647577,20.0,20.0
11135,1,1135,[603 175 121 268 216],669,2,4233,3.726232394366197,20.0,0.0
11136,1,1136,[127 187 483 302 318],90,5,4238,3.727352682497801,40.0,20.0
11137,1,1137,[483 423 200   9  96],749,4,4242,3.727592267135325,20.0,0.0
11138,1,1138,[ 25 135 183 237  71],378,4,4246,3.7278314310798946,0.0,0.0
11139,1,1139,[ 95  71 191 427 204],6,3,4249,3.7271929824561405,0.0,0.0
11140,1,1140,[ 98 483   1 471 423],343,5,4254,3.728308501314636,20.0,20.0
11141,1,1141,[100   9 276 194 496],378,4,4258,3.7285464098073553,0.0,20.0
11142,1,1142,[237 168 265 125 276],298,3,4261,3.7279090113735784,0.0,0.0
11143,1,1143,[ 11 127 238 333 168],881,3,4264,3.727272727272727,0.0,20.0
11144,1,1144,[405 237   8 151 257],883,3,4267,3.7266375545851527,0.0,0.0
11145,1,1145,[ 22  98 275 161  15],821,5,4272,3.7277486910994764,0.0,20.0
11146,1,1146,[127 405 121 151 288],486,3,4275,3.727114210985179,0.0,20.0
11147,1,1147,[ 22 215 174 294 515],774,0,4275,3.7238675958188154,0.0,20.0
11148,1,1148,[127 187 483 302 427],339,5,4280,3.7249782419495214,20.0,20.0
11149,1,1149,[ 64 175 144 194 282],666,2,4282,3.723478260869565,0.0,0.0
11150,1,1150,[ 25 195 181  22 173],804,5,4287,3.7245873153779323,0.0,0.0
11151,1,1151,[161  64 186 179  69],749,4,4291,3.724826388888889,0.0,0.0
11152,1,1152,[127 187 483 302 427],90,5,4296,3.7259323503902864,20.0,20.0
11153,1,1153,[153 151 135 276 183],378,3,4299,3.7253032928942806,0.0,0.0
11154,1,1154,[127 187 483 302 427],6,5,4304,3.7264069264069266,20.0,20.0
11155,1,1155,[127 187 483 302 427],13,5,4309,3.7275086505190314,20.0,20.0
11156,1,1156,[153 175 245 655 271],92,4,4313,3.727744165946413,0.0,0.0
11157,1,1157,[127 187 483 302 427],13,5,4318,3.7288428324697755,20.0,20.0
11158,1,1158,[127 187 483 302 427],334,5,4323,3.729939603106126,20.0,20.0
11159,1,1159,[127 187 483 302 427],334,5,4328,3.731034482758621,20.0,20.0
11160,1,1160,[603 185 508 183 234],326,3,4331,3.730404823428079,20.0,0.0
11161,1,1161,[179 194 269 143 265],312,4,4335,3.7306368330464714,0.0,0.0
11162,1,1162,[127 187 483 427 302],664,5,4340,3.7317282889079966,20.0,20.0
11163,1,1163,[127 187 483 427 302],13,5,4345,3.7328178694158076,20.0,20.0
11164,1,1164,[265 181  11  69 496],234,2,4347,3.7313304721030045,0.0,0.0
11165,1,1165,[172 742 125 568 289],533,4,4351,3.7315608919382504,0.0,0.0
11166,1,1166,[127 187 483 427 302],833,3,4354,3.7309340188517566,20.0,20.0
11167,1,1167,[180  82  25 161 191],207,3,4357,3.7303082191780823,0.0,0.0
11168,1,1168,[127 187 483 302 318],524,5,4362,3.7313943541488452,40.0,20.0
11169,1,1169,[127 187 483 302 318],343,5,4367,3.7324786324786325,40.0,20.0
11170,1,1170,[127 187 483 302 318],474,5,4372,3.7335610589239967,40.0,20.0
11171,1,1171,[168  79 186  70 423],795,1,4373,3.7312286689419794,0.0,0.0
11172,1,1172,[127 187 483 302 318],334,5,4378,3.73231031543052,40.0,20.0
11173,1,1173,[127 187 483 302 318],537,5,4383,3.733390119250426,40.0,20.0
11174,1,1174,[ 12 302 204 322 405],328,3,4386,3.7327659574468086,20.0,0.0
11175,1,1175,[405 603 174 403 204],60,4,4390,3.7329931972789114,20.0,20.0
11176,1,1176,[ 82 237 172 483 187],804,5,4395,3.734069668649108,20.0,0.0
11177,1,1177,[144 471  28 245 185],666,2,4397,3.732597623089983,0.0,0.0
11178,1,1178,[185 186 194 423 153],326,4,4401,3.732824427480916,0.0,0.0
11179,1,1179,[ 82 183 546 181 403],102,1,4402,3.730508474576271,0.0,0.0
11180,1,1180,[195  64 180 318 118],7,4,4406,3.7307366638442,20.0,0.0
11181,1,1181,[427 471 132 357 187],666,5,4411,3.7318104906937393,20.0,0.0
11182,1,1182,[ 88 597 121 180 333],533,3,4414,3.731191885038039,0.0,0.0
11183,1,1183,[  1 748 143 483 286],533,4,4418,3.731418918918919,20.0,0.0
11184,1,1184,[127 187 483 302 318],458,5,4423,3.7324894514767935,40.0,20.0
11185,1,1185,[180 182 568 168   4],7,5,4428,3.7335581787521077,0.0,0.0
11186,1,1186,[427 483 200  79 176],334,4,4432,3.733782645324347,20.0,0.0
11187,1,1187,[127 187 483 302 318],458,5,4437,3.734848484848485,40.0,20.0
11188,1,1188,[127 187 483 302 318],334,5,4442,3.7359125315391086,40.0,20.0
11189,1,1189,[127 187 483 302 318],666,5,4447,3.7369747899159664,40.0,20.0
11190,1,1190,[515 172 385 235   7],524,1,4448,3.7346767422334173,0.0,0.0
11191,1,1191,[276 288 216 185 318],474,4,4452,3.7348993288590604,20.0,0.0
11192,1,1192,[471 174  28 597 168],92,3,4455,3.7342833193629503,0.0,20.0
11193,1,1193,[127 187 483 302 318],524,5,4460,3.7353433835845897,40.0,20.0
11194,1,1194,[200 483 603 185  69],60,5,4465,3.7364016736401675,40.0,0.0
11195,1,1195,[496 194 222  97 333],64,3,4468,3.7357859531772575,0.0,0.0
11196,1,1196,[127 187 483 302 318],334,5,4473,3.736842105263158,40.0,20.0
11197,1,1197,[748 288 186 234 357],648,3,4476,3.7362270450751254,20.0,0.0
11198,1,1198,[151 127 238 294  95],537,2,4478,3.7347789824854045,0.0,20.0
11199,1,1199,[127 187 483 302 318],13,4,4482,3.735,40.0,20.0
11200,1,1200,[215 546 125 655 144],234,0,4482,3.7318900915903415,0.0,0.0
11201,1,1201,[ 89 197 357 603 181],840,4,4486,3.7321131447587352,40.0,0.0
11202,1,1202,[ 70 181 121 172 483],474,5,4491,3.733167082294264,20.0,0.0
11203,1,1203,[427 588 234 187 508],85,2,4493,3.7317275747508307,0.0,0.0
11204,1,1204,[300   8  69 143 405],379,3,4496,3.7311203319502075,0.0,0.0
11205,1,1205,[127 187 483 302 318],328,5,4501,3.732172470978441,40.0,20.0
11206,1,1206,[127 187 483 302 318],524,5,4506,3.7332228666114333,40.0,20.0
11207,1,1207,[ 28 181 202 182 176],313,4,4510,3.7334437086092715,0.0,0.0
11208,1,1208,[173 182 100 245  64],92,4,4514,3.7336641852770884,0.0,20.0
11209,1,1209,[216 588 238   7  96],650,4,4518,3.733884297520661,0.0,0.0
11210,1,1210,[475 268 174 238  95],13,3,4521,3.7332782824112303,0.0,20.0
11211,1,1211,[322 275 286 215 300],13,1,4522,3.731023102310231,0.0,0.0
11212,1,1212,[127 187 483 302 318],328,5,4527,3.7320692497938994,40.0,20.0
11213,1,1213,[196 427 276   9 423],339,4,4531,3.732289950576606,0.0,0.0
11214,1,1214,[195  15 151 483 286],479,3,4534,3.731687242798354,20.0,0.0
11215,1,1215,[127 483 187 302 318],334,5,4539,3.7327302631578947,40.0,20.0
11216,1,1216,[294 302 271 222 508],676,3,4542,3.732128184059162,0.0,0.0
11217,1,1217,[228 173 151 403 313],234,1,4543,3.7298850574712645,0.0,0.0
11218,1,1218,[127 483 187 302 318],343,5,4548,3.730926989335521,40.0,20.0
11219,1,1219,[186 196 161 100  56],339,4,4552,3.7311475409836063,0.0,20.0
11220,1,1220,[235 568  25  96 403],804,4,4556,3.7313677313677314,0.0,0.0
11221,1,1221,[144 597   1 289 294],92,2,4558,3.729950900163666,0.0,0.0
11222,1,1222,[127 483 187 302 318],6,5,4563,3.7309893704006543,40.0,20.0
11223,1,1223,[195 322 271 127 222],883,3,4566,3.730392156862745,0.0,20.0
11224,1,1224,[515 100 435 385 135],7,4,4570,3.730612244897959,0.0,20.0
11225,1,1225,[117 180 111  15  98],653,2,4572,3.729200652528548,0.0,20.0
11226,1,1226,[127 483 187 302 318],474,5,4577,3.7302363488182557,40.0,20.0
11227,1,1227,[568 742 257 228 258],749,4,4581,3.730456026058632,0.0,0.0
11228,1,1228,[127 483 187 302 318],90,5,4586,3.7314890154597236,40.0,20.0
11229,1,1229,[  7 127  50 322  69],881,3,4589,3.7308943089430895,0.0,40.0
11230,1,1230,[127 483 187 302 318],664,5,4594,3.7319252640129976,40.0,20.0
11231,1,1231,[742  96 100 181 202],666,2,4596,3.7305194805194803,0.0,20.0
11232,1,1232,[127 483 187 302 318],524,5,4601,3.7315490673154907,40.0,20.0
11233,1,1233,[127 483 187 302 318],605,5,4606,3.73257698541329,40.0,20.0
11234,1,1234,[588 508  89 427   7],59,4,4610,3.7327935222672064,0.0,0.0
11235,1,1235,[202 185 568 168 748],882,5,4615,3.733818770226537,0.0,0.0
11236,1,1236,[127 483 187 302 318],458,5,4620,3.734842360549717,40.0,20.0
11237,1,1237,[ 12 405 144 211  50],379,4,4624,3.7350565428109856,20.0,20.0
11238,1,1238,[  8 215  89 357 121],840,4,4628,3.735270379338176,20.0,0.0
11239,1,1239,[  1 191 151 180 286],648,2,4630,3.7338709677419355,0.0,0.0
11240,1,1240,[235 216  50 181 318],87,4,4634,3.734085414987913,20.0,20.0
11241,1,1241,[127 483 187 302 318],605,5,4639,3.7351046698872787,40.0,20.0
11242,1,1242,[143 176 238 182 678],13,1,4640,3.7329042638777152,0.0,0.0
11243,1,1243,[ 69 597 216 286 118],378,3,4643,3.732315112540193,0.0,0.0
11244,1,1244,[268 117  28 168 271],13,3,4646,3.731726907630522,0.0,0.0
11245,1,1245,[127 483 187 302 318],13,4,4650,3.7319422150882824,40.0,20.0
11246,1,1246,[127 483 187 302 318],474,5,4655,3.732959101844427,40.0,20.0
11247,1,1247,[118 588 202  50 168],892,5,4660,3.733974358974359,0.0,20.0
11248,1,1248,[127 483 187 302 318],664,5,4665,3.7349879903923138,40.0,20.0
11249,1,1249,[  1 204 132 182 496],194,3,4668,3.7344,0.0,0.0
11250,1,1250,[328  56 211  98 471],537,2,4670,3.733013589128697,0.0,20.0
11251,1,1251,[ 56 132  97 238 180],474,5,4675,3.734025559105431,0.0,0.0
11252,1,1252,[ 98  69 742 546 597],308,1,4676,3.7318435754189943,0.0,20.0
11253,1,1253,[ 11 200 111  64 135],271,5,4681,3.7328548644338118,0.0,0.0
11254,1,1254,[173 196 168 174 597],882,5,4686,3.7338645418326695,0.0,20.0
11255,1,1255,[127 483 187 302 318],90,5,4691,3.734872611464968,40.0,20.0
11256,1,1256,[655 301 182 174 318],788,1,4692,3.7326968973747015,20.0,20.0
11257,1,1257,[234 197  11 215 588],406,4,4696,3.7329093799682034,0.0,0.0
11258,1,1258,[185 265  25 405 180],804,5,4701,3.733915806195393,0.0,0.0
11259,1,1259,[ 97 475 222  69 132],343,5,4706,3.734920634920635,0.0,0.0
11260,1,1260,[385  69  56  50 191],659,3,4709,3.7343378271213323,0.0,20.0
11261,1,1261,[111 300  79  88 435],13,3,4712,3.733755942947702,0.0,0.0
11262,1,1262,[127 483 187 302 318],605,5,4717,3.7347585114806017,40.0,20.0
11263,1,1263,[185 300 175 187 515],334,4,4721,3.7349683544303796,0.0,0.0
11264,1,1264,[172  98 234  25 204],92,4,4725,3.7351778656126484,0.0,20.0
11265,1,1265,[127 483 187 302 318],605,5,4730,3.736176935229068,40.0,20.0
11266,1,1266,[ 50 183  64 471 121],666,3,4733,3.7355958958168904,0.0,20.0
11267,1,1267,[194 132 204  79 168],234,2,4735,3.7342271293375395,0.0,0.0
11268,1,1268,[168 269 289 197  15],537,2,4737,3.7328605200945626,0.0,0.0
11269,1,1269,[234   9 237 176 185],13,2,4739,3.731496062992126,0.0,0.0
11270,1,1270,[127 483 187 302 318],6,5,4744,3.7324940991345397,40.0,20.0
11271,1,1271,[423 211  28 748 294],13,4,4748,3.7327044025157234,0.0,0.0
11272,1,1272,[181 403 180 161 333],346,3,4751,3.732128829536528,0.0,0.0
11273,1,1273,[127 483 187 302 318],207,5,4756,3.7331240188383044,40.0,20.0
11274,1,1274,[127 483 187 302 318],666,5,4761,3.7341176470588233,40.0,20.0
11275,1,1275,[  9 215 143 132 180],881,2,4763,3.7327586206896552,0.0,0.0
11276,1,1276,[182   7 323  95 603],650,2,4765,3.731401722787784,20.0,0.0
11277,1,1277,[127 483 187 302 318],458,5,4770,3.732394366197183,40.0,20.0
11278,1,1278,[  4 288 132  98 200],537,0,4770,3.7294761532447223,0.0,20.0
11279,1,1279,[179 153 568 238  28],378,3,4773,3.72890625,0.0,0.0
11280,1,1280,[186  95 496  98 237],664,4,4777,3.72911787665886,0.0,20.0
11281,1,1281,[187 333 228 222 275],343,4,4781,3.7293291731669265,0.0,0.0
11282,1,1282,[  9 385 228  22  56],234,1,4782,3.7272018706157444,0.0,0.0
11283,1,1283,[127 483 187 302 318],537,5,4787,3.7281931464174454,40.0,20.0
11284,1,1284,[211  12 435 183 186],387,3,4790,3.727626459143969,20.0,0.0
11285,1,1285,[168 237 197 179 216],334,4,4794,3.7278382581648524,0.0,0.0
11286,1,1286,[127 143 423  96 282],95,5,4799,3.728826728826729,0.0,20.0
11287,1,1287,[ 98 216 181 100 742],144,5,4804,3.729813664596273,0.0,40.0
11288,1,1288,[135 286 172 121 322],533,4,4808,3.730023273855702,0.0,0.0
11289,1,1289,[322 228 405 173 655],92,2,4810,3.7286821705426356,0.0,0.0
11290,1,1290,[ 98  22 176 483 194],749,5,4815,3.7296669248644463,20.0,20.0
11291,1,1291,[127 483 187 302 318],207,5,4820,3.7306501547987616,40.0,20.0
11292,1,1292,[ 22 135  97   7  56],650,2,4822,3.7293116782675946,0.0,0.0
11293,1,1293,[161 151  28 168 427],380,4,4826,3.7295208655332304,0.0,0.0
11294,1,1294,[271 210  88 202  71],506,5,4831,3.7305019305019305,0.0,0.0
11295,1,1295,[  7 100  89 546 235],650,3,4834,3.7299382716049383,0.0,20.0
11296,1,1296,[276 216 187 238  69],311,5,4839,3.730917501927525,0.0,0.0
11297,1,1297,[127 483 187 302 318],90,5,4844,3.731895223420647,40.0,20.0
11298,1,1298,[127 483 187 302 318],6,5,4849,3.7328714395688993,40.0,20.0
11299,1,1299,[ 82 515 357  25  22],207,3,4852,3.732307692307692,20.0,0.0
11300,1,1300,[546  70 275  95 100],554,3,4855,3.7317448116833205,0.0,20.0
11301,1,1301,[144  96  95  89 276],378,5,4860,3.7327188940092166,0.0,0.0
11302,1,1302,[127 483 187 302 318],334,5,4865,3.733691481197237,40.0,20.0
11303,1,1303,[357 289 211 191 216],234,3,4868,3.733128834355828,20.0,0.0
11304,1,1304,[471 176 238  88  69],145,5,4873,3.7340996168582374,0.0,0.0
11305,1,1305,[127 483 187 302 318],343,5,4878,3.7350689127105667,40.0,20.0
11306,1,1306,[204 186  98  64 144],215,4,4882,3.735271614384086,0.0,20.0
11307,1,1307,[127 483 187 302 318],334,5,4887,3.7362385321100917,40.0,20.0
11308,1,1308,[135  64 265 176 125],234,2,4889,3.7349121466768525,0.0,0.0
11309,1,1309,[  4  97 194 183  69],308,3,4892,3.734351145038168,0.0,0.0
11310,1,1310,[127 483 187 302 318],6,5,4897,3.7353165522501905,40.0,20.0
11311,1,1311,[127 483 187 302 318],605,5,4902,3.736280487804878,40.0,20.0
11312,1,1312,[288 568 300 222 235],119,5,4907,3.7372429550647372,0.0,0.0
11313,1,1313,[ 71  11 323 216 200],59,4,4911,3.7374429223744294,0.0,0.0
11314,1,1314,[588  15  11  88 234],234,1,4912,3.735361216730038,0.0,0.0
11315,1,1315,[181 568  79  96 179],897,3,4915,3.7348024316109423,0.0,0.0
11316,1,1316,[405  79 294 655 191],194,3,4918,3.734244495064541,0.0,0.0
11317,1,1317,[  9 182 175  50 238],64,5,4923,3.735204855842185,0.0,20.0
11318,1,1318,[322 288 286 238 121],474,4,4927,3.7354056103108415,0.0,0.0
11319,1,1319,[ 28 118 183 211  69],653,2,4929,3.734090909090909,0.0,0.0
11320,1,1320,[ 95 286 197 202  70],271,5,4934,3.7350492051476154,0.0,0.0
11321,1,1321,[ 82 546 153 597 172],95,2,4936,3.7337367624810893,0.0,0.0
11322,1,1322,[216 185  70 173   1],804,5,4941,3.7346938775510203,0.0,0.0
11323,1,1323,[195 546 427  15 603],533,4,4945,3.734894259818731,20.0,0.0
11324,1,1324,[117 748 182  89 245],92,4,4949,3.7350943396226417,0.0,0.0
11325,1,1325,[127 196 121 301  71],184,3,4952,3.7345399698340875,0.0,20.0
11326,1,1326,[ 98 174 132 258 186],533,4,4956,3.73474001507159,0.0,40.0
11327,1,1327,[127 483 187 302 318],524,5,4961,3.7356927710843375,40.0,20.0
11328,1,1328,[127 483 187 302 318],207,5,4966,3.7366440933032354,40.0,20.0
11329,1,1329,[405 475 183 197  71],334,3,4969,3.7360902255639097,0.0,0.0
11330,1,1330,[ 11 174 194  28 276],308,4,4973,3.736288504883546,0.0,20.0
11331,1,1331,[127 483 187 302 318],524,5,4978,3.7372372372372373,40.0,20.0
11332,1,1332,[748  98 132 568 271],64,3,4981,3.7366841710427607,0.0,20.0
11333,1,1333,[127 483 187 302 318],458,5,4986,3.737631184407796,40.0,20.0
11334,1,1334,[ 97 322 197 174 195],313,4,4990,3.737827715355805,0.0,20.0
11335,1,1335,[127 483 187 302 318],605,5,4995,3.7387724550898205,40.0,20.0
11336,1,1336,[202 237 435 265 655],899,4,4999,3.738967838444278,0.0,0.0
11337,1,1337,[ 69 546 318 143  56],207,4,5003,3.7391629297458895,20.0,0.0
11338,1,1338,[237 195 269 275 300],537,1,5004,3.7371172516803584,0.0,0.0
11339,1,1339,[127 483 187 302 318],13,4,5008,3.737313432835821,40.0,20.0
11340,1,1340,[127 483 187 302 318],343,5,5013,3.738255033557047,40.0,20.0
11341,1,1341,[186 172  79 151 328],334,2,5015,3.7369597615499255,0.0,0.0
11342,1,1342,[118 742 216 258   8],313,2,5017,3.7356664184661206,0.0,0.0
11343,1,1343,[ 82 204 515 210 216],883,4,5021,3.7358630952380953,0.0,0.0
11344,1,1344,[127 483 187 302 318],524,5,5026,3.7368029739776953,40.0,20.0
11345,1,1345,[127 483 187 302 318],458,5,5031,3.737741456166419,40.0,20.0
11346,1,1346,[202 151 211 271 265],290,2,5033,3.7364513734224203,0.0,0.0
11347,1,1347,[127 483 187 302 318],90,5,5038,3.7373887240356085,40.0,20.0
11348,1,1348,[172   1 678 323 742],648,4,5042,3.737583395107487,0.0,0.0
11349,1,1349,[127 483 187 302 318],207,5,5047,3.7385185185185184,40.0,20.0
11350,1,1350,[172  95 194 289 173],524,3,5050,3.7379718726868987,0.0,0.0
11351,1,1351,[204 181 135 546 273],749,4,5054,3.7381656804733727,0.0,0.0
11352,1,1352,[182  56  15 153  79],308,4,5058,3.738359201773836,0.0,0.0
11353,1,1353,[186 427 135   1 144],379,5,5063,3.7392909896602657,0.0,0.0
11354,1,1354,[175 357  82 202 127],653,3,5066,3.7387453874538745,20.0,20.0
11355,1,1355,[204 568 328 202  15],95,5,5071,3.739675516224189,0.0,0.0
11356,1,1356,[181 185 403 191  88],881,3,5074,3.739130434782609,0.0,0.0
11357,1,1357,[181   9 202  56 125],59,4,5078,3.739322533136966,0.0,0.0
11358,1,1358,[127 483 187 302 318],524,5,5083,3.740250183958793,40.0,20.0
11359,1,1359,[588 655  56 173 427],85,1,5084,3.738235294117647,0.0,0.0
11360,1,1360,[286 655 318 289 187],85,3,5087,3.7376928728875827,20.0,0.0
11361,1,1361,[318  22 191  11 276],234,3,5090,3.737151248164464,20.0,0.0
11362,1,1362,[121 186 196  50 100],346,2,5092,3.735876742479824,0.0,40.0
11363,1,1363,[191 143   7 197 228],843,2,5094,3.7346041055718473,0.0,0.0
11364,1,1364,[237 405 357  15  70],184,3,5097,3.734065934065934,20.0,0.0
11365,1,1365,[127 483 187 302 318],474,5,5102,3.7349926793557833,40.0,20.0
11366,1,1366,[289 405  22 125 288],378,2,5104,3.7337234820775422,0.0,0.0
11367,1,1367,[127 483 187 302 318],666,5,5109,3.7346491228070176,40.0,20.0
11368,1,1368,[127 483 187 302 318],664,5,5114,3.735573411249087,40.0,20.0
11369,1,1369,[ 95 196 181 100 182],308,4,5118,3.7357664233576644,0.0,20.0
11370,1,1370,[127 483 187 302 318],13,4,5122,3.735959153902261,40.0,20.0
11371,1,1371,[127 483 187 302 318],6,5,5127,3.736880466472303,40.0,20.0
11372,1,1372,[143 172 678 322 181],334,1,5128,3.7348871085214856,0.0,0.0
11373,1,1373,[127 483 187 302 318],666,5,5133,3.7358078602620086,40.0,20.0
11374,1,1374,[127 483 187 302 318],207,5,5138,3.736727272727273,40.0,20.0
11375,1,1375,[135  15 385   1 357],488,4,5142,3.7369186046511627,20.0,0.0
11376,1,1376,[127 483 187 302 318],6,5,5147,3.737835875090777,40.0,20.0
11377,1,1377,[175 215 475 515  97],343,5,5152,3.7387518142235123,0.0,0.0
11378,1,1378,[195 186 265 175 121],92,5,5157,3.7396664249456126,0.0,0.0
11379,1,1379,[483 237 132  50 228],343,5,5162,3.7405797101449276,20.0,20.0
11380,1,1380,[127 483 187 302 318],458,5,5167,3.7414916727009415,40.0,20.0
11381,1,1381,[ 25 288 323 181 127],13,2,5169,3.740231548480463,0.0,20.0
11382,1,1382,[194 237  79 435 427],7,5,5174,3.7411424439624006,0.0,0.0
11383,1,1383,[127 483 187 302 318],328,5,5179,3.742052023121387,40.0,20.0
11384,1,1384,[127 483 187 302 318],666,5,5184,3.742960288808664,40.0,20.0
11385,1,1385,[127 483 187 302 318],666,5,5189,3.743867243867244,40.0,20.0
11386,1,1386,[127 483 187 302 318],13,4,5193,3.744051910598414,40.0,20.0
11387,1,1387,[289 215 185 275   9],271,4,5197,3.744236311239193,0.0,0.0
11388,1,1388,[127 483 187 302 318],458,5,5202,3.7451403887688985,40.0,20.0
11389,1,1389,[127 483 187 302 318],666,5,5207,3.746043165467626,40.0,20.0
11390,1,1390,[183 182 176  50   7],659,3,5210,3.745506829618979,0.0,20.0
11391,1,1391,[191 588 204  98 181],194,4,5214,3.7456896551724137,0.0,20.0
11392,1,1392,[ 22 197 222  88 121],13,4,5218,3.745872218234027,0.0,0.0
11393,1,1393,[ 96  89 118 183 143],653,2,5220,3.744619799139168,0.0,0.0
11394,1,1394,[127 483 187 302 318],524,5,5225,3.7455197132616487,40.0,20.0
11395,1,1395,[322 301 235 546 475],637,0,5225,3.742836676217765,0.0,0.0
11396,1,1396,[235 127 204 191 288],537,2,5227,3.7415891195418753,0.0,20.0
11397,1,1397,[127 483 187 302 318],13,4,5231,3.7417739628040056,40.0,20.0
11398,1,1398,[127 483 187 302 318],664,5,5236,3.742673338098642,40.0,20.0
11399,1,1399,[127 483 187 302 318],664,5,5241,3.7435714285714288,40.0,20.0
11400,1,1400,[216 357 302  28   4],271,5,5246,3.7444682369735904,20.0,0.0
11401,1,1401,[127 483 187 302 318],334,5,5251,3.745363766048502,40.0,20.0
11402,1,1402,[127 483 187 302 318],90,5,5256,3.7462580185317176,40.0,20.0
11403,1,1403,[216 271 228 435 172],506,5,5261,3.7471509971509973,0.0,0.0
11404,1,1404,[655 125 228 328  50],749,5,5266,3.7480427046263345,0.0,20.0
11405,1,1405,[127 483 187 302 318],6,5,5271,3.7489331436699858,40.0,20.0
11406,1,1406,[127 483 187 302 318],13,4,5275,3.7491115849324803,40.0,20.0
11407,1,1407,[200 215   8 322 181],313,2,5277,3.7478693181818183,0.0,0.0
11408,1,1408,[ 64 328 210 257 111],92,2,5279,3.746628814762243,0.0,0.0
11409,1,1409,[127 483 187 302 318],334,5,5284,3.7475177304964538,40.0,20.0
11410,1,1410,[568 175 405 515 174],883,3,5287,3.746987951807229,0.0,20.0
11411,1,1411,[127 483 187 302 318],524,5,5292,3.7478753541076486,40.0,20.0
11412,1,1412,[187 204 258  88 180],474,5,5297,3.748761500353857,0.0,0.0
11413,1,1413,[127 483 187 302 318],343,5,5302,3.7496463932107496,40.0,20.0
11414,1,1414,[161 546 508 181   9],455,4,5306,3.7498233215547705,0.0,0.0
11415,1,1415,[127 483 187 302 318],343,5,5311,3.7507062146892656,40.0,20.0
11416,1,1416,[ 28 187 125 603 245],313,2,5313,3.749470712773465,20.0,0.0
11417,1,1417,[282  28 235 176 151],406,2,5315,3.7482369534555713,0.0,0.0
11418,1,1418,[127 483 187 302 318],458,5,5320,3.7491190979563074,40.0,20.0
11419,1,1419,[127 483 187 302 318],13,4,5324,3.749295774647887,40.0,20.0
11420,1,1420,[127 483 187 302 318],524,5,5329,3.7501759324419424,40.0,20.0
11421,1,1421,[127 483 187 302 318],474,5,5334,3.7510548523206753,40.0,20.0
11422,1,1422,[ 98 318 196 175 216],653,1,5335,3.7491215741391426,20.0,20.0
11423,1,1423,[ 79 258   7 172 300],774,0,5335,3.746488764044944,0.0,0.0
11424,1,1424,[121 288 143 180 435],666,2,5337,3.745263157894737,0.0,0.0
11425,1,1425,[318  98 210 435 196],7,5,5342,3.7461430575035064,20.0,20.0
11426,1,1426,[546  88 245 195  11],207,0,5342,3.7435178696566225,0.0,0.0
11427,1,1427,[127 483 187 302 318],664,5,5347,3.7443977591036415,40.0,20.0
11428,1,1428,[182 196 238 300 179],234,0,5347,3.741777466759972,0.0,0.0
11429,1,1429,[238 289 508 265 182],537,3,5350,3.7412587412587412,0.0,0.0
11430,1,1430,[127 483 187 302 318],6,5,5355,3.742138364779874,40.0,20.0
11431,1,1431,[194  82 275 216 176],7,3,5358,3.7416201117318435,0.0,0.0
11432,1,1432,[127 483 187 302 318],328,5,5363,3.7424982554082344,40.0,20.0
11433,1,1433,[ 56 508 603   4 435],232,4,5367,3.7426778242677825,20.0,0.0
11434,1,1434,[194 210 186  82 183],385,0,5367,3.74006968641115,0.0,0.0
11435,1,1435,[ 50   4  64 435  71],194,4,5371,3.7402506963788302,0.0,20.0
11436,1,1436,[121 742 328 197  97],653,2,5373,3.7390396659707723,0.0,0.0
11437,1,1437,[187 313 275 300 423],85,3,5376,3.7385257301808066,0.0,0.0
11438,1,1438,[127 483 187 302 318],13,4,5380,3.7387074357192494,40.0,20.0
11439,1,1439,[185 245 181 333 322],329,2,5382,3.7375,0.0,0.0
11440,1,1440,[183 200 435 118 238],650,5,5387,3.7383761276891048,0.0,0.0
11441,1,1441,[210 121  11  22 194],653,3,5390,3.737864077669903,0.0,0.0
11442,1,1442,[127 483 187 302 318],524,5,5395,3.7387387387387387,40.0,20.0
11443,1,1443,[127 200 176 258  50],102,2,5397,3.737534626038781,0.0,40.0
11444,1,1444,[ 79 435 215 423 222],234,1,5398,3.7356401384083044,0.0,0.0
11445,1,1445,[ 71  88 172 237  56],184,3,5401,3.735131396957123,0.0,0.0
11446,1,1446,[483 127 187 302 318],458,5,5406,3.7360055286800278,40.0,20.0
11447,1,1447,[ 12 318 276  11  22],455,2,5408,3.734806629834254,40.0,0.0
11448,1,1448,[117 318 289 508 238],13,0,5408,3.7322291235334712,20.0,0.0
11449,1,1449,[265 496 204 405 655],378,3,5411,3.7317241379310344,0.0,0.0
11450,1,1450,[197 238 174 175 172],308,4,5415,3.731909028256375,0.0,20.0
11451,1,1451,[143  71 265 234 194],59,2,5417,3.7307162534435263,0.0,0.0
11452,1,1452,[508   9 427 222  71],13,2,5419,3.729525120440468,0.0,0.0
11453,1,1453,[172 117 357 483 257],474,4,5423,3.7297111416781292,40.0,0.0
11454,1,1454,[200 333 211 405 121],343,2,5425,3.7285223367697595,0.0,0.0
11455,1,1455,[357 127 161  56 427],234,3,5428,3.728021978021978,20.0,20.0
11456,1,1456,[127 678 117   4 405],334,1,5429,3.7261496225120108,0.0,20.0
11457,1,1457,[ 28 179 597  82 181],897,3,5432,3.7256515775034296,0.0,0.0
11458,1,1458,[ 70 496 313 200 121],537,3,5435,3.7251542152159014,0.0,0.0
11459,1,1459,[179 191 202 301 153],13,2,5437,3.723972602739726,0.0,0.0
11460,1,1460,[483 127 187 302 313],537,5,5442,3.7248459958932236,20.0,20.0
11461,1,1461,[273 328  11 196 322],92,3,5445,3.7243502051983586,0.0,0.0
11462,1,1462,[197 222 257 215 357],653,1,5446,3.722488038277512,20.0,0.0
11463,1,1463,[196   8 186 322 678],488,1,5447,3.7206284153005464,0.0,0.0
11464,1,1464,[ 88 204 748 111  50],92,2,5449,3.7194539249146756,0.0,20.0
11465,1,1465,[475 172 269  50 508],455,5,5454,3.720327421555252,0.0,20.0
11466,1,1466,[483 127 187 302 313],669,4,5458,3.720518064076346,20.0,20.0
11467,1,1467,[403  28 483 288  89],648,5,5463,3.7213896457765667,20.0,0.0
11468,1,1468,[125 568 496 235 742],378,3,5466,3.7208985704560926,0.0,0.0
11469,1,1469,[568  28 194 496 515],387,2,5468,3.7197278911564626,0.0,0.0
11470,1,1470,[194 228 181 245   7],102,1,5469,3.717878993881713,0.0,0.0
11471,1,1471,[508 153  98 603 204],339,4,5473,3.718070652173913,20.0,20.0
11472,1,1472,[ 79 175  12 271  64],379,4,5477,3.7182620502376103,20.0,0.0
11473,1,1473,[ 64 245 234 423   1],653,3,5480,3.717774762550882,0.0,0.0
11474,1,1474,[427  97   9 289  11],271,5,5485,3.7186440677966104,0.0,0.0
11475,1,1475,[194 132 151 168 172],64,4,5489,3.7188346883468837,0.0,0.0
11476,1,1476,[183  71  28 289 655],95,4,5493,3.719025050778605,0.0,0.0
11477,1,1477,[185 496 546 173 135],64,4,5497,3.719215155615697,0.0,0.0
11478,1,1478,[127 483 187 302 313],13,5,5502,3.720081135902637,20.0,20.0
11479,1,1479,[ 97 202 265 180  69],263,5,5507,3.720945945945946,0.0,0.0
11480,1,1480,[127 483 187 302 313],90,5,5512,3.721809588116138,20.0,20.0
11481,1,1481,[111   7 117   1 187],234,1,5513,3.7199730094466936,0.0,0.0
11482,1,1482,[423 300 289  12 196],234,2,5515,3.7188132164531353,20.0,0.0
11483,1,1483,[405 118 187   9 100],881,4,5519,3.7190026954177897,0.0,20.0
11484,1,1484,[275 427 289  89 328],13,2,5521,3.7178451178451177,0.0,0.0
11485,1,1485,[194 144   4 603 655],804,5,5526,3.718707940780619,20.0,0.0
11486,1,1486,[127 483 187 302 313],328,5,5531,3.719569603227976,20.0,20.0
11487,1,1487,[127 483 187 302 313],334,5,5536,3.7204301075268815,20.0,20.0
11488,1,1488,[127 483 187 302 313],207,5,5541,3.7212894560107457,20.0,20.0
11489,1,1489,[483 211 183 302 294],207,3,5544,3.720805369127517,20.0,0.0
11490,1,1490,[127 483 187 302 313],328,5,5549,3.721663313212609,20.0,20.0
11491,1,1491,[238 191 186 173 483],537,5,5554,3.722520107238606,20.0,0.0
11492,1,1492,[197 191  25 210 294],666,2,5556,3.7213663764233087,0.0,0.0
11493,1,1493,[742 100 405  95 546],804,3,5559,3.7208835341365463,0.0,20.0
11494,1,1494,[173 127 144 121 176],843,1,5560,3.719063545150502,0.0,20.0
11495,1,1495,[269 405 215 313 195],378,3,5563,3.718582887700535,0.0,0.0
11496,1,1496,[  4 143 588 568  79],7,4,5567,3.7187708750835005,0.0,0.0
11497,1,1497,[ 95 357 100 172   7],892,5,5572,3.7196261682242993,20.0,20.0
11498,1,1498,[144 742   1 179  12],387,3,5575,3.7191460973982653,20.0,0.0
11499,1,1499,[127 483 187 302 313],537,5,5580,3.72,20.0,20.0
11500,1,1500,[185 210   7 174  56],524,3,5583,3.7195203197868087,0.0,20.0
11501,1,1501,[127 483 187 302 313],537,5,5588,3.7203728362183757,20.0,20.0
11502,1,1502,[127 483 187 302 313],207,5,5593,3.721224218230206,20.0,20.0
11503,1,1503,[195 328  96 265 748],479,4,5597,3.721409574468085,0.0,0.0
11504,1,1504,[127 483 187 302 313],207,5,5602,3.7222591362126245,20.0,20.0
11505,1,1505,[300 228 182 237  15],313,2,5604,3.7211155378486054,0.0,0.0
11506,1,1506,[127 483 187 302 313],334,5,5609,3.7219641672196415,20.0,20.0
11507,1,1507,[ 82  22 204  96 132],804,5,5614,3.722811671087533,0.0,0.0
11508,1,1508,[127 483 187 302 313],474,5,5619,3.7236580516898607,20.0,20.0
11509,1,1509,[176  97 475  88 187],13,3,5622,3.72317880794702,0.0,0.0
11510,1,1510,[117 186 135 187 144],343,4,5626,3.7233620119126405,0.0,0.0
11511,1,1511,[ 71 172 515 496 403],64,4,5630,3.7235449735449735,0.0,0.0
11512,1,1512,[ 82 483 200 168 111],749,4,5634,3.7237276933245207,20.0,0.0
11513,1,1513,[  8 172 405 483  22],328,4,5638,3.723910171730515,20.0,0.0
11514,1,1514,[313  22 568 181  28],738,3,5641,3.7234323432343235,0.0,0.0
11515,1,1515,[144 194  12 186 234],234,2,5643,3.7222955145118735,20.0,0.0
11516,1,1516,[655  82 111  15 191],398,4,5647,3.722478576137113,0.0,0.0
11517,1,1517,[301  98 204 176 211],234,1,5648,3.72068511198946,0.0,20.0
11518,1,1518,[216 121 215 125  69],42,5,5653,3.7215273206056616,0.0,0.0
11519,1,1519,[318 435  28 191 132],666,4,5657,3.7217105263157895,20.0,0.0
11520,1,1520,[210 288  79 183 328],92,3,5660,3.721236028928337,0.0,0.0
11521,1,1521,[187  50 237  70 117],524,3,5663,3.7207621550591328,0.0,20.0
11522,1,1522,[210 237 186 496  22],334,2,5665,3.7196323046618516,0.0,0.0
11523,1,1523,[655 328 333  95 294],13,2,5667,3.718503937007874,0.0,0.0
11524,1,1524,[127 483 187 302 313],669,4,5671,3.718688524590164,20.0,20.0
11525,1,1525,[195 173 117  25 655],749,5,5676,3.7195281782437744,0.0,0.0
11526,1,1526,[301 333 328 238 174],334,3,5679,3.719056974459725,0.0,20.0
11527,1,1527,[127 483 187 302 313],328,5,5684,3.7198952879581153,20.0,20.0
11528,1,1528,[127 483 187 302 313],669,4,5688,3.7200784826684106,20.0,20.0
11529,1,1529,[127 187 483 302 313],474,5,5693,3.7209150326797387,20.0,20.0
11530,1,1530,[127 187 483 302 313],334,5,5698,3.721750489875898,20.0,20.0
11531,1,1531,[ 70 294 204 435  69],452,2,5700,3.720626631853786,0.0,0.0
11532,1,1532,[127 187 483 302 313],207,5,5705,3.721461187214612,20.0,20.0
11533,1,1533,[276 568 268 265 300],13,3,5708,3.720990873533246,0.0,0.0
11534,1,1534,[153 180 143 748 515],346,3,5711,3.7205211726384366,0.0,0.0
11535,1,1535,[742 151  96  98 405],897,4,5715,3.720703125,0.0,20.0
11536,1,1536,[183  79 176 173  96],234,1,5716,3.71893298633702,0.0,0.0
11537,1,1537,[204 742 172 333 187],506,5,5721,3.7197659297789336,0.0,0.0
11538,1,1538,[204 282 216 228 496],804,5,5726,3.7205977907732293,0.0,0.0
11539,1,1539,[ 79  71 118 235 161],200,4,5730,3.720779220779221,0.0,0.0
11540,1,1540,[ 96 210 403 173 273],387,4,5734,3.720960415314731,0.0,0.0
11541,1,1541,[127 187 483 302 313],328,5,5739,3.7217898832684826,20.0,20.0
11542,1,1542,[  9 176 403 286 275],343,5,5744,3.7226182760855475,0.0,0.0
11543,1,1543,[ 25 222 132 118 300],87,4,5748,3.72279792746114,0.0,0.0
11544,1,1544,[127 187 483 313 302],90,5,5753,3.7236245954692557,20.0,20.0
11545,1,1545,[496  28 195   1 187],648,4,5757,3.723803363518758,0.0,0.0
11546,1,1546,[ 69 143  28 483  70],312,5,5762,3.724628312863607,20.0,0.0
11547,1,1547,[127 187 483 313 302],207,5,5767,3.7254521963824287,20.0,20.0
11548,1,1548,[ 95 191 258 237  98],454,3,5770,3.724983860555197,0.0,20.0
11549,1,1549,[ 25  50 483 496 294],452,3,5773,3.724516129032258,20.0,20.0
11550,1,1550,[318 176 153  56 210],666,4,5777,3.7246937459703418,20.0,0.0
11551,1,1551,[235 483 222 603 181],648,5,5782,3.725515463917526,40.0,0.0
11552,1,1552,[ 98 475 143 200 179],325,3,5785,3.7250482936252416,0.0,20.0
11553,1,1553,[194 153 357 215 182],892,5,5790,3.7258687258687258,20.0,0.0
11554,1,1554,[ 25 172 496 176  96],200,5,5795,3.7266881028938905,0.0,0.0
11555,1,1555,[294 748 144  88 118],648,3,5798,3.7262210796915167,0.0,0.0
11556,1,1556,[127 483 187 313 302],669,4,5802,3.7263969171483624,20.0,20.0
11557,1,1557,[127 187 483 313 302],669,4,5806,3.7265725288831835,20.0,20.0
11558,1,1558,[127 187 483 313 302],537,5,5811,3.7273893521488133,20.0,20.0
11559,1,1559,[151 496 183 144 234],346,4,5815,3.7275641025641026,0.0,0.0
11560,1,1560,[ 88 117 597 435 515],308,2,5817,3.726457399103139,0.0,0.0
11561,1,1561,[385 496 181 176  50],650,5,5822,3.727272727272727,0.0,20.0
11562,1,1562,[135 180 143 176 168],339,5,5827,3.72808701215611,0.0,0.0
11563,1,1563,[195  15  28  96 245],533,4,5831,3.7282608695652173,0.0,0.0
11564,1,1564,[ 56 173 135  97  98],234,2,5833,3.7271565495207666,0.0,20.0
11565,1,1565,[111  88 222 496  79],42,4,5837,3.727330779054917,0.0,0.0
11566,1,1566,[127 187 483 313 302],334,5,5842,3.7281429483088706,20.0,20.0
11567,1,1567,[127 187 483 313 302],537,5,5847,3.728954081632653,20.0,20.0
11568,1,1568,[286 228 237 200 118],653,3,5850,3.72848948374761,0.0,0.0
11569,1,1569,[175 403 288 515 313],64,5,5855,3.729299363057325,0.0,0.0
11570,1,1570,[238 288 172 496  79],537,2,5857,3.7281985996180778,0.0,0.0
11571,1,1571,[176 161 427 655 200],899,5,5862,3.7290076335877864,0.0,0.0
11572,1,1572,[202 282 210 405 258],92,3,5865,3.7285441830896375,0.0,0.0
11573,1,1573,[ 22 289 385 245  56],533,2,5867,3.727445997458704,0.0,0.0
11574,1,1574,[172 144  88 216  70],194,1,5868,3.7257142857142855,0.0,0.0
11575,1,1575,[423 288 211  22 181],59,5,5873,3.7265228426395938,0.0,0.0
11576,1,1576,[323 127 427 678 286],13,2,5875,3.725428027901078,0.0,20.0
11577,1,1577,[ 22  64 161 322 423],749,4,5879,3.725602027883397,0.0,0.0
11578,1,1578,[174 597 173 258 202],13,3,5882,3.725142495250158,0.0,20.0
11579,1,1579,[318 496 191 289 435],458,3,5885,3.7246835443037973,20.0,0.0
11580,1,1580,[294 471 234 265  70],7,3,5888,3.724225173940544,0.0,0.0
11581,1,1581,[ 56 546   9 318 323],374,2,5890,3.723135271807838,20.0,0.0
11582,1,1582,[ 50 483 132 186   7],295,5,5895,3.7239418825015793,20.0,20.0
11583,1,1583,[127 187 483 313 302],328,5,5900,3.724747474747475,20.0,20.0
11584,1,1584,[ 50  89 168 180  95],766,4,5904,3.724921135646688,0.0,20.0
11585,1,1585,[ 28 276  79   8 179],406,3,5907,3.7244640605296344,0.0,0.0
11586,1,1586,[405 597 483 268 151],560,3,5910,3.724007561436673,20.0,0.0
11587,1,1587,[238   1 168 515  69],64,5,5915,3.724811083123426,0.0,0.0
11588,1,1588,[127 187 483 313 302],537,5,5920,3.725613593455003,20.0,20.0
11589,1,1589,[222  71  22 194   4],749,4,5924,3.7257861635220126,0.0,0.0
11590,1,1590,[202  96 742 546 235],145,4,5928,3.725958516656191,0.0,0.0
11591,1,1591,[127 187 483 313 302],207,5,5933,3.726758793969849,20.0,20.0
11592,1,1592,[127 187 483 313 302],207,5,5938,3.727558066541117,20.0,20.0
11593,1,1593,[174 655 435  88 286],343,5,5943,3.728356336260979,0.0,20.0
11594,1,1594,[222  95  25 403 135],387,2,5945,3.727272727272727,0.0,0.0
11595,1,1595,[286 588 568  70 125],194,1,5946,3.725563909774436,0.0,0.0
11596,1,1596,[222  64 228 742 357],290,3,5949,3.7251095804633687,20.0,0.0
11597,1,1597,[ 22 748 211  79 127],749,4,5953,3.7252816020025032,0.0,20.0
11598,1,1598,[127 187 483 313 302],669,4,5957,3.7254534083802375,20.0,20.0
11599,1,1599,[127 187 483 313 302],90,5,5962,3.72625,20.0,20.0
11600,1,1600,[200 313 195 508 238],474,3,5965,3.72579637726421,0.0,0.0
11601,1,1601,[127 187 483 313 302],207,5,5970,3.7265917602996255,20.0,20.0
11602,1,1602,[ 98 258   7 268 204],537,3,5973,3.72613849033063,0.0,20.0
11603,1,1603,[127 187 483 313 302],90,5,5978,3.726932668329177,20.0,20.0
11604,1,1604,[182 202  96 515  97],234,1,5979,3.725233644859813,0.0,0.0
11605,1,1605,[ 12   7 483 202 603],745,3,5982,3.7247820672478205,60.0,0.0
11606,1,1606,[127 187 483 313 302],537,5,5987,3.7255756067205974,20.0,20.0
11607,1,1607,[176 202 186 210 172],774,2,5989,3.724502487562189,0.0,0.0
11608,1,1608,[100 318 405 678 202],92,1,5990,3.722809198259789,20.0,20.0
11609,1,1609,[  1   4 195  50 151],64,3,5993,3.722360248447205,0.0,20.0
11610,1,1610,[678  97 603 385 333],506,4,5997,3.722532588454376,20.0,0.0
11611,1,1611,[186 228  96  22 135],87,5,6002,3.7233250620347396,0.0,0.0
11612,1,1612,[174 187 117 275 234],233,4,6006,3.723496590204588,0.0,20.0
11613,1,1613,[127 187 313 483 302],13,5,6011,3.724287484510533,20.0,20.0
11614,1,1614,[191 268 127 174 678],334,4,6015,3.7244582043343653,0.0,40.0
11615,1,1615,[127 187 313 483 302],13,5,6020,3.7252475247524752,20.0,20.0
11616,1,1616,[127 187 313 483 302],328,5,6025,3.7260358688930117,20.0,20.0
11617,1,1617,[127 187 313 483 302],474,5,6030,3.726823238566131,20.0,20.0
11618,1,1618,[257   8 200   9 215],378,4,6034,3.7269919703520693,0.0,0.0
11619,1,1619,[ 79 179 187  12 435],833,3,6037,3.726543209876543,20.0,0.0
11620,1,1620,[204   1 118 423  28],83,4,6041,3.726711906230722,0.0,0.0
11621,1,1621,[265 182 173 546 603],271,3,6044,3.7262638717632552,20.0,0.0
11622,1,1622,[323 174  50  96 100],13,4,6048,3.7264325323475047,0.0,60.0
11623,1,1623,[282 174 258 187  69],653,3,6051,3.725985221674877,0.0,20.0
11624,1,1624,[323  64 423 483 405],881,4,6055,3.726153846153846,20.0,0.0
11625,1,1625,[127 187 313 483 302],669,4,6059,3.7263222632226323,20.0,20.0
11626,1,1626,[174 118 282 483 742],298,4,6063,3.7264904732636754,20.0,20.0
11627,1,1627,[515  15  95  97 117],184,2,6065,3.7254299754299756,0.0,0.0
11628,1,1628,[483 196 508 127 191],339,5,6070,3.7262124002455494,20.0,20.0
11629,1,1629,[168  82 655 597 748],13,3,6073,3.725766871165644,0.0,0.0
11630,1,1630,[127 187 313 483 302],328,5,6078,3.7265481299816066,20.0,20.0
11631,1,1631,[127 187 313 483 302],328,5,6083,3.727328431372549,20.0,20.0
11632,1,1632,[127 187 313 483 302],207,5,6088,3.728107777097367,20.0,20.0
11633,1,1633,[508 423  70 228 234],533,4,6092,3.7282741738066094,0.0,0.0
11634,1,1634,[127 187 313 483 302],13,5,6097,3.7290519877675843,20.0,20.0
11635,1,1635,[174  56 508  11  64],13,3,6100,3.728606356968215,0.0,20.0
11636,1,1636,[202 153 132 475 318],343,5,6105,3.729383017715333,20.0,0.0
11637,1,1637,[127 187 313 483 302],90,5,6110,3.7301587301587302,20.0,20.0
11638,1,1638,[ 56   8 135 197 181],189,4,6114,3.7303233679072605,0.0,0.0
11639,1,1639,[127 187 313 483 302],328,5,6119,3.7310975609756096,20.0,20.0
11640,1,1640,[271  11 204  97 153],328,0,6119,3.728823887873248,0.0,0.0
11641,1,1641,[176 258 185 234 173],479,5,6124,3.7295980511571254,0.0,0.0
11642,1,1642,[127 187 313 483 302],207,5,6129,3.730371272063299,20.0,20.0
11643,1,1643,[127 187 313 483 302],207,5,6134,3.7311435523114356,20.0,20.0
11644,1,1644,[ 28 135  64 215 132],474,5,6139,3.7319148936170214,0.0,0.0
11645,1,1645,[176  95 405 143 423],92,1,6140,3.730255164034022,0.0,0.0
11646,1,1646,[ 70 176  98 427 100],664,4,6144,3.7304189435336976,0.0,40.0
11647,1,1647,[127 187 313 483 302],474,5,6149,3.7311893203883497,20.0,20.0
11648,1,1648,[200 471 234 748 322],328,2,6151,3.730139478471801,0.0,0.0
11649,1,1649,[127 187 313 483 302],669,4,6155,3.7303030303030305,20.0,20.0
11650,1,1650,[127 187 313 483 302],328,5,6160,3.7310720775287702,20.0,20.0
11651,1,1651,[125 194 238 286 568],378,3,6163,3.7306295399515736,0.0,0.0
11652,1,1652,[269  22 423 161 186],452,4,6167,3.7307924984875984,0.0,0.0
11653,1,1653,[ 95 286 742  28 172],387,2,6169,3.729746070133011,0.0,0.0
11654,1,1654,[282  97 302 435 191],474,5,6174,3.730513595166163,0.0,0.0
11655,1,1655,[  4 121 111  70 135],533,3,6177,3.7300724637681157,0.0,0.0
11656,1,1656,[328 125 405 546 183],653,1,6178,3.7284248642124322,0.0,0.0
11657,1,1657,[546 568  70 216 153],648,4,6182,3.7285886610373944,0.0,0.0
11658,1,1658,[135  89 276 427  70],537,5,6187,3.7293550331525016,0.0,0.0
11659,1,1659,[742 265   1  82  50],378,5,6192,3.730120481927711,0.0,20.0
11660,1,1660,[153 118 222 176 435],102,0,6192,3.72787477423239,0.0,0.0
11661,1,1661,[313 197 182 176  70],378,4,6196,3.728038507821901,0.0,0.0
11662,1,1662,[127 187 313 483 302],669,4,6200,3.728202044497895,20.0,20.0
11663,1,1663,[678 483  22 118 117],454,2,6202,3.7271634615384617,20.0,0.0
11664,1,1664,[181 100 235 313  25],26,3,6205,3.7267267267267266,0.0,20.0
11665,1,1665,[435 183 185 237 161],694,5,6210,3.7274909963985596,0.0,0.0
11666,1,1666,[228 300 187 333  28],537,1,6211,3.7258548290341933,0.0,0.0
11667,1,1667,[196 655 121  95 322],537,0,6211,3.723621103117506,0.0,0.0
11668,1,1668,[ 56 655 222 172 186],194,3,6214,3.7231875374475734,0.0,0.0
11669,1,1669,[403 117 111  25 211],234,0,6214,3.7209580838323353,0.0,0.0
11670,1,1670,[ 98  71 302 202 655],378,4,6218,3.7211250748055056,0.0,20.0
11671,1,1671,[176 153 174 144 357],932,4,6222,3.721291866028708,20.0,20.0
11672,1,1672,[144  28 423  70  88],378,5,6227,3.722056186491333,0.0,0.0
11673,1,1673,[483 168 197 475   9],374,1,6228,3.7204301075268815,20.0,0.0
11674,1,1674,[117  71 168  12 515],543,3,6231,3.72,20.0,0.0
11675,1,1675,[127 187 313 302 483],13,5,6236,3.720763723150358,20.0,20.0
11676,1,1676,[515 172 237 216 111],271,5,6241,3.7215265354800238,0.0,0.0
11677,1,1677,[748 186   1 195 245],92,4,6245,3.7216924910607867,0.0,0.0
11678,1,1678,[204 748  88  28  22],653,4,6249,3.721858248957713,0.0,0.0
11679,1,1679,[ 56  89  15 423 385],537,2,6251,3.720833333333333,0.0,0.0
11680,1,1680,[  9 276  70 202  69],82,5,6256,3.721594289113623,0.0,0.0
11681,1,1681,[ 95  89 191  28 144],406,3,6259,3.721165279429251,0.0,0.0
11682,1,1682,[475   9 405 238 288],343,4,6263,3.7213309566250743,0.0,0.0
11683,1,1683,[195   1  12  56  88],374,3,6266,3.7209026128266034,20.0,0.0
11684,1,1684,[  7 176 496 234  28],95,3,6269,3.720474777448071,0.0,0.0
11685,1,1685,[423  70 603 273 187],666,3,6272,3.720047449584816,20.0,0.0
11686,1,1686,[405 286 100 204 202],653,3,6275,3.7196206283343214,0.0,20.0
11687,1,1687,[204 161   1 211 435],932,4,6279,3.71978672985782,0.0,0.0
11688,1,1688,[483 211 168 748 742],804,5,6284,3.7205447010065127,20.0,0.0
11689,1,1689,[603  50 173 288 200],804,3,6287,3.7201183431952662,20.0,20.0
11690,1,1690,[196  28  82 228 588],804,5,6292,3.7208752217622707,0.0,0.0
11691,1,1691,[127 187 313 302 483],334,5,6297,3.721631205673759,20.0,20.0
11692,1,1692,[ 97 405 328 194 423],313,4,6301,3.7217956290608387,0.0,0.0
11693,1,1693,[125 181  64 179 215],881,4,6305,3.7219598583234945,0.0,0.0
11694,1,1694,[ 88 197  96 568 132],311,5,6310,3.7227138643067845,0.0,0.0
11695,1,1695,[127 187 313 302 483],474,5,6315,3.7234669811320753,20.0,20.0
11696,1,1696,[202 194 234 127 216],311,5,6320,3.7242192103712433,0.0,20.0
11697,1,1697,[ 11 265  64 333 151],666,2,6322,3.7232037691401647,0.0,0.0
11698,1,1698,[127 187 313 302 483],90,5,6327,3.723955267804591,20.0,20.0
11699,1,1699,[222  69  89 202 211],311,4,6331,3.7241176470588235,0.0,0.0
11700,1,1700,[471   9 202 211 180],7,4,6335,3.7242798353909463,0.0,0.0
11701,1,1701,[196 187 183 597 195],59,4,6339,3.7244418331374853,0.0,0.0
11702,1,1702,[127 187 313 302 483],13,5,6344,3.7251908396946565,20.0,20.0
11703,1,1703,[127 187 313 302 483],13,5,6349,3.72593896713615,20.0,20.0
11704,1,1704,[235 181 276 100  98],339,4,6353,3.726099706744868,0.0,40.0
11705,1,1705,[  8 234 176 175 168],308,4,6357,3.7262602579132476,0.0,0.0
11706,1,1706,[475 204 234 235 117],339,2,6359,3.7252489748096074,0.0,0.0
11707,1,1707,[195 655 475  98 132],10,5,6364,3.7259953161592505,0.0,20.0
11708,1,1708,[127 187 313 302 483],334,5,6369,3.7267407840842597,20.0,20.0
11709,1,1709,[237 132 508 245  97],653,1,6370,3.7251461988304095,0.0,0.0
11710,1,1710,[182   4 357 200 181],7,4,6374,3.7253068381063708,20.0,0.0
11711,1,1711,[ 28 322 496 238 202],537,2,6376,3.7242990654205608,0.0,0.0
11712,1,1712,[423  22 182 265 191],313,4,6380,3.7244600116754234,0.0,0.0
11713,1,1713,[ 82 276 183 127  25],13,3,6383,3.7240373395565927,0.0,20.0
11714,1,1714,[194  79 210 204 216],158,4,6387,3.724198250728863,0.0,0.0
11715,1,1715,[127 187 313 302 483],328,5,6392,3.724941724941725,20.0,20.0
11716,1,1716,[172 132 328  50 271],749,5,6397,3.7256843331391964,0.0,20.0
11717,1,1717,[176  82 269 183 175],102,2,6399,3.7246798603026776,0.0,0.0
11718,1,1718,[245 276 257  56  50],119,4,6403,3.724840023269343,0.0,20.0
11719,1,1719,[ 11   4   9  70 483],234,2,6405,3.7238372093023258,20.0,0.0
11720,1,1720,[127 187 313 302 483],474,5,6410,3.7245787332945963,20.0,20.0
11721,1,1721,[127 187 313 302 483],334,5,6415,3.7253193960511033,20.0,20.0
11722,1,1722,[127 187 313 302 483],13,5,6420,3.726059199071387,20.0,20.0
11723,1,1723,[127 187 313 302 483],669,4,6424,3.726218097447796,20.0,20.0
11724,1,1724,[ 95  12 222 245 100],402,4,6428,3.726376811594203,20.0,20.0
11725,1,1725,[127 187 313 302 483],328,5,6433,3.727114716106605,20.0,20.0
11726,1,1726,[127 187 313 302 483],334,5,6438,3.727851766068327,20.0,20.0
11727,1,1727,[ 97   1  50 135  12],795,2,6440,3.7268518518518516,20.0,20.0
11728,1,1728,[127 187 313 302 483],474,5,6445,3.727588201272412,20.0,20.0
11729,1,1729,[286  70 187  82 313],533,5,6450,3.7283236994219653,0.0,0.0
11730,1,1730,[313 153  70 286 742],334,3,6453,3.7279029462738302,0.0,0.0
11731,1,1731,[238 742  79 181 200],653,3,6456,3.727482678983834,0.0,0.0
11732,1,1732,[127 187 313 302 483],207,5,6461,3.7282169648009233,20.0,20.0
11733,1,1733,[127 187 313 302 483],537,5,6466,3.728950403690888,20.0,20.0
11734,1,1734,[127 187 313 302 483],669,4,6470,3.729106628242075,20.0,20.0
11735,1,1735,[215  64 100   9 175],788,3,6473,3.7286866359447006,0.0,20.0
11736,1,1736,[127 187 313 302 483],13,5,6478,3.729418537708693,20.0,20.0
11737,1,1737,[127 187 313 302 483],13,5,6483,3.730149597238205,20.0,20.0
11738,1,1738,[186 185 435 603 204],60,5,6488,3.730879815986199,20.0,0.0
11739,1,1739,[ 28 182  97 194 269],7,4,6492,3.731034482758621,0.0,0.0
11740,1,1740,[228 496 222  71 286],200,5,6497,3.7317633543940265,0.0,0.0
11741,1,1741,[100 385 235  96  11],158,3,6500,3.7313432835820897,0.0,20.0
11742,1,1742,[655  71 181 427 182],194,3,6503,3.7309236947791167,0.0,0.0
11743,1,1743,[127 187 313 302 483],13,5,6508,3.731651376146789,20.0,20.0
11744,1,1744,[ 56 117  15 282 655],92,4,6512,3.731805157593123,0.0,0.0
11745,1,1745,[181 196  96 210 127],59,5,6517,3.7325315005727377,0.0,20.0
11746,1,1746,[187   1  82  96  12],892,4,6521,3.7326846021751576,20.0,0.0
11747,1,1747,[180 186 127 286 175],666,4,6525,3.732837528604119,0.0,20.0
11748,1,1748,[127 187 313 302 483],13,5,6530,3.733562035448828,20.0,20.0
11749,1,1749,[294 282 603 286 182],474,4,6534,3.7337142857142855,20.0,0.0
11750,1,1750,[603  25 135 174   9],474,5,6539,3.7344374643061107,20.0,20.0
11751,1,1751,[127 187 313 302 483],207,5,6544,3.7351598173515983,20.0,20.0
11752,1,1752,[357 204  56   8 294],379,4,6548,3.73531089560753,20.0,0.0
11753,1,1753,[ 12 275 181 222 496],533,5,6553,3.7360319270239453,20.0,0.0
11754,1,1754,[181 234 182 211 318],13,4,6557,3.736182336182336,20.0,0.0
11755,1,1755,[ 15 118 568 234  50],650,3,6560,3.735763097949886,0.0,20.0
11756,1,1756,[515 258  11  15  25],92,3,6563,3.7353443369379624,0.0,0.0
11757,1,1757,[127 187 313 302 483],474,5,6568,3.7360637087599544,20.0,20.0
11758,1,1758,[197 135 546 183 403],194,1,6569,3.734508243320068,0.0,0.0
11759,1,1759,[194  64 111 288 257],533,4,6573,3.734659090909091,0.0,0.0
11760,1,1760,[435 180  82  95 135],378,3,6576,3.734241908006814,0.0,0.0
11761,1,1761,[127 187 313 302 483],13,5,6581,3.734960272417707,20.0,20.0
11762,1,1762,[127 187 313 302 483],537,5,6586,3.735677821894498,20.0,20.0
11763,1,1763,[ 98 655 333 181  50],387,3,6589,3.7352607709750565,0.0,40.0
11764,1,1764,[496 269 238 265 191],650,5,6594,3.7359773371104814,0.0,0.0
11765,1,1765,[475  28 179 181 483],308,3,6597,3.7355605889014725,20.0,0.0
11766,1,1766,[127 187 313 302 483],537,5,6602,3.7362761743067345,20.0,20.0
11767,1,1767,[322 333 435 273  71],13,2,6604,3.735294117647059,0.0,0.0
11768,1,1768,[ 71  69 200 181 597],374,4,6608,3.7354437535330693,0.0,0.0
11769,1,1769,[127 187 313 302 483],207,5,6613,3.7361581920903957,20.0,20.0
11770,1,1770,[427 238  82  88 215],234,1,6614,3.7346132128740823,0.0,0.0
11771,1,1771,[132 318 228 222 211],406,3,6617,3.734198645598194,20.0,0.0
11772,1,1772,[127 187 313 302 483],334,5,6622,3.7349125775521714,20.0,20.0
11773,1,1773,[176 215 423  70 234],95,3,6625,3.734498308906426,0.0,0.0
11774,1,1774,[328  56 597 153 132],92,2,6627,3.7335211267605635,0.0,0.0
11775,1,1775,[328 603  89 197 423],90,4,6631,3.733671171171171,20.0,0.0
11776,1,1776,[143  69   1 286  64],458,4,6635,3.7338210467079347,0.0,0.0
11777,1,1777,[328 496 276 234 215],664,3,6638,3.7334083239595053,0.0,0.0
11778,1,1778,[322 328  96 185  98],804,5,6643,3.7341202922990444,0.0,20.0
11779,1,1779,[182 173 216 603 200],234,2,6645,3.7331460674157304,20.0,0.0
11780,1,1780,[ 56 121 742 204 191],454,3,6648,3.732734418865806,0.0,0.0
11781,1,1781,[357 328 423 228 234],804,4,6652,3.7328843995510663,20.0,0.0
11782,1,1782,[ 50 322 174 127 273],749,5,6657,3.733595064498037,0.0,60.0
11783,1,1783,[294 195 210 265 228],374,3,6660,3.733183856502242,0.0,0.0
11784,1,1784,[194 546 385 234  97],881,2,6662,3.7322128851540617,0.0,0.0
11785,1,1785,[ 15 403 151   8 175],308,4,6666,3.732362821948488,0.0,0.0
11786,1,1786,[144 191 235   1 405],406,3,6669,3.731952993844432,0.0,0.0
11787,1,1787,[282  89 405 181  50],804,5,6674,3.732662192393736,0.0,20.0
11788,1,1788,[210 173 423  69 168],666,2,6676,3.7316936836221353,0.0,0.0
11789,1,1789,[181 288  22 588 174],537,0,6676,3.729608938547486,0.0,20.0
11790,1,1790,[127 187 313 302 483],537,5,6681,3.730318257956449,20.0,20.0
11791,1,1791,[ 12 357  88  15 289],234,2,6683,3.7293526785714284,40.0,0.0
11792,1,1792,[175 318 200 202  70],537,3,6686,3.7289459007250416,20.0,0.0
11793,1,1793,[237 508  79 144 333],653,2,6688,3.7279821627647713,0.0,0.0
11794,1,1794,[603 216 294 100 144],804,5,6693,3.7286908077994427,20.0,20.0
11795,1,1795,[568 403  25 191 748],533,3,6696,3.728285077951002,0.0,0.0
11796,1,1796,[175  70 588 127 121],804,4,6700,3.728436282693378,0.0,20.0
11797,1,1797,[  8 100  25 483  97],234,3,6703,3.728031145717464,20.0,20.0
11798,1,1798,[174 258 515  28 471],7,4,6707,3.728182323513063,0.0,20.0
11799,1,1799,[655 588 200 742 191],95,3,6710,3.727777777777778,0.0,0.0
11800,1,1800,[ 50 197 185 182 215],479,4,6714,3.727928928373126,0.0,20.0
11801,1,1801,[211 204 748 301   4],102,1,6715,3.7264150943396226,0.0,0.0
11802,1,1802,[176 204 187 276 194],13,4,6719,3.7265668330560175,0.0,0.0
11803,1,1803,[127 187 313 302 483],207,5,6724,3.727272727272727,20.0,20.0
11804,1,1804,[271  79 222 202  70],506,5,6729,3.72797783933518,0.0,0.0
11805,1,1805,[143 748 210 181   1],804,4,6733,3.7281284606866003,0.0,0.0
11806,1,1806,[186 301 271 200 300],788,2,6735,3.7271721084670726,0.0,0.0
11807,1,1807,[403 183 603 568 678],749,4,6739,3.7273230088495577,20.0,0.0
11808,1,1808,[ 28 135 100 318 204],694,5,6744,3.728026533996683,20.0,20.0
11809,1,1809,[742 118 174 197 111],653,1,6745,3.726519337016575,0.0,20.0
11810,1,1810,[118 302 300 318 276],271,2,6747,3.725565985643291,20.0,0.0
11811,1,1811,[174   8 185 183 258],474,5,6752,3.726269315673289,0.0,20.0
11812,1,1812,[403  70 194 153 176],892,4,6756,3.726420297848869,0.0,0.0
11813,1,1813,[127 187 313 302 483],537,5,6761,3.727122381477398,20.0,20.0
11814,1,1814,[  7 742  95 403 204],378,5,6766,3.727823691460055,0.0,0.0
11815,1,1815,[655 173 318 475  96],387,2,6768,3.7268722466960353,20.0,0.0
11816,1,1816,[515 294 200  22  50],308,3,6771,3.7264722069345075,0.0,20.0
11817,1,1817,[204 100 475  25 127],207,2,6773,3.7255225522552253,0.0,40.0
11818,1,1818,[194  88 357 118  28],298,5,6778,3.7262231995601978,20.0,0.0
11819,1,1819,[127 313 187 302 483],207,5,6783,3.726923076923077,20.0,20.0
11820,1,1820,[ 56 173 276 183 234],315,3,6786,3.7265238879736406,0.0,0.0
11821,1,1821,[323 180 300 183 174],788,3,6789,3.726125137211855,0.0,20.0
11822,1,1822,[172 125 180 168 195],194,1,6790,3.7246297312122874,0.0,0.0
11823,1,1823,[127 313 187 302 483],537,5,6795,3.7253289473684212,20.0,20.0
11824,1,1824,[ 69 174  64 294 194],207,4,6799,3.7254794520547945,0.0,20.0
11825,1,1825,[117 182 121  82 655],13,3,6802,3.725082146768894,0.0,0.0
11826,1,1826,[127 313 187 302 483],474,5,6807,3.7257799671592773,20.0,20.0
11827,1,1827,[405 597 185 211 111],833,1,6808,3.7242888402625822,0.0,0.0
11828,1,1828,[127 313 187 302 483],537,5,6813,3.7249863313285947,20.0,20.0
11829,1,1829,[127 313 187 302 483],474,5,6818,3.7256830601092896,20.0,20.0
11830,1,1830,[211 235 742 237  97],788,2,6820,3.724740578918624,0.0,0.0
11831,1,1831,[ 97 172 742 471   8],313,3,6823,3.724344978165939,0.0,0.0
11832,1,1832,[357  64 186  12 333],343,4,6827,3.724495362793235,40.0,0.0
11833,1,1833,[655 153 318 183 186],234,2,6829,3.723555070883315,20.0,0.0
11834,1,1834,[127 313 187 302 483],474,5,6834,3.7242506811989102,20.0,20.0
11835,1,1835,[127 313 187 302 483],474,5,6839,3.724945533769063,20.0,20.0
11836,1,1836,[197  64 403 215 117],194,2,6841,3.7240065323897658,0.0,0.0
11837,1,1837,[273 302  79 405 222],13,1,6842,3.7225244831338413,0.0,0.0
11838,1,1838,[258 135  64 222 195],313,3,6845,3.722131593257205,0.0,0.0
11839,1,1839,[ 97 603  69 328 475],533,3,6848,3.7217391304347824,20.0,0.0
11840,1,1840,[385 333  82 423 183],537,0,6848,3.719717544812602,0.0,0.0
11841,1,1841,[176 228 269 357 117],339,4,6852,3.7198697068403908,20.0,0.0
11842,1,1842,[273 282 268 174 153],643,3,6855,3.7194791101465,0.0,20.0
11843,1,1843,[471 238 144  56 172],234,0,6855,3.7174620390455533,0.0,0.0
11844,1,1844,[127 313 187 302 483],13,5,6860,3.7181571815718155,20.0,20.0
11845,1,1845,[197 194  95   1 237],194,3,6863,3.717768147345612,0.0,0.0
11846,1,1846,[127 313 187 302 483],537,5,6868,3.718462371413102,20.0,20.0
11847,1,1847,[100  71  95 186  15],92,3,6871,3.718073593073593,0.0,20.0
11848,1,1848,[237 748 168   1 180],804,5,6876,3.7187669010275823,0.0,0.0
11849,1,1849,[127 313 187 302 483],334,5,6881,3.7194594594594594,20.0,20.0
11850,1,1850,[  1 546  82 496 238],643,2,6883,3.718530524041059,0.0,0.0
11851,1,1851,[194 222 275 357  69],899,4,6887,3.7186825053995682,20.0,0.0
11852,1,1852,[357 427 313 257  56],650,3,6890,3.7182946573124664,20.0,0.0
11853,1,1853,[135 173 323 655 215],59,5,6895,3.7189859762675295,0.0,0.0
11854,1,1854,[182 180  70   4 222],210,5,6900,3.719676549865229,0.0,0.0
11855,1,1855,[471 197 546   1 135],899,3,6903,3.7192887931034484,0.0,0.0
11856,1,1856,[496   7 175 597 168],82,3,6906,3.7189014539579968,0.0,0.0
11857,1,1857,[ 69  71 588 181 194],804,5,6911,3.7195909580193756,0.0,0.0
11858,1,1858,[200 235 183  50 168],897,3,6914,3.7192038730500268,0.0,20.0
11859,1,1859,[318 237 748 515 265],92,3,6917,3.718817204301075,20.0,0.0
11860,1,1860,[127 313 187 302 483],207,5,6922,3.719505642127888,20.0,20.0
11861,1,1861,[268  11 333 435 269],13,2,6924,3.7185821697099892,0.0,0.0
11862,1,1862,[127 313 187 302 483],334,5,6929,3.7192699946323136,20.0,20.0
11863,1,1863,[546  88 202 210 496],313,4,6933,3.7194206008583692,0.0,0.0
11864,1,1864,[197 135 143 257 496],479,3,6936,3.719034852546917,0.0,0.0
11865,1,1865,[471 135 748 161 111],479,3,6939,3.7186495176848875,0.0,0.0
11866,1,1866,[  4 173 423  96 161],650,2,6941,3.7177289769683983,0.0,0.0
11867,1,1867,[328 196 318 187 258],533,5,6946,3.7184154175588864,20.0,0.0
11868,1,1868,[211  28 135 174  89],447,5,6951,3.7191011235955056,0.0,20.0
11869,1,1869,[ 69 742 508 237 132],653,1,6952,3.7176470588235295,0.0,0.0
11870,1,1870,[187  71 294 127  79],804,4,6956,3.7177979690005345,0.0,20.0
11871,1,1871,[ 64 172  79  12 182],474,5,6961,3.718482905982906,20.0,0.0
11872,1,1872,[271 301  96  28  64],328,3,6964,3.718099305926321,0.0,0.0
11873,1,1873,[174 179 135 258 175],474,5,6969,3.7187833511205977,0.0,20.0
11874,1,1874,[127 313 187 302 483],328,5,6974,3.7194666666666665,20.0,20.0
11875,1,1875,[127 313 187 302 483],90,5,6979,3.720149253731343,20.0,20.0
11876,1,1876,[238 333 286 186 245],653,4,6983,3.720298348428343,0.0,0.0
11877,1,1877,[127 313 187 302 483],207,5,6988,3.7209797657082,20.0,20.0
11878,1,1878,[127 313 187 302 483],334,5,6993,3.7216604576902608,20.0,20.0
11879,1,1879,[483 211 195   4 597],7,4,6997,3.7218085106382977,20.0,0.0
11880,1,1880,[127 313 187 302 483],207,5,7002,3.722488038277512,20.0,20.0
11881,1,1881,[185 204  56 405  22],524,2,7004,3.7215727948990436,0.0,0.0
11882,1,1882,[127 313 187 302 483],328,5,7009,3.722251725969198,20.0,20.0
11883,1,1883,[ 98 161 423   9  82],7,3,7012,3.721868365180467,0.0,20.0
11884,1,1884,[655 216 204   1 117],313,5,7017,3.722546419098143,0.0,0.0
11885,1,1885,[173 302 211  64 117],339,4,7021,3.722693531283139,0.0,0.0
11886,1,1886,[127 313 187 302 483],90,5,7026,3.7233704292527823,20.0,20.0
11887,1,1887,[127 313 187 302 483],207,5,7031,3.7240466101694913,20.0,20.0
11888,1,1888,[238 197  89 222 121],454,2,7033,3.7231339332980413,0.0,0.0
11889,1,1889,[ 50 197 357   1  22],650,3,7036,3.7227513227513227,20.0,20.0
11890,1,1890,[182 603 161 176 135],334,2,7038,3.7218402961396087,20.0,0.0
11891,1,1891,[ 22 216  56  95 185],59,4,7042,3.721987315010571,0.0,0.0
11892,1,1892,[186  95 546 117 204],92,3,7045,3.7216059165346014,0.0,0.0
11893,1,1893,[ 56 117 216 191 237],234,1,7046,3.720168954593453,0.0,0.0
11894,1,1894,[186 742 182 135  71],788,0,7046,3.7182058047493403,0.0,0.0
11895,1,1895,[127 313 187 302 483],207,5,7051,3.7188818565400843,20.0,20.0
11896,1,1896,[127 313 187 302 483],334,5,7056,3.7195571955719555,20.0,20.0
11897,1,1897,[127 313 187 302 483],537,5,7061,3.720231822971549,20.0,20.0
11898,1,1898,[286 603  98 276 111],234,2,7063,3.7193259610321223,20.0,20.0
11899,1,1899,[161 200 132 273  12],328,4,7067,3.7194736842105263,20.0,0.0
11900,1,1900,[127 313 187 302 483],474,5,7072,3.7201472908995266,20.0,20.0
11901,1,1901,[186 100 180 210 153],279,4,7076,3.7202944269190326,0.0,20.0
11902,1,1902,[ 50 333 357  82 597],653,5,7081,3.720966894377299,20.0,20.0
11903,1,1903,[215  71 318  22  82],648,2,7083,3.720063025210084,20.0,0.0
11904,1,1904,[603 118 238 181 405],189,2,7085,3.7191601049868765,20.0,0.0
11905,1,1905,[118 282  64 180 191],653,3,7088,3.7187827911857294,0.0,0.0
11906,1,1906,[423  88 153 180  50],308,5,7093,3.7194546407970637,0.0,20.0
11907,1,1907,[127 313 187 302 483],207,5,7098,3.720125786163522,20.0,20.0
11908,1,1908,[215 180 234  97 174],308,2,7100,3.719224724986904,0.0,20.0
11909,1,1909,[ 70 385 180 515 294],308,3,7103,3.718848167539267,0.0,0.0
11910,1,1910,[216 168 318 435 111],59,5,7108,3.7195185766614336,20.0,0.0
11911,1,1911,[286 328 271 168 603],537,2,7110,3.7186192468619246,20.0,0.0
11912,1,1912,[127 313 187 302 483],328,5,7115,3.719289074751699,20.0,20.0
11913,1,1913,[196  70 323  15 289],881,0,7115,3.7173458725182864,0.0,0.0
11914,1,1914,[132  95 237 180 174],85,4,7119,3.7174934725848563,0.0,20.0
11915,1,1915,[127 313 187 302 483],334,5,7124,3.7181628392484343,20.0,20.0
11916,1,1916,[508 282 748 151 385],533,3,7127,3.7177882107459572,0.0,0.0
11917,1,1917,[183 111  70 187  15],452,3,7130,3.7174139728884255,0.0,0.0
11918,1,1918,[  4 202 211  56  12],315,4,7134,3.7175612298071914,20.0,0.0
11919,1,1919,[127 313 187 302 483],13,5,7139,3.7182291666666667,20.0,20.0
11920,1,1920,[ 69  28 186  50 289],374,3,7142,3.717855283706403,0.0,20.0
11921,1,1921,[301 475 286  69   9],605,3,7145,3.717481789802289,0.0,0.0
11922,1,1922,[ 70 168 187 118 276],533,4,7149,3.717628705148206,0.0,0.0
11923,1,1923,[196 211 357 294 228],7,4,7153,3.7177754677754677,20.0,0.0
11924,1,1924,[ 64 258 286   1  88],454,3,7156,3.7174025974025975,0.0,0.0
11925,1,1925,[127 313 187 302 483],328,5,7161,3.718068535825545,20.0,20.0
11926,1,1926,[ 69  79 423 483 403],374,2,7163,3.7171769590036328,20.0,0.0
11927,1,1927,[328  69 183 181 197],263,5,7168,3.7178423236514524,0.0,0.0
11928,1,1928,[ 69 216 385 174 204],60,5,7173,3.71850699844479,0.0,20.0
11929,1,1929,[265 313   7 273 144],92,5,7178,3.7191709844559586,0.0,0.0
11930,1,1930,[127 313 187 302 483],328,5,7183,3.7198342827550492,20.0,20.0
11931,1,1931,[ 89 328  71 200 180],95,2,7185,3.718944099378882,0.0,0.0
11932,1,1932,[282 210  71 568 385],85,1,7186,3.7175375064666323,0.0,0.0
11933,1,1933,[271   8  71 172 228],328,2,7188,3.71664943123061,0.0,0.0
11934,1,1934,[294 180 194  22 143],194,3,7191,3.7162790697674417,0.0,0.0
11935,1,1935,[257 546  50 200 655],881,3,7194,3.715909090909091,0.0,20.0
11936,1,1936,[180 475 194 186   4],339,5,7199,3.7165720185854414,0.0,0.0
11937,1,1937,[196 228 118  50 215],774,2,7201,3.715686274509804,0.0,20.0
11938,1,1938,[127 313 187 302 483],537,5,7206,3.716348633316142,20.0,20.0
11939,1,1939,[127 313 187 302 483],90,5,7211,3.7170103092783506,20.0,20.0
11940,1,1940,[204 238 289 235 210],13,1,7212,3.7156105100463677,0.0,0.0
11941,1,1941,[546 423  71 405 385],804,3,7215,3.71524201853759,0.0,0.0
11942,1,1942,[135 215 173  12 194],892,5,7220,3.7159032424086464,20.0,0.0
11943,1,1943,[127 313 187 302 483],13,5,7225,3.7165637860082303,20.0,20.0
11944,1,1944,[ 82  50 318 597 144],653,4,7229,3.7167095115681232,20.0,20.0
11945,1,1945,[127 313 187 302 483],90,5,7234,3.7173689619732784,20.0,20.0
11946,1,1946,[195 269  69 210 568],378,3,7237,3.717000513610683,0.0,0.0
11947,1,1947,[127 313 187 302 483],537,5,7242,3.717659137577002,20.0,20.0
11948,1,1948,[151 237 597 496 179],899,2,7244,3.71677783478707,0.0,0.0
11949,1,1949,[ 69 597 276 132  56],378,3,7247,3.7164102564102564,0.0,0.0
11950,1,1950,[435 568 121 546  96],158,4,7251,3.716555612506407,0.0,0.0
11951,1,1951,[ 82 268 202 288 258],7,2,7253,3.7156762295081966,0.0,0.0
11952,1,1952,[403 182 151 265  25],59,5,7258,3.7163338453661034,0.0,0.0
11953,1,1953,[215 258   4 196 183],650,2,7260,3.7154554759467757,0.0,0.0
11954,1,1954,[200 196  95 173  22],387,3,7263,3.7150895140664963,0.0,0.0
11955,1,1955,[403  56  98 194 294],308,3,7266,3.714723926380368,0.0,20.0
11956,1,1956,[127 313 187 302 483],207,5,7271,3.7153806847215125,20.0,20.0
11957,1,1957,[235 200 216 181 483],643,3,7274,3.7150153217568946,20.0,0.0
11958,1,1958,[174 172 385 202 168],766,1,7275,3.713629402756508,0.0,20.0
11959,1,1959,[385 144 204 235  11],119,5,7280,3.7142857142857144,0.0,0.0
11960,1,1960,[275 111 276 655 678],334,3,7283,3.71392146863845,0.0,0.0
11961,1,1961,[313 403 238 210 100],308,4,7287,3.714067278287462,0.0,20.0
11962,1,1962,[151 100   1 288   9],403,4,7291,3.7142129393785024,0.0,20.0
11963,1,1963,[151 265 215 195 655],7,5,7296,3.714867617107943,0.0,0.0
11964,1,1964,[405 121 200 427 186],334,2,7298,3.713994910941476,0.0,0.0
11965,1,1965,[127 313 187 302 483],328,5,7303,3.714649033570702,20.0,20.0
11966,1,1966,[183 333 174   7 275],537,2,7305,3.71377732587697,0.0,20.0
11967,1,1967,[318  69  12 168 121],533,5,7310,3.714430894308943,40.0,0.0
11968,1,1968,[127 313 187 302 483],13,5,7315,3.7150837988826817,20.0,20.0
11969,1,1969,[174  69 175 215 568],313,5,7320,3.715736040609137,0.0,20.0
11970,1,1970,[183 546 181 182  22],339,5,7325,3.7163876204972097,0.0,0.0
11971,1,1971,[194 121   7 435 187],648,3,7328,3.716024340770791,0.0,0.0
11972,1,1972,[288 435 194 328 135],804,2,7330,3.715154586923467,0.0,0.0
11973,1,1973,[127 313 187 302 483],207,5,7335,3.7158054711246202,20.0,20.0
11974,1,1974,[135 222  11  71 100],13,3,7338,3.7154430379746834,0.0,20.0
11975,1,1975,[127 313 187 302 483],474,5,7343,3.716093117408907,20.0,20.0
11976,1,1976,[127 313 187 302 483],334,5,7348,3.7167425392008093,20.0,20.0
11977,1,1977,[  4 135  71  98 603],387,3,7351,3.7163801820020224,20.0,20.0
11978,1,1978,[168 357 187  69 323],488,3,7354,3.7160181910055585,20.0,0.0
11979,1,1979,[127 313 187 302 483],328,5,7359,3.716666666666667,20.0,20.0
11980,1,1980,[100 204 191 273 515],537,3,7362,3.7163048965169105,0.0,20.0
11981,1,1981,[210 132 187  69 318],474,5,7367,3.7169525731584256,20.0,0.0
11982,1,1982,[ 70  64  82 181 202],125,4,7371,3.7170953101361572,0.0,0.0
11983,1,1983,[127 313 187 302 483],334,5,7376,3.717741935483871,20.0,20.0
11984,1,1984,[127 313 187 302 483],537,5,7381,3.7183879093198993,20.0,20.0
11985,1,1985,[271 161 403 187 183],102,1,7382,3.717019133937563,0.0,0.0
11986,1,1986,[197  64 286  11  28],7,4,7386,3.717161550075491,0.0,0.0
11987,1,1987,[127 313 187 302 483],13,5,7391,3.7178068410462775,20.0,20.0
11988,1,1988,[191 258 568 748 405],882,4,7395,3.717948717948718,0.0,0.0
11989,1,1989,[127 313 187 302 483],90,5,7400,3.7185929648241207,20.0,20.0
11990,1,1990,[216  82 161 286 143],881,3,7403,3.718232044198895,0.0,0.0
11991,1,1991,[282 403 313 286 269],334,4,7407,3.7183734939759034,0.0,0.0
11992,1,1992,[568  88 238 153  15],95,5,7412,3.719016557952835,0.0,0.0
11993,1,1993,[100 187 143 196 111],234,2,7414,3.7181544633901704,0.0,20.0
11994,1,1994,[111 186 435 228  97],533,3,7417,3.717794486215539,0.0,0.0
11995,1,1995,[175 179 288 228 234],234,1,7418,3.716432865731463,0.0,0.0
11996,1,1996,[174 127  22 191 151],881,4,7422,3.7165748622934403,0.0,40.0
11997,1,1997,[216 301 357  12 286],234,1,7423,3.715215215215215,40.0,0.0
11998,1,1998,[127 313 187 302 483],669,4,7427,3.71535767883942,20.0,20.0
11999,1,1999,[271 515 508 125 179],334,2,7429,3.7145,0.0,0.0
12000,1,2000,[435 215 153  82 121],454,3,7432,3.714142928535732,0.0,0.0
12001,1,2001,[127 313 187 302 483],474,5,7437,3.714785214785215,20.0,20.0
12002,1,2002,[127 313 187 302 483],13,5,7442,3.7154268597104343,20.0,20.0
12003,1,2003,[234 195 215 515   8],85,4,7446,3.715568862275449,0.0,0.0
12004,1,2004,[187  64 275 282  15],406,2,7448,3.714713216957606,0.0,0.0
12005,1,2005,[180 111  50 357  64],833,2,7450,3.7138584247258226,20.0,20.0
12006,1,2006,[153 258 546 186 427],313,2,7452,3.713004484304933,0.0,0.0
12007,1,2007,[  9 153 194 211  70],207,4,7456,3.7131474103585655,0.0,0.0
12008,1,2008,[127 313 187 302 483],334,5,7461,3.7137879542060728,20.0,20.0
12009,1,2009,[127 313 187 302 483],474,5,7466,3.7144278606965173,20.0,20.0
12010,1,2010,[265 546 313 161 435],650,3,7469,3.714072600696171,0.0,0.0
12011,1,2011,[127 313 187 302 483],90,5,7474,3.7147117296222665,20.0,20.0
12012,1,2012,[222 748 185 276 186],474,4,7478,3.7148534525583705,0.0,0.0
12013,1,2013,[176 181 161 423 276],311,5,7483,3.715491559086395,0.0,0.0
12014,1,2014,[483 245   1 197 423],533,4,7487,3.715632754342432,20.0,0.0
12015,1,2015,[111  56 125 215 132],234,1,7488,3.7142857142857144,0.0,0.0
12016,1,2016,[210 117  95 191  97],234,1,7489,3.7129400099157164,0.0,0.0
12017,1,2017,[200   8   1 496 211],311,4,7493,3.713082259663033,0.0,0.0
12018,1,2018,[211 294 216 276 515],311,4,7497,3.713224368499257,0.0,0.0
12019,1,2019,[328 135 471 568 435],378,2,7499,3.7123762376237623,0.0,0.0
12020,1,2020,[100 186  28  64   9],207,4,7503,3.7125185551707074,0.0,20.0
12021,1,2021,[ 22 678 748 127 200],648,1,7504,3.711177052423343,0.0,20.0
12022,1,2022,[191  95 172 127 276],271,4,7508,3.7113198220464656,0.0,20.0
12023,1,2023,[228 275 515 183 143],60,4,7512,3.7114624505928853,0.0,0.0
12024,1,2024,[143 655 181 176 117],213,5,7517,3.7120987654320987,0.0,0.0
12025,1,2025,[127 313 187 302 483],669,4,7521,3.7122408687068114,20.0,20.0
12026,1,2026,[127 313 187 302 483],537,5,7526,3.712876171682289,20.0,20.0
12027,1,2027,[168   8  56 282 357],194,3,7529,3.712524654832347,20.0,0.0
12028,1,2028,[515 196  69   8 174],406,3,7532,3.712173484475111,0.0,20.0
12029,1,2029,[127 313 187 302 483],207,5,7537,3.712807881773399,20.0,20.0
12030,1,2030,[742  79 204 403 215],313,3,7540,3.7124569177744955,0.0,0.0
12031,1,2031,[215 655 187 197 121],64,3,7543,3.7121062992125986,0.0,0.0
12032,1,2032,[127 313 187 302 483],207,5,7548,3.7127397934087556,20.0,20.0
12033,1,2033,[127 313 187 302 483],669,4,7552,3.712881022615536,20.0,20.0
12034,1,2034,[111 202 546 125  56],64,3,7555,3.7125307125307123,0.0,0.0
12035,1,2035,[  9 357 471 144 546],788,3,7558,3.712180746561886,20.0,0.0
12036,1,2036,[194  69 183  70 265],328,4,7562,3.7123220422189496,0.0,0.0
12037,1,2037,[294 195  88  89 174],897,4,7566,3.7124631992149166,0.0,20.0
12038,1,2038,[403 127 333  79   8],881,4,7570,3.712604217753801,0.0,20.0
12039,1,2039,[ 64  98 546 301   7],234,2,7572,3.711764705882353,0.0,20.0
12040,1,2040,[237   4 357 483 508],537,3,7575,3.7114159725624694,40.0,0.0
12041,1,2041,[127 313 187 302 483],474,5,7580,3.712047012732615,20.0,20.0
12042,1,2042,[143  56 180 318 655],234,1,7581,3.71071953010279,20.0,0.0
12043,1,2043,[496 508 187  71   1],184,5,7586,3.7113502935420746,0.0,0.0
12044,1,2044,[515 179 174 204 161],334,4,7590,3.7114914425427874,0.0,20.0
12045,1,2045,[483 195  12 423 275],537,2,7592,3.710654936461388,40.0,0.0
12046,1,2046,[ 15 313 197   4  69],653,2,7594,3.709819247679531,0.0,0.0
12047,1,2047,[168 179   7 175 210],13,2,7596,3.708984375,0.0,0.0
12048,1,2048,[179  98 196  11 197],474,5,7601,3.7096144460712543,0.0,20.0
12049,1,2049,[294  98 265 181 211],102,1,7602,3.7082926829268295,0.0,20.0
12050,1,2050,[222 127   4 322 483],537,2,7604,3.7074597757191614,20.0,20.0
12051,1,2051,[ 15 100   1 748 286],26,2,7606,3.706627680311891,0.0,20.0
12052,1,2052,[153 423  70 100 471],454,3,7609,3.7062834875791526,0.0,20.0
12053,1,2053,[403 210  28  82  15],311,5,7614,3.706913339824732,0.0,0.0
12054,1,2054,[483 176 118   7 655],881,5,7619,3.707542579075426,20.0,0.0
12055,1,2055,[333 144 286   9  56],343,4,7623,3.707684824902724,0.0,0.0
12056,1,2056,[ 98  79  56  11 144],892,4,7627,3.707826932425863,0.0,20.0
12057,1,2057,[127 313 187 302 483],669,4,7631,3.707968901846453,20.0,20.0
12058,1,2058,[273 271 475 194 181],537,1,7632,3.7066537153958232,0.0,0.0
12059,1,2059,[423  12 403  64 288],892,4,7636,3.7067961165048544,20.0,0.0
12060,1,2060,[ 97 245 132 143 204],263,5,7641,3.7074235807860263,0.0,0.0
12061,1,2061,[318 515 603  50 196],59,5,7646,3.7080504364694473,40.0,20.0
12062,1,2062,[294   7   1 678  71],648,1,7647,3.706737760542899,0.0,0.0
12063,1,2063,[127 313 187 302 483],207,5,7652,3.7073643410852712,20.0,20.0
12064,1,2064,[121 238  69 588  97],254,2,7654,3.7065375302663437,0.0,0.0
12065,1,2065,[588 435  88 568 294],897,3,7657,3.7061955469506294,0.0,0.0
12066,1,2066,[ 50 288 603  70 289],334,2,7659,3.705370101596517,20.0,20.0
12067,1,2067,[144 228 258  97 179],738,4,7663,3.705512572533849,0.0,0.0
12068,1,2068,[ 79 742 678 172 515],881,4,7667,3.7056549057515706,0.0,0.0
12069,1,2069,[132  89 181 121 183],650,4,7671,3.705797101449275,0.0,0.0
12070,1,2070,[144 135 196 195 271],13,3,7674,3.705456301303718,0.0,0.0
12071,1,2071,[194 187 265 132  88],881,2,7676,3.7046332046332044,0.0,0.0
12072,1,2072,[127 313 187 302 483],90,5,7681,3.705258080077183,20.0,20.0
12073,1,2073,[ 69 176 197 186 215],387,0,7681,3.7034715525554485,0.0,0.0
12074,1,2074,[328 235 179   7 210],537,2,7683,3.7026506024096384,0.0,0.0
12075,1,2075,[174 132 210  25 405],892,5,7688,3.703275529865125,0.0,20.0
12076,1,2076,[127 313 187 302 483],669,4,7692,3.7034183919114105,20.0,20.0
12077,1,2077,[222 172 483 153 546],290,3,7695,3.703079884504331,20.0,0.0
12078,1,2078,[127 313 187 302 483],669,4,7699,3.7032227032227034,20.0,20.0
12079,1,2079,[196 191 245 405 318],488,1,7700,3.701923076923077,20.0,0.0
12080,1,2080,[132 294  97 357 282],328,2,7702,3.70110523786641,20.0,0.0
12081,1,2081,[427 234   1 210  70],934,3,7705,3.7007684918347743,0.0,0.0
12082,1,2082,[357 161 588 269 546],7,3,7708,3.700432069131061,20.0,0.0
12083,1,2083,[127 313 187 302 483],207,5,7713,3.7010556621880997,20.0,20.0
12084,1,2084,[245 286  82 161 294],378,3,7716,3.7007194244604316,0.0,0.0
12085,1,2085,[ 64 187  88 121  50],406,3,7719,3.7003835091083412,0.0,20.0
12086,1,2086,[211  79   8 235 183],64,5,7724,3.7010062290368952,0.0,0.0
12087,1,2087,[435   4 161 187 282],804,4,7728,3.7011494252873565,0.0,0.0
12088,1,2088,[496 471 173  98 333],815,3,7731,3.700813786500718,0.0,20.0
12089,1,2089,[183 318 276 185 196],194,2,7733,3.7,20.0,0.0
12090,1,2090,[ 50 161 603  64 222],234,3,7736,3.699665231946437,20.0,20.0
12091,1,2091,[  9  69  70 238  50],194,3,7739,3.6993307839388145,0.0,20.0
12092,1,2092,[127 313 187 302 483],669,4,7743,3.6994744386048732,20.0,20.0
12093,1,2093,[  7 655 173 174  56],643,5,7748,3.700095510983763,0.0,20.0
12094,1,2094,[127 313 187 302 483],13,5,7753,3.700715990453461,20.0,20.0
12095,1,2095,[161 187 435 172 135],379,4,7757,3.700858778625954,0.0,0.0
12096,1,2096,[127 313 187 302 483],537,5,7762,3.7014783023366715,20.0,20.0
12097,1,2097,[ 64  12  70 195 405],59,3,7765,3.7011439466158245,20.0,0.0
12098,1,2098,[176 216 118 111 194],13,3,7768,3.700809909480705,0.0,0.0
12099,1,2099,[273 121 215 546  96],64,2,7770,3.7,0.0,0.0
12100,1,2100,[127 313 187 302 483],334,5,7775,3.700618752974774,20.0,20.0
12101,1,2101,[ 69 508  12 328 603],533,5,7780,3.7012369172216935,40.0,0.0
12102,1,2102,[268  56 294  79  98],145,5,7785,3.701854493580599,0.0,20.0
12103,1,2103,[127 313 187 302 483],13,5,7790,3.702471482889734,20.0,20.0
12104,1,2104,[127 313 187 302 483],328,5,7795,3.7030878859857483,20.0,20.0
12105,1,2105,[127 403 173 187   9],749,3,7798,3.7027540360873696,0.0,20.0
12106,1,2106,[153  28 127 181 228],653,4,7802,3.7028951115329853,0.0,20.0
12107,1,2107,[127 174 180  96   7],650,3,7805,3.702561669829222,0.0,40.0
12108,1,2108,[ 89 238 515 183   7],474,5,7810,3.703176861071598,0.0,0.0
12109,1,2109,[182  50 271 180 211],650,2,7812,3.7023696682464453,0.0,20.0
12110,1,2110,[ 28 187 194 742 216],804,5,7817,3.7029843675982947,0.0,0.0
12111,1,2111,[385  22 282 100 515],328,3,7820,3.702651515151515,0.0,20.0
12112,1,2112,[222 655 273 471  15],378,3,7823,3.702318977756744,0.0,0.0
12113,1,2113,[181 294 118 183 186],92,3,7826,3.7019867549668874,0.0,0.0
12114,1,2114,[313 127 187 302 483],334,5,7831,3.7026004728132387,20.0,20.0
12115,1,2115,[313 127 187 302 483],328,5,7836,3.7032136105860114,20.0,20.0
12116,1,2116,[143 183 678 144 294],263,3,7839,3.7028814359943314,0.0,0.0
12117,1,2117,[273  88  64 234 475],13,3,7842,3.7025495750708215,0.0,0.0
12118,1,2118,[238 423 173 385  70],666,3,7845,3.702218027371402,0.0,0.0
12119,1,2119,[300   7 185  79 211],843,1,7846,3.700943396226415,0.0,0.0
12120,1,2120,[275 172   7 151  56],474,3,7849,3.7006129184347007,0.0,0.0
12121,1,2121,[ 82  11 228 211 176],882,5,7854,3.701225259189444,0.0,0.0
12122,1,2122,[423   1  56 222  64],360,3,7857,3.7008949599623175,0.0,0.0
12123,1,2123,[328  96 216 273 100],13,2,7859,3.7000941619585688,0.0,20.0
12124,1,2124,[ 89  28 175 546 191],666,4,7863,3.700235294117647,0.0,0.0
12125,1,2125,[135 180 161 210 194],7,4,7867,3.700376293508937,0.0,0.0
12126,1,2126,[ 96 153 655 176 588],234,0,7867,3.698636577338975,0.0,0.0
12127,1,2127,[176 151  96  97 132],843,1,7868,3.6973684210526314,0.0,0.0
12128,1,2128,[313 127 187 302 483],207,5,7873,3.69798027242837,20.0,20.0
12129,1,2129,[385 265 182 357 176],653,3,7876,3.6976525821596242,20.0,0.0
12130,1,2130,[313 127 187 302 483],474,5,7881,3.698263725950258,20.0,20.0
12131,1,2131,[195 483 269 357 323],263,4,7885,3.698405253283302,40.0,0.0
12132,1,2132,[210  71 294 588 161],13,3,7888,3.698077824660103,0.0,0.0
12133,1,2133,[313 127 187 302 483],474,5,7893,3.698687910028116,20.0,20.0
12134,1,2134,[276  50 546 135 268],92,4,7897,3.6988290398126464,0.0,20.0
12135,1,2135,[175  50 174 237  11],749,3,7900,3.698501872659176,0.0,40.0
12136,1,2136,[742 427 515 187 200],271,4,7904,3.6986429574169395,0.0,0.0
12137,1,2137,[235 222   1 313 187],13,2,7906,3.6978484565014034,0.0,0.0
12138,1,2138,[748  96 269 121 289],13,3,7909,3.697522206638616,0.0,0.0
12139,1,2139,[202 179  11 183 515],7,2,7911,3.696728971962617,0.0,0.0
12140,1,2140,[183 210 475 175 200],537,2,7913,3.695936478281177,0.0,0.0
12141,1,2141,[515  96 168  11 195],406,3,7916,3.6956115779645193,0.0,0.0
12142,1,2142,[121  95 181  71 195],897,3,7919,3.6952869808679423,0.0,0.0
12143,1,2143,[313 127 187 302 483],207,5,7924,3.6958955223880596,20.0,20.0
12144,1,2144,[475 271  12 471 117],92,4,7928,3.696037296037296,20.0,0.0
12145,1,2145,[313 127 187 302 483],207,5,7933,3.696644920782852,20.0,20.0
12146,1,2146,[144 175 238  82 181],234,0,7933,3.694923148579413,0.0,0.0
12147,1,2147,[313 127 187 302 483],90,5,7938,3.695530726256983,20.0,20.0
12148,1,2148,[ 50 216   8 168  89],882,5,7943,3.6961377384830154,0.0,20.0
12149,1,2149,[117 333 173 496 475],334,3,7946,3.695813953488372,0.0,0.0
12150,1,2150,[173 168 111 180 234],666,3,7949,3.695490469549047,0.0,0.0
12151,1,2151,[313 127 187 302 483],207,5,7954,3.696096654275093,20.0,20.0
12152,1,2152,[  8 202   1 179 143],200,5,7959,3.696702275894101,0.0,0.0
12153,1,2153,[ 79  11 234   9 210],406,4,7963,3.6968430826369545,0.0,0.0
12154,1,2154,[313 127 187 302 483],207,5,7968,3.697447795823666,20.0,20.0
12155,1,2155,[125 196 265 118  69],92,4,7972,3.697588126159555,0.0,0.0
12156,1,2156,[313 127 187 302 483],207,5,7977,3.698191933240612,20.0,20.0
12157,1,2157,[ 11 202 117 175 168],881,3,7980,3.6978683966635773,0.0,0.0
12158,1,2158,[313 127 187 302 483],474,5,7985,3.698471514590088,20.0,20.0
12159,1,2159,[173 286 237 179 357],194,3,7988,3.698148148148148,20.0,0.0
12160,1,2160,[153 276 328 597 237],13,3,7991,3.697825080981027,0.0,0.0
12161,1,2161,[187 300 475  89 275],90,3,7994,3.6975023126734503,0.0,0.0
12162,1,2162,[302 211 216 197 175],615,5,7999,3.6981044845122515,0.0,0.0
12163,1,2163,[ 64  96 265 655 597],92,4,8003,3.6982439926062844,0.0,0.0
12164,1,2164,[  8 181 222 216 121],474,5,8008,3.6988452655889144,0.0,0.0
12165,1,2165,[ 50 568  28 322  98],13,3,8011,3.698522622345337,0.0,40.0
12166,1,2166,[ 89 187 204 238 483],59,5,8016,3.6991232118135673,20.0,0.0
12167,1,2167,[ 22   1 135 186   4],326,2,8018,3.6983394833948338,0.0,0.0
12168,1,2168,[313 127 187 302 483],90,5,8023,3.698939603503919,20.0,20.0
12169,1,2169,[313 127 187 302 483],328,5,8028,3.6995391705069123,20.0,20.0
12170,1,2170,[313 127 187 302 483],474,5,8033,3.700138185168125,20.0,20.0
12171,1,2171,[286 265 405  11  22],447,3,8036,3.699815837937385,0.0,0.0
12172,1,2172,[202 568  56  98 655],308,4,8040,3.699953980671882,0.0,20.0
12173,1,2173,[313 127 187 302 483],207,5,8045,3.7005519779208833,20.0,20.0
12174,1,2174,[275  64 194 182 196],318,4,8049,3.7006896551724138,0.0,0.0
12175,1,2175,[ 25 181   7 655  28],119,5,8054,3.7012867647058822,0.0,0.0
12176,1,2176,[515 132 318 168 265],488,4,8058,3.701423977951309,20.0,0.0
12177,1,2177,[568 195 357 322 168],749,5,8063,3.702020202020202,20.0,0.0
12178,1,2178,[313 127 187 302 483],90,5,8068,3.702615878843506,20.0,20.0
12179,1,2179,[269   7  98 196 423],452,5,8073,3.703211009174312,0.0,20.0
12180,1,2180,[427 191 100  97 168],406,4,8077,3.7033470884915176,0.0,20.0
12181,1,2181,[313 127 187 302 483],90,5,8082,3.703941338221815,20.0,20.0
12182,1,2182,[183 234 238 257  28],479,5,8087,3.7045350435180944,0.0,0.0
12183,1,2183,[197 546 471 191 237],194,2,8089,3.703754578754579,0.0,0.0
12184,1,2184,[144 385 403 302 471],328,2,8091,3.702974828375286,0.0,0.0
12185,1,2185,[313 127 187 302 483],537,5,8096,3.7035681610247027,20.0,20.0
12186,1,2186,[  1 172 183  88 194],326,3,8099,3.703246456332876,0.0,0.0
12187,1,2187,[313 127 187 302 483],669,4,8103,3.703382084095064,20.0,20.0
12188,1,2188,[313 127 187 302 483],90,5,8108,3.703974417542257,20.0,20.0
12189,1,2189,[ 98 238 153 118 111],833,0,8108,3.702283105022831,0.0,20.0
12190,1,2190,[211 423 234 238 183],59,5,8113,3.702875399361022,0.0,0.0
12191,1,2191,[423 174  50 144   4],749,5,8118,3.7034671532846715,0.0,40.0
12192,1,2192,[200 100 302 161 313],378,4,8122,3.7036023711810304,0.0,20.0
12193,1,2193,[185 265  95  79 286],524,4,8126,3.7037374658158613,0.0,0.0
12194,1,2194,[568 273  28 286 181],537,0,8126,3.702050113895216,0.0,0.0
12195,1,2195,[508 228 181 216 195],13,2,8128,3.7012750455373404,0.0,0.0
12196,1,2196,[313 127 187 302 483],334,5,8133,3.701866181156122,20.0,20.0
12197,1,2197,[ 22 288 234 195 151],339,3,8136,3.7015468607825297,0.0,0.0
12198,1,2198,[ 50 153 483  88 181],184,3,8139,3.7012278308321966,20.0,20.0
12199,1,2199,[313 127 187 302 483],537,5,8144,3.7018181818181817,20.0,20.0
12200,1,2200,[211  11 181 216 357],328,3,8147,3.7014993184915945,20.0,0.0
12201,1,2201,[183 144 187 322 237],313,3,8150,3.701180744777475,0.0,0.0
12202,1,2202,[405  25 211  71 265],648,3,8153,3.7008624602814346,0.0,0.0
12203,1,2203,[385 603   8 276 132],533,3,8156,3.7005444646098002,20.0,0.0
12204,1,2204,[ 28 132 302 235  25],343,4,8160,3.7006802721088436,0.0,0.0
12205,1,2205,[313 127 187 302 483],474,5,8165,3.7012692656391657,20.0,20.0
12206,1,2206,[423 427 742  98  15],308,3,8168,3.7009515178975985,0.0,20.0
12207,1,2207,[323 403 276  71 588],13,3,8171,3.7006340579710146,0.0,0.0
12208,1,2208,[ 71 265 216 173 289],524,4,8175,3.7007695789950206,0.0,0.0
12209,1,2209,[ 79  64  22 132 100],892,5,8180,3.7013574660633486,0.0,20.0
12210,1,2210,[313 127 187 302 483],207,5,8185,3.7019448213478063,20.0,20.0
12211,1,2211,[ 97 174 289   1 435],454,2,8187,3.7011754068716094,0.0,20.0
12212,1,2212,[313 127 187 302 483],537,5,8192,3.701762313601446,20.0,20.0
12213,1,2213,[313 127 187 302 483],537,5,8197,3.7023486901535683,20.0,20.0
12214,1,2214,[127 175 196  82 200],339,5,8202,3.70293453724605,0.0,20.0
12215,1,2215,[  4 234  12 125 179],92,5,8207,3.7035198555956677,20.0,0.0
12216,1,2216,[195  69 435 300 289],533,4,8211,3.7036535859269284,0.0,0.0
12217,1,2217,[483 118 265 161  69],380,2,8213,3.7028854824165913,20.0,0.0
12218,1,2218,[655 568 168 176 301],940,2,8215,3.7021180712032447,0.0,0.0
12219,1,2219,[100   8 268 180 238],387,4,8219,3.702252252252252,0.0,20.0
12220,1,2220,[111  98 168  64  25],533,5,8224,3.7028365601080595,0.0,20.0
12221,1,2221,[121 100 265 515 333],145,3,8227,3.7025202520252027,0.0,20.0
12222,1,2222,[ 56 215 235 273 258],92,4,8231,3.702654071075124,0.0,0.0
12223,1,2223,[265 204   7 475 282],474,5,8236,3.7032374100719423,0.0,0.0
12224,1,2224,[222 385 655  64  12],343,4,8240,3.703370786516854,20.0,0.0
12225,1,2225,[132 471 181  96 210],7,4,8244,3.7035040431266846,0.0,0.0
12226,1,2226,[ 70 423 186  89 153],87,4,8248,3.7036371800628647,0.0,0.0
12227,1,2227,[222 191 748 475 328],699,1,8249,3.702423698384201,0.0,0.0
12228,1,2228,[313 127 187 302 483],13,5,8254,3.7030058322117543,20.0,20.0
12229,1,2229,[385 174 742  50 211],346,5,8259,3.7035874439461884,0.0,40.0
12230,1,2230,[286 238  64  56 194],406,3,8262,3.703272075302555,0.0,0.0
12231,1,2231,[ 64  12 121   9  89],308,4,8266,3.703405017921147,20.0,0.0
12232,1,2232,[313 127 187 302 483],334,5,8271,3.7039856695029107,20.0,20.0
12233,1,2233,[288 210 257  50 196],334,3,8274,3.70367054610564,0.0,20.0
12234,1,2234,[195   9 318 286 211],474,5,8279,3.7042505592841164,20.0,0.0
12235,1,2235,[655 302 161  22 289],833,0,8279,3.702593917710197,0.0,0.0
12236,1,2236,[313 127 187 302 483],537,5,8284,3.7031738936075103,20.0,20.0
12237,1,2237,[405 357  79 222 235],328,3,8287,3.7028596961572835,20.0,0.0
12238,1,2238,[508  98 161  71 117],543,4,8291,3.7029924073246985,0.0,20.0
12239,1,2239,[179 180 100 127 318],87,5,8296,3.7035714285714287,20.0,40.0
12240,1,2240,[196 121 216 357  71],85,3,8299,3.703257474341812,20.0,0.0
12241,1,2241,[216 132  28 475 288],308,2,8301,3.7024977698483497,0.0,0.0
12242,1,2242,[328 127   1 173 117],13,1,8302,3.7012929112795363,0.0,20.0
12243,1,2243,[483  88   1 132 211],194,3,8305,3.700980392156863,20.0,0.0
12244,1,2244,[313 127 187 302 483],13,5,8310,3.7015590200445434,20.0,20.0
12245,1,2245,[ 89 196 265 182 202],59,5,8315,3.7021371326803205,0.0,0.0
12246,1,2246,[655 186 483 435 210],804,4,8319,3.7022696929238985,20.0,0.0
12247,1,2247,[313 127 187 302 483],669,4,8323,3.7024021352313166,20.0,20.0
12248,1,2248,[282  28  64 237 204],119,5,8328,3.7029791018230322,0.0,0.0
12249,1,2249,[313 127 187 302 483],90,5,8333,3.7035555555555555,20.0,20.0
12250,1,2250,[313 127 187 302 483],669,4,8337,3.7036872501110616,20.0,20.0
12251,1,2251,[313 127 187 302 483],537,5,8342,3.7042628774422734,20.0,20.0
12252,1,2252,[313 127 187 302 483],334,5,8347,3.704837993786063,20.0,20.0
12253,1,2253,[238 234 294  50 200],378,2,8349,3.704081632653061,0.0,20.0
12254,1,2254,[313 127 187 302 483],13,5,8354,3.7046563192904656,20.0,20.0
12255,1,2255,[ 98 194 191 121 216],533,5,8359,3.705230496453901,0.0,20.0
12256,1,2256,[111 427 181 125  11],334,3,8362,3.7049180327868854,0.0,0.0
12257,1,2257,[313 127 187 302 483],669,4,8366,3.7050487156775906,20.0,20.0
12258,1,2258,[313 127 187 302 483],207,5,8371,3.7056219566179727,20.0,20.0
12259,1,2259,[216 222 173 182 153],64,4,8375,3.7057522123893807,0.0,0.0
12260,1,2260,[318 405   7 496  25],378,3,8378,3.7054400707651483,20.0,0.0
12261,1,2261,[196 210 175 269 132],334,2,8380,3.704686118479222,0.0,0.0
12262,1,2262,[111  11 245 197 194],207,2,8382,3.7039328325231993,0.0,0.0
12263,1,2263,[135 211 127  70 118],328,3,8385,3.7036219081272086,0.0,20.0
12264,1,2264,[ 64 191   8 515 257],474,4,8389,3.7037527593818984,0.0,0.0
12265,1,2265,[405 100 568 245 748],328,3,8392,3.703442188879082,0.0,20.0
12266,1,2266,[313 127 187 302 483],207,5,8397,3.7040141155712396,20.0,20.0
12267,1,2267,[ 89  88 568   8 238],343,3,8400,3.7037037037037037,0.0,0.0
12268,1,2268,[313 127 187 302 483],669,4,8404,3.7038342882327018,20.0,20.0
12269,1,2269,[173 435 180 228 195],312,3,8407,3.70352422907489,0.0,0.0
12270,1,2270,[121 258 204  79 302],102,2,8409,3.702774108322325,0.0,0.0
12271,1,2271,[313 127 187 302 483],207,5,8414,3.703345070422535,20.0,20.0
12272,1,2272,[211 161 323 117   1],311,3,8417,3.703035635723713,0.0,0.0
12273,1,2273,[258 423  64 211 237],90,4,8421,3.703166226912929,0.0,0.0
12274,1,2274,[313 127 187 302 483],537,5,8426,3.7037362637362636,20.0,20.0
12275,1,2275,[313 127 187 302 483],334,5,8431,3.7043057996485063,20.0,20.0
12276,1,2276,[191 100 427   8 294],379,4,8435,3.7044356609574,0.0,20.0
12277,1,2277,[185 121   8 289  69],328,4,8439,3.7045654082528534,0.0,0.0
12278,1,2278,[313 127 187 302 483],334,5,8444,3.705133830627468,20.0,20.0
12279,1,2279,[294 196  96 182  15],537,1,8445,3.7039473684210527,0.0,0.0
12280,1,2280,[  7   8 121 269 475],452,4,8449,3.7040771591407275,0.0,0.0
12281,1,2281,[313 127 187 302 483],474,5,8454,3.7046450482033304,20.0,20.0
12282,1,2282,[186 183 173 405 568],102,2,8456,3.703898379325449,0.0,0.0
12283,1,2283,[ 28 186 515 318  97],804,5,8461,3.70446584938704,20.0,0.0
12284,1,2284,[  4 235 215 546 568],788,0,8461,3.7028446389496716,0.0,0.0
12285,1,2285,[405 196 121  79 323],804,5,8466,3.7034120734908136,0.0,0.0
12286,1,2286,[257   8 161 276 174],308,4,8470,3.7035417577612595,0.0,20.0
12287,1,2287,[427 168  71 597  82],882,5,8475,3.7041083916083917,0.0,0.0
12288,1,2288,[313 127 187 302 483],207,5,8480,3.704674530362604,20.0,20.0
12289,1,2289,[187  22  11 265 357],308,4,8484,3.7048034934497815,20.0,0.0
12290,1,2290,[  8 187 268 678 176],334,3,8487,3.704495853339153,0.0,0.0
12291,1,2291,[313 127 187 302 483],328,5,8492,3.7050610820244327,20.0,20.0
12292,1,2292,[313 127 187 302 483],669,4,8496,3.705189707806367,20.0,20.0
12293,1,2293,[286  97 655 603 357],387,2,8498,3.7044463818657367,40.0,0.0
12294,1,2294,[121 196 269 194 204],452,4,8502,3.704575163398693,0.0,0.0
12295,1,2295,[385 333 196 210 197],666,1,8503,3.703397212543554,0.0,0.0
12296,1,2296,[182 276 273 202  96],538,3,8506,3.703090988245538,0.0,0.0
12297,1,2297,[313 127 187 302 483],207,5,8511,3.7036553524804177,20.0,20.0
12298,1,2298,[313 127 187 302 483],328,5,8516,3.704219225750326,20.0,20.0
12299,1,2299,[172 603 237 187 302],537,3,8519,3.703913043478261,20.0,0.0
12300,1,2300,[313 127 187 302 483],537,5,8524,3.704476314645806,20.0,20.0
12301,1,2301,[313 127 187 302 483],13,5,8529,3.70503909643788,20.0,20.0
12302,1,2302,[161 179  70 294 185],95,1,8530,3.7038645245332176,0.0,0.0
12303,1,2303,[  1 286 288 322  15],699,0,8530,3.7022569444444446,0.0,0.0
12304,1,2304,[100  96 258 385 588],59,3,8533,3.701952277657267,0.0,20.0
12305,1,2305,[121  79 405 302 483],343,4,8537,3.702081526452732,20.0,0.0
12306,1,2306,[357 423  89 121 125],271,2,8539,3.7013437364542696,20.0,0.0
12307,1,2307,[183 196 176 496  69],380,4,8543,3.701473136915078,0.0,0.0
12308,1,2308,[ 69 176 403  71 435],387,0,8543,3.699870073624946,0.0,0.0
12309,1,2309,[238 742 185 197   7],666,4,8547,3.7,0.0,0.0
12310,1,2310,[  1  82 211 135 257],379,5,8552,3.7005625270445694,0.0,0.0
12311,1,2311,[144 238 143  96 151],7,4,8556,3.7006920415224913,0.0,0.0
12312,1,2312,[88  7 25 95 98],92,2,8558,3.699956766104626,0.0,20.0
12313,1,2313,[265  97 257 183 179],308,3,8561,3.699654278305964,0.0,0.0
12314,1,2314,[ 89 234  64 135  96],308,4,8565,3.699784017278618,0.0,0.0
12315,1,2315,[301  11 655 275 302],116,2,8567,3.699050086355786,0.0,0.0
12316,1,2316,[234   7  12 235 268],92,4,8571,3.6991799741044455,20.0,0.0
12317,1,2317,[318 258 172  22 678],7,4,8575,3.699309749784297,20.0,0.0
12318,1,2318,[282 222 211  28 257],804,5,8580,3.69987063389392,0.0,0.0
12319,1,2319,[228 210  89 405 143],882,5,8585,3.7004310344827585,0.0,0.0
12320,1,2320,[313 127 187 302 483],90,5,8590,3.700990952175786,20.0,20.0
12321,1,2321,[294 191 117  28 161],387,2,8592,3.7002583979328167,0.0,0.0
12322,1,2322,[313 127 187 302 483],334,5,8597,3.7008179078777443,20.0,20.0
12323,1,2323,[168 216 194 423 405],666,1,8598,3.6996557659208262,0.0,0.0
12324,1,2324,[313 127 187 302 483],334,5,8603,3.700215053763441,20.0,20.0
12325,1,2325,[  4 228 403 143 257],374,1,8604,3.699054170249355,0.0,0.0
12326,1,2326,[127 282  69  28 197],666,2,8606,3.6983240223463687,0.0,20.0
12327,1,2327,[515 301 222 265 180],13,2,8608,3.6975945017182132,0.0,0.0
12328,1,2328,[174 237   9  50 183],374,3,8611,3.6972949763847143,0.0,40.0
12329,1,2329,[313 127 187 302 483],13,5,8616,3.697854077253219,20.0,20.0
12330,1,2330,[313 127 187 302 483],13,5,8621,3.6984126984126986,20.0,20.0
12331,1,2331,[180 194   9 100  56],239,4,8625,3.6985420240137223,0.0,20.0
12332,1,2332,[ 56  28  96 216 144],308,2,8627,3.697813973424775,0.0,0.0
12333,1,2333,[179 200 132 238 197],650,4,8631,3.697943444730077,0.0,0.0
12334,1,2334,[496 132 168 175   4],385,2,8633,3.6972162740899357,0.0,0.0
12335,1,2335,[313 127 187 302 483],207,5,8638,3.69777397260274,20.0,20.0
12336,1,2336,[ 25  64   9 258 200],234,2,8640,3.6970474967907574,0.0,0.0
12337,1,2337,[135 185 294  56 678],82,1,8641,3.6958939264328485,0.0,0.0
12338,1,2338,[ 82   7 182  79   9],194,1,8642,3.6947413424540403,0.0,0.0
12339,1,2339,[318 216 234 179 508],537,3,8645,3.6944444444444446,20.0,0.0
12340,1,2340,[180 181  79 435 322],474,5,8650,3.6950021358393847,0.0,0.0
12341,1,2341,[ 89 132 176 276 234],339,5,8655,3.695559350982067,0.0,0.0
12342,1,2342,[202 294 286 427   9],234,1,8656,3.694408877507469,0.0,0.0
12343,1,2343,[238 182 403 144 427],650,2,8658,3.6936860068259385,0.0,0.0
12344,1,2344,[313 127 187 302 483],474,5,8663,3.6942430703624733,20.0,20.0
12345,1,2345,[323 265 181  25  56],648,3,8666,3.6939471440750213,0.0,0.0
12346,1,2346,[423 135 742  82 215],42,5,8671,3.6945036216446527,0.0,0.0
12347,1,2347,[ 25 258 180 118 546],447,4,8675,3.6946337308347528,0.0,0.0
12348,1,2348,[515 405 132 655  56],643,4,8679,3.6947637292464877,0.0,0.0
12349,1,2349,[313 127 187 302 483],328,5,8684,3.69531914893617,20.0,20.0
12350,1,2350,[ 11 179 172 273 742],59,3,8687,3.6950233943002977,0.0,0.0
12351,1,2351,[ 70 546 174 195 471],194,1,8688,3.693877551020408,0.0,20.0
12352,1,2352,[174 385  64 286  71],378,5,8693,3.6944326391840203,0.0,20.0
12353,1,2353,[216 235 294   1 288],650,1,8694,3.693288020390824,0.0,0.0
12354,1,2354,[215 234  88 435  25],343,3,8697,3.6929936305732483,0.0,0.0
12355,1,2355,[313 127 187 302 483],537,5,8702,3.693548387096774,20.0,20.0
12356,1,2356,[237 179   1  25 655],308,4,8706,3.693678404751803,0.0,0.0
12357,1,2357,[423 357 211 197 182],774,1,8707,3.6925360474978794,20.0,0.0
12358,1,2358,[  8 655 174  95 153],194,2,8709,3.691818567189487,0.0,20.0
12359,1,2359,[204 194 403  56 187],749,3,8712,3.6915254237288138,0.0,0.0
12360,1,2360,[405  79  12 403 568],892,4,8716,3.691656077933079,20.0,0.0
12361,1,2361,[ 11 269 234 210 168],271,4,8720,3.6917866215071973,0.0,0.0
12362,1,2362,[ 71 118  28 195 423],738,3,8723,3.691493863732543,0.0,0.0
12363,1,2363,[313 127 187 302 483],474,5,8728,3.692047377326565,20.0,20.0
12364,1,2364,[172 100  56 215 191],488,2,8730,3.6913319238900635,0.0,20.0
12365,1,2365,[118 286 496 211  89],7,4,8734,3.691462383770076,0.0,0.0
12366,1,2366,[151 121 200 161 286],881,1,8735,3.690325306294888,0.0,0.0
12367,1,2367,[655 288 475  70 135],334,3,8738,3.6900337837837838,0.0,0.0
12368,1,2368,[313 127 187 302 483],669,4,8742,3.690164626424652,20.0,20.0
12369,1,2369,[191 385   9 143 655],13,1,8743,3.6890295358649787,0.0,0.0
12370,1,2370,[435  89   7 597 118],102,1,8744,3.6878954027836355,0.0,0.0
12371,1,2371,[318 174 238  25 302],458,3,8747,3.6876053962900506,20.0,20.0
12372,1,2372,[ 25 195  28 568  97],378,4,8751,3.6877370417193425,0.0,0.0
12373,1,2373,[435  70 179 269  82],537,2,8753,3.6870261162594775,0.0,0.0
12374,1,2374,[143 121 403 235   9],194,1,8754,3.6858947368421053,0.0,0.0
12375,1,2375,[195 153 515  98 286],95,5,8759,3.6864478114478114,0.0,20.0
12376,1,2376,[  8 186 132 215 180],95,3,8762,3.6861590239798065,0.0,0.0
12377,1,2377,[300 328 127 161 117],334,1,8763,3.6850294365012615,0.0,20.0
12378,1,2378,[286 405 276  56 678],82,2,8765,3.6843211433375367,0.0,0.0
12379,1,2379,[313 127 187 302  64],474,5,8770,3.6848739495798317,0.0,20.0
12380,1,2380,[742 186  12 471 174],788,1,8771,3.6837463250734985,20.0,20.0
12381,1,2381,[  4 405 187 288 515],7,3,8774,3.683459277917716,0.0,0.0
12382,1,2382,[313 127 187 302  64],669,5,8779,3.6840117498950904,0.0,20.0
12383,1,2383,[ 97 151 168 403 237],64,3,8782,3.6837248322147653,0.0,0.0
12384,1,2384,[313 127 187 302  64],328,5,8787,3.6842767295597483,0.0,20.0
12385,1,2385,[313 127 187 302  64],90,5,8792,3.6848281642917016,0.0,20.0
12386,1,2386,[191 100  64 423   4],343,5,8797,3.68537913699204,0.0,20.0
12387,1,2387,[ 89 546 151 204 144],313,4,8801,3.6855108877721943,0.0,0.0
12388,1,2388,[313 127 187 302  64],207,5,8806,3.686061113436584,0.0,20.0
12389,1,2389,[313 127 187 302  64],669,5,8811,3.686610878661088,0.0,20.0
12390,1,2390,[313 127 187 302  64],207,5,8816,3.6871601840234214,0.0,20.0
12391,1,2391,[216  70 471 185 118],524,5,8821,3.6877090301003346,0.0,0.0
12392,1,2392,[313 127 187 302  64],13,5,8826,3.688257417467614,0.0,20.0
12393,1,2393,[ 96 195 294 127 175],308,4,8830,3.6883876357560568,0.0,20.0
12394,1,2394,[318 323 597 144  28],13,2,8832,3.6876826722338203,20.0,0.0
12395,1,2395,[313 127 187 302  64],669,5,8837,3.6882303839732886,0.0,20.0
12396,1,2396,[144 508 269  22 228],339,4,8841,3.688360450563204,0.0,0.0
12397,1,2397,[ 89 121 118  70 172],653,2,8843,3.687656380316931,0.0,0.0
12398,1,2398,[515 286  89 191   8],387,4,8847,3.6877865777407255,0.0,0.0
12399,1,2399,[ 11 100  50 742 286],59,3,8850,3.6875,0.0,40.0
12400,1,2400,[168  12 175   1 546],42,2,8852,3.6867971678467306,20.0,0.0
12401,1,2401,[135  25 294  56 357],533,2,8854,3.686094920899251,20.0,0.0
12402,1,2402,[237   7 475 111 173],13,2,8856,3.6853932584269664,0.0,0.0
12403,1,2403,[143 174 265 200 125],815,5,8861,3.6859400998336107,0.0,20.0
12404,1,2404,[176  96 179  97  89],897,4,8865,3.686070686070686,0.0,0.0
12405,1,2405,[313 127 187 302  64],207,5,8870,3.686616791354946,0.0,20.0
12406,1,2406,[313 405 172 655 301],334,2,8872,3.6859160781055254,0.0,0.0
12407,1,2407,[234 405  71 168  64],7,4,8876,3.686046511627907,0.0,0.0
12408,1,2408,[186   4 100 127 435],207,4,8880,3.6861768368617684,0.0,40.0
12409,1,2409,[172 175 496 258 508],378,4,8884,3.6863070539419085,0.0,0.0
12410,1,2410,[546 168 215 179  82],343,4,8888,3.6864371630029034,0.0,0.0
12411,1,2411,[546 181 405 357 186],666,2,8890,3.685737976782753,20.0,0.0
12412,1,2412,[ 12 508  50 187 211],474,4,8894,3.6858682138416907,20.0,20.0
12413,1,2413,[176 294  98 405  25],374,4,8898,3.6859983429991714,0.0,20.0
12414,1,2414,[313 127 187 302  64],328,5,8903,3.686542443064182,0.0,20.0
12415,1,2415,[313 127 187 302  64],144,4,8907,3.6866721854304636,0.0,20.0
12416,1,2416,[313 127 187 302  64],13,5,8912,3.687215556474969,0.0,20.0
12417,1,2417,[144  98 357   7 121],650,3,8915,3.686931348221671,20.0,20.0
12418,1,2418,[197 175  98 153 118],664,4,8919,3.6870607689127737,0.0,20.0
12419,1,2419,[ 50  89  69 322  98],313,4,8923,3.687190082644628,0.0,40.0
12420,1,2420,[313 127 187 302  64],537,4,8927,3.6873192895497726,0.0,20.0
12421,1,2421,[275  50 313 215 515],271,5,8932,3.6878612716763004,0.0,20.0
12422,1,2422,[603  25 118 237  95],804,4,8936,3.687990094923648,20.0,0.0
12423,1,2423,[318 403   9 172 176],13,1,8937,3.6868811881188117,20.0,0.0
12424,1,2424,[ 79 515 211 180 195],313,5,8942,3.687422680412371,0.0,0.0
12425,1,2425,[288 197  11 135 357],833,3,8945,3.6871393239901074,20.0,0.0
12426,1,2426,[313 127 187 302  64],537,4,8949,3.6872682323856614,0.0,20.0
12427,1,2427,[313 127 187 302 483],207,5,8954,3.687808896210873,20.0,20.0
12428,1,2428,[603 118 175 143 176],308,4,8958,3.6879374228077397,20.0,0.0
12429,1,2429,[ 96 179  15 276 294],378,3,8961,3.6876543209876544,0.0,0.0
12430,1,2430,[182 313 568 655 174],119,5,8966,3.688194158782394,0.0,20.0
12431,1,2431,[216  12   4 186 181],346,3,8969,3.687911184210526,20.0,0.0
12432,1,2432,[ 96 191 179 173 210],95,4,8973,3.6880394574599262,0.0,0.0
12433,1,2433,[313 127 187 302 483],334,5,8978,3.6885784716516024,20.0,20.0
12434,1,2434,[196  22   1 168 237],326,2,8980,3.6878850102669403,0.0,0.0
12435,1,2435,[ 15  28 191 275 195],694,5,8985,3.688423645320197,0.0,0.0
12436,1,2436,[313 127 187 302 483],328,5,8990,3.6889618383258105,20.0,20.0
12437,1,2437,[143 187   1  69 655],537,1,8991,3.68785890073831,0.0,0.0
12438,1,2438,[427 186   1 132 196],380,4,8995,3.6879868798687987,0.0,0.0
12439,1,2439,[403 234 588 496 655],194,3,8998,3.6877049180327868,0.0,0.0
12440,1,2440,[200 197 127  69 117],234,4,9002,3.6878328553871365,0.0,20.0
12441,1,2441,[313 127 187 302 483],537,5,9007,3.6883701883701883,20.0,20.0
12442,1,2442,[313 127 187 302 483],328,5,9012,3.688907081457225,20.0,20.0
12443,1,2443,[405 121  50 597 185],13,2,9014,3.688216039279869,0.0,20.0
12444,1,2444,[313 127 187 302 483],328,5,9019,3.688752556237219,20.0,20.0
12445,1,2445,[313 127 187 302 483],328,5,9024,3.689288634505315,20.0,20.0
12446,1,2446,[100 186  79 181  88],452,3,9027,3.6890069472823868,0.0,20.0
12447,1,2447,[ 89 144   4  82 385],308,4,9031,3.6891339869281046,0.0,0.0
12448,1,2448,[191 405 174  71 318],892,4,9035,3.689260922825643,20.0,20.0
12449,1,2449,[313 127 187 302 483],13,5,9040,3.6897959183673468,20.0,20.0
12450,1,2450,[313 127 187 302 483],334,5,9045,3.690330477356181,20.0,20.0
12451,1,2451,[238 405 471 286 294],13,0,9045,3.6888254486133767,0.0,0.0
12452,1,2452,[385 515 210 748   9],474,4,9049,3.688952303302079,0.0,0.0
12453,1,2453,[282 265 182 216  79],334,2,9051,3.6882640586797066,0.0,0.0
12454,1,2454,[  7 143 322 258 313],474,5,9056,3.6887983706720977,0.0,0.0
12455,1,2455,[  7  98   8 174 151],148,4,9060,3.688925081433225,0.0,40.0
12456,1,2456,[ 50  95  97 135 423],738,5,9065,3.6894586894586894,0.0,20.0
12457,1,2457,[318 357 183 235 597],59,3,9068,3.6891781936533765,40.0,0.0
12458,1,2458,[323 222 294 742 237],328,2,9070,3.688491256608377,0.0,0.0
12459,1,2459,[475 216 172 111  98],92,3,9073,3.688211382113821,0.0,20.0
12460,1,2460,[483  28 496 655 238],666,4,9077,3.6883380739536773,20.0,0.0
12461,1,2461,[313 127 187 302 483],13,5,9082,3.6888708367181153,20.0,20.0
12462,1,2462,[313 127 187 302 483],207,5,9087,3.689403166869671,20.0,20.0
12463,1,2463,[185 174 403 313  79],13,2,9089,3.6887175324675323,0.0,20.0
12464,1,2464,[313 127 187 302 483],207,5,9094,3.6892494929006086,20.0,20.0
12465,1,2465,[144 179 125 435 173],7,5,9099,3.68978102189781,0.0,0.0
12466,1,2466,[294 202 568 265 174],308,3,9102,3.689501418727199,0.0,20.0
12467,1,2467,[176 282 100 496   7],334,3,9105,3.689222042139384,0.0,20.0
12468,1,2468,[202  71 210   9 300],7,4,9109,3.6893479141352774,0.0,0.0
12469,1,2469,[153 183 185  22 294],804,5,9114,3.6898785425101215,0.0,0.0
12470,1,2470,[313 127 187 302 483],537,5,9119,3.6904087414002427,20.0,20.0
12471,1,2471,[ 97 151 603 135 405],474,4,9123,3.6905339805825244,20.0,0.0
12472,1,2472,[153 483 182  88 603],815,3,9126,3.6902547513141934,40.0,0.0
12473,1,2473,[318  56 183 186 194],328,4,9130,3.690379951495554,20.0,0.0
12474,1,2474,[ 95 568  64  97  11],387,0,9130,3.688888888888889,0.0,0.0
12475,1,2475,[ 56 135  69 427 187],6,4,9134,3.6890145395799676,0.0,0.0
12476,1,2476,[  9 257 144 288   1],676,3,9137,3.68873637464675,0.0,0.0
12477,1,2477,[273 121  89 237 135],59,3,9140,3.688458434221146,0.0,0.0
12478,1,2478,[313 127 187 302 483],537,5,9145,3.688987494957644,20.0,20.0
12479,1,2479,[100 655 174 742 322],313,3,9148,3.6887096774193546,0.0,40.0
12480,1,2480,[328 302 176  11 151],334,3,9151,3.6884320838371623,0.0,0.0
12481,1,2481,[ 88 204 322  89  79],92,3,9154,3.6881547139403708,0.0,0.0
12482,1,2482,[322 496 127  82  56],537,3,9157,3.6878775674587194,0.0,20.0
12483,1,2483,[300 117 100 215 181],537,1,9158,3.686795491143317,0.0,20.0
12484,1,2484,[234 143   4 215 121],659,4,9162,3.6869215291750503,0.0,0.0
12485,1,2485,[313 127 187 302 483],474,5,9167,3.68744971842317,20.0,20.0
12486,1,2486,[496  50 161  79 144],653,3,9170,3.6871733011660637,0.0,20.0
12487,1,2487,[216  82 176 172  64],311,5,9175,3.687700964630225,0.0,0.0
12488,1,2488,[174 385 403 179  11],343,4,9179,3.687826436319807,0.0,20.0
12489,1,2489,[603  82 655  79  97],13,3,9182,3.687550200803213,20.0,0.0
12490,1,2490,[313 127 187 302 483],207,5,9187,3.688077077478924,20.0,20.0
12491,1,2491,[228  22 121  98 191],749,4,9191,3.688202247191011,0.0,20.0
12492,1,2492,[172 237   1 216  97],145,4,9195,3.6883273164861614,0.0,0.0
12493,1,2493,[237   4 200 238 508],653,1,9196,3.6872493985565358,0.0,0.0
12494,1,2494,[182 200 174   1 181],234,1,9197,3.686172344689379,0.0,20.0
12495,1,2495,[197 234 245  28 742],653,2,9199,3.6854967948717947,0.0,0.0
12496,1,2496,[235 202  11 121  12],13,3,9202,3.6852222667200643,20.0,0.0
12497,1,2497,[210 235   9 427 153],87,4,9206,3.6853482786228984,0.0,0.0
12498,1,2498,[211 228 183 175 265],339,4,9210,3.6854741896758703,0.0,0.0
12499,1,2499,[185   1  50 483 216],95,3,9213,3.6852,20.0,20.0
12500,1,2500,[ 28 258 237 318 153],313,1,9214,3.684126349460216,20.0,0.0
12501,1,2501,[597 333 182 427 127],458,3,9217,3.683852917665867,0.0,20.0
12502,1,2502,[515  28 357 127 496],474,5,9222,3.6843787455053936,20.0,20.0
12503,1,2503,[313 127 187 302 483],334,5,9227,3.6849041533546325,20.0,20.0
12504,1,2504,[ 28 204  88 265 215],83,5,9232,3.685429141716567,0.0,0.0
12505,1,2505,[313 127 187 302 483],537,5,9237,3.6859537110933758,20.0,20.0
12506,1,2506,[276 318 100 302  50],13,4,9241,3.6860789788591943,20.0,40.0
12507,1,2507,[  9 328 748 496 168],533,4,9245,3.6862041467304625,0.0,0.0
12508,1,2508,[196 194 153  82 435],263,4,9249,3.6863292148266242,0.0,0.0
12509,1,2509,[ 98 357 496 748 176],749,4,9253,3.686454183266932,20.0,20.0
12510,1,2510,[172 196 258 423 211],215,4,9257,3.6865790521704502,0.0,0.0
12511,1,2511,[143 234 117 176 268],537,1,9258,3.6855095541401273,0.0,0.0
12512,1,2512,[313 127 187 302 483],537,5,9263,3.686032630322324,20.0,20.0
12513,1,2513,[313 127 187 302 483],334,5,9268,3.686555290373906,20.0,20.0
12514,1,2514,[235 238 173 144 265],92,3,9271,3.686282306163022,0.0,0.0
12515,1,2515,[202 132  89 385  12],92,3,9274,3.6860095389507155,20.0,0.0
12516,1,2516,[121  22 427 508 238],537,3,9277,3.685736988478347,0.0,0.0
12517,1,2517,[186  12  56 127 117],343,4,9281,3.6858617950754566,20.0,20.0
12518,1,2518,[294  70 228 118 235],804,5,9286,3.686383485510123,0.0,0.0
12519,1,2519,[405 423  71 172 127],374,3,9289,3.686111111111111,0.0,20.0
12520,1,2520,[191 174  97   8  70],234,2,9291,3.685442284807616,0.0,20.0
12521,1,2521,[313 127 187 302 483],90,5,9296,3.685963521015067,20.0,20.0
12522,1,2522,[ 25 515 127 185 234],881,3,9299,3.6856916369401507,0.0,20.0
12523,1,2523,[313 127 187 302 483],334,5,9304,3.6862123613312203,20.0,20.0
12524,1,2524,[405 276 204 132  95],194,1,9305,3.6851485148514853,0.0,0.0
12525,1,2525,[182 179 161 294 234],308,2,9307,3.6844813935075216,0.0,0.0
12526,1,2526,[403 655 216 742 161],313,3,9310,3.6842105263157894,0.0,0.0
12527,1,2527,[179   7  82   4  98],64,3,9313,3.6839398734177213,0.0,20.0
12528,1,2528,[313 127 187 302 483],90,5,9318,3.6844602609727164,20.0,20.0
12529,1,2529,[202 100  22 276   4],533,3,9321,3.684189723320158,0.0,20.0
12530,1,2530,[187 385 200 275 323],474,2,9323,3.6835242986961676,0.0,0.0
12531,1,2531,[111 328 471  97 222],479,4,9327,3.683649289099526,0.0,0.0
12532,1,2532,[322 568 181 313  28],454,3,9330,3.6833793920252664,0.0,0.0
12533,1,2533,[ 15 269 187 597 276],452,3,9333,3.683109707971586,0.0,0.0
12534,1,2534,[186 237 202 181 183],882,5,9338,3.683629191321499,0.0,0.0
12535,1,2535,[313 127 187 302 483],207,5,9343,3.684148264984227,20.0,20.0
12536,1,2536,[568   8 195 175 655],7,5,9348,3.6846669294442256,0.0,0.0
12537,1,2537,[ 97 269 183   4 313],650,3,9351,3.6843971631205674,0.0,0.0
12538,1,2538,[ 56  71 132 111 302],474,5,9356,3.6849153209925167,0.0,0.0
12539,1,2539,[ 88  71 118 125 143],92,2,9358,3.684251968503937,0.0,0.0
12540,1,2540,[135  97  95 196  69],194,1,9359,3.683195592286501,0.0,0.0
12541,1,2541,[ 11  95 286  50 357],271,5,9364,3.6837136113296616,20.0,20.0
12542,1,2542,[313 127 187 302 483],13,5,9369,3.684231222965002,20.0,20.0
12543,1,2543,[143 597 182 294   7],804,3,9372,3.6839622641509435,0.0,0.0
12544,1,2544,[313 127 187 302 483],334,5,9377,3.6844793713163067,20.0,20.0
12545,1,2545,[313 127 187 302 483],90,5,9382,3.684996072270228,20.0,20.0
12546,1,2546,[313 127 187 302 483],669,4,9386,3.685119748723989,20.0,20.0
12547,1,2547,[  1 222 121   9  15],168,4,9390,3.685243328100471,0.0,0.0
12548,1,2548,[313 127 187 302 427],90,5,9395,3.6857591212240095,0.0,20.0
12549,1,2549,[172 200 318 286 238],387,3,9398,3.6854901960784314,20.0,0.0
12550,1,2550,[313 127 187 302 427],537,5,9403,3.686005488043904,0.0,20.0
12551,1,2551,[273 175 423 323 385],378,4,9407,3.686128526645768,0.0,0.0
12552,1,2552,[313 238 118 216   7],13,2,9409,3.6854680767724246,0.0,0.0
12553,1,2553,[ 71 186 216 258  50],85,3,9412,3.6851996867658574,0.0,20.0
12554,1,2554,[ 89 435 135 196  64],308,4,9416,3.6853228962818005,0.0,0.0
12555,1,2555,[ 22  15 515  69 588],184,2,9418,3.684663536776213,0.0,0.0
12556,1,2556,[  9 318 275 153 174],883,5,9423,3.6851779429018383,20.0,20.0
12557,1,2557,[143 172 265 195 183],666,1,9424,3.6841282251759186,0.0,0.0
12558,1,2558,[313 127 187 302 427],669,5,9429,3.6846424384525207,0.0,20.0
12559,1,2559,[222 234 318  11  95],200,5,9434,3.68515625,20.0,0.0
12560,1,2560,[153 357 185  64 172],184,4,9438,3.685279187817259,20.0,0.0
12561,1,2561,[172 678 245 111 742],749,3,9441,3.6850117096018735,0.0,0.0
12562,1,2562,[100 144  95 195 187],650,2,9443,3.6843542723371048,0.0,20.0
12563,1,2563,[313 127 187 302 427],537,5,9448,3.6848673946957877,0.0,20.0
12564,1,2564,[ 98  15 748 181 187],533,4,9452,3.684990253411306,0.0,20.0
12565,1,2565,[185 183 161  50   7],60,5,9457,3.685502727981294,0.0,20.0
12566,1,2566,[423 282 202 237 357],666,2,9459,3.6848461238800154,20.0,0.0
12567,1,2567,[258  95 144  98  64],263,4,9463,3.684968847352025,0.0,20.0
12568,1,2568,[313 127 187 302 427],537,5,9468,3.6854807318022575,0.0,20.0
12569,1,2569,[121 357 135 182  12],537,3,9471,3.685214007782101,40.0,0.0
12570,1,2570,[313 127 187 302 427],328,4,9475,3.6853364449630495,0.0,20.0
12571,1,2571,[313 127 187 302 483],90,5,9480,3.685847589424572,20.0,20.0
12572,1,2572,[313 127 187 302 483],328,5,9485,3.686358336572095,20.0,20.0
12573,1,2573,[313 127 187 302 483],474,5,9490,3.686868686868687,20.0,20.0
12574,1,2574,[161 318 125 172  25],455,2,9492,3.6862135922330097,20.0,0.0
12575,1,2575,[313 127 187 302 483],90,5,9497,3.686723602484472,20.0,20.0
12576,1,2576,[313 127 187 302 483],474,5,9502,3.687233216918898,20.0,20.0
12577,1,2577,[144  79 471  11 275],455,3,9505,3.686966640806827,0.0,0.0
12578,1,2578,[313 127 187 302 483],328,5,9510,3.687475765800698,20.0,20.0
12579,1,2579,[228 132  98 183 194],59,4,9514,3.6875968992248063,0.0,20.0
12580,1,2580,[ 50  69 183 181 655],488,4,9518,3.6877179387834174,0.0,20.0
12581,1,2581,[588   8 204 202 127],406,4,9522,3.6878388845855925,0.0,20.0
12582,1,2582,[ 69 300 100 181 191],892,5,9527,3.6883468834688347,0.0,20.0
12583,1,2583,[496 211 515   7 318],346,4,9531,3.6884674922600618,20.0,0.0
12584,1,2584,[135  22 546   4  56],650,1,9532,3.6874274661508704,0.0,0.0
12585,1,2585,[313 127 187 302 483],90,5,9537,3.687935034802784,20.0,20.0
12586,1,2586,[ 69 222 318 282 117],406,3,9540,3.6876691148047933,20.0,0.0
12587,1,2587,[ 71   8 313 195 179],13,3,9543,3.687403400309119,0.0,0.0
12588,1,2588,[313 127 187 302 483],669,4,9547,3.6875241405948245,20.0,20.0
12589,1,2589,[  1 191 496 546 568],95,4,9551,3.6876447876447878,0.0,0.0
12590,1,2590,[313 127 187 302 483],334,5,9556,3.68815129293709,20.0,20.0
12591,1,2591,[597 294  96 196 265],7,3,9559,3.6878858024691357,0.0,0.0
12592,1,2592,[121 195 172 237 191],308,3,9562,3.6876205167759353,0.0,0.0
12593,1,2593,[185 168 196 568 228],194,2,9564,3.6869699306090977,0.0,0.0
12594,1,2594,[238 275  71 222 323],378,2,9566,3.686319845857418,0.0,0.0
12595,1,2595,[ 88 180 257 568 403],378,4,9570,3.6864406779661016,0.0,0.0
12596,1,2596,[568 153 182 135 185],210,5,9575,3.686946476703889,0.0,0.0
12597,1,2597,[313 127 187 302 483],90,5,9580,3.6874518860662047,20.0,20.0
12598,1,2598,[172  71 385 215 186],524,0,9580,3.6860330896498654,0.0,0.0
12599,1,2599,[313 127 187 302 483],328,5,9585,3.6865384615384613,20.0,20.0
12600,1,2600,[313 127 187 302 483],90,5,9590,3.687043444828912,20.0,20.0
12601,1,2601,[294 121  56  98 187],749,1,9591,3.686010760953113,0.0,20.0
12602,1,2602,[313 127 187 302 483],13,5,9596,3.686515558970419,20.0,20.0
12603,1,2603,[ 64 328 385 197 175],85,3,9599,3.686251920122888,0.0,0.0
12604,1,2604,[265 186  96 300 202],263,4,9603,3.68637236084453,0.0,0.0
12605,1,2605,[313 127 187 302 483],90,5,9608,3.6868764389869533,20.0,20.0
12606,1,2606,[742 603 215   8 288],387,2,9610,3.686229382431914,20.0,0.0
12607,1,2607,[175  28 173 238  95],795,4,9614,3.686349693251534,0.0,0.0
12608,1,2608,[121 508 427  12 200],60,5,9619,3.686853200459946,20.0,0.0
12609,1,2609,[357 183 678 258  50],387,4,9623,3.6869731800766283,20.0,20.0
12610,1,2610,[194 403 423  56  98],339,3,9626,3.686710072769054,0.0,20.0
12611,1,2611,[191  64 194 183 318],82,4,9630,3.6868300153139355,20.0,0.0
12612,1,2612,[405 357 175 180 508],406,4,9634,3.6869498660543436,20.0,0.0
12613,1,2613,[191 238 173 127 496],738,5,9639,3.687452180566182,0.0,20.0
12614,1,2614,[  7 211   8 237   9],474,5,9644,3.6879541108986618,0.0,0.0
12615,1,2615,[655 678  71 174 508],334,2,9646,3.687308868501529,0.0,20.0
12616,1,2616,[196 132   8 245  82],533,3,9649,3.6870462361482614,0.0,0.0
12617,1,2617,[313 127 187 302 483],328,5,9654,3.687547746371276,20.0,20.0
12618,1,2618,[174 211 195 196  98],804,5,9659,3.688048873615884,0.0,40.0
12619,1,2619,[313 127 187 302 483],328,5,9664,3.688549618320611,20.0,20.0
12620,1,2620,[ 79 265 257 597 237],374,4,9668,3.6886684471575735,0.0,0.0
12621,1,2621,[313 127 187 302 483],90,5,9673,3.6891685736079327,20.0,20.0
12622,1,2622,[313 127 187 302 483],328,5,9678,3.6896683187190242,20.0,20.0
12623,1,2623,[286 210 276 125 678],334,2,9680,3.6890243902439024,0.0,0.0
12624,1,2624,[ 64  50 135 197 168],387,3,9683,3.688761904761905,0.0,20.0
12625,1,2625,[153 195 172 275 257],454,2,9685,3.6881188118811883,0.0,0.0
12626,1,2626,[185 172 161 183 405],334,2,9687,3.6874762086029693,0.0,0.0
12627,1,2627,[196  89  70 191  50],653,3,9690,3.6872146118721463,0.0,20.0
12628,1,2628,[282  69 546 258 174],788,3,9693,3.6869532141498667,0.0,20.0
12629,1,2629,[ 98  82 678 222 276],334,4,9697,3.6870722433460075,0.0,20.0
12630,1,2630,[313 127 187 302 483],207,5,9702,3.687571265678449,20.0,20.0
12631,1,2631,[313 127 187 302 483],13,5,9707,3.68806990881459,20.0,20.0
12632,1,2632,[313 127 187 302 483],13,5,9712,3.6885681731864794,20.0,20.0
12633,1,2633,[176 273 100 265   7],92,5,9717,3.6890660592255125,0.0,20.0
12634,1,2634,[435 403 405 742 294],648,4,9721,3.6891840607210624,0.0,0.0
12635,1,2635,[237 195 216 258 228],749,4,9725,3.6893019726858878,0.0,0.0
12636,1,2636,[313 127 187 302 483],334,5,9730,3.689799014031096,20.0,20.0
12637,1,2637,[333 235 288 286 234],343,2,9732,3.689158453373768,0.0,0.0
12638,1,2638,[121  89 427 183 185],882,5,9737,3.689655172413793,0.0,0.0
12639,1,2639,[322 168 423 180 655],881,4,9741,3.6897727272727274,0.0,0.0
12640,1,2640,[546  88 168 182 144],313,3,9744,3.6895115486558123,0.0,0.0
12641,1,2641,[275   8 174 179  12],308,5,9749,3.69000757002271,20.0,20.0
12642,1,2642,[471 301 357 294  71],328,2,9751,3.6893681422625804,20.0,0.0
12643,1,2643,[ 89 405 289   4 204],194,2,9753,3.6887291981845687,0.0,0.0
12644,1,2644,[238 245 176 121 173],749,3,9756,3.688468809073724,0.0,0.0
12645,1,2645,[182   8 294 176 568],158,4,9760,3.688586545729403,0.0,0.0
12646,1,2646,[515 294 678 222 288],548,3,9763,3.6883264072534945,0.0,0.0
12647,1,2647,[ 96 423 172  25  89],92,3,9766,3.6880664652567976,0.0,0.0
12648,1,2648,[245 186 357 144 271],328,4,9770,3.6881842204605513,20.0,0.0
12649,1,2649,[234 328  15  88 423],479,3,9773,3.687924528301887,0.0,0.0
12650,1,2650,[655  11 289 435 423],881,3,9776,3.6876650320633724,0.0,0.0
12651,1,2651,[ 12 202 597  22 196],59,4,9780,3.6877828054298645,20.0,0.0
12652,1,2652,[194 215  82   9 271],13,2,9782,3.6871466264606108,0.0,0.0
12653,1,2653,[ 70 508 268  11 234],13,2,9784,3.686510926902788,0.0,0.0
12654,1,2654,[216 471 265 215 435],328,2,9786,3.685875706214689,0.0,0.0
12655,1,2655,[313 127 187 302 483],207,5,9791,3.6863704819277108,20.0,20.0
12656,1,2656,[ 95 273   7  56 127],102,1,9792,3.6853594279262327,0.0,20.0
12657,1,2657,[313 127 187 302 483],90,5,9797,3.6858540255831453,20.0,20.0
12658,1,2658,[385 181 286 276 204],537,1,9798,3.684843926288078,0.0,0.0
12659,1,2659,[196 194 546 385  89],653,2,9800,3.6842105263157894,0.0,0.0
12660,1,2660,[ 89 200 202  97 186],379,4,9804,3.6843291995490417,0.0,0.0
12661,1,2661,[313 127 187 302 483],474,5,9809,3.684823441021788,20.0,20.0
12662,1,2662,[235 185 678  12   9],13,1,9810,3.683815245963199,20.0,0.0
12663,1,2663,[483 294 176 603 182],533,3,9813,3.6835585585585586,40.0,0.0
12664,1,2664,[235  56  98 173 435],643,4,9817,3.6836772983114447,0.0,20.0
12665,1,2665,[174 121  96  22 181],447,5,9822,3.68417104276069,0.0,20.0
12666,1,2666,[313 127 187 302 483],537,5,9827,3.6846644169478817,20.0,20.0
12667,1,2667,[313 127 187 302 483],90,5,9832,3.685157421289355,20.0,20.0
12668,1,2668,[496 143 175 151 174],312,3,9835,3.6849007118771073,0.0,20.0
12669,1,2669,[313 127 187 302 483],90,5,9840,3.6853932584269664,20.0,20.0
12670,1,2670,[204  70 300  98 269],334,2,9842,3.6847622613253463,0.0,20.0
12671,1,2671,[357 100 597 234   7],788,3,9845,3.684505988023952,20.0,20.0
12672,1,2672,[186 100 742 211 144],387,2,9847,3.683875794986906,0.0,20.0
12673,1,2673,[313 127 187 302 483],328,5,9852,3.6843679880329097,20.0,20.0
12674,1,2674,[313 127 187 302 483],90,5,9857,3.6848598130841124,20.0,20.0
12675,1,2675,[403  56 118 172 186],524,3,9860,3.6846038863976083,0.0,0.0
12676,1,2676,[742 294 273  69 174],897,2,9862,3.6839745984310794,0.0,20.0
12677,1,2677,[ 88 210  64 496 135],87,5,9867,3.6844660194174756,0.0,0.0
12678,1,2678,[ 22 195  82 265  56],533,3,9870,3.6842105263157894,0.0,0.0
12679,1,2679,[313 127 187 302 483],669,4,9874,3.684328358208955,20.0,20.0
12680,1,2680,[286 135 200 655 179],387,3,9877,3.6840731070496084,0.0,0.0
12681,1,2681,[ 95  98 678 257 423],749,2,9879,3.6834451901565997,0.0,20.0
12682,1,2682,[286 210 403 180 173],650,1,9880,3.682445024226612,0.0,0.0
12683,1,2683,[216 655 234 181 237],234,1,9881,3.6814456035767513,0.0,0.0
12684,1,2684,[ 22  89   9 228  79],447,3,9884,3.681191806331471,0.0,0.0
12685,1,2685,[269 151  22 289 153],378,4,9888,3.6813104988830974,0.0,0.0
12686,1,2686,[173  95  71  82 174],897,3,9891,3.6810569408262004,0.0,20.0
12687,1,2687,[153 215 678 196 228],7,4,9895,3.6811755952380953,0.0,0.0
12688,1,2688,[265  25  15  96  70],374,4,9899,3.6812941613982892,0.0,0.0
12689,1,2689,[313 127 187 302 483],328,5,9904,3.6817843866171005,20.0,20.0
12690,1,2690,[132 655  12 185 271],13,3,9907,3.6815310293571164,20.0,0.0
12691,1,2691,[144 678  56 322 200],13,2,9909,3.6809063893016343,0.0,0.0
12692,1,2692,[313 127 187 302 483],13,5,9914,3.6813962124025252,20.0,20.0
12693,1,2693,[174  70  97 235 135],64,4,9918,3.681514476614699,0.0,20.0
12694,1,2694,[515 191  25 185 100],537,4,9922,3.6816326530612247,0.0,20.0
12695,1,2695,[282 195 216  88 403],378,4,9926,3.6817507418397626,0.0,0.0
12696,1,2696,[313 127 187 302 483],334,5,9931,3.682239525398591,20.0,20.0
12697,1,2697,[173 603  82 588 125],897,4,9935,3.6823573017049664,20.0,0.0
12698,1,2698,[313 127 187 302 483],669,4,9939,3.68247499073731,20.0,20.0
12699,1,2699,[313 127 187 302 483],669,4,9943,3.6825925925925924,20.0,20.0
12700,1,2700,[313 127 187 302 483],90,5,9948,3.683080340614587,20.0,20.0
12701,1,2701,[194 132 144 427 597],7,4,9952,3.68319763138416,0.0,0.0
12702,1,2702,[515 182 185 181 100],488,3,9955,3.682944876063633,0.0,20.0
12703,1,2703,[168 195 568 185  88],648,5,9960,3.6834319526627217,0.0,0.0
12704,1,2704,[313 127 187 302 483],474,5,9965,3.6839186691312387,20.0,20.0
12705,1,2705,[313 127 187 302 483],328,5,9970,3.6844050258684407,20.0,20.0
12706,1,2706,[313 127 187 302 483],90,5,9975,3.684891023272996,20.0,20.0
12707,1,2707,[313 127 187 302 483],90,5,9980,3.6853766617429837,20.0,20.0
12708,1,2708,[588  25 202 294 191],650,1,9981,3.6843853820598005,0.0,0.0
12709,1,2709,[185  89  98 186 275],312,4,9985,3.6845018450184504,0.0,20.0
12710,1,2710,[194 385 423 234 471],899,4,9989,3.684618222058281,0.0,0.0
12711,1,2711,[318 471 182 161 322],92,2,9991,3.6839970501474926,20.0,0.0
12712,1,2712,[ 50 176 183  12 385],42,4,9995,3.684113527460376,20.0,20.0
12713,1,2713,[276 268  71 202  64],92,4,9999,3.6842299189388354,0.0,0.0
12714,1,2714,[313 127 187 302 483],334,5,10004,3.6847145488029467,20.0,20.0
12715,1,2715,[568 118  50  96 194],308,4,10008,3.6848306332842413,0.0,20.0
12716,1,2716,[313 127 187 302 483],669,4,10012,3.6849466323150533,20.0,20.0
12717,1,2717,[222 294  22 216 100],881,4,10016,3.685062545989698,0.0,20.0
12718,1,2718,[ 79  70 185 385 118],102,0,10016,3.683707245310776,0.0,0.0
12719,1,2719,[313 127 187 302 427],537,5,10021,3.684191176470588,0.0,20.0
12720,1,2720,[161 234 588 197 216],479,2,10023,3.6835722160970232,0.0,0.0
12721,1,2721,[257 597 423 210 483],650,1,10024,3.6825863335782514,20.0,0.0
12722,1,2722,[435 237 286 475 182],6,3,10027,3.6823356591994125,0.0,0.0
12723,1,2723,[496 289 405 143 117],194,1,10028,3.6813509544787077,0.0,0.0
12724,1,2724,[234 176 197 168 100],749,4,10032,3.681467889908257,0.0,20.0
12725,1,2725,[191 216 183 357 180],339,4,10036,3.681584739545121,20.0,0.0
12726,1,2726,[ 70   1  95 118 222],795,2,10038,3.680968096809681,0.0,0.0
12727,1,2727,[ 79 204  95   9   1],455,5,10043,3.681451612903226,0.0,0.0
12728,1,2728,[313 127 187 302 427],328,4,10047,3.681568340051301,0.0,20.0
12729,1,2729,[268 271 187   1 475],13,2,10049,3.6809523809523808,0.0,0.0
12730,1,2730,[276 385 181 546 235],308,3,10052,3.6807030391797877,0.0,0.0
12731,1,2731,[197 182 655 175 234],95,3,10055,3.680453879941435,0.0,0.0
12732,1,2732,[ 11 302 117 173 228],454,1,10056,3.6794731064763995,0.0,0.0
12733,1,2733,[202 135  69 385  71],897,2,10058,3.6788588149231893,0.0,0.0
12734,1,2734,[313 127 187 302 483],474,5,10063,3.679341864716636,20.0,20.0
12735,1,2735,[187 435 588  50 483],458,4,10067,3.6794590643274856,20.0,20.0
12736,1,2736,[313 127 187 302 483],13,5,10072,3.679941541834125,20.0,20.0
12737,1,2737,[427  89 143  96 228],882,5,10077,3.6804236669101535,0.0,0.0
12738,1,2738,[191 202 323 275  56],454,1,10078,3.679445052939029,0.0,0.0
12739,1,2739,[179 125   4 121 276],77,1,10079,3.6784671532846716,0.0,0.0
12740,1,2740,[197 175 471 403 215],524,3,10082,3.6782196278730392,0.0,0.0
12741,1,2741,[144 143 196  69 268],234,1,10083,3.677242888402626,0.0,0.0
12742,1,2742,[313 127 187 302 483],474,5,10088,3.677725118483412,20.0,20.0
12743,1,2743,[313 127 187 302 483],13,5,10093,3.678206997084548,20.0,20.0
12744,1,2744,[210  25 194  70   7],13,1,10094,3.677231329690346,0.0,0.0
12745,1,2745,[313 127 187 302 483],537,5,10099,3.677713037144938,20.0,20.0
12746,1,2746,[313 127 187 302 483],328,5,10104,3.678194393884237,20.0,20.0
12747,1,2747,[ 89 194  50 234 181],64,4,10108,3.678311499272198,0.0,20.0
12748,1,2748,[238 257   8 237 385],883,3,10111,3.6780647508184794,0.0,0.0
12749,1,2749,[179 275   9  71 183],378,4,10115,3.678181818181818,0.0,0.0
12750,1,2750,[302 357 196 179  22],343,5,10120,3.6786623046165032,20.0,0.0
12751,1,2751,[313 127 187 302 483],474,5,10125,3.6791424418604652,20.0,20.0
12752,1,2752,[ 69  25 282 151   8],95,4,10129,3.6792589901925172,0.0,0.0
12753,1,2753,[313 127 187 302 483],537,5,10134,3.679738562091503,20.0,20.0
12754,1,2754,[ 11 238 176 135 515],213,5,10139,3.68021778584392,0.0,0.0
12755,1,2755,[313 127 187 302 483],13,5,10144,3.6806966618287373,20.0,20.0
12756,1,2756,[172 471 100 515 546],213,4,10148,3.6808124773304316,0.0,20.0
12757,1,2757,[215 194   1 161 216],378,5,10153,3.6812907904278465,0.0,0.0
12758,1,2758,[313 127 187 302 483],334,5,10158,3.6817687567959405,20.0,20.0
12759,1,2759,[161 202  25 180 168],271,2,10160,3.681159420289855,0.0,0.0
12760,1,2760,[313 127 187 302 483],334,5,10165,3.68163708801159,20.0,20.0
12761,1,2761,[313 127 187 302 483],334,5,10170,3.6821144098479364,20.0,20.0
12762,1,2762,[ 71 191 216 435  22],194,4,10174,3.6822294607310893,0.0,0.0
12763,1,2763,[176 125  71 100 118],374,5,10179,3.6827062228654124,0.0,20.0
12764,1,2764,[ 70 179 194 288  71],452,3,10182,3.6824593128390597,0.0,0.0
12765,1,2765,[ 82 151 294 204  95],378,3,10185,3.6822125813449023,0.0,0.0
12766,1,2766,[313 127 187 302 483],13,5,10190,3.6826888326707627,20.0,20.0
12767,1,2767,[313 127 187 302 483],334,5,10195,3.683164739884393,20.0,20.0
12768,1,2768,[313 127 187 302 483],328,5,10200,3.6836403033586134,20.0,20.0
12769,1,2769,[313 127 187 302 483],474,5,10205,3.684115523465704,20.0,20.0
12770,1,2770,[195  71 603 269 216],650,4,10209,3.6842295200288704,20.0,0.0
12771,1,2771,[125 257 405  15 286],637,2,10211,3.6836219336219336,0.0,0.0
12772,1,2772,[ 79 403 195 125 435],64,4,10215,3.6837360259646594,0.0,0.0
12773,1,2773,[269 427   7  28 174],6,3,10218,3.683489545782264,0.0,20.0
12774,1,2774,[ 96 180 655 111 161],95,3,10221,3.6832432432432434,0.0,0.0
12775,1,2775,[313 127 187 302 483],90,5,10226,3.6837175792507204,20.0,20.0
12776,1,2776,[191 200 216 196 257],334,4,10230,3.6838314728123875,0.0,0.0
12777,1,2777,[176  70 185 196 181],406,3,10233,3.683585313174946,0.0,0.0
12778,1,2778,[289 655 210  69 200],13,2,10235,3.682979489024829,0.0,0.0
12779,1,2779,[181 515 483 508 180],524,4,10239,3.683093525179856,20.0,0.0
12780,1,2780,[144  28 153 132 748],447,4,10243,3.683207479323984,0.0,0.0
12781,1,2781,[471 237 245 118 200],455,3,10246,3.682961897915169,0.0,0.0
12782,1,2782,[185 215 435 222 117],194,2,10248,3.6823571685231764,0.0,0.0
12783,1,2783,[313 127 187 302 483],13,5,10253,3.682830459770115,20.0,20.0
12784,1,2784,[179 294  69   9 196],92,4,10257,3.6829443447037704,0.0,0.0
12785,1,2785,[195 508 204 135 144],339,2,10259,3.6823402727925343,0.0,0.0
12786,1,2786,[603   4 144 269 222],738,4,10263,3.6824542518837458,20.0,0.0
12787,1,2787,[200 483 302 210 168],13,3,10266,3.682209469153515,20.0,0.0
12788,1,2788,[200  96 258  50  95],815,4,10270,3.6823234134098244,0.0,20.0
12789,1,2789,[204 187 318   1 185],537,3,10273,3.682078853046595,20.0,0.0
12790,1,2790,[269 435 135 173 385],666,4,10277,3.6821927624507347,0.0,0.0
12791,1,2791,[  9  22 405 748  71],13,3,10280,3.681948424068768,0.0,0.0
12792,1,2792,[118   9  69 117  98],145,3,10283,3.681704260651629,0.0,20.0
12793,1,2793,[288 174 258  96 357],537,2,10285,3.6811023622047245,20.0,20.0
12794,1,2794,[210  22 496 143 357],311,4,10289,3.681216457960644,20.0,0.0
12795,1,2795,[ 98 135 483 234 118],840,4,10293,3.6813304721030042,20.0,20.0
12796,1,2796,[185  56  95 179 271],537,3,10296,3.681086878798713,0.0,0.0
12797,1,2797,[127 286 118 210  82],184,3,10299,3.68084345961401,0.0,20.0
12798,1,2798,[276 135 172  98  64],537,2,10301,3.6802429439085387,0.0,20.0
12799,1,2799,[153 678 328 210 245],334,1,10302,3.6792857142857143,0.0,0.0
12800,1,2800,[144 117  98 328  96],234,1,10303,3.6783291681542307,0.0,20.0
12801,1,2801,[ 50 228   1 508   9],447,2,10305,3.677730192719486,0.0,20.0
12802,1,2802,[568 423 403 204 197],881,3,10308,3.677488405280057,0.0,0.0
12803,1,2803,[179 228 144  89  79],339,4,10312,3.6776034236804565,0.0,0.0
12804,1,2804,[234 211 118 403 161],643,2,10314,3.677005347593583,0.0,0.0
12805,1,2805,[313 127 187 302 483],207,5,10319,3.6774768353528153,20.0,20.0
12806,1,2806,[302  15 435 182 191],537,3,10322,3.677235482721767,0.0,0.0
12807,1,2807,[210 301 204 435 180],537,1,10323,3.676282051282051,0.0,0.0
12808,1,2808,[182 237  96 333 271],537,1,10324,3.6753292986828052,0.0,0.0
12809,1,2809,[313 127 187 302 483],90,5,10329,3.675800711743772,20.0,20.0
12810,1,2810,[271 655  64 294 211],537,1,10330,3.674848808253291,0.0,0.0
12811,1,2811,[  9 216 143  22 182],533,4,10334,3.6749644381223328,0.0,0.0
12812,1,2812,[197 216 176  25 234],804,5,10339,3.6754354781372203,0.0,0.0
12813,1,2813,[ 69 111 182 204 483],533,4,10343,3.675550817341862,20.0,0.0
12814,1,2814,[313 127 187 302 483],537,5,10348,3.6760213143872114,20.0,20.0
12815,1,2815,[ 15 496 196 185 132],311,4,10352,3.6761363636363638,0.0,0.0
12816,1,2816,[197 286 515 182 195],339,4,10356,3.676251331203408,0.0,0.0
12817,1,2817,[234  11 655 127 483],406,4,10360,3.6763662171753015,20.0,20.0
12818,1,2818,[ 25 179 121 435 185],897,2,10362,3.6757715501951047,0.0,0.0
12819,1,2819,[245 269   8 127 286],452,4,10366,3.675886524822695,0.0,20.0
12820,1,2820,[238 175 483 161  64],804,5,10371,3.6763559021623538,20.0,0.0
12821,1,2821,[  7 211 180 176  56],804,4,10375,3.676470588235294,0.0,0.0
12822,1,2822,[313 127 187 302 483],207,5,10380,3.6769394261424018,20.0,20.0
12823,1,2823,[ 69 195 423  82  71],843,1,10381,3.6759915014164304,0.0,0.0
12824,1,2824,[265 191   1 300  56],653,5,10386,3.6764601769911502,0.0,0.0
12825,1,2825,[144 172 508 180 216],144,5,10391,3.6769285208775653,0.0,0.0
12826,1,2826,[313 127 187 302 483],328,5,10396,3.677396533427662,20.0,20.0
12827,1,2827,[ 70  79  69 174 258],537,2,10398,3.676803394625177,0.0,20.0
12828,1,2828,[  1   7  12  89 234],234,1,10399,3.6758571933545423,20.0,0.0
12829,1,2829,[313 127 187 302 483],474,5,10404,3.6763250883392224,20.0,20.0
12830,1,2830,[318 508 174 196 322],537,2,10406,3.675732956552455,20.0,20.0
12831,1,2831,[182 258 286  15 234],488,3,10409,3.6754943502824857,0.0,0.0
12832,1,2832,[423 265 655 179  71],738,2,10411,3.674902929756442,0.0,0.0
12833,1,2833,[313 127 187 302 483],13,5,10416,3.6753705010585747,20.0,20.0
12834,1,2834,[ 98 471 546 143 483],666,4,10420,3.675485008818342,20.0,20.0
12835,1,2835,[313 127 187 302 483],328,5,10425,3.6759520451339913,20.0,20.0
12836,1,2836,[313 127 187 302 483],13,5,10430,3.6764187522030314,20.0,20.0
12837,1,2837,[  4  97 100 228 271],13,4,10434,3.6765327695560255,0.0,20.0
12838,1,2838,[238 333 172 111 496],488,3,10437,3.676294469883762,0.0,0.0
12839,1,2839,[210 143 153 200 228],479,4,10441,3.6764084507042254,0.0,0.0
12840,1,2840,[ 25 238 322 546 144],92,2,10443,3.675818373812038,0.0,0.0
12841,1,2841,[174 597 182 144   7],119,5,10448,3.6762843068261786,0.0,20.0
12842,1,2842,[313 127 187 302 483],207,5,10453,3.6767499120647202,20.0,20.0
12843,1,2843,[313 127 187 302 483],328,5,10458,3.6772151898734178,20.0,20.0
12844,1,2844,[ 69   9 204 111 265],648,3,10461,3.6769771528998243,0.0,0.0
12845,1,2845,[ 96 588 144 179  15],378,4,10465,3.6770906535488406,0.0,0.0
12846,1,2846,[228 185 144 423  28],95,4,10469,3.6772040744643486,0.0,0.0
12847,1,2847,[313 127 187 302 483],537,5,10474,3.677668539325843,20.0,20.0
12848,1,2848,[222 234 151 483 288],374,3,10477,3.6774306774306775,20.0,0.0
12849,1,2849,[117 423  88   4 182],92,3,10480,3.6771929824561402,0.0,0.0
12850,1,2850,[151 185 405   1 143],406,2,10482,3.6766047001052264,0.0,0.0
12851,1,2851,[427  79 323 194 196],537,1,10483,3.6756661991584854,0.0,0.0
12852,1,2852,[121  11 546  25 204],13,2,10485,3.675078864353312,0.0,0.0
12853,1,2853,[313 127 187 302 483],207,5,10490,3.675543097407148,20.0,20.0
12854,1,2854,[313 127 187 302 483],13,5,10495,3.6760070052539406,20.0,20.0
12855,1,2855,[ 71   9 153 597 202],308,4,10499,3.6761204481792715,0.0,0.0
12856,1,2856,[313 127 187 302 483],669,4,10503,3.6762338116905844,20.0,20.0
12857,1,2857,[313 127 187 302 483],207,5,10508,3.6766969909027294,20.0,20.0
12858,1,2858,[333 742  97 258 318],328,3,10511,3.676460300804477,20.0,0.0
12859,1,2859,[313 127 187 302 483],474,5,10516,3.6769230769230767,20.0,20.0
12860,1,2860,[ 79 328  97 197 678],13,2,10518,3.6763369451240826,0.0,0.0
12861,1,2861,[313 127 187 302 483],537,5,10523,3.676799440950384,20.0,20.0
12862,1,2862,[313 127 187 302 483],669,4,10527,3.6769123297240656,20.0,20.0
12863,1,2863,[197 144 183 173 289],387,2,10529,3.676326815642458,0.0,0.0
12864,1,2864,[385 121  98 357 204],659,5,10534,3.676788830715532,20.0,20.0
12865,1,2865,[202 258  88 194 323],506,4,10538,3.6769016050244243,0.0,0.0
12866,1,2866,[286 265 195 151  98],881,3,10541,3.6766655040111615,0.0,20.0
12867,1,2867,[403  28 151 161 185],374,3,10544,3.676429567642957,0.0,0.0
12868,1,2868,[357 302 300 200 172],380,3,10547,3.6761937957476474,20.0,0.0
12869,1,2869,[313 127 187 302 483],474,5,10552,3.6766550522648083,20.0,20.0
12870,1,2870,[313 127 187 302 483],207,5,10557,3.677115987460815,20.0,20.0
12871,1,2871,[313 127 187 302 483],13,5,10562,3.6775766016713094,20.0,20.0
12872,1,2872,[50  1 82 96 88],815,5,10567,3.6780368952314655,0.0,20.0
12873,1,2873,[357  82 174 210 496],643,4,10571,3.678148921363953,20.0,20.0
12874,1,2874,[179 211 289 603 385],13,2,10573,3.6775652173913045,20.0,0.0
12875,1,2875,[ 70 597 200  22 175],804,3,10576,3.677329624478442,0.0,0.0
12876,1,2876,[ 50  96 423 269 273],13,3,10579,3.6770941953423706,0.0,20.0
12877,1,2877,[204 210 237 185 471],537,1,10580,3.676164002779708,0.0,0.0
12878,1,2878,[  9 179  89 286  12],378,4,10584,3.676276484890587,20.0,0.0
12879,1,2879,[496 172 211 603 175],650,5,10589,3.676736111111111,20.0,0.0
12880,1,2880,[181 172 300   4 174],774,0,10589,3.675459909753558,0.0,20.0
12881,1,2881,[151 588   1  50 111],537,1,10590,3.674531575294934,0.0,20.0
12882,1,2882,[238 176 200 322 186],234,1,10591,3.673603884842178,0.0,0.0
12883,1,2883,[357 215 403 174 144],234,1,10592,3.6726768377253816,20.0,20.0
12884,1,2884,[ 88 423 127  71 168],308,5,10597,3.67313691507799,0.0,20.0
12885,1,2885,[144 245 282  97 151],653,1,10598,3.672210672210672,0.0,0.0
12886,1,2886,[265  79 127  22 200],7,5,10603,3.672670592310357,0.0,20.0
12887,1,2887,[186 216 211 187 496],452,1,10604,3.6717451523545708,0.0,0.0
12888,1,2888,[ 71  82   8 173  97],488,3,10607,3.6715126341294564,0.0,0.0
12889,1,2889,[313 127 187 302 483],537,5,10612,3.6719723183391,20.0,20.0
12890,1,2890,[238 435 483 125 195],313,4,10616,3.6720857834659286,20.0,0.0
12891,1,2891,[153 234  25 268 603],234,2,10618,3.6715076071922543,20.0,0.0
12892,1,2892,[ 71 135  89  25 195],13,3,10621,3.671275492568268,0.0,0.0
12893,1,2893,[228 172 144 423 357],215,5,10626,3.671734623358673,20.0,0.0
12894,1,2894,[302 196 210 125  64],207,4,10630,3.6718480138169256,0.0,0.0
12895,1,2895,[313 127 187 302 483],669,4,10634,3.671961325966851,20.0,20.0
12896,1,2896,[ 79 161 200 245 127],455,4,10638,3.672074559889541,0.0,20.0
12897,1,2897,[318   4   7 302  69],883,4,10642,3.6721877156659763,20.0,0.0
12898,1,2898,[235 200 161 496 655],334,2,10644,3.671610900310452,0.0,0.0
12899,1,2899,[313 127 187 302 483],669,4,10648,3.6717241379310344,20.0,20.0
12900,1,2900,[289 117 271 183 385],13,1,10649,3.6708031713202343,0.0,0.0
12901,1,2901,[191 210 125 483 132],200,5,10654,3.671261199172984,20.0,0.0
12902,1,2902,[496 435  28 191  22],275,2,10656,3.670685497760937,0.0,0.0
12903,1,2903,[ 25 300 125 435  95],749,4,10660,3.6707988980716255,0.0,0.0
12904,1,2904,[313 127 187 302 483],13,5,10665,3.6712564543889843,20.0,20.0
12905,1,2905,[100 678 195   1 121],537,1,10666,3.6703372333103923,0.0,20.0
12906,1,2906,[235 228 471   4 185],194,2,10668,3.6697626418988647,0.0,0.0
12907,1,2907,[313 127 187 302 483],474,5,10673,3.6702200825309492,20.0,20.0
12908,1,2908,[222  56  11 185 144],328,3,10676,3.6699896871777242,0.0,0.0
12909,1,2909,[313 127 187 302 483],334,5,10681,3.670446735395189,20.0,20.0
12910,1,2910,[313 127 187 302 483],207,5,10686,3.6709034695980765,20.0,20.0
12911,1,2911,[ 25 258 568  11 294],213,4,10690,3.6710164835164836,0.0,0.0
12912,1,2912,[121 117 181 202 655],194,1,10691,3.6700995537246826,0.0,0.0
12913,1,2913,[302 258   7  95  22],378,5,10696,3.6705559368565543,0.0,0.0
12914,1,2914,[181 185 294 118 174],881,4,10700,3.6706689536878216,0.0,20.0
12915,1,2915,[313 127 187 302 483],13,5,10705,3.671124828532236,20.0,20.0
12916,1,2916,[234 323 318 210 313],59,5,10710,3.6715803908124784,20.0,0.0
12917,1,2917,[313 127 187 302 483],207,5,10715,3.6720356408498973,20.0,20.0
12918,1,2918,[135 186 222 403 118],194,1,10716,3.671120246659815,0.0,0.0
12919,1,2919,[153 182 202  15 161],479,3,10719,3.6708904109589042,0.0,0.0
12920,1,2920,[228 175 273 121 200],13,3,10722,3.670660732625813,0.0,0.0
12921,1,2921,[655 286 181 180 200],234,1,10723,3.6697467488021904,0.0,0.0
12922,1,2922,[313 127 187 302 483],537,5,10728,3.6702018474170375,20.0,20.0
12923,1,2923,[196 215 483 194 135],406,3,10731,3.6699726402188784,20.0,0.0
12924,1,2924,[ 28  50 546 405 238],313,3,10734,3.66974358974359,0.0,20.0
12925,1,2925,[ 97 323   7 179 168],537,3,10737,3.669514695830485,0.0,0.0
12926,1,2926,[742 222 117 132 328],119,5,10742,3.6699692517936455,0.0,0.0
12927,1,2927,[423 318 603 546 187],308,4,10746,3.6700819672131146,40.0,0.0
12928,1,2928,[313 127 187 302 483],207,5,10751,3.670536019119153,20.0,20.0
12929,1,2929,[228 173 200 144 265],7,5,10756,3.6709897610921502,0.0,0.0
12930,1,2930,[204  96 183 100 195],144,4,10760,3.6711020129648584,0.0,20.0
12931,1,2931,[179 191  96  50 202],840,4,10764,3.671214188267394,0.0,20.0
12932,1,2932,[216 215   7 237   9],13,2,10766,3.6706443914081146,0.0,0.0
12933,1,2933,[588   1 181 172 276],311,5,10771,3.671097477845944,0.0,0.0
12934,1,2934,[210  95  82 483 180],537,2,10773,3.670528109028961,20.0,0.0
12935,1,2935,[385 161 135 168  82],379,3,10776,3.670299727520436,0.0,0.0
12936,1,2936,[ 22 186 313 288  96],308,4,10780,3.6704119850187267,0.0,0.0
12937,1,2937,[546 655  22 125 238],194,3,10783,3.6701837985023826,0.0,0.0
12938,1,2938,[ 69 597 235 215 187],59,3,10786,3.669955767267778,0.0,0.0
12939,1,2939,[187 427  56 180  89],90,5,10791,3.6704081632653063,0.0,0.0
12940,1,2940,[ 12 268 318 168 210],387,3,10794,3.670180210812649,40.0,0.0
12941,1,2941,[173  71  50 118 235],200,4,10798,3.670292318150918,0.0,20.0
12942,1,2942,[423  98 405 118 121],774,1,10799,3.6693849813115866,0.0,20.0
12943,1,2943,[313 127 187 302 483],13,5,10804,3.6698369565217392,20.0,20.0
12944,1,2944,[  8 180 175 179 191],207,2,10806,3.669269949066214,0.0,0.0
12945,1,2945,[288 210  15 568 135],537,1,10807,3.6683638832315,0.0,0.0
12946,1,2946,[153 237  96 182 228],328,2,10809,3.66779776043434,0.0,0.0
12947,1,2947,[313 127 187 302 483],537,5,10814,3.6682496607869743,20.0,20.0
12948,1,2948,[313 121  70   4 200],653,3,10817,3.668023058663954,0.0,0.0
12949,1,2949,[237 483 100 197 301],524,4,10821,3.668135593220339,20.0,20.0
12950,1,2950,[ 70  79 143 275  69],13,1,10822,3.6672314469671297,0.0,0.0
12951,1,2951,[313 127 187 302 483],537,5,10827,3.667682926829268,20.0,20.0
12952,1,2952,[  7  89 144 216 515],64,3,10830,3.6674568235692515,0.0,0.0
12953,1,2953,[ 28 125  50  97 234],83,4,10834,3.667569397427217,0.0,20.0
12954,1,2954,[  4  64 204 183  15],749,5,10839,3.668020304568528,0.0,0.0
12955,1,2955,[546 174 385  97 185],881,4,10843,3.668132611637348,0.0,20.0
12956,1,2956,[161  15 168  28 202],92,1,10844,3.667230300980724,0.0,0.0
12957,1,2957,[176 118 508 127 423],13,3,10847,3.6670047329276536,0.0,20.0
12958,1,2958,[ 50 228 186 300 288],488,4,10851,3.6671172693477527,0.0,20.0
12959,1,2959,[313 127 187 302 483],328,5,10856,3.6675675675675676,20.0,20.0
12960,1,2960,[313 127 187 302 483],90,5,10861,3.6680175616345827,20.0,20.0
12961,1,2961,[313 127 187 302 483],328,5,10866,3.6684672518568533,20.0,20.0
12962,1,2962,[197 179 508 222  96],524,4,10870,3.6685791427607155,0.0,0.0
12963,1,2963,[237 282 228  28 597],328,2,10872,3.668016194331984,0.0,0.0
12964,1,2964,[132 176 175 257 181],804,5,10877,3.6684654300168633,0.0,0.0
12965,1,2965,[328 100 508 423 111],378,3,10880,3.668240053944707,0.0,20.0
12966,1,2966,[197 515 318  11 200],271,5,10885,3.668688911358274,20.0,0.0
12967,1,2967,[191 100 318 121 186],653,5,10890,3.6691374663072778,20.0,20.0
12968,1,2968,[313 127 187 302 483],13,5,10895,3.669585719097339,20.0,20.0
12969,1,2969,[275 471 202 322  11],537,1,10896,3.6686868686868688,0.0,0.0
12970,1,2970,[313 127 187 302 483],669,4,10900,3.668798384382363,20.0,20.0
12971,1,2971,[234 202 127  15 471],648,3,10903,3.6685733512786003,0.0,20.0
12972,1,2972,[288 423 197   1 403],648,4,10907,3.668684830137908,0.0,0.0
12973,1,2973,[423 235 300  89 322],313,3,10910,3.668459986550101,0.0,0.0
12974,1,2974,[ 71 216 748 258  50],533,4,10914,3.6685714285714286,0.0,20.0
12975,1,2975,[423   1 237 483 603],298,5,10919,3.669018817204301,40.0,0.0
12976,1,2976,[269 678  69 423 191],334,2,10921,3.66845817937521,0.0,0.0
12977,1,2977,[313 127 187 302 483],334,5,10926,3.668905305574211,20.0,20.0
12978,1,2978,[182 191  22 172  95],749,3,10929,3.6686807653575024,0.0,0.0
12979,1,2979,[ 64 238 496 204 403],95,4,10933,3.668791946308725,0.0,0.0
12980,1,2980,[313 127 187 302 483],537,5,10938,3.669238510566924,20.0,20.0
12981,1,2981,[ 98 173 215 603 191],234,3,10941,3.6690140845070425,20.0,20.0
12982,1,2982,[ 25 125 282 238 258],271,1,10942,3.6681193429433456,0.0,0.0
12983,1,2983,[238 185 228  22 276],883,4,10946,3.668230563002681,0.0,0.0
12984,1,2984,[313 127 187 302 483],328,5,10951,3.668676716917923,20.0,20.0
12985,1,2985,[183 483 435  50  71],536,3,10954,3.668452779638312,20.0,20.0
12986,1,2986,[313 127 187 302 483],334,5,10959,3.6688985604285236,20.0,20.0
12987,1,2987,[153 403 127 100  89],194,2,10961,3.6683400267737616,0.0,40.0
12988,1,2988,[276  79 202  88  11],538,3,10964,3.6681164268986284,0.0,0.0
12989,1,2989,[  4 125 100 210 333],533,4,10968,3.6682274247491637,0.0,20.0
12990,1,2990,[ 64 100 318 276  98],430,4,10972,3.6683383483784686,20.0,40.0
12991,1,2991,[ 89 435  69 323  98],290,2,10974,3.6677807486631018,0.0,20.0
12992,1,2992,[313 127 187 302 483],474,5,10979,3.668225860340795,20.0,20.0
12993,1,2993,[471 121 222 186 568],343,3,10982,3.668002672010688,0.0,0.0
12994,1,2994,[235  98 276 597 405],378,3,10985,3.667779632721202,0.0,20.0
12995,1,2995,[ 25  98 655  50 318],295,5,10990,3.6682242990654204,20.0,40.0
12996,1,2996,[313 127 187 302 483],334,5,10995,3.6686686686686687,20.0,20.0
12997,1,2997,[ 50 318 175 117  95],184,3,10998,3.66844563042028,20.0,20.0
12998,1,2998,[144 222 132 228  71],313,3,11001,3.668222740913638,0.0,0.0
12999,1,2999,[238 153 179 435 173],899,1,11002,3.667333333333333,0.0,0.0
13000,1,3000,[748 294 258 678 475],92,2,11004,3.666777740753082,0.0,0.0
13001,1,3001,[313 127 187 302 483],334,5,11009,3.667221852098601,20.0,20.0
13002,1,3002,[187 265 175 176 289],474,4,11013,3.6673326673326674,0.0,0.0
13003,1,3003,[435  69 161 180 135],380,1,11014,3.666444740346205,0.0,0.0
13004,1,3004,[117 173 175  95 202],125,3,11017,3.6662229617304494,0.0,0.0
13005,1,3005,[313 127 187 302 483],207,5,11022,3.6666666666666665,20.0,20.0
13006,1,3006,[273 135 597 187 322],328,1,11023,3.6657798470236114,0.0,0.0
13007,1,3007,[313 127 187 302 483],328,5,11028,3.666223404255319,20.0,20.0
13008,1,3008,[ 56 546 181 300 132],346,5,11033,3.6666666666666665,0.0,0.0
13009,1,3009,[313 127 187 302 483],537,5,11038,3.667109634551495,20.0,20.0
13010,1,3010,[ 98 135 357 181 276],42,4,11042,3.6672201926270342,20.0,20.0
13011,1,3011,[313 127 187 302 483],669,4,11046,3.6673306772908365,20.0,20.0
13012,1,3012,[135 118 483 655  50],881,4,11050,3.6674410886159974,20.0,20.0
13013,1,3013,[313 127 187 302 483],207,5,11055,3.667883211678832,20.0,20.0
13014,1,3014,[313 127 187 302 483],328,5,11060,3.66832504145937,20.0,20.0
13015,1,3015,[313 127 187 302 483],207,5,11065,3.668766578249337,20.0,20.0
13016,1,3016,[191   8 143 333  82],313,2,11067,3.668213457076566,0.0,0.0
13017,1,3017,[125 515 588 655   9],406,2,11069,3.667660702451955,0.0,0.0
13018,1,3018,[ 98 161  15 195 196],533,5,11074,3.6681020205366015,0.0,20.0
13019,1,3019,[385  50 187  82 216],538,4,11078,3.668211920529801,0.0,20.0
13020,1,3020,[313 127 187 302 483],669,4,11082,3.6683217477656407,20.0,20.0
13021,1,3021,[265 475 202  12 322],308,3,11085,3.6681005956320316,20.0,0.0
13022,1,3022,[313 127 187 302 483],328,5,11090,3.6685411842540523,20.0,20.0
13023,1,3023,[333 111 228  70 216],533,5,11095,3.6689814814814814,0.0,0.0
13024,1,3024,[258 403  28  98  89],738,4,11099,3.669090909090909,0.0,20.0
13025,1,3025,[ 89 288  22 180  97],339,4,11103,3.669200264375413,0.0,0.0
13026,1,3026,[ 79  88 235 275 313],13,2,11105,3.6686488272216717,0.0,0.0
13027,1,3027,[515 210  97  50 172],774,1,11106,3.66776750330251,0.0,20.0
13028,1,3028,[185  64 211 265 173],883,4,11110,3.667877187190492,0.0,0.0
13029,1,3029,[257 121  98 174 118],881,5,11115,3.6683168316831685,0.0,40.0
13030,1,3030,[ 56  89 742 269 282],271,1,11116,3.66743648960739,0.0,0.0
13031,1,3031,[ 96 187  98 161 182],234,2,11118,3.66688654353562,0.0,20.0
13032,1,3032,[313 127 187 302 483],207,5,11123,3.667326079788988,20.0,20.0
13033,1,3033,[265 508 100 183 179],207,2,11125,3.666776532630191,0.0,20.0
13034,1,3034,[194 423 127 357 496],59,4,11129,3.6668863261943985,20.0,20.0
13035,1,3035,[143 228 144 282 357],406,1,11130,3.66600790513834,20.0,0.0
13036,1,3036,[179 742 117 161 234],653,3,11133,3.6657886071781363,0.0,0.0
13037,1,3037,[100   1 603 234   9],533,4,11137,3.665898617511521,20.0,20.0
13038,1,3038,[301 168  79 172 313],13,3,11140,3.665679499835472,0.0,0.0
13039,1,3039,[313 127 187 302 483],669,4,11144,3.6657894736842107,20.0,20.0
13040,1,3040,[313 127 187 302 603],116,3,11147,3.665570536007892,20.0,20.0
13041,1,3041,[222 151 183 546 234],447,2,11149,3.6650230111768574,0.0,0.0
13042,1,3042,[423 132 322  28 180],474,5,11154,3.665461715412422,0.0,0.0
13043,1,3043,[323 678  11  50 210],804,5,11159,3.665900131406045,0.0,20.0
13044,1,3044,[313 127 187 302 483],474,5,11164,3.6663382594417078,20.0,20.0
13045,1,3045,[313 127 187 302 483],537,5,11169,3.6667760998030205,20.0,20.0
13046,1,3046,[161 175 238 174 403],7,4,11173,3.666885461109288,0.0,20.0
13047,1,3047,[200 483   7 238 515],537,4,11177,3.666994750656168,20.0,0.0
13048,1,3048,[423 265 121 125 179],7,5,11182,3.6674319448999673,0.0,0.0
13049,1,3049,[204 176 174 603 269],7,3,11185,3.6672131147540985,20.0,20.0
13050,1,3050,[182 237 127  69 238],271,4,11189,3.6673221894460832,0.0,20.0
13051,1,3051,[222 678 204  50 127],455,3,11192,3.667103538663172,0.0,40.0
13052,1,3052,[182 202 186 185  88],749,4,11196,3.6672125777923354,0.0,0.0
13053,1,3053,[275 742   1 276 333],458,4,11200,3.66732154551408,0.0,0.0
13054,1,3054,[125 568 423 471 515],194,1,11201,3.6664484451718495,0.0,0.0
13055,1,3055,[655  95 195 435  71],59,3,11204,3.6662303664921465,0.0,0.0
13056,1,3056,[ 71  50 180   1 111],648,3,11207,3.666012430487406,0.0,20.0
13057,1,3057,[180 265 181 215 748],804,5,11212,3.6664486592544145,0.0,0.0
13058,1,3058,[588 258 568  79 161],13,3,11215,3.6662307943772476,0.0,0.0
13059,1,3059,[357 204 172  50 191],815,5,11220,3.6666666666666665,20.0,20.0
13060,1,3060,[313 127 187 302 483],474,5,11225,3.6671022541653056,20.0,20.0
13061,1,3061,[ 98  79  88 588 475],308,4,11229,3.6672109732201177,0.0,20.0
13062,1,3062,[313 127 187 302 483],13,5,11234,3.6676460985961477,20.0,20.0
13063,1,3063,[313 127 187 302 483],328,5,11239,3.6680809399477807,20.0,20.0
13064,1,3064,[ 69 132 185 515 181],406,4,11243,3.668189233278956,0.0,0.0
13065,1,3065,[176 288  50 135 546],804,2,11245,3.66764514024788,0.0,20.0
13066,1,3066,[328 183  95 275 471],378,3,11248,3.667427453537659,0.0,0.0
13067,1,3067,[135 174 173 121 216],42,5,11253,3.6678617992177314,0.0,20.0
13068,1,3068,[471 313 258  69 300],234,2,11255,3.6673183447376996,0.0,0.0
13069,1,3069,[127 143 173  11 318],374,2,11257,3.666775244299674,20.0,20.0
13070,1,3070,[216  12 301 300   7],145,4,11261,3.6668837512211008,20.0,0.0
13071,1,3071,[313 127 187 302 483],474,5,11266,3.6673177083333335,20.0,20.0
13072,1,3072,[ 98 322 265 194 742],328,3,11269,3.6671005532053367,0.0,20.0
13073,1,3073,[ 56 143 196  25 313],59,4,11273,3.6672088484059855,0.0,0.0
13074,1,3074,[132  71  95 276 181],92,3,11276,3.666991869918699,0.0,0.0
13075,1,3075,[ 70 182  22  97 191],653,2,11278,3.666449934980494,0.0,0.0
13076,1,3076,[245 194 161 100 125],804,5,11283,3.666883327916802,0.0,20.0
13077,1,3077,[265 125 200 323 175],804,4,11287,3.6669915529564654,0.0,0.0
13078,1,3078,[313 127 187 302 483],474,5,11292,3.6674244884702825,20.0,20.0
13079,1,3079,[132 276 245 403 471],92,4,11296,3.6675324675324674,0.0,0.0
13080,1,3080,[313 127 187 302 483],537,5,11301,3.667964946445959,20.0,20.0
13081,1,3081,[183 265 275   4 204],7,5,11306,3.6683971447112267,0.0,0.0
13082,1,3082,[118  69  88   7 202],374,2,11308,3.6678559844307492,0.0,0.0
13083,1,3083,[403  98  88  64 127],184,3,11311,3.667639429312581,0.0,40.0
13084,1,3084,[471  82 174   4  56],194,3,11314,3.66742301458671,0.0,20.0
13085,1,3085,[111 125 144 237 187],64,3,11317,3.6672067401166557,0.0,0.0
13086,1,3086,[313 127 187 302 483],669,4,11321,3.6673145448655653,20.0,20.0
13087,1,3087,[496  50 216  79 508],643,5,11326,3.6677461139896375,0.0,20.0
13088,1,3088,[313 127 187 302 483],90,5,11331,3.668177403690515,20.0,20.0
13089,1,3089,[742 173 237 161 471],899,4,11335,3.668284789644013,0.0,0.0
13090,1,3090,[235  12 151  79 202],447,1,11336,3.667421546425105,20.0,0.0
13091,1,3091,[ 98 403 132 237  70],308,2,11338,3.666882276843467,0.0,20.0
13092,1,3092,[268 216 180 423 175],234,1,11339,3.6660200452634983,0.0,0.0
13093,1,3093,[185  96   4  70  89],659,4,11343,3.6661279896574013,0.0,0.0
13094,1,3094,[211 405 423  22 215],313,3,11346,3.6659127625201937,0.0,0.0
13095,1,3095,[313 127 187 302 483],669,4,11350,3.6660206718346253,20.0,20.0
13096,1,3096,[313 127 187 302 483],90,5,11355,3.6664514045850822,20.0,20.0
13097,1,3097,[179   8  50 318 143],343,5,11360,3.6668818592640413,20.0,20.0
13098,1,3098,[204 153 228 135 475],374,4,11364,3.6669893514036787,0.0,0.0
13099,1,3099,[655  71 385 357 173],13,2,11366,3.666451612903226,20.0,0.0
13100,1,3100,[313 127 187 302 483],669,4,11370,3.666559174459852,20.0,20.0
13101,1,3101,[235 197 289 125 132],406,3,11373,3.6663442940038684,0.0,0.0
13102,1,3102,[313 127 187 302 483],328,5,11378,3.6667740895907186,20.0,20.0
13103,1,3103,[313 127 187 302 483],328,5,11383,3.667203608247423,20.0,20.0
13104,1,3104,[313 403 180 238 125],59,4,11387,3.6673107890499197,0.0,0.0
13105,1,3105,[322 237 111 200 211],13,3,11390,3.6670959433354797,0.0,0.0
13106,1,3106,[215   9 515 300 483],488,4,11394,3.667203089797232,20.0,0.0
13107,1,3107,[ 95 202 210  11 194],64,4,11398,3.667310167310167,0.0,0.0
13108,1,3108,[172 132 183  64 143],346,4,11402,3.667417175940817,0.0,0.0
13109,1,3109,[313  28 423 168 228],234,3,11405,3.667202572347267,0.0,0.0
13110,1,3110,[357 118  15  88 216],311,4,11409,3.6673095467695274,20.0,0.0
13111,1,3111,[ 71 271 273   4 127],13,3,11412,3.667095115681234,0.0,20.0
13112,1,3112,[313 127 187 302 427],537,5,11417,3.6675232894314167,0.0,20.0
13113,1,3113,[313 127 187 302 427],13,5,11422,3.667951188182402,0.0,20.0
13114,1,3114,[603  96   7 289 385],13,2,11424,3.6674157303370785,20.0,0.0
13115,1,3115,[294 181 215  28 135],537,1,11425,3.666559691912709,0.0,0.0
13116,1,3116,[655 143 322 222 235],313,1,11426,3.665704202759063,0.0,0.0
13117,1,3117,[ 11 118  96 257   9],749,2,11428,3.6651699807568954,0.0,0.0
13118,1,3118,[265  71 496 483 385],234,2,11430,3.6646361013145237,20.0,0.0
13119,1,3119,[313 127 187 302 427],13,5,11435,3.6650641025641026,0.0,20.0
13120,1,3120,[ 56  28  97 183 210],537,1,11436,3.664210189041974,0.0,0.0
13121,1,3121,[153 603 483 237  15],694,5,11441,3.6646380525304294,40.0,0.0
13122,1,3122,[ 28  15 194  11 202],454,1,11442,3.6637848222862632,0.0,0.0
13123,1,3123,[288 172   1  82  28],374,4,11446,3.6638924455825865,0.0,0.0
13124,1,3124,[313 127 187 302 427],328,4,11450,3.664,0.0,20.0
13125,1,3125,[175 144 187 191 168],387,4,11454,3.6641074856046063,0.0,0.0
13126,1,3126,[176 182 117   4 328],653,2,11456,3.663575311800448,0.0,0.0
13127,1,3127,[313 127 187 302 483],328,5,11461,3.664002557544757,20.0,20.0
13128,1,3128,[313 127 187 302 483],669,4,11465,3.6641099392777243,20.0,20.0
13129,1,3129,[423 301 546 508 118],524,5,11470,3.6645367412140577,0.0,0.0
13130,1,3130,[ 89 117  22 135  64],892,5,11475,3.6649632705206003,0.0,0.0
13131,1,3131,[  4 135 194 125 322],881,3,11478,3.664750957854406,0.0,0.0
13132,1,3132,[568 176 234 313  79],659,5,11483,3.665177146504947,0.0,0.0
13133,1,3133,[313 127 187 302 603],669,5,11488,3.665603063178047,20.0,20.0
13134,1,3134,[ 70 603 127 471 288],533,4,11492,3.6657097288676237,20.0,20.0
13135,1,3135,[313 127 187 302 603],116,3,11495,3.665497448979592,20.0,20.0
13136,1,3136,[ 50  82 318  69 222],524,4,11499,3.665604080331527,20.0,20.0
13137,1,3137,[282 515  50 471 179],194,2,11501,3.6650732950924154,0.0,20.0
13138,1,3138,[313 127 187 302 483],13,5,11506,3.6654985664224276,20.0,20.0
13139,1,3139,[238 204 175 111  89],479,5,11511,3.665923566878981,0.0,0.0
13140,1,3140,[742 183 211 385 168],59,4,11515,3.6660299267749124,0.0,0.0
13141,1,3141,[182  12 496 100  64],90,4,11519,3.6661362189688096,20.0,20.0
13142,1,3142,[313 127 187 302 483],669,4,11523,3.6662424435252943,20.0,20.0
13143,1,3143,[111 153 211 471 215],454,1,11524,3.6653944020356235,0.0,0.0
13144,1,3144,[313 127 187 302 483],474,5,11529,3.665818759936407,20.0,20.0
13145,1,3145,[200 423 179 151 143],378,2,11531,3.665289256198347,0.0,0.0
13146,1,3146,[ 79 268 194 597 546],643,3,11534,3.665077851922466,0.0,0.0
13147,1,3147,[313 127 187 302 483],13,5,11539,3.6655019059720457,20.0,20.0
13148,1,3148,[588  70 357   8 200],479,4,11543,3.665608129564941,20.0,0.0
13149,1,3149,[322 323 238 100 515],804,5,11548,3.666031746031746,0.0,20.0
13150,1,3150,[234  71 318 323 245],488,2,11550,3.6655030149159,20.0,0.0
13151,1,3151,[ 97 144  89 100  50],194,2,11552,3.66497461928934,0.0,40.0
13152,1,3152,[125 655 135  50 216],311,5,11557,3.665398033618776,0.0,20.0
13153,1,3153,[  7 515  89 235 313],184,3,11560,3.6651870640456563,0.0,0.0
13154,1,3154,[117  25 176 265  70],234,0,11560,3.664025356576862,0.0,0.0
13155,1,3155,[313 127 187 302 483],328,5,11565,3.664448669201521,20.0,20.0
13156,1,3156,[238 181  12 172 204],940,4,11569,3.664554957237884,20.0,0.0
13157,1,3157,[508 175 568  79 301],378,4,11573,3.6646611779607348,0.0,0.0
13158,1,3158,[405 515 182 153  22],804,5,11578,3.6650838873061096,0.0,0.0
13159,1,3159,[183 117 265 204 216],653,3,11581,3.664873417721519,0.0,0.0
13160,1,3160,[195  22 180 194  56],881,3,11584,3.664663081303385,0.0,0.0
13161,1,3161,[313 127 187 302 483],13,5,11589,3.6650853889943074,20.0,20.0
13162,1,3162,[195 568  56 515 286],387,3,11592,3.6648751185583306,0.0,0.0
13163,1,3163,[257 181 175 121 176],213,5,11597,3.6652970922882426,0.0,0.0
13164,1,3164,[191  11  22  56 515],804,4,11601,3.6654028436018957,0.0,0.0
13165,1,3165,[ 25  28   8 174 385],892,4,11605,3.6655085281111814,0.0,20.0
13166,1,3166,[127 496  69 258 196],815,4,11609,3.665614145879381,0.0,20.0
13167,1,3167,[187  28 182  64 238],6,4,11613,3.665719696969697,0.0,0.0
13168,1,3168,[313 127 187 302 483],13,5,11618,3.6661407384032816,20.0,20.0
13169,1,3169,[ 56 435  11 182 286],788,1,11619,3.6652996845425867,0.0,0.0
13170,1,3170,[210  56 200 333 423],537,1,11620,3.664459161147903,0.0,0.0
13171,1,3171,[180 568 273 111 168],385,1,11621,3.6636191677175285,0.0,0.0
13172,1,3172,[ 25 204 151  64 515],279,2,11623,3.6630948629057674,0.0,0.0
13173,1,3173,[313 127 187 302 483],90,5,11628,3.66351606805293,20.0,20.0
13174,1,3174,[151 176 144 210 186],95,4,11632,3.6636220472440946,0.0,0.0
13175,1,3175,[  1 742 405 196  50],804,5,11637,3.66404282115869,0.0,20.0
13176,1,3176,[176 151 603  98 179],650,3,11640,3.663833805476865,20.0,20.0
13177,1,3177,[ 56  89 196  12 385],379,4,11644,3.6639395846444303,20.0,0.0
13178,1,3178,[235 175 265 423 168],343,4,11648,3.66404529726329,0.0,0.0
13179,1,3179,[313 127 187 302 483],669,4,11652,3.6641509433962263,20.0,20.0
13180,1,3180,[143 222 168 182 265],666,2,11654,3.6636277900031438,0.0,0.0
13181,1,3181,[111 216 245  69  25],378,2,11656,3.6631049654305468,0.0,0.0
13182,1,3182,[222 423 176  89 496],804,4,11660,3.663210807414389,0.0,0.0
13183,1,3183,[  8 197 471 258  28],6,2,11662,3.6626884422110555,0.0,0.0
13184,1,3184,[175 161 117  11 357],234,1,11663,3.6618524332810045,20.0,0.0
13185,1,3185,[265 175 127 161 191],7,4,11667,3.6619585687382297,0.0,20.0
13186,1,3186,[313 127 187 302 483],669,4,11671,3.6620646375902104,20.0,20.0
13187,1,3187,[313 127 187 302 357],13,4,11675,3.6621706398996237,20.0,20.0
13188,1,3188,[282 405  88 181  79],374,3,11678,3.6619629978049546,0.0,0.0
13189,1,3189,[117 118  82  88 194],533,5,11683,3.662382445141066,0.0,0.0
13190,1,3190,[191 180 423  69 265],311,5,11688,3.662801629583203,0.0,0.0
13191,1,3191,[313 127 187 302 483],334,5,11693,3.663220551378446,20.0,20.0
13192,1,3192,[117 357 333 197 273],13,1,11694,3.6623864704040088,20.0,0.0
13193,1,3193,[202 100 655 258 204],749,4,11698,3.662492172824045,0.0,20.0
13194,1,3194,[118 135   1  50 111],59,4,11702,3.6625978090766824,0.0,20.0
13195,1,3195,[385 196  97 423  56],892,4,11706,3.66270337922403,0.0,0.0
13196,1,3196,[204 655 268 168   9],119,5,11711,3.663121676571786,0.0,0.0
13197,1,3197,[427  12 117 186   8],328,3,11714,3.662914321450907,20.0,0.0
13198,1,3198,[273  88 153 546 742],749,4,11718,3.663019693654267,0.0,0.0
13199,1,3199,[302 328 655  56 483],207,4,11722,3.663125,20.0,0.0
13200,1,3200,[ 97 483  64 144 195],7,5,11727,3.663542642924086,20.0,0.0
13201,1,3201,[300 222 153 125  98],334,3,11730,3.6633354153653968,0.0,20.0
13202,1,3202,[403 118 132 127   4],87,4,11734,3.6634405245082733,0.0,20.0
13203,1,3203,[196 186 210 282  11],378,3,11737,3.6632334581772783,0.0,0.0
13204,1,3204,[403 144 153  69 174],295,5,11742,3.6636505460218407,0.0,20.0
13205,1,3205,[515 385 282 228 655],881,4,11746,3.663755458515284,0.0,0.0
13206,1,3206,[265 185 194 191 588],881,3,11749,3.663548487683193,0.0,0.0
13207,1,3207,[172 182 176 183 568],537,1,11750,3.6627182044887783,0.0,0.0
13208,1,3208,[313 127 187 302 483],334,5,11755,3.663134933000935,20.0,20.0
13209,1,3209,[ 95   1 196 186 173],64,5,11760,3.663551401869159,0.0,0.0
13210,1,3210,[313 127 187 302 483],334,5,11765,3.6639676113360324,20.0,20.0
13211,1,3211,[210 183 258 185 265],479,5,11770,3.664383561643836,0.0,0.0
13212,1,3212,[187 210   4 181   9],749,3,11773,3.6641767818238407,0.0,0.0
13213,1,3213,[313 127 187 302 483],474,5,11778,3.6645924082140633,20.0,20.0
13214,1,3214,[235  97 186 215 435],271,4,11782,3.664696734059098,0.0,0.0
13215,1,3215,[ 79 202   4  56 423],234,2,11784,3.6641791044776117,0.0,0.0
13216,1,3216,[ 22 228 597 200  50],13,3,11787,3.6639726453217283,0.0,20.0
13217,1,3217,[ 56 186 216  25 234],533,2,11789,3.663455562461156,0.0,0.0
13218,1,3218,[172 127  50 153 204],374,3,11792,3.6632494563529048,0.0,40.0
13219,1,3219,[257 405   4 357  82],881,4,11796,3.6633540372670805,20.0,0.0
13220,1,3220,[423 195 258 483  25],200,5,11801,3.663769015833592,20.0,0.0
13221,1,3221,[  7   8 258   9 202],200,5,11806,3.664183736809435,0.0,0.0
13222,1,3222,[313 127 187 302 483],328,5,11811,3.664598200434378,20.0,20.0
13223,1,3223,[211 179 168 385 275],64,5,11816,3.665012406947891,0.0,0.0
13224,1,3224,[180 183 121 200 211],650,3,11819,3.6648062015503875,0.0,0.0
13225,1,3225,[313 127 187 302 483],537,5,11824,3.6652200867947924,20.0,20.0
13226,1,3226,[ 12 117 483 318 125],213,5,11829,3.6656337155252556,60.0,0.0
13227,1,3227,[211 204 322 161 423],328,3,11832,3.6654275092936803,0.0,0.0
13228,1,3228,[228  82 268 471   8],234,1,11833,3.6646020439764633,0.0,0.0
13229,1,3229,[313 127 187 302 483],334,5,11838,3.665015479876161,20.0,20.0
13230,1,3230,[173 546 289   7 143],92,1,11839,3.6641906530485917,0.0,0.0
13231,1,3231,[313 127 187 302 483],328,5,11844,3.6646039603960396,20.0,20.0
13232,1,3232,[313 127 187 302 483],537,5,11849,3.665017012063099,20.0,20.0
13233,1,3233,[172 186 269 153  50],659,2,11851,3.6645021645021645,0.0,20.0
13234,1,3234,[173  97 276  15  64],271,3,11854,3.6642967542503864,0.0,0.0
13235,1,3235,[515 475   4 202 204],13,3,11857,3.664091470951792,0.0,0.0
13236,1,3236,[204   8 215 121 588],311,5,11862,3.664504170528267,0.0,0.0
13237,1,3237,[302 313 216 237 100],144,4,11866,3.664607782581841,0.0,20.0
13238,1,3238,[ 28 127  12  98 289],271,5,11871,3.6650200679221983,20.0,40.0
13239,1,3239,[313 127 187 302 483],334,5,11876,3.6654320987654323,20.0,20.0
13240,1,3240,[ 79 216   8  15 483],60,4,11880,3.6655353286022834,20.0,0.0
13241,1,3241,[313 127 187 302 483],334,5,11885,3.6659469463294263,20.0,20.0
13242,1,3242,[313 127 187 302 483],207,5,11890,3.666358310206599,20.0,20.0
13243,1,3243,[200 748 294 161 210],479,2,11892,3.665844636251541,0.0,0.0
13244,1,3244,[238 196  71 655 127],474,5,11897,3.6662557781201848,0.0,20.0
13245,1,3245,[313 127 187 302 483],334,5,11902,3.6666666666666665,20.0,20.0
13246,1,3246,[313 127 187 302 483],207,5,11907,3.6670773021250387,20.0,20.0
13247,1,3247,[475   9 508 222 132],13,1,11908,3.666256157635468,0.0,0.0
13248,1,3248,[265  28  25 100 181],313,3,11911,3.6660510926438903,0.0,20.0
13249,1,3249,[204 194 186 271 181],13,4,11915,3.666153846153846,0.0,0.0
13250,1,3250,[200   4 187 195 228],537,1,11916,3.66533374346355,0.0,0.0
13251,1,3251,[546 100 234 176 269],279,2,11918,3.664821648216482,0.0,20.0
13252,1,3252,[  9 127 333 195 194],328,2,11920,3.664309867814325,0.0,20.0
13253,1,3253,[265  89  82 183 286],197,4,11924,3.6644130301167794,0.0,0.0
13254,1,3254,[405 100 168 273 313],92,4,11928,3.664516129032258,0.0,20.0
13255,1,3255,[313 127 187 302 483],334,5,11933,3.66492628992629,20.0,20.0
13256,1,3256,[186 328   9 185 313],271,3,11936,3.6647221369358305,0.0,0.0
13257,1,3257,[ 82  79 265   4  15],234,1,11937,3.6639042357274403,0.0,0.0
13258,1,3258,[597  97 238 121 265],650,2,11939,3.663393679042651,0.0,0.0
13259,1,3259,[269 182 515 222  98],102,1,11940,3.6625766871165646,0.0,20.0
13260,1,3260,[313 127 187 302 483],669,4,11944,3.6626801594602885,20.0,20.0
13261,1,3261,[357 286 180  88  98],881,3,11947,3.6624770079705704,20.0,20.0
13262,1,3262,[ 56  71  95 515 132],843,0,11947,3.6613545816733066,0.0,0.0
13263,1,3263,[211  12 118 127  56],194,4,11951,3.6614583333333335,20.0,20.0
13264,1,3264,[546  71 323 202 183],290,3,11954,3.6612557427258805,0.0,0.0
13265,1,3265,[143 546   8   9 475],308,4,11958,3.6613594611145133,0.0,0.0
13266,1,3266,[313 127 187 302 483],207,5,11963,3.661769207223753,20.0,20.0
13267,1,3267,[  9 180 211  82 210],7,4,11967,3.66187270501836,0.0,0.0
13268,1,3268,[313 127 187 302 483],328,5,11972,3.6622820434383603,20.0,20.0
13269,1,3269,[186 179   4 471 127],524,4,11976,3.6623853211009174,0.0,20.0
13270,1,3270,[ 96 168 121 179 153],308,4,11980,3.6624885356160197,0.0,0.0
13271,1,3271,[ 64 742 282 405 357],533,3,11983,3.6622860635696823,20.0,0.0
13272,1,3272,[313 127 187 302 483],669,4,11987,3.662389245340666,20.0,20.0
13273,1,3273,[313 234 172 132 597],200,5,11992,3.662797800855223,0.0,0.0
13274,1,3274,[153 144 180 173 282],326,3,11995,3.662595419847328,0.0,0.0
13275,1,3275,[172 182 174  69   1],788,1,11996,3.6617826617826617,0.0,20.0
13276,1,3276,[  1 194 210 328 475],13,1,11997,3.6609703997558745,0.0,0.0
13277,1,3277,[  7 181 121 597  71],650,2,11999,3.660463697376449,0.0,0.0
13278,1,3278,[210 186 132  79 423],385,1,12000,3.659652333028362,0.0,0.0
13279,1,3279,[313 127 187 302 483],328,5,12005,3.660060975609756,20.0,20.0
13280,1,3280,[ 28 603 211 215  97],897,5,12010,3.660469369094788,20.0,0.0
13281,1,3281,[313 127 187 302 483],669,4,12014,3.660572821450335,20.0,20.0
13282,1,3282,[323 318 483 111 180],537,3,12017,3.6603716113310996,40.0,0.0
13283,1,3283,[ 88   9 423 597 118],200,5,12022,3.6607795371498173,0.0,0.0
13284,1,3284,[313 127 187 302 483],334,5,12027,3.6611872146118722,20.0,20.0
13285,1,3285,[  9  22 153 210 235],648,4,12031,3.661290322580645,0.0,0.0
13286,1,3286,[  8 179 185 194 496],189,5,12036,3.6616975965926377,0.0,0.0
13287,1,3287,[403 288 475 210  15],479,1,12037,3.6608880778588806,0.0,0.0
13288,1,3288,[ 98 181 271 153 216],13,3,12040,3.6606871389480085,0.0,20.0
13289,1,3289,[175 173 222  82 271],479,4,12044,3.660790273556231,0.0,0.0
13290,1,3290,[132 172 135 286 204],452,2,12046,3.6602856274688547,0.0,0.0
13291,1,3291,[288 235 286   7 174],213,3,12049,3.6600850546780075,0.0,20.0
13292,1,3292,[313 127 187 302 483],90,5,12054,3.660491952626784,20.0,20.0
13293,1,3293,[ 28  71 135 496 742],488,4,12058,3.6605950212507588,0.0,0.0
13294,1,3294,[182 121 191  28 328],833,2,12060,3.660091047040971,0.0,0.0
13295,1,3295,[313 127 187 302 483],334,5,12065,3.660497572815534,20.0,20.0
13296,1,3296,[313 127 187 302 483],334,5,12070,3.6609038519866544,20.0,20.0
13297,1,3297,[282 121 143  82 117],194,0,12070,3.6597938144329896,0.0,0.0
13298,1,3298,[174 143  11 234  64],406,4,12074,3.659896938466202,0.0,20.0
13299,1,3299,[496  69 187   4 121],115,2,12076,3.659393939393939,0.0,0.0
13300,1,3300,[ 98 228 245 742  22],313,1,12077,3.6585883065737654,0.0,20.0
13301,1,3301,[  9 282 216 172 258],378,5,12082,3.6589945487583284,0.0,0.0
13302,1,3302,[748  95 257 546  56],92,1,12083,3.658189524674538,0.0,0.0
13303,1,3303,[288 118 471 300 475],533,3,12086,3.6579903147699757,0.0,0.0
13304,1,3304,[313 127 187 302 483],334,5,12091,3.6583963691376704,20.0,20.0
13305,1,3305,[ 96 181  97 202 257],804,5,12096,3.658802177858439,0.0,0.0
13306,1,3306,[265  25 597 179  95],378,3,12099,3.6586029634109463,0.0,0.0
13307,1,3307,[313 127 187 302 483],90,5,12104,3.6590084643289,20.0,20.0
13308,1,3308,[ 97  64 204 180 144],804,5,12109,3.659413720157147,0.0,0.0
13309,1,3309,[117   4   9 202 175],543,3,12112,3.659214501510574,0.0,0.0
13310,1,3310,[276   8  89  88 289],13,4,12116,3.659317426759287,0.0,0.0
13311,1,3311,[ 96 313 153 435 588],378,5,12121,3.6597222222222223,0.0,0.0
13312,1,3312,[ 97 117 508 127  95],387,2,12123,3.6592212496226986,0.0,20.0
13313,1,3313,[313 127 187 302 483],537,5,12128,3.659625829812915,20.0,20.0
13314,1,3314,[ 56 288 435 196 257],804,2,12130,3.659125188536953,0.0,0.0
13315,1,3315,[423  28 435 200  89],234,3,12133,3.6589264173703255,0.0,0.0
13316,1,3316,[ 71 168   8 235 289],194,2,12135,3.6584262888151944,0.0,0.0
13317,1,3317,[127  64 318 174  69],7,5,12140,3.6588306208559374,20.0,40.0
13318,1,3318,[313 127 187 302 483],334,5,12145,3.659234709249774,20.0,20.0
13319,1,3319,[185  89 294 322 257],308,3,12148,3.6590361445783133,0.0,0.0
13320,1,3320,[ 95  50  96  25 172],13,4,12152,3.659138813610358,0.0,20.0
13321,1,3321,[174 127 176 210  98],605,3,12155,3.6589403973509933,0.0,60.0
13322,1,3322,[435 151   7  95 200],815,4,12159,3.659043033403551,0.0,0.0
13323,1,3323,[313 127 187 302 483],474,5,12164,3.6594464500601687,20.0,20.0
13324,1,3324,[588 195 132 301 172],378,3,12167,3.659248120300752,0.0,0.0
13325,1,3325,[ 95   8  82   4 153],194,1,12168,3.6584485868911605,0.0,0.0
13326,1,3326,[313 127 187 302 483],474,5,12173,3.6588518184550645,20.0,20.0
13327,1,3327,[748 195 187 323   4],804,5,12178,3.6592548076923075,0.0,0.0
13328,1,3328,[313 127 187 302 483],13,5,12183,3.6596575548212678,20.0,20.0
13329,1,3329,[196 357 294 204  56],232,4,12187,3.6597597597597598,20.0,0.0
13330,1,3330,[288 568 245 258 161],102,1,12188,3.6589612728910237,0.0,0.0
13331,1,3331,[127 301 238 237 289],13,2,12190,3.6584633853541417,0.0,20.0
13332,1,3332,[313 127 187 302 483],537,5,12195,3.658865886588659,20.0,20.0
13333,1,3333,[403 176 194 118 222],774,1,12196,3.6580683863227352,0.0,0.0
13334,1,3334,[313 127 187 302 483],537,5,12201,3.6584707646176913,20.0,20.0
13335,1,3335,[ 56   9 100 427  95],6,4,12205,3.6585731414868103,0.0,20.0
13336,1,3336,[211 546  82 318 182],804,4,12209,3.658675456997303,20.0,0.0
13337,1,3337,[ 12 197  89 222 427],666,4,12213,3.658777711204314,20.0,0.0
13338,1,3338,[748 161  12 742 153],543,2,12215,3.658280922431866,20.0,0.0
13339,1,3339,[ 89 405  79  22 300],64,2,12217,3.6577844311377246,0.0,0.0
13340,1,3340,[100  96 508 294 322],537,2,12219,3.657288237054774,0.0,20.0
13341,1,3341,[597 276  69  95 216],13,3,12222,3.657091561938959,0.0,0.0
13342,1,3342,[313 127 187 302 483],13,5,12227,3.6574932695183966,20.0,20.0
13343,1,3343,[313 127 187 302 483],537,5,12232,3.6578947368421053,20.0,20.0
13344,1,3344,[313 127 187 302 483],537,5,12237,3.6582959641255606,20.0,20.0
13345,1,3345,[269  98 197  69 258],659,4,12241,3.65839808726838,0.0,20.0
13346,1,3346,[313 127 187 302 483],328,5,12246,3.6587989244099193,20.0,20.0
13347,1,3347,[385 111 405 318 186],59,4,12250,3.6589008363201914,20.0,0.0
13348,1,3348,[182 180  98 597 282],328,2,12252,3.6584054941773663,0.0,20.0
13349,1,3349,[168 313 228  98 234],738,4,12256,3.658507462686567,0.0,20.0
13350,1,3350,[174 471 172 100 483],666,3,12259,3.6583109519546406,20.0,40.0
13351,1,3351,[313 127 187 302 483],334,5,12264,3.658711217183771,20.0,20.0
13352,1,3352,[313 127 187 302 483],334,5,12269,3.659111243662392,20.0,20.0
13353,1,3353,[313 127 187 302 483],13,5,12274,3.6595110316040547,20.0,20.0
13354,1,3354,[185 172 121 135   8],64,4,12278,3.659612518628912,0.0,0.0
13355,1,3355,[ 50   1 100  56 153],308,5,12283,3.6600119189511324,0.0,40.0
13356,1,3356,[313 127 187 302 483],207,5,12288,3.6604110813226094,20.0,20.0
13357,1,3357,[ 22  15 100 175 117],207,1,12289,3.659618820726623,0.0,20.0
13358,1,3358,[179 508  96  64 175],524,3,12292,3.659422447156892,0.0,0.0
13359,1,3359,[546 222 471  79  89],666,3,12295,3.6592261904761907,0.0,0.0
13360,1,3360,[427 294 271 197 111],13,3,12298,3.6590300505801845,0.0,0.0
13361,1,3361,[294  64 496  70 117],533,5,12303,3.6594289113622844,0.0,0.0
13362,1,3362,[181  22 294 385  88],83,4,12307,3.6595301813856675,0.0,0.0
13363,1,3363,[313 127 187 302 483],474,5,12312,3.6599286563614744,20.0,20.0
13364,1,3364,[ 96 483   8 180 181],533,3,12315,3.6597325408618127,20.0,0.0
13365,1,3365,[215  22 228 496  28],892,4,12319,3.6598336304218657,0.0,0.0
13366,1,3366,[ 64 135 234 300  97],533,2,12321,3.659340659340659,0.0,0.0
13367,1,3367,[196 183 496   8 268],234,3,12324,3.659144893111639,0.0,0.0
13368,1,3368,[313 127 187 302 483],669,4,12328,3.65924606708222,20.0,20.0
13369,1,3369,[173 273 215 318 603],13,2,12330,3.658753709198813,40.0,0.0
13370,1,3370,[318 135  22 323  11],804,4,12334,3.6588549391871847,20.0,0.0
13371,1,3371,[313 127 187 302 483],90,5,12339,3.659252669039146,20.0,20.0
13372,1,3372,[265   8 100 168 257],92,4,12343,3.6593536910761935,0.0,20.0
13373,1,3373,[  1 257 132 496 318],560,2,12345,3.6588618850029637,20.0,0.0
13374,1,3374,[183 180   1 143 222],406,3,12348,3.6586666666666665,0.0,0.0
13375,1,3375,[483 143 210 186 257],840,3,12351,3.658471563981043,20.0,0.0
13376,1,3376,[187  71  50 195 196],64,4,12355,3.6585726976606456,0.0,20.0
13377,1,3377,[135  97 546 174 222],194,1,12356,3.6577856719952635,0.0,20.0
13378,1,3378,[  9  71 483 568 132],881,3,12359,3.657591003255401,20.0,0.0
13379,1,3379,[ 12 235 568 385 111],92,2,12361,3.6571005917159765,20.0,0.0
13380,1,3380,[423 183 282 427 322],334,4,12365,3.6572020112392782,0.0,0.0
13381,1,3381,[313 127 187 302 483],474,5,12370,3.657599053814311,20.0,20.0
13382,1,3382,[313 127 187 302 483],474,5,12375,3.6579958616612473,20.0,20.0
13383,1,3383,[ 25 245  28 515 597],207,3,12378,3.6578014184397163,0.0,0.0
13384,1,3384,[ 12 273  69 187  97],524,3,12381,3.6576070901033972,20.0,0.0
13385,1,3385,[313 127 187 302 483],669,4,12385,3.6577082102776135,20.0,20.0
13386,1,3386,[313 127 187 302 483],90,5,12390,3.658104517271922,20.0,20.0
13387,1,3387,[135 118 194  88  50],840,3,12393,3.657910271546635,0.0,20.0
13388,1,3388,[174 289 117 196 423],13,3,12396,3.6577161404544114,0.0,20.0
13389,1,3389,[313 127 187 302 483],334,5,12401,3.65811209439528,20.0,20.0
13390,1,3390,[313 127 187 302 483],207,5,12406,3.6585078148038925,20.0,20.0
13391,1,3391,[228 271  96  64   1],738,4,12410,3.6586084905660377,0.0,0.0
13392,1,3392,[275 174 235 181 678],648,4,12414,3.658709106984969,0.0,20.0
13393,1,3393,[515 172  98  89  22],311,5,12419,3.659104301708898,0.0,20.0
13394,1,3394,[132 300 191 282 496],605,4,12423,3.65920471281296,0.0,0.0
13395,1,3395,[313 127 187 302 483],334,5,12428,3.659599528857479,20.0,20.0
13396,1,3396,[282 118  70 187  56],328,3,12431,3.6594053576685313,0.0,0.0
13397,1,3397,[  4 202 183 268 508],13,4,12435,3.659505591524426,0.0,0.0
13398,1,3398,[385 289 135  71 288],533,2,12437,3.6590173580464844,0.0,0.0
13399,1,3399,[179 172 173 313 328],334,3,12440,3.6588235294117646,0.0,0.0
13400,1,3400,[ 50 385  69 161 127],13,4,12444,3.6589238459276685,0.0,40.0
13401,1,3401,[ 25 273  71 245 216],378,4,12448,3.659024103468548,0.0,0.0
13402,1,3402,[118 179 121 153  96],664,2,12450,3.658536585365854,0.0,0.0
13403,1,3403,[  9 748  69 423 403],533,3,12453,3.65834312573443,0.0,0.0
13404,1,3404,[313 127 187 302 483],537,5,12458,3.6587371512481646,20.0,20.0
13405,1,3405,[ 15 117 121 175 483],648,2,12460,3.658250146799765,20.0,0.0
13406,1,3406,[  8 235 405 222 118],328,1,12461,3.657469914881127,0.0,0.0
13407,1,3407,[313 127 187 302 483],537,5,12466,3.657863849765258,20.0,20.0
13408,1,3408,[313 127 187 302 483],537,5,12471,3.658257553534761,20.0,20.0
13409,1,3409,[135 172  97 288 197],387,2,12473,3.6577712609970674,0.0,0.0
13410,1,3410,[286 258 282 197 182],479,4,12477,3.657871591908531,0.0,0.0
13411,1,3411,[313 127 187 302 483],334,5,12482,3.6582649472450175,20.0,20.0
13412,1,3412,[313 127 187 302 483],207,5,12487,3.658658072077351,20.0,20.0
13413,1,3413,[405 173 271   4 403],102,0,12487,3.657586408904511,0.0,0.0
13414,1,3414,[ 95 135 234  88  64],749,4,12491,3.6576866764275255,0.0,0.0
13415,1,3415,[187  97  12 197 111],64,3,12494,3.6574941451990632,20.0,0.0
13416,1,3416,[ 98 405  15   8 168],882,5,12499,3.6578870354111794,0.0,20.0
13417,1,3417,[302 597  11  69 271],145,5,12504,3.658279695728496,0.0,0.0
13418,1,3418,[313 127 187 302 483],207,5,12509,3.6586721263527346,20.0,20.0
13419,1,3419,[228  89 423 176 357],200,5,12514,3.65906432748538,20.0,0.0
13420,1,3420,[508 475 181 742   7],92,4,12518,3.6591639871382635,0.0,0.0
13421,1,3421,[265 385 100 127  97],328,3,12521,3.6589713617767385,0.0,40.0
13422,1,3422,[ 89 202 496  96 176],899,5,12526,3.6593631317557698,0.0,0.0
13423,1,3423,[313 127 187 302 483],474,5,12531,3.659754672897196,20.0,20.0
13424,1,3424,[  1 257   4  12 322],92,3,12534,3.6595620437956202,20.0,0.0
13425,1,3425,[ 15  64  95 173  97],406,4,12538,3.6596614127262113,0.0,0.0
13426,1,3426,[100 179 187 196 323],650,2,12540,3.659177122847972,0.0,20.0
13427,1,3427,[313 127 187 302 483],474,5,12545,3.6595682613768963,20.0,20.0
13428,1,3428,[515 655  88 275 286],406,0,12545,3.658501020705745,0.0,0.0
13429,1,3429,[ 12 228 385 496 483],533,5,12550,3.6588921282798834,40.0,0.0
13430,1,3430,[132 237 222 234 748],804,5,12555,3.659283007869426,0.0,0.0
13431,1,3431,[237 288  95 173  50],13,3,12558,3.659090909090909,0.0,20.0
13432,1,3432,[144 238 405 202 186],892,4,12562,3.659190212642004,0.0,0.0
13433,1,3433,[288 202 742 176 471],308,4,12566,3.6592894583576006,0.0,0.0
13434,1,3434,[288 603  79 269 435],7,4,12570,3.6593886462882095,20.0,0.0
13435,1,3435,[313 127 187 302 483],207,5,12575,3.659778812572759,20.0,20.0
13436,1,3436,[ 28 172 483   9  69],60,5,12580,3.6601687518184463,20.0,0.0
13437,1,3437,[313 127 187 302 483],207,5,12585,3.6605584642233855,20.0,20.0
13438,1,3438,[546  22 313 185 117],653,3,12588,3.660366385577203,0.0,0.0
13439,1,3439,[181 191 258 238 121],339,3,12591,3.660174418604651,0.0,0.0
13440,1,3440,[153 111 181 172 471],234,0,12591,3.6591107236268527,0.0,0.0
13441,1,3441,[143 179 238 603 237],234,1,12592,3.6583381754793725,20.0,0.0
13442,1,3442,[215 427 173 302 271],537,3,12595,3.65814696485623,0.0,0.0
13443,1,3443,[ 96 117 235 121  56],406,5,12600,3.658536585365854,0.0,0.0
13444,1,3444,[313 127 187 302 483],537,5,12605,3.6589259796806965,20.0,20.0
13445,1,3445,[258 318 144  88 603],815,4,12609,3.659024956471271,40.0,0.0
13446,1,3446,[313 127 187 302 483],537,5,12614,3.659413983173774,20.0,20.0
13447,1,3447,[313 127 187 302 483],537,5,12619,3.659802784222738,20.0,20.0
13448,1,3448,[ 11  88 357 603  56],840,4,12623,3.6599014207016527,40.0,0.0
13449,1,3449,[269  70 121 168  11],119,3,12626,3.659710144927536,0.0,0.0
13450,1,3450,[313 127 187 302 483],537,5,12631,3.6600985221674875,20.0,20.0
13451,1,3451,[ 28  70   1 183 496],308,3,12634,3.659907300115875,0.0,0.0
13452,1,3452,[173  70 215 210  89],488,4,12638,3.660005792064871,0.0,0.0
13453,1,3453,[313 127 187 302 483],328,5,12643,3.6603937463810077,20.0,20.0
13454,1,3454,[313 127 187 302 483],334,5,12648,3.660781476121563,20.0,20.0
13455,1,3455,[228 403 289 176 265],95,1,12649,3.660011574074074,0.0,0.0
13456,1,3456,[313 127 187 302 483],474,5,12654,3.6603991900491755,20.0,20.0
13457,1,3457,[294 403 288 222 313],13,1,12655,3.6596298438403703,0.0,0.0
13458,1,3458,[313 127 187 302 483],328,5,12660,3.6600173460537726,20.0,20.0
13459,1,3459,[748 204 143 238 289],474,3,12663,3.659826589595376,0.0,0.0
13460,1,3460,[313 127 187 302 483],328,5,12668,3.6602138110372726,20.0,20.0
13461,1,3461,[313 127 187 302 483],207,5,12673,3.6606008087810515,20.0,20.0
13462,1,3462,[185 435 496  69 318],694,5,12678,3.6609875830205025,20.0,0.0
13463,1,3463,[313 127 187 302 483],474,5,12683,3.6613741339491916,20.0,20.0
13464,1,3464,[655 273 228 742 405],749,4,12687,3.6614718614718615,0.0,0.0
13465,1,3465,[ 70 200 183 300  98],666,4,12691,3.6615695326024236,0.0,20.0
13466,1,3466,[200 273 245 210   1],92,4,12695,3.6616671473896742,0.0,0.0
13467,1,3467,[ 88 186 117 204 127],271,4,12699,3.661764705882353,0.0,20.0
13468,1,3468,[118 121  22  95 269],13,4,12703,3.661862208129144,0.0,0.0
13469,1,3469,[196  79  50 405  28],653,3,12706,3.661671469740634,0.0,20.0
13470,1,3470,[678 194 603 100 175],749,2,12708,3.661192739844425,20.0,20.0
13471,1,3471,[318 180 405   8 176],271,3,12711,3.6610023041474653,20.0,0.0
13472,1,3472,[  9  64 222 180 175],234,1,12712,3.660236107112007,0.0,0.0
13473,1,3473,[  4 182 568 265 228],13,4,12716,3.660333909038572,0.0,0.0
13474,1,3474,[ 98 211 168  64  89],85,5,12721,3.6607194244604315,0.0,20.0
13475,1,3475,[313 127 187 302 483],328,5,12726,3.6611047180667433,20.0,20.0
13476,1,3476,[  4 597  69   9 385],13,2,12728,3.660626977279264,0.0,0.0
13477,1,3477,[313 127 187 302 483],328,5,12733,3.6610120759056928,20.0,20.0
13478,1,3478,[ 79 194 357 215   9],474,5,12738,3.661396953147456,20.0,0.0
13479,1,3479,[118 125 475 258 276],533,3,12741,3.661206896551724,0.0,0.0
13480,1,3480,[313 127 187 302 483],207,5,12746,3.6615914966963516,20.0,20.0
13481,1,3481,[176 173 275 588 204],311,5,12751,3.6619758759333716,0.0,0.0
13482,1,3482,[313 127 187 302 483],207,5,12756,3.662360034453058,20.0,20.0
13483,1,3483,[313 127 187 302 483],207,5,12761,3.662743972445465,20.0,20.0
13484,1,3484,[182 185 187 300 483],313,5,12766,3.6631276901004304,20.0,0.0
13485,1,3485,[313 127 187 302 483],13,5,12771,3.663511187607573,20.0,20.0
13486,1,3486,[313 127 187 302 483],90,5,12776,3.663894465156295,20.0,20.0
13487,1,3487,[268 135 100 173   9],13,3,12779,3.663704128440367,0.0,20.0
13488,1,3488,[153 475  96  98  12],387,4,12783,3.6638005159071367,20.0,20.0
13489,1,3489,[313 127 187 302 483],334,5,12788,3.6641833810888254,20.0,20.0
13490,1,3490,[568  64 234 273 143],374,3,12791,3.6639931251790316,0.0,0.0
13491,1,3491,[235 322 125 294 176],788,2,12793,3.663516609392898,0.0,0.0
13492,1,3492,[313 127 187 302 483],537,5,12798,3.6638992270254795,20.0,20.0
13493,1,3493,[ 82 204 435 288 200],843,1,12799,3.6631368059530622,0.0,0.0
13494,1,3494,[313 127 187 302 483],669,4,12803,3.663233190271817,20.0,20.0
13495,1,3495,[313 127 187 302 483],537,5,12808,3.663615560640732,20.0,20.0
13496,1,3496,[313 127 187 302 483],537,5,12813,3.66399771232485,20.0,20.0
13497,1,3497,[313 127 187 302 483],90,5,12818,3.664379645511721,20.0,20.0
13498,1,3498,[313 127 187 302 483],328,5,12823,3.6647613603886824,20.0,20.0
13499,1,3499,[313 127 187 302 483],328,5,12828,3.665142857142857,20.0,20.0
13500,1,3500,[ 56  96 173 202 357],738,5,12833,3.665524135961154,20.0,0.0
13501,1,3501,[173 191 294 508 181],144,5,12838,3.6659051970302685,0.0,0.0
13502,1,3502,[313 127 187 302 483],334,5,12843,3.666286040536683,20.0,20.0
13503,1,3503,[216  98 173 301 132],85,3,12846,3.666095890410959,0.0,20.0
13504,1,3504,[496 234 153 195  97],346,3,12849,3.6659058487874465,0.0,0.0
13505,1,3505,[313 127 187 302 483],537,5,12854,3.666286366229321,20.0,20.0
13506,1,3506,[ 95  97 282   4 172],374,3,12857,3.666096378671229,0.0,0.0
13507,1,3507,[313 127 187 302 483],328,5,12862,3.6664766248574687,20.0,20.0
13508,1,3508,[313 127 187 302 483],328,5,12867,3.666856654317469,20.0,20.0
13509,1,3509,[172 196 427 197 180],326,3,12870,3.6666666666666665,0.0,0.0
13510,1,3510,[180 176 191 258 328],234,1,12871,3.66590714896041,0.0,0.0
13511,1,3511,[471 265 172 211 132],311,4,12875,3.666002277904328,0.0,0.0
13512,1,3512,[357 273 185 405  79],13,0,12875,3.6649587247366924,20.0,0.0
13513,1,3513,[ 22 357  25 117  71],406,2,12877,3.6644849174729655,20.0,0.0
13514,1,3514,[228 245 271 515 117],334,2,12879,3.6640113798008533,0.0,0.0
13515,1,3515,[ 28  11 125 655 135],7,4,12883,3.6641069397042094,0.0,0.0
13516,1,3516,[186 265  71 323   1],13,3,12886,3.663918112027296,0.0,0.0
13517,1,3517,[215 180 237 496   9],7,5,12891,3.6642978965321205,0.0,0.0
13518,1,3518,[313 127 187 302 483],474,5,12896,3.664677465188974,20.0,20.0
13519,1,3519,[  8 323 222 204   1],378,3,12899,3.6644886363636364,0.0,0.0
13520,1,3520,[132 117 546 215 328],653,2,12901,3.6640159045725644,0.0,0.0
13521,1,3521,[ 69  25  28 265 111],234,2,12903,3.663543441226576,0.0,0.0
13522,1,3522,[194  88   4  69   1],378,3,12906,3.6633550950894125,0.0,0.0
13523,1,3523,[313 127 187 302 483],328,5,12911,3.663734392735528,20.0,20.0
13524,1,3524,[ 71 187 127 176  95],325,1,12912,3.6629787234042555,0.0,20.0
13525,1,3525,[  8 185 194 132  56],271,3,12915,3.6627906976744184,0.0,0.0
13526,1,3526,[313 127 187 302 483],334,5,12920,3.6631698327190247,20.0,20.0
13527,1,3527,[313 127 187 302 483],537,5,12925,3.6635487528344672,20.0,20.0
13528,1,3528,[121 405 182 179 423],881,4,12929,3.663644091810711,0.0,0.0
13529,1,3529,[151  96 127 515 302],669,4,12933,3.6637393767705384,0.0,20.0
13530,1,3530,[  7  56 176 202 100],158,5,12938,3.664117813650524,0.0,20.0
13531,1,3531,[125 427 655 215 238],234,1,12939,3.6633635334088335,0.0,0.0
13532,1,3532,[313 127 187 302 483],474,5,12944,3.663741862439853,20.0,20.0
13533,1,3533,[153 318 100 180 385],738,4,12948,3.6638370118845502,20.0,20.0
13534,1,3534,[435  88 143  79   7],881,3,12951,3.6636492220650636,0.0,0.0
13535,1,3535,[313 127 187 302 483],13,5,12956,3.664027149321267,20.0,20.0
13536,1,3536,[196 210 127 603 118],59,5,12961,3.664404862878145,20.0,20.0
13537,1,3537,[228   8  50  96 176],774,3,12964,3.6642170717919726,0.0,20.0
13538,1,3538,[202 597 313 196 118],59,4,12968,3.664311952528963,0.0,0.0
13539,1,3539,[151 483 258 435 173],899,2,12970,3.6638418079096047,20.0,0.0
13540,1,3540,[ 70 483 210 288  22],479,4,12974,3.663936741033606,20.0,0.0
13541,1,3541,[313 127 187 302 483],328,5,12979,3.6643139469226425,20.0,20.0
13542,1,3542,[  7 183  12 515 197],59,5,12984,3.6646909398814564,20.0,0.0
13543,1,3543,[151 427 496 471 111],474,3,12987,3.664503386004515,0.0,0.0
13544,1,3544,[144 265 180 496 237],343,4,12991,3.6645980253878703,0.0,0.0
13545,1,3545,[313 127 187 302 483],328,5,12996,3.66497461928934,20.0,20.0
13546,1,3546,[275 300 200   7 174],455,5,13001,3.665351000845785,0.0,20.0
13547,1,3547,[216 300 202 132 271],506,4,13005,3.665445321307779,0.0,0.0
13548,1,3548,[313 127 187 302 483],537,5,13010,3.6658213581290506,20.0,20.0
13549,1,3549,[597 275 300 423 211],533,4,13014,3.6659154929577467,0.0,0.0
13550,1,3550,[  7   4 405 423 181],648,3,13017,3.665727963953816,0.0,0.0
13551,1,3551,[237 127 121 483 196],184,4,13021,3.6658220720720722,20.0,20.0
13552,1,3552,[ 71 117 194  79 286],328,4,13025,3.6659161272164367,0.0,0.0
13553,1,3553,[ 22   1 403 185 180],339,4,13029,3.6660101294316263,0.0,0.0
13554,1,3554,[603  69  64 176 258],64,3,13032,3.6658227848101266,20.0,0.0
13555,1,3555,[313 127 187 302 483],328,5,13037,3.6661979752530933,20.0,20.0
13556,1,3556,[313 127 187 302 483],328,5,13042,3.666572954737138,20.0,20.0
13557,1,3557,[175 357 210 202 100],537,3,13045,3.6663856098931986,20.0,20.0
13558,1,3558,[186  11 678 322 135],804,4,13049,3.6664793481314977,0.0,0.0
13559,1,3559,[151 483 265  28 588],82,3,13052,3.6662921348314605,20.0,0.0
13560,1,3560,[318 275 168 301 483],85,4,13056,3.666385846672283,40.0,0.0
13561,1,3561,[182 228 121 405 515],334,2,13058,3.665918023582257,0.0,0.0
13562,1,3562,[161 357 328 111 265],533,3,13061,3.6657311254560763,20.0,0.0
13563,1,3563,[655 173 127 496 125],804,4,13065,3.6658249158249157,0.0,20.0
13564,1,3564,[313 127 187 302 483],669,4,13069,3.6659186535764374,20.0,20.0
13565,1,3565,[313 127 187 302 483],13,5,13074,3.666292765002804,20.0,20.0
13566,1,3566,[ 25 235 210 187 168],210,4,13078,3.6663863190356043,0.0,0.0
13567,1,3567,[215  89 111  11 100],13,4,13082,3.666479820627803,0.0,20.0
13568,1,3568,[286 132 245 302  79],666,3,13085,3.66629307929392,0.0,0.0
13569,1,3569,[ 82 228 186 172  28],643,4,13089,3.6663865546218486,0.0,0.0
13570,1,3570,[313 127 187 302 483],90,5,13094,3.6667600112013443,20.0,20.0
13571,1,3571,[313 127 187 302 483],90,5,13099,3.6671332586786116,20.0,20.0
13572,1,3572,[313 127 187 302 483],90,5,13104,3.667506297229219,20.0,20.0
13573,1,3573,[210 182  22  64  12],288,4,13108,3.667599328483492,20.0,0.0
13574,1,3574,[234 179 273 313 168],59,4,13112,3.667692307692308,0.0,0.0
13575,1,3575,[202 210 228 111  12],533,5,13117,3.6680648769574944,20.0,0.0
13576,1,3576,[313 127 187 302 483],328,5,13122,3.6684372379088623,20.0,20.0
13577,1,3577,[ 50 195 385 173  25],378,4,13126,3.668529904974846,0.0,20.0
13578,1,3578,[202 194 496 191  69],533,5,13131,3.6689019279128248,0.0,0.0
13579,1,3579,[385 357 403 301 235],788,1,13132,3.6681564245810057,20.0,0.0
13580,1,3580,[  8 176 174 228 328],488,4,13136,3.6682490924322817,0.0,20.0
13581,1,3581,[269  96 121 175 471],7,4,13140,3.6683417085427137,0.0,0.0
13582,1,3582,[294  56  64  28 181],821,5,13145,3.668713368685459,0.0,0.0
13583,1,3583,[ 96 313  25 183 179],934,2,13147,3.668247767857143,0.0,0.0
13584,1,3584,[238 100 200 187 179],833,4,13151,3.668340306834031,0.0,20.0
13585,1,3585,[ 69 313  70 405 235],13,2,13153,3.6678750697155604,0.0,0.0
13586,1,3586,[ 25 289  69 172 496],387,1,13154,3.667131307499303,0.0,0.0
13587,1,3587,[313 127 187 302 483],537,5,13159,3.6675027870680044,20.0,20.0
13588,1,3588,[313 127 187 302 483],669,4,13163,3.6675954304820286,20.0,20.0
13589,1,3589,[313 127 187 302 483],328,5,13168,3.667966573816156,20.0,20.0
13590,1,3590,[200 197  98 265  69],543,5,13173,3.6683375104427736,0.0,20.0
13591,1,3591,[195   4 181 183 483],833,3,13176,3.66815144766147,20.0,0.0
13592,1,3592,[313 127 187 302 483],334,5,13181,3.668522126356805,20.0,20.0
13593,1,3593,[ 64  88 238 496 191],379,5,13186,3.6688925987757375,0.0,0.0
13594,1,3594,[187 385   1 515 405],804,5,13191,3.6692628650904036,0.0,0.0
13595,1,3595,[180 210 117 144 121],901,4,13195,3.6693548387096775,0.0,0.0
13596,1,3596,[195  97 385 237 508],60,4,13199,3.6694467611898807,0.0,0.0
13597,1,3597,[328  82 282 597 197],207,2,13201,3.668982768204558,0.0,0.0
13598,1,3598,[153  79 216 496 301],184,2,13203,3.66851903306474,0.0,0.0
13599,1,3599,[  9 186 195 483 204],328,3,13206,3.6683333333333334,20.0,0.0
13600,1,3600,[ 69 265 257 323 222],374,3,13209,3.6681477367397943,0.0,0.0
13601,1,3601,[196  22 127  25 161],13,4,13213,3.6682398667406995,0.0,20.0
13602,1,3602,[357 228   1 322  95],537,1,13214,3.6674993061337773,20.0,0.0
13603,1,3603,[194 265  71 748 385],313,4,13218,3.667591564927858,0.0,0.0
13604,1,3604,[318 151   1 196 357],380,5,13223,3.6679611650485437,40.0,0.0
13605,1,3605,[313 127 187 302 483],669,4,13227,3.668053244592346,20.0,20.0
13606,1,3606,[186 742 161 423  82],378,4,13231,3.668145273080122,0.0,0.0
13607,1,3607,[181 135 132 153  12],892,5,13236,3.6685144124168514,20.0,0.0
13608,1,3608,[238 153 144 118 121],378,4,13240,3.6686062621224718,0.0,0.0
13609,1,3609,[191   4 508 204  98],940,4,13244,3.668698060941828,0.0,20.0
13610,1,3610,[313 127 187 302 483],334,5,13249,3.6690667405150927,20.0,20.0
13611,1,3611,[117 151 237  69 742],334,2,13251,3.6686046511627906,0.0,0.0
13612,1,3612,[313 127 187 302 483],13,5,13256,3.6689731525048437,20.0,20.0
13613,1,3613,[313 127 187 302 483],474,5,13261,3.6693414499169896,20.0,20.0
13614,1,3614,[ 79 215 515 235   9],271,4,13265,3.669432918395574,0.0,0.0
13615,1,3615,[  4 603 194  70  11],10,5,13270,3.669800884955752,20.0,0.0
13616,1,3616,[216 135 186 174 423],385,0,13270,3.668786286978159,0.0,20.0
13617,1,3617,[ 64 546 405 185  12],524,2,13272,3.66832504145937,20.0,0.0
13618,1,3618,[483  25 294 179 237],207,4,13276,3.6684166896932853,20.0,0.0
13619,1,3619,[153 238  69 294 210],95,4,13280,3.6685082872928176,0.0,0.0
13620,1,3620,[313 427 144 173  56],934,3,13283,3.668323667495167,0.0,0.0
13621,1,3621,[323  89  11  82 269],537,1,13284,3.6675869685256766,0.0,0.0
13622,1,3622,[301 403 121 197 238],210,4,13288,3.667678719293403,0.0,0.0
13623,1,3623,[313 127 187 302 483],334,5,13293,3.668046357615894,20.0,20.0
13624,1,3624,[197 132 273 182   7],213,5,13298,3.6684137931034484,0.0,0.0
13625,1,3625,[ 15 238 125   8   1],554,2,13300,3.667953667953668,0.0,0.0
13626,1,3626,[127 234  70 143 238],479,4,13304,3.668045216432313,0.0,20.0
13627,1,3627,[313 127 187 302 483],669,4,13308,3.6681367144432193,20.0,20.0
13628,1,3628,[322 100 196  96 183],488,1,13309,3.6674014880132266,0.0,20.0
13629,1,3629,[181  70 273 405 176],13,1,13310,3.6666666666666665,0.0,0.0
13630,1,3630,[127  71 132 176 294],234,2,13312,3.6662076562930324,0.0,20.0
13631,1,3631,[121 135 111 655 742],207,2,13314,3.665748898678414,0.0,0.0
13632,1,3632,[235  70 275  50 496],378,4,13318,3.6658409028351224,0.0,20.0
13633,1,3633,[215 748 405  11 228],788,1,13319,3.6651073197578428,0.0,0.0
13634,1,3634,[117 427  11 258  12],788,3,13322,3.664924346629986,20.0,0.0
13635,1,3635,[568  11 282 181 471],207,2,13324,3.6644664466446644,0.0,0.0
13636,1,3636,[313 127 187 302 483],90,5,13329,3.664833654110531,20.0,20.0
13637,1,3637,[313 127 187 302 483],474,5,13334,3.6652006597031335,20.0,20.0
13638,1,3638,[172 179 405 204  56],87,5,13339,3.665567463588898,0.0,0.0
13639,1,3639,[ 70 151  79 132 322],804,4,13343,3.6656593406593405,0.0,0.0
13640,1,3640,[ 95 187  98 603  88],308,4,13347,3.665751167261741,20.0,20.0
13641,1,3641,[144  11 216 204 118],653,1,13348,3.6650192202086767,0.0,0.0
13642,1,3642,[196   7 238 210 515],7,4,13352,3.6651111721108975,0.0,0.0
13643,1,3643,[100 200 228 323  11],788,2,13354,3.6646542261251374,0.0,20.0
13644,1,3644,[216 245 276 202 423],378,3,13357,3.664471879286694,0.0,0.0
13645,1,3645,[313 127 187 302 483],669,4,13361,3.664563905650027,20.0,20.0
13646,1,3646,[179 200 144 191 111],13,2,13363,3.6641074856046063,0.0,0.0
13647,1,3647,[313 127 187 302 483],474,5,13368,3.664473684210526,20.0,20.0
13648,1,3648,[313 127 187 302 483],90,5,13373,3.6648396821046862,20.0,20.0
13649,1,3649,[210 357 100 196 405],840,4,13377,3.664931506849315,20.0,20.0
13650,1,3650,[172 237  97  89 195],13,4,13381,3.6650232812927963,0.0,0.0
13651,1,3651,[313 127 187 302 483],537,5,13386,3.6653888280394304,20.0,20.0
13652,1,3652,[313 127 187 302 483],474,5,13391,3.6657541746509716,20.0,20.0
13653,1,3653,[234 210 471  89 435],378,4,13395,3.6658456486042694,0.0,0.0
13654,1,3654,[210 238  79 194 195],454,3,13398,3.6656634746922023,0.0,0.0
13655,1,3655,[546 357 403 515 323],328,2,13400,3.665207877461707,20.0,0.0
13656,1,3656,[ 28 333 143 161 211],533,5,13405,3.665572873940388,0.0,0.0
13657,1,3657,[196  79 237 117   4],538,3,13408,3.665390924002187,0.0,0.0
13658,1,3658,[175 318 153 508 191],184,3,13411,3.6652090735173544,20.0,0.0
13659,1,3659,[144 195 435  88 286],60,5,13416,3.6655737704918034,0.0,0.0
13660,1,3660,[210 117  95 168 196],406,3,13419,3.6653919694072656,0.0,0.0
13661,1,3661,[427 301 300 588  64],85,2,13421,3.6649371927908247,0.0,0.0
13662,1,3662,[265 144 183 678  50],804,5,13426,3.6653016653016652,0.0,20.0
13663,1,3663,[ 15   4 273 175 403],234,1,13427,3.6645742358078603,0.0,0.0
13664,1,3664,[496 118 423 197 187],7,4,13431,3.6646657571623464,0.0,0.0
13665,1,3665,[132 471 111 435 202],271,4,13435,3.664757228587016,0.0,0.0
13666,1,3666,[118 257  69  22 385],343,2,13437,3.6643032451595308,0.0,0.0
13667,1,3667,[313 127 187 302 483],334,5,13442,3.6646673936750274,20.0,20.0
13668,1,3668,[313 127 187 302 483],90,5,13447,3.6650313436903788,20.0,20.0
13669,1,3669,[ 79 175 182 288 238],339,4,13451,3.665122615803815,0.0,0.0
13670,1,3670,[313 127 187 302 483],334,5,13456,3.6654862435303732,20.0,20.0
13671,1,3671,[313 127 187 302 483],474,5,13461,3.6658496732026142,20.0,20.0
13672,1,3672,[313 127 187 302 483],328,5,13466,3.666212904982303,20.0,20.0
13673,1,3673,[313 127 187 302 483],474,5,13471,3.666575939031029,20.0,20.0
13674,1,3674,[300 168 153 228 288],7,5,13476,3.666938775510204,0.0,0.0
13675,1,3675,[173 215 318 182 111],378,4,13480,3.6670293797606095,20.0,0.0
13676,1,3676,[313 127 187 302 483],207,5,13485,3.667391895567038,20.0,20.0
13677,1,3677,[568 655  96 200  50],795,0,13485,3.666394779771615,0.0,20.0
13678,1,3678,[ 82 483 132 187 215],537,2,13487,3.6659418320195707,20.0,0.0
13679,1,3679,[313 127 187 302 483],13,5,13492,3.666304347826087,20.0,20.0
13680,1,3680,[ 28 118 742 496 234],308,1,13493,3.665580005433306,0.0,0.0
13681,1,3681,[313 127 187 302 483],90,5,13498,3.665942422596415,20.0,20.0
13682,1,3682,[273 403   9  70  88],87,3,13501,3.6657616073852837,0.0,0.0
13683,1,3683,[ 69 179 483 187 678],648,2,13503,3.6653094462540716,20.0,0.0
13684,1,3684,[143 181  56 405 318],334,3,13506,3.6651289009497963,20.0,0.0
13685,1,3685,[588 403 182  95 742],650,0,13506,3.664134563212154,0.0,0.0
13686,1,3686,[ 15 215 195 187  50],650,2,13508,3.6636832112828857,0.0,20.0
13687,1,3687,[173 172  28 286 546],479,3,13511,3.6635032537960956,0.0,0.0
13688,1,3688,[179   7 151 187   9],59,5,13516,3.6638655462184873,0.0,0.0
13689,1,3689,[215 275 333 257 125],298,3,13519,3.6636856368563686,0.0,0.0
13690,1,3690,[ 95  22  28 235 483],125,4,13523,3.6637767542671362,20.0,0.0
13691,1,3691,[313 127 187 302 483],474,5,13528,3.664138678223185,20.0,20.0
13692,1,3692,[742 234 182 322 187],488,2,13530,3.6636880584890332,0.0,0.0
13693,1,3693,[302  28 282  70 275],334,3,13533,3.663508391987006,0.0,0.0
13694,1,3694,[135 328  70 132  98],13,3,13536,3.6633288227334235,0.0,20.0
13695,1,3695,[313 127 187 302 483],13,5,13541,3.6636904761904763,20.0,20.0
13696,1,3696,[313 127 187 302 483],13,5,13546,3.664051934000541,20.0,20.0
13697,1,3697,[200 748 269 471 427],13,2,13548,3.6636019469983774,0.0,0.0
13698,1,3698,[313  50 210 111 268],334,3,13551,3.6634225466342256,0.0,20.0
13699,1,3699,[742 100  70 323 121],881,3,13554,3.6632432432432434,0.0,20.0
13700,1,3700,[288   4 471 174 210],648,4,13558,3.6633342339908133,0.0,20.0
13701,1,3701,[196 174  69 173  56],454,2,13560,3.6628849270664507,0.0,20.0
13702,1,3702,[191 357 435  96 286],648,3,13563,3.6627059141236833,20.0,0.0
13703,1,3703,[313 127 187 302 483],90,5,13568,3.6630669546436283,20.0,20.0
13704,1,3704,[ 89 197  79 508 135],543,5,13573,3.6634278002699054,0.0,0.0
13705,1,3705,[ 28 333 132 191 173],506,5,13578,3.6637884511602805,0.0,0.0
13706,1,3706,[ 89 151 172  69   1],881,3,13581,3.6636093876449958,0.0,0.0
13707,1,3707,[313 127 187 302 483],13,5,13586,3.6639697950377563,20.0,20.0
13708,1,3708,[313 127 187 302 483],13,5,13591,3.6643300080884336,20.0,20.0
13709,1,3709,[313 127 187 302 483],90,5,13596,3.664690026954178,20.0,20.0
13710,1,3710,[185 186 181 127  71],234,1,13597,3.6639719752088387,0.0,20.0
13711,1,3711,[222 265 357 183 216],311,5,13602,3.664331896551724,20.0,0.0
13712,1,3712,[483 238 210 175  12],272,5,13607,3.6646916240237006,40.0,0.0
13713,1,3713,[282 269 300 323  50],119,4,13611,3.6647819063004845,0.0,20.0
13714,1,3714,[ 15 181 288  11  88],234,0,13611,3.6637954239569313,0.0,0.0
13715,1,3715,[313 127 187 302 483],13,5,13616,3.6641550053821312,20.0,20.0
13716,1,3716,[313 127 187 302 483],90,5,13621,3.6645143933279525,20.0,20.0
13717,1,3717,[313 127 187 302 483],328,5,13626,3.664873587950511,20.0,20.0
13718,1,3718,[  9  79 286 118 191],378,5,13631,3.665232589405754,0.0,0.0
13719,1,3719,[ 28 153  82 508 180],387,5,13636,3.6655913978494623,0.0,0.0
13720,1,3720,[ 96 127  79 301 194],537,1,13637,3.66487503359312,0.0,20.0
13721,1,3721,[  9 191 265 496 597],59,4,13641,3.6649650725416443,0.0,0.0
13722,1,3722,[300 191 143  82 173],843,0,13641,3.6639806607574537,0.0,0.0
13723,1,3723,[ 82 294 496 435 144],308,2,13643,3.6635338345864663,0.0,0.0
13724,1,3724,[282 288 357 176 197],643,4,13647,3.6636241610738254,20.0,0.0
13725,1,3725,[273 174 172 282 508],92,5,13652,3.663982823403113,0.0,20.0
13726,1,3726,[427 196  15 202 195],42,5,13657,3.6643412932653607,0.0,0.0
13727,1,3727,[191  96  98  82 568],524,4,13661,3.664431330472103,0.0,20.0
13728,1,3728,[313 127 187 302 483],90,5,13666,3.6647894877983376,20.0,20.0
13729,1,3729,[313 127 187 302 483],13,5,13671,3.66514745308311,20.0,20.0
13730,1,3730,[313 127 187 302 483],207,5,13676,3.6655052264808363,20.0,20.0
13731,1,3731,[ 96 185 194 168  56],840,3,13679,3.665326902465166,0.0,0.0
13732,1,3732,[313 127 187 302 483],90,5,13684,3.665684436110367,20.0,20.0
13733,1,3733,[302  95 288  11 385],102,1,13685,3.664970540974826,0.0,0.0
13734,1,3734,[313 127 187 302 483],90,5,13690,3.6653279785809905,20.0,20.0
13735,1,3735,[ 82 186 143  50 127],95,4,13694,3.6654175588865097,0.0,40.0
13736,1,3736,[313 127 187 302 483],13,5,13699,3.665774685576666,20.0,20.0
13737,1,3737,[258 216 276 655 100],378,5,13704,3.666131621187801,0.0,20.0
13738,1,3738,[427  71 172 144 238],234,1,13705,3.665418561112597,0.0,0.0
13739,1,3739,[276 257 216  28 197],378,4,13709,3.6655080213903743,0.0,0.0
13740,1,3740,[313 127 187 302 483],537,5,13714,3.6658647420475807,20.0,20.0
13741,1,3741,[135 235 496 118 210],897,3,13717,3.665686798503474,0.0,0.0
13742,1,3742,[183   4  71 175 176],378,4,13721,3.6657761154154422,0.0,0.0
13743,1,3743,[333 271 742  22 187],334,3,13724,3.6655982905982905,0.0,0.0
13744,1,3744,[328 294 742  71  64],804,5,13729,3.665954606141522,0.0,0.0
13745,1,3745,[313 127 187 302 483],328,5,13734,3.6663107314468766,20.0,20.0
13746,1,3746,[313 127 187 302 483],474,5,13739,3.6666666666666665,20.0,20.0
13747,1,3747,[302 121  56 423  70],934,3,13742,3.666488794023479,0.0,0.0
13748,1,3748,[273 144 258 597 435],144,5,13747,3.6668444918644973,0.0,0.0
13749,1,3749,[313 127 187 302 483],90,5,13752,3.6672,20.0,20.0
13750,1,3750,[357 183 215 597 187],653,3,13755,3.6670221274326846,20.0,0.0
13751,1,3751,[508 181  69 180 276],59,5,13760,3.6673773987206824,0.0,0.0
13752,1,3752,[  7 173  82  50 118],840,3,13763,3.667199573674394,0.0,20.0
13753,1,3753,[100 405 515 403 423],774,0,13763,3.666222695791156,0.0,20.0
13754,1,3754,[ 50 191 151  71 180],378,3,13766,3.666045272969374,0.0,20.0
13755,1,3755,[427  11 257 100 204],374,3,13769,3.6658679446219384,0.0,20.0
13756,1,3756,[546  50  70 286 117],447,2,13771,3.665424540857067,0.0,20.0
13757,1,3757,[172  50 237 182 515],326,3,13774,3.665247472059606,0.0,20.0
13758,1,3758,[313 127 187 302 483],207,5,13779,3.6656025538707104,20.0,20.0
13759,1,3759,[144  50 323   1 176],290,3,13782,3.6654255319148934,0.0,20.0
13760,1,3760,[282 127 100 187 435],144,5,13787,3.6657803775591598,0.0,40.0
13761,1,3761,[191 176 182 202 210],499,3,13790,3.6656034024455075,0.0,0.0
13762,1,3762,[313 127 187 302 483],90,5,13795,3.665958012224289,20.0,20.0
13763,1,3763,[313 127 187 302 483],328,5,13800,3.6663124335812967,20.0,20.0
13764,1,3764,[132 191   9 172 173],554,4,13804,3.6664010624169987,0.0,0.0
13765,1,3765,[313 127 187 302 483],90,5,13809,3.666755177907594,20.0,20.0
13766,1,3766,[135   9 286 144 195],379,4,13813,3.6668436421555612,0.0,0.0
13767,1,3767,[435 194 181 294 168],901,4,13817,3.666932059447983,0.0,0.0
13768,1,3768,[405 173 300 135   4],13,2,13819,3.666489785088883,0.0,0.0
13769,1,3769,[313 127 187 302 483],669,4,13823,3.66657824933687,20.0,20.0
13770,1,3770,[ 95 322 183 100  15],308,3,13826,3.6664014850172366,0.0,20.0
13771,1,3771,[ 69 318 323 197 210],488,3,13829,3.666224814422057,20.0,0.0
13772,1,3772,[191 197 302 179 273],13,2,13831,3.6657831963954415,0.0,0.0
13773,1,3773,[313 127 187 302 483],207,5,13836,3.6661367249602543,20.0,20.0
13774,1,3774,[ 50 143  70 496 405],533,4,13840,3.666225165562914,0.0,20.0
13775,1,3775,[282 275 222 742  88],378,4,13844,3.6663135593220337,0.0,0.0
13776,1,3776,[313 127 187 302 483],207,5,13849,3.6666666666666665,20.0,20.0
13777,1,3777,[313 127 187 302 483],13,5,13854,3.6670195870831126,20.0,20.0
13778,1,3778,[313 127 187 302 483],474,5,13859,3.667372320719767,20.0,20.0
13779,1,3779,[318 300 182 742  22],334,2,13861,3.666931216931217,20.0,0.0
13780,1,3780,[121 174 194 196 210],207,3,13864,3.666754826765406,0.0,20.0
13781,1,3781,[121 172 603 186  88],749,4,13868,3.6668429402432574,20.0,0.0
13782,1,3782,[153  22  79 235 175],833,2,13870,3.6664023261961405,0.0,0.0
13783,1,3783,[546 143 173 234 328],13,1,13871,3.6656976744186047,0.0,0.0
13784,1,3784,[121  22  96 313 181],455,5,13876,3.6660501981505944,0.0,0.0
13785,1,3785,[ 25  11 197 127  82],537,2,13878,3.665610142630745,0.0,20.0
13786,1,3786,[313 127 187 302 483],328,5,13883,3.665962503300766,20.0,20.0
13787,1,3787,[313 127 187 302 483],328,5,13888,3.6663146779303064,20.0,20.0
13788,1,3788,[313 294 135 175 597],378,2,13890,3.6658749010292953,0.0,0.0
13789,1,3789,[318 215 237 588 174],892,5,13895,3.6662269129287597,20.0,20.0
13790,1,3790,[ 70 405  98 191   4],13,2,13897,3.6657873911896597,0.0,20.0
13791,1,3791,[313 127 187 302 483],328,5,13902,3.6661392405063293,20.0,20.0
13792,1,3792,[235 185  82 181 742],313,2,13904,3.6656999736356446,0.0,0.0
13793,1,3793,[748 151 265 496 200],479,3,13907,3.665524512387981,0.0,0.0
13794,1,3794,[194 153  89 144   8],13,5,13912,3.6658761528326744,0.0,0.0
13795,1,3795,[195 423 168 222  64],311,5,13917,3.66622760800843,0.0,0.0
13796,1,3796,[195 132 357 288 135],13,2,13919,3.665788780616276,20.0,0.0
13797,1,3797,[ 98 234 515 323 210],650,3,13922,3.6656134807793577,0.0,20.0
13798,1,3798,[  7 568 742 151 328],788,2,13924,3.665175046064754,0.0,0.0
13799,1,3799,[275  28 588 127 174],95,3,13927,3.665,0.0,40.0
13800,1,3800,[238  64 265 200  89],234,2,13929,3.664561957379637,0.0,0.0
13801,1,3801,[435 182   8 508 318],207,3,13932,3.664387164650184,20.0,0.0
13802,1,3802,[313 127 187 302 483],334,5,13937,3.664738364449119,20.0,20.0
13803,1,3803,[ 28 318 508 228 286],334,3,13940,3.664563617245005,20.0,0.0
13804,1,3804,[216 228 143   8   1],234,1,13941,3.663863337713535,0.0,0.0
13805,1,3805,[ 89 234  69  28 195],7,5,13946,3.6642143983184448,0.0,0.0
13806,1,3806,[313 127 187 302 483],537,5,13951,3.6645652744943527,20.0,20.0
13807,1,3807,[121 268   9 111  97],13,4,13955,3.664653361344538,0.0,0.0
13808,1,3808,[ 88 127   1 210 202],533,5,13960,3.6650039380414805,0.0,20.0
13809,1,3809,[313 127 187 302 483],537,5,13965,3.6653543307086616,20.0,20.0
13810,1,3810,[313 127 187 302 483],13,5,13970,3.6657045394909473,20.0,20.0
13811,1,3811,[168 172  22 234   8],474,4,13974,3.665792235047219,0.0,0.0
13812,1,3812,[ 79 121 237 228 161],455,4,13978,3.665879884605298,0.0,0.0
13813,1,3813,[191 222 200 515  89],311,5,13983,3.666229680125852,0.0,0.0
13814,1,3814,[313 127 187 302 483],669,4,13987,3.6663171690694627,20.0,20.0
13815,1,3815,[603 568 322 276 161],533,4,13991,3.666404612159329,20.0,0.0
13816,1,3816,[ 79  96 546  71   4],804,4,13995,3.6664920094314906,0.0,0.0
13817,1,3817,[181 196   4 294 195],346,3,13998,3.6663174436877948,0.0,0.0
13818,1,3818,[ 88 125 183 204 210],295,4,14002,3.666404818015187,0.0,0.0
13819,1,3819,[ 22  98 211  70  71],454,2,14004,3.6659685863874345,0.0,20.0
13820,1,3820,[313 127 187 302 483],537,5,14009,3.666317717874902,20.0,20.0
13821,1,3821,[385 238 183   8 153],95,5,14014,3.6666666666666665,0.0,0.0
13822,1,3822,[187 357 405 180 174],144,5,14019,3.6670154329060947,20.0,20.0
13823,1,3823,[135 546 117 132 245],313,4,14023,3.6671025104602513,0.0,0.0
13824,1,3824,[403 151 405 222 125],653,0,14023,3.6661437908496732,0.0,0.0
13825,1,3825,[  7  79 216 118 238],378,4,14027,3.6662310507056977,0.0,0.0
13826,1,3826,[ 69 125  89 275 435],899,2,14029,3.6657956623987458,0.0,0.0
13827,1,3827,[197 194 276   1 655],339,5,14034,3.666144200626959,0.0,0.0
13828,1,3828,[ 88 508 179 568 276],13,2,14036,3.665709062418386,0.0,0.0
13829,1,3829,[234  28 318 300 435],85,4,14040,3.6657963446475197,20.0,0.0
13830,1,3830,[ 50 235 475 197 357],537,4,14044,3.665883581310363,20.0,20.0
13831,1,3831,[202 175 183 204 172],815,4,14048,3.6659707724425887,0.0,0.0
13832,1,3832,[313 127 187 302 483],669,4,14052,3.666057918079833,20.0,20.0
13833,1,3833,[313 127 187 302 483],474,5,14057,3.6664058424621806,20.0,20.0
13834,1,3834,[ 12  25 168  56 183],537,2,14059,3.6659713168187746,20.0,0.0
13835,1,3835,[182 202 235 196 135],650,2,14061,3.6655370177267987,0.0,0.0
13836,1,3836,[173 151 294 118 204],213,4,14065,3.6656241855616365,0.0,0.0
13837,1,3837,[143 191 194 132 197],881,2,14067,3.6651902032308494,0.0,0.0
13838,1,3838,[515 174 258 435 294],271,3,14070,3.665016931492576,0.0,20.0
13839,1,3839,[313 127 187 302 483],669,4,14074,3.6651041666666666,20.0,20.0
13840,1,3840,[118 216 423  79 202],308,3,14077,3.664931007550117,0.0,0.0
13841,1,3841,[ 88  25  82 238 282],95,3,14080,3.6647579385736595,0.0,0.0
13842,1,3842,[172 153  82 546 211],650,3,14083,3.664584959666927,0.0,0.0
13843,1,3843,[313 127 187 302 483],328,5,14088,3.664932362122789,20.0,20.0
13844,1,3844,[234 195 132 118 222],454,2,14090,3.6644993498049416,0.0,0.0
13845,1,3845,[176 195 175 328 210],102,2,14092,3.6640665626625064,0.0,0.0
13846,1,3846,[183 328 275 121 588],95,3,14095,3.6638939433324667,0.0,0.0
13847,1,3847,[173  11  28 235 237],59,3,14098,3.663721413721414,0.0,0.0
13848,1,3848,[496 100 423  89 234],311,4,14102,3.6638087815016886,0.0,20.0
13849,1,3849,[313 127 187 302 483],90,5,14107,3.664155844155844,20.0,20.0
13850,1,3850,[228 568 265 196 245],92,4,14111,3.6642430537522723,0.0,0.0
13851,1,3851,[182  25 196 210 655],59,5,14116,3.664589823468328,0.0,0.0
13852,1,3852,[ 28 742 195   4 257],653,2,14118,3.6641577991175707,0.0,0.0
13853,1,3853,[182 111  12 204 132],334,2,14120,3.6637259989621174,20.0,0.0
13854,1,3854,[313 127 187 302 483],328,5,14125,3.664072632944228,20.0,20.0
13855,1,3855,[ 15 496  97 161 210],42,4,14129,3.6641597510373445,0.0,0.0
13856,1,3856,[182 172 168  56  89],686,5,14134,3.6645060928182525,0.0,0.0
13857,1,3857,[200 294 186 286 144],10,4,14138,3.6645930533955418,0.0,0.0
13858,1,3858,[313 127 187 302 483],328,5,14143,3.6649391033946617,20.0,20.0
13859,1,3859,[258 132 313 271 276],13,4,14147,3.6650259067357513,0.0,0.0
13860,1,3860,[179  50 228 200 471],479,4,14151,3.665112665112665,0.0,20.0
13861,1,3861,[200 183 172 222  69],313,3,14154,3.664940445365096,0.0,0.0
13862,1,3862,[313 127 187 302 483],537,5,14159,3.6652860471136424,20.0,20.0
13863,1,3863,[ 64  96  71 228 483],374,4,14163,3.665372670807453,20.0,0.0
13864,1,3864,[ 95 216 132  82  11],537,0,14163,3.6644243208279432,0.0,0.0
13865,1,3865,[313 127 187 302 483],328,5,14168,3.6647697878944645,20.0,20.0
13866,1,3866,[405 288  82 742 328],554,3,14171,3.6645978794931473,0.0,0.0
13867,1,3867,[603 117 286 204 300],13,2,14173,3.6641675284384694,20.0,0.0
13868,1,3868,[175 568 179  96 423],659,4,14177,3.6642543292840526,0.0,0.0
13869,1,3869,[322 173 546  11 435],234,0,14177,3.6633074935400516,0.0,0.0
13870,1,3870,[313 127 187 302 483],328,5,14182,3.663652802893309,20.0,20.0
13871,1,3871,[100 300   8 318 187],64,4,14186,3.6637396694214877,20.0,20.0
13872,1,3872,[180 333 172 313 117],13,3,14189,3.6635682933126774,0.0,0.0
13873,1,3873,[483  89 183 234 118],328,4,14193,3.663655136809499,20.0,0.0
13874,1,3874,[176  79 127 273 257],479,5,14198,3.664,0.0,20.0
13875,1,3875,[195 228 216  82  22],326,3,14201,3.6638286893704852,0.0,0.0
13876,1,3876,[294 423 215   4 118],788,1,14202,3.6631416043332474,0.0,0.0
13877,1,3877,[121  98 168 265 181],474,4,14206,3.66322846828262,0.0,20.0
13878,1,3878,[ 82 258 271 176 435],788,2,14208,3.662799690641918,0.0,0.0
13879,1,3879,[ 95  98 597 172 655],308,3,14211,3.6626288659793813,0.0,20.0
13880,1,3880,[313 127 187 302 483],669,4,14215,3.6627157948982223,20.0,20.0
13881,1,3881,[204  64 168  11 121],881,4,14219,3.662802679031427,0.0,0.0
13882,1,3882,[313 127 187 302 483],13,5,14224,3.6631470512490343,20.0,20.0
13883,1,3883,[179 276 135  22 211],343,5,14229,3.663491246138002,0.0,0.0
13884,1,3884,[151 118 568 174 405],524,3,14232,3.6633204633204635,0.0,20.0
13885,1,3885,[ 69  11 748  56 194],207,3,14235,3.6631497683993826,0.0,0.0
13886,1,3886,[313 127 187 302 483],90,5,14240,3.663493696938513,20.0,20.0
13887,1,3887,[182 257 210 135 168],840,3,14243,3.66332304526749,0.0,0.0
13888,1,3888,[237 143  97 121 168],653,1,14244,3.6626382103368473,0.0,0.0
13889,1,3889,[313 127 187 302 483],328,5,14249,3.662982005141388,20.0,20.0
13890,1,3890,[313 127 187 302 483],334,5,14254,3.663325623233102,20.0,20.0
13891,1,3891,[597 294  88 151  69],374,2,14256,3.6628982528263103,0.0,0.0
13892,1,3892,[286 132 269  12 181],537,0,14256,3.661957359362959,20.0,0.0
13893,1,3893,[313 127 187 302 483],334,5,14261,3.662300975860298,20.0,20.0
13894,1,3894,[168  28 216 237 238],271,4,14265,3.662387676508344,0.0,0.0
13895,1,3895,[269 357 258 185  96],659,5,14270,3.6627310061601643,20.0,0.0
13896,1,3896,[ 56  82 176  96 318],59,5,14275,3.6630741596099563,20.0,0.0
13897,1,3897,[  8 265 515 168 187],308,3,14278,3.662904053360698,0.0,0.0
13898,1,3898,[ 69 300 100  96  28],537,1,14279,3.662221082328802,0.0,20.0
13899,1,3899,[313 127 187 302 483],207,5,14284,3.6625641025641027,20.0,20.0
13900,1,3900,[174 111 508 435 202],6,2,14286,3.66213791335555,0.0,20.0
13901,1,3901,[ 89 423 568 597 216],59,4,14290,3.6622245002562788,0.0,0.0
13902,1,3902,[ 50 427  98 265 195],379,4,14294,3.662311042787599,0.0,40.0
13903,1,3903,[118  89 333 194  22],881,4,14298,3.6623975409836067,0.0,0.0
13904,1,3904,[471 300 237  50   9],328,4,14302,3.662483994878361,0.0,20.0
13905,1,3905,[125 322 288 258 132],234,1,14303,3.6618023553507424,0.0,0.0
13906,1,3906,[183 211 269  88 313],13,4,14307,3.661888917327873,0.0,0.0
13907,1,3907,[200 286  64  70 385],234,2,14309,3.6614636642784033,0.0,0.0
13908,1,3908,[ 28 435   1 385 357],533,4,14313,3.661550268610898,20.0,0.0
13909,1,3909,[ 56 403  79  95  82],308,5,14318,3.6618925831202045,0.0,0.0
13910,1,3910,[ 82  98 508 161 245],455,4,14322,3.6619790334952698,0.0,20.0
13911,1,3911,[186  70  95 200  79],378,3,14325,3.66180981595092,0.0,0.0
13912,1,3912,[313 127 187 302 483],474,5,14330,3.662151801686685,20.0,20.0
13913,1,3913,[313 127 187 302 483],474,5,14335,3.6624936126724577,20.0,20.0
13914,1,3914,[  7 568 294  98 318],308,3,14338,3.662324393358876,20.0,20.0
13915,1,3915,[181 175 318  82 435],64,4,14342,3.6624106230847806,20.0,0.0
13916,1,3916,[ 22 174 194 211 276],82,4,14346,3.6624968087822314,0.0,20.0
13917,1,3917,[ 22 403 179 294 153],378,3,14349,3.6623277182235836,0.0,0.0
13918,1,3918,[202 151 117 172  96],899,4,14353,3.662413881092115,0.0,0.0
13919,1,3919,[313 127 187 302 483],334,5,14358,3.6627551020408164,20.0,20.0
13920,1,3920,[385 125  97 197 357],194,2,14360,3.66233103800051,20.0,0.0
13921,1,3921,[174 117  82 196 202],200,5,14365,3.6626721060683325,0.0,20.0
13922,1,3922,[276 176 181 191 143],234,1,14366,3.661993372419067,0.0,0.0
13923,1,3923,[ 95   7 210 286  71],650,1,14367,3.66131498470948,0.0,0.0
13924,1,3924,[216 135 125  95  82],313,2,14369,3.660891719745223,0.0,0.0
13925,1,3925,[100 180 588  25 211],650,2,14371,3.6604686704024454,0.0,20.0
13926,1,3926,[200 197 288 475 238],13,1,14372,3.659791189202954,0.0,0.0
13927,1,3927,[  9 204 151 655  89],406,3,14375,3.659623217922607,0.0,0.0
13928,1,3928,[191  28 176 127 179],766,4,14379,3.6597098498345635,0.0,20.0
13929,1,3929,[ 50  15 132 276  79],194,1,14380,3.659033078880407,0.0,20.0
13930,1,3930,[ 25 357 288  28  12],474,4,14384,3.659119816840499,40.0,0.0
13931,1,3931,[294 588  98  97 197],537,1,14385,3.658443540183113,0.0,20.0
13932,1,3932,[313 127 187 302 483],207,5,14390,3.658784642766336,20.0,20.0
13933,1,3933,[265 197 405 238 135],488,2,14392,3.6583629893238436,0.0,0.0
13934,1,3934,[313 127 187 302 483],334,5,14397,3.6587039390088947,20.0,20.0
13935,1,3935,[ 97 121 186 435 182],650,2,14399,3.658282520325203,0.0,0.0
13936,1,3936,[132 288 121 471 427],882,4,14403,3.6583693167386335,0.0,0.0
13937,1,3937,[300 174 475 294 111],605,1,14404,3.6576942610462164,0.0,20.0
13938,1,3938,[313 127 187 302 483],474,5,14409,3.658035034272658,20.0,20.0
13939,1,3939,[403 235 202 204 483],13,3,14412,3.6578680203045684,20.0,0.0
13940,1,3940,[302 273 282   9 204],328,2,14414,3.6574473483887338,0.0,0.0
13941,1,3941,[313 127 187 302 483],474,5,14419,3.6577879249112124,20.0,20.0
13942,1,3942,[197 121 403 216 176],311,5,14424,3.6581283286837434,0.0,0.0
13943,1,3943,[183 175 161 196   1],42,4,14428,3.658215010141988,0.0,0.0
13944,1,3944,[174 180  88 175 483],892,5,14433,3.658555133079848,20.0,20.0
13945,1,3945,[313 127 187 302 483],328,5,14438,3.6588950836289915,20.0,20.0
13946,1,3946,[313 127 187 302 483],537,5,14443,3.659234861920446,20.0,20.0
13947,1,3947,[475   9 168 151 237],6,3,14446,3.659067882472138,0.0,0.0
13948,1,3948,[ 97 546 143   7 117],339,4,14450,3.6591542162572805,0.0,0.0
13949,1,3949,[ 69 132 135 125  50],92,4,14454,3.659240506329114,0.0,20.0
13950,1,3950,[228 179 197 496 100],311,3,14457,3.659073652239939,0.0,20.0
13951,1,3951,[196   8 302 161  50],334,4,14461,3.65915991902834,0.0,20.0
13952,1,3952,[216 748 302 313  97],474,4,14465,3.6592461421705034,0.0,0.0
13953,1,3953,[186 151 144 275   8],64,3,14468,3.6590794132524027,0.0,0.0
13954,1,3954,[288  56 435 302 197],833,1,14469,3.6584070796460177,0.0,0.0
13955,1,3955,[313 127 187 302 483],90,5,14474,3.6587462082912032,20.0,20.0
13956,1,3956,[496 172 273 300 181],7,3,14477,3.6585797321202933,0.0,0.0
13957,1,3957,[302 182 194 333 172],537,2,14479,3.6581606872157657,0.0,0.0
13958,1,3958,[275   8 100 174 196],311,4,14483,3.658247032078808,0.0,40.0
13959,1,3959,[237  50 471 197 151],234,2,14485,3.657828282828283,0.0,20.0
13960,1,3960,[  4 117 222  96 153],749,4,14489,3.657914668013128,0.0,0.0
13961,1,3961,[273 678 172  56 161],387,3,14492,3.657748611812216,0.0,0.0
13962,1,3962,[185 385 173  22  28],474,5,14497,3.658087307595256,0.0,0.0
13963,1,3963,[655 196 132 183  70],234,2,14499,3.6576690211907166,0.0,0.0
13964,1,3964,[748 168 268 100 300],13,4,14503,3.6577553593947036,0.0,20.0
13965,1,3965,[ 97 151 269 258 121],7,4,14507,3.657841654059506,0.0,0.0
13966,1,3966,[385 288 173  69  95],387,1,14508,3.657171666246534,0.0,0.0
13967,1,3967,[313 127 187 302 483],13,5,14513,3.6575100806451615,20.0,20.0
13968,1,3968,[405 597 179 204  70],95,2,14515,3.6570924666162763,0.0,0.0
13969,1,3969,[234  69 100 515 186],234,4,14519,3.6571788413098236,0.0,20.0
13970,1,3970,[111 181 282 257 135],533,4,14523,3.6572651725006295,0.0,0.0
13971,1,3971,[405 597 655 204  79],13,2,14525,3.656847935548842,0.0,0.0
13972,1,3972,[ 64 568 168 655 276],119,4,14529,3.656934306569343,0.0,0.0
13973,1,3973,[194 483  98 515 118],213,5,14534,3.6572722697533973,20.0,20.0
13974,1,3974,[322 185 151 179 357],234,1,14535,3.6566037735849055,20.0,0.0
13975,1,3975,[313 127 187 302 483],328,5,14540,3.6569416498993963,20.0,20.0
13976,1,3976,[313 127 187 302 483],474,5,14545,3.6572793562987176,20.0,20.0
13977,1,3977,[204  88 471 323 176],13,2,14547,3.656862745098039,0.0,0.0
13978,1,3978,[135 403 175  69 121],13,4,14551,3.6569489821563206,0.0,0.0
13979,1,3979,[210  69 568  64 423],454,5,14556,3.657286432160804,0.0,0.0
13980,1,3980,[ 12 172 196 204 186],506,5,14561,3.6576237126350164,20.0,0.0
13981,1,3981,[258 135  64 286 269],343,5,14566,3.65796082370668,0.0,0.0
13982,1,3982,[  1 135 202  50 322],234,2,14568,3.6575445643986946,0.0,20.0
13983,1,3983,[313 127 187 302 483],474,5,14573,3.6578815261044175,20.0,20.0
13984,1,3984,[313 127 187 302 483],328,5,14578,3.6582183186951065,20.0,20.0
13985,1,3985,[313 127 187 302 483],13,5,14583,3.6585549422980432,20.0,20.0
13986,1,3986,[322  28 200 211  88],234,2,14585,3.6581389515926763,0.0,0.0
13987,1,3987,[275  56 197 289 302],883,5,14590,3.6584754262788364,0.0,0.0
13988,1,3988,[313 127 187 302 483],474,5,14595,3.6588117322637252,20.0,20.0
13989,1,3989,[313 127 187 302 483],334,5,14600,3.6591478696741855,20.0,20.0
13990,1,3990,[  7  88  64 678 216],13,2,14602,3.658732147331496,0.0,0.0
13991,1,3991,[174 385 427 423 117],537,1,14603,3.658066132264529,0.0,20.0
13992,1,3992,[313 127 187 302 483],474,5,14608,3.6584022038567494,20.0,20.0
13993,1,3993,[496   9 385  97 204],87,5,14613,3.658738107160741,0.0,0.0
13994,1,3994,[313 127 187 302 483],537,5,14618,3.659073842302879,20.0,20.0
13995,1,3995,[313 127 187 302 483],13,5,14623,3.6594094094094096,20.0,20.0
13996,1,3996,[597 655 143 194 182],378,4,14627,3.659494620965724,0.0,0.0
13997,1,3997,[313 127 187 302 483],207,5,14632,3.659829914957479,20.0,20.0
13998,1,3998,[181 173 275  15 588],454,0,14632,3.6589147286821704,0.0,0.0
13999,1,3999,[121  15 191 200 235],378,4,14636,3.659,0.0,0.0
14000,1,4000,[191 546 151 121 300],313,4,14640,3.6590852286928266,0.0,0.0
14001,1,4001,[ 15 180 202 204 228],881,3,14643,3.658920539730135,0.0,0.0
14002,1,4002,[ 69 118 496 257  98],666,2,14645,3.658506120409693,0.0,20.0
14003,1,4003,[496 174 427 175 179],537,4,14649,3.6585914085914086,0.0,20.0
14004,1,4004,[313 127 187 302 483],537,5,14654,3.6589263420724096,20.0,20.0
14005,1,4005,[215  88 118 216 435],194,1,14655,3.658262606090864,0.0,0.0
14006,1,4006,[194 273 603   8 423],234,4,14659,3.6583478911904166,20.0,0.0
14007,1,4007,[385  82 132  98 187],13,3,14662,3.6581836327345307,0.0,20.0
14008,1,4008,[135 423  28 269 313],378,4,14666,3.6582688949862807,0.0,0.0
14009,1,4009,[  4 568 257 202 435],210,5,14671,3.6586034912718204,0.0,0.0
14010,1,4010,[ 69 282 204 235 318],92,3,14674,3.6584392919471456,20.0,0.0
14011,1,4011,[313 127 187 302 483],334,5,14679,3.6587736789631107,20.0,20.0
14012,1,4012,[313 127 187 302 483],207,5,14684,3.6591078993271866,20.0,20.0
14013,1,4013,[ 28 176 748 288 235],804,4,14688,3.6591928251121075,0.0,0.0
14014,1,4014,[318   9 185 135 216],82,3,14691,3.6590286425902865,20.0,0.0
14015,1,4015,[313 127 187 302 483],90,5,14696,3.6593625498007967,20.0,20.0
14016,1,4016,[196 191  64  15 216],474,5,14701,3.659696290764252,0.0,0.0
14017,1,4017,[173 194 385 405 271],102,0,14701,3.6587854654056744,0.0,0.0
14018,1,4018,[313 127 187 302 483],669,4,14705,3.6588703657626276,20.0,20.0
14019,1,4019,[185 273 118 143 568],374,3,14708,3.6587064676616916,0.0,0.0
14020,1,4020,[ 96  25 471 257 100],474,3,14711,3.6585426510818206,0.0,20.0
14021,1,4021,[427 357 174 194 228],788,2,14713,3.658130283441074,20.0,20.0
14022,1,4022,[200 483 515 132 265],313,4,14717,3.658215262242108,20.0,0.0
14023,1,4023,[496  88 185  96 135],95,3,14720,3.658051689860835,0.0,0.0
14024,1,4024,[234 294 405 186 187],328,4,14724,3.658136645962733,0.0,0.0
14025,1,4025,[197 100 153   1 183],932,5,14729,3.658469945355191,0.0,20.0
14026,1,4026,[181 288  79 179 117],458,3,14732,3.658306431586789,0.0,0.0
14027,1,4027,[237  64 195 333 322],313,3,14735,3.658142999006951,0.0,0.0
14028,1,4028,[313 127 187 302 483],669,4,14739,3.6582278481012658,20.0,20.0
14029,1,4029,[ 79 328 172 194  71],13,3,14742,3.6580645161290324,0.0,0.0
14030,1,4030,[435 546 204  98 211],102,2,14744,3.6576531877945917,0.0,20.0
14031,1,4031,[313 127 187 302 483],207,5,14749,3.657986111111111,20.0,20.0
14032,1,4032,[100 748 276 282 508],26,3,14752,3.6578229605752544,0.0,20.0
14033,1,4033,[ 98  11 186  69 151],295,5,14757,3.658155676747645,0.0,20.0
14034,1,4034,[238 153 216 173 546],899,2,14759,3.657744733581165,0.0,0.0
14035,1,4035,[ 97 216 195  22 328],13,2,14761,3.6573339940535186,0.0,0.0
14036,1,4036,[153 200 515  50 228],387,5,14766,3.6576665840971017,0.0,20.0
14037,1,4037,[313 127 187 302 483],13,5,14771,3.657999009410599,20.0,20.0
14038,1,4038,[127  98 210 174  96],77,2,14773,3.657588512007923,0.0,60.0
14039,1,4039,[185 179 483 180 238],13,2,14775,3.657178217821782,20.0,0.0
14040,1,4040,[475  98 546  12  96],374,4,14779,3.6572630536995794,20.0,20.0
14041,1,4041,[228 186 323   4 118],87,4,14783,3.6573478476001977,0.0,0.0
14042,1,4042,[405 313  79  15  82],59,4,14787,3.657432599554786,0.0,0.0
14043,1,4043,[194 174 181 496 222],474,5,14792,3.6577645895153315,0.0,20.0
14044,1,4044,[  8  96  28 191   9],200,5,14797,3.658096415327565,0.0,0.0
14045,1,4045,[191 265 423 195 168],234,2,14799,3.657686604053386,0.0,0.0
14046,1,4046,[181  64 216 385  98],194,2,14801,3.6572769953051645,0.0,20.0
14047,1,4047,[ 98 200 275  11 237],455,3,14804,3.6571146245059287,0.0,20.0
14048,1,4048,[385 173 195 237 196],374,2,14806,3.656705359347987,0.0,0.0
14049,1,4049,[427 385 211  11  70],13,2,14808,3.656296296296296,0.0,0.0
14050,1,4050,[238 180 168 222  69],650,3,14811,3.6561342878301653,0.0,0.0
14051,1,4051,[ 89 405 546  97  98],60,4,14815,3.656219151036525,0.0,20.0
14052,1,4052,[435 294 515 118 194],271,3,14818,3.6560572415494694,0.0,0.0
14053,1,4053,[151 238 215 234 174],378,3,14821,3.655895411938826,0.0,20.0
14054,1,4054,[427 202 196 588 183],326,4,14825,3.655980271270037,0.0,0.0
14055,1,4055,[597 294 268 475 275],486,2,14827,3.6555719921104535,0.0,0.0
14056,1,4056,[ 82  88 117  64 186],881,3,14830,3.65541040177471,0.0,0.0
14057,1,4057,[313 127 187 302 483],328,5,14835,3.6557417447018237,20.0,20.0
14058,1,4058,[258 125 546   1  97],455,3,14838,3.655580192165558,0.0,0.0
14059,1,4059,[144 181  97 153 182],387,3,14841,3.6554187192118226,0.0,0.0
14060,1,4060,[588 143 435 313 275],85,3,14844,3.655257325781827,0.0,0.0
14061,1,4061,[313 127 187 302 483],328,5,14849,3.655588380108321,20.0,20.0
14062,1,4062,[313 127 187 302 483],207,5,14854,3.6559192714742803,20.0,20.0
14063,1,4063,[313 127 187 302 483],13,5,14859,3.65625,20.0,20.0
14064,1,4064,[294 268 174 132 144],119,4,14863,3.6563345633456334,0.0,20.0
14065,1,4065,[ 89   4 475  71 183],648,2,14865,3.6559272011805213,0.0,0.0
14066,1,4066,[196 180 588 216 144],840,4,14869,3.6560118023112858,0.0,0.0
14067,1,4067,[  7 568 117 172 125],892,5,14874,3.6563421828908553,0.0,0.0
14068,1,4068,[210 153 144 181 121],892,5,14879,3.6566724010813467,0.0,0.0
14069,1,4069,[313 127 187 302 483],474,5,14884,3.657002457002457,20.0,20.0
14070,1,4070,[180  82  15   9 515],59,5,14889,3.657332350773766,0.0,0.0
14071,1,4071,[313 127 187 302 483],669,4,14893,3.6574165029469548,20.0,20.0
14072,1,4072,[313 127 187 302 483],334,5,14898,3.6577461330714462,20.0,20.0
14073,1,4073,[215 678 173 423 288],92,1,14899,3.657093765341188,0.0,0.0
14074,1,4074,[603 423 182 588 237],454,3,14902,3.6569325153374233,20.0,0.0
14075,1,4075,[313 127 187 302 483],669,4,14906,3.657016683022571,20.0,20.0
14076,1,4076,[222  82 179 318  79],815,4,14910,3.65710080941869,20.0,0.0
14077,1,4077,[ 12  11 125  98 161],271,3,14913,3.6569396763119175,20.0,20.0
14078,1,4078,[313 127 187 302 483],537,5,14918,3.65726893846531,20.0,20.0
14079,1,4079,[ 56 197 196 275 496],64,4,14922,3.6573529411764705,0.0,0.0
14080,1,4080,[313 127 187 302 483],207,5,14927,3.6576819407008085,20.0,20.0
14081,1,4081,[196 301 269 423 546],455,3,14930,3.657520823125919,0.0,0.0
14082,1,4082,[180 118  28 183 265],194,2,14932,3.657114866519716,0.0,0.0
14083,1,4083,[100 238 172 302   8],378,4,14936,3.6571988246816844,0.0,20.0
14084,1,4084,[ 15  88  70  11 313],454,3,14939,3.6570379436964506,0.0,0.0
14085,1,4085,[ 28  88  69 202 237],398,3,14942,3.656877141458639,0.0,0.0
14086,1,4086,[ 50   9 183 153 237],447,4,14946,3.6569610961585517,0.0,20.0
14087,1,4087,[135 403 179 143 423],378,3,14949,3.6568003913894325,0.0,0.0
14088,1,4088,[403 132 286  50 121],334,3,14952,3.656639765223771,0.0,20.0
14089,1,4089,[313 127 187 302 483],90,5,14957,3.656968215158924,20.0,20.0
14090,1,4090,[655 144   7 271   4],144,3,14960,3.656807626497189,0.0,0.0
14091,1,4091,[237 546   7 238 111],95,3,14963,3.6566471163245358,0.0,0.0
14092,1,4092,[313   8 111 276 125],234,2,14965,3.6562423650134375,0.0,0.0
14093,1,4093,[ 22 302 427 168 195],6,4,14969,3.6563263312164143,0.0,0.0
14094,1,4094,[179  82 200  28 265],343,3,14972,3.656166056166056,0.0,0.0
14095,1,4095,[125  50 228 173  70],398,4,14976,3.65625,0.0,20.0
14096,1,4096,[121 288  97   7 515],666,3,14979,3.6560898218208444,0.0,0.0
14097,1,4097,[200 194 265 135  71],59,3,14982,3.65592972181552,0.0,0.0
14098,1,4098,[228 182 111 117 742],145,4,14986,3.6560136618687484,0.0,0.0
14099,1,4099,[183 234 174  11 185],308,4,14990,3.65609756097561,0.0,20.0
14100,1,4100,[546  98 172  82 237],194,1,14991,3.6554498902706656,0.0,20.0
14101,1,4101,[313 127 187 302 483],13,5,14996,3.6557776694295465,20.0,20.0
14102,1,4102,[313 127 187 302 483],207,5,15001,3.6561052888130634,20.0,20.0
14103,1,4103,[313 127 187 302 483],13,5,15006,3.6564327485380117,20.0,20.0
14104,1,4104,[265 194  97 276 143],311,4,15010,3.656516443361754,0.0,0.0
14105,1,4105,[313 127 187 302 483],207,5,15015,3.6568436434486116,20.0,20.0
14106,1,4106,[100 515 182 333 127],537,4,15019,3.656927197467738,0.0,40.0
14107,1,4107,[588   1 172 275  11],378,4,15023,3.657010710808179,0.0,0.0
14108,1,4108,[ 79 423  64 183 181],659,4,15027,3.657094183499635,0.0,0.0
14109,1,4109,[313 127 187 302 483],537,5,15032,3.6574209245742093,20.0,20.0
14110,1,4110,[515 174 175  88  71],13,4,15036,3.6575042568718072,0.0,20.0
14111,1,4111,[237 173 172 385 427],42,5,15041,3.657830739299611,0.0,0.0
14112,1,4112,[  9  71 357 228 323],648,2,15043,3.6574276683685873,20.0,0.0
14113,1,4113,[313 127 187 302 483],207,5,15048,3.657754010695187,20.0,20.0
14114,1,4114,[265 185  22  97 186],543,2,15050,3.657351154313487,0.0,0.0
14115,1,4115,[ 69 179 191  71 143],452,3,15053,3.6571914480077745,0.0,0.0
14116,1,4116,[127 271 228 222 186],738,4,15057,3.6572747145980085,0.0,20.0
14117,1,4117,[  8 423 318 597 210],7,4,15061,3.6573579407479357,20.0,0.0
14118,1,4118,[269  95  88 202  69],125,4,15065,3.6574411264870115,0.0,0.0
14119,1,4119,[427 132  97   7 172],60,4,15069,3.65752427184466,0.0,0.0
14120,1,4120,[ 11 435 144 197 216],804,4,15073,3.657607376850279,0.0,0.0
14121,1,4121,[357   7 323  28  97],328,3,15076,3.6574478408539544,20.0,0.0
14122,1,4122,[ 50 180 210 194 471],648,4,15080,3.6575309240844045,0.0,20.0
14123,1,4123,[ 50 496 435 173 588],194,4,15084,3.6576139670223085,0.0,20.0
14124,1,4124,[313 127 187 302 483],537,5,15089,3.657939393939394,20.0,20.0
14125,1,4125,[172 180   1 423  88],290,4,15093,3.658022297624818,0.0,0.0
14126,1,4126,[ 70   1 215  71  96],892,4,15097,3.6581051611339954,0.0,0.0
14127,1,4127,[423 143 204 176 385],643,3,15100,3.6579457364341086,0.0,0.0
14128,1,4128,[ 69 173 211 216 135],488,4,15104,3.6580285783482682,0.0,0.0
14129,1,4129,[ 56 127 118 234 204],774,1,15105,3.6573849878934626,0.0,20.0
14130,1,4130,[144  64 179 195   8],60,4,15109,3.6574679254417815,0.0,0.0
14131,1,4131,[588  95 204 181 423],650,2,15111,3.6570667957405614,0.0,0.0
14132,1,4132,[423 302 153  25  69],666,2,15113,3.656665860150012,0.0,0.0
14133,1,4133,[234 202 300 275  89],454,1,15114,3.656023222060958,0.0,0.0
14134,1,4134,[ 89  15 161 181 323],648,3,15117,3.655864570737606,0.0,0.0
14135,1,4135,[ 50 180 357 235  82],313,3,15120,3.655705996131528,20.0,20.0
14136,1,4136,[286   4 245 300 215],378,3,15123,3.655547498187092,0.0,0.0
14137,1,4137,[ 64 202 265 301 121],537,0,15123,3.654664088931851,0.0,0.0
14138,1,4138,[313 127 187 302 483],90,5,15128,3.6549891278086495,20.0,20.0
14139,1,4139,[  4 237 183 238 357],59,4,15132,3.655072463768116,20.0,0.0
14140,1,4140,[313 127 187 302 483],474,5,15137,3.6553972470417775,20.0,20.0
14141,1,4141,[313 127 187 302 483],474,5,15142,3.6557218734910673,20.0,20.0
14142,1,4142,[161 273 211  70 496],479,3,15145,3.655563601255129,0.0,0.0
14143,1,4143,[ 89  98 322 181 222],328,3,15148,3.6554054054054053,0.0,20.0
14144,1,4144,[313 127 187 302 483],537,5,15153,3.655729794933655,20.0,20.0
14145,1,4145,[196 427 100  96 222],537,2,15155,3.6553304389773276,0.0,20.0
14146,1,4146,[181 202 111  50  25],374,1,15156,3.654690137448758,0.0,20.0
14147,1,4147,[ 64 144 300 234 435],379,4,15160,3.6547733847637414,0.0,0.0
14148,1,4148,[313 127 187 302 483],90,5,15165,3.6550976138828633,20.0,20.0
14149,1,4149,[313  12 385  69 194],328,3,15168,3.6549397590361448,20.0,0.0
14150,1,4150,[228 258  71  50  98],234,2,15170,3.654541074439894,0.0,40.0
14151,1,4151,[ 71 300  98 215 186],13,4,15174,3.6546242774566475,0.0,20.0
14152,1,4152,[ 97 568 276 318 195],13,2,15176,3.654225860823501,20.0,0.0
14153,1,4153,[405 176  50 168 294],537,2,15178,3.653827636013481,0.0,20.0
14154,1,4154,[313 127 187 302 483],334,5,15183,3.6541516245487364,20.0,20.0
14155,1,4155,[  7 143 282  25 196],194,0,15183,3.6532723772858517,0.0,0.0
14156,1,4156,[313 127 187 302 483],669,4,15187,3.6533557854221796,20.0,20.0
14157,1,4157,[282 435 196 183 318],144,5,15192,3.653679653679654,20.0,0.0
14158,1,4158,[313 127 187 302 483],537,5,15197,3.6540033661937965,20.0,20.0
14159,1,4159,[187 135 222 515 161],13,3,15200,3.6538461538461537,0.0,0.0
14160,1,4160,[235 288 182 121  89],119,5,15205,3.654169670752223,0.0,0.0
14161,1,4161,[118 200 176 237 183],59,4,15209,3.654252763094666,0.0,0.0
14162,1,4162,[181 275 234 258 603],548,4,15213,3.6543358155176557,20.0,0.0
14163,1,4163,[143 385 197 168  97],313,3,15216,3.654178674351585,0.0,0.0
14164,1,4164,[132  22 276 181 515],194,2,15218,3.653781512605042,0.0,0.0
14165,1,4165,[237  96 194 144 322],901,4,15222,3.6538646183389343,0.0,0.0
14166,1,4166,[427  71 222  25 496],474,5,15227,3.654187664986801,0.0,0.0
14167,1,4167,[153 197 187 427 135],406,3,15230,3.6540307101727447,0.0,0.0
14168,1,4168,[300 182 318  96 195],653,4,15234,3.654113696330055,20.0,0.0
14169,1,4169,[181 182 195 172 515],102,1,15235,3.6534772182254196,0.0,0.0
14170,1,4170,[313 127 187 302 483],537,5,15240,3.653800047950132,20.0,20.0
14171,1,4171,[288 191 471 475 655],308,4,15244,3.653883029721956,0.0,0.0
14172,1,4172,[678 271 179 215 185],749,4,15248,3.653965971722981,0.0,0.0
14173,1,4173,[  9 234 117 245 271],328,4,15252,3.6540488739817922,0.0,0.0
14174,1,4174,[257 289 202  28 742],95,4,15256,3.654131736526946,0.0,0.0
14175,1,4175,[ 97  70  89 475 328],506,4,15260,3.6542145593869733,0.0,0.0
14176,1,4176,[195 111 117  25 187],533,5,15265,3.6545367488628204,0.0,0.0
14177,1,4177,[313 127 187 302 483],207,5,15270,3.6548587841072284,20.0,20.0
14178,1,4178,[313 127 187 302 483],90,5,15275,3.6551806652309167,20.0,20.0
14179,1,4179,[211 294 176 318 742],653,1,15276,3.6545454545454548,20.0,0.0
14180,1,4180,[286  89 515  88 202],184,3,15279,3.6543889021765126,0.0,0.0
14181,1,4181,[313 127 187 302 483],537,5,15284,3.6547106647537064,20.0,20.0
14182,1,4182,[204 385 235 403  71],788,0,15284,3.6538369591202486,0.0,0.0
14183,1,4183,[313 127 187 302 483],328,5,15289,3.6541586998087956,20.0,20.0
14184,1,4184,[313 127 187 302 483],474,5,15294,3.6544802867383512,20.0,20.0
14185,1,4185,[313 127 187 302 483],90,5,15299,3.6548017200191114,20.0,20.0
14186,1,4186,[328 265 258 508 318],653,3,15302,3.6546453307857654,20.0,0.0
14187,1,4187,[ 70 515 234 181 405],194,1,15303,3.6540114613180514,0.0,0.0
14188,1,4188,[313 127 187 302 483],537,5,15308,3.6543327763189306,20.0,20.0
14189,1,4189,[210 302 286 153 333],13,2,15310,3.6539379474940334,0.0,0.0
14190,1,4190,[125  11 202 195 235],406,3,15313,3.6537819136244334,0.0,0.0
14191,1,4191,[313 127 187 302 483],474,5,15318,3.6541030534351147,20.0,20.0
14192,1,4192,[313 127 187 302 483],474,5,15323,3.654424040066778,20.0,20.0
14193,1,4193,[237  22  69 508  28],653,3,15326,3.6542680019074867,0.0,0.0
14194,1,4194,[195 597  82 176 186],788,1,15327,3.6536352800953518,0.0,0.0
14195,1,4195,[655 273 151 258 121],59,3,15330,3.6534795042897996,0.0,0.0
14196,1,4196,[313 127 187 302 483],13,5,15335,3.6538003335715987,20.0,20.0
14197,1,4197,[222  79 257 423 200],653,2,15337,3.6534063839923774,0.0,0.0
14198,1,4198,[ 50 185 258 403 143],650,2,15339,3.6530126220528696,0.0,20.0
14199,1,4199,[313 127 187 302 483],90,5,15344,3.6533333333333333,20.0,20.0
14200,1,4200,[423 118 196 435  82],804,3,15347,3.6531778148059986,0.0,0.0
14201,1,4201,[313 127 187 302 483],90,5,15352,3.6534983341266063,20.0,20.0
14202,1,4202,[318 655 427 197 678],537,3,15355,3.6533428503449916,20.0,0.0
14203,1,4203,[313 127 187 302 483],474,5,15360,3.653663177925785,20.0,20.0
14204,1,4204,[322  22  71 475 174],474,5,15365,3.653983353151011,0.0,20.0
14205,1,4205,[143 245   8 111 508],378,3,15368,3.6538278649548266,0.0,0.0
14206,1,4206,[100 191  69 655 117],232,3,15371,3.6536724506774423,0.0,20.0
14207,1,4207,[173 405 180 143 181],378,3,15374,3.6535171102661597,0.0,0.0
14208,1,4208,[286 471  98 258  11],447,4,15378,3.6535994297933,0.0,20.0
14209,1,4209,[313 127 187 302 483],474,5,15383,3.653919239904988,20.0,20.0
14210,1,4210,[  7   9 508 197 204],60,5,15388,3.654238898123961,0.0,0.0
14211,1,4211,[405 179 100 175 258],378,3,15391,3.6540835707502373,0.0,20.0
14212,1,4212,[496  97 204  64   9],308,3,15394,3.653928317113696,0.0,0.0
14213,1,4213,[196 385  79 235  98],13,2,15396,3.6535358329378265,0.0,20.0
14214,1,4214,[427 211  71 151 742],533,4,15400,3.65361803084223,0.0,0.0
14215,1,4215,[333 515 235 197 222],334,4,15404,3.653700189753321,0.0,0.0
14216,1,4216,[313 127 187 302 483],669,4,15408,3.653782309698838,20.0,20.0
14217,1,4217,[ 70   9 568 301  12],788,3,15411,3.6536273115220483,20.0,0.0
14218,1,4218,[204 197 257 435  79],749,4,15415,3.653709409812752,0.0,0.0
14219,1,4219,[508 405   9  25 269],634,5,15420,3.654028436018957,0.0,0.0
14220,1,4220,[748 127 300 186 235],328,3,15423,3.6538734896943854,0.0,20.0
14221,1,4221,[234  98 210 125 588],406,4,15427,3.653955471340597,0.0,20.0
14222,1,4222,[ 25 245  64  71 127],313,3,15430,3.65380061567606,0.0,20.0
14223,1,4223,[483 194 471 185 237],194,3,15433,3.6536458333333335,20.0,0.0
14224,1,4224,[182 153 216 588 151],95,3,15436,3.653491124260355,0.0,0.0
14225,1,4225,[168 237 655 483 318],7,5,15441,3.653809749171794,40.0,0.0
14226,1,4226,[195 173  98 182  71],804,5,15446,3.654128223326236,0.0,20.0
14227,1,4227,[289  28 245 215  70],328,4,15450,3.654210028382214,0.0,0.0
14228,1,4228,[313 127 187 302 483],328,5,15455,3.6545282572712225,20.0,20.0
14229,1,4229,[196  22 182 202  82],215,2,15457,3.6541371158392435,0.0,0.0
14230,1,4230,[313 127 187 302 483],474,5,15462,3.654455211533916,20.0,20.0
14231,1,4231,[127 187 202  70 153],659,5,15467,3.654773156899811,0.0,20.0
14232,1,4232,[385  97 197 275  96],64,3,15470,3.6546184738955825,0.0,0.0
14233,1,4233,[294 111 300 117 125],552,2,15472,3.654227680680208,0.0,0.0
14234,1,4234,[313 127 187 302 483],669,4,15476,3.6543093270365996,20.0,20.0
14235,1,4235,[313 127 187 302 483],474,5,15481,3.6546270066100095,20.0,20.0
14236,1,4236,[ 98  15  69  95 435],60,5,15486,3.6549445362284634,0.0,20.0
14237,1,4237,[161 276 323 196 210],200,4,15490,3.6550259556394527,0.0,0.0
14238,1,4238,[678 132 286 176 186],664,4,15494,3.655107336635999,0.0,0.0
14239,1,4239,[  9  89   4 194 182],326,2,15496,3.6547169811320757,0.0,0.0
14240,1,4240,[405 222 403  64 204],653,2,15498,3.65432680971469,0.0,0.0
14241,1,4241,[265  71 161 403 118],479,1,15499,3.6537010843941538,0.0,0.0
14242,1,4242,[121 655   7  25 300],378,5,15504,3.6540183832194204,0.0,0.0
14243,1,4243,[403 313 655  50   9],308,4,15508,3.6540999057492933,0.0,20.0
14244,1,4244,[ 82 174  89 216   9],92,3,15511,3.6539458186101297,0.0,20.0
14245,1,4245,[200 151 655 294 175],788,1,15512,3.653320772491757,0.0,0.0
14246,1,4246,[294 357 496 475 127],533,3,15515,3.653166941370379,20.0,20.0
14247,1,4247,[  4 237  79 328 211],271,4,15519,3.6532485875706215,0.0,0.0
14248,1,4248,[194 275 111  69 597],378,2,15521,3.652859496352083,0.0,0.0
14249,1,4249,[ 22 210  98 174 204],536,5,15526,3.6531764705882352,0.0,40.0
14250,1,4250,[313 127 187 302 483],669,4,15530,3.6532580569277817,20.0,20.0
14251,1,4251,[200 143 144  79 195],379,4,15534,3.6533396048918156,0.0,0.0
14252,1,4252,[228 435 202  12 318],234,1,15535,3.65271573007289,40.0,0.0
14253,1,4253,[568 196  22 275 204],119,5,15540,3.6530324400564176,0.0,0.0
14254,1,4254,[111 245 237 294 568],119,4,15544,3.6531139835487663,0.0,0.0
14255,1,4255,[179 282 423 333 273],666,1,15545,3.6524906015037595,0.0,0.0
14256,1,4256,[313 127 187 302 483],669,4,15549,3.652572233967583,20.0,20.0
14257,1,4257,[269 210  69 423  25],207,4,15553,3.6526538280883045,0.0,0.0
14258,1,4258,[187  50 423  70 194],892,5,15558,3.6529701807936137,0.0,20.0
14259,1,4259,[228 195 288 204 194],215,3,15561,3.6528169014084506,0.0,0.0
14260,1,4260,[313 127 187 302 483],537,5,15566,3.653133067355081,20.0,20.0
14261,1,4261,[132 191 427  25 183],650,4,15570,3.6532144533083057,0.0,0.0
14262,1,4262,[ 97 423 294 168 323],263,3,15573,3.6530612244897958,0.0,0.0
14263,1,4263,[313 127 187 302 483],537,5,15578,3.653377110694184,20.0,20.0
14264,1,4264,[313 127 187 302 483],669,4,15582,3.6534583821805393,20.0,20.0
14265,1,4265,[144 216 121 181 273],207,2,15584,3.653070792311299,0.0,0.0
14266,1,4266,[118 237  64 475  56],533,2,15586,3.6526833841106163,0.0,0.0
14267,1,4267,[435 238 187  97 127],387,3,15589,3.6525304592314902,0.0,20.0
14268,1,4268,[180 276 475 211 186],207,2,15591,3.6521433591004917,0.0,0.0
14269,1,4269,[234 288 174  50  97],843,3,15594,3.651990632318501,0.0,40.0
14270,1,4270,[196 100  11 289   4],538,3,15597,3.651837977054554,0.0,20.0
14271,1,4271,[678 268 742 176  25],387,0,15597,3.6509831460674156,0.0,0.0
14272,1,4272,[276 269  98  56 191],271,3,15600,3.650830798034168,0.0,20.0
14273,1,4273,[195  95  69 176 228],92,4,15604,3.6509124941506785,0.0,0.0
14274,1,4274,[191 195 333  28  69],815,4,15608,3.6509941520467835,0.0,0.0
14275,1,4275,[313 127 187 302 483],537,5,15613,3.651309635173059,20.0,20.0
14276,1,4276,[313 127 187 302 483],669,4,15617,3.65139116202946,20.0,20.0
14277,1,4277,[111 173 202 273 483],374,0,15617,3.650537634408602,20.0,0.0
14278,1,4278,[183 333 323 200  11],328,2,15619,3.6501519046506194,0.0,0.0
14279,1,4279,[313 127 187 302 483],328,5,15624,3.650467289719626,20.0,20.0
14280,1,4280,[323 117 515  79 100],881,4,15628,3.650548937164214,0.0,20.0
14281,1,4281,[568 216 174   8 125],64,4,15632,3.6506305464736104,0.0,20.0
14282,1,4282,[ 11  96  69 194  95],64,5,15637,3.6509455988792903,0.0,0.0
14283,1,4283,[313 127 187 302 483],207,5,15642,3.6512605042016806,20.0,20.0
14284,1,4284,[174 234 204 228  89],479,5,15647,3.651575262543757,0.0,20.0
14285,1,4285,[300 176 210 322 197],537,1,15648,3.6509566028931406,0.0,0.0
14286,1,4286,[127  96 211 168 181],749,5,15653,3.6512712852810822,0.0,20.0
14287,1,4287,[234 195  98 144 322],346,2,15655,3.6508861940298507,0.0,20.0
14288,1,4288,[117 197 215 186 483],343,4,15659,3.650967591513173,20.0,0.0
14289,1,4289,[258 678 271 234 276],92,3,15662,3.650815850815851,0.0,0.0
14290,1,4290,[197 496  69 288 143],643,4,15666,3.6508972267536706,0.0,0.0
14291,1,4291,[313 127 187 302 483],328,5,15671,3.65121155638397,20.0,20.0
14292,1,4292,[313 127 187 302 483],13,5,15676,3.651525739576054,20.0,20.0
14293,1,4293,[603 403 288 546 182],13,2,15678,3.6511411271541685,20.0,0.0
14294,1,4294,[161 183 234 200 173],479,4,15682,3.6512223515715947,0.0,0.0
14295,1,4295,[143 151 191  97  98],474,4,15686,3.6513035381750467,0.0,20.0
14296,1,4296,[125 180 182 328 210],804,5,15691,3.6516174074936,0.0,0.0
14297,1,4297,[ 64 427 186 597   8],899,4,15695,3.6516984644020476,0.0,0.0
14298,1,4298,[258 151 204  69 286],653,3,15698,3.6515468713654338,0.0,0.0
14299,1,4299,[176 216 322 508  97],474,4,15702,3.6516279069767443,0.0,0.0
14300,1,4300,[238 118 168 204 515],308,3,15705,3.651476400837015,0.0,0.0
14301,1,4301,[496  12 603 300 276],334,3,15708,3.6513249651324964,40.0,0.0
14302,1,4302,[357 161 191   7 294],804,5,15713,3.651638391819661,20.0,0.0
14303,1,4303,[ 88  97 237 151 183],298,3,15716,3.6514869888475836,0.0,0.0
14304,1,4304,[423 111 135 385 185],479,3,15719,3.651335656213705,0.0,0.0
14305,1,4305,[196  12 286 237 176],13,3,15722,3.65118439386902,20.0,0.0
14306,1,4306,[186  98 302 323  28],474,4,15726,3.6512653819363825,0.0,20.0
14307,1,4307,[427 121 118 180 135],533,3,15729,3.651114206128134,0.0,0.0
14308,1,4308,[  7 132 423 258 568],650,2,15731,3.650731028080761,0.0,0.0
14309,1,4309,[313 127 187 302 483],13,5,15736,3.651044083526682,20.0,20.0
14310,1,4310,[313 127 187 302 483],669,4,15740,3.6511250289955925,20.0,20.0
14311,1,4311,[153 265 175 357 210],379,5,15745,3.6514378478664193,20.0,0.0
14312,1,4312,[289 228 475  56 173],455,4,15749,3.6515186645026665,0.0,0.0
14313,1,4313,[357 288 125  98 423],144,4,15753,3.6515994436717665,20.0,20.0
14314,1,4314,[302   7 385 183 175],537,3,15756,3.6514484356894554,0.0,0.0
14315,1,4315,[313 127 187 302 483],669,4,15760,3.6515291936978684,20.0,20.0
14316,1,4316,[186 427 100 235 265],13,4,15764,3.6516099142923326,0.0,20.0
14317,1,4317,[678 118 179 175  69],7,3,15767,3.6514590088003707,0.0,0.0
14318,1,4318,[313 127 187 302 483],474,5,15772,3.6517712433433664,20.0,20.0
14319,1,4319,[265 300 288 182 125],234,0,15772,3.650925925925926,0.0,0.0
14320,1,4320,[234 289   1 228 655],194,2,15774,3.650543855588984,0.0,0.0
14321,1,4321,[175  25 276 174 588],184,3,15777,3.650393336418325,0.0,20.0
14322,1,4322,[289  82 135 183  56],91,4,15781,3.6504742077261163,0.0,0.0
14323,1,4323,[ 69 471 286 117 515],537,1,15782,3.6498612395929695,0.0,0.0
14324,1,4324,[180 423 182   9  69],85,5,15787,3.650173410404624,0.0,0.0
14325,1,4325,[313 127 187 302 483],334,5,15792,3.650485436893204,20.0,20.0
14326,1,4326,[175 475  69 191 483],648,2,15794,3.650103998151144,20.0,0.0
14327,1,4327,[313   4  11  82 125],59,4,15798,3.650184842883549,0.0,0.0
14328,1,4328,[204 100 153 187   7],452,3,15801,3.65003465003465,0.0,20.0
14329,1,4329,[496 100 603   8  70],312,5,15806,3.650346420323326,20.0,20.0
14330,1,4330,[183 176 111 268 300],234,1,15807,3.6497344724082197,0.0,0.0
14331,1,4331,[ 50 194 127 175 191],387,4,15811,3.649815327793167,0.0,40.0
14332,1,4332,[151 357   4 135 100],653,3,15814,3.6496653588737593,20.0,20.0
14333,1,4333,[ 97 568 271 144 483],788,2,15816,3.6492847254268574,20.0,0.0
14334,1,4334,[ 70 257 515 258 655],213,4,15820,3.6493656286043827,0.0,0.0
14335,1,4335,[ 95   9 405  56 475],92,3,15823,3.6492158671586714,0.0,0.0
14336,1,4336,[496 215 182 187 238],488,2,15825,3.6488356006456075,0.0,0.0
14337,1,4337,[655 187  25 471 143],666,3,15828,3.648686030428769,0.0,0.0
14338,1,4338,[195  82 127 216 328],533,5,15833,3.648997464853653,0.0,20.0
14339,1,4339,[111 173  79  22 471],271,4,15837,3.649078341013825,0.0,0.0
14340,1,4340,[435  11 603 202  69],537,1,15838,3.648468094909007,20.0,0.0
14341,1,4341,[210  28 238 197  95],308,3,15841,3.6483187471211425,0.0,0.0
14342,1,4342,[153 200 196 237 748],13,4,15845,3.6483997236932995,0.0,0.0
14343,1,4343,[313 127 187 302 191],207,5,15850,3.648710865561694,0.0,20.0
14344,1,4344,[313 127 187 302 191],334,5,15855,3.6490218642117376,0.0,20.0
14345,1,4345,[313 127 187 302 191],334,5,15860,3.649332719742292,0.0,20.0
14346,1,4346,[313 127 187 302 191],90,5,15865,3.649643432252128,0.0,20.0
14347,1,4347,[121 435 288 568 125],455,3,15868,3.6494940202391906,0.0,0.0
14348,1,4348,[ 64 183 197 151 125],374,4,15872,3.6495746148539894,0.0,0.0
14349,1,4349,[265 258  56 515  69],328,5,15877,3.6498850574712645,0.0,0.0
14350,1,4350,[ 97 180 323 185  82],59,5,15882,3.650195357389106,0.0,0.0
14351,1,4351,[153 132 269 603 168],339,5,15887,3.6505055147058822,20.0,0.0
14352,1,4352,[333  11 234 181  15],881,3,15890,3.6503560762692397,0.0,0.0
14353,1,4353,[ 88 678 151 257  28],881,2,15892,3.6499770326136884,0.0,0.0
14354,1,4354,[313 127 187 302 191],144,4,15896,3.6500574052812857,0.0,20.0
14355,1,4355,[127  56 176 144 196],326,2,15898,3.649678604224059,0.0,20.0
14356,1,4356,[286 216 215 111 143],524,3,15901,3.6495294927702546,0.0,0.0
14357,1,4357,[ 28 301 183 127 194],666,3,15904,3.6493804497475906,0.0,20.0
14358,1,4358,[313 127 187 302 191],207,5,15909,3.6496902959394357,0.0,20.0
14359,1,4359,[265  96 144 300 288],102,0,15909,3.6488532110091745,0.0,0.0
14360,1,4360,[313 127 187 302 191],207,5,15914,3.649163036000917,0.0,20.0
14361,1,4361,[ 88   8  79 282  89],311,5,15919,3.6494727189362677,0.0,0.0
14362,1,4362,[313 127 187 302 191],116,4,15923,3.649553059821224,0.0,20.0
14363,1,4363,[313 127 187 302 191],669,4,15927,3.649633363886343,0.0,20.0
14364,1,4364,[  8  96  56 127 603],458,5,15932,3.649942726231386,20.0,20.0
14365,1,4365,[175 423 238 313 200],92,3,15935,3.6497938616582686,0.0,0.0
14366,1,4366,[196  12 301 121 435],455,3,15938,3.649645065262194,20.0,0.0
14367,1,4367,[385   8 182 161  15],234,1,15939,3.6490384615384617,0.0,0.0
14368,1,4368,[173 333  96  22 318],64,4,15943,3.6491187914854657,20.0,0.0
14369,1,4369,[194  69 286   7 196],234,2,15945,3.648741418764302,0.0,0.0
14370,1,4370,[181 288 172 435 318],308,5,15950,3.6490505605124683,20.0,0.0
14371,1,4371,[100 204 508  28   7],447,4,15954,3.649130832570906,0.0,20.0
14372,1,4372,[  9 748 195 546 357],207,2,15956,3.64875371598445,20.0,0.0
14373,1,4373,[323  64 125  69   7],881,3,15959,3.6486053955189757,0.0,0.0
14374,1,4374,[174 403 153 496 210],890,3,15962,3.648457142857143,0.0,20.0
14375,1,4375,[143 508 294 568 202],378,3,15965,3.648308957952468,0.0,0.0
14376,1,4376,[546  95 748  97 151],83,3,15968,3.64816084075851,0.0,0.0
14377,1,4377,[313 127 187 302 603],669,5,15973,3.64846962083143,20.0,20.0
14378,1,4378,[313 127 187 302 603],537,5,15978,3.6487782598766842,20.0,20.0
14379,1,4379,[ 69 215 238 194  64],343,5,15983,3.6490867579908675,0.0,0.0
14380,1,4380,[313 127 187 302 603],537,5,15988,3.649395115270486,20.0,20.0
14381,1,4381,[117 174 588 195 181],815,4,15992,3.6494751255134643,0.0,20.0
14382,1,4382,[496 195 215 118 210],42,5,15997,3.649783253479352,0.0,0.0
14383,1,4383,[125 117 282  97  71],406,2,15999,3.6494069343065694,0.0,0.0
14384,1,4384,[100 323  11 125 237],378,2,16001,3.64903078677309,0.0,20.0
14385,1,4385,[313 127 187 302 603],90,5,16006,3.649338805289558,20.0,20.0
14386,1,4386,[313 127 187 302 603],537,5,16011,3.6496466833827217,20.0,20.0
14387,1,4387,[ 71  15 313 318 597],308,2,16013,3.649270738377393,20.0,0.0
14388,1,4388,[132 318 655  71 182],234,2,16015,3.6488949646844384,20.0,0.0
14389,1,4389,[191 121  96 183 678],7,4,16019,3.6489749430523917,0.0,0.0
14390,1,4390,[222   8 117 181 194],411,2,16021,3.648599407879754,0.0,0.0
14391,1,4391,[245 301 196 100 385],119,5,16026,3.648907103825137,0.0,20.0
14392,1,4392,[313 127 187 302 603],116,3,16029,3.6487593899385384,20.0,20.0
14393,1,4393,[235 405 515  11 202],643,3,16032,3.6486117432862994,0.0,0.0
14394,1,4394,[405 181 265 300  56],892,5,16037,3.648919226393629,0.0,0.0
14395,1,4395,[313 127 187 302 483],537,5,16042,3.6492265696087354,20.0,20.0
14396,1,4396,[276 515 194 111 475],207,2,16044,3.6488514896520354,0.0,0.0
14397,1,4397,[265 210 435  89 135],7,5,16049,3.6491587085038653,0.0,0.0
14398,1,4398,[200 143 235 318 117],374,2,16051,3.6487838145032963,20.0,0.0
14399,1,4399,[ 95 403 117 185 238],313,3,16054,3.6486363636363635,0.0,0.0
14400,1,4400,[313 127 187 302 483],13,5,16059,3.648943421949557,20.0,20.0
14401,1,4401,[597 196 294 118 186],378,2,16061,3.6485688323489325,0.0,0.0
14402,1,4402,[  8 294 135  88 179],881,3,16064,3.648421530774472,0.0,0.0
14403,1,4403,[187 121  50 144 483],648,4,16068,3.64850136239782,20.0,20.0
14404,1,4404,[275 175   7 202   1],279,3,16071,3.6483541430192963,0.0,0.0
14405,1,4405,[313 127 187 302 483],669,4,16075,3.6484339536995005,20.0,20.0
14406,1,4406,[222 151  79 546 183],653,1,16076,3.6478329929657365,0.0,0.0
14407,1,4407,[294 238 288 168 200],92,2,16078,3.647459165154265,0.0,0.0
14408,1,4408,[204 215 121 186 313],474,5,16083,3.6477659333182126,0.0,0.0
14409,1,4409,[173 237 210 204  69],234,1,16084,3.6471655328798187,0.0,0.0
14410,1,4410,[313 127 187 302 191],474,5,16089,3.64747222851961,0.0,20.0
14411,1,4411,[  7   4 216 195  11],13,1,16090,3.64687216681777,0.0,0.0
14412,1,4412,[313 127 187 302 191],669,4,16094,3.6469521867210513,0.0,20.0
14413,1,4413,[313 127 187 302 483],537,5,16099,3.6472587222473947,20.0,20.0
14414,1,4414,[175  79 294 196  50],506,5,16104,3.647565118912797,0.0,20.0
14415,1,4415,[313 127 187 302 483],328,5,16109,3.6478713768115942,20.0,20.0
14416,1,4416,[ 69  88 161 173 588],194,4,16113,3.647951098030337,0.0,0.0
14417,1,4417,[180 328 282 742 318],788,4,16117,3.648030783159801,20.0,0.0
14418,1,4418,[269 143 172  79 515],650,4,16121,3.648110432224485,0.0,0.0
14419,1,4419,[228 258 132  79 748],653,3,16124,3.6479638009049773,0.0,0.0
14420,1,4420,[318 127 111   1 471],234,2,16126,3.6475910427505087,20.0,20.0
14421,1,4421,[175 204 271 313 257],334,4,16130,3.647670737222976,0.0,0.0
14422,1,4422,[423 471 405  89 100],666,3,16133,3.647524304770518,0.0,20.0
14423,1,4423,[323 328  69  98 301],378,1,16134,3.6469258589511755,0.0,20.0
14424,1,4424,[ 95 100  89 228  28],194,2,16136,3.6465536723163843,0.0,20.0
14425,1,4425,[151  50 118 173 496],295,4,16140,3.6466335291459555,0.0,20.0
14426,1,4426,[313 127 187 302 483],90,5,16145,3.6469392365032753,20.0,20.0
14427,1,4427,[ 25 313  82 144  71],234,1,16146,3.6463414634146343,0.0,0.0
14428,1,4428,[ 96  82  97 132 135],533,3,16149,3.6461955294648907,0.0,0.0
14429,1,4429,[216 238  50 144 121],650,3,16152,3.6460496613995486,0.0,20.0
14430,1,4430,[313 127 187 302 483],207,5,16157,3.6463552245542767,20.0,20.0
14431,1,4431,[ 79 180 546 294 210],271,3,16160,3.6462093862815883,0.0,0.0
14432,1,4432,[  7 161   4   9 269],13,2,16162,3.6458380329348072,0.0,0.0
14433,1,4433,[ 79 328   1 135 269],537,1,16163,3.6452413170951736,0.0,0.0
14434,1,4434,[678 234  50 288 515],804,4,16167,3.6453213077790303,0.0,20.0
14435,1,4435,[176 118 238 180 181],666,3,16170,3.645175834084761,0.0,0.0
14436,1,4436,[313 127 187 302 483],328,5,16175,3.6454811809781384,20.0,20.0
14437,1,4437,[  7 515 143 286 117],537,2,16177,3.645110410094637,0.0,0.0
14438,1,4438,[  7 597  98 132  79],554,4,16181,3.6451903581887812,0.0,20.0
14439,1,4439,[313 288 282  79 597],378,3,16184,3.645045045045045,0.0,0.0
14440,1,4440,[222   1 215 176 508],343,5,16189,3.6453501463634317,0.0,0.0
14441,1,4441,[313 127 187 302 483],13,5,16194,3.645655110310671,20.0,20.0
14442,1,4442,[ 28  11 182 282 174],881,4,16198,3.645734863830745,0.0,20.0
14443,1,4443,[313 127 187 302 483],537,5,16203,3.646039603960396,20.0,20.0
14444,1,4444,[275 197 172 258 405],455,4,16207,3.646119235095613,0.0,0.0
14445,1,4445,[313 127 187 302 483],90,5,16212,3.6464237516869096,20.0,20.0
14446,1,4446,[211 204  70 215 385],804,5,16217,3.6467281313244886,0.0,0.0
14447,1,4447,[271 748 294 175 603],749,2,16219,3.646357913669065,20.0,0.0
14448,1,4448,[187 323 496 678 153],804,5,16224,3.6466621712744436,0.0,0.0
14449,1,4449,[ 15 748 385 235 121],648,3,16227,3.6465168539325843,0.0,0.0
14450,1,4450,[216 179   4 301 588],13,2,16229,3.6461469332734215,0.0,0.0
14451,1,4451,[313 127 187 302 483],13,5,16234,3.646451033243486,20.0,20.0
14452,1,4452,[186 286 168  98 151],406,1,16235,3.6458567258028296,0.0,20.0
14453,1,4453,[282 181 655 222 235],194,1,16236,3.6452626852267627,0.0,0.0
14454,1,4454,[153  71 655 111 182],488,1,16237,3.644668911335578,0.0,0.0
14455,1,4455,[194  82 143 204 202],840,3,16240,3.644524236983842,0.0,0.0
14456,1,4456,[313 127 187 302 483],334,5,16245,3.6448283598833298,20.0,20.0
14457,1,4457,[435  79 515   9 127],194,4,16249,3.644908030506954,0.0,20.0
14458,1,4458,[194 168 181 174 655],843,1,16250,3.6443148688046647,0.0,20.0
14459,1,4459,[179 357 181 100 176],311,3,16253,3.644170403587444,20.0,20.0
14460,1,4460,[176 318 508 471 265],537,2,16255,3.6438018381528807,20.0,0.0
14461,1,4461,[313 132 161 403 742],650,2,16257,3.643433437920215,0.0,0.0
14462,1,4462,[313 127 187 302 483],207,5,16262,3.6437373963701547,20.0,20.0
14463,1,4463,[748 182 423 313 117],92,3,16265,3.643593189964158,0.0,0.0
14464,1,4464,[313 127 187 302 483],90,5,16270,3.6438969764837625,20.0,20.0
14465,1,4465,[275 153  69 237  70],85,2,16272,3.643528884908195,0.0,0.0
14466,1,4466,[183  97 202  22 276],13,5,16277,3.6438325498097157,0.0,0.0
14467,1,4467,[125 234 181 204  96],398,4,16281,3.6439122649955236,0.0,0.0
14468,1,4468,[483 475 228 603 235],13,3,16284,3.6437681808010742,40.0,0.0
14469,1,4469,[269 194 234 181 211],13,4,16288,3.643847874720358,0.0,0.0
14470,1,4470,[151 117 100 235 271],294,4,16292,3.6439275329903826,0.0,20.0
14471,1,4471,[125 269  12 222 286],119,3,16295,3.643783542039356,20.0,0.0
14472,1,4472,[313 127 187 302 483],90,5,16300,3.644086742678292,20.0,20.0
14473,1,4473,[313 127 187 302 483],537,5,16305,3.6443898077782744,20.0,20.0
14474,1,4474,[313 127 187 302 483],207,5,16310,3.6446927374301676,20.0,20.0
14475,1,4475,[  8 204 216 222  11],13,2,16312,3.644325290437891,0.0,0.0
14476,1,4476,[  4 132  88  56 301],318,3,16315,3.6441813714540987,0.0,0.0
14477,1,4477,[196 111 286 121   7],653,2,16317,3.6438142027690934,0.0,0.0
14478,1,4478,[313 127 187 302 483],90,5,16322,3.6441169903996427,20.0,20.0
14479,1,4479,[313 127 187 302 483],334,5,16327,3.6444196428571427,20.0,20.0
14480,1,4480,[496 318  56 568  96],454,4,16331,3.644498995759875,20.0,0.0
14481,1,4481,[288  22 286   7 168],452,4,16335,3.644578313253012,0.0,0.0
14482,1,4482,[ 64 294 222 174 132],474,4,16339,3.64465759536025,0.0,20.0
14483,1,4483,[323 435 257 357 234],804,4,16343,3.6447368421052633,20.0,0.0
14484,1,4484,[216 245 568 235 182],92,2,16345,3.6443701226309924,0.0,0.0
14485,1,4485,[423 172 496 238 143],648,4,16349,3.6444493981275077,0.0,0.0
14486,1,4486,[153 132 186 174   9],343,5,16354,3.644751504345888,0.0,20.0
14487,1,4487,[180 211 496 204 172],406,5,16359,3.645053475935829,0.0,0.0
14488,1,4488,[175 742 121  25 200],308,4,16363,3.6451325462241035,0.0,0.0
14489,1,4489,[183 197 655 182 211],207,3,16366,3.644988864142539,0.0,0.0
14490,1,4490,[100  22 180 211 322],788,5,16371,3.6452905811623246,0.0,20.0
14491,1,4491,[111  88 181  97 153],374,2,16373,3.6449243098842388,0.0,0.0
14492,1,4492,[181  28 196 435 276],13,5,16378,3.645225906966392,0.0,0.0
14493,1,4493,[ 50  22 144 742 191],648,5,16383,3.645527369826435,0.0,20.0
14494,1,4494,[483 211 403  89 234],313,4,16387,3.645606229143493,20.0,0.0
14495,1,4495,[313 127 187 302 483],537,5,16392,3.6459074733096086,20.0,20.0
14496,1,4496,[168   9 288 301 222],234,0,16392,3.6450967311541027,0.0,0.0
14497,1,4497,[215 211 313 245 318],653,3,16395,3.6449533125833704,20.0,0.0
14498,1,4498,[118 216 258 183  96],311,4,16399,3.6450322293843076,0.0,0.0
14499,1,4499,[ 50 483 655 183 276],643,5,16404,3.6453333333333333,20.0,20.0
14500,1,4500,[ 15  69 405 151 117],200,3,16407,3.6451899577871583,0.0,0.0
14501,1,4501,[313 127 187 302 483],669,4,16411,3.6452687694358064,20.0,20.0
14502,1,4502,[313 127 187 302 483],474,5,16416,3.6455696202531644,20.0,20.0
14503,1,4503,[168 111 483 197 245],334,3,16419,3.645426287744227,20.0,0.0
14504,1,4504,[258  56 210 183  15],207,3,16422,3.6452830188679246,0.0,0.0
14505,1,4505,[313 127 187 302 483],334,5,16427,3.645583666222814,20.0,20.0
14506,1,4506,[313 127 187 302 483],474,5,16432,3.645884180164189,20.0,20.0
14507,1,4507,[ 97 127 655   1 234],537,1,16433,3.6452972493345164,0.0,20.0
14508,1,4508,[210 238 258 273 161],64,1,16434,3.6447105788423153,0.0,0.0
14509,1,4509,[313 127 187 302 483],90,5,16439,3.645011086474501,20.0,20.0
14510,1,4510,[471 237 483 172  95],524,2,16441,3.6446464198625583,20.0,0.0
14511,1,4511,[385 111 127 182 117],533,4,16445,3.6447251773049647,0.0,20.0
14512,1,4512,[313 127 187 302 483],207,5,16450,3.645025481941059,20.0,20.0
14513,1,4513,[174 216 265  97  25],82,4,16454,3.6451041205139565,0.0,20.0
14514,1,4514,[111 202 748 268 276],92,2,16456,3.6447397563676636,0.0,0.0
14515,1,4515,[313 127 187 302 483],334,5,16461,3.645039858281665,20.0,20.0
14516,1,4516,[289 568 183 268 333],13,2,16463,3.6446756696922735,0.0,0.0
14517,1,4517,[ 56 546 322  50  69],308,2,16465,3.6443116423196105,0.0,20.0
14518,1,4518,[183 180 357 194  82],543,4,16469,3.644390351847754,20.0,0.0
14519,1,4519,[313 127 187 302 483],334,5,16474,3.6446902654867257,20.0,20.0
14520,1,4520,[313 127 187 302 483],669,4,16478,3.6447688564476888,20.0,20.0
14521,1,4521,[111 121 471 238  95],13,3,16481,3.6446262715612563,0.0,0.0
14522,1,4522,[ 28  71 182 289 191],454,2,16483,3.644262657528189,0.0,0.0
14523,1,4523,[ 98 237  15 185   1],406,4,16487,3.644341290893015,0.0,20.0
14524,1,4524,[210 132  22 204   1],536,5,16492,3.6446408839779005,0.0,0.0
14525,1,4525,[ 98 222 118 603 200],897,5,16497,3.6449403446752098,20.0,20.0
14526,1,4526,[200  64 273 265 195],374,3,16500,3.6447978793903246,0.0,0.0
14527,1,4527,[385 216 496 175 186],648,4,16504,3.6448763250883394,0.0,0.0
14528,1,4528,[191 181 234  69 175],749,4,16508,3.6449547361448444,0.0,0.0
14529,1,4529,[185 194 496  69 181],666,2,16510,3.644591611479029,0.0,0.0
14530,1,4530,[182  79 271 111 237],749,2,16512,3.644228647097771,0.0,0.0
14531,1,4531,[186  79  69  28 200],210,5,16517,3.6445278022947925,0.0,0.0
14532,1,4532,[405 135 318 322 151],524,2,16519,3.644165012133245,20.0,0.0
14533,1,4533,[313 127 187 302 483],13,5,16524,3.6444640494044993,20.0,20.0
14534,1,4534,[153  95 257 210  71],738,3,16527,3.644321940463065,0.0,0.0
14535,1,4535,[153 322 302 678 182],13,3,16530,3.644179894179894,0.0,0.0
14536,1,4536,[313 127 187 302 483],669,4,16534,3.6442583204760854,20.0,20.0
14537,1,4537,[182  82 237 100   4],328,3,16537,3.644116350815337,0.0,20.0
14538,1,4538,[313 195 117 175 216],537,2,16539,3.6437541308658297,0.0,0.0
14539,1,4539,[313 127 187 302 603],474,5,16544,3.6440528634361233,20.0,20.0
14540,1,4540,[483 258 271 222 200],13,2,16546,3.6436908170006608,20.0,0.0
14541,1,4541,[195  56 191 153  50],378,4,16550,3.643769264641127,0.0,20.0
14542,1,4542,[357 132  12 191 121],339,4,16554,3.643847677745983,40.0,0.0
14543,1,4543,[328  79   9 144 215],488,4,16558,3.643926056338028,0.0,0.0
14544,1,4544,[181 197   7 204  64],455,5,16563,3.644224422442244,0.0,0.0
14545,1,4545,[313 127 187 302 603],90,5,16568,3.6445226572811262,20.0,20.0
14546,1,4546,[318 515 435 195 204],85,4,16572,3.6446008357158566,20.0,0.0
14547,1,4547,[313 127 187 302 603],669,5,16577,3.6448988566402813,20.0,20.0
14548,1,4548,[135 748 496 678 161],474,3,16580,3.6447570894702133,0.0,0.0
14549,1,4549,[202 655 182  88 173],234,0,16580,3.643956043956044,0.0,0.0
14550,1,4550,[313 127 187 302 603],474,5,16585,3.6442540101076686,20.0,20.0
14551,1,4551,[496  96 143 258 748],479,2,16587,3.6438927943760984,0.0,0.0
14552,1,4552,[ 15 200 234  56 222],749,3,16590,3.6437513727212827,0.0,0.0
14553,1,4553,[127  70 238 300 568],488,2,16592,3.6433904259991214,0.0,20.0
14554,1,4554,[313 127 187 302 603],271,5,16597,3.643688254665203,20.0,20.0
14555,1,4555,[191  56  96  98 173],379,5,16602,3.643985952589991,0.0,20.0
14556,1,4556,[258 301 302 222 403],334,4,16606,3.644064077243801,0.0,0.0
14557,1,4557,[496 135 282  98 127],653,2,16608,3.6437033786748576,0.0,40.0
14558,1,4558,[257 181 245 153  69],804,5,16613,3.6440008773853916,0.0,0.0
14559,1,4559,[313 127 187 302 603],13,5,16618,3.644298245614035,20.0,20.0
14560,1,4560,[357 195 471 153 282],328,1,16619,3.643718482788862,20.0,0.0
14561,1,4561,[216 742 179 294 117],207,3,16622,3.6435773783428322,0.0,0.0
14562,1,4562,[143 117 216  64 100],374,4,16626,3.643655489809336,0.0,20.0
14563,1,4563,[195 568 197 182  70],804,5,16631,3.6439526730937772,0.0,0.0
14564,1,4564,[313 127 187 302 603],669,5,16636,3.644249726177437,20.0,20.0
14565,1,4565,[  8  69 258 385 222],455,3,16639,3.6441086289969338,0.0,0.0
14566,1,4566,[313 127 187 302 603],669,5,16644,3.6444055178454127,20.0,20.0
14567,1,4567,[191  89 385  97 182],308,4,16648,3.6444833625218913,0.0,0.0
14568,1,4568,[508 127  12 180 475],339,5,16653,3.644780039395929,20.0,20.0
14569,1,4569,[174  95 100   7 186],59,4,16657,3.6448577680525163,0.0,40.0
14570,1,4570,[496  15  79 238  89],479,3,16660,3.644716692189893,0.0,0.0
14571,1,4571,[ 97 403 496 151 265],536,2,16662,3.6443569553805775,0.0,0.0
14572,1,4572,[187 161 211 235   4],648,2,16664,3.6439973759020337,0.0,0.0
14573,1,4573,[173  82 228 603  69],815,4,16668,3.6440752076956713,20.0,0.0
14574,1,4574,[ 50 435 678  69  82],881,1,16669,3.643497267759563,0.0,20.0
14575,1,4575,[313 127 187 302  64],474,5,16674,3.6437937062937062,0.0,20.0
14576,1,4576,[  9 161 191 496 257],474,4,16678,3.643871531570898,0.0,0.0
14577,1,4577,[313 127 187 302  64],669,5,16683,3.644167758846658,0.0,20.0
14578,1,4578,[313 127 187 302  64],207,5,16688,3.644463856737279,0.0,20.0
14579,1,4579,[121  25  50 588 568],881,2,16690,3.6441048034934496,0.0,20.0
14580,1,4580,[175  56 168 265 435],308,4,16694,3.6441824929054794,0.0,0.0
14581,1,4581,[301  22 286 405  11],455,2,16696,3.6438236577913576,0.0,0.0
14582,1,4582,[ 70  25  15  97 216],83,4,16700,3.643901374645429,0.0,0.0
14583,1,4583,[  9 183 748 180 172],13,4,16704,3.643979057591623,0.0,0.0
14584,1,4584,[161   8 143  89   7],92,3,16707,3.6438386041439474,0.0,0.0
14585,1,4585,[313 127 187 302  64],328,5,16712,3.644134321849106,0.0,20.0
14586,1,4586,[ 22 181 121 215 216],7,4,16716,3.644211903204709,0.0,0.0
14587,1,4587,[313 127 187 302  64],669,5,16721,3.644507410636443,0.0,20.0
14588,1,4588,[ 97   9 183  96 173],455,5,16726,3.64480278927871,0.0,0.0
14589,1,4589,[ 11 175 742 182 125],804,5,16731,3.645098039215686,0.0,0.0
14590,1,4590,[313 127 187 302  64],271,5,16736,3.6453931605314747,0.0,20.0
14591,1,4591,[313 127 187 302  64],90,5,16741,3.6456881533101044,0.0,20.0
14592,1,4592,[427  64 211 186 200],379,5,16746,3.6459830176355323,0.0,0.0
14593,1,4593,[245 323 161 234 588],200,3,16749,3.645842403134523,0.0,0.0
14594,1,4594,[313 210 117  69  79],815,3,16752,3.645701849836779,0.0,0.0
14595,1,4595,[288 318  56 180 435],144,4,16756,3.645778938207137,20.0,0.0
14596,1,4596,[313 127 187 302  64],474,5,16761,3.6460735262127475,0.0,20.0
14597,1,4597,[269   4 100  69  25],13,3,16764,3.645933014354067,0.0,20.0
14598,1,4598,[ 22 237 568  97 200],313,2,16766,3.6455751250271797,0.0,0.0
14599,1,4599,[174 301 234 117 273],524,3,16769,3.6454347826086955,0.0,20.0
14600,1,4600,[151 288 172  79 228],479,4,16773,3.6455118452510322,0.0,0.0
14601,1,4601,[187 742 172 294 289],387,2,16775,3.645154280747501,0.0,0.0
14602,1,4602,[ 28 200 427 385 228],59,5,16780,3.645448620464914,0.0,0.0
14603,1,4603,[180 427 143 678 435],308,4,16784,3.6455256298870546,0.0,0.0
14604,1,4604,[357 588   7 132 496],537,3,16787,3.645385450597177,20.0,0.0
14605,1,4605,[603 294 196 302 181],537,2,16789,3.64502822405558,20.0,0.0
14606,1,4606,[100 117  69 423 121],334,2,16791,3.644671152593879,0.0,20.0
14607,1,4607,[313 127 187 302  64],474,5,16796,3.6449652777777777,0.0,20.0
14608,1,4608,[313 127 187 302  64],13,5,16801,3.6452592753308743,0.0,20.0
14609,1,4609,[ 50 204  89 121 471],454,3,16804,3.645119305856833,0.0,20.0
14610,1,4610,[313 127 187 302  64],144,4,16808,3.6451962697896336,0.0,20.0
14611,1,4611,[403 210 228 423 215],774,1,16809,3.6446227233304422,0.0,0.0
14612,1,4612,[313 127 187 302  64],669,5,16814,3.644916540212443,0.0,20.0
14613,1,4613,[496 742 200 202 204],749,5,16819,3.6452102297355875,0.0,0.0
14614,1,4614,[301  56 161 403 173],378,4,16823,3.6452871072589383,0.0,0.0
14615,1,4615,[245 174 172 318  15],452,4,16827,3.645363951473137,20.0,20.0
14616,1,4616,[742 210   1 196 161],184,3,16830,3.645224171539961,0.0,0.0
14617,1,4617,[288 172 475  25   7],92,3,16833,3.6450844521437853,0.0,0.0
14618,1,4618,[318 125  95 181 121],406,4,16837,3.6451612903225805,20.0,0.0
14619,1,4619,[174 597 294  89 176],346,3,16840,3.645021645021645,0.0,20.0
14620,1,4620,[151 181 100 568 313],533,4,16844,3.6450984635360313,0.0,20.0
14621,1,4621,[ 70   9 275  98 483],85,4,16848,3.645175248810039,20.0,20.0
14622,1,4622,[313 127 187 302  64],537,4,16852,3.645252000865239,0.0,20.0
14623,1,4623,[235   1  88  96 195],537,0,16852,3.644463667820069,0.0,0.0
14624,1,4624,[ 82 168 269 175 216],669,3,16855,3.6443243243243244,0.0,0.0
14625,1,4625,[286  79 302 179 288],666,3,16858,3.6441850410722005,0.0,0.0
14626,1,4626,[313 127 187 302  64],537,4,16862,3.644261940782364,0.0,20.0
14627,1,4627,[313 127 187 302 191],207,5,16867,3.644554883318928,0.0,20.0
14628,1,4628,[357  97 183  70  79],780,3,16870,3.6444156405271118,20.0,0.0
14629,1,4629,[ 89 228 194 357  11],406,4,16874,3.6444924406047514,20.0,0.0
14630,1,4630,[200 496 181 234 235],479,3,16877,3.6443532714316564,0.0,0.0
14631,1,4631,[313 127 187 302 191],13,4,16881,3.6444300518134716,0.0,20.0
14632,1,4632,[202 323  79 144  50],648,5,16886,3.6447226419166845,0.0,20.0
14633,1,4633,[313 127 187 302 483],13,5,16891,3.6450151057401814,20.0,20.0
14634,1,4634,[100   4  79 179 173],378,3,16894,3.64487594390507,0.0,20.0
14635,1,4635,[427 357  22   7   1],234,3,16897,3.6447368421052633,20.0,0.0
14636,1,4636,[313 127 187 302 483],90,5,16902,3.6450291136510673,20.0,20.0
14637,1,4637,[215 294 286 403 318],533,4,16906,3.645105648986632,20.0,0.0
14638,1,4638,[ 82  71 423 174 161],42,5,16911,3.64539771502479,0.0,20.0
14639,1,4639,[313 127 187 302 483],13,5,16916,3.6456896551724136,20.0,20.0
14640,1,4640,[313 127 187 302 483],474,5,16921,3.645981469510881,20.0,20.0
14641,1,4641,[313 127 187 302 483],669,4,16925,3.646057733735459,20.0,20.0
14642,1,4642,[603 405 215 185  28],313,3,16928,3.6459185871203963,20.0,0.0
14643,1,4643,[185 265 216  71 235],374,4,16932,3.645994832041344,0.0,0.0
14644,1,4644,[276 655 748  25 357],474,4,16936,3.646071044133477,20.0,0.0
14645,1,4645,[185 313 300  50 258],145,4,16940,3.646147223417994,0.0,20.0
14646,1,4646,[204 161 318 258 276],271,2,16942,3.6457929847213255,20.0,0.0
14647,1,4647,[ 96 483 187 143  64],7,4,16946,3.645869191049914,20.0,0.0
14648,1,4648,[ 98  64 174 483 161],91,4,16950,3.6459453645945366,20.0,40.0
14649,1,4649,[313 127 187 302 603],669,5,16955,3.6462365591397847,20.0,20.0
14650,1,4650,[313 127 187 302 603],537,5,16960,3.6465276284669965,20.0,20.0
14651,1,4651,[313 127 187 302 603],90,5,16965,3.6468185726569216,20.0,20.0
14652,1,4652,[603 546 323  89  95],13,3,16968,3.6466795615731784,20.0,0.0
14653,1,4653,[265  15 228 483 200],234,2,16970,3.6463257412978085,20.0,0.0
14654,1,4654,[151 195 135  95   1],897,3,16973,3.646186895810956,0.0,0.0
14655,1,4655,[161   8 508 282  70],207,3,16976,3.6460481099656357,0.0,0.0
14656,1,4656,[ 22 182 427  98 175],474,5,16981,3.646338844749839,0.0,20.0
14657,1,4657,[238 117 195 403 172],158,4,16985,3.6464147702876772,0.0,0.0
14658,1,4658,[ 82 161 100 174 282],533,5,16990,3.64670530156686,0.0,40.0
14659,1,4659,[313 127 187 302 603],90,5,16995,3.6469957081545066,20.0,20.0
14660,1,4660,[117 258 568 257 173],339,2,16997,3.6466423514267325,0.0,0.0
14661,1,4661,[322  98  28  82 385],633,4,17001,3.646718146718147,0.0,20.0
14662,1,4662,[313 127 187 302 603],537,5,17006,3.647008363714347,20.0,20.0
14663,1,4663,[ 79 678 183 222 323],804,5,17011,3.6472984562607205,0.0,0.0
14664,1,4664,[ 50 151 313 204 269],14,4,17015,3.647374062165059,0.0,20.0
14665,1,4665,[313 127 187 302 603],474,5,17020,3.6476639519931418,20.0,20.0
14666,1,4666,[435 117 182 273 211],13,3,17023,3.6475251767730876,0.0,0.0
14667,1,4667,[238 180  15 282 405],653,1,17024,3.6469580119965723,0.0,0.0
14668,1,4668,[ 15 196 333  88 185],537,1,17025,3.646391090169201,0.0,0.0
14669,1,4669,[ 56 172 405 168  70],279,2,17027,3.6460385438972165,0.0,0.0
14670,1,4670,[ 95 742  98  79 300],271,3,17030,3.645900235495611,0.0,20.0
14671,1,4671,[125  95  96 471 222],42,5,17035,3.6461900684931505,0.0,0.0
14672,1,4672,[196 423  88 144 483],295,5,17040,3.6464797774448963,20.0,0.0
14673,1,4673,[204  89 286 483 678],648,3,17043,3.6463414634146343,20.0,0.0
14674,1,4674,[127 176 289 508 197],455,3,17046,3.6462032085561495,0.0,20.0
14675,1,4675,[ 22 181 276 546 143],533,3,17049,3.64606501283148,0.0,0.0
14676,1,4676,[182 183  11 161 357],184,3,17052,3.645926876202694,20.0,0.0
14677,1,4677,[174 194 196  96  11],207,3,17055,3.645788798631894,0.0,20.0
14678,1,4678,[117 118 546 238   8],13,2,17057,3.6454370592006837,0.0,0.0
14679,1,4679,[313 127 187 302 603],537,5,17062,3.6457264957264957,20.0,20.0
14680,1,4680,[313 127 187 302 603],116,3,17065,3.6455885494552445,20.0,20.0
14681,1,4681,[ 64 121  28 202 318],343,4,17069,3.645664246048697,20.0,0.0
14682,1,4682,[483 125 234 282 597],804,4,17073,3.6457399103139014,20.0,0.0
14683,1,4683,[ 50 204 323  88 216],83,4,17077,3.6458155422715626,0.0,20.0
14684,1,4684,[269 180 515 546  95],524,4,17081,3.645891141942369,0.0,0.0
14685,1,4685,[313 127 187 302 483],207,5,17086,3.646180110968843,20.0,20.0
14686,1,4686,[313 127 187 302 483],334,5,17091,3.6464689566887136,20.0,20.0
14687,1,4687,[546  79  12 216 185],643,4,17095,3.6465443686006824,20.0,0.0
14688,1,4688,[176 181 194 257 186],95,4,17099,3.6466197483471956,0.0,0.0
14689,1,4689,[237   7 186  70   9],13,2,17101,3.6462686567164178,0.0,0.0
14690,1,4690,[275 294 286 121 204],119,4,17105,3.6463440630995523,0.0,0.0
14691,1,4691,[186  70 132  22 117],234,2,17107,3.645993179880648,0.0,0.0
14692,1,4692,[313 127 187 302 483],207,5,17112,3.646281696143192,20.0,20.0
14693,1,4693,[322   1 186  22 125],788,2,17114,3.645930975713677,0.0,0.0
14694,1,4694,[313 127 187 302 483],13,5,17119,3.6462193823216187,20.0,20.0
14695,1,4695,[313 127 187 302 483],328,5,17124,3.6465076660988074,20.0,20.0
14696,1,4696,[313 127 187 302 483],90,5,17129,3.6467958271236958,20.0,20.0
14697,1,4697,[135  95 153  22 288],308,5,17134,3.64708386547467,0.0,0.0
14698,1,4698,[742 202 195 143 257],749,4,17138,3.6471589699936158,0.0,0.0
14699,1,4699,[313 127 187 302 483],474,5,17143,3.6474468085106384,20.0,20.0
14700,1,4700,[196 173 655 423 313],64,5,17148,3.6477345245692407,0.0,0.0
14701,1,4701,[313 127 187 302 483],328,5,17153,3.648022118247554,20.0,20.0
14702,1,4702,[496 322 153 568  64],313,3,17156,3.6478843291516054,0.0,0.0
14703,1,4703,[211   4 275 144 515],343,5,17161,3.648171768707483,0.0,0.0
14704,1,4704,[182  71 234 175  82],234,1,17162,3.6476089266737515,0.0,0.0
14705,1,4705,[215 153 168  56  28],77,4,17166,3.6476838079048024,0.0,0.0
14706,1,4706,[313 127 187 302 483],669,4,17170,3.647758657318887,20.0,20.0
14707,1,4707,[204 678 515 286 483],7,3,17173,3.647621070518267,20.0,0.0
14708,1,4708,[568 172 385 588 211],42,5,17178,3.647908260777235,0.0,0.0
14709,1,4709,[313 127 187 302 483],13,5,17183,3.648195329087049,20.0,20.0
14710,1,4710,[357  69 196 211  79],59,5,17188,3.648482275525366,20.0,0.0
14711,1,4711,[313 127 187 302 483],537,5,17193,3.6487691001697793,20.0,20.0
14712,1,4712,[496   7 161 423 265],380,1,17194,3.6482070867812433,0.0,0.0
14713,1,4713,[191 180  12 435 294],378,3,17197,3.648069579974544,20.0,0.0
14714,1,4714,[313 127 187 302 483],474,5,17202,3.648356309650053,20.0,20.0
14715,1,4715,[313 127 187 302 483],669,4,17206,3.6484308736217135,20.0,20.0
14716,1,4716,[313 127 187 302 483],537,5,17211,3.6487174051303795,20.0,20.0
14717,1,4717,[313 127 187 302 483],207,5,17216,3.649003815175922,20.0,20.0
14718,1,4718,[313 127 187 302 483],474,5,17221,3.6492901038355585,20.0,20.0
14719,1,4719,[144  82 151  56 204],379,5,17226,3.6495762711864406,0.0,0.0
14720,1,4720,[313 127 187 302 483],669,4,17230,3.649650497775895,20.0,20.0
14721,1,4721,[235 204 655  12 357],537,1,17231,3.6490893689114783,40.0,0.0
14722,1,4722,[275 176 276 210 173],378,5,17236,3.6493753969934364,0.0,0.0
14723,1,4723,[435 385 271 127 174],158,4,17240,3.649449618966977,0.0,40.0
14724,1,4724,[588 228 175  25 197],881,0,17240,3.6486772486772487,0.0,0.0
14725,1,4725,[313 127 187 302 603],90,5,17245,3.6489631823952604,20.0,20.0
14726,1,4726,[185 301 222   9 288],13,0,17245,3.6481912418024116,0.0,0.0
14727,1,4727,[313 127 187 302 603],669,5,17250,3.6484771573604062,20.0,20.0
14728,1,4728,[405 153  79 185  69],7,4,17254,3.648551490801438,0.0,0.0
14729,1,4729,[  8  88 195 151  98],892,5,17259,3.6488372093023256,0.0,20.0
14730,1,4730,[ 89 238 471 475  12],6,4,17263,3.648911435214542,20.0,0.0
14731,1,4731,[ 71 179  69 161 318],452,4,17267,3.6489856297548604,20.0,0.0
14732,1,4732,[313 127 187 302 603],474,5,17272,3.6492710754278472,20.0,20.0
14733,1,4733,[ 12  98 515 173 603],339,5,17277,3.6495564005069707,40.0,20.0
14734,1,4734,[174 603 318 427 216],308,4,17281,3.6496304118268217,40.0,20.0
14735,1,4735,[313 127 187 302 603],13,5,17286,3.6499155405405403,20.0,20.0
14736,1,4736,[333 385 161 127 234],313,5,17291,3.6502005488705933,0.0,20.0
14737,1,4737,[ 98 427 588 742 568],454,2,17293,3.649852258336851,0.0,20.0
14738,1,4738,[323 742 175  22 597],378,3,17296,3.649715129774214,0.0,0.0
14739,1,4739,[515  89 191 257 200],343,2,17298,3.649367088607595,0.0,0.0
14740,1,4740,[313 127 187 302 603],334,5,17303,3.6496519721577725,20.0,20.0
14741,1,4741,[496 289 301 435 238],85,3,17306,3.649514972585407,0.0,0.0
14742,1,4742,[168 121 186  50 144],298,5,17311,3.6497997048281676,0.0,20.0
14743,1,4743,[313 127 187 302 603],474,5,17316,3.6500843170320403,20.0,20.0
14744,1,4744,[286 121 127 196 318],479,4,17320,3.650158061116965,20.0,20.0
14745,1,4745,[313 127 187 302 603],334,5,17325,3.650442477876106,20.0,20.0
14746,1,4746,[234 427 603 111 258],59,4,17329,3.6505161154413313,20.0,0.0
14747,1,4747,[294  96 257 546 234],95,2,17331,3.65016849199663,0.0,0.0
14748,1,4748,[ 82 194  70 265 132],881,2,17333,3.6498210149505157,0.0,0.0
14749,1,4749,[ 69 118  28 174 427],42,5,17338,3.6501052631578945,0.0,20.0
14750,1,4750,[313 127 187 302 603],13,5,17343,3.650389391707009,20.0,20.0
14751,1,4751,[265 153 117 135  50],536,5,17348,3.6506734006734005,0.0,20.0
14752,1,4752,[168 161 475 186  88],474,4,17352,3.650746896696823,0.0,0.0
14753,1,4753,[313 127 187 302 603],334,5,17357,3.651030710980227,20.0,20.0
14754,1,4754,[313 127 187 302 603],334,5,17362,3.6513144058885385,20.0,20.0
14755,1,4755,[313 127 187 302 603],537,5,17367,3.6515979814970563,20.0,20.0
14756,1,4756,[ 97   8 197   4   1],308,3,17370,3.65146100483498,0.0,0.0
14757,1,4757,[271  50 185 748 127],102,1,17371,3.6509037410676757,0.0,40.0
14758,1,4758,[222 286  88 265 135],234,1,17372,3.650346711494011,0.0,0.0
14759,1,4759,[197  96 191 183 172],398,5,17377,3.6506302521008402,0.0,0.0
14760,1,4760,[313 127 187 302 603],669,5,17382,3.6509136735979837,20.0,20.0
14761,1,4761,[275 271 301 515 234],537,2,17384,3.650566988660227,0.0,0.0
14762,1,4762,[313 127 187 302 603],271,5,17389,3.650850304429981,20.0,20.0
14763,1,4763,[515 176 357 294   8],200,5,17394,3.6511335012594457,20.0,0.0
14764,1,4764,[228 403 357 186 121],295,5,17399,3.651416579223505,20.0,0.0
14765,1,4765,[202  82 423 143 195],194,0,17399,3.650650440621066,0.0,0.0
14766,1,4766,[313 127 187 302 603],474,5,17404,3.6509335011537654,20.0,20.0
14767,1,4767,[313 127 187 302 603],116,3,17407,3.650796979865772,20.0,20.0
14768,1,4768,[265  96  79  22 294],200,5,17412,3.6510798909624658,0.0,0.0
14769,1,4769,[313 127 187 302 603],90,5,17417,3.651362683438155,20.0,20.0
14770,1,4770,[313 127 187 302 603],90,5,17422,3.6516453573674283,20.0,20.0
14771,1,4771,[313 127 187 302 603],334,5,17427,3.6519279128248114,20.0,20.0
14772,1,4772,[ 28 143 151 288 269],64,4,17431,3.65200083804735,0.0,0.0
14773,1,4773,[ 28 168 275 546  97],95,3,17434,3.6518642647674904,0.0,0.0
14774,1,4774,[313 127 187 302 603],116,3,17437,3.6517277486910995,20.0,20.0
14775,1,4775,[313 127 187 302 603],334,5,17442,3.6520100502512562,20.0,20.0
14776,1,4776,[313 127 187 302 603],537,5,17447,3.6522922336194266,20.0,20.0
14777,1,4777,[357 191 265 276 172],537,3,17450,3.6521557136877356,20.0,0.0
14778,1,4778,[313 127 187 302 603],537,5,17455,3.6524377484829462,20.0,20.0
14779,1,4779,[175 302 427 273 423],666,3,17458,3.6523012552301255,0.0,0.0
14780,1,4780,[288 496 187 186  50],346,2,17460,3.6519556578121732,0.0,20.0
14781,1,4781,[483 194  64 427 174],59,4,17464,3.6520284399832708,20.0,20.0
14782,1,4782,[ 71 182 200 118 294],804,4,17468,3.6521011917206776,0.0,0.0
14783,1,4783,[313 127 187 302 603],334,5,17473,3.6523829431438126,20.0,20.0
14784,1,4784,[182 568 191 322  88],308,4,17477,3.6524555903866247,0.0,0.0
14785,1,4785,[204 237 318 181   9],458,4,17481,3.6525282072712075,20.0,0.0
14786,1,4786,[143 182 385 508 427],474,4,17485,3.6526007938165868,0.0,0.0
14787,1,4787,[  7 121  98 265 181],194,2,17487,3.6522556390977443,0.0,20.0
14788,1,4788,[ 12 471 286 655 185],194,3,17490,3.652119440384214,20.0,0.0
14789,1,4789,[ 22 289 603  25 181],537,1,17491,3.6515657620041755,20.0,0.0
14790,1,4790,[313 127 187 302 603],474,5,17496,3.65184721352536,20.0,20.0
14791,1,4791,[197 597  11 173 132],378,2,17498,3.6515025041736227,0.0,0.0
14792,1,4792,[200 175 515 265 301],650,4,17502,3.6515752138535365,0.0,0.0
14793,1,4793,[294  96 202 215 357],234,1,17503,3.651022110972048,20.0,0.0
14794,1,4794,[  1 234 313 132 258],533,4,17507,3.651094890510949,0.0,0.0
14795,1,4795,[301 235 357 175 288],650,2,17509,3.6507506255212676,20.0,0.0
14796,1,4796,[313 127 187 302 603],13,5,17514,3.651031894934334,20.0,20.0
14797,1,4797,[427 197  12 202 179],7,4,17518,3.6511046269278866,20.0,0.0
14798,1,4798,[313 127 187 302 603],90,5,17523,3.6513857053552825,20.0,20.0
14799,1,4799,[294 228 182 210 200],374,4,17527,3.6514583333333333,0.0,0.0
14800,1,4800,[186 118 222 245  50],666,0,17527,3.6506977712976463,0.0,20.0
14801,1,4801,[313 127 187 302 603],334,5,17532,3.650978758850479,20.0,20.0
14802,1,4802,[173 204  95 483 269],6,3,17535,3.650843222985634,20.0,0.0
14803,1,4803,[313 127 187 302 603],474,5,17540,3.6511240632805997,20.0,20.0
14804,1,4804,[288 546 597 403 742],308,3,17543,3.6509885535900106,0.0,0.0
14805,1,4805,[546 195 276 187 210],346,3,17546,3.6508531002913025,0.0,0.0
14806,1,4806,[204 597 655   1 176],378,4,17550,3.650925733305596,0.0,0.0
14807,1,4807,[302 322 176 423  28],788,5,17555,3.6512063227953413,0.0,0.0
14808,1,4808,[271 496  96 423 258],506,5,17560,3.651486795591599,0.0,0.0
14809,1,4809,[182 275 117  98 288],308,3,17563,3.651351351351351,0.0,20.0
14810,1,4810,[265 210  64 215 174],653,4,17567,3.6514238204115568,0.0,20.0
14811,1,4811,[168 210 135 100 423],738,3,17570,3.6512884455527845,0.0,20.0
14812,1,4812,[186  88 181 222 294],406,1,17571,3.6507375857053814,0.0,0.0
14813,1,4813,[191 322 210  50  96],454,4,17575,3.6508101371001245,0.0,20.0
14814,1,4814,[222  69 202 313 328],653,3,17578,3.65067497403946,0.0,0.0
14815,1,4815,[ 89  98 202  15 117],454,0,17578,3.649916943521595,0.0,20.0
14816,1,4816,[176 273 385 168 269],279,3,17581,3.6497820220053976,0.0,0.0
14817,1,4817,[204 258 176 153 483],263,3,17584,3.6496471564964716,20.0,0.0
14818,1,4818,[ 11  25  69  82 238],666,2,17586,3.649304835028014,0.0,0.0
14819,1,4819,[313 127 187 302 603],90,5,17591,3.649585062240664,20.0,20.0
14820,1,4820,[313 127 187 302 603],116,3,17594,3.64945032151006,20.0,20.0
14821,1,4821,[186 597 143 118 187],897,5,17599,3.6497304023226875,0.0,0.0
14822,1,4822,[118 546 269  50 271],650,3,17602,3.6495956873315363,0.0,20.0
14823,1,4823,[475  56 202 185  88],648,3,17605,3.6494610281923716,0.0,0.0
14824,1,4824,[173 215 322  50 182],537,3,17608,3.649326424870466,0.0,20.0
14825,1,4825,[289 269 475 385 195],13,0,17608,3.64857024450891,0.0,0.0
14826,1,4826,[ 11 483 234 182   1],749,4,17612,3.648643049513155,20.0,0.0
14827,1,4827,[313 127 187 302 603],271,5,17617,3.6489229494614746,20.0,20.0
14828,1,4828,[313 127 187 302 603],90,5,17622,3.6492027334851938,20.0,20.0
14829,1,4829,[313 127 187 302 603],271,5,17627,3.6494824016563148,20.0,20.0
14830,1,4830,[313 127 187 302 603],334,5,17632,3.6497619540467814,20.0,20.0
14831,1,4831,[318 174 153 143  12],234,1,17633,3.6492135761589406,40.0,20.0
14832,1,4832,[187 174  28 168 435],533,5,17638,3.649493068487482,0.0,20.0
14833,1,4833,[ 22 180 215 168  15],311,5,17643,3.649772445179975,0.0,0.0
14834,1,4834,[273 276 271 423 508],144,3,17646,3.649638055842813,0.0,0.0
14835,1,4835,[144  15  64 181 282],378,5,17651,3.6499172870140613,0.0,0.0
14836,1,4836,[313 127 187 302 603],271,5,17656,3.650196402728964,20.0,20.0
14837,1,4837,[357 135 175 194 483],95,3,17659,3.6500620090946674,40.0,0.0
14838,1,4838,[742  71 269  70 258],378,5,17664,3.6503409795412276,0.0,0.0
14839,1,4839,[313 127 187 302 603],116,3,17667,3.650206611570248,20.0,20.0
14840,1,4840,[173 179 546 302 111],666,4,17671,3.650278868002479,0.0,0.0
14841,1,4841,[ 70  50 181  79 100],455,4,17675,3.6503510945890127,0.0,40.0
14842,1,4842,[ 96  22 301 194 496],524,3,17678,3.650216807763783,0.0,0.0
14843,1,4843,[211 216 237 238   4],537,2,17680,3.6498761354252682,0.0,0.0
14844,1,4844,[234 322 168 176 748],313,2,17682,3.6495356037151705,0.0,0.0
14845,1,4845,[313 127 187 302  64],90,5,17687,3.649814279818407,0.0,20.0
14846,1,4846,[313 127 187 302  64],669,5,17692,3.6500928409325355,0.0,20.0
14847,1,4847,[313 127 187 302  64],669,5,17697,3.650371287128713,0.0,20.0
14848,1,4848,[357  25  71 173 275],843,0,17697,3.6496184780367087,20.0,0.0
14849,1,4849,[  1 200 286 234 161],10,5,17702,3.649896907216495,0.0,0.0
14850,1,4850,[515  96  69 100 175],474,5,17707,3.650175221603793,0.0,20.0
14851,1,4851,[568 204 318 174 289],455,3,17710,3.6500412201154164,20.0,20.0
14852,1,4852,[313 127 187 302  64],207,5,17715,3.6503193900679993,0.0,20.0
14853,1,4853,[161  64 180 496 172],804,5,17720,3.6505974454058507,0.0,0.0
14854,1,4854,[ 69  95 144 127 176],263,5,17725,3.650875386199794,0.0,20.0
14855,1,4855,[288   7 161 181  12],374,3,17728,3.6507413509060958,20.0,0.0
14856,1,4856,[313 127 187 302  64],90,5,17733,3.651019147621989,0.0,20.0
14857,1,4857,[ 82 742 132 475 117],308,3,17736,3.650885137916838,0.0,0.0
14858,1,4858,[313 127 187 302  64],328,5,17741,3.6511627906976742,0.0,20.0
14859,1,4859,[ 89 132 423 286   4],788,4,17745,3.6512345679012346,0.0,0.0
14860,1,4860,[322   9 151  69 276],334,3,17748,3.651100596585065,0.0,0.0
14861,1,4861,[313 127 187 302  64],474,5,17753,3.6513780337309747,0.0,20.0
14862,1,4862,[313 127 187 302  64],537,4,17757,3.651449722393584,0.0,20.0
14863,1,4863,[313 127 187 302 191],334,5,17762,3.6517269736842106,0.0,20.0
14864,1,4864,[318 568  56 597 423],200,5,17767,3.652004110996917,20.0,0.0
14865,1,4865,[313 127 187 302 191],13,4,17771,3.6520756267981915,0.0,20.0
14866,1,4866,[ 82 181  97 655 176],506,5,17776,3.6523525785905075,0.0,0.0
14867,1,4867,[186  88 204 742 423],207,3,17779,3.6522185702547247,0.0,0.0
14868,1,4868,[ 15 403 323 568  50],881,1,17780,3.651673855001027,0.0,20.0
14869,1,4869,[ 98  56 175   9  22],883,3,17783,3.651540041067762,0.0,20.0
14870,1,4870,[237 423  15 475  69],308,2,17785,3.651200985423938,0.0,0.0
14871,1,4871,[483 403  56   8 237],234,2,17787,3.6508620689655173,20.0,0.0
14872,1,4872,[313 127 187 302  64],669,5,17792,3.651138928791299,0.0,20.0
14873,1,4873,[546 258 210 172 100],749,3,17795,3.651005334427575,0.0,20.0
14874,1,4874,[313 127 187 302  64],144,4,17799,3.651076923076923,0.0,20.0
14875,1,4875,[182  25 185  88 427],271,2,17801,3.650738310090238,0.0,0.0
14876,1,4876,[313 127 187 302  64],537,4,17805,3.650809924133689,0.0,20.0
14877,1,4877,[313 127 187 302 483],90,5,17810,3.6510865108651087,20.0,20.0
14878,1,4878,[313 127 187 302 483],474,5,17815,3.6513629842180775,20.0,20.0
14879,1,4879,[132 118 179 216 568],311,3,17818,3.6512295081967214,0.0,0.0
14880,1,4880,[180  22 286  70 194],452,5,17823,3.6515058389674246,0.0,0.0
14881,1,4881,[313 127 187 302 483],328,5,17828,3.6517820565342074,20.0,20.0
14882,1,4882,[313 127 187 302 483],334,5,17833,3.652058160966619,20.0,20.0
14883,1,4883,[172 168   7 161 302],474,4,17837,3.652129402129402,0.0,0.0
14884,1,4884,[294 238 181 121  89],804,5,17842,3.6524053224155577,0.0,0.0
14885,1,4885,[313 127 187 302 483],334,5,17847,3.6526811297584936,20.0,20.0
14886,1,4886,[202  28 174 215 194],308,3,17850,3.652547575199509,0.0,20.0
14887,1,4887,[288  96 179 204 258],234,0,17850,3.6518003273322424,0.0,0.0
14888,1,4888,[ 98  79 196 271 742],749,5,17855,3.652076089179791,0.0,20.0
14889,1,4889,[313 127 187 302 483],669,4,17859,3.6521472392638037,20.0,20.0
14890,1,4890,[603 265 655 423  11],13,4,17863,3.652218360253527,20.0,0.0
14891,1,4891,[127 211 238 216 405],488,2,17865,3.651880621422731,0.0,20.0
14892,1,4892,[  9 322 323 161 127],13,2,17867,3.651543020641733,0.0,20.0
14893,1,4893,[127 182  70 222 181],334,3,17870,3.651409889660809,0.0,20.0
14894,1,4894,[168 100   4 211 153],308,5,17875,3.651685393258427,0.0,20.0
14895,1,4895,[111 496 183 471 265],537,1,17876,3.651143790849673,0.0,0.0
14896,1,4896,[181  98 423 300  97],653,2,17878,3.650806616295691,0.0,20.0
14897,1,4897,[187 132 385 121 546],643,3,17881,3.6506737443854633,0.0,0.0
14898,1,4898,[100  28 357 403 174],311,4,17885,3.6507450500102063,20.0,40.0
14899,1,4899,[313 127 187 302 603],474,5,17890,3.6510204081632653,20.0,20.0
14900,1,4900,[100 194 168 183 235],537,2,17892,3.6506835339726584,0.0,20.0
14901,1,4901,[313 127 187 302 603],334,5,17897,3.6509587923296616,20.0,20.0
14902,1,4902,[313 127 187 302 603],474,5,17902,3.651233938405058,20.0,20.0
14903,1,4903,[313 127 187 302 603],271,5,17907,3.651508972267537,20.0,20.0
14904,1,4904,[200 127 111  89  98],6,3,17910,3.6513761467889907,0.0,40.0
14905,1,4905,[ 25 100 568 200 143],881,3,17913,3.651243375458622,0.0,20.0
14906,1,4906,[222 300 483  28 143],479,3,17916,3.6511106582433257,20.0,0.0
14907,1,4907,[313 127 187 302 603],271,5,17921,3.6513854930725347,20.0,20.0
14908,1,4908,[ 88 385 423 175 186],537,2,17923,3.6510490935017317,0.0,0.0
14909,1,4909,[289 195  69 168 191],387,3,17926,3.65091649694501,0.0,0.0
14910,1,4910,[313 127 187 302 603],116,3,17929,3.650783954388108,20.0,20.0
14911,1,4911,[  8   4 196 235 273],64,3,17932,3.650651465798046,0.0,0.0
14912,1,4912,[655 313 175  12 181],64,5,17937,3.650926114390393,20.0,0.0
14913,1,4913,[597  64  71 180 265],899,3,17940,3.6507936507936507,0.0,0.0
14914,1,4914,[180 174 191 153 172],488,1,17941,3.6502543234994915,0.0,20.0
14915,1,4915,[111 168 237 655  15],474,4,17945,3.650325467860049,0.0,0.0
14916,1,4916,[313 127 187 302 483],207,5,17950,3.6505999593247918,20.0,20.0
14917,1,4917,[ 64 318 179  28 222],374,3,17953,3.650467669784465,20.0,0.0
14918,1,4918,[174 176  88 202 655],210,5,17958,3.650742020735922,0.0,20.0
14919,1,4919,[175  56 174  71 475],92,5,17963,3.6510162601626015,0.0,20.0
14920,1,4920,[182 268   1 405 183],6,3,17966,3.6508839666734403,0.0,0.0
14921,1,4921,[313 127 187 302 483],474,5,17971,3.6511580658268996,20.0,20.0
14922,1,4922,[313 127 187 302 483],328,5,17976,3.651432053625838,20.0,20.0
14923,1,4923,[ 89 318 151 423  98],234,3,17979,3.6512997562956944,20.0,20.0
14924,1,4924,[273 215 100 168   1],479,3,17982,3.651167512690355,0.0,20.0
14925,1,4925,[313 127 187 302 483],474,5,17987,3.6514413317092975,20.0,20.0
14926,1,4926,[435 127 191 323 121],59,5,17992,3.6517150395778364,0.0,20.0
14927,1,4927,[313 127 187 302 483],474,5,17997,3.6519886363636362,20.0,20.0
14928,1,4928,[183  95 333 175   8],334,4,18001,3.6520592412254005,0.0,0.0
14929,1,4929,[237 183 265 187 403],346,3,18004,3.651926977687627,0.0,0.0
14930,1,4930,[435  50 742   8  98],144,5,18009,3.6522003650375177,0.0,40.0
14931,1,4931,[313 127 187 302 483],328,5,18014,3.6524736415247365,20.0,20.0
14932,1,4932,[313 127 187 302 483],474,5,18019,3.6527468072167038,20.0,20.0
14933,1,4933,[111 318   7 151  89],374,0,18019,3.6520064856100527,20.0,0.0
14934,1,4934,[181 172  69 385 194],308,4,18023,3.652077001013171,0.0,0.0
14935,1,4935,[742 323 215 204 194],897,4,18027,3.6521474878444082,0.0,0.0
14936,1,4936,[313 127 187 302 483],328,5,18032,3.652420498278307,20.0,20.0
14937,1,4937,[100  50 265 568 127],313,5,18037,3.6526933981368974,0.0,60.0
14938,1,4938,[289 222 323 196 515],537,1,18038,3.652156306944726,0.0,0.0
14939,1,4939,[ 97 168  25 215  88],295,5,18043,3.652429149797571,0.0,0.0
14940,1,4940,[ 97 211  11 235 186],343,5,18048,3.6527018822100787,0.0,0.0
14941,1,4941,[313 127 187 302 483],328,5,18053,3.6529745042492916,20.0,20.0
14942,1,4942,[234 568 427 357 211],13,3,18056,3.6528424033987457,20.0,0.0
14943,1,4943,[ 12 475 275 210 286],13,1,18057,3.6523058252427183,20.0,0.0
14944,1,4944,[313 127 187 302 483],328,5,18062,3.6525783619817997,20.0,20.0
14945,1,4945,[215  89 515  98 168],313,4,18066,3.6526486049332796,0.0,20.0
14946,1,4946,[135 204 175   1 435],892,5,18071,3.6529209621993126,0.0,0.0
14947,1,4947,[423  98 187 195 179],643,4,18075,3.652991107518189,0.0,20.0
14948,1,4948,[318  64 568 181  56],213,5,18080,3.653263285512225,20.0,0.0
14949,1,4949,[ 96 153 238 176  50],13,3,18083,3.653131313131313,0.0,20.0
14950,1,4950,[405 237 328  97 161],85,1,18084,3.652595435265603,0.0,0.0
14951,1,4951,[313 127 187 302 483],328,5,18089,3.6528675282714054,20.0,20.0
14952,1,4952,[313 127 187 302 483],669,4,18093,3.6529376135675347,20.0,20.0
14953,1,4953,[195 385 185 265 143],207,2,18095,3.6526039563988695,0.0,0.0
14954,1,4954,[191  28 222 568  79],339,4,18099,3.6526740665993946,0.0,0.0
14955,1,4955,[294 182 742 288 186],378,2,18101,3.6523405972558516,0.0,0.0
14956,1,4956,[313 127 187 302 427],13,5,18106,3.6526124672180753,0.0,20.0
14957,1,4957,[211 403 125  71 185],804,4,18110,3.652682533279548,0.0,0.0
14958,1,4958,[313 127 187 302 427],334,5,18115,3.6529542246420648,0.0,20.0
14959,1,4959,[175 385 216 151 603],883,4,18119,3.653024193548387,20.0,0.0
14960,1,4960,[515 357 318  28 182],13,2,18121,3.6526909897198148,40.0,0.0
14961,1,4961,[515 185 235 176 216],271,2,18123,3.65235792019347,0.0,0.0
14962,1,4962,[313 127 187 302 427],90,5,18128,3.6526294579891196,0.0,20.0
14963,1,4963,[313 127 187 302 427],669,5,18133,3.65290088638195,0.0,20.0
14964,1,4964,[ 11 191 196 181 258],455,4,18137,3.652970795568983,0.0,0.0
14965,1,4965,[228 204 403  22  69],883,3,18140,3.652839307289569,0.0,0.0
14966,1,4966,[403 237 289 423  79],13,2,18142,3.652506543185021,0.0,0.0
14967,1,4967,[238 186  98 161  50],749,3,18145,3.652375201288245,0.0,40.0
14968,1,4968,[313 127 187 302 427],669,5,18150,3.652646407727913,0.0,20.0
14969,1,4969,[313 127 187 302 427],474,5,18155,3.652917505030181,0.0,20.0
14970,1,4970,[265 302 194 748   8],328,2,18157,3.652584992959163,0.0,0.0
14971,1,4971,[ 97 508 176   9 546],60,4,18161,3.6526548672566372,0.0,0.0
14972,1,4972,[237  64 282 185 180],804,5,18166,3.652925799316308,0.0,0.0
14973,1,4973,[  4 179   8  11  95],234,2,18168,3.652593486127865,0.0,0.0
14974,1,4974,[ 71 265 185  25  79],59,4,18172,3.6526633165829145,0.0,0.0
14975,1,4975,[135 118  98 117   4],92,4,18176,3.652733118971061,0.0,20.0
14976,1,4976,[  7 222 294 245 117],825,5,18181,3.6530038175607795,0.0,0.0
14977,1,4977,[216  22 182 288 132],215,2,18183,3.6526717557251906,0.0,0.0
14978,1,4978,[  4  95 210  28  70],13,3,18186,3.6525406708174333,0.0,0.0
14979,1,4979,[357 181 176 515 153],406,3,18189,3.652409638554217,20.0,0.0
14980,1,4980,[228 323 405 175 174],13,3,18192,3.6522786589038345,0.0,20.0
14981,1,4981,[118  79 180 215 405],892,5,18197,3.6525491770373346,0.0,0.0
14982,1,4982,[176 174 271  28 302],883,3,18200,3.6524182219546457,0.0,20.0
14983,1,4983,[  4 483 313  15 655],207,5,18205,3.6526886035313,20.0,0.0
14984,1,4984,[228 234 568 111 273],13,3,18208,3.652557673019057,0.0,0.0
14985,1,4985,[313 127 187 302 427],13,5,18213,3.6528279181708783,0.0,20.0
14986,1,4986,[ 56  64 132 515 204],213,5,18218,3.6530980549428516,0.0,0.0
14987,1,4987,[186 323  12 313  50],537,3,18221,3.6529671210906174,20.0,20.0
14988,1,4988,[135 301 435 323 300],13,2,18223,3.652635798757266,0.0,0.0
14989,1,4989,[111 546   9  79 471],378,2,18225,3.652304609218437,0.0,0.0
14990,1,4990,[313 127 187 302 427],90,5,18230,3.652574634341815,0.0,20.0
14991,1,4991,[427 423 153  82 179],85,2,18232,3.65224358974359,0.0,0.0
14992,1,4992,[313 127 187 302  64],90,5,18237,3.6525135189264972,0.0,20.0
14993,1,4993,[333 313  56 257 235],144,3,18240,3.6523828594313175,0.0,0.0
14994,1,4994,[181   9  71 265  28],92,4,18244,3.6524524524524526,0.0,0.0
14995,1,4995,[313 127 187 302  64],90,5,18249,3.6527221777421937,0.0,20.0
14996,1,4996,[313 127 187 302  64],271,5,18254,3.652991795077046,0.0,20.0
14997,1,4997,[200 172 211 185   4],328,4,18258,3.6530612244897958,0.0,0.0
14998,1,4998,[318 245   8  50 100],454,4,18262,3.653130626125225,20.0,40.0
14999,1,4999,[237 197 515 328 182],207,3,18265,3.653,0.0,0.0
15000,1,5000,[313 127 187 302  64],90,5,18270,3.6532693461307737,0.0,20.0
15001,1,5001,[180 546 172 568  79],804,4,18274,3.6533386645341865,0.0,0.0
15002,1,5002,[313 127 187 302  64],537,4,18278,3.653407955226864,0.0,20.0
15003,1,5003,[228 179 211 215 210],13,3,18281,3.653277378097522,0.0,0.0
15004,1,5004,[748 180 235 597 132],447,2,18283,3.652947052947053,0.0,0.0
15005,1,5005,[318   8 121 234 265],64,4,18287,3.6530163803435878,20.0,0.0
15006,1,5006,[237 210  64 187 196],346,3,18290,3.652885959656481,0.0,0.0
15007,1,5007,[161  25  50 175  15],194,2,18292,3.652555910543131,0.0,20.0
15008,1,5008,[195 153 191 172 174],536,5,18297,3.652824915152725,0.0,20.0
15009,1,5009,[ 12 161 175 153 318],334,4,18301,3.652894211576846,40.0,0.0
15010,1,5010,[475 568 180 210 211],13,2,18303,3.6525643584114946,0.0,0.0
15011,1,5011,[135 143   9 273  82],13,1,18304,3.6520351157222666,0.0,0.0
15012,1,5012,[313 127 187 302 483],474,5,18309,3.6523040095751047,20.0,20.0
15013,1,5013,[313 127 187 302 483],13,5,18314,3.652572796170722,20.0,20.0
15014,1,5014,[237 111 234 265 496],524,3,18317,3.6524426719840477,0.0,0.0
15015,1,5015,[200   1 181 186 202],897,3,18320,3.6523125996810206,0.0,0.0
15016,1,5016,[313 127 187 302 483],90,5,18325,3.6525812238389475,20.0,20.0
15017,1,5017,[234 194 117 588 121],13,4,18329,3.65265045834994,0.0,0.0
15018,1,5018,[313 127 187 302 483],334,5,18334,3.652918908149034,20.0,20.0
15019,1,5019,[173  28 237 234 216],59,4,18338,3.652988047808765,0.0,0.0
15020,1,5020,[323 288 328  15 515],537,1,18339,3.652459669388568,0.0,0.0
15021,1,5021,[ 79  12 313 204 215],474,5,18344,3.6527279968140185,20.0,0.0
15022,1,5022,[118 173   1 121 183],374,4,18348,3.652797133187338,0.0,0.0
15023,1,5023,[313 127 187 302 483],13,5,18353,3.6530652866242037,20.0,20.0
15024,1,5024,[ 89 301  95 515 475],334,3,18356,3.6529353233830846,0.0,0.0
15025,1,5025,[257 121 153  69 183],804,5,18361,3.6532033426183843,0.0,0.0
15026,1,5026,[288 117  79   8 273],308,3,18364,3.6530734036204495,0.0,0.0
15027,1,5027,[ 98 197 435 515 176],932,5,18369,3.653341288782816,0.0,20.0
15028,1,5028,[117   8   1 121 289],271,2,18371,3.65301252734142,0.0,0.0
15029,1,5029,[  1 174  64 318 191],465,4,18375,3.6530815109343937,20.0,20.0
15030,1,5030,[168 135 294   7  50],882,5,18380,3.6533492347445837,0.0,20.0
15031,1,5031,[ 95 195 300  22 258],234,1,18381,3.6528219395866453,0.0,0.0
15032,1,5032,[144 289 302 194 117],13,3,18384,3.652692231273594,0.0,0.0
15033,1,5033,[265 172 121 215 182],474,5,18389,3.652959872864521,0.0,0.0
15034,1,5034,[313 127 187 302 483],207,5,18394,3.653227408142999,20.0,20.0
15035,1,5035,[ 79 215 168 183 186],59,5,18399,3.6534948371723592,0.0,0.0
15036,1,5036,[245 257 197 195 318],653,3,18402,3.6533650982727814,20.0,0.0
15037,1,5037,[238 603 182 144 237],454,3,18405,3.653235410877332,20.0,0.0
15038,1,5038,[313 127 187 302 483],328,5,18410,3.6535026791029965,20.0,20.0
15039,1,5039,[313 127 187 302 483],328,5,18415,3.6537698412698414,20.0,20.0
15040,1,5040,[ 70 423 183 197   7],95,5,18420,3.654036897440984,0.0,0.0
15041,1,5041,[313 127 187 302 483],537,5,18425,3.6543038476794925,20.0,20.0
15042,1,5042,[313 127 187 302 483],669,4,18429,3.6543723973825104,20.0,20.0
15043,1,5043,[161 187  82 210 111],59,4,18433,3.6544409199048373,0.0,0.0
15044,1,5044,[ 79 748  95   4 588],64,3,18436,3.654311199207136,0.0,0.0
15045,1,5045,[ 11 475 302 132 143],474,5,18441,3.654577883472057,0.0,0.0
15046,1,5046,[318 357 742 197  64],899,5,18446,3.6548444620566674,40.0,0.0
15047,1,5047,[ 22 215 196  71  12],7,5,18451,3.655110935023772,20.0,0.0
15048,1,5048,[357  96  50   7 238],843,1,18452,3.6545850663497723,20.0,20.0
15049,1,5049,[313 127 187 302 483],328,5,18457,3.654851485148515,20.0,20.0
15050,1,5050,[313 127 187 302 483],334,5,18462,3.6551177984557515,20.0,20.0
15051,1,5051,[313 127 187 302 483],207,5,18467,3.655384006334125,20.0,20.0
15052,1,5052,[  4 423 655 211  69],537,1,18468,3.654858499901049,0.0,0.0
15053,1,5053,[313 127 187 302 483],334,5,18473,3.655124653739612,20.0,20.0
15054,1,5054,[237 180 228 118  56],533,2,18475,3.654797230464886,0.0,0.0
15055,1,5055,[222 515 385  98 286],13,1,18476,3.6542721518987342,0.0,20.0
15056,1,5056,[313 127 187 302 483],207,5,18481,3.6545382637927624,20.0,20.0
15057,1,5057,[313 127 187 302 483],90,5,18486,3.6548042704626336,20.0,20.0
15058,1,5058,[211 748 405 196 183],488,3,18489,3.6546748369242934,0.0,0.0
15059,1,5059,[174 196 204 168 568],738,3,18492,3.6545454545454548,0.0,20.0
15060,1,5060,[ 98 302   9 222 144],788,4,18496,3.654613712704999,0.0,20.0
15061,1,5061,[313 127 187 302 483],13,5,18501,3.654879494271039,20.0,20.0
15062,1,5062,[ 64 471 182 144  25],378,4,18505,3.654947659490421,0.0,0.0
15063,1,5063,[ 96   4 471  79 176],115,3,18508,3.654818325434439,0.0,0.0
15064,1,5064,[405 180 183   7 235],13,2,18510,3.654491609081935,0.0,0.0
15065,1,5065,[313 127 187 302 483],207,5,18515,3.654757204895381,20.0,20.0
15066,1,5066,[313 127 187 302 483],328,5,18520,3.6550226958752714,20.0,20.0
15067,1,5067,[273 100 301 195  88],234,1,18521,3.654498816101026,0.0,20.0
15068,1,5068,[313 127 187 302 483],537,5,18526,3.6547642533043994,20.0,20.0
15069,1,5069,[174  56 204 597 185],833,2,18528,3.6544378698224853,0.0,20.0
15070,1,5070,[ 82 322 603 237   7],234,1,18529,3.6539144153027014,20.0,0.0
15071,1,5071,[216 423 603  64  82],533,5,18534,3.654179810725552,20.0,0.0
15072,1,5072,[222  50 210 153 191],295,5,18539,3.6544451015178394,0.0,20.0
15073,1,5073,[471 228 143 403 200],313,1,18540,3.6539219550650373,0.0,0.0
15074,1,5074,[471 245 294 328 301],378,0,18540,3.65320197044335,0.0,0.0
15075,1,5075,[275 174 216 268 176],145,4,18544,3.653270291568164,0.0,20.0
15076,1,5076,[748  11 288 100 197],64,3,18547,3.653141619066378,0.0,20.0
15077,1,5077,[435 405 235 179 174],524,3,18550,3.653012997243009,0.0,20.0
15078,1,5078,[273 174 294  56 117],92,4,18554,3.6530813152195316,0.0,20.0
15079,1,5079,[ 69 427 135 100 172],379,5,18559,3.6533464566929132,0.0,20.0
15080,1,5080,[216 211 357  95 294],650,3,18562,3.6532178704979335,20.0,0.0
15081,1,5081,[204  96 132 234 275],843,1,18563,3.6526957890594254,0.0,0.0
15082,1,5082,[385 222 135 265  71],899,4,18567,3.652764115679717,0.0,0.0
15083,1,5083,[182 742 211  95  11],59,3,18570,3.6526357199055863,0.0,0.0
15084,1,5084,[385 175 222  88 403],881,2,18572,3.6523107177974437,0.0,0.0
15085,1,5085,[  7 237 195  79 183],308,4,18576,3.652379079826976,0.0,0.0
15086,1,5086,[186 111 475 333 180],537,3,18579,3.6522508354629446,0.0,0.0
15087,1,5087,[515  89 172  71 313],234,2,18581,3.651926100628931,0.0,0.0
15088,1,5088,[313 127 187 302 483],207,5,18586,3.652191000196502,20.0,20.0
15089,1,5089,[183 179 228 187 237],664,3,18589,3.6520628683693515,0.0,0.0
15090,1,5090,[194 186 269  56 588],378,4,18593,3.6521312119426437,0.0,0.0
15091,1,5091,[237  11 202  96 568],804,5,18598,3.652395915161037,0.0,0.0
15092,1,5092,[313 127 187 302 483],328,5,18603,3.652660514431573,20.0,20.0
15093,1,5093,[ 95 183 258 302 185],380,5,18608,3.652925009815469,0.0,0.0
15094,1,5094,[273 423 151 100 197],537,2,18610,3.6526005888125614,0.0,20.0
15095,1,5095,[ 82 471 127 228 385],234,1,18611,3.6520800627943486,0.0,20.0
15096,1,5096,[357 172 403 194 127],749,5,18616,3.6523445163821857,20.0,20.0
15097,1,5097,[  1 265 144 215 195],653,3,18619,3.6522165555119654,0.0,0.0
15098,1,5098,[100 183  69 195 515],833,3,18622,3.65208864483232,0.0,20.0
15099,1,5099,[313 127 187 302 483],328,5,18627,3.6523529411764706,20.0,20.0
15100,1,5100,[179  15 546 269 144],650,1,18628,3.651832973926681,0.0,0.0
15101,1,5101,[313 127 187 302 483],328,5,18633,3.6520972167777344,20.0,20.0
15102,1,5102,[655 200 100 265 176],7,4,18637,3.6521653929061335,0.0,20.0
15103,1,5103,[313 127 187 302 483],669,4,18641,3.6522335423197494,20.0,20.0
15104,1,5104,[403 151 135 257 323],378,2,18643,3.6519098922624877,0.0,0.0
15105,1,5105,[475 300  25 191 211],13,1,18644,3.6513905209557382,0.0,0.0
15106,1,5106,[180 234 135 405 173],92,3,18647,3.6512629723908363,0.0,0.0
15107,1,5107,[427 143 204 186 483],125,4,18651,3.6513312451057165,20.0,0.0
15108,1,5108,[ 25  64  97 211 172],7,4,18655,3.6513994910941476,0.0,0.0
15109,1,5109,[257 385 294 132 423],533,5,18660,3.6516634050880628,0.0,0.0
15110,1,5110,[313 127 187 302 483],13,5,18665,3.6519272158090392,20.0,20.0
15111,1,5111,[195 161 144 228 222],194,2,18667,3.65160406885759,0.0,0.0
15112,1,5112,[ 28 200 403  71 515],899,3,18670,3.6514766282026208,0.0,0.0
15113,1,5113,[427  11 215  89   8],343,4,18674,3.651544779037935,0.0,0.0
15114,1,5114,[276   8 168 216  11],308,4,18678,3.6516129032258067,0.0,0.0
15115,1,5115,[ 88  22 176 151 111],653,1,18679,3.6510946051602815,0.0,0.0
15116,1,5116,[313 127 187 302 427],537,5,18684,3.651358217705687,0.0,20.0
15117,1,5117,[172 210 187  12  28],537,1,18685,3.650840171942165,20.0,0.0
15118,1,5118,[175 143 300 185 111],479,3,18688,3.6507130298886503,0.0,0.0
15119,1,5119,[ 97 357 174 427 742],313,4,18692,3.65078125,20.0,20.0
15120,1,5120,[265 180 222  71 173],897,3,18695,3.650654169107596,0.0,0.0
15121,1,5121,[132 135 211  64 210],308,4,18699,3.650722374072628,0.0,0.0
15122,1,5122,[276 603 515 403  25],234,2,18701,3.6504001561585007,20.0,0.0
15123,1,5123,[194 211 237 483 144],666,2,18703,3.65007806401249,20.0,0.0
15124,1,5124,[ 69 357  56 238  71],148,5,18708,3.6503414634146343,20.0,0.0
15125,1,5125,[ 95  97 111 234 289],234,2,18710,3.650019508388607,0.0,0.0
15126,1,5126,[183 143 294 588 222],881,3,18713,3.649892724790326,0.0,0.0
15127,1,5127,[313 127 187 302 427],537,5,18718,3.6501560062402496,0.0,20.0
15128,1,5128,[313 127 187 302 427],90,5,18723,3.650419185026321,0.0,20.0
15129,1,5129,[313 135  28 211 357],474,5,18728,3.650682261208577,20.0,0.0
15130,1,5130,[118  15 655 125 568],311,4,18732,3.65075034106412,0.0,0.0
15131,1,5131,[313 127 187 302 427],328,4,18736,3.650818394388153,0.0,20.0
15132,1,5132,[  9  82 275 135 161],10,5,18741,3.6510812390414964,0.0,0.0
15133,1,5133,[ 88 546 174 168 265],343,3,18744,3.650954421503701,0.0,20.0
15134,1,5134,[161 603  79  50  56],308,4,18748,3.651022395326193,20.0,20.0
15135,1,5135,[ 97  12 204  50 194],380,3,18751,3.6508956386292835,20.0,20.0
15136,1,5136,[ 88 132 508 202 265],326,3,18754,3.6507689312828497,0.0,0.0
15137,1,5137,[127 132 268 200  70],6,2,18756,3.650447644998054,0.0,20.0
15138,1,5138,[276 289 288 742 405],92,1,18757,3.6499318933644678,0.0,0.0
15139,1,5139,[245 204   8   7 132],378,4,18761,3.65,0.0,0.0
15140,1,5140,[289  25  69 234  70],85,3,18764,3.649873565454192,0.0,0.0
15141,1,5141,[275 216 273 183 427],7,4,18768,3.649941656942824,0.0,0.0
15142,1,5142,[ 50 197 135 588 175],189,5,18773,3.650204160995528,0.0,20.0
15143,1,5143,[405  15 318   9 435],271,3,18776,3.650077760497667,20.0,0.0
15144,1,5144,[183 185  95 125 202],804,4,18780,3.6501457725947524,0.0,0.0
15145,1,5145,[313 127 187 302 603],90,5,18785,3.650408083948698,20.0,20.0
15146,1,5146,[ 28 275 496 210  56],648,4,18789,3.650476005440062,0.0,0.0
15147,1,5147,[121 195 238  96  97],454,4,18793,3.6505439005439007,0.0,0.0
15148,1,5148,[181  79 302 153 655],13,4,18797,3.6506117692755873,0.0,0.0
15149,1,5149,[313 127 187 302 603],13,5,18802,3.650873786407767,20.0,20.0
15150,1,5150,[222 597 211 195 269],102,1,18803,3.650359153562415,0.0,0.0
15151,1,5151,[515 144 588  89 151],899,1,18804,3.6498447204968945,0.0,0.0
15152,1,5152,[313 127 187 302 603],271,5,18809,3.6501067339413935,20.0,20.0
15153,1,5153,[313 127 187 302 603],116,3,18812,3.6499805975941015,20.0,20.0
15154,1,5154,[153 357  82 204 508],339,4,18816,3.650048496605238,20.0,0.0
15155,1,5155,[742 323 234 289 568],378,4,18820,3.6501163692785106,0.0,0.0
15156,1,5156,[ 97 588   4 181 132],326,3,18823,3.6499903044405664,0.0,0.0
15157,1,5157,[204 300 265  82 187],892,4,18827,3.650058162078325,0.0,0.0
15158,1,5158,[515 328  25 186  88],207,3,18830,3.649932157394844,0.0,0.0
15159,1,5159,[313 127 187 302 483],474,5,18835,3.6501937984496124,20.0,20.0
15160,1,5160,[ 95 194 238  89 471],524,4,18839,3.650261577213718,0.0,0.0
15161,1,5161,[496 182  79 265 181],378,4,18843,3.650329329717164,0.0,0.0
15162,1,5162,[ 70 258 300 568  95],64,3,18846,3.650203370133643,0.0,0.0
15163,1,5163,[282 179 111 235  96],643,4,18850,3.650271107668474,0.0,0.0
15164,1,5164,[678 195 603 288 191],13,1,18851,3.649757986447241,20.0,0.0
15165,1,5165,[427 323 174 288 276],374,3,18854,3.6496322106078205,0.0,20.0
15166,1,5166,[211 405 276 179 175],406,4,18858,3.64970001935359,0.0,0.0
15167,1,5167,[313 127 187 302 483],474,5,18863,3.6499613003095974,20.0,20.0
15168,1,5168,[257 286 187 197 265],161,0,18863,3.649255175082221,0.0,0.0
15169,1,5169,[172 176 328 216 117],378,3,18866,3.6491295938104447,0.0,0.0
15170,1,5170,[234 302 328 191 211],833,1,18867,3.648617288725585,0.0,0.0
15171,1,5171,[313 127 187 302 483],90,5,18872,3.6488785769528227,20.0,20.0
15172,1,5172,[118   9  89 300 100],788,4,18876,3.648946452735357,0.0,20.0
15173,1,5173,[423 282 265 181 197],533,4,18880,3.649014302280634,0.0,0.0
15174,1,5174,[313 127 187 302 483],207,5,18885,3.6492753623188405,20.0,20.0
15175,1,5175,[132  98  64 269 121],537,0,18885,3.6485703245749614,0.0,20.0
15176,1,5176,[ 28 179 286 182 597],378,3,18888,3.648445045393085,0.0,0.0
15177,1,5177,[181 313 288 268 403],92,4,18892,3.6485129393588256,0.0,0.0
15178,1,5178,[313 127 187 302 483],669,4,18896,3.6485808071056187,20.0,20.0
15179,1,5179,[ 95 204 186 405  12],378,3,18899,3.6484555984555986,20.0,0.0
15180,1,5180,[176 197 135  56 179],343,5,18904,3.6487164640030882,0.0,0.0
15181,1,5181,[215 174  56  95 546],882,4,18908,3.6487842531840986,0.0,20.0
15182,1,5182,[  8 234 655 568 117],313,4,18912,3.64885201620683,0.0,0.0
15183,1,5183,[ 11 748   7 216 135],92,3,18915,3.6487268518518516,0.0,0.0
15184,1,5184,[300 603 357 183 127],840,4,18919,3.648794599807136,40.0,20.0
15185,1,5185,[172 286 153 435 151],406,2,18921,3.648476667952179,0.0,0.0
15186,1,5186,[ 96 168  28 508 180],527,3,18924,3.6483516483516483,0.0,0.0
15187,1,5187,[132  28 273 435 427],234,3,18927,3.6482266769468,0.0,0.0
15188,1,5188,[228  50 127 471 202],343,5,18932,3.648487184428599,0.0,40.0
15189,1,5189,[125 300 100 200 127],455,4,18936,3.648554913294798,0.0,40.0
15190,1,5190,[313 127 187 302 483],13,5,18941,3.6488152571758814,20.0,20.0
15191,1,5191,[245 323 151  56 546],804,2,18943,3.648497688751926,0.0,0.0
15192,1,5192,[  7 135 196 172 475],387,3,18946,3.648372809551319,0.0,0.0
15193,1,5193,[175 172 228 144 302],883,5,18951,3.648633038120909,0.0,0.0
15194,1,5194,[ 64 181 475 173 168],92,4,18955,3.6487006737247354,0.0,0.0
15195,1,5195,[300 323 127  89 144],13,3,18958,3.6485758275596614,0.0,20.0
15196,1,5196,[313 127 187 302 483],13,5,18963,3.6488358668462575,20.0,20.0
15197,1,5197,[187 180  64 496 191],194,4,18967,3.6489034243939975,0.0,0.0
15198,1,5198,[216 195   8 508 185],13,1,18968,3.6483939219080592,0.0,0.0
15199,1,5199,[183 748  28 200 191],653,4,18972,3.6484615384615386,0.0,0.0
15200,1,5200,[ 25 403 328  56 183],749,4,18976,3.6485291290136512,0.0,0.0
15201,1,5201,[234 183  25 275 496],458,3,18979,3.648404459823145,0.0,0.0
15202,1,5202,[655 144 173  96 357],454,2,18981,3.648087641745147,20.0,0.0
15203,1,5203,[313 127 187 302 483],90,5,18986,3.648347425057648,20.0,20.0
15204,1,5204,[300 151 245 174 273],378,3,18989,3.6482228626320845,0.0,20.0
15205,1,5205,[313 127 187 302 483],474,5,18994,3.648482520169036,20.0,20.0
15206,1,5206,[275 508 127 143  70],334,2,18996,3.6481659304782026,0.0,20.0
15207,1,5207,[313 127 187 302 483],90,5,19001,3.648425499231951,20.0,20.0
15208,1,5208,[132  56 276  22 172],119,4,19005,3.648492992896909,0.0,0.0
15209,1,5209,[151 135 655 234 132],64,4,19009,3.648560460652591,0.0,0.0
15210,1,5210,[423  89 183   9 204],749,4,19013,3.648627902513913,0.0,0.0
15211,1,5211,[ 64  79 202 100 423],387,2,19015,3.6483115886415964,0.0,20.0
15212,1,5212,[357 228  50 127 655],95,5,19020,3.64857088049108,20.0,40.0
15213,1,5213,[301 275   7 216 215],524,2,19022,3.64825469888761,0.0,0.0
15214,1,5214,[180 318 100 216  96],804,5,19027,3.6485139022051776,20.0,20.0
15215,1,5215,[313 127 187 302 483],669,4,19031,3.6485812883435584,20.0,20.0
15216,1,5216,[161 191  96 187  70],474,5,19036,3.6488403296913936,0.0,0.0
15217,1,5217,[313 127 187 302 483],669,4,19040,3.648907627443465,20.0,20.0
15218,1,5218,[144 210 423 655  96],843,0,19040,3.6482084690553744,0.0,0.0
15219,1,5219,[313 127 187 302 603],669,5,19045,3.6484674329501914,20.0,20.0
15220,1,5220,[313 127 187 302 603],90,5,19050,3.6487262976441293,20.0,20.0
15221,1,5221,[313 127 187 302 603],116,3,19053,3.6486020681731137,20.0,20.0
15222,1,5222,[216 186  56 234   4],643,5,19058,3.648860807964771,0.0,0.0
15223,1,5223,[ 12 194 173  28 475],207,2,19060,3.6485451761102605,20.0,0.0
15224,1,5224,[143 546 385 204 173],804,3,19063,3.648421052631579,0.0,0.0
15225,1,5225,[216 286 172 153 300],666,2,19065,3.648105625717566,0.0,0.0
15226,1,5226,[197  12 475 318  69],527,3,19068,3.6479816338243736,40.0,0.0
15227,1,5227,[546 228 211 127 194],87,4,19072,3.6480489671002294,0.0,20.0
15228,1,5228,[313 127 187 302 483],474,5,19077,3.6483075157773954,20.0,20.0
15229,1,5229,[  9 176 121 200  79],815,4,19081,3.648374760994264,0.0,0.0
15230,1,5230,[127 597 118 323   7],386,2,19083,3.648059644427452,0.0,20.0
15231,1,5231,[202 265 183  50 546],7,4,19087,3.648126911314985,0.0,20.0
15232,1,5232,[176   8 151  22  95],308,5,19092,3.6483852474679916,0.0,0.0
15233,1,5233,[313 127 187 302 483],669,4,19096,3.6484524264424913,20.0,20.0
15234,1,5234,[181 183 175 275 216],843,2,19098,3.648137535816619,0.0,0.0
15235,1,5235,[313 127 187 302 483],669,4,19102,3.6482047364400305,20.0,20.0
15236,1,5236,[313 127 187 302 483],669,4,19106,3.6482719113996565,20.0,20.0
15237,1,5237,[ 50 151   4  15 568],59,5,19111,3.6485299732722414,0.0,20.0
15238,1,5238,[302 323 313 328 153],13,3,19114,3.6484061843863334,0.0,0.0
15239,1,5239,[313 127 187 302 483],669,4,19118,3.648473282442748,20.0,20.0
15240,1,5240,[ 98 117  25  11 357],271,3,19121,3.648349551612288,20.0,20.0
15241,1,5241,[515  15  96 282 275],474,4,19125,3.648416634872186,0.0,0.0
15242,1,5242,[289   9 181 175 187],334,4,19129,3.6484836925424373,0.0,0.0
15243,1,5243,[180 194 100  69 127],694,5,19134,3.648741418764302,0.0,40.0
15244,1,5244,[186 289 135 172 202],378,2,19136,3.648427073403241,0.0,0.0
15245,1,5245,[180 273 603 405 258],537,3,19139,3.6483034693099503,20.0,0.0
15246,1,5246,[195  11 185 423 328],653,2,19141,3.6479893272346104,0.0,0.0
15247,1,5247,[313 127 187 302 603],474,5,19146,3.6482469512195124,20.0,20.0
15248,1,5248,[ 50  56 186  70  12],374,4,19150,3.648313964564679,20.0,20.0
15249,1,5249,[143 597   7   4  97],653,1,19151,3.647809523809524,0.0,0.0
15250,1,5250,[313 127 187 302 603],537,5,19156,3.648067034850505,20.0,20.0
15251,1,5251,[294 678 179 286 222],537,1,19157,3.6475628332063974,0.0,0.0
15252,1,5252,[127 286 195 179 202],379,4,19161,3.6476299257567106,0.0,20.0
15253,1,5253,[546 603  89 125 597],899,2,19163,3.647316330414922,20.0,0.0
15254,1,5254,[313 127 187 302 603],334,5,19168,3.6475737392959084,20.0,20.0
15255,1,5255,[238 302  25 471 135],13,2,19170,3.6472602739726026,0.0,0.0
15256,1,5256,[313 127 187 302 603],116,3,19173,3.6471371504660453,20.0,20.0
15257,1,5257,[  9 161 302 515 405],13,2,19175,3.6468238874096617,0.0,0.0
15258,1,5258,[313 127 187 302 191],90,5,19180,3.6470811941433734,0.0,20.0
15259,1,5259,[318  50  71 294 197],804,5,19185,3.647338403041825,20.0,20.0
15260,1,5260,[313 127 187 302 191],207,5,19190,3.647595514160806,0.0,20.0
15261,1,5261,[294 678 187 222 288],537,1,19191,3.64709236031927,0.0,0.0
15262,1,5262,[161 405  71  22 153],184,1,19192,3.6465893976819306,0.0,0.0
15263,1,5263,[ 15 357 237 302  50],144,4,19196,3.646656534954407,20.0,20.0
15264,1,5264,[121 143 125 234 328],804,4,19200,3.646723646723647,0.0,0.0
15265,1,5265,[ 88 210 204 282 179],200,5,19205,3.646980630459552,0.0,0.0
15266,1,5266,[100 483 222 202 168],881,4,19209,3.6470476552116953,20.0,20.0
15267,1,5267,[211 385 496 176 117],387,1,19210,3.646545178435839,0.0,0.0
15268,1,5268,[185 289 127  97 174],881,3,19213,3.6464224710571265,0.0,40.0
15269,1,5269,[194 603 265 161 196],474,5,19218,3.6466793168880454,20.0,0.0
15270,1,5270,[276 216 121 427  98],374,4,19222,3.646746347941567,0.0,20.0
15271,1,5271,[ 98 385 210  70  96],207,1,19223,3.6462443095599393,0.0,20.0
15272,1,5272,[100 186 132 588 179],10,5,19228,3.6465010430494975,0.0,20.0
15273,1,5273,[118 323 427 194 127],669,2,19230,3.646188850967008,0.0,20.0
15274,1,5274,[748  98  11 322  88],454,2,19232,3.6458767772511846,0.0,20.0
15275,1,5275,[423 211 144 187  79],313,5,19237,3.6461334344200154,0.0,0.0
15276,1,5276,[313 127 187 302 191],207,5,19242,3.646389994314952,0.0,20.0
15277,1,5277,[173  22 435 210 151],650,2,19244,3.6460780598711633,0.0,0.0
15278,1,5278,[294  28 182 176 172],774,2,19246,3.6457662436067437,0.0,0.0
15279,1,5279,[187 194 211 161   9],694,5,19251,3.6460227272727272,0.0,0.0
15280,1,5280,[313 127 187 302 191],537,5,19256,3.6462791138042037,0.0,20.0
15281,1,5281,[ 28   9 435  15 174],648,3,19259,3.6461567588034836,0.0,20.0
15282,1,5282,[313 127 187 302 191],144,4,19263,3.6462237365133445,0.0,20.0
15283,1,5283,[313 127 187 302 191],116,4,19267,3.6462906888720665,0.0,20.0
15284,1,5284,[496 174  96 515  98],452,4,19271,3.64635761589404,0.0,40.0
15285,1,5285,[ 12 423 318 179 483],343,5,19276,3.6466136965569427,60.0,0.0
15286,1,5286,[222 182 322 194 603],454,1,19277,3.64611310762247,20.0,0.0
15287,1,5287,[313 127 187 302 191],537,5,19282,3.6463691376701965,0.0,20.0
15288,1,5288,[313 127 187 302 191],90,5,19287,3.6466250709018717,0.0,20.0
15289,1,5289,[313 127 187 302 191],271,5,19292,3.6468809073724007,0.0,20.0
15290,1,5290,[182 471 234 183 301],13,3,19295,3.646758646758647,0.0,0.0
15291,1,5291,[117  12 483 515  96],13,3,19298,3.646636432350718,40.0,0.0
15292,1,5292,[191 204 215 423 234],506,5,19303,3.64689212167013,0.0,0.0
15293,1,5293,[313 127 187 302 191],116,4,19307,3.64695882130714,0.0,20.0
15294,1,5294,[181 143 313 135  88],474,5,19312,3.6472143531633616,0.0,0.0
15295,1,5295,[194 286 179  70 483],474,5,19317,3.6474697885196377,20.0,0.0
15296,1,5296,[143  28 180 161 215],194,2,19319,3.647158769114593,0.0,0.0
15297,1,5297,[132 403 742 121 423],533,4,19323,3.6472253680634203,0.0,0.0
15298,1,5298,[475 302 185 202 269],90,3,19326,3.6471032270239667,0.0,0.0
15299,1,5299,[313 127 187 302 191],90,5,19331,3.6473584905660377,0.0,20.0
15300,1,5300,[273 427 403 211 508],833,1,19332,3.646859083191851,0.0,0.0
15301,1,5301,[  4 276 300 204 496],271,3,19335,3.6467370803470387,0.0,0.0
15302,1,5302,[235 186   8   1 496],343,5,19340,3.646992268527249,0.0,0.0
15303,1,5303,[403 258  98 216 161],7,4,19344,3.6470588235294117,0.0,20.0
15304,1,5304,[127 318 588 286 655],479,3,19347,3.64693685202639,20.0,20.0
15305,1,5305,[  1 588 655 174 111],398,4,19351,3.647003392385978,0.0,20.0
15306,1,5306,[ 64 238 100   9 135],378,3,19354,3.64688147729414,0.0,20.0
15307,1,5307,[216   4  28 186  11],308,3,19357,3.646759608138659,0.0,0.0
15308,1,5308,[258 471 185 168 200],815,2,19359,3.6464494255038615,0.0,0.0
15309,1,5309,[313 127 187 302 191],271,5,19364,3.646704331450094,0.0,20.0
15310,1,5310,[313 127 187 302 191],90,5,19369,3.646959141404632,0.0,20.0
15311,1,5311,[  9 435 168 403 282],533,4,19373,3.6470256024096384,0.0,0.0
15312,1,5312,[ 88 183  28 143   8],474,5,19378,3.6472802559759083,0.0,0.0
15313,1,5313,[237 568 132 302 357],343,4,19382,3.64734663153933,20.0,0.0
15314,1,5314,[313 127 187 302 191],334,5,19387,3.647601128880527,0.0,20.0
15315,1,5315,[313 127 187 302 191],334,5,19392,3.6478555304740405,0.0,20.0
15316,1,5316,[333 258 161 168 216],64,2,19394,3.647545608425804,0.0,0.0
15317,1,5317,[172 111  69  12  15],901,4,19398,3.64761188416698,20.0,0.0
15318,1,5318,[ 15 215 282  97 318],311,5,19403,3.647866140251927,20.0,0.0
15319,1,5319,[288  98 289  95 196],334,2,19405,3.6475563909774436,0.0,20.0
15320,1,5320,[174 135 173 117 515],271,4,19409,3.6476226273256906,0.0,20.0
15321,1,5321,[173  64 191  82 176],125,5,19414,3.6478767380683954,0.0,0.0
15322,1,5322,[121 405  50   9  89],474,5,19419,3.648130753334586,0.0,20.0
15323,1,5323,[313 127 187 302 191],334,5,19424,3.648384673178062,0.0,20.0
15324,1,5324,[313 127 187 302 191],334,5,19429,3.6486384976525823,0.0,20.0
15325,1,5325,[202 228  64 742 322],881,4,19433,3.648704468644386,0.0,0.0
15326,1,5326,[313 127 187 302 191],207,5,19438,3.648958137788624,0.0,20.0
15327,1,5327,[204 318 222 174 180],311,5,19443,3.6492117117117115,20.0,20.0
15328,1,5328,[313 127 187 302 191],271,5,19448,3.6494651904672546,0.0,20.0
15329,1,5329,[121 228 265  79 234],479,5,19453,3.649718574108818,0.0,0.0
15330,1,5330,[313 127 187 302 191],90,5,19458,3.649971862689927,0.0,20.0
15331,1,5331,[423 194 288 187 546],64,4,19462,3.6500375093773445,0.0,0.0
15332,1,5332,[173 143   1 100 301],537,2,19464,3.6497281080067503,0.0,20.0
15333,1,5333,[121 323 257 300 275],548,4,19468,3.649793775778028,0.0,0.0
15334,1,5334,[144 423   1 187 180],749,4,19472,3.649859418931584,0.0,0.0
15335,1,5335,[475 288 143 194 216],308,4,19476,3.6499250374812595,0.0,0.0
15336,1,5336,[313 127 187 302 191],90,5,19481,3.6501780026231967,0.0,20.0
15337,1,5337,[328  98 161 405 172],328,5,19486,3.650430872986137,0.0,20.0
15338,1,5338,[196  70  50  15 125],533,5,19491,3.6506836486233376,0.0,20.0
15339,1,5339,[313 127 187 302 191],669,4,19495,3.650749063670412,0.0,20.0
15340,1,5340,[313 127 187 302 191],90,5,19500,3.6510016850777007,0.0,20.0
15341,1,5341,[200  25 127 597 235],308,3,19503,3.6508798202920256,0.0,20.0
15342,1,5342,[313 127 187 302 191],13,4,19507,3.650945161894067,0.0,20.0
15343,1,5343,[288 588 508  56   4],144,4,19511,3.6510104790419162,0.0,0.0
15344,1,5344,[288  25 471  12  28],447,5,19516,3.651262862488307,20.0,0.0
15345,1,5345,[405 173 197 282 176],666,3,19519,3.651141040029929,0.0,0.0
15346,1,5346,[143 181 173  64 238],125,4,19523,3.651206283897513,0.0,0.0
15347,1,5347,[235 204  96   8 238],479,4,19527,3.651271503365744,0.0,0.0
15348,1,5348,[182 235 515   9 172],271,3,19530,3.651149747616377,0.0,0.0
15349,1,5349,[161 187 265 237  82],13,4,19534,3.651214953271028,0.0,0.0
15350,1,5350,[222 118 228 288  28],13,3,19537,3.6510932535974585,0.0,0.0
15351,1,5351,[313 127 187 302 191],207,5,19542,3.651345291479821,0.0,20.0
15352,1,5352,[313 127 187 302 191],207,5,19547,3.6515972351952177,0.0,20.0
15353,1,5353,[216 175 118 210 195],749,3,19550,3.65147553231229,0.0,0.0
15354,1,5354,[ 69  50 216  88 300],653,3,19553,3.6513538748832866,0.0,20.0
15355,1,5355,[181 568 245 302  64],328,4,19557,3.6514189693801344,0.0,0.0
15356,1,5356,[ 11   8 471 655 597],7,3,19560,3.6512973679298115,0.0,0.0
15357,1,5357,[655 475 204 135 423],537,2,19562,3.6509891750653227,0.0,0.0
15358,1,5358,[313 127 187 302 191],537,5,19567,3.6512409031535733,0.0,20.0
15359,1,5359,[ 70 294 132 269  22],119,2,19569,3.6509328358208957,0.0,0.0
15360,1,5360,[483 427 655 172  89],194,3,19572,3.650811415780638,20.0,0.0
15361,1,5361,[  1 405 143   8 173],189,4,19576,3.650876538604998,0.0,0.0
15362,1,5362,[313 127 187 302 191],537,5,19581,3.651128099944061,0.0,20.0
15363,1,5363,[ 97 173 276 286 210],378,5,19586,3.6513795674869503,0.0,0.0
15364,1,5364,[204 228 174 238 318],387,3,19589,3.6512581547064307,20.0,20.0
15365,1,5365,[135 588 100 228 216],13,4,19593,3.651323145732389,0.0,20.0
15366,1,5366,[318 153 269 127  69],883,3,19596,3.651201788708776,20.0,20.0
15367,1,5367,[435 423 215 471 168],234,1,19597,3.6507078986587183,0.0,0.0
15368,1,5368,[405 181 144 282 322],374,4,19601,3.650772955857702,0.0,0.0
15369,1,5369,[202 568 588 423 153],892,5,19606,3.651024208566108,0.0,0.0
15370,1,5370,[269 288 257  64 423],339,3,19609,3.650902997579594,0.0,0.0
15371,1,5371,[313 127 187 302 191],207,5,19614,3.6511541325390917,0.0,20.0
15372,1,5372,[515 471 211   9 237],6,3,19617,3.651032942490229,0.0,0.0
15373,1,5373,[748 100 195 435  22],454,4,19621,3.6510978786751025,0.0,20.0
15374,1,5374,[313 127 187 302 191],207,5,19626,3.6513488372093024,0.0,20.0
15375,1,5375,[655 185   9 302  98],474,5,19631,3.6515997023809526,0.0,20.0
15376,1,5376,[185 211 288 265 216],666,2,19633,3.651292542309838,0.0,0.0
15377,1,5377,[313 127 187 302 191],474,5,19638,3.651543324656006,0.0,20.0
15378,1,5378,[186 322  64 655   4],474,5,19643,3.651794013757204,0.0,0.0
15379,1,5379,[235 318 423 427  64],313,4,19647,3.6518587360594794,20.0,0.0
15380,1,5380,[ 71 234 127  82 333],64,2,19649,3.651551756179149,0.0,20.0
15381,1,5381,[265   1 186 153 238],804,5,19654,3.651802303976217,0.0,0.0
15382,1,5382,[313 127 187 302 191],90,5,19659,3.652052758684748,0.0,20.0
15383,1,5383,[172  71 179 196 185],694,5,19664,3.652303120356612,0.0,0.0
15384,1,5384,[228 172 185 173  69],234,1,19665,3.651810584958217,0.0,0.0
15385,1,5385,[ 95 168 427 313 121],13,5,19670,3.6520608986260674,0.0,0.0
15386,1,5386,[186 175 238  64 151],653,2,19672,3.651754223129757,0.0,0.0
15387,1,5387,[  9 234 300 135 235],328,3,19675,3.6516332590942837,0.0,0.0
15388,1,5388,[471 385 182 318  89],313,5,19680,3.651883466320282,20.0,0.0
15389,1,5389,[ 95 318   8 275 195],308,5,19685,3.6521335807050095,20.0,0.0
15390,1,5390,[172 200 211  71 185],325,2,19687,3.651827119272862,0.0,0.0
15391,1,5391,[ 50 179  22 318 313],13,3,19690,3.651706231454006,20.0,20.0
15392,1,5392,[313 127 187 302 191],334,5,19695,3.6519562395698126,0.0,20.0
15393,1,5393,[313 127 187 302 191],537,5,19700,3.652206154987023,0.0,20.0
15394,1,5394,[313 127 187 302 191],537,5,19705,3.6524559777571826,0.0,20.0
15395,1,5395,[151  79 161 435  71],59,3,19708,3.652335063009637,0.0,0.0
15396,1,5396,[333 196 313  56 194],533,4,19712,3.6523994811932554,0.0,0.0
15397,1,5397,[ 69  96 186  25 204],749,5,19717,3.6526491293071506,0.0,0.0
15398,1,5398,[100 179 427  98 508],339,5,19722,3.652898684941656,0.0,40.0
15399,1,5399,[ 95  82 238 655 174],738,4,19726,3.6529629629629627,0.0,20.0
15400,1,5400,[186 179 118 403 200],378,2,19728,3.6526569153860398,0.0,0.0
15401,1,5401,[313 127 187 302 191],474,5,19733,3.6529063309885226,0.0,20.0
15402,1,5402,[ 71 228 405 196  89],64,2,19735,3.6526004071811955,0.0,0.0
15403,1,5403,[ 69 294 357 200  28],537,1,19736,3.6521095484826054,20.0,0.0
15404,1,5404,[175 265 174 181  25],881,3,19739,3.6519888991674376,0.0,20.0
15405,1,5405,[100  28   9 172 238],308,4,19743,3.6520532741398446,0.0,20.0
15406,1,5406,[313 127 187 302 191],474,5,19748,3.652302570741631,0.0,20.0
15407,1,5407,[153 328 273 144 176],749,5,19753,3.652551775147929,0.0,0.0
15408,1,5408,[ 69 185   9 273 202],308,3,19756,3.652431133296358,0.0,0.0
15409,1,5409,[313 127 187 302 191],669,4,19760,3.6524953789279113,0.0,20.0
15410,1,5410,[257 181 515 173 144],899,1,19761,3.652005174644243,0.0,0.0
15411,1,5411,[286 176 185  11 216],666,4,19765,3.6520694752402068,0.0,0.0
15412,1,5412,[483 183  15 161 153],479,3,19768,3.6519490116386475,20.0,0.0
15413,1,5413,[269 182 210  69 111],666,2,19770,3.6516438862209086,0.0,0.0
15414,1,5414,[ 22 174 496 268 276],664,3,19773,3.6515235457063713,0.0,20.0
15415,1,5415,[144 118 181 655 132],308,2,19775,3.651218611521418,0.0,0.0
15416,1,5416,[313 127 187 302 191],669,4,19779,3.6512829979693557,0.0,20.0
15417,1,5417,[435 196 273 175 483],234,1,19780,3.6507936507936507,20.0,0.0
15418,1,5418,[183 187 357 385 211],766,4,19784,3.6508580918988742,20.0,0.0
15419,1,5419,[ 98  25 121 515 211],882,4,19788,3.6509225092250923,0.0,20.0
15420,1,5420,[ 89 265 508 173 258],92,4,19792,3.650986902785464,0.0,0.0
15421,1,5421,[ 71   8 742  97 118],881,4,19796,3.651051272593139,0.0,0.0
15422,1,5422,[185 200 273 427  97],537,2,19798,3.650746819103817,0.0,0.0
15423,1,5423,[257 194 118  50 322],804,5,19803,3.650995575221239,0.0,20.0
15424,1,5424,[  7 174 118  71  69],648,2,19805,3.6506912442396313,0.0,20.0
15425,1,5425,[546 179 181 273 144],87,3,19808,3.6505713232583856,0.0,0.0
15426,1,5426,[144  25 153 273 183],207,3,19811,3.650451446471347,0.0,0.0
15427,1,5427,[313 127 187 302  64],537,4,19815,3.6505158437730287,0.0,20.0
15428,1,5428,[257 196 483 187 237],749,2,19817,3.6502118253822067,20.0,0.0
15429,1,5429,[  7 655   4 196 186],339,5,19822,3.650460405156538,0.0,0.0
15430,1,5430,[313 127 187 302 483],13,5,19827,3.6507088933897993,20.0,20.0
15431,1,5431,[176 282 153 143  12],406,2,19829,3.65040500736377,20.0,0.0
15432,1,5432,[313 127 187 302 483],669,4,19833,3.650469353948095,20.0,20.0
15433,1,5433,[200 121 175 301   1],788,2,19835,3.6501656238498343,0.0,0.0
15434,1,5434,[597  96 318 179 196],374,2,19837,3.649862005519779,20.0,0.0
15435,1,5435,[276 210   1 515 186],271,3,19840,3.6497424576894777,0.0,0.0
15436,1,5436,[313 127 187 302 191],207,5,19845,3.649990803752069,0.0,20.0
15437,1,5437,[483  64 273 216  69],537,1,19846,3.6495034939315927,20.0,0.0
15438,1,5438,[ 56 121 357 322 117],13,2,19848,3.649200220628792,20.0,0.0
15439,1,5439,[313 127 187 302 191],474,5,19853,3.6494485294117647,0.0,20.0
15440,1,5440,[238  12 515 215 475],537,3,19856,3.649329167432457,20.0,0.0
15441,1,5441,[143  22 603 427 273],308,4,19860,3.649393605292172,20.0,0.0
15442,1,5442,[301 323 200 423 322],13,1,19861,3.648906852838508,0.0,0.0
15443,1,5443,[313 127 187 302 191],669,4,19865,3.648971344599559,0.0,20.0
15444,1,5444,[ 69  71 496 202 127],749,5,19870,3.6492194674012857,0.0,20.0
15445,1,5445,[313 127 187 302 483],474,5,19875,3.649467499081895,20.0,20.0
15446,1,5446,[313 127 187 302 483],90,5,19880,3.6497154396915734,20.0,20.0
15447,1,5447,[  4 357 496 132 235],398,3,19883,3.649596182085169,20.0,0.0
15448,1,5448,[313 127 187 302 483],474,5,19888,3.649844008074876,20.0,20.0
15449,1,5449,[313 127 187 302 483],328,5,19893,3.650091743119266,20.0,20.0
15450,1,5450,[313 127 187 302 483],474,5,19898,3.650339387268391,20.0,20.0
15451,1,5451,[238  95 742   4  50],524,3,19901,3.6502201027146,0.0,20.0
15452,1,5452,[211  50 191 195 405],537,3,19904,3.650100861910875,0.0,20.0
15453,1,5453,[  1  96 191 216 471],95,5,19909,3.6503483681701505,0.0,0.0
15454,1,5454,[313 127 187 302 483],207,5,19914,3.6505957836846927,20.0,20.0
15455,1,5455,[313 127 187 302 483],328,5,19919,3.650843108504399,20.0,20.0
15456,1,5456,[515  15 132 153   1],184,3,19922,3.6507238409382445,0.0,0.0
15457,1,5457,[294 186  64 405 435],7,3,19925,3.650604617075852,0.0,0.0
15458,1,5458,[ 79 200 117 546   4],328,3,19928,3.650485436893204,0.0,0.0
15459,1,5459,[405   1 151  15 176],892,5,19933,3.6507326007326006,0.0,0.0
15460,1,5460,[588  96  88 322  69],308,3,19936,3.650613440761765,0.0,0.0
15461,1,5461,[300  70 568 289 185],537,2,19938,3.6503112413035517,0.0,0.0
15462,1,5462,[121  71 385 300 191],843,0,19938,3.6496430532674355,0.0,0.0
15463,1,5463,[118 655 182 234 496],749,3,19941,3.649524158125915,0.0,0.0
15464,1,5464,[313 127 187 302 483],537,5,19946,3.6497712717291857,20.0,20.0
15465,1,5465,[313 127 187 302 483],90,5,19951,3.650018294914014,20.0,20.0
15466,1,5466,[195 161 215  28 282],479,3,19954,3.6498993963782698,0.0,0.0
15467,1,5467,[211 322  22  12  56],537,2,19956,3.6495976591075348,20.0,0.0
15468,1,5468,[  7 161 475 185  71],452,3,19959,3.6494788809654417,0.0,0.0
15469,1,5469,[546 258 678  11 222],339,3,19962,3.649360146252285,0.0,0.0
15470,1,5470,[175 183  89  95 427],194,1,19963,3.648875891061963,0.0,0.0
15471,1,5471,[ 22 427 194  28   9],194,5,19968,3.6491228070175437,0.0,0.0
15472,1,5472,[  4 258 204 322 302],474,5,19973,3.6493696327425544,0.0,0.0
15473,1,5473,[313 127 187 302 483],207,5,19978,3.649616368286445,20.0,20.0
15474,1,5474,[508 265 211   4  79],207,4,19982,3.6496803652968035,0.0,0.0
15475,1,5475,[ 12 187 204 118 176],213,5,19987,3.649926953981008,20.0,0.0
15476,1,5476,[ 79  22 125  97  88],298,4,19991,3.6499908709147344,0.0,0.0
15477,1,5477,[ 50 215  25 151 185],648,2,19993,3.649689667761957,0.0,20.0
15478,1,5478,[151  12  11 546 318],666,4,19997,3.6497536046723855,40.0,0.0
15479,1,5479,[117  95  28 195  64],6,2,19999,3.6494525547445256,0.0,0.0
15480,1,5480,[174 257 318 258 127],815,3,20002,3.6493340631271667,20.0,40.0
15481,1,5481,[194 238 403 237 175],194,2,20004,3.6490331995622034,0.0,0.0
15482,1,5482,[191  12 144 197 228],343,5,20009,3.6492795914645266,20.0,0.0
15483,1,5483,[237 318 215 603 508],537,3,20012,3.649161196207148,40.0,0.0
15484,1,5484,[282 328 176 748 655],92,3,20015,3.649042844120328,0.0,0.0
15485,1,5485,[234 276  98   1   4],59,4,20019,3.649106817353263,0.0,20.0
15486,1,5486,[257  98 288 179  11],392,5,20024,3.649353016220157,0.0,20.0
15487,1,5487,[405 234 185 216  28],804,5,20029,3.6495991253644315,0.0,0.0
15488,1,5488,[313 127 187 302 483],13,5,20034,3.649845144835125,20.0,20.0
15489,1,5489,[313 127 187 302 483],207,5,20039,3.6500910746812387,20.0,20.0
15490,1,5490,[403 235  50 427 405],59,3,20042,3.6499726825714807,0.0,20.0
15491,1,5491,[182 483 185  69  96],753,2,20044,3.649672250546249,20.0,0.0
15492,1,5492,[423  95 216   7  50],882,5,20049,3.6499180775532496,0.0,20.0
15493,1,5493,[238 197   9 273 323],59,4,20053,3.649981798325446,0.0,0.0
15494,1,5494,[483 153 132 294 237],234,2,20055,3.6496815286624202,20.0,0.0
15495,1,5495,[313 127 187 302 483],537,5,20060,3.6499272197962154,20.0,20.0
15496,1,5496,[172 222 269 603 180],312,4,20064,3.6499909041295253,20.0,0.0
15497,1,5497,[ 89  79 125 215  70],648,2,20066,3.6496907966533283,0.0,0.0
15498,1,5498,[286 132  89 195  97],7,5,20071,3.6499363520640116,0.0,0.0
15499,1,5499,[202 286 144 182   8],207,0,20071,3.6492727272727272,0.0,0.0
15500,1,5500,[ 95 655 182 175 135],92,4,20075,3.649336484275586,0.0,0.0
15501,1,5501,[313 127 187 302 483],328,5,20080,3.6495819701926573,20.0,20.0
15502,1,5502,[313 127 187 302 483],537,5,20085,3.649827366890787,20.0,20.0
15503,1,5503,[ 98 182 100  22  69],881,3,20088,3.6497093023255816,0.0,40.0
15504,1,5504,[211 423 294 135 210],506,5,20093,3.649954586739328,0.0,0.0
15505,1,5505,[313 127 187 302 483],334,5,20098,3.650199782055939,20.0,20.0
15506,1,5506,[313 127 187 302 483],207,5,20103,3.6504448883239515,20.0,20.0
15507,1,5507,[  1 182  88   7 176],234,0,20103,3.649782135076253,0.0,0.0
15508,1,5508,[313 127 187 302 483],537,5,20108,3.6500272281720822,20.0,20.0
15509,1,5509,[202 125  89 546 742],313,3,20111,3.6499092558983666,0.0,0.0
15510,1,5510,[313 127 187 302 483],474,5,20116,3.650154236980584,20.0,20.0
15511,1,5511,[179 269  96 210 173],524,4,20120,3.6502177068214805,0.0,0.0
15512,1,5512,[168 222 204 153 191],650,5,20125,3.6504625430799926,0.0,0.0
15513,1,5513,[313 127 187 302 483],328,5,20130,3.6507072905331883,20.0,20.0
15514,1,5514,[ 96  89 568 269 111],119,4,20134,3.6507706255666363,0.0,0.0
15515,1,5515,[313 127 187 302 483],474,5,20139,3.651015228426396,20.0,20.0
15516,1,5516,[  8 195 471 265 202],543,4,20143,3.6510784846837048,0.0,0.0
15517,1,5517,[172 483  22 496  64],290,5,20148,3.6513229430953245,20.0,0.0
15518,1,5518,[237   4  64  97 121],328,3,20151,3.6512049284290633,0.0,0.0
15519,1,5519,[313 127 187 302 483],669,4,20155,3.651268115942029,20.0,20.0
15520,1,5520,[180 508 427  69 168],339,5,20160,3.6515124071726137,0.0,0.0
15521,1,5521,[172 204 196 185 318],774,0,20160,3.6508511408909814,20.0,0.0
15522,1,5522,[403  25 496 268  82],7,2,20162,3.6505522361035667,0.0,0.0
15523,1,5523,[202  95 483 210  56],313,3,20165,3.6504344677769733,20.0,0.0
15524,1,5524,[  1  70  79 289  15],374,3,20168,3.650316742081448,0.0,0.0
15525,1,5525,[288 173  71  12 151],334,3,20171,3.6501990589938473,20.0,0.0
15526,1,5526,[ 28 195  70 235 568],194,1,20172,3.6497195585308484,0.0,0.0
15527,1,5527,[313 127 187 302 483],474,5,20177,3.6499638205499276,20.0,20.0
15528,1,5528,[228   7 546 172 180],650,3,20180,3.6498462651474046,0.0,0.0
15529,1,5529,[496 174 475  98 175],90,3,20183,3.6497287522603976,0.0,40.0
15530,1,5530,[175   9 405  97 151],82,3,20186,3.649611281865847,0.0,0.0
15531,1,5531,[313 127 187 302 483],474,5,20191,3.6498553868402026,20.0,20.0
15532,1,5532,[313 127 187 302 483],13,5,20196,3.650099403578529,20.0,20.0
15533,1,5533,[143 127  25  71 322],474,5,20201,3.650343332128659,0.0,20.0
15534,1,5534,[ 89 286 161 265 174],95,2,20203,3.650045167118338,0.0,20.0
15535,1,5535,[423 176 172 135 186],749,5,20208,3.6502890173410405,0.0,0.0
15536,1,5536,[313 127 187 302 483],474,5,20213,3.6505327794834748,20.0,20.0
15537,1,5537,[191  56 186 568 269],524,4,20217,3.6505958829902494,0.0,0.0
15538,1,5538,[135  11 195 161 238],234,1,20218,3.6501173497021124,0.0,0.0
15539,1,5539,[313 127 187 302 483],537,5,20223,3.650361010830325,20.0,20.0
15540,1,5540,[153  28 197 403 204],374,4,20227,3.6504241111712687,0.0,0.0
15541,1,5541,[276   1 237  79 197],59,3,20230,3.6503067484662575,0.0,0.0
15542,1,5542,[313 127 187 302 483],90,5,20235,3.650550243550424,20.0,20.0
15543,1,5543,[186  97 588  96 235],795,1,20236,3.65007215007215,0.0,0.0
15544,1,5544,[210  50 294 191 173],271,4,20240,3.650135256988278,0.0,20.0
15545,1,5545,[678 294   8 289 276],92,2,20242,3.6498377208799133,0.0,0.0
15546,1,5546,[100 153 546 385 258],479,2,20244,3.649540292049757,0.0,20.0
15547,1,5547,[286 132 294 427 161],13,3,20247,3.6494232155731794,0.0,0.0
15548,1,5548,[245 121 132   1 483],533,4,20251,3.649486393944855,20.0,0.0
15549,1,5549,[ 28 257 183 423 153],95,5,20256,3.6497297297297298,0.0,0.0
15550,1,5550,[ 50  79 151 475 111],648,3,20259,3.649612682399568,0.0,20.0
15551,1,5551,[313 127 187 302 483],90,5,20264,3.64985590778098,20.0,20.0
15552,1,5552,[173 144 288 271 222],676,3,20267,3.649738879884747,0.0,0.0
15553,1,5553,[471 276  25   7 245],141,3,20270,3.6496218941303566,0.0,0.0
15554,1,5554,[258 238 483 515   8],85,4,20274,3.6496849684968495,20.0,0.0
15555,1,5555,[313 127 187 302 483],334,5,20279,3.649928005759539,20.0,20.0
15556,1,5556,[313 127 187 302 483],537,5,20284,3.6501709555515567,20.0,20.0
15557,1,5557,[271  11 222   1 435],102,0,20284,3.649514213745952,0.0,0.0
15558,1,5558,[200 172 294 204 748],804,4,20288,3.6495772620974996,0.0,0.0
15559,1,5559,[202 172  98 238 257],145,5,20293,3.649820143884892,0.0,20.0
15560,1,5560,[127 196 322 117  64],234,2,20295,3.6495234670023375,0.0,20.0
15561,1,5561,[313 127 187 302 483],90,5,20300,3.6497662711254946,20.0,20.0
15562,1,5562,[ 70 172 125 289 328],533,4,20304,3.6498292288333634,0.0,0.0
15563,1,5563,[ 70 237 427 135 300],666,3,20307,3.649712437095615,0.0,0.0
15564,1,5564,[ 22  28 318  15 302],6,2,20309,3.6494159928122194,20.0,0.0
15565,1,5565,[313 127 187 302 483],13,5,20314,3.6496586417535033,20.0,20.0
15566,1,5566,[323 175 118 235 568],13,2,20316,3.649362313633914,0.0,0.0
15567,1,5567,[313 127 187 302 483],334,5,20321,3.6496048850574714,20.0,20.0
15568,1,5568,[313 127 187 302 483],334,5,20326,3.649847369366134,20.0,20.0
15569,1,5569,[210 195 222 228 475],648,4,20330,3.649910233393178,0.0,0.0
15570,1,5570,[322  56 182 144 173],13,3,20333,3.649793573864656,0.0,0.0
15571,1,5571,[ 79 322 245 496 180],346,4,20337,3.6498564249820533,0.0,0.0
15572,1,5572,[597  25 179 427  71],374,3,20340,3.6497398169746993,0.0,0.0
15573,1,5573,[313 127 187 302 483],669,4,20344,3.6498026551847866,20.0,20.0
15574,1,5574,[237 127 183  15 357],537,2,20346,3.6495067264573993,20.0,20.0
15575,1,5575,[210 258  22   4  64],59,4,20350,3.6495695839311333,0.0,0.0
15576,1,5576,[182 328 168 191 127],313,4,20354,3.649632418863188,0.0,20.0
15577,1,5577,[405 322  28 161 546],901,5,20359,3.6498745069917535,0.0,0.0
15578,1,5578,[435 508 238 423 216],378,4,20363,3.6499372647427855,0.0,0.0
15579,1,5579,[328 603  95 588 153],664,3,20366,3.649820788530466,20.0,0.0
15580,1,5580,[313 127 187 302 483],669,4,20370,3.64988353341695,20.0,20.0
15581,1,5581,[313 127 187 302 483],669,4,20374,3.649946255822286,20.0,20.0
15582,1,5582,[289 186 151 196  96],537,1,20375,3.6494716102453877,0.0,0.0
15583,1,5583,[323  82  97  28 423],374,3,20378,3.649355300859599,0.0,0.0
15584,1,5584,[ 82 235 238 183   1],537,1,20379,3.648880931065354,0.0,0.0
15585,1,5585,[216 173 271  69 265],843,1,20380,3.6484067311134982,0.0,0.0
15586,1,5586,[546 228 176 127  50],774,4,20384,3.648469661714695,0.0,40.0
15587,1,5587,[191 273  79 405  11],538,3,20387,3.648353614889048,0.0,0.0
15588,1,5588,[202 546 125  15 496],749,4,20391,3.6484165324745037,0.0,0.0
15589,1,5589,[265 282 603 195 234],145,5,20396,3.64865831842576,20.0,0.0
15590,1,5590,[483 187  71 204 403],892,3,20399,3.648542300125201,20.0,0.0
15591,1,5591,[ 15 183  89 328 197],488,4,20403,3.648605150214592,0.0,0.0
15592,1,5592,[301 143 435 204 258],666,3,20406,3.6484891829072055,0.0,0.0
15593,1,5593,[313 127 187 302 603],334,5,20411,3.648730782981766,20.0,20.0
15594,1,5594,[313 127 187 302 603],669,5,20416,3.648972296693476,20.0,20.0
15595,1,5595,[655 269  25  56 186],343,4,20420,3.64903502501787,0.0,0.0
15596,1,5596,[182 186 172  69 117],308,3,20423,3.64891906378417,0.0,0.0
15597,1,5597,[258 153   7 269 268],13,3,20426,3.648803143979993,0.0,0.0
15598,1,5598,[313 127 187 302 603],90,5,20431,3.6490444722271835,20.0,20.0
15599,1,5599,[313 127 187 302 603],334,5,20436,3.6492857142857145,20.0,20.0
15600,1,5600,[276   9 186 204 176],339,4,20440,3.6493483306552403,0.0,0.0
15601,1,5601,[313 127 187 302 603],90,5,20445,3.649589432345591,20.0,20.0
15602,1,5602,[125 202 597 183 191],7,3,20448,3.649473496341246,0.0,0.0
15603,1,5603,[483  28 117  56 245],454,1,20449,3.6490007137758744,20.0,0.0
15604,1,5604,[313 127 187 302 603],537,5,20454,3.649241748438894,20.0,20.0
15605,1,5605,[204  98 161 427 186],328,3,20457,3.6491259364966107,0.0,20.0
15606,1,5606,[181 276 191 186 237],92,5,20462,3.649366862850009,0.0,0.0
15607,1,5607,[175  12 186 288  98],59,5,20467,3.6496077032810272,20.0,20.0
15608,1,5608,[228 180 185   9 496],339,5,20472,3.6498484578356214,0.0,0.0
15609,1,5609,[216  79 742   1 202],59,3,20475,3.6497326203208558,0.0,0.0
15610,1,5610,[ 88 111  95 288 161],374,3,20478,3.6496168240955265,0.0,0.0
15611,1,5611,[  4 228  50   7 176],455,3,20481,3.6495010691375622,0.0,20.0
15612,1,5612,[234 121 568 678  56],881,2,20483,3.6492071975770535,0.0,0.0
15613,1,5613,[333  71  56 222 427],85,2,20485,3.648913430708942,0.0,0.0
15614,1,5614,[234 258  22 211  96],653,2,20487,3.648619768477293,0.0,0.0
15615,1,5615,[313 127 187 302 603],537,5,20492,3.648860398860399,20.0,20.0
15616,1,5616,[385 328 294 357 168],804,5,20497,3.6491009435641804,20.0,0.0
15617,1,5617,[215 322 313   1  11],234,1,20498,3.648629405482378,0.0,0.0
15618,1,5618,[313 127 187 302 603],13,5,20503,3.648869905677167,20.0,20.0
15619,1,5619,[121 257 603  64  98],804,5,20508,3.6491103202846977,20.0,20.0
15620,1,5620,[195  25 273 181 385],387,3,20511,3.6489948407756625,0.0,0.0
15621,1,5621,[496 234 546   4 228],643,4,20515,3.6490572749911063,0.0,0.0
15622,1,5622,[ 11 210  71 269 191],378,4,20519,3.649119686999822,0.0,0.0
15623,1,5623,[186 144 273  71 603],13,4,20523,3.6491820768136556,20.0,0.0
15624,1,5624,[222 568 273 385 237],328,1,20524,3.648711111111111,0.0,0.0
15625,1,5625,[  7  69 132 172  79],815,5,20529,3.648951297547103,0.0,0.0
15626,1,5626,[237 168 161 175 286],60,5,20534,3.649191398613826,0.0,0.0
15627,1,5627,[222  69 210 328 238],13,1,20535,3.648720682302772,0.0,0.0
15628,1,5628,[185 182  71  95 234],374,5,20540,3.648960739030023,0.0,0.0
15629,1,5629,[118 211 435 173 405],524,4,20544,3.649023090586146,0.0,0.0
15630,1,5630,[175 117 515 186 121],207,2,20546,3.64873024329604,0.0,0.0
15631,1,5631,[100 275  96 161  56],7,4,20550,3.6487926136363638,0.0,20.0
15632,1,5632,[313 127 187 302 603],334,5,20555,3.649032487129416,20.0,20.0
15633,1,5633,[313 127 187 302 603],669,5,20560,3.6492722754703584,20.0,20.0
15634,1,5634,[313 127 187 302 603],271,5,20565,3.6495119787045254,20.0,20.0
15635,1,5635,[182 742 135  69 194],881,2,20567,3.649219304471256,0.0,0.0
15636,1,5636,[300  12  98 265  70],334,2,20569,3.6489267340784104,20.0,20.0
15637,1,5637,[ 25 300 215 195 275],533,5,20574,3.649166371053565,0.0,0.0
15638,1,5638,[237 222 176  97 275],60,4,20578,3.6492285866288348,0.0,0.0
15639,1,5639,[427 182 265 121  56],533,2,20580,3.648936170212766,0.0,0.0
15640,1,5640,[ 97 475 180 176 222],213,4,20584,3.6489984045382022,0.0,0.0
15641,1,5641,[196 195 194 215 357],843,1,20585,3.6485288904643745,20.0,0.0
15642,1,5642,[181 423 172 301 294],666,1,20586,3.648059542796385,0.0,0.0
15643,1,5643,[313 127 187 302 603],116,3,20589,3.6479447200566972,20.0,20.0
15644,1,5644,[313 127 187 302 603],474,5,20594,3.6481842338352526,20.0,20.0
15645,1,5645,[168 151 202 174  88],815,4,20598,3.648246546227418,0.0,20.0
15646,1,5646,[ 88 197  12 655 435],194,4,20602,3.6483088365503806,20.0,0.0
15647,1,5647,[121 496 427 405 216],60,5,20607,3.6485481586402266,0.0,0.0
15648,1,5648,[603 435 282 275 289],533,4,20611,3.6486103735174367,20.0,0.0
15649,1,5649,[  4 300 215 234 197],774,0,20611,3.6479646017699117,0.0,0.0
15650,1,5650,[313 127 187 302 603],271,5,20616,3.6482038577242966,20.0,20.0
15651,1,5651,[313 127 187 302 603],334,5,20621,3.6484430290162773,20.0,20.0
15652,1,5652,[313 127 187 302 603],334,5,20626,3.6486821156907836,20.0,20.0
15653,1,5653,[313 127 187 302 603],271,5,20631,3.648921117792713,20.0,20.0
15654,1,5654,[238   4  50 135  64],881,2,20633,3.6486295313881523,0.0,20.0
15655,1,5655,[ 50 515 655 161 265],64,4,20637,3.648691654879774,0.0,20.0
15656,1,5656,[234 210 181  11 546],378,3,20640,3.6485769842672795,0.0,0.0
15657,1,5657,[313 127 187 302 603],271,5,20645,3.648815835984447,20.0,20.0
15658,1,5658,[ 25  50 173 215   9],92,3,20648,3.6487011839547625,0.0,20.0
15659,1,5659,[546 288 300   4 151],234,1,20649,3.648233215547703,0.0,0.0
15660,1,5660,[313 127 187 302 603],537,5,20654,3.648472001413178,20.0,20.0
15661,1,5661,[117 496 269 333  82],263,3,20657,3.648357470858354,0.0,0.0
15662,1,5662,[357 427 222  64  79],13,2,20659,3.6480663959032316,20.0,0.0
15663,1,5663,[483 196   7 202 423],343,5,20664,3.6483050847457625,20.0,0.0
15664,1,5664,[ 25 235 435  56  98],537,1,20665,3.64783759929391,0.0,20.0
15665,1,5665,[ 64 168 234  82 210],215,4,20669,3.647899752912107,0.0,0.0
15666,1,5666,[313 127 187 302 603],334,5,20674,3.6481383448032467,20.0,20.0
15667,1,5667,[ 56 423 211 385 182],653,2,20676,3.647847565278758,0.0,0.0
15668,1,5668,[269 483 168 323  98],13,3,20679,3.647733286293879,20.0,20.0
15669,1,5669,[313 127 187 302 603],474,5,20684,3.6479717813051145,20.0,20.0
15670,1,5670,[496 197  82 191  70],840,3,20687,3.64785752071945,0.0,0.0
15671,1,5671,[286 135 508 294 195],537,2,20689,3.6475669957686883,0.0,0.0
15672,1,5672,[ 82 328 234 132  69],328,5,20694,3.647805393971444,0.0,0.0
15673,1,5673,[313 127 187 302 603],271,5,20699,3.6480437081424038,20.0,20.0
15674,1,5674,[313 127 187 302 603],90,5,20704,3.648281938325991,20.0,20.0
15675,1,5675,[313 127 187 302 603],116,3,20707,3.6481677237491192,20.0,20.0
15676,1,5676,[313 127 187 302 603],13,5,20712,3.648405848159239,20.0,20.0
15677,1,5677,[748 323 655 289 132],13,3,20715,3.6482916519901374,0.0,0.0
15678,1,5678,[496   7 215 423 132],643,4,20719,3.648353583377355,0.0,0.0
15679,1,5679,[546 483 195 215 185],60,5,20724,3.648591549295775,20.0,0.0
15680,1,5680,[427   9   4 228 180],339,5,20729,3.648829431438127,0.0,0.0
15681,1,5681,[ 79 135 294  98 265],207,2,20731,3.6485392467441042,0.0,20.0
15682,1,5682,[435 234  82 194 125],749,5,20736,3.6487770543726903,0.0,0.0
15683,1,5683,[187 202 222 176 273],666,3,20739,3.6486629134412385,0.0,0.0
15684,1,5684,[423 515 194  89 302],474,5,20744,3.6489006156552333,0.0,0.0
15685,1,5685,[313 127 187 302 603],474,5,20749,3.649138234259585,20.0,20.0
15686,1,5686,[423 546 302 153 258],328,3,20752,3.6490240900298927,0.0,0.0
15687,1,5687,[211 405 234 161 121],290,2,20754,3.6487341772151898,0.0,0.0
15688,1,5688,[313 127 187 302 603],90,5,20759,3.6489716997714887,20.0,20.0
15689,1,5689,[197 210 222 183  25],406,3,20762,3.6488576449912125,0.0,0.0
15690,1,5690,[216 117 153 483 172],749,5,20767,3.649095062379195,20.0,0.0
15691,1,5691,[300 385  28 182 328],234,1,20768,3.6486296556570625,0.0,0.0
15692,1,5692,[  7 182 245 151  64],804,4,20772,3.6486913753732653,0.0,0.0
15693,1,5693,[  1  82 194 228  69],901,5,20777,3.6489286968739023,0.0,0.0
15694,1,5694,[204  69 125 195 423],378,2,20779,3.6486391571553995,0.0,0.0
15695,1,5695,[313 127 187 302 603],90,5,20784,3.648876404494382,20.0,20.0
15696,1,5696,[  7 403 194  70 216],7,4,20788,3.6489380375636298,0.0,0.0
15697,1,5697,[176 216 210  95 515],313,4,20792,3.648999648999649,0.0,0.0
15698,1,5698,[313 127 187 302 603],669,5,20797,3.64923670819442,20.0,20.0
15699,1,5699,[  9 194 313 153 121],378,5,20802,3.6494736842105264,0.0,0.0
15700,1,5700,[125 237 276  15 194],533,3,20805,3.6493597614453606,0.0,0.0
15701,1,5701,[135 323 427 132 194],650,4,20809,3.6494212556997545,0.0,0.0
15702,1,5702,[211 176 265  71 483],897,3,20812,3.6493073820796074,20.0,0.0
15703,1,5703,[172 546 194 111  12],643,4,20816,3.6493688639551194,20.0,0.0
15704,1,5704,[204 655 186 172 234],379,5,20821,3.6496056091148117,0.0,0.0
15705,1,5705,[313 127 187 302 603],537,5,20826,3.6498422712933754,20.0,20.0
15706,1,5706,[185 286 423 127 153],385,3,20829,3.6497284037147364,0.0,20.0
15707,1,5707,[168  12 322 265 144],234,0,20829,3.6490889978976875,20.0,0.0
15708,1,5708,[204 268 471 132 125],119,5,20834,3.649325626204239,0.0,0.0
15709,1,5709,[313 127 187 302 603],90,5,20839,3.6495621716287214,20.0,20.0
15710,1,5710,[423 125  11 471  96],378,2,20841,3.6492733321659956,0.0,0.0
15711,1,5711,[313 127 187 302 603],474,5,20846,3.6495098039215685,20.0,20.0
15712,1,5712,[427 183  95 144 475],374,3,20849,3.649396114125678,0.0,0.0
15713,1,5713,[313 127 187 302 603],474,5,20854,3.649632481624081,20.0,20.0
15714,1,5714,[ 64 588  56  98 185],194,5,20859,3.6498687664041993,0.0,20.0
15715,1,5715,[196 216 173 172 191],295,5,20864,3.650104968509447,0.0,0.0
15716,1,5716,[204  79   4 234  82],883,4,20868,3.6501661710687423,0.0,0.0
15717,1,5717,[357 195 187 235  71],788,2,20870,3.6498775795732774,20.0,0.0
15718,1,5718,[ 97  22   7  82 172],788,2,20872,3.649589089001574,0.0,0.0
15719,1,5719,[313 127 187 302 603],537,5,20877,3.6498251748251747,20.0,20.0
15720,1,5720,[588 172  89 271 204],843,2,20879,3.6495367942667367,0.0,0.0
15721,1,5721,[313 127 187 302 603],13,5,20884,3.6497728067109403,20.0,20.0
15722,1,5722,[204  89 222 176 195],374,3,20887,3.649659269613839,0.0,0.0
15723,1,5723,[313 127 187 302 603],13,5,20892,3.649895178197065,20.0,20.0
15724,1,5724,[ 12 276  22 403  56],308,5,20897,3.6501310043668123,20.0,0.0
15725,1,5725,[216 288 185 357 143],308,4,20901,3.650192106182326,20.0,0.0
15726,1,5726,[313 127 187 302 603],334,5,20906,3.650427798149118,20.0,20.0
15727,1,5727,[ 69 235 194 475 182],213,3,20909,3.6503142458100557,0.0,0.0
15728,1,5728,[187 300 588 180 175],85,3,20912,3.650200733112236,0.0,0.0
15729,1,5729,[186 603   1 496 273],749,5,20917,3.65043630017452,20.0,0.0
15730,1,5730,[313 127 187 302 603],474,5,20922,3.650671785028791,20.0,20.0
15731,1,5731,[313 127 187 302 603],116,3,20925,3.6505582693649687,20.0,20.0
15732,1,5732,[357 678   9 265 185],82,3,20928,3.650444793301936,20.0,0.0
15733,1,5733,[135  97 237 288 546],234,1,20929,3.6499825601674223,0.0,0.0
15734,1,5734,[313 127 187 302 603],271,5,20934,3.6502179598953792,20.0,20.0
15735,1,5735,[313 127 187 302 603],474,5,20939,3.650453277545328,20.0,20.0
15736,1,5736,[234 546 508 403 282],533,2,20941,3.6501655917727036,0.0,0.0
15737,1,5737,[313 127 187 302 603],13,5,20946,3.6504008365284073,20.0,20.0
15738,1,5738,[405  82 210 121 117],374,5,20951,3.6506359993030144,0.0,0.0
15739,1,5739,[183 655   7 132 172],840,4,20955,3.6506968641114983,0.0,0.0
15740,1,5740,[286   1 181 222 197],194,2,20957,3.650409336352552,0.0,0.0
15741,1,5741,[ 12  69 427 144 333],666,2,20959,3.6501219087425985,20.0,0.0
15742,1,5742,[313 127 187 302 603],90,5,20964,3.6503569562946194,20.0,20.0
15743,1,5743,[282 471 176 125  71],378,3,20967,3.6502437325905293,0.0,0.0
15744,1,5744,[318 174 275 100 191],235,5,20972,3.650478677110531,20.0,40.0
15745,1,5745,[  1  15 496 237 194],378,4,20976,3.650539505743126,0.0,0.0
15746,1,5746,[603  71 423 313 117],738,3,20979,3.6504263093788065,20.0,0.0
15747,1,5747,[ 70 202  56 427 357],90,4,20983,3.6504871259568548,20.0,0.0
15748,1,5748,[271 151  96 186 143],64,3,20986,3.650373978083145,0.0,0.0
15749,1,5749,[ 56 195 173 151  71],524,2,20988,3.650086956521739,0.0,0.0
15750,1,5750,[313 127 187 302 603],669,5,20993,3.650321683185533,20.0,20.0
15751,1,5751,[313 127 187 302 603],116,3,20996,3.6502086230876216,20.0,20.0
15752,1,5752,[ 64 435 175 235 357],343,5,21001,3.650443247001564,20.0,0.0
15753,1,5753,[117  56 322  64 318],533,4,21005,3.650503997219326,20.0,0.0
15754,1,5754,[313 423   8 289 483],334,4,21009,3.650564726324935,20.0,0.0
15755,1,5755,[313 127 187 302 603],90,5,21014,3.6507991660875607,20.0,20.0
15756,1,5756,[435 125 216 127 496],59,4,21018,3.650859822824388,0.0,20.0
15757,1,5757,[313 127 187 302 603],669,5,21023,3.6510941299062174,20.0,20.0
15758,1,5758,[ 15  56 172  28 173],200,5,21028,3.6513283556172946,0.0,0.0
15759,1,5759,[313 127 187 302 603],334,5,21033,3.6515625,20.0,20.0
15760,1,5760,[ 50 597 183 238 435],833,1,21034,3.6511022391945844,0.0,20.0
15761,1,5761,[195  11 483 568 471],213,4,21038,3.6511627906976742,20.0,0.0
15762,1,5762,[423 276 257 111 173],378,4,21042,3.651223321186882,0.0,0.0
15763,1,5763,[  1   9 288  12  69],605,5,21047,3.6514573213046497,20.0,0.0
15764,1,5764,[210   1  50 216 211],643,5,21052,3.6516912402428447,0.0,20.0
15765,1,5765,[313 127 187 302 603],271,5,21057,3.6519250780437043,20.0,20.0
15766,1,5766,[186 127 237 194 196],271,5,21062,3.6521588347494363,0.0,20.0
15767,1,5767,[ 71 238 200 211 174],897,5,21067,3.652392510402219,0.0,20.0
15768,1,5768,[313 127 187 302 603],334,5,21072,3.652626105044202,20.0,20.0
15769,1,5769,[328  79 245 132 294],804,5,21077,3.652859618717504,0.0,0.0
15770,1,5770,[215 508 403 385 182],533,3,21080,3.65274649107607,0.0,0.0
15771,1,5771,[210 179 194 183 435],650,3,21083,3.6526334026334024,0.0,0.0
15772,1,5772,[313 127 187 302 603],669,5,21088,3.6528667936947863,20.0,20.0
15773,1,5773,[313 127 187 302 603],334,5,21093,3.6531001039140976,20.0,20.0
15774,1,5774,[313 127 187 302 603],271,5,21098,3.6533333333333333,20.0,20.0
15775,1,5775,[301 117 403 200 282],334,3,21101,3.6532202216066483,0.0,0.0
15776,1,5776,[204  64 135 187 143],311,4,21105,3.653280249264324,0.0,0.0
15777,1,5777,[328  82 144 678 100],488,2,21107,3.6529941156109382,0.0,20.0
15778,1,5778,[153 483 435 117 132],234,2,21109,3.652708080982869,20.0,0.0
15779,1,5779,[172 200 748  79 196],92,3,21112,3.6525951557093426,0.0,0.0
15780,1,5780,[ 25 323 121 127 273],634,4,21116,3.652655249956755,0.0,20.0
15781,1,5781,[182 403  95 179 405],13,2,21118,3.6523694223452092,0.0,0.0
15782,1,5782,[174 286 185  96 318],59,4,21122,3.652429534843507,20.0,20.0
15783,1,5783,[313 127 187 302 603],116,3,21125,3.65231673582296,20.0,20.0
15784,1,5784,[313 127 187 302 603],271,5,21130,3.6525496974935177,20.0,20.0
15785,1,5785,[ 56 216 288 301  88],537,1,21131,3.6520912547528517,0.0,0.0
15786,1,5786,[172 655 301 258 328],85,3,21134,3.651978572662865,0.0,0.0
15787,1,5787,[117  88 423 471 742],648,4,21138,3.6520387007601935,0.0,0.0
15788,1,5788,[313 127 187 302 603],334,5,21143,3.652271549490413,20.0,20.0
15789,1,5789,[318 172 181  56 286],144,5,21148,3.6525043177892917,20.0,0.0
15790,1,5790,[  4 234 117  88 328],102,0,21148,3.6518735969608014,0.0,0.0
15791,1,5791,[313 127 187 302 603],537,5,21153,3.65210635359116,20.0,20.0
15792,1,5792,[ 70  50 435 100 172],643,4,21157,3.6521664077334712,0.0,40.0
15793,1,5793,[117  25 508 183 234],13,2,21159,3.6518812564722127,0.0,0.0
15794,1,5794,[ 96 175 268 144 172],234,0,21159,3.651251078515962,0.0,0.0
15795,1,5795,[216 234 273 282  12],374,4,21163,3.6513112491373363,20.0,0.0
15796,1,5796,[196  12  88  70 186],271,5,21168,3.651543902018285,20.0,0.0
15797,1,5797,[235   4 678  15  12],308,2,21170,3.651259054846499,20.0,0.0
15798,1,5798,[183 195 302 245 294],666,2,21172,3.6509743059148128,0.0,0.0
15799,1,5799,[ 88  50 195  69 181],125,5,21177,3.651206896551724,0.0,20.0
15800,1,5800,[210 318 515 197 588],537,3,21180,3.6510946388553696,20.0,0.0
15801,1,5801,[197  96 185 515 135],95,3,21183,3.6509824198552225,0.0,0.0
15802,1,5802,[238  25 143 127 195],650,3,21186,3.650870239531277,0.0,20.0
15803,1,5803,[111 125 100 294 161],378,2,21188,3.6505858028945557,0.0,20.0
15804,1,5804,[117 174 181 202 234],378,3,21191,3.650473729543497,0.0,20.0
15805,1,5805,[313 127 187 302 603],13,5,21196,3.650706166035136,20.0,20.0
15806,1,5806,[471 194  50 143 258],474,4,21200,3.6507663165145514,0.0,20.0
15807,1,5807,[748  96 496 435 161],749,3,21203,3.650654269972452,0.0,0.0
15808,1,5808,[357 125 603  56 194],213,5,21208,3.650886555345154,40.0,0.0
15809,1,5809,[161  96  56 143 168],64,4,21212,3.6509466437177283,0.0,0.0
15810,1,5810,[176 197 483  88 174],398,5,21217,3.6511787988298057,20.0,20.0
15811,1,5811,[210 187 185  25 211],7,4,21221,3.6512388162422575,0.0,0.0
15812,1,5812,[313 127 187 302 603],271,5,21226,3.65147084121796,20.0,20.0
15813,1,5813,[597 117   4 125 197],653,2,21228,3.651186790505676,0.0,0.0
15814,1,5814,[423 121 194 289 405],458,1,21229,3.6507308684436803,0.0,0.0
15815,1,5815,[228 357 180  96 161],749,4,21233,3.6507909215955983,20.0,0.0
15816,1,5816,[300 258 191 234  82],215,2,21235,3.650507134261647,0.0,0.0
15817,1,5817,[318 153 111 144  98],543,3,21238,3.6503953248539016,20.0,20.0
15818,1,5818,[471 483 187  97 276],90,5,21243,3.6506272555421893,20.0,0.0
15819,1,5819,[313 127 187 302 603],271,5,21248,3.6508591065292095,20.0,20.0
15820,1,5820,[228 173 196 357 403],42,4,21252,3.650919086067686,20.0,0.0
15821,1,5821,[268 100 328 204 132],92,3,21255,3.6508072827207148,0.0,20.0
15822,1,5822,[ 25 546 180 185 357],666,4,21259,3.6508672505581314,20.0,0.0
15823,1,5823,[483 111 238  82 183],537,2,21261,3.650583791208791,20.0,0.0
15824,1,5824,[508 269 515 282 186],334,2,21263,3.6503004291845493,0.0,0.0
15825,1,5825,[318 191  28  64  12],892,5,21268,3.6505320974939925,40.0,0.0
15826,1,5826,[196  71 127   9 168],7,5,21273,3.65076368628797,0.0,20.0
15827,1,5827,[234 151 228 588 483],312,3,21276,3.6506520247083047,20.0,0.0
15828,1,5828,[403   4 175  71 302],334,3,21279,3.6505404014410705,0.0,0.0
15829,1,5829,[179 235 174 597 603],897,3,21282,3.6504288164665524,20.0,20.0
15830,1,5830,[ 79  71  15 121 185],452,4,21286,3.6504887669353456,0.0,0.0
15831,1,5831,[180 187 302 182 132],6,5,21291,3.6507201646090537,0.0,0.0
15832,1,5832,[111 302 194   9 174],378,4,21295,3.6507800445739758,0.0,20.0
15833,1,5833,[313 127 187 302 603],334,5,21300,3.651011312992801,20.0,20.0
15834,1,5834,[ 12 508 117 328  22],13,2,21302,3.6507283633247645,20.0,0.0
15835,1,5835,[313 127 187 302 603],13,5,21307,3.650959561343386,20.0,20.0
15836,1,5836,[174 127 135  22 191],840,4,21311,3.6510193592598936,0.0,40.0
15837,1,5837,[302 180 286 216 288],13,2,21313,3.6507365536142515,0.0,0.0
15838,1,5838,[127 313 294   8 333],144,4,21317,3.6507963692413083,0.0,20.0
15839,1,5839,[176 265  70 121 318],7,3,21320,3.6506849315068495,20.0,0.0
15840,1,5840,[313 127 187 302 603],90,5,21325,3.6509159390515324,20.0,20.0
15841,1,5841,[427   8 313 191  64],308,4,21329,3.6509756932557345,0.0,0.0
15842,1,5842,[ 98 286 235 423 200],650,2,21331,3.6506931370871127,0.0,20.0
15843,1,5843,[313 127 187 302 603],334,5,21336,3.650924024640657,20.0,20.0
15844,1,5844,[313 127 187 302 603],537,5,21341,3.6511548331907613,20.0,20.0
15845,1,5845,[313 127 187 302 603],13,5,21346,3.6513855627779677,20.0,20.0
15846,1,5846,[313 127 187 302 603],334,5,21351,3.651616213442791,20.0,20.0
15847,1,5847,[183 117 181 200 597],308,3,21354,3.6515047879616964,0.0,0.0
15848,1,5848,[  1 588 302 234  82],10,5,21359,3.651735339374252,0.0,0.0
15849,1,5849,[496 475 318 234 300],479,2,21361,3.6514529914529916,20.0,0.0
15850,1,5850,[  4 168 191 288 111],533,3,21364,3.651341650999829,0.0,0.0
15851,1,5851,[204 144 211  97 181],738,4,21368,3.6514012303485988,0.0,0.0
15852,1,5852,[357 237 195 135   4],308,4,21372,3.6514607893388007,20.0,0.0
15853,1,5853,[288 216  56 118 197],308,2,21374,3.6511786812435942,0.0,0.0
15854,1,5854,[313 127 187 302 603],334,5,21379,3.651409052092229,20.0,20.0
15855,1,5855,[ 79 132 143 357 111],537,1,21380,3.6509562841530054,20.0,0.0
15856,1,5856,[200 496   7   9 121],378,3,21383,3.6508451425644526,0.0,0.0
15857,1,5857,[195  69 161 100 508],92,4,21387,3.6509047456469785,0.0,20.0
15858,1,5858,[194 483 121 357 197],666,3,21390,3.6507936507936507,40.0,0.0
15859,1,5859,[313 127 187 302 603],116,3,21393,3.650682593856655,20.0,20.0
15860,1,5860,[ 79 405 228 121   7],64,3,21396,3.6505715748165843,0.0,0.0
15861,1,5861,[194 238 269 471 294],271,3,21399,3.650460593654043,0.0,0.0
15862,1,5862,[196 496 403 435 127],892,4,21403,3.650520211495821,0.0,20.0
15863,1,5863,[313 210 258 153 202],659,5,21408,3.65075034106412,0.0,0.0
15864,1,5864,[196 603  89 286 127],13,4,21412,3.6508098891730607,20.0,20.0
15865,1,5865,[313 127 187 302 603],90,5,21417,3.651039890896693,20.0,20.0
15866,1,5866,[215 508  50 132  89],59,5,21422,3.651269814215101,0.0,20.0
15867,1,5867,[187  12  11   7  96],474,5,21427,3.651499659168371,20.0,0.0
15868,1,5868,[282 276  79 202  98],207,3,21430,3.6513886522405863,0.0,20.0
15869,1,5869,[ 88  97  96 403 151],479,3,21433,3.6512776831345826,0.0,0.0
15870,1,5870,[132   1 153 568 357],749,5,21438,3.651507409299949,20.0,0.0
15871,1,5871,[313 174 597 100 172],144,5,21443,3.6517370572207084,0.0,40.0
15872,1,5872,[313 127 187 302 603],271,5,21448,3.6519666269368294,20.0,20.0
15873,1,5873,[475  96 276   8 143],13,3,21451,3.6518556350017026,0.0,0.0
15874,1,5874,[234 294 117 655 435],232,2,21453,3.6515744680851063,0.0,0.0
15875,1,5875,[ 70 173  64 174 135],95,4,21457,3.6516337644656227,0.0,20.0
15876,1,5876,[ 82  79 483 144 194],343,5,21462,3.651863195507912,20.0,0.0
15877,1,5877,[111 176 182  64 196],59,5,21467,3.6520925484858795,0.0,0.0
15878,1,5878,[286 204 323   1 405],455,3,21470,3.6519816295288314,0.0,0.0
15879,1,5879,[132  22   1 172 100],537,1,21471,3.651530612244898,0.0,20.0
15880,1,5880,[ 11  71 318 161 508],92,3,21474,3.651419826560109,20.0,0.0
15881,1,5881,[  4 275 135  11 111],271,5,21479,3.6516490989459367,0.0,0.0
15882,1,5882,[151   1 143 174 111],42,4,21483,3.6517083120856704,0.0,20.0
15883,1,5883,[ 69 234 210 172 197],311,5,21488,3.6519374575118966,0.0,0.0
15884,1,5884,[183 194  97   4  96],664,2,21490,3.6516567544604928,0.0,0.0
15885,1,5885,[655 302 216 210 176],474,5,21495,3.6518858307849134,0.0,0.0
15886,1,5886,[742 515  96  98  69],488,4,21499,3.6519449634788517,0.0,20.0
15887,1,5887,[313 127 187 302 603],271,5,21504,3.652173913043478,20.0,20.0
15888,1,5888,[357 186 294 385 318],788,2,21506,3.651893360502632,40.0,0.0
15889,1,5889,[127 185 302 144 211],883,5,21511,3.6521222410865875,0.0,20.0
15890,1,5890,[187 603 132 273   7],524,2,21513,3.6518417925649294,20.0,0.0
15891,1,5891,[185 204 173 153  71],7,5,21518,3.652070604209097,0.0,0.0
15892,1,5892,[204  50 100 323 196],650,4,21522,3.652129645341931,0.0,40.0
15893,1,5893,[273 151 323 546 118],699,2,21524,3.651849338310146,0.0,0.0
15894,1,5894,[496 276 117 202 211],643,3,21527,3.651738761662426,0.0,0.0
15895,1,5895,[200 100 182 300  97],145,4,21531,3.651797829036635,0.0,20.0
15896,1,5896,[  1   9 245 318 265],378,4,21535,3.651856876377819,20.0,0.0
15897,1,5897,[111  25 180 235 286],537,1,21536,3.6514072566971856,0.0,0.0
15898,1,5898,[313 127 187 302 603],537,5,21541,3.651635870486523,20.0,20.0
15899,1,5899,[216   7 183 135 191],881,5,21546,3.651864406779661,0.0,0.0
15900,1,5900,[313 127 187 302 603],669,5,21551,3.652092865615997,20.0,20.0
15901,1,5901,[357   8 181 427 238],7,4,21555,3.6521518129447643,20.0,0.0
15902,1,5902,[258  25 181 151  56],447,4,21559,3.6522107403015416,0.0,0.0
15903,1,5903,[313 127 187 302 603],90,5,21564,3.652439024390244,20.0,20.0
15904,1,5904,[204 678 357 322  82],537,1,21565,3.6519898391193903,20.0,0.0
15905,1,5905,[  8 273 118  70 175],479,4,21569,3.6520487639688453,0.0,0.0
15906,1,5906,[313 127 187 302 603],116,3,21572,3.6519383781953616,20.0,20.0
15907,1,5907,[435 318 176 515  79],666,4,21576,3.651997291807718,20.0,0.0
15908,1,5908,[143 182 318 258 328],13,2,21578,3.6517177187341345,20.0,0.0
15909,1,5909,[  1 423 318 135 301],6,3,21581,3.65160744500846,20.0,0.0
15910,1,5910,[313 127 187 302 603],116,3,21584,3.6514972085941464,20.0,20.0
15911,1,5911,[313 127 187 302  64],271,5,21589,3.651725304465494,0.0,20.0
15912,1,5912,[313 127 187 302  64],328,5,21594,3.6519533231862,0.0,20.0
15913,1,5913,[195 202 117 483 125],406,3,21597,3.6518430842069667,20.0,0.0
15914,1,5914,[153 168  12 144 172],60,4,21601,3.6519019442096363,20.0,0.0
15915,1,5915,[132  70  79 173 216],398,5,21606,3.652129817444219,0.0,0.0
15916,1,5916,[289   4 100  95  98],455,3,21609,3.6520196045293223,0.0,40.0
15917,1,5917,[289  11  89 191  28],13,2,21611,3.6517404528556945,0.0,0.0
15918,1,5918,[228  22  15  69  95],194,3,21614,3.6516303429633385,0.0,0.0
15919,1,5919,[127 257 258 175   7],6,2,21616,3.651351351351351,0.0,20.0
15920,1,5920,[168 174 210  96 323],13,3,21619,3.6512413443675054,0.0,20.0
15921,1,5921,[238  88 258  79 300],454,4,21623,3.6513002364066196,0.0,0.0
15922,1,5922,[313 127 187 302  64],328,5,21628,3.651527941921324,0.0,20.0
15923,1,5923,[144 210 435 357 257],298,5,21633,3.6517555705604323,20.0,0.0
15924,1,5924,[173 151 161  56  89],378,4,21637,3.651814345991561,0.0,0.0
15925,1,5925,[210 196 302 385  64],537,1,21638,3.651366857914276,0.0,0.0
15926,1,5926,[176 180 405   1 276],13,2,21640,3.6510882402564535,0.0,0.0
15927,1,5927,[294 568  95  15 245],200,4,21644,3.6511470985155197,0.0,0.0
15928,1,5928,[313 568 174  11  96],13,3,21647,3.651037274413898,0.0,20.0
15929,1,5929,[181 168 678 515 182],881,2,21649,3.650758853288364,0.0,0.0
15930,1,5930,[271  98 258 275 301],334,3,21652,3.650649131680998,0.0,20.0
15931,1,5931,[211 238 427 546  97],343,4,21656,3.650708024275118,0.0,0.0
15932,1,5932,[313 127 187 302 483],328,5,21661,3.6509354458115624,20.0,20.0
15933,1,5933,[204 215 603 118  89],454,4,21665,3.650994270306707,20.0,0.0
15934,1,5934,[357   1 196  25 403],881,2,21667,3.650716090985678,20.0,0.0
15935,1,5935,[100  98  89 175  96],234,2,21669,3.6504380053908356,0.0,40.0
15936,1,5936,[276  97  25 195 211],210,5,21674,3.6506653191847733,0.0,0.0
15937,1,5937,[322 228 204 144 323],13,3,21677,3.650555742674301,0.0,0.0
15938,1,5938,[313 127 187 302 483],334,5,21682,3.650782960094292,20.0,20.0
15939,1,5939,[275 176 385 655 187],343,4,21686,3.6508417508417508,0.0,0.0
15940,1,5940,[427 172  96 237 234],13,5,21691,3.6510688436290186,0.0,0.0
15941,1,5941,[313 127 187 302 483],537,5,21696,3.651295859979805,20.0,20.0
15942,1,5942,[215 174 286  70 245],533,4,21700,3.651354534746761,0.0,20.0
15943,1,5943,[100 210  95  11  88],13,3,21703,3.6512449528936743,0.0,20.0
15944,1,5944,[ 79  22 471  69 405],13,2,21705,3.6509671993271655,0.0,0.0
15945,1,5945,[ 25 273 202 318  89],666,3,21708,3.6508577194752774,20.0,0.0
15946,1,5946,[423 200 173 127  50],234,4,21712,3.65091642845132,0.0,40.0
15947,1,5947,[228 182 289 196 234],194,0,21712,3.6503026227303295,0.0,0.0
15948,1,5948,[181 174  98 222 385],774,1,21713,3.649857118843503,0.0,40.0
15949,1,5949,[ 12   9  64 196 357],7,5,21718,3.6500840336134455,40.0,0.0
15950,1,5950,[194 234 135 265 118],543,3,21721,3.6499747941522434,0.0,0.0
15951,1,5951,[135 132 100 323 121],537,2,21723,3.6496975806451615,0.0,20.0
15952,1,5952,[313 127 187 302 483],13,5,21728,3.6499244078615822,20.0,20.0
15953,1,5953,[173 183 180 210 153],664,4,21732,3.6499832045683576,0.0,0.0
15954,1,5954,[313 127 187 302 483],90,5,21737,3.650209907640638,20.0,20.0
15955,1,5955,[173  50 132 211 161],452,3,21740,3.6501007387508393,0.0,20.0
15956,1,5956,[ 70 405  56  71  15],892,4,21744,3.650159476246433,0.0,0.0
15957,1,5957,[ 25 196 111 168 257],666,1,21745,3.6497146693521314,0.0,0.0
15958,1,5958,[  1 100 302 313 471],537,3,21748,3.649605638529955,0.0,20.0
15959,1,5959,[313 127 187 302 483],90,5,21753,3.649832214765101,20.0,20.0
15960,1,5960,[265 135 168 185 475],452,2,21755,3.649555443717497,0.0,0.0
15961,1,5961,[185 238  71 151  97],380,3,21758,3.6494464944649447,0.0,0.0
15962,1,5962,[186 546 132 176  98],749,4,21762,3.6495052825758845,0.0,20.0
15963,1,5963,[313 127 187 302 483],207,5,21767,3.6497317236753855,20.0,20.0
15964,1,5964,[403 245 257 288 200],334,3,21770,3.649622799664711,0.0,0.0
15965,1,5965,[313 127 187 302 483],334,5,21775,3.6498491451558834,20.0,20.0
15966,1,5966,[313 127 187 302 483],334,5,21780,3.650075414781297,20.0,20.0
15967,1,5967,[405 111 216 322 174],92,1,21781,3.6496313672922254,0.0,20.0
15968,1,5968,[ 95 568 328  89 180],749,4,21785,3.6496900653375777,0.0,0.0
15969,1,5969,[176 196   8 275 427],474,4,21789,3.649748743718593,0.0,0.0
15970,1,5970,[313 127 187 302 483],669,4,21793,3.6498074024451514,20.0,20.0
15971,1,5971,[288 333 183 423 144],346,4,21797,3.6498660415271265,0.0,0.0
15972,1,5972,[568 186  11 176  50],64,5,21802,3.6500920810313073,0.0,20.0
15973,1,5973,[313 127 187 302 483],334,5,21807,3.6503180448610646,20.0,20.0
15974,1,5974,[135 357 286 204 222],234,2,21809,3.650041841004184,20.0,0.0
15975,1,5975,[357 175 655  69 405],13,3,21812,3.6499330655957163,20.0,0.0
15976,1,5976,[  9 191 300  71  79],7,5,21817,3.650158942613351,0.0,0.0
15977,1,5977,[234 222 235 204 496],524,1,21818,3.6497156239544997,0.0,0.0
15978,1,5978,[235 210 234 181 202],194,0,21818,3.6491052015387186,0.0,0.0
15979,1,5979,[121 118 132 235 168],295,4,21822,3.649163879598662,0.0,0.0
15980,1,5980,[186 405 655   9   7],343,5,21827,3.6493897341581674,0.0,0.0
15981,1,5981,[176 238 403 603 179],650,3,21830,3.649281176863925,20.0,0.0
15982,1,5982,[313 127 187 302 483],13,5,21835,3.6495069363195722,20.0,20.0
15983,1,5983,[  4 496 257 161 118],738,3,21838,3.649398395721925,0.0,0.0
15984,1,5984,[183 196 603 435 175],749,4,21842,3.649456975772765,20.0,0.0
15985,1,5985,[151 322 403  70  82],334,3,21845,3.649348479786168,0.0,0.0
15986,1,5986,[ 97 603 328  96 187],313,5,21850,3.6495740771671956,20.0,0.0
15987,1,5987,[132  97  56 173 197],406,4,21854,3.649632598530394,0.0,0.0
15988,1,5988,[135 546 182 588  15],881,2,21856,3.6493571547837704,0.0,0.0
15989,1,5989,[405  97 435 515 153],343,5,21861,3.6495826377295493,0.0,0.0
15990,1,5990,[435 204 211 427  70],454,3,21864,3.6494742113169756,0.0,0.0
15991,1,5991,[132  15 238 173 210],488,3,21867,3.649365821094793,0.0,0.0
15992,1,5992,[197   7 174 186 181],833,0,21867,3.648756883030202,0.0,20.0
15993,1,5993,[313 127 187 302 603],537,5,21872,3.6489823156489822,20.0,20.0
15994,1,5994,[313 127 187 302 603],537,5,21877,3.649207673060884,20.0,20.0
15995,1,5995,[238 216 204 603 118],738,3,21880,3.649099399599733,20.0,0.0
15996,1,5996,[748 300 151 144 186],749,4,21884,3.649157912289478,0.0,0.0
15997,1,5997,[200 385 143 204 132],313,3,21887,3.6490496832277426,0.0,0.0
15998,1,5998,[588 258 210 508 111],13,3,21890,3.6489414902483746,0.0,0.0
15999,1,5999,[313 127 187 302 603],474,5,21895,3.6491666666666664,20.0,20.0
16000,1,6000,[313 127 187 302 603],669,5,21900,3.6493917680386603,20.0,20.0
16001,1,6001,[313 127 187 302 603],474,5,21905,3.649616794401866,20.0,20.0
16002,1,6002,[313 127 187 302 603],537,5,21910,3.6498417457937697,20.0,20.0
16003,1,6003,[237 318 405 403  88],346,3,21913,3.6497335109926716,20.0,0.0
16004,1,6004,[172 603 111 302  79],454,3,21916,3.6496253122398,20.0,0.0
16005,1,6005,[655 135  71 257 435],899,4,21920,3.6496836496836496,0.0,0.0
16006,1,6006,[ 89 357  82 603 174],650,4,21924,3.649741967704345,40.0,20.0
16007,1,6007,[ 97 238 125 655 197],7,5,21929,3.6499667110519307,0.0,0.0
16008,1,6008,[257 245 403 742   1],92,3,21932,3.6498585455150607,0.0,0.0
16009,1,6009,[313 127 187 302 603],116,3,21935,3.6497504159733776,20.0,20.0
16010,1,6010,[118 121 191 168 288],7,4,21939,3.649808684079188,0.0,0.0
16011,1,6011,[313 127 187 302 603],90,5,21944,3.650033266799734,20.0,20.0
16012,1,6012,[313 127 187 302 603],90,5,21949,3.650257774821221,20.0,20.0
16013,1,6013,[318   8 100 282 127],85,3,21952,3.6501496508147655,20.0,40.0
16014,1,6014,[313 127 187 302 603],537,5,21957,3.650374064837905,20.0,20.0
16015,1,6015,[  1 181  64 265 118],311,4,21961,3.650432180851064,0.0,0.0
16016,1,6016,[237 125 181 211  98],234,1,21962,3.6499916902110687,0.0,20.0
16017,1,6017,[161 183 176   7   9],328,5,21967,3.650216018610834,0.0,0.0
16018,1,6018,[194 151 328 176 125],788,3,21970,3.650107991360691,0.0,0.0
16019,1,6019,[144   4 357 202 427],234,3,21973,3.65,20.0,0.0
16020,1,6020,[ 22 135 496  28 191],343,5,21978,3.6502242152466366,0.0,0.0
16021,1,6021,[313 127 187 302 603],271,5,21983,3.6504483560278977,20.0,20.0
16022,1,6022,[234 196 168 181 678],92,4,21987,3.650506392163374,0.0,0.0
16023,1,6023,[269 200 222  88 323],378,2,21989,3.6502324037184595,0.0,0.0
16024,1,6024,[222  64   1 111  89],64,4,21993,3.6502904564315353,0.0,0.0
16025,1,6025,[181  15 496 173 132],234,2,21995,3.650016594756057,0.0,0.0
16026,1,6026,[475  11  22 294 215],474,4,21999,3.6500746640119464,0.0,0.0
16027,1,6027,[ 88 181  56 174 197],215,4,22003,3.650132714001327,0.0,20.0
16028,1,6028,[194  28 204  70 172],648,4,22007,3.650190744733787,0.0,0.0
16029,1,6029,[313 127 187 302 603],13,5,22012,3.650414593698176,20.0,20.0
16030,1,6030,[ 11 176 100 186 322],346,2,22014,3.6501409384844967,0.0,20.0
16031,1,6031,[111 215 191 175 222],234,1,22015,3.649701591511936,0.0,0.0
16032,1,6032,[289 186 195 333 168],13,2,22017,3.649428145201392,0.0,0.0
16033,1,6033,[313 127 187 302 603],90,5,22022,3.6496519721577725,20.0,20.0
16034,1,6034,[195 288 313 196  89],144,3,22025,3.649544324772162,0.0,0.0
16035,1,6035,[300 508 301 161 471],940,3,22028,3.649436713055003,0.0,0.0
16036,1,6036,[191  79 168 183  56],506,5,22033,3.649660427364585,0.0,0.0
16037,1,6037,[313 127 187 302 603],116,3,22036,3.649552832063597,20.0,20.0
16038,1,6038,[313 127 187 302  64],474,5,22041,3.6497764530551415,0.0,20.0
16039,1,6039,[313 179 234 117 210],543,2,22043,3.649503311258278,0.0,0.0
16040,1,6040,[187 195 216 275 210],409,4,22047,3.6495613309054793,0.0,0.0
16041,1,6041,[313 127 187 302  64],474,5,22052,3.6497848394571335,0.0,20.0
16042,1,6042,[ 56 182 318 191 173],454,2,22054,3.649511831871587,20.0,0.0
16043,1,6043,[313 127 187 302  64],144,4,22058,3.6495698213103904,0.0,20.0
16044,1,6044,[313 127 187 302  64],537,4,22062,3.6496277915632755,0.0,20.0
16045,1,6045,[313 127 187 302 483],90,5,22067,3.6498511412504135,20.0,20.0
16046,1,6046,[313 127 187 302 483],537,5,22072,3.650074417066314,20.0,20.0
16047,1,6047,[215 313 151 181  89],59,5,22077,3.650297619047619,0.0,0.0
16048,1,6048,[ 15 328 294 181 180],144,4,22081,3.6503554306496944,0.0,0.0
16049,1,6049,[117 121 176 172 183],537,0,22081,3.6497520661157026,0.0,0.0
16050,1,6050,[180 194  79 204 748],474,4,22085,3.6498099487687985,0.0,0.0
16051,1,6051,[313 127 187 302 483],334,5,22090,3.650033046926636,20.0,20.0
16052,1,6052,[  1  97  88 202 210],653,2,22092,3.649760449363952,0.0,0.0
16053,1,6053,[222 180 168 187 182],210,5,22097,3.649983481995375,0.0,0.0
16054,1,6054,[173 423 435 588 237],64,5,22102,3.650206440957886,0.0,0.0
16055,1,6055,[182 427   4 216 357],406,3,22105,3.6500990752972258,20.0,0.0
16056,1,6056,[313 127 187 302 483],207,5,22110,3.6503219415552253,20.0,20.0
16057,1,6057,[ 71  96 195 117 174],308,4,22114,3.6503796632551997,0.0,20.0
16058,1,6058,[301   9 211 273 234],328,3,22117,3.6502723221653737,0.0,0.0
16059,1,6059,[748 475  97 118 276],13,4,22121,3.6503300330033004,0.0,0.0
16060,1,6060,[265 222 546 204 289],378,3,22124,3.650222735522191,0.0,0.0
16061,1,6061,[  1 333 475  25 197],13,1,22125,3.6497855493236555,0.0,0.0
16062,1,6062,[175 185 427  69  79],13,3,22128,3.649678377041069,0.0,0.0
16063,1,6063,[ 11   7 153   4 403],295,5,22133,3.649901055408971,0.0,0.0
16064,1,6064,[483  22 153 435 333],298,4,22137,3.649958779884584,20.0,0.0
16065,1,6065,[132  69 234 742  96],488,3,22140,3.649851632047478,0.0,0.0
16066,1,6066,[172 515  50 197 168],452,5,22145,3.650074171748805,0.0,20.0
16067,1,6067,[234 195 603 423 180],738,5,22150,3.650296638101516,20.0,0.0
16068,1,6068,[179 222 181  82 603],815,3,22153,3.6501894875597296,20.0,0.0
16069,1,6069,[515  22   1 483 204],313,4,22157,3.6502471169686985,20.0,0.0
16070,1,6070,[186   1 269 216 357],13,1,22158,3.649810574864108,20.0,0.0
16071,1,6071,[ 22 588 179 655 118],840,3,22161,3.649703557312253,0.0,0.0
16072,1,6072,[313 127 187 302 483],537,5,22166,3.6499259015313683,20.0,20.0
16073,1,6073,[ 50 176 204  95 603],334,3,22169,3.649818900230491,20.0,20.0
16074,1,6074,[405 180  98  70 302],378,3,22172,3.6497119341563784,0.0,20.0
16075,1,6075,[ 98 245 125 265 333],263,4,22176,3.6497695852534564,0.0,20.0
16076,1,6076,[173  89 265 202  11],378,3,22179,3.649662662497943,0.0,0.0
16077,1,6077,[173 175 135 179  56],659,3,22182,3.6495557749259624,0.0,0.0
16078,1,6078,[313 127 187 302 483],13,5,22187,3.649777924000658,20.0,20.0
16079,1,6079,[313 127 187 302 483],537,5,22192,3.65,20.0,20.0
16080,1,6080,[385 245 197 173 186],804,5,22197,3.6502220029600396,0.0,0.0
16081,1,6081,[ 82 655 194 328 678],537,0,22197,3.6496218349227227,0.0,0.0
16082,1,6082,[143 144 302 318 294],666,2,22199,3.6493506493506493,20.0,0.0
16083,1,6083,[175 435   1 471   8],313,4,22203,3.649408284023669,0.0,0.0
16084,1,6084,[ 97 275 603 215 100],271,5,22208,3.649630238290879,20.0,20.0
16085,1,6085,[222 202 742 403 197],749,4,22212,3.6496878080841273,0.0,0.0
16086,1,6086,[ 82 237  50 197 183],883,3,22215,3.649581074420897,0.0,20.0
16087,1,6087,[ 71 435 196 179 603],59,4,22219,3.6496386333771356,20.0,0.0
16088,1,6088,[237 597  12 257 301],455,1,22220,3.6492034816882906,20.0,0.0
16089,1,6089,[  7 173 508 180 603],13,2,22222,3.6489326765188834,20.0,0.0
16090,1,6090,[313 127 187 302 483],207,5,22227,3.649154490231489,20.0,20.0
16091,1,6091,[ 82 211 210 273  79],385,0,22227,3.6485554826001314,0.0,0.0
16092,1,6092,[183 180 323   8 546],87,3,22230,3.6484490398818314,0.0,0.0
16093,1,6093,[603 508   4 483  88],643,4,22234,3.6485067279291106,40.0,0.0
16094,1,6094,[173 100 186  96 195],312,3,22237,3.648400328137818,0.0,20.0
16095,1,6095,[742 294  98 173  95],200,5,22242,3.6486220472440944,0.0,20.0
16096,1,6096,[ 71  15 318 187 195],543,3,22245,3.6485156634410365,20.0,0.0
16097,1,6097,[183   4 161  88 118],92,2,22247,3.648245326336504,0.0,0.0
16098,1,6098,[191   9 237 186 125],749,3,22250,3.648139039186752,0.0,0.0
16099,1,6099,[313 127 187 302 483],13,5,22255,3.648360655737705,20.0,20.0
16100,1,6100,[313 127 187 302 483],334,5,22260,3.6485821996394034,20.0,20.0
16101,1,6101,[313 546 269 276 237],271,3,22263,3.6484759095378565,0.0,0.0
16102,1,6102,[234  69  56 179 385],90,4,22267,3.648533508110765,0.0,0.0
16103,1,6103,[313 121   8 597 117],308,1,22268,3.648099606815203,0.0,0.0
16104,1,6104,[151 222 294 288   9],447,2,22270,3.647829647829648,0.0,0.0
16105,1,6105,[423 322 288 228 175],334,3,22273,3.6477235506059613,0.0,0.0
16106,1,6106,[100 568  70 185 276],311,3,22276,3.647617488128377,0.0,20.0
16107,1,6107,[237 268 161  95 435],85,4,22280,3.647675180091683,0.0,0.0
16108,1,6108,[118   7 276  97 655],59,5,22285,3.6478965460795547,0.0,0.0
16109,1,6109,[289 268 187 173  28],537,3,22288,3.6477905073649755,0.0,0.0
16110,1,6110,[313 127 187 302 483],90,5,22293,3.6480117820324005,20.0,20.0
16111,1,6111,[ 22 144 118 265 186],295,4,22297,3.6480693717277486,0.0,0.0
16112,1,6112,[471 228 265 435 742],447,4,22301,3.648126942581384,0.0,0.0
16113,1,6113,[135 132 216  15 357],474,5,22306,3.648348053647367,20.0,0.0
16114,1,6114,[313 127 187 302 483],328,5,22311,3.648569092395748,20.0,20.0
16115,1,6115,[210 173 313  11 265],102,0,22311,3.6479725310660562,0.0,0.0
16116,1,6116,[161  50 655  71 302],474,5,22316,3.648193558934118,0.0,20.0
16117,1,6117,[ 28  70 333 286 191],653,4,22320,3.6482510624387054,0.0,0.0
16118,1,6118,[475 275 191 546   8],343,4,22324,3.648308547148227,0.0,0.0
16119,1,6119,[111 237 210 183 234],234,2,22326,3.6480392156862744,0.0,0.0
16120,1,6120,[313 127 187 302 483],90,5,22331,3.648260088220879,20.0,20.0
16121,1,6121,[  7 144 151 222  22],378,3,22334,3.648154197974518,0.0,0.0
16122,1,6122,[427 568 183  98 216],940,3,22337,3.648048342315858,0.0,20.0
16123,1,6123,[180 204 185 216 191],234,1,22338,3.647615937295885,0.0,0.0
16124,1,6124,[ 95 215 117 275 197],536,4,22342,3.647673469387755,0.0,0.0
16125,1,6125,[127 234 100 194  25],533,4,22346,3.6477309826967024,0.0,40.0
16126,1,6126,[  7 294 228 180 200],788,3,22349,3.6476252652195202,0.0,0.0
16127,1,6127,[132 302 211 427 191],13,4,22353,3.647682767624021,0.0,0.0
16128,1,6128,[195 603 678  96 748],749,3,22356,3.647577092511013,20.0,0.0
16129,1,6129,[289 117 748 222 168],524,1,22357,3.6471451876019576,0.0,0.0
16130,1,6130,[313 127 187 302 483],537,5,22362,3.6473658457021694,20.0,20.0
16131,1,6131,[234 185 204 435  69],271,4,22366,3.647423352902805,0.0,0.0
16132,1,6132,[ 96 100 294 174 435],474,4,22370,3.6474808413500734,0.0,40.0
16133,1,6133,[228 222 194  79 234],234,2,22372,3.6472122595370067,0.0,0.0
16134,1,6134,[313 127 187 302 483],537,5,22377,3.647432762836186,20.0,20.0
16135,1,6135,[568 196 186 194  88],326,4,22381,3.647490221642764,0.0,0.0
16136,1,6136,[313 127 187 302 483],669,4,22385,3.6475476617239693,20.0,20.0
16137,1,6137,[185  22 275 237 235],328,4,22389,3.647605083088954,0.0,0.0
16138,1,6138,[313 127 187 302 483],13,5,22394,3.6478253787261767,20.0,20.0
16139,1,6139,[496 143 238 603 202],308,4,22398,3.647882736156352,20.0,0.0
16140,1,6140,[313 127 187 302 483],474,5,22403,3.6481029148347175,20.0,20.0
16141,1,6141,[ 64 175 100 191   1],406,5,22408,3.6483230218169975,0.0,20.0
16142,1,6142,[181  12 588 211  64],59,4,22412,3.6483802702262738,20.0,0.0
16143,1,6143,[176  64 182 216 655],881,4,22416,3.6484375,0.0,0.0
16144,1,6144,[202 588 235 323 172],13,3,22419,3.64833197721725,0.0,0.0
16145,1,6145,[265 515  95  97 168],815,3,22422,3.6482264887731857,0.0,0.0
16146,1,6146,[127 211 181 235  95],59,3,22425,3.6481210346510493,0.0,20.0
16147,1,6147,[ 56 215  15 211 275],533,4,22429,3.648178269355888,0.0,0.0
16148,1,6148,[471 132 265  97  64],533,3,22432,3.648072857375183,0.0,0.0
16149,1,6149,[258 200 174 186 471],311,4,22436,3.648130081300813,0.0,20.0
16150,1,6150,[ 71 237 151 275  95],524,0,22436,3.6475369858559583,0.0,0.0
16151,1,6151,[313 127 187 302 483],537,5,22441,3.647756827048114,20.0,20.0
16152,1,6152,[423 496 313 269  69],738,4,22445,3.6478140744352348,0.0,0.0
16153,1,6153,[323   9 289  79 204],455,3,22448,3.647708807279818,0.0,0.0
16154,1,6154,[282 183   9   1  56],447,3,22451,3.647603574329813,0.0,0.0
16155,1,6155,[215 588 202 143 294],650,1,22452,3.6471734892787526,0.0,0.0
16156,1,6156,[ 89 423  25 181 183],749,5,22457,3.647393210979373,0.0,0.0
16157,1,6157,[655 185 215 176 357],804,5,22462,3.64761286131861,20.0,0.0
16158,1,6158,[194 385 215 125 135],804,4,22466,3.6476700763110896,0.0,0.0
16159,1,6159,[357 187 313 144 588],144,5,22471,3.6478896103896106,20.0,0.0
16160,1,6160,[313 127 187 302 483],207,5,22476,3.648109073202402,20.0,20.0
16161,1,6161,[496  79 174  69  89],840,5,22481,3.648328464784161,0.0,20.0
16162,1,6162,[300 288 215 176  64],892,5,22486,3.6485477851695602,0.0,0.0
16163,1,6163,[ 71 117 151 322 234],901,4,22490,3.648604802076574,0.0,0.0
16164,1,6164,[191 186 471 405  71],13,2,22492,3.648337388483374,0.0,0.0
16165,1,6165,[  8  56 197 483 185],480,2,22494,3.648070061628284,20.0,0.0
16166,1,6166,[385   8 276 135 196],200,5,22499,3.6482892816604506,0.0,0.0
16167,1,6167,[117 238 222 181 385],454,0,22499,3.647697795071336,0.0,0.0
16168,1,6168,[313 127 187 302 483],474,5,22504,3.647917004376722,20.0,20.0
16169,1,6169,[483 197 328 194 182],804,5,22509,3.648136142625608,20.0,0.0
16170,1,6170,[234 180   4  88  96],659,3,22512,3.648031113271755,0.0,0.0
16171,1,6171,[269 423 180 273  98],207,4,22516,3.6480881399870384,0.0,20.0
16172,1,6172,[235 143 238 161 405],479,2,22518,3.6478211566499272,0.0,0.0
16173,1,6173,[475 257 186 258 195],6,3,22521,3.6477162293488825,0.0,0.0
16174,1,6174,[ 56   1 427 202 175],343,5,22526,3.6479352226720647,0.0,0.0
16175,1,6175,[286 187 333 294 180],328,3,22529,3.647830310880829,0.0,0.0
16176,1,6176,[257 222  88 265 180],474,4,22533,3.647887323943662,0.0,0.0
16177,1,6177,[313 127 187 302 483],90,5,22538,3.6481061832308193,20.0,20.0
16178,1,6178,[323 269  50 294 357],537,2,22540,3.6478394562226897,20.0,20.0
16179,1,6179,[179 276 323   4  12],13,3,22543,3.6477346278317153,20.0,0.0
16180,1,6180,[483 237 333 471 546],343,3,22546,3.647629833360298,20.0,0.0
16181,1,6181,[210 471 100  79 195],374,4,22550,3.6476868327402134,0.0,20.0
16182,1,6182,[222 318 194 238 132],87,4,22554,3.6477438136826783,20.0,0.0
16183,1,6183,[200 289 257 127 275],474,1,22555,3.647315653298836,0.0,20.0
16184,1,6184,[300 161 186 197 238],653,3,22558,3.647210994341148,0.0,0.0
16185,1,6185,[125  69  82 182 127],653,3,22561,3.647106369220821,0.0,20.0
16186,1,6186,[385 286  56 357 125],881,3,22564,3.647001777921448,20.0,0.0
16187,1,6187,[185 173  88 197 234],406,3,22567,3.646897220426632,0.0,0.0
16188,1,6188,[186 655 202 195 127],840,5,22572,3.64711585070286,0.0,20.0
16189,1,6189,[313 127 187 302 483],334,5,22577,3.6473344103392566,20.0,20.0
16190,1,6190,[301 183 568 603 403],13,2,22579,3.6470683249878855,20.0,0.0
16191,1,6191,[ 15 204  56  97 176],398,5,22584,3.647286821705426,0.0,0.0
16192,1,6192,[ 12 435 100 258  96],7,5,22589,3.6475052478604875,20.0,20.0
16193,1,6193,[276 471 151  64  22],234,2,22591,3.647239263803681,0.0,0.0
16194,1,6194,[313 127 187 302 483],474,5,22596,3.647457627118644,20.0,20.0
16195,1,6195,[195   9 289  97  12],374,2,22598,3.647191736604261,20.0,0.0
16196,1,6196,[202 174 186 153 135],308,5,22603,3.647410037114733,0.0,20.0
16197,1,6197,[423   9 195 357 161],749,3,22606,3.6473055824459504,20.0,0.0
16198,1,6198,[153  88  56 100 187],343,5,22611,3.6475237941603487,0.0,20.0
16199,1,6199,[185 294 269 385 222],666,2,22613,3.647258064516129,0.0,0.0
16200,1,6200,[313 127 187 302 483],474,5,22618,3.6474762135139494,20.0,20.0
16201,1,6201,[168 435 181 127 143],263,5,22623,3.647694292163818,0.0,20.0
16202,1,6202,[313 127 187 302 483],474,5,22628,3.6479123004997582,20.0,20.0
16203,1,6203,[318 202 275 174 265],343,4,22632,3.6479690522243713,20.0,20.0
16204,1,6204,[313 127 187 302 483],328,5,22637,3.6481869460112812,20.0,20.0
16205,1,6205,[ 82 318  96 405 132],200,4,22641,3.6482436351917498,20.0,0.0
16206,1,6206,[176 210  96 175 483],234,1,22642,3.647816980828097,20.0,0.0
16207,1,6207,[  1 546 176 195 127],897,5,22647,3.648034793814433,0.0,20.0
16208,1,6208,[ 50 151 333 186 483],881,2,22649,3.6477693670478337,20.0,20.0
16209,1,6209,[ 22   1 117  50 546],897,4,22653,3.6478260869565218,0.0,20.0
16210,1,6210,[288 202 204 174 323],537,0,22653,3.6472387699243276,0.0,20.0
16211,1,6211,[546 265  56 100 508],207,2,22655,3.646973599484868,0.0,20.0
16212,1,6212,[313 127 187 302 483],537,5,22660,3.647191372927732,20.0,20.0
16213,1,6213,[405 168 186 289  56],406,1,22661,3.646765368522691,0.0,0.0
16214,1,6214,[313 197 176 265 328],271,3,22664,3.6466613032984716,0.0,0.0
16215,1,6215,[286 265 276 237 678],554,2,22666,3.6463963963963963,0.0,0.0
16216,1,6216,[313 127 187 302 483],669,4,22670,3.646453273282934,20.0,20.0
16217,1,6217,[471 118 228 121 282],447,5,22675,3.6466709552910905,0.0,0.0
16218,1,6218,[181 294 515 118  70],804,5,22680,3.646888567293777,0.0,0.0
16219,1,6219,[153 202  89 204  70],479,5,22685,3.647106109324759,0.0,0.0
16220,1,6220,[313 127 187 302 483],328,5,22690,3.6473235814177785,20.0,20.0
16221,1,6221,[313 127 187 302 483],207,5,22695,3.6475409836065573,20.0,20.0
16222,1,6222,[215 403 216 186 568],506,5,22700,3.6477583159247953,0.0,0.0
16223,1,6223,[258 179 191 181 195],843,3,22703,3.6476542416452444,0.0,0.0
16224,1,6224,[211 238  71 655 117],387,2,22705,3.647389558232932,0.0,0.0
16225,1,6225,[117 328 125 185  71],234,0,22705,3.6468037263090265,0.0,0.0
16226,1,6226,[427 180 328  64 322],533,4,22709,3.64686044644291,0.0,0.0
16227,1,6227,[181  15 471 186 222],537,1,22710,3.6464354527938343,0.0,0.0
16228,1,6228,[313 127 187 302  64],271,5,22715,3.646652753250923,0.0,20.0
16229,1,6229,[ 89 235 405 483   1],184,3,22718,3.646548956661316,20.0,0.0
16230,1,6230,[ 82 161 135 186 269],738,4,22722,3.646605681271064,0.0,0.0
16231,1,6231,[228 403 385  71 258],749,4,22726,3.6466623876765083,0.0,0.0
16232,1,6232,[202 286 211 288 357],59,4,22730,3.646719075886411,20.0,0.0
16233,1,6233,[ 69 568 301 655 168],13,3,22733,3.6466153352582613,0.0,0.0
16234,1,6234,[313 127 187 302  64],669,5,22738,3.646832397754611,0.0,20.0
16235,1,6235,[ 64  56 195 196 168],653,3,22741,3.6467286722257857,0.0,0.0
16236,1,6236,[ 97  28  69 678  88],474,4,22745,3.6467853134519803,0.0,0.0
16237,1,6237,[313 127 187 302  64],669,5,22750,3.6470022443090735,0.0,20.0
16238,1,6238,[ 97   9 100 181 655],13,4,22754,3.6470588235294117,0.0,20.0
16239,1,6239,[546  82 174 515  64],308,3,22757,3.646955128205128,0.0,20.0
16240,1,6240,[427 100 403   1  22],788,2,22759,3.646691235378946,0.0,20.0
16241,1,6241,[483  82 191 196 132],234,3,22762,3.6465876321691764,20.0,0.0
16242,1,6242,[204 176   4 173 215],882,5,22767,3.6468044209514656,0.0,0.0
16243,1,6243,[ 95 265 471 191 655],815,2,22769,3.6465406790518897,0.0,0.0
16244,1,6244,[143 187 234  28 423],479,3,22772,3.646437149719776,0.0,0.0
16245,1,6245,[313 127 187 302  64],537,4,22776,3.6464937560038426,0.0,20.0
16246,1,6246,[174 118 323 197   4],881,2,22778,3.646230190491436,0.0,20.0
16247,1,6247,[678  50 181 204  95],454,2,22780,3.645966709346991,0.0,20.0
16248,1,6248,[195 125  71  11 483],788,1,22781,3.6455432869259083,20.0,0.0
16249,1,6249,[ 50 194 174 234  15],537,1,22782,3.64512,0.0,40.0
16250,1,6250,[151 132 655  98 127],666,4,22786,3.6451767717165255,0.0,40.0
16251,1,6251,[322  25 196 127  95],537,1,22787,3.644753678822777,0.0,20.0
16252,1,6252,[435  50 144 168 423],643,5,22792,3.6449704142011834,0.0,20.0
16253,1,6253,[182 322  56  11 228],334,3,22795,3.64486728493764,0.0,0.0
16254,1,6254,[313 127 187 302 483],13,5,22800,3.645083932853717,20.0,20.0
16255,1,6255,[313 127 187 302 483],334,5,22805,3.6453005115089514,20.0,20.0
16256,1,6256,[603 182 187 168 181],7,4,22809,3.6453571999360714,20.0,0.0
16257,1,6257,[179 323 121 191 174],378,3,22812,3.645254074784276,0.0,20.0
16258,1,6258,[257  12 127 215 405],385,1,22813,3.6448314427224795,20.0,20.0
16259,1,6259,[135  79 568  88  56],378,4,22817,3.644888178913738,0.0,0.0
16260,1,6260,[151  98 100 194  64],213,5,22822,3.645104615876058,0.0,40.0
16261,1,6261,[257 161  97 403 655],210,5,22827,3.6453209837112746,0.0,0.0
16262,1,6262,[ 71 183 182  64 300],64,3,22830,3.6452179466709245,0.0,0.0
16263,1,6263,[313 127 187 302 483],328,5,22835,3.645434227330779,20.0,20.0
16264,1,6264,[ 82 185  56 111 546],234,0,22835,3.644852354349561,0.0,0.0
16265,1,6265,[ 98   7 186 144   9],13,3,22838,3.6447494414299393,0.0,20.0
16266,1,6266,[ 11 515  79  97 172],64,4,22842,3.6448061273336525,0.0,0.0
16267,1,6267,[176 180 238 191  11],527,4,22846,3.644862795149968,0.0,0.0
16268,1,6268,[313 127 187 302 483],537,5,22851,3.6450789599617166,20.0,20.0
16269,1,6269,[118 405 265  56  12],328,4,22855,3.645135566188198,20.0,0.0
16270,1,6270,[ 70   1 111  50  98],533,5,22860,3.645351618561633,0.0,40.0
16271,1,6271,[313 127 187 302 483],537,5,22865,3.6455676020408165,20.0,20.0
16272,1,6272,[275 427 176  12  11],499,3,22868,3.6454646899410172,20.0,0.0
16273,1,6273,[471 546 405 143 328],533,3,22871,3.645361810647115,0.0,0.0
16274,1,6274,[ 79 357 183 269 258],650,3,22874,3.645258964143426,20.0,0.0
16275,1,6275,[173 181 237   9 294],378,4,22878,3.6453154875717018,0.0,0.0
16276,1,6276,[ 25 286 111 258  22],234,1,22879,3.6448940576708617,0.0,0.0
16277,1,6277,[132 111 546 328 515],271,3,22882,3.6447913348200065,0.0,0.0
16278,1,6278,[143 168 216 197 210],7,4,22886,3.6448479057174707,0.0,0.0
16279,1,6279,[121 603 286  71 403],648,3,22889,3.644745222929936,20.0,0.0
16280,1,6280,[313 127 187 302 483],334,5,22894,3.644960993472377,20.0,20.0
16281,1,6281,[ 15 179 173 100 269],271,4,22898,3.645017510347023,0.0,20.0
16282,1,6282,[121 222 215 328  56],653,3,22901,3.644914849594143,0.0,0.0
16283,1,6283,[435 180 195 187  12],385,2,22903,3.6446530872056013,20.0,0.0
16284,1,6284,[235  82 427 202 300],125,4,22907,3.6447096260938743,0.0,0.0
16285,1,6285,[313 127 187 302 483],537,5,22912,3.6449252306713333,20.0,20.0
16286,1,6286,[ 11 186 603  79  56],666,3,22915,3.644822649912518,20.0,0.0
16287,1,6287,[ 69 187 597 237 496],458,2,22917,3.64456106870229,0.0,0.0
16288,1,6288,[174   9 200  69 265],311,5,22922,3.6447765940531087,0.0,20.0
16289,1,6289,[435 483  79 333 144],298,5,22927,3.644992050874404,20.0,0.0
16290,1,6290,[603  28 118  96 121],308,2,22929,3.6447305674773487,20.0,0.0
16291,1,6291,[313 127 187 302 483],669,4,22933,3.6447870311506674,20.0,20.0
16292,1,6292,[483 597 238  12 173],213,5,22938,3.6450023836008265,40.0,0.0
16293,1,6293,[173   9 111 273 265],92,3,22941,3.6448999046711155,0.0,0.0
16294,1,6294,[405 483 175 228 748],804,5,22946,3.6451151707704526,20.0,0.0
16295,1,6295,[568 191 182   7 427],59,5,22951,3.645330368487929,0.0,0.0
16296,1,6296,[313 127 187 302 483],474,5,22956,3.645545497856122,20.0,20.0
16297,1,6297,[ 89  69 191 196 288],455,3,22959,3.645442997777072,0.0,0.0
16298,1,6298,[  7 302 183 161 144],158,3,22962,3.645340530242896,0.0,0.0
16299,1,6299,[  9 191 118 183 435],308,4,22966,3.6453968253968254,0.0,0.0
16300,1,6300,[282 118 276 257 475],294,2,22968,3.645135692747183,0.0,0.0
16301,1,6301,[405 186 215 121 211],59,4,22972,3.6451920025388764,0.0,0.0
16302,1,6302,[323 161 183 175 191],474,4,22976,3.645248294462954,0.0,0.0
16303,1,6303,[ 28 174 196 403 143],343,5,22981,3.6454631979695433,0.0,20.0
16304,1,6304,[313 127 187 302 483],669,4,22985,3.6455194290245836,20.0,20.0
16305,1,6305,[235 318 515 273  70],13,0,22985,3.644941325721535,20.0,0.0
16306,1,6306,[210 475 276 238 508],605,2,22987,3.64468051371492,0.0,0.0
16307,1,6307,[ 88 216 215 191 235],308,2,22989,3.644419784400761,0.0,0.0
16308,1,6308,[ 98 276 603 135  70],10,5,22994,3.6446346489142494,20.0,20.0
16309,1,6309,[313 127 187 302 603],90,5,22999,3.644849445324881,20.0,20.0
16310,1,6310,[176 289 185 200 323],881,2,23001,3.6445888131833306,0.0,0.0
16311,1,6311,[173 211 302 385 300],666,3,23004,3.6444866920152093,0.0,0.0
16312,1,6312,[173  71 125 228 176],899,2,23006,3.644226199904958,0.0,0.0
16313,1,6313,[ 89 194 144  71 100],378,5,23011,3.64444092492873,0.0,20.0
16314,1,6314,[144 143 121 588  28],7,4,23015,3.6444972288202693,0.0,0.0
16315,1,6315,[196 180  97 183 143],840,4,23019,3.6445535148828374,0.0,0.0
16316,1,6316,[127 275 211 216 153],452,3,23022,3.6444514801329744,0.0,20.0
16317,1,6317,[196 258 186  70  11],666,3,23025,3.644349477682811,0.0,0.0
16318,1,6318,[ 89 191  25   7 234],648,3,23028,3.644247507517012,0.0,0.0
16319,1,6319,[210  64 294 471 182],666,3,23031,3.644145569620253,0.0,0.0
16320,1,6320,[ 95  15  82  98 100],313,2,23033,3.643885461161209,0.0,40.0
16321,1,6321,[183 228 496 135  56],313,3,23036,3.6437836127807657,0.0,0.0
16322,1,6322,[238 197 180  28 294],804,5,23041,3.643998102166693,0.0,0.0
16323,1,6323,[117  95 238 186  98],92,4,23045,3.644054395951929,0.0,20.0
16324,1,6324,[435 234   4   1 161],648,3,23048,3.6439525691699606,0.0,0.0
16325,1,6325,[237 127 187 323 483],804,4,23052,3.6440088523553587,20.0,20.0
16326,1,6326,[427 603  11 181 127],59,5,23057,3.64422317053896,20.0,20.0
16327,1,6327,[313 127 187 302 603],90,5,23062,3.6444374209860935,20.0,20.0
16328,1,6328,[655 211 151 182  12],339,5,23067,3.644651603728867,20.0,0.0
16329,1,6329,[603   4  28 546  69],648,3,23070,3.6445497630331753,20.0,0.0
16330,1,6330,[135 427 181 168 132],882,5,23075,3.64476386036961,0.0,0.0
16331,1,6331,[202 483 185 597  82],897,3,23078,3.6446620341124447,20.0,0.0
16332,1,6332,[ 25 313 288 435 174],59,5,23083,3.6448760461076897,0.0,20.0
16333,1,6333,[117  64 211 132 127],95,3,23086,3.6447742342911273,0.0,20.0
16334,1,6334,[237  88 423 210 496],215,4,23090,3.6448303078137334,0.0,0.0
16335,1,6335,[153 748  50 191  89],313,3,23093,3.6447285353535355,0.0,20.0
16336,1,6336,[313 127 187 302 603],90,5,23098,3.644942401767398,20.0,20.0
16337,1,6337,[385 127  69  97 423],194,2,23100,3.6446828652571788,0.0,20.0
16338,1,6338,[202 185 655  98 282],326,4,23104,3.6447389178103804,0.0,20.0
16339,1,6339,[ 56  22  97 211 181],387,4,23108,3.644794952681388,0.0,0.0
16340,1,6340,[186  82  79 385 273],524,2,23110,3.6445355622141618,0.0,0.0
16341,1,6341,[546 475 100 273 257],637,1,23111,3.644118574582151,0.0,20.0
16342,1,6342,[ 56  97 174  88 405],892,5,23116,3.644332334857323,0.0,20.0
16343,1,6343,[173  71 234 161  96],64,3,23119,3.644230769230769,0.0,0.0
16344,1,6344,[ 25 210  79 127  96],234,1,23120,3.64381402679275,0.0,20.0
16345,1,6345,[ 95 228   7 181  64],64,5,23125,3.644027734005673,0.0,0.0
16346,1,6346,[313 127 187 302 603],474,5,23130,3.6442413738774224,20.0,20.0
16347,1,6347,[403  56 168 151 294],650,1,23131,3.643824826717076,0.0,0.0
16348,1,6348,[194 323  79 210   4],13,2,23133,3.6435659158922666,0.0,0.0
16349,1,6349,[204 258  82 127 194],59,3,23136,3.6434645669291337,0.0,20.0
16350,1,6350,[161 191  12   9   7],64,4,23140,3.643520705400724,20.0,0.0
16351,1,6351,[127 238 405  56 357],892,5,23145,3.643734256926952,20.0,20.0
16352,1,6352,[204 234 132 403   1],650,3,23148,3.6436329293247285,0.0,0.0
16353,1,6353,[  7 301   8 269 180],378,3,23151,3.6435316336166195,0.0,0.0
16354,1,6354,[568 202 185   9  15],59,5,23156,3.6437450826121163,0.0,0.0
16355,1,6355,[210 173 127 515 282],85,2,23158,3.6434864694776588,0.0,20.0
16356,1,6356,[127 228 144 118 234],194,2,23160,3.6432279377064654,0.0,20.0
16357,1,6357,[313 127 187 302 603],537,5,23165,3.6434413337527523,20.0,20.0
16358,1,6358,[313 127 187 302 603],90,5,23170,3.643654662682812,20.0,20.0
16359,1,6359,[ 98 269  79 168 132],537,1,23171,3.6432389937106917,0.0,20.0
16360,1,6360,[222 257 118 258 200],378,3,23174,3.643137871403867,0.0,0.0
16361,1,6361,[568 187 655  25 216],207,5,23179,3.6433511474379126,0.0,0.0
16362,1,6362,[117 100 222 286   8],454,2,23181,3.643092880716643,0.0,20.0
16363,1,6363,[121 172 127 265 174],14,2,23183,3.6428346951602766,0.0,40.0
16364,1,6364,[313 127 187 302 603],334,5,23188,3.6430479183032207,20.0,20.0
16365,1,6365,[176 588 496 174 322],804,5,23193,3.6432610744580582,0.0,20.0
16366,1,6366,[196 333 403 215  89],881,2,23195,3.643002984136956,0.0,0.0
16367,1,6367,[200 153  64 187  89],488,2,23197,3.642744974874372,0.0,0.0
16368,1,6368,[313 127 187 302 603],13,5,23202,3.642958078191239,20.0,20.0
16369,1,6369,[179 121  96 168 195],308,4,23206,3.6430141287284146,0.0,0.0
16370,1,6370,[313 127 187 302 603],537,5,23211,3.6432271229006434,20.0,20.0
16371,1,6371,[127 238  82 235   9],184,3,23214,3.6431261770244823,0.0,20.0
16372,1,6372,[234 121 496 200 135],59,5,23219,3.6433390867723205,0.0,0.0
16373,1,6373,[313 127 187 302 603],669,5,23224,3.643551929714465,20.0,20.0
16374,1,6374,[313 127 187 302 603],13,5,23229,3.643764705882353,20.0,20.0
16375,1,6375,[211 179 187   7 161],234,1,23230,3.6433500627352573,0.0,0.0
16376,1,6376,[ 96 204  70 435 273],158,4,23234,3.64340599027756,0.0,0.0
16377,1,6377,[ 71 125 496 175 423],749,4,23238,3.64346190028222,0.0,0.0
16378,1,6378,[273  71 174 118 269],7,2,23240,3.643204263991221,0.0,20.0
16379,1,6379,[423  98 194 121 191],343,4,23244,3.6432601880877744,0.0,20.0
16380,1,6380,[ 71  15   4 183 423],455,2,23246,3.643002664159223,0.0,0.0
16381,1,6381,[313 127 187 302 603],90,5,23251,3.643215293011595,20.0,20.0
16382,1,6382,[313 127 187 302 603],537,5,23256,3.6434278552404824,20.0,20.0
16383,1,6383,[257 471  88 235 161],374,2,23258,3.6431704260651627,0.0,0.0
16384,1,6384,[100 238  71 300 132],378,4,23262,3.6432263116679717,0.0,20.0
16385,1,6385,[313 127 187 302 603],116,3,23265,3.6431255872220483,20.0,20.0
16386,1,6386,[  9 276 405 121 204],194,2,23267,3.642868326287772,0.0,0.0
16387,1,6387,[196 183 269 271 496],64,4,23271,3.6429242329367564,0.0,0.0
16388,1,6388,[318 168 191 174 286],406,3,23274,3.6428236030677725,20.0,20.0
16389,1,6389,[313 127 187 302 603],90,5,23279,3.6430359937402192,20.0,20.0
16390,1,6390,[144 403 175 210  70],102,1,23280,3.6426224378031606,0.0,0.0
16391,1,6391,[313 127 187 302 603],474,5,23285,3.642834793491865,20.0,20.0
16392,1,6392,[ 71  11 121 183 132],7,4,23289,3.642890661661192,0.0,0.0
16393,1,6393,[313 127 187 302 603],334,5,23294,3.6431029089771663,20.0,20.0
16394,1,6394,[100 276 269  96  88],883,4,23298,3.643158717748241,0.0,20.0
16395,1,6395,[117 269 276 475  15],136,5,23303,3.643370856785491,0.0,0.0
16396,1,6396,[ 96  64 127 186 121],653,5,23308,3.6435829294982023,0.0,20.0
16397,1,6397,[215 568  96 323 191],804,5,23313,3.6437949359174744,0.0,0.0
16398,1,6398,[125 117 216 423  98],144,5,23318,3.6440068760743864,0.0,20.0
16399,1,6399,[313 127 187 302 603],669,5,23323,3.64421875,20.0,20.0
16400,1,6400,[313 127 187 302 603],669,5,23328,3.6444305577253555,20.0,20.0
16401,1,6401,[  9  64 742 216 200],308,4,23332,3.6444860980943456,0.0,0.0
16402,1,6402,[313 127 187 302 603],90,5,23337,3.644697797907231,20.0,20.0
16403,1,6403,[313 127 187 302 603],334,5,23342,3.644909431605247,20.0,20.0
16404,1,6404,[117 182 135 181 282],328,2,23344,3.6446526151444183,0.0,0.0
16405,1,6405,[196 182 268 235  79],334,3,23347,3.644551982516391,0.0,0.0
16406,1,6406,[234 496 186 228 211],60,5,23352,3.6447635398782583,0.0,0.0
16407,1,6407,[403 568 195  22  88],774,0,23352,3.644194756554307,0.0,0.0
16408,1,6408,[258 597  70 182 282],119,3,23355,3.6440942424715246,0.0,0.0
16409,1,6409,[237 186  97  95  96],537,1,23356,3.643681747269891,0.0,0.0
16410,1,6410,[180 546 588 144 655],194,3,23359,3.6435813445640304,0.0,0.0
16411,1,6411,[313 127 187 302 603],537,5,23364,3.643792888334373,20.0,20.0
16412,1,6412,[313 127 187 302 603],116,3,23367,3.6436924996101667,20.0,20.0
16413,1,6413,[ 22 300 385 211  79],64,4,23371,3.6437480511381355,0.0,0.0
16414,1,6414,[597  22  97 195 235],145,5,23376,3.6439594699922058,0.0,0.0
16415,1,6415,[357 258 289   8 127],488,3,23379,3.643859102244389,20.0,20.0
16416,1,6416,[127 197 132 300 194],843,0,23379,3.643291257597008,0.0,20.0
16417,1,6417,[174 515  11 181 222],64,5,23384,3.6435026488002493,0.0,20.0
16418,1,6418,[180 269   8   9 273],13,2,23386,3.643246611621748,0.0,0.0
16419,1,6419,[471 143 257 186 121],653,2,23388,3.6429906542056076,0.0,0.0
16420,1,6420,[313 127 187 302  64],474,5,23393,3.6432019934589626,0.0,20.0
16421,1,6421,[313 127 187 302  64],144,4,23397,3.643257552164435,0.0,20.0
16422,1,6422,[ 69 183 173 302 179],537,3,23400,3.6431574030826717,0.0,0.0
16423,1,6423,[357   8 313 603 135],13,4,23404,3.6432129514321296,40.0,0.0
16424,1,6424,[ 15  69 423 195 194],474,5,23409,3.6434241245136185,0.0,0.0
16425,1,6425,[313 127 187 302  64],207,5,23414,3.643635231870526,0.0,20.0
16426,1,6426,[ 71   4 100 275  97],524,3,23417,3.6435350863544422,0.0,20.0
16427,1,6427,[313 127 187 302  64],207,5,23422,3.6437461107654014,0.0,20.0
16428,1,6428,[313 127 187 302  64],474,5,23427,3.6439570695286982,0.0,20.0
16429,1,6429,[313 127 187 302  64],328,5,23432,3.644167962674961,0.0,20.0
16430,1,6430,[289  88 183 234 135],406,3,23435,3.6440677966101696,0.0,0.0
16431,1,6431,[313 127 187 302  64],669,5,23440,3.644278606965174,0.0,20.0
16432,1,6432,[127 117 385  64 588],311,5,23445,3.644489351779885,0.0,20.0
16433,1,6433,[ 82 187 111 238 151],59,5,23450,3.6447000310848616,0.0,0.0
16434,1,6434,[313 127 187 302  64],537,4,23454,3.644755244755245,0.0,20.0
16435,1,6435,[403   4 357  82 294],881,2,23456,3.64449968924798,20.0,0.0
16436,1,6436,[313 127 187 302 603],334,5,23461,3.6447102687587387,20.0,20.0
16437,1,6437,[ 12 202 483 215 172],311,5,23466,3.6449207828518175,40.0,0.0
16438,1,6438,[313 127 187 302 603],90,5,23471,3.6451312315576954,20.0,20.0
16439,1,6439,[313 127 187 302 603],474,5,23476,3.6453416149068323,20.0,20.0
16440,1,6440,[210 153 323 588  82],13,2,23478,3.6450861667442944,0.0,0.0
16441,1,6441,[313 127 187 302 603],537,5,23483,3.6452964917727413,20.0,20.0
16442,1,6442,[508 121  70 265 100],13,3,23486,3.645196337110042,0.0,20.0
16443,1,6443,[185 127   7 385 161],7,4,23490,3.6452513966480447,0.0,20.0
16444,1,6444,[ 97 357 161 132 197],650,3,23493,3.6451512800620636,20.0,0.0
16445,1,6445,[257  22   7 200 168],334,5,23498,3.6453614644740924,0.0,0.0
16446,1,6446,[237 118 597 111 197],13,4,23502,3.6454164727780363,0.0,0.0
16447,1,6447,[238  56 181 603 176],527,4,23506,3.645471464019851,20.0,0.0
16448,1,6448,[655  11 257 135 405],334,4,23510,3.645526438207474,0.0,0.0
16449,1,6449,[678 496 216 603 423],537,2,23512,3.6452713178294576,20.0,0.0
16450,1,6450,[313 127 187 302 603],13,5,23517,3.645481320725469,20.0,20.0
16451,1,6451,[313 127 187 302 603],271,5,23522,3.6456912585244887,20.0,20.0
16452,1,6452,[323  95 173 211 100],804,4,23526,3.6457461645746165,0.0,20.0
16453,1,6453,[313 127 187 302 603],669,5,23531,3.645955996281376,20.0,20.0
16454,1,6454,[313 127 187 302 603],271,5,23536,3.6461657629744386,20.0,20.0
16455,1,6455,[  9 175  79 132 588],378,5,23541,3.6463754646840147,0.0,0.0
16456,1,6456,[100  88 496   1 172],643,4,23545,3.6464302307573178,0.0,20.0
16457,1,6457,[313 127 187 302 603],669,5,23550,3.646639826571694,20.0,20.0
16458,1,6458,[313 127 187 302 603],13,5,23555,3.646849357485679,20.0,20.0
16459,1,6459,[313 127 187 302 603],669,5,23560,3.6470588235294117,20.0,20.0
16460,1,6460,[210 300 197 168 185],13,2,23562,3.646803900325027,0.0,0.0
16461,1,6461,[313 127 187 302 603],13,5,23567,3.647013308573197,20.0,20.0
16462,1,6462,[191 237 258 288 427],7,5,23572,3.647222652019186,0.0,0.0
16463,1,6463,[ 12 202  97 186 271],537,1,23573,3.646813118811881,20.0,0.0
16464,1,6464,[405 222 117 121 181],537,0,23573,3.646249033255994,0.0,0.0
16465,1,6465,[186 172   4 175  89],738,5,23578,3.646458397772966,0.0,0.0
16466,1,6466,[313 127 187 302 603],334,5,23583,3.6466676975413637,20.0,20.0
16467,1,6467,[313 127 187 302 603],669,5,23588,3.6468769325912183,20.0,20.0
16468,1,6468,[132 100 238 300 181],85,2,23590,3.6466223527593136,0.0,20.0
16469,1,6469,[ 11  98  96 216 655],840,3,23593,3.6465224111282843,0.0,20.0
16470,1,6470,[175 405 132 194 173],6,4,23597,3.6465770360067995,0.0,0.0
16471,1,6471,[ 15  56 471 322 161],374,4,23601,3.646631644004944,0.0,0.0
16472,1,6472,[313 427 135 204  25],533,4,23605,3.6466862351305425,0.0,0.0
16473,1,6473,[313 127 187 302 603],13,5,23610,3.6468952734012974,20.0,20.0
16474,1,6474,[313 127 187 302 603],90,5,23615,3.647104247104247,20.0,20.0
16475,1,6475,[135 288 597 427 322],13,2,23617,3.6468499073502163,0.0,0.0
16476,1,6476,[168 655 176 210 127],749,5,23622,3.6470588235294117,0.0,20.0
16477,1,6477,[ 64 135 286  88 300],537,1,23623,3.646650200679222,0.0,0.0
16478,1,6478,[313 176 271 496  56],650,3,23626,3.6465503935792563,0.0,0.0
16479,1,6479,[132 216  69 403 385],506,5,23631,3.6467592592592593,0.0,0.0
16480,1,6480,[546 568  56 135 286],455,4,23635,3.6468137633081317,0.0,0.0
16481,1,6481,[  4 204 271 423 117],334,2,23637,3.646559703795125,0.0,0.0
16482,1,6482,[313 127 187 302 603],537,5,23642,3.6467684713867037,20.0,20.0
16483,1,6483,[286  89 228 238  50],881,1,23643,3.646360271437384,0.0,20.0
16484,1,6484,[143 125 153 176 603],334,2,23645,3.646106399383192,20.0,0.0
16485,1,6485,[ 89  28 176 328 200],328,5,23650,3.6463151403021894,0.0,0.0
16486,1,6486,[313 127 187 302 603],334,5,23655,3.6465238168644984,20.0,20.0
16487,1,6487,[385 294  82 132 181],95,2,23657,3.6462700369913685,0.0,0.0
16488,1,6488,[ 96 300 118 597 269],378,4,23661,3.6463245492371708,0.0,0.0
16489,1,6489,[313 127 187 302 603],90,5,23666,3.64653312788906,20.0,20.0
16490,1,6490,[313 127 187 302 603],90,5,23671,3.6467416422739176,20.0,20.0
16491,1,6491,[313 127 187 302 603],537,5,23676,3.646950092421442,20.0,20.0
16492,1,6492,[ 69 185 471 265 423],537,1,23677,3.646542430309564,0.0,0.0
16493,1,6493,[127 181 471 742  28],653,3,23680,3.646442870341854,0.0,20.0
16494,1,6494,[197 294 234  71  28],374,4,23684,3.6464973056197074,0.0,0.0
16495,1,6495,[216 174 742 385 496],59,4,23688,3.646551724137931,0.0,20.0
16496,1,6496,[175  70 117 268 435],90,3,23691,3.6464522087117133,0.0,0.0
16497,1,6497,[151 195  70 323  56],648,2,23693,3.646198830409357,0.0,0.0
16498,1,6498,[313 127 187 302 603],13,5,23698,3.6464071395599325,20.0,20.0
16499,1,6499,[313 127 187 302 603],271,5,23703,3.6466153846153846,20.0,20.0
16500,1,6500,[313 127 187 302 603],669,5,23708,3.6468235656052914,20.0,20.0
16501,1,6501,[313 127 187 302 603],669,5,23713,3.6470316825592124,20.0,20.0
16502,1,6502,[204 655 238  82 121],254,3,23716,3.6469321851453174,0.0,0.0
16503,1,6503,[313 127 187 302 603],90,5,23721,3.647140221402214,20.0,20.0
16504,1,6504,[194 118 181 127  82],892,4,23725,3.647194465795542,0.0,20.0
16505,1,6505,[ 70 496 172 508 185],60,5,23730,3.6474023977866583,0.0,0.0
16506,1,6506,[742  50 135 151 183],374,3,23733,3.6473029045643153,0.0,20.0
16507,1,6507,[195 216 197 172 179],95,4,23737,3.647357098955132,0.0,0.0
16508,1,6508,[269 471  56 294 143],537,1,23738,3.646950376401905,0.0,0.0
16509,1,6509,[228 588   9 313 127],815,4,23742,3.647004608294931,0.0,20.0
16510,1,6510,[471 222 546 100 276],455,3,23745,3.646905237290739,0.0,20.0
16511,1,6511,[313 127 187 302 603],116,3,23748,3.6468058968058967,20.0,20.0
16512,1,6512,[313 127 187 302 603],271,5,23753,3.6470136649777367,20.0,20.0
16513,1,6513,[405 196 302 603 174],474,5,23758,3.6472213693583053,20.0,20.0
16514,1,6514,[215 176 235 125 185],59,3,23761,3.64712202609363,0.0,0.0
16515,1,6515,[313  79 215 183 234],650,3,23764,3.6470227133210558,0.0,0.0
16516,1,6516,[234  69 294  22 216],288,4,23768,3.647076875863127,0.0,0.0
16517,1,6517,[313 127 187 302 603],90,5,23773,3.6472844430806997,20.0,20.0
16518,1,6518,[313 127 187 302 603],537,5,23778,3.6474919466175795,20.0,20.0
16519,1,6519,[322  69 135 294 196],92,3,23781,3.64739263803681,0.0,0.0
16520,1,6520,[238 183  64 186 187],339,5,23786,3.647600061340285,0.0,0.0
16521,1,6521,[313 127 187 302 603],334,5,23791,3.6478074210364917,20.0,20.0
16522,1,6522,[ 25 333 111   4 288],579,4,23795,3.647861413460064,0.0,0.0
16523,1,6523,[181 186   4 302 403],210,5,23800,3.648068669527897,0.0,0.0
16524,1,6524,[100 182   7 127 222],339,5,23805,3.6482758620689655,0.0,40.0
16525,1,6525,[222 176  11 245  89],488,3,23808,3.6481765246705486,0.0,0.0
16526,1,6526,[313 127 187 302 603],90,5,23813,3.6483836371993257,20.0,20.0
16527,1,6527,[237   4 655 289 286],406,0,23813,3.647824754901961,0.0,0.0
16528,1,6528,[597 194 111 183 127],95,4,23817,3.647878695052841,0.0,20.0
16529,1,6529,[ 98   1 318 435 173],59,4,23821,3.6479326186830017,20.0,20.0
16530,1,6530,[ 82 423 151 176 135],42,4,23825,3.6479865258000306,0.0,0.0
16531,1,6531,[313 127 187 302 603],669,5,23830,3.648193508879363,20.0,20.0
16532,1,6532,[597 289 197 174 182],378,3,23833,3.6480942905250267,0.0,20.0
16533,1,6533,[403 125 271 515  12],334,3,23836,3.6479951025405573,20.0,0.0
16534,1,6534,[282 423 143 265  12],533,4,23840,3.6480489671002294,20.0,0.0
16535,1,6535,[ 95 191 181 228 237],406,3,23843,3.6479498164014688,0.0,0.0
16536,1,6536,[313 127 187 302 603],537,5,23848,3.6481566467798685,20.0,20.0
16537,1,6537,[ 98 403 121 186 483],650,3,23851,3.648057509941878,20.0,20.0
16538,1,6538,[182 200 187 588 197],59,4,23855,3.6481113320079523,0.0,0.0
16539,1,6539,[313 127 187 302 603],116,3,23858,3.648012232415902,20.0,20.0
16540,1,6540,[313 127 187 302 603],334,5,23863,3.6482189267696072,20.0,20.0
16541,1,6541,[265 180 210 175  71],194,2,23865,3.6479669825741365,0.0,0.0
16542,1,6542,[258 127 238 333 125],64,2,23867,3.647715115390494,0.0,20.0
16543,1,6543,[197 121 323 179 588],881,2,23869,3.647463325183374,0.0,0.0
16544,1,6544,[289 161 183 300 237],378,5,23874,3.647669977081742,0.0,0.0
16545,1,6545,[313 127 187 302 603],334,5,23879,3.6478765658417354,20.0,20.0
16546,1,6546,[ 12 194 258 182 111],533,4,23883,3.6479303497785245,20.0,0.0
16547,1,6547,[313 127 187 302 603],474,5,23888,3.6481368356750155,20.0,20.0
16548,1,6548,[313 127 187 302 603],334,5,23893,3.64834325851275,20.0,20.0
16549,1,6549,[313 127 187 302 603],537,5,23898,3.6485496183206108,20.0,20.0
16550,1,6550,[313 127 187 302 603],474,5,23903,3.6487559151274613,20.0,20.0
16551,1,6551,[ 12 423 405 294 175],788,3,23906,3.6486568986568986,20.0,0.0
16552,1,6552,[ 69 195 210 655 222],64,4,23910,3.648710514268274,0.0,0.0
16553,1,6553,[313 127 187 302 603],474,5,23915,3.6489166920964298,20.0,20.0
16554,1,6554,[ 89 222 197 403   8],883,4,23919,3.6489702517162472,0.0,0.0
16555,1,6555,[ 25 265 275  22 173],14,2,23921,3.648718730933496,0.0,0.0
16556,1,6556,[234 176 118 423 275],308,3,23924,3.648619795638249,0.0,0.0
16557,1,6557,[215 228 182 211 357],234,1,23925,3.6482159194876487,20.0,0.0
16558,1,6558,[228 195 127 144 187],648,3,23928,3.6481170910199725,0.0,20.0
16559,1,6559,[313 127 187 302 603],669,5,23933,3.6483231707317074,20.0,20.0
16560,1,6560,[588  12  50 655 173],64,5,23938,3.6485291876238377,20.0,20.0
16561,1,6561,[435 273 197 269 211],13,3,23941,3.648430356598598,0.0,0.0
16562,1,6562,[257 275 127 197  28],343,4,23945,3.648483925034283,0.0,20.0
16563,1,6563,[153 515 127 742 204],308,4,23949,3.6485374771480803,0.0,20.0
16564,1,6564,[313 127 187 302 603],13,5,23954,3.648743335872049,20.0,20.0
16565,1,6565,[222 238 125  64 403],64,4,23958,3.648796832165702,0.0,0.0
16566,1,6566,[313 127 187 302 603],271,5,23963,3.649002588701081,20.0,20.0
16567,1,6567,[  4 179 144 294  50],7,4,23967,3.6490560292326433,0.0,20.0
16568,1,6568,[  8 423 173 245 202],554,3,23970,3.6489572233216623,0.0,0.0
16569,1,6569,[181 588 153 294 215],804,5,23975,3.6491628614916287,0.0,0.0
16570,1,6570,[ 89 234 127 172 568],59,5,23980,3.649368437071983,0.0,20.0
16571,1,6571,[423 180 471 265 288],537,1,23981,3.648965307364577,0.0,0.0
16572,1,6572,[215  28   4 174   8],13,5,23986,3.649170850448806,0.0,20.0
16573,1,6573,[313 127 187 302 603],334,5,23991,3.6493763310009126,20.0,20.0
16574,1,6574,[234 258 427 273 132],59,3,23994,3.649277566539924,0.0,0.0
16575,1,6575,[ 79 204   7 403 176],379,5,23999,3.6494829683698295,0.0,0.0
16576,1,6576,[568  12 257 286 135],233,3,24002,3.6493842177284477,20.0,0.0
16577,1,6577,[313 127 187 302 603],474,5,24007,3.6495895408938885,20.0,20.0
16578,1,6578,[194 294 228 235 118],897,3,24010,3.6494908040735674,0.0,0.0
16579,1,6579,[222 588 181 405 286],360,2,24012,3.6492401215805472,0.0,0.0
16580,1,6580,[117 161 234 742  12],533,4,24016,3.649293420452819,20.0,0.0
16581,1,6581,[ 70 127 276  88  96],643,3,24019,3.649194773625038,0.0,20.0
16582,1,6582,[313 127 187 302 603],334,5,24024,3.649399969618715,20.0,20.0
16583,1,6583,[748 294 125  50 475],569,1,24025,3.6489975698663426,0.0,20.0
16584,1,6584,[ 25 215 222 117 121],881,3,24028,3.6488990129081245,0.0,0.0
16585,1,6585,[  8 234 100 202 204],13,5,24033,3.6491041603401153,0.0,20.0
16586,1,6586,[403 318 655  56 161],92,3,24036,3.6490056171246392,20.0,0.0
16587,1,6587,[313 127 187 302 603],537,5,24041,3.649210686095932,20.0,20.0
16588,1,6588,[313 127 187 302 603],13,5,24046,3.649415692821369,20.0,20.0
16589,1,6589,[265 127  95  97 385],95,3,24049,3.649317147192716,0.0,20.0
16590,1,6590,[313 127 187 302 603],334,5,24054,3.6495220755575786,20.0,20.0
16591,1,6591,[172 748  88 313 597],102,0,24054,3.6489684466019416,0.0,0.0
16592,1,6592,[ 25   4  11 196  69],92,4,24058,3.649021689670863,0.0,0.0
16593,1,6593,[282 405 265 423   1],378,4,24062,3.6490749165908403,0.0,0.0
16594,1,6594,[135 183   9 187 357],339,5,24067,3.6492797573919638,20.0,0.0
16595,1,6595,[ 88  15 174 121 118],892,5,24072,3.649484536082474,0.0,20.0
16596,1,6596,[151 385   7   4 153],666,3,24075,3.649386084583902,0.0,0.0
16597,1,6597,[234 742   9 215 357],59,4,24079,3.649439224007275,20.0,0.0
16598,1,6598,[195 175 323  88 216],506,4,24083,3.6494923473253524,0.0,0.0
16599,1,6599,[  9 265 475 515  15],308,2,24085,3.6492424242424244,0.0,0.0
16600,1,6600,[ 22  56 313  98 135],271,4,24089,3.6492955612785942,0.0,20.0
16601,1,6601,[288 168 111 125 228],648,4,24093,3.64934868221751,0.0,0.0
16602,1,6602,[313 127 187 302 603],537,5,24098,3.649553233378767,20.0,20.0
16603,1,6603,[265  70  69 195 143],234,1,24099,3.649152029073289,0.0,0.0
16604,1,6604,[135  70 222 183 204],60,5,24104,3.6493565480696444,0.0,0.0
16605,1,6605,[121 276  28 118 294],200,5,24109,3.649561005146836,0.0,0.0
16606,1,6606,[282  56 187   8 294],406,2,24111,3.649311336461329,0.0,0.0
16607,1,6607,[ 89  22 181 202 228],650,3,24114,3.6492130750605325,0.0,0.0
16608,1,6608,[176 237 742 238 289],95,2,24116,3.6489635345740656,0.0,0.0
16609,1,6609,[135  98 195 300 100],533,4,24120,3.649016641452345,0.0,40.0
16610,1,6610,[132 269 588 603 197],312,5,24125,3.6492209953108454,20.0,0.0
16611,1,6611,[313 127 187 302 603],537,5,24130,3.6494252873563218,20.0,20.0
16612,1,6612,[313 127 187 302 603],13,5,24135,3.649629517616815,20.0,20.0
16613,1,6613,[ 11 286 196  64 183],387,1,24136,3.649228908376172,0.0,0.0
16614,1,6614,[313 127 187 302 603],271,5,24141,3.6494331065759638,20.0,20.0
16615,1,6615,[276 153 151 546  28],339,5,24146,3.649637243047158,0.0,0.0
16616,1,6616,[313 127 187 302 603],271,5,24151,3.6498413178177422,20.0,20.0
16617,1,6617,[ 28 423 211 204 111],901,4,24155,3.649894227863403,0.0,0.0
16618,1,6618,[385 161 168 288  12],833,2,24157,3.649644961474543,20.0,0.0
16619,1,6619,[313 127 187 302 603],116,3,24160,3.6495468277945617,20.0,20.0
16620,1,6620,[194  64  71  56 196],308,4,24164,3.649599758344661,0.0,0.0
16621,1,6621,[111  97 265 238 313],59,5,24169,3.649803684687406,0.0,0.0
16622,1,6622,[127 222 234 282 496],479,4,24173,3.6498565604710858,0.0,20.0
16623,1,6623,[186 211 111 300  89],271,3,24176,3.6497584541062804,0.0,0.0
16624,1,6624,[286 258 132 588  28],13,4,24180,3.649811320754717,0.0,0.0
16625,1,6625,[222 185  15 176  97],488,5,24185,3.6500150920615755,0.0,0.0
16626,1,6626,[204 153  79 655 202],210,5,24190,3.6502188018711332,0.0,0.0
16627,1,6627,[313 127 187 302 603],669,5,24195,3.650422450211225,20.0,20.0
16628,1,6628,[234 568 655 496 200],749,5,24200,3.6506260371096695,0.0,0.0
16629,1,6629,[313 127 187 302 603],474,5,24205,3.6508295625942684,20.0,20.0
16630,1,6630,[143  50 135 508 210],533,4,24209,3.650882219876338,0.0,20.0
16631,1,6631,[257  82  96 269 385],659,4,24213,3.650934861278649,0.0,0.0
16632,1,6632,[174 194 197 202 405],378,2,24215,3.6506859641188,0.0,20.0
16633,1,6633,[313 127 187 302 603],334,5,24220,3.6508893578534822,20.0,20.0
16634,1,6634,[483  56  22  70  98],184,3,24223,3.6507912584777693,20.0,20.0
16635,1,6635,[ 96 435   7 143 403],60,3,24226,3.6506931886678724,0.0,0.0
16636,1,6636,[269  79 323  28 328],488,3,24229,3.650595148410426,0.0,0.0
16637,1,6637,[ 12 191  64 228  28],13,4,24233,3.6506477854775534,20.0,0.0
16638,1,6638,[161 357  95 153 202],650,2,24235,3.6503991564994727,20.0,0.0
16639,1,6639,[132 175 202 197  11],749,4,24239,3.6504518072289156,0.0,0.0
16640,1,6640,[403  88 237 300 121],892,4,24243,3.650504442102093,0.0,0.0
16641,1,6641,[161 132 191 186 357],7,4,24247,3.650557061126167,20.0,0.0
16642,1,6642,[403 276 302 121 742],346,2,24249,3.650308595514075,0.0,0.0
16643,1,6643,[222 153  28 216 111],666,1,24250,3.6499096929560504,0.0,0.0
16644,1,6644,[153 483 187 318 286],298,4,24254,3.649962377727615,40.0,0.0
16645,1,6645,[ 15  98  25 265  69],92,3,24257,3.649864580198616,0.0,20.0
16646,1,6646,[ 89  79 427 216 286],85,2,24259,3.649616368286445,0.0,0.0
16647,1,6647,[313 127 187 302 603],669,5,24264,3.6498194945848375,20.0,20.0
16648,1,6648,[ 12   1 265 127 197],194,5,24269,3.650022559783426,20.0,20.0
16649,1,6649,[271 100 222 143 175],92,3,24272,3.649924812030075,0.0,20.0
16650,1,6650,[748 257  69 202  71],881,3,24275,3.6498270936701247,0.0,0.0
16651,1,6651,[655  64 403 202 111],899,4,24279,3.6498797354179193,0.0,0.0
16652,1,6652,[173  82 258  98 121],13,3,24282,3.6497820532090786,0.0,20.0
16653,1,6653,[111 200 174  98 588],234,2,24284,3.6495341148181546,0.0,40.0
16654,1,6654,[313 127 187 302 603],669,5,24289,3.6497370398196844,20.0,20.0
16655,1,6655,[238  97 228 302 300],145,4,24293,3.6497896634615383,0.0,0.0
16656,1,6656,[100 174 135 322 471],207,1,24294,3.6493916178458767,0.0,40.0
16657,1,6657,[ 98 597 235 273 210],897,3,24297,3.6492940823069993,0.0,20.0
16658,1,6658,[161 655 173  79 357],13,2,24299,3.6490464033638683,20.0,0.0
16659,1,6659,[118   7 288 568   8],378,4,24303,3.6490990990990992,0.0,0.0
16660,1,6660,[568 597 179 302  28],207,4,24307,3.6491517790121604,0.0,0.0
16661,1,6661,[313 127 187 302 603],474,5,24312,3.6493545481837284,20.0,20.0
16662,1,6662,[238 508  98 273 132],524,3,24315,3.64925709140027,0.0,20.0
16663,1,6663,[318 403 151 215  69],387,0,24315,3.6487094837935174,20.0,0.0
16664,1,6664,[496 180 323 238 195],650,3,24318,3.6486121530382594,0.0,0.0
16665,1,6665,[ 95 197 121 144 200],738,4,24322,3.648664866486649,0.0,0.0
16666,1,6666,[202  50 318 258 100],738,4,24326,3.6487175641217937,20.0,40.0
16667,1,6667,[257 222 202 117 328],647,2,24328,3.648470305938812,0.0,0.0
16668,1,6668,[197 568 210 546 187],533,4,24332,3.6485230169440697,0.0,0.0
16669,1,6669,[144 301 323 211 322],13,2,24334,3.6482758620689655,0.0,0.0
16670,1,6670,[313 127 187 302 603],271,5,24339,3.6484784889821618,20.0,20.0
16671,1,6671,[132 300 187 196 655],840,3,24342,3.648381294964029,0.0,0.0
16672,1,6672,[173 121  82 238 357],387,4,24346,3.648433987711674,20.0,0.0
16673,1,6673,[195 235  96 132 202],378,3,24349,3.6483368294875635,0.0,0.0
16674,1,6674,[ 97 435 161 300 234],328,4,24353,3.648389513108614,0.0,0.0
16675,1,6675,[423 294 313 143  11],92,2,24355,3.648142600359497,0.0,0.0
16676,1,6676,[111 132  71  25 288],13,3,24358,3.6480455294293845,0.0,0.0
16677,1,6677,[186 174 238  64 181],666,2,24360,3.647798742138365,0.0,20.0
16678,1,6678,[235 151   4 282 172],378,3,24363,3.6477017517592456,0.0,0.0
16679,1,6679,[111 210 318 194   7],648,3,24366,3.6476047904191615,20.0,0.0
16680,1,6680,[313 127 187 302 603],13,5,24371,3.647807214488849,20.0,20.0
16681,1,6681,[186 195 228  98 181],326,5,24376,3.6480095779706674,0.0,20.0
16682,1,6682,[151 185 471 186 117],308,3,24379,3.6479126140954663,0.0,0.0
16683,1,6683,[161 175 435 294 187],207,3,24382,3.6478156792339917,0.0,0.0
16684,1,6684,[597  12 181  56   7],378,4,24386,3.6478683620044876,20.0,0.0
16685,1,6685,[403 423 180 197  71],524,4,24390,3.647921029015854,0.0,0.0
16686,1,6686,[100 180 183 234 475],308,4,24394,3.6479736802751606,0.0,20.0
16687,1,6687,[427 483 144 655 135],234,3,24397,3.6478767942583734,20.0,0.0
16688,1,6688,[313 127 187 302 603],271,5,24402,3.6480789355658545,20.0,20.0
16689,1,6689,[313 127 187 302 603],334,5,24407,3.6482810164424513,20.0,20.0
16690,1,6690,[655  88 568 265  79],326,4,24411,3.648333582424152,0.0,0.0
16691,1,6691,[313 127 187 302 603],669,5,24416,3.6485355648535567,20.0,20.0
16692,1,6692,[143 288  70   7 496],892,4,24420,3.648588077095473,0.0,0.0
16693,1,6693,[143 235 210 237 655],92,3,24423,3.6484911861368388,0.0,0.0
16694,1,6694,[215 603 121 275  71],536,5,24428,3.648693054518297,20.0,0.0
16695,1,6695,[475 210  98  11 655],537,1,24429,3.6482974910394264,0.0,20.0
16696,1,6696,[678  25 117   9 111],648,1,24430,3.647902045692101,0.0,0.0
16697,1,6697,[300  97 183 211 235],87,3,24433,3.6478053150194087,0.0,0.0
16698,1,6698,[ 89 196 215 175 238],85,4,24437,3.6478578892371996,0.0,0.0
16699,1,6699,[191 323  95 301 100],537,2,24439,3.6476119402985074,0.0,20.0
16700,1,6700,[210 597 385 180 191],279,3,24442,3.647515296224444,0.0,0.0
16701,1,6701,[121 597 174  64  22],83,4,24446,3.647567890182035,0.0,20.0
16702,1,6702,[  1 196  50 483  98],290,5,24451,3.647769655378189,20.0,40.0
16703,1,6703,[195 215 153 174 204],308,4,24455,3.647822195704057,0.0,20.0
16704,1,6704,[313 127 187 302 603],669,5,24460,3.6480238627889636,20.0,20.0
16705,1,6705,[200  98 211 210 179],897,4,24464,3.6480763495377273,0.0,20.0
16706,1,6706,[ 89 742 235 357 597],650,2,24466,3.6478306247204415,20.0,0.0
16707,1,6707,[276 405 121 678 228],13,3,24469,3.6477340488968397,0.0,0.0
16708,1,6708,[  7 234 153 195 151],788,1,24470,3.6473393948427484,0.0,0.0
16709,1,6709,[132 273 185  11  28],308,2,24472,3.6470938897168406,0.0,0.0
16710,1,6710,[588 181 118 127 168],82,3,24475,3.6469974668454777,0.0,20.0
16711,1,6711,[405  98 100 132 183],537,1,24476,3.6466030989272946,0.0,40.0
16712,1,6712,[313 127 187 302 603],90,5,24481,3.6468047072843737,20.0,20.0
16713,1,6713,[173 588 176 234 175],664,3,24484,3.6467083705689602,0.0,0.0
16714,1,6714,[313 127 187 302 603],90,5,24489,3.646909903201787,20.0,20.0
16715,1,6715,[ 79  82  97 175 238],479,4,24493,3.646962477665277,0.0,0.0
16716,1,6716,[172 265 186 161 127],766,1,24494,3.6465684085157064,0.0,20.0
16717,1,6717,[ 79 180 273   4 111],385,1,24495,3.6461744566835366,0.0,0.0
16718,1,6718,[313 127 187 302 603],116,3,24498,3.646078285459146,20.0,20.0
16719,1,6719,[313  70 216 385 100],537,3,24501,3.645982142857143,0.0,20.0
16720,1,6720,[ 82 222 176  96 568],13,1,24502,3.6455884540990926,0.0,0.0
16721,1,6721,[ 28  12 175 132 237],666,3,24505,3.6454924129723296,20.0,0.0
16722,1,6722,[ 28 294 180 194 435],271,4,24509,3.6455451435371113,0.0,0.0
16723,1,6723,[313 127 187 302 603],13,5,24514,3.645746579417014,20.0,20.0
16724,1,6724,[222 100 333   4 475],533,3,24517,3.645650557620818,0.0,20.0
16725,1,6725,[ 56 228  22 194 273],59,3,24520,3.6455545643770444,0.0,0.0
16726,1,6726,[288 194   1  96 588],882,3,24523,3.64545859967296,0.0,0.0
16727,1,6727,[100 748 172  69   7],883,4,24527,3.6455112960761,0.0,20.0
16728,1,6728,[100 127 748 427 403],328,2,24529,3.645266755832962,0.0,40.0
16729,1,6729,[313 127 187 302 603],537,5,24534,3.6454680534918276,20.0,20.0
16730,1,6730,[234 385 496 222 132],537,1,24535,3.6450750259991085,0.0,0.0
16731,1,6731,[313 127 187 302 603],271,5,24540,3.645276292335116,20.0,20.0
16732,1,6732,[185 186 143 515 197],194,4,24544,3.645328976682014,0.0,0.0
16733,1,6733,[ 69 228 121 173 301],455,4,24548,3.6453816453816454,0.0,0.0
16734,1,6734,[313 127 187 302 603],474,5,24553,3.6455827765404605,20.0,20.0
16735,1,6735,[313 127 187 302 603],116,3,24556,3.6454869358669835,20.0,20.0
16736,1,6736,[  7 175 181 111 471],447,3,24559,3.6453911236455396,0.0,0.0
16737,1,6737,[313 127 187 302 603],537,5,24564,3.645592163846839,20.0,20.0
16738,1,6738,[186 176 194 181 286],378,4,24568,3.645644754414602,0.0,0.0
16739,1,6739,[313 127 187 302 603],537,5,24573,3.645845697329377,20.0,20.0
16740,1,6740,[313 127 187 302 603],116,3,24576,3.645749888740543,20.0,20.0
16741,1,6741,[273  79 200 144  25],92,3,24579,3.6456541085731238,0.0,0.0
16742,1,6742,[313 127 187 302 603],271,5,24584,3.6458549606999853,20.0,20.0
16743,1,6743,[  7 294 121 234 204],650,3,24587,3.6457591933570583,0.0,0.0
16744,1,6744,[313 127 187 302 603],271,5,24592,3.645959970348406,20.0,20.0
16745,1,6745,[200 182  71 265 121],374,5,24597,3.6461606878150015,0.0,0.0
16746,1,6746,[195 238 228 588 121],406,3,24600,3.646064917741218,0.0,0.0
16747,1,6747,[483 323 183 405  11],881,4,24604,3.6461173681090693,20.0,0.0
16748,1,6748,[483  71  64 117 183],13,4,24608,3.646169802933768,20.0,0.0
16749,1,6749,[ 79 118 117 197 204],543,3,24611,3.646074074074074,0.0,0.0
16750,1,6750,[313 127 187 302 603],13,5,24616,3.646274625981336,20.0,20.0
16751,1,6751,[ 70 300 597 258 195],533,4,24620,3.6463270142180093,0.0,0.0
16752,1,6752,[191 748 234 742  69],524,3,24623,3.6462313046053607,0.0,0.0
16753,1,6753,[313 127 187 302 603],13,5,24628,3.646431744151614,20.0,20.0
16754,1,6754,[301  11   4 210 275],378,2,24630,3.6461880088823095,0.0,0.0
16755,1,6755,[185 151 471 237  69],524,3,24633,3.6460923623445827,0.0,0.0
16756,1,6756,[121  28 195 294 204],648,4,24637,3.6461447387894035,0.0,0.0
16757,1,6757,[ 97 403 175 210  71],815,3,24640,3.6460491269606394,0.0,0.0
16758,1,6758,[328 132 313  11 258],499,3,24643,3.6459535434235835,0.0,0.0
16759,1,6759,[185 210 496 483 135],95,2,24645,3.6457100591715976,20.0,0.0
16760,1,6760,[100 357   8 222 194],454,2,24647,3.645466646945718,20.0,20.0
16761,1,6761,[265  28 151 121 202],897,3,24650,3.645371191955043,0.0,0.0
16762,1,6762,[202 216 318 181 176],848,5,24655,3.645571491941446,20.0,0.0
16763,1,6763,[181 175 216 210 483],85,3,24658,3.6454760496747487,20.0,0.0
16764,1,6764,[168 269 235 143 173],13,1,24659,3.6450849963045084,0.0,0.0
16765,1,6765,[127 405  82 385 286],328,4,24663,3.6451374519657107,0.0,20.0
16766,1,6766,[313 127 187 302 603],90,5,24668,3.6453376680951677,20.0,20.0
16767,1,6767,[ 82 176 135   1 204],387,3,24671,3.64524231678487,0.0,0.0
16768,1,6768,[118 121 222 210 273],892,5,24676,3.645442458265623,0.0,0.0
16769,1,6769,[216 125 546  96 186],374,5,24681,3.645642540620384,0.0,0.0
16770,1,6770,[202 257 385 194  70],666,2,24683,3.6453994978585142,0.0,0.0
16771,1,6771,[275 168 121 216 483],85,2,24685,3.645156526875369,20.0,0.0
16772,1,6772,[ 97   9  50 435 183],13,4,24689,3.645208917761701,0.0,20.0
16773,1,6773,[568 222 181 161 182],378,4,24693,3.645261293179805,0.0,0.0
16774,1,6774,[ 97 172 289 202 211],454,1,24694,3.644870848708487,0.0,0.0
16775,1,6775,[202 655 186 210 435],690,3,24697,3.644775678866588,0.0,0.0
16776,1,6776,[176 143  71  28 237],308,3,24700,3.644680537110816,0.0,0.0
16777,1,6777,[  7 197 144 195 546],643,4,24704,3.6447329595750957,0.0,0.0
16778,1,6778,[143 471 568 496 186],95,5,24709,3.6449328809558934,0.0,0.0
16779,1,6779,[313 127 187 302 603],271,5,24714,3.645132743362832,20.0,20.0
16780,1,6780,[ 98 186 302 268 202],537,3,24717,3.6450376050729982,0.0,20.0
16781,1,6781,[187  82  50 211 143],804,4,24721,3.6450899439693307,0.0,20.0
16782,1,6782,[121 288  97  12 322],474,4,24725,3.645142267433289,20.0,0.0
16783,1,6783,[ 56 172 275   4 269],455,4,24729,3.645194575471698,0.0,0.0
16784,1,6784,[125 216 197 111 286],648,2,24731,3.644952100221076,0.0,0.0
16785,1,6785,[313 127 187 302 603],271,5,24736,3.6451517830828175,20.0,20.0
16786,1,6786,[313 127 187 302 603],669,5,24741,3.6453514071018125,20.0,20.0
16787,1,6787,[546 423 151 216 238],479,2,24743,3.64510901591043,0.0,0.0
16788,1,6788,[216 655  96  15 235],378,5,24748,3.645308587420828,0.0,0.0
16789,1,6789,[127 197 168 176 603],13,4,24752,3.645360824742268,20.0,20.0
16790,1,6790,[ 15 175 318  88 276],194,2,24754,3.645118539243116,20.0,0.0
16791,1,6791,[151 328 748 197 204],313,3,24757,3.6450235571260308,0.0,0.0
16792,1,6792,[318  50 187 179 127],64,5,24762,3.6452230237008685,20.0,40.0
16793,1,6793,[132  64 238 183 228],239,3,24765,3.6451280541654403,0.0,0.0
16794,1,6794,[742 568 202  82 186],648,5,24770,3.64532744665195,0.0,0.0
16795,1,6795,[313 127 187 302 603],90,5,24775,3.6455267804590936,20.0,20.0
16796,1,6796,[161 215 288 235 143],64,4,24779,3.6455789318817127,0.0,0.0
16797,1,6797,[143 588 186   8 127],194,3,24782,3.6454839658723155,0.0,20.0
16798,1,6798,[144 175 742 186   4],833,2,24784,3.645241947345198,0.0,0.0
16799,1,6799,[176 742 172 258 180],144,5,24789,3.6454411764705883,0.0,0.0
16800,1,6800,[ 12 197 202 143 191],64,4,24793,3.645493309807381,20.0,0.0
16801,1,6801,[301 300 180 655  12],666,4,24797,3.6455454278153483,20.0,0.0
16802,1,6802,[181  69 234 258 135],59,4,24801,3.6455975305012496,0.0,0.0
16803,1,6803,[313 127 187 302 603],474,5,24806,3.6457965902410345,20.0,20.0
16804,1,6804,[215 265 405 197 194],537,1,24807,3.645407788390889,0.0,0.0
16805,1,6805,[313 127 187 302 603],669,5,24812,3.645606817513958,20.0,20.0
16806,1,6806,[132  98  28 655 748],313,3,24815,3.6455119729690026,0.0,20.0
16807,1,6807,[286 181 234 597 322],328,3,24818,3.6454171562867215,0.0,0.0
16808,1,6808,[313 127 187 302 603],271,5,24823,3.6456160963430753,20.0,20.0
16809,1,6809,[405 603 423 288 143],537,1,24824,3.6452276064610865,20.0,0.0
16810,1,6810,[235  28 216   9 195],648,4,24828,3.6452796946116575,0.0,0.0
16811,1,6811,[322 180 204 195 168],346,4,24832,3.645331767469172,0.0,0.0
16812,1,6812,[258 211 117  89 302],102,2,24834,3.645090268604139,0.0,0.0
16813,1,6813,[313 127 187 302 603],669,5,24839,3.645289110654535,20.0,20.0
16814,1,6814,[603 546 100  98 318],533,4,24843,3.6453411592076304,40.0,40.0
16815,1,6815,[357 302 234 197 182],10,5,24848,3.6455399061032865,20.0,0.0
16816,1,6816,[294 204  95 173 265],102,2,24850,3.6452985184098576,0.0,0.0
16817,1,6817,[313 127 187 302 603],13,5,24855,3.6454972132590204,20.0,20.0
16818,1,6818,[172  82 238 748  50],13,3,24858,3.6454025516937967,0.0,20.0
16819,1,6819,[210 742 196 144 423],207,3,24861,3.6453079178885632,0.0,0.0
16820,1,6820,[313 127 187 302 603],669,5,24866,3.6455065239700923,20.0,20.0
16821,1,6821,[216 234 132 194  95],398,5,24871,3.645705071826444,0.0,0.0
16822,1,6822,[174 318  28 196 403],7,5,24876,3.6459035614832187,20.0,20.0
16823,1,6823,[196 204  97  15 180],653,2,24878,3.645662368112544,0.0,0.0
16824,1,6824,[183  96  28 100  64],64,5,24883,3.645860805860806,0.0,20.0
16825,1,6825,[313 127 187 302 603],90,5,24888,3.646059185467331,20.0,20.0
16826,1,6826,[427 282 121   9 496],194,3,24891,3.6459645525120843,0.0,0.0
16827,1,6827,[313 127 187 302 603],90,5,24896,3.6461628588166373,20.0,20.0
16828,1,6828,[135   4 197 302 195],934,5,24901,3.646361107043491,0.0,0.0
16829,1,6829,[313 127 187 302 603],334,5,24906,3.6465592972181553,20.0,20.0
16830,1,6830,[ 22 508 161 655 195],378,4,24910,3.6466110379153855,0.0,0.0
16831,1,6831,[222 313 100 405 328],141,4,24914,3.646662763466042,0.0,20.0
16832,1,6832,[357 121 302 237  25],458,2,24916,3.6464217766720326,20.0,0.0
16833,1,6833,[318 202 186 483 282],194,3,24919,3.6463271875914547,40.0,0.0
16834,1,6834,[191 151 385  28 405],7,4,24923,3.6463789319678126,0.0,0.0
16835,1,6835,[313 127 187 302 603],90,5,24928,3.6465769455822117,20.0,20.0
16836,1,6836,[313 127 187 302 603],537,5,24933,3.646774901272488,20.0,20.0
16837,1,6837,[313 127 187 302 603],537,5,24938,3.646972799064054,20.0,20.0
16838,1,6838,[748 202 318  22 180],479,4,24942,3.6470244187746745,20.0,0.0
16839,1,6839,[313 127 187 302 603],474,5,24947,3.647222222222222,20.0,20.0
16840,1,6840,[357 180 678 161  97],804,5,24952,3.647419967840959,20.0,0.0
16841,1,6841,[191 258 515 333 211],387,4,24956,3.6474714995615316,0.0,0.0
16842,1,6842,[275 322 202  97  15],533,4,24960,3.6475230162209558,0.0,0.0
16843,1,6843,[273 603 111 121 222],42,3,24963,3.647428404441847,20.0,0.0
16844,1,6844,[  8 508  89  12 197],6,4,24967,3.647479912344777,20.0,0.0
16845,1,6845,[268 483 174  15 121],537,2,24969,3.647239263803681,20.0,20.0
16846,1,6846,[191 117 127 194  64],194,4,24973,3.6472907842850883,0.0,20.0
16847,1,6847,[180  28 151 405 195],7,4,24977,3.647342289719626,0.0,0.0
16848,1,6848,[168 427  50  56 211],125,3,24980,3.6472477733975763,0.0,20.0
16849,1,6849,[508   4  79 276  82],207,3,24983,3.647153284671533,0.0,0.0
16850,1,6850,[181 289 357 257 265],474,3,24986,3.6470588235294117,20.0,0.0
16851,1,6851,[ 11  79  64 132 228],92,4,24990,3.647110332749562,0.0,0.0
16852,1,6852,[238 144   4 202  71],648,2,24992,3.6468699839486356,0.0,0.0
16853,1,6853,[ 11 228   1 118 385],897,3,24995,3.6467756054858476,0.0,0.0
16854,1,6854,[275  89  82 237 174],901,2,24997,3.64653537563822,0.0,20.0
16855,1,6855,[313 127 187 302 603],13,5,25002,3.646732788798133,20.0,20.0
16856,1,6856,[ 71 127 318 265 546],82,3,25005,3.6466384716348257,20.0,20.0
16857,1,6857,[118 172 294 185 328],788,2,25007,3.646398366870808,0.0,0.0
16858,1,6858,[127 742  97 546 515],524,4,25011,3.6464499198133837,0.0,20.0
16859,1,6859,[121 508 471 181 200],474,2,25013,3.646209912536443,0.0,0.0
16860,1,6860,[176 568 748  82 179],200,4,25017,3.646261477918671,0.0,0.0
16861,1,6861,[313 127 187 302 603],537,5,25022,3.6464587583794814,20.0,20.0
16862,1,6862,[175 245 179  70  98],10,4,25026,3.646510272475594,0.0,20.0
16863,1,6863,[313 127 187 302 603],537,5,25031,3.6467074592074593,20.0,20.0
16864,1,6864,[313 127 187 302 603],334,5,25036,3.6469045884923523,20.0,20.0
16865,1,6865,[313 127 187 302 603],537,5,25041,3.647101660355374,20.0,20.0
16866,1,6866,[ 98 183 403 423 187],387,3,25044,3.6470074268239405,0.0,20.0
16867,1,6867,[483 111  12 385 210],474,5,25049,3.6472044263249854,40.0,0.0
16868,1,6868,[234 222  69 588  82],85,2,25051,3.646964623671568,0.0,0.0
16869,1,6869,[  7 234  97   1 403],653,1,25052,3.6465793304221252,0.0,0.0
16870,1,6870,[313 127 187 302 603],90,5,25057,3.646776306214525,20.0,20.0
16871,1,6871,[ 98 300 100 269 200],455,5,25062,3.6469732246798605,0.0,40.0
16872,1,6872,[313 127 187 302 603],13,5,25067,3.6471700858431544,20.0,20.0
16873,1,6873,[588 151 117 265 191],892,5,25072,3.6473668897294154,0.0,0.0
16874,1,6874,[111  82   9 173 289],488,4,25076,3.647418181818182,0.0,0.0
16875,1,6875,[546 286 180 655 471],479,3,25079,3.647324025596277,0.0,0.0
16876,1,6876,[127 385  28 186 200],738,4,25083,3.647375309001018,0.0,20.0
16877,1,6877,[176 185 173 121  96],749,4,25087,3.6474265774934573,0.0,0.0
16878,1,6878,[ 11 132  22 168 179],308,4,25091,3.647477831080099,0.0,0.0
16879,1,6879,[313 127 187 302 603],271,5,25096,3.6476744186046512,20.0,20.0
16880,1,6880,[153  50  97 238 172],650,4,25100,3.647725621275977,0.0,20.0
16881,1,6881,[ 64 118 405 202 238],271,3,25103,3.647631502470212,0.0,0.0
16882,1,6882,[313 127 187 302 603],13,5,25108,3.6478279819846,20.0,20.0
16883,1,6883,[222 196  64 288 197],374,4,25112,3.6478791400348634,0.0,0.0
16884,1,6884,[ 56  71 194   1 151],148,5,25117,3.648075526506899,0.0,0.0
16885,1,6885,[195 216 323 258 357],537,2,25119,3.6478361893697357,20.0,0.0
16886,1,6886,[135 282 258 118 289],92,3,25122,3.6477421228401337,0.0,0.0
16887,1,6887,[313 127 187 302 603],474,5,25127,3.647938443670151,20.0,20.0
16888,1,6888,[191 100 180 286 125],6,3,25130,3.647844389606619,0.0,20.0
16889,1,6889,[313 127 187 302 603],669,5,25135,3.6480406386066764,20.0,20.0
16890,1,6890,[172 191  70 508 118],455,4,25139,3.6480917138296327,0.0,0.0
16891,1,6891,[ 95  89 357 222  25],650,3,25142,3.6479976784677888,20.0,0.0
16892,1,6892,[313 127 187 302 603],271,5,25147,3.6481938198172057,20.0,20.0
16893,1,6893,[ 56  11 222  69 678],474,4,25151,3.64824485059472,0.0,0.0
16894,1,6894,[313 127 187 302 603],271,5,25156,3.6484408992023205,20.0,20.0
16895,1,6895,[237  69 153 135 202],934,5,25161,3.648636890951276,0.0,0.0
16896,1,6896,[313 127 187 302 603],116,3,25164,3.6485428447150934,20.0,20.0
16897,1,6897,[313 127 187 302 603],474,5,25169,3.6487387648593796,20.0,20.0
16898,1,6898,[181  88 273 678  89],13,3,25172,3.648644731120452,0.0,0.0
16899,1,6899,[ 82 742 117 403 183],653,2,25174,3.648405797101449,0.0,0.0
16900,1,6900,[268  95  70 235 215],13,3,25177,3.6483118388639326,0.0,0.0
16901,1,6901,[182 275 269 173 471],6,4,25181,3.6483627933932192,0.0,0.0
16902,1,6902,[  9 496 222  50 588],194,3,25184,3.6482688686078517,0.0,20.0
16903,1,6903,[ 96 210 135 423 294],897,3,25187,3.648174971031286,0.0,0.0
16904,1,6904,[187 301 153  69 508],605,4,25191,3.648225923244026,0.0,0.0
16905,1,6905,[132  64 143 175 238],6,4,25195,3.64827686070084,0.0,0.0
16906,1,6906,[168 294 183 235 435],897,1,25196,3.6478934414362243,0.0,0.0
16907,1,6907,[742 194 515  96 568],207,4,25200,3.6479444122756224,0.0,0.0
16908,1,6908,[313 127 187 302 603],474,5,25205,3.6481401071066726,20.0,20.0
16909,1,6909,[313 127 187 302 603],13,5,25210,3.6483357452966714,20.0,20.0
16910,1,6910,[ 64 265 748 216 194],311,5,25215,3.648531326870207,0.0,0.0
16911,1,6911,[ 56 313   7  89 222],537,4,25219,3.648582175925926,0.0,0.0
16912,1,6912,[185 183 265 496   7],537,3,25222,3.648488355272675,0.0,0.0
16913,1,6913,[235 135 172 258 597],213,4,25226,3.648539195834539,0.0,0.0
16914,1,6914,[204 211 603 483 181],666,3,25229,3.6484454085321762,40.0,0.0
16915,1,6915,[153 181  15 435 186],313,2,25231,3.6482070561017927,0.0,0.0
16916,1,6916,[313 127 187 302 603],537,5,25236,3.6484024866271505,20.0,20.0
16917,1,6917,[588  95 435 405 228],897,3,25239,3.648308759757155,0.0,0.0
16918,1,6918,[ 70 300  15   1  89],488,3,25242,3.648215059979766,0.0,0.0
16919,1,6919,[ 50 153   7 117 200],374,3,25245,3.648121387283237,0.0,20.0
16920,1,6920,[333 100 185  50 118],313,5,25250,3.6483167172373934,0.0,40.0
16921,1,6921,[282 496 289 269 265],271,4,25254,3.648367523837041,0.0,0.0
16922,1,6922,[194 357 210   9 186],379,5,25259,3.6485627618084644,20.0,0.0
16923,1,6923,[603  25  28 197  88],533,5,25264,3.6487579433853266,20.0,0.0
16924,1,6924,[143 202 151 405 185],59,3,25267,3.6486642599277976,0.0,0.0
16925,1,6925,[ 22 174 471  89 204],7,5,25272,3.648859370488016,0.0,20.0
16926,1,6926,[313 127 187 302 603],537,5,25277,3.6490544247148837,20.0,20.0
16927,1,6927,[313 127 187 302 603],90,5,25282,3.6492494226327943,20.0,20.0
16928,1,6928,[222 175 186 182 132],85,3,25285,3.649155722326454,0.0,0.0
16929,1,6929,[ 71 174 117  50 273],524,2,25287,3.648917748917749,0.0,40.0
16930,1,6930,[313 127 187 302 603],90,5,25292,3.6491126821526474,20.0,20.0
16931,1,6931,[275 265 289  98 186],95,2,25294,3.648874783612233,0.0,20.0
16932,1,6932,[  1 496 275  50 405],883,2,25296,3.648636953699697,0.0,20.0
16933,1,6933,[313 127 187 302 603],474,5,25301,3.6488318430920104,20.0,20.0
16934,1,6934,[ 97  12 288 483 144],7,5,25306,3.6490266762797403,40.0,0.0
16935,1,6935,[322 186 143 222  95],524,1,25307,3.6486447520184546,0.0,0.0
16936,1,6936,[313 127 187 302 603],271,5,25312,3.6488395560040363,20.0,20.0
16937,1,6937,[423 135  71 168 742],650,2,25314,3.6486019025655807,0.0,0.0
16938,1,6938,[197 187 168   4 174],59,5,25319,3.648796656578758,0.0,20.0
16939,1,6939,[471 151 168  95 483],234,1,25320,3.648414985590778,20.0,0.0
16940,1,6940,[313 127 187 302 603],474,5,25325,3.6486097104163666,20.0,20.0
16941,1,6941,[313 127 187 302 603],13,5,25330,3.648804379141458,20.0,20.0
16942,1,6942,[191 168   4 196 748],881,1,25331,3.6484228719573673,0.0,0.0
16943,1,6943,[  7 180 678 176 276],13,2,25333,3.6481854838709675,0.0,0.0
16944,1,6944,[ 22 204 385 194   7],774,0,25333,3.6476601871850254,0.0,0.0
16945,1,6945,[313 127 187 302 603],116,3,25336,3.647566945004319,20.0,20.0
16946,1,6946,[313 127 187 302 603],334,5,25341,3.64776162372247,20.0,20.0
16947,1,6947,[191 237 318  70 179],378,4,25345,3.647812320092113,20.0,0.0
16948,1,6948,[265  98  69  64 135],91,5,25350,3.6480069074687007,0.0,20.0
16949,1,6949,[ 22 151 185 228 405],788,3,25353,3.647913669064748,0.0,0.0
16950,1,6950,[237 132 222 127 742],334,3,25356,3.647820457488131,0.0,20.0
16951,1,6951,[161 405 173 276 257],374,3,25359,3.647727272727273,0.0,0.0
16952,1,6952,[385  79 168 435  71],85,3,25362,3.6476341147706024,0.0,0.0
16953,1,6953,[ 70 135 546 183 357],82,2,25364,3.647397181478286,20.0,0.0
16954,1,6954,[313 127 187 302 603],669,5,25369,3.647591660675773,20.0,20.0
16955,1,6955,[  4  28 194 174 153],788,2,25371,3.647354801610121,0.0,20.0
16956,1,6956,[268  97  50 216 508],669,2,25373,3.6471180106367687,0.0,20.0
16957,1,6957,[ 98 202  71 172  96],892,4,25377,3.647168726645588,0.0,20.0
16958,1,6958,[313 127 187 302 603],669,5,25382,3.647363126886047,20.0,20.0
16959,1,6959,[195 357 318 200 435],409,3,25385,3.6472701149425286,40.0,0.0
16960,1,6960,[ 12 194   8 176  56],533,2,25387,3.6470334722022697,20.0,0.0
16961,1,6961,[181 483 135 196 546],194,1,25388,3.646653260557311,20.0,0.0
16962,1,6962,[234 202 127 271 161],13,4,25392,3.6467040068935805,0.0,20.0
16963,1,6963,[ 12  69 742 496 182],387,2,25394,3.6464675473865595,20.0,0.0
16964,1,6964,[  7 322  11 508 179],334,3,25397,3.6463747307968415,0.0,0.0
16965,1,6965,[268 294 186   8 168],234,1,25398,3.645994832041344,0.0,0.0
16966,1,6966,[268 333  64  96 191],387,2,25400,3.645758576144682,0.0,0.0
16967,1,6967,[ 88 288 597  98 204],308,3,25403,3.645665901262916,0.0,20.0
16968,1,6968,[173 289   1  11 357],488,2,25405,3.645429760367341,20.0,0.0
16969,1,6969,[313 127 187 302 603],116,3,25408,3.6453371592539456,20.0,20.0
16970,1,6970,[496 471 197   7 269],537,3,25411,3.645244584708076,0.0,0.0
16971,1,6971,[258 144 182 135  56],843,2,25413,3.6450086058519795,0.0,0.0
16972,1,6972,[ 69 603 302 276 174],474,5,25418,3.645202925570056,20.0,20.0
16973,1,6973,[313 127 187 302 603],334,5,25423,3.6453971895612276,20.0,20.0
16974,1,6974,[313 127 187 302 603],116,3,25426,3.645304659498208,20.0,20.0
16975,1,6975,[313 127 187 302 603],537,5,25431,3.6454988532110093,20.0,20.0
16976,1,6976,[313 127 187 302 603],669,5,25436,3.645692991256987,20.0,20.0
16977,1,6977,[238  12  79 323 271],537,1,25437,3.6453138435081684,20.0,0.0
16978,1,6978,[197 195 125 186 405],848,4,25441,3.645364665424846,0.0,0.0
16979,1,6979,[313 127 187 302 603],90,5,25446,3.6455587392550144,20.0,20.0
16980,1,6980,[588 222 234 172  98],312,4,25450,3.6456095115312994,0.0,20.0
16981,1,6981,[185 568 496   4 222],749,4,25454,3.6456602692638214,0.0,0.0
16982,1,6982,[194 191  12  97 144],387,2,25456,3.6454246026063295,20.0,0.0
16983,1,6983,[286 153 168 183 187],406,1,25457,3.645045819014891,0.0,0.0
16984,1,6984,[313 127 187 302 603],116,3,25460,3.6449534717251253,20.0,20.0
16985,1,6985,[135  71 515 215 302],524,2,25462,3.6447180074434584,0.0,0.0
16986,1,6986,[118 175 508 323 588],59,4,25466,3.6447688564476888,0.0,0.0
16987,1,6987,[ 11 196 265 183  64],308,3,25469,3.644676588437321,0.0,0.0
16988,1,6988,[181 265 100 161 471],7,3,25472,3.644584346830734,0.0,20.0
16989,1,6989,[222 179  12 191 143],343,5,25477,3.6447782546494993,20.0,0.0
16990,1,6990,[435 294 385 515 100],881,3,25480,3.6446860248891433,0.0,20.0
16991,1,6991,[313 127 187 302 603],334,5,25485,3.644879862700229,20.0,20.0
16992,1,6992,[289 313 215   8  15],378,5,25490,3.645073645073645,0.0,0.0
16993,1,6993,[ 11 228 118 202 603],897,3,25493,3.6449814126394053,20.0,0.0
16994,1,6994,[ 22 748  82 603  89],64,1,25494,3.644603288062902,20.0,0.0
16995,1,6995,[181 200 194 597 215],308,3,25497,3.6445111492281304,0.0,0.0
16996,1,6996,[161 185 302 271  56],102,0,25497,3.6439902815492355,0.0,0.0
16997,1,6997,[275 210  12 322 100],537,2,25499,3.6437553586739067,20.0,20.0
16998,1,6998,[174 515 276  82  15],452,3,25502,3.643663380482926,0.0,20.0
16999,1,6999,[195 288  97 202 172],892,5,25507,3.6438571428571427,0.0,0.0
17000,1,7000,[ 89 300 276  79 204],378,5,25512,3.644050849878589,0.0,0.0
17001,1,7001,[168 100 403 151  82],650,2,25514,3.6438160525564123,0.0,20.0
17002,1,7002,[313 127 187 302 603],537,5,25519,3.6440097101242324,20.0,20.0
17003,1,7003,[313 127 187 302 603],669,5,25524,3.6442033123929183,20.0,20.0
17004,1,7004,[313 127 187 302 603],474,5,25529,3.644396859386153,20.0,20.0
17005,1,7005,[200  96  12 210 179],474,4,25533,3.644447616328861,20.0,0.0
17006,1,7006,[197 204 427  15 286],6,2,25535,3.6442129299272157,0.0,0.0
17007,1,7007,[185 176 483 742 183],334,3,25538,3.6441210045662102,20.0,0.0
17008,1,7008,[282 121 111 117 143],92,3,25541,3.644029105435868,0.0,0.0
17009,1,7009,[216  95 289 117 202],234,1,25542,3.6436519258202567,0.0,0.0
17010,1,7010,[258 289 121  50  64],455,4,25546,3.643702752817002,0.0,20.0
17011,1,7011,[182 427 197 235  98],385,5,25551,3.6438961779806047,0.0,20.0
17012,1,7012,[257  82 276 161 196],533,4,25555,3.643946955653786,0.0,0.0
17013,1,7013,[ 82 245 655  25 183],749,5,25560,3.644140290846878,0.0,0.0
17014,1,7014,[313 127 187 302 603],90,5,25565,3.6443335709194584,20.0,20.0
17015,1,7015,[313 127 187 302 603],116,3,25568,3.6442417331812997,20.0,20.0
17016,1,7016,[204 678   7 180 191],387,3,25571,3.6441499216189253,0.0,0.0
17017,1,7017,[313 127 187 302 603],116,3,25574,3.6440581362211457,20.0,20.0
17018,1,7018,[174  64 508  70  89],524,4,25578,3.6441088474141616,0.0,20.0
17019,1,7019,[174 748  69  28 125],92,3,25581,3.644017094017094,0.0,20.0
17020,1,7020,[475  70 100 294 483],10,4,25585,3.6440677966101696,20.0,20.0
17021,1,7021,[313 127 187 302 603],116,3,25588,3.6439760751922528,20.0,20.0
17022,1,7022,[313 127 187 302 603],90,5,25593,3.6441691584792824,20.0,20.0
17023,1,7023,[313 127 187 302 603],474,5,25598,3.644362186788155,20.0,20.0
17024,1,7024,[153 313 496 196 182],308,2,25600,3.6441281138790034,0.0,0.0
17025,1,7025,[143  15 216 176   1],374,3,25603,3.644036436094506,0.0,0.0
17026,1,7026,[471 405 127 153  50],7,4,25607,3.644087092642664,0.0,40.0
17027,1,7027,[403 183  82 318   7],387,3,25610,3.643995446784291,20.0,0.0
17028,1,7028,[405 423 183 257 288],666,1,25611,3.6436192915066155,0.0,0.0
17029,1,7029,[313 127 187 302 603],116,3,25614,3.6435277382645803,20.0,20.0
17030,1,7030,[289 196 143 125 175],406,1,25615,3.643151756506898,0.0,0.0
17031,1,7031,[515 597  64  28 238],833,0,25615,3.6426336746302614,0.0,0.0
17032,1,7032,[508  97 125 228 204],455,4,25619,3.6426844874164654,0.0,0.0
17033,1,7033,[234 546 202 302 127],102,1,25620,3.6423087858970713,0.0,20.0
17034,1,7034,[181 173 282  96 294],92,3,25623,3.642217484008529,0.0,0.0
17035,1,7035,[318  12 568 471 234],308,3,25626,3.6421262080727685,40.0,0.0
17036,1,7036,[ 82 132  97 301 202],650,1,25627,3.6417507460565584,0.0,0.0
17037,1,7037,[187   4  12 181  50],194,3,25630,3.641659562375675,20.0,20.0
17038,1,7038,[508 179 204   1 318],653,4,25634,3.64171047023725,20.0,0.0
17039,1,7039,[185  56 318 168  64],194,5,25639,3.6419034090909093,20.0,0.0
17040,1,7040,[135 144  25 118 435],650,3,25642,3.6418122425791792,0.0,0.0
17041,1,7041,[313 127 187 302 603],271,5,25647,3.6420051121840387,20.0,20.0
17042,1,7042,[ 82 179 127   7 471],234,1,25648,3.6416299872213544,0.0,20.0
17043,1,7043,[323 288   4 179 182],378,1,25649,3.6412549687677456,0.0,0.0
17044,1,7044,[313 127 187 302 603],271,5,25654,3.641447835344216,20.0,20.0
17045,1,7045,[515 435 475 405 186],13,2,25656,3.6412148736871983,0.0,0.0
17046,1,7046,[313 127 187 302 603],669,5,25661,3.6414076912161204,20.0,20.0
17047,1,7047,[ 88 191 185  95 161],749,3,25664,3.641316685584563,0.0,0.0
17048,1,7048,[176 300 144   4 194],144,4,25668,3.6413675698680663,0.0,0.0
17049,1,7049,[ 15  50 276 118 588],59,4,25672,3.641418439716312,0.0,20.0
17050,1,7050,[313 127 187 302 603],474,5,25677,3.6416111189902143,20.0,20.0
17051,1,7051,[173 132  69 161 403],234,2,25679,3.641378332387975,0.0,0.0
17052,1,7052,[288 234  50 222 385],488,4,25683,3.641429179072735,0.0,20.0
17053,1,7053,[313 127 187 302 603],271,5,25688,3.641621774879501,20.0,20.0
17054,1,7054,[328 121  88 144 173],207,0,25688,3.6411055988660523,0.0,0.0
17055,1,7055,[568 202 265 118 323],881,4,25692,3.641156462585034,0.0,0.0
17056,1,7056,[186 132 568 235  88],339,3,25695,3.641065608615559,0.0,0.0
17057,1,7057,[168  71 234 195 200],95,3,25698,3.6409747803910455,0.0,0.0
17058,1,7058,[313 127 187 302 603],116,3,25701,3.6408839779005526,20.0,20.0
17059,1,7059,[678 210 423 127  70],308,4,25705,3.6409348441926346,0.0,20.0
17060,1,7060,[655 181 313   1  71],13,4,25709,3.640985696077043,0.0,0.0
17061,1,7061,[125  25  12 483 508],406,3,25712,3.640894930614557,40.0,0.0
17062,1,7062,[181 273  25 125 245],207,3,25715,3.640804190853745,0.0,0.0
17063,1,7063,[196 187 194  15 265],311,5,25720,3.6409966024915064,0.0,0.0
17064,1,7064,[ 96  70 181 742 546],328,4,25724,3.641047416843595,0.0,0.0
17065,1,7065,[ 11 127 194 222 197],474,5,25729,3.6412397395980753,0.0,20.0
17066,1,7066,[313 127 187 302 603],334,5,25734,3.6414320079241547,20.0,20.0
17067,1,7067,[121 288 496 111   8],452,3,25737,3.641341256366723,0.0,0.0
17068,1,7068,[ 88 288  28 151 597],374,3,25740,3.641250530485217,0.0,0.0
17069,1,7069,[435 269 125 423 273],378,4,25744,3.641301272984441,0.0,0.0
17070,1,7070,[603 204 515  82  69],233,5,25749,3.6414934238438694,20.0,0.0
17071,1,7071,[313 127 187 302 603],116,3,25752,3.6414027149321266,20.0,20.0
17072,1,7072,[302 234 191 357  12],90,5,25757,3.6415947971157925,40.0,0.0
17073,1,7073,[100 258 153 313 117],378,4,25761,3.6416454622561494,0.0,20.0
17074,1,7074,[ 15 118 172  97 210],311,4,25765,3.641696113074205,0.0,0.0
17075,1,7075,[200 257 357  11 427],271,5,25770,3.641888072357264,20.0,0.0
17076,1,7076,[385  96 357 135 276],90,5,25775,3.64207997739155,20.0,0.0
17077,1,7077,[313 127 187 302 483],207,5,25780,3.6422718282000566,20.0,20.0
17078,1,7078,[471 143 181 200 515],313,3,25783,3.642181099025286,0.0,0.0
17079,1,7079,[117 257 143 405 216],881,5,25788,3.642372881355932,0.0,0.0
17080,1,7080,[568 195  89 196 357],454,2,25790,3.642140940545121,20.0,0.0
17081,1,7081,[121 300  28 175   1],378,5,25795,3.642332674385767,0.0,0.0
17082,1,7082,[182  15 194  89 313],653,2,25797,3.6421008047437526,0.0,0.0
17083,1,7083,[ 50 423  96 197 286],452,4,25801,3.6421513269339356,0.0,20.0
17084,1,7084,[195  56 222 405 385],313,2,25803,3.6419195483415665,0.0,0.0
17085,1,7085,[180 161 168  88 286],194,2,25805,3.6416878351679367,0.0,0.0
17086,1,7086,[183  95 403   4 328],334,2,25807,3.6414561873853533,0.0,0.0
17087,1,7087,[  1 288 183  28 143],648,5,25812,3.641647855530474,0.0,0.0
17088,1,7088,[125 186 191 173 258],6,3,25815,3.641557342361405,0.0,0.0
17089,1,7089,[  1 275 257 176 194],378,5,25820,3.6417489421720735,0.0,0.0
17090,1,7090,[238 197 403 294 603],7,4,25824,3.6417994641094347,20.0,0.0
17091,1,7091,[ 95 182 194  71 173],766,2,25826,3.641567963902989,0.0,0.0
17092,1,7092,[313 127 187 302 483],90,5,25831,3.6417594811786267,20.0,20.0
17093,1,7093,[603 191 423 200 175],527,2,25833,3.6415280518748236,20.0,0.0
17094,1,7094,[313 127 187 302 483],334,5,25838,3.6417195207892883,20.0,20.0
17095,1,7095,[357 161 168  70 508],13,2,25840,3.641488162344983,20.0,0.0
17096,1,7096,[475   4  88 222  69],13,3,25843,3.6413977737072,0.0,0.0
17097,1,7097,[273  25 603 179 151],749,5,25848,3.6415891800507185,20.0,0.0
17098,1,7098,[ 12 151 508 288   1],213,4,25852,3.641639667558811,20.0,0.0
17099,1,7099,[135 173 238 127 357],840,5,25857,3.641830985915493,20.0,20.0
17100,1,7100,[313 127 187 302 483],90,5,25862,3.6420222503872695,20.0,20.0
17101,1,7101,[  7 151 172 183 508],387,4,25866,3.6420726555899745,0.0,0.0
17102,1,7102,[ 88 195 655  79   8],474,5,25871,3.6422638321835845,0.0,0.0
17103,1,7103,[273   1 180 257  98],378,4,25875,3.642314189189189,0.0,20.0
17104,1,7104,[508 318 200  22 273],537,2,25877,3.6420830401125968,20.0,0.0
17105,1,7105,[427 496   1 288 194],59,3,25880,3.6419926822403603,0.0,0.0
17106,1,7106,[ 97 235 132 357 483],308,1,25881,3.6416209371042636,40.0,0.0
17107,1,7107,[313 127 187 302 603],271,5,25886,3.6418120427687115,20.0,20.0
17108,1,7108,[  8  69 151 196 423],378,3,25889,3.6417217611478407,0.0,0.0
17109,1,7109,[ 95  25 132   4 125],406,2,25891,3.6414908579465544,0.0,0.0
17110,1,7110,[294 471  71 385 216],648,3,25894,3.6414006468851077,0.0,0.0
17111,1,7111,[313 127 187 302 603],90,5,25899,3.6415916760404947,20.0,20.0
17112,1,7112,[181 483   1 271 245],263,4,25903,3.641642063826796,20.0,0.0
17113,1,7113,[ 98   1 215  28  88],313,3,25906,3.6415518695529943,0.0,20.0
17114,1,7114,[182   4  89 215 100],378,4,25910,3.6416022487702038,0.0,20.0
17115,1,7115,[483  98 471 286 294],648,3,25913,3.641512085441259,20.0,20.0
17116,1,7116,[313 127 187 302 603],13,5,25918,3.641702964732331,20.0,20.0
17117,1,7117,[197 183 405 143 322],474,5,25923,3.6418937903905593,0.0,0.0
17118,1,7118,[183  82 191  56 216],64,4,25927,3.641944093271527,0.0,0.0
17119,1,7119,[ 50 515 181 318 100],311,4,25931,3.641994382022472,20.0,40.0
17120,1,7120,[215   8  69 435 423],243,2,25933,3.641763797219492,0.0,0.0
17121,1,7121,[196 175  97 111 194],42,2,25935,3.6415332771693345,0.0,0.0
17122,1,7122,[313 127 187 302 603],474,5,25940,3.6417239926997054,20.0,20.0
17123,1,7123,[185  98 403 175 143],95,3,25943,3.6416339135317237,0.0,20.0
17124,1,7124,[313 127 187 302 603],537,5,25948,3.6418245614035087,20.0,20.0
17125,1,7125,[  7   4  11  95 288],102,1,25949,3.6414538310412574,0.0,0.0
17126,1,7126,[202 435 234  79 168],398,3,25952,3.6413638276974885,0.0,0.0
17127,1,7127,[ 15 235 678  96  98],308,1,25953,3.640993265993266,0.0,20.0
17128,1,7128,[153  71 257 172 204],815,4,25957,3.6410436246317857,0.0,0.0
17129,1,7129,[515 143 265 748 200],311,4,25961,3.64109396914446,0.0,0.0
17130,1,7130,[ 96 237 210 181 186],537,1,25962,3.6407236011779553,0.0,0.0
17131,1,7131,[151 182 197 282  89],334,4,25966,3.640773976444195,0.0,0.0
17132,1,7132,[ 15 183   7 323  95],200,4,25970,3.6408243375858684,0.0,0.0
17133,1,7133,[180 181 271   7  64],738,4,25974,3.640874684608915,0.0,0.0
17134,1,7134,[313 127 187 302 603],537,5,25979,3.6410651716888576,20.0,20.0
17135,1,7135,[215 179 603 180 183],843,2,25981,3.6408352017937218,20.0,0.0
17136,1,7136,[215  95 405 483  82],95,1,25982,3.640465181448788,20.0,0.0
17137,1,7137,[313 127 187 302 603],334,5,25987,3.640655645839171,20.0,20.0
17138,1,7138,[211 127   8 195 215],774,1,25988,3.640285754307326,0.0,20.0
17139,1,7139,[385 403 210  89 172],64,3,25991,3.6401960784313725,0.0,0.0
17140,1,7140,[313 127 187 302 603],271,5,25996,3.6403865004901275,20.0,20.0
17141,1,7141,[195 185 515  64 273],234,2,25998,3.6401568188182583,0.0,0.0
17142,1,7142,[357 258   9 237 302],13,3,26001,3.640067198656027,20.0,0.0
17143,1,7143,[197 135 678 176 182],474,4,26005,3.64011758118701,0.0,0.0
17144,1,7144,[294 215 403 313  50],328,2,26007,3.639888033589923,0.0,20.0
17145,1,7145,[  8 191 294  15 127],144,5,26012,3.6400783655191717,0.0,20.0
17146,1,7146,[ 56 313 215 471 235],13,3,26015,3.6399888064922346,0.0,0.0
17147,1,7147,[655 588 294  56 168],537,2,26017,3.639759373251259,0.0,0.0
17148,1,7148,[515  64  25 288 318],804,4,26021,3.639809763603301,20.0,0.0
17149,1,7149,[603  82 427 204 100],537,3,26024,3.63972027972028,20.0,20.0
17150,1,7150,[ 98 403 161 151 179],234,1,26025,3.639351139700741,0.0,20.0
17151,1,7151,[313 127 187 302 603],271,5,26030,3.6395413870246087,20.0,20.0
17152,1,7152,[125 173 496 405 318],6,3,26033,3.639451978190969,20.0,0.0
17153,1,7153,[678 655 200 222   7],13,1,26034,3.639083030472463,0.0,0.0
17154,1,7154,[475  15   4  64 168],537,2,26036,3.6388539482879105,0.0,0.0
17155,1,7155,[182 180 143 483 568],85,4,26040,3.6389044158747903,20.0,0.0
17156,1,7156,[187 180 216 195 238],6,5,26045,3.6390945927064413,0.0,0.0
17157,1,7157,[313 127 187 302 603],271,5,26050,3.6392847164012294,20.0,20.0
17158,1,7158,[313 127 187 302 603],90,5,26055,3.639474786981422,20.0,20.0
17159,1,7159,[313 127 187 302 603],334,5,26060,3.6396648044692737,20.0,20.0
17160,1,7160,[ 50 475 216 313 318],92,3,26063,3.6395754782851557,20.0,20.0
17161,1,7161,[313 127 187 302 603],90,5,26068,3.6397654286512147,20.0,20.0
17162,1,7162,[ 64  69  88 191  89],749,5,26073,3.6399553259807345,0.0,0.0
17163,1,7163,[ 22 288 202 194 183],378,3,26076,3.6398659966499163,0.0,0.0
17164,1,7164,[173 276 135   7 117],537,4,26080,3.6399162595952546,0.0,0.0
17165,1,7165,[322 183  98 435 151],313,3,26083,3.639826960647502,0.0,20.0
17166,1,7166,[313 127 187 302 603],669,5,26088,3.6400167434072834,20.0,20.0
17167,1,7167,[603 181 195 655 172],843,1,26089,3.6396484375,20.0,0.0
17168,1,7168,[ 22 186 161 276 194],881,2,26091,3.6394197238108523,0.0,0.0
17169,1,7169,[313 357  70 286  69],144,5,26096,3.6396094839609483,20.0,0.0
17170,1,7170,[385 435  69   9  25],85,3,26099,3.639520290057175,0.0,0.0
17171,1,7171,[313 127 187 302 191],13,4,26103,3.6395705521472395,0.0,20.0
17172,1,7172,[ 50 144 118 546 385],194,1,26104,3.6392025651749615,0.0,20.0
17173,1,7173,[313 127 187 302 603],474,5,26109,3.6393922497909115,20.0,20.0
17174,1,7174,[313 127 187 302 603],90,5,26114,3.639581881533101,20.0,20.0
17175,1,7175,[179 194 678  89  11],881,3,26117,3.6394927536231885,0.0,0.0
17176,1,7176,[204 435 191 546   4],833,1,26118,3.639124982583252,0.0,0.0
17177,1,7177,[ 88 185 195 183 176],543,5,26123,3.639314572304263,0.0,0.0
17178,1,7178,[125  82 323  22 265],378,3,26126,3.639225518874495,0.0,0.0
17179,1,7179,[ 82 471 237 286 496],533,4,26130,3.639275766016713,0.0,0.0
17180,1,7180,[515 276  22 294   1],232,2,26132,3.6390474864225038,0.0,0.0
17181,1,7181,[385 125 176 181 151],64,3,26135,3.63895850737956,0.0,0.0
17182,1,7182,[ 98 127  56  95 385],892,4,26139,3.6390087707086174,0.0,40.0
17183,1,7183,[  4 216 258   8  12],328,2,26141,3.638780623608018,20.0,0.0
17184,1,7184,[300 191 181 483 271],537,2,26143,3.638552540013918,20.0,0.0
17185,1,7185,[313 127 187 302 603],537,5,26148,3.638741998330086,20.0,20.0
17186,1,7186,[ 64 546 603  82 143],42,4,26152,3.6387922638096564,20.0,0.0
17187,1,7187,[ 82 228 211 181 435],339,5,26157,3.6389816360601004,0.0,0.0
17188,1,7188,[  7 125  97 100 597],788,2,26159,3.6387536514118795,0.0,20.0
17189,1,7189,[  8 183   1 187 385],326,2,26161,3.6385257301808065,0.0,0.0
17190,1,7190,[118  69  96 135 427],454,4,26165,3.6385759977749967,0.0,0.0
17191,1,7191,[ 28  50  25 678 200],13,2,26167,3.638348164627364,0.0,20.0
17192,1,7192,[471 323 423 483 427],90,4,26171,3.638398442930627,20.0,0.0
17193,1,7193,[603 196 161  12 496],7,4,26175,3.6384487072560465,40.0,0.0
17194,1,7194,[ 69 125 179 286  98],271,4,26179,3.638498957609451,0.0,20.0
17195,1,7195,[ 97  79  50 258 196],263,4,26183,3.6385491939966648,0.0,20.0
17196,1,7196,[748 300 294 183 257],447,3,26186,3.638460469640128,0.0,0.0
17197,1,7197,[313 127 187 302 603],474,5,26191,3.6386496248958045,20.0,20.0
17198,1,7198,[228 748 176 222  22],881,3,26194,3.638560911237672,0.0,0.0
17199,1,7199,[403 197 200 175 186],234,2,26196,3.638333333333333,0.0,0.0
17200,1,7200,[216 568  88 210 125],313,3,26199,3.638244688237745,0.0,0.0
17201,1,7201,[313 127 187 302 603],90,5,26204,3.6384337683976673,20.0,20.0
17202,1,7202,[ 82  70 180 179  22],479,4,26208,3.638483965014577,0.0,0.0
17203,1,7203,[313 127 187 302 603],271,5,26213,3.638672959466963,20.0,20.0
17204,1,7204,[172 186 127   9 197],406,4,26217,3.6387231089521164,0.0,20.0
17205,1,7205,[313 127 187 302 603],116,3,26220,3.6386344712739382,20.0,20.0
17206,1,7206,[222 273 333 300  95],699,0,26220,3.6381295962258915,0.0,0.0
17207,1,7207,[ 88 588  69 215  71],378,4,26224,3.6381798002219754,0.0,0.0
17208,1,7208,[222 179  28  70  98],64,5,26229,3.638368705784436,0.0,20.0
17209,1,7209,[ 71 427  79 127 289],328,4,26233,3.6384188626907075,0.0,20.0
17210,1,7210,[597 405 568 186  25],59,3,26236,3.6383303286645403,0.0,0.0
17211,1,7211,[117 118  96 546 179],650,3,26239,3.6382418191902386,0.0,0.0
17212,1,7212,[ 71 173  69 118 151],200,4,26243,3.6382919728268406,0.0,0.0
17213,1,7213,[313 127 187 302 483],334,5,26248,3.6384807319101746,20.0,20.0
17214,1,7214,[313 127 187 302 483],328,5,26253,3.6386694386694387,20.0,20.0
17215,1,7215,[175  22 117  50  96],653,4,26257,3.638719512195122,0.0,20.0
17216,1,7216,[ 82  69 194 603 435],533,5,26262,3.638908133573507,20.0,0.0
17217,1,7217,[603  28  98 289 300],271,4,26266,3.6389581601551675,20.0,20.0
17218,1,7218,[483   1  70 385  97],788,2,26268,3.638731126194764,20.0,0.0
17219,1,7219,[276  28 289 300 204],533,3,26271,3.6386426592797783,0.0,0.0
17220,1,7220,[313 127 187 302 483],13,5,26276,3.6388311868162306,20.0,20.0
17221,1,7221,[313 127 187 302 483],537,5,26281,3.6390196621434505,20.0,20.0
17222,1,7222,[237 427 195 215  97],85,1,26282,3.638654298767825,0.0,0.0
17223,1,7223,[508  11 161 121 194],643,4,26286,3.638704318936877,0.0,0.0
17224,1,7224,[ 96 471 483  95  64],899,5,26291,3.6388927335640138,20.0,0.0
17225,1,7225,[172 357 197 180   7],774,1,26292,3.638527539440908,20.0,0.0
17226,1,7226,[313 127 187 302 483],90,5,26297,3.6387159263871593,20.0,20.0
17227,1,7227,[313 127 187 302 483],537,5,26302,3.6389042612064193,20.0,20.0
17228,1,7228,[313 275  79 153 655],334,5,26307,3.639092543920321,0.0,0.0
17229,1,7229,[257  69 496 286 275],271,5,26312,3.639280774550484,0.0,0.0
17230,1,7230,[238  15  70 385 200],234,1,26313,3.6389157792836397,0.0,0.0
17231,1,7231,[ 88 172 135  82 187],650,2,26315,3.6386891592920354,0.0,0.0
17232,1,7232,[294 194 257 228 196],749,3,26318,3.6386008571823587,0.0,0.0
17233,1,7233,[ 69  79  96 161 196],659,3,26321,3.6385125794857616,0.0,0.0
17234,1,7234,[ 95 403  12 328 191],334,3,26324,3.6384243261921214,20.0,0.0
17235,1,7235,[313 127 187 302 483],474,5,26329,3.638612493090105,20.0,20.0
17236,1,7236,[313 127 187 302 483],207,5,26334,3.638800607986735,20.0,20.0
17237,1,7237,[678  12  28   7 258],28,4,26338,3.638850511190937,20.0,0.0
17238,1,7238,[  7 168 302 275 222],745,2,26340,3.638624119353502,0.0,0.0
17239,1,7239,[313 127 187 302 483],669,4,26344,3.6386740331491714,20.0,20.0
17240,1,7240,[313 127 187 302 603],90,5,26349,3.6388620356304378,20.0,20.0
17241,1,7241,[ 69 271   8  11 568],13,2,26351,3.6386357359845345,0.0,0.0
17242,1,7242,[328 483 168  70 288],334,2,26353,3.6384094988264533,20.0,0.0
17243,1,7243,[174  22  96  88 117],533,5,26358,3.6385974599668693,0.0,20.0
17244,1,7244,[568  64 144   1  70],13,2,26360,3.6383712905452037,0.0,0.0
17245,1,7245,[182 175  71 235 183],92,4,26364,3.638421197902291,0.0,0.0
17246,1,7246,[313 127 187 302 603],13,5,26369,3.638609079619153,20.0,20.0
17247,1,7247,[153 403   1 216 182],892,4,26373,3.638658940397351,0.0,0.0
17248,1,7248,[211 471 216  25 151],42,4,26377,3.6387087874189543,0.0,0.0
17249,1,7249,[ 89 211 405 237 143],64,3,26380,3.6386206896551725,0.0,0.0
17250,1,7250,[313 127 187 302 603],13,5,26385,3.6388084402151426,20.0,20.0
17251,1,7251,[  8 405 748  82 385],533,2,26387,3.6385824600110315,0.0,0.0
17252,1,7252,[ 15 135 195  12  50],145,4,26391,3.6386322900868606,20.0,20.0
17253,1,7253,[135 237 588 127 435],64,5,26396,3.6388199614006065,0.0,20.0
17254,1,7254,[271 258  98 313 153],890,2,26398,3.638594073053067,0.0,20.0
17255,1,7255,[ 95 121  64 211 197],13,5,26403,3.638781697905182,0.0,0.0
17256,1,7256,[515 234 100 195   1],263,5,26408,3.6389692710486425,0.0,20.0
17257,1,7257,[313 127 187 302 603],474,5,26413,3.639156792504822,20.0,20.0
17258,1,7258,[125 237 276  12 357],406,3,26416,3.639068742250999,40.0,0.0
17259,1,7259,[403 174 187 121 135],533,3,26419,3.6389807162534433,0.0,20.0
17260,1,7260,[180 245  15 200 405],92,2,26421,3.638754992425286,0.0,0.0
17261,1,7261,[313 127 187 302 603],537,5,26426,3.638942440099146,20.0,20.0
17262,1,7262,[191 222 265  56 179],881,4,26430,3.6389921520033046,0.0,0.0
17263,1,7263,[ 69 151 100 121 191],650,2,26432,3.6387665198237884,0.0,20.0
17264,1,7264,[ 88 300 211  22 215],311,4,26436,3.6388162422573984,0.0,0.0
17265,1,7265,[268 288 597 194 222],13,2,26438,3.6385906963941648,0.0,0.0
17266,1,7266,[423 271 276 385   9],92,3,26441,3.638502820971515,0.0,0.0
17267,1,7267,[238 143 132 180 215],85,4,26445,3.638552559163456,0.0,0.0
17268,1,7268,[168  96 176 182 475],474,4,26449,3.638602283670381,0.0,0.0
17269,1,7269,[435 182 194 515 748],524,4,26453,3.6386519944979367,0.0,0.0
17270,1,7270,[235 173  82 300 185],13,0,26453,3.6381515609957367,0.0,0.0
17271,1,7271,[275 183 222 151 678],334,4,26457,3.6382013201320134,0.0,0.0
17272,1,7272,[ 11  69 187 222  25],666,2,26459,3.637976075897154,0.0,0.0
17273,1,7273,[313 127 187 302 603],13,5,26464,3.6381633214187517,20.0,20.0
17274,1,7274,[313 127 187 302 603],90,5,26469,3.6383505154639177,20.0,20.0
17275,1,7275,[197  11 238 200 180],666,5,26474,3.6385376580538757,0.0,0.0
17276,1,7276,[172 100  89 211  97],380,2,26476,3.6383124914112956,0.0,20.0
17277,1,7277,[385 151 143 173 210],295,5,26481,3.638499587798846,0.0,0.0
17278,1,7278,[313 127 187 302 603],537,5,26486,3.638686632779228,20.0,20.0
17279,1,7279,[172 515 271 161 121],334,1,26487,3.638324175824176,0.0,0.0
17280,1,7280,[179  56 294 655  98],10,4,26491,3.638373849745914,0.0,20.0
17281,1,7281,[196 182 258 603   7],474,5,26496,3.6385608349354572,20.0,0.0
17282,1,7282,[ 22 161  12 313 182],59,4,26500,3.638610462721406,20.0,0.0
17283,1,7283,[185 257 294 173 172],650,2,26502,3.6383855024711695,0.0,0.0
17284,1,7284,[257 265 403 151  98],290,3,26505,3.6382978723404253,0.0,20.0
17285,1,7285,[289 191 195 204 216],194,2,26507,3.6380730167444413,0.0,0.0
17286,1,7286,[ 89 427 100 195  50],406,5,26512,3.6382599149169756,0.0,40.0
17287,1,7287,[ 56 117 111 216 301],83,2,26514,3.638035126234907,0.0,0.0
17288,1,7288,[ 82 568  71 357 185],194,3,26517,3.637947592262313,20.0,0.0
17289,1,7289,[ 96 176 121 181 186],843,1,26518,3.6375857338820303,0.0,0.0
17290,1,7290,[313 127 187 302 603],474,5,26523,3.6377725963516663,20.0,20.0
17291,1,7291,[143 234 496 423 185],749,5,26528,3.6379594075699395,0.0,0.0
17292,1,7292,[135 333 228   7 194],387,3,26531,3.637871931989579,0.0,0.0
17293,1,7293,[313 127 187 302 603],669,5,26536,3.63805867836578,20.0,20.0
17294,1,7294,[258 202 471 172 282],479,5,26541,3.638245373543523,0.0,0.0
17295,1,7295,[313 127 187 302 603],271,5,26546,3.6384320175438596,20.0,20.0
17296,1,7296,[313 127 187 302 603],334,5,26551,3.6386186103878306,20.0,20.0
17297,1,7297,[313 127 187 302 603],669,5,26556,3.638805152096465,20.0,20.0
17298,1,7298,[ 69 515   8 196 403],892,4,26560,3.638854637621592,0.0,0.0
17299,1,7299,[678  96 318  97 117],454,3,26563,3.6387671232876713,20.0,0.0
17300,1,7300,[313 127 187 302 603],90,5,26568,3.638953568004383,20.0,20.0
17301,1,7301,[216 173 357   4 228],738,4,26572,3.6390030128731854,20.0,0.0
17302,1,7302,[313 127 187 302 603],669,5,26577,3.6391893742297685,20.0,20.0
17303,1,7303,[318 173  56 222 197],883,4,26581,3.639238773274918,20.0,0.0
17304,1,7304,[216 215 121 194 423],60,5,26586,3.6394250513347024,0.0,0.0
17305,1,7305,[121 182   7 282 210],374,4,26590,3.6394744045989595,0.0,0.0
17306,1,7306,[195 132 328  64 143],804,4,26594,3.639523744354728,0.0,0.0
17307,1,7307,[313 127 187 302 603],116,3,26597,3.6394362342638207,20.0,20.0
17308,1,7308,[183 176 185 265   1],843,2,26599,3.639211930496648,0.0,0.0
17309,1,7309,[276 385 127 168 195],474,4,26603,3.6392612859097127,0.0,20.0
17310,1,7310,[385  89 435 144 228],328,3,26606,3.639173847626864,0.0,0.0
17311,1,7311,[588 143  28 423 132],59,3,26609,3.639086433260394,0.0,0.0
17312,1,7312,[427 423 200 302  70],788,4,26613,3.6391357855873103,0.0,0.0
17313,1,7313,[196  95 301   9  89],234,0,26613,3.6386382280557834,0.0,0.0
17314,1,7314,[ 88 302 427 328  25],271,3,26616,3.638550922761449,0.0,0.0
17315,1,7315,[313 127 187 302 603],13,5,26621,3.638737014762165,20.0,20.0
17316,1,7316,[216 286 180 194 100],41,3,26624,3.6386497198305316,0.0,20.0
17317,1,7317,[196  82 194  79  64],194,2,26626,3.638425799398743,0.0,0.0
17318,1,7318,[313 127 187 302 603],116,3,26629,3.638338570843011,20.0,20.0
17319,1,7319,[161  56 302  79  96],833,2,26631,3.6381147540983605,0.0,0.0
17320,1,7320,[153  28 210 216 215],13,3,26634,3.6380275918590357,0.0,0.0
17321,1,7321,[125 588  15 182 187],881,2,26636,3.6378038787216607,0.0,0.0
17322,1,7322,[300 202  96 245  15],653,3,26639,3.6377167827393144,0.0,0.0
17323,1,7323,[ 50   1 194  56  70],882,3,26642,3.637629710540688,0.0,20.0
17324,1,7324,[357 100 403 215  28],308,3,26645,3.637542662116041,20.0,20.0
17325,1,7325,[216  82 235 176 568],882,4,26649,3.6375921375921374,0.0,0.0
17326,1,7326,[294 322  98 237 216],328,2,26651,3.6373686365497475,0.0,20.0
17327,1,7327,[210 294 742 496 151],897,3,26654,3.637281659388646,0.0,0.0
17328,1,7328,[ 50 121 655 144 294],308,2,26656,3.6370582617000955,0.0,20.0
17329,1,7329,[496 300 127  97 185],694,5,26661,3.637244201909959,0.0,20.0
17330,1,7330,[508  25 678  97 176],537,1,26662,3.636884463238303,0.0,0.0
17331,1,7331,[313 127 187 302 483],328,5,26667,3.6370703764320784,20.0,20.0
17332,1,7332,[313 127 187 302 483],669,4,26671,3.6371198690849584,20.0,20.0
17333,1,7333,[313 127 187 302 603],13,5,26676,3.6373056994818653,20.0,20.0
17334,1,7334,[210  56   1 151 204],536,3,26679,3.6372188139059305,0.0,0.0
17335,1,7335,[313 127 187 302 603],90,5,26684,3.6374045801526718,20.0,20.0
17336,1,7336,[  7  88   8 269 222],343,5,26689,3.6375902957612105,0.0,0.0
17337,1,7337,[185 211  71 234 603],452,2,26691,3.6373671300081765,20.0,0.0
17338,1,7338,[161 228   4 216 187],524,4,26695,3.637416541763183,0.0,0.0
17339,1,7339,[435  50 588  70 153],295,5,26700,3.637602179836512,0.0,20.0
17340,1,7340,[313 127 187 302 603],537,5,26705,3.6377877673341508,20.0,20.0
17341,1,7341,[313 132 508 257 211],533,5,26710,3.637973304276764,0.0,0.0
17342,1,7342,[435  64  28 172 191],379,5,26715,3.638158790685006,0.0,0.0
17343,1,7343,[ 64  97 174  28  22],387,3,26718,3.6380718954248366,0.0,20.0
17344,1,7344,[313 127 187 302 603],669,5,26723,3.6382573179033355,20.0,20.0
17345,1,7345,[313  22 121 483 288],59,5,26728,3.638442689899265,20.0,0.0
17346,1,7346,[313 127 187 302 603],90,5,26733,3.638628011433238,20.0,20.0
17347,1,7347,[313 127 187 302 603],669,5,26738,3.6388132825258572,20.0,20.0
17348,1,7348,[144 204  50 117 127],387,2,26740,3.6385902843924343,0.0,40.0
17349,1,7349,[  1 257 742 153 175],795,2,26742,3.6383673469387756,0.0,0.0
17350,1,7350,[237 168 121 234  11],537,1,26743,3.6380084342266357,0.0,0.0
17351,1,7351,[100 195 265 357 515],328,4,26747,3.638057671381937,20.0,20.0
17352,1,7352,[313 127 187 302 603],116,3,26750,3.6379708962328303,20.0,20.0
17353,1,7353,[ 82 515 313 197 405],184,3,26753,3.6378841446831656,0.0,0.0
17354,1,7354,[294 135  22 100 228],145,5,26758,3.6380693405846363,0.0,20.0
17355,1,7355,[313 127 187 302 191],13,4,26762,3.6381185426862426,0.0,20.0
17356,1,7356,[275 234 483  82 655],343,4,26766,3.6381677314122602,20.0,0.0
17357,1,7357,[313 127 187 302 483],328,5,26771,3.6383528132644742,20.0,20.0
17358,1,7358,[313 127 187 302 483],328,5,26776,3.638537844815872,20.0,20.0
17359,1,7359,[313 127 187 302 483],328,5,26781,3.6387228260869566,20.0,20.0
17360,1,7360,[238  64  89 427 175],474,5,26786,3.6389077570982202,0.0,0.0
17361,1,7361,[313 127 187 302 483],207,5,26791,3.639092637870144,20.0,20.0
17362,1,7362,[237 117 174   8 100],13,4,26795,3.639141654217031,0.0,40.0
17363,1,7363,[515  56 483 435 176],13,3,26798,3.6390548614883214,20.0,0.0
17364,1,7364,[ 28 151  50 121 300],666,0,26798,3.638560760353021,0.0,20.0
17365,1,7365,[313 127 187 302 483],13,5,26803,3.638745587836003,20.0,20.0
17366,1,7366,[515  69 127 238 117],774,3,26806,3.638658884213384,0.0,20.0
17367,1,7367,[313 127 187 302 483],328,5,26811,3.638843648208469,20.0,20.0
17368,1,7368,[173 385 234 748 194],311,5,26816,3.639028362057267,0.0,0.0
17369,1,7369,[313 127 187 302 483],13,5,26821,3.63921302578019,20.0,20.0
17370,1,7370,[313 127 187 302 483],207,5,26826,3.6393976393976395,20.0,20.0
17371,1,7371,[237  64  82 176 245],455,2,26828,3.6391752577319587,0.0,0.0
17372,1,7372,[496 216  28 286 273],537,1,26829,3.638817306388173,0.0,0.0
17373,1,7373,[313 127 187 302 483],207,5,26834,3.6390018985625168,20.0,20.0
17374,1,7374,[202 135 294 191 168],882,5,26839,3.639186440677966,0.0,0.0
17375,1,7375,[ 56 132 153   4 483],328,3,26842,3.6390997830802605,20.0,0.0
17376,1,7376,[313 127 187 302 483],537,5,26847,3.6392842618950794,20.0,20.0
17377,1,7377,[195 132 143 237   7],13,2,26849,3.6390620764434805,0.0,0.0
17378,1,7378,[100 132 603 496 588],312,5,26854,3.6392465103672587,20.0,20.0
17379,1,7379,[403  97  69 151  82],379,4,26858,3.6392953929539296,0.0,0.0
17380,1,7380,[655 153  11  82 301],234,0,26858,3.6388023303075463,0.0,0.0
17381,1,7381,[ 96 181 210  82 222],653,4,26862,3.6388512598211866,0.0,0.0
17382,1,7382,[125  71  50  97  96],234,1,26863,3.6384938371935527,0.0,20.0
17383,1,7383,[313 127 187 302 483],13,5,26868,3.6386782231852655,20.0,20.0
17384,1,7384,[588 597  97 143 471],378,3,26871,3.638591740013541,0.0,0.0
17385,1,7385,[597 196 195  50  82],882,5,26876,3.638776062821554,0.0,20.0
17386,1,7386,[313 127 187 302 483],13,5,26881,3.638960335724922,20.0,20.0
17387,1,7387,[423 603 742 121 172],454,3,26884,3.6388738494856523,20.0,0.0
17388,1,7388,[435 655 132 174 318],194,4,26888,3.638922722966572,20.0,20.0
17389,1,7389,[427 143 322  79 176],13,1,26889,3.638565629228687,0.0,0.0
17390,1,7390,[ 22 194  56 222 187],897,4,26893,3.6386145311865783,0.0,0.0
17391,1,7391,[ 22 216 471 323 276],311,4,26897,3.63866341991342,0.0,0.0
17392,1,7392,[313 127 187 302 483],207,5,26902,3.638847558501285,20.0,20.0
17393,1,7393,[313 127 187 302 483],334,5,26907,3.6390316472815796,20.0,20.0
17394,1,7394,[ 82 318 265 168  89],488,5,26912,3.6392156862745098,20.0,0.0
17395,1,7395,[276 265 121 172 515],92,5,26917,3.6393996755002704,0.0,0.0
17396,1,7396,[313 127 187 302 483],90,5,26922,3.6395836149790455,20.0,20.0
17397,1,7397,[117 195 385 161 153],328,2,26924,3.6393619897269534,0.0,0.0
17398,1,7398,[405 176 127 423  79],815,4,26928,3.6394107311798893,0.0,20.0
17399,1,7399,[427 273 294  88 153],374,1,26929,3.639054054054054,0.0,0.0
17400,1,7400,[471 181 215  97 286],271,4,26933,3.6391028239427103,0.0,0.0
17401,1,7401,[183 191 405  79 273],666,2,26935,3.638881383409889,0.0,0.0
17402,1,7402,[ 11 132 175  25 194],7,3,26938,3.638795083074429,0.0,0.0
17403,1,7403,[ 15 211 286 471 228],194,2,26940,3.6385737439222043,0.0,0.0
17404,1,7404,[153 191   9 423 435],815,5,26945,3.6387575962187713,0.0,0.0
17405,1,7405,[313 127 187 302 483],328,5,26950,3.6389413988657844,20.0,20.0
17406,1,7406,[187 176 181 216 174],7,3,26953,3.638855137032537,0.0,20.0
17407,1,7407,[182  98 132  88  12],474,5,26958,3.639038876889849,20.0,20.0
17408,1,7408,[313 127 187 302 483],328,5,26963,3.6392225671480634,20.0,20.0
17409,1,7409,[496 143   8 222 235],194,1,26964,3.6388663967611334,0.0,0.0
17410,1,7410,[313 127 187 302 483],669,4,26968,3.6389151261638104,20.0,20.0
17411,1,7411,[265 603 179 187 403],13,3,26971,3.6388289260658393,20.0,0.0
17412,1,7412,[211 300   8 180 135],774,1,26972,3.638472952920545,0.0,0.0
17413,1,7413,[313 127 187 302 483],90,5,26977,3.6386565956298895,20.0,20.0
17414,1,7414,[216  69 228 143 265],313,3,26980,3.6385704652730952,0.0,0.0
17415,1,7415,[313 127 187 302 483],90,5,26985,3.638754045307443,20.0,20.0
17416,1,7416,[237 471   8 427 655],194,2,26987,3.6385330996359713,0.0,0.0
17417,1,7417,[313 127 187 302 483],13,5,26992,3.6387166352116473,20.0,20.0
17418,1,7418,[273 288 204 143  28],892,4,26996,3.638765332255021,0.0,0.0
17419,1,7419,[313 127 187 302 483],334,5,27001,3.6389487870619948,20.0,20.0
17420,1,7420,[748 215 210 228 603],13,4,27005,3.6389974396981537,20.0,0.0
17421,1,7421,[423 182  96 742  70],524,4,27009,3.6390460792239288,0.0,0.0
17422,1,7422,[435 204 234 100 546],804,3,27012,3.6389599892226863,0.0,20.0
17423,1,7423,[275 435 313  97 678],454,2,27014,3.638739224137931,0.0,0.0
17424,1,7424,[313 127 187 302 483],474,5,27019,3.638922558922559,20.0,20.0
17425,1,7425,[313 228 235  95 322],537,1,27020,3.6385671963371937,0.0,0.0
17426,1,7426,[ 89 655  11 215 405],406,2,27022,3.6383465733135854,0.0,0.0
17427,1,7427,[313 127 187 302 483],537,5,27027,3.638529886914378,20.0,20.0
17428,1,7428,[313 127 187 302 483],207,5,27032,3.638713151164356,20.0,20.0
17429,1,7429,[313 127 187 302 483],537,5,27037,3.6388963660834457,20.0,20.0
17430,1,7430,[678 222 275 403 435],648,4,27041,3.63894496030144,0.0,0.0
17431,1,7431,[176  71 210 172 322],234,0,27041,3.6384553283100107,0.0,0.0
17432,1,7432,[222 385  95  50 257],279,2,27043,3.6382348984259383,0.0,20.0
17433,1,7433,[176 235   4 144  69],788,3,27046,3.638149044928706,0.0,0.0
17434,1,7434,[204 483 183 286 174],234,2,27048,3.6379287155346334,20.0,20.0
17435,1,7435,[ 88 180 216 423  79],452,3,27051,3.6378429263044647,0.0,0.0
17436,1,7436,[ 15 258  12  79  71],59,3,27054,3.63775716014522,20.0,0.0
17437,1,7437,[483 471 258  79 200],815,4,27058,3.637805861790804,20.0,0.0
17438,1,7438,[ 96 271 100 143  95],28,4,27062,3.637854550342788,0.0,20.0
17439,1,7439,[144  69 276 275 515],13,3,27065,3.637768817204301,0.0,0.0
17440,1,7440,[180 183  28 195 202],59,5,27070,3.6379518881870716,0.0,0.0
17441,1,7441,[ 12  95 234 471  56],13,4,27074,3.6380005374899222,20.0,0.0
17442,1,7442,[187  98 357 172 144],788,4,27078,3.6380491737202743,20.0,20.0
17443,1,7443,[121  25 202 228 161],897,3,27081,3.6379634605051048,0.0,0.0
17444,1,7444,[588 216 117 742 237],144,5,27086,3.6381464069845535,0.0,0.0
17445,1,7445,[196 176 132  96 385],378,5,27091,3.6383293043244693,0.0,0.0
17446,1,7446,[127 194 211 403  11],804,3,27094,3.6382435880220223,0.0,20.0
17447,1,7447,[655 282  82 238 202],666,3,27097,3.638157894736842,0.0,0.0
17448,1,7448,[313 127 187 302 483],328,5,27102,3.6383407168747484,20.0,20.0
17449,1,7449,[172  71 222 151  70],312,3,27105,3.638255033557047,0.0,0.0
17450,1,7450,[222  97 216  79 151],339,4,27109,3.6383035834116226,0.0,0.0
17451,1,7451,[568 100  79 153 748],207,3,27112,3.6382179280730007,0.0,20.0
17452,1,7452,[187   7 132 211 121],653,2,27114,3.6379981215617874,0.0,0.0
17453,1,7453,[183  95 132  70  96],506,5,27119,3.6381808425006708,0.0,0.0
17454,1,7454,[385   8 183 168 211],308,5,27124,3.6383635144198525,0.0,0.0
17455,1,7455,[182  28 271   8 187],13,4,27128,3.638412017167382,0.0,0.0
17456,1,7456,[180 121 143 222 294],13,2,27130,3.6381923025345313,0.0,0.0
17457,1,7457,[121 182 135 515 172],815,2,27132,3.6379726468222042,0.0,0.0
17458,1,7458,[313 127 187 302 483],537,5,27137,3.638155248692854,20.0,20.0
17459,1,7459,[423 678 194 318 276],537,2,27139,3.637935656836461,20.0,0.0
17460,1,7460,[172 435 228 186 405],638,2,27141,3.6377161238439886,0.0,0.0
17461,1,7461,[ 28 289 118  22 215],271,4,27145,3.63776467435004,0.0,0.0
17462,1,7462,[313 127 187 302 483],334,5,27150,3.637947206217339,20.0,20.0
17463,1,7463,[215 132 161 173 174],650,3,27153,3.637861736334405,0.0,20.0
17464,1,7464,[313 127 187 302 483],90,5,27158,3.638044206296048,20.0,20.0
17465,1,7465,[ 79 176  28 568  96],387,3,27161,3.6379587463166354,0.0,0.0
17466,1,7466,[313 127 187 302 483],13,5,27166,3.6381411544127493,20.0,20.0
17467,1,7467,[313 127 187 302 483],537,5,27171,3.638323513658275,20.0,20.0
17468,1,7468,[117 100 276 471  28],308,2,27173,3.63810416387736,0.0,20.0
17469,1,7469,[ 98 211 151 275 423],308,4,27177,3.638152610441767,0.0,20.0
17470,1,7470,[ 69 269 302 294 180],10,4,27181,3.638201044036943,0.0,0.0
17471,1,7471,[655 235 496 187  89],339,4,27185,3.6382494646680943,0.0,0.0
17472,1,7472,[313 127 187 302 483],207,5,27190,3.6384316874080023,20.0,20.0
17473,1,7473,[195  98 215  89 182],144,3,27193,3.638346267059138,0.0,20.0
17474,1,7474,[427   8  70 173  79],271,5,27198,3.6385284280936454,0.0,0.0
17475,1,7475,[ 50 172 257 127   4],455,4,27202,3.6385767790262173,0.0,40.0
17476,1,7476,[271 210 222 238 172],215,4,27206,3.638625117025545,0.0,0.0
17477,1,7477,[748 318 435  50 204],524,3,27209,3.6385397165017386,20.0,20.0
17478,1,7478,[238 271 483 435 235],833,3,27212,3.63845433881535,20.0,0.0
17479,1,7479,[ 56 202 168 175 135],804,3,27215,3.638368983957219,0.0,0.0
17480,1,7480,[ 82 132 191 195 515],669,3,27218,3.6382836519181927,0.0,0.0
17481,1,7481,[  9 181 135 195 216],533,4,27222,3.6383319967923016,0.0,0.0
17482,1,7482,[ 70 144 405 275 237],13,2,27224,3.638113056260858,0.0,0.0
17483,1,7483,[180 182 237 568 427],313,4,27228,3.638161411010155,0.0,0.0
17484,1,7484,[678   8 202 288  97],13,3,27231,3.6380761523046092,0.0,0.0
17485,1,7485,[313 127 187 302 483],328,5,27236,3.6382580817526047,20.0,20.0
17486,1,7486,[195  12 483 289 121],328,4,27240,3.6383063977561108,40.0,0.0
17487,1,7487,[313 127 187 302 483],474,5,27245,3.638488247863248,20.0,20.0
17488,1,7488,[ 89 273 222 121 234],64,2,27247,3.63826946187742,0.0,0.0
17489,1,7489,[121 276  70 204  89],194,1,27248,3.637917222963952,0.0,0.0
17490,1,7490,[294 471  64 153 282],194,2,27250,3.6376985716192767,0.0,0.0
17491,1,7491,[294  22 132 202  95],766,1,27251,3.6373465029364658,0.0,0.0
17492,1,7492,[313 127 187 302 483],13,5,27256,3.637528359802482,20.0,20.0
17493,1,7493,[742 144 313 216 568],650,2,27258,3.637309847878303,0.0,0.0
17494,1,7494,[313 127 187 302 483],334,5,27263,3.637491661107405,20.0,20.0
17495,1,7495,[313 127 187 302 483],90,5,27268,3.6376734258271077,20.0,20.0
17496,1,7496,[194 143 265 172  15],234,1,27269,3.6373215953047886,0.0,0.0
17497,1,7497,[313 127 187 302 483],474,5,27274,3.637503334222459,20.0,20.0
17498,1,7498,[265 196 210 144 568],92,4,27278,3.6375516735564744,0.0,0.0
17499,1,7499,[ 56 210   8 357 172],313,3,27281,3.6374666666666666,20.0,0.0
17500,1,7500,[313 127 187 302 483],13,5,27286,3.6376483135581923,20.0,20.0
17501,1,7501,[204 222 385 197  22],804,5,27291,3.6378299120234603,0.0,0.0
17502,1,7502,[ 22 403  96 168 135],7,5,27296,3.638011462081834,0.0,0.0
17503,1,7503,[132   4 257 194 234],881,1,27297,3.6376599147121533,0.0,0.0
17504,1,7504,[ 98 172 173 289 286],488,2,27299,3.637441705529647,0.0,20.0
17505,1,7505,[194 173 323 405  79],883,3,27302,3.637356781241673,0.0,0.0
17506,1,7506,[187 483 318  64 191],533,5,27307,3.6375382975889172,40.0,0.0
17507,1,7507,[111 603 204 471 385],666,2,27309,3.637320191795418,20.0,0.0
17508,1,7508,[144  97 496 475 187],479,2,27311,3.6371021440937543,0.0,0.0
17509,1,7509,[313 127 187 302 483],537,5,27316,3.63728362183755,20.0,20.0
17510,1,7510,[118  88 135 168 597],774,0,27316,3.636799360937292,0.0,0.0
17511,1,7511,[276 235 202 258 144],13,4,27320,3.6368477103301386,0.0,0.0
17512,1,7512,[197 435 179 597 135],452,3,27323,3.6367629442300013,0.0,0.0
17513,1,7513,[265 294 191  64  50],653,4,27327,3.636811285600213,0.0,20.0
17514,1,7514,[127 197 191  50 496],650,4,27331,3.636859614105123,0.0,40.0
17515,1,7515,[405  96 121  28 168],774,0,27331,3.6363757317722194,0.0,0.0
17516,1,7516,[313 127 187 302 483],334,5,27336,3.6365571371557803,20.0,20.0
17517,1,7517,[742 172 182 222 194],158,4,27340,3.6366054801808994,0.0,0.0
17518,1,7518,[302 318 276 235 265],271,3,27343,3.6365208139380236,20.0,0.0
17519,1,7519,[655 143 357 202  71],840,4,27347,3.6365691489361702,20.0,0.0
17520,1,7520,[313 127 187 302 483],669,4,27351,3.636617471080973,20.0,20.0
17521,1,7521,[313 127 187 302 483],474,5,27356,3.636798723743685,20.0,20.0
17522,1,7522,[483 186   1 403 210],234,1,27357,3.636448225441978,20.0,0.0
17523,1,7523,[  8 222 100  71 121],82,4,27361,3.636496544391281,0.0,20.0
17524,1,7524,[273  69 182 191 195],92,5,27366,3.6366777408637874,0.0,0.0
17525,1,7525,[313 127 187 302 483],669,4,27370,3.636726016476216,20.0,20.0
17526,1,7526,[313 127 187 302 483],13,5,27375,3.636907134316461,20.0,20.0
17527,1,7527,[655 483  95 385 100],85,2,27377,3.6366896918172156,20.0,20.0
17528,1,7528,[143 301 175  89 508],13,2,27379,3.6364723070792935,0.0,0.0
17529,1,7529,[ 69 286 423 496 132],60,5,27384,3.6366533864541832,0.0,0.0
17530,1,7530,[111 286  50 179  69],648,3,27387,3.636568848758465,0.0,20.0
17531,1,7531,[132 168 435  88 174],850,5,27392,3.6367498672331386,0.0,20.0
17532,1,7532,[191 322  96 196 282],881,3,27395,3.6366653391742996,0.0,0.0
17533,1,7533,[286 100 273 202 294],699,1,27396,3.6363153703212103,0.0,20.0
17534,1,7534,[313 127 187 302 483],207,5,27401,3.6364963503649634,20.0,20.0
17535,1,7535,[211 237 143 121 546],346,4,27405,3.636544585987261,0.0,0.0
17536,1,7536,[173 257  98 222  89],339,5,27410,3.636725487594534,0.0,20.0
17537,1,7537,[183  12  89  28 318],406,4,27414,3.636773680021226,40.0,0.0
17538,1,7538,[161 173 127 174 168],524,4,27418,3.6368218596630855,0.0,40.0
17539,1,7539,[282 496 172 181 300],479,3,27421,3.636737400530504,0.0,0.0
17540,1,7540,[ 95 323  64 313 235],13,3,27424,3.636652963797905,0.0,0.0
17541,1,7541,[228  98 182 143  70],406,2,27426,3.6364359586316626,0.0,20.0
17542,1,7542,[313 127 187 302 483],669,4,27430,3.636484157497017,20.0,20.0
17543,1,7543,[238 435 357 191 318],6,5,27435,3.6366648992576884,40.0,0.0
17544,1,7544,[268  79  50 289 475],387,2,27437,3.6364479787939032,0.0,20.0
17545,1,7545,[ 28 385 748 234 182],479,3,27440,3.6363636363636362,0.0,0.0
17546,1,7546,[182 515 273 678  70],13,1,27441,3.636014310321982,0.0,0.0
17547,1,7547,[172  89 127  82 121],387,4,27445,3.6360625331213567,0.0,20.0
17548,1,7548,[313 127 187 302 483],537,5,27450,3.6362432110213274,20.0,20.0
17549,1,7549,[313 127 187 302 483],328,5,27455,3.6364238410596026,20.0,20.0
17550,1,7550,[173  89 195  69 181],804,5,27460,3.636604423255198,0.0,0.0
17551,1,7551,[313 127 187 302 483],13,5,27465,3.6367849576271185,20.0,20.0
17552,1,7552,[ 82 496 151 423 471],533,4,27469,3.6368330464716006,0.0,0.0
17553,1,7553,[196 288 168 276  15],92,3,27472,3.636748742388139,0.0,0.0
17554,1,7554,[ 69 288 172 546 323],378,1,27473,3.6363997352746527,0.0,0.0
17555,1,7555,[ 64 125 546  11 678],82,2,27475,3.6361831656961354,0.0,0.0
17556,1,7556,[323 273 385 515 118],328,1,27476,3.6358343257906576,0.0,0.0
17557,1,7557,[313 127 187 302 483],13,5,27481,3.636014818735115,20.0,20.0
17558,1,7558,[197 483 211 132 173],60,5,27486,3.6361952639237995,20.0,0.0
17559,1,7559,[313 127 187 302 483],90,5,27491,3.6363756613756615,20.0,20.0
17560,1,7560,[174 235  56  25 333],313,2,27493,3.6361592381960057,0.0,20.0
17561,1,7561,[216  71 515 179 132],85,4,27497,3.6362073525522347,0.0,0.0
17562,1,7562,[313 127 187 302 483],537,5,27502,3.6363876768478116,20.0,20.0
17563,1,7563,[313 127 187 302 483],13,5,27507,3.636567953463776,20.0,20.0
17564,1,7564,[313 127 187 302 483],207,5,27512,3.636748182419035,20.0,20.0
17565,1,7565,[276 289 288 187 182],533,1,27513,3.6363996827914353,0.0,0.0
17566,1,7566,[121 222 173 678 234],92,3,27516,3.636315580811418,0.0,0.0
17567,1,7567,[121 186 496 427  11],406,4,27520,3.6363636363636362,0.0,0.0
17568,1,7568,[265 127  79 121   9],207,3,27523,3.636279561368741,0.0,20.0
17569,1,7569,[313 127 187 302 483],537,5,27528,3.636459709379128,20.0,20.0
17570,1,7570,[313 127 187 302 483],537,5,27533,3.636639809800555,20.0,20.0
17571,1,7571,[546 483  64 423 216],13,3,27536,3.6365557316428947,20.0,0.0
17572,1,7572,[ 69 211 153 187 176],650,3,27539,3.6364716756899513,0.0,0.0
17573,1,7573,[748 187 176  11 153],102,0,27539,3.635991550039609,0.0,0.0
17574,1,7574,[176 427 127 257  64],271,4,27543,3.636039603960396,0.0,20.0
17575,1,7575,[204 118  89 515  50],311,4,27547,3.636087645195354,0.0,20.0
17576,1,7576,[313 127 187 302 483],474,5,27552,3.636267652105055,20.0,20.0
17577,1,7577,[197 435  98 568 423],387,1,27553,3.6359197677487463,0.0,20.0
17578,1,7578,[ 56 273   7 288 546],92,3,27556,3.6358358622509566,0.0,0.0
17579,1,7579,[313 127 187 302 483],13,5,27561,3.6360158311345647,20.0,20.0
17580,1,7580,[235 186 427 496 258],339,3,27564,3.6359319351009103,0.0,0.0
17581,1,7581,[275 288 322 176  11],13,0,27564,3.63545238723292,0.0,0.0
17582,1,7582,[238 202 222   1 294],749,2,27566,3.635236713701701,0.0,0.0
17583,1,7583,[313 127 187 302 483],13,5,27571,3.6354166666666665,20.0,20.0
17584,1,7584,[ 28 313 181 238 196],59,5,27576,3.635596572181938,0.0,0.0
17585,1,7585,[ 88  64 194  89  96],892,5,27581,3.63577643026628,0.0,0.0
17586,1,7586,[273  11 222 238 294],213,3,27584,3.6356926321339134,0.0,0.0
17587,1,7587,[ 88 121 273  79 471],378,4,27588,3.635740643120717,0.0,0.0
17588,1,7588,[328  97 161 121 276],533,3,27591,3.6356568717881146,0.0,0.0
17589,1,7589,[313 127 187 302 483],90,5,27596,3.635836627140975,20.0,20.0
17590,1,7590,[125 175  12 202 204],42,4,27600,3.6358846001844287,20.0,0.0
17591,1,7591,[ 69 172 276  11 111],92,4,27604,3.6359325605900947,0.0,0.0
17592,1,7592,[234 276   7  95 186],59,4,27608,3.635980508362966,0.0,0.0
17593,1,7593,[588 405 181 234 403],881,2,27610,3.6357650776929153,0.0,0.0
17594,1,7594,[  1 475 471 127 210],605,2,27612,3.635549703752469,0.0,20.0
17595,1,7595,[  4 568 289 216 172],374,2,27614,3.6353343865192205,0.0,0.0
17596,1,7596,[ 25 176 185 194  64],666,3,27617,3.635250756877715,0.0,0.0
17597,1,7597,[ 56  79 174 423 265],387,4,27621,3.635298762832324,0.0,20.0
17598,1,7598,[204 144 172 258  56],213,5,27626,3.6354783524147916,0.0,0.0
17599,1,7599,[313 127 187 302 483],207,5,27631,3.635657894736842,20.0,20.0
17600,1,7600,[313 127 187 302 483],13,5,27636,3.6358373898171292,20.0,20.0
17601,1,7601,[ 15 211  89  96  69],830,4,27640,3.635885293343857,0.0,0.0
17602,1,7602,[269 151 302  97 515],90,4,27644,3.6359331842693674,0.0,0.0
17603,1,7603,[135 200 405 173 180],59,4,27648,3.635981062598632,0.0,0.0
17604,1,7604,[183 210 237 197 216],194,1,27649,3.6356344510190666,0.0,0.0
17605,1,7605,[ 50 515 196 187 202],650,3,27652,3.635550880883513,0.0,20.0
17606,1,7606,[  8 200  64  25  11],455,3,27655,3.6354673327198634,0.0,0.0
17607,1,7607,[265 257  95 235 234],308,2,27657,3.6352523659305995,0.0,0.0
17608,1,7608,[174  56 202 257 471],343,4,27661,3.6353003022736234,0.0,20.0
17609,1,7609,[475 265 268 185 200],537,3,27664,3.635216819973719,0.0,0.0
17610,1,7610,[222 568 183  97 168],881,3,27667,3.635133359611089,0.0,0.0
17611,1,7611,[423 678 175 288 496],648,3,27670,3.635049921177089,0.0,0.0
17612,1,7612,[405  71 215 204  98],881,4,27674,3.6350978589255223,0.0,20.0
17613,1,7613,[288 121 173 111 204],334,2,27676,3.634883110060415,0.0,0.0
17614,1,7614,[161 228 222 357 403],13,2,27678,3.6346684175968482,20.0,0.0
17615,1,7615,[125   4  25 143 153],92,3,27681,3.6345850840336134,0.0,0.0
17616,1,7616,[  1  69 288 185 132],537,1,27682,3.63423920178548,0.0,0.0
17617,1,7617,[186 318 151   7  22],334,4,27686,3.6342872144919927,20.0,0.0
17618,1,7618,[ 95 237  56  71 235],524,1,27687,3.633941462134138,0.0,0.0
17619,1,7619,[210 174  95 273 168],892,5,27692,3.6341207349081364,0.0,20.0
17620,1,7620,[313 127 187 302 483],13,5,27697,3.6342999606350874,20.0,20.0
17621,1,7621,[195 471 215 135   7],144,4,27701,3.634347940173183,0.0,0.0
17622,1,7622,[234 196 427  98  79],85,3,27704,3.634264725173816,0.0,20.0
17623,1,7623,[  9   7 235  98  71],184,3,27707,3.6341815320041975,0.0,20.0
17624,1,7624,[111 748 202  98 204],899,5,27712,3.634360655737705,0.0,20.0
17625,1,7625,[269 118 323 202 294],378,2,27714,3.6341463414634148,0.0,0.0
17626,1,7626,[313 127 187 302 483],474,5,27719,3.6343254228399107,20.0,20.0
17627,1,7627,[313 127 187 302 483],537,5,27724,3.6345044572627163,20.0,20.0
17628,1,7628,[174 403 173 678 265],339,2,27726,3.6342902084152575,0.0,20.0
17629,1,7629,[100 144  50 180 435],7,5,27731,3.6344692005242463,0.0,40.0
17630,1,7630,[191 423 215 357 180],234,3,27734,3.63438605687328,20.0,0.0
17631,1,7631,[313 127 187 302 483],537,5,27739,3.63456498951782,20.0,20.0
17632,1,7632,[313 127 187 302 483],207,5,27744,3.6347438752783963,20.0,20.0
17633,1,7633,[ 69 180 496 405 144],536,4,27748,3.6347917212470526,0.0,0.0
17634,1,7634,[ 70 357  95 195 257],308,5,27753,3.6349705304518665,20.0,0.0
17635,1,7635,[186 100 202 234 496],738,4,27757,3.6350183342063906,0.0,20.0
17636,1,7636,[ 95  22  25 202 568],95,3,27760,3.634935183972764,0.0,0.0
17637,1,7637,[655 135 127 172 180],326,2,27762,3.6347211311861742,0.0,20.0
17638,1,7638,[322  71 144 111  11],92,3,27765,3.6346380416284854,0.0,0.0
17639,1,7639,[180 121 174 211   7],346,4,27769,3.6346858638743456,0.0,20.0
17640,1,7640,[294 174 117  25  70],406,2,27771,3.6344719277581468,0.0,20.0
17641,1,7641,[313 127 187 302 483],207,5,27776,3.6346506150222453,20.0,20.0
17642,1,7642,[ 25  15  96 678 289],537,0,27776,3.6341750621483713,0.0,0.0
17643,1,7643,[313 127 187 302 483],669,4,27780,3.634222919937206,20.0,20.0
17644,1,7644,[ 11 180 216 328 405],378,1,27781,3.6338783518639635,0.0,0.0
17645,1,7645,[210   1 191 568  70],454,4,27785,3.633926235940361,0.0,0.0
17646,1,7646,[742  89 546 515 258],650,2,27787,3.6337125670197463,0.0,0.0
17647,1,7647,[ 15 175 265 197 238],95,4,27791,3.633760460251046,0.0,0.0
17648,1,7648,[313 127 187 302 483],90,5,27796,3.63393907700353,20.0,20.0
17649,1,7649,[333 182 121 258   4],653,2,27798,3.6337254901960785,0.0,0.0
17650,1,7650,[ 12 234 204 258 483],213,5,27803,3.633904064828127,40.0,0.0
17651,1,7651,[ 98 153 228 161 182],650,3,27806,3.6338212232096185,0.0,20.0
17652,1,7652,[313 127 187 302 483],90,5,27811,3.633999738664576,20.0,20.0
17653,1,7653,[197  96 153   1 195],95,5,27816,3.6341782074732167,0.0,0.0
17654,1,7654,[181 202  71 423 191],59,4,27820,3.6342259960809926,0.0,0.0
17655,1,7655,[  4 289 181 603 301],524,3,27823,3.63414315569488,20.0,0.0
17656,1,7656,[328 216 475  95 228],13,2,27825,3.6339297374951025,0.0,0.0
17657,1,7657,[100 118 210 181 179],87,5,27830,3.634108122225124,0.0,20.0
17658,1,7658,[  1  89 196  22 655],387,3,27833,3.634025329677504,0.0,0.0
17659,1,7659,[313 127 187 302 483],474,5,27838,3.6342036553524806,20.0,20.0
17660,1,7660,[234 204 235  88 515],339,3,27841,3.6341208719488316,0.0,0.0
17661,1,7661,[313 127 187 302 483],669,4,27845,3.6341686243800573,20.0,20.0
17662,1,7662,[515 288 282   7 742],92,3,27848,3.634085867153856,0.0,0.0
17663,1,7663,[ 98  69 197 655 234],210,5,27853,3.6342640918580376,0.0,20.0
17664,1,7664,[313 127 187 302 483],207,5,27858,3.6344422700587082,20.0,20.0
17665,1,7665,[313 127 187 302 483],207,5,27863,3.6346204017740673,20.0,20.0
17666,1,7666,[ 89 222 168 196 118],92,4,27867,3.6346680579105257,0.0,0.0
17667,1,7667,[ 96 135 175 483  71],59,4,27871,3.63471570161711,20.0,0.0
17668,1,7668,[132 655 176   7  11],339,5,27876,3.6348937279958276,0.0,0.0
17669,1,7669,[143 183  50 111 194],378,4,27880,3.6349413298565842,0.0,20.0
17670,1,7670,[313 127 187 302 483],328,5,27885,3.6351192804067267,20.0,20.0
17671,1,7671,[546 176   7   8 286],13,1,27886,3.6347758081334725,0.0,0.0
17672,1,7672,[204  12 168 286  97],409,5,27891,3.6349537338720186,20.0,0.0
17673,1,7673,[301 318 435  12 168],6,4,27895,3.6350013031013813,40.0,0.0
17674,1,7674,[ 50 168 132 258  97],650,3,27898,3.6349185667752444,0.0,20.0
17675,1,7675,[ 71 211 182 282 186],533,3,27901,3.6348358520062534,0.0,0.0
17676,1,7676,[313 127 187 302 483],13,5,27906,3.635013677217663,20.0,20.0
17677,1,7677,[216 143 211   9 313],533,5,27911,3.6351914561083616,0.0,0.0
17678,1,7678,[ 79 235  95 144 269],738,2,27913,3.634978512827191,0.0,0.0
17679,1,7679,[222 135  15 748  82],901,5,27918,3.63515625,0.0,0.0
17680,1,7680,[258 257 176   1 111],447,2,27920,3.634943366749121,0.0,0.0
17681,1,7681,[ 70 678 228 210 183],13,2,27922,3.6347305389221556,0.0,0.0
17682,1,7682,[100  22 588 603 174],234,3,27925,3.6346479239880254,20.0,40.0
17683,1,7683,[210 100 118  95 483],295,4,27929,3.6346954711087975,20.0,20.0
17684,1,7684,[135 288 202  69 197],387,1,27930,3.634352635003253,0.0,0.0
17685,1,7685,[265 423 100 182 143],13,4,27934,3.6344002081707,0.0,20.0
17686,1,7686,[403 161 196 211 588],234,0,27934,3.63392740991284,0.0,0.0
17687,1,7687,[180  96  70  15 196],207,2,27936,3.6337148803329864,0.0,0.0
17688,1,7688,[655 237  97 132 301],378,4,27940,3.6337625178826896,0.0,0.0
17689,1,7689,[ 28 197 210  12 258],378,4,27944,3.633810143042913,20.0,0.0
17690,1,7690,[172  95 546 294 597],897,3,27947,3.6337277337147316,0.0,0.0
17691,1,7691,[125  50 423 185 265],897,4,27951,3.6337753510140405,0.0,20.0
17692,1,7692,[286   9 294   1 238],379,4,27955,3.633822955933966,0.0,0.0
17693,1,7693,[ 98 294 405 111  15],533,4,27959,3.6338705484793343,0.0,20.0
17694,1,7694,[435 222 200 144 176],899,3,27962,3.633788174139051,0.0,0.0
17695,1,7695,[238  12 153 435 176],883,5,27967,3.6339656964656966,20.0,0.0
17696,1,7696,[ 70 172  56 257 181],144,5,27972,3.6341431726646745,0.0,0.0
17697,1,7697,[118  12   7 172 204],380,1,27973,3.633800987269421,20.0,0.0
17698,1,7698,[313 127 187 302 483],207,5,27978,3.6339784387582803,20.0,20.0
17699,1,7699,[313 127 187 302 483],474,5,27983,3.634155844155844,20.0,20.0
17700,1,7700,[215 197 435 313 187],90,4,27987,3.634203350214258,0.0,0.0
17701,1,7701,[603 144  97   7  71],738,4,27991,3.63425084393664,20.0,0.0
17702,1,7702,[202 173  79 288 132],279,2,27993,3.6340386862261456,0.0,0.0
17703,1,7703,[ 28 496 357 258  25],899,4,27997,3.634086188992731,20.0,0.0
17704,1,7704,[313 127 187 302 483],334,5,28002,3.634263465282284,20.0,20.0
17705,1,7705,[183 222 282  82  95],881,5,28007,3.6344406955618997,0.0,0.0
17706,1,7706,[  9 678 357 173 183],7,4,28011,3.6344881276761387,20.0,0.0
17707,1,7707,[313 127 187 302 483],207,5,28016,3.634665282823041,20.0,20.0
17708,1,7708,[  8 568 204 273 187],774,0,28016,3.6341937994551823,0.0,0.0
17709,1,7709,[313 127 187 302 483],207,5,28021,3.6343709468223087,20.0,20.0
17710,1,7710,[258 405 111 182 328],271,1,28022,3.6340293087796653,0.0,0.0
17711,1,7711,[313 127 187 302 483],13,5,28027,3.6342064315352696,20.0,20.0
17712,1,7712,[117   9 288 508 323],634,4,28031,3.6342538571243357,0.0,0.0
17713,1,7713,[313 127 187 302 483],537,5,28036,3.634430904848328,20.0,20.0
17714,1,7714,[182 275 183 210 168],95,3,28039,3.634348671419313,0.0,0.0
17715,1,7715,[313 127 187 302 483],537,5,28044,3.63452566096423,20.0,20.0
17716,1,7716,[174 423 173 161 181],843,1,28045,3.634184268498121,0.0,20.0
17717,1,7717,[313 127 187 302 483],13,5,28050,3.6343612334801763,20.0,20.0
17718,1,7718,[117 234 185  98 216],653,1,28051,3.634019950770825,0.0,20.0
17719,1,7719,[ 28 405 238  50 181],458,2,28053,3.6338082901554403,0.0,20.0
17720,1,7720,[191 183   7 121  95],308,4,28057,3.633855718171221,0.0,0.0
17721,1,7721,[245  70 143 268 435],90,4,28061,3.633903133903134,0.0,0.0
17722,1,7722,[ 71  89 546 135   7],234,1,28062,3.6335620872717858,0.0,0.0
17723,1,7723,[197 357 288 322  28],409,1,28063,3.633221128948731,20.0,0.0
17724,1,7724,[313 127 187 302 483],207,5,28068,3.633398058252427,20.0,20.0
17725,1,7725,[313 127 187 302 483],334,5,28073,3.6335749417551124,20.0,20.0
17726,1,7726,[144 265 588 403 211],64,4,28077,3.6336223631422286,0.0,0.0
17727,1,7727,[ 95 405 427 294 238],13,2,28079,3.633410973084886,0.0,0.0
17728,1,7728,[357  69 289  71 215],454,2,28081,3.6331996377280373,20.0,0.0
17729,1,7729,[313 127 187 302 483],207,5,28086,3.6333764553686936,20.0,20.0
17730,1,7730,[546 271 168 496 238],650,3,28089,3.6332945285215366,0.0,0.0
17731,1,7731,[117  82 302 222 234],102,0,28089,3.6328246249353335,0.0,0.0
17732,1,7732,[313 127 187 302 483],13,5,28094,3.6330014224751066,20.0,20.0
17733,1,7733,[ 79 200 318 194 222],537,1,28095,3.6326609775019394,20.0,0.0
17734,1,7734,[161 568 276 143 118],194,1,28096,3.6323206205559146,0.0,0.0
17735,1,7735,[313 127 187 302 483],328,5,28101,3.6324974146845914,20.0,20.0
17736,1,7736,[187 202 318 125   4],653,2,28103,3.6322864159234847,20.0,0.0
17737,1,7737,[215 288 237 187 228],64,5,28108,3.632463168777462,0.0,0.0
17738,1,7738,[313 127 187 302 483],13,5,28113,3.6326398759529654,20.0,20.0
17739,1,7739,[118  12  88 121  22],194,2,28115,3.6324289405684755,20.0,0.0
17740,1,7740,[313 127 187 302 483],537,5,28120,3.632605606510787,20.0,20.0
17741,1,7741,[ 64 405 300 186 423],666,1,28121,3.6322655644536295,0.0,0.0
17742,1,7742,[313 127 187 302 483],669,4,28125,3.632313056954669,20.0,20.0
17743,1,7743,[195 302 508 200  50],537,3,28128,3.6322314049586777,0.0,20.0
17744,1,7744,[515 603  71  11 204],543,4,28132,3.6322788896061975,20.0,0.0
17745,1,7745,[313 127 187 302 483],474,5,28137,3.6324554608830364,20.0,20.0
17746,1,7746,[313 127 187 302 483],669,4,28141,3.632502904350071,20.0,20.0
17747,1,7747,[313 161  89  15   7],650,3,28144,3.6324212700051626,0.0,0.0
17748,1,7748,[508 655 435  79  28],378,5,28149,3.632597754548974,0.0,0.0
17749,1,7749,[  4 176 435  88 132],749,5,28154,3.632774193548387,0.0,0.0
17750,1,7750,[ 69 508  64  11 597],13,2,28156,3.6325635401883627,0.0,0.0
17751,1,7751,[328 546 597 286 118],554,4,28160,3.632610939112487,0.0,0.0
17752,1,7752,[195   7  11 269   1],10,5,28165,3.632787308138785,0.0,0.0
17753,1,7753,[228 185 234 496 237],215,5,28170,3.6329636316739746,0.0,0.0
17754,1,7754,[313 127 187 302 483],669,4,28174,3.633010960670535,20.0,20.0
17755,1,7755,[ 71 289  97 228 318],533,3,28177,3.6329293450232076,20.0,0.0
17756,1,7756,[ 79 269 333  64 483],666,3,28180,3.6328477504189762,20.0,0.0
17757,1,7757,[313 127 187 302 483],474,5,28185,3.6330239752513536,20.0,20.0
17758,1,7758,[182 132 204  96 216],815,3,28188,3.6329423894831807,0.0,0.0
17759,1,7759,[289 186 187 405 742],533,2,28190,3.6327319587628866,0.0,0.0
17760,1,7760,[204 678 318 176 286],334,3,28193,3.6326504316454065,20.0,0.0
17761,1,7761,[181  50 121 546 597],455,3,28196,3.632568925534656,0.0,20.0
17762,1,7762,[603 405  64 197 282],666,3,28199,3.632487440422517,20.0,0.0
17763,1,7763,[313 127 187 302 483],669,4,28203,3.632534775888717,20.0,20.0
17764,1,7764,[135 180  28 603 282],271,4,28207,3.6325820991629105,20.0,0.0
17765,1,7765,[313 127 187 302 483],90,5,28212,3.632758176667525,20.0,20.0
17766,1,7766,[313 127 187 302 483],328,5,28217,3.632934208832239,20.0,20.0
17767,1,7767,[ 97 153  95 483 174],290,3,28220,3.632852729145211,20.0,20.0
17768,1,7768,[ 11  79 194 294 265],7,3,28223,3.6327712704337753,0.0,0.0
17769,1,7769,[313 127 187 302 483],328,5,28228,3.6329472329472328,20.0,20.0
17770,1,7770,[174 385  98 273 405],643,1,28229,3.6326084159052887,0.0,40.0
17771,1,7771,[ 98 143 132  82  70],882,4,28233,3.632655687081832,0.0,20.0
17772,1,7772,[180  64 313 603 183],13,5,28238,3.6328315965521676,20.0,0.0
17773,1,7773,[496 168 237 294 186],263,3,28241,3.6327501929508617,0.0,0.0
17774,1,7774,[ 98 300 121 215  50],843,0,28241,3.6322829581993568,0.0,40.0
17775,1,7775,[183   8 182 237 176],892,5,28246,3.6324588477366255,0.0,0.0
17776,1,7776,[  7 204 127 211 322],524,3,28249,3.6323775234666322,0.0,20.0
17777,1,7777,[  7 183 174 197 742],144,4,28253,3.632424787863204,0.0,20.0
17778,1,7778,[ 50 471 300 132 216],313,5,28258,3.632600591335647,0.0,20.0
17779,1,7779,[174 143 182  98  96],474,5,28263,3.632776349614396,0.0,40.0
17780,1,7780,[313 127 187 302 483],328,5,28268,3.6329520627168743,20.0,20.0
17781,1,7781,[117  64 286 515 300],328,5,28273,3.6331277306604988,0.0,0.0
17782,1,7782,[742  69 127 179 655],334,3,28276,3.633046383142747,0.0,20.0
17783,1,7783,[273 175   8 603 588],308,4,28280,3.633093525179856,20.0,0.0
17784,1,7784,[121 276 435  28 179],339,4,28284,3.633140655105973,0.0,0.0
17785,1,7785,[ 89 515 121  22   7],200,5,28289,3.633316208579502,0.0,0.0
17786,1,7786,[313 127 187 302 483],334,5,28294,3.633491716964171,20.0,20.0
17787,1,7787,[174 568  98  96  95],804,4,28298,3.6335387776065744,0.0,40.0
17788,1,7788,[ 22 515 435 117   9],881,3,28301,3.633457439979458,0.0,0.0
17789,1,7789,[313 127 187 302 483],207,5,28306,3.633632862644416,20.0,20.0
17790,1,7790,[187  22 286 427 273],7,4,28310,3.6336798870491593,0.0,0.0
17791,1,7791,[ 82 175 655  64 181],184,2,28312,3.63347022587269,0.0,0.0
17792,1,7792,[313 127 187 302 483],207,5,28317,3.6336455793660978,20.0,20.0
17793,1,7793,[200  96 238 135 423],653,3,28320,3.6335642802155506,0.0,0.0
17794,1,7794,[151 185 385  50 173],60,5,28325,3.6337395766517,0.0,20.0
17795,1,7795,[313 127 187 302 483],669,4,28329,3.633786557208825,20.0,20.0
17796,1,7796,[210  12 357  69 176],499,4,28333,3.6338335257150187,40.0,0.0
17797,1,7797,[313 127 187 302 483],334,5,28338,3.6340087201846627,20.0,20.0
17798,1,7798,[ 12 302 195 237 546],378,3,28341,3.633927426593153,20.0,0.0
17799,1,7799,[496 655 153 121 508],334,2,28343,3.6337179487179485,0.0,0.0
17800,1,7800,[678 210 655  11 168],804,5,28348,3.6338930906294067,0.0,0.0
17801,1,7801,[313 127 187 302 483],334,5,28353,3.6340681876441936,20.0,20.0
17802,1,7802,[127 185  88   1 100],313,4,28357,3.6341150839420737,0.0,40.0
17803,1,7803,[183  98  11 191 288],92,4,28361,3.634161968221425,0.0,20.0
17804,1,7804,[282 187 175 196 100],207,3,28364,3.6340807174887892,0.0,20.0
17805,1,7805,[313 127 187 302 483],328,5,28369,3.6342557007430183,20.0,20.0
17806,1,7806,[204 286 289 405 568],13,1,28370,3.6339182784680415,0.0,0.0
17807,1,7807,[ 79 301 302 180  96],328,4,28374,3.6339651639344264,0.0,0.0
17808,1,7808,[313 127 187 302 483],90,5,28379,3.6341400947624534,20.0,20.0
17809,1,7809,[328 181  25 132 200],313,3,28382,3.6340588988476314,0.0,0.0
17810,1,7810,[118 235 181 200  64],774,0,28382,3.633593649980796,0.0,0.0
17811,1,7811,[273 588 187 191 546],13,2,28384,3.633384536610343,0.0,0.0
17812,1,7812,[ 96 508 204 117 678],537,1,28385,3.6330474849609624,0.0,0.0
17813,1,7813,[118 185  11 187  50],308,4,28389,3.633094445866394,0.0,20.0
17814,1,7814,[603   7 475   9  69],648,1,28390,3.63275751759437,20.0,0.0
17815,1,7815,[313 127 187 302 483],328,5,28395,3.6329324462640735,20.0,20.0
17816,1,7816,[471 427 210 258 515],882,4,28399,3.6329794038633745,0.0,0.0
17817,1,7817,[276 143 182 185 191],184,4,28403,3.6330263494499873,0.0,0.0
17818,1,7818,[ 11  95 195  22 211],454,2,28405,3.632817495843458,0.0,0.0
17819,1,7819,[515 202 210 288 176],234,1,28406,3.6324808184143222,0.0,0.0
17820,1,7820,[ 69 269  64 187  82],7,3,28409,3.632399948855645,0.0,0.0
17821,1,7821,[496 135 151  69 603],897,4,28413,3.6324469445154692,20.0,0.0
17822,1,7822,[655   4  95 597  79],92,3,28416,3.6323660999616516,0.0,0.0
17823,1,7823,[313 127 187 302 483],13,5,28421,3.632540899795501,20.0,20.0
17824,1,7824,[ 96 121 385 568 423],313,5,28426,3.6327156549520767,0.0,0.0
17825,1,7825,[210 748 204 196   4],653,3,28429,3.6326348070534116,0.0,0.0
17826,1,7826,[423  97  12 302 234],474,5,28434,3.632809505557685,20.0,0.0
17827,1,7827,[282  89 269 196  56],334,4,28438,3.632856412876852,0.0,0.0
17828,1,7828,[313 127 187 302 483],207,5,28443,3.6330310384468003,20.0,20.0
17829,1,7829,[313 127 187 302 483],669,4,28447,3.6330779054916986,20.0,20.0
17830,1,7830,[127 678 181 435 275],474,3,28450,3.6329970629549226,0.0,20.0
17831,1,7831,[228 174 195 483 144],313,4,28454,3.6330439223697653,20.0,20.0
17832,1,7832,[313 127 187 302 483],537,5,28459,3.633218434827014,20.0,20.0
17833,1,7833,[276 121  97  98  70],455,4,28463,3.6332652540209343,0.0,20.0
17834,1,7834,[ 89 515 238  64 202],234,2,28465,3.6330567964262923,0.0,0.0
17835,1,7835,[194 655  71 403 515],899,3,28468,3.6329760081674323,0.0,0.0
17836,1,7836,[435 197 318 238 289],318,3,28471,3.6328952405257113,20.0,0.0
17837,1,7837,[313 127 187 302 483],328,5,28476,3.633069660627711,20.0,20.0
17838,1,7838,[ 25 216 289   1 121],194,1,28477,3.6327337670621254,0.0,0.0
17839,1,7839,[313 127 187 302 483],90,5,28482,3.632908163265306,20.0,20.0
17840,1,7840,[258 288 111 333 294],569,1,28483,3.6325723759724524,0.0,0.0
17841,1,7841,[313 127 187 302 483],207,5,28488,3.6327467482785005,20.0,20.0
17842,1,7842,[655 172  50 118  22],378,5,28493,3.632921076118832,0.0,20.0
17843,1,7843,[265   4 168 144  98],77,2,28495,3.632712901580826,0.0,20.0
17844,1,7844,[ 56 435  11 168 174],102,1,28496,3.6323773103887826,0.0,20.0
17845,1,7845,[496 117 483 333 121],313,5,28501,3.6325516186591895,20.0,0.0
17846,1,7846,[313 127 187 302 483],328,5,28506,3.6327258825028674,20.0,20.0
17847,1,7847,[ 56 200  82 180 100],311,4,28510,3.6327726809378187,0.0,20.0
17848,1,7848,[313 127 187 302 483],537,5,28515,3.632946872213021,20.0,20.0
17849,1,7849,[313 127 187 302 483],334,5,28520,3.6331210191082803,20.0,20.0
17850,1,7850,[172 265 405 135 216],60,5,28525,3.6332951216405553,0.0,0.0
17851,1,7851,[ 11 318 204 194  71],328,2,28527,3.633087111563933,20.0,0.0
17852,1,7852,[313 127 187 302 483],334,5,28532,3.6332611740736023,20.0,20.0
17853,1,7853,[ 25 265  97  96 597],59,4,28536,3.633307868601986,0.0,0.0
17854,1,7854,[294 403 179  97 215],653,1,28537,3.6329726288987905,0.0,0.0
17855,1,7855,[ 88 588  15  98 187],194,4,28541,3.633019348268839,0.0,20.0
17856,1,7856,[313 127 187 302 483],90,5,28546,3.6331933307878326,20.0,20.0
17857,1,7857,[318 187 597 234 182],144,4,28550,3.6332400101807076,20.0,0.0
17858,1,7858,[ 96 153 237  79 180],653,3,28553,3.6331594350426264,0.0,0.0
17859,1,7859,[313 127 187 302 483],328,5,28558,3.6333333333333333,20.0,20.0
17860,1,7860,[471 117  88 603 385],454,2,28560,3.633125556544969,20.0,0.0
17861,1,7861,[ 28 151 271 257  79],379,4,28564,3.6331722208089543,0.0,0.0
17862,1,7862,[200 357   1 173  22],749,5,28569,3.6333460511255247,20.0,0.0
17863,1,7863,[151 197  71 161 238],387,1,28570,3.6330111902339777,0.0,0.0
17864,1,7864,[294 194 234 357 168],311,5,28575,3.6331849968213605,20.0,0.0
17865,1,7865,[176 222  71 186 175],738,4,28579,3.6332316297991354,0.0,0.0
17866,1,7866,[ 98 191 269 496 197],378,3,28582,3.6331511376636585,0.0,20.0
17867,1,7867,[228 210 234 211 322],313,3,28585,3.6330706659888157,0.0,0.0
17868,1,7868,[313 127 187 302 483],537,5,28590,3.6332443766679376,20.0,20.0
17869,1,7869,[ 25  69 435  64 100],318,5,28595,3.633418043202033,0.0,20.0
17870,1,7870,[143 153 235  69 282],92,3,28598,3.6333375682886544,0.0,0.0
17871,1,7871,[172 496   4  89 655],664,4,28602,3.6333841463414633,0.0,0.0
17872,1,7872,[ 82 196 678   1 183],339,4,28606,3.6334307125619203,0.0,0.0
17873,1,7873,[ 11 125 568 228 435],788,0,28606,3.6329692659385318,0.0,0.0
17874,1,7874,[313 127 187 302 483],328,5,28611,3.633142857142857,20.0,20.0
17875,1,7875,[ 64 269  22 143 276],605,4,28615,3.633189436262062,0.0,0.0
17876,1,7876,[237 748  25  22 318],474,4,28619,3.6332360035546527,20.0,0.0
17877,1,7877,[427   9   8 238 153],6,5,28624,3.6334094947956332,0.0,0.0
17878,1,7878,[568 385  97 204  71],455,3,28627,3.633329102678005,0.0,0.0
17879,1,7879,[238 289 234 265 496],474,4,28631,3.6333756345177664,0.0,0.0
17880,1,7880,[300  11 195 496  56],378,2,28633,3.6331683796472527,0.0,0.0
17881,1,7881,[ 88 603  50 196 186],379,5,28638,3.6333417914234967,20.0,20.0
17882,1,7882,[ 97 186 496  70  56],234,1,28639,3.6330077381707473,0.0,0.0
17883,1,7883,[  4  98  64 175 179],881,3,28642,3.6329274479959413,0.0,20.0
17884,1,7884,[323 186 151 204 176],59,5,28647,3.6331008243500316,0.0,0.0
17885,1,7885,[215 294 111 151 135],537,1,28648,3.632766928734466,0.0,0.0
17886,1,7886,[313 127 187 302 483],537,5,28653,3.6329402814758462,20.0,20.0
17887,1,7887,[185 135 197 435  69],524,4,28657,3.6329868154158214,0.0,0.0
17888,1,7888,[289 483 357 151 742],788,3,28660,3.6329065787805805,40.0,0.0
17889,1,7889,[313 127 187 302 483],328,5,28665,3.6330798479087454,20.0,20.0
17890,1,7890,[ 98 475  82 238 180],207,1,28666,3.6327461665188188,0.0,20.0
17891,1,7891,[403 176 655 235 222],804,4,28670,3.632792701469843,0.0,0.0
17892,1,7892,[ 69 328 265 496  79],653,4,28674,3.6328392246294183,0.0,0.0
17893,1,7893,[357 403  96 237  56],328,4,28678,3.632885736002027,20.0,0.0
17894,1,7894,[121  15 216  98 194],882,4,28682,3.632932235592147,0.0,20.0
17895,1,7895,[655 546 185 211 483],194,4,28686,3.632978723404255,20.0,0.0
17896,1,7896,[496 405 655 546  89],804,4,28690,3.633025199442826,0.0,0.0
17897,1,7897,[204 483   1 180 238],13,3,28693,3.6329450493795896,20.0,0.0
17898,1,7898,[ 98 172  95   8 257],899,5,28698,3.6331181162172426,0.0,20.0
17899,1,7899,[176  98 423 182 403],385,2,28700,3.632911392405063,0.0,20.0
17900,1,7900,[211 228 234 427 215],890,4,28704,3.632957853436274,0.0,0.0
17901,1,7901,[313 127 187 302 483],328,5,28709,3.6331308529486206,20.0,20.0
17902,1,7902,[357  25 471 508 121],537,2,28711,3.6329242059977225,20.0,0.0
17903,1,7903,[ 56 328  97  50 215],378,4,28715,3.6329706477732793,0.0,20.0
17904,1,7904,[313 127 187 302 483],328,5,28720,3.6331435800126504,20.0,20.0
17905,1,7905,[135 187 176  96  97],788,2,28722,3.6329370098659246,0.0,0.0
17906,1,7906,[ 50 322 117 186 100],329,2,28724,3.6327304919691414,0.0,40.0
17907,1,7907,[333 288 183 238 100],488,2,28726,3.6325240263024785,0.0,20.0
17908,1,7908,[403 258 210 678 111],334,2,28728,3.6323176128461245,0.0,0.0
17909,1,7909,[ 12 318 475 211  28],6,4,28732,3.6323640960809103,40.0,0.0
17910,1,7910,[125 515   9 313 385],234,2,28734,3.6321577550246493,0.0,0.0
17911,1,7911,[135 403 194 588 183],64,5,28739,3.632330637007078,0.0,0.0
17912,1,7912,[185 483 216 195 187],452,3,28742,3.632250726652344,20.0,0.0
17913,1,7913,[132   7 180 273 323],13,2,28744,3.632044478140005,0.0,0.0
17914,1,7914,[ 11  97 655 168 172],387,2,28746,3.631838281743525,0.0,0.0
17915,1,7915,[161 210  56  98  96],387,4,28750,3.6318847902981304,0.0,20.0
17916,1,7916,[235  56 385 313 238],13,2,28752,3.6316786661614247,0.0,0.0
17917,1,7917,[313 127 187 302 483],90,5,28757,3.63185147764587,20.0,20.0
17918,1,7918,[121 427 197 357 151],7,5,28762,3.632024245485541,20.0,0.0
17919,1,7919,[313 127 187 302 483],537,5,28767,3.63219696969697,20.0,20.0
17920,1,7920,[423 195 265 204 127],263,5,28772,3.63236965029668,0.0,20.0
17921,1,7921,[ 28 118 183  69   7],380,3,28775,3.6322898258015655,0.0,0.0
17922,1,7922,[125  79  22  69 111],207,3,28778,3.632210021456519,0.0,0.0
17923,1,7923,[405  56 176  11 111],447,3,28781,3.632130237253912,0.0,0.0
17924,1,7924,[328 748  64   9 222],13,2,28783,3.63192429022082,0.0,0.0
17925,1,7925,[ 64  22 144  71  89],308,4,28787,3.6319707292455212,0.0,0.0
17926,1,7926,[195 100  97 132 496],653,2,28789,3.631764854295446,0.0,20.0
17927,1,7927,[ 96  50 135   8 194],328,2,28791,3.631559031281534,0.0,20.0
17928,1,7928,[  8 357 265 588 182],892,5,28796,3.6317316181107326,20.0,0.0
17929,1,7929,[ 98 182  12 183 357],474,5,28801,3.631904161412358,40.0,20.0
17930,1,7930,[194  70 273  11 132],64,4,28805,3.6319505736981466,0.0,0.0
17931,1,7931,[313 127 187 302 483],537,5,28810,3.6321230458900655,20.0,20.0
17932,1,7932,[742 546 286 265 423],207,2,28812,3.6319173074498927,0.0,0.0
17933,1,7933,[294 161 144 357 111],13,3,28815,3.6318376607007816,20.0,0.0
17934,1,7934,[  1 100 282  28 173],455,4,28819,3.6318840579710145,0.0,20.0
17935,1,7935,[117 211 200  28 258],738,2,28821,3.631678427419355,0.0,0.0
17936,1,7936,[313 127 187 302 483],207,5,28826,3.6318508252488346,20.0,20.0
17937,1,7937,[ 22 423 568 269 237],13,3,28829,3.631771227009322,0.0,0.0
17938,1,7938,[182 173 276  12 655],398,4,28833,3.631817609270689,20.0,0.0
17939,1,7939,[ 56 173 603   7 180],650,3,28836,3.6317380352644837,20.0,0.0
17940,1,7940,[313 127 187 302 483],474,5,28841,3.6319103387482685,20.0,20.0
17941,1,7941,[195 144 135  56 597],207,1,28842,3.6315789473684212,0.0,0.0
17942,1,7942,[313 127 187 302 483],13,5,28847,3.6317512274959083,20.0,20.0
17943,1,7943,[288 191 135 211   7],666,4,28851,3.631797583081571,0.0,0.0
17944,1,7944,[127   7 125  70  71],455,2,28853,3.6315921963499056,0.0,20.0
17945,1,7945,[151 200 172 301 180],650,2,28855,3.6313868613138687,0.0,0.0
17946,1,7946,[ 71 185 515  56 175],543,4,28859,3.63143324524978,0.0,0.0
17947,1,7947,[204  28  97 153 174],398,5,28864,3.6316054353296425,0.0,20.0
17948,1,7948,[168   7  15 323 172],59,5,28869,3.631777582085797,0.0,0.0
17949,1,7949,[ 12 215  79  98 357],774,1,28870,3.631446540880503,40.0,20.0
17950,1,7950,[194 323 143 318 427],90,4,28874,3.6314928939756004,20.0,0.0
17951,1,7951,[ 64 423 328 174 183],804,4,28878,3.631539235412475,0.0,20.0
17952,1,7952,[ 71 678   8 179  15],881,3,28881,3.6314598264805733,0.0,0.0
17953,1,7953,[313 127 187 302 483],13,5,28886,3.6316318833291428,20.0,20.0
17954,1,7954,[427 172  22  71 405],788,2,28888,3.6314267756128222,0.0,0.0
17955,1,7955,[ 96 235 200 118 282],92,2,28890,3.6312217194570136,0.0,0.0
17956,1,7956,[168 423 228 121 273],897,3,28893,3.631142390348121,0.0,0.0
17957,1,7957,[234 191 483 286 603],664,3,28896,3.631063081176175,40.0,0.0
17958,1,7958,[179  82 215 144 269],378,4,28900,3.631109435858776,0.0,0.0
17959,1,7959,[ 28 275 597  11 144],13,2,28902,3.6309045226130654,0.0,0.0
17960,1,7960,[313 127 187 302 483],328,5,28907,3.631076497927396,20.0,20.0
17961,1,7961,[197 143 318 132 135],6,4,28911,3.63112283345893,20.0,0.0
17962,1,7962,[ 22  28 268  25  12],7,3,28914,3.6310435765415043,20.0,0.0
17963,1,7963,[286 200 168  89 191],13,2,28916,3.6308387744851833,0.0,0.0
17964,1,7964,[655  56 127 427 328],537,3,28919,3.6307595731324547,0.0,20.0
17965,1,7965,[  8 143 173 235 187],479,3,28922,3.6306803916645745,0.0,0.0
17966,1,7966,[257 322   1 181 125],804,5,28927,3.630852265595582,0.0,0.0
17967,1,7967,[318 234 194 508 275],524,4,28931,3.63089859437751,20.0,0.0
17968,1,7968,[269  64 183 197 603],64,3,28934,3.6308194252729327,20.0,0.0
17969,1,7969,[313 127 187 302 483],334,5,28939,3.6309912170639898,20.0,20.0
17970,1,7970,[ 97 302 144 127 265],328,4,28943,3.6310375109772925,0.0,20.0
17971,1,7971,[216   7 318 121  11],188,5,28948,3.631209232313096,20.0,0.0
17972,1,7972,[121 238 228  69 143],85,2,28950,3.631004640662235,0.0,0.0
17973,1,7973,[427 121 173 144 180],194,3,28953,3.630925507900677,0.0,0.0
17974,1,7974,[313 127 187 302 483],13,5,28958,3.6310971786833854,20.0,20.0
17975,1,7975,[  4 435  56 276 181],385,1,28959,3.630767301905717,0.0,0.0
17976,1,7976,[ 82 258 515 603 195],7,3,28962,3.63068822865739,20.0,0.0
17977,1,7977,[202 181 180 197 257],899,3,28965,3.630609175231888,0.0,0.0
17978,1,7978,[144 318 197 268 471],13,3,28968,3.6305301416217572,20.0,0.0
17979,1,7979,[313 127 187 302 483],328,5,28973,3.630701754385965,20.0,20.0
17980,1,7980,[313 127 187 302 483],90,5,28978,3.630873324144844,20.0,20.0
17981,1,7981,[313 127 187 302 483],537,5,28983,3.6310448509145576,20.0,20.0
17982,1,7982,[  7 187  64  88 175],343,5,28988,3.6312163347112616,0.0,0.0
17983,1,7983,[323 228 172 515 328],804,5,28993,3.631387775551102,0.0,0.0
17984,1,7984,[269  11 194 597 471],207,2,28995,3.6311834690043834,0.0,0.0
17985,1,7985,[286 132  25 182 405],59,3,28998,3.631104432757325,0.0,0.0
17986,1,7986,[144 286 483 655 475],339,4,29002,3.6311506197571055,20.0,0.0
17987,1,7987,[403  56  71 204 273],328,2,29004,3.6309464196294443,0.0,0.0
17988,1,7988,[475  12 234 175 216],339,4,29008,3.6309926148454124,20.0,0.0
17989,1,7989,[ 70 186  28 172 216],374,4,29012,3.6310387984981225,0.0,0.0
17990,1,7990,[204 144 273 385 127],234,1,29013,3.630709548241772,0.0,20.0
17991,1,7991,[211  97 328  98 143],91,4,29017,3.630755755755756,0.0,20.0
17992,1,7992,[118  50 100 333 245],313,4,29021,3.630801951707744,0.0,40.0
17993,1,7993,[483  98 175 121  56],932,4,29025,3.6308481361020766,20.0,20.0
17994,1,7994,[182 168 153 197  22],13,5,29030,3.631019387116948,0.0,0.0
17995,1,7995,[588 742 258 245 210],454,2,29032,3.630815407703852,0.0,0.0
17996,1,7996,[318 197 161 405 175],774,0,29032,3.6303613855195698,20.0,0.0
17997,1,7997,[286 117 127 423  56],387,2,29034,3.630157539384846,0.0,20.0
17998,1,7998,[161 588 143  98 211],7,3,29037,3.6300787598449804,0.0,20.0
17999,1,7999,[313 127 187 302 483],669,4,29041,3.630125,20.0,20.0
18000,1,8000,[234 179 216 194 546],881,3,29044,3.6300462442194728,0.0,0.0
18001,1,8001,[313 127 187 302 483],328,5,29049,3.6302174456385905,20.0,20.0
18002,1,8002,[180 269 258 588 185],13,3,29052,3.6301386979882544,0.0,0.0
18003,1,8003,[313 127 187 302 483],334,5,29057,3.6303098450774614,20.0,20.0
18004,1,8004,[ 82 257 118 144 245],454,4,29061,3.630356027482823,0.0,0.0
18005,1,8005,[202 273 100   1 385],158,3,29064,3.6302772920309767,0.0,20.0
18006,1,8006,[313 127 187 302 483],334,5,29069,3.630448357687024,20.0,20.0
18007,1,8007,[132 427   9  22   7],328,4,29073,3.6304945054945055,0.0,0.0
18008,1,8008,[313 127 187 302 483],207,5,29078,3.630665501311025,20.0,20.0
18009,1,8009,[175 475 300 322 187],334,3,29081,3.6305867665418226,0.0,0.0
18010,1,8010,[ 56 196 153 258 175],234,0,29081,3.6301335663462737,0.0,0.0
18011,1,8011,[ 88 475 483 117 175],13,3,29084,3.6300549176235646,20.0,0.0
18012,1,8012,[216 276 678 127 176],334,2,29086,3.6298514913265945,0.0,20.0
18013,1,8013,[313 286 748  69 186],13,4,29090,3.629897679061642,0.0,0.0
18014,1,8014,[313 127 187 302 483],474,5,29095,3.630068621334997,20.0,20.0
18015,1,8015,[ 11 135  88 173 546],92,2,29097,3.629865269461078,0.0,0.0
18016,1,8016,[300 265 172  12 276],234,0,29097,3.6294124984408134,20.0,0.0
18017,1,8017,[ 82 175 127 117 234],653,3,29100,3.6293339985033675,0.0,20.0
18018,1,8018,[313 127 187 302 483],207,5,29105,3.629504925801222,20.0,20.0
18019,1,8019,[ 71 118 302 313 568],378,5,29110,3.6296758104738154,0.0,0.0
18020,1,8020,[286 423  50 471 211],648,4,29114,3.629721979803017,0.0,20.0
18021,1,8021,[181 435 423 186 405],643,3,29117,3.629643480428821,0.0,0.0
18022,1,8022,[202 144 276 597 174],92,3,29120,3.629565000623208,0.0,20.0
18023,1,8023,[ 95 132  69 191 265],13,4,29124,3.6296111665004984,0.0,0.0
18024,1,8024,[313 127 187 302 483],207,5,29129,3.6297819314641746,20.0,20.0
18025,1,8025,[235 333 215 234 237],13,3,29132,3.629703463742836,0.0,0.0
18026,1,8026,[313 127 187 302 483],207,5,29137,3.6298741746605208,20.0,20.0
18027,1,8027,[313 127 187 302 483],669,4,29141,3.629920279023418,20.0,20.0
18028,1,8028,[269  28 282  15 216],378,5,29146,3.630090920413501,0.0,0.0
18029,1,8029,[271  98 211 748 301],328,2,29148,3.6298879202988794,0.0,20.0
18030,1,8030,[313 127 187 302 483],207,5,29153,3.630058523222513,20.0,20.0
18031,1,8031,[313 127 187 302 483],90,5,29158,3.6302290836653386,20.0,20.0
18032,1,8032,[144 183 211 168 313],102,1,29159,3.6299016556703596,0.0,0.0
18033,1,8033,[194 181 294  64 496],387,1,29160,3.62957430918596,0.0,0.0
18034,1,8034,[  7 210 143  95   1],892,4,29164,3.6296204107031738,0.0,0.0
18035,1,8035,[313 127 187 302 483],13,5,29169,3.6297909407665507,20.0,20.0
18036,1,8036,[ 69 183 174 168 202],881,3,29172,3.629712579320642,0.0,20.0
18037,1,8037,[  9 194 508   7  28],6,2,29174,3.629509828315501,0.0,0.0
18038,1,8038,[ 50  28 168 174 294],298,4,29178,3.6295559149147905,0.0,40.0
18039,1,8039,[678  95 235 286 268],334,2,29180,3.629353233830846,0.0,0.0
18040,1,8040,[100 238 204 318 196],311,4,29184,3.6293993284417363,20.0,20.0
18041,1,8041,[182 269 282 100 515],334,3,29187,3.6293210644118377,0.0,20.0
18042,1,8042,[132 200 405 483 197],95,1,29188,3.6289941564093002,20.0,0.0
18043,1,8043,[186 597 423 385 237],7,4,29192,3.6290402784684237,0.0,0.0
18044,1,8044,[603 168 196 121 174],308,3,29195,3.628962088253574,20.0,20.0
18045,1,8045,[ 95 546 210 238 568],64,3,29198,3.6288839174745213,0.0,0.0
18046,1,8046,[ 96 357 215 144   9],60,5,29203,3.629054305952529,20.0,0.0
18047,1,8047,[ 56 194   1 127  79],387,4,29207,3.629100397614314,0.0,20.0
18048,1,8048,[111 182  12 276 194],398,3,29210,3.629022238787427,20.0,0.0
18049,1,8049,[179 286  22 168 294],234,1,29211,3.628695652173913,0.0,0.0
18050,1,8050,[172 275  95  12 222],901,4,29215,3.6287417712085457,20.0,0.0
18051,1,8051,[257  64 427 211 748],474,3,29218,3.6286636860407353,0.0,0.0
18052,1,8052,[313 127 187 302 483],669,4,29222,3.6287097975909597,20.0,20.0
18053,1,8053,[ 79 202  64 257 180],279,2,29224,3.628507573876335,0.0,0.0
18054,1,8054,[385 187 181 195 185],638,4,29228,3.6285536933581626,0.0,0.0
18055,1,8055,[175 235  79 275  22],378,5,29233,3.628723932472691,0.0,0.0
18056,1,8056,[237 748 180 265  89],313,3,29236,3.6286458979769143,0.0,0.0
18057,1,8057,[204 144 191 183   4],339,3,29239,3.6285678828493424,0.0,0.0
18058,1,8058,[ 64 187 111 423  70],474,5,29244,3.6287380568308722,0.0,0.0
18059,1,8059,[313 127 187 302 483],13,5,29249,3.628908188585608,20.0,20.0
18060,1,8060,[  4 173 191 132 195],474,5,29254,3.6290782781292643,0.0,0.0
18061,1,8061,[174  79 742 435 234],524,4,29258,3.6291242867774747,0.0,20.0
18062,1,8062,[313 127 187 302 483],537,5,29263,3.629294307329778,20.0,20.0
18063,1,8063,[ 64 403 117 423 271],328,3,29266,3.6292162698412698,0.0,0.0
18064,1,8064,[588 117 234  56 195],308,3,29269,3.6291382517048976,0.0,0.0
18065,1,8065,[423 174 144 228 185],643,5,29274,3.6293082072898586,0.0,20.0
18066,1,8066,[313 127 187 302 483],207,5,29279,3.6294781207388125,20.0,20.0
18067,1,8067,[153 211  98 318 172],194,3,29282,3.629400099157164,20.0,20.0
18068,1,8068,[ 97 318 174 405 100],194,3,29285,3.6293220969141156,20.0,40.0
18069,1,8069,[313 127 187 302 483],328,5,29290,3.6294919454770755,20.0,20.0
18070,1,8070,[132 742  98 100 235],650,3,29293,3.6294139511832486,0.0,40.0
18071,1,8071,[313 127 187 302 483],328,5,29298,3.629583746283449,20.0,20.0
18072,1,8072,[496  28 222 191 176],882,5,29303,3.6297534993187166,0.0,0.0
18073,1,8073,[186 174 153 175 172],650,5,29308,3.629923210304682,0.0,20.0
18074,1,8074,[588 132 161 176 186],378,4,29312,3.629969040247678,0.0,0.0
18075,1,8075,[  1 603 245 181 127],533,4,29316,3.6300148588410104,20.0,20.0
18076,1,8076,[222  22 357 257  28],479,5,29321,3.6301844744335767,20.0,0.0
18077,1,8077,[ 97  25  88 172 194],881,1,29322,3.6298588759593957,0.0,0.0
18078,1,8078,[ 11 471 483 204  64],666,4,29326,3.62990469117465,20.0,0.0
18079,1,8079,[237  50 655 301  82],328,4,29330,3.629950495049505,0.0,20.0
18080,1,8080,[182 111 328   8  95],13,4,29334,3.62999628758817,0.0,0.0
18081,1,8081,[427 265 276 144 127],194,4,29338,3.630042068794853,0.0,20.0
18082,1,8082,[ 98 153 238   9 181],488,3,29341,3.6299641222318444,0.0,20.0
18083,1,8083,[313   8 182 568 191],85,4,29345,3.630009896091044,0.0,0.0
18084,1,8084,[  7  71  28  79 403],374,3,29348,3.6299319727891155,0.0,0.0
18085,1,8085,[197 286 176 202  82],379,5,29353,3.6301014098441753,0.0,0.0
18086,1,8086,[ 15 276 100 257 258],569,5,29358,3.6302708049956722,0.0,20.0
18087,1,8087,[313 127 187 302 483],669,4,29362,3.6303165182987143,20.0,20.0
18088,1,8088,[210  89 216 202 143],374,2,29364,3.6301149709482012,0.0,0.0
18089,1,8089,[ 11   1 228  82  71],64,3,29367,3.630037082818294,0.0,0.0
18090,1,8090,[313 127 187 302 483],669,4,29371,3.6300828080583365,20.0,20.0
18091,1,8091,[323 191 313 183 655],378,4,29375,3.630128521997034,0.0,0.0
18092,1,8092,[ 71 181 294 655   1],234,0,29375,3.629679970344742,0.0,0.0
18093,1,8093,[183 597 603 471 276],13,3,29378,3.62960217445021,20.0,0.0
18094,1,8094,[313 127 187 302 483],669,4,29382,3.629647930821495,20.0,20.0
18095,1,8095,[ 64 181 515 195 234],213,5,29387,3.629817193675889,0.0,0.0
18096,1,8096,[117 153 111 333 143],653,2,29389,3.6296159071260963,0.0,0.0
18097,1,8097,[  8 471 111  98 168],271,3,29392,3.6295381575697703,0.0,20.0
18098,1,8098,[603 117 118 435  98],840,3,29395,3.6294604272132363,20.0,20.0
18099,1,8099,[ 96 322 194  22 216],749,5,29400,3.6296296296296298,0.0,0.0
18100,1,8100,[313 127 187 302 603],537,5,29405,3.629798790272806,20.0,20.0
18101,1,8101,[257 265 117 322 100],474,4,29409,3.629844482843742,0.0,20.0
18102,1,8102,[313 127 187 302 603],334,5,29414,3.6300135752190545,20.0,20.0
18103,1,8103,[176 117 222 118  28],479,3,29417,3.6299358341559724,0.0,0.0
18104,1,8104,[132 117 186  12 135],537,2,29419,3.6297347316471313,20.0,0.0
18105,1,8105,[313 127 187 302 603],669,5,29424,3.629903774981495,20.0,20.0
18106,1,8106,[318  96 211 183 174],7,5,29429,3.6300727766128036,20.0,20.0
18107,1,8107,[313 127 187 302 603],474,5,29434,3.6302417365564876,20.0,20.0
18108,1,8108,[265  95 742 515  22],95,3,29437,3.6301640152916512,0.0,0.0
18109,1,8109,[100  82 597 546 179],643,2,29439,3.6299630086313193,0.0,20.0
18110,1,8110,[ 82 216 194 143 268],643,4,29443,3.630008630255209,0.0,0.0
18111,1,8111,[427 168  15 275 191],308,4,29447,3.6300542406311638,0.0,0.0
18112,1,8112,[176 603 300 132 100],840,3,29450,3.629976580796253,20.0,20.0
18113,1,8113,[191 313 181 197 234],215,5,29455,3.6301454276559033,0.0,0.0
18114,1,8114,[181 271   4  28 151],334,2,29457,3.629944547134935,0.0,0.0
18115,1,8115,[508  71 132  56 175],59,4,29461,3.6299901429275505,0.0,0.0
18116,1,8116,[294 143 175 172  79],881,3,29464,3.629912529259579,0.0,0.0
18117,1,8117,[196  82 121 235 435],295,5,29469,3.630081300813008,0.0,0.0
18118,1,8118,[323  69 333 211 181],506,4,29473,3.630126862914152,0.0,0.0
18119,1,8119,[237 204 180 385  79],543,4,29477,3.6301724137931033,0.0,0.0
18120,1,8120,[204   8 174 121 127],452,4,29481,3.630217953454008,0.0,40.0
18121,1,8121,[269 515 176 210 405],7,1,29482,3.6298941147500616,0.0,0.0
18122,1,8122,[238 471 168 323 210],537,2,29484,3.6296934630062783,0.0,0.0
18123,1,8123,[328 265   7 182  12],234,0,29484,3.6292466765140325,20.0,0.0
18124,1,8124,[215 135  56 168 403],313,2,29486,3.629046153846154,0.0,0.0
18125,1,8125,[313 127 187 302 603],271,5,29491,3.629214865862663,20.0,20.0
18126,1,8126,[ 95 183 118 222 546],479,3,29494,3.6291374430909316,0.0,0.0
18127,1,8127,[ 97 385 153 357 180],95,4,29498,3.6291830708661417,20.0,0.0
18128,1,8128,[318 168 183 597 117],346,4,29502,3.6292286874154263,20.0,0.0
18129,1,8129,[ 96 100 118 121 127],308,3,29505,3.629151291512915,0.0,40.0
18130,1,8130,[268 265  15   7 211],537,3,29508,3.6290739146476447,0.0,0.0
18131,1,8131,[173 174 678 357 271],537,2,29510,3.6288735858337433,20.0,20.0
18132,1,8132,[196 202 427 191   7],452,4,29514,3.6289192180007377,0.0,0.0
18133,1,8133,[313 127 187 302 603],669,5,29519,3.6290877796901895,20.0,20.0
18134,1,8134,[496  56 269 403 603],883,3,29522,3.6290104486785495,20.0,0.0
18135,1,8135,[483 117  64 204 180],339,3,29525,3.6289331366764994,20.0,0.0
18136,1,8136,[191 100 228 215 515],234,3,29528,3.628855843677031,0.0,20.0
18137,1,8137,[ 25  70 742 195  97],308,4,29532,3.628901449987712,0.0,0.0
18138,1,8138,[257 179  64  69 153],738,3,29535,3.6288241798746776,0.0,0.0
18139,1,8139,[118 237  88 183 357],694,5,29540,3.628992628992629,20.0,0.0
18140,1,8140,[313 127 187 302 603],334,5,29545,3.6291610367276745,20.0,20.0
18141,1,8141,[183 568 187 655 143],538,2,29547,3.628960943257185,0.0,0.0
18142,1,8142,[313 127 187 302 603],13,5,29552,3.6291293135208154,20.0,20.0
18143,1,8143,[211  96 132 153  12],454,1,29553,3.6288064833005893,20.0,0.0
18144,1,8144,[117 135 427 176 185],406,5,29558,3.628974831184776,0.0,0.0
18145,1,8145,[ 82  28 196 286 183],881,3,29561,3.6288976184630495,0.0,0.0
18146,1,8146,[294   1 546 234 195],234,1,29562,3.6285749355591017,0.0,0.0
18147,1,8147,[423 200  25 202 289],537,0,29562,3.6281296023564065,0.0,0.0
18148,1,8148,[313 127 187 302 603],116,3,29565,3.6280525217818136,20.0,20.0
18149,1,8149,[294 215  25  88 186],378,3,29568,3.6279754601226992,0.0,0.0
18150,1,8150,[186 286 210  12  15],60,5,29573,3.628143786038523,20.0,0.0
18151,1,8151,[200 117 302  82 568],13,1,29574,3.6278213935230617,0.0,0.0
18152,1,8152,[258 234 191 269 127],343,4,29578,3.627867042806329,0.0,20.0
18153,1,8153,[179 322   4 151 204],524,3,29581,3.6277900416973266,0.0,0.0
18154,1,8154,[195 546 294   4 194],804,4,29585,3.6278356836296752,0.0,0.0
18155,1,8155,[313 127 187 302 603],474,5,29590,3.628003923491908,20.0,20.0
18156,1,8156,[174  69 496 202 111],82,5,29595,3.6281721221037144,0.0,20.0
18157,1,8157,[313 127 187 302 603],334,5,29600,3.628340279480265,20.0,20.0
18158,1,8158,[127  12 215 117   9],311,5,29605,3.6285083956367203,20.0,20.0
18159,1,8159,[132 301 475 210 176],334,1,29606,3.628186274509804,0.0,0.0
18160,1,8160,[268  12 204 508  89],537,3,29609,3.628109300330842,20.0,0.0
18161,1,8161,[483 568  15 191 117],95,4,29613,3.6281548640039207,20.0,0.0
18162,1,8162,[313 127 187 302 603],334,5,29618,3.628322920494916,20.0,20.0
18163,1,8163,[  4  79 323 742 216],804,5,29623,3.6284909358157766,0.0,0.0
18164,1,8164,[313 127 187 302 603],90,5,29628,3.628658909981629,20.0,20.0
18165,1,8165,[269  28  96  95 153],64,4,29632,3.6287043840313493,0.0,0.0
18166,1,8166,[ 98 216 132 313 423],184,5,29637,3.628872290926901,0.0,20.0
18167,1,8167,[313 127 187 302 603],271,5,29642,3.6290401567091086,20.0,20.0
18168,1,8168,[ 56 313  22 194  97],308,3,29645,3.6289631533847473,0.0,0.0
18169,1,8169,[196 258 195 183 202],538,4,29649,3.6290085679314568,0.0,0.0
18170,1,8170,[144  28  56 202 173],279,4,29653,3.6290539713621346,0.0,0.0
18171,1,8171,[215 117 385 121 597],643,1,29654,3.6287322564855606,0.0,0.0
18172,1,8172,[313 127 187 302 603],474,5,29659,3.6289000367062276,20.0,20.0
18173,1,8173,[268 185  50 328 117],145,5,29664,3.629067775874725,0.0,20.0
18174,1,8174,[ 69 186 483 144  56],343,5,29669,3.629235474006116,20.0,0.0
18175,1,8175,[313 127 187 302 603],271,5,29674,3.6294031311154598,20.0,20.0
18176,1,8176,[313 127 187 302 603],537,5,29679,3.629570747217806,20.0,20.0
18177,1,8177,[191 286  15  96  64],59,4,29683,3.629616043042309,0.0,0.0
18178,1,8178,[357 204 275 132 496],85,4,29687,3.6296613277906835,20.0,0.0
18179,1,8179,[143  15  96 568  95],881,3,29690,3.62958435207824,0.0,0.0
18180,1,8180,[313 127 187 302 603],13,5,29695,3.6297518640752964,20.0,20.0
18181,1,8181,[100 182 181  64 180],474,5,29700,3.6299193351258863,0.0,20.0
18182,1,8182,[ 96 496  97 238  12],234,1,29701,3.6295979469632162,20.0,0.0
18183,1,8183,[313 127 187 302 603],537,5,29706,3.6297653958944283,20.0,20.0
18184,1,8184,[405 100 172  70 125],378,3,29709,3.6296884544899206,0.0,20.0
18185,1,8185,[273 385 271 210 202],102,1,29710,3.6293672123137064,0.0,0.0
18186,1,8186,[313 127 187 302 603],669,5,29715,3.62953462806889,20.0,20.0
18187,1,8187,[313 127 187 302 603],537,5,29720,3.629702002931119,20.0,20.0
18188,1,8188,[ 89  98 132 194 268],234,3,29723,3.629625106850653,0.0,20.0
18189,1,8189,[216 300 127 172 173],409,3,29726,3.6295482295482295,0.0,20.0
18190,1,8190,[268 328  98 423  89],537,2,29728,3.6293492858014895,0.0,20.0
18191,1,8191,[  9 496  15  97 471],533,4,29732,3.62939453125,0.0,0.0
18192,1,8192,[435 181 135 174 222],313,4,29736,3.629439765653607,0.0,20.0
18193,1,8193,[313 127 187 302 603],537,5,29741,3.629607029533805,20.0,20.0
18194,1,8194,[210 143 323  15 471],648,4,29745,3.6296522269676634,0.0,0.0
18195,1,8195,[508 121  98 210 302],378,5,29750,3.629819424109322,0.0,20.0
18196,1,8196,[483 211 286 191 471],90,5,29755,3.6299865804562645,20.0,0.0
18197,1,8197,[125   1 237  69 143],92,4,29759,3.6300317150524517,0.0,0.0
18198,1,8198,[313 127 187 302 603],116,3,29762,3.6299548725454325,20.0,20.0
18199,1,8199,[313 127 187 302 603],474,5,29767,3.630121951219512,20.0,20.0
18200,1,8200,[423 508 286 182  97],537,2,29769,3.6299231800999876,0.0,0.0
18201,1,8201,[ 15   8 357 568 323],881,3,29772,3.6298463789319677,20.0,0.0
18202,1,8202,[127 200  71 187   8],313,3,29775,3.6297695964890893,0.0,20.0
18203,1,8203,[182 288  28 100 313],64,5,29780,3.629936616284739,0.0,20.0
18204,1,8204,[471 238   8  70  89],13,2,29782,3.6297379646556975,0.0,0.0
18205,1,8205,[313 127 187 302 603],13,5,29787,3.6299049475993175,20.0,20.0
18206,1,8206,[313 127 187 302 603],474,5,29792,3.630071889850128,20.0,20.0
18207,1,8207,[176  25 180  64 546],7,3,29795,3.629995126705653,0.0,0.0
18208,1,8208,[313 127 187 302 603],474,5,29800,3.6301620172980873,20.0,20.0
18209,1,8209,[182 385 194  96  97],326,2,29802,3.6299634591961025,0.0,0.0
18210,1,8210,[238  70 182 508 100],13,2,29804,3.629764949458044,0.0,20.0
18211,1,8211,[200  89 194 403   1],95,2,29806,3.6295664880662444,0.0,0.0
18212,1,8212,[655 125  79 273  50],42,3,29809,3.629489833191282,0.0,20.0
18213,1,8213,[286 143 423 121  22],194,1,29810,3.629169710250791,0.0,0.0
18214,1,8214,[216   1 294 187   4],804,5,29815,3.629336579427876,0.0,0.0
18215,1,8215,[186 300  15 237   1],892,4,29819,3.629381694255112,0.0,0.0
18216,1,8216,[ 95  96 182 515 202],64,5,29824,3.6295484970183765,0.0,0.0
18217,1,8217,[313 127 187 302 603],13,5,29829,3.62971525918715,20.0,20.0
18218,1,8218,[271   9  69 234 202],92,3,29832,3.62963864217058,0.0,0.0
18219,1,8219,[194  88 181  25  97],897,3,29835,3.6295620437956204,0.0,0.0
18220,1,8220,[180 333  64 204 161],653,5,29840,3.629728743461866,0.0,0.0
18221,1,8221,[313 127 187 302 603],271,5,29845,3.6298954025784482,20.0,20.0
18222,1,8222,[204 234 405 197 195],379,3,29848,3.629818800924237,0.0,0.0
18223,1,8223,[258  95 211 132 176],64,4,29852,3.629863813229572,0.0,0.0
18224,1,8224,[143 423 181 195 496],59,4,29856,3.629908814589666,0.0,0.0
18225,1,8225,[144 423 238 185 271],650,1,29857,3.6295891077072695,0.0,0.0
18226,1,8226,[313 127 187 302 603],116,3,29860,3.6295125805275315,20.0,20.0
18227,1,8227,[313 127 187 302 603],116,3,29863,3.6294360719494407,20.0,20.0
18228,1,8228,[186 175  22 179 121],7,5,29868,3.6296026248632884,0.0,0.0
18229,1,8229,[174 185 204 195  22],638,5,29873,3.6297691373025516,0.0,20.0
18230,1,8230,[153 318  50 403 186],308,5,29878,3.6299356092819828,20.0,20.0
18231,1,8231,[313 127 187 302 483],334,5,29883,3.6301020408163267,20.0,20.0
18232,1,8232,[313 127 187 302 483],537,5,29888,3.6302684319203204,20.0,20.0
18233,1,8233,[197  50 180 483 172],524,4,29892,3.6303133349526355,20.0,20.0
18234,1,8234,[ 95 318 276 200 173],59,4,29896,3.6303582270795385,20.0,0.0
18235,1,8235,[181 496 175  97 483],234,2,29898,3.630160271976688,20.0,0.0
18236,1,8236,[161 144 471  98  71],7,4,29902,3.6302051717858443,0.0,20.0
18237,1,8237,[143 132 235  50 655],313,3,29905,3.630128672007769,0.0,20.0
18238,1,8238,[ 71 121  25   7 161],184,2,29907,3.629930816846705,0.0,0.0
18239,1,8239,[435 211 273   9 357],308,4,29911,3.62997572815534,20.0,0.0
18240,1,8240,[265   1 143 211 196],254,2,29913,3.6297779395704404,0.0,0.0
18241,1,8241,[  7 471  12   1  96],455,4,29917,3.629822858529483,20.0,0.0
18242,1,8242,[294 175 475 174  15],82,3,29920,3.6297464515346354,0.0,20.0
18243,1,8243,[181 111  69  88 202],92,2,29922,3.6295487627365355,0.0,0.0
18244,1,8244,[ 95 515 172 215  97],843,0,29922,3.6291085506367495,0.0,0.0
18245,1,8245,[ 97 238  95 180  12],13,4,29926,3.6291535289837498,20.0,0.0
18246,1,8246,[313 127 187 302 483],537,5,29931,3.629319752637323,20.0,20.0
18247,1,8247,[175 187  88 161 194],194,3,29934,3.629243452958293,0.0,0.0
18248,1,8248,[313 127 187 302 483],90,5,29939,3.6294096254091404,20.0,20.0
18249,1,8249,[  4 211 180 275 228],533,3,29942,3.6293333333333333,0.0,0.0
18250,1,8250,[100 172  95 180 204],194,2,29944,3.629135862319719,0.0,20.0
18251,1,8251,[257 143  28 300 179],379,4,29948,3.6291808046534175,0.0,0.0
18252,1,8252,[216  98 265 603 238],334,3,29951,3.629104568035866,20.0,20.0
18253,1,8253,[385 300 186 245 294],378,2,29953,3.6289071965107826,0.0,0.0
18254,1,8254,[ 98 427 183  56  95],664,4,29957,3.6289521502119926,0.0,20.0
18255,1,8255,[ 89  25 127 216 435],308,4,29961,3.628997093023256,0.0,20.0
18256,1,8256,[748 143 215 183 515],200,4,29965,3.6290420249485287,0.0,0.0
18257,1,8257,[ 22   1 508 210  79],59,4,29969,3.6290869459917654,0.0,0.0
18258,1,8258,[423 318 161 135 118],42,5,29974,3.6292529361908223,20.0,0.0
18259,1,8259,[475 546 238 186   4],64,3,29977,3.6291767554479417,0.0,0.0
18260,1,8260,[183 153 118 427 186],328,2,29979,3.6289795424282776,0.0,0.0
18261,1,8261,[403  15 678 435  12],308,3,29982,3.6289034132171385,20.0,0.0
18262,1,8262,[258 153  11 180 135],234,1,29983,3.6285852595909476,0.0,0.0
18263,1,8263,[357 222 211 196  95],479,5,29988,3.628751210067764,20.0,0.0
18264,1,8264,[183  98 196 176 318],664,4,29992,3.6287961282516634,20.0,20.0
18265,1,8265,[496 204 238 423  89],899,4,29996,3.6288410355673846,0.0,0.0
18266,1,8266,[313 127 187 302 483],334,5,30001,3.629006894883271,20.0,20.0
18267,1,8267,[ 98 153 268 568 228],92,4,30005,3.6290517658442187,0.0,20.0
18268,1,8268,[313 127 187 302 483],669,4,30009,3.6290966259523523,20.0,20.0
18269,1,8269,[238   9 186 161  71],648,1,30010,3.6287787182587667,0.0,0.0
18270,1,8270,[742 200  64  50 222],92,3,30013,3.6287026961673314,0.0,20.0
18271,1,8271,[322 265 210  22  56],488,4,30017,3.628747582205029,0.0,0.0
18272,1,8272,[245  22 197 742 322],313,1,30018,3.628429831983561,0.0,0.0
18273,1,8273,[215 748 132 275  79],64,4,30022,3.628474740149867,0.0,0.0
18274,1,8274,[135 483 172 235 127],385,3,30025,3.6283987915407856,20.0,20.0
18275,1,8275,[125 423 151 135  56],334,4,30029,3.6284436926051233,0.0,0.0
18276,1,8276,[385 655 202 118 153],749,3,30032,3.6283677660988283,0.0,0.0
18277,1,8277,[496 175  22 405  71],334,2,30034,3.6281710558105824,0.0,0.0
18278,1,8278,[313 127 187 302 483],13,5,30039,3.628336755646817,20.0,20.0
18279,1,8279,[ 98 187 357 435   1],271,4,30043,3.6283816425120774,20.0,20.0
18280,1,8280,[288 182 508 597  64],92,3,30046,3.628305760173892,0.0,0.0
18281,1,8281,[175   7 144 174 194],7,5,30051,3.6284713837237383,0.0,20.0
18282,1,8282,[ 71 118 276 187 318],184,4,30055,3.628516238077991,20.0,0.0
18283,1,8283,[228 161 204 211  15],311,4,30059,3.6285610816030904,0.0,0.0
18284,1,8284,[186 405 238 210 322],804,5,30064,3.6287266143633072,0.0,0.0
18285,1,8285,[496 121 483 423 168],749,4,30068,3.628771421675115,20.0,0.0
18286,1,8286,[403 294 200 172 423],308,4,30072,3.628816218173042,0.0,0.0
18287,1,8287,[273 603 127 175 173],213,5,30077,3.62898166023166,20.0,20.0
18288,1,8288,[ 22 204 143 172  88],311,4,30081,3.629026420557365,0.0,0.0
18289,1,8289,[313 127 187 302 483],13,5,30086,3.6291917973462002,20.0,20.0
18290,1,8290,[471 100 245 423   8],328,3,30089,3.6291159088167895,0.0,20.0
18291,1,8291,[313 127 187 302 483],537,5,30094,3.6292812349252292,20.0,20.0
18292,1,8292,[153 176 268 313 508],13,3,30097,3.6292053539129387,0.0,0.0
18293,1,8293,[183 234 288 216 204],474,4,30101,3.629250060284543,0.0,0.0
18294,1,8294,[357 294  70 181 215],488,4,30105,3.6292947558770345,20.0,0.0
18295,1,8295,[313 127 187 302 483],328,5,30110,3.6294599807135968,20.0,20.0
18296,1,8296,[182  82 173 403 132],95,1,30111,3.6291430637579847,0.0,0.0
18297,1,8297,[181 508 153 173 183],326,4,30115,3.6291877560858037,0.0,0.0
18298,1,8298,[ 12   8 143 215 186],311,3,30118,3.629111941197735,20.0,0.0
18299,1,8299,[ 88 121 204 161  28],95,4,30122,3.629156626506024,0.0,0.0
18300,1,8300,[273 210 179 202 546],92,3,30125,3.629080833634502,0.0,0.0
18301,1,8301,[  4  28 742 603 174],308,4,30129,3.6291255119248373,20.0,20.0
18302,1,8302,[234   1 257 200   7],378,4,30133,3.62917017945321,0.0,0.0
18303,1,8303,[194 202 143 588 435],59,2,30135,3.628973988439306,0.0,0.0
18304,1,8304,[313 127 187 302 483],474,5,30140,3.629139072847682,20.0,20.0
18305,1,8305,[313 127 187 302 483],474,5,30145,3.6293041175054177,20.0,20.0
18306,1,8306,[313 127 187 302 483],13,5,30150,3.629469122426869,20.0,20.0
18307,1,8307,[215 423 172 121 196],7,5,30155,3.629634087626384,0.0,0.0
18308,1,8308,[238  79 357 471 161],899,4,30159,3.6296786616921413,20.0,0.0
18309,1,8309,[496 210 603  79  98],537,2,30161,3.629482551143201,20.0,20.0
18310,1,8310,[132  64  98 202 322],234,3,30164,3.629406810251474,0.0,20.0
18311,1,8311,[132   4 235 405 471],271,2,30166,3.6292107795957653,0.0,0.0
18312,1,8312,[ 22 183 269   1  95],738,3,30169,3.6291350896186696,0.0,0.0
18313,1,8313,[187  79  64 357 742],749,4,30173,3.6291796968968004,20.0,0.0
18314,1,8314,[435  71 210  69 238],313,5,30178,3.6293445580276606,0.0,0.0
18315,1,8315,[515  95 127   9  97],271,5,30183,3.6295093795093796,0.0,20.0
18316,1,8316,[  8 135 204   4 143],385,1,30184,3.629193218708669,0.0,0.0
18317,1,8317,[265 168 515 197  96],387,4,30188,3.6292377975474874,0.0,0.0
18318,1,8318,[275 234  22 300  69],537,1,30189,3.6289217454020917,0.0,0.0
18319,1,8319,[121 197 183 173 483],334,4,30193,3.628966346153846,20.0,0.0
18320,1,8320,[234 204 435  64 301],666,3,30196,3.628890758322317,0.0,0.0
18321,1,8321,[ 98 181 403  89 118],374,2,30198,3.6286950252343186,0.0,20.0
18322,1,8322,[ 98  25  11 175 100],881,3,30201,3.628619488165325,0.0,40.0
18323,1,8323,[168   9 588 187 174],7,5,30206,3.6287842383469484,0.0,20.0
18324,1,8324,[161  15   4 597 132],378,3,30209,3.6287087087087087,0.0,0.0
18325,1,8325,[435 168 385 423 143],194,2,30211,3.628513091520538,0.0,0.0
18326,1,8326,[ 89 222 153 117 257],749,3,30214,3.628437612585565,0.0,0.0
18327,1,8327,[515 423 568 187 211],339,3,30217,3.628362151777137,0.0,0.0
18328,1,8328,[173 100 515 276  96],883,5,30222,3.628526833953656,0.0,20.0
18329,1,8329,[257 471 588 121 181],454,2,30224,3.6283313325330133,0.0,0.0
18330,1,8330,[302 588  56 423  69],378,4,30228,3.628375945264674,0.0,0.0
18331,1,8331,[ 97  25  56  12 286],339,5,30233,3.6285405664906385,20.0,0.0
18332,1,8332,[515  22  97 174 216],95,5,30238,3.628705148205928,0.0,20.0
18333,1,8333,[357  69 200 234  56],379,5,30243,3.628869690424766,20.0,0.0
18334,1,8334,[235  97 211 187 195],328,2,30245,3.628674265146971,0.0,0.0
18335,1,8335,[603  56 153 286   7],234,1,30246,3.628358925143954,20.0,0.0
18336,1,8336,[286 265  28 258 176],339,3,30249,3.6282835552356962,0.0,0.0
18337,1,8337,[313 127 187 302 483],474,5,30254,3.6284480690813146,20.0,20.0
18338,1,8338,[204 228 294  96   7],200,5,30259,3.62861254347044,0.0,0.0
18339,1,8339,[568 265 135 100  12],774,0,30259,3.6281774580335733,20.0,20.0
18340,1,8340,[202 127  96 194 403],234,2,30261,3.6279822563241817,0.0,20.0
18341,1,8341,[508  50 111 204 174],92,4,30265,3.6280268520738432,0.0,40.0
18342,1,8342,[313 127 187 302 483],328,5,30270,3.628191298094211,20.0,20.0
18343,1,8343,[210 151  96 144 121],934,3,30273,3.628116011505273,0.0,0.0
18344,1,8344,[144 483 118 161 195],13,4,30277,3.6281605751947272,20.0,0.0
18345,1,8345,[313 127 187 302 483],334,5,30282,3.6283249460819555,20.0,20.0
18346,1,8346,[313 127 187 302 483],328,5,30287,3.628489277584761,20.0,20.0
18347,1,8347,[144 222 183 194 568],102,1,30288,3.628174413033062,0.0,0.0
18348,1,8348,[313 127 187 302 483],90,5,30293,3.6283387232003834,20.0,20.0
18349,1,8349,[  7 144 174 176 161],374,4,30297,3.6283832335329342,0.0,20.0
18350,1,8350,[191 183 276 228 176],339,5,30302,3.628547479343791,0.0,0.0
18351,1,8351,[ 15 161  25   9 289],881,0,30302,3.6281130268199235,0.0,0.0
18352,1,8352,[211  69 275 357  70],406,3,30305,3.628037830719502,20.0,0.0
18353,1,8353,[405 357 588  88 655],815,4,30309,3.6280823557577206,20.0,0.0
18354,1,8354,[258 118 322  88 204],92,2,30311,3.6278874925194495,0.0,0.0
18355,1,8355,[313 127 187 302 483],328,5,30316,3.628051699377693,20.0,20.0
18356,1,8356,[ 69 186  88  79 276],881,2,30318,3.6278568864425034,0.0,0.0
18357,1,8357,[ 28 135 222 257 423],666,1,30319,3.6275424742761424,0.0,0.0
18358,1,8358,[ 97  89 172 176 215],308,3,30322,3.627467400406747,0.0,0.0
18359,1,8359,[313 127 187 302 483],207,5,30327,3.6276315789473683,20.0,20.0
18360,1,8360,[258 151 357 183 117],474,4,30331,3.6276761152972132,20.0,0.0
18361,1,8361,[313 127 187 302 483],474,5,30336,3.627840229610141,20.0,20.0
18362,1,8362,[118   4 423 427 588],295,4,30340,3.6278847303599187,0.0,0.0
18363,1,8363,[ 15 276 174  56 237],6,2,30342,3.6276901004304163,0.0,20.0
18364,1,8364,[313 127 187 302 483],474,5,30347,3.627854154213987,20.0,20.0
18365,1,8365,[ 11 515  22  69 471],474,4,30351,3.627898637341621,0.0,0.0
18366,1,8366,[313 127 187 302 483],537,5,30356,3.6280626269869725,20.0,20.0
18367,1,8367,[ 95   8  12 546 265],234,1,30357,3.6277485659655833,20.0,0.0
18368,1,8368,[313 127 187 302 483],669,4,30361,3.6277930457641294,20.0,20.0
18369,1,8369,[385  98  56 748 194],328,2,30363,3.6275985663082437,0.0,20.0
18370,1,8370,[313 127 187 302 483],207,5,30368,3.6277625134392544,20.0,20.0
18371,1,8371,[496  82 174 228 313],254,5,30373,3.6279264214046822,0.0,20.0
18372,1,8372,[172 322 176 194 423],311,5,30378,3.6280902902185597,0.0,0.0
18373,1,8373,[143   7  71  88 117],474,5,30383,3.6282541198949128,0.0,0.0
18374,1,8374,[515 301   7  98   9],145,4,30387,3.6282985074626866,0.0,20.0
18375,1,8375,[100 216  98 180  70],378,4,30391,3.6283428844317096,0.0,40.0
18376,1,8376,[265 111 202  96 132],537,0,30391,3.627909752894831,0.0,0.0
18377,1,8377,[301 153 172 265 176],328,3,30394,3.6278348054428267,0.0,0.0
18378,1,8378,[471 144 357 182 173],95,4,30398,3.6278792218641844,20.0,0.0
18379,1,8379,[275 313 265  79 301],145,4,30402,3.627923627684964,0.0,0.0
18380,1,8380,[228 185 328 282 748],328,2,30404,3.627729387901205,0.0,0.0
18381,1,8381,[187 180  22 515 186],311,4,30408,3.6277738010021476,0.0,0.0
18382,1,8382,[313 127 187 302 483],474,5,30413,3.627937492544435,20.0,20.0
18383,1,8383,[313 127 187 302 483],328,5,30418,3.6281011450381677,20.0,20.0
18384,1,8384,[  7  28 483 275 179],343,5,30423,3.6282647584973167,20.0,0.0
18385,1,8385,[180 286  89 228 475],339,5,30428,3.6284283329358455,0.0,0.0
18386,1,8386,[175 216 265 403  15],60,4,30432,3.6284726362227255,0.0,0.0
18387,1,8387,[183 173 300  50 328],102,2,30434,3.62827849308536,0.0,20.0
18388,1,8388,[475 568   4  11 100],308,5,30439,3.6284420073906305,0.0,20.0
18389,1,8389,[210 174 118 238 475],648,3,30442,3.628367103694875,0.0,20.0
18390,1,8390,[194 180 151 175 678],648,1,30443,3.628053867238708,0.0,0.0
18391,1,8391,[204  22  79 597 172],308,4,30447,3.6280981887511916,0.0,0.0
18392,1,8392,[405 483 300  28 174],533,4,30451,3.6281424997021325,20.0,20.0
18393,1,8393,[313 127 187 302 483],13,5,30456,3.6283059328091496,20.0,20.0
18394,1,8394,[568 125 496 515   7],59,4,30460,3.628350208457415,0.0,0.0
18395,1,8395,[313 127 187 302 483],13,5,30465,3.6285135778942355,20.0,20.0
18396,1,8396,[ 12   4 385 300  88],379,3,30468,3.628438728117185,20.0,0.0
18397,1,8397,[ 56  15  28  11 117],543,2,30470,3.6282448201952846,0.0,0.0
18398,1,8398,[238 294 181 135 202],406,2,30472,3.6280509584474343,0.0,0.0
18399,1,8399,[180  12 276 202 228],343,5,30477,3.628214285714286,20.0,0.0
18400,1,8400,[ 15 216 322 172 286],488,1,30478,3.6279014403047256,0.0,0.0
18401,1,8401,[168 202  64  71 289],881,3,30481,3.627826707926684,0.0,0.0
18402,1,8402,[ 28  71 496 180 172],488,2,30483,3.6276329882184934,0.0,0.0
18403,1,8403,[515 173 313 111 132],13,3,30486,3.6275583055687766,0.0,0.0
18404,1,8404,[313 127 187 302 483],334,5,30491,3.6277215942891137,20.0,20.0
18405,1,8405,[313 127 187 302 483],328,5,30496,3.627884844158934,20.0,20.0
18406,1,8406,[202 678 195 234 742],648,4,30500,3.6279291066968002,0.0,0.0
18407,1,8407,[ 11  69 282 174 204],406,4,30504,3.627973358705994,0.0,20.0
18408,1,8408,[ 88  71 191  56  70],378,5,30509,3.6281365203948153,0.0,0.0
18409,1,8409,[313 127 187 302 483],537,5,30514,3.6282996432818075,20.0,20.0
18410,1,8410,[215 187 385 200 161],749,2,30516,3.6281060515990964,0.0,0.0
18411,1,8411,[100  88 357 546 211],308,4,30520,3.628150261531146,20.0,20.0
18412,1,8412,[ 22 204 228  15 300],653,4,30524,3.628194460953287,0.0,0.0
18413,1,8413,[204 269 313  98 222],883,1,30525,3.627882101259805,0.0,20.0
18414,1,8414,[301 181 385 174 405],119,5,30530,3.6280451574569224,0.0,20.0
18415,1,8415,[238  56 289 655  97],387,2,30532,3.627851711026616,0.0,0.0
18416,1,8416,[ 22 405 588 191 423],536,3,30535,3.6277771177379114,0.0,0.0
18417,1,8417,[276  95  15 323 195],881,3,30538,3.627702542171537,0.0,0.0
18418,1,8418,[ 64 515 204 300 200],380,2,30540,3.6275092053688085,0.0,0.0
18419,1,8419,[175 194 318 196 216],41,2,30542,3.6273159144893112,20.0,0.0
18420,1,8420,[313 127 187 302 483],13,5,30547,3.627478921743261,20.0,20.0
18421,1,8421,[100 180 186 228 127],738,4,30551,3.627523153645215,0.0,40.0
18422,1,8422,[216 197 100 238 742],334,3,30554,3.6274486524991096,0.0,20.0
18423,1,8423,[313 127 187 302 483],328,5,30559,3.627611585944919,20.0,20.0
18424,1,8424,[288 132 111 143 323],474,3,30562,3.6275370919881307,0.0,0.0
18425,1,8425,[313 127 187 302 483],207,5,30567,3.627699976263945,20.0,20.0
18426,1,8426,[357 197  88 117 204],648,2,30569,3.62750682330604,20.0,0.0
18427,1,8427,[405 194 234  12 357],379,4,30573,3.627551020408163,40.0,0.0
18428,1,8428,[ 98 271  95 313 182],92,3,30576,3.6274765689880177,0.0,20.0
18429,1,8429,[ 64 210 100  15  88],454,4,30580,3.627520759193357,0.0,20.0
18430,1,8430,[176 191   9 300 181],940,3,30583,3.6274463290238406,0.0,0.0
18431,1,8431,[118  56 144  82 182],87,5,30588,3.6276091081593926,0.0,0.0
18432,1,8432,[313 127 187 302 483],669,4,30592,3.6276532669275467,20.0,20.0
18433,1,8433,[313 127 187 302 483],334,5,30597,3.627815982926251,20.0,20.0
18434,1,8434,[ 79 258 215 174 289],90,2,30599,3.6276229994072318,0.0,20.0
18435,1,8435,[313 127 187 302 483],334,5,30604,3.6277856804172592,20.0,20.0
18436,1,8436,[216 196 568  97  71],804,5,30609,3.627948322863577,0.0,0.0
18437,1,8437,[483 127 258  95 180],234,2,30611,3.6277553922730505,20.0,20.0
18438,1,8438,[313 127 187 302 483],537,5,30616,3.627917999763005,20.0,20.0
18439,1,8439,[276 100 174 222 515],881,5,30621,3.628080568720379,0.0,40.0
18440,1,8440,[185 300 568 275 471],537,2,30623,3.6278876910318685,0.0,0.0
18441,1,8441,[313 127 187 302 483],474,5,30628,3.6280502250651505,20.0,20.0
18442,1,8442,[294 175 195 211  96],95,3,30631,3.6279758379722846,0.0,0.0
18443,1,8443,[183 245 216 289 302],328,4,30635,3.6280198957839884,0.0,0.0
18444,1,8444,[180 483 258 328  11],234,1,30636,3.627708703374778,20.0,0.0
18445,1,8445,[127  25 194 143  15],881,2,30638,3.627515983897703,0.0,20.0
18446,1,8446,[678 655 175 135   7],13,3,30641,3.6274416952764295,0.0,0.0
18447,1,8447,[313 127 187 302 483],90,5,30646,3.6276041666666665,20.0,20.0
18448,1,8448,[183 234  89 258 173],311,5,30651,3.6277665995975856,0.0,0.0
18449,1,8449,[275 301  12 210 258],537,2,30653,3.6275739644970413,20.0,0.0
18450,1,8450,[313 127 187 302 483],13,5,30658,3.627736362560644,20.0,20.0
18451,1,8451,[328 216 323  12 546],328,2,30660,3.627543776620918,20.0,0.0
18452,1,8452,[508 179 185 515 235],537,4,30664,3.62758783863717,0.0,0.0
18453,1,8453,[ 50 268 273 276 151],569,3,30667,3.6275136030281523,0.0,20.0
18454,1,8454,[191  64 357 132  95],308,4,30671,3.62755765819042,20.0,0.0
18455,1,8455,[151 174  25 175 222],14,4,30675,3.6276017029328287,0.0,20.0
18456,1,8456,[ 98  89 186 568 215],774,1,30676,3.627291001537188,0.0,20.0
18457,1,8457,[174   1 144 588 180],144,5,30681,3.6274532986521635,0.0,20.0
18458,1,8458,[100 245 282 191  15],92,4,30685,3.627497340111124,0.0,20.0
18459,1,8459,[168 258   8 357 200],313,1,30686,3.6271867612293143,20.0,0.0
18460,1,8460,[313 127 187 302 483],90,5,30691,3.6273490131190167,20.0,20.0
18461,1,8461,[276 202   7 301 313],184,2,30693,3.6271567005436065,0.0,0.0
18462,1,8462,[ 82 276 546 111 385],533,3,30696,3.62708259482453,0.0,0.0
18463,1,8463,[313 127 187 302 483],90,5,30701,3.6272448015122873,20.0,20.0
18464,1,8464,[ 88 216 181 121 258],653,2,30703,3.6270525694034257,0.0,0.0
18465,1,8465,[313 127 187 302 483],90,5,30708,3.627214741318214,20.0,20.0
18466,1,8466,[ 98  70 742 357 195],543,4,30712,3.62725876933979,20.0,20.0
18467,1,8467,[471  15 313 300 135],533,4,30716,3.627302786962683,0.0,0.0
18468,1,8468,[323 211 357 288 118],648,4,30720,3.6273467941905775,20.0,0.0
18469,1,8469,[ 71  98 181  22  95],95,4,30724,3.6273907910271546,0.0,20.0
18470,1,8470,[176 161  82 195 174],234,0,30724,3.626962578208004,0.0,20.0
18471,1,8471,[172 132 153  96 238],279,3,30727,3.6268885741265344,0.0,0.0
18472,1,8472,[200 302 202 172 275],13,3,30730,3.6268145875132776,0.0,0.0
18473,1,8473,[313 127 187 302 483],13,5,30735,3.62697663441114,20.0,20.0
18474,1,8474,[197 235 173 294 435],144,4,30739,3.6270206489675516,0.0,0.0
18475,1,8475,[176 238 168 174  15],308,4,30743,3.6270646531382726,0.0,20.0
18476,1,8476,[313 127 187 302 483],474,5,30748,3.627226613188628,20.0,20.0
18477,1,8477,[245 435 202 471 235],378,2,30750,3.627034677990092,0.0,0.0
18478,1,8478,[257  22 300  88 435],840,2,30752,3.6268427880646303,0.0,0.0
18479,1,8479,[204 289 179 143 168],881,3,30755,3.6267688679245285,0.0,0.0
18480,1,8480,[515 508 273   7 100],294,4,30759,3.626812875840113,0.0,20.0
18481,1,8481,[313 127 187 302 483],474,5,30764,3.6269747701013912,20.0,20.0
18482,1,8482,[191 385 515 202  50],64,5,30769,3.627136626193564,0.0,20.0
18483,1,8483,[  4 427 515 118 235],308,2,30771,3.626944837340877,0.0,0.0
18484,1,8484,[313 127 187 302 483],334,5,30776,3.627106658809664,20.0,20.0
18485,1,8485,[286 435 405 265  97],13,3,30779,3.627032759839736,0.0,0.0
18486,1,8486,[ 22 151 323 237 588],537,0,30779,3.6266053964887477,0.0,0.0
18487,1,8487,[200 742  96 276 176],447,3,30782,3.6265315739868047,0.0,0.0
18488,1,8488,[313 127 187 302 483],669,4,30786,3.626575568382613,20.0,20.0
18489,1,8489,[405 191  22 194 174],648,5,30791,3.6267373380447587,0.0,20.0
18490,1,8490,[ 64 234 289 100 173],194,3,30794,3.6266635260864444,0.0,20.0
18491,1,8491,[117 153 121 216 132],346,3,30797,3.6265897315120115,0.0,0.0
18492,1,8492,[313 127 187 302 483],334,5,30802,3.6267514423643,20.0,20.0
18493,1,8493,[ 28 127 132 143 228],694,5,30807,3.626913115140099,0.0,20.0
18494,1,8494,[313 127 187 302 483],13,5,30812,3.627074749852855,20.0,20.0
18495,1,8495,[313 127 187 302 483],13,5,30817,3.6272363465160073,20.0,20.0
18496,1,8496,[435 143 546 153 196],343,4,30821,3.6272802165470166,0.0,0.0
18497,1,8497,[ 70 127 118 655  88],308,4,30825,3.627324076253236,0.0,20.0
18498,1,8498,[238 135 196 275 172],334,4,30829,3.6273679256383105,0.0,0.0
18499,1,8499,[176  98  56 288 289],378,4,30833,3.6274117647058826,0.0,20.0
18500,1,8500,[313 127 187 302 483],537,5,30838,3.627573226679214,20.0,20.0
18501,1,8501,[313 127 187 302 483],90,5,30843,3.6277346506704307,20.0,20.0
18502,1,8502,[ 69  96 748  12 210],64,3,30846,3.6276608255909677,20.0,0.0
18503,1,8503,[ 82 475 597 322 268],92,2,30848,3.6274694261523988,0.0,0.0
18504,1,8504,[273 275 143 174  95],378,5,30853,3.6276308054085833,0.0,20.0
18505,1,8505,[313 127 187 302 483],334,5,30858,3.6277921467199623,20.0,20.0
18506,1,8506,[313 127 187 302 483],90,5,30863,3.6279534500999175,20.0,20.0
18507,1,8507,[185 172 222 200 127],881,4,30867,3.6279971791255288,0.0,20.0
18508,1,8508,[196  12 168 323 471],537,1,30868,3.627688330003526,20.0,0.0
18509,1,8509,[173  56 234 168 508],92,4,30872,3.627732079905993,0.0,0.0
18510,1,8510,[313 127 187 302 483],669,4,30876,3.62777581952767,20.0,20.0
18511,1,8511,[195 603  15 288  71],533,4,30880,3.6278195488721803,20.0,0.0
18512,1,8512,[153 144 435 132 151],815,5,30885,3.6279807353459415,0.0,0.0
18513,1,8513,[313 127 187 302 483],328,5,30890,3.6281418839558373,20.0,20.0
18514,1,8514,[194 185 475 235  15],308,3,30893,3.6280681150910157,0.0,0.0
18515,1,8515,[313 127 187 302 483],474,5,30898,3.6282292155941755,20.0,20.0
18516,1,8516,[301  25 173 265 275],537,2,30900,3.628038041563931,0.0,0.0
18517,1,8517,[222  28 568   1 258],387,4,30904,3.628081709321437,0.0,0.0
18518,1,8518,[ 11 182  79  96  56],666,3,30907,3.62800798215753,0.0,0.0
18519,1,8519,[286 135 121 238  28],194,2,30909,3.6278169014084507,0.0,0.0
18520,1,8520,[185 180  11 257 546],749,3,30912,3.627743222626452,0.0,0.0
18521,1,8521,[313 127 187 302 483],207,5,30917,3.627904247829148,20.0,20.0
18522,1,8522,[ 28 174 210 748 257],533,4,30921,3.6279479056670185,0.0,20.0
18523,1,8523,[483  50 121 174  89],200,5,30926,3.628108869075551,20.0,40.0
18524,1,8524,[ 15 235 132 403 191],194,2,30928,3.62791788856305,0.0,0.0
18525,1,8525,[204   7 405  89 132],788,4,30932,3.627961529439362,0.0,0.0
18526,1,8526,[235 174  70 222 603],13,2,30934,3.627770611000352,20.0,20.0
18527,1,8527,[301 100 182   9 181],145,4,30938,3.62781425891182,0.0,20.0
18528,1,8528,[483 323   9 515 180],311,4,30942,3.627857896588111,20.0,0.0
18529,1,8529,[237 204 423 181 194],899,4,30946,3.627901524032825,0.0,0.0
18530,1,8530,[200  22 385 121 423],897,4,30950,3.6279451412495605,0.0,0.0
18531,1,8531,[282 423  11 182 328],334,3,30953,3.6278715424285046,0.0,0.0
18532,1,8532,[313 127 187 302 483],13,5,30958,3.628032345013477,20.0,20.0
18533,1,8533,[568  96 222   9 135],488,3,30961,3.6279587532224045,0.0,0.0
18534,1,8534,[ 22 678 127 265 172],13,4,30965,3.6280023432923256,0.0,20.0
18535,1,8535,[313 127 187 302 483],669,4,30969,3.628045923149016,20.0,20.0
18536,1,8536,[483 135 403 215 271],749,5,30974,3.6282066299636875,20.0,0.0
18537,1,8537,[ 71 405   1 100 196],13,3,30977,3.628133052237058,0.0,20.0
18538,1,8538,[313 127 187 302 483],13,5,30982,3.628293711207401,20.0,20.0
18539,1,8539,[235  71 210 179 183],92,4,30986,3.628337236533958,0.0,0.0
18540,1,8540,[313 127 187 302 483],474,5,30991,3.628497833977286,20.0,20.0
18541,1,8541,[ 96 357 742 182 222],387,4,30995,3.628541325216577,20.0,0.0
18542,1,8542,[405 257  70   8 210],479,5,31000,3.6287018611728903,0.0,0.0
18543,1,8543,[515 294 258 357 186],7,3,31003,3.628628277153558,20.0,0.0
18544,1,8544,[313 127 187 302 483],537,5,31008,3.6287887653598596,20.0,20.0
18545,1,8545,[271   8 196  96 222],92,4,31012,3.6288322021998596,0.0,0.0
18546,1,8546,[127   1  79  97 228],339,5,31017,3.628992628992629,0.0,20.0
18547,1,8547,[  7 678  82 100 318],455,3,31020,3.6289190453907345,20.0,20.0
18548,1,8548,[204  71 186 276 423],334,3,31023,3.628845479003392,0.0,0.0
18549,1,8549,[313 127 187 302 483],90,5,31028,3.6290058479532163,20.0,20.0
18550,1,8550,[435 333 302 172 127],13,4,31032,3.6290492340077183,0.0,20.0
18551,1,8551,[174 194  22  82 496],387,3,31035,3.628975678203929,0.0,20.0
18552,1,8552,[ 12 186 546 111 258],207,2,31037,3.6287852215596867,20.0,0.0
18553,1,8553,[ 25 237  89 597 182],378,4,31041,3.62882861819032,0.0,0.0
18554,1,8554,[ 88  11 235 228 268],145,5,31046,3.628988895382817,0.0,0.0
18555,1,8555,[313 127 187 302 483],669,4,31050,3.629032258064516,20.0,20.0
18556,1,8556,[195 111   8 257  64],533,4,31054,3.6290756106111957,0.0,0.0
18557,1,8557,[ 28 118 186 288 183],13,4,31058,3.629118953026408,0.0,0.0
18558,1,8558,[546 181 302  28 496],378,3,31061,3.6290454492347237,0.0,0.0
18559,1,8559,[ 25 483 197 153 276],13,4,31065,3.629088785046729,20.0,0.0
18560,1,8560,[515 100 275  22 191],271,5,31070,3.629248919518748,0.0,20.0
18561,1,8561,[ 25  69 475 187 194],213,4,31074,3.629292221443588,0.0,0.0
18562,1,8562,[269 435  28  71 258],6,3,31077,3.6292187317528906,0.0,0.0
18563,1,8563,[125 185 173 275 742],271,2,31079,3.629028491359178,0.0,0.0
18564,1,8564,[678 508 483 288  82],334,2,31081,3.6288382953882077,20.0,0.0
18565,1,8565,[ 28 546 301  97 427],666,4,31085,3.628881625029185,0.0,0.0
18566,1,8566,[  1 313 181 100 132],308,3,31088,3.6288082175790826,0.0,20.0
18567,1,8567,[  9   7  50 427 546],339,5,31093,3.628968253968254,0.0,20.0
18568,1,8568,[127 318 258   1 276],184,4,31097,3.6290115532734273,20.0,20.0
18569,1,8569,[222 215  25 357 161],194,2,31099,3.628821470245041,20.0,0.0
18570,1,8570,[ 12 100 222 179  11],387,4,31103,3.6288647765721618,20.0,20.0
18571,1,8571,[174  50 257 204 357],308,5,31108,3.6290247316845545,20.0,40.0
18572,1,8572,[742 194 197 174  95],543,2,31110,3.6288347136358334,0.0,20.0
18573,1,8573,[  8 515 132 300 173],271,4,31114,3.628878003265687,0.0,0.0
18574,1,8574,[ 71 100 168 300 187],488,2,31116,3.6286880466472304,0.0,20.0
18575,1,8575,[ 70  88  64 546 100],374,4,31120,3.628731343283582,0.0,20.0
18576,1,8576,[273  88  96 405  64],145,4,31124,3.6287746298239476,0.0,0.0
18577,1,8577,[ 11 238 111 269 175],13,2,31126,3.628584751690371,0.0,0.0
18578,1,8578,[322  96  82 186 111],374,4,31130,3.6286280452267166,0.0,0.0
18579,1,8579,[ 70 173 508 174  64],6,3,31133,3.6285547785547787,0.0,20.0
18580,1,8580,[144  71   7 182 322],328,3,31136,3.6284815289593286,0.0,0.0
18581,1,8581,[313 127 187 302 483],13,5,31141,3.6286413423444417,20.0,20.0
18582,1,8582,[100 435  70  12 294],308,4,31145,3.6286846091110334,20.0,20.0
18583,1,8583,[313 127 187 302 483],537,5,31150,3.628844361602982,20.0,20.0
18584,1,8584,[191 144  69 181 200],804,4,31154,3.6288875946418173,0.0,0.0
18585,1,8585,[313 127 187 302 483],669,4,31158,3.6289308176100628,20.0,20.0
18586,1,8586,[135 423 603 151 117],90,3,31161,3.6288575754046817,20.0,0.0
18587,1,8587,[191 194   7 185 655],234,2,31163,3.6286679087098275,0.0,0.0
18588,1,8588,[273 234   4 546 179],378,2,31165,3.628478286179998,0.0,0.0
18589,1,8589,[185 176 132 197 179],843,2,31167,3.628288707799767,0.0,0.0
18590,1,8590,[313 127 187 302 603],334,5,31172,3.6284483762076594,20.0,20.0
18591,1,8591,[271 181 423 258 655],843,2,31174,3.6282588454376166,0.0,0.0
18592,1,8592,[144  69 275 183 215],378,4,31178,3.6283021063656467,0.0,0.0
18593,1,8593,[403 322  97 483 181],328,2,31180,3.628112636723295,20.0,0.0
18594,1,8594,[ 64 200 151 222 403],788,2,31182,3.6279232111692843,0.0,0.0
18595,1,8595,[161 234 435  96 176],650,4,31186,3.627966496044672,0.0,0.0
18596,1,8596,[210 179 258   4 288],64,2,31188,3.62777713155752,0.0,0.0
18597,1,8597,[135 194 222 496 118],897,4,31192,3.6278204233542684,0.0,0.0
18598,1,8598,[168 153 568 300 197],749,5,31197,3.627979997674148,0.0,0.0
18599,1,8599,[215 161  15 181 357],454,2,31199,3.6277906976744188,20.0,0.0
18600,1,8600,[ 64  97   7 186  69],374,4,31203,3.6278339727938613,0.0,0.0
18601,1,8601,[ 69 271 234 286 175],883,2,31205,3.6276447337828412,0.0,0.0
18602,1,8602,[195  71 153 132  28],95,4,31209,3.627688015808439,0.0,0.0
18603,1,8603,[  7 183 151  28 286],82,1,31210,3.6273826127382613,0.0,0.0
18604,1,8604,[313 127 187 302 603],474,5,31215,3.6275421266705403,20.0,20.0
18605,1,8605,[313 127 187 302 603],116,3,31218,3.6274692075296304,20.0,20.0
18606,1,8606,[194 289 210 211  56],234,2,31220,3.6272801208318812,0.0,0.0
18607,1,8607,[300  22 118  97 471],479,2,31222,3.6270910780669143,0.0,0.0
18608,1,8608,[235 183 258 100 286],144,4,31226,3.6271343942385874,0.0,20.0
18609,1,8609,[313 127 187 302 483],474,5,31231,3.6272938443670153,20.0,20.0
18610,1,8610,[515 172 216  22  15],474,5,31236,3.6274532574613865,0.0,0.0
18611,1,8611,[197 403  56 125 194],144,4,31240,3.6274965164886206,0.0,0.0
18612,1,8612,[515 276 185 151 175],308,4,31244,3.6275397654708,0.0,0.0
18613,1,8613,[313 127 187 302 483],474,5,31249,3.6276990944973297,20.0,20.0
18614,1,8614,[313 127 187 302 483],474,5,31254,3.627858386535113,20.0,20.0
18615,1,8615,[294 286 180 357 181],387,3,31257,3.627785515320334,20.0,0.0
18616,1,8616,[313 127 187 302 483],334,5,31262,3.627944760357433,20.0,20.0
18617,1,8617,[294  79 333 273 748],328,1,31263,3.627639823624971,0.0,0.0
18618,1,8618,[423 234 175 323  96],788,1,31264,3.6273349576516996,0.0,0.0
18619,1,8619,[100 204 174 185 322],374,5,31269,3.627494199535963,0.0,40.0
18620,1,8620,[200 269  50 195 186],7,4,31273,3.6275374086532883,0.0,20.0
18621,1,8621,[ 96 179 423 237  25],13,3,31276,3.627464625376943,0.0,0.0
18622,1,8622,[143 151 121  79 118],189,2,31278,3.6272758900614637,0.0,0.0
18623,1,8623,[603 228 127 153 222],339,5,31283,3.627435064935065,20.0,20.0
18624,1,8624,[111 313  95 258  50],234,2,31285,3.6272463768115943,0.0,20.0
18625,1,8625,[313 127 187 302 483],328,5,31290,3.6274055182007885,20.0,20.0
18626,1,8626,[313 127 187 302 483],537,5,31295,3.627564622696186,20.0,20.0
18627,1,8627,[127 328 323 151 211],699,1,31296,3.6272600834492352,0.0,20.0
18628,1,8628,[515  82 294 191  15],311,5,31301,3.627419167922123,0.0,0.0
18629,1,8629,[313 127 187 302 483],207,5,31306,3.6275782155272305,20.0,20.0
18630,1,8630,[313 127 187 302 483],207,5,31311,3.627737226277372,20.0,20.0
18631,1,8631,[313 127 187 302 483],669,4,31315,3.6277803521779424,20.0,20.0
18632,1,8632,[313 127 187 302 483],334,5,31320,3.627939302675779,20.0,20.0
18633,1,8633,[ 96 323 588 322  89],454,1,31321,3.6276349316655083,0.0,0.0
18634,1,8634,[196 273 174 125 168],374,2,31323,3.627446438911407,0.0,20.0
18635,1,8635,[135 588 427 300 318],234,3,31326,3.627373784159333,20.0,0.0
18636,1,8636,[234  64 748 405 435],524,2,31328,3.6271853652888733,0.0,0.0
18637,1,8637,[313 127 187 302 483],207,5,31333,3.627344292660338,20.0,20.0
18638,1,8638,[313 127 187 302 483],334,5,31338,3.627503183238801,20.0,20.0
18639,1,8639,[286 483  79  95   8],406,3,31341,3.6274305555555557,20.0,0.0
18640,1,8640,[172  88 275 269  82],452,3,31344,3.6273579446823283,0.0,0.0
18641,1,8641,[173 144  22 222 258],92,3,31347,3.627285350613284,0.0,0.0
18642,1,8642,[195 180 603 111 183],749,4,31351,3.627328473909522,20.0,0.0
18643,1,8643,[508  12  96 328  25],537,1,31352,3.6270245256825544,20.0,0.0
18644,1,8644,[313 127 187 302 483],207,5,31357,3.627183342972817,20.0,20.0
18645,1,8645,[294 678 215 151 216],940,3,31360,3.6271108026833216,0.0,0.0
18646,1,8646,[210 328 237 117  15],234,0,31360,3.6266913380363133,0.0,0.0
18647,1,8647,[508  12 286  64 483],13,3,31363,3.626618871415356,40.0,0.0
18648,1,8648,[313 127 187 302 483],334,5,31368,3.6267776621574748,20.0,20.0
18649,1,8649,[678  82 427 603   9],13,2,31370,3.6265895953757226,20.0,0.0
18650,1,8650,[276 313  89 318 143],92,3,31373,3.62651716564559,20.0,0.0
18651,1,8651,[211 423 121   4  64],328,4,31377,3.6265603328710125,0.0,0.0
18652,1,8652,[132 197 357 196  28],7,5,31382,3.62671905697446,20.0,0.0
18653,1,8653,[313 127 187 302 483],328,5,31387,3.6268777443956552,20.0,20.0
18654,1,8654,[300  82 328 423 121],328,5,31392,3.627036395147314,0.0,0.0
18655,1,8655,[288 180 215 194 195],144,4,31396,3.627079482439926,0.0,0.0
18656,1,8656,[179  79 194 135 294],406,3,31399,3.6270070463208963,0.0,0.0
18657,1,8657,[234 588 286 210 238],7,5,31404,3.627165627165627,0.0,0.0
18658,1,8658,[313 127 187 302 483],207,5,31409,3.6273241713823765,20.0,20.0
18659,1,8659,[153  71 121 222 197],64,1,31410,3.6270207852193996,0.0,0.0
18660,1,8660,[313 127 187 302 483],90,5,31415,3.627179309548551,20.0,20.0
18661,1,8661,[  7  96 288  22 271],92,2,31417,3.6269914569383515,0.0,0.0
18662,1,8662,[ 96 678 294   8  22],474,3,31420,3.626919081149717,0.0,0.0
18663,1,8663,[313 127 187 302 483],669,4,31424,3.6269621421975993,20.0,20.0
18664,1,8664,[313 127 187 302 483],334,5,31429,3.627120600115407,20.0,20.0
18665,1,8665,[286 180 323 135  11],881,3,31432,3.627048234479575,0.0,0.0
18666,1,8666,[ 96 271  79 515 288],13,1,31433,3.626745125187493,0.0,0.0
18667,1,8667,[181 508 153 111 117],378,3,31436,3.626672819566221,0.0,0.0
18668,1,8668,[ 69   7 435 237 245],804,4,31440,3.6267158841850273,0.0,0.0
18669,1,8669,[ 79 269 265 144 182],339,3,31443,3.626643598615917,0.0,0.0
18670,1,8670,[186  70 318 183 197],488,3,31446,3.6265713297197557,20.0,0.0
18671,1,8671,[111  96 742 294 588],378,3,31449,3.626499077490775,0.0,0.0
18672,1,8672,[ 12 288 228  50 144],234,1,31450,3.6261962412083477,20.0,20.0
18673,1,8673,[269 191 153 187 435],339,5,31455,3.626354623011298,0.0,0.0
18674,1,8674,[153 100 197  64 238],207,3,31458,3.6262824207492796,0.0,20.0
18675,1,8675,[200 135 597   1  79],804,2,31460,3.6260949746426925,0.0,0.0
18676,1,8676,[ 82 172 181 483  96],311,5,31465,3.626253313357151,20.0,0.0
18677,1,8677,[313 127 187 302 483],334,5,31470,3.6264116155796264,20.0,20.0
18678,1,8678,[300 318  64 385  88],653,4,31474,3.626454660675193,20.0,0.0
18679,1,8679,[125  25 195 289  56],92,3,31477,3.626382488479263,0.0,0.0
18680,1,8680,[403 161 265 215 118],524,4,31481,3.626425527013017,0.0,0.0
18681,1,8681,[  4  69 318  64 546],13,3,31484,3.6263533747984336,20.0,0.0
18682,1,8682,[483 271 268 173 427],13,3,31487,3.6262812392030406,20.0,0.0
18683,1,8683,[174  56  79 194 211],379,5,31492,3.6264394288346384,0.0,20.0
18684,1,8684,[423 161  69 385 300],83,4,31496,3.626482440990213,0.0,0.0
18685,1,8685,[181 211 568 174 153],87,5,31501,3.6266405710338474,0.0,20.0
18686,1,8686,[313 127 187 302 483],328,5,31506,3.626798664671348,20.0,20.0
18687,1,8687,[132   7 258 100 475],537,4,31510,3.626841620626151,0.0,20.0
18688,1,8688,[313 127 187 302 483],537,5,31515,3.626999654735873,20.0,20.0
18689,1,8689,[183 228 655 197 403],95,4,31519,3.627042577675489,0.0,0.0
18690,1,8690,[405 143 168  12  97],64,3,31522,3.626970429179611,20.0,0.0
18691,1,8691,[191  56 258  97 483],59,4,31526,3.627013345605154,20.0,0.0
18692,1,8692,[191 179  56   4 121],59,5,31531,3.627171287242609,0.0,0.0
18693,1,8693,[288 222  22 121 597],804,3,31534,3.6270991488382793,0.0,0.0
18694,1,8694,[471 210 302 195 222],666,2,31536,3.62691201840138,0.0,0.0
18695,1,8695,[496 176 313 143 202],378,3,31539,3.626839926402944,0.0,0.0
18696,1,8696,[318 176 185 181 357],42,4,31543,3.62688283316086,40.0,0.0
18697,1,8697,[ 98  71 111 357 172],59,4,31547,3.6269257300528857,20.0,20.0
18698,1,8698,[357  89 118 144  69],308,2,31549,3.6267387055983447,20.0,0.0
18699,1,8699,[211  25 100 286 234],339,5,31554,3.626896551724138,0.0,20.0
18700,1,8700,[313 127 187 302 483],328,5,31559,3.627054361567636,20.0,20.0
18701,1,8701,[275 121 186 269 180],13,3,31562,3.626982302918869,0.0,0.0
18702,1,8702,[143 405 508  25 273],59,2,31564,3.6267953579225556,0.0,0.0
18703,1,8703,[288 269 568 515  25],13,0,31564,3.6263786764705883,0.0,0.0
18704,1,8704,[258  69 273 655 202],749,5,31569,3.6265364732912118,0.0,0.0
18705,1,8705,[403 195 568 185 179],749,5,31574,3.6266942338617048,0.0,0.0
18706,1,8706,[234 195  89   8  22],774,0,31574,3.626277707591593,0.0,0.0
18707,1,8707,[313 127 187 302 483],13,5,31579,3.6264354616444647,20.0,20.0
18708,1,8708,[176 471 748  15 435],447,3,31582,3.6263635319784133,0.0,0.0
18709,1,8709,[195 216 405 144 197],883,4,31586,3.626406429391504,0.0,0.0
18710,1,8710,[175 322 313 678 423],474,4,31590,3.6264493169555734,0.0,0.0
18711,1,8711,[742 228 182 185 273],374,4,31594,3.6264921946740127,0.0,0.0
18712,1,8712,[ 70 403 100  12 186],643,3,31597,3.626420291518421,20.0,20.0
18713,1,8713,[313 127 187 302 483],90,5,31602,3.62657792058756,20.0,20.0
18714,1,8714,[475  15 168 588 276],308,4,31606,3.6266207687894436,0.0,0.0
18715,1,8715,[180 204 172  95  71],479,4,31610,3.6266636071592475,0.0,0.0
18716,1,8716,[ 56 234 475 176 357],144,4,31614,3.626706435700356,20.0,0.0
18717,1,8717,[435 257 210 515  82],290,3,31617,3.626634549208534,0.0,0.0
18718,1,8718,[258 181 269 121  69],13,4,31621,3.6266773712581717,0.0,0.0
18719,1,8719,[313 127 187 302 483],474,5,31626,3.626834862385321,20.0,20.0
18720,1,8720,[100 200 318 435  50],385,1,31627,3.6265336543974316,20.0,40.0
18721,1,8721,[313 127 187 302 483],90,5,31632,3.6266911258885575,20.0,20.0
18722,1,8722,[118 204 186 234 215],7,4,31636,3.626733921815889,0.0,0.0
18723,1,8723,[742 185 435 181  15],650,2,31638,3.6265474552957357,0.0,0.0
18724,1,8724,[ 28 180 289  25 185],474,4,31642,3.626590257879656,0.0,0.0
18725,1,8725,[132 117 294   9 186],533,4,31646,3.6266330506532203,0.0,0.0
18726,1,8726,[333  50 328 294  12],145,4,31650,3.626675833619801,20.0,20.0
18727,1,8727,[125 748 174 186 215],749,4,31654,3.626718606782768,0.0,20.0
18728,1,8728,[496 168 179 118  82],749,4,31658,3.626761370145492,0.0,0.0
18729,1,8729,[427 204 191  89 568],339,3,31661,3.6266895761741123,0.0,0.0
18730,1,8730,[197   8  12 265 302],271,5,31666,3.6268468674836787,20.0,0.0
18731,1,8731,[313 127 187 302 483],537,5,31671,3.627004122766835,20.0,20.0
18732,1,8732,[215 471 168 185 275],7,5,31676,3.6271613420359556,0.0,0.0
18733,1,8733,[435 181 200 187 186],749,4,31680,3.6272040302267,0.0,0.0
18734,1,8734,[385 100 655 286   9],234,1,31681,3.626903262736119,0.0,20.0
18735,1,8735,[313 127 187 302 483],537,5,31686,3.6270604395604398,20.0,20.0
18736,1,8736,[ 82 210 215 194  96],892,4,31690,3.6271031246423258,0.0,0.0
18737,1,8737,[ 15 483 405 318  70],474,5,31695,3.627260242618448,40.0,0.0
18738,1,8738,[403 222 185 196  69],749,4,31699,3.6273028950680857,0.0,0.0
18739,1,8739,[ 82 181 228 191  56],13,3,31702,3.6272311212814645,0.0,0.0
18740,1,8740,[508 194 187  15 211],406,4,31706,3.627273767303512,0.0,0.0
18741,1,8741,[132  96 282 405 508],533,4,31710,3.6273164035689773,0.0,0.0
18742,1,8742,[ 89 238 182 135 180],194,1,31711,3.627015898433032,0.0,0.0
18743,1,8743,[313 127 187 302 483],537,5,31716,3.6271729185727355,20.0,20.0
18744,1,8744,[ 82 211 328 191 655],207,3,31719,3.6271012006861065,0.0,0.0
18745,1,8745,[ 89 301 235 471 289],537,1,31720,3.626800823233478,0.0,0.0
18746,1,8746,[182 180 496 234 100],378,3,31723,3.6267291642848978,0.0,20.0
18747,1,8747,[ 89 268 258 265   8],387,4,31727,3.626771833561957,0.0,0.0
18748,1,8748,[185 742 153 215  97],454,2,31729,3.626585895530918,0.0,0.0
18749,1,8749,[748 238 173  50 135],474,4,31733,3.6266285714285713,0.0,20.0
18750,1,8750,[475 333 100 168  28],533,4,31737,3.626671237572849,0.0,20.0
18751,1,8751,[678  79 234 182 202],881,2,31739,3.6264853747714807,0.0,0.0
18752,1,8752,[313 127 187 302 483],328,5,31744,3.6266422940706042,20.0,20.0
18753,1,8753,[172  25 111 202 118],271,3,31747,3.626570710532328,0.0,0.0
18754,1,8754,[742  96  79 194 655],506,5,31752,3.6267275842375786,0.0,0.0
18755,1,8755,[ 82  96 118 603   4],59,5,31757,3.6268844221105527,20.0,0.0
18756,1,8756,[257 238 181  98 403],650,3,31760,3.626812835445929,0.0,20.0
18757,1,8757,[194 294 176  89 168],102,1,31761,3.6265129024891527,0.0,0.0
18758,1,8758,[127 183 496 471 181],234,3,31764,3.62644137458614,0.0,20.0
18759,1,8759,[135 588 187 197  71],311,5,31769,3.6265981735159816,0.0,0.0
18760,1,8760,[172 100 286 323  64],455,4,31773,3.6266407944298598,0.0,20.0
18761,1,8761,[318 423 294 282 237],298,4,31777,3.6266834056151565,20.0,0.0
18762,1,8762,[313 127 187 302 483],334,5,31782,3.6268401232454637,20.0,20.0
18763,1,8763,[ 11  22  69 237  95],334,3,31785,3.626768598813327,0.0,0.0
18764,1,8764,[173 222 748 258 568],899,4,31789,3.626811180832858,0.0,0.0
18765,1,8765,[ 15  50 588 216 211],290,4,31793,3.6268537531371208,0.0,20.0
18766,1,8766,[313 127 187 302 483],537,5,31798,3.6270103798334663,20.0,20.0
18767,1,8767,[143  28  88  50 161],454,5,31803,3.6271669708029197,0.0,20.0
18768,1,8768,[ 56 257  98 216 288],666,2,31805,3.6269814117915384,0.0,20.0
18769,1,8769,[186 180 187  98 333],653,4,31809,3.627023945267959,0.0,20.0
18770,1,8770,[313 127 187 302 483],669,4,31813,3.627066469045719,20.0,20.0
18771,1,8771,[215 195 135 237 423],234,2,31815,3.62688098495212,0.0,0.0
18772,1,8772,[313 127 187 302 483],474,5,31820,3.627037501424826,20.0,20.0
18773,1,8773,[ 96 289 234 196 748],533,2,31822,3.6268520629131524,0.0,0.0
18774,1,8774,[168  12 234 546 265],194,3,31825,3.6267806267806266,20.0,0.0
18775,1,8775,[195 234 121 204  96],788,1,31826,3.6264813126709208,0.0,0.0
18776,1,8776,[228 173  56 186 318],804,4,31830,3.6265238692036004,20.0,0.0
18777,1,8777,[204  97 121 257  95],290,4,31834,3.6265664160401,0.0,0.0
18778,1,8778,[313 127 187 302 483],474,5,31839,3.626722861373733,20.0,20.0
18779,1,8779,[403  64 204 276 211],533,3,31842,3.6266514806378134,0.0,0.0
18780,1,8780,[125 179 121  69 191],653,4,31846,3.6266939984056488,0.0,0.0
18781,1,8781,[385 161 100  69  28],7,4,31850,3.626736506490549,0.0,20.0
18782,1,8782,[678 748  50 276 235],699,0,31850,3.626323579642491,0.0,20.0
18783,1,8783,[318 127 210 185  96],488,4,31854,3.626366120218579,20.0,20.0
18784,1,8784,[313 127 187 302 483],90,5,31859,3.6265224815025614,20.0,20.0
18785,1,8785,[405  97 423 151  11],653,0,31859,3.6261097200091053,0.0,0.0
18786,1,8786,[313 127 187 302 483],474,5,31864,3.6262660748833504,20.0,20.0
18787,1,8787,[282 234 135  56   4],474,5,31869,3.6264223941738734,0.0,0.0
18788,1,8788,[ 56 322  82 182 288],234,0,31869,3.626009784958471,0.0,0.0
18789,1,8789,[132 135 515 288 238],892,5,31874,3.626166097838453,0.0,0.0
18790,1,8790,[117 216 333 187  96],653,4,31878,3.6262086224547834,0.0,0.0
18791,1,8791,[144 286  28  56 135],653,4,31882,3.626251137397634,0.0,0.0
18792,1,8792,[182 405 179 194 111],59,3,31885,3.626179915842147,0.0,0.0
18793,1,8793,[313 127 187 302 483],328,5,31890,3.6263361382760975,20.0,20.0
18794,1,8794,[313 127 187 302 483],13,5,31895,3.6264923251847643,20.0,20.0
18795,1,8795,[215  98  89 568 180],90,4,31899,3.6265347885402455,0.0,20.0
18796,1,8796,[151 245 423 603 200],313,2,31901,3.626349892008639,20.0,0.0
18797,1,8797,[180 185 300  79 748],653,4,31905,3.626392361900432,0.0,0.0
18798,1,8798,[151 546  95 143 168],374,2,31907,3.626207523582225,0.0,0.0
18799,1,8799,[742 181 210 143 588],795,3,31910,3.6261363636363635,0.0,0.0
18800,1,8800,[127 271 175  15 216],537,2,31912,3.625951596409499,0.0,20.0
18801,1,8801,[ 70  97 300 289 216],533,3,31915,3.6258804817087027,0.0,0.0
18802,1,8802,[174 172 179 313 269],650,4,31919,3.6259229808019993,0.0,20.0
18803,1,8803,[313 127 187 302 483],474,5,31924,3.6260790549750115,20.0,20.0
18804,1,8804,[313 127 187 302 483],474,5,31929,3.626235093696763,20.0,20.0
18805,1,8805,[655 187 403 313 204],234,2,31931,3.6260504201680672,0.0,0.0
18806,1,8806,[174  50 211 172 195],346,5,31936,3.6262064267060294,0.0,40.0
18807,1,8807,[100 204  50 222 273],13,3,31939,3.626135331516803,0.0,40.0
18808,1,8808,[313 127 187 302 483],328,5,31944,3.6262912929957998,20.0,20.0
18809,1,8809,[176  98 186 204 235],650,4,31948,3.62633371169126,0.0,20.0
18810,1,8810,[  1 588 282 125 265],378,4,31952,3.626376120758143,0.0,0.0
18811,1,8811,[257 100 202 403  69],92,3,31955,3.6263050385837494,0.0,20.0
18812,1,8812,[435 195 216 185  22],694,5,31960,3.6264609100192895,0.0,0.0
18813,1,8813,[204 313 175 172  70],13,4,31964,3.6265032902201044,0.0,0.0
18814,1,8814,[173 186 742  89 257],795,2,31966,3.626318774815655,0.0,0.0
18815,1,8815,[222  97 172 175 125],213,4,31970,3.626361161524501,0.0,0.0
18816,1,8816,[271 168 153 143  97],536,3,31973,3.6262901213564707,0.0,0.0
18817,1,8817,[222 175 245 603 185],334,4,31977,3.626332501701066,20.0,0.0
18818,1,8818,[180 127 215 161 204],479,3,31980,3.6262614808935254,0.0,20.0
18819,1,8819,[435  25  22 173 322],13,2,31982,3.626077097505669,0.0,0.0
18820,1,8820,[313 127 187 302 483],328,5,31987,3.6262328534179797,20.0,20.0
18821,1,8821,[288 508 176 475 678],455,2,31989,3.6260485150759463,0.0,0.0
18822,1,8822,[313 127 187 302 483],207,5,31994,3.626204238921002,20.0,20.0
18823,1,8823,[403 161 568 234 186],326,2,31996,3.626019945602901,0.0,0.0
18824,1,8824,[ 98 172 258  97 288],7,5,32001,3.626175637393768,0.0,20.0
18825,1,8825,[515 125 202  88 323],311,4,32005,3.6262179922954907,0.0,0.0
18826,1,8826,[313 127 187 302 483],13,5,32010,3.6263736263736264,20.0,20.0
18827,1,8827,[210 176 197  50 568],385,1,32011,3.626076121431808,0.0,20.0
18828,1,8828,[153  95 245 194 269],263,4,32015,3.6261184732132743,0.0,0.0
18829,1,8829,[  8 742 194  82 180],378,4,32019,3.6261608154020384,0.0,0.0
18830,1,8830,[176 174 228 173 234],13,3,32022,3.6260899105424076,0.0,20.0
18831,1,8831,[ 56 161 216   4 185],10,5,32027,3.6262454710144927,0.0,0.0
18832,1,8832,[237 546  12 282 174],271,3,32030,3.626174572625382,20.0,20.0
18833,1,8833,[313 127 187 302 483],207,5,32035,3.626330088295223,20.0,20.0
18834,1,8834,[313 127 187 302 483],90,5,32040,3.6264855687606112,20.0,20.0
18835,1,8835,[  9  95 197  79 117],13,2,32042,3.6263014938886373,0.0,0.0
18836,1,8836,[286   1 597 748 117],157,3,32045,3.626230621251556,0.0,0.0
18837,1,8837,[228 132 333 385 182],64,4,32049,3.6262729124236253,0.0,0.0
18838,1,8838,[313 127 187 302 483],537,5,32054,3.626428328996493,20.0,20.0
18839,1,8839,[186 508 202  98 174],343,5,32059,3.62658371040724,0.0,40.0
18840,1,8840,[471   4 204  82 195],7,4,32063,3.6266259472910303,0.0,0.0
18841,1,8841,[269 179 597 258   4],13,2,32065,3.6264419814521602,0.0,0.0
18842,1,8842,[ 56 385  25 215 275],533,4,32069,3.626484224810585,0.0,0.0
18843,1,8843,[100 257 508 151 176],653,1,32070,3.6261872455902306,0.0,20.0
18844,1,8844,[ 12  88  69 568 182],378,4,32074,3.6262295081967215,20.0,0.0
18845,1,8845,[546 748   8  96  97],881,2,32076,3.6260456703594843,0.0,0.0
18846,1,8846,[186   7 222  50 427],328,3,32079,3.6259749067480502,0.0,20.0
18847,1,8847,[153   1 174  28 118],643,4,32083,3.626017179023508,0.0,20.0
18848,1,8848,[195 186  50  56   9],326,3,32086,3.6259464346253814,0.0,20.0
18849,1,8849,[  1 196  95 111  22],59,3,32089,3.625875706214689,0.0,0.0
18850,1,8850,[300 196 294 496  56],378,3,32092,3.625804993786013,0.0,0.0
18851,1,8851,[ 89 508 483 235 204],406,5,32097,3.625960234975147,20.0,0.0
18852,1,8852,[172 257  69   7 515],334,3,32100,3.6258895289732296,0.0,0.0
18853,1,8853,[546 742 210 237 180],653,2,32102,3.6257058956403885,0.0,0.0
18854,1,8854,[ 50 222 118 237 289],454,3,32105,3.6256352343308866,0.0,20.0
18855,1,8855,[427  88  25 127  89],650,2,32107,3.6254516711833786,0.0,20.0
18856,1,8856,[216 405 186 568 588],804,5,32112,3.6256068646268487,0.0,0.0
18857,1,8857,[194 173 180 197  12],6,5,32117,3.6257620230300294,20.0,0.0
18858,1,8858,[313 127 187 302 483],207,5,32122,3.625917146404786,20.0,20.0
18859,1,8859,[202 300 182 405 237],666,2,32124,3.6257336343115125,0.0,0.0
18860,1,8860,[475 238 179 546  12],207,1,32125,3.6254373095587407,20.0,0.0
18861,1,8861,[742 318  12 483 357],454,1,32126,3.625141051681336,80.0,0.0
18862,1,8862,[313 127 187 302 483],474,5,32131,3.625296175110008,20.0,20.0
18863,1,8863,[313 127 187 302 483],474,5,32136,3.625451263537906,20.0,20.0
18864,1,8864,[ 88 276   4 238  12],339,5,32141,3.6256063169768753,20.0,0.0
18865,1,8865,[282 191 216 204 195],881,5,32146,3.625761335438755,0.0,0.0
18866,1,8866,[204 127 118 175 245],653,3,32149,3.625690763505131,0.0,20.0
18867,1,8867,[175 265 289 568 173],13,2,32151,3.6255074424898512,0.0,0.0
18868,1,8868,[313 286 187 742  22],184,3,32154,3.6254369150975307,0.0,0.0
18869,1,8869,[ 88 286 588 234  82],378,5,32159,3.6255918827508458,0.0,0.0
18870,1,8870,[202 143 153 197 234],643,4,32163,3.6256340886033143,0.0,0.0
18871,1,8871,[313 127 187 302 483],537,5,32168,3.625788999098287,20.0,20.0
18872,1,8872,[235 210 238 237 204],378,4,32172,3.6258311732221347,0.0,0.0
18873,1,8873,[313 127 187 302 483],669,4,32176,3.6258733378408836,20.0,20.0
18874,1,8874,[174 302 185 258 245],90,3,32179,3.6258028169014085,0.0,20.0
18875,1,8875,[313 127 187 302 483],334,5,32184,3.625957638575935,20.0,20.0
18876,1,8876,[127 275 176   9 132],311,5,32189,3.6261124253689307,0.0,20.0
18877,1,8877,[ 82 568 121 153 210],378,5,32194,3.626267177292183,0.0,0.0
18878,1,8878,[318 187 300 301 161],13,2,32196,3.6260840184705483,20.0,0.0
18879,1,8879,[313  11 286 385 234],378,4,32200,3.626126126126126,0.0,0.0
18880,1,8880,[313 127 187 302 483],537,5,32205,3.6262808242315057,20.0,20.0
18881,1,8881,[168  69  56 228 194],533,4,32209,3.626322900247692,0.0,0.0
18882,1,8882,[195 117 210 176 515],543,3,32212,3.626252392209839,0.0,0.0
18883,1,8883,[328 182 475 286 597],13,1,32213,3.625956776226925,0.0,0.0
18884,1,8884,[597 257 508 323 301],294,2,32215,3.6257737760270117,0.0,0.0
18885,1,8885,[313 127 187 302 483],207,5,32220,3.62592842673869,20.0,20.0
18886,1,8886,[ 82 118 237 496 435],694,5,32225,3.6260830426465622,0.0,0.0
18887,1,8887,[175 546  70 117 282],447,2,32227,3.625900090009001,0.0,0.0
18888,1,8888,[204 385  98 678 271],537,0,32227,3.625492181347733,0.0,20.0
18889,1,8889,[313 127 187 302 483],669,4,32231,3.6255343082114737,20.0,20.0
18890,1,8890,[313 127 187 302 483],334,5,32236,3.6256888988865144,20.0,20.0
18891,1,8891,[313 127 187 302 483],328,5,32241,3.6258434547908234,20.0,20.0
18892,1,8892,[173 603 222 151 546],749,3,32244,3.625773079950523,20.0,0.0
18893,1,8893,[748 176 117  69 211],543,3,32247,3.625702720935462,0.0,0.0
18894,1,8894,[ 82 237 322 180 185],804,5,32252,3.625857223159078,0.0,0.0
18895,1,8895,[117 333 210 111 265],334,1,32253,3.6255620503597124,0.0,0.0
18896,1,8896,[175 100 191 215 176],653,2,32255,3.6253793413510174,0.0,20.0
18897,1,8897,[202 483 194  50 357],188,3,32258,3.625309058215329,40.0,20.0
18898,1,8898,[275 238 204 323   8],13,2,32260,3.62512641869873,0.0,0.0
18899,1,8899,[ 79  88 273 318 423],234,2,32262,3.6249438202247193,20.0,0.0
18900,1,8900,[302 603 202 121 546],271,3,32265,3.6248736097067744,20.0,0.0
18901,1,8901,[313 127 187 302 603],334,5,32270,3.625028083576724,20.0,20.0
18902,1,8902,[313 127 187 302 603],669,5,32275,3.625182522745142,20.0,20.0
18903,1,8903,[210 121 228  88 186],194,1,32276,3.624887690925427,0.0,0.0
18904,1,8904,[313 127 187 302 603],13,5,32281,3.625042111173498,20.0,20.0
18905,1,8905,[313 127 187 302 603],13,5,32286,3.625196496743768,20.0,20.0
18906,1,8906,[181 215 211  89 197],385,2,32288,3.6250140339059165,0.0,0.0
18907,1,8907,[318 435 211 144  50],481,4,32292,3.625056129321958,20.0,20.0
18908,1,8908,[144 515 127  28 202],892,5,32297,3.625210461331238,0.0,20.0
18909,1,8909,[197 301 135  96 204],13,4,32301,3.625252525252525,0.0,0.0
18910,1,8910,[127 111  69 288 211],13,4,32305,3.6252945797329144,0.0,20.0
18911,1,8911,[228 202 121 294 161],374,3,32308,3.6252244165170557,0.0,0.0
18912,1,8912,[211  25 182 423 385],7,4,32312,3.625266464714462,0.0,0.0
18913,1,8913,[ 79 588 238 300  71],840,3,32315,3.6251963203948843,0.0,0.0
18914,1,8914,[100  79 186 125 276],271,3,32318,3.6251261918115536,0.0,20.0
18915,1,8915,[215 186 153 483 195],840,4,32322,3.6251682368775238,20.0,0.0
18916,1,8916,[313 127 187 302 603],334,5,32327,3.625322417853538,20.0,20.0
18917,1,8917,[265 222 194  88 288],339,3,32330,3.6252522987216866,0.0,0.0
18918,1,8918,[515 125 151  12 742],334,3,32333,3.625182195313376,20.0,0.0
18919,1,8919,[313 127 187 302 603],90,5,32338,3.625336322869955,20.0,20.0
18920,1,8920,[313 127 187 302 603],474,5,32343,3.62549041587266,20.0,20.0
18921,1,8921,[172 132 313  50  69],13,5,32348,3.625644474333109,0.0,20.0
18922,1,8922,[313 127 187 302 603],116,3,32351,3.6255743583996414,20.0,20.0
18923,1,8923,[161  82 313 300 238],454,4,32355,3.6256163155535632,0.0,0.0
18924,1,8924,[194   1 153 179 195],643,5,32360,3.6257703081232493,0.0,0.0
18925,1,8925,[313 127 187 302 483],669,4,32364,3.62581223392337,20.0,20.0
18926,1,8926,[  8 496  97 588 176],479,2,32366,3.625630110899518,0.0,0.0
18927,1,8927,[121 286 405 181 515],552,2,32368,3.6254480286738353,0.0,0.0
18928,1,8928,[471 318 235   7  22],92,2,32370,3.6252659872326127,20.0,0.0
18929,1,8929,[333 588 197  98 204],313,5,32375,3.6254199328107504,0.0,20.0
18930,1,8930,[515 143  70 234 168],60,4,32379,3.6254618743701714,0.0,0.0
18931,1,8931,[276 294  89 127 234],189,4,32383,3.625503806538289,0.0,20.0
18932,1,8932,[ 79  69 275 483 302],537,3,32386,3.625433784842718,20.0,0.0
18933,1,8933,[313 127 187 302 603],116,3,32389,3.625363778822476,20.0,20.0
18934,1,8934,[313 127 187 302 483],328,5,32394,3.625517627308338,20.0,20.0
18935,1,8935,[313 127 187 302 483],474,5,32399,3.625671441360788,20.0,20.0
18936,1,8936,[202 496 271 135 197],883,3,32402,3.625601432247958,0.0,0.0
18937,1,8937,[186   1 282 742 182],378,4,32406,3.6256433206533902,0.0,0.0
18938,1,8938,[748 257 183 328 275],548,3,32409,3.625573330350151,0.0,0.0
18939,1,8939,[144 204 216 195 185],648,5,32414,3.6257270693512305,0.0,0.0
18940,1,8940,[286 238 100 483 271],158,5,32419,3.625880773962644,20.0,20.0
18941,1,8941,[ 70  11 117 168 182],334,2,32421,3.625698948781033,0.0,0.0
18942,1,8942,[385  88 235 357   4],343,4,32425,3.625740802862574,20.0,0.0
18943,1,8943,[ 15 186   9 125 185],207,5,32430,3.6258944543828266,0.0,0.0
18944,1,8944,[301  79   4  12 191],524,4,32434,3.6259362772498602,20.0,0.0
18945,1,8945,[313 127 187 302 483],334,5,32439,3.6260898725687456,20.0,20.0
18946,1,8946,[313 127 187 302 483],207,5,32444,3.6262434335531464,20.0,20.0
18947,1,8947,[496  79 100 194 135],385,1,32445,3.6259499329459097,0.0,20.0
18948,1,8948,[313 127 187 302 483],90,5,32450,3.626103475248631,20.0,20.0
18949,1,8949,[313 127 187 302 483],474,5,32455,3.6262569832402236,20.0,20.0
18950,1,8950,[313 127 187 302 483],90,5,32460,3.626410456932186,20.0,20.0
18951,1,8951,[ 11 471 111 180 125],271,3,32463,3.6263404825737267,0.0,0.0
18952,1,8952,[135 176 403  98 100],385,2,32465,3.626158829442645,0.0,40.0
18953,1,8953,[313 127 187 302 483],334,5,32470,3.6263122626758992,20.0,20.0
18954,1,8954,[118 143 313 258 176],92,3,32473,3.626242322724735,0.0,0.0
18955,1,8955,[471 176 300  64  28],537,0,32473,3.625837427422957,0.0,0.0
18956,1,8956,[597 234 508 471 655],92,4,32477,3.625879200625209,0.0,0.0
18957,1,8957,[174  97 181 132 423],815,5,32482,3.6260325965617324,0.0,20.0
18958,1,8958,[282   9 172  64 179],311,4,32486,3.6260743386538676,0.0,0.0
18959,1,8959,[300  50 185 174  89],380,4,32490,3.6261160714285716,0.0,40.0
18960,1,8960,[195 176  56  64 144],339,3,32493,3.6260462002008707,0.0,0.0
18961,1,8961,[  8 132 496 174   9],334,3,32496,3.625976344565945,0.0,20.0
18962,1,8962,[313 127 187 302 483],328,5,32501,3.6261296440923796,20.0,20.0
18963,1,8963,[313 127 187 302 483],207,5,32506,3.6262829094154396,20.0,20.0
18964,1,8964,[313 127 187 302 483],474,5,32511,3.62643614054657,20.0,20.0
18965,1,8965,[328 427 210  12 174],334,3,32514,3.6263662725853223,20.0,20.0
18966,1,8966,[268 176 237 181  22],234,1,32515,3.6260733801717406,0.0,0.0
18967,1,8967,[185 496 210 742 568],308,4,32519,3.626115075825156,0.0,0.0
18968,1,8968,[195 568 234 483 276],881,4,32523,3.626156762180845,20.0,0.0
18969,1,8969,[204 135 121 187  98],311,5,32528,3.626309921962096,0.0,20.0
18970,1,8970,[313 127 187 302 483],669,4,32532,3.626351577304648,20.0,20.0
18971,1,8971,[202 546 423 385 196],881,4,32536,3.6263932233615694,0.0,0.0
18972,1,8972,[180  56 496 288 403],387,2,32538,3.6262119692410564,0.0,0.0
18973,1,8973,[186 215 176 182 196],749,4,32542,3.6262536215734342,0.0,0.0
18974,1,8974,[100  88 328 597 135],145,5,32547,3.626406685236769,0.0,20.0
18975,1,8975,[385 515 187 135 546],64,4,32551,3.6264483065953654,0.0,0.0
18976,1,8976,[313 127 187 302 483],90,5,32556,3.626601314470313,20.0,20.0
18977,1,8977,[258 282 216 483 195],666,2,32558,3.6264201381153933,20.0,0.0
18978,1,8978,[ 50 168 603  89  64],7,5,32563,3.626573115046219,20.0,20.0
18979,1,8979,[313 127 187 302 483],669,4,32567,3.6266146993318484,20.0,20.0
18980,1,8980,[ 89 748 121  70 423],328,4,32571,3.626656274356976,0.0,0.0
18981,1,8981,[289 483  98   4 172],538,3,32574,3.626586506346025,20.0,20.0
18982,1,8982,[313 127 187 302 483],13,5,32579,3.626739396638094,20.0,20.0
18983,1,8983,[603  11 191  25 289],90,4,32583,3.626780943900267,20.0,0.0
18984,1,8984,[403  88 286 405 135],378,3,32586,3.626711185308848,0.0,0.0
18985,1,8985,[313 127 187 302 483],13,5,32591,3.6268640106832852,20.0,20.0
18986,1,8986,[313 127 187 302 483],669,4,32595,3.626905530210304,20.0,20.0
18987,1,8987,[ 71 269  95 301 100],650,2,32597,3.6267245215843347,0.0,20.0
18988,1,8988,[435  82 385 265 185],452,2,32599,3.626543553231728,0.0,0.0
18989,1,8989,[323 288 182  96 496],650,2,32601,3.6263626251390435,0.0,0.0
18990,1,8990,[313 127 187 302 483],328,5,32606,3.626515404293182,20.0,20.0
18991,1,8991,[313 127 187 302 483],207,5,32611,3.6266681494661923,20.0,20.0
18992,1,8992,[313 127 187 302 483],328,5,32616,3.6268208606694095,20.0,20.0
18993,1,8993,[313 127 187 302 483],328,5,32621,3.626973537914165,20.0,20.0
18994,1,8994,[125 282 222 276 515],334,4,32625,3.6270150083379655,0.0,0.0
18995,1,8995,[276 302 181 135  96],474,5,32630,3.6271676300578033,0.0,0.0
18996,1,8996,[423 125  69 235 121],194,1,32631,3.626875625208403,0.0,0.0
18997,1,8997,[191 186 175 318  22],664,3,32634,3.6268059568793065,20.0,0.0
18998,1,8998,[313 127 187 302 483],13,5,32639,3.6269585509501057,20.0,20.0
18999,1,8999,[323 483 174  97   1],650,2,32641,3.626777777777778,20.0,20.0
19000,1,9000,[483 210 323 211 174],13,3,32644,3.6267081435396067,20.0,20.0
19001,1,9001,[313 127 187 302 483],90,5,32649,3.6268606976227504,20.0,20.0
19002,1,9002,[313 127 187 302 483],13,5,32654,3.6270132178162835,20.0,20.0
19003,1,9003,[313 127 187 302 483],474,5,32659,3.6271657041314973,20.0,20.0
19004,1,9004,[210 181 313  28  79],13,3,32662,3.627096057745697,0.0,0.0
19005,1,9005,[258  95  97  50 179],815,3,32665,3.62702642682656,0.0,20.0
19006,1,9006,[127 144  96  12 288],144,4,32669,3.6270678361274564,20.0,20.0
19007,1,9007,[269   4 357 276 182],339,5,32674,3.6272202486678506,20.0,0.0
19008,1,9008,[197 237 273  79 183],378,4,32678,3.6272616272616274,0.0,0.0
19009,1,9009,[588 211 301 100 186],650,3,32681,3.6271920088790233,0.0,20.0
19010,1,9010,[313 127 187 302 483],334,5,32686,3.6273443568971255,20.0,20.0
19011,1,9011,[275   4 333 323 435],537,1,32687,3.62705281846427,0.0,0.0
19012,1,9012,[  1  69  98 333 186],13,3,32690,3.626983246421835,0.0,20.0
19013,1,9013,[180 515  98 742 191],881,5,32695,3.6271355668959395,0.0,20.0
19014,1,9014,[ 28  22  64 471  71],533,5,32700,3.627287853577371,0.0,0.0
19015,1,9015,[313 127 187 302 483],90,5,32705,3.6274401064773736,20.0,20.0
19016,1,9016,[357 210  88   4 194],533,3,32708,3.6273705223466783,20.0,0.0
19017,1,9017,[ 28 143   1 202 603],537,1,32709,3.6270791749833666,20.0,0.0
19018,1,9018,[132 483 237  50 187],6,4,32713,3.627120523339616,20.0,20.0
19019,1,9019,[125 191 197 196 180],881,3,32716,3.627050997782705,0.0,0.0
19020,1,9020,[313 127 187 302 483],669,4,32720,3.627092340095333,20.0,20.0
19021,1,9021,[313 127 187 302 483],334,5,32725,3.6272445134116604,20.0,20.0
19022,1,9022,[357 258 183 568  95],313,3,32728,3.627174997229303,20.0,0.0
19023,1,9023,[313 127 187 302 483],537,5,32733,3.6273271276595747,20.0,20.0
19024,1,9024,[197 196  56   1 385],378,4,32737,3.6273684210526316,0.0,0.0
19025,1,9025,[ 56 204 258 228 322],788,2,32739,3.6271881231996455,0.0,0.0
19026,1,9026,[435 125 282 588 127],194,3,32742,3.6271186440677967,0.0,20.0
19027,1,9027,[ 98 143 174 286 210],85,4,32746,3.627159946832078,0.0,40.0
19028,1,9028,[568 427  64  69 286],788,3,32749,3.6270904862110975,0.0,0.0
19029,1,9029,[268 200  11 269  79],13,1,32750,3.626799557032115,0.0,0.0
19030,1,9030,[313 127 187 302 483],207,5,32755,3.6269516111172626,20.0,20.0
19031,1,9031,[222 271 168 135 191],334,4,32759,3.6269929140832593,0.0,0.0
19032,1,9032,[313 127 187 302 483],207,5,32764,3.627144913096424,20.0,20.0
19033,1,9033,[185  95 180 273 197],13,3,32767,3.627075492583573,0.0,0.0
19034,1,9034,[ 70 286   4 269 655],7,3,32770,3.627006087437742,0.0,0.0
19035,1,9035,[313 127 187 302 483],474,5,32775,3.6271580345285526,20.0,20.0
19036,1,9036,[313 127 187 302 483],13,5,32780,3.62730994799159,20.0,20.0
19037,1,9037,[ 69  88 385 258 655],343,4,32784,3.6273511838902412,0.0,0.0
19038,1,9038,[678 322  71 196  97],454,1,32785,3.627060515543755,0.0,0.0
19039,1,9039,[ 11 144 186 288 216],7,4,32789,3.6271017699115045,0.0,0.0
19040,1,9040,[276 313 588  12  28],308,3,32792,3.627032407919478,20.0,0.0
19041,1,9041,[210 187  98 174 100],311,4,32796,3.6270736562707366,0.0,60.0
19042,1,9042,[288 200  25 300 245],378,2,32798,3.6268937299568726,0.0,0.0
19043,1,9043,[228 173  89 181 197],339,5,32803,3.627045555064131,0.0,0.0
19044,1,9044,[194  96 204 117 275],533,5,32808,3.6271973466003318,0.0,0.0
19045,1,9045,[265 471  11 237  98],455,3,32811,3.627128012381163,0.0,20.0
19046,1,9046,[  8 258  69 238 742],454,3,32814,3.6270586934895546,0.0,0.0
19047,1,9047,[313 127 187 302 483],207,5,32819,3.627210433244916,20.0,20.0
19048,1,9048,[186 144  50  82 135],194,2,32821,3.6270306111172506,0.0,20.0
19049,1,9049,[313 127 187 302 483],90,5,32826,3.627182320441989,20.0,20.0
19050,1,9050,[181  50 403 111 300],64,4,32830,3.6272235112142304,0.0,20.0
19051,1,9051,[216 234 118  56 161],650,3,32833,3.6271542200618647,0.0,0.0
19052,1,9052,[  4   1  95  28 275],378,4,32837,3.6271954048381754,0.0,0.0
19053,1,9053,[121  89 173  64 273],64,2,32839,3.6270156836757232,0.0,0.0
19054,1,9054,[  8  22 588  82 234],308,4,32843,3.627056874654887,0.0,0.0
19055,1,9055,[289 313 435  96 475],90,3,32846,3.626987632508834,0.0,0.0
19056,1,9056,[196 294 496 257 179],653,1,32847,3.6266975819807885,0.0,0.0
19057,1,9057,[ 95 211 195 191  12],64,5,32852,3.626849194082579,20.0,0.0
19058,1,9058,[175 405 546 197  98],313,4,32856,3.6268903852522354,0.0,20.0
19059,1,9059,[  7 204 195  69 211],194,3,32859,3.6268211920529803,0.0,0.0
19060,1,9060,[313 127 187 302 483],328,5,32864,3.6269727403156384,20.0,20.0
19061,1,9061,[385 210 245  97 405],378,3,32867,3.6269035532994924,0.0,0.0
19062,1,9062,[313 127 187 302 483],207,5,32872,3.627055059031226,20.0,20.0
19063,1,9063,[153 191 195 183 196],934,4,32876,3.6270962047661075,0.0,0.0
19064,1,9064,[187 197  28 318 289],334,3,32879,3.627027027027027,20.0,0.0
19065,1,9065,[313 127 187 302 483],328,5,32884,3.627178469005074,20.0,20.0
19066,1,9066,[313 127 187 302 483],334,5,32889,3.6273298775780303,20.0,20.0
19067,1,9067,[  9   4  28 151 100],189,4,32893,3.6273709748566385,0.0,20.0
19068,1,9068,[211  12 228 204 135],339,4,32897,3.6274120630720037,20.0,0.0
19069,1,9069,[ 97 196   1 471  15],42,4,32901,3.6274531422271226,0.0,0.0
19070,1,9070,[ 50 603 328 357 313],271,4,32905,3.627494212324992,40.0,20.0
19071,1,9071,[333  12 204 194 179],387,2,32907,3.627314814814815,20.0,0.0
19072,1,9072,[313 127 187 302 483],537,5,32912,3.6274661082332194,20.0,20.0
19073,1,9073,[313 127 187 302 483],207,5,32917,3.627617368305047,20.0,20.0
19074,1,9074,[568  96 423 216 202],13,3,32920,3.6275482093663913,0.0,0.0
19075,1,9075,[234 302  96  82 423],454,4,32924,3.627589246364037,0.0,0.0
19076,1,9076,[215  79 174 181  98],60,5,32929,3.6277404428776028,0.0,40.0
19077,1,9077,[313 127 187 302 483],13,5,32934,3.6278916060806345,20.0,20.0
19078,1,9078,[ 79 273 132 238   9],7,4,32938,3.6279325916951204,0.0,0.0
19079,1,9079,[191  82  89 228 127],7,4,32942,3.6279735682819383,0.0,20.0
19080,1,9080,[483 269  70 161 385],85,3,32945,3.6279044158132363,20.0,0.0
19081,1,9081,[196 427 153   7 385],87,5,32950,3.6280554943844967,0.0,0.0
19082,1,9082,[313 127 187 302 483],13,5,32955,3.62820653968953,20.0,20.0
19083,1,9083,[313 127 187 302 483],328,5,32960,3.628357551739322,20.0,20.0
19084,1,9084,[  7  79 294 385 405],194,1,32961,3.6280682443588335,0.0,0.0
19085,1,9085,[117 100  71 216  79],738,0,32961,3.627668941228263,0.0,20.0
19086,1,9086,[546   9 118  11  22],455,3,32964,3.6275998679432155,0.0,0.0
19087,1,9087,[483 132  89 357 265],343,3,32967,3.627530809859155,40.0,0.0
19088,1,9088,[294 111 435 678 597],82,3,32970,3.627461766971064,0.0,0.0
19089,1,9089,[187  56 143 238 496],897,4,32974,3.6275027502750277,0.0,0.0
19090,1,9090,[313 127 187 302 483],334,5,32979,3.6276537234627653,20.0,20.0
19091,1,9091,[568 508 111   9 179],92,3,32982,3.6275846898372195,0.0,0.0
19092,1,9092,[100   9 269 185 603],64,4,32986,3.6276256461013965,20.0,20.0
19093,1,9093,[313 127 187 302 483],13,5,32991,3.62777655597097,20.0,20.0
19094,1,9094,[194   1 234  95 286],271,4,32995,3.62781748213304,0.0,0.0
19095,1,9095,[313 127 187 302 483],669,4,32999,3.627858399296394,20.0,20.0
19096,1,9096,[ 22 655 125 144  25],749,5,33004,3.628009233813345,0.0,0.0
19097,1,9097,[313 127 187 302 483],207,5,33009,3.6281600351725656,20.0,20.0
19098,1,9098,[179 161 143 111  98],207,4,33013,3.6282009011979337,0.0,20.0
19099,1,9099,[313 127 187 302 483],328,5,33018,3.6283516483516483,20.0,20.0
19100,1,9100,[200 216  89 118 294],13,2,33020,3.6281727282716183,0.0,0.0
19101,1,9101,[313 127 187 302 483],328,5,33025,3.628323445396616,20.0,20.0
19102,1,9102,[195 357 191 210 546],804,4,33029,3.628364275513567,20.0,0.0
19103,1,9103,[313 127 187 302 483],334,5,33034,3.6285149384885766,20.0,20.0
19104,1,9104,[187 515  79 200 168],543,4,33038,3.628555738605162,0.0,0.0
19105,1,9105,[  8  71 271 181 322],13,3,33041,3.628486712057984,0.0,0.0
19106,1,9106,[215 100  22 202 385],311,4,33045,3.6285275063138247,0.0,20.0
19107,1,9107,[294 215 187 173 168],311,5,33050,3.6286780851998244,0.0,0.0
19108,1,9108,[234 483  79   9 313],474,5,33055,3.6288286310242617,20.0,0.0
19109,1,9109,[204   1 210 215 275],13,2,33057,3.6286498353457737,0.0,0.0
19110,1,9110,[ 25 151 258 180 435],313,2,33059,3.6284710789155965,0.0,0.0
19111,1,9111,[173 174 257 258 265],145,5,33064,3.6286215978928884,0.0,20.0
19112,1,9112,[185 153 175 234 168],840,4,33068,3.6286623504883133,0.0,0.0
19113,1,9113,[302 118 234 211 235],328,3,33071,3.628593372833004,0.0,0.0
19114,1,9114,[313 127 187 302 483],90,5,33076,3.6287438288535383,20.0,20.0
19115,1,9115,[313 127 187 302 483],669,4,33080,3.6287845546292234,20.0,20.0
19116,1,9116,[216 275 143  28 423],694,5,33085,3.6289349566743447,0.0,0.0
19117,1,9117,[313 127 187 302 483],537,5,33090,3.6290853257293265,20.0,20.0
19118,1,9118,[143 210  64 153 655],234,1,33091,3.6287970172168,0.0,0.0
19119,1,9119,[215  50  71 228 183],804,5,33096,3.6289473684210525,0.0,20.0
19120,1,9120,[435 216 118 161 273],308,1,33097,3.6286591382523845,0.0,0.0
19121,1,9121,[195 204 100 301 161],650,3,33100,3.628590221442666,0.0,20.0
19122,1,9122,[276 127   1 273 471],234,1,33101,3.6283020936095585,0.0,20.0
19123,1,9123,[ 64 143  22 179 153],308,5,33106,3.6284524331433583,0.0,0.0
19124,1,9124,[222 435 385 182 173],85,2,33108,3.6282739726027398,0.0,0.0
19125,1,9125,[ 25 301 237 496 385],666,2,33110,3.6280955511724744,0.0,0.0
19126,1,9126,[313 127 187 302 483],474,5,33115,3.628245863920237,20.0,20.0
19127,1,9127,[235  79 318 168  89],194,2,33117,3.628067484662577,20.0,0.0
19128,1,9128,[313 127 187 302 483],334,5,33122,3.628217767553949,20.0,20.0
19129,1,9129,[508 228 288 257 333],334,3,33125,3.628148959474261,0.0,0.0
19130,1,9130,[313 127 187 302 483],669,4,33129,3.6281896834957834,20.0,20.0
19131,1,9131,[257  56 228  89 180],92,4,33133,3.6282303985983355,0.0,0.0
19132,1,9132,[313 127 187 302 483],328,5,33138,3.6283805978320376,20.0,20.0
19133,1,9133,[245 597 496 568 405],200,3,33141,3.628311802058244,0.0,0.0
19134,1,9134,[186 185 245  97 210],666,2,33143,3.6281335522714833,0.0,0.0
19135,1,9135,[234 435 423 403 200],326,0,33143,3.62773642732049,0.0,0.0
19136,1,9136,[313 127 187 302 483],334,5,33148,3.6278866148626463,20.0,20.0
19137,1,9137,[  9 118 191  82 183],92,3,33151,3.6278179032611075,0.0,0.0
19138,1,9138,[568 238 195 153 204],538,3,33154,3.627749206696575,0.0,0.0
19139,1,9139,[186 568 286  28 194],207,4,33158,3.6277899343544857,0.0,0.0
19140,1,9140,[  7 302 742 546 427],833,0,33158,3.627393064216169,0.0,0.0
19141,1,9141,[ 97 121   4 235  79],210,4,33162,3.627433821920805,0.0,0.0
19142,1,9142,[245 302 197 117 175],378,2,33164,3.627255824127748,0.0,0.0
19143,1,9143,[172  70   7 322  56],537,3,33167,3.6271872265966754,0.0,0.0
19144,1,9144,[313 127 187 302 483],669,4,33171,3.6272279934390377,20.0,20.0
19145,1,9145,[ 50 153 435 121 195],60,4,33175,3.6272687513667177,0.0,20.0
19146,1,9146,[318   1 269 286 237],13,1,33176,3.626981523996939,20.0,0.0
19147,1,9147,[323 483  64 204  69],311,4,33180,3.6270222999562747,20.0,0.0
19148,1,9148,[196   4  11 195 118],13,3,33183,3.626953765438846,0.0,0.0
19149,1,9149,[237  89 273 655  69],13,4,33187,3.6269945355191258,0.0,0.0
19150,1,9150,[ 50 269 323 127 181],13,3,33190,3.6269260190143155,0.0,40.0
19151,1,9151,[313 127 187 302 483],90,5,33195,3.6270760489510487,20.0,20.0
19152,1,9152,[546 222 403 483 127],524,4,33199,3.6271167923085326,20.0,20.0
19153,1,9153,[100  56 427 172 187],474,5,33204,3.6272667686257374,0.0,20.0
19154,1,9154,[ 79 323  70 289 318],488,2,33206,3.6270890223921355,20.0,0.0
19155,1,9155,[603 245 515 302 282],666,3,33209,3.6270205329838356,20.0,0.0
19156,1,9156,[313 127 187 302 483],90,5,33214,3.62717047067817,20.0,20.0
19157,1,9157,[176 174  70  98 197],474,5,33219,3.6273203756278662,0.0,40.0
19158,1,9158,[313 127 187 302 483],669,4,33223,3.6273610656185173,20.0,20.0
19159,1,9159,[204  28 117  70 245],455,2,33225,3.627183406113537,0.0,0.0
19160,1,9160,[515  88  96 175  97],474,5,33230,3.627333260561074,0.0,0.0
19161,1,9161,[313 127 187 302 483],537,5,33235,3.627483082296442,20.0,20.0
19162,1,9162,[313 127 187 302 483],13,5,33240,3.6276328713303503,20.0,20.0
19163,1,9163,[ 25 294 200 210 143],13,0,33240,3.6272370144041903,0.0,0.0
19164,1,9164,[118  82 153  97 742],374,5,33245,3.6273867975995637,0.0,0.0
19165,1,9165,[313 127 187 302 483],13,5,33250,3.62753654811259,20.0,20.0
19166,1,9166,[174  12 234   9 185],13,3,33253,3.627468092069379,20.0,20.0
19167,1,9167,[546 180 187  98 273],346,3,33256,3.6273996509598603,0.0,20.0
19168,1,9168,[ 96 216 748 568 191],207,3,33259,3.627331224779147,0.0,0.0
19169,1,9169,[211 471 228 405 121],194,1,33260,3.6270447110141766,0.0,0.0
19170,1,9170,[  4 215 132 204  97],406,3,33263,3.6269763384581832,0.0,0.0
19171,1,9171,[313 127 187 302 483],13,5,33268,3.6271260357610116,20.0,20.0
19172,1,9172,[313 127 187 302 483],90,5,33273,3.627275700425161,20.0,20.0
19173,1,9173,[313 127 187 302 483],334,5,33278,3.6274253324613035,20.0,20.0
19174,1,9174,[ 82 200 173 323 175],59,5,33283,3.627574931880109,0.0,0.0
19175,1,9175,[228 127 269 183  88],738,3,33286,3.6275065387968612,0.0,20.0
19176,1,9176,[313 127 187 302 483],537,5,33291,3.627656096763648,20.0,20.0
19177,1,9177,[313 127 187 302 483],328,5,33296,3.6278056221398995,20.0,20.0
19178,1,9178,[313 127 187 302 483],13,5,33301,3.6279551149362677,20.0,20.0
19179,1,9179,[143 176   9 258  98],234,1,33302,3.6276688453159043,0.0,20.0
19180,1,9180,[313 546  98 435 216],234,2,33304,3.6274915586537415,0.0,20.0
19181,1,9181,[294 245  97 222 180],533,2,33306,3.627314310607711,0.0,0.0
19182,1,9182,[313 183 496  98 180],653,2,33308,3.6271371011651965,0.0,20.0
19183,1,9183,[100 197 427  98  88],650,4,33312,3.6271777003484322,0.0,40.0
19184,1,9184,[483  88 265 216 181],650,4,33316,3.6272182906913444,20.0,0.0
19185,1,9185,[117 161 597  22 172],346,3,33319,3.627150010886131,0.0,0.0
19186,1,9186,[153  71   7  89 302],13,4,33323,3.6271905954065526,0.0,0.0
19187,1,9187,[ 50  70 135 172  98],60,5,33328,3.627340008707009,0.0,40.0
19188,1,9188,[313 127 187 302 483],328,5,33333,3.6274893894874305,20.0,20.0
19189,1,9189,[173 144  25  11 215],92,3,33336,3.6274211099020675,0.0,0.0
19190,1,9190,[405  89 204 423 568],897,5,33341,3.6275704493526275,0.0,0.0
19191,1,9191,[313 127 187 302 483],669,4,33345,3.6276109660574414,20.0,20.0
19192,1,9192,[111 475 100 328 333],13,2,33347,3.6274339171108454,0.0,20.0
19193,1,9193,[  1 144 496  50  97],308,2,33349,3.6272569066782685,0.0,20.0
19194,1,9194,[228 180 143 748 546],313,2,33351,3.627079934747145,0.0,0.0
19195,1,9195,[185 333 286  96 588],537,1,33352,3.626794258373206,0.0,0.0
19196,1,9196,[ 97 403 483 385   7],881,3,33355,3.6267261063390235,20.0,0.0
19197,1,9197,[546 111 175 258 202],13,4,33359,3.626766688410524,0.0,0.0
19198,1,9198,[313 127 187 302 483],207,5,33364,3.626915969127079,20.0,20.0
19199,1,9199,[ 11 276 603 515 176],474,5,33369,3.6270652173913045,20.0,0.0
19200,1,9200,[313 127 187 302 483],334,5,33374,3.6272144332137812,20.0,20.0
19201,1,9201,[568 258 175 100  98],313,4,33378,3.627254944577266,0.0,40.0
19202,1,9202,[385 228 176 174  89],13,3,33381,3.6271867869173096,0.0,20.0
19203,1,9203,[313 127 187 302 483],334,5,33386,3.627335940895263,20.0,20.0
19204,1,9204,[403 286 323 100 172],650,2,33388,3.6271591526344378,0.0,20.0
19205,1,9205,[135 202 603  89 228],694,5,33393,3.6273082772105147,20.0,0.0
19206,1,9206,[  9 405 135 300 182],328,3,33396,3.6272401433691757,0.0,0.0
19207,1,9207,[195  25  22 483 265],308,3,33399,3.6271720243266725,20.0,0.0
19208,1,9208,[294 678 186 496  95],648,2,33401,3.626995330654794,0.0,0.0
19209,1,9209,[151 191  71   9 197],334,4,33405,3.6270358306188926,0.0,0.0
19210,1,9210,[403 100 215  69   9],64,5,33410,3.62718488763435,0.0,20.0
19211,1,9211,[182 235 222 153  97],374,4,33414,3.6272253582283978,0.0,0.0
19212,1,9212,[151 238 288 313 117],334,3,33417,3.627157277759687,0.0,0.0
19213,1,9213,[194 423 435 238 182],840,4,33421,3.6271977425656607,0.0,0.0
19214,1,9214,[313 127 187 302 483],90,5,33426,3.6273467173087357,20.0,20.0
19215,1,9215,[313 127 187 302 483],207,5,33431,3.6274956597222223,20.0,20.0
19216,1,9216,[  7   9 385 742 118],92,3,33434,3.6274275794727133,0.0,0.0
19217,1,9217,[678 176 258  96 435],506,4,33438,3.627467997396398,0.0,0.0
19218,1,9218,[313 127 187 302 483],669,4,33442,3.6275084065516867,20.0,20.0
19219,1,9219,[127 385 168 237 322],474,4,33446,3.627548806941432,0.0,20.0
19220,1,9220,[322 100   4 153 195],883,5,33451,3.6276976466760655,0.0,20.0
19221,1,9221,[313 127 187 302 603],474,5,33456,3.627846454131425,20.0,20.0
19222,1,9222,[195   9 176   1  56],13,1,33457,3.6275615309552207,0.0,0.0
19223,1,9223,[313 127 187 302 603],669,5,33462,3.6277103209019947,20.0,20.0
19224,1,9224,[313 127 187 302 603],116,3,33465,3.627642276422764,20.0,20.0
19225,1,9225,[405  22   8 100  25],7,3,33468,3.627574246694125,0.0,20.0
19226,1,9226,[235 100 191 210  56],385,3,33471,3.627506231711282,0.0,20.0
19227,1,9227,[237 118 222 117  28],92,3,33474,3.6274382314694407,0.0,0.0
19228,1,9228,[196 111  97 515 204],474,5,33479,3.6275869541662153,0.0,0.0
19229,1,9229,[187 175 194  64  79],339,5,33484,3.627735644637053,0.0,0.0
19230,1,9230,[313 127 187 302 483],328,5,33489,3.6278843028924275,20.0,20.0
19231,1,9231,[357 187 182 588  22],308,5,33494,3.6280329289428077,20.0,0.0
19232,1,9232,[313 127 187 302 483],328,5,33499,3.628181522798657,20.0,20.0
19233,1,9233,[313 127 187 302 483],207,5,33504,3.628330084470435,20.0,20.0
19234,1,9234,[181 328 276 187 423],537,2,33506,3.6281537628586897,0.0,0.0
19235,1,9235,[153 405 435 318 427],788,2,33508,3.627977479428324,20.0,0.0
19236,1,9236,[ 71  69  79   4 204],194,4,33512,3.628017754682256,0.0,0.0
19237,1,9237,[ 79 191 168  82 273],666,2,33514,3.627841524139424,0.0,0.0
19238,1,9238,[313 127 187 302 483],669,4,33518,3.6278818053901936,20.0,20.0
19239,1,9239,[ 50 258 210   7 265],474,5,33523,3.628030303030303,0.0,20.0
19240,1,9240,[204   1 121 187 168],13,4,33527,3.628070555134726,0.0,0.0
19241,1,9241,[289  82 678  70  79],881,2,33529,3.6278943951525644,0.0,0.0
19242,1,9242,[288  25 238 185 179],666,3,33532,3.627826463269501,0.0,0.0
19243,1,9243,[176 172 111  11 187],537,1,33533,3.627542189528343,0.0,0.0
19244,1,9244,[ 88 179 273 194 603],234,2,33535,3.627366143861547,20.0,0.0
19245,1,9245,[132  56 127  25 183],537,2,33537,3.627190136275146,0.0,20.0
19246,1,9246,[655 258 423 323 151],474,3,33540,3.6271223099383585,0.0,0.0
19247,1,9247,[313 127 187 302 483],207,5,33545,3.6272707612456747,20.0,20.0
19248,1,9248,[ 64 597 258 603 508],213,5,33550,3.6274191804519407,20.0,0.0
19249,1,9249,[748 100 237 222 195],360,2,33552,3.6272432432432433,0.0,20.0
19250,1,9250,[313 127 187 302 483],13,5,33557,3.6273916333369365,20.0,20.0
19251,1,9251,[ 22  89 603 427 403],334,5,33562,3.627539991353221,20.0,0.0
19252,1,9252,[117 186 245 132 168],533,3,33565,3.6274721711877227,0.0,0.0
19253,1,9253,[191   4 294 161 215],318,2,33567,3.627296304300843,0.0,0.0
19254,1,9254,[603 216  56 168 423],666,3,33570,3.627228525121556,20.0,0.0
19255,1,9255,[ 69  97 546 427 216],194,2,33572,3.6270527225583407,0.0,0.0
19256,1,9256,[ 64  70 176 265 132],666,4,33576,3.6270930106946095,0.0,0.0
19257,1,9257,[313 127 187 302 483],334,5,33581,3.627241304817455,20.0,20.0
19258,1,9258,[313 127 187 302 483],474,5,33586,3.6273895669078735,20.0,20.0
19259,1,9259,[187 286  28 228  82],488,3,33589,3.6273218142548598,0.0,0.0
19260,1,9260,[ 71 238 222 678 265],488,2,33591,3.627146096533852,0.0,0.0
19261,1,9261,[  4 196  98 172 655],7,5,33596,3.627294320881019,0.0,20.0
19262,1,9262,[173  25  88 265  95],892,5,33601,3.6274425132246573,0.0,0.0
19263,1,9263,[ 96 135 258 357 508],653,3,33604,3.6273747841105353,20.0,0.0
19264,1,9264,[200 211 301 179 385],650,3,33607,3.6273070696168377,0.0,0.0
19265,1,9265,[ 28  12 245 179 132],378,3,33610,3.62723936973883,20.0,0.0
19266,1,9266,[216 125 197  22 496],378,2,33612,3.627063774684364,0.0,0.0
19267,1,9267,[313 127 187 302 483],537,5,33617,3.6272119119551145,20.0,20.0
19268,1,9268,[235 168  28 204 496],125,4,33621,3.627252130758442,0.0,0.0
19269,1,9269,[ 96 200 471 568 273],374,4,33625,3.627292340884574,0.0,0.0
19270,1,9270,[546 197 215 172 179],479,2,33627,3.6271168158774674,0.0,0.0
19271,1,9271,[121 435 181 258 302],102,1,33628,3.626833477135462,0.0,0.0
19272,1,9272,[318 323  70 187   1],648,2,33630,3.626658039469427,20.0,0.0
19273,1,9273,[187 288 603 173 183],315,3,33633,3.626590467974984,20.0,0.0
19274,1,9274,[245 125  64 151 161],804,4,33637,3.6266307277628034,0.0,0.0
19275,1,9275,[ 98  28  82 300 228],455,5,33642,3.6267787839586028,0.0,20.0
19276,1,9276,[496 302 186 597 385],378,2,33644,3.6266034278322734,0.0,0.0
19277,1,9277,[ 79 180  95 403   4],648,2,33646,3.6264281095063593,0.0,0.0
19278,1,9278,[183 237 271 300 276],144,2,33648,3.6262528289686387,0.0,0.0
19279,1,9279,[ 22 603  12  11 228],883,3,33651,3.626185344827586,40.0,0.0
19280,1,9280,[ 12 237 515 302 127],883,4,33655,3.626225622238983,20.0,20.0
19281,1,9281,[180  69 179 238 204],85,4,33659,3.6262658909717733,0.0,0.0
19282,1,9282,[471 202 216 265  71],815,3,33662,3.6261984272325756,0.0,0.0
19283,1,9283,[313 127 187 302 603],334,5,33667,3.626346402412753,20.0,20.0
19284,1,9284,[313 127 187 302 603],13,5,33672,3.6264943457189016,20.0,20.0
19285,1,9285,[302 194 322  96 742],788,3,33675,3.6264268791729486,0.0,0.0
19286,1,9286,[427  56 216 275  12],406,3,33678,3.62635942715624,20.0,0.0
19287,1,9287,[742 191  89 245 748],92,3,33681,3.626291989664083,0.0,0.0
19288,1,9288,[313 127 187 302 603],13,5,33686,3.626439875121111,20.0,20.0
19289,1,9289,[313 127 187 302 603],474,5,33691,3.6265877287405814,20.0,20.0
19290,1,9290,[ 70 405 237 202 181],42,4,33695,3.6266279194919813,0.0,0.0
19291,1,9291,[405 196  64 187   7],379,4,33699,3.626668101592768,0.0,0.0
19292,1,9292,[  4 427 211 127 175],385,3,33702,3.626600667168837,0.0,20.0
19293,1,9293,[  4 237 427 185  25],59,4,33706,3.6266408435549815,0.0,0.0
19294,1,9294,[234   1 568 228 496],533,4,33710,3.626681011296396,0.0,0.0
19295,1,9295,[ 69  22 588   9 191],378,4,33714,3.6267211703958693,0.0,0.0
19296,1,9296,[471 258 222  70 191],537,3,33717,3.626653759277186,0.0,0.0
19297,1,9297,[385 187 742 135 302],788,2,33719,3.626478812647881,0.0,0.0
19298,1,9298,[568  79 153 234 357],85,2,33721,3.626303903645553,20.0,0.0
19299,1,9299,[742 175 161 268 210],92,3,33724,3.626236559139785,0.0,0.0
19300,1,9300,[313 127 187 302 603],271,5,33729,3.6263842597570153,20.0,20.0
19301,1,9301,[313 127 187 302 603],116,3,33732,3.626316921092238,20.0,20.0
19302,1,9302,[276 222 678 273 435],13,2,33734,3.6261421046974096,0.0,0.0
19303,1,9303,[313 127 187 302 483],537,5,33739,3.6262897678417887,20.0,20.0
19304,1,9304,[100  82 385 742 179],207,2,33741,3.6261149919398172,0.0,20.0
19305,1,9305,[191 235 427  56 204],313,3,33744,3.626047711154094,0.0,0.0
19306,1,9306,[179 405 273 286 258],13,1,33745,3.625765552809713,0.0,0.0
19307,1,9307,[313 127 187 302 483],13,5,33750,3.625913192952299,20.0,20.0
19308,1,9308,[168 546  88 385 496],42,3,33753,3.6258459555269096,0.0,0.0
19309,1,9309,[333 435   8 191 655],144,4,33757,3.6258861439312566,0.0,0.0
19310,1,9310,[132 187 197 265 300],666,3,33760,3.625818923853507,0.0,0.0
19311,1,9311,[238 597 121 100  25],59,4,33764,3.6258591065292096,0.0,20.0
19312,1,9312,[180 183 483 435 405],406,4,33768,3.6258992805755397,20.0,0.0
19313,1,9313,[197 125   4 603  82],59,4,33772,3.625939445995276,20.0,0.0
19314,1,9314,[ 79 655 435 176   4],102,0,33772,3.6255501878690284,0.0,0.0
19315,1,9315,[ 70 151 237  89  71],788,3,33775,3.625483039931301,0.0,0.0
19316,1,9316,[234 182 153   7 597],13,3,33778,3.625415906407642,0.0,0.0
19317,1,9317,[597 135 655  56 144],92,4,33782,3.625456106460614,0.0,0.0
19318,1,9318,[  4  71 118  97 127],13,5,33787,3.6256036055370746,0.0,20.0
19319,1,9319,[121 655 471 181 191],92,5,33792,3.6257510729613736,0.0,0.0
19320,1,9320,[100 185 181 186 118],313,4,33796,3.625791224117584,0.0,20.0
19321,1,9321,[143 245 288 121 276],458,2,33798,3.6256168204248014,0.0,0.0
19322,1,9322,[258 194 546 222 357],328,2,33800,3.625442454145661,20.0,0.0
19323,1,9323,[313 127 187 302 483],13,5,33805,3.6255898755898754,20.0,20.0
19324,1,9324,[427 496 143 211 202],7,3,33808,3.6255227882037535,0.0,0.0
19325,1,9325,[385 179 211 204 435],60,5,33813,3.625670169418829,0.0,0.0
19326,1,9326,[175 496 288 121  70],64,4,33817,3.625710303420178,0.0,0.0
19327,1,9327,[435 153 215   4 318],648,2,33819,3.6255360205831906,20.0,0.0
19328,1,9328,[  4   8 182  50 228],158,5,33824,3.6256833529853147,0.0,20.0
19329,1,9329,[313 127 187 302 483],90,5,33829,3.6258306538049303,20.0,20.0
19330,1,9330,[182   1 273 161 132],13,3,33832,3.625763583753081,0.0,0.0
19331,1,9331,[  9 273 175 161 135],378,4,33836,3.6258036862408916,0.0,0.0
19332,1,9332,[161 180 153 121  82],932,2,33838,3.6256294867673846,0.0,0.0
19333,1,9333,[211 195 187 174   7],188,3,33841,3.625562459824298,0.0,20.0
19334,1,9334,[216 385 423 172  71],95,5,33846,3.6257096946973753,0.0,0.0
19335,1,9335,[268 174 403 182 313],92,5,33851,3.6258568980291344,0.0,20.0
19336,1,9336,[323   1 175 215   7],59,4,33855,3.625896969047874,0.0,0.0
19337,1,9337,[313 127 187 302 483],90,5,33860,3.6260441207967444,20.0,20.0
19338,1,9338,[ 25  56 173 237 245],378,4,33864,3.6260841631866367,0.0,0.0
19339,1,9339,[125 204 238  71 172],7,5,33869,3.6262312633832976,0.0,0.0
19340,1,9340,[300 185 216 257 496],749,4,33873,3.626271277165186,0.0,0.0
19341,1,9341,[496  95 318   4 234],524,3,33876,3.626204238921002,20.0,0.0
19342,1,9342,[313 127 187 302 483],334,5,33881,3.6263512790324306,20.0,20.0
19343,1,9343,[313 127 187 302 483],90,5,33886,3.626498287671233,20.0,20.0
19344,1,9344,[313 127 187 302 483],334,5,33891,3.626645264847512,20.0,20.0
19345,1,9345,[313 127 187 302 483],474,5,33896,3.6267922105713675,20.0,20.0
19346,1,9346,[174   7 655 313 100],13,4,33900,3.626832138654114,0.0,40.0
19347,1,9347,[483 196 187 318 111],479,5,33905,3.626979032948224,40.0,0.0
19348,1,9348,[180 258 357 655 568],13,3,33908,3.626911969194566,20.0,0.0
19349,1,9349,[313 127 187 302 483],669,4,33912,3.626951871657754,20.0,20.0
19350,1,9350,[222 168 216  79  56],488,4,33916,3.626991765586568,0.0,0.0
19351,1,9351,[313 127 187 302 483],90,5,33921,3.6271385799828915,20.0,20.0
19352,1,9352,[121 286   7 125 748],825,5,33926,3.6272853629851385,0.0,0.0
19353,1,9353,[174 568 228   8 515],881,4,33930,3.627325208466966,0.0,20.0
19354,1,9354,[313 127 187 302 483],207,5,33935,3.627471940138963,20.0,20.0
19355,1,9355,[ 70 603 121  89 202],648,4,33939,3.62751175716118,20.0,0.0
19356,1,9356,[385 234 186 228 496],326,3,33942,3.6274446938121194,0.0,0.0
19357,1,9357,[237  95 269  69 228],64,5,33947,3.6275913656764267,0.0,0.0
19358,1,9358,[100 176 237 153 435],378,5,33952,3.6277380061972435,0.0,20.0
19359,1,9359,[238 187 323  56 269],13,2,33954,3.6275641025641026,0.0,0.0
19360,1,9360,[ 50 197 168 161  79],479,4,33958,3.6276038884734536,0.0,20.0
19361,1,9361,[127 197 222 302  79],474,5,33963,3.627750480666524,0.0,20.0
19362,1,9362,[313 127 187 302 483],474,5,33968,3.627897041546513,20.0,20.0
19363,1,9363,[313 127 187 302 483],334,5,33973,3.6280435711234515,20.0,20.0
19364,1,9364,[655 187   1 172  89],387,4,33977,3.628083288841431,0.0,0.0
19365,1,9365,[183 179 323 568 173],537,2,33979,3.627909459748025,0.0,0.0
19366,1,9366,[742  25 168 357 435],533,4,33983,3.6279491833030852,20.0,0.0
19367,1,9367,[ 71 318 204  95  56],295,5,33988,3.6280956447480786,20.0,0.0
19368,1,9368,[313 127 187 302 483],474,5,33993,3.628242074927954,20.0,20.0
19369,1,9369,[127  25 151 191 204],95,4,33997,3.628281750266809,0.0,20.0
19370,1,9370,[313 127 187 302 483],669,4,34001,3.628321417137979,20.0,20.0
19371,1,9371,[143  64 187 173 202],659,5,34006,3.6284677763551003,0.0,0.0
19372,1,9372,[ 98 215  89 117 423],90,3,34009,3.6284007254881043,0.0,20.0
19373,1,9373,[195 301 132 300 135],537,1,34010,3.6281203328355023,0.0,0.0
19374,1,9374,[313 204   9   4 135],455,4,34014,3.62816,0.0,0.0
19375,1,9375,[117 195 183   8 234],13,3,34017,3.6280930034129693,0.0,0.0
19376,1,9376,[435 294 210 322 237],901,3,34020,3.6280260211154953,0.0,0.0
19377,1,9377,[546 143 234 328 423],533,3,34023,3.627959053103007,0.0,0.0
19378,1,9378,[313 127 187 302 483],669,4,34027,3.6279987205459006,20.0,20.0
19379,1,9379,[ 97 185  69 655 273],59,4,34031,3.628038379530917,0.0,0.0
19380,1,9380,[127 275 300 204 245],455,4,34035,3.628078030060761,0.0,20.0
19381,1,9381,[313 127 187 302 603],13,5,34040,3.6282242592197824,20.0,20.0
19382,1,9382,[196  95 127 111 173],271,5,34045,3.6283704572098476,0.0,20.0
19383,1,9383,[323 196 245 423  64],378,3,34048,3.628303495311168,0.0,0.0
19384,1,9384,[135 194 176 210 265],311,5,34053,3.628449653702717,0.0,0.0
19385,1,9385,[313 127 187 302 603],474,5,34058,3.6285957809503517,20.0,20.0
19386,1,9386,[313 127 187 302 603],537,5,34063,3.6287418770640247,20.0,20.0
19387,1,9387,[196 210  15  69 496],95,5,34068,3.6288879420536855,0.0,0.0
19388,1,9388,[179  22 204 258 655],537,2,34070,3.6287144530833952,0.0,0.0
19389,1,9389,[258 742 678 222  25],486,2,34072,3.6285410010649626,0.0,0.0
19390,1,9390,[  9  97 483 405 204],60,4,34076,3.628580555851347,20.0,0.0
19391,1,9391,[323 191  11  22 238],881,3,34079,3.628513628620102,0.0,0.0
19392,1,9392,[313 127 187 302 603],537,5,34084,3.628659640157564,20.0,20.0
19393,1,9393,[ 50 117 323 151   9],699,2,34086,3.6284862678305303,0.0,20.0
19394,1,9394,[313 127 187 302 603],271,5,34091,3.6286322511974456,20.0,20.0
19395,1,9395,[275 333 678 265 194],537,1,34092,3.628352490421456,0.0,0.0
19396,1,9396,[179  25 210 322   7],13,0,34092,3.6279663722464615,0.0,0.0
19397,1,9397,[  7  82 173 234 265],374,3,34095,3.6278995530964036,0.0,0.0
19398,1,9398,[515   1 483 135 211],804,4,34099,3.627939142461964,20.0,0.0
19399,1,9399,[568  97 174 323 161],455,4,34103,3.6279787234042553,0.0,20.0
19400,1,9400,[313 127 187 302 603],90,5,34108,3.6281246675885543,20.0,20.0
19401,1,9401,[182 234  70  50 174],64,5,34113,3.628270580727505,0.0,40.0
19402,1,9402,[121 153 210 276 186],334,2,34115,3.6280974157183876,0.0,0.0
19403,1,9403,[173 121 211  56  71],279,4,34119,3.6281369629944704,0.0,0.0
19404,1,9404,[313 127 187 302 603],334,5,34124,3.628282828282828,20.0,20.0
19405,1,9405,[313 127 187 302 603],669,5,34129,3.6284286625558155,20.0,20.0
19406,1,9406,[475 179 204 322 168],537,3,34132,3.628361858190709,0.0,0.0
19407,1,9407,[127 483 294 234 603],7,4,34136,3.628401360544218,40.0,20.0
19408,1,9408,[ 71  96 161   9  50],378,5,34141,3.628547135721118,0.0,20.0
19409,1,9409,[215   1 187 176 191],64,5,34146,3.628692879914984,0.0,0.0
19410,1,9410,[216 275 181 427 186],899,4,34150,3.6287323345021782,0.0,0.0
19411,1,9411,[ 50 172   7 603 265],474,5,34155,3.6288780280492987,20.0,20.0
19412,1,9412,[ 79  12 175 405 127],385,2,34157,3.6287049824710507,20.0,20.0
19413,1,9413,[ 28 132 183 204 153],7,5,34162,3.628850647971107,0.0,0.0
19414,1,9414,[282 483 202   1 176],447,3,34165,3.628783855549655,20.0,0.0
19415,1,9415,[313 127 187 302 603],116,3,34168,3.628717077315208,20.0,20.0
19416,1,9416,[228 127  98  22 385],738,4,34172,3.6287565041945418,0.0,40.0
19417,1,9417,[186 100 185 121 176],189,3,34175,3.6286897430452325,0.0,20.0
19418,1,9418,[313 127 187 302 191],90,5,34180,3.628835332837881,0.0,20.0
19419,1,9419,[294 427 180 210 268],13,3,34183,3.628768577494692,0.0,0.0
19420,1,9420,[313 127 187 302 191],207,5,34188,3.628914128011888,0.0,20.0
19421,1,9421,[313 127 187 302 191],474,5,34193,3.629059647633199,0.0,20.0
19422,1,9422,[237 174 216 161   7],474,5,34198,3.6292051363684603,0.0,20.0
19423,1,9423,[568 174 202  98 125],533,5,34203,3.629350594227504,0.0,40.0
19424,1,9424,[238 182 111 197  22],833,1,34204,3.6290716180371354,0.0,0.0
19425,1,9425,[313 127 187 302 191],90,5,34209,3.629217059197963,0.0,20.0
19426,1,9426,[313 127 187 302 191],13,4,34213,3.629256391216718,0.0,20.0
19427,1,9427,[313 127 187 302 603],13,5,34218,3.6294017819261772,20.0,20.0
19428,1,9428,[187  88 168  15 357],311,5,34223,3.629547141796585,20.0,0.0
19429,1,9429,[496 117 546 385 294],533,4,34227,3.6295864262990456,0.0,0.0
19430,1,9430,[405   7 176 271 210],738,3,34230,3.6295196691761213,0.0,0.0
19431,1,9431,[313 127 187 302 603],90,5,34235,3.6296649703138253,20.0,20.0
19432,1,9432,[318 568 191 151 186],648,3,34238,3.62959821901834,20.0,0.0
19433,1,9433,[200  22 333 405 197],488,2,34240,3.6294254822980707,0.0,0.0
19434,1,9434,[180 568 194 161 195],901,4,34244,3.6294647588765234,0.0,0.0
19435,1,9435,[185  56 234 475 286],213,4,34248,3.6295040271301398,0.0,0.0
19436,1,9436,[182 210   9 143 275],474,4,34252,3.629543287061566,0.0,0.0
19437,1,9437,[194  96 300 117 238],378,3,34255,3.6294765840220387,0.0,0.0
19438,1,9438,[ 96 483  28 168 603],13,5,34260,3.629621781968429,40.0,0.0
19439,1,9439,[215 175 151 603 483],815,3,34263,3.6295550847457627,40.0,0.0
19440,1,9440,[187 216 172 286  50],334,3,34266,3.629488401652367,0.0,20.0
19441,1,9441,[196 121 183   7  28],334,3,34269,3.6294217326837535,0.0,0.0
19442,1,9442,[168 276  22 185 258],474,4,34273,3.6294609763846237,0.0,0.0
19443,1,9443,[183 273 210 427 228],13,3,34276,3.629394324438797,0.0,0.0
19444,1,9444,[  1 403 204 121 273],13,2,34278,3.629221810481736,0.0,0.0
19445,1,9445,[ 64 322 289 181 186],328,4,34282,3.6292610628837605,0.0,0.0
19446,1,9446,[174 228 471 515  12],537,1,34283,3.6289827458452417,20.0,20.0
19447,1,9447,[403  89 202 161 100],313,4,34287,3.629022015241321,0.0,20.0
19448,1,9448,[258 161   9 174 186],378,4,34291,3.629061276325537,0.0,20.0
19449,1,9449,[423 161 183 568 186],339,2,34293,3.628888888888889,0.0,0.0
19450,1,9450,[403 211 301 286 204],318,3,34296,3.628822346841604,0.0,0.0
19451,1,9451,[ 95  69 322  15 183],537,0,34296,3.628438425730004,0.0,0.0
19452,1,9452,[748  15 234 183 238],474,4,34300,3.6284777319369512,0.0,0.0
19453,1,9453,[313 127 187 302 483],90,5,34305,3.6286228051618363,20.0,20.0
19454,1,9454,[300 151  88 496 258],234,1,34306,3.6283447911158118,0.0,0.0
19455,1,9455,[313 127 187 302 483],474,5,34311,3.628489847715736,20.0,20.0
19456,1,9456,[288  12   8 655 204],234,1,34312,3.628211906524268,20.0,0.0
19457,1,9457,[ 96 271 405 257  88],749,3,34315,3.6281454853034467,0.0,0.0
19458,1,9458,[216 195  64  12 588],194,3,34318,3.628079078126652,20.0,0.0
19459,1,9459,[655   9 118 471 405],13,2,34320,3.627906976744186,0.0,0.0
19460,1,9460,[183 483 200 118   4],374,3,34323,3.627840608815136,20.0,0.0
19461,1,9461,[288 742 301 328 245],334,0,34323,3.627457197209892,0.0,0.0
19462,1,9462,[313 127 187 302 191],334,5,34328,3.627602240304343,0.0,20.0
19463,1,9463,[313 127 187 302 191],116,4,34332,3.6276415891800506,0.0,20.0
19464,1,9464,[313 127 187 302 191],271,5,34337,3.627786582144744,0.0,20.0
19465,1,9465,[ 25  15  96 168 195],77,2,34339,3.62761462074794,0.0,0.0
19466,1,9466,[ 79 655 385   8 318],207,3,34342,3.6275483257631773,20.0,0.0
19467,1,9467,[196 546 435 118 483],13,4,34346,3.6275876637093365,20.0,0.0
19468,1,9468,[313 127 187 302 191],474,5,34351,3.627732601119442,0.0,20.0
19469,1,9469,[  8 483 151 238 234],479,5,34356,3.6278775079197465,20.0,0.0
19470,1,9470,[125 597 183 568 196],207,3,34359,3.627811213177067,0.0,0.0
19471,1,9471,[ 12 185  50 179 132],380,4,34363,3.6278505067567566,20.0,20.0
19472,1,9472,[357 191 238 210  96],14,4,34367,3.6278897920405364,20.0,0.0
19473,1,9473,[313 127 187 302 191],537,5,34372,3.6280346210681866,0.0,20.0
19474,1,9474,[603 273 132 194  22],7,4,34376,3.6280738786279683,20.0,0.0
19475,1,9475,[237 204 121 435 258],447,5,34381,3.6282186576614603,0.0,0.0
19476,1,9476,[180 234 286 215 111],234,1,34382,3.6279413316450353,0.0,0.0
19477,1,9477,[313 127 187 302 191],271,5,34387,3.628086094112682,0.0,20.0
19478,1,9478,[568 195 655  97 423],308,4,34391,3.628125329676126,0.0,0.0
19479,1,9479,[238 403 276  28   7],881,3,34394,3.628059071729958,0.0,0.0
19480,1,9480,[273 385  70 176 161],7,1,34395,3.627781879548571,0.0,0.0
19481,1,9481,[313 127 187 302 191],90,5,34400,3.627926597764185,0.0,20.0
19482,1,9482,[200  15 568 173 191],488,2,34402,3.6277549298745124,0.0,0.0
19483,1,9483,[168 127 180 182  50],406,4,34406,3.627794179671025,0.0,40.0
19484,1,9484,[200 515 282 144  64],92,4,34410,3.627833421191355,0.0,0.0
19485,1,9485,[200 288 121 180 301],13,2,34412,3.627661817415138,0.0,0.0
19486,1,9486,[174   7 215  12  69],892,5,34417,3.6278064720143353,20.0,20.0
19487,1,9487,[302   9 182  11  79],328,3,34420,3.6277403035413154,0.0,0.0
19488,1,9488,[ 50 195 135 269 228],650,5,34425,3.6278849193803353,0.0,20.0
19489,1,9489,[ 12 186 183  11 132],346,4,34429,3.6279241306638568,20.0,0.0
19490,1,9490,[313 127 187 302 483],474,5,34434,3.6280686966599935,20.0,20.0
19491,1,9491,[313 127 187 302 483],328,5,34439,3.628213232195533,20.0,20.0
19492,1,9492,[313 127 187 302 483],334,5,34444,3.6283577372801012,20.0,20.0
19493,1,9493,[471  56 258   8 161],271,1,34445,3.6280808931957025,0.0,0.0
19494,1,9494,[228 294 121  11 182],749,2,34447,3.6279094260136913,0.0,0.0
19495,1,9495,[174 597 161 210 385],102,1,34448,3.6276326874473463,0.0,20.0
19496,1,9496,[234 275 182  28 423],454,2,34450,3.6274613035695484,0.0,0.0
19497,1,9497,[222 176 568 118  64],774,1,34451,3.627184670456938,0.0,0.0
19498,1,9498,[313 127 187 302 483],474,5,34456,3.627329192546584,20.0,20.0
19499,1,9499,[186 204 187 172 238],7,5,34461,3.627473684210526,0.0,0.0
19500,1,9500,[ 64  69 258 294   9],271,3,34464,3.6274076413009158,0.0,0.0
19501,1,9501,[ 11  12 127 135 405],406,4,34468,3.6274468532940434,20.0,20.0
19502,1,9502,[323 286  89 588 204],13,3,34471,3.6273808271072294,0.0,0.0
19503,1,9503,[427 202  28 100  22],694,5,34476,3.6275252525252526,0.0,20.0
19504,1,9504,[125 655 588 483 153],815,4,34480,3.627564439768543,20.0,0.0
19505,1,9505,[ 69 546 258 179  97],234,1,34481,3.627288028613507,0.0,0.0
19506,1,9506,[318 144 265 143  88],479,4,34485,3.627327232565478,20.0,0.0
19507,1,9507,[  4 191  98 202 135],379,5,34490,3.6274716028607488,0.0,20.0
19508,1,9508,[181  12 228 289  22],194,2,34492,3.6273004522031758,20.0,0.0
19509,1,9509,[313 127 187 302 483],537,5,34497,3.6274447949526816,20.0,20.0
19510,1,9510,[153 172 742 328 234],749,5,34502,3.627589107349385,0.0,0.0
19511,1,9511,[ 22 191 135 222 215],536,5,34507,3.6277333894028594,0.0,0.0
19512,1,9512,[173 216 483 125  25],406,1,34508,3.627457163881005,20.0,0.0
19513,1,9513,[  4 313  22  25 597],650,1,34509,3.6271809964263193,0.0,0.0
19514,1,9514,[313 127 187 302 483],669,4,34513,3.6272201786652656,20.0,20.0
19515,1,9515,[ 56 258  79  71  25],650,0,34513,3.626839007986549,0.0,0.0
19516,1,9516,[194 268 258 187 211],387,3,34516,3.6267731427971,0.0,0.0
19517,1,9517,[185 269 176 301 127],537,2,34518,3.626602227358689,0.0,20.0
19518,1,9518,[ 70  22 471 194 151],524,3,34521,3.6265364008824457,0.0,0.0
19519,1,9519,[118 435 235  22 271],788,1,34522,3.6262605042016807,0.0,0.0
19520,1,9520,[258   4 265 742 748],328,3,34525,3.626194727444596,0.0,0.0
19521,1,9521,[275 151  95 173 125],899,2,34527,3.6260239445494644,0.0,0.0
19522,1,9522,[313 127 187 302 191],537,5,34532,3.6261682242990654,0.0,20.0
19523,1,9523,[313 127 187 302 191],144,4,34536,3.626207475850483,0.0,20.0
19524,1,9524,[597 127  22  56 403],346,3,34539,3.6261417322834646,0.0,20.0
19525,1,9525,[313 127 187 302 191],271,5,34544,3.626285954230527,0.0,20.0
19526,1,9526,[313 127 187 302 191],116,4,34548,3.6263251810643435,0.0,20.0
19527,1,9527,[313 127 187 302 191],537,5,34553,3.6264693534844668,0.0,20.0
19528,1,9528,[ 88  79 197 475 187],474,5,34558,3.6266134956448735,0.0,0.0
19529,1,9529,[313 127 187 302 191],144,4,34562,3.6266526757607553,0.0,20.0
19530,1,9530,[ 97 183 168 200 135],60,4,34566,3.6266918476550205,0.0,0.0
19531,1,9531,[288 237   1 121 202],308,3,34569,3.626626101552665,0.0,0.0
19532,1,9532,[313 127 187 302 191],271,5,34574,3.6267701667890484,0.0,20.0
19533,1,9533,[175 125 215  56 435],648,1,34575,3.6264946507237257,0.0,0.0
19534,1,9534,[568 181 175 176 313],92,4,34579,3.626533822758259,0.0,0.0
19535,1,9535,[ 69 187 183 237  28],406,2,34581,3.626363255033557,0.0,0.0
19536,1,9536,[175  25 237 403 748],92,3,34584,3.6262975778546713,0.0,0.0
19537,1,9537,[313 127 187 302 191],13,4,34588,3.626336758230237,0.0,20.0
19538,1,9538,[ 82 427   4  98  89],788,2,34590,3.626166264807632,0.0,20.0
19539,1,9539,[151 748 180 183   1],653,3,34593,3.6261006289308177,0.0,0.0
19540,1,9540,[ 82   4 271 515 127],328,3,34596,3.626035006812703,0.0,20.0
19541,1,9541,[ 50 151 228  89 185],843,2,34598,3.625864598616642,0.0,20.0
19542,1,9542,[180   7 204 172   1],537,2,34600,3.6256942261343394,0.0,0.0
19543,1,9543,[181 215 234 172 282],42,5,34605,3.6258382229673094,0.0,0.0
19544,1,9544,[ 56 357 176 143  82],125,3,34608,3.625772655840754,20.0,0.0
19545,1,9545,[313 127 187 302 483],328,5,34613,3.625916614288707,20.0,20.0
19546,1,9546,[135 483 496 475  64],533,3,34616,3.625851052686708,20.0,0.0
19547,1,9547,[ 95   4  25 216 588],378,4,34620,3.6258902387934646,0.0,0.0
19548,1,9548,[ 70 318 276 132  28],537,3,34623,3.6258246936852028,20.0,0.0
19549,1,9549,[ 98 151 318 100 301],788,3,34626,3.625759162303665,20.0,40.0
19550,1,9550,[ 97 121 742 483  69],308,1,34627,3.6254842424876976,20.0,0.0
19551,1,9551,[135 302 435 546   1],271,3,34630,3.6254187604690116,0.0,0.0
19552,1,9552,[ 22  25 435 143  98],533,5,34635,3.62556265047629,0.0,20.0
19553,1,9553,[471   8 333 196 202],298,4,34639,3.6256018421603518,0.0,0.0
19554,1,9554,[496 197 515 475  28],334,3,34642,3.625536368393511,0.0,0.0
19555,1,9555,[313 127 187 302 191],334,5,34647,3.6256802009208875,0.0,20.0
19556,1,9556,[435 323 678  69  70],881,0,34647,3.625300826619232,0.0,0.0
19557,1,9557,[271  15 100 185 200],749,4,34651,3.6253400292948315,0.0,20.0
19558,1,9558,[427   4 496 135 173],666,5,34656,3.625483837221467,0.0,0.0
19559,1,9559,[313 127 187 302 191],537,5,34661,3.6256276150627613,0.0,20.0
19560,1,9560,[313 127 187 302 191],144,4,34665,3.6256667712582367,0.0,20.0
19561,1,9561,[  4 423  69 222 515],64,4,34669,3.625705919263752,0.0,0.0
19562,1,9562,[121 405  96 678 182],749,1,34670,3.6254313499947717,0.0,0.0
19563,1,9563,[179 234 111 175 258],13,4,34674,3.625470514429109,0.0,0.0
19564,1,9564,[ 25 238 211  56 301],666,4,34678,3.6255096706743335,0.0,0.0
19565,1,9565,[210 483  64 100  69],452,5,34683,3.625653355634539,20.0,20.0
19566,1,9566,[300 258 328 257 222],145,4,34687,3.6256924845824186,0.0,0.0
19567,1,9567,[168 202 222 195 273],64,4,34691,3.6257316053511706,0.0,0.0
19568,1,9568,[ 71  50 300 496  97],64,2,34693,3.6255617096875326,0.0,20.0
19569,1,9569,[313 127 187 302 191],116,4,34697,3.6256008359456637,0.0,20.0
19570,1,9570,[ 70 132 588 300 100],64,4,34701,3.6256399540277924,0.0,20.0
19571,1,9571,[435 258 748 202  25],125,3,34704,3.6255745925616383,0.0,0.0
19572,1,9572,[215 144   1 237 194],194,3,34707,3.625509244750862,0.0,0.0
19573,1,9573,[313 127 187 302 191],537,5,34712,3.625652809692918,0.0,20.0
19574,1,9574,[403  71  69  88 258],311,5,34717,3.6257963446475197,0.0,0.0
19575,1,9575,[313 127 187 302 191],207,5,34722,3.6259398496240602,0.0,20.0
19576,1,9576,[313 127 187 302 191],90,5,34727,3.6260833246319306,0.0,20.0
19577,1,9577,[313 127 187 302 191],271,5,34732,3.626226769680518,0.0,20.0
19578,1,9578,[313 127 187 302 191],116,4,34736,3.626265789748408,0.0,20.0
19579,1,9579,[245 405 655 237  28],334,2,34738,3.6260960334029226,0.0,0.0
19580,1,9580,[313 127 187 302 191],90,5,34743,3.6262394322095814,0.0,20.0
19581,1,9581,[ 89 143 183  69 357],13,3,34746,3.6261740763932373,20.0,0.0
19582,1,9582,[222 176 237 423 153],343,5,34751,3.626317437128248,0.0,0.0
19583,1,9583,[313 127 187 302 191],537,5,34756,3.6264607679465777,0.0,20.0
19584,1,9584,[211 216 143 135  12],385,0,34756,3.6260824204486175,20.0,0.0
19585,1,9585,[313 127 187 302 191],271,5,34761,3.6262257458794074,0.0,20.0
19586,1,9586,[313 127 187 302 191],271,5,34766,3.626369041410243,0.0,20.0
19587,1,9587,[186 185 173 180 423],659,4,34770,3.626408010012516,0.0,0.0
19588,1,9588,[ 88 235 187   7 185],406,3,34773,3.62634268432579,0.0,0.0
19589,1,9589,[127 228  88   4 181],537,1,34774,3.62606882168926,0.0,20.0
19590,1,9590,[273 127 322 427 318],374,2,34776,3.6258992805755397,20.0,20.0
19591,1,9591,[202 200 174 238  50],738,4,34780,3.625938281901585,0.0,40.0
19592,1,9592,[ 96  88 471 176 118],308,3,34783,3.6258730324194723,0.0,0.0
19593,1,9593,[151 427 210  89 471],537,2,34785,3.625703564727955,0.0,0.0
19594,1,9594,[182 200  70 546 271],788,2,34787,3.6255341323606043,0.0,0.0
19595,1,9595,[313 127 187 302 191],474,5,34792,3.625677365568987,0.0,20.0
19596,1,9596,[313 127 187 302 191],474,5,34797,3.62582056892779,0.0,20.0
19597,1,9597,[ 50   1   7 127 313],144,4,34801,3.6258595540737653,0.0,40.0
19598,1,9598,[ 89 216 132 403  15],311,5,34806,3.6260027086154807,0.0,0.0
19599,1,9599,[546 153 210 357 180],60,4,34810,3.6260416666666666,20.0,0.0
19600,1,9600,[100 183  70  64  96],59,4,34814,3.626080616602437,0.0,20.0
19601,1,9601,[183  96 187 127 194],648,3,34817,3.62601541345553,0.0,20.0
19602,1,9602,[313 127 187 302 191],334,5,34822,3.626158492137874,0.0,20.0
19603,1,9603,[313 127 187 302 191],144,4,34826,3.626197417742607,0.0,20.0
19604,1,9604,[313 127 187 302 191],537,5,34831,3.626340447683498,0.0,20.0
19605,1,9605,[ 22 423 135 238  97],694,4,34835,3.626379346241932,0.0,0.0
19606,1,9606,[313 127 187 302 191],90,5,34840,3.6265223274695533,0.0,20.0
19607,1,9607,[313 127 187 302 191],537,5,34845,3.6266652789342215,0.0,20.0
19608,1,9608,[313 127 187 302 191],537,5,34850,3.6268082006452285,0.0,20.0
19609,1,9609,[313 127 187 302 191],334,5,34855,3.6269510926118627,0.0,20.0
19610,1,9610,[405 678   4 172 161],334,0,34855,3.6265737176152326,0.0,0.0
19611,1,9611,[  7 357  96 276  70],14,3,34858,3.626508531002913,20.0,0.0
19612,1,9612,[ 97 742 168 300 222],488,5,34863,3.6266514095495683,0.0,0.0
19613,1,9613,[  8 748 268 568 655],92,3,34866,3.626586228416892,0.0,0.0
19614,1,9614,[234 508 172 100 435],144,5,34871,3.6267290691627667,0.0,20.0
19615,1,9615,[258 234  89 172 471],454,1,34872,3.6264559068219633,0.0,0.0
19616,1,9616,[313 127 187 302 191],13,4,34876,3.626494748882188,0.0,20.0
19617,1,9617,[313 127 187 302 191],271,5,34881,3.626637554585153,0.0,20.0
19618,1,9618,[ 70 238 111   1 180],648,2,34883,3.626468447863603,0.0,0.0
19619,1,9619,[  1 179  28 195   9],815,4,34887,3.6265072765072763,0.0,0.0
19620,1,9620,[  1 200 197 405 515],343,4,34891,3.6265460970793058,0.0,0.0
19621,1,9621,[ 56 125  89 282  64],271,1,34892,3.6262731240906256,0.0,0.0
19622,1,9622,[313 127 187 302 191],13,4,34896,3.626311960926946,0.0,20.0
19623,1,9623,[475   4 168  98 185],308,4,34900,3.6263507896924354,0.0,20.0
19624,1,9624,[313 127 187 302 191],537,5,34905,3.6264935064935067,0.0,20.0
19625,1,9625,[ 95 496 322 471 318],454,2,34907,3.6263245377103677,20.0,0.0
19626,1,9626,[234 215 471 237  56],271,3,34910,3.626259478549912,0.0,0.0
19627,1,9627,[125  50 357 318 196],263,5,34915,3.6264021603656005,40.0,20.0
19628,1,9628,[211 286 210 234 186],452,2,34917,3.626233253712743,0.0,0.0
19629,1,9629,[ 64  82 546 235  50],524,3,34920,3.6261682242990654,0.0,20.0
19630,1,9630,[ 15 161 405 357 168],95,3,34923,3.6261032083895754,20.0,0.0
19631,1,9631,[423 181 748 328 216],313,4,34927,3.6261420265780733,0.0,0.0
19632,1,9632,[258  11 181 496 125],271,3,34930,3.6260770268867435,0.0,0.0
19633,1,9633,[183  79 204 151  56],334,5,34935,3.626219638779323,0.0,0.0
19634,1,9634,[313 127 187 302 191],669,4,34939,3.626258432797094,0.0,20.0
19635,1,9635,[313 127 187 302 603],669,5,34944,3.62640099626401,20.0,20.0
19636,1,9636,[111 168 515 197  28],488,4,34948,3.62643976341185,0.0,0.0
19637,1,9637,[313 127 187 302 603],474,5,34953,3.6265822784810124,20.0,20.0
19638,1,9638,[597 179 121  22 211],59,4,34957,3.6266210187778816,0.0,0.0
19639,1,9639,[483 195 215 151 742],95,4,34961,3.6266597510373444,20.0,0.0
19640,1,9640,[237 121  79 282  89],804,5,34966,3.6268021989420185,0.0,0.0
19641,1,9641,[185 655 678 168  89],334,4,34970,3.626840904376685,0.0,0.0
19642,1,9642,[ 11 144 385 405 153],7,3,34973,3.626775899616302,0.0,0.0
19643,1,9643,[ 22 175 100 204 187],788,3,34976,3.62671090833679,0.0,20.0
19644,1,9644,[121  12  69 403  95],42,4,34980,3.6267496111975115,20.0,0.0
19645,1,9645,[195 200 483 237 196],694,5,34985,3.62689197594858,20.0,0.0
19646,1,9646,[313 161   1 269 588],650,2,34987,3.626723333678864,0.0,0.0
19647,1,9647,[222 200 202 135 403],92,3,34990,3.626658374792703,0.0,0.0
19648,1,9648,[234 173   7 180  15],537,3,34993,3.6265934293709194,0.0,0.0
19649,1,9649,[265 234 515 357 496],313,5,34998,3.6267357512953367,20.0,0.0
19650,1,9650,[313 127 187 302 603],669,5,35003,3.626878043726039,20.0,20.0
19651,1,9651,[121  70 191  69  15],184,2,35005,3.626709490261086,0.0,0.0
19652,1,9652,[568 100  15 153 121],378,5,35010,3.6268517559307987,0.0,20.0
19653,1,9653,[237 546  12 211 222],533,3,35013,3.626786824114357,20.0,0.0
19654,1,9654,[ 89   9 132 191 135],308,4,35017,3.626825479026411,0.0,0.0
19655,1,9655,[ 95 588 288 273 655],64,4,35021,3.626864125932063,0.0,0.0
19656,1,9656,[313 127 187 302 603],334,5,35026,3.627006316661489,20.0,20.0
19657,1,9657,[ 79 191  64  22 302],339,5,35031,3.6271484779457444,0.0,0.0
19658,1,9658,[313 127 187 302 603],669,5,35036,3.6272906097939743,20.0,20.0
19659,1,9659,[185  96 603 187  82],840,2,35038,3.62712215320911,20.0,0.0
19660,1,9660,[313 127 187 302 603],334,5,35043,3.627264258358348,20.0,20.0
19661,1,9661,[483  28  79 235 508],59,4,35047,3.6273028358517907,20.0,0.0
19662,1,9662,[748 185 197 216   7],653,1,35048,3.627030942771396,0.0,0.0
19663,1,9663,[313 127 187 302 603],116,3,35051,3.626966059602649,20.0,20.0
19664,1,9664,[313 127 187 302 191],13,4,35055,3.6270046559751683,0.0,20.0
19665,1,9665,[313 127 187 302 603],334,5,35060,3.627146699772398,20.0,20.0
19666,1,9666,[  1  95 603 195 174],648,4,35064,3.6271852694734665,20.0,20.0
19667,1,9667,[216   1 194  79 196],339,4,35068,3.627223831195697,0.0,0.0
19668,1,9668,[313 127 187 302 603],116,3,35071,3.6271589616299513,20.0,20.0
19669,1,9669,[313 127 187 302 483],474,5,35076,3.627300930713547,20.0,20.0
19670,1,9670,[ 97  11 245  69 100],488,2,35078,3.627132664667563,0.0,20.0
19671,1,9671,[174 118 483 173   9],648,4,35082,3.6271712158808933,20.0,20.0
19672,1,9672,[313 127 187 302 483],207,5,35087,3.6273131396671148,20.0,20.0
19673,1,9673,[313 127 187 302 483],669,4,35091,3.6273516642547032,20.0,20.0
19674,1,9674,[313 127 187 302 483],207,5,35096,3.6274935400516797,20.0,20.0
19675,1,9675,[318 215 258 403 144],328,3,35099,3.6274286895411327,20.0,0.0
19676,1,9676,[ 22 405 228 196 191],533,4,35103,3.6274671902449107,0.0,0.0
19677,1,9677,[300 196 237   7 172],7,5,35108,3.627609010126059,0.0,0.0
19678,1,9678,[313 127 187 302 483],13,5,35113,3.627750800702552,20.0,20.0
19679,1,9679,[197 496 174 258 127],271,4,35117,3.627789256198347,0.0,40.0
19680,1,9680,[235 597 271 191  50],833,3,35120,3.6277244086354714,0.0,20.0
19681,1,9681,[603  12 121 302 143],458,4,35124,3.6277628589134476,40.0,0.0
19682,1,9682,[313 127 187 302 483],90,5,35129,3.6279045750284005,20.0,20.0
19683,1,9683,[210 435 121  97 118],194,1,35130,3.627633209417596,0.0,0.0
19684,1,9684,[405  97   4 191 234],343,4,35134,3.6276716572018586,0.0,0.0
19685,1,9685,[313 127 187 302 191],334,5,35139,3.6278133388395624,0.0,20.0
19686,1,9686,[313 127 187 302 191],474,5,35144,3.6279549912253537,0.0,20.0
19687,1,9687,[271 318 475 100  64],144,3,35147,3.6278901734104045,20.0,20.0
19688,1,9688,[ 15 508 144   8 742],144,5,35152,3.628031788626277,0.0,0.0
19689,1,9689,[211 195 175 185 161],194,3,35155,3.6279669762641897,0.0,0.0
19690,1,9690,[313 127 187 302 191],13,4,35159,3.6280053658033227,0.0,20.0
19691,1,9691,[237 238 173  22 313],334,5,35164,3.628146925299216,0.0,0.0
19692,1,9692,[275 427  22  82 318],343,5,35169,3.628288455586506,20.0,0.0
19693,1,9693,[313 127 187 302 483],90,5,35174,3.6284299566742315,20.0,20.0
19694,1,9694,[174   4  15  64 211],318,4,35178,3.6284682826199073,0.0,20.0
19695,1,9695,[318 194 182   8 302],207,3,35181,3.6284034653465347,20.0,0.0
19696,1,9696,[132 180 471 168 475],537,3,35184,3.628338661441683,0.0,0.0
19697,1,9697,[313 127 187 302 483],13,5,35189,3.6284800989894825,20.0,20.0
19698,1,9698,[176   1 435 204 195],263,5,35194,3.628621507371894,0.0,0.0
19699,1,9699,[181  88  50 435   1],194,2,35196,3.6284536082474226,0.0,20.0
19700,1,9700,[333 216 185 271 302],13,1,35197,3.62818266158128,0.0,0.0
19701,1,9701,[313 127 187 302 483],474,5,35202,3.6283240568954853,20.0,20.0
19702,1,9702,[127 197 269 168 172],271,4,35206,3.628362362156034,0.0,20.0
19703,1,9703,[423 405  22 168  97],537,1,35207,3.628091508656224,0.0,0.0
19704,1,9704,[  7  50 100 194 161],158,4,35211,3.628129829984544,0.0,40.0
19705,1,9705,[216 135 742 215 435],271,4,35215,3.6281681434164432,0.0,0.0
19706,1,9706,[423 161 234 117 294],650,2,35217,3.628000412073761,0.0,0.0
19707,1,9707,[748 228 121 172 191],92,4,35221,3.6280387309435516,0.0,0.0
19708,1,9708,[ 22 313   7  70 471],144,4,35225,3.6280770419198682,0.0,0.0
19709,1,9709,[435 174 228  71 204],290,4,35229,3.6281153450051495,0.0,20.0
19710,1,9710,[ 25 294 273 237 742],92,2,35231,3.627947688188652,0.0,0.0
19711,1,9711,[ 79 181  70 172  97],378,5,35236,3.6280889621087313,0.0,0.0
19712,1,9712,[211 191 222  12 186],311,3,35239,3.6280242973334706,20.0,0.0
19713,1,9713,[135 276 546  50 215],881,3,35242,3.6279596458719374,0.0,20.0
19714,1,9714,[176 196 210 135 202],749,5,35247,3.6281008749356665,0.0,0.0
19715,1,9715,[ 64  98 357 546 588],42,4,35251,3.628139151914368,20.0,20.0
19716,1,9716,[ 22  56 180  69 568],749,4,35255,3.6281774210147164,0.0,0.0
19717,1,9717,[100 294 323 265 228],374,3,35258,3.6281127804074913,0.0,20.0
19718,1,9718,[294 597 180 385   1],804,4,35262,3.6281510443461262,0.0,0.0
19719,1,9719,[ 25 546 273  11 258],749,4,35266,3.6281893004115227,0.0,0.0
19720,1,9720,[195 202  64 194 282],533,5,35271,3.6283304186812058,0.0,0.0
19721,1,9721,[211  69 234 300 276],210,5,35276,3.6284715079201812,0.0,0.0
19722,1,9722,[211 322 515 100 275],883,5,35281,3.628612568137406,0.0,20.0
19723,1,9723,[187 423  79 121 211],64,4,35285,3.628650761003702,0.0,0.0
19724,1,9724,[216 403 195 588 132],881,2,35287,3.6284832904884317,0.0,0.0
19725,1,9725,[238 135  28 180 187],474,5,35292,3.6286243059839607,0.0,0.0
19726,1,9726,[176   1 172 204 258],533,4,35296,3.6286624858640897,0.0,0.0
19727,1,9727,[100 427 301 121 195],666,3,35299,3.6285978618421053,0.0,20.0
19728,1,9728,[200 286  12  25   4],474,4,35303,3.6286360365916335,20.0,0.0
19729,1,9729,[313 127 187 302 483],328,5,35308,3.628776978417266,20.0,20.0
19730,1,9730,[191 286  70 435 161],648,2,35310,3.628609598191347,0.0,0.0
19731,1,9731,[313 127 187 302 483],13,5,35315,3.6287505137690093,20.0,20.0
19732,1,9732,[ 98   7   8  96 222],474,5,35320,3.6288914003904242,0.0,20.0
19733,1,9733,[313 127 187 302 483],474,5,35325,3.629032258064516,20.0,20.0
19734,1,9734,[204 323 588 302 100],537,2,35327,3.628864920390344,0.0,20.0
19735,1,9735,[318 483  64  82 100],524,4,35331,3.6289030402629416,40.0,20.0
19736,1,9736,[546 222 111   9 121],119,5,35336,3.629043853342919,0.0,0.0
19737,1,9737,[172 546  88 427 186],308,4,35340,3.6290819470117066,0.0,0.0
19738,1,9738,[  8 288  22 515  56],387,4,35344,3.629120032857583,0.0,0.0
19739,1,9739,[313 127 187 302 483],537,5,35349,3.629260780287474,20.0,20.0
19740,1,9740,[423 215 328 237  89],788,4,35353,3.62929883995483,0.0,0.0
19741,1,9741,[211 403  22   4 135],883,4,35357,3.6293368918086637,0.0,0.0
19742,1,9742,[179 182  11 423 742],749,4,35361,3.6293749358513803,0.0,0.0
19743,1,9743,[496 200 174 238  15],749,4,35365,3.629412972085386,0.0,20.0
19744,1,9744,[471 323  50 318 222],374,2,35367,3.6292457670600307,20.0,20.0
19745,1,9745,[313 127 187 302 483],328,5,35372,3.629386414939462,20.0,20.0
19746,1,9746,[313 127 187 302 483],90,5,35377,3.629527033959167,20.0,20.0
19747,1,9747,[ 28 168 235 318  56],82,2,35379,3.6293598686910133,20.0,0.0
19748,1,9748,[ 96 118 195 273 655],102,1,35380,3.6290901630936507,0.0,0.0
19749,1,9749,[313 127 187 302 483],90,5,35385,3.629230769230769,20.0,20.0
19750,1,9750,[ 28  95 117  25 238],194,2,35387,3.629063685775818,0.0,0.0
19751,1,9751,[172 333  98 182 121],64,3,35390,3.6289991796554553,0.0,20.0
19752,1,9752,[210 294 196 127  50],452,4,35394,3.629037219317133,0.0,40.0
19753,1,9753,[ 96 215 175  88 194],313,4,35398,3.6290752511790036,0.0,0.0
19754,1,9754,[ 28 405 222  25 210],897,4,35402,3.6291132752434647,0.0,0.0
19755,1,9755,[ 71  50 237  82 182],749,3,35405,3.629048790487905,0.0,20.0
19756,1,9756,[ 96 423 168 294 127],95,4,35409,3.629086809470124,0.0,20.0
19757,1,9757,[ 89   4 121 186  69],653,4,35413,3.629124820659971,0.0,0.0
19758,1,9758,[471 235 258  69 100],343,5,35418,3.6292652935751613,0.0,20.0
19759,1,9759,[313 127 187 302 483],207,5,35423,3.629405737704918,20.0,20.0
19760,1,9760,[186 597 403 153 215],328,1,35424,3.6291363589796126,0.0,0.0
19761,1,9761,[ 11 183 237   4 100],666,4,35428,3.629174349518541,0.0,20.0
19762,1,9762,[603 210 546 187 323],804,4,35432,3.6292123322749155,20.0,0.0
19763,1,9763,[313 127 187 302 483],13,5,35437,3.6293527242933226,20.0,20.0
19764,1,9764,[322 144 172 515 196],488,1,35438,3.629083461341526,0.0,0.0
19765,1,9765,[515 186 258   1 288],387,3,35441,3.629019045668646,0.0,0.0
19766,1,9766,[143 174 200 175 496],804,3,35444,3.628954643186239,0.0,20.0
19767,1,9767,[313 127 187 302 483],207,5,35449,3.6290950040950043,20.0,20.0
19768,1,9768,[496  97 405 211 568],7,4,35453,3.6291329716449994,0.0,0.0
19769,1,9769,[313 127 187 302 483],537,5,35458,3.6292732855680656,20.0,20.0
19770,1,9770,[195  89 471 318  98],815,4,35462,3.6293112271006036,20.0,20.0
19771,1,9771,[313 127 187 302 483],90,5,35467,3.6294514940646745,20.0,20.0
19772,1,9772,[322 200 318  89 269],334,3,35470,3.6293870868719944,20.0,0.0
19773,1,9773,[313 127 187 302 483],334,5,35475,3.629527317372621,20.0,20.0
19774,1,9774,[313 127 187 302 483],207,5,35480,3.6296675191815857,20.0,20.0
19775,1,9775,[313 127 187 302 483],334,5,35485,3.6298076923076925,20.0,20.0
19776,1,9776,[496  56 471  71 222],194,3,35488,3.6297432750332415,0.0,0.0
19777,1,9777,[  7  56 100 288 235],643,5,35493,3.6298834117406424,0.0,20.0
19778,1,9778,[328 202 235 182 132],313,4,35497,3.62992125984252,0.0,0.0
19779,1,9779,[161 168  56   7  79],379,4,35501,3.629959100204499,0.0,0.0
19780,1,9780,[313 127 187 302 483],207,5,35506,3.630099171863818,20.0,20.0
19781,1,9781,[435 294 271 125 174],158,3,35509,3.630034757718258,0.0,20.0
19782,1,9782,[  4 200 483 222 186],13,3,35512,3.629970356741286,20.0,0.0
19783,1,9783,[748 216 588  96 211],64,4,35516,3.6300081766148815,0.0,0.0
19784,1,9784,[568 427 475   7 435],537,3,35519,3.629943791517629,0.0,0.0
19785,1,9785,[313 127 187 302 483],334,5,35524,3.630083793173922,20.0,20.0
19786,1,9786,[176 181 603 121 546],897,4,35528,3.6301215898641055,20.0,0.0
19787,1,9787,[265 132 275 111 179],271,5,35533,3.630261544748672,0.0,0.0
19788,1,9788,[313 127 187 302 483],537,5,35538,3.630401471038921,20.0,20.0
19789,1,9789,[ 98 121 100 111 282],447,4,35542,3.6304392236976506,0.0,40.0
19790,1,9790,[313 127 187 302 483],13,5,35547,3.630579103258094,20.0,20.0
19791,1,9791,[180 143 496 282 174],194,2,35549,3.630412581699346,0.0,20.0
19792,1,9792,[238 313 228 186  95],380,2,35551,3.6302460941488817,0.0,0.0
19793,1,9793,[313 127 187 302 483],13,5,35556,3.630385950581989,20.0,20.0
19794,1,9794,[211 161 275 301 405],524,3,35559,3.630321592649311,0.0,0.0
19795,1,9795,[245  71 117 265  64],533,3,35562,3.630257247856268,0.0,0.0
19796,1,9796,[313 127 187 302 483],537,5,35567,3.630397060324589,20.0,20.0
19797,1,9797,[257 210 603 655  11],840,2,35569,3.630230659318228,20.0,0.0
19798,1,9798,[186   4 187 100 143],318,4,35573,3.6302683947341565,0.0,20.0
19799,1,9799,[118  56  97  25 172],184,2,35575,3.6301020408163267,0.0,0.0
19800,1,9800,[ 71  28 216 143 238],843,0,35575,3.6297316600346905,0.0,0.0
19801,1,9801,[597 182  69  97 153],653,2,35577,3.629565394817384,0.0,0.0
19802,1,9802,[183 423 176 194 117],653,1,35578,3.6292971539324697,0.0,0.0
19803,1,9803,[222 273 204 275 289],554,4,35582,3.6293349653202776,0.0,0.0
19804,1,9804,[180 237 118 174  11],447,5,35587,3.6294747577766446,0.0,20.0
19805,1,9805,[  9 168 496  15 182],749,3,35590,3.6294105649602284,0.0,0.0
19806,1,9806,[313 127 187 302 483],328,5,35595,3.6295503211991433,20.0,20.0
19807,1,9807,[313 127 187 302 483],537,5,35600,3.6296900489396413,20.0,20.0
19808,1,9808,[301  50 195  69 151],666,1,35601,3.629421959425018,0.0,20.0
19809,1,9809,[313 127 187 302 483],474,5,35606,3.6295616717635064,20.0,20.0
19810,1,9810,[ 25 313  69  12 191],59,5,35611,3.6297013556212416,20.0,0.0
19811,1,9811,[172 176  97 151 597],788,1,35612,3.629433346922136,0.0,0.0
19812,1,9812,[210 181 173 211 143],882,5,35617,3.629573015387751,0.0,0.0
19813,1,9813,[313 127 187 302 483],328,5,35622,3.629712655390259,20.0,20.0
19814,1,9814,[  4 216 135 294  96],189,5,35627,3.6298522669383595,0.0,0.0
19815,1,9815,[195   9 182 210 294],378,3,35630,3.6297881010594946,0.0,0.0
19816,1,9816,[ 96 174   8 423 185],840,4,35634,3.6298258123663034,0.0,20.0
19817,1,9817,[496   9 182  64  95],234,2,35636,3.6296598085149725,0.0,0.0
19818,1,9818,[313 127 187 302 483],537,5,35641,3.6297993685711374,20.0,20.0
19819,1,9819,[ 96 196 194 273 288],234,1,35642,3.629531568228106,0.0,0.0
19820,1,9820,[427 234  69  12  89],271,4,35646,3.629569290296304,20.0,0.0
19821,1,9821,[471 187  11 179 216],271,4,35650,3.629607004683364,0.0,0.0
19822,1,9822,[313 127 187 302 483],474,5,35655,3.629746513285147,20.0,20.0
19823,1,9823,[  7 173 215 202 195],234,0,35655,3.6293770358306188,0.0,0.0
19824,1,9824,[168 194 301 496 175],524,2,35657,3.629211195928753,0.0,0.0
19825,1,9825,[313 127 187 302 483],474,5,35662,3.629350702218604,20.0,20.0
19826,1,9826,[265 175 597 282 228],804,4,35666,3.62938841966012,0.0,0.0
19827,1,9827,[313 127 187 302 483],474,5,35671,3.6295278795278794,20.0,20.0
19828,1,9828,[302 191 271 135 174],537,3,35674,3.6294638315189744,0.0,20.0
19829,1,9829,[111 135 655 132 151],95,3,35677,3.6293997965412004,0.0,0.0
19830,1,9830,[204 191 333 483   7],881,5,35682,3.629539212694538,20.0,0.0
19831,1,9831,[357  95 228 588 172],295,5,35687,3.629678600488202,20.0,0.0
19832,1,9832,[191 216 403 496 215],234,2,35689,3.629512864842876,0.0,0.0
19833,1,9833,[ 70  96 222 328 204],102,1,35690,3.6292454748830587,0.0,0.0
19834,1,9834,[211  50 257 153 483],6,4,35694,3.6292831723436705,20.0,20.0
19835,1,9835,[234 228 238 568 173],643,4,35698,3.629320862139081,0.0,0.0
19836,1,9836,[204  95 301 144  82],102,2,35700,3.629155230253126,0.0,0.0
19837,1,9837,[313 127 187 302 483],207,5,35705,3.629294572067493,20.0,20.0
19838,1,9838,[313 127 187 302 483],334,5,35710,3.6294338855574755,20.0,20.0
19839,1,9839,[  8 117 143 294 323],897,2,35712,3.629268292682927,0.0,0.0
19840,1,9840,[216 238 258 191  71],474,5,35717,3.629407580530434,0.0,0.0
19841,1,9841,[313 127 187 302 483],328,5,35722,3.629546840073156,20.0,20.0
19842,1,9842,[ 15 100  12 186 172],311,3,35725,3.6294828812353956,20.0,20.0
19843,1,9843,[508 515 483 175 271],833,4,35729,3.629520520113775,20.0,0.0
19844,1,9844,[121  95 127 483 117],334,2,35731,3.62935500253936,20.0,20.0
19845,1,9845,[313 127 187 302 483],207,5,35736,3.6294942108470445,20.0,20.0
19846,1,9846,[ 95 568 333 655  88],881,4,35740,3.6295318371077485,0.0,0.0
19847,1,9847,[187 271 258 121 183],788,4,35744,3.6295694557270513,0.0,0.0
19848,1,9848,[222  11 100 183 200],447,3,35747,3.6295055335567064,0.0,20.0
19849,1,9849,[117 301 742 191   1],378,3,35750,3.6294416243654823,0.0,0.0
19850,1,9850,[ 71 257 435 216 238],6,4,35754,3.6294792406862246,0.0,0.0
19851,1,9851,[ 82 273 322 508  96],537,1,35755,3.6292123426715386,0.0,0.0
19852,1,9852,[174 204 357  97 286],780,5,35760,3.6293514665584086,20.0,20.0
19853,1,9853,[273 403  50 475 175],387,3,35763,3.629287598944591,0.0,20.0
19854,1,9854,[273 143 515  11 144],308,2,35765,3.6291222729578894,0.0,0.0
19855,1,9855,[313 127 187 302 483],537,5,35770,3.6292613636363638,20.0,20.0
19856,1,9856,[258 271 276   9 127],26,3,35773,3.629197524601806,0.0,20.0
19857,1,9857,[588 183 161 143 216],313,4,35777,3.6292351389734225,0.0,0.0
19858,1,9858,[403 183 174 210 273],643,3,35780,3.6291713155492444,0.0,20.0
19859,1,9859,[173  28 132  82 161],843,0,35780,3.6288032454361057,0.0,0.0
19860,1,9860,[ 96   7 100 265 245],378,4,35784,3.6288408883480376,0.0,20.0
19861,1,9861,[313 127 187 302 483],207,5,35789,3.628979922936524,20.0,20.0
19862,1,9862,[313 127 187 302 483],537,5,35794,3.629118929331846,20.0,20.0
19863,1,9863,[ 28 127 238  95 181],313,3,35797,3.6290551500405517,0.0,20.0
19864,1,9864,[313 127 187 302 483],537,5,35802,3.6291941206284846,20.0,20.0
19865,1,9865,[403 135 179  64  98],59,5,35807,3.6293330630448004,0.0,20.0
19866,1,9866,[ 22 153 121  50 144],188,4,35811,3.629370629370629,0.0,20.0
19867,1,9867,[313 127 187 302 483],90,5,35816,3.6295095257397647,20.0,20.0
19868,1,9868,[191 187  64 182 195],6,5,35821,3.6296483939608875,0.0,0.0
19869,1,9869,[286 258  25 515 435],650,2,35823,3.629483282674772,0.0,0.0
19870,1,9870,[313 127 187 302 483],328,5,35828,3.6296221254178906,20.0,20.0
19871,1,9871,[313 127 187 302 483],537,5,35833,3.629760940032415,20.0,20.0
19872,1,9872,[186  97 191   4 161],653,3,35836,3.6296971538539453,0.0,0.0
19873,1,9873,[ 70 597 471 403 117],328,2,35838,3.629532104516913,0.0,0.0
19874,1,9874,[ 79 121 191   7 180],308,4,35842,3.6295696202531644,0.0,0.0
19875,1,9875,[475 238 385 302 216],13,1,35843,3.629303361684893,0.0,0.0
19876,1,9876,[211 276  64 588 471],194,3,35846,3.6292396476662954,0.0,0.0
19877,1,9877,[313 127 187 302 483],328,5,35851,3.629378416683539,20.0,20.0
19878,1,9878,[257 655  64 132  25],474,4,35855,3.6294159327867193,0.0,0.0
19879,1,9879,[313 127 187 302 483],334,5,35860,3.6295546558704452,20.0,20.0
19880,1,9880,[204 168  88 258  82],815,4,35864,3.6295921465438723,0.0,0.0
19881,1,9881,[ 70 197 179 210 222],536,2,35866,3.6294272414490996,0.0,0.0
19882,1,9882,[313 127 187 302 483],13,5,35871,3.6295659212789637,20.0,20.0
19883,1,9883,[313 127 187 302 483],474,5,35876,3.6297045730473494,20.0,20.0
19884,1,9884,[588 435 143 161 471],308,3,35879,3.629640870005058,0.0,0.0
19885,1,9885,[ 50 204 238   1 273],749,4,35883,3.629678332996156,0.0,20.0
19886,1,9886,[  4 182  64  89  88],92,4,35887,3.629715788409022,0.0,0.0
19887,1,9887,[313 127 187 302 483],328,5,35892,3.629854368932039,20.0,20.0
19888,1,9888,[313 127 187 302 483],90,5,35897,3.6299929214278492,20.0,20.0
19889,1,9889,[  4 597 215 132 191],13,3,35900,3.629929221435794,0.0,0.0
19890,1,9890,[496 175 288 151 182],346,4,35904,3.629966636336063,0.0,0.0
19891,1,9891,[ 98 161 175 546 234],378,4,35908,3.630004043671654,0.0,20.0
19892,1,9892,[655 100 323  11   9],378,3,35911,3.6299403618720305,0.0,20.0
19893,1,9893,[268  89 204   4 118],92,4,35915,3.629977764301597,0.0,0.0
19894,1,9894,[313 127 187 302 483],328,5,35920,3.6301162203132895,20.0,20.0
19895,1,9895,[234  25 175 385 176],308,4,35924,3.6301535974130963,0.0,0.0
19896,1,9896,[ 25 385 168 191 186],7,4,35928,3.6301909669596846,0.0,0.0
19897,1,9897,[313 127 187 302 483],537,5,35933,3.630329359466559,20.0,20.0
19898,1,9898,[385  12 245 275 333],328,3,35936,3.6302656834023637,20.0,0.0
19899,1,9899,[228 111 435 175  64],749,3,35939,3.63020202020202,0.0,0.0
19900,1,9900,[174  98 161 302  89],833,1,35940,3.62993637006363,0.0,40.0
19901,1,9901,[ 22 435  97 405 187],271,4,35944,3.629973742678247,0.0,0.0
19902,1,9902,[328 127 180 357 172],95,4,35948,3.6300111077451276,20.0,20.0
19903,1,9903,[313 127 187 302 483],90,5,35953,3.6301494345718903,20.0,20.0
19904,1,9904,[ 79 172 179 185 237],374,3,35956,3.6300858152448257,0.0,0.0
19905,1,9905,[ 71 333  98 143 194],298,5,35961,3.6302241066020593,0.0,20.0
19906,1,9906,[  9 100 288 121 385],13,2,35963,3.6300595538508125,0.0,20.0
19907,1,9907,[313 127 187 302 483],90,5,35968,3.63019781994348,20.0,20.0
19908,1,9908,[204 197 546 286 385],378,3,35971,3.6301342214148753,0.0,0.0
19909,1,9909,[216 168 210   7 172],452,4,35975,3.6301715438950555,0.0,0.0
19910,1,9910,[323 125  50 210  15],200,4,35979,3.630208858843709,0.0,20.0
19911,1,9911,[181  98 222 121 597],650,3,35982,3.6301452784503634,0.0,20.0
19912,1,9912,[300 471  22 301 144],234,1,35983,3.6298799556138404,0.0,0.0
19913,1,9913,[313 127 187 302 483],90,5,35988,3.630018156142828,20.0,20.0
19914,1,9914,[117 275   7 742 185],308,4,35992,3.6300554715078164,0.0,0.0
19915,1,9915,[313 127 187 302 483],90,5,35997,3.630193626462283,20.0,20.0
19916,1,9916,[ 96  98  97 211 196],7,5,36002,3.6303317535545023,0.0,20.0
19917,1,9917,[313 127 187 302 483],537,5,36007,3.630469852792902,20.0,20.0
19918,1,9918,[168 202  97 194 288],82,4,36011,3.6305071075713276,0.0,0.0
19919,1,9919,[175 183 125 313  71],234,2,36013,3.630342741935484,0.0,0.0
19920,1,9920,[237 185 515 546 210],234,1,36014,3.630077613143836,0.0,0.0
19921,1,9921,[187 313 111 471 174],13,4,36018,3.630114896190284,0.0,20.0
19922,1,9922,[313 127 187 302 483],669,4,36022,3.6301521717222616,20.0,20.0
19923,1,9923,[228 172 515  15 300],892,4,36026,3.6301894397420393,0.0,0.0
19924,1,9924,[313 127 187 302 483],90,5,36031,3.6303274559193954,20.0,20.0
19925,1,9925,[313 127 187 302 483],207,5,36036,3.6304654442877293,20.0,20.0
19926,1,9926,[258 271 423 300 496],537,2,36038,3.6303011987508813,0.0,0.0
19927,1,9927,[ 71 496  95 318 357],454,2,36040,3.6301369863013697,40.0,0.0
19928,1,9928,[ 22  64 235 215 202],537,0,36040,3.6297713767751034,0.0,0.0
19929,1,9929,[132  71 125 357 235],406,3,36043,3.629707955689829,20.0,0.0
19930,1,9930,[117 294 204 289  89],95,2,36045,3.6295438525828216,0.0,0.0
19931,1,9931,[313 127 187 302 483],334,5,36050,3.6296818364881194,20.0,20.0
19932,1,9932,[313 127 187 302 483],13,5,36055,3.6298197926104905,20.0,20.0
19933,1,9933,[588 202 222 196 655],406,1,36056,3.6295550634185627,0.0,0.0
19934,1,9934,[196 318 301 216  82],537,1,36057,3.6292903875188727,20.0,0.0
19935,1,9935,[197 228 168   8  28],488,3,36060,3.6292270531400965,0.0,0.0
19936,1,9936,[313 127 187 302 483],537,5,36065,3.62936499949683,20.0,20.0
19937,1,9937,[  1   9  98 187 423],339,4,36069,3.62940229422419,0.0,20.0
19938,1,9938,[603 210  70 289 202],537,2,36071,3.629238353959151,20.0,0.0
19939,1,9939,[313 127 187 302 483],13,5,36076,3.6293762575452715,20.0,20.0
19940,1,9940,[313 127 187 302 483],90,5,36081,3.629514133386983,20.0,20.0
19941,1,9941,[234 204 423 603 196],189,5,36086,3.6296519814926573,20.0,0.0
19942,1,9942,[323  28 546 294 121],83,4,36090,3.6296892286030373,0.0,0.0
19943,1,9943,[313 127 187 302 483],328,5,36095,3.629827031375704,20.0,20.0
19944,1,9944,[111  95 211   4 204],271,5,36100,3.6299648064353947,0.0,0.0
19945,1,9945,[144 288 273 132 237],64,3,36103,3.6299014679268047,0.0,0.0
19946,1,9946,[ 15  28 268  22 655],243,3,36106,3.629838142153413,0.0,0.0
19947,1,9947,[ 64 257   8 215 423],308,4,36110,3.6298753518295133,0.0,0.0
19948,1,9948,[435 483 180  22 174],313,4,36114,3.6299125540255304,20.0,20.0
19949,1,9949,[210 196  28  64 222],119,5,36119,3.6300502512562813,0.0,0.0
19950,1,9950,[313 127 187 302 483],537,5,36124,3.6301879208119785,20.0,20.0
19951,1,9951,[655   1   4 216 678],13,2,36126,3.630024115755627,0.0,0.0
19952,1,9952,[153 125  22 265 496],298,3,36129,3.629960815834422,0.0,0.0
19953,1,9953,[ 11  50 483 195 121],840,3,36132,3.6298975286317057,20.0,20.0
19954,1,9954,[121 471 423 211  12],666,3,36135,3.6298342541436464,20.0,0.0
19955,1,9955,[ 56 423 127 258 328],537,3,36138,3.6297709923664123,0.0,20.0
19956,1,9956,[742 153 151 678 435],447,2,36140,3.6296073114391887,0.0,0.0
19957,1,9957,[333 235 211 286 597],13,1,36141,3.629343241614782,0.0,0.0
19958,1,9958,[179 197 174 403 508],339,4,36145,3.629380459885531,0.0,20.0
19959,1,9959,[313 127 187 302 483],90,5,36150,3.6295180722891565,20.0,20.0
19960,1,9960,[313 127 187 302 483],207,5,36155,3.629655657062544,20.0,20.0
19961,1,9961,[313 127 187 302 483],13,5,36160,3.6297932142140135,20.0,20.0
19962,1,9962,[ 15 144  56 318 182],194,4,36164,3.629830372377798,20.0,0.0
19963,1,9963,[ 95 265 357 168   7],892,5,36169,3.6299678843837815,20.0,0.0
19964,1,9964,[174 655 269 435 423],254,3,36172,3.6299046663321626,0.0,20.0
19965,1,9965,[742 186 318  96 245],488,3,36175,3.6298414609672887,20.0,0.0
19966,1,9966,[313 127 187 302 483],13,5,36180,3.629978930470553,20.0,20.0
19967,1,9967,[ 98  28 222 180 313],13,4,36184,3.630016051364366,0.0,20.0
19968,1,9968,[286 194 202 276  28],271,4,36188,3.630053164810914,0.0,0.0
19969,1,9969,[435   4 302 127 269],13,4,36192,3.6300902708124374,0.0,20.0
19970,1,9970,[313 127 187 302 483],669,4,36196,3.630127369371176,20.0,20.0
19971,1,9971,[313 127 187 302 483],207,5,36201,3.6302647412755715,20.0,20.0
19972,1,9972,[ 82  89 182 302 258],537,4,36205,3.6303018149002306,0.0,0.0
19973,1,9973,[742 161 172  98 508],92,3,36208,3.630238620413074,0.0,20.0
19974,1,9974,[237 483  56  95 173],664,4,36212,3.6302756892230574,20.0,0.0
19975,1,9975,[235  50  89 161 179],339,3,36215,3.630212510024058,0.0,20.0
19976,1,9976,[313 127 187 302 483],334,5,36220,3.630349804550466,20.0,20.0
19977,1,9977,[168 132 405  50 195],840,5,36225,3.6304870715574262,0.0,20.0
19978,1,9978,[143 172   8 357 289],125,4,36229,3.6305241006112836,20.0,0.0
19979,1,9979,[258 204  98 183 423],6,2,36231,3.630360721442886,0.0,20.0
19980,1,9980,[313 127 187 302 483],90,5,36236,3.6304979460975852,20.0,20.0
19981,1,9981,[181 172  89  96  12],115,4,36240,3.6305349629332797,20.0,0.0
19982,1,9982,[405 496 196 300 286],379,3,36243,3.630471802063508,0.0,0.0
19983,1,9983,[603 182 183 135  95],64,4,36247,3.6305088141025643,20.0,0.0
19984,1,9984,[313 127 187 302 483],90,5,36252,3.6306459689534303,20.0,20.0
19985,1,9985,[127 172  70  56 161],87,5,36257,3.6307830963348686,0.0,20.0
19986,1,9986,[313 127 187 302 483],474,5,36262,3.630920196255132,20.0,20.0
19987,1,9987,[313 127 187 302 483],328,5,36267,3.631057268722467,20.0,20.0
19988,1,9988,[313 127 187 302 483],474,5,36272,3.6311943137451195,20.0,20.0
19989,1,9989,[546  50 202 161  82],378,3,36275,3.631131131131131,0.0,20.0
19990,1,9990,[111 403 200  88 235],479,3,36278,3.6310679611650487,0.0,0.0
19991,1,9991,[423 515 405 117 187],334,3,36281,3.6310048038430747,0.0,0.0
19992,1,9992,[313  88 294  98 603],474,4,36285,3.6310417292104473,20.0,20.0
19993,1,9993,[313 127 187 302 483],328,5,36290,3.6311787072243344,20.0,20.0
19994,1,9994,[127 185 176 603 144],234,2,36292,3.631015507753877,20.0,20.0
19995,1,9995,[187 471 286  69  12],213,2,36294,3.6308523409363747,20.0,0.0
19996,1,9996,[300  56 143  11   7],64,4,36298,3.630889266780034,0.0,0.0
19997,1,9997,[313 423  98 318 153],328,4,36302,3.6309261852370476,20.0,20.0
19998,1,9998,[318 237   8 257 117],271,4,36306,3.630963096309631,20.0,0.0
19999,1,9999,[286 288 127 222 168],387,3,36309,3.6309,0.0,20.0
20000,2,0,[655 144 357 265 475],339,3,3,3.0,20.0,0.0
20001,2,1,[423 180 187 222 183],749,3,6,3.0,0.0,0.0
20002,2,2,[546  69 655 179 202],378,1,7,2.3333333333333335,0.0,0.0
20003,2,3,[546  15   7 423 200],455,3,10,2.5,0.0,0.0
20004,2,4,[655 423   7 475 180],527,2,12,2.4,0.0,0.0
20005,2,5,[  7 180 183 357 200],650,4,16,2.6666666666666665,20.0,0.0
20006,2,6,[ 88 215 132 228 182],537,1,17,2.4285714285714284,0.0,0.0
20007,2,7,[143 435 423 173 403],59,4,21,2.625,0.0,0.0
20008,2,8,[  7 100 111 245 603],579,3,24,2.6666666666666665,20.0,20.0
20009,2,9,[483 179  50  89 135],666,4,28,2.8,20.0,20.0
20010,2,10,[294 143  89 216  70],666,2,30,2.727272727272727,0.0,0.0
20011,2,11,[ 70 173 435 403 111],59,4,34,2.8333333333333335,0.0,0.0
20012,2,12,[ 50 515 435 483 132],313,5,39,3.0,20.0,20.0
20013,2,13,[200 135 173 483 182],537,4,43,3.0714285714285716,20.0,0.0
20014,2,14,[172 496   4 180 144],749,5,48,3.2,0.0,0.0
20015,2,15,[204 222 568 117 588],378,3,51,3.1875,0.0,0.0
20016,2,16,[269 496   7 195   9],64,5,56,3.2941176470588234,0.0,0.0
20017,2,17,[  4 182 172  89 515],328,3,59,3.2777777777777777,0.0,0.0
20018,2,18,[ 95  56  88  22 202],881,3,62,3.263157894736842,0.0,0.0
20019,2,19,[435  95 515  89 135],804,2,64,3.2,0.0,0.0
20020,2,20,[  1 405 603 237 211],537,2,66,3.142857142857143,20.0,0.0
20021,2,21,[ 97 273 151 191 161],7,3,69,3.1363636363636362,0.0,0.0
20022,2,22,[265  15 238  79 210],234,0,69,3.0,0.0,0.0
20023,2,23,[ 22  98 655 143 273],308,3,72,3.0,0.0,20.0
20024,2,24,[ 25 515 265 328 175],537,2,74,2.96,0.0,0.0
20025,2,25,[588 357 603  89 151],815,4,78,3.0,40.0,0.0
20026,2,26,[268 194 176 187 234],643,5,83,3.074074074074074,0.0,0.0
20027,2,27,[ 70 183  89 435  12],788,4,87,3.107142857142857,20.0,0.0
20028,2,28,[175 173 234 357   9],474,5,92,3.1724137931034484,20.0,0.0
20029,2,29,[175 173 234 357   9],749,3,95,3.1666666666666665,20.0,0.0
20030,2,30,[172 100 496 183 195],666,3,98,3.161290322580645,0.0,20.0
20031,2,31,[302 515 655 172  79],13,3,101,3.15625,0.0,0.0
20032,2,32,[ 97  12 603  82 357],533,3,104,3.1515151515151514,60.0,0.0
20033,2,33,[153 258  71 471 215],13,4,108,3.176470588235294,0.0,0.0
20034,2,34,[742 546 121 176 185],788,3,111,3.1714285714285713,0.0,0.0
20035,2,35,[ 82 121 176 258  12],64,2,113,3.138888888888889,20.0,0.0
20036,2,36,[194 100 176  12  89],940,4,117,3.1621621621621623,20.0,20.0
20037,2,37,[194 496  12  89 234],524,3,120,3.1578947368421053,20.0,0.0
20038,2,38,[194  71  89 234 269],312,5,125,3.2051282051282053,0.0,0.0
20039,2,39,[328  98 222 194 185],13,2,127,3.175,0.0,20.0
20040,2,40,[211 294 127 121 483],538,3,130,3.1707317073170733,20.0,20.0
20041,2,41,[185 196   1 182 289],13,2,132,3.142857142857143,0.0,0.0
20042,2,42,[483 204  89 194 234],339,4,136,3.1627906976744184,20.0,0.0
20043,2,43,[483 302  89 194 269],524,5,141,3.2045454545454546,20.0,0.0
20044,2,44,[187 186 127  12 496],537,4,145,3.2222222222222223,20.0,20.0
20045,2,45,[194 196  89 483 234],897,3,148,3.217391304347826,20.0,0.0
20046,2,46,[568 288  69  25 183],59,5,153,3.25531914893617,0.0,0.0
20047,2,47,[175 265 238  15 245],92,4,157,3.2708333333333335,0.0,0.0
20048,2,48,[234 153 194  71 588],899,4,161,3.2857142857142856,0.0,0.0
20049,2,49,[182  97 588 655 200],7,5,166,3.32,0.0,0.0
20050,2,50,[234 191 194  71 127],308,4,170,3.3333333333333335,0.0,20.0
20051,2,51,[194 313 153 161  28],64,3,173,3.326923076923077,0.0,0.0
20052,2,52,[183 211 173 176 288],897,4,177,3.339622641509434,0.0,0.0
20053,2,53,[  9 258  25 125  97],234,0,177,3.2777777777777777,0.0,0.0
20054,2,54,[ 64 144 215 257  71],749,4,181,3.290909090909091,0.0,0.0
20055,2,55,[183 211 176 288  64],13,3,184,3.2857142857142856,0.0,0.0
20056,2,56,[ 28 100 238 173 118],554,2,186,3.263157894736842,0.0,20.0
20057,2,57,[ 28 186  89 313  64],653,5,191,3.293103448275862,0.0,0.0
20058,2,58,[197  28 323 211 161],454,3,194,3.288135593220339,0.0,0.0
20059,2,59,[174 423 204  22 135],326,2,196,3.2666666666666666,0.0,20.0
20060,2,60,[ 28 186  89 197 313],474,5,201,3.2950819672131146,0.0,0.0
20061,2,61,[235 153 161 185 186],804,5,206,3.3225806451612905,0.0,0.0
20062,2,62,[127 222 655  28 153],210,5,211,3.3492063492063493,0.0,20.0
20063,2,63,[238  88 237 135 228],234,1,212,3.3125,0.0,0.0
20064,2,64,[ 12  28 288 183  56],234,2,214,3.292307692307692,20.0,0.0
20065,2,65,[ 71 302  89 313 174],543,4,218,3.303030303030303,0.0,20.0
20066,2,66,[ 71 302  89 174 151],474,4,222,3.3134328358208953,0.0,20.0
20067,2,67,[ 71 302  89 174  64],474,5,227,3.338235294117647,0.0,20.0
20068,2,68,[546 196 185 200 235],804,3,230,3.3333333333333335,0.0,0.0
20069,2,69,[ 79 186  96 215  50],64,5,235,3.357142857142857,0.0,20.0
20070,2,70,[546 238  79 603 202],749,3,238,3.352112676056338,20.0,0.0
20071,2,71,[403 144 191 168 427],343,5,243,3.375,0.0,0.0
20072,2,72,[186  22  96 194  89],59,4,247,3.3835616438356166,0.0,0.0
20073,2,73,[ 88 385 357 210 121],892,4,251,3.391891891891892,20.0,0.0
20074,2,74,[174 268 168  22  96],119,5,256,3.4133333333333336,0.0,20.0
20075,2,75,[196  70  88 211 275],918,1,257,3.3815789473684212,0.0,0.0
20076,2,76,[127 302  96  89 275],883,5,262,3.4025974025974026,0.0,20.0
20077,2,77,[183 125  56 127 237],234,2,264,3.3846153846153846,0.0,20.0
20078,2,78,[200 125 202 322 423],804,3,267,3.3797468354430378,0.0,0.0
20079,2,79,[ 22 132  95 568  69],59,4,271,3.3875,0.0,0.0
20080,2,80,[ 97 435 196 403 385],533,3,274,3.382716049382716,0.0,0.0
20081,2,81,[568 216 151 237 161],313,3,277,3.3780487804878048,0.0,0.0
20082,2,82,[121 125 323 238 194],311,4,281,3.3855421686746987,0.0,0.0
20083,2,83,[275  28  89  71 269],279,2,283,3.369047619047619,0.0,0.0
20084,2,84,[118 111  89 269  64],378,4,287,3.376470588235294,0.0,0.0
20085,2,85,[194 216 195  71  79],474,5,292,3.395348837209302,0.0,0.0
20086,2,86,[568 204 357 475  98],13,2,294,3.3793103448275863,20.0,20.0
20087,2,87,[ 70 678 302 238 300],334,2,296,3.3636363636363638,0.0,0.0
20088,2,88,[118 183  89  64 191],833,3,299,3.359550561797753,0.0,0.0
20089,2,89,[197 191 168  22 186],840,4,303,3.3666666666666667,0.0,0.0
20090,2,90,[318  28 475 181 153],409,4,307,3.3736263736263736,20.0,0.0
20091,2,91,[181 302  89 269 322],13,3,310,3.369565217391304,0.0,0.0
20092,2,92,[181 127  89 191 427],385,3,313,3.3655913978494625,0.0,20.0
20093,2,93,[ 79  64   9 245 258],207,4,317,3.372340425531915,0.0,0.0
20094,2,94,[ 56  12 183 135  69],379,5,322,3.389473684210526,20.0,0.0
20095,2,95,[435 168 515 173 235],102,0,322,3.3541666666666665,0.0,0.0
20096,2,96,[ 89  96 302 427 197],90,5,327,3.3711340206185567,0.0,0.0
20097,2,97,[427 483 655 515 286],7,4,331,3.377551020408163,20.0,0.0
20098,2,98,[183 427 286  89 318],664,4,335,3.3838383838383836,20.0,0.0
20099,2,99,[161 318 191 300 211],13,2,337,3.37,20.0,0.0
20100,2,100,[194   7 313 181  22],13,4,341,3.376237623762376,0.0,0.0
20101,2,101,[ 96 197  89 286 127],883,4,345,3.3823529411764706,0.0,20.0
20102,2,102,[268  96 197  89 127],7,4,349,3.3883495145631066,0.0,20.0
20103,2,103,[186 174  96 197  89],488,3,352,3.3846153846153846,0.0,20.0
20104,2,104,[186 174  89 427 127],406,4,356,3.3904761904761904,0.0,40.0
20105,2,105,[183 300 597 234 168],774,1,357,3.3679245283018866,0.0,0.0
20106,2,106,[118 286 655  97 568],7,4,361,3.3738317757009346,0.0,0.0
20107,2,107,[271 176  25 515 300],843,2,363,3.361111111111111,0.0,0.0
20108,2,108,[276 197 210 313 655],537,3,366,3.3577981651376145,0.0,0.0
20109,2,109,[282  97  22  12  11],271,4,370,3.3636363636363638,20.0,0.0
20110,2,110,[ 25 151 132 257 196],339,5,375,3.3783783783783785,0.0,0.0
20111,2,111,[168 265 496 127  98],653,2,377,3.3660714285714284,0.0,40.0
20112,2,112,[276 174 127 302 427],474,5,382,3.3805309734513274,0.0,40.0
20113,2,113,[111 117 357 288 194],537,1,383,3.3596491228070176,20.0,0.0
20114,2,114,[276 174 127 302 427],458,4,387,3.365217391304348,0.0,40.0
20115,2,115,[  8 183 568 588 385],892,4,391,3.3706896551724137,0.0,0.0
20116,2,116,[276  11 127 271 302],13,3,394,3.3675213675213675,0.0,20.0
20117,2,117,[276   8  89 427 302],6,4,398,3.3728813559322033,0.0,0.0
20118,2,118,[302   8 127  89 427],6,5,403,3.3865546218487395,0.0,20.0
20119,2,119,[288  69 161 151 176],804,3,406,3.3833333333333333,0.0,0.0
20120,2,120,[181 143 204 153   7],95,5,411,3.396694214876033,0.0,0.0
20121,2,121,[294 275   7 318   8],378,4,415,3.401639344262295,20.0,0.0
20122,2,122,[161 289  69  12  89],328,5,420,3.4146341463414633,20.0,0.0
20123,2,123,[127 222 187 197 483],360,4,424,3.4193548387096775,20.0,20.0
20124,2,124,[568 257 215 294  79],659,4,428,3.424,0.0,0.0
20125,2,125,[385 271  88 195  97],738,3,431,3.4206349206349205,0.0,0.0
20126,2,126,[196 483 597 174 143],452,4,435,3.425196850393701,20.0,20.0
20127,2,127,[186   4  11 135 143],474,5,440,3.4375,0.0,0.0
20128,2,128,[742 204 385 180 655],788,1,441,3.4186046511627906,0.0,0.0
20129,2,129,[153 117 237 185  15],374,4,445,3.423076923076923,0.0,0.0
20130,2,130,[173 204  89 235  64],194,3,448,3.4198473282442747,0.0,0.0
20131,2,131,[403 313  15 427  71],59,4,452,3.4242424242424243,0.0,0.0
20132,2,132,[300 655 313  82  95],102,1,453,3.406015037593985,0.0,0.0
20133,2,133,[742  96 117  95  88],650,2,455,3.3955223880597014,0.0,0.0
20134,2,134,[127 302   8 427  89],271,4,459,3.4,0.0,20.0
20135,2,135,[127 302   8 427  89],474,5,464,3.411764705882353,0.0,20.0
20136,2,136,[135 483 228 187  64],311,5,469,3.423357664233577,20.0,0.0
20137,2,137,[176 258 269 181 197],738,4,473,3.427536231884058,0.0,0.0
20138,2,138,[ 50 258 318 282 678],92,3,476,3.4244604316546763,20.0,20.0
20139,2,139,[ 71 174 195 357 204],308,5,481,3.4357142857142855,20.0,20.0
20140,2,140,[179 288 322 427 471],308,3,484,3.4326241134751774,0.0,0.0
20141,2,141,[546 195 403 183 180],328,2,486,3.4225352112676055,0.0,0.0
20142,2,142,[302 427   8 127  89],474,5,491,3.4335664335664338,0.0,20.0
20143,2,143,[144 172 288 333 179],64,3,494,3.4305555555555554,0.0,0.0
20144,2,144,[302 427   8 127  89],334,5,499,3.4413793103448276,0.0,20.0
20145,2,145,[183 125 273 313 276],234,2,501,3.4315068493150687,0.0,0.0
20146,2,146,[132  96 151 234 238],653,1,502,3.4149659863945576,0.0,0.0
20147,2,147,[127 302 427   8  89],328,3,505,3.4121621621621623,0.0,20.0
20148,2,148,[127 302  89 427 183],666,5,510,3.422818791946309,0.0,20.0
20149,2,149,[127 302  89 427 183],666,5,515,3.433333333333333,0.0,20.0
20150,2,150,[234  79 172  71  95],60,4,519,3.437086092715232,0.0,0.0
20151,2,151,[ 96 202 187 144 228],648,4,523,3.4407894736842106,0.0,0.0
20152,2,152,[403  96 144 678 546],648,4,527,3.4444444444444446,0.0,0.0
20153,2,153,[196 228 496 179 187],537,3,530,3.4415584415584415,0.0,0.0
20154,2,154,[197 144 748 313 568],64,2,532,3.432258064516129,0.0,0.0
20155,2,155,[678 161 216 196 302],339,2,534,3.423076923076923,0.0,0.0
20156,2,156,[238 121 385  64 483],59,5,539,3.43312101910828,20.0,0.0
20157,2,157,[328 200 300 245   8],334,2,541,3.4240506329113924,0.0,0.0
20158,2,158,[ 97 200  98  71 273],378,4,545,3.4276729559748427,0.0,20.0
20159,2,159,[ 64 187 202 546 597],804,3,548,3.425,0.0,0.0
20160,2,160,[435  70 204 111 179],234,0,548,3.4037267080745344,0.0,0.0
20161,2,161,[508  69 475 483 100],833,3,551,3.4012345679012346,20.0,20.0
20162,2,162,[515   9 258  82 268],7,2,553,3.392638036809816,0.0,0.0
20163,2,163,[127 302 508  89 427],6,4,557,3.3963414634146343,0.0,20.0
20164,2,164,[197 289 191 211 471],234,3,560,3.393939393939394,0.0,0.0
20165,2,165,[127 302  89 427 183],328,4,564,3.397590361445783,0.0,20.0
20166,2,166,[403  64 211 111 196],398,4,568,3.4011976047904193,0.0,0.0
20167,2,167,[187  97  64 195  79],666,3,571,3.3988095238095237,0.0,0.0
20168,2,168,[144   4 195 385 174],7,5,576,3.408284023668639,0.0,20.0
20169,2,169,[ 69 271 318 196   1],263,4,580,3.411764705882353,20.0,0.0
20170,2,170,[186 181 179 132 515],308,3,583,3.409356725146199,0.0,0.0
20171,2,171,[172 385 196 132  22],290,4,587,3.4127906976744184,0.0,0.0
20172,2,172,[153 175   9 168 176],334,4,591,3.4161849710982657,0.0,0.0
20173,2,173,[603 151 265  56 191],339,4,595,3.4195402298850577,20.0,0.0
20174,2,174,[302 127  89 183  64],346,4,599,3.422857142857143,0.0,20.0
20175,2,175,[153  96 286 175   1],387,4,603,3.4261363636363638,0.0,0.0
20176,2,176,[127 302  89 183  64],480,3,606,3.4237288135593222,0.0,20.0
20177,2,177,[181 121  88  95 117],313,3,609,3.4213483146067416,0.0,0.0
20178,2,178,[182 288 300 405 195],102,1,610,3.4078212290502794,0.0,0.0
20179,2,179,[127 302  89 183 483],664,4,614,3.411111111111111,20.0,20.0
20180,2,180,[222 483 181 257  97],290,4,618,3.414364640883978,20.0,0.0
20181,2,181,[172 301 176   4 496],537,1,619,3.401098901098901,0.0,0.0
20182,2,182,[127 302  89 483  96],474,5,624,3.4098360655737703,20.0,20.0
20183,2,183,[127 302  89 483  96],480,3,627,3.407608695652174,20.0,20.0
20184,2,184,[197 173 161 216  69],7,4,631,3.4108108108108106,0.0,0.0
20185,2,185,[302  89 127  96 174],537,3,634,3.4086021505376345,0.0,40.0
20186,2,186,[282 172 238  95 294],554,2,636,3.4010695187165774,0.0,0.0
20187,2,187,[210 222 135 275 405],536,4,640,3.404255319148936,0.0,0.0
20188,2,188,[302  89 127 186 183],664,4,644,3.4074074074074074,0.0,20.0
20189,2,189,[302  89 127 186 427],474,5,649,3.4157894736842107,0.0,20.0
20190,2,190,[655  15 143 245 186],207,4,653,3.418848167539267,0.0,0.0
20191,2,191,[ 50 195 194  69 187],653,4,657,3.421875,0.0,20.0
20192,2,192,[  7 161 588 153  22],13,4,661,3.4248704663212437,0.0,0.0
20193,2,193,[302  89 127 186 153],339,5,666,3.4329896907216493,0.0,20.0
20194,2,194,[302  89 127 186 153],343,4,670,3.4358974358974357,0.0,20.0
20195,2,195,[215 276 161 322 174],474,5,675,3.443877551020408,0.0,20.0
20196,2,196,[515 143 195 196 197],7,3,678,3.4416243654822334,0.0,0.0
20197,2,197,[111 286 435 194 742],533,5,683,3.4494949494949494,0.0,0.0
20198,2,198,[ 79 238 118  89   4],666,3,686,3.4472361809045227,0.0,0.0
20199,2,199,[153  15 273 196 175],92,4,690,3.45,0.0,0.0
20200,2,200,[289 515 273   4 222],524,3,693,3.4477611940298507,0.0,0.0
20201,2,201,[302  89 127 186 153],334,4,697,3.4504950495049505,0.0,20.0
20202,2,202,[186 423 568 204  28],374,4,701,3.4532019704433496,0.0,0.0
20203,2,203,[ 79 568 655 202 216],194,1,702,3.4411764705882355,0.0,0.0
20204,2,204,[405  69 235 385 194],295,5,707,3.448780487804878,0.0,0.0
20205,2,205,[302  89 127 153  22],883,4,711,3.4514563106796117,0.0,20.0
20206,2,206,[234 181  79  64  88],452,3,714,3.449275362318841,0.0,0.0
20207,2,207,[194 235 118 179 143],897,3,717,3.4471153846153846,0.0,0.0
20208,2,208,[742   8 187  95 357],308,5,722,3.4545454545454546,20.0,0.0
20209,2,209,[302  89 127 153 427],339,5,727,3.461904761904762,0.0,20.0
20210,2,210,[111 286 423  96 300],666,1,728,3.4502369668246446,0.0,0.0
20211,2,211,[168 127 172  70 742],648,3,731,3.44811320754717,0.0,20.0
20212,2,212,[211 202  50 125  79],897,4,735,3.4507042253521125,0.0,20.0
20213,2,213,[ 11 168  64 385 678],537,1,736,3.439252336448598,0.0,0.0
20214,2,214,[302  89 153 127 427],833,2,738,3.432558139534884,0.0,20.0
20215,2,215,[172  56 175  95 182],102,2,740,3.425925925925926,0.0,0.0
20216,2,216,[ 89 302 127   8 181],271,4,744,3.4285714285714284,0.0,20.0
20217,2,217,[ 88  12 210  64  69],106,4,748,3.4311926605504586,20.0,0.0
20218,2,218,[302  89 127   8 181],328,4,752,3.4337899543378994,0.0,20.0
20219,2,219,[195  69 427 191 172],848,3,755,3.4318181818181817,0.0,0.0
20220,2,220,[302  89 127 181 153],13,5,760,3.4389140271493215,0.0,20.0
20221,2,221,[302  89 127 181 153],102,1,761,3.4279279279279278,0.0,20.0
20222,2,222,[197 385 655 194 135],7,5,766,3.4349775784753365,0.0,0.0
20223,2,223,[ 69 195 235  11  98],13,2,768,3.4285714285714284,0.0,20.0
20224,2,224,[234  25 300 216 748],749,4,772,3.431111111111111,0.0,0.0
20225,2,225,[405 546 475  89 175],13,2,774,3.424778761061947,0.0,0.0
20226,2,226,[ 89 302 127 175 186],666,4,778,3.4273127753303965,0.0,20.0
20227,2,227,[117 483 546 237 385],95,2,780,3.4210526315789473,20.0,0.0
20228,2,228,[748 125 294 322  98],804,5,785,3.427947598253275,0.0,20.0
20229,2,229,[ 79 423 183 215 176],537,0,785,3.4130434782608696,0.0,0.0
20230,2,230,[508 191 515 678 185],13,0,785,3.398268398268398,0.0,0.0
20231,2,231,[483 183 313 100  89],59,5,790,3.4051724137931036,20.0,20.0
20232,2,232,[161 125 127 237 405],334,2,792,3.3991416309012874,0.0,20.0
20233,2,233,[ 89 302 127 175 427],6,5,797,3.405982905982906,0.0,20.0
20234,2,234,[471 197  56   8 181],311,5,802,3.4127659574468083,0.0,0.0
20235,2,235,[181 496 276 211 405],533,3,805,3.4110169491525424,0.0,0.0
20236,2,236,[ 89 179 204 173 118],643,2,807,3.4050632911392404,0.0,0.0
20237,2,237,[302  89 127 175 427],474,5,812,3.411764705882353,0.0,20.0
20238,2,238,[302  89 175 127 427],334,5,817,3.418410041841004,0.0,20.0
20239,2,239,[300 181 182 135 183],840,3,820,3.4166666666666665,0.0,0.0
20240,2,240,[483 196 161 127 655],194,4,824,3.4190871369294604,20.0,20.0
20241,2,241,[302  89 175 127 427],537,5,829,3.425619834710744,0.0,20.0
20242,2,242,[302 175  89 127 427],537,5,834,3.432098765432099,0.0,20.0
20243,2,243,[318  88 196  50 181],538,3,837,3.430327868852459,20.0,20.0
20244,2,244,[ 25 357 313 197 100],474,5,842,3.436734693877551,20.0,20.0
20245,2,245,[302 175  89 127 427],13,5,847,3.4430894308943087,0.0,20.0
20246,2,246,[300 568 301 748 127],83,2,849,3.437246963562753,0.0,20.0
20247,2,247,[176  11 405  28 172],64,4,853,3.439516129032258,0.0,0.0
20248,2,248,[118 475 322 125 111],533,4,857,3.4417670682730925,0.0,0.0
20249,2,249,[385 168  89 313  69],64,4,861,3.444,0.0,0.0
20250,2,250,[121 234 405 151 323],374,3,864,3.442231075697211,0.0,0.0
20251,2,251,[294 496 313 202 127],653,2,866,3.4365079365079363,0.0,20.0
20252,2,252,[204  88 132  98 176],653,1,867,3.4268774703557314,0.0,20.0
20253,2,253,[302 175 127  89 427],666,5,872,3.4330708661417324,0.0,20.0
20254,2,254,[175 302 127  89 427],833,3,875,3.4313725490196076,0.0,20.0
20255,2,255,[175 127 302  89 197],343,4,879,3.43359375,0.0,20.0
20256,2,256,[175 127 302  89 197],883,5,884,3.4396887159533076,0.0,20.0
20257,2,257,[127   7  88 161 143],184,1,885,3.4302325581395348,0.0,20.0
20258,2,258,[175 127 302  89 197],474,5,890,3.436293436293436,0.0,20.0
20259,2,259,[125 282  97 275 322],533,4,894,3.4384615384615387,0.0,0.0
20260,2,260,[179  12 204 174  97],13,4,898,3.4406130268199235,20.0,20.0
20261,2,261,[174 100 185 161 151],524,4,902,3.4427480916030535,0.0,40.0
20262,2,262,[258 276 172 597  88],533,3,905,3.44106463878327,0.0,0.0
20263,2,263,[ 79 268 597 403 200],7,3,908,3.4393939393939394,0.0,0.0
20264,2,264,[235 323 168 172 191],13,2,910,3.4339622641509435,0.0,0.0
20265,2,265,[234  89 435 151  82],290,1,911,3.424812030075188,0.0,0.0
20266,2,266,[238 185 328   7   8],13,1,912,3.4157303370786516,0.0,0.0
20267,2,267,[175 127 302 197  89],480,2,914,3.41044776119403,0.0,20.0
20268,2,268,[302 216 742 748 117],543,2,916,3.4052044609665426,0.0,0.0
20269,2,269,[302 127 175  89 427],537,5,921,3.411111111111111,0.0,20.0
20270,2,270,[197 175 144 151 153],650,3,924,3.4095940959409594,0.0,0.0
20271,2,271,[302 127 175  89 427],6,5,929,3.4154411764705883,0.0,20.0
20272,2,272,[172  50 405 483 185],474,5,934,3.421245421245421,20.0,20.0
20273,2,273,[  1 191 423 269 135],64,5,939,3.427007299270073,0.0,0.0
20274,2,274,[322  64 100 271 204],119,5,944,3.4327272727272726,0.0,20.0
20275,2,275,[302 127 175  89 427],666,5,949,3.4384057971014492,0.0,20.0
20276,2,276,[210 143 202 276 323],311,3,952,3.436823104693141,0.0,0.0
20277,2,277,[ 70  11 186   7 187],406,2,954,3.431654676258993,0.0,0.0
20278,2,278,[302 127 175  89 427],6,5,959,3.4372759856630823,0.0,20.0
20279,2,279,[742 276 546  25 288],447,3,962,3.4357142857142855,0.0,0.0
20280,2,280,[228 143 546  71 655],749,4,966,3.4377224199288254,0.0,0.0
20281,2,281,[ 69 318 183   1 143],536,4,970,3.4397163120567376,20.0,0.0
20282,2,282,[300 597 117 288   1],447,3,973,3.4381625441696113,0.0,0.0
20283,2,283,[ 70 237 187 182 288],666,3,976,3.436619718309859,0.0,0.0
20284,2,284,[302 175 127  89 427],339,5,981,3.442105263157895,0.0,20.0
20285,2,285,[215   7 143  79 235],650,2,983,3.437062937062937,0.0,0.0
20286,2,286,[302 175 127  89 427],90,4,987,3.4390243902439024,0.0,20.0
20287,2,287,[302 127  89 427 175],343,4,991,3.4409722222222223,0.0,20.0
20288,2,288,[385 186  11 182  98],7,4,995,3.442906574394464,0.0,20.0
20289,2,289,[257 197 100 168 228],374,3,998,3.4413793103448276,0.0,20.0
20290,2,290,[197 265  98 655  69],474,5,1003,3.4467353951890036,0.0,20.0
20291,2,291,[ 96 238  64  88 121],95,5,1008,3.452054794520548,0.0,0.0
20292,2,292,[302 127 427 175  89],474,5,1013,3.4573378839590445,0.0,20.0
20293,2,293,[302 127 175 427  89],537,5,1018,3.4625850340136055,0.0,20.0
20294,2,294,[302 127 175 427  89],13,5,1023,3.4677966101694917,0.0,20.0
20295,2,295,[ 28  56  70 234 313],271,4,1027,3.4695945945945947,0.0,0.0
20296,2,296,[ 79 204 185 173 235],804,5,1032,3.474747474747475,0.0,0.0
20297,2,297,[322 258 181 603  97],454,3,1035,3.4731543624161074,20.0,0.0
20298,2,298,[181 200  11 191 258],7,3,1038,3.471571906354515,0.0,0.0
20299,2,299,[323  64 357 403 300],788,3,1041,3.47,20.0,0.0
20300,2,300,[748 132 179 196 176],200,4,1045,3.471760797342193,0.0,0.0
20301,2,301,[  7  11 180   8 135],234,2,1047,3.466887417218543,0.0,0.0
20302,2,302,[181 313 496  97 172],533,4,1051,3.4686468646864688,0.0,0.0
20303,2,303,[302 127 175 427  89],666,5,1056,3.473684210526316,0.0,20.0
20304,2,304,[515 176 215  98 427],60,5,1061,3.4786885245901638,0.0,20.0
20305,2,305,[276 202 515 238 748],92,3,1064,3.477124183006536,0.0,0.0
20306,2,306,[302 127 175 427  89],90,4,1068,3.478827361563518,0.0,20.0
20307,2,307,[271 588 210  28 245],263,1,1069,3.470779220779221,0.0,0.0
20308,2,308,[175  82 121 197  71],749,3,1072,3.469255663430421,0.0,0.0
20309,2,309,[ 82   8 328 196 286],533,4,1076,3.470967741935484,0.0,0.0
20310,2,310,[302 127 427  89 197],474,5,1081,3.4758842443729905,0.0,20.0
20311,2,311,[302 127 427  89 197],833,2,1083,3.4711538461538463,0.0,20.0
20312,2,312,[  8 144 200  64 742],92,3,1086,3.4696485623003195,0.0,0.0
20313,2,313,[301  89 194 427 313],234,3,1089,3.468152866242038,0.0,0.0
20314,2,314,[117 125 210 568 196],207,3,1092,3.466666666666667,0.0,0.0
20315,2,315,[ 50  15 176 215  22],234,2,1094,3.462025316455696,0.0,20.0
20316,2,316,[127 302 427  89  50],328,4,1098,3.4637223974763405,0.0,40.0
20317,2,317,[ 50  98 234  28 204],379,5,1103,3.4685534591194966,0.0,40.0
20318,2,318,[222   1 132 210 235],406,4,1107,3.470219435736677,0.0,0.0
20319,2,319,[127 302  50  89 313],197,4,1111,3.471875,0.0,40.0
20320,2,320,[187 302   8 211 273],207,4,1115,3.473520249221184,0.0,0.0
20321,2,321,[222 215 143  50 234],653,1,1116,3.4658385093167703,0.0,20.0
20322,2,322,[748   9 318 173 215],488,5,1121,3.4705882352941178,20.0,0.0
20323,2,323,[300 118 748 471 742],328,2,1123,3.4660493827160495,0.0,0.0
20324,2,324,[175  98  50  89 202],447,3,1126,3.4646153846153847,0.0,40.0
20325,2,325,[127  50 302  89 313],883,4,1130,3.4662576687116564,0.0,40.0
20326,2,326,[127  50 302  89 427],6,5,1135,3.470948012232416,0.0,40.0
20327,2,327,[ 97 302 289 423 678],615,3,1138,3.4695121951219514,0.0,0.0
20328,2,328,[127  50 302  89 427],474,5,1143,3.474164133738602,0.0,40.0
20329,2,329,[302 191 187  64  50],6,5,1148,3.478787878787879,0.0,20.0
20330,2,330,[300 322 313 258  89],197,4,1152,3.4803625377643503,0.0,0.0
20331,2,331,[515 175  69 181 179],406,4,1156,3.4819277108433737,0.0,0.0
20332,2,332,[151 328 210 168 172],334,2,1158,3.4774774774774775,0.0,0.0
20333,2,333,[204 282 200  50 181],328,3,1161,3.4760479041916166,0.0,20.0
20334,2,334,[182  56 302   1 403],158,5,1166,3.4805970149253733,0.0,0.0
20335,2,335,[211 385 194 183 118],666,2,1168,3.4761904761904763,0.0,0.0
20336,2,336,[168 182  98  70  12],533,4,1172,3.477744807121662,20.0,20.0
20337,2,337,[ 79 276 132 238  71],184,4,1176,3.4792899408284024,0.0,0.0
20338,2,338,[ 50 127 302  89 427],833,2,1178,3.4749262536873156,0.0,40.0
20339,2,339,[127 302  89  50 174],339,5,1183,3.4794117647058824,0.0,60.0
20340,2,340,[471 161 265  79  97],42,3,1186,3.4780058651026393,0.0,0.0
20341,2,341,[127 302  50  89 174],339,5,1191,3.482456140350877,0.0,60.0
20342,2,342,[603 173 302  98 294],13,3,1194,3.4810495626822155,20.0,20.0
20343,2,343,[508 435  71 328 183],13,3,1197,3.479651162790698,0.0,0.0
20344,2,344,[318 257 322 144  95],92,1,1198,3.472463768115942,20.0,0.0
20345,2,345,[127 302  50  89 174],197,4,1202,3.4739884393063583,0.0,60.0
20346,2,346,[127  50  89 302 174],833,2,1204,3.4697406340057637,0.0,60.0
20347,2,347,[186 200 197 168 121],643,4,1208,3.471264367816092,0.0,0.0
20348,2,348,[127 175 196 235 427],13,4,1212,3.4727793696275073,0.0,20.0
20349,2,349,[172  50 175 196  89],184,4,1216,3.474285714285714,0.0,20.0
20350,2,350,[181  98  12 471 211],42,5,1221,3.4786324786324787,20.0,20.0
20351,2,351,[127  89 302  50 603],524,4,1225,3.4801136363636362,20.0,40.0
20352,2,352,[210 100 483 237 313],533,4,1229,3.481586402266289,20.0,20.0
20353,2,353,[117 515 655 405 174],194,3,1232,3.480225988700565,0.0,20.0
20354,2,354,[ 79 174 175 118  22],378,5,1237,3.484507042253521,0.0,20.0
20355,2,355,[127  89 302  50 427],13,5,1242,3.4887640449438204,0.0,40.0
20356,2,356,[423  64 276 357  50],234,4,1246,3.4901960784313726,20.0,20.0
20357,2,357,[127  89 302  50  64],480,3,1249,3.488826815642458,0.0,40.0
20358,2,358,[127  89 302  50 427],666,4,1253,3.4902506963788302,0.0,40.0
20359,2,359,[508 496 235 111 515],59,4,1257,3.4916666666666667,0.0,0.0
20360,2,360,[ 22 222 197 265 678],387,3,1260,3.490304709141274,0.0,0.0
20361,2,361,[ 98 276   9 204 200],447,3,1263,3.4889502762430937,0.0,20.0
20362,2,362,[127  89 302 427  22],90,5,1268,3.4931129476584024,0.0,20.0
20363,2,363,[  7  69  28  11 204],200,5,1273,3.4972527472527473,0.0,0.0
20364,2,364,[211  95 172 496 117],454,1,1274,3.4904109589041097,0.0,0.0
20365,2,365,[127  89 302 427  22],339,5,1279,3.4945355191256833,0.0,20.0
20366,2,366,[127  89 302  22 427],833,2,1281,3.4904632152588557,0.0,20.0
20367,2,367,[179 588 234  69  82],194,3,1284,3.489130434782609,0.0,0.0
20368,2,368,[ 96 195 176 204 405],374,4,1288,3.4905149051490514,0.0,0.0
20369,2,369,[121  70 234  12 496],537,2,1290,3.4864864864864864,20.0,0.0
20370,2,370,[ 71  11 179 143 435],474,5,1295,3.490566037735849,0.0,0.0
20371,2,371,[423 435  64   4 289],387,0,1295,3.4811827956989245,0.0,0.0
20372,2,372,[ 28  79 515  70 200],308,3,1298,3.479892761394102,0.0,0.0
20373,2,373,[168 568 228 204 234],42,4,1302,3.481283422459893,0.0,0.0
20374,2,374,[273 117  96  88 132],892,5,1307,3.485333333333333,0.0,0.0
20375,2,375,[127  89 302  50 427],537,5,1312,3.4893617021276597,0.0,40.0
20376,2,376,[127  89 302  50 427],328,4,1316,3.490716180371353,0.0,40.0
20377,2,377,[302 100 118 328 222],548,5,1321,3.494708994708995,0.0,20.0
20378,2,378,[323 176 125 173 211],59,4,1325,3.496042216358839,0.0,0.0
20379,2,379,[  7 678  97 100 257],213,5,1330,3.5,0.0,20.0
20380,2,380,[195 127 423  89 603],840,5,1335,3.5039370078740157,20.0,20.0
20381,2,381,[127  89 302  50 174],102,3,1338,3.5026178010471205,0.0,60.0
20382,2,382,[173 222 655 151 117],339,4,1342,3.503916449086162,0.0,0.0
20383,2,383,[127  89 302  50 174],346,4,1346,3.5052083333333335,0.0,60.0
20384,2,384,[127  89  50 302 174],883,5,1351,3.5090909090909093,0.0,60.0
20385,2,385,[127  89  50 174 302],115,5,1356,3.5129533678756477,0.0,60.0
20386,2,386,[127  89  50 174 302],524,5,1361,3.516795865633075,0.0,60.0
20387,2,387,[127  89  50 174 302],102,3,1364,3.515463917525773,0.0,60.0
20388,2,388,[  9  56  69 127   4],7,5,1369,3.519280205655527,0.0,20.0
20389,2,389,[127  89  50 174 302],524,5,1374,3.523076923076923,0.0,60.0
20390,2,390,[127  89  50 174 302],271,4,1378,3.524296675191816,0.0,60.0
20391,2,391,[313 275 294 423 286],537,2,1380,3.520408163265306,0.0,0.0
20392,2,392,[204 195  97  50 211],346,5,1385,3.524173027989822,0.0,20.0
20393,2,393,[182 289 127 175  88],234,2,1387,3.520304568527919,0.0,20.0
20394,2,394,[322 181 175 100  97],474,5,1392,3.5240506329113925,0.0,20.0
20395,2,395,[127  89  50 174 302],343,4,1396,3.525252525252525,0.0,60.0
20396,2,396,[546 197 286 678 515],7,3,1399,3.5239294710327456,0.0,0.0
20397,2,397,[328 191 271 161 135],334,2,1401,3.520100502512563,0.0,0.0
20398,2,398,[135 271 191 182  96],13,3,1404,3.518796992481203,0.0,0.0
20399,2,399,[322 265 222 403 385],533,3,1407,3.5175,0.0,0.0
20400,2,400,[742 181  25 176  11],897,1,1408,3.511221945137157,0.0,0.0
20401,2,401,[183 194 215 568 403],650,2,1410,3.5074626865671643,0.0,0.0
20402,2,402,[127  89  50 174 302],334,5,1415,3.511166253101737,0.0,60.0
20403,2,403,[187 238 471 508 357],343,5,1420,3.514851485148515,20.0,0.0
20404,2,404,[588 175  79 135 125],42,4,1424,3.5160493827160493,0.0,0.0
20405,2,405,[405 215 301 168  79],85,3,1427,3.5147783251231526,0.0,0.0
20406,2,406,[100 183 234 435 282],406,4,1431,3.515970515970516,0.0,20.0
20407,2,407,[191 228 588  50   7],843,2,1433,3.5122549019607843,0.0,20.0
20408,2,408,[127 174  89  50 302],6,5,1438,3.5158924205378974,0.0,60.0
20409,2,409,[483  97 151 100 125],295,5,1443,3.5195121951219512,20.0,20.0
20410,2,410,[125 187  89  22  69],271,3,1446,3.5182481751824817,0.0,0.0
20411,2,411,[161 143 125   8 588],64,3,1449,3.516990291262136,0.0,0.0
20412,2,412,[144 435 275   4  79],406,1,1450,3.5108958837772395,0.0,0.0
20413,2,413,[271 118  95   4 200],738,2,1452,3.5072463768115942,0.0,0.0
20414,2,414,[ 88  25   8 183 211],406,3,1455,3.5060240963855422,0.0,0.0
20415,2,415,[127 174  89  50 302],524,5,1460,3.5096153846153846,0.0,60.0
20416,2,416,[127 174  89  50 302],474,5,1465,3.513189448441247,0.0,60.0
20417,2,417,[322 546 294  96 194],308,2,1467,3.5095693779904304,0.0,0.0
20418,2,418,[ 88 172  70 234 269],934,3,1470,3.5083532219570404,0.0,0.0
20419,2,419,[127 174  89  50 302],664,5,1475,3.511904761904762,0.0,60.0
20420,2,420,[127 174  89  50 302],13,5,1480,3.5154394299287413,0.0,60.0
20421,2,421,[127 174  89  50 302],524,5,1485,3.518957345971564,0.0,60.0
20422,2,422,[195 228 202 294  64],387,2,1487,3.5153664302600474,0.0,0.0
20423,2,423,[127 174  89  50 302],158,5,1492,3.518867924528302,0.0,60.0
20424,2,424,[127 117 385 286 180],13,2,1494,3.5152941176470587,0.0,20.0
20425,2,425,[258 117 125 273 427],234,1,1495,3.5093896713615025,0.0,0.0
20426,2,426,[ 50 211 173 185 300],479,4,1499,3.510538641686183,0.0,20.0
20427,2,427,[ 97 210 568 515  64],326,4,1503,3.5116822429906542,0.0,0.0
20428,2,428,[180 161  11 238 185],271,3,1506,3.5104895104895104,0.0,0.0
20429,2,429,[483 125 153 174  71],290,3,1509,3.5093023255813955,20.0,20.0
20430,2,430,[ 89 186  98 258 180],666,4,1513,3.5104408352668215,0.0,20.0
20431,2,431,[174 197 210 265 172],313,5,1518,3.513888888888889,0.0,20.0
20432,2,432,[127 174  89  50 302],666,3,1521,3.51270207852194,0.0,60.0
20433,2,433,[194  96 313 742 257],144,5,1526,3.5161290322580645,0.0,0.0
20434,2,434,[117 322 215 318  50],311,5,1531,3.5195402298850573,20.0,20.0
20435,2,435,[ 71 125 475 195 228],648,2,1533,3.5160550458715596,0.0,0.0
20436,2,436,[127  89 174  50 302],664,5,1538,3.519450800915332,0.0,60.0
20437,2,437,[127  50 427 173 322],575,2,1540,3.5159817351598175,0.0,40.0
20438,2,438,[204 185 151 191 135],804,3,1543,3.5148063781321186,0.0,0.0
20439,2,439,[111 655 475 322 515],474,5,1548,3.518181818181818,0.0,0.0
20440,2,440,[127 174  89 302 100],271,4,1552,3.5192743764172336,0.0,60.0
20441,2,441,[111 210 175 289  11],474,4,1556,3.520361990950226,0.0,0.0
20442,2,442,[181 258 357 182 180],380,2,1558,3.5169300225733635,20.0,0.0
20443,2,443,[127 174  89 302 100],115,5,1563,3.52027027027027,0.0,60.0
20444,2,444,[127 174  89 100 302],883,5,1568,3.5235955056179775,0.0,60.0
20445,2,445,[127 174  89 100 302],833,3,1571,3.522421524663677,0.0,60.0
20446,2,446,[127  89 100 174 302],339,5,1576,3.5257270693512304,0.0,60.0
20447,2,447,[127 100  89 174 302],271,4,1580,3.5267857142857144,0.0,60.0
20448,2,448,[127 100 174  89 302],474,5,1585,3.530066815144766,0.0,60.0
20449,2,449,[286  89 135 132  25],537,2,1587,3.526666666666667,0.0,0.0
20450,2,450,[127 100 174  89 302],666,4,1591,3.5277161862527717,0.0,60.0
20451,2,451,[121 568 655 403 202],42,3,1594,3.5265486725663715,0.0,0.0
20452,2,452,[127 100  89 302 174],13,5,1599,3.5298013245033113,0.0,60.0
20453,2,453,[127 100  89 302 174],664,5,1604,3.5330396475770924,0.0,60.0
20454,2,454,[127 100  89 302 174],115,5,1609,3.536263736263736,0.0,60.0
20455,2,455,[678 271 135 265 288],334,1,1610,3.530701754385965,0.0,0.0
20456,2,456,[127 100  89 174 302],158,5,1615,3.533916849015317,0.0,60.0
20457,2,457,[127 100  89 174 302],537,4,1619,3.534934497816594,0.0,60.0
20458,2,458,[127 200 132 546 191],749,4,1623,3.5359477124183005,0.0,20.0
20459,2,459,[ 71 318 180 234   1],804,5,1628,3.5391304347826087,20.0,0.0
20460,2,460,[ 12 300  97 588  56],64,3,1631,3.537960954446855,20.0,0.0
20461,2,461,[508 275 182 100  97],533,3,1634,3.536796536796537,0.0,20.0
20462,2,462,[100 127  89 302 174],883,5,1639,3.5399568034557234,0.0,60.0
20463,2,463,[100 127  89 302 174],90,5,1644,3.543103448275862,0.0,60.0
20464,2,464,[100 127  89 302 174],346,3,1647,3.541935483870968,0.0,60.0
20465,2,465,[127 100  89 302 174],13,5,1652,3.5450643776824036,0.0,60.0
20466,2,466,[127 100  89 302 174],90,5,1657,3.5481798715203428,0.0,60.0
20467,2,467,[222 546  89 597 435],899,2,1659,3.5448717948717947,0.0,0.0
20468,2,468,[125 195 143 185 405],42,5,1664,3.5479744136460556,0.0,0.0
20469,2,469,[144 588 175 176  71],234,0,1664,3.5404255319148934,0.0,0.0
20470,2,470,[  8 185 180 200 161],774,1,1665,3.535031847133758,0.0,0.0
20471,2,471,[ 56 289  50  98  64],194,3,1668,3.5338983050847457,0.0,40.0
20472,2,472,[127 100  89 302 174],343,4,1672,3.5348837209302326,0.0,60.0
20473,2,473,[385 301 515 118 173],666,3,1675,3.5337552742616034,0.0,0.0
20474,2,474,[127 100  89 302 174],883,5,1680,3.536842105263158,0.0,60.0
20475,2,475,[588 172 185 318 302],537,3,1683,3.5357142857142856,20.0,0.0
20476,2,476,[127 100  89 302 174],271,4,1687,3.5366876310272537,0.0,60.0
20477,2,477,[ 25 204 187 151  79],234,1,1688,3.5313807531380754,0.0,0.0
20478,2,478,[  9 294 323 568 111],13,1,1689,3.5260960334029225,0.0,0.0
20479,2,479,[216  97 179 423 435],60,4,1693,3.527083333333333,0.0,0.0
20480,2,480,[127 100  89 174 302],271,4,1697,3.528066528066528,0.0,60.0
20481,2,481,[257 435  22 508  82],343,4,1701,3.529045643153527,0.0,0.0
20482,2,482,[127 100 174 302  89],883,5,1706,3.5320910973084887,0.0,60.0
20483,2,483,[127 100 174 302  89],664,5,1711,3.5351239669421486,0.0,60.0
20484,2,484,[127 100 174 302  89],144,3,1714,3.534020618556701,0.0,60.0
20485,2,485,[191 187  22 111 121],669,2,1716,3.5308641975308643,0.0,0.0
20486,2,486,[568  88   4  15 742],92,1,1717,3.5256673511293632,0.0,0.0
20487,2,487,[127 100 174 302  89],537,4,1721,3.526639344262295,0.0,60.0
20488,2,488,[175  88 235 318 195],194,1,1722,3.521472392638037,20.0,0.0
20489,2,489,[603 515 588  88 496],326,3,1725,3.520408163265306,20.0,0.0
20490,2,490,[204  69   9 245 196],749,4,1729,3.521384928716904,0.0,0.0
20491,2,491,[127 100 302  89 174],144,3,1732,3.5203252032520327,0.0,60.0
20492,2,492,[181 175 222 125 748],92,4,1736,3.5212981744421907,0.0,0.0
20493,2,493,[127 100 174  89 302],537,4,1740,3.522267206477733,0.0,60.0
20494,2,494,[210 275 161 357   1],311,5,1745,3.525252525252525,20.0,0.0
20495,2,495,[127 100 357  89 302],343,4,1749,3.526209677419355,20.0,40.0
20496,2,496,[ 82 515 174 183  50],91,5,1754,3.5291750503018107,0.0,40.0
20497,2,497,[  1 333 678 603 405],294,4,1758,3.5301204819277108,20.0,0.0
20498,2,498,[258 127 173 191 323],474,4,1762,3.531062124248497,0.0,20.0
20499,2,499,[127 100 357 302  89],339,5,1767,3.534,20.0,40.0
20500,2,500,[127 100 357 302  89],537,5,1772,3.536926147704591,20.0,40.0
20501,2,501,[228 182  69  98 185],59,5,1777,3.539840637450199,0.0,20.0
20502,2,502,[ 98 143 181 294 195],474,4,1781,3.540755467196819,0.0,20.0
20503,2,503,[181 508 132  96 546],13,3,1784,3.5396825396825395,0.0,0.0
20504,2,504,[127 100 357 302  89],343,4,1788,3.5405940594059406,20.0,40.0
20505,2,505,[172 143 496 276 265],234,1,1789,3.535573122529644,0.0,0.0
20506,2,506,[127 100 357 302 174],144,4,1793,3.5364891518737673,20.0,60.0
20507,2,507,[127 100 357 302 174],10,5,1798,3.5393700787401574,20.0,60.0
20508,2,508,[127 100 357 302 174],474,5,1803,3.5422396856581533,20.0,60.0
20509,2,509,[127 100 357 302 174],90,5,1808,3.545098039215686,20.0,60.0
20510,2,510,[ 15 174 289 200  22],455,3,1811,3.544031311154599,0.0,20.0
20511,2,511,[100 127 357 174 302],6,5,1816,3.546875,20.0,60.0
20512,2,512,[100 127 357 174 302],605,4,1820,3.54775828460039,20.0,60.0
20513,2,513,[100 127 357 302  69],13,4,1824,3.5486381322957197,20.0,40.0
20514,2,514,[100 127 357 302  69],339,5,1829,3.5514563106796118,20.0,40.0
20515,2,515,[100 127 357  69 302],339,5,1834,3.554263565891473,20.0,40.0
20516,2,516,[100 127 357  69 302],328,5,1839,3.5570599613152805,20.0,40.0
20517,2,517,[100 127 357  69 302],10,5,1844,3.55984555984556,20.0,40.0
20518,2,518,[100 127 357  69 302],144,4,1848,3.560693641618497,20.0,40.0
20519,2,519,[423 186 175 196 216],92,3,1851,3.5596153846153844,0.0,0.0
20520,2,520,[132 515 202 313 174],59,5,1856,3.5623800383877158,0.0,20.0
20521,2,521,[100 127 357  69 302],115,4,1860,3.5632183908045976,20.0,40.0
20522,2,522,[100 127 357 302 174],343,5,1865,3.565965583173996,20.0,60.0
20523,2,523,[117 678  56 234 202],447,3,1868,3.564885496183206,0.0,0.0
20524,2,524,[  7 143 117 288  82],537,1,1869,3.56,0.0,0.0
20525,2,525,[ 97 210  64 318 143],7,4,1873,3.5608365019011408,20.0,0.0
20526,2,526,[182  95 269  15 179],537,2,1875,3.5578747628083494,0.0,0.0
20527,2,527,[100 127 357 302 174],666,4,1879,3.558712121212121,20.0,60.0
20528,2,528,[  1 234 194 597   7],308,3,1882,3.55765595463138,0.0,0.0
20529,2,529,[100 127 357 302  96],13,4,1886,3.5584905660377357,20.0,40.0
20530,2,530,[197 174 405 269 483],6,4,1890,3.559322033898305,20.0,20.0
20531,2,531,[100 127 357 302 483],537,5,1895,3.56203007518797,40.0,40.0
20532,2,532,[121 200  50 288 228],343,2,1897,3.5590994371482174,0.0,20.0
20533,2,533,[172 288 185 183 483],648,5,1902,3.561797752808989,20.0,0.0
20534,2,534,[234 435  15 144 427],308,2,1904,3.5588785046728972,0.0,0.0
20535,2,535,[196 186 228 215 179],406,1,1905,3.5541044776119404,0.0,0.0
20536,2,536,[100 127 357 483 302],458,4,1909,3.554934823091248,40.0,40.0
20537,2,537,[100 127 483 302  96],537,4,1913,3.5557620817843865,20.0,40.0
20538,2,538,[210 127 427 173  50],499,3,1916,3.5547309833024117,0.0,40.0
20539,2,539,[127 144 135 288 271],64,3,1919,3.553703703703704,0.0,20.0
20540,2,540,[172  28 603  79   1],189,4,1923,3.55452865064695,20.0,0.0
20541,2,541,[175 125  98  71 405],92,4,1927,3.555350553505535,0.0,20.0
20542,2,542,[ 50 423 435  12 300],328,5,1932,3.5580110497237567,20.0,20.0
20543,2,543,[496 182 313 200 179],59,5,1937,3.5606617647058822,0.0,0.0
20544,2,544,[174 678 187  28 182],7,4,1941,3.561467889908257,0.0,20.0
20545,2,545,[100 127 483 302 313],232,3,1944,3.5604395604395602,20.0,40.0
20546,2,546,[265 597 289 273 328],328,3,1947,3.5594149908592323,0.0,0.0
20547,2,547,[100 127 483 302  89],90,5,1952,3.562043795620438,20.0,40.0
20548,2,548,[100 127 483 302  89],480,3,1955,3.5610200364298725,20.0,40.0
20549,2,549,[132  56 328 216 196],749,4,1959,3.561818181818182,0.0,0.0
20550,2,550,[475 471 132 268 179],537,3,1962,3.560798548094374,0.0,0.0
20551,2,551,[427 175 182 748 118],788,0,1962,3.5543478260869565,0.0,0.0
20552,2,552,[385  22 175 237 603],13,4,1966,3.5551537070524413,20.0,0.0
20553,2,553,[132  12  50 121 143],7,4,1970,3.555956678700361,20.0,20.0
20554,2,554,[ 50  69  70  28 301],666,2,1972,3.5531531531531533,0.0,20.0
20555,2,555,[ 50 185 568 234  89],313,5,1977,3.555755395683453,0.0,20.0
20556,2,556,[ 71  56 176 173 175],13,3,1980,3.5547576301615798,0.0,0.0
20557,2,557,[ 22 742 328 183 322],92,1,1981,3.550179211469534,0.0,0.0
20558,2,558,[ 82 588  89  15 742],313,2,1983,3.547406082289803,0.0,0.0
20559,2,559,[ 96 257 204 294 268],119,4,1987,3.5482142857142858,0.0,0.0
20560,2,560,[435 153 195 275   1],536,4,1991,3.549019607843137,0.0,0.0
20561,2,561,[100 127 302  89 483],480,3,1994,3.5480427046263343,20.0,40.0
20562,2,562,[100 127 302  89 357],339,5,1999,3.5506216696269983,20.0,40.0
20563,2,563,[172  12 117 301  89],328,4,2003,3.551418439716312,20.0,0.0
20564,2,564,[234 127 175 194   8],95,4,2007,3.552212389380531,0.0,20.0
20565,2,565,[100 127 302  89 357],13,4,2011,3.5530035335689045,20.0,40.0
20566,2,566,[100 127 302  89 174],6,5,2016,3.5555555555555554,0.0,60.0
20567,2,567,[118   9  25 211 144],308,3,2019,3.5545774647887325,0.0,0.0
20568,2,568,[100 127 302  89 174],158,5,2024,3.5571177504393674,0.0,60.0
20569,2,569,[265  64  95 179 210],537,1,2025,3.5526315789473686,0.0,0.0
20570,2,570,[185 289 174  82 182],10,5,2030,3.555166374781086,0.0,20.0
20571,2,571,[100 127 302  89 174],346,3,2033,3.554195804195804,0.0,60.0
20572,2,572,[ 70 132   8 269 313],334,2,2035,3.5514834205933683,0.0,0.0
20573,2,573,[ 28 318 132 222 211],788,4,2039,3.552264808362369,20.0,0.0
20574,2,574,[100 127 302  89 174],158,5,2044,3.554782608695652,0.0,60.0
20575,2,575,[385 286   1 183 423],95,5,2049,3.5572916666666665,0.0,0.0
20576,2,576,[194  97  89 300 161],328,3,2052,3.5563258232235704,0.0,0.0
20577,2,577,[100 127 302  89 174],339,5,2057,3.5588235294117645,0.0,60.0
20578,2,578,[100 127 302  89 174],334,5,2062,3.5613126079447324,0.0,60.0
20579,2,579,[100 127 302  89 174],537,4,2066,3.5620689655172413,0.0,60.0
20580,2,580,[588  71 515  98 168],881,3,2069,3.5611015490533564,0.0,20.0
20581,2,581,[181 210 125 222 176],263,4,2073,3.5618556701030926,0.0,0.0
20582,2,582,[ 71 118 100 282 496],479,1,2074,3.5574614065180103,0.0,20.0
20583,2,583,[202 175 185 174  12],527,3,2077,3.5565068493150687,20.0,20.0
20584,2,584,[ 22 228 234 289   8],883,4,2081,3.557264957264957,0.0,0.0
20585,2,585,[742 179 174 273  12],666,2,2083,3.554607508532423,20.0,20.0
20586,2,586,[151 186 135 313  97],254,3,2086,3.55366269165247,0.0,0.0
20587,2,587,[153 195 258 286 234],102,2,2088,3.5510204081632653,0.0,0.0
20588,2,588,[143 176 568 222 294],28,4,2092,3.5517826825127337,0.0,0.0
20589,2,589,[222  69 174 405   1],738,4,2096,3.552542372881356,0.0,20.0
20590,2,590,[357 135   1  96 182],387,5,2101,3.5549915397631136,20.0,0.0
20591,2,591,[403  64 172 234  95],374,3,2104,3.554054054054054,0.0,0.0
20592,2,592,[100 127 302  89  98],346,2,2106,3.551433389544688,0.0,60.0
20593,2,593,[515 496  98 483 300],85,4,2110,3.5521885521885523,20.0,20.0
20594,2,594,[301 328 269 276 117],119,3,2113,3.5512605042016805,0.0,0.0
20595,2,595,[127 100  89 302 135],343,4,2117,3.552013422818792,0.0,40.0
20596,2,596,[127 100 302  89 135],883,5,2122,3.5544388609715245,0.0,40.0
20597,2,597,[  9 143 385 144 194],648,4,2126,3.5551839464882944,0.0,0.0
20598,2,598,[748 186 135  22 357],881,3,2129,3.5542570951585977,20.0,0.0
20599,2,599,[127 100 302  89 135],90,5,2134,3.5566666666666666,0.0,40.0
20600,2,600,[127 100 302 135  89],328,4,2138,3.557404326123128,0.0,40.0
20601,2,601,[211 197 405   8   4],318,3,2141,3.5564784053156147,0.0,0.0
20602,2,602,[127 100 302  89 174],13,5,2146,3.558872305140962,0.0,60.0
20603,2,603,[127 100 302  89 174],271,4,2150,3.5596026490066226,0.0,60.0
20604,2,604,[405 200 423 168  97],13,3,2153,3.5586776859504132,0.0,0.0
20605,2,605,[127 100 302  89 174],664,5,2158,3.561056105610561,0.0,60.0
20606,2,606,[161 186  12 286 202],379,4,2162,3.5617792421746293,20.0,0.0
20607,2,607,[127 100 302  89 174],664,5,2167,3.5641447368421053,0.0,60.0
20608,2,608,[127 100 302  89 174],271,4,2171,3.5648604269293926,0.0,60.0
20609,2,609,[127 100 302  89 174],480,4,2175,3.5655737704918034,0.0,60.0
20610,2,610,[153 180  82 200 357],343,4,2179,3.5662847790507364,20.0,0.0
20611,2,611,[257 121 118 234 568],290,3,2182,3.565359477124183,0.0,0.0
20612,2,612,[100 127 302  89 174],346,3,2185,3.564437194127243,0.0,60.0
20613,2,613,[127 100 302  89 174],271,4,2189,3.5651465798045603,0.0,60.0
20614,2,614,[186 204 183 282 257],95,5,2194,3.567479674796748,0.0,0.0
20615,2,615,[471 483  22 181 186],328,4,2198,3.5681818181818183,20.0,0.0
20616,2,616,[181 496 202 301 194],378,2,2200,3.565640194489465,0.0,0.0
20617,2,617,[127 100 302 174  89],343,4,2204,3.5663430420711975,0.0,60.0
20618,2,618,[  4  98 197 180  96],524,4,2208,3.5670436187399033,0.0,20.0
20619,2,619,[127 100 302 174  89],343,4,2212,3.567741935483871,0.0,60.0
20620,2,620,[180 403 118 174 215],13,4,2216,3.5684380032206118,0.0,20.0
20621,2,621,[127 100 302 174 183],6,5,2221,3.5707395498392285,0.0,60.0
20622,2,622,[127 100 302 174 183],537,3,2224,3.5698234349919744,0.0,60.0
20623,2,623,[153 471 289 313 173],13,2,2226,3.5673076923076925,0.0,0.0
20624,2,624,[655 742 568 200 172],804,4,2230,3.568,0.0,0.0
20625,2,625,[238 174 200  15 508],537,2,2232,3.5654952076677318,0.0,20.0
20626,2,626,[405 196  28 265 153],379,4,2236,3.5661881977671452,0.0,0.0
20627,2,627,[ 69 265 118 117 121],881,4,2240,3.56687898089172,0.0,0.0
20628,2,628,[127 100 302 357  89],474,5,2245,3.5691573926868045,20.0,40.0
20629,2,629,[471 257 200 742 121],145,4,2249,3.56984126984127,0.0,0.0
20630,2,630,[127 100 302 357  89],13,4,2253,3.5705229793977815,20.0,40.0
20631,2,631,[ 89 323 275   8 318],328,3,2256,3.569620253164557,20.0,0.0
20632,2,632,[127 100 302  89 174],537,4,2260,3.5703001579778832,0.0,60.0
20633,2,633,[127 100 302  89 313],271,4,2264,3.5709779179810726,0.0,40.0
20634,2,634,[132 168 100 269 515],6,5,2269,3.573228346456693,0.0,20.0
20635,2,635,[ 89  28 228 125 117],455,2,2271,3.5707547169811322,0.0,0.0
20636,2,636,[174 210   7  64 186],59,5,2276,3.572998430141287,0.0,20.0
20637,2,637,[127 100 302 313  96],474,5,2281,3.5752351097178683,0.0,40.0
20638,2,638,[168 245 121 435 427],452,3,2284,3.5743348982785603,0.0,0.0
20639,2,639,[655  89  69 603 191],454,3,2287,3.5734375,20.0,0.0
20640,2,640,[ 22 179 234  96 200],234,3,2290,3.572542901716069,0.0,0.0
20641,2,641,[117   7 222 237 288],374,4,2294,3.573208722741433,0.0,0.0
20642,2,642,[127 100 302 313 603],474,5,2299,3.5754276827371694,20.0,40.0
20643,2,643,[175  11 275 318 135],308,5,2304,3.577639751552795,20.0,0.0
20644,2,644,[127 100 302 603 313],271,5,2309,3.57984496124031,20.0,40.0
20645,2,645,[282  22  12 265 180],533,3,2312,3.5789473684210527,20.0,0.0
20646,2,646,[127 100 302 603 313],232,3,2315,3.578052550231839,20.0,40.0
20647,2,647,[100 127 302 603 135],339,5,2320,3.580246913580247,20.0,40.0
20648,2,648,[357 405 323 237 127],59,3,2323,3.579352850539291,20.0,20.0
20649,2,649,[100 127 603 302 135],90,5,2328,3.5815384615384613,20.0,40.0
20650,2,650,[294  69 237 210 135],95,2,2330,3.579109062980031,0.0,0.0
20651,2,651,[117 235 183  98  22],897,3,2333,3.5782208588957056,0.0,20.0
20652,2,652,[ 15 222 179 161 655],194,4,2337,3.578866768759571,0.0,0.0
20653,2,653,[100 127 603 302 483],90,5,2342,3.581039755351682,40.0,40.0
20654,2,654,[357 181 118  71 245],313,4,2346,3.5816793893129772,20.0,0.0
20655,2,655,[168  79 235  89  82],194,1,2347,3.5777439024390243,0.0,0.0
20656,2,656,[603 300 180 385 100],234,2,2349,3.5753424657534247,20.0,20.0
20657,2,657,[100 127 603 302 483],13,5,2354,3.5775075987841944,40.0,40.0
20658,2,658,[100 127 603 302 483],232,4,2358,3.5781487101669196,40.0,40.0
20659,2,659,[  9 182  89 175 276],334,4,2362,3.5787878787878786,0.0,0.0
20660,2,660,[195 172 483 300 161],749,4,2366,3.5794251134644477,20.0,0.0
20661,2,661,[100 127 603 302 483],537,5,2371,3.581570996978852,40.0,40.0
20662,2,662,[318 174  97 313 182],378,5,2376,3.583710407239819,20.0,20.0
20663,2,663,[187 258 496  50 135],488,4,2380,3.5843373493975905,0.0,20.0
20664,2,664,[276  69  98 151 235],537,1,2381,3.5804511278195488,0.0,20.0
20665,2,665,[100 127 603 302 483],90,5,2386,3.5825825825825826,40.0,40.0
20666,2,666,[100 127 603 302 483],339,5,2391,3.5847076461769114,40.0,40.0
20667,2,667,[265 194 238 515  88],343,4,2395,3.5853293413173652,0.0,0.0
20668,2,668,[216 276 180 423 195],194,0,2395,3.579970104633782,0.0,0.0
20669,2,669,[179  70 216 496  56],60,5,2400,3.582089552238806,0.0,0.0
20670,2,670,[748 187  12 197  71],543,4,2404,3.5827123695976155,20.0,0.0
20671,2,671,[323 176 269   4 235],13,1,2405,3.5788690476190474,0.0,0.0
20672,2,672,[ 69   4 200 174 286],474,4,2409,3.5794947994056465,0.0,20.0
20673,2,673,[588 127 258  50 268],7,4,2413,3.580118694362018,0.0,40.0
20674,2,674,[215 318 286 161 172],653,3,2416,3.5792592592592594,20.0,0.0
20675,2,675,[100 127 603 302 483],90,5,2421,3.581360946745562,40.0,40.0
20676,2,676,[185 179  71 423 597],452,4,2425,3.5819793205317576,0.0,0.0
20677,2,677,[234 568 257   9 385],378,5,2430,3.584070796460177,0.0,0.0
20678,2,678,[100 127 603 302 483],664,5,2435,3.586156111929308,40.0,40.0
20679,2,679,[100 127 603 302 483],474,5,2440,3.588235294117647,40.0,40.0
20680,2,680,[127  25 258 121 588],7,4,2444,3.5888399412628487,0.0,20.0
20681,2,681,[183 186  79 234  22],313,3,2447,3.5879765395894427,0.0,0.0
20682,2,682,[294  28 174 222 568],537,0,2447,3.5827232796486093,0.0,20.0
20683,2,683,[100 127 603 302 483],13,5,2452,3.584795321637427,40.0,40.0
20684,2,684,[403 288  96 197 237],308,3,2455,3.5839416058394162,0.0,0.0
20685,2,685,[294 175 238  56 186],653,2,2457,3.5816326530612246,0.0,0.0
20686,2,686,[100 603 127 302 483],524,4,2461,3.582241630276565,40.0,40.0
20687,2,687,[191 121 403 181 197],653,3,2464,3.5813953488372094,0.0,0.0
20688,2,688,[100 127 603 302 483],745,3,2467,3.5805515239477503,40.0,40.0
20689,2,689,[357   4 173 385  64],474,5,2472,3.582608695652174,20.0,0.0
20690,2,690,[100 127 603 302 483],339,5,2477,3.58465991316932,40.0,40.0
20691,2,691,[268 357 475 471 174],90,4,2481,3.5852601156069364,20.0,20.0
20692,2,692,[100 127 603 302 483],13,5,2486,3.5873015873015874,40.0,40.0
20693,2,693,[100 127 603 302 483],524,4,2490,3.5878962536023056,40.0,40.0
20694,2,694,[228 196 210 194  70],215,4,2494,3.5884892086330935,0.0,0.0
20695,2,695,[100 127 302 603 483],458,5,2499,3.5905172413793105,40.0,40.0
20696,2,696,[100 127 302 603 483],666,5,2504,3.592539454806313,40.0,40.0
20697,2,697,[195 210 268 174 496],234,1,2505,3.5888252148997135,0.0,20.0
20698,2,698,[211 301  71  98 323],788,2,2507,3.586552217453505,0.0,20.0
20699,2,699,[100 127 302 603 483],13,5,2512,3.5885714285714285,40.0,40.0
20700,2,700,[100 127 302 603 483],90,5,2517,3.5905848787446506,40.0,40.0
20701,2,701,[100 127 302 603 483],10,5,2522,3.5925925925925926,40.0,40.0
20702,2,702,[100 127 302 603 483],13,5,2527,3.5945945945945947,40.0,40.0
20703,2,703,[ 25 546  79 289 197],881,2,2529,3.5923295454545454,0.0,0.0
20704,2,704,[100 127 603 302 483],666,5,2534,3.594326241134752,40.0,40.0
20705,2,705,[ 89 118 151 211 301],560,2,2536,3.592067988668555,0.0,0.0
20706,2,706,[568 118 269 313  98],13,3,2539,3.5912305516265914,0.0,20.0
20707,2,707,[508  82 257 313 546],92,2,2541,3.5889830508474576,0.0,0.0
20708,2,708,[100 127 603 302 483],474,5,2546,3.590973201692525,40.0,40.0
20709,2,709,[403 655 588  50 174],881,2,2548,3.5887323943661973,0.0,40.0
20710,2,710,[100 127 603 302 483],474,5,2553,3.590717299578059,40.0,40.0
20711,2,711,[ 82 172 269 405 222],666,1,2554,3.587078651685393,0.0,0.0
20712,2,712,[180 496 403 222  50],60,4,2558,3.58765778401122,0.0,20.0
20713,2,713,[100 127 603 302 483],524,4,2562,3.588235294117647,40.0,40.0
20714,2,714,[ 96   1  98 187 228],234,2,2564,3.586013986013986,0.0,20.0
20715,2,715,[100 127 302 483 603],334,5,2569,3.5879888268156424,40.0,40.0
20716,2,716,[ 95 196   1 238  22],271,4,2573,3.588563458856346,0.0,0.0
20717,2,717,[  8 435 176  79 125],7,4,2577,3.5891364902506964,0.0,0.0
20718,2,718,[483 132 144 210 423],13,4,2581,3.58970792767733,20.0,0.0
20719,2,719,[238 186 117 427 200],334,3,2584,3.588888888888889,0.0,0.0
20720,2,720,[286 174 385 427  97],452,5,2589,3.590846047156727,0.0,20.0
20721,2,721,[181   9 210 151 588],298,4,2593,3.5914127423822713,0.0,0.0
20722,2,722,[ 97  89 588 216 318],848,4,2597,3.591977869986169,20.0,0.0
20723,2,723,[ 71  12 176 168 228],92,5,2602,3.5939226519337018,20.0,0.0
20724,2,724,[496 172 117 186   8],899,5,2607,3.595862068965517,0.0,0.0
20725,2,725,[100 127 302 483 603],339,5,2612,3.597796143250689,40.0,40.0
20726,2,726,[ 97 328 268   9 301],145,4,2616,3.5983493810178815,0.0,0.0
20727,2,727,[257 403 200  98 423],254,2,2618,3.5961538461538463,0.0,20.0
20728,2,728,[  7 333 271  96 211],13,2,2620,3.5939643347050754,0.0,0.0
20729,2,729,[100 127 483 302 603],524,4,2624,3.5945205479452054,40.0,40.0
20730,2,730,[100 127 483 302 603],524,4,2628,3.595075239398085,40.0,40.0
20731,2,731,[ 79 200 289 187 678],334,3,2631,3.5942622950819674,0.0,0.0
20732,2,732,[135 186 265 191 403],7,5,2636,3.5961800818553886,0.0,0.0
20733,2,733,[100 127 483 302 313],328,5,2641,3.5980926430517712,20.0,40.0
20734,2,734,[100 127 483 302 313],207,4,2645,3.598639455782313,20.0,40.0
20735,2,735,[202 294 143 161  22],234,1,2646,3.595108695652174,0.0,0.0
20736,2,736,[483 180  71 174 172],325,3,2649,3.594301221166893,20.0,20.0
20737,2,737,[100 127 483 302 313],13,5,2654,3.5962059620596207,20.0,40.0
20738,2,738,[100 127 483 302 313],329,5,2659,3.598105548037889,20.0,40.0
20739,2,739,[ 79 186 185   4 179],194,4,2663,3.598648648648649,0.0,0.0
20740,2,740,[181 172 265  64 191],234,2,2665,3.5964912280701755,0.0,0.0
20741,2,741,[100 127 483 302 313],334,5,2670,3.5983827493261455,20.0,40.0
20742,2,742,[168 288 357 427 301],666,4,2674,3.5989232839838494,20.0,0.0
20743,2,743,[173 568 294  25 118],13,1,2675,3.5954301075268815,0.0,0.0
20744,2,744,[588  69 235 211 195],406,5,2680,3.597315436241611,0.0,0.0
20745,2,745,[100 127 483 302 313],13,5,2685,3.599195710455764,20.0,40.0
20746,2,746,[100 127 483 302 313],329,5,2690,3.6010709504685408,20.0,40.0
20747,2,747,[100 127 483 302 313],329,5,2695,3.6029411764705883,20.0,40.0
20748,2,748,[423 132 215 183  50],536,4,2699,3.6034712950600802,0.0,20.0
20749,2,749,[546 603 357 588  70],7,4,2703,3.604,40.0,0.0
20750,2,750,[100 127 483 302 313],474,5,2708,3.605858854860186,20.0,40.0
20751,2,751,[435 318 143 118 187],648,3,2711,3.6050531914893615,20.0,0.0
20752,2,752,[100 127 483 302 313],13,5,2716,3.6069057104913678,20.0,40.0
20753,2,753,[118  82 127  50  97],194,1,2717,3.603448275862069,0.0,40.0
20754,2,754,[508  11 276 275 235],82,2,2719,3.6013245033112584,0.0,0.0
20755,2,755,[ 12 235 508 125 100],825,4,2723,3.6018518518518516,20.0,20.0
20756,2,756,[100 127 483 302 313],328,5,2728,3.603698811096433,20.0,40.0
20757,2,757,[100 127 483 302 313],328,5,2733,3.6055408970976255,20.0,40.0
20758,2,758,[515 238  56 234 181],279,2,2735,3.6034255599472993,0.0,0.0
20759,2,759,[100 127 483 302 313],329,5,2740,3.6052631578947367,20.0,40.0
20760,2,760,[111 176  50 276 323],825,3,2743,3.6044678055190538,0.0,20.0
20761,2,761,[100 127 483 302 313],90,5,2748,3.606299212598425,20.0,40.0
20762,2,762,[100 127 483 302 313],328,5,2753,3.6081258191349934,20.0,40.0
20763,2,763,[100 127 483 302 313],90,5,2758,3.6099476439790577,20.0,40.0
20764,2,764,[258 568 234   9 222],311,5,2763,3.611764705882353,0.0,0.0
20765,2,765,[175 197 234 423 186],659,4,2767,3.612271540469974,0.0,0.0
20766,2,766,[ 28 210  89  50 603],897,5,2772,3.6140808344198176,20.0,20.0
20767,2,767,[238 187 423 191 288],13,2,2774,3.6119791666666665,0.0,0.0
20768,2,768,[186 196  88 118 385],308,3,2777,3.611183355006502,0.0,0.0
20769,2,769,[273 196 183 181 121],774,1,2778,3.6077922077922078,0.0,0.0
20770,2,770,[ 15 238 289  96 318],234,2,2780,3.6057068741893645,20.0,0.0
20771,2,771,[286 161 276 187  79],13,3,2783,3.604922279792746,0.0,0.0
20772,2,772,[403 282 211 427 153],326,3,2786,3.6041397153945667,0.0,0.0
20773,2,773,[100 127 483 302 313],207,4,2790,3.604651162790698,20.0,40.0
20774,2,774,[100 127 483 302 313],13,5,2795,3.606451612903226,20.0,40.0
20775,2,775,[286 245 180  64 216],328,4,2799,3.606958762886598,0.0,0.0
20776,2,776,[153 333 194 748 301],328,0,2799,3.6023166023166024,0.0,0.0
20777,2,777,[300 204 182 496 202],533,4,2803,3.602827763496144,0.0,0.0
20778,2,778,[ 50 176 546 742 161],650,2,2805,3.600770218228498,0.0,20.0
20779,2,779,[  8  70  28 403 176],7,3,2808,3.6,0.0,0.0
20780,2,780,[100 127 483 302 313],329,5,2813,3.6017925736235594,20.0,40.0
20781,2,781,[180  95 191 333 748],13,3,2816,3.601023017902813,0.0,0.0
20782,2,782,[100 127 483 302 313],334,5,2821,3.602809706257982,20.0,40.0
20783,2,783,[ 50 118 100 235 121],643,4,2825,3.6033163265306123,0.0,40.0
20784,2,784,[153 191   1 174 161],308,4,2829,3.6038216560509553,0.0,20.0
20785,2,785,[286  82 282   9 678],881,2,2831,3.6017811704834606,0.0,0.0
20786,2,786,[301  25 385 153 237],90,5,2836,3.6035578144853875,0.0,0.0
20787,2,787,[ 98  50 288 185 179],308,4,2840,3.6040609137055837,0.0,40.0
20788,2,788,[496 655 276  50  79],42,3,2843,3.6032953105196452,0.0,20.0
20789,2,789,[257 172 742 176 153],666,2,2845,3.6012658227848102,0.0,0.0
20790,2,790,[222  64 328 275  71],533,5,2850,3.6030341340075855,0.0,0.0
20791,2,791,[172  96 125 143 300],533,5,2855,3.6047979797979797,0.0,0.0
20792,2,792,[318 195 294 265   4],234,2,2857,3.6027742749054226,20.0,0.0
20793,2,793,[125 405  95 121 179],897,3,2860,3.602015113350126,0.0,0.0
20794,2,794,[100 127 483 302 313],334,5,2865,3.6037735849056602,20.0,40.0
20795,2,795,[211 318  25 289 385],537,2,2867,3.601758793969849,20.0,0.0
20796,2,796,[216 210 318  50 135],378,4,2871,3.602258469259724,20.0,20.0
20797,2,797,[100 127 483 302 313],13,5,2876,3.6040100250626566,20.0,40.0
20798,2,798,[ 96 357 204 111 175],59,5,2881,3.6057571964956194,20.0,0.0
20799,2,799,[357 515 258 265 300],488,5,2886,3.6075,20.0,0.0
20800,2,800,[173 275 204 235 181],648,5,2891,3.6092384519350813,0.0,0.0
20801,2,801,[100 127 483 313 302],207,4,2895,3.609725685785536,20.0,40.0
20802,2,802,[496 132 143 175  69],653,1,2896,3.6064757160647574,0.0,0.0
20803,2,803,[ 82 265 211 435 403],194,3,2899,3.605721393034826,0.0,0.0
20804,2,804,[ 71 483 269  69  89],334,2,2901,3.603726708074534,20.0,0.0
20805,2,805,[318 174 215   7 748],346,3,2904,3.6029776674937963,20.0,20.0
20806,2,806,[127 100 483 313 302],537,5,2909,3.6047087980173482,20.0,40.0
20807,2,807,[127 100 483 313 302],90,5,2914,3.6064356435643563,20.0,40.0
20808,2,808,[  8  88  82 127   7],343,5,2919,3.608158220024722,0.0,20.0
20809,2,809,[204 168 143  28 282],311,4,2923,3.608641975308642,0.0,0.0
20810,2,810,[195 234 265 568 186],897,4,2927,3.6091245376078915,0.0,0.0
20811,2,811,[271   9  15 568 235],92,1,2928,3.605911330049261,0.0,0.0
20812,2,812,[127 100 483 313 302],13,5,2933,3.607626076260763,20.0,40.0
20813,2,813,[127 100 483 313 302],537,5,2938,3.6093366093366095,20.0,40.0
20814,2,814,[127 100 483 313 302],537,5,2943,3.611042944785276,20.0,40.0
20815,2,815,[127 100 483 313 302],13,5,2948,3.6127450980392157,20.0,40.0
20816,2,816,[161 111 258 288 132],474,4,2952,3.613219094247246,0.0,0.0
20817,2,817,[127 100 483 313 302],328,5,2957,3.6149144254278727,20.0,40.0
20818,2,818,[ 69 195 385 471 153],13,2,2959,3.612942612942613,0.0,0.0
20819,2,819,[197 245 471  89 222],378,1,2960,3.6097560975609757,0.0,0.0
20820,2,820,[435 234 172 175 179],59,5,2965,3.6114494518879416,0.0,0.0
20821,2,821,[483 210 172  96 181],479,5,2970,3.613138686131387,20.0,0.0
20822,2,822,[127 100 483 313 302],207,4,2974,3.6136087484811665,20.0,40.0
20823,2,823,[173  25 179 211 181],666,3,2977,3.612864077669903,0.0,0.0
20824,2,824,[ 96 174 286 121 200],60,5,2982,3.6145454545454547,0.0,20.0
20825,2,825,[515 568 289 471   9],13,0,2982,3.610169491525424,0.0,0.0
20826,2,826,[ 71 179 496 182 276],308,4,2986,3.610640870616687,0.0,0.0
20827,2,827,[100 174 275 144 603],13,4,2990,3.611111111111111,20.0,40.0
20828,2,828,[191 125  95 515   9],200,5,2995,3.6127864897466826,0.0,0.0
20829,2,829,[ 96  25 471 588 180],313,4,2999,3.613253012048193,0.0,0.0
20830,2,830,[127 483 100 313 302],13,5,3004,3.614921780986763,20.0,40.0
20831,2,831,[588 174 185 222  50],42,5,3009,3.6165865384615383,0.0,40.0
20832,2,832,[ 25 172   9 121 405],378,4,3013,3.617046818727491,0.0,0.0
20833,2,833,[ 96 423 405 111 300],653,2,3015,3.615107913669065,0.0,0.0
20834,2,834,[323 222 185 117 197],650,3,3018,3.61437125748503,0.0,0.0
20835,2,835,[568 483 318 475 588],13,2,3020,3.61244019138756,40.0,0.0
20836,2,836,[127 483 100 313 302],13,5,3025,3.6140979689366786,20.0,40.0
20837,2,837,[127 483 100 313 302],207,4,3029,3.6145584725536994,20.0,40.0
20838,2,838,[127 483 100 313 302],334,5,3034,3.6162097735399286,20.0,40.0
20839,2,839,[  9 161 100 237 210],374,4,3038,3.6166666666666667,0.0,20.0
20840,2,840,[127 483 100 313 302],13,5,3043,3.618311533888228,20.0,40.0
20841,2,841,[100  15 121 597  98],308,1,3044,3.6152019002375297,0.0,40.0
20842,2,842,[127 483 100 313 302],474,5,3049,3.616844602609727,20.0,40.0
20843,2,843,[127 483 100 313 302],328,5,3054,3.618483412322275,20.0,40.0
20844,2,844,[200 202  79 127  89],409,3,3057,3.617751479289941,0.0,20.0
20845,2,845,[403 187 483 269 655],325,3,3060,3.617021276595745,20.0,0.0
20846,2,846,[265 204 515 176 117],263,4,3064,3.617473435655254,0.0,0.0
20847,2,847,[127 275 258 357 135],465,4,3068,3.6179245283018866,20.0,20.0
20848,2,848,[435 301 748 597   8],328,1,3069,3.614840989399293,0.0,0.0
20849,2,849,[483 127 100 313 302],13,5,3074,3.6164705882352943,20.0,40.0
20850,2,850,[655  96 195 153 288],666,2,3076,3.6145710928319623,0.0,0.0
20851,2,851,[483 127 100 313 302],13,5,3081,3.6161971830985915,20.0,40.0
20852,2,852,[ 69 168  22 185 183],326,3,3084,3.615474794841735,0.0,0.0
20853,2,853,[318 100 275 515  88],311,4,3088,3.6159250585480094,20.0,20.0
20854,2,854,[211 168   1 385 196],653,2,3090,3.6140350877192984,0.0,0.0
20855,2,855,[195 265 748 181  97],474,4,3094,3.614485981308411,0.0,0.0
20856,2,856,[  9 197 245 238   8],488,1,3095,3.6114352392065343,0.0,0.0
20857,2,857,[144 318 202 508   4],527,1,3096,3.6083916083916083,20.0,0.0
20858,2,858,[483 127 313 100 302],13,5,3101,3.610011641443539,20.0,40.0
20859,2,859,[496 186 168 132 215],890,4,3105,3.61046511627907,0.0,0.0
20860,2,860,[568  25  69 265 546],13,2,3107,3.608594657375145,0.0,0.0
20861,2,861,[483 127 313 100 302],90,5,3112,3.6102088167053363,20.0,40.0
20862,2,862,[237 655 185  79 215],308,3,3115,3.609501738122827,0.0,0.0
20863,2,863,[187 265  96 183  12],64,5,3120,3.611111111111111,20.0,0.0
20864,2,864,[180 435 200 269 289],378,3,3123,3.610404624277457,0.0,0.0
20865,2,865,[471 185 237  15 194],653,0,3123,3.6062355658198615,0.0,0.0
20866,2,866,[ 12 289 127 323 678],455,1,3124,3.6032295271049595,20.0,20.0
20867,2,867,[186 568 143 173 172],659,3,3127,3.6025345622119818,0.0,0.0
20868,2,868,[483 127 313 100 302],474,5,3132,3.6041426927502878,20.0,40.0
20869,2,869,[222 200   8 182 475],479,4,3136,3.6045977011494252,0.0,0.0
20870,2,870,[483 127 313 100 302],232,3,3139,3.6039035591274398,20.0,40.0
20871,2,871,[ 98 318 174 276 237],406,4,3143,3.604357798165138,20.0,40.0
20872,2,872,[135 182 603  82  56],385,3,3146,3.6036655211912945,20.0,0.0
20873,2,873,[483 127 100 313 302],334,5,3151,3.6052631578947367,20.0,40.0
20874,2,874,[121  56 655 168 185],334,4,3155,3.605714285714286,0.0,0.0
20875,2,875,[483 127 100 313 302],537,5,3160,3.6073059360730593,20.0,40.0
20876,2,876,[483 127 100 313 302],474,5,3165,3.6088939566704674,20.0,40.0
20877,2,877,[483 127 100 313 302],334,5,3170,3.6104783599088837,20.0,40.0
20878,2,878,[215 258 423  56  70],234,1,3171,3.6075085324232083,0.0,0.0
20879,2,879,[318  79 151  12  69],7,5,3176,3.609090909090909,40.0,0.0
20880,2,880,[127  71 210 161 186],311,4,3180,3.6095346197502836,0.0,20.0
20881,2,881,[483 127 100 313 302],13,5,3185,3.611111111111111,20.0,40.0
20882,2,882,[483 127 100 313 302],232,3,3188,3.6104190260475653,20.0,40.0
20883,2,883,[294   9 289 245  82],378,3,3191,3.6097285067873304,0.0,0.0
20884,2,884,[508  11 176 333 237],537,1,3192,3.606779661016949,0.0,0.0
20885,2,885,[173 121 257 655  88],479,5,3197,3.608352144469526,0.0,0.0
20886,2,886,[483 127 100 302 313],328,5,3202,3.6099210822998873,20.0,40.0
20887,2,887,[483 127 100 302 313],537,5,3207,3.6114864864864864,20.0,40.0
20888,2,888,[483 127 100 302 313],90,5,3212,3.613048368953881,20.0,40.0
20889,2,889,[483 127 100 302 313],328,5,3217,3.614606741573034,20.0,40.0
20890,2,890,[153 176 191 238  56],334,4,3221,3.6150392817059482,0.0,0.0
20891,2,891,[483 127 100 302 313],334,5,3226,3.616591928251121,20.0,40.0
20892,2,892,[117 172  69  82  56],92,4,3230,3.617021276595745,0.0,0.0
20893,2,893,[483 127 100 302 313],474,5,3235,3.6185682326621924,20.0,40.0
20894,2,894,[496  71 185 197 182],7,5,3240,3.6201117318435756,0.0,0.0
20895,2,895,[ 82 288 172 385 300],666,0,3240,3.6160714285714284,0.0,0.0
20896,2,896,[385 125  56  82 143],653,3,3243,3.6153846153846154,0.0,0.0
20897,2,897,[172 168  28 118 228],92,3,3246,3.6146993318485525,0.0,0.0
20898,2,898,[483 127 100 313 302],232,3,3249,3.6140155728587318,20.0,40.0
20899,2,899,[135 546 153 228  50],95,3,3252,3.6133333333333333,0.0,20.0
20900,2,900,[483 127 100 302 313],537,5,3257,3.6148723640399556,20.0,40.0
20901,2,901,[  4 265 194   7 172],194,3,3260,3.614190687361419,0.0,0.0
20902,2,902,[183 568 588  70 257],378,5,3265,3.6157253599114063,0.0,0.0
20903,2,903,[117 423   7  69 289],474,4,3269,3.6161504424778763,0.0,0.0
20904,2,904,[ 96 135 245 143  28],454,3,3272,3.6154696132596684,0.0,0.0
20905,2,905,[483 127 100 302 313],537,5,3277,3.616997792494481,20.0,40.0
20906,2,906,[483 127 100 302 313],328,5,3282,3.6185226019845644,20.0,40.0
20907,2,907,[483 127 100 302 313],207,4,3286,3.618942731277533,20.0,40.0
20908,2,908,[174 508  79 258 215],59,4,3290,3.6193619361936196,0.0,20.0
20909,2,909,[483 127 100 302 313],13,5,3295,3.620879120879121,20.0,40.0
20910,2,910,[483 127 100 302 313],537,5,3300,3.622392974753019,20.0,40.0
20911,2,911,[483 127 100 302 313],232,3,3303,3.6217105263157894,20.0,40.0
20912,2,912,[483 127 100 302 313],207,4,3307,3.6221248630887186,20.0,40.0
20913,2,913,[288 435  82 323  95],13,2,3309,3.6203501094091903,0.0,0.0
20914,2,914,[496 195 483 655 117],537,2,3311,3.6185792349726777,20.0,0.0
20915,2,915,[483 127 100 302 313],328,5,3316,3.6200873362445414,20.0,40.0
20916,2,916,[216 603 179 176 655],474,5,3321,3.6215921483097055,20.0,0.0
20917,2,917,[  7 238 202 282  69],653,1,3322,3.6187363834422657,0.0,0.0
20918,2,918,[ 97 127  11   4 183],7,4,3326,3.619151251360174,0.0,20.0
20919,2,919,[121 181 423 144 176],899,3,3329,3.618478260869565,0.0,0.0
20920,2,920,[135 282 176 597 245],328,2,3331,3.6167209554831703,0.0,0.0
20921,2,921,[483 127 100 302 313],474,5,3336,3.6182212581344904,20.0,40.0
20922,2,922,[197  56 483 288 238],833,2,3338,3.61646803900325,20.0,0.0
20923,2,923,[318 195 273 187 211],59,4,3342,3.616883116883117,20.0,0.0
20924,2,924,[210 301 179  88 143],234,0,3342,3.612972972972973,0.0,0.0
20925,2,925,[483 127 100 302 313],90,5,3347,3.6144708423326133,20.0,40.0
20926,2,926,[179 515 597 435 176],643,4,3351,3.614886731391586,0.0,0.0
20927,2,927,[  4 202  50 222 118],13,4,3355,3.615301724137931,0.0,20.0
20928,2,928,[222 515 228 282 191],455,3,3358,3.614639397201292,0.0,0.0
20929,2,929,[ 70   7 357 168  82],932,4,3362,3.6150537634408604,20.0,0.0
20930,2,930,[ 79  82 357 194  12],666,2,3364,3.6133190118152525,40.0,0.0
20931,2,931,[483 127 100 302 313],537,5,3369,3.6148068669527897,20.0,40.0
20932,2,932,[172 118 216  28  88],738,2,3371,3.613076098606645,0.0,0.0
20933,2,933,[483 127 100 302 313],329,5,3376,3.6145610278372593,20.0,40.0
20934,2,934,[483 127 100 302 313],13,5,3381,3.6160427807486633,20.0,40.0
20935,2,935,[195 173 202  50 496],666,3,3384,3.6153846153846154,0.0,20.0
20936,2,936,[185 405   4 318  11],271,3,3387,3.614727854855923,20.0,0.0
20937,2,937,[194 546 222  12 121],339,4,3391,3.615138592750533,20.0,0.0
20938,2,938,[ 50  15  79 265 597],145,4,3395,3.615548455804047,0.0,20.0
20939,2,939,[546 294 200 197 282],95,2,3397,3.6138297872340424,0.0,0.0
20940,2,940,[182  64 191 195  79],95,4,3401,3.614240170031881,0.0,0.0
20941,2,941,[282 423  70 215 300],311,5,3406,3.6157112526539277,0.0,0.0
20942,2,942,[ 70  64 215  71 568],42,4,3410,3.616118769883351,0.0,0.0
20943,2,943,[483 127 100 302 313],334,5,3415,3.617584745762712,20.0,40.0
20944,2,944,[483 127 100 302 313],474,5,3420,3.619047619047619,20.0,40.0
20945,2,945,[742 186 185 286  89],95,3,3423,3.6183932346723044,0.0,0.0
20946,2,946,[185 546 216   4 174],648,4,3427,3.6187961985216472,0.0,20.0
20947,2,947,[483 127 100 302 313],232,3,3430,3.6181434599156117,20.0,40.0
20948,2,948,[186  64 174 179 546],343,4,3434,3.61854583772392,0.0,20.0
20949,2,949,[357 228  88 222 211],311,4,3438,3.6189473684210527,20.0,0.0
20950,2,950,[  4 215 234 175 200],308,3,3441,3.6182965299684544,0.0,0.0
20951,2,951,[ 22 174 357 265 183],653,4,3445,3.6186974789915967,20.0,20.0
20952,2,952,[235 211  64 403 183],788,3,3448,3.6180482686253934,0.0,0.0
20953,2,953,[196  56  15 204 168],749,4,3452,3.6184486373165616,0.0,0.0
20954,2,954,[568 215 385 546 483],881,4,3456,3.618848167539267,20.0,0.0
20955,2,955,[258 215 135 265 168],474,4,3460,3.6192468619246863,0.0,0.0
20956,2,956,[483 127 100 302 313],13,5,3465,3.6206896551724137,20.0,40.0
20957,2,957,[483 127 100 302 313],90,5,3470,3.6221294363256784,20.0,40.0
20958,2,958,[483 127 100 302 313],334,5,3475,3.6235662148070906,20.0,40.0
20959,2,959,[655 111 435 275 210],64,4,3479,3.6239583333333334,0.0,0.0
20960,2,960,[161 194 195 143 185],339,3,3482,3.623309053069719,0.0,0.0
20961,2,961,[202 174 282 742  71],554,3,3485,3.6226611226611225,0.0,20.0
20962,2,962,[173 515 111 318 405],488,4,3489,3.6230529595015577,20.0,0.0
20963,2,963,[215 286 121 234 333],328,3,3492,3.6224066390041494,0.0,0.0
20964,2,964,[204  95 742 300 237],313,2,3494,3.6207253886010364,0.0,0.0
20965,2,965,[238 173 257 194 118],378,4,3498,3.62111801242236,0.0,0.0
20966,2,966,[194  98 202 603  96],537,1,3499,3.6184074457083764,20.0,20.0
20967,2,967,[483 127 100 302 313],13,5,3504,3.6198347107438016,20.0,40.0
20968,2,968,[294 111  97 196 204],537,0,3504,3.6160990712074303,0.0,0.0
20969,2,969,[235  64 132  12 515],279,0,3504,3.6123711340206186,20.0,0.0
20970,2,970,[300 100 405 125 271],894,2,3506,3.610710607621009,0.0,20.0
20971,2,971,[  7 294 161  50 546],648,2,3508,3.6090534979423867,0.0,20.0
20972,2,972,[143 475   1  89 546],92,3,3511,3.6084275436793423,0.0,0.0
20973,2,973,[238 135  69 118 318],454,3,3514,3.6078028747433266,20.0,0.0
20974,2,974,[ 64 289  96 385 187],328,4,3518,3.608205128205128,0.0,0.0
20975,2,975,[200  96 204 568 496],326,2,3520,3.6065573770491803,0.0,0.0
20976,2,976,[483 127 100 302 313],537,5,3525,3.6079836233367453,20.0,40.0
20977,2,977,[427 100 294 121 289],537,2,3527,3.6063394683026586,0.0,20.0
20978,2,978,[ 88 748  89 475 515],474,4,3531,3.606741573033708,0.0,0.0
20979,2,979,[483 127 100 302 313],328,5,3536,3.6081632653061226,20.0,40.0
20980,2,980,[483 127 100 302 313],90,5,3541,3.6095820591233436,20.0,40.0
20981,2,981,[168 357 172 185 235],406,4,3545,3.609979633401222,20.0,0.0
20982,2,982,[483 127 100 302 313],328,5,3550,3.6113936927772126,20.0,40.0
20983,2,983,[568 435 403 427 174],87,4,3554,3.611788617886179,0.0,20.0
20984,2,984,[318 117  22   4 385],207,2,3556,3.6101522842639593,20.0,0.0
20985,2,985,[174  98 194 183 125],298,3,3559,3.609533468559838,0.0,40.0
20986,2,986,[  1  56 318 143 515],804,3,3562,3.6089159067882473,20.0,0.0
20987,2,987,[483 127 100 302 313],328,5,3567,3.610323886639676,20.0,40.0
20988,2,988,[483 127 100 302 313],207,4,3571,3.6107178968655207,20.0,40.0
20989,2,989,[258 655   9 313 234],85,4,3575,3.611111111111111,0.0,0.0
20990,2,990,[191 588  64  82 318],64,4,3579,3.6115035317860746,20.0,0.0
20991,2,991,[ 79 300 678 496 127],749,4,3583,3.6118951612903225,0.0,20.0
20992,2,992,[483 127 302 100 313],537,5,3588,3.6132930513595167,20.0,40.0
20993,2,993,[483 127 100 302 313],334,5,3593,3.614688128772636,20.0,40.0
20994,2,994,[483 127 100 302 313],207,4,3597,3.615075376884422,20.0,40.0
20995,2,995,[483 127 302 100 313],537,5,3602,3.6164658634538154,20.0,40.0
20996,2,996,[483 127 302 100 313],334,5,3607,3.6178535606820463,20.0,40.0
20997,2,997,[186 181 204 132 323],897,4,3611,3.618236472945892,0.0,0.0
20998,2,998,[258 318 200  12 175],288,4,3615,3.6186186186186187,40.0,0.0
20999,2,999,[176  56  79 237 216],184,3,3618,3.618,0.0,0.0
21000,2,1000,[174 204 289 180 234],85,4,3622,3.618381618381618,0.0,20.0
21001,2,1001,[471  88 282 496 200],271,3,3625,3.617764471057884,0.0,0.0
21002,2,1002,[483 127 302 100 313],334,5,3630,3.6191425722831507,20.0,40.0
21003,2,1003,[215 546  12   7  79],92,4,3634,3.6195219123505975,20.0,0.0
21004,2,1004,[588 427 655 496 100],406,4,3638,3.619900497512438,0.0,20.0
21005,2,1005,[385 357 175 235 132],13,2,3640,3.618290258449304,20.0,0.0
21006,2,1006,[483 127 302 100 313],334,5,3645,3.6196623634558094,20.0,40.0
21007,2,1007,[483 127 302 100 313],334,5,3650,3.621031746031746,20.0,40.0
21008,2,1008,[127 194  97  64  22],87,5,3655,3.622398414271556,0.0,20.0
21009,2,1009,[483 127 302 100 313],90,5,3660,3.623762376237624,20.0,40.0
21010,2,1010,[483 127 302 100 313],474,5,3665,3.625123639960435,20.0,40.0
21011,2,1011,[405  50  96 187 118],653,3,3668,3.624505928853755,0.0,20.0
21012,2,1012,[423 204 132 179   8],308,4,3672,3.6248766041461007,0.0,0.0
21013,2,1013,[483 127 302 100 313],334,5,3677,3.626232741617357,20.0,40.0
21014,2,1014,[151 496  89 234 202],290,2,3679,3.6246305418719214,0.0,0.0
21015,2,1015,[748 210 216  71  88],311,5,3684,3.625984251968504,0.0,0.0
21016,2,1016,[483 127 302 100 313],328,5,3689,3.6273352999016715,20.0,40.0
21017,2,1017,[ 25 175 194   1  64],378,5,3694,3.6286836935166993,0.0,0.0
21018,2,1018,[301 174 328 194  79],85,3,3697,3.6280667320902844,0.0,20.0
21019,2,1019,[195  22 132 678  70],308,3,3700,3.627450980392157,0.0,0.0
21020,2,1020,[125 228  98 196 385],194,1,3701,3.624877571008815,0.0,20.0
21021,2,1021,[483 127 302 100 313],13,5,3706,3.6262230919765166,20.0,40.0
21022,2,1022,[423 195 151 183 655],749,5,3711,3.627565982404692,0.0,0.0
21023,2,1023,[215  79 204 210 483],313,5,3716,3.62890625,20.0,0.0
21024,2,1024,[483 127 302 100 313],13,5,3721,3.6302439024390245,20.0,40.0
21025,2,1025,[483 127 302 100 313],334,5,3726,3.6315789473684212,20.0,40.0
21026,2,1026,[483 127 302 100 313],328,5,3731,3.632911392405063,20.0,40.0
21027,2,1027,[ 69 483 357 186  15],881,2,3733,3.6313229571984436,40.0,0.0
21028,2,1028,[ 64 475 202 127 318],13,3,3736,3.630709426627794,20.0,20.0
21029,2,1029,[588 202  69 183 216],892,5,3741,3.6320388349514565,0.0,0.0
21030,2,1030,[475  98 191  56 655],13,3,3744,3.6314258001939863,0.0,20.0
21031,2,1031,[200  98 210 176 161],774,2,3746,3.62984496124031,0.0,20.0
21032,2,1032,[496 742 245 182 385],346,5,3751,3.6311713455953534,0.0,0.0
21033,2,1033,[ 97 238 153 286  69],454,2,3753,3.629593810444874,0.0,0.0
21034,2,1034,[211 187 151 276 202],533,3,3756,3.628985507246377,0.0,0.0
21035,2,1035,[483 127 302 100 313],207,4,3760,3.629343629343629,20.0,40.0
21036,2,1036,[423  25 191 210 300],749,5,3765,3.630665380906461,0.0,0.0
21037,2,1037,[ 98 215 322 132 588],804,5,3770,3.631984585741811,0.0,20.0
21038,2,1038,[265 135 471 176  25],374,5,3775,3.63330125120308,0.0,0.0
21039,2,1039,[435 161 385   4  79],328,3,3778,3.6326923076923077,0.0,0.0
21040,2,1040,[ 79   8 195 546  64],899,4,3782,3.633045148895293,0.0,0.0
21041,2,1041,[ 98 423  70 172 197],60,5,3787,3.6343570057581576,0.0,20.0
21042,2,1042,[318 234 238 748 257],883,5,3792,3.635666347075743,20.0,0.0
21043,2,1043,[301 286 121  97 144],378,4,3796,3.636015325670498,0.0,0.0
21044,2,1044,[ 50 333 508 174 471],343,4,3800,3.6363636363636362,0.0,40.0
21045,2,1045,[483 127 302 313 100],13,5,3805,3.6376673040152965,20.0,40.0
21046,2,1046,[  7  96  28 403 237],234,1,3806,3.635148042024833,0.0,0.0
21047,2,1047,[202  11 742  70 118],653,0,3806,3.631679389312977,0.0,0.0
21048,2,1048,[483 127 302 313 100],474,5,3811,3.632983794089609,20.0,40.0
21049,2,1049,[328 318 117 211 187],328,5,3816,3.6342857142857143,20.0,0.0
21050,2,1050,[172 117  22 191 423],536,5,3821,3.6355851569933395,0.0,0.0
21051,2,1051,[483 127 302 313 100],328,5,3826,3.6368821292775664,20.0,40.0
21052,2,1052,[276 175 742  22  56],59,4,3830,3.6372269705603038,0.0,0.0
21053,2,1053,[216   7 191 427 176],234,2,3832,3.635673624288425,0.0,0.0
21054,2,1054,[483 127 302 313 100],537,5,3837,3.6369668246445497,20.0,40.0
21055,2,1055,[258   8 300 294  28],234,2,3839,3.6354166666666665,0.0,0.0
21056,2,1056,[257  69 483 496 168],804,5,3844,3.6367076631977295,20.0,0.0
21057,2,1057,[483 127 302 313 100],329,5,3849,3.6379962192816637,20.0,40.0
21058,2,1058,[269 286 228 204  98],537,0,3849,3.634560906515581,0.0,20.0
21059,2,1059,[194  98 135 180 357],881,4,3853,3.6349056603773584,20.0,20.0
21060,2,1060,[168 181 191 405 172],934,5,3858,3.636192271442036,0.0,0.0
21061,2,1061,[483 127 302 313 100],474,5,3863,3.6374764595103577,20.0,40.0
21062,2,1062,[ 22 179 186 546 678],13,2,3865,3.6359360301034807,0.0,0.0
21063,2,1063,[288 186 179 204 234],239,1,3866,3.6334586466165413,0.0,0.0
21064,2,1064,[ 88 195 100 258 322],533,5,3871,3.634741784037559,0.0,20.0
21065,2,1065,[172 200 168 118 151],890,4,3875,3.6350844277673544,0.0,0.0
21066,2,1066,[195 275 211 276  88],298,3,3878,3.6344892221180882,0.0,0.0
21067,2,1067,[181  50  25 228 172],650,4,3882,3.634831460674157,0.0,20.0
21068,2,1068,[182  98  15 183 117],194,2,3884,3.6333021515434987,0.0,20.0
21069,2,1069,[483 127 302 313 100],334,5,3889,3.6345794392523363,20.0,40.0
21070,2,1070,[174 121 238 197 423],643,4,3893,3.634920634920635,0.0,20.0
21071,2,1071,[173  22 179 515 288],92,2,3895,3.6333955223880596,0.0,0.0
21072,2,1072,[483 127 302 313 100],90,5,3900,3.6346691519105314,20.0,40.0
21073,2,1073,[135 182 234 132 289],537,2,3902,3.633147113594041,0.0,0.0
21074,2,1074,[215 265 234 435  56],650,3,3905,3.6325581395348836,0.0,0.0
21075,2,1075,[117 385 265 176 135],479,3,3908,3.6319702602230484,0.0,0.0
21076,2,1076,[483 127 302 313 100],329,5,3913,3.6332404828226554,20.0,40.0
21077,2,1077,[ 22 357 172 135  56],533,2,3915,3.631725417439703,20.0,0.0
21078,2,1078,[483 127 302 313 100],334,5,3920,3.6329935125115846,20.0,40.0
21079,2,1079,[483 127 302 313 100],13,5,3925,3.634259259259259,20.0,40.0
21080,2,1080,[483 127 302 313 100],13,5,3930,3.635522664199815,20.0,40.0
21081,2,1081,[742 121 597  71  70],554,4,3934,3.635859519408503,0.0,0.0
21082,2,1082,[483 127 302 313 100],207,4,3938,3.6361957525392428,20.0,40.0
21083,2,1083,[186 118 200  89 132],343,2,3940,3.6346863468634685,0.0,0.0
21084,2,1084,[748 568 405  56 265],200,3,3943,3.6341013824884794,0.0,0.0
21085,2,1085,[195 161  88  69 100],830,4,3947,3.634438305709024,0.0,20.0
21086,2,1086,[385 655 265   8 405],474,5,3952,3.6356945722171115,0.0,0.0
21087,2,1087,[ 15 678  64 423 181],308,3,3955,3.635110294117647,0.0,0.0
21088,2,1088,[ 28  22 204   1 403],59,4,3959,3.63544536271809,0.0,0.0
21089,2,1089,[483 238  56 475 144],10,5,3964,3.636697247706422,20.0,0.0
21090,2,1090,[286 195 597 515 174],7,3,3967,3.6361136571952337,0.0,20.0
21091,2,1091,[483 127 302 313 100],13,5,3972,3.6373626373626373,20.0,40.0
21092,2,1092,[483 127 302 313 100],90,5,3977,3.6386093321134494,20.0,40.0
21093,2,1093,[269  50 195  25 435],339,4,3981,3.6389396709323583,0.0,20.0
21094,2,1094,[ 64 222 328   1 135],378,2,3983,3.6374429223744293,0.0,0.0
21095,2,1095,[328  50   7 191  79],95,5,3988,3.6386861313868613,0.0,20.0
21096,2,1096,[483 127 302 313 100],537,5,3993,3.639927073837739,20.0,40.0
21097,2,1097,[300 200  88 322 258],13,2,3995,3.6384335154826957,0.0,0.0
21098,2,1098,[ 98 471 238 318 127],234,3,3998,3.637852593266606,20.0,40.0
21099,2,1099,[211 191 143 185 161],311,2,4000,3.6363636363636362,0.0,0.0
21100,2,1100,[ 79 323 172   9 483],200,4,4004,3.63669391462307,20.0,0.0
21101,2,1101,[ 96  11 496 194  50],653,2,4006,3.635208711433757,0.0,20.0
21102,2,1102,[182 153 273 385   4],346,4,4010,3.6355394378966457,0.0,0.0
21103,2,1103,[483 127 302 313 100],232,3,4013,3.634963768115942,20.0,40.0
21104,2,1104,[483 127 302 313 100],90,5,4018,3.6361990950226244,20.0,40.0
21105,2,1105,[271  98  28  64 294],379,3,4021,3.635623869801085,0.0,20.0
21106,2,1106,[328 427 215 302  64],328,3,4024,3.6350496838301716,0.0,0.0
21107,2,1107,[483 127 302 313 100],328,5,4029,3.6362815884476536,20.0,40.0
21108,2,1108,[435  50 204   7 121],194,2,4031,3.6348061316501354,0.0,20.0
21109,2,1109,[483 127 302 313 100],90,5,4036,3.636036036036036,20.0,40.0
21110,2,1110,[483 127 302 313 100],537,5,4041,3.637263726372637,20.0,40.0
21111,2,1111,[222 265 313   1 183],815,5,4046,3.6384892086330933,0.0,0.0
21112,2,1112,[151 228 546 435 588],82,2,4048,3.637017070979335,0.0,0.0
21113,2,1113,[282 186 211 175 546],207,3,4051,3.6364452423698386,0.0,0.0
21114,2,1114,[ 82 228 275 423  95],60,4,4055,3.6367713004484306,0.0,0.0
21115,2,1115,[483 127 302 313 100],329,5,4060,3.6379928315412187,20.0,40.0
21116,2,1116,[300  64 204 515 678],263,3,4063,3.6374216651745748,0.0,0.0
21117,2,1117,[174  79 211 328 568],788,3,4066,3.636851520572451,0.0,20.0
21118,2,1118,[ 56 135 186 172 151],334,3,4069,3.636282394995532,0.0,0.0
21119,2,1119,[475 546 211 357 151],308,4,4073,3.6366071428571427,20.0,0.0
21120,2,1120,[100  15 275   7 228],145,3,4076,3.6360392506690453,0.0,20.0
21121,2,1121,[  8 210 194 127 238],158,5,4081,3.6372549019607843,0.0,20.0
21122,2,1122,[173 187 286 211 234],890,4,4085,3.6375779162956365,0.0,0.0
21123,2,1123,[508  22  71 257 161],455,4,4089,3.6379003558718863,0.0,0.0
21124,2,1124,[546  79 135  89 475],13,2,4091,3.6364444444444444,0.0,0.0
21125,2,1125,[194 117 151   4 111],653,1,4092,3.6341030195381885,0.0,0.0
21126,2,1126,[301  96 273 423 405],328,3,4095,3.6335403726708075,0.0,0.0
21127,2,1127,[176 143 173 515 200],804,3,4098,3.632978723404255,0.0,0.0
21128,2,1128,[183 195 423  82 174],234,2,4100,3.6315323294951285,0.0,20.0
21129,2,1129,[ 28 313 222 180 265],328,4,4104,3.631858407079646,0.0,0.0
21130,2,1130,[483 127 302 313 100],474,5,4109,3.6330680813439433,20.0,40.0
21131,2,1131,[  9   4 121 117 269],115,3,4112,3.6325088339222615,0.0,0.0
21132,2,1132,[483 127 302 313 100],474,5,4117,3.6337157987643423,20.0,40.0
21133,2,1133,[483 127 302 313 100],90,5,4122,3.634920634920635,20.0,40.0
21134,2,1134,[483 127 302 313 100],537,5,4127,3.636123348017621,20.0,40.0
21135,2,1135,[194 282 172  96 322],119,5,4132,3.637323943661972,0.0,0.0
21136,2,1136,[ 88 228 515 405   1],92,3,4135,3.6367634124890063,0.0,0.0
21137,2,1137,[  1 121 127 174 179],749,4,4139,3.6370826010544817,0.0,40.0
21138,2,1138,[228 234 151 496  69],200,4,4143,3.637401229148376,0.0,0.0
21139,2,1139,[118 172 603  97 423],650,3,4146,3.636842105263158,20.0,0.0
21140,2,1140,[483 127 302 313 100],474,5,4151,3.638036809815951,20.0,40.0
21141,2,1141,[483 127 302 313 100],90,5,4156,3.63922942206655,20.0,40.0
21142,2,1142,[179 197 301 275 117],378,1,4157,3.636920384951881,0.0,0.0
21143,2,1143,[300 174 197 322 216],409,2,4159,3.6354895104895104,0.0,20.0
21144,2,1144,[228 117 175 172  25],279,4,4163,3.6358078602620085,0.0,0.0
21145,2,1145,[483 127 302 313 100],329,5,4168,3.636998254799302,20.0,40.0
21146,2,1146,[483 127 302 313 100],537,5,4173,3.6381865736704446,20.0,40.0
21147,2,1147,[215 204 181  95 515],263,5,4178,3.6393728222996518,0.0,0.0
21148,2,1148,[483 127 302 313 100],537,5,4183,3.640557006092254,20.0,40.0
21149,2,1149,[423 234 300  15 173],454,2,4185,3.639130434782609,0.0,0.0
21150,2,1150,[678 200 435 423 172],254,2,4187,3.637706342311034,0.0,0.0
21151,2,1151,[181 483 258  70 132],488,2,4189,3.6362847222222223,20.0,0.0
21152,2,1152,[222   7  96 742  82],119,4,4193,3.6366001734605375,0.0,0.0
21153,2,1153,[483 127 302 313 100],232,3,4196,3.636048526863085,20.0,40.0
21154,2,1154,[ 28 179 423 161   1],843,1,4197,3.633766233766234,0.0,0.0
21155,2,1155,[483 127 302 100 313],13,5,4202,3.634948096885813,20.0,40.0
21156,2,1156,[483 127 302 100 313],329,5,4207,3.6361279170267933,20.0,40.0
21157,2,1157,[ 22 186 546 423  82],339,4,4211,3.6364421416234887,0.0,0.0
21158,2,1158,[ 89 222  82 118  22],901,3,4214,3.635893011216566,0.0,0.0
21159,2,1159,[216 302 234  50 588],537,2,4216,3.6344827586206896,0.0,20.0
21160,2,1160,[483 127 302 100 313],207,4,4220,3.6347975882859602,20.0,40.0
21161,2,1161,[357  95 568 215  28],95,4,4224,3.6351118760757317,20.0,0.0
21162,2,1162,[288 475 216 265 168],334,2,4226,3.6337059329320724,0.0,0.0
21163,2,1163,[483 127 302 313 100],537,5,4231,3.6348797250859106,20.0,40.0
21164,2,1164,[483 127 302 313 100],329,5,4236,3.6360515021459228,20.0,40.0
21165,2,1165,[  4  70 118  96 237],664,1,4237,3.6337907375643224,0.0,0.0
21166,2,1166,[423 187 173   1 168],326,1,4238,3.631533847472151,0.0,0.0
21167,2,1167,[475 603   1  71 197],648,2,4240,3.6301369863013697,20.0,0.0
21168,2,1168,[ 22 181  95   7   1],378,5,4245,3.6313088109495295,0.0,0.0
21169,2,1169,[333 435 222 237 302],13,3,4248,3.6307692307692307,0.0,0.0
21170,2,1170,[483 127 302 313 100],90,5,4253,3.6319385140905207,20.0,40.0
21171,2,1171,[117  25 144 135 181],234,1,4254,3.6296928327645053,0.0,0.0
21172,2,1172,[195 597  15 196 179],92,3,4257,3.629156010230179,0.0,0.0
21173,2,1173,[483 127 302 313 100],207,4,4261,3.6294718909710393,20.0,40.0
21174,2,1174,[204  22 195 237 228],7,5,4266,3.6306382978723404,0.0,0.0
21175,2,1175,[211 127  89 185  70],13,3,4269,3.6301020408163267,0.0,20.0
21176,2,1176,[215 195  12 176 210],774,1,4270,3.6278674596431606,20.0,0.0
21177,2,1177,[483 127 302 313 100],90,5,4275,3.629032258064516,20.0,40.0
21178,2,1178,[176 286 153 483 313],890,4,4279,3.6293469041560646,20.0,0.0
21179,2,1179,[234  11  28 181   4],92,4,4283,3.6296610169491523,0.0,0.0
21180,2,1180,[237 196 273 175 286],666,2,4285,3.6282811176968672,0.0,0.0
21181,2,1181,[483 127 302 313 100],207,4,4289,3.6285956006768187,20.0,40.0
21182,2,1182,[258   1 405 182   9],271,1,4290,3.6263736263736264,0.0,0.0
21183,2,1183,[483 127 302 313 100],328,5,4295,3.6275337837837838,20.0,40.0
21184,2,1184,[ 95 186  22 127 121],881,4,4299,3.6278481012658226,0.0,20.0
21185,2,1185,[234 168 186  69 180],664,3,4302,3.627318718381113,0.0,0.0
21186,2,1186,[333  82 185 385 118],653,3,4305,3.6267902274641957,0.0,0.0
21187,2,1187,[211 194 204 173 508],537,3,4308,3.6262626262626263,0.0,0.0
21188,2,1188,[135 144  70 238 300],479,4,4312,3.6265769554247265,0.0,0.0
21189,2,1189,[ 98  79 423 215 144],804,4,4316,3.626890756302521,0.0,20.0
21190,2,1190,[117  25 215 322 144],308,1,4317,3.624685138539043,0.0,0.0
21191,2,1191,[483 127 302 313 100],334,5,4322,3.6258389261744965,20.0,40.0
21192,2,1192,[132 275 234 183 237],328,5,4327,3.6269907795473597,0.0,0.0
21193,2,1193,[132 186 258 496 423],380,3,4330,3.626465661641541,0.0,0.0
21194,2,1194,[195 234 427 180 265],474,5,4335,3.6276150627615062,0.0,0.0
21195,2,1195,[483 127 302 313 100],13,5,4340,3.62876254180602,20.0,40.0
21196,2,1196,[294 475 385  98  64],537,1,4341,3.6265664160401,0.0,20.0
21197,2,1197,[294  50 228 173 357],650,4,4345,3.6268781302170283,20.0,20.0
21198,2,1198,[200 655  25 118 143],343,2,4347,3.625521267723103,0.0,0.0
21199,2,1199,[196 475 435 234 288],474,4,4351,3.6258333333333335,0.0,0.0
21200,2,1200,[ 22 234  82  96 423],13,4,4355,3.6261448792672772,0.0,0.0
21201,2,1201,[423 174   8 427 153],60,3,4358,3.6256239600665556,0.0,20.0
21202,2,1202,[483 127 302 313 100],329,5,4363,3.626766417290108,20.0,40.0
21203,2,1203,[211 228 173 161 191],64,4,4367,3.627076411960133,0.0,0.0
21204,2,1204,[183 210 655 515 222],474,5,4372,3.6282157676348548,0.0,0.0
21205,2,1205,[ 89 204 403 185  82],13,2,4374,3.626865671641791,0.0,0.0
21206,2,1206,[ 89 191 211 182 318],454,2,4376,3.6255178127589063,20.0,0.0
21207,2,1207,[265 195  22 269 228],883,2,4378,3.6241721854304636,0.0,0.0
21208,2,1208,[588 483 508 273 333],13,2,4380,3.6228287841191067,20.0,0.0
21209,2,1209,[ 50 174 175 515  11],346,5,4385,3.62396694214876,0.0,40.0
21210,2,1210,[269 286  98 385 228],883,1,4386,3.6218001651527665,0.0,20.0
21211,2,1211,[234 173  88 313 183],378,5,4391,3.622937293729373,0.0,0.0
21212,2,1212,[655 135 179 182 195],85,3,4394,3.62242374278648,0.0,0.0
21213,2,1213,[ 82  50 118 405 273],897,4,4398,3.6227347611202636,0.0,20.0
21214,2,1214,[127 215 172 183 175],59,5,4403,3.623868312757202,0.0,20.0
21215,2,1215,[194 385 289 508 176],474,3,4406,3.6233552631578947,0.0,0.0
21216,2,1216,[151  97 238 357 237],7,5,4411,3.6244864420706655,20.0,0.0
21217,2,1217,[546 265 135 161 471],7,4,4415,3.6247947454844005,0.0,0.0
21218,2,1218,[210 265 151 405  25],42,3,4418,3.62428219852338,0.0,0.0
21219,2,1219,[238 403  95 597 174],650,2,4420,3.622950819672131,0.0,20.0
21220,2,1220,[483 127 302 313 100],328,5,4425,3.6240786240786242,20.0,40.0
21221,2,1221,[181  15 175 258 182],378,5,4430,3.6252045826513912,0.0,0.0
21222,2,1222,[195  12 288 127 176],666,3,4433,3.624693376941946,20.0,20.0
21223,2,1223,[483 127 302 313 100],329,5,4438,3.6258169934640523,20.0,40.0
21224,2,1224,[194 234 483 176 269],343,4,4442,3.626122448979592,20.0,0.0
21225,2,1225,[ 97 151 258 257 269],669,2,4444,3.624796084828711,0.0,0.0
21226,2,1226,[132   7  64  79  88],308,4,4448,3.6251018744906274,0.0,0.0
21227,2,1227,[405  98 187 678  70],334,2,4450,3.6237785016286646,0.0,20.0
21228,2,1228,[132 179  95 135 748],200,4,4454,3.624084621643613,0.0,0.0
21229,2,1229,[228 135   9 405 328],92,3,4457,3.6235772357723577,0.0,0.0
21230,2,1230,[483 127 302 313 100],329,5,4462,3.6246953696181965,20.0,40.0
21231,2,1231,[357 322  89 265 427],13,3,4465,3.624188311688312,20.0,0.0
21232,2,1232,[276   9 546 135 180],378,2,4467,3.6228710462287106,0.0,0.0
21233,2,1233,[302  12 385 508 191],378,5,4472,3.6239870340356566,20.0,0.0
21234,2,1234,[215 357 318  89 222],295,5,4477,3.6251012145748986,40.0,0.0
21235,2,1235,[655 182 181 258 483],339,4,4481,3.6254045307443366,20.0,0.0
21236,2,1236,[ 69  89 286  97 186],234,1,4482,3.6232821341956347,0.0,0.0
21237,2,1237,[288  82 144 275 323],455,2,4484,3.621970920840065,0.0,0.0
21238,2,1238,[483 127 302 313 100],207,4,4488,3.62227602905569,20.0,40.0
21239,2,1239,[144  56 322 172 271],883,4,4492,3.6225806451612903,0.0,0.0
21240,2,1240,[  8 127 175 318 515],326,3,4495,3.6220789685737307,20.0,20.0
21241,2,1241,[483 302 127 313 100],328,5,4500,3.6231884057971016,20.0,40.0
21242,2,1242,[423 135  50 132 151],254,4,4504,3.6234915526950924,0.0,20.0
21243,2,1243,[483 302 127 313 100],474,5,4509,3.62459807073955,20.0,40.0
21244,2,1244,[  4 179 483 302  70],474,5,4514,3.62570281124498,20.0,0.0
21245,2,1245,[194 151 168 125  22],648,3,4517,3.625200642054575,0.0,0.0
21246,2,1246,[288 265   8  89 508],92,4,4521,3.6255012028869285,0.0,0.0
21247,2,1247,[118 135  25  56  97],892,5,4526,3.6266025641025643,0.0,0.0
21248,2,1248,[  1 228   8 132 215],194,1,4527,3.6244995996797438,0.0,0.0
21249,2,1249,[100 235  96   4 435],524,4,4531,3.6248,0.0,20.0
21250,2,1250,[289 185 273  50 174],13,2,4533,3.6235011990407675,0.0,40.0
21251,2,1251,[211 181  95  56 515],537,3,4536,3.623003194888179,0.0,0.0
21252,2,1252,[ 69 403  88 191 210],506,5,4541,3.624102154828412,0.0,0.0
21253,2,1253,[ 56 222 568  95 228],901,4,4545,3.624401913875598,0.0,0.0
21254,2,1254,[546 234 403 273  97],378,4,4549,3.6247011952191235,0.0,0.0
21255,2,1255,[210 313 151 216  12],64,3,4552,3.624203821656051,20.0,0.0
21256,2,1256,[234 186 216 215   8],64,5,4557,3.6252983293556085,0.0,0.0
21257,2,1257,[483 302 127 313 100],537,5,4562,3.6263910969793325,20.0,40.0
21258,2,1258,[427 183 204 121 546],882,4,4566,3.6266878474980144,0.0,0.0
21259,2,1259,[ 79  11 180 181  96],804,5,4571,3.6277777777777778,0.0,0.0
21260,2,1260,[483 302 127 313 100],232,3,4574,3.627279936558287,20.0,40.0
21261,2,1261,[423 181 655 183 496],537,1,4575,3.6251980982567353,0.0,0.0
21262,2,1262,[197  97 405 318 588],378,3,4578,3.624703087885986,20.0,0.0
21263,2,1263,[121 179  64 173 196],474,5,4583,3.6257911392405062,0.0,0.0
21264,2,1264,[483 302 127 313 100],90,5,4588,3.626877470355731,20.0,40.0
21265,2,1265,[172 196  96 215 182],840,3,4591,3.626382306477093,0.0,0.0
21266,2,1266,[ 64 294 333 258  95],537,1,4592,3.6243093922651934,0.0,0.0
21267,2,1267,[496 161 121 471 204],454,4,4596,3.6246056782334386,0.0,0.0
21268,2,1268,[191   4 100  89  96],537,3,4599,3.624113475177305,0.0,20.0
21269,2,1269,[100 294 161 181 172],346,2,4601,3.6228346456692915,0.0,20.0
21270,2,1270,[135  89 144   8 294],234,2,4603,3.6215578284815106,0.0,0.0
21271,2,1271,[151 515   8 186 211],6,4,4607,3.62185534591195,0.0,0.0
21272,2,1272,[483 302 127 313 100],474,5,4612,3.6229379418695995,20.0,40.0
21273,2,1273,[ 50 515 546  98 161],13,3,4615,3.622448979591837,0.0,40.0
21274,2,1274,[ 71 748 144   1 235],64,2,4617,3.621176470588235,0.0,0.0
21275,2,1275,[289  69  56 194 175],125,3,4620,3.6206896551724137,0.0,0.0
21276,2,1276,[ 98  64 195   1 318],311,5,4625,3.6217697729052465,20.0,20.0
21277,2,1277,[228 180  88  28 151],234,1,4626,3.619718309859155,0.0,0.0
21278,2,1278,[ 82 475 195 496 237],64,4,4630,3.6200156372165755,0.0,0.0
21279,2,1279,[235 172 588 385 257],290,4,4634,3.6203125,0.0,0.0
21280,2,1280,[483 302 127 313 100],232,3,4637,3.6198282591725213,20.0,40.0
21281,2,1281,[318 245 173 323 151],378,2,4639,3.6185647425897036,20.0,0.0
21282,2,1282,[ 89   1 168  50 172],892,5,4644,3.6196414653156666,0.0,20.0
21283,2,1283,[471 204 603  70 181],308,4,4648,3.61993769470405,20.0,0.0
21284,2,1284,[173 181  12   7 300],537,2,4650,3.6186770428015564,20.0,0.0
21285,2,1285,[191 187  79 471  95],194,2,4652,3.6174183514774496,0.0,0.0
21286,2,1286,[483 302 127 313 100],328,5,4657,3.6184926184926183,20.0,40.0
21287,2,1287,[161 200 603 403 182],326,1,4658,3.6164596273291925,20.0,0.0
21288,2,1288,[483 302 127 313 100],329,5,4663,3.617532971295578,20.0,40.0
21289,2,1289,[323 471 191  98 435],13,2,4665,3.616279069767442,0.0,20.0
21290,2,1290,[186 300 357 127 182],271,3,4668,3.6158017041053445,20.0,20.0
21291,2,1291,[483 204 294 588 288],650,2,4670,3.6145510835913313,20.0,0.0
21292,2,1292,[211 215 515 161 333],64,3,4673,3.6140757927300853,0.0,0.0
21293,2,1293,[215 228   4  88 210],194,1,4674,3.6120556414219473,0.0,0.0
21294,2,1294,[185 357   1 175 127],479,5,4679,3.613127413127413,20.0,20.0
21295,2,1295,[483 302 127 313 100],474,5,4684,3.6141975308641974,20.0,40.0
21296,2,1296,[125 403  15  96 508],653,1,4685,3.6121819583654586,0.0,0.0
21297,2,1297,[183  50 172 127 151],95,5,4690,3.6132511556240368,0.0,40.0
21298,2,1298,[197 678   8   9  82],308,3,4693,3.6127790608160124,0.0,0.0
21299,2,1299,[483 302 127 313 100],90,5,4698,3.6138461538461537,20.0,40.0
21300,2,1300,[483 302 127 313 100],232,3,4701,3.6133743274404306,20.0,40.0
21301,2,1301,[597 288 200 435 258],13,2,4703,3.612135176651306,0.0,0.0
21302,2,1302,[100 111 185  89 117],374,3,4706,3.611665387567153,0.0,20.0
21303,2,1303,[183 135 143 182 186],804,3,4709,3.611196319018405,0.0,0.0
21304,2,1304,[153 183  97  64 423],653,1,4710,3.6091954022988504,0.0,0.0
21305,2,1305,[483 302 127 313 100],537,5,4715,3.610260336906585,20.0,40.0
21306,2,1306,[483 302 127 313 100],232,3,4718,3.6097934200459068,20.0,40.0
21307,2,1307,[483 302 127 100 313],13,5,4723,3.61085626911315,20.0,40.0
21308,2,1308,[257 423 269 100 496],378,4,4727,3.611153552330023,0.0,20.0
21309,2,1309,[328 276 405 228 135],334,3,4730,3.6106870229007635,0.0,0.0
21310,2,1310,[483 302 127 100 313],207,4,4734,3.610983981693364,20.0,40.0
21311,2,1311,[183 258 257 318 546],455,3,4737,3.6105182926829267,20.0,0.0
21312,2,1312,[405  69 195 286  71],59,2,4739,3.609291698400609,0.0,0.0
21313,2,1313,[180   9 742  79 313],308,4,4743,3.6095890410958904,0.0,0.0
21314,2,1314,[ 96 210 135 180 328],263,4,4747,3.6098859315589356,0.0,0.0
21315,2,1315,[100 215 195  89 181],454,3,4750,3.6094224924012157,0.0,20.0
21316,2,1316,[288 172 427 127 546],533,3,4753,3.6089597570235386,0.0,20.0
21317,2,1317,[483 302 127 100 313],13,5,4758,3.6100151745068287,20.0,40.0
21318,2,1318,[186 748 403  25 269],13,2,4760,3.608794541319181,0.0,0.0
21319,2,1319,[237 286 111 174 471],524,4,4764,3.609090909090909,0.0,20.0
21320,2,1320,[ 70   1 435 276 100],144,4,4768,3.6093868281604844,0.0,20.0
21321,2,1321,[195 435  97 238 191],666,4,4772,3.6096822995461424,0.0,0.0
21322,2,1322,[ 79 191 153 403 179],194,2,4774,3.6084656084656084,0.0,0.0
21323,2,1323,[191 328  69 185 179],749,5,4779,3.6095166163141994,0.0,0.0
21324,2,1324,[ 96 294 328  70 194],653,2,4781,3.608301886792453,0.0,0.0
21325,2,1325,[568 238 258   7 496],650,3,4784,3.607843137254902,0.0,0.0
21326,2,1326,[ 97 294  69 161 204],378,3,4787,3.607385079125848,0.0,0.0
21327,2,1327,[483 302 127 100 313],334,5,4792,3.608433734939759,20.0,40.0
21328,2,1328,[132 143 323 318 294],378,3,4795,3.6079759217456733,20.0,0.0
21329,2,1329,[483 302 127 100 313],537,5,4800,3.6090225563909772,20.0,40.0
21330,2,1330,[282 245 182  79 215],378,4,4804,3.6093163035311795,0.0,0.0
21331,2,1331,[ 11 153   4 121 216],334,2,4806,3.608108108108108,0.0,0.0
21332,2,1332,[483 302 127 100 313],329,5,4811,3.609152288072018,20.0,40.0
21333,2,1333,[117 181 180 405 195],749,4,4815,3.6094452773613193,0.0,0.0
21334,2,1334,[483 302 127 100 313],207,4,4819,3.609737827715356,20.0,40.0
21335,2,1335,[328 228 568 742  97],313,3,4822,3.6092814371257487,0.0,0.0
21336,2,1336,[483 302 127 100 313],207,4,4826,3.6095736724008973,20.0,40.0
21337,2,1337,[483 302 127 313 100],334,5,4831,3.610612855007474,20.0,40.0
21338,2,1338,[483 302 127 313 100],334,5,4836,3.6116504854368934,20.0,40.0
21339,2,1339,[403 204 194 196  71],59,3,4839,3.611194029850746,0.0,0.0
21340,2,1340,[294 174 546 222 200],447,2,4841,3.609992542878449,0.0,20.0
21341,2,1341,[655 204  96 427 195],14,5,4846,3.6110283159463488,0.0,0.0
21342,2,1342,[ 97 211 237 222 405],64,3,4849,3.6105733432613554,0.0,0.0
21343,2,1343,[ 70  98 181 196 313],85,5,4854,3.611607142857143,0.0,20.0
21344,2,1344,[143 211 175 435 186],524,2,4856,3.6104089219330855,0.0,0.0
21345,2,1345,[423 197 228  11 286],59,4,4860,3.610698365527489,0.0,0.0
21346,2,1346,[ 64   9  28   7 127],194,4,4864,3.610987379361544,0.0,20.0
21347,2,1347,[403  22 161 172 228],326,3,4867,3.6105341246290803,0.0,0.0
21348,2,1348,[403 186 179  28 195],833,2,4869,3.609340252038547,0.0,0.0
21349,2,1349,[471 515 144 385  56],308,2,4871,3.6081481481481483,0.0,0.0
21350,2,1350,[483 302 127 313 100],328,5,4876,3.6091783863804587,20.0,40.0
21351,2,1351,[215 185 121 100  96],774,0,4876,3.606508875739645,0.0,20.0
21352,2,1352,[483 302 127 313 100],232,3,4879,3.606060606060606,20.0,40.0
21353,2,1353,[483 302 127 313 100],232,3,4882,3.6056129985228953,20.0,40.0
21354,2,1354,[483 302 127 100 313],232,3,4885,3.6051660516605164,20.0,40.0
21355,2,1355,[173 357 180 222 175],650,4,4889,3.605457227138643,20.0,0.0
21356,2,1356,[186 197 180  64  96],664,4,4893,3.6057479734708915,0.0,0.0
21357,2,1357,[161 318 151 265  22],524,3,4896,3.605301914580265,20.0,0.0
21358,2,1358,[508 546 125 210  96],378,3,4899,3.6048565121412803,0.0,0.0
21359,2,1359,[357 276 215 153  69],90,3,4902,3.6044117647058824,20.0,0.0
21360,2,1360,[153 151 597 211   7],346,2,4904,3.603232916972814,0.0,0.0
21361,2,1361,[496 127 100 173 121],479,3,4907,3.6027900146842877,0.0,40.0
21362,2,1362,[117  98 180  28 597],653,4,4911,3.603081438004402,0.0,20.0
21363,2,1363,[475 258  22  25 568],13,2,4913,3.6019061583577714,0.0,0.0
21364,2,1364,[483 302 127 100 313],328,5,4918,3.602930402930403,20.0,40.0
21365,2,1365,[483 302 127 100 313],474,5,4923,3.603953147877013,20.0,40.0
21366,2,1366,[179  28 182 181 234],234,2,4925,3.6027798098024872,0.0,0.0
21367,2,1367,[496  82 183 172 202],815,5,4930,3.603801169590643,0.0,0.0
21368,2,1368,[204 183 117 195 427],788,2,4932,3.602629656683711,0.0,0.0
21369,2,1369,[143 423 322  22 435],749,5,4937,3.603649635036496,0.0,0.0
21370,2,1370,[483 302 127 100 313],329,5,4942,3.6046681254558717,20.0,40.0
21371,2,1371,[483 302 127 100 313],537,5,4947,3.6056851311953353,20.0,40.0
21372,2,1372,[483 302 127 100 313],537,5,4952,3.6067006554989076,20.0,40.0
21373,2,1373,[268  15 313 471  98],537,2,4954,3.6055312954876273,0.0,20.0
21374,2,1374,[111 179 211 300 197],537,3,4957,3.605090909090909,0.0,0.0
21375,2,1375,[546 200 127 318 405],271,3,4960,3.604651162790698,20.0,20.0
21376,2,1376,[515 235 237 282 294],26,2,4962,3.603485838779956,0.0,0.0
21377,2,1377,[132 174  22   1 237],378,5,4967,3.6044992743105952,0.0,20.0
21378,2,1378,[181  50 216 211 187],659,2,4969,3.6033357505438723,0.0,20.0
21379,2,1379,[215 179 172 333 678],881,3,4972,3.6028985507246376,0.0,0.0
21380,2,1380,[173 678 191 100  82],387,4,4976,3.603186097031137,0.0,20.0
21381,2,1381,[483 302 127 100 313],334,5,4981,3.6041968162083937,20.0,40.0
21382,2,1382,[125 143  82 235 323],378,3,4984,3.603759942154736,0.0,0.0
21383,2,1383,[121 143 216 322  50],881,4,4988,3.6040462427745665,0.0,20.0
21384,2,1384,[195 515 603 322 748],13,2,4990,3.6028880866425994,20.0,0.0
21385,2,1385,[ 50 385 496 210 234],538,2,4992,3.601731601731602,0.0,20.0
21386,2,1386,[515 275 268 483  22],7,3,4995,3.601297764960346,20.0,0.0
21387,2,1387,[ 56 210  96 100 194],387,4,4999,3.601585014409222,0.0,20.0
21388,2,1388,[318 222   7 234 121],648,3,5002,3.601151907847372,20.0,0.0
21389,2,1389,[  8 195 174 588 100],406,5,5007,3.602158273381295,0.0,40.0
21390,2,1390,[427  70 286  98  95],194,2,5009,3.601006470165349,0.0,20.0
21391,2,1391,[546 181 300  56 174],145,3,5012,3.6005747126436782,0.0,20.0
21392,2,1392,[117 195 546 678  98],92,3,5015,3.6001435750179467,0.0,20.0
21393,2,1393,[275 228 238   4 172],13,3,5018,3.599713055954089,0.0,0.0
21394,2,1394,[237  69 323 181 508],59,4,5022,3.6,0.0,0.0
21395,2,1395,[515 385 276 174 185],311,4,5026,3.6002865329512894,0.0,20.0
21396,2,1396,[483 302 127 100 313],232,3,5029,3.5998568360773087,20.0,40.0
21397,2,1397,[132 237  96 405 288],804,4,5033,3.600143061516452,0.0,0.0
21398,2,1398,[483 302 127 100 313],328,5,5038,3.601143674052895,20.0,40.0
21399,2,1399,[ 96 121 195 211  89],653,4,5042,3.6014285714285714,0.0,0.0
21400,2,1400,[483 302 127 100 313],328,5,5047,3.6024268379728763,20.0,40.0
21401,2,1401,[483 302 127 100 313],13,5,5052,3.6034236804564905,20.0,40.0
21402,2,1402,[483 302 127 100 313],90,5,5057,3.6044191019244476,20.0,40.0
21403,2,1403,[245  64 237  89 258],378,4,5061,3.6047008547008548,0.0,0.0
21404,2,1404,[215  79 403  28 127],313,3,5064,3.604270462633452,0.0,20.0
21405,2,1405,[423 204  28  12 237],59,4,5068,3.604551920341394,20.0,0.0
21406,2,1406,[483 302 127 100 313],207,4,5072,3.6048329779673063,20.0,40.0
21407,2,1407,[100 748 196 151 546],64,2,5074,3.6036931818181817,0.0,20.0
21408,2,1408,[328 179 322 289 127],90,3,5077,3.603264726756565,0.0,20.0
21409,2,1409,[483 302 127 100 313],537,5,5082,3.6042553191489364,20.0,40.0
21410,2,1410,[483 302 127 100 313],329,5,5087,3.605244507441531,20.0,40.0
21411,2,1411,[111 237 191 127 257],653,2,5089,3.6041076487252126,0.0,20.0
21412,2,1412,[175  11  25 276 196],92,4,5093,3.6043878273177636,0.0,0.0
21413,2,1413,[483 302 127 100 313],207,4,5097,3.6046676096181045,20.0,40.0
21414,2,1414,[204 172  97 385 286],890,5,5102,3.60565371024735,0.0,0.0
21415,2,1415,[191 357 427 271 194],669,2,5104,3.6045197740112993,20.0,0.0
21416,2,1416,[210 282 161   1 276],92,4,5108,3.6047988708539167,0.0,0.0
21417,2,1417,[ 25 385 196 215  97],537,0,5108,3.602256699576869,0.0,0.0
21418,2,1418,[588 427 257 197 161],308,3,5111,3.6018322762508808,0.0,0.0
21419,2,1419,[210 483 323 168 294],804,5,5116,3.602816901408451,20.0,0.0
21420,2,1420,[ 89 202  50 143 144],64,3,5119,3.6023926812104152,0.0,20.0
21421,2,1421,[ 69  11 210 234 568],804,5,5124,3.6033755274261603,0.0,0.0
21422,2,1422,[195 121 234 588 275],537,1,5125,3.601546029515109,0.0,0.0
21423,2,1423,[216 127 603 423 405],643,4,5129,3.601825842696629,20.0,20.0
21424,2,1424,[216 202  95   4 313],234,2,5131,3.6007017543859647,0.0,0.0
21425,2,1425,[ 56 117 211 228 546],447,4,5135,3.600981767180926,0.0,0.0
21426,2,1426,[483 302 127 100 313],334,5,5140,3.601962158374212,20.0,40.0
21427,2,1427,[ 50 385 238   4  28],538,2,5142,3.600840336134454,0.0,20.0
21428,2,1428,[179 588   1 546  25],897,3,5145,3.600419874037789,0.0,0.0
21429,2,1429,[237 282   1 257  25],486,3,5148,3.6,0.0,0.0
21430,2,1430,[234 100 132 153  71],406,3,5151,3.59958071278826,0.0,20.0
21431,2,1431,[403 144 423  28 135],64,4,5155,3.599860335195531,0.0,0.0
21432,2,1432,[ 69 294 222 195 185],13,1,5156,3.59804605722261,0.0,0.0
21433,2,1433,[483 302 127 100 313],537,5,5161,3.599023709902371,20.0,40.0
21434,2,1434,[ 70 471   1 257 195],658,3,5164,3.5986062717770033,0.0,0.0
21435,2,1435,[286 202 471 294 181],533,5,5169,3.59958217270195,0.0,0.0
21436,2,1436,[435 161 127 238 172],881,2,5171,3.5984690327070283,0.0,20.0
21437,2,1437,[172  70 174 475 127],527,4,5175,3.59874826147427,0.0,40.0
21438,2,1438,[ 71  89 183 357 216],13,3,5178,3.5983321751216124,20.0,0.0
21439,2,1439,[483 302 127 100 313],90,5,5183,3.5993055555555555,20.0,40.0
21440,2,1440,[ 56 302 405 588   1],537,2,5185,3.5981956974323386,0.0,0.0
21441,2,1441,[168 300 202  89 118],749,4,5189,3.5984743411927878,0.0,0.0
21442,2,1442,[483 302 127 100 313],207,4,5193,3.598752598752599,20.0,40.0
21443,2,1443,[483 135 182 153  22],788,2,5195,3.597645429362881,20.0,0.0
21444,2,1444,[423  79 313  28 121],13,4,5199,3.597923875432526,0.0,0.0
21445,2,1445,[173  88  22 228  12],406,1,5200,3.59612724757953,20.0,0.0
21446,2,1446,[483 302 127 313 100],334,5,5205,3.597097442985487,20.0,40.0
21447,2,1447,[483 302 127 313 100],334,5,5210,3.5980662983425415,20.0,40.0
21448,2,1448,[222 173 161  11 357],474,5,5215,3.5990338164251208,20.0,0.0
21449,2,1449,[385 322  82 471   1],13,0,5215,3.5965517241379312,0.0,0.0
21450,2,1450,[180  88 175  89 121],406,4,5219,3.596829772570641,0.0,0.0
21451,2,1451,[475 282 357 302 204],207,3,5222,3.5964187327823693,20.0,0.0
21452,2,1452,[300 117 153 245 180],346,4,5226,3.596696490020647,0.0,0.0
21453,2,1453,[289 655 318 197 403],378,4,5230,3.5969738651994496,20.0,0.0
21454,2,1454,[ 89 202 742 194 195],897,3,5233,3.5965635738831616,0.0,0.0
21455,2,1455,[127 194 143  64 175],207,4,5237,3.596840659340659,0.0,20.0
21456,2,1456,[ 96  97 186 496 313],308,2,5239,3.595744680851064,0.0,0.0
21457,2,1457,[118 313 176 603 318],533,4,5243,3.5960219478738,40.0,0.0
21458,2,1458,[216  88  69 153 427],374,3,5246,3.5956134338588073,0.0,0.0
21459,2,1459,[483 302 127 100 313],232,3,5249,3.595205479452055,20.0,40.0
21460,2,1460,[ 89 216 202  95 186],766,1,5250,3.593429158110883,0.0,0.0
21461,2,1461,[ 22 153 322 245 100],207,1,5251,3.591655266757866,0.0,20.0
21462,2,1462,[483 302 127 100 313],207,4,5255,3.5919343814080658,20.0,40.0
21463,2,1463,[294 185   4  79 282],474,4,5259,3.5922131147540983,0.0,0.0
21464,2,1464,[483 302 127 313 100],90,5,5264,3.593174061433447,20.0,40.0
21465,2,1465,[423  98 435  96  79],59,5,5269,3.5941336971350615,0.0,20.0
21466,2,1466,[181 603 186 168  11],64,4,5273,3.594410361281527,20.0,0.0
21467,2,1467,[300 471 245 117 405],455,2,5275,3.593324250681199,0.0,0.0
21468,2,1468,[187  22  28 258 211],313,2,5277,3.5922396187882915,0.0,0.0
21469,2,1469,[515 118 194  88 405],643,2,5279,3.591156462585034,0.0,0.0
21470,2,1470,[180  25 211 603 202],537,3,5282,3.5907545887151597,20.0,0.0
21471,2,1471,[ 15  70 427 196 215],454,3,5285,3.5903532608695654,0.0,0.0
21472,2,1472,[273 258 269 127 194],102,1,5286,3.5885947046843176,0.0,20.0
21473,2,1473,[211 191 173 475   4],339,5,5291,3.58955223880597,0.0,0.0
21474,2,1474,[182 176  70  64 655],184,4,5295,3.5898305084745763,0.0,0.0
21475,2,1475,[288 196 173 161 515],452,4,5299,3.5901084010840107,0.0,0.0
21476,2,1476,[483 302 127 313 100],537,5,5304,3.5910629654705484,20.0,40.0
21477,2,1477,[282   9 313  50  71],533,5,5309,3.592016238159675,0.0,20.0
21478,2,1478,[483 302 127 313 100],329,5,5314,3.5929682217714674,20.0,40.0
21479,2,1479,[179  15 195 385 265],537,1,5315,3.5912162162162162,0.0,0.0
21480,2,1480,[385  95 196   7 228],13,3,5318,3.5908170155300474,0.0,0.0
21481,2,1481,[ 22   9 286  97  82],455,5,5323,3.5917678812415654,0.0,0.0
21482,2,1482,[234 471 508 191 289],455,4,5327,3.5920431557653405,0.0,0.0
21483,2,1483,[228 496 144   7  98],194,3,5330,3.591644204851752,0.0,20.0
21484,2,1484,[ 82 121  56 151 357],533,2,5332,3.5905723905723907,20.0,0.0
21485,2,1485,[195 100 127   1 742],650,2,5334,3.58950201884253,0.0,40.0
21486,2,1486,[483 302 127 313 100],328,5,5339,3.5904505716207127,20.0,40.0
21487,2,1487,[176 483 427 216 742],334,2,5341,3.5893817204301075,20.0,0.0
21488,2,1488,[228 151  69 185  88],749,5,5346,3.590329079919409,0.0,0.0
21489,2,1489,[483 302 127 313 100],537,5,5351,3.591275167785235,20.0,40.0
21490,2,1490,[322 121  70 597 435],102,0,5351,3.5888665325285043,0.0,0.0
21491,2,1491,[ 70  50 183 100  56],87,5,5356,3.5898123324396782,0.0,40.0
21492,2,1492,[135  96 196 568 187],64,5,5361,3.5907568653717346,0.0,0.0
21493,2,1493,[483 302 127 313 100],232,3,5364,3.5903614457831323,20.0,40.0
21494,2,1494,[  1 168  64 496 357],379,5,5369,3.591304347826087,20.0,0.0
21495,2,1495,[235 237 288 216 273],308,1,5370,3.589572192513369,0.0,0.0
21496,2,1496,[483 302 127 100 313],537,5,5375,3.5905143620574482,20.0,40.0
21497,2,1497,[483 302 127 100 313],328,5,5380,3.5914552736982643,20.0,40.0
21498,2,1498,[483 302 127 100 313],334,5,5385,3.592394929953302,20.0,40.0
21499,2,1499,[  4 508  56 275 475],527,1,5386,3.5906666666666665,0.0,0.0
21500,2,1500,[271 153 234  97 588],536,2,5388,3.5896069287141907,0.0,0.0
21501,2,1501,[313 176 173 222 323],474,4,5392,3.5898801597869507,0.0,0.0
21502,2,1502,[180 271 204 172  11],749,5,5397,3.590818363273453,0.0,0.0
21503,2,1503,[483 302 127 100 313],329,5,5402,3.591755319148936,20.0,40.0
21504,2,1504,[173 161 121  11   9],749,2,5404,3.5906976744186045,0.0,0.0
21505,2,1505,[483  28 742 475 127],833,2,5406,3.589641434262948,20.0,20.0
21506,2,1506,[125 204 483 135 286],200,5,5411,3.590577305905773,20.0,0.0
21507,2,1507,[179 196  89 194 655],406,3,5414,3.590185676392573,0.0,0.0
21508,2,1508,[483 302 127 100 313],232,3,5417,3.5897945659377073,20.0,40.0
21509,2,1509,[172   7 185 318 322],474,5,5422,3.5907284768211922,20.0,0.0
21510,2,1510,[282   9 357  64 194],458,2,5424,3.589675711449371,20.0,0.0
21511,2,1511,[483 302 127 100 313],232,3,5427,3.5892857142857144,20.0,40.0
21512,2,1512,[196 496 182 403   4],378,3,5430,3.5888962326503635,0.0,0.0
21513,2,1513,[300 153 265 195   1],479,4,5434,3.5891677675033025,0.0,0.0
21514,2,1514,[483 302 127 100 313],334,5,5439,3.59009900990099,20.0,40.0
21515,2,1515,[275 187  88 179 172],452,3,5442,3.5897097625329817,0.0,0.0
21516,2,1516,[483 302 127 100 313],537,5,5447,3.5906394199077125,20.0,40.0
21517,2,1517,[300  79   1 515  95],843,0,5447,3.5882740447957837,0.0,0.0
21518,2,1518,[483 302 127 100 313],13,5,5452,3.589203423304806,20.0,40.0
21519,2,1519,[483 302 127 100 313],334,5,5457,3.5901315789473682,20.0,40.0
21520,2,1520,[ 88 186 121  89  64],659,3,5460,3.58974358974359,0.0,0.0
21521,2,1521,[294 135   4 172 318],7,4,5464,3.590013140604468,20.0,0.0
21522,2,1522,[234 568 289 181  95],13,3,5467,3.5896257386736705,0.0,0.0
21523,2,1523,[483 302 127 100 313],90,5,5472,3.590551181102362,20.0,40.0
21524,2,1524,[483 302 127 100 313],329,5,5477,3.5914754098360655,20.0,40.0
21525,2,1525,[238 210 276  97 185],13,2,5479,3.59043250327654,0.0,0.0
21526,2,1526,[ 82 181 228 313 151],653,4,5483,3.590700720366732,0.0,0.0
21527,2,1527,[357 405  88 186 111],653,2,5485,3.5896596858638743,20.0,0.0
21528,2,1528,[483  71 187 125   1],6,4,5489,3.5899280575539567,20.0,0.0
21529,2,1529,[197 153 176  56 302],666,5,5494,3.5908496732026145,0.0,0.0
21530,2,1530,[ 95 179   1 176 435],308,5,5499,3.5917700849118224,0.0,0.0
21531,2,1531,[257 151 603 403 271],650,1,5500,3.5900783289817233,20.0,0.0
21532,2,1532,[ 97 153  64 151 168],379,4,5504,3.5903457273320285,0.0,0.0
21533,2,1533,[483 302 127 100 313],329,5,5509,3.591264667535854,20.0,40.0
21534,2,1534,[191 302 228 385 268],13,3,5512,3.5908794788273615,0.0,0.0
21535,2,1535,[ 25 238  88   7 174],343,4,5516,3.5911458333333335,0.0,20.0
21536,2,1536,[483 302 127 100 313],232,3,5519,3.590761223162004,20.0,40.0
21537,2,1537,[483 302 127 100 313],334,5,5524,3.5916775032509753,20.0,40.0
21538,2,1538,[483 302 127 100 313],90,5,5529,3.5925925925925926,20.0,40.0
21539,2,1539,[483 302 127 100 313],329,5,5534,3.5935064935064935,20.0,40.0
21540,2,1540,[496  25 168   8 174],897,2,5536,3.592472420506165,0.0,20.0
21541,2,1541,[323 196 568 328 125],263,4,5540,3.5927367055771726,0.0,0.0
21542,2,1542,[ 22 427 151   1 216],313,3,5543,3.592352559948153,0.0,0.0
21543,2,1543,[483 302 127 100 313],334,5,5548,3.593264248704663,20.0,40.0
21544,2,1544,[483 302 127 100 313],232,3,5551,3.5928802588996764,20.0,40.0
21545,2,1545,[483 302 127 100 313],13,5,5556,3.59379042690815,20.0,40.0
21546,2,1546,[215 603 258 546  97],13,4,5560,3.594053005817712,20.0,0.0
21547,2,1547,[  7 210 173 603 357],234,2,5562,3.5930232558139537,40.0,0.0
21548,2,1548,[216 435 100 195 275],452,3,5565,3.592640413169787,0.0,20.0
21549,2,1549,[276 191 258 405  12],6,2,5567,3.5916129032258066,20.0,0.0
21550,2,1550,[423 288 508 228  64],339,3,5570,3.591231463571889,0.0,0.0
21551,2,1551,[ 96  97   1 100 333],313,5,5575,3.592139175257732,0.0,20.0
21552,2,1552,[  9  50  25  12 427],474,5,5580,3.5930457179652286,20.0,20.0
21553,2,1553,[ 25   7 294 181 204],308,4,5584,3.5933075933075935,0.0,0.0
21554,2,1554,[ 69 195 175 286 161],934,5,5589,3.594212218649518,0.0,0.0
21555,2,1555,[197 678  11 216 405],474,4,5593,3.5944730077120823,0.0,0.0
21556,2,1556,[427 271 181 196 216],334,3,5596,3.5940912010276174,0.0,0.0
21557,2,1557,[161 196 275 100 183],452,5,5601,3.5949935815147627,0.0,20.0
21558,2,1558,[282 318 405 300 194],378,4,5605,3.595253367543297,20.0,0.0
21559,2,1559,[127 172 257  50 496],749,4,5609,3.5955128205128206,0.0,40.0
21560,2,1560,[483 302 127 100 313],329,5,5614,3.596412556053812,20.0,40.0
21561,2,1561,[174 161 276 515 168],271,2,5616,3.5953905249679896,0.0,20.0
21562,2,1562,[  7 168 182  96 269],13,3,5619,3.595009596928983,0.0,0.0
21563,2,1563,[187  64 125 181   8],234,3,5622,3.5946291560102304,0.0,0.0
21564,2,1564,[483 302 127 100 313],232,3,5625,3.594249201277955,20.0,40.0
21565,2,1565,[483 302 127 100 313],334,5,5630,3.59514687100894,20.0,40.0
21566,2,1566,[161 211 191 187 202],387,3,5633,3.5947670708359922,0.0,0.0
21567,2,1567,[ 89 265 117 181 286],13,3,5636,3.5943877551020407,0.0,0.0
21568,2,1568,[ 28 265 100  89 318],380,4,5640,3.5946462715105163,20.0,20.0
21569,2,1569,[385 183 118 144 228],328,2,5642,3.5936305732484075,0.0,0.0
21570,2,1570,[276  89 655  97 197],59,5,5647,3.594525779758116,0.0,0.0
21571,2,1571,[175 186 546 603 135],308,4,5651,3.5947837150127224,20.0,0.0
21572,2,1572,[483 302 127 100 313],537,5,5656,3.5956770502225046,20.0,40.0
21573,2,1573,[ 88 185  15   9 235],145,3,5659,3.5952986022871665,0.0,0.0
21574,2,1574,[273 174  12 179 515],537,2,5661,3.5942857142857143,20.0,20.0
21575,2,1575,[  4 181 405 121 161],774,0,5661,3.592005076142132,0.0,0.0
21576,2,1576,[173 603 202 323 588],13,3,5664,3.5916296766011415,20.0,0.0
21577,2,1577,[204 191  88 144  25],125,4,5668,3.5918884664131814,0.0,0.0
21578,2,1578,[151  88 143 176 273],308,4,5672,3.5921469284357186,0.0,0.0
21579,2,1579,[ 56 211 235 173   4],650,2,5674,3.591139240506329,0.0,0.0
21580,2,1580,[483 302 127 100 313],329,5,5679,3.592030360531309,20.0,40.0
21581,2,1581,[322 204 186 269 183],263,4,5683,3.592288242730721,0.0,0.0
21582,2,1582,[483 302 127 100 313],207,4,5687,3.5925457991156033,20.0,40.0
21583,2,1583,[ 88 168 655  22 313],474,4,5691,3.5928030303030303,0.0,0.0
21584,2,1584,[483 302 127 100 313],328,5,5696,3.593690851735016,20.0,40.0
21585,2,1585,[  8 179 742 144 121],95,4,5700,3.5939470365699875,0.0,0.0
21586,2,1586,[483 302 127 100 313],207,4,5704,3.5942028985507246,20.0,40.0
21587,2,1587,[179  28 181 588 237],64,5,5709,3.595088161209068,0.0,0.0
21588,2,1588,[183 143 238 151 197],25,3,5712,3.594713656387665,0.0,0.0
21589,2,1589,[483 302 127 100 313],329,5,5717,3.5955974842767295,20.0,40.0
21590,2,1590,[483 302 127 100 313],13,5,5722,3.596480201131364,20.0,40.0
21591,2,1591,[748 172 235   4 143],882,4,5726,3.5967336683417086,0.0,0.0
21592,2,1592,[483 302 127 100 313],537,5,5731,3.5976145637162587,20.0,40.0
21593,2,1593,[483 302 127 100 313],474,5,5736,3.5984943538268506,20.0,40.0
21594,2,1594,[211  88 237  50 435],326,2,5738,3.5974921630094046,0.0,20.0
21595,2,1595,[483 302 127 100 313],329,5,5743,3.5983709273182956,20.0,40.0
21596,2,1596,[483 302 127 100 313],537,5,5748,3.5992485911083283,20.0,40.0
21597,2,1597,[ 79 568 275 228 655],25,5,5753,3.6001251564455568,0.0,0.0
21598,2,1598,[483 302 127 100 313],90,5,5758,3.6010006253908693,20.0,40.0
21599,2,1599,[435 174  95 186  71],378,4,5762,3.60125,0.0,20.0
21600,2,1600,[200 294 174   8 258],387,4,5766,3.6014990630855714,0.0,20.0
21601,2,1601,[742 215 127 238 187],749,3,5769,3.601123595505618,0.0,20.0
21602,2,1602,[483 302 127 100 313],13,5,5774,3.601996257018091,20.0,40.0
21603,2,1603,[ 22 288 257  11 357],474,3,5777,3.6016209476309227,20.0,0.0
21604,2,1604,[182 175 276 215 222],378,4,5781,3.601869158878505,0.0,0.0
21605,2,1605,[300 161 294  12 405],533,4,5785,3.6021170610211706,20.0,0.0
21606,2,1606,[405  70  69  82 597],59,2,5787,3.601120099564406,0.0,0.0
21607,2,1607,[603   4 268 172   1],189,5,5792,3.601990049751244,20.0,0.0
21608,2,1608,[183 196 216  56 191],666,3,5795,3.6016159105034182,0.0,0.0
21609,2,1609,[483 302 127 100 313],537,5,5800,3.6024844720496896,20.0,40.0
21610,2,1610,[483 302 127 100 313],329,5,5805,3.6033519553072626,20.0,40.0
21611,2,1611,[483 302 127 100 313],329,5,5810,3.6042183622828783,20.0,40.0
21612,2,1612,[216 194 180  71   1],6,5,5815,3.605083694978301,0.0,0.0
21613,2,1613,[483 302 127 100 313],537,5,5820,3.6059479553903344,20.0,40.0
21614,2,1614,[ 98 405 215  50 181],85,4,5824,3.6061919504643964,0.0,40.0
21615,2,1615,[483 302 127 100 313],537,5,5829,3.6070544554455446,20.0,40.0
21616,2,1616,[742 211  50 222  28],648,5,5834,3.6079158936301794,0.0,20.0
21617,2,1617,[ 22 168 237 228   4],653,2,5836,3.606922126081582,0.0,0.0
21618,2,1618,[234 173 168 143 151],474,3,5839,3.6065472513897467,0.0,0.0
21619,2,1619,[144 294 191 273 153],279,2,5841,3.6055555555555556,0.0,0.0
21620,2,1620,[ 22  88 546 357   9],271,4,5845,3.605798889574337,20.0,0.0
21621,2,1621,[238   4 515  69 117],474,5,5850,3.6066584463625153,0.0,0.0
21622,2,1622,[ 25   8 118 127   7],213,4,5854,3.6069008009858288,0.0,20.0
21623,2,1623,[  4 294 282 435 258],207,4,5858,3.607142857142857,0.0,0.0
21624,2,1624,[  8 273 237 568  96],378,5,5863,3.608,0.0,0.0
21625,2,1625,[191 185 403 183 385],308,5,5868,3.6088560885608856,0.0,0.0
21626,2,1626,[195 588  15 385 318],454,2,5870,3.6078672403196066,20.0,0.0
21627,2,1627,[483 302 127 100 313],329,5,5875,3.6087223587223587,20.0,40.0
21628,2,1628,[234 200 179 385 294],308,3,5878,3.6083486801718845,0.0,0.0
21629,2,1629,[179 168 161 194 125],7,4,5882,3.6085889570552148,0.0,0.0
21630,2,1630,[294 427 202 546 111],42,3,5885,3.6082158185162476,0.0,0.0
21631,2,1631,[153  79 185 515 258],815,4,5889,3.608455882352941,0.0,0.0
21632,2,1632,[483 302 127 100 313],232,3,5892,3.608083282302511,20.0,40.0
21633,2,1633,[186   1 282 183 143],311,3,5895,3.6077111383108935,0.0,0.0
21634,2,1634,[483 302 127 100 313],90,5,5900,3.6085626911314983,20.0,40.0
21635,2,1635,[483 302 127 100 313],329,5,5905,3.609413202933985,20.0,40.0
21636,2,1636,[301 286 121  79 143],537,0,5905,3.607208307880269,0.0,0.0
21637,2,1637,[483 302 127 100 313],329,5,5910,3.608058608058608,20.0,40.0
21638,2,1638,[508  89 183 179 678],334,3,5913,3.607687614399024,0.0,0.0
21639,2,1639,[483 302 127 100 313],474,5,5918,3.6085365853658535,20.0,40.0
21640,2,1640,[483 302 127 100 313],537,5,5923,3.6093845216331504,20.0,40.0
21641,2,1641,[ 28 271 185 357 211],537,3,5926,3.6090133982947625,20.0,0.0
21642,2,1642,[301 294 182 323  56],378,2,5928,3.6080340839926963,0.0,0.0
21643,2,1643,[173 100 182 200 135],271,4,5932,3.608272506082725,0.0,20.0
21644,2,1644,[ 22 678  79 322 173],537,1,5933,3.6066869300911852,0.0,0.0
21645,2,1645,[483 302 127 100 313],474,5,5938,3.6075334143377886,20.0,40.0
21646,2,1646,[483 302 127 100 313],90,5,5943,3.6083788706739526,20.0,40.0
21647,2,1647,[483 302 127 100 313],328,5,5948,3.6092233009708736,20.0,40.0
21648,2,1648,[483 302 127 100 313],537,5,5953,3.6100667070952093,20.0,40.0
21649,2,1649,[483 302 127 100 313],207,4,5957,3.6103030303030303,20.0,40.0
21650,2,1650,[216  15 186 235 405],378,3,5960,3.6099333737129013,0.0,0.0
21651,2,1651,[318 216 117 427 655],406,3,5963,3.6095641646489103,20.0,0.0
21652,2,1652,[ 11 475 289 508 235],537,2,5965,3.6085904416212946,0.0,0.0
21653,2,1653,[215  88  98  12  50],60,5,5970,3.6094316807738815,20.0,40.0
21654,2,1654,[180 194 202 245 328],749,5,5975,3.610271903323263,0.0,0.0
21655,2,1655,[483 302 127 100 313],232,3,5978,3.609903381642512,20.0,40.0
21656,2,1656,[496  89 234 179 237],537,3,5981,3.609535304767652,0.0,0.0
21657,2,1657,[483 302 127 100 313],537,5,5986,3.6103739445114598,20.0,40.0
21658,2,1658,[475 173  97 435  50],13,3,5989,3.6100060277275468,0.0,20.0
21659,2,1659,[435 175 588 125 185],59,3,5992,3.6096385542168674,0.0,0.0
21660,2,1660,[ 89 508 568  28  69],92,3,5995,3.609271523178808,0.0,0.0
21661,2,1661,[ 98  88 234 153 185],452,3,5998,3.608904933814681,0.0,20.0
21662,2,1662,[496 186 357 191 210],488,4,6002,3.609140108238124,20.0,0.0
21663,2,1663,[117 423 176 427 100],343,4,6006,3.609375,0.0,20.0
21664,2,1664,[ 50 174 655 202 235],378,4,6010,3.6096096096096097,0.0,40.0
21665,2,1665,[427 286 200 143   4],379,5,6015,3.6104441776710683,0.0,0.0
21666,2,1666,[405 294 179 496 175],95,2,6017,3.609478104379124,0.0,0.0
21667,2,1667,[135  98   4 742 215],387,2,6019,3.6085131894484412,0.0,20.0
21668,2,1668,[194 483 180   8 313],533,3,6022,3.6081485919712404,20.0,0.0
21669,2,1669,[ 95  25 194  15 323],881,1,6023,3.6065868263473053,0.0,0.0
21670,2,1670,[202 117 276  56 265],374,4,6027,3.606822262118492,0.0,0.0
21671,2,1671,[ 97 100 238 173  25],213,5,6032,3.6076555023923444,0.0,20.0
21672,2,1672,[328  56 132  95 143],804,2,6034,3.6066945606694563,0.0,0.0
21673,2,1673,[197 180 125 294 195],881,3,6037,3.606332138590203,0.0,0.0
21674,2,1674,[235 405  88 194 294],537,0,6037,3.604179104477612,0.0,0.0
21675,2,1675,[211  98 603 111 121],474,5,6042,3.6050119331742243,20.0,20.0
21676,2,1676,[483 302 127 100 313],334,5,6047,3.6058437686344664,20.0,40.0
21677,2,1677,[180 174 742 125 403],653,2,6049,3.604886769964243,0.0,20.0
21678,2,1678,[597 100 435 172 194],7,4,6053,3.605122096486004,0.0,20.0
21679,2,1679,[483 302 127 100 313],328,5,6058,3.605952380952381,20.0,40.0
21680,2,1680,[483 302 127 100 313],537,5,6063,3.606781677572873,20.0,40.0
21681,2,1681,[111 257 405 176 181],447,2,6065,3.6058263971462545,0.0,0.0
21682,2,1682,[483 302 127 100 313],474,5,6070,3.6066547831253715,20.0,40.0
21683,2,1683,[483 302 127 100 313],329,5,6075,3.607482185273159,20.0,40.0
21684,2,1684,[483 302 127 100 313],334,5,6080,3.608308605341246,20.0,40.0
21685,2,1685,[ 64 471 357  70 222],454,2,6082,3.6073546856465004,20.0,0.0
21686,2,1686,[301 125   7 276 508],526,3,6085,3.6069946650859515,0.0,0.0
21687,2,1687,[483 302 127 100 313],474,5,6090,3.6078199052132702,20.0,40.0
21688,2,1688,[ 96 471  22 405 333],328,3,6093,3.6074600355239785,0.0,0.0
21689,2,1689,[186 176 194 678 294],474,3,6096,3.607100591715976,0.0,0.0
21690,2,1690,[483 302 127 100 313],90,5,6101,3.6079243051448846,20.0,40.0
21691,2,1691,[483 302 127 100 313],334,5,6106,3.6087470449172576,20.0,40.0
21692,2,1692,[282  64  50 202  22],311,5,6111,3.609568812758417,0.0,20.0
21693,2,1693,[182 186 318 132  98],7,5,6116,3.6103896103896105,20.0,20.0
21694,2,1694,[ 22 175 183 173 202],59,5,6121,3.6112094395280234,0.0,0.0
21695,2,1695,[118  50 265 210 127],653,4,6125,3.611438679245283,0.0,40.0
21696,2,1696,[483 302 127 100 313],537,5,6130,3.6122569239835003,20.0,40.0
21697,2,1697,[222 210 202 471  22],194,1,6131,3.610718492343934,0.0,0.0
21698,2,1698,[483 302 127 100 313],537,5,6136,3.61153619776339,20.0,40.0
21699,2,1699,[423 121 186  89 118],343,2,6138,3.6105882352941174,0.0,0.0
21700,2,1700,[135 234 121 403 204],536,4,6142,3.6108171663727218,0.0,0.0
21701,2,1701,[427 269 333  64 273],537,1,6143,3.609283196239718,0.0,0.0
21702,2,1702,[117  96  28 180 174],788,3,6146,3.608925425719319,0.0,20.0
21703,2,1703,[483 302 127 100 313],329,5,6151,3.6097417840375585,20.0,40.0
21704,2,1704,[483 302 127 100 313],328,5,6156,3.610557184750733,20.0,40.0
21705,2,1705,[ 69 286 191  22 151],650,1,6157,3.6090269636576786,0.0,0.0
21706,2,1706,[483 302 127 100 313],328,5,6162,3.609841827768014,20.0,40.0
21707,2,1707,[333 313  79 211 127],537,3,6165,3.6094847775175642,0.0,20.0
21708,2,1708,[144 176 161 301 328],13,2,6167,3.6085430076067877,0.0,0.0
21709,2,1709,[483 302 127 100 313],232,3,6170,3.608187134502924,20.0,40.0
21710,2,1710,[ 95 245 289 235 125],92,2,6172,3.6072472238457043,0.0,0.0
21711,2,1711,[269 174 161  50 180],339,4,6176,3.607476635514019,0.0,40.0
21712,2,1712,[ 70 183  96 151 237],64,4,6180,3.607705779334501,0.0,0.0
21713,2,1713,[204 435 173 191 515],474,5,6185,3.6085180863477246,0.0,0.0
21714,2,1714,[ 11  96 197 597   1],378,2,6187,3.6075801749271137,0.0,0.0
21715,2,1715,[483 302 127 100 313],334,5,6192,3.6083916083916083,20.0,40.0
21716,2,1716,[215 121 202 483  70],454,3,6195,3.608037274315667,20.0,0.0
21717,2,1717,[483 302 127 100 313],474,5,6200,3.608847497089639,20.0,40.0
21718,2,1718,[588 318  15   4 183],406,4,6204,3.6090750436300176,20.0,0.0
21719,2,1719,[ 28 195  79 180 200],60,5,6209,3.6098837209302324,0.0,0.0
21720,2,1720,[678 588 318 323 258],454,2,6211,3.6089482858803024,20.0,0.0
21721,2,1721,[483 302 127 100 313],329,5,6216,3.6097560975609757,20.0,40.0
21722,2,1722,[483 302 127 100 313],329,5,6221,3.6105629715612304,20.0,40.0
21723,2,1723,[191  15 496 235 237],59,3,6224,3.6102088167053363,0.0,0.0
21724,2,1724,[194 111   8  70 216],271,5,6229,3.611014492753623,0.0,0.0
21725,2,1725,[176  98 597 173 655],13,2,6231,3.6100811123986096,0.0,20.0
21726,2,1726,[483 302 127 100 313],13,5,6236,3.610885929357267,20.0,40.0
21727,2,1727,[273 294 568 427  88],42,4,6240,3.611111111111111,0.0,0.0
21728,2,1728,[483 302 127 100 313],537,5,6245,3.6119144013880855,20.0,40.0
21729,2,1729,[173 328 172 187 182],144,3,6248,3.6115606936416187,0.0,0.0
21730,2,1730,[173 269 180 121  56],378,4,6252,3.611785095320624,0.0,0.0
21731,2,1731,[483 302 127 100 313],537,5,6257,3.6125866050808315,20.0,40.0
21732,2,1732,[  7 118 204 132  79],7,4,6261,3.6128101557991923,0.0,0.0
21733,2,1733,[483 302 127 100 313],537,5,6266,3.6136101499423297,20.0,40.0
21734,2,1734,[588 186 172 191 275],406,3,6269,3.613256484149856,0.0,0.0
21735,2,1735,[483 302 127 100 313],13,5,6274,3.6140552995391704,20.0,40.0
21736,2,1736,[197 175 385  56 222],64,4,6278,3.614277489925158,0.0,0.0
21737,2,1737,[483 302 127 100 313],329,5,6283,3.6150747986191023,20.0,40.0
21738,2,1738,[742 515 655 144 216],313,4,6287,3.615296147211041,0.0,0.0
21739,2,1739,[289 655  22 168 588],406,1,6288,3.613793103448276,0.0,0.0
21740,2,1740,[216 117  95 276  97],308,2,6290,3.6128661688684662,0.0,0.0
21741,2,1741,[127 195 318 237  64],64,5,6295,3.613662456946039,20.0,20.0
21742,2,1742,[ 69  82  22 273 471],524,3,6298,3.6133103843947216,0.0,0.0
21743,2,1743,[483 173 182 179 211],537,5,6303,3.614105504587156,20.0,0.0
21744,2,1744,[265 237 127 322 483],313,3,6306,3.613753581661891,20.0,20.0
21745,2,1745,[385 118 197 275   1],454,2,6308,3.6128293241695304,0.0,0.0
21746,2,1746,[185 153 313  97 258],659,5,6313,3.6136233543216942,0.0,0.0
21747,2,1747,[ 96 196 234 210 235],537,0,6313,3.6115560640732265,0.0,0.0
21748,2,1748,[483 302 127 100 313],232,3,6316,3.6112064036592337,20.0,40.0
21749,2,1749,[204 210  71 301 258],13,3,6319,3.6108571428571428,0.0,0.0
21750,2,1750,[ 95 176 117 118 678],308,2,6321,3.609937178754997,0.0,0.0
21751,2,1751,[405 282 269 288 237],634,4,6325,3.6101598173515983,0.0,0.0
21752,2,1752,[483 302 127 100 313],537,5,6330,3.6109526525955506,20.0,40.0
21753,2,1753,[153 121  28 318 100],85,2,6332,3.6100342075256555,20.0,20.0
21754,2,1754,[  4  95 181  69 423],334,2,6334,3.6091168091168093,0.0,0.0
21755,2,1755,[257 678  98 276 222],474,3,6337,3.60876993166287,0.0,20.0
21756,2,1756,[483 302 127 100 313],474,5,6342,3.6095617529880477,20.0,40.0
21757,2,1757,[ 95 237 471 323 678],454,1,6343,3.6080773606370875,0.0,0.0
21758,2,1758,[483 302 127 100 313],537,5,6348,3.6088686753837407,20.0,40.0
21759,2,1759,[235 258  82 210 211],102,1,6349,3.6073863636363637,0.0,0.0
21760,2,1760,[603 195 185 546  89],64,2,6351,3.606473594548552,20.0,0.0
21761,2,1761,[483 302 127 100 313],232,3,6354,3.606129398410897,20.0,40.0
21762,2,1762,[ 12 282  22 211  97],474,5,6359,3.606920022688599,20.0,0.0
21763,2,1763,[ 56 318 204 173   4],194,5,6364,3.6077097505668934,20.0,0.0
21764,2,1764,[483 302 127 100 313],207,4,6368,3.6079320113314446,20.0,40.0
21765,2,1765,[125 117 322 268 323],637,0,6368,3.605889014722537,0.0,0.0
21766,2,1766,[471 496 180 475 515],90,4,6372,3.6061120543293717,0.0,0.0
21767,2,1767,[288 286 202 195 318],648,3,6375,3.605769230769231,20.0,0.0
21768,2,1768,[ 64 269 435 405 175],666,4,6379,3.605992085924251,0.0,0.0
21769,2,1769,[483 302 127 100 313],90,5,6384,3.606779661016949,20.0,40.0
21770,2,1770,[483 302 127 100 313],13,5,6389,3.6075663466967813,20.0,40.0
21771,2,1771,[597 121 238 215 475],13,2,6391,3.6066591422121896,0.0,0.0
21772,2,1772,[483 302 127 100 313],232,3,6394,3.6063169768753527,20.0,40.0
21773,2,1773,[ 22 125  96 322 238],804,5,6399,3.6071025930101466,0.0,0.0
21774,2,1774,[143 237 181 161 175],95,3,6402,3.6067605633802815,0.0,0.0
21775,2,1775,[483 302 127 100 313],334,5,6407,3.607545045045045,20.0,40.0
21776,2,1776,[210 195 288 286 204],239,2,6409,3.606640405177265,0.0,0.0
21777,2,1777,[301 275 294 175  56],537,3,6412,3.606299212598425,0.0,0.0
21778,2,1778,[ 64  95 135  97 144],234,2,6414,3.60539629005059,0.0,0.0
21779,2,1779,[ 89 127  64 282 508],653,3,6417,3.6050561797752807,0.0,20.0
21780,2,1780,[228 238 265  89 179],311,4,6421,3.605277933745087,0.0,0.0
21781,2,1781,[483 302 127 100 313],334,5,6426,3.606060606060606,20.0,40.0
21782,2,1782,[168 471  15 186  70],308,3,6429,3.605720695457095,0.0,0.0
21783,2,1783,[289 191 179 496 197],378,2,6431,3.6048206278026904,0.0,0.0
21784,2,1784,[202 183  89  50 475],64,4,6435,3.6050420168067228,0.0,20.0
21785,2,1785,[ 15 172 289  28   1],454,1,6436,3.6035834266517357,0.0,0.0
21786,2,1786,[357 174 175 173 423],6,4,6440,3.603805260212647,20.0,20.0
21787,2,1787,[483 302 127 100 313],90,5,6445,3.604586129753915,20.0,40.0
21788,2,1788,[471 483 173 323 228],648,5,6450,3.6053661263275574,20.0,0.0
21789,2,1789,[ 95  56  28 173 286],6,2,6452,3.6044692737430166,0.0,0.0
21790,2,1790,[ 97 151 168 144 194],666,2,6454,3.6035734226689002,0.0,0.0
21791,2,1791,[275 181 405  64 135],145,3,6457,3.603236607142857,0.0,0.0
21792,2,1792,[228  79  96 195 423],200,5,6462,3.604015616285555,0.0,0.0
21793,2,1793,[483 302 127 100 313],232,3,6465,3.6036789297658864,20.0,40.0
21794,2,1794,[483 302 127 100 313],90,5,6470,3.604456824512535,20.0,40.0
21795,2,1795,[180  69 204 175 183],659,4,6474,3.60467706013363,0.0,0.0
21796,2,1796,[483 302 127 100 313],329,5,6479,3.605453533667223,20.0,40.0
21797,2,1797,[191  82  50 151 655],234,2,6481,3.604560622914349,0.0,20.0
21798,2,1798,[483 302 127 100 313],334,5,6486,3.605336297943302,20.0,40.0
21799,2,1799,[588  50 288   7  69],59,4,6490,3.6055555555555556,0.0,20.0
21800,2,1800,[ 70 194 258 385 300],7,4,6494,3.605774569683509,0.0,0.0
21801,2,1801,[603 265 202  22  97],650,2,6496,3.60488346281909,20.0,0.0
21802,2,1802,[483 302 127 100 313],207,4,6500,3.6051026067665,20.0,40.0
21803,2,1803,[ 64  96 182 288 423],13,4,6504,3.6053215077605323,0.0,0.0
21804,2,1804,[ 98 173  25 194   1],899,2,6506,3.604432132963989,0.0,20.0
21805,2,1805,[135 161  89 182 568],881,3,6509,3.604097452934662,0.0,0.0
21806,2,1806,[ 22 275 546  97 435],343,4,6513,3.6043165467625897,0.0,0.0
21807,2,1807,[483 302 127 100 313],232,3,6516,3.603982300884956,20.0,40.0
21808,2,1808,[ 15 603 135  95 202],234,2,6518,3.603095632946379,20.0,0.0
21809,2,1809,[483 302 127 100 313],334,5,6523,3.603867403314917,20.0,40.0
21810,2,1810,[183   8 153  11 265],13,4,6527,3.604086140254003,0.0,0.0
21811,2,1811,[483 302 127 100 313],13,5,6532,3.6048565121412803,20.0,40.0
21812,2,1812,[357 181 318 265   1],387,4,6536,3.605074462217319,40.0,0.0
21813,2,1813,[ 69 257 143 496 182],308,3,6539,3.6047409040793825,0.0,0.0
21814,2,1814,[471   7 748 194 322],13,2,6541,3.6038567493112947,0.0,0.0
21815,2,1815,[483 302 127 100 313],474,5,6546,3.604625550660793,20.0,40.0
21816,2,1816,[483 302 127 100 313],232,3,6549,3.604292790313704,20.0,40.0
21817,2,1817,[282 273  69 195 143],458,3,6552,3.603960396039604,0.0,0.0
21818,2,1818,[483 302 100 127 313],537,5,6557,3.6047278724573943,20.0,40.0
21819,2,1819,[357  64 318 403 127],13,2,6559,3.603846153846154,40.0,20.0
21820,2,1820,[483 302 100 127 313],13,5,6564,3.6046128500823724,20.0,40.0
21821,2,1821,[237 427  50 313 742],328,4,6568,3.604829857299671,0.0,20.0
21822,2,1822,[483 302 100 127 313],207,4,6572,3.6050466264399343,20.0,40.0
21823,2,1823,[ 28 282  64 121 185],474,5,6577,3.605811403508772,0.0,0.0
21824,2,1824,[100  89 403 568   4],328,2,6579,3.604931506849315,0.0,20.0
21825,2,1825,[515 282 185 403 215],881,3,6582,3.6046002190580504,0.0,0.0
21826,2,1826,[ 97 132 313 125  71],59,3,6585,3.6042692939244665,0.0,0.0
21827,2,1827,[483 302 127 100 313],232,3,6588,3.603938730853392,20.0,40.0
21828,2,1828,[117 423 235  22 238],650,2,6590,3.603061782394751,0.0,0.0
21829,2,1829,[515 175  82 258 186],64,3,6593,3.6027322404371587,0.0,0.0
21830,2,1830,[496  98 180 403  89],653,2,6595,3.6018569087930095,0.0,20.0
21831,2,1831,[ 95 111 515   9 234],271,5,6600,3.6026200873362444,0.0,0.0
21832,2,1832,[275 328 269 151 121],378,3,6603,3.602291325695581,0.0,0.0
21833,2,1833,[483 302 100 127 313],537,5,6608,3.6030534351145036,20.0,40.0
21834,2,1834,[483 302 100 127 313],207,4,6612,3.6032697547683923,20.0,40.0
21835,2,1835,[427 483 546 195 496],7,5,6617,3.6040305010893245,20.0,0.0
21836,2,1836,[135 222 172 288 204],474,4,6621,3.60424605334785,0.0,0.0
21837,2,1837,[176 273 195 187 234],328,3,6624,3.603917301414581,0.0,0.0
21838,2,1838,[222 588 183 176 357],200,5,6629,3.6046764545948884,20.0,0.0
21839,2,1839,[515 265 176 423   4],328,4,6633,3.604891304347826,0.0,0.0
21840,2,1840,[ 89 385  22 289 275],13,2,6635,3.6040195545898968,0.0,0.0
21841,2,1841,[302 273 187 111 195],158,4,6639,3.6042345276872965,0.0,0.0
21842,2,1842,[435 237 175 118  82],749,2,6641,3.6033640803038525,0.0,0.0
21843,2,1843,[483 302 127 100 313],328,5,6646,3.60412147505423,20.0,40.0
21844,2,1844,[483 302 127 100 313],537,5,6651,3.604878048780488,20.0,40.0
21845,2,1845,[258  89 132  22 127],184,3,6654,3.6045503791982667,0.0,20.0
21846,2,1846,[161  70 655 180 238],308,4,6658,3.604764482945317,0.0,0.0
21847,2,1847,[ 25  11 144 200 127],666,3,6661,3.6044372294372296,0.0,20.0
21848,2,1848,[144  69 135 197 196],263,5,6666,3.605191995673337,0.0,0.0
21849,2,1849,[194 742 496 269 121],650,3,6669,3.6048648648648647,0.0,0.0
21850,2,1850,[185 588 204 273 125],897,4,6673,3.605078336034576,0.0,0.0
21851,2,1851,[748 200 313 228  70],102,1,6674,3.603671706263499,0.0,0.0
21852,2,1852,[268 216 357  11 403],234,1,6675,3.602266594711279,20.0,0.0
21853,2,1853,[265 385 151 202 258],666,2,6677,3.6014023732470335,0.0,0.0
21854,2,1854,[210  64 118 100 471],13,3,6680,3.601078167115903,0.0,20.0
21855,2,1855,[483 302 127 100 313],207,4,6684,3.601293103448276,20.0,40.0
21856,2,1856,[655  98  56 173  50],664,4,6688,3.6015078082929457,0.0,40.0
21857,2,1857,[135 597  79 161 655],774,0,6688,3.5995694294940797,0.0,0.0
21858,2,1858,[483 302 127 100 313],207,4,6692,3.599784830554061,20.0,40.0
21859,2,1859,[135 168 191 143 175],334,4,6696,3.6,0.0,0.0
21860,2,1860,[483 302 127 100 313],328,5,6701,3.600752283718431,20.0,40.0
21861,2,1861,[ 28 286  22 258 197],387,3,6704,3.6004296455424276,0.0,0.0
21862,2,1862,[483 302 127 100 313],328,5,6709,3.6011808910359635,20.0,40.0
21863,2,1863,[405 234 423 322 143],633,4,6713,3.601394849785408,0.0,0.0
21864,2,1864,[483 302 127 100 313],207,4,6717,3.601608579088472,20.0,40.0
21865,2,1865,[483 302 127 100 313],328,5,6722,3.602357984994641,20.0,40.0
21866,2,1866,[234 121 403 475 118],308,2,6724,3.60149973219068,0.0,0.0
21867,2,1867,[179 286 194 508 176],406,4,6728,3.601713062098501,0.0,0.0
21868,2,1868,[568   9 175 483 194],343,4,6732,3.6019261637239164,20.0,0.0
21869,2,1869,[ 70  28 357  97 423],533,3,6735,3.6016042780748663,20.0,0.0
21870,2,1870,[483 302 127 100 313],232,3,6738,3.601282736504543,20.0,40.0
21871,2,1871,[483 302 127 100 313],474,5,6743,3.6020299145299144,20.0,40.0
21872,2,1872,[483 302 127 100 313],328,5,6748,3.602776294714362,20.0,40.0
21873,2,1873,[ 22   1 423 194 117],6,2,6750,3.601921024546425,0.0,0.0
21874,2,1874,[135  98 100  12 288],213,5,6755,3.6026666666666665,20.0,40.0
21875,2,1875,[483 302 127 100 313],13,5,6760,3.603411513859275,20.0,40.0
21876,2,1876,[655 603 435 197  56],454,2,6762,3.6025572722429406,20.0,0.0
21877,2,1877,[202 301 435 100 143],234,1,6763,3.601171458998935,0.0,20.0
21878,2,1878,[  1 153 176 288 301],234,0,6763,3.5992549228312933,0.0,0.0
21879,2,1879,[143   4 181  22 211],194,3,6766,3.598936170212766,0.0,0.0
21880,2,1880,[183  97 427  82 179],848,4,6770,3.599149388623073,0.0,0.0
21881,2,1881,[546 151 273 173 222],42,3,6773,3.5988310308182783,0.0,0.0
21882,2,1882,[483 302 127 100 313],90,5,6778,3.5995751460435477,20.0,40.0
21883,2,1883,[153  98  64  22 196],840,3,6781,3.599256900212314,0.0,20.0
21884,2,1884,[ 50 222 403 210  96],653,3,6784,3.59893899204244,0.0,20.0
21885,2,1885,[603 568 100 508 117],13,2,6786,3.5980911983032873,20.0,20.0
21886,2,1886,[ 79 179 172 222 748],881,4,6790,3.5983041865394805,0.0,0.0
21887,2,1887,[483 302 127 100 313],232,3,6793,3.5979872881355934,20.0,40.0
21888,2,1888,[483 302 127 100 313],329,5,6798,3.598729486500794,20.0,40.0
21889,2,1889,[483 302 127 100 313],537,5,6803,3.5994708994708993,20.0,40.0
21890,2,1890,[483 302 127 100 313],328,5,6808,3.600211528291909,20.0,40.0
21891,2,1891,[483 302 127 100 313],474,5,6813,3.600951374207188,20.0,40.0
21892,2,1892,[483 302 127 100 313],328,5,6818,3.601690438457475,20.0,40.0
21893,2,1893,[748 245 211 357  69],533,2,6820,3.6008447729672652,20.0,0.0
21894,2,1894,[483 302 127 100 313],328,5,6825,3.6015831134564644,20.0,40.0
21895,2,1895,[204  95  22  56 216],92,2,6827,3.6007383966244726,0.0,0.0
21896,2,1896,[742  69 172 187  56],506,5,6832,3.6014760147601477,0.0,0.0
21897,2,1897,[423 313 173 179 258],650,2,6834,3.600632244467861,0.0,0.0
21898,2,1898,[182 282 471 265 216],479,4,6838,3.6008425487098474,0.0,0.0
21899,2,1899,[483 302 127 100 313],13,5,6843,3.601578947368421,20.0,40.0
21900,2,1900,[483 302 127 100 313],537,5,6848,3.6023145712782747,20.0,40.0
21901,2,1901,[302 197  96  70 216],934,4,6852,3.6025236593059935,0.0,0.0
21902,2,1902,[175 603   4 197 215],524,2,6854,3.601681555438781,20.0,0.0
21903,2,1903,[ 8  9 98  1 88],298,5,6859,3.6024159663865545,0.0,20.0
21904,2,1904,[161 118 100 238   4],804,5,6864,3.6031496062992128,0.0,20.0
21905,2,1905,[483 302 127 100 313],474,5,6869,3.6038824763903463,20.0,40.0
21906,2,1906,[273 211 748 143 483],479,3,6872,3.6035658101730466,20.0,0.0
21907,2,1907,[  4 191 300 238 258],749,4,6876,3.6037735849056602,0.0,0.0
21908,2,1908,[483 302 127 100 313],207,4,6880,3.603981141959141,20.0,40.0
21909,2,1909,[483 302 127 100 313],329,5,6885,3.6047120418848166,20.0,40.0
21910,2,1910,[483 302 127 100 313],232,3,6888,3.6043956043956045,20.0,40.0
21911,2,1911,[483 302 127 100 313],328,5,6893,3.6051255230125525,20.0,40.0
21912,2,1912,[483 302 127 100 313],329,5,6898,3.6058546785154206,20.0,40.0
21913,2,1913,[211 127 288  69  56],188,5,6903,3.6065830721003134,0.0,20.0
21914,2,1914,[318 186 265 182 210],892,4,6907,3.6067885117493472,20.0,0.0
21915,2,1915,[483 302 127 100 313],328,5,6912,3.607515657620042,20.0,40.0
21916,2,1916,[204 427 435 180 196],308,4,6916,3.6077203964527906,0.0,0.0
21917,2,1917,[  9 427 237 187   8],334,5,6921,3.60844629822732,0.0,0.0
21918,2,1918,[483 302 127 100 313],207,4,6925,3.6086503387180824,20.0,40.0
21919,2,1919,[483 302 127 100 313],334,5,6930,3.609375,20.0,40.0
21920,2,1920,[483 302 127 100 313],13,5,6935,3.6100989068193647,20.0,40.0
21921,2,1921,[135 546  64  50 286],653,4,6939,3.610301768990635,0.0,20.0
21922,2,1922,[568 194 135   9 234],308,4,6943,3.6105044201768073,0.0,0.0
21923,2,1923,[194  88 186 204 678],506,4,6947,3.610706860706861,0.0,0.0
21924,2,1924,[238 111 161  64 173],271,4,6951,3.610909090909091,0.0,0.0
21925,2,1925,[127  89  22 328   7],144,2,6953,3.610072689511942,0.0,20.0
21926,2,1926,[483 302 127 100 313],329,5,6958,3.6107939802802282,20.0,40.0
21927,2,1927,[257 265 185 125  11],881,5,6963,3.611514522821577,0.0,0.0
21928,2,1928,[143 197 100 215 161],749,3,6966,3.6111975116640744,0.0,20.0
21929,2,1929,[483 302 127 100 313],474,5,6971,3.6119170984455957,20.0,40.0
21930,2,1930,[ 22 235  12 168 204],92,3,6974,3.611600207146556,20.0,0.0
21931,2,1931,[483 302 127 100 313],90,5,6979,3.61231884057971,20.0,40.0
21932,2,1932,[  7 100 132 182 276],194,1,6980,3.6109674081738232,0.0,20.0
21933,2,1933,[216  28 200 172 176],648,4,6984,3.611168562564633,0.0,0.0
21934,2,1934,[194 435 568 211 181],64,5,6989,3.611886304909561,0.0,0.0
21935,2,1935,[222 257 235 322 742],334,2,6991,3.6110537190082646,0.0,0.0
21936,2,1936,[ 15 588 143 496 258],200,5,6996,3.6117707795560143,0.0,0.0
21937,2,1937,[302 204  79  71  70],788,3,6999,3.611455108359133,0.0,0.0
21938,2,1938,[183  69 176 265 191],7,4,7003,3.6116554925219186,0.0,0.0
21939,2,1939,[172 187 282 182  28],533,4,7007,3.611855670103093,0.0,0.0
21940,2,1940,[483 302 127 100 313],474,5,7012,3.612570839773313,20.0,40.0
21941,2,1941,[483 302 127 100 313],334,5,7017,3.613285272914521,20.0,40.0
21942,2,1942,[175 173 210   9 275],13,1,7018,3.611940298507463,0.0,0.0
21943,2,1943,[483 302 127 100 313],334,5,7023,3.6126543209876543,20.0,40.0
21944,2,1944,[483 302 127 100 313],232,3,7026,3.612339331619537,20.0,40.0
21945,2,1945,[483 302 127 100 313],329,5,7031,3.6130524152106887,20.0,40.0
21946,2,1946,[174 202 318  11 210],454,3,7034,3.6127375449409347,20.0,20.0
21947,2,1947,[210  88 568  22 588],454,4,7038,3.6129363449691994,0.0,0.0
21948,2,1948,[195 180 173 588 302],378,3,7041,3.61262185736275,0.0,0.0
21949,2,1949,[ 88  25 195 197 180],207,2,7043,3.6117948717948716,0.0,0.0
21950,2,1950,[117 222 111 423 125],334,2,7045,3.610968733982573,0.0,0.0
21951,2,1951,[597 180  95 125 471],821,4,7049,3.6111680327868854,0.0,0.0
21952,2,1952,[357 238  96 333 210],313,5,7054,3.611879160266257,20.0,0.0
21953,2,1953,[318 496 151 403 161],308,3,7057,3.6115660184237464,20.0,0.0
21954,2,1954,[  8  88 176 588 174],479,4,7061,3.611764705882353,0.0,20.0
21955,2,1955,[483 302 127 100 313],334,5,7066,3.612474437627812,20.0,40.0
21956,2,1956,[204 168 202  88 121],881,3,7069,3.612161471640266,0.0,0.0
21957,2,1957,[294  96 100 276 405],474,4,7073,3.6123595505617976,0.0,20.0
21958,2,1958,[271 222 186 144 204],102,2,7075,3.611536498213374,0.0,0.0
21959,2,1959,[ 69 471 195 742 265],533,4,7079,3.611734693877551,0.0,0.0
21960,2,1960,[182 238 168 215 204],194,3,7082,3.611422743498215,0.0,0.0
21961,2,1961,[ 15 237 200 179 258],271,3,7085,3.611111111111111,0.0,0.0
21962,2,1962,[483 302 127 100 313],207,4,7089,3.6113092205807438,20.0,40.0
21963,2,1963,[294 202 200 197  88],308,3,7092,3.610997963340122,0.0,0.0
21964,2,1964,[135   1 172 403 202],533,3,7095,3.6106870229007635,0.0,0.0
21965,2,1965,[483 302 127 100 313],329,5,7100,3.6113936927772126,20.0,40.0
21966,2,1966,[ 69 175 302 153  79],343,5,7105,3.6120996441281137,0.0,0.0
21967,2,1967,[185 655 117 435 568],749,5,7110,3.6128048780487805,0.0,0.0
21968,2,1968,[211 194 172  88 294],533,5,7115,3.613509395632301,0.0,0.0
21969,2,1969,[172 357  82  25  89],648,3,7118,3.613197969543147,20.0,0.0
21970,2,1970,[222 175 288 235 186],92,3,7121,3.612886859462202,0.0,0.0
21971,2,1971,[483 302 127 100 313],232,3,7124,3.612576064908722,20.0,40.0
21972,2,1972,[161  96 475 234  97],533,2,7126,3.6117587430309173,0.0,0.0
21973,2,1973,[ 11 187  50 172 185],213,5,7131,3.6124620060790273,0.0,20.0
21974,2,1974,[483 302 127 100 313],328,5,7136,3.613164556962025,20.0,40.0
21975,2,1975,[483 302 127 100 313],328,5,7141,3.6138663967611335,20.0,40.0
21976,2,1976,[161 182 237 423   4],318,3,7144,3.6135558927668185,0.0,0.0
21977,2,1977,[483 302 127 100 313],90,5,7149,3.614256825075834,20.0,40.0
21978,2,1978,[435   7 153 194 515],843,1,7150,3.612935826174836,0.0,0.0
21979,2,1979,[483 302 127 100 313],232,3,7153,3.6126262626262626,20.0,40.0
21980,2,1980,[  7 282  22 173 471],455,4,7157,3.612821807168097,0.0,0.0
21981,2,1981,[568 111 273 405 117],92,2,7159,3.612008072653885,0.0,0.0
21982,2,1982,[  1 132 302  70 186],6,4,7163,3.612203731719617,0.0,0.0
21983,2,1983,[301 300 597 121 282],486,2,7165,3.611391129032258,0.0,0.0
21984,2,1984,[483 302 127 100 313],537,5,7170,3.6120906801007555,20.0,40.0
21985,2,1985,[515 568 222 132 168],64,5,7175,3.6127895266868078,0.0,0.0
21986,2,1986,[483 302 127 100 313],474,5,7180,3.6134876698540515,20.0,40.0
21987,2,1987,[183  97  25 172 179],406,4,7184,3.613682092555332,0.0,0.0
21988,2,1988,[144 597 172 568 282],804,4,7188,3.6138763197586727,0.0,0.0
21989,2,1989,[483 302 127 100 313],90,5,7193,3.614572864321608,20.0,40.0
21990,2,1990,[ 82 197  22 121 191],13,3,7196,3.614264188849824,0.0,0.0
21991,2,1991,[196 286 742 183 515],881,3,7199,3.6139558232931726,0.0,0.0
21992,2,1992,[187 127 196 603 195],234,3,7202,3.613647767185148,20.0,20.0
21993,2,1993,[678 191 186  64 100],474,4,7206,3.613841524573721,0.0,20.0
21994,2,1994,[423 475 211 328 483],479,3,7209,3.613533834586466,20.0,0.0
21995,2,1995,[483 302 127 100 313],207,4,7213,3.6137274549098195,20.0,40.0
21996,2,1996,[483 302 127 100 313],334,5,7218,3.614421632448673,20.0,40.0
21997,2,1997,[  8 153  25  71 174],7,4,7222,3.6146146146146148,0.0,20.0
21998,2,1998,[237 423 300  82 357],13,2,7224,3.6138069034517257,20.0,0.0
21999,2,1999,[202  69 483  28 186],210,5,7229,3.6145,20.0,0.0
22000,2,2000,[ 79 288   9 127 121],474,4,7233,3.6146926536731634,0.0,20.0
22001,2,2001,[ 98  25 100  56 186],892,4,7237,3.614885114885115,0.0,40.0
22002,2,2002,[483 302 127 100 313],207,4,7241,3.6150773839241137,20.0,40.0
22003,2,2003,[496 483 191 125  50],398,4,7245,3.6152694610778444,20.0,20.0
22004,2,2004,[ 28 211 275 195 257],883,4,7249,3.6154613466334165,0.0,0.0
22005,2,2005,[176 546 168 182 245],533,1,7250,3.614157527417747,0.0,0.0
22006,2,2006,[  1 546 117 161 655],95,3,7253,3.6138515196811163,0.0,0.0
22007,2,2007,[174 179 196 181   7],92,5,7258,3.614541832669323,0.0,20.0
22008,2,2008,[483 302 127 100 313],207,4,7262,3.6147336983573917,20.0,40.0
22009,2,2009,[483 302 127 100 313],537,5,7267,3.6154228855721393,20.0,40.0
22010,2,2010,[117  89  71 121 216],184,3,7270,3.615116857284933,0.0,0.0
22011,2,2011,[322 405 228  89 168],804,5,7275,3.6158051689860833,0.0,0.0
22012,2,2012,[483 302 127 100 313],232,3,7278,3.615499254843517,20.0,40.0
22013,2,2013,[187 328 546 483 168],234,2,7280,3.6146971201588878,20.0,0.0
22014,2,2014,[174  82 546  95 132],749,3,7283,3.61439205955335,0.0,20.0
22015,2,2015,[423 210 294  28 742],804,4,7287,3.6145833333333335,0.0,0.0
22016,2,2016,[483 302 127 100 313],207,4,7291,3.614774417451661,20.0,40.0
22017,2,2017,[427  50 265  12 196],194,3,7294,3.614469772051536,20.0,20.0
22018,2,2018,[328 181 483   4 216],207,3,7297,3.614165428429916,20.0,0.0
22019,2,2019,[117  56 222 175  95],524,1,7298,3.612871287128713,0.0,0.0
22020,2,2020,[273 313   4 197 357],234,4,7302,3.6130628401781295,20.0,0.0
22021,2,2021,[546 196  69 194   8],901,4,7306,3.613254203758655,0.0,0.0
22022,2,2022,[483 302 127 100 313],207,4,7310,3.6134453781512605,20.0,40.0
22023,2,2023,[435  79 302 313 197],871,3,7313,3.6131422924901186,0.0,0.0
22024,2,2024,[111 204  50  28 132],653,3,7316,3.6128395061728393,0.0,20.0
22025,2,2025,[483 302 127 100 313],328,5,7321,3.613524185587364,20.0,40.0
22026,2,2026,[496 385 186 216 322],234,1,7322,3.6122348297977305,0.0,0.0
22027,2,2027,[301 180 173 185 125],234,0,7322,3.6104536489151875,0.0,0.0
22028,2,2028,[197 172 603 143 161],13,4,7326,3.6106456382454413,20.0,0.0
22029,2,2029,[483 302 127 100 313],329,5,7331,3.611330049261084,20.0,40.0
22030,2,2030,[483 302 127 100 313],207,4,7335,3.6115214180206796,20.0,40.0
22031,2,2031,[175  56  95 100 187],749,0,7335,3.609744094488189,0.0,20.0
22032,2,2032,[483 302 127 100 313],474,5,7340,3.6104279390063945,20.0,40.0
22033,2,2033,[483 302 127 100 313],90,5,7345,3.611111111111111,20.0,40.0
22034,2,2034,[603 546 282 135 197],271,3,7348,3.610810810810811,20.0,0.0
22035,2,2035,[483 302 127 100 313],334,5,7353,3.611493123772102,20.0,40.0
22036,2,2036,[179 195 173 318 271],479,3,7356,3.6111929307805597,20.0,0.0
22037,2,2037,[182 172 111  82   9],374,2,7358,3.6104023552502453,0.0,0.0
22038,2,2038,[181  88 483 318 222],479,5,7363,3.611083864639529,40.0,0.0
22039,2,2039,[483 302 127 100 313],90,5,7368,3.611764705882353,20.0,40.0
22040,2,2040,[ 71 172  15 238 210],892,4,7372,3.611954924056835,0.0,0.0
22041,2,2041,[ 71   8  22 216 271],479,2,7374,3.6111655239960823,0.0,0.0
22042,2,2042,[483 302 127 100 313],232,3,7377,3.6108663729809103,20.0,40.0
22043,2,2043,[ 15 588 238 144 435],313,4,7381,3.6110567514677103,0.0,0.0
22044,2,2044,[211 483 132 172 276],643,5,7386,3.611735941320293,20.0,0.0
22045,2,2045,[151  89  22 174 127],749,5,7391,3.612414467253177,0.0,40.0
22046,2,2046,[496 135 172 144 195],454,3,7394,3.612115290669272,0.0,0.0
22047,2,2047,[289 403  56 282 238],881,1,7395,3.61083984375,0.0,0.0
22048,2,2048,[173  79 127 475 216],339,4,7399,3.6110297706198144,0.0,20.0
22049,2,2049,[269 405   9  11  97],7,2,7401,3.6102439024390245,0.0,0.0
22050,2,2050,[185 183  28  95 427],60,5,7406,3.6109215017064846,0.0,0.0
22051,2,2051,[385 186 496 187 216],537,3,7409,3.6106237816764133,0.0,0.0
22052,2,2052,[483 302 127 100 313],334,5,7414,3.6113005358012664,20.0,40.0
22053,2,2053,[483 302 127 100 313],537,5,7419,3.611976630963973,20.0,40.0
22054,2,2054,[ 15 273 234 257 237],374,2,7421,3.611192214111922,0.0,0.0
22055,2,2055,[173 275  25 161 168],648,3,7424,3.6108949416342413,0.0,0.0
22056,2,2056,[204  11 100  95  69],271,5,7429,3.6115702479338845,0.0,20.0
22057,2,2057,[483 302 127 100 313],328,5,7434,3.6122448979591835,20.0,40.0
22058,2,2058,[483 302 127 100 313],334,5,7439,3.6129188926663427,20.0,40.0
22059,2,2059,[237 475 333 435 405],144,3,7442,3.612621359223301,0.0,0.0
22060,2,2060,[323 161 235  71 403],650,0,7442,3.610868510431829,0.0,0.0
22061,2,2061,[176 403 153 357   1],313,3,7445,3.610572259941804,20.0,0.0
22062,2,2062,[173  88 483 238 202],454,1,7446,3.6093068347067376,20.0,0.0
22063,2,2063,[183 211 197 172 603],326,4,7450,3.6094961240310077,20.0,0.0
22064,2,2064,[483 302 127 100 313],207,4,7454,3.6096852300242133,20.0,40.0
22065,2,2065,[483 302 127 100 313],334,5,7459,3.6103581800580833,20.0,40.0
22066,2,2066,[483 302 127 100 313],90,5,7464,3.611030478955007,20.0,40.0
22067,2,2067,[ 95 175 200 100 168],13,4,7468,3.611218568665377,0.0,20.0
22068,2,2068,[127 275 202 483  56],406,3,7471,3.610923151280812,20.0,20.0
22069,2,2069,[ 28 196   8 197  96],378,4,7475,3.611111111111111,0.0,0.0
22070,2,2070,[483 302 127 100 313],207,4,7479,3.6112988894253983,20.0,40.0
22071,2,2071,[ 64 276 174   7 191],452,4,7483,3.6114864864864864,0.0,20.0
22072,2,2072,[588 258 568 215 100],64,4,7487,3.611673902556681,0.0,20.0
22073,2,2073,[471 132 202 427 181],454,1,7488,3.6104146576663454,0.0,0.0
22074,2,2074,[483 302 127 100 313],90,5,7493,3.6110843373493977,20.0,40.0
22075,2,2075,[483 302 127 100 313],474,5,7498,3.611753371868979,20.0,40.0
22076,2,2076,[215  88  71 568 183],13,4,7502,3.611940298507463,0.0,0.0
22077,2,2077,[288   4 328 215 210],533,3,7505,3.611645813282002,0.0,0.0
22078,2,2078,[483 302 127 100 313],328,5,7510,3.612313612313612,20.0,40.0
22079,2,2079,[200 125  71  50 238],899,3,7513,3.612019230769231,0.0,20.0
22080,2,2080,[385 275 185 322  12],537,2,7515,3.6112445939452185,20.0,0.0
22081,2,2081,[ 96 301  71 196 269],13,3,7518,3.610951008645533,0.0,0.0
22082,2,2082,[237  64 258 286 435],144,5,7523,3.611617858857417,0.0,0.0
22083,2,2083,[483 302 127 100 313],90,5,7528,3.6122840690978886,20.0,40.0
22084,2,2084,[483 302 127 100 313],474,5,7533,3.61294964028777,20.0,40.0
22085,2,2085,[143 568 237  98  15],59,3,7536,3.6126558005752636,0.0,20.0
22086,2,2086,[483 302 127 100 313],232,3,7539,3.6123622424532824,20.0,40.0
22087,2,2087,[357 181   1   8 204],254,3,7542,3.6120689655172415,20.0,0.0
22088,2,2088,[318 405 435 153   7],406,3,7545,3.6117759693633316,20.0,0.0
22089,2,2089,[483 302 127 100 313],232,3,7548,3.6114832535885166,20.0,40.0
22090,2,2090,[211 186 195   7 427],882,5,7553,3.612147297943568,0.0,0.0
22091,2,2091,[182 100  95 118  15],378,5,7558,3.612810707456979,0.0,20.0
22092,2,2092,[179  79 403 186 204],95,3,7561,3.612517916865743,0.0,0.0
22093,2,2093,[483 121 323 191 265],537,2,7563,3.6117478510028653,20.0,0.0
22094,2,2094,[318 174 210 222  96],524,3,7566,3.6114558472553697,20.0,20.0
22095,2,2095,[ 15 435  25 357 268],537,2,7568,3.6106870229007635,20.0,0.0
22096,2,2096,[153 568   4 197 603],308,4,7572,3.6108726752503575,20.0,0.0
22097,2,2097,[483 302 127 100 313],232,3,7575,3.6105815061963775,20.0,40.0
22098,2,2098,[483 302 127 100 313],334,5,7580,3.6112434492615533,20.0,40.0
22099,2,2099,[ 22 603  97 161 196],738,4,7584,3.611428571428571,20.0,0.0
22100,2,2100,[385 210 748 151 357],648,2,7586,3.6106615897191814,20.0,0.0
22101,2,2101,[483 302 127 100 313],13,5,7591,3.611322549952426,20.0,40.0
22102,2,2102,[ 95  22 215  50 427],59,4,7595,3.611507370423205,0.0,20.0
22103,2,2103,[483 302 127 100 313],329,5,7600,3.612167300380228,20.0,40.0
22104,2,2104,[144 588 427 237 211],308,3,7603,3.61187648456057,0.0,0.0
22105,2,2105,[483 302 127 100 313],232,3,7606,3.611585944919278,20.0,40.0
22106,2,2106,[195 153 238 121  64],279,4,7610,3.611770289511153,0.0,0.0
22107,2,2107,[427 210 132 288 202],882,4,7614,3.611954459203036,0.0,0.0
22108,2,2108,[ 82 313 588 678 196],308,2,7616,3.6111901375059268,0.0,0.0
22109,2,2109,[117 172   7 265 597],346,3,7619,3.610900473933649,0.0,0.0
22110,2,2110,[202 135  11 282  71],804,4,7623,3.611084793936523,0.0,0.0
22111,2,2111,[168 197  69 216 183],60,5,7628,3.6117424242424243,0.0,0.0
22112,2,2112,[187  96  22 237 211],474,5,7633,3.61239943208708,0.0,0.0
22113,2,2113,[100   8 405 403 194],892,4,7637,3.6125827814569536,0.0,20.0
22114,2,2114,[215 237  70 175  96],378,5,7642,3.6132387706855793,0.0,0.0
22115,2,2115,[483 302 127 100 313],474,5,7647,3.6138941398865785,20.0,40.0
22116,2,2116,[211 294 135 182  70],6,3,7650,3.613604156825697,0.0,0.0
22117,2,2117,[385 435  95 258 143],13,3,7653,3.6133144475920678,0.0,0.0
22118,2,2118,[174 216 475  50   7],334,4,7657,3.6134969325153374,0.0,40.0
22119,2,2119,[483 302 127 100 313],207,4,7661,3.6136792452830186,20.0,40.0
22120,2,2120,[228  82 161 268 257],334,4,7665,3.613861386138614,0.0,0.0
22121,2,2121,[483 302 127 100 313],329,5,7670,3.6145146088595665,20.0,40.0
22122,2,2122,[ 50 288 302 202 176],537,2,7672,3.613754121526142,0.0,20.0
22123,2,2123,[496 180 100 322   1],313,4,7676,3.6139359698681734,0.0,20.0
22124,2,2124,[245 121  12 180 286],207,0,7676,3.612235294117647,20.0,0.0
22125,2,2125,[ 69  79  70 322  71],334,1,7677,3.6110065851364066,0.0,0.0
22126,2,2126,[483 302 127 100 313],474,5,7682,3.611659614480489,20.0,40.0
22127,2,2127,[ 97 194 323 215 748],804,5,7687,3.612312030075188,0.0,0.0
22128,2,2128,[ 15 228 238 471 197],194,3,7690,3.612024424612494,0.0,0.0
22129,2,2129,[111 117 202 144 568],749,4,7694,3.6122065727699533,0.0,0.0
22130,2,2130,[483 302 127 100 313],334,5,7699,3.612857813233224,20.0,40.0
22131,2,2131,[300  70  22 475 182],144,2,7701,3.6121013133208257,0.0,0.0
22132,2,2132,[ 12 215 568  50 211],538,4,7705,3.6122831692451944,20.0,20.0
22133,2,2133,[ 95 168 175  82 588],843,1,7706,3.611059044048735,0.0,0.0
22134,2,2134,[483 302 127 100 313],90,5,7711,3.611709601873536,20.0,40.0
22135,2,2135,[211 234 200 597 168],650,4,7715,3.61189138576779,0.0,0.0
22136,2,2136,[318 333   8 100  50],13,3,7718,3.6116050538137574,20.0,40.0
22137,2,2137,[403  71 423   1  98],184,4,7722,3.6117867165575306,0.0,20.0
22138,2,2138,[273 117 151 191 357],387,3,7725,3.611500701262272,20.0,0.0
22139,2,2139,[483 302 127 100 313],90,5,7730,3.6121495327102804,20.0,40.0
22140,2,2140,[483  69 385 118 200],7,4,7734,3.612330686595049,20.0,0.0
22141,2,2141,[282 483  89  50   4],881,3,7737,3.612044817927171,20.0,20.0
22142,2,2142,[483 302 127 100 313],334,5,7742,3.6126924871675223,20.0,40.0
22143,2,2143,[742 111 300 748 289],84,4,7746,3.612873134328358,0.0,0.0
22144,2,2144,[173  88  50 153 588],326,3,7749,3.6125874125874127,0.0,20.0
22145,2,2145,[ 89 273 197 568  64],524,3,7752,3.612301957129543,0.0,0.0
22146,2,2146,[483 302 127 100 313],334,5,7757,3.6129482999534233,20.0,40.0
22147,2,2147,[435 300 194 118  98],7,4,7761,3.613128491620112,0.0,20.0
22148,2,2148,[182 197 222 175 200],653,1,7762,3.611912517449977,0.0,0.0
22149,2,2149,[273 302 210 186 222],524,1,7763,3.6106976744186046,0.0,0.0
22150,2,2150,[286 515  64  71 153],6,4,7767,3.6108786610878663,0.0,0.0
22151,2,2151,[173 197 215   1  56],378,4,7771,3.6110594795539033,0.0,0.0
22152,2,2152,[483 302 127 100 313],474,5,7776,3.611704598235021,20.0,40.0
22153,2,2153,[282  97 210  28  70],533,4,7780,3.6118848653667595,0.0,0.0
22154,2,2154,[288  89 748 196   4],474,3,7783,3.611600928074246,0.0,0.0
22155,2,2155,[301 151  22 183  88],234,2,7785,3.6108534322820036,0.0,0.0
22156,2,2156,[483 302 127 100 313],334,5,7790,3.6114974501622625,20.0,40.0
22157,2,2157,[222 182 216 568 268],537,2,7792,3.6107506950880444,0.0,0.0
22158,2,2158,[483 302 127 100 313],474,5,7797,3.6113941639647984,20.0,40.0
22159,2,2159,[483 302 127 100 313],328,5,7802,3.612037037037037,20.0,40.0
22160,2,2160,[237 265 385 222 215],533,3,7805,3.6117538176770014,0.0,0.0
22161,2,2161,[483 302 127 100 313],474,5,7810,3.6123959296947272,20.0,40.0
22162,2,2162,[496 143 125 187  56],406,2,7812,3.6116504854368934,0.0,0.0
22163,2,2163,[191 294 210 423 508],207,3,7815,3.6113678373382623,0.0,0.0
22164,2,2164,[483 302 127 100 313],334,5,7820,3.612009237875289,20.0,40.0
22165,2,2165,[144 216 748 282 385],207,2,7822,3.611265004616805,0.0,0.0
22166,2,2166,[483 302 127 100 313],90,5,7827,3.611905860636825,20.0,40.0
22167,2,2167,[ 56 405 100 238 265],738,3,7830,3.6116236162361623,0.0,20.0
22168,2,2168,[483 302 127 100 313],329,5,7835,3.612263715998156,20.0,40.0
22169,2,2169,[ 71 196  50  95 237],184,5,7840,3.6129032258064515,0.0,20.0
22170,2,2170,[ 89 100 483  88 196],406,3,7843,3.6126209120221096,20.0,20.0
22171,2,2171,[288  98 194 435 496],648,5,7848,3.613259668508287,0.0,20.0
22172,2,2172,[748 323   9 200 238],311,4,7852,3.6134376438104003,0.0,0.0
22173,2,2173,[483 302 127 100 313],207,4,7856,3.6136154553817845,20.0,40.0
22174,2,2174,[ 88  98 144  11 228],343,5,7861,3.6142528735632182,0.0,20.0
22175,2,2175,[483 302 127 100 313],334,5,7866,3.614889705882353,20.0,40.0
22176,2,2176,[215  56 475 118  96],13,4,7870,3.6150666054203033,0.0,0.0
22177,2,2177,[237 216 185  89 496],883,3,7873,3.6147842056932964,0.0,0.0
22178,2,2178,[ 89 269 196 228 286],455,4,7877,3.614960991280404,0.0,0.0
22179,2,2179,[483 302 127 100 313],328,5,7882,3.6155963302752294,20.0,40.0
22180,2,2180,[282 195 238 318  11],474,5,7887,3.6162310866574967,20.0,0.0
22181,2,2181,[144  88 328 197 121],479,5,7892,3.616865261228231,0.0,0.0
22182,2,2182,[483 302 127 100 313],207,4,7896,3.6170407695831424,20.0,40.0
22183,2,2183,[483 302 127 100 313],328,5,7901,3.6176739926739927,20.0,40.0
22184,2,2184,[588 187 265 132 181],537,1,7902,3.6164759725400457,0.0,0.0
22185,2,2185,[483 302 127 100 313],334,5,7907,3.617108874656908,20.0,40.0
22186,2,2186,[172 323 180 238 161],474,4,7911,3.617283950617284,0.0,0.0
22187,2,2187,[483 302 127 100 313],329,5,7916,3.6179159049360146,20.0,40.0
22188,2,2188,[182 197 228 125 175],234,1,7917,3.616719963453632,0.0,0.0
22189,2,2189,[483 302 127 100 313],232,3,7920,3.6164383561643834,20.0,40.0
22190,2,2190,[483 302 127 100 313],474,5,7925,3.6170698311273393,20.0,40.0
22191,2,2191,[483 302 127 100 313],329,5,7930,3.6177007299270074,20.0,40.0
22192,2,2192,[183   8 211 194  70],398,4,7934,3.617875056999544,0.0,0.0
22193,2,2193,[100 196 204 245 603],334,4,7938,3.6180492251595258,20.0,20.0
22194,2,2194,[483 302 127 100 313],537,5,7943,3.6186788154897496,20.0,40.0
22195,2,2195,[151   9 197  22 328],749,4,7947,3.6188524590163933,0.0,0.0
22196,2,2196,[483 302 127 100 313],537,5,7952,3.619481110605371,20.0,40.0
22197,2,2197,[ 22  64 496 183 216],749,5,7957,3.6201091901728844,0.0,0.0
22198,2,2198,[483 302 127 100 313],474,5,7962,3.620736698499318,20.0,40.0
22199,2,2199,[483 302 127 100 313],328,5,7967,3.6213636363636366,20.0,40.0
22200,2,2200,[196 215  98 179  82],64,4,7971,3.6215356656065425,0.0,20.0
22201,2,2201,[483 302 127 100 313],207,4,7975,3.6217075386012714,20.0,40.0
22202,2,2202,[ 82 288 132 328  95],554,4,7979,3.621879255560599,0.0,0.0
22203,2,2203,[ 56  98 125 237 186],295,5,7984,3.6225045372050815,0.0,20.0
22204,2,2204,[588  96 238 204 568],313,5,7989,3.6231292517006803,0.0,0.0
22205,2,2205,[228 282 276 289  96],92,4,7993,3.6233000906618313,0.0,0.0
22206,2,2206,[483 302 127 100 313],328,5,7998,3.623923878568192,20.0,40.0
22207,2,2207,[ 70 196  15  98 191],406,3,8001,3.623641304347826,0.0,20.0
22208,2,2208,[483 302 127 100 313],232,3,8004,3.6233589859665005,20.0,40.0
22209,2,2209,[275 318 194  64 186],378,4,8008,3.623529411764706,20.0,0.0
22210,2,2210,[161  95 268 143 210],13,3,8011,3.6232473993668024,0.0,0.0
22211,2,2211,[483 302 127 100 313],328,5,8016,3.623869801084991,20.0,40.0
22212,2,2212,[483 302 127 100 313],537,5,8021,3.624491640307275,20.0,40.0
22213,2,2213,[211  98  97 435 234],90,5,8026,3.6251129177958448,0.0,20.0
22214,2,2214,[ 89 111 275 546 175],378,3,8029,3.6248306997742663,0.0,0.0
22215,2,2215,[257 273   4 200  64],374,2,8031,3.6240974729241877,0.0,0.0
22216,2,2216,[234 748 288 197 257],474,2,8033,3.623364907532702,0.0,0.0
22217,2,2217,[180 127 496  79 508],385,2,8035,3.6226330027051397,0.0,20.0
22218,2,2218,[151 176 234   8 286],7,4,8039,3.622803064443443,0.0,0.0
22219,2,2219,[483 302 127 100 313],328,5,8044,3.6234234234234233,20.0,40.0
22220,2,2220,[294   1  28 269 238],537,1,8045,3.6222422332282758,0.0,0.0
22221,2,2221,[235 603 655 183 405],334,3,8048,3.621962196219622,20.0,0.0
22222,2,2222,[179 215 471 111 235],648,4,8052,3.622132253711201,0.0,0.0
22223,2,2223,[515 182 176 135 195],840,4,8056,3.6223021582733814,0.0,0.0
22224,2,2224,[385 200 210 237 508],59,4,8060,3.6224719101123597,0.0,0.0
22225,2,2225,[405 197  96  71 168],738,2,8062,3.6217430368373766,0.0,0.0
22226,2,2226,[588 185 508 144 172],527,4,8066,3.6219128872923214,0.0,0.0
22227,2,2227,[182 265 423 742  70],378,5,8071,3.622531418312388,0.0,0.0
22228,2,2228,[  8 300 234  96  12],311,5,8076,3.623149394347241,20.0,0.0
22229,2,2229,[435 237  79 132 471],313,4,8080,3.623318385650224,0.0,0.0
22230,2,2230,[237 357 117 318 423],13,2,8082,3.6225907664724337,40.0,0.0
22231,2,2231,[210  22 748 245 475],533,2,8084,3.621863799283154,0.0,0.0
22232,2,2232,[  8 176 135 100 175],213,4,8088,3.6220331392745186,0.0,20.0
22233,2,2233,[483 302 127 100 313],207,4,8092,3.622202327663384,20.0,40.0
22234,2,2234,[211 237 144 183 176],308,3,8095,3.621923937360179,0.0,0.0
22235,2,2235,[ 15 153 204  12 471],234,0,8095,3.620304114490161,20.0,0.0
22236,2,2236,[483 302 127 100 313],90,5,8100,3.6209208761734466,20.0,40.0
22237,2,2237,[483 302 127 100 313],13,5,8105,3.6215370866845396,20.0,40.0
22238,2,2238,[496 257 318 423 289],474,3,8108,3.621259490844127,20.0,0.0
22239,2,2239,[483 302 127 100 313],232,3,8111,3.6209821428571427,20.0,40.0
22240,2,2240,[161  12 318 405 258],474,5,8116,3.6215975011155734,40.0,0.0
22241,2,2241,[385 435 172 427 186],379,4,8120,3.6217662801070474,0.0,0.0
22242,2,2242,[483 302 127 100 313],232,3,8123,3.6214890771288455,20.0,40.0
22243,2,2243,[508 597 118 235 237],82,0,8123,3.6198752228163995,0.0,0.0
22244,2,2244,[483 302 127 100 313],328,5,8128,3.620489977728285,20.0,40.0
22245,2,2245,[483 302 127 100 313],328,5,8133,3.6211041852181656,20.0,40.0
22246,2,2246,[289 186 496 313 269],537,3,8136,3.6208277703604805,0.0,0.0
22247,2,2247,[172 269 318 111 237],13,3,8139,3.6205516014234878,20.0,0.0
22248,2,2248,[183 286 318 194 182],59,3,8142,3.620275678079146,20.0,0.0
22249,2,2249,[127 194   9 215 508],533,5,8147,3.620888888888889,0.0,20.0
22250,2,2250,[168  64 210 357 405],60,5,8152,3.621501554864505,20.0,0.0
22251,2,2251,[  9 271  50 215 175],13,3,8155,3.6212255772646538,0.0,20.0
22252,2,2252,[427 182   7 173   8],474,5,8160,3.621837549933422,0.0,0.0
22253,2,2253,[179 132  28 597 257],378,3,8163,3.621561668145519,0.0,0.0
22254,2,2254,[515 176  82 127 483],488,4,8167,3.621729490022173,20.0,20.0
22255,2,2255,[132 204  69 161  79],506,5,8172,3.622340425531915,0.0,0.0
22256,2,2256,[ 82 294  50   8  22],774,1,8173,3.6211785556047853,0.0,20.0
22257,2,2257,[483 302 127 100 313],13,5,8178,3.6217891939769706,20.0,40.0
22258,2,2258,[151 210 143 144   8],95,5,8183,3.622399291722001,0.0,0.0
22259,2,2259,[238 182  69  11  89],406,4,8187,3.622566371681416,0.0,0.0
22260,2,2260,[175  96 210 186 435],326,1,8188,3.62140645731977,0.0,0.0
22261,2,2261,[175 127 185 161 515],774,1,8189,3.6202475685234305,0.0,20.0
22262,2,2262,[ 96 132 100   7 435],295,4,8193,3.620415377817057,0.0,20.0
22263,2,2263,[483 302 127 100 313],474,5,8198,3.621024734982332,20.0,40.0
22264,2,2264,[182 215  70  11 121],328,2,8200,3.6203090507726268,0.0,0.0
22265,2,2265,[483 302 127 100 313],207,4,8204,3.6204766107678727,20.0,40.0
22266,2,2266,[483 302 127 100 313],474,5,8209,3.6210851345390385,20.0,40.0
22267,2,2267,[483 302 127 100 313],90,5,8214,3.621693121693122,20.0,40.0
22268,2,2268,[100 181 385 132 323],650,4,8218,3.621859850154253,0.0,20.0
22269,2,2269,[328 210  97  25 588],313,4,8222,3.6220264317180617,0.0,0.0
22270,2,2270,[483 302 127 100 313],329,5,8227,3.622633201232937,20.0,40.0
22271,2,2271,[483 302 127 100 313],328,5,8232,3.6232394366197185,20.0,40.0
22272,2,2272,[258 196 185 151 237],666,2,8234,3.622525296964364,0.0,0.0
22273,2,2273,[302 194  50 357 271],328,3,8237,3.6222515391380825,20.0,20.0
22274,2,2274,[496  88 403 475 427],339,4,8241,3.6224175824175826,0.0,0.0
22275,2,2275,[  8 678 153 186 318],308,4,8245,3.6225834797891037,20.0,0.0
22276,2,2276,[ 71 289 181 216   7],378,5,8250,3.6231884057971016,0.0,0.0
22277,2,2277,[204 268 423 234  98],234,3,8253,3.622914837576822,0.0,20.0
22278,2,2278,[100  88 194 173 405],406,2,8255,3.6222027204914435,0.0,20.0
22279,2,2279,[483 302 127 100 313],232,3,8258,3.6219298245614033,20.0,40.0
22280,2,2280,[483 302 127 100 313],232,3,8261,3.621657167908812,20.0,40.0
22281,2,2281,[483 302 127 100 313],232,3,8264,3.621384750219106,20.0,40.0
22282,2,2282,[210  95  56 161 174],804,3,8267,3.621112571178274,0.0,20.0
22283,2,2283,[191  56 273 121 127],7,4,8271,3.621278458844133,0.0,20.0
22284,2,2284,[282 197 427 196 180],406,3,8274,3.6210065645514224,0.0,0.0
22285,2,2285,[483 302 127 100 313],232,3,8277,3.620734908136483,20.0,40.0
22286,2,2286,[234   1  89 211  56],488,4,8281,3.620900743331876,0.0,0.0
22287,2,2287,[215 515 132  64  88],234,3,8284,3.620629370629371,0.0,0.0
22288,2,2288,[483 302 127 100 603],666,5,8289,3.6212319790301444,40.0,40.0
22289,2,2289,[483 302 127 100 603],524,4,8293,3.621397379912664,40.0,40.0
22290,2,2290,[  1   7 322 483 300],234,1,8294,3.6202531645569622,20.0,0.0
22291,2,2291,[655 268 135 269  82],537,2,8296,3.619546247818499,0.0,0.0
22292,2,2292,[333 153 185  50 655],488,3,8299,3.619276057566507,0.0,20.0
22293,2,2293,[508  89 269 238  88],13,2,8301,3.618570183086312,0.0,0.0
22294,2,2294,[357 238 286 546 568],207,2,8303,3.617864923747277,20.0,0.0
22295,2,2295,[742 403  97 385 186],881,2,8305,3.6171602787456445,0.0,0.0
22296,2,2296,[ 50 135 237 161 111],749,2,8307,3.61645624727906,0.0,20.0
22297,2,2297,[179 302 471 301   4],537,2,8309,3.615752828546562,0.0,0.0
22298,2,2298,[174 100 301 175 194],650,4,8313,3.615919965202262,0.0,40.0
22299,2,2299,[202 191 237  28 403],64,5,8318,3.6165217391304347,0.0,0.0
22300,2,2300,[483 302 127 100 313],474,5,8323,3.617122990004346,20.0,40.0
22301,2,2301,[ 89 403 144  97 168],194,2,8325,3.616420503909644,0.0,0.0
22302,2,2302,[286 496 173  69   7],406,3,8328,3.61615284411637,0.0,0.0
22303,2,2303,[  1 200 118 265 385],343,1,8329,3.615017361111111,0.0,0.0
22304,2,2304,[288 200 403 385 742],374,4,8333,3.6151843817787417,0.0,0.0
22305,2,2305,[200 423 179 216  50],271,5,8338,3.6157849089332177,0.0,20.0
22306,2,2306,[175  11 597  79 210],653,3,8341,3.6155179887299522,0.0,0.0
22307,2,2307,[748 423 258 161 294],13,4,8345,3.615684575389948,0.0,0.0
22308,2,2308,[194 427 237 172 200],474,4,8349,3.615851017756605,0.0,0.0
22309,2,2309,[ 88 144 151 294  98],378,3,8352,3.6155844155844155,0.0,20.0
22310,2,2310,[546 182   8 294 435],158,3,8355,3.615318044136737,0.0,0.0
22311,2,2311,[ 64 210 483 357 403],308,4,8359,3.6154844290657437,40.0,0.0
22312,2,2312,[195  25 385  69 265],897,2,8361,3.614785992217899,0.0,0.0
22313,2,2313,[ 89  69 405 176 168],59,4,8365,3.61495246326707,0.0,0.0
22314,2,2314,[  8  95 175  50 405],406,4,8369,3.6151187904967603,0.0,20.0
22315,2,2315,[288 132 313 181 289],334,2,8371,3.6144214162348876,0.0,0.0
22316,2,2316,[172 405 385 194 655],194,2,8373,3.6137246439361244,0.0,0.0
22317,2,2317,[180  89 302   7 127],144,2,8375,3.613028472821398,0.0,20.0
22318,2,2318,[ 50 143 323 211 176],125,3,8378,3.6127641224665803,0.0,20.0
22319,2,2319,[118 286  11 216 423],59,4,8382,3.6129310344827585,0.0,0.0
22320,2,2320,[ 88 234 238  89 144],92,4,8386,3.6130978026712626,0.0,0.0
22321,2,2321,[265 185 238 195 748],313,4,8390,3.6132644272179157,0.0,0.0
22322,2,2322,[483 302 127 100 313],13,5,8395,3.613861386138614,20.0,40.0
22323,2,2323,[568 328 179  12 265],13,2,8397,3.6131669535283994,20.0,0.0
22324,2,2324,[333 471 742 322 151],26,0,8397,3.6116129032258066,0.0,0.0
22325,2,2325,[471 423 546 258 144],13,3,8400,3.6113499570077385,0.0,0.0
22326,2,2326,[185 100 275 121 318],271,3,8403,3.611087236785561,20.0,20.0
22327,2,2327,[483 302 127 100 313],474,5,8408,3.611683848797251,20.0,40.0
22328,2,2328,[161  50 273  64 403],308,3,8411,3.6114212108200943,0.0,20.0
22329,2,2329,[588 228 194 210 546],95,3,8414,3.611158798283262,0.0,0.0
22330,2,2330,[197 210 313 216 186],934,2,8416,3.6104676104676106,0.0,0.0
22331,2,2331,[132 471  64 237 222],42,5,8421,3.61106346483705,0.0,0.0
22332,2,2332,[483 302 127 100 313],90,5,8426,3.6116588084012,20.0,40.0
22333,2,2333,[  8 568 546 176 258],343,3,8429,3.6113967437874894,0.0,0.0
22334,2,2334,[483 302 127 100 313],329,5,8434,3.6119914346895077,20.0,40.0
22335,2,2335,[172 323   9 185 435],328,4,8438,3.6121575342465753,0.0,0.0
22336,2,2336,[294 313  82 111 257],378,3,8441,3.611895592640137,0.0,0.0
22337,2,2337,[483 302 127 100 313],328,5,8446,3.6124893071000854,20.0,40.0
22338,2,2338,[235  25  82 191  69],537,1,8447,3.6113723813595553,0.0,0.0
22339,2,2339,[161 215   8 185   4],13,4,8451,3.6115384615384616,0.0,0.0
22340,2,2340,[515 313 237 111 168],543,3,8454,3.6112772319521573,0.0,0.0
22341,2,2341,[483 302 127 100 313],537,5,8459,3.6118701964133217,20.0,40.0
22342,2,2342,[496   9 161 135 357],749,3,8462,3.6116090482287664,20.0,0.0
22343,2,2343,[597 215  64   9 186],378,3,8465,3.611348122866894,0.0,0.0
22344,2,2344,[237 257 144 168  70],934,5,8470,3.611940298507463,0.0,0.0
22345,2,2345,[603 172  97  95  71],848,5,8475,3.612531969309463,20.0,0.0
22346,2,2346,[483 302 127 100 313],328,5,8480,3.6131231359181935,20.0,40.0
22347,2,2347,[483 302 127 100 313],537,5,8485,3.6137137989778534,20.0,40.0
22348,2,2348,[483 302 127 100 313],328,5,8490,3.6143039591315453,20.0,40.0
22349,2,2349,[204 655 121 197 168],308,3,8493,3.6140425531914895,0.0,0.0
22350,2,2350,[222 197   8 318 276],455,3,8496,3.613781369629945,20.0,0.0
22351,2,2351,[483 302 127 100 313],328,5,8501,3.61437074829932,20.0,40.0
22352,2,2352,[ 79  88 294 176 265],650,2,8503,3.613684657883553,0.0,0.0
22353,2,2353,[483 302 127 100 313],328,5,8508,3.6142735768903993,20.0,40.0
22354,2,2354,[483 302 127 100 313],334,5,8513,3.6148619957537154,20.0,40.0
22355,2,2355,[ 56 132 125   7 202],406,3,8516,3.6146010186757214,0.0,0.0
22356,2,2356,[405  71 322 515  79],524,3,8519,3.614340263046245,0.0,0.0
22357,2,2357,[483 302 127 100 313],329,5,8524,3.6149279050042407,20.0,40.0
22358,2,2358,[ 25 127 276  98 435],271,3,8527,3.6146672318779145,0.0,40.0
22359,2,2359,[405 125  89 483 173],295,5,8532,3.6152542372881356,20.0,0.0
22360,2,2360,[ 25  50 568 179 222],378,3,8535,3.6149936467598476,0.0,20.0
22361,2,2361,[597 282 508 151 153],378,3,8538,3.614733276883997,0.0,0.0
22362,2,2362,[276 427 328 313  11],537,3,8541,3.6144731273804487,0.0,0.0
22363,2,2363,[ 25 172  56 180 603],59,5,8546,3.6150592216582065,20.0,0.0
22364,2,2364,[161 313  11  50 289],92,3,8549,3.614799154334038,0.0,20.0
22365,2,2365,[483 302 127 100 313],334,5,8554,3.6153846153846154,20.0,40.0
22366,2,2366,[245  70  11 282 210],334,2,8556,3.614702154626109,0.0,0.0
22367,2,2367,[748 216 289 151 275],474,1,8557,3.613597972972973,0.0,0.0
22368,2,2368,[483 302 127 100 313],474,5,8562,3.6141831996623046,20.0,40.0
22369,2,2369,[228  95 186  96 168],506,5,8567,3.6147679324894515,0.0,0.0
22370,2,2370,[175 405 313 483  82],934,3,8570,3.6145086461408686,20.0,0.0
22371,2,2371,[496  71  97 282   9],378,4,8574,3.6146711635750424,0.0,0.0
22372,2,2372,[153 191 405 238 210],92,4,8578,3.614833544037084,0.0,0.0
22373,2,2373,[  8  88  56 100  28],271,4,8582,3.6149957877000842,0.0,20.0
22374,2,2374,[289 200 496 187 333],334,3,8585,3.614736842105263,0.0,0.0
22375,2,2375,[181 288  22 286 172],648,4,8589,3.61489898989899,0.0,0.0
22376,2,2376,[483 302 127 100 313],90,5,8594,3.6154816996213714,20.0,40.0
22377,2,2377,[ 98  64 197 196 185],7,5,8599,3.6160639192598825,0.0,20.0
22378,2,2378,[ 56 143  69 333 496],653,3,8602,3.6158049600672553,0.0,0.0
22379,2,2379,[483 302 127 100 313],328,5,8607,3.6163865546218488,20.0,40.0
22380,2,2380,[483 302 127 100 313],90,5,8612,3.616967660646787,20.0,40.0
22381,2,2381,[483 302 127 100 313],334,5,8617,3.6175482787573467,20.0,40.0
22382,2,2382,[181  95  50 196 603],387,3,8620,3.6172891313470417,20.0,20.0
22383,2,2383,[  1 515 228 435 588],313,4,8624,3.61744966442953,0.0,0.0
22384,2,2384,[  7  50 405 132 228],60,5,8629,3.618029350104822,0.0,20.0
22385,2,2385,[179 172 289 318 173],194,3,8632,3.617770326906957,20.0,0.0
22386,2,2386,[483 302 127 100 313],232,3,8635,3.6175115207373274,20.0,40.0
22387,2,2387,[191 132 282 300 118],271,2,8637,3.6168341708542715,0.0,0.0
22388,2,2388,[423  12 186  79 182],271,4,8641,3.616994558392633,20.0,0.0
22389,2,2389,[655 135 179 180 357],774,2,8643,3.6163179916317993,20.0,0.0
22390,2,2390,[228 273  98 655  71],7,4,8647,3.616478460895023,0.0,20.0
22391,2,2391,[182 153 302  71 678],454,1,8648,3.6153846153846154,0.0,0.0
22392,2,2392,[302 235 121  79 127],13,3,8651,3.615127455077309,0.0,20.0
22393,2,2393,[483 302 127 100 313],328,5,8656,3.615705931495405,20.0,40.0
22394,2,2394,[483 302 127 100 313],537,5,8661,3.6162839248434238,20.0,40.0
22395,2,2395,[ 50 197 135 258 173],6,4,8665,3.6164440734557597,0.0,20.0
22396,2,2396,[204  70 333   7  28],13,2,8667,3.615769712140175,0.0,0.0
22397,2,2397,[483 302 127 100 313],334,5,8672,3.616346955796497,20.0,40.0
22398,2,2398,[427 181 121 385 132],533,5,8677,3.6169237182159235,0.0,0.0
22399,2,2399,[483 302 127 100 313],13,5,8682,3.6175,20.0,40.0
22400,2,2400,[483 302 127 100 313],474,5,8687,3.618075801749271,20.0,40.0
22401,2,2401,[483 302 127 100 313],329,5,8692,3.6186511240632804,20.0,40.0
22402,2,2402,[175 172 273 301 132],666,3,8695,3.6183936745734497,0.0,0.0
22403,2,2403,[ 56  15 357 185 288],488,4,8699,3.618552412645591,20.0,0.0
22404,2,2404,[197  56 215 742 288],804,3,8702,3.618295218295218,0.0,0.0
22405,2,2405,[405  96 603 216   9],13,2,8704,3.6176226101413134,20.0,0.0
22406,2,2406,[588 333  12   1   8],64,4,8708,3.617781470710428,20.0,0.0
22407,2,2407,[ 15 515 191  28 117],194,4,8712,3.617940199335548,0.0,0.0
22408,2,2408,[288 328 127 216  69],488,3,8715,3.6176836861768367,0.0,20.0
22409,2,2409,[483 302 127 100 313],232,3,8718,3.617427385892116,20.0,40.0
22410,2,2410,[111 475 286 427 210],334,3,8721,3.617171298216508,0.0,0.0
22411,2,2411,[483 302 127 100 313],537,5,8726,3.6177446102819237,20.0,40.0
22412,2,2412,[483 302 127 100 313],232,3,8729,3.6174886033982596,20.0,40.0
22413,2,2413,[423 202 222  69 483],311,5,8734,3.6180613090306544,20.0,0.0
22414,2,2414,[117  64 153  82 204],738,4,8738,3.6182194616977226,0.0,0.0
22415,2,2415,[153 216 172   1 515],815,4,8742,3.618377483443709,0.0,0.0
22416,2,2416,[496 182 194 183 318],537,3,8745,3.618121638394704,20.0,0.0
22417,2,2417,[483 302 127 100 427],745,3,8748,3.6178660049627793,20.0,40.0
22418,2,2418,[483 302 100 127 427],474,5,8753,3.618437370814386,20.0,40.0
22419,2,2419,[483 302 100 127 427],745,3,8756,3.618181818181818,20.0,40.0
22420,2,2420,[603 515 144 127  12],308,3,8759,3.6179264766625363,40.0,20.0
22421,2,2421,[483 302 100 127 427],745,3,8762,3.6176713459950456,20.0,40.0
22422,2,2422,[234 271 216 168 200],843,2,8764,3.6170037144036318,0.0,0.0
22423,2,2423,[195 179 269 187 210],650,2,8766,3.616336633663366,0.0,0.0
22424,2,2424,[175 496 151 288 194],650,3,8769,3.616082474226804,0.0,0.0
22425,2,2425,[483 302 100 127 427],666,5,8774,3.6166529266281944,20.0,40.0
22426,2,2426,[483 302 100 127 427],339,5,8779,3.6172229089410797,20.0,40.0
22427,2,2427,[216 318 323  22 286],537,1,8780,3.6161449752883033,20.0,0.0
22428,2,2428,[ 96  97 318 204 196],538,4,8784,3.616303005351997,20.0,0.0
22429,2,2429,[121 423 258   8 216],207,3,8787,3.6160493827160494,0.0,0.0
22430,2,2430,[483 302 100 127 427],334,5,8792,3.6166186754422047,20.0,40.0
22431,2,2431,[483 302 100 127 427],458,5,8797,3.6171875,20.0,40.0
22432,2,2432,[ 50 286  12 125 313],144,5,8802,3.6177558569667077,20.0,20.0
22433,2,2433,[483 302 100 127 427],458,5,8807,3.6183237469186524,20.0,40.0
22434,2,2434,[483 302 100 127 427],90,5,8812,3.6188911704312114,20.0,40.0
22435,2,2435,[483 302 100 127 427],666,5,8817,3.6194581280788176,20.0,40.0
22436,2,2436,[195 151 175 318 435],788,1,8818,3.6183832581042266,20.0,0.0
22437,2,2437,[483 302 100 127 427],474,5,8823,3.618949958982773,20.0,40.0
22438,2,2438,[282 118 161  79 483],328,3,8826,3.6186961869618695,20.0,0.0
22439,2,2439,[357  95  50 435 200],325,2,8828,3.6180327868852458,20.0,20.0
22440,2,2440,[276 483 168 322 194],234,2,8830,3.6173699303564115,20.0,0.0
22441,2,2441,[403 132  70 161  69],524,5,8835,3.617936117936118,0.0,0.0
22442,2,2442,[161  88 173 179 286],650,1,8836,3.6168645108473187,0.0,0.0
22443,2,2443,[143  89   9 183 161],749,3,8839,3.6166121112929623,0.0,0.0
22444,2,2444,[286 603 588  56  95],537,2,8841,3.6159509202453988,20.0,0.0
22445,2,2445,[195 265  95  89 204],387,3,8844,3.615699100572363,0.0,0.0
22446,2,2446,[237  79 100 235  50],313,3,8847,3.6154474867184305,0.0,40.0
22447,2,2447,[195 210 125  71  98],42,5,8852,3.616013071895425,0.0,20.0
22448,2,2448,[483 302 100 127 427],13,5,8857,3.616578195181707,20.0,40.0
22449,2,2449,[483 302 100 127 427],334,5,8862,3.617142857142857,20.0,40.0
22450,2,2450,[216 275 273 182  56],538,4,8866,3.617299061607507,0.0,0.0
22451,2,2451,[483 302 100 127 427],343,5,8871,3.617862969004894,20.0,40.0
22452,2,2452,[483 302 100 127 427],537,5,8876,3.6184264166326945,20.0,40.0
22453,2,2453,[483 302 100 127 427],666,5,8881,3.6189894050529747,20.0,40.0
22454,2,2454,[483 302 100 127 427],745,3,8884,3.618737270875764,20.0,40.0
22455,2,2455,[195 228 143 238  98],653,2,8886,3.6180781758957656,0.0,20.0
22456,2,2456,[483 302 100 127 427],537,5,8891,3.618640618640619,20.0,40.0
22457,2,2457,[483 302 100 127 427],328,4,8895,3.618795768917819,20.0,40.0
22458,2,2458,[185 117 181 234  96],643,3,8898,3.618544123627491,0.0,0.0
22459,2,2459,[483 302 100 127 427],666,5,8903,3.6191056910569106,20.0,40.0
22460,2,2460,[471 483 182 546  64],788,2,8905,3.6184477854530677,20.0,0.0
22461,2,2461,[180 222 603 151 300],843,0,8905,3.61697806661251,20.0,0.0
22462,2,2462,[235 200   8 323 282],378,3,8908,3.616727568006496,0.0,0.0
22463,2,2463,[483 302 100 127 427],13,5,8913,3.617288961038961,20.0,40.0
22464,2,2464,[161 191 216 742 211],207,5,8918,3.6178498985801215,0.0,0.0
22465,2,2465,[153 202  69  70 197],374,4,8922,3.6180048661800486,0.0,0.0
22466,2,2466,[483 302 100 127 427],13,5,8927,3.618565058775841,20.0,40.0
22467,2,2467,[ 89 202 111  98 121],899,5,8932,3.619124797406807,0.0,20.0
22468,2,2468,[191 237 183 117 186],537,2,8934,3.6184690157958688,0.0,0.0
22469,2,2469,[483 302 100 127 427],666,5,8939,3.6190283400809715,20.0,40.0
22470,2,2470,[483 302 100 127 427],537,5,8944,3.6195872116552,20.0,40.0
22471,2,2471,[238  98   9 151 200],59,5,8949,3.620145631067961,0.0,20.0
22472,2,2472,[237 568 135  98  97],95,3,8952,3.6198948645369997,0.0,20.0
22473,2,2473,[300 153 269 132  98],666,4,8956,3.620048504446241,0.0,20.0
22474,2,2474,[ 79 655 508 238 182],833,2,8958,3.6193939393939396,0.0,0.0
22475,2,2475,[222 257 238 117 269],378,2,8960,3.618739903069467,0.0,0.0
22476,2,2476,[174 204  98 427 258],334,5,8965,3.6192975373435607,0.0,40.0
22477,2,2477,[655 153 135 748 173],13,4,8969,3.619451170298628,0.0,0.0
22478,2,2478,[483 302 100 127 427],458,5,8974,3.6200080677692617,20.0,40.0
22479,2,2479,[180 216   8 196 403],378,4,8978,3.6201612903225806,0.0,0.0
22480,2,2480,[483 302 100 127 427],833,3,8981,3.6199113260781943,20.0,40.0
22481,2,2481,[483 302 100 127 427],339,5,8986,3.620467365028203,20.0,40.0
22482,2,2482,[483 302 100 127 427],664,5,8991,3.62102295610149,20.0,40.0
22483,2,2483,[176 196 475 183 258],334,4,8995,3.6211755233494363,0.0,0.0
22484,2,2484,[483 302 100 127 427],537,5,9000,3.6217303822937628,20.0,40.0
22485,2,2485,[173 471 568 323 302],454,2,9002,3.6210780370072406,0.0,0.0
22486,2,2486,[195 215 182 161   4],64,3,9005,3.6208283071974265,0.0,0.0
22487,2,2487,[179 405 194 302  50],13,3,9008,3.620578778135048,0.0,20.0
22488,2,2488,[172 180 118 204 211],59,5,9013,3.6211329851345924,0.0,0.0
22489,2,2489,[194 496 313  28 234],189,4,9017,3.621285140562249,0.0,0.0
22490,2,2490,[275 210  69 405 265],536,4,9021,3.6214371738257727,0.0,0.0
22491,2,2491,[403 471 168 235 483],648,5,9026,3.6219903691813804,20.0,0.0
22492,2,2492,[294 222 597 405  12],13,1,9027,3.6209386281588447,20.0,0.0
22493,2,2493,[483 302 100 127 427],833,3,9030,3.6206896551724137,20.0,40.0
22494,2,2494,[483 302 100 127 427],537,5,9035,3.62124248496994,20.0,40.0
22495,2,2495,[483 302 100 127 427],328,4,9039,3.621394230769231,20.0,40.0
22496,2,2496,[483 302 100 127  50],474,5,9044,3.6219463356027233,20.0,60.0
22497,2,2497,[483 302 100 127  50],232,4,9048,3.622097678142514,20.0,60.0
22498,2,2498,[483 302 100 127  50],360,5,9053,3.6226490596238494,20.0,60.0
22499,2,2499,[196 403 176  56 174],7,4,9057,3.6228,0.0,20.0
22500,2,2500,[483 302 100 127  50],343,5,9062,3.6233506597361056,20.0,60.0
22501,2,2501,[483 302 100 127  50],745,2,9064,3.6227018385291765,20.0,60.0
22502,2,2502,[195  50 313 202 161],378,3,9067,3.622453056332401,0.0,20.0
22503,2,2503,[483 302 100 127  50],666,4,9071,3.622603833865815,20.0,60.0
22504,2,2504,[405 222 151 181 286],82,2,9073,3.6219560878243513,0.0,0.0
22505,2,2505,[483 302 100 127 427],664,5,9078,3.6225059856344775,20.0,40.0
22506,2,2506,[483 302 100 127 427],343,5,9083,3.6230554447546868,20.0,40.0
22507,2,2507,[483 302 100 127 427],328,4,9087,3.623205741626794,20.0,40.0
22508,2,2508,[143 200 173 132  25],666,3,9090,3.6229573535273016,0.0,0.0
22509,2,2509,[483 302 100 127 313],207,4,9094,3.6231075697211157,20.0,40.0
22510,2,2510,[153 172 197  95 405],13,4,9098,3.623257666268419,0.0,0.0
22511,2,2511,[385  88 186 187 180],326,1,9099,3.6222133757961785,0.0,0.0
22512,2,2512,[210 125 483 143 187],298,4,9103,3.622363708714684,20.0,0.0
22513,2,2513,[204 273 194 144 275],308,3,9106,3.62211614956245,0.0,0.0
22514,2,2514,[127 118 172 357 202],833,3,9109,3.621868787276342,20.0,20.0
22515,2,2515,[333 427 288 100 318],13,2,9111,3.6212241653418125,20.0,20.0
22516,2,2516,[483 302 100 127 313],537,5,9116,3.621771950735002,20.0,40.0
22517,2,2517,[237 748 385 182  71],474,4,9120,3.6219221604447975,0.0,0.0
22518,2,2518,[483 302 100 127 313],329,5,9125,3.6224692338229456,20.0,40.0
22519,2,2519,[483 302 100 127 313],329,5,9130,3.623015873015873,20.0,40.0
22520,2,2520,[ 95 238 144 125 301],378,2,9132,3.622372074573582,0.0,0.0
22521,2,2521,[ 96 172 742 318  15],200,5,9137,3.6229183187946075,20.0,0.0
22522,2,2522,[  7 235 153 403  56],343,5,9142,3.6234641300039634,0.0,0.0
22523,2,2523,[194 210 269 183 300],537,0,9142,3.62202852614897,0.0,0.0
22524,2,2524,[182  25 403 238 196],87,3,9145,3.621782178217822,0.0,0.0
22525,2,2525,[ 97  79  96 568 216],210,5,9150,3.6223277909738716,0.0,0.0
22526,2,2526,[742 496 282 427 301],458,2,9152,3.6216857934309457,0.0,0.0
22527,2,2527,[ 56 173 185 269  69],64,5,9157,3.622231012658228,0.0,0.0
22528,2,2528,[742  88  12  96  64],454,3,9160,3.6219849742981416,20.0,0.0
22529,2,2529,[143 234 195 179  82],7,3,9163,3.621739130434783,0.0,0.0
22530,2,2530,[121   8 143 100 161],308,3,9166,3.621493480837614,0.0,20.0
22531,2,2531,[483 302 100 127 313],334,5,9171,3.6220379146919433,20.0,40.0
22532,2,2532,[ 28 222 546  25  56],648,3,9174,3.621792341097513,0.0,0.0
22533,2,2533,[172 405 135  25 175],42,3,9177,3.6215469613259668,0.0,0.0
22534,2,2534,[135 655 228 300 173],234,1,9178,3.6205128205128205,0.0,0.0
22535,2,2535,[288 216  71 174  11],234,0,9178,3.619085173501577,0.0,20.0
22536,2,2536,[322  22 435 135 161],13,4,9182,3.6192353173039025,0.0,0.0
22537,2,2537,[118 603  28 191 211],454,4,9186,3.619385342789598,20.0,0.0
22538,2,2538,[200 302 403 515 215],328,3,9189,3.619141394249705,0.0,0.0
22539,2,2539,[483 302 100 127 313],207,4,9193,3.619291338582677,20.0,40.0
22540,2,2540,[191 204 179 197 496],406,5,9198,3.6198347107438016,0.0,0.0
22541,2,2541,[483 302 100 127 313],329,5,9203,3.6203776553894573,20.0,40.0
22542,2,2542,[  1 603 385   4 288],64,3,9206,3.6201337003539127,20.0,0.0
22543,2,2543,[204 191 144 265 385],455,3,9209,3.6198899371069184,0.0,0.0
22544,2,2544,[ 79 238 135 588 435],308,5,9214,3.6204322200392927,0.0,0.0
22545,2,2545,[265 118  25 435 121],59,5,9219,3.6209740769835035,0.0,0.0
22546,2,2546,[483 302 100 127 313],207,4,9223,3.6211228896741265,20.0,40.0
22547,2,2547,[546  97 127 153 168],374,4,9227,3.6212715855572997,0.0,20.0
22548,2,2548,[196  64 322 427  25],537,1,9228,3.620243232640251,0.0,0.0
22549,2,2549,[195 144 234 288  88],378,3,9231,3.62,0.0,0.0
22550,2,2550,[ 71 210 211 215 186],85,3,9234,3.6197569580556643,0.0,0.0
22551,2,2551,[483 302 100 127 313],537,5,9239,3.6202978056426334,20.0,40.0
22552,2,2552,[  9 237 546 222 143],64,4,9243,3.6204465334900116,0.0,0.0
22553,2,2553,[118  15 179 273 176],308,2,9245,3.619812059514487,0.0,0.0
22554,2,2554,[ 28 191 132 215  95],378,5,9250,3.620352250489237,0.0,0.0
22555,2,2555,[ 50 234 423  98 204],200,5,9255,3.6208920187793425,0.0,40.0
22556,2,2556,[151  82  95   4 271],738,4,9259,3.6210402815799765,0.0,0.0
22557,2,2557,[185  89  28 357 318],694,5,9264,3.6215793588741203,40.0,0.0
22558,2,2558,[211 655   7 568 182],774,1,9265,3.6205549042594765,0.0,0.0
22559,2,2559,[ 70 268 328 546 423],234,1,9266,3.61953125,0.0,0.0
22560,2,2560,[483 302 100 127 313],232,3,9269,3.6192893401015227,20.0,40.0
22561,2,2561,[546 333  11  64  82],13,1,9270,3.6182669789227164,0.0,0.0
22562,2,2562,[  7 182 132 121  56],653,2,9272,3.617635583300819,0.0,0.0
22563,2,2563,[ 79 483 194 173 215],840,4,9276,3.6177847113884556,20.0,0.0
22564,2,2564,[ 71   1  56 597 300],455,3,9279,3.617543859649123,0.0,0.0
22565,2,2565,[176 196 135 742 603],650,4,9283,3.617692907248636,20.0,0.0
22566,2,2566,[197 182 202 204 194],378,3,9286,3.617452278924815,0.0,0.0
22567,2,2567,[275 151  15 161 181],308,3,9289,3.6172118380062304,0.0,0.0
22568,2,2568,[483 302 100 127 427],6,5,9294,3.61775009731413,20.0,40.0
22569,2,2569,[483 302 100 127 427],474,5,9299,3.6182879377431907,20.0,40.0
22570,2,2570,[483 302 100 127 427],666,5,9304,3.618825359782186,20.0,40.0
22571,2,2571,[483 302 100 127 427],458,5,9309,3.6193623639191292,20.0,40.0
22572,2,2572,[202   4  96 234 187],881,2,9311,3.6187329965021378,0.0,0.0
22573,2,2573,[588 405  98 153 204],95,3,9314,3.6184926184926183,0.0,20.0
22574,2,2574,[678 181 385  82 202],881,4,9318,3.618640776699029,0.0,0.0
22575,2,2575,[483 302 100 127 427],474,5,9323,3.6191770186335406,20.0,40.0
22576,2,2576,[  1  71  88 173  25],279,2,9325,3.618548700038805,0.0,0.0
22577,2,2577,[483 302 100 127 427],343,5,9330,3.6190845616757175,20.0,40.0
22578,2,2578,[423 288 257 483  28],533,4,9334,3.6192322605661107,20.0,0.0
22579,2,2579,[483 302 100 127 427],334,5,9339,3.619767441860465,20.0,40.0
22580,2,2580,[127 151  70 483   8],82,3,9342,3.6195273149941882,20.0,20.0
22581,2,2581,[276 265 237 222 183],82,2,9344,3.618900077459334,0.0,0.0
22582,2,2582,[483 302 100 127 427],458,5,9349,3.619434765776229,20.0,40.0
22583,2,2583,[172 211 435 288  69],666,2,9351,3.6188080495356036,0.0,0.0
22584,2,2584,[228  25 186 273 197],7,3,9354,3.618568665377176,0.0,0.0
22585,2,2585,[742 117  22 176 333],346,5,9359,3.6191028615622582,0.0,0.0
22586,2,2586,[483 302 100 127 427],6,5,9364,3.6196366447622728,20.0,40.0
22587,2,2587,[483 302 100 127 427],666,5,9369,3.6201700154559506,20.0,40.0
22588,2,2588,[215 273 294 276 172],378,4,9373,3.6203167246040944,0.0,0.0
22589,2,2589,[483 302 100 127 427],6,5,9378,3.620849420849421,20.0,40.0
22590,2,2590,[294  69  71 405   7],82,3,9381,3.6206098031648013,0.0,0.0
22591,2,2591,[483 302 100 127 427],458,5,9386,3.621141975308642,20.0,40.0
22592,2,2592,[483 302 100 127 427],458,5,9391,3.6216737369841883,20.0,40.0
22593,2,2593,[483 302 100 127 427],334,5,9396,3.6222050886661528,20.0,40.0
22594,2,2594,[195  70  22 168 121],892,5,9401,3.6227360308285164,0.0,0.0
22595,2,2595,[173 238  64  70 597],207,1,9402,3.6217257318952236,0.0,0.0
22596,2,2596,[ 69 186 237 180 742],59,3,9405,3.621486330381209,0.0,0.0
22597,2,2597,[423 245 202 237 238],653,1,9406,3.6204772902232487,0.0,0.0
22598,2,2598,[195 471 427 234  98],374,3,9409,3.620238553289727,0.0,20.0
22599,2,2599,[483 302 100 127 427],745,3,9412,3.62,20.0,40.0
22600,2,2600,[483 302 100 127 427],339,5,9417,3.6205305651672433,20.0,40.0
22601,2,2601,[483 302 100 127 427],664,5,9422,3.6210607225211375,20.0,40.0
22602,2,2602,[ 82 318 187 118 176],7,2,9424,3.6204379562043796,20.0,0.0
22603,2,2603,[483 302 100 127 427],343,5,9429,3.620967741935484,20.0,40.0
22604,2,2604,[210  70 185 117  79],308,4,9433,3.621113243761996,0.0,0.0
22605,2,2605,[135 180 200 194 265],13,4,9437,3.621258633921719,0.0,0.0
22606,2,2606,[258 200 183   8 289],334,4,9441,3.621403912543153,0.0,0.0
22607,2,2607,[197 175 405 603 181],60,5,9446,3.621932515337423,20.0,0.0
22608,2,2608,[483 302 100 127 427],339,5,9451,3.6224607129168263,20.0,40.0
22609,2,2609,[483 302 100 127 427],328,4,9455,3.6226053639846745,20.0,40.0
22610,2,2610,[215 185 322 153 187],804,5,9460,3.6231328992723095,0.0,0.0
22611,2,2611,[483 302 100 127 427],458,5,9465,3.6236600306278715,20.0,40.0
22612,2,2612,[301 172  88   7  25],13,2,9467,3.623038652889399,0.0,0.0
22613,2,2613,[483 302 100 127 427],13,5,9472,3.6235654169854628,20.0,40.0
22614,2,2614,[483 302 100 127 427],537,5,9477,3.624091778202677,20.0,40.0
22615,2,2615,[228 748 300 423 302],13,4,9481,3.6242354740061162,0.0,0.0
22616,2,2616,[143  79 180  22  96],7,4,9485,3.6243790599923575,0.0,0.0
22617,2,2617,[483 302 100 127 427],666,5,9490,3.6249045072574484,20.0,40.0
22618,2,2618,[ 69   9  98 282 117],194,3,9493,3.6246659030164183,0.0,20.0
22619,2,2619,[483 302 100 127 427],458,5,9498,3.6251908396946564,20.0,40.0
22620,2,2620,[271 172 186 403 153],102,1,9499,3.624189240747806,0.0,0.0
22621,2,2621,[483 302 100 127 427],339,5,9504,3.6247139588100685,20.0,40.0
22622,2,2622,[202 143 132 237 195],313,3,9507,3.6244757910789174,0.0,0.0
22623,2,2623,[ 71 238  98 216 568],650,3,9510,3.6242378048780486,0.0,20.0
22624,2,2624,[301 271  98   7  82],13,1,9511,3.6232380952380954,0.0,20.0
22625,2,2625,[268 187  56 121 258],537,4,9515,3.6233815689261233,0.0,0.0
22626,2,2626,[483 302 100 127 427],6,5,9520,3.6239055957365816,20.0,40.0
22627,2,2627,[748 568   4  56 742],881,2,9522,3.6232876712328768,0.0,0.0
22628,2,2628,[ 56 174 405 173 588],200,4,9526,3.6234309623430963,0.0,20.0
22629,2,2629,[ 11 258 289  50 127],271,4,9530,3.623574144486692,0.0,40.0
22630,2,2630,[483 302 100 127 427],458,5,9535,3.6240973014063096,20.0,40.0
22631,2,2631,[483 302 100 127 427],6,5,9540,3.6246200607902734,20.0,40.0
22632,2,2632,[ 71  28  56 210 196],387,3,9543,3.624382833270034,0.0,0.0
22633,2,2633,[204 323 234 603 176],648,5,9548,3.6249050873196658,20.0,0.0
22634,2,2634,[471  12 258 176  56],213,4,9552,3.6250474383301707,20.0,0.0
22635,2,2635,[181 275  69   4 318],554,4,9556,3.625189681335357,20.0,0.0
22636,2,2636,[483 302 100 127 427],474,5,9561,3.6257110352673494,20.0,40.0
22637,2,2637,[483 302 100 127 427],666,5,9566,3.626231993934799,20.0,40.0
22638,2,2638,[ 96 174 191 313 258],90,4,9570,3.6263736263736264,0.0,20.0
22639,2,2639,[483 302 100 127 427],537,5,9575,3.6268939393939394,20.0,40.0
22640,2,2640,[483 302 100 127 427],90,5,9580,3.6274138583869746,20.0,40.0
22641,2,2641,[269 238 234   9 176],13,1,9581,3.6264193792581376,0.0,0.0
22642,2,2642,[483 302 100 127 427],334,5,9586,3.626939084373818,20.0,40.0
22643,2,2643,[483 302 100 127 427],537,5,9591,3.627458396369138,20.0,40.0
22644,2,2644,[204 216 174 210  96],650,4,9595,3.627599243856333,0.0,20.0
22645,2,2645,[483 302 100 127 427],343,5,9600,3.6281179138321997,20.0,40.0
22646,2,2646,[161 357 196 194  56],311,5,9605,3.628636191915376,20.0,0.0
22647,2,2647,[245 200 179 182   1],653,4,9609,3.6287764350453173,0.0,0.0
22648,2,2648,[483 403 265 515 357],804,4,9613,3.628916572291431,40.0,0.0
22649,2,2649,[483 302 100 127 427],13,5,9618,3.629433962264151,20.0,40.0
22650,2,2650,[258  82 183 196 288],666,2,9620,3.6288193134666162,0.0,0.0
22651,2,2651,[ 97 195 100  98 385],881,4,9624,3.6289592760180995,0.0,40.0
22652,2,2652,[483 302 100 127 427],334,5,9629,3.6294760648322653,20.0,40.0
22653,2,2653,[483 302 100 127 427],745,3,9632,3.6292388847023362,20.0,40.0
22654,2,2654,[483 302 100 127 427],664,5,9637,3.6297551789077214,20.0,40.0
22655,2,2655,[234 200 204 216  88],848,4,9641,3.629894578313253,0.0,0.0
22656,2,2656,[483 302 100 127 427],13,5,9646,3.630410237109522,20.0,40.0
22657,2,2657,[  7 100 276 294 405],554,1,9647,3.629420617005267,0.0,20.0
22658,2,2658,[  8  69 168 588 294],95,3,9650,3.629183903723204,0.0,0.0
22659,2,2659,[ 79 289 655  98 275],13,2,9652,3.6285714285714286,0.0,20.0
22660,2,2660,[483 302 100 127 427],328,4,9656,3.6287110108981584,20.0,40.0
22661,2,2661,[483 302 100 127 427],328,4,9660,3.6288504883546207,20.0,40.0
22662,2,2662,[403 286 300 125  28],788,3,9663,3.6286143447239954,0.0,0.0
22663,2,2663,[483 302 100 127 427],458,5,9668,3.629129129129129,20.0,40.0
22664,2,2664,[181 508 176 132 289],334,1,9669,3.628142589118199,0.0,0.0
22665,2,2665,[333  11  98 195 143],64,4,9673,3.6282820705176295,0.0,20.0
22666,2,2666,[323 508 180 427 483],474,3,9676,3.6280464941882267,20.0,0.0
22667,2,2667,[216 286  69 265 234],533,3,9679,3.6278110944527735,0.0,0.0
22668,2,2668,[483 302 100 127 427],833,3,9682,3.6275758711127764,20.0,40.0
22669,2,2669,[403 385 289   7  89],524,3,9685,3.6273408239700373,0.0,0.0
22670,2,2670,[187 151 196  88 237],474,4,9689,3.6274803444402846,0.0,0.0
22671,2,2671,[144 173 210 185 176],749,5,9694,3.627994011976048,0.0,0.0
22672,2,2672,[ 50 179 215  15 328],537,2,9696,3.627384960718294,0.0,20.0
22673,2,2673,[121   4 187 276 117],881,4,9700,3.6275243081525805,0.0,0.0
22674,2,2674,[  7 237 276 135 174],92,5,9705,3.62803738317757,0.0,20.0
22675,2,2675,[282 151 185  71 655],42,4,9709,3.6281763826606874,0.0,0.0
22676,2,2676,[ 50 191 100 289 181],387,4,9713,3.6283152782966006,0.0,40.0
22677,2,2677,[127 174 288 135  22],387,4,9717,3.6284540702016432,0.0,40.0
22678,2,2678,[483 302 100 127 427],745,3,9720,3.6282194848824187,20.0,40.0
22679,2,2679,[125 185 121 182 127],194,2,9722,3.6276119402985074,0.0,20.0
22680,2,2680,[ 22  97 172  95 196],308,3,9725,3.6273778440880267,0.0,0.0
22681,2,2681,[235  98 405 294 195],13,1,9726,3.626398210290828,0.0,20.0
22682,2,2682,[ 28 603 385 588 405],64,3,9729,3.62616474096161,20.0,0.0
22683,2,2683,[483 302 100 127 427],474,5,9734,3.6266766020864383,20.0,40.0
22684,2,2684,[483 302 100 127 427],13,5,9739,3.6271880819366853,20.0,40.0
22685,2,2685,[483 302 100 127 427],458,5,9744,3.627699180938198,20.0,40.0
22686,2,2686,[748 603 168 245 180],533,2,9746,3.6270934127279495,20.0,0.0
22687,2,2687,[ 71 125  69   1 273],92,5,9751,3.6276041666666665,0.0,0.0
22688,2,2688,[300 175  15 144  98],313,4,9755,3.627742655262179,0.0,20.0
22689,2,2689,[185 197  82  15   1],454,2,9757,3.6271375464684015,0.0,0.0
22690,2,2690,[318 357 282 100  64],605,5,9762,3.6276477146042363,40.0,20.0
22691,2,2691,[174 204 258 238 357],650,4,9766,3.62778603268945,20.0,20.0
22692,2,2692,[483 302 100 127 427],537,5,9771,3.628295581136279,20.0,40.0
22693,2,2693,[475 211 273  15 127],699,1,9772,3.62731997030438,0.0,20.0
22694,2,2694,[483 302 100 127 427],334,5,9777,3.6278293135435993,20.0,40.0
22695,2,2695,[172 273 216 196 265],892,5,9782,3.628338278931751,0.0,0.0
22696,2,2696,[483 302 100 127 427],6,5,9787,3.6288468668891363,20.0,40.0
22697,2,2697,[483 302 100 127 427],6,5,9792,3.6293550778354335,20.0,40.0
22698,2,2698,[161 288  25 508 197],533,4,9796,3.629492404594294,0.0,0.0
22699,2,2699,[257 127 748 237 471],486,3,9799,3.629259259259259,0.0,20.0
22700,2,2700,[118 181  11 127 210],749,4,9803,3.6293965198074787,0.0,20.0
22701,2,2701,[186 403 318 121 176],378,4,9807,3.6295336787564767,20.0,0.0
22702,2,2702,[483 302 100 127 427],13,5,9812,3.6300406955234923,20.0,40.0
22703,2,2703,[180 172 678 228 235],13,3,9815,3.6298076923076925,0.0,0.0
22704,2,2704,[215 174 211 435 100],804,4,9819,3.629944547134935,0.0,40.0
22705,2,2705,[483 302 100 127 427],6,5,9824,3.630450849963045,20.0,40.0
22706,2,2706,[483 302 100 127 427],13,5,9829,3.630956778721832,20.0,40.0
22707,2,2707,[483 302 100 127 427],343,5,9834,3.6314623338257017,20.0,40.0
22708,2,2708,[483 302 100 127 427],537,5,9839,3.631967515688446,20.0,40.0
22709,2,2709,[100 191 222 568 515],313,4,9843,3.6321033210332105,0.0,20.0
22710,2,2710,[483 302 100 127 427],343,5,9848,3.632607893766138,20.0,40.0
22711,2,2711,[483 302 100 127 427],90,5,9853,3.63311209439528,20.0,40.0
22712,2,2712,[483 302 100 127 427],6,5,9858,3.633615923332105,20.0,40.0
22713,2,2713,[183 269 265 258   7],13,3,9861,3.633382461311717,0.0,0.0
22714,2,2714,[153  56  11 508 568],92,4,9865,3.6335174953959486,0.0,0.0
22715,2,2715,[125  11 258 100   7],92,5,9870,3.634020618556701,0.0,20.0
22716,2,2716,[173 276 175 185   4],194,3,9873,3.633787265366213,0.0,0.0
22717,2,2717,[196 215  82 175 423],343,5,9878,3.634289919058131,0.0,0.0
22718,2,2718,[276  25 127  89 322],537,3,9881,3.634056638470026,0.0,20.0
22719,2,2719,[216 194  70  12 238],474,5,9886,3.634558823529412,20.0,0.0
22720,2,2720,[483 302 100 127 427],474,5,9891,3.6350606394707827,20.0,40.0
22721,2,2721,[483 302 100 127 427],6,5,9896,3.635562086700955,20.0,40.0
22722,2,2722,[496 271 144 265 176],479,3,9899,3.6353286816011754,0.0,0.0
22723,2,2723,[483 302 100 127 427],90,5,9904,3.63582966226138,20.0,40.0
22724,2,2724,[588 289 183 568 172],881,3,9907,3.6355963302752294,0.0,0.0
22725,2,2725,[237 215  69 202 301],234,1,9908,3.6346294937637564,0.0,0.0
22726,2,2726,[483 302 100 127 427],745,3,9911,3.6343967730106344,20.0,40.0
22727,2,2727,[196  70 211  98 181],59,4,9915,3.6345307917888565,0.0,20.0
22728,2,2728,[318  88 237   1 222],42,5,9920,3.635031146940271,20.0,0.0
22729,2,2729,[282 286 322   4 151],881,2,9922,3.6344322344322344,0.0,0.0
22730,2,2730,[655 100   8 153 183],313,3,9925,3.634199926766752,0.0,20.0
22731,2,2731,[483 302 100 127 427],90,5,9930,3.6346998535871156,20.0,40.0
22732,2,2732,[483 302 100 127 427],664,5,9935,3.6351994145627518,20.0,40.0
22733,2,2733,[  8 100   4   1 403],379,5,9940,3.6356986100950985,0.0,20.0
22734,2,2734,[211 405 180  79 132],524,4,9944,3.635831809872029,0.0,0.0
22735,2,2735,[483 302 100 127 427],90,5,9949,3.636330409356725,20.0,40.0
22736,2,2736,[ 70 196  88 210 435],87,5,9954,3.636828644501279,0.0,0.0
22737,2,2737,[483 302 100 127 427],339,5,9959,3.637326515704894,20.0,40.0
22738,2,2738,[269 168 423 471 215],271,3,9962,3.6370938298649143,0.0,0.0
22739,2,2739,[121 210  97  11 168],295,5,9967,3.6375912408759126,0.0,0.0
22740,2,2740,[121 423 234 427 333],537,1,9968,3.6366289675300987,0.0,0.0
22741,2,2741,[182  64 187 435 588],406,4,9972,3.636761487964989,0.0,0.0
22742,2,2742,[ 97 197 161 385  25],7,3,9975,3.6365293474298213,0.0,0.0
22743,2,2743,[174  71   4 204  89],650,3,9978,3.6362973760932946,0.0,20.0
22744,2,2744,[483 302 100 127 427],334,5,9983,3.6367941712204006,20.0,40.0
22745,2,2745,[483 302 100 127 427],13,5,9988,3.637290604515659,20.0,40.0
22746,2,2746,[322  97 118 323 546],83,3,9991,3.637058609392064,0.0,0.0
22747,2,2747,[ 82 237 153  70 597],328,3,9994,3.6368267831149925,0.0,0.0
22748,2,2748,[423 228 181  11 191],64,5,9999,3.6373226627864677,0.0,0.0
22749,2,2749,[202  25  96 328 127],207,2,10001,3.636727272727273,0.0,20.0
22750,2,2750,[483 302 100 127 427],6,5,10006,3.6372228280625225,20.0,40.0
22751,2,2751,[  9 238 216  50 475],474,5,10011,3.637718023255814,0.0,20.0
22752,2,2752,[143 568  95 175 276],892,4,10015,3.637849618597893,0.0,0.0
22753,2,2753,[202  96 194 144 127],398,4,10019,3.637981118373275,0.0,20.0
22754,2,2754,[238 176 151 127 179],406,3,10022,3.6377495462794918,0.0,20.0
22755,2,2755,[483 302 100 127 427],334,5,10027,3.6382438316400583,20.0,40.0
22756,2,2756,[ 79  96 300 211 187],90,4,10031,3.638375045339137,0.0,0.0
22757,2,2757,[187 302 204 175 515],833,2,10033,3.637781000725163,0.0,0.0
22758,2,2758,[483 302 100 127 427],474,5,10038,3.638274737223632,20.0,40.0
22759,2,2759,[ 64 655 100 328  22],207,2,10040,3.63768115942029,0.0,20.0
22760,2,2760,[483 302 100 127 427],474,5,10045,3.6381745744295544,20.0,40.0
22761,2,2761,[496 151 423 176 175],653,0,10045,3.6368573497465606,0.0,0.0
22762,2,2762,[183 180  15 132 174],378,4,10049,3.6369887803112557,0.0,20.0
22763,2,2763,[483 302 100 127 427],833,3,10052,3.6367583212735166,20.0,40.0
22764,2,2764,[483 302 100 127 427],334,5,10057,3.637251356238698,20.0,40.0
22765,2,2765,[483 302 100 127 427],6,5,10062,3.6377440347071586,20.0,40.0
22766,2,2766,[ 96  12  64 168 405],59,4,10066,3.63787495482472,20.0,0.0
22767,2,2767,[234 117 568   7  89],648,3,10069,3.6376445086705202,0.0,0.0
22768,2,2768,[143 151  25 471 216],882,4,10073,3.637775370169736,0.0,0.0
22769,2,2769,[168  11 742 181 748],92,3,10076,3.637545126353791,0.0,0.0
22770,2,2770,[483 302 100 127 427],13,5,10081,3.638036809815951,20.0,40.0
22771,2,2771,[144 172 174 135  70],840,2,10083,3.6374458874458875,0.0,20.0
22772,2,2772,[ 56 496 273 100 597],7,3,10086,3.6372160115398486,0.0,20.0
22773,2,2773,[265  50  25 322 323],13,2,10088,3.6366258111031002,0.0,20.0
22774,2,2774,[143 385 176 222 357],749,3,10091,3.6363963963963966,20.0,0.0
22775,2,2775,[483 302 100 127 427],90,5,10096,3.636887608069164,20.0,40.0
22776,2,2776,[180 172 288 161 132],378,3,10099,3.6366582643140077,0.0,0.0
22777,2,2777,[483 302 100 127 427],664,5,10104,3.637149028077754,20.0,40.0
22778,2,2778,[ 28 200 121 174 111],374,4,10108,3.63727959697733,0.0,20.0
22779,2,2779,[ 15 237  64 182 174],474,5,10113,3.637769784172662,0.0,20.0
22780,2,2780,[483 302 100 127 427],745,3,10116,3.6375404530744335,20.0,40.0
22781,2,2781,[143 568   4 289 237],533,2,10118,3.6369518332135153,0.0,0.0
22782,2,2782,[ 28  22 127  11 174],833,2,10120,3.6363636363636362,0.0,40.0
22783,2,2783,[ 69 318  96  79  82],64,4,10124,3.6364942528735633,20.0,0.0
22784,2,2784,[483 302 100 127 427],745,3,10127,3.636265709156194,20.0,40.0
22785,2,2785,[222  82 322  28 118],881,5,10132,3.6367552045944005,0.0,0.0
22786,2,2786,[655 181 175 435 222],13,4,10136,3.6368855400071762,0.0,0.0
22787,2,2787,[483 302 100 127 427],745,3,10139,3.6366571018651364,20.0,40.0
22788,2,2788,[ 69 135 211 222   1],533,4,10143,3.6367873789888847,0.0,0.0
22789,2,2789,[302 483 100 127 427],664,5,10148,3.6372759856630825,20.0,40.0
22790,2,2790,[302 483 100 127 427],343,5,10153,3.637764242207094,20.0,40.0
22791,2,2791,[172 427 210 191 238],848,5,10158,3.6382521489971347,0.0,0.0
22792,2,2792,[483 204 234 286  25],650,3,10161,3.6380236305048337,20.0,0.0
22793,2,2793,[385 182  70 127 275],537,4,10165,3.6381531853972797,0.0,20.0
22794,2,2794,[ 25  89 204 294 187],749,3,10168,3.6379248658318426,0.0,0.0
22795,2,2795,[289 328 268 117  89],537,2,10170,3.6373390557939915,0.0,0.0
22796,2,2796,[302 483 100 127 427],90,5,10175,3.637826242402574,20.0,40.0
22797,2,2797,[186 144 403 301 153],13,3,10178,3.6375982844889205,0.0,0.0
22798,2,2798,[302 483 100 127 427],537,5,10183,3.6380850303679884,20.0,40.0
22799,2,2799,[302 483 100 127 427],745,3,10186,3.637857142857143,20.0,40.0
22800,2,2800,[302 483 100 127 427],833,3,10189,3.637629418064977,20.0,40.0
22801,2,2801,[742 546 265 216  56],145,4,10193,3.637758743754461,0.0,0.0
22802,2,2802,[ 89 210 423 475  12],92,4,10197,3.637887977167321,20.0,0.0
22803,2,2803,[328 185 483 235  11],334,3,10200,3.637660485021398,20.0,0.0
22804,2,2804,[302 483 100 127 427],6,5,10205,3.6381461675579323,20.0,40.0
22805,2,2805,[302 483 100 127 427],474,5,10210,3.638631503920171,20.0,40.0
22806,2,2806,[357 471 151 268   8],7,4,10214,3.638760242251514,20.0,0.0
22807,2,2807,[191  79 183 172 483],184,4,10218,3.638888888888889,20.0,0.0
22808,2,2808,[237 161 323 182  97],328,2,10220,3.638305446778213,0.0,0.0
22809,2,2809,[318 483 435 276 181],59,5,10225,3.6387900355871885,40.0,0.0
22810,2,2810,[ 69 181  11 182 742],145,5,10230,3.6392742796157953,0.0,0.0
22811,2,2811,[ 79 197  97 276  56],378,4,10234,3.639402560455192,0.0,0.0
22812,2,2812,[172 245 423 204 237],749,4,10238,3.639530750088873,0.0,0.0
22813,2,2813,[135 265 173  96 172],311,5,10243,3.6400142146410803,0.0,0.0
22814,2,2814,[172  95 313 435 200],308,4,10247,3.6401420959147424,0.0,0.0
22815,2,2815,[22 64 71 79 56],92,4,10251,3.6402698863636362,0.0,0.0
22816,2,2816,[302 483 100 127 427],343,5,10256,3.6407525736599218,20.0,40.0
22817,2,2817,[179 597 265 742 216],378,3,10259,3.640525195173882,0.0,0.0
22818,2,2818,[302 483 100 127 427],458,5,10264,3.6410074494501594,20.0,40.0
22819,2,2819,[302 483 100 127 427],6,5,10269,3.641489361702128,20.0,40.0
22820,2,2820,[302 483 100 127 427],833,3,10272,3.641261963842609,20.0,40.0
22821,2,2821,[483 302 100 127 427],339,5,10277,3.641743444365698,20.0,40.0
22822,2,2822,[ 71 175 328  95 181],334,2,10279,3.641161884520014,0.0,0.0
22823,2,2823,[483 302 100 127 427],90,5,10284,3.641643059490085,20.0,40.0
22824,2,2824,[483 302 100 127 427],833,3,10287,3.6414159292035397,20.0,40.0
22825,2,2825,[483 302 100 127 427],6,5,10292,3.6418966737438074,20.0,40.0
22826,2,2826,[655  15 282 403  64],311,5,10297,3.6423770781747438,0.0,0.0
22827,2,2827,[742 258 210 515  69],387,3,10300,3.6421499292786423,0.0,0.0
22828,2,2828,[273 282 234  70 121],374,4,10304,3.6422764227642275,0.0,0.0
22829,2,2829,[151 215  71 211 275],648,2,10306,3.641696113074205,0.0,0.0
22830,2,2830,[185 151 127 121 403],374,3,10309,3.6414694454256447,0.0,20.0
22831,2,2831,[ 79   4 742 172 678],554,2,10311,3.6408898305084745,0.0,0.0
22832,2,2832,[483 302 100 127 427],328,4,10315,3.641016590187081,20.0,40.0
22833,2,2833,[483 302 100 127 427],339,5,10320,3.641496118560339,20.0,40.0
22834,2,2834,[678  70 288 153 258],13,2,10322,3.6409171075837743,0.0,0.0
22835,2,2835,[204  96 289 194 286],537,0,10322,3.639633286318759,0.0,0.0
22836,2,2836,[ 97 269 197 153  88],659,4,10326,3.639760310186817,0.0,0.0
22837,2,2837,[202 258 483 135 144],815,4,10330,3.639887244538407,20.0,0.0
22838,2,2838,[333 204  64 180  69],263,4,10334,3.6400140894681225,0.0,0.0
22839,2,2839,[ 79 204  98  12 597],13,3,10337,3.6397887323943663,20.0,20.0
22840,2,2840,[135  79 200 204 423],788,3,10340,3.6395635339669132,0.0,0.0
22841,2,2841,[483 302 100 127 427],6,5,10345,3.6400422237860663,20.0,40.0
22842,2,2842,[475 515 238 275 143],537,4,10349,3.6401688357368975,0.0,0.0
22843,2,2843,[ 98 210 228 215 322],749,5,10354,3.640646976090014,0.0,20.0
22844,2,2844,[111  25  70  22  95],95,3,10357,3.6404217926186293,0.0,0.0
22845,2,2845,[143 318 185 195 222],537,2,10359,3.639845397048489,20.0,0.0
22846,2,2846,[483 302 100 127 427],6,5,10364,3.640323147172462,20.0,40.0
22847,2,2847,[483 302 100 127 427],334,5,10369,3.640800561797753,20.0,40.0
22848,2,2848,[483 302 100 127 427],328,4,10373,3.640926640926641,20.0,40.0
22849,2,2849,[118  64  79 597 204],213,5,10378,3.64140350877193,0.0,0.0
22850,2,2850,[483 302 100 127 427],537,5,10383,3.6418800420904947,20.0,40.0
22851,2,2851,[ 82 183 176  56 174],666,3,10386,3.6416549789621318,0.0,20.0
22852,2,2852,[427 496 195  97 546],87,4,10390,3.6417805818436735,0.0,0.0
22853,2,2853,[161 273 195 385 427],42,4,10394,3.641906096706377,0.0,0.0
22854,2,2854,[180 161 175 187  56],313,4,10398,3.642031523642732,0.0,0.0
22855,2,2855,[180  28  12 269 282],271,4,10402,3.642156862745098,20.0,0.0
22856,2,2856,[483 302 100 127 427],745,3,10405,3.64193209660483,20.0,40.0
22857,2,2857,[483 302 100 127 427],334,5,10410,3.642407277816655,20.0,40.0
22858,2,2858,[483 302 100 127 427],745,3,10413,3.6421825813221407,20.0,40.0
22859,2,2859,[357 176 603 174 186],313,4,10417,3.6423076923076922,40.0,20.0
22860,2,2860,[302 483 100 127 427],666,5,10422,3.6427822439706397,20.0,40.0
22861,2,2861,[302 483 100 127 427],339,5,10427,3.643256464011181,20.0,40.0
22862,2,2862,[197 121 257 132 125],271,3,10430,3.643031784841076,0.0,0.0
22863,2,2863,[568  28 222  88  98],210,5,10435,3.6435055865921786,0.0,20.0
22864,2,2864,[127 546 237 175 185],64,4,10439,3.643630017452007,0.0,20.0
22865,2,2865,[302 483 100 127 427],339,5,10444,3.6441032798325192,20.0,40.0
22866,2,2866,[117 568  50 135 286],387,2,10446,3.643529822113708,0.0,20.0
22867,2,2867,[ 28 132 185 200  71],897,5,10451,3.644002789400279,0.0,0.0
22868,2,2868,[179 187 161 588 211],479,2,10453,3.643429766469153,0.0,0.0
22869,2,2869,[302 483 100 127 427],474,5,10458,3.6439024390243904,20.0,40.0
22870,2,2870,[302 483 100 127 427],833,3,10461,3.6436781609195403,20.0,40.0
22871,2,2871,[ 88 282 483  89  28],95,3,10464,3.6434540389972145,20.0,0.0
22872,2,2872,[ 97  64 742 174 176],290,3,10467,3.6432300730943266,0.0,20.0
22873,2,2873,[302 483 100 127 427],537,5,10472,3.6437021572720947,20.0,40.0
22874,2,2874,[302 483 100 127 427],664,5,10477,3.644173913043478,20.0,40.0
22875,2,2875,[302 483 100 127 427],90,5,10482,3.644645340751043,20.0,40.0
22876,2,2876,[135 144 195 515 403],892,4,10486,3.6447688564476888,0.0,0.0
22877,2,2877,[118 153 588 597  98],7,3,10489,3.644544822793607,0.0,20.0
22878,2,2878,[118  97 588 234 182],194,1,10490,3.6436262591177493,0.0,0.0
22879,2,2879,[302 483 100 127 427],339,5,10495,3.6440972222222223,20.0,40.0
22880,2,2880,[ 89 197 111 403 202],543,5,10500,3.644567858382506,0.0,0.0
22881,2,2881,[302 483 100 127 427],339,5,10505,3.645038167938931,20.0,40.0
22882,2,2882,[302 483 100 127 427],474,5,10510,3.6455081512313563,20.0,40.0
22883,2,2883,[302 483 100 127 427],13,5,10515,3.645977808599168,20.0,40.0
22884,2,2884,[323 216  79 180 185],488,2,10517,3.6454072790294627,0.0,0.0
22885,2,2885,[210  15  12 174 143],194,3,10520,3.645183645183645,20.0,20.0
22886,2,2886,[302 483 100 127 427],664,5,10525,3.645652926913751,20.0,40.0
22887,2,2887,[ 88 168  28 197  22],215,3,10528,3.6454293628808863,0.0,0.0
22888,2,2888,[204 172 182 568 385],308,5,10533,3.6458982346832816,0.0,0.0
22889,2,2889,[111 322 117 194 195],13,2,10535,3.6453287197231834,0.0,0.0
22890,2,2890,[302 483 100 127 427],474,5,10540,3.645797301971636,20.0,40.0
22891,2,2891,[302 483 100 127 427],13,5,10545,3.646265560165975,20.0,40.0
22892,2,2892,[302 483 100 127 427],13,5,10550,3.64673349464224,20.0,40.0
22893,2,2893,[ 56  98 179 211 403],311,3,10553,3.64651002073255,0.0,20.0
22894,2,2894,[302 483 100 127 427],328,4,10557,3.6466321243523314,20.0,40.0
22895,2,2895,[302 483 100 127 427],474,5,10562,3.647099447513812,20.0,40.0
22896,2,2896,[302 483 100 127 427],537,5,10567,3.6475664480497065,20.0,40.0
22897,2,2897,[302 483 100 127 427],666,5,10572,3.648033126293996,20.0,40.0
22898,2,2898,[180  15 204 132 144],892,5,10577,3.6484994825802,0.0,0.0
22899,2,2899,[302 483 100 127 427],666,5,10582,3.6489655172413795,20.0,40.0
22900,2,2900,[  4 385 132  25 268],92,3,10585,3.6487418131678733,0.0,0.0
22901,2,2901,[568  88 185 186   7],13,2,10587,3.648173673328739,0.0,0.0
22902,2,2902,[568 182 183  89 234],378,5,10592,3.648639338615226,0.0,0.0
22903,2,2903,[200 168  89   7  96],653,3,10595,3.6484159779614327,0.0,0.0
22904,2,2904,[302 483 100 127 427],664,5,10600,3.648881239242685,20.0,40.0
22905,2,2905,[302 483 100 127 427],90,5,10605,3.6493461803165865,20.0,40.0
22906,2,2906,[302 483 100 127 427],13,5,10610,3.649810801513588,20.0,40.0
22907,2,2907,[ 15  88 182 508 132],184,3,10613,3.6495873452544703,0.0,0.0
22908,2,2908,[302 483 100 127 427],666,5,10618,3.6500515641113784,20.0,40.0
22909,2,2909,[302 483 100 127 427],343,5,10623,3.6505154639175257,20.0,40.0
22910,2,2910,[ 97 180 235 202 483],313,4,10627,3.6506355204397116,20.0,0.0
22911,2,2911,[143  50 228 194 234],64,5,10632,3.651098901098901,0.0,20.0
22912,2,2912,[302 483 100 127 427],745,3,10635,3.650875386199794,20.0,40.0
22913,2,2913,[302 483 100 127 427],474,5,10640,3.65133836650652,20.0,40.0
22914,2,2914,[238 200  82 132 318],537,2,10642,3.650771869639794,20.0,0.0
22915,2,2915,[318 588 322 194 180],13,3,10645,3.650548696844993,20.0,0.0
22916,2,2916,[143 405 125 168 215],7,3,10648,3.6503256770654784,0.0,0.0
22917,2,2917,[302 483 100 127 427],458,5,10653,3.6507882111034955,20.0,40.0
22918,2,2918,[302 483 100 127 427],745,3,10656,3.6505652620760536,20.0,40.0
22919,2,2919,[176 185 515 195 187],666,4,10660,3.6506849315068495,0.0,0.0
22920,2,2920,[135  89 183 215 143],378,4,10664,3.650804519000342,0.0,0.0
22921,2,2921,[328  12 200 202  89],378,2,10666,3.650239561943874,20.0,0.0
22922,2,2922,[302 483 100 127 427],6,5,10671,3.650701334245638,20.0,40.0
22923,2,2923,[302 483 100 127 427],666,5,10676,3.6511627906976742,20.0,40.0
22924,2,2924,[111 215 273 357  69],749,4,10680,3.651282051282051,20.0,0.0
22925,2,2925,[300 568 127 176 200],328,4,10684,3.6514012303485988,0.0,20.0
22926,2,2926,[678  70   7 176 588],308,4,10688,3.651520327980868,0.0,0.0
22927,2,2927,[302 483 100 127 427],6,5,10693,3.6519808743169397,20.0,40.0
22928,2,2928,[153 515  95 333 258],64,2,10695,3.6514168658245136,0.0,0.0
22929,2,2929,[748 132 423 269 174],13,4,10699,3.6515358361774743,0.0,20.0
22930,2,2930,[302 483 100 127 427],339,5,10704,3.651995905834186,20.0,40.0
22931,2,2931,[302 483 100 127 427],537,5,10709,3.652455661664393,20.0,40.0
22932,2,2932,[191 125 161 175  79],334,3,10712,3.652233208319127,0.0,0.0
22933,2,2933,[237 172 153  15  88],92,3,10715,3.6520109066121336,0.0,0.0
22934,2,2934,[180 135   4 333   9],533,2,10717,3.6514480408858603,0.0,0.0
22935,2,2935,[118 742   7 588   1],200,5,10722,3.6519073569482288,0.0,0.0
22936,2,2936,[ 95 210   8 175 568],378,5,10727,3.652366360231529,0.0,0.0
22937,2,2937,[301 187 288 195 427],537,2,10729,3.651803948264125,0.0,0.0
22938,2,2938,[265 603 187 546 294],897,3,10732,3.651582170806397,20.0,0.0
22939,2,2939,[302 483 100 127 427],6,5,10737,3.6520408163265308,20.0,40.0
22940,2,2940,[302 483 100 127 427],90,5,10742,3.652499149948997,20.0,40.0
22941,2,2941,[423   7  56 235 313],200,4,10746,3.6526172671651937,0.0,0.0
22942,2,2942,[135  22 742  50 655],334,4,10750,3.652735304111451,0.0,20.0
22943,2,2943,[302 483 100 127 427],6,5,10755,3.653192934782609,20.0,40.0
22944,2,2944,[144 313 235 302 197],144,3,10758,3.6529711375212224,0.0,0.0
22945,2,2945,[286 172   9 118 323],59,4,10762,3.653088934147997,0.0,0.0
22946,2,2946,[435  89  95  70 568],378,5,10767,3.653545978961656,0.0,0.0
22947,2,2947,[132 125 282 300 100],788,4,10771,3.653663500678426,0.0,20.0
22948,2,2948,[302 483 100 127 427],664,5,10776,3.65412004069176,20.0,40.0
22949,2,2949,[215 238 273 173  12],385,2,10778,3.653559322033898,20.0,0.0
22950,2,2950,[210  82 204  71  89],738,4,10782,3.6536767197560147,0.0,0.0
22951,2,2951,[427   8 174 238 183],6,5,10787,3.654132791327913,0.0,20.0
22952,2,2952,[302 483 100 127 427],339,5,10792,3.6545885540128684,20.0,40.0
22953,2,2953,[748   7 471 333 235],634,3,10795,3.6543669600541637,0.0,0.0
22954,2,2954,[173  88  96 273 222],749,4,10799,3.6544839255499153,0.0,0.0
22955,2,2955,[191 194 742 289 181],881,3,10802,3.65426251691475,0.0,0.0
22956,2,2956,[238 357  96 515   4],59,5,10807,3.6547176192086575,20.0,0.0
22957,2,2957,[302 483 100 127 427],90,5,10812,3.6551724137931036,20.0,40.0
22958,2,2958,[302 483 100 127 427],666,5,10817,3.655626900980061,20.0,40.0
22959,2,2959,[302 483 100 127 427],537,5,10822,3.656081081081081,20.0,40.0
22960,2,2960,[302 483 100 127 427],666,5,10827,3.6565349544072947,20.0,40.0
22961,2,2961,[228 175 210 187 196],334,4,10831,3.6566509115462527,0.0,0.0
22962,2,2962,[302 483 100 127 427],334,5,10836,3.6571042861964225,20.0,40.0
22963,2,2963,[174 176 655 135 132],92,4,10840,3.657219973009447,0.0,20.0
22964,2,2964,[302 483 100 127 427],474,5,10845,3.657672849915683,20.0,40.0
22965,2,2965,[302 483 100 127 427],13,5,10850,3.658125421443021,20.0,40.0
22966,2,2966,[ 25 181 216 322  89],881,4,10854,3.6582406471183013,0.0,0.0
22967,2,2967,[195   9 258 273 118],825,4,10858,3.658355795148248,0.0,0.0
22968,2,2968,[302 483 100 127 427],6,5,10863,3.6588076793533175,20.0,40.0
22969,2,2969,[211 471 257 132 435],533,5,10868,3.6592592592592594,0.0,0.0
22970,2,2970,[302 483 100 127 427],328,4,10872,3.6593739481656007,20.0,40.0
22971,2,2971,[302 483 100 127 427],833,3,10875,3.6591520861372815,20.0,40.0
22972,2,2972,[475 678   9  98  15],548,3,10878,3.658930373360242,0.0,20.0
22973,2,2973,[238 183  82 100   1],537,2,10880,3.6583725622057837,0.0,20.0
22974,2,2974,[200  28 357  25 483],474,4,10884,3.6584873949579833,40.0,0.0
22975,2,2975,[172 289  11 143 302],13,2,10886,3.6579301075268815,0.0,0.0
22976,2,2976,[302 483 100 127 427],334,5,10891,3.658380920389654,20.0,40.0
22977,2,2977,[288   7   4 273 258],13,2,10893,3.657824042981867,0.0,0.0
22978,2,2978,[515 204 273 237  95],308,2,10895,3.657267539442766,0.0,0.0
22979,2,2979,[197 174 427 210 405],60,5,10900,3.6577181208053693,0.0,20.0
22980,2,2980,[234 200 215 483 187],311,5,10905,3.6581683998658168,20.0,0.0
22981,2,2981,[234 143 603  64 175],234,3,10908,3.6579476861167004,20.0,0.0
22982,2,2982,[302 483 100 127 427],666,5,10913,3.658397586322494,20.0,40.0
22983,2,2983,[282 195  96 187 176],804,5,10918,3.658847184986595,0.0,0.0
22984,2,2984,[286 161 269  15 179],650,1,10919,3.657956448911223,0.0,0.0
22985,2,2985,[153 748 245 258  79],488,3,10922,3.6577361018084393,0.0,0.0
22986,2,2986,[302 483 100 127 427],458,5,10927,3.65818547037161,20.0,40.0
22987,2,2987,[ 28 176 194 187 228],766,2,10929,3.6576305220883536,0.0,0.0
22988,2,2988,[496  64 403 385 174],804,4,10933,3.6577450652392103,0.0,20.0
22989,2,2989,[ 12 172 185 132 282],788,4,10937,3.657859531772575,20.0,0.0
22990,2,2990,[302 483 100 127 427],833,3,10940,3.6576395854229355,20.0,40.0
22991,2,2991,[151 200 357 127   1],6,3,10943,3.6574197860962565,20.0,20.0
22992,2,2992,[180 144  28   1  97],738,5,10948,3.657868359505513,0.0,0.0
22993,2,2993,[181  69 185   9 161],13,3,10951,3.6576486305945224,0.0,0.0
22994,2,2994,[483 302 100 127 427],474,5,10956,3.6580968280467445,20.0,40.0
22995,2,2995,[678  98 288 200 143],648,3,10959,3.6578771695594123,0.0,20.0
22996,2,2996,[483 302 100 127 427],334,5,10964,3.658324991658325,20.0,40.0
22997,2,2997,[475 238 678 289 176],537,2,10966,3.657771847898599,0.0,0.0
22998,2,2998,[ 97 403  15 333 237],313,2,10968,3.6572190730243412,0.0,0.0
22999,2,2999,[153 179 496 235 257],343,4,10972,3.6573333333333333,0.0,0.0
23000,2,3000,[ 98 228 234 265  88],92,4,10976,3.6574475174941687,0.0,20.0
23001,2,3001,[ 25  12  15 405 132],92,1,10977,3.656562291805463,20.0,0.0
23002,2,3002,[182 153  22 151 216],7,5,10982,3.657009657009657,0.0,0.0
23003,2,3003,[483 302 100 127 427],90,5,10987,3.65745672436751,20.0,40.0
23004,2,3004,[496 301 275 200 245],334,2,10989,3.6569051580698835,0.0,0.0
23005,2,3005,[216 210 238 211   4],474,5,10994,3.6573519627411843,0.0,0.0
23006,2,3006,[655  70  88 204 182],474,5,10999,3.657798470236116,0.0,0.0
23007,2,3007,[483 302 100 127 427],833,3,11002,3.6575797872340425,20.0,40.0
23008,2,3008,[483 228  96 275  50],536,5,11007,3.6580259222333003,20.0,20.0
23009,2,3009,[174 385 176 228 403],13,2,11009,3.6574750830564784,0.0,20.0
23010,2,3010,[313  82  22 546 289],13,2,11011,3.656924609764198,0.0,0.0
23011,2,3011,[216  79 197 289 265],378,4,11015,3.657038512616202,0.0,0.0
23012,2,3012,[496 423 588 121 228],536,4,11019,3.657152339860604,0.0,0.0
23013,2,3013,[742  11  69 161 269],334,1,11020,3.6562707365627074,0.0,0.0
23014,2,3014,[483 302 100 127 427],343,5,11025,3.656716417910448,20.0,40.0
23015,2,3015,[174  15  98 333 215],653,2,11027,3.6561671087533156,0.0,40.0
23016,2,3016,[ 11 333 318  98  71],334,4,11031,3.6562810739144846,20.0,20.0
23017,2,3017,[125  22  88 127 234],749,5,11036,3.656726308813784,0.0,20.0
23018,2,3018,[228 202   4 143 204],650,3,11039,3.656508777740974,0.0,0.0
23019,2,3019,[196 269 216  50 286],666,2,11041,3.655960264900662,0.0,20.0
23020,2,3020,[132 215 173 204 273],643,2,11043,3.6554121151936445,0.0,0.0
23021,2,3021,[195 181  12  98 403],524,1,11044,3.654533421575116,20.0,20.0
23022,2,3022,[  7 222 237 328 100],234,1,11045,3.653655309295402,0.0,20.0
23023,2,3023,[ 11 127 135  95 269],271,5,11050,3.6541005291005293,0.0,20.0
23024,2,3024,[515   8 200 153  96],313,2,11052,3.6535537190082645,0.0,0.0
23025,2,3025,[187 265  50  97 515],474,5,11057,3.6539986781229348,0.0,20.0
23026,2,3026,[ 28 151 204 234 117],200,4,11061,3.6541129831516352,0.0,0.0
23027,2,3027,[483 302 100 127 427],458,5,11066,3.654557463672391,20.0,40.0
23028,2,3028,[597 496 187 435  82],59,4,11070,3.654671508748762,0.0,0.0
23029,2,3029,[483 302 100 127 427],537,5,11075,3.655115511551155,20.0,40.0
23030,2,3030,[357 204 322  89 127],474,5,11080,3.655559221379083,20.0,20.0
23031,2,3031,[180 176 385 183  82],659,5,11085,3.6560026385224274,0.0,0.0
23032,2,3032,[483 302 100 127 427],6,5,11090,3.656445763270689,20.0,40.0
23033,2,3033,[ 88 515  56  98 403],883,4,11094,3.6565589980224127,0.0,20.0
23034,2,3034,[483 302 100 127 427],343,5,11099,3.657001647446458,20.0,40.0
23035,2,3035,[194 222 294 322 313],328,1,11100,3.656126482213439,0.0,0.0
23036,2,3036,[211 403  79 153 191],843,0,11100,3.6549226210075734,0.0,0.0
23037,2,3037,[ 82 496 161 186 176],766,1,11101,3.654048716260698,0.0,0.0
23038,2,3038,[435  25 257 275   9],474,3,11104,3.6538334978611386,0.0,0.0
23039,2,3039,[ 64 655  79  82 216],666,2,11106,3.6532894736842105,0.0,0.0
23040,2,3040,[ 97 357 265  89   1],843,1,11107,3.6524169681025977,20.0,0.0
23041,2,3041,[483 118 508 471 222],213,3,11110,3.6522024983563446,20.0,0.0
23042,2,3042,[483 302 100 127 427],328,4,11114,3.6523167926388433,20.0,40.0
23043,2,3043,[195 265   8 179 187],387,5,11119,3.6527595269382394,0.0,0.0
23044,2,3044,[483 302 100 127 427],664,5,11124,3.65320197044335,20.0,40.0
23045,2,3045,[546 127 161 194 186],13,4,11128,3.653315824031517,0.0,20.0
23046,2,3046,[300 475 187 322 191],409,2,11130,3.652773219560223,0.0,0.0
23047,2,3047,[301 195 333 196 187],537,1,11131,3.6519028871391077,0.0,0.0
23048,2,3048,[173 182 238  56 357],387,5,11136,3.6523450311577568,20.0,0.0
23049,2,3049,[275 265 100  96  69],13,4,11140,3.6524590163934425,0.0,20.0
23050,2,3050,[ 88 483  97 748 423],313,3,11143,3.652245165519502,20.0,0.0
23051,2,3051,[483 302 100 127 427],6,5,11148,3.652686762778506,20.0,40.0
23052,2,3052,[  7 508 186 100  50],774,1,11149,3.651817884048477,0.0,40.0
23053,2,3053,[483 302 100 127 427],458,5,11154,3.6522593320235757,20.0,40.0
23054,2,3054,[483 302 100 127 427],343,5,11159,3.652700490998363,20.0,40.0
23055,2,3055,[483 302 100 127 427],343,5,11164,3.6531413612565444,20.0,40.0
23056,2,3056,[483 302 100 127 427],666,5,11169,3.6535819430814525,20.0,40.0
23057,2,3057,[483 302 100 127 427],90,5,11174,3.6540222367560498,20.0,40.0
23058,2,3058,[181 211 127  50 195],326,4,11178,3.654135338345865,0.0,40.0
23059,2,3059,[483 302 100 127 427],666,5,11183,3.6545751633986927,20.0,40.0
23060,2,3060,[ 12 168 257 276 568],339,4,11187,3.6546880104541,20.0,0.0
23061,2,3061,[172  98   9 151 245],334,3,11190,3.6544741998693664,0.0,20.0
23062,2,3062,[483 302 100 127 427],334,5,11195,3.654913483512896,20.0,40.0
23063,2,3063,[187 318 211 182 173],59,5,11200,3.6553524804177546,20.0,0.0
23064,2,3064,[483 302 100 127 427],745,3,11203,3.6551386623164763,20.0,40.0
23065,2,3065,[  4 403 318 294 222],653,1,11204,3.654272667971298,20.0,0.0
23066,2,3066,[483 302 100 127 427],328,4,11208,3.654385392892077,20.0,40.0
23067,2,3067,[483 302 100 127 427],6,5,11213,3.6548239895697523,20.0,40.0
23068,2,3068,[ 79  69 678   1 185],145,3,11216,3.654610622352558,0.0,0.0
23069,2,3069,[483 302 100 127 427],343,5,11221,3.6550488599348534,20.0,40.0
23070,2,3070,[135  11 181 258 288],537,2,11223,3.6545099316183656,0.0,0.0
23071,2,3071,[483 302 100 127 427],90,5,11228,3.6549479166666665,20.0,40.0
23072,2,3072,[546 323  79 174 357],881,4,11232,3.6550602017572404,20.0,20.0
23073,2,3073,[180  15 318  64 174],311,5,11237,3.655497722836695,20.0,20.0
23074,2,3074,[496   7 121  71 588],200,5,11242,3.6559349593495933,0.0,0.0
23075,2,3075,[ 70 185 187 322  64],328,4,11246,3.6560468140442133,0.0,0.0
23076,2,3076,[483 302 100 127 427],13,5,11251,3.6564835879103024,20.0,40.0
23077,2,3077,[200 258 210 302 100],13,3,11254,3.6562703053931123,0.0,20.0
23078,2,3078,[ 98 655 268 215 180],7,4,11258,3.6563819421890225,0.0,20.0
23079,2,3079,[483 302 100 127 427],745,3,11261,3.656168831168831,20.0,40.0
23080,2,3080,[302 483 100 127 427],745,3,11264,3.6559558584875043,20.0,40.0
23081,2,3081,[144  71 204 216 118],194,3,11267,3.6557430240103828,0.0,0.0
23082,2,3082,[302 483 100 127 427],339,5,11272,3.656179046383393,20.0,40.0
23083,2,3083,[ 89 143   4 179 475],308,5,11277,3.656614785992218,0.0,0.0
23084,2,3084,[302 483 100 127 427],666,5,11282,3.6570502431118315,20.0,40.0
23085,2,3085,[302 483 100 127 427],328,4,11286,3.657161373946857,20.0,40.0
23086,2,3086,[302 483 100 127 427],343,5,11291,3.6575963718820863,20.0,40.0
23087,2,3087,[300  79  69 234 204],311,5,11296,3.6580310880829017,0.0,0.0
23088,2,3088,[282 222 182 151  28],653,1,11297,3.6571706053739073,0.0,0.0
23089,2,3089,[ 50 204 405 125  98],892,5,11302,3.6576051779935277,0.0,40.0
23090,2,3090,[302 483 100 127 427],339,5,11307,3.65803946942737,20.0,40.0
23091,2,3091,[ 22 191 257 161 597],455,4,11311,3.658150064683053,0.0,0.0
23092,2,3092,[302 483 100 127 427],664,5,11316,3.658583899127061,20.0,40.0
23093,2,3093,[302 483 100 127 427],537,5,11321,3.6590174531351,20.0,40.0
23094,2,3094,[275 132 111 144 235],119,5,11326,3.6594507269789984,0.0,0.0
23095,2,3095,[179  11 357 515  89],59,5,11331,3.6598837209302326,20.0,0.0
23096,2,3096,[423 172 210 179 483],643,5,11336,3.660316435259929,20.0,0.0
23097,2,3097,[302 483 100 127 427],745,3,11339,3.66010329244674,20.0,40.0
23098,2,3098,[302 483 100 127 427],343,5,11344,3.66053565666344,20.0,40.0
23099,2,3099,[  7  25 194 289  79],458,2,11346,3.66,0.0,0.0
23100,2,3100,[302 483 100 127 427],833,3,11349,3.6597871654305063,20.0,40.0
23101,2,3101,[143  56 135 323  70],374,3,11352,3.6595744680851063,0.0,0.0
23102,2,3102,[742 125  79 228  50],334,3,11355,3.6593619078311312,0.0,20.0
23103,2,3103,[191 385   9 427 182],7,5,11360,3.6597938144329896,0.0,0.0
23104,2,3104,[238   4 273 168 275],279,3,11363,3.6595813204508856,0.0,0.0
23105,2,3105,[302 483 100 127 427],343,5,11368,3.6600128783000643,20.0,40.0
23106,2,3106,[268 111  15 168 301],537,2,11370,3.6594785967170904,0.0,0.0
23107,2,3107,[183 403 546 143  28],92,2,11372,3.658944658944659,0.0,0.0
23108,2,3108,[181  82  89 286 655],328,5,11377,3.659376005146349,0.0,0.0
23109,2,3109,[ 56 228 568 597 282],533,3,11380,3.6591639871382635,0.0,0.0
23110,2,3110,[302 483 100 127 427],474,5,11385,3.6595949855351977,20.0,40.0
23111,2,3111,[385  15 222 322  70],84,4,11389,3.6597043701799485,0.0,0.0
23112,2,3112,[ 64 168 546 118 748],92,2,11391,3.6591712174751043,0.0,0.0
23113,2,3113,[ 97 182 313 216  88],234,1,11392,3.658317276814387,0.0,0.0
23114,2,3114,[204 181 228   9 427],328,2,11394,3.657784911717496,0.0,0.0
23115,2,3115,[111 483 742   7 300],447,3,11397,3.6575738125802313,20.0,0.0
23116,2,3116,[302 483 100 127 427],666,5,11402,3.6580044914982355,20.0,40.0
23117,2,3117,[282 172 235 318 385],194,1,11403,3.657152020525978,20.0,0.0
23118,2,3118,[216  70  11  89 143],881,4,11407,3.6572619429304263,0.0,0.0
23119,2,3119,[328 546 153  56 135],328,2,11409,3.6567307692307693,0.0,0.0
23120,2,3120,[302 483 100 127 427],339,5,11414,3.657161166292855,20.0,40.0
23121,2,3121,[302 483 100 127 427],537,5,11419,3.6575912876361305,20.0,40.0
23122,2,3122,[302 483 100 127 427],474,5,11424,3.658021133525456,20.0,40.0
23123,2,3123,[302 483 100 127 427],328,4,11428,3.6581306017925734,20.0,40.0
23124,2,3124,[211 204 748 194 118],543,2,11430,3.6576,0.0,0.0
23125,2,3125,[135 196 187  95  56],749,2,11432,3.657069737683941,0.0,0.0
23126,2,3126,[302 483 100 127 427],833,3,11435,3.6568596098496964,20.0,40.0
23127,2,3127,[ 79 546 125  82 196],92,3,11438,3.6566496163682864,0.0,0.0
23128,2,3128,[294   8  82 187 483],766,2,11440,3.6561201661872804,20.0,0.0
23129,2,3129,[302 483 100 127 427],474,5,11445,3.6565495207667733,20.0,40.0
23130,2,3130,[302 483 100 127 427],666,5,11450,3.656978601085915,20.0,40.0
23131,2,3131,[ 82  89  64 211 546],339,5,11455,3.6574074074074074,0.0,0.0
23132,2,3132,[302 483 100 127  64],328,5,11460,3.6578359399936162,20.0,40.0
23133,2,3133,[678 151  88 237   1],537,0,11460,3.656668793873644,0.0,0.0
23134,2,3134,[483 179 238  28 200],343,4,11464,3.6567783094098885,20.0,0.0
23135,2,3135,[265 173 200 385 185],374,4,11468,3.6568877551020407,0.0,0.0
23136,2,3136,[302 483 100 127  64],474,5,11473,3.6573159069174372,20.0,40.0
23137,2,3137,[302 483 100 127  64],480,2,11475,3.6567877629063097,20.0,40.0
23138,2,3138,[196  25 195 144 210],650,2,11477,3.656259955399809,0.0,0.0
23139,2,3139,[302 483 100 127 427],343,5,11482,3.656687898089172,20.0,40.0
23140,2,3140,[302 483 100 127 427],334,5,11487,3.6571155682903536,20.0,40.0
23141,2,3141,[302 483 100 127 427],328,4,11491,3.6572246976448124,20.0,40.0
23142,2,3142,[276 143  69 257 237],378,4,11495,3.657333757556475,0.0,0.0
23143,2,3143,[257 182 197 471 172],308,3,11498,3.6571246819338423,0.0,0.0
23144,2,3144,[302 483 100 127 427],458,5,11503,3.657551669316375,20.0,40.0
23145,2,3145,[302 483 100 127 427],664,5,11508,3.6579783852511127,20.0,40.0
23146,2,3146,[ 11 168  22 172 496],749,5,11513,3.6584048299968224,0.0,0.0
23147,2,3147,[302 483 100 127 427],666,5,11518,3.6588310038119443,20.0,40.0
23148,2,3148,[125 471  70 204 357],144,4,11522,3.6589393458240713,20.0,0.0
23149,2,3149,[  9  12 289  82  11],455,2,11524,3.6584126984126986,20.0,0.0
23150,2,3150,[496 403 286 125 228],234,1,11525,3.657569025706125,0.0,0.0
23151,2,3151,[181 168  71 546 515],308,3,11528,3.6573604060913705,0.0,0.0
23152,2,3152,[ 50 117 197 655 127],334,4,11532,3.657469077069458,0.0,40.0
23153,2,3153,[179 175 197 180 286],90,4,11536,3.657577679137603,0.0,0.0
23154,2,3154,[ 12 268 175 273   8],387,4,11540,3.657686212361331,20.0,0.0
23155,2,3155,[302 483 100 127 427],474,5,11545,3.6581115335868186,20.0,40.0
23156,2,3156,[ 98  11  12 204 174],455,3,11548,3.657903072537219,20.0,40.0
23157,2,3157,[288 195 202 118 403],378,2,11550,3.657378087397087,0.0,0.0
23158,2,3158,[228 210 328 237 405],804,5,11555,3.657803102247547,0.0,0.0
23159,2,3159,[ 98 172 228 546   9],13,3,11558,3.6575949367088607,0.0,20.0
23160,2,3160,[483 204  98 100 202],666,4,11562,3.657703258462512,20.0,40.0
23161,2,3161,[385 204 202 179 328],749,4,11566,3.6578115117014547,0.0,0.0
23162,2,3162,[302 483 100 127 427],458,5,11571,3.658235852039203,20.0,40.0
23163,2,3163,[300 546  88   1 237],313,3,11574,3.6580278128950696,0.0,0.0
23164,2,3164,[302 483 100 127 427],664,5,11579,3.6584518167456554,20.0,40.0
23165,2,3165,[302 483 100 127 427],328,4,11583,3.658559696778269,20.0,40.0
23166,2,3166,[748  11 197  28 234],488,3,11586,3.658351752447111,0.0,0.0
23167,2,3167,[143 216 265 153 196],290,4,11590,3.658459595959596,0.0,0.0
23168,2,3168,[302 483 100 127 427],664,5,11595,3.6588829283685707,20.0,40.0
23169,2,3169,[257 496 313 204 186],474,4,11599,3.6589905362776025,0.0,0.0
23170,2,3170,[300 196 135 286 215],271,4,11603,3.6590980763166194,0.0,0.0
23171,2,3171,[117   4 275 289 288],378,2,11605,3.658575031525851,0.0,0.0
23172,2,3172,[  8  98 222   4 173],387,4,11609,3.658682634730539,0.0,20.0
23173,2,3173,[ 69 195  56 483  88],659,3,11612,3.6584751102709516,20.0,0.0
23174,2,3174,[302 483 100 127 427],90,5,11617,3.6588976377952758,20.0,40.0
23175,2,3175,[302 483 100 127 427],334,5,11622,3.6593198992443323,20.0,40.0
23176,2,3176,[302 483 100 127 427],90,5,11627,3.6597418948693736,20.0,40.0
23177,2,3177,[302 483 100 127 427],745,3,11630,3.659534298300818,20.0,40.0
23178,2,3178,[568 153 100 132 168],308,4,11634,3.6596413966656183,0.0,20.0
23179,2,3179,[175   1 174 135 275],406,4,11638,3.659748427672956,0.0,20.0
23180,2,3180,[302 483 100 127 427],537,5,11643,3.6601697579377555,20.0,40.0
23181,2,3181,[302 483 100 127 427],6,5,11648,3.660590823381521,20.0,40.0
23182,2,3182,[603 180 237   1 588],537,2,11650,3.6600691171850457,20.0,0.0
23183,2,3183,[117  70 258  88 748],13,3,11653,3.659861809045226,0.0,0.0
23184,2,3184,[302 483 100 127 427],334,5,11658,3.660282574568289,20.0,40.0
23185,2,3185,[302 483 100 127 427],90,5,11663,3.660703075957313,20.0,40.0
23186,2,3186,[302 483 100 127 427],664,5,11668,3.661123313460935,20.0,40.0
23187,2,3187,[302 483 100 127 427],339,5,11673,3.6615432873274782,20.0,40.0
23188,2,3188,[143 191 194   9 228],7,4,11677,3.6616494198808405,0.0,0.0
23189,2,3189,[302 483 100 127 427],328,4,11681,3.661755485893417,20.0,40.0
23190,2,3190,[172 423 143 483 313],85,5,11686,3.6621748668129115,20.0,0.0
23191,2,3191,[ 22  71 191 197 174],454,4,11690,3.662280701754386,0.0,20.0
23192,2,3192,[132 194 328 265 597],95,2,11692,3.6617601002192295,0.0,0.0
23193,2,3193,[423 117 194 515 144],339,2,11694,3.6612398246712585,0.0,0.0
23194,2,3194,[302 483 100 127 427],833,3,11697,3.661032863849765,20.0,40.0
23195,2,3195,[302 483 100 127 427],334,5,11702,3.6614518147684607,20.0,40.0
23196,2,3196,[  7  79 100 302 174],334,5,11707,3.661870503597122,0.0,40.0
23197,2,3197,[121 597 100 132 174],653,4,11711,3.661976235146967,0.0,40.0
23198,2,3198,[237  69 238  98 111],899,3,11714,3.6617693029071585,0.0,20.0
23199,2,3199,[271 181 655 328 186],833,1,11715,3.6609375,0.0,0.0
23200,2,3200,[237 204   7 286  82],95,3,11718,3.660731021555764,0.0,0.0
23201,2,3201,[302 483 100 127 427],537,5,11723,3.6611492816989384,20.0,40.0
23202,2,3202,[302 483 100 127 427],664,5,11728,3.661567280674368,20.0,40.0
23203,2,3203,[302 483 100 127 427],745,3,11731,3.6613607990012484,20.0,40.0
23204,2,3204,[161 435  50 100  98],833,1,11732,3.6605304212168486,0.0,60.0
23205,2,3205,[268 144 275 269 172],119,4,11736,3.6606363069245167,0.0,0.0
23206,2,3206,[302 483 100 127 427],474,5,11741,3.6610539444964143,20.0,40.0
23207,2,3207,[302 483 100 127 427],745,3,11744,3.6608478802992517,20.0,40.0
23208,2,3208,[302 483 100 127 427],664,5,11749,3.6612651916484884,20.0,40.0
23209,2,3209,[ 25  22 216 181 405],313,2,11751,3.660747663551402,0.0,0.0
23210,2,3210,[258   1 328 546 276],533,3,11754,3.660541887262535,0.0,0.0
23211,2,3211,[172  82 357 568 175],42,4,11758,3.660647571606476,20.0,0.0
23212,2,3212,[100 405 265  28   1],64,4,11762,3.660753190164955,0.0,20.0
23213,2,3213,[302 483 100 127 427],537,5,11767,3.661169881767268,20.0,40.0
23214,2,3214,[181 216 258 655 228],488,3,11770,3.660964230171073,0.0,0.0
23215,2,3215,[245 294 118 144  79],666,0,11770,3.6598258706467663,0.0,0.0
23216,2,3216,[597 318 187 100 269],452,4,11774,3.659931613304321,20.0,20.0
23217,2,3217,[186 195 289  82 273],92,3,11777,3.6597265382224986,0.0,0.0
23218,2,3218,[144 211  89 471 546],479,4,11781,3.6598322460391426,0.0,0.0
23219,2,3219,[302 483 100 127 427],745,3,11784,3.6596273291925465,20.0,40.0
23220,2,3220,[302 483 100 127 427],90,5,11789,3.660043464762496,20.0,40.0
23221,2,3221,[117 191 275  71 215],311,5,11794,3.660459342023588,0.0,0.0
23222,2,3222,[302 483 100 127 427],339,5,11799,3.6608749612162583,20.0,40.0
23223,2,3223,[195 174 183 588  50],102,5,11804,3.661290322580645,0.0,40.0
23224,2,3224,[196 483   9  97 301],90,5,11809,3.661705426356589,20.0,0.0
23225,2,3225,[202 282  97 173 275],311,5,11814,3.662120272783633,0.0,0.0
23226,2,3226,[  4 183 288  71 196],59,4,11818,3.6622249767585995,0.0,0.0
23227,2,3227,[302 483 100 127 427],6,5,11823,3.662639405204461,20.0,40.0
23228,2,3228,[333 135 275 215 127],533,4,11827,3.6627438835552804,0.0,20.0
23229,2,3229,[302 483 100 127 427],474,5,11832,3.663157894736842,20.0,40.0
23230,2,3230,[302 483 100 127 427],458,5,11837,3.663571649644073,20.0,40.0
23231,2,3231,[546 111 127 216 210],479,3,11840,3.6633663366336635,0.0,20.0
23232,2,3232,[235  11 118 427 238],59,4,11844,3.663470460872255,0.0,0.0
23233,2,3233,[515 302 132 265 423],328,5,11849,3.663883735312307,0.0,0.0
23234,2,3234,[ 25 258  69  79 238],749,4,11853,3.6639876352395673,0.0,0.0
23235,2,3235,[235 195 174 515  64],279,2,11855,3.6634734239802227,0.0,20.0
23236,2,3236,[302 483 100 127 427],745,3,11858,3.6632684584491813,20.0,40.0
23237,2,3237,[ 22 100 125 568  96],263,5,11863,3.663681284743669,0.0,20.0
23238,2,3238,[ 98  71 202 172  50],533,5,11868,3.6640938561284346,0.0,40.0
23239,2,3239,[100 258 200 185 228],59,4,11872,3.6641975308641976,0.0,20.0
23240,2,3240,[302 483 100 127 427],90,5,11877,3.6646096883677877,20.0,40.0
23241,2,3241,[ 82  89 228 195  15],648,4,11881,3.6647131400370143,0.0,0.0
23242,2,3242,[127   4 200 151 179],234,3,11884,3.664508171446192,0.0,20.0
23243,2,3243,[180   7  88   9  28],343,5,11889,3.6649198520345254,0.0,0.0
23244,2,3244,[302 483 100 127 427],664,5,11894,3.665331278890601,20.0,40.0
23245,2,3245,[302   9 318 423 180],328,5,11899,3.6657424522489217,20.0,0.0
23246,2,3246,[276 496 204 258 117],533,4,11903,3.665845395749923,0.0,0.0
23247,2,3247,[508 385 546 300 100],533,4,11907,3.665948275862069,0.0,20.0
23248,2,3248,[302 483 100 127 427],664,5,11912,3.6663588796552786,20.0,40.0
23249,2,3249,[302 483 100 127 427],328,4,11916,3.6664615384615384,20.0,40.0
23250,2,3250,[ 22 175   8 181 125],82,3,11919,3.666256536450323,0.0,0.0
23251,2,3251,[195 181 176 258 175],774,1,11920,3.6654366543665438,0.0,0.0
23252,2,3252,[ 22 546  79 385  69],455,3,11923,3.665232093452198,0.0,0.0
23253,2,3253,[483  25 265  98 118],897,2,11925,3.664720344191764,20.0,20.0
23254,2,3254,[ 97 286 228 328 132],664,3,11928,3.664516129032258,0.0,0.0
23255,2,3255,[302 483 100 127 427],833,3,11931,3.664312039312039,20.0,40.0
23256,2,3256,[175  98 202 151  82],883,3,11934,3.6641080749155663,0.0,20.0
23257,2,3257,[302 483 100 127 427],13,5,11939,3.6645181092694905,20.0,40.0
23258,2,3258,[302 483 100 127 427],90,5,11944,3.6649278919914083,20.0,40.0
23259,2,3259,[515 748 268 180 183],13,4,11948,3.665030674846626,0.0,0.0
23260,2,3260,[302   4 385  89 127],13,4,11952,3.6651333946642133,0.0,20.0
23261,2,3261,[471  95 191 222 127],313,3,11955,3.6649294911097487,0.0,20.0
23262,2,3262,[302 483 100 127 427],339,5,11960,3.6653386454183265,20.0,40.0
23263,2,3263,[597  89 135  25 182],13,3,11963,3.6651348039215685,0.0,0.0
23264,2,3264,[302 483 100 127 427],458,5,11968,3.665543644716692,20.0,40.0
23265,2,3265,[302 483 100 127 427],339,5,11973,3.6659522351500304,20.0,40.0
23266,2,3266,[302 483 100 127 427],339,5,11978,3.6663605754514847,20.0,40.0
23267,2,3267,[302 483 100 127 427],343,5,11983,3.666768665850673,20.0,40.0
23268,2,3268,[302 483 100 127 427],339,5,11988,3.667176506576935,20.0,40.0
23269,2,3269,[302 483 100 127 427],833,3,11991,3.66697247706422,20.0,40.0
23270,2,3270,[302 483 100 127 427],328,4,11995,3.6670742892081933,20.0,40.0
23271,2,3271,[237 215 471 286   9],474,4,11999,3.6671760391198043,0.0,0.0
23272,2,3272,[135 125   8 182  56],213,4,12003,3.667277726856095,0.0,0.0
23273,2,3273,[172 403 405   9 185],60,4,12007,3.667379352474038,0.0,0.0
23274,2,3274,[302 483 100 127 427],6,5,12012,3.667786259541985,20.0,40.0
23275,2,3275,[302 483 100 127 427],13,5,12017,3.668192918192918,20.0,40.0
23276,2,3276,[258 118 318 423 300],271,2,12019,3.667683857186451,20.0,0.0
23277,2,3277,[302 483 100 127 427],664,5,12024,3.6680902989627824,20.0,40.0
23278,2,3278,[302 483 100 127 427],13,5,12029,3.6684964928331807,20.0,40.0
23279,2,3279,[180 121 237 135  95],749,2,12031,3.6679878048780488,0.0,0.0
23280,2,3280,[127  22 185 111  28],82,1,12032,3.667174641877476,0.0,20.0
23281,2,3281,[302 483 100 127 427],328,4,12036,3.6672760511883,20.0,40.0
23282,2,3282,[204   8 276  71 483],233,4,12040,3.6673773987206824,20.0,0.0
23283,2,3283,[302 483 100 127 427],328,4,12044,3.66747868453106,20.0,40.0
23284,2,3284,[302 483 100 127 427],6,5,12049,3.667884322678843,20.0,40.0
23285,2,3285,[302 483 100 127 427],328,4,12053,3.667985392574559,20.0,40.0
23286,2,3286,[655 496  69 423 197],7,5,12058,3.6683906297535747,0.0,0.0
23287,2,3287,[ 22 100  98 385 117],92,4,12062,3.6684914841849148,0.0,40.0
23288,2,3288,[603 111 748 275  64],474,3,12065,3.6682882335056246,20.0,0.0
23289,2,3289,[302 483 100 127 313],13,5,12070,3.6686930091185412,20.0,40.0
23290,2,3290,[302 483 100 127 313],329,5,12075,3.6690975387420237,20.0,40.0
23291,2,3291,[168 153 194 215 195],64,4,12079,3.669198055893074,0.0,0.0
23292,2,3292,[235 597  12 204 176],643,3,12082,3.6689948375341634,20.0,0.0
23293,2,3293,[211 655 508  95 568],537,2,12084,3.6684881602914388,0.0,0.0
23294,2,3294,[191 202 597 118   1],804,4,12088,3.6685887708649467,0.0,0.0
23295,2,3295,[302 483 100 127 313],328,5,12093,3.668992718446602,20.0,40.0
23296,2,3296,[271  88  98 181 143],650,3,12096,3.6687898089171975,0.0,20.0
23297,2,3297,[  8 125 222   1  25],899,2,12098,3.668283808368708,0.0,0.0
23298,2,3298,[ 15 194 588 191 235],398,4,12102,3.668384358896635,0.0,0.0
23299,2,3299,[403   8 174  64 180],881,4,12106,3.6684848484848485,0.0,20.0
23300,2,3300,[302 483 100 127 313],334,5,12111,3.6688882156922147,20.0,40.0
23301,2,3301,[515 100 748 176 265],311,4,12115,3.6689884918231375,0.0,20.0
23302,2,3302,[ 50  15 742  22 435],313,2,12117,3.6684831970935514,0.0,20.0
23303,2,3303,[302 483 100 127 313],329,5,12122,3.6688861985472156,20.0,40.0
23304,2,3304,[435 151 181 168  28],897,2,12124,3.668381240544629,0.0,0.0
23305,2,3305,[286   1 191 318 195],144,5,12129,3.6687840290381124,20.0,0.0
23306,2,3306,[302 483 100 127 313],90,5,12134,3.669186573934079,20.0,40.0
23307,2,3307,[302 483 100 127 313],328,5,12139,3.6695888754534463,20.0,40.0
23308,2,3308,[302 483 100 127 313],537,5,12144,3.6699909338168633,20.0,40.0
23309,2,3309,[121 302 427 143 515],343,4,12148,3.6700906344410877,0.0,0.0
23310,2,3310,[257  64 423 237 173],474,4,12152,3.6701902748414374,0.0,0.0
23311,2,3311,[ 64 143   8 423 265],452,3,12155,3.669987922705314,0.0,0.0
23312,2,3312,[228 143 403 546 195],881,3,12158,3.6697856927256263,0.0,0.0
23313,2,3313,[135 127 176  11   8],387,3,12161,3.6695835847917926,0.0,20.0
23314,2,3314,[151  71 546 197 174],308,3,12164,3.6693815987933633,0.0,20.0
23315,2,3315,[302 483 100 127 313],328,5,12169,3.66978287092883,20.0,40.0
23316,2,3316,[183   7 187 185 286],452,4,12173,3.6698824238769974,0.0,0.0
23317,2,3317,[215 483 216 423 234],194,1,12174,3.669077757685353,20.0,0.0
23318,2,3318,[302 483 100 127 313],232,3,12177,3.6688761675203376,20.0,40.0
23319,2,3319,[423 603 483 301 475],568,4,12181,3.668975903614458,40.0,0.0
23320,2,3320,[302 483 100 127 313],537,5,12186,3.669376693766938,20.0,40.0
23321,2,3321,[183 300 127 210 271],215,4,12190,3.669476219145093,0.0,20.0
23322,2,3322,[211 127 515 588 200],95,2,12192,3.668973818838399,0.0,20.0
23323,2,3323,[678  98 202 483 197],308,1,12193,3.668170878459687,20.0,20.0
23324,2,3324,[597 174 204 197 258],533,4,12197,3.6682706766917295,0.0,20.0
23325,2,3325,[302 483 100 127 313],328,5,12202,3.6686710763680095,20.0,40.0
23326,2,3326,[302 483 100 127 313],13,5,12207,3.6690712353471597,20.0,40.0
23327,2,3327,[ 22 222 202 195 179],234,1,12208,3.668269230769231,0.0,0.0
23328,2,3328,[328 496 427 161  56],85,3,12211,3.6680684890357464,0.0,0.0
23329,2,3329,[ 11  28 135  89 258],653,3,12214,3.667867867867868,0.0,0.0
23330,2,3330,[385 216 238 265 515],537,2,12216,3.667367157009907,0.0,0.0
23331,2,3331,[302 483 100 127 313],537,5,12221,3.667767106842737,20.0,40.0
23332,2,3332,[127 187 200 655  97],313,4,12225,3.667866786678668,0.0,20.0
23333,2,3333,[302 483 100 127 313],328,5,12230,3.668266346730654,20.0,40.0
23334,2,3334,[496 748  82 143  96],64,3,12233,3.6680659670164917,0.0,0.0
23335,2,3335,[302 483 100 127 313],329,5,12238,3.668465227817746,20.0,40.0
23336,2,3336,[143  15  97  95 174],479,2,12240,3.6679652382379384,0.0,20.0
23337,2,3337,[117 228 423  79 275],524,2,12242,3.6674655482324745,0.0,0.0
23338,2,3338,[385 275  50 173 568],64,5,12247,3.667864630128781,0.0,20.0
23339,2,3339,[302 483 100 127 313],13,5,12252,3.668263473053892,20.0,40.0
23340,2,3340,[235 286 118 289 144],328,3,12255,3.668063454055672,0.0,0.0
23341,2,3341,[143 403 237 132 435],804,2,12257,3.6675643327348895,0.0,0.0
23342,2,3342,[302 483 100 127 313],537,5,12262,3.6679629075680524,20.0,40.0
23343,2,3343,[302 483 100 127 313],334,5,12267,3.6683612440191387,20.0,40.0
23344,2,3344,[302 483 100 127 313],207,4,12271,3.668460388639761,20.0,40.0
23345,2,3345,[216  89 175 161   9],308,3,12274,3.668260609683204,0.0,0.0
23346,2,3346,[483  82 181  22 194],804,5,12279,3.6686585001493874,20.0,0.0
23347,2,3347,[302 483 100 127 313],537,5,12284,3.6690561529271206,20.0,40.0
23348,2,3348,[ 12 175 186 176 302],315,5,12289,3.669453568229322,20.0,0.0
23349,2,3349,[ 50 435  97 546 100],13,4,12293,3.66955223880597,0.0,40.0
23350,2,3350,[  8 215 405  98 100],774,1,12294,3.668755595344673,0.0,40.0
23351,2,3351,[302 483 100 127 313],13,5,12299,3.669152744630072,20.0,40.0
23352,2,3352,[216  69   7 323 357],13,1,12300,3.6683566954965703,20.0,0.0
23353,2,3353,[302 483 100 127 313],537,5,12305,3.6687537268932617,20.0,40.0
23354,2,3354,[186 127 185 546 161],524,4,12309,3.6688524590163936,0.0,20.0
23355,2,3355,[471 234 271 475 196],479,3,12312,3.66865315852205,0.0,0.0
23356,2,3356,[ 88 515  64 179 257],95,4,12316,3.6687518617813524,0.0,0.0
23357,2,3357,[204  11  71 202 176],387,0,12316,3.6676593210244195,0.0,0.0
23358,2,3358,[196 180 118   4 172],92,4,12320,3.6677582613873176,0.0,0.0
23359,2,3359,[302 483 100 127 313],329,5,12325,3.668154761904762,20.0,40.0
23360,2,3360,[302 483 100 127 313],474,5,12330,3.6685510264802144,20.0,40.0
23361,2,3361,[132 268  64 187 197],7,4,12334,3.6686496133254014,0.0,0.0
23362,2,3362,[197 100 286  97 275],524,4,12338,3.6687481415402914,0.0,20.0
23363,2,3363,[172  89 173 117 187],479,4,12342,3.66884661117717,0.0,0.0
23364,2,3364,[194 202 603 143  97],64,3,12345,3.6686478454680533,20.0,0.0
23365,2,3365,[435   1 118  25 195],749,4,12349,3.668746286393345,0.0,0.0
23366,2,3366,[268 215 234 202  88],234,1,12350,3.667953667953668,0.0,0.0
23367,2,3367,[265 194 100 151 235],59,3,12353,3.6677553444180524,0.0,20.0
23368,2,3368,[175 210 265  95   8],92,4,12357,3.6678539626001783,0.0,0.0
23369,2,3369,[135 117 742 385 180],290,2,12359,3.667359050445104,0.0,0.0
23370,2,3370,[ 89 405 176 127 117],271,1,12360,3.666567784040344,0.0,20.0
23371,2,3371,[323 655 125 180 187],311,4,12364,3.6666666666666665,0.0,0.0
23372,2,3372,[204 405 210 238 215],774,1,12365,3.66587607471094,0.0,0.0
23373,2,3373,[173 202 271 286 300],379,3,12368,3.665678719620628,0.0,0.0
23374,2,3374,[288 235  69  71 515],804,4,12372,3.6657777777777776,0.0,0.0
23375,2,3375,[ 79 427 181 197  95],85,3,12375,3.665580568720379,0.0,0.0
23376,2,3376,[302 483 100 127 313],474,5,12380,3.665975718092982,20.0,40.0
23377,2,3377,[302 483 100 127 313],207,4,12384,3.66607460035524,20.0,40.0
23378,2,3378,[357 204 427 328  82],788,2,12386,3.6655815329979284,20.0,0.0
23379,2,3379,[289 125 173 211 216],194,2,12388,3.66508875739645,0.0,0.0
23380,2,3380,[302 483 100 127 313],207,4,12392,3.665187814256137,20.0,40.0
23381,2,3381,[302 483 100 127 313],232,3,12395,3.664991129509166,20.0,40.0
23382,2,3382,[180 143 286 204 186],533,3,12398,3.6647945610404964,0.0,0.0
23383,2,3383,[161  71  70   8 597],452,4,12402,3.6648936170212765,0.0,0.0
23384,2,3384,[568 185 210 204  82],882,5,12407,3.665288035450517,0.0,0.0
23385,2,3385,[175 318 427  69 144],125,4,12411,3.665386887182516,20.0,0.0
23386,2,3386,[ 69 234 182  82 179],308,3,12414,3.6651904340124,0.0,0.0
23387,2,3387,[118  70 153 215 175],788,1,12415,3.6644037780401417,0.0,0.0
23388,2,3388,[222 427 135  97 546],666,4,12419,3.664502803186781,0.0,0.0
23389,2,3389,[179  25 121 475 195],13,1,12420,3.663716814159292,0.0,0.0
23390,2,3390,[197 271 228  50  25],537,2,12422,3.6632261869654967,0.0,20.0
23391,2,3391,[176 289 202   4 496],234,3,12425,3.6630306603773586,0.0,0.0
23392,2,3392,[302 483 100 127 313],474,5,12430,3.6634246979074567,20.0,40.0
23393,2,3393,[ 25 385 161 294 288],387,0,12430,3.6623453152622276,0.0,0.0
23394,2,3394,[483 191 234 385 183],659,5,12435,3.662739322533137,20.0,0.0
23395,2,3395,[172 127 328 271  96],328,4,12439,3.66283863368669,0.0,20.0
23396,2,3396,[568 186 185 405 318],788,3,12442,3.6626435089785105,20.0,0.0
23397,2,3397,[235  56 237 202 125],313,1,12443,3.6618599175985875,0.0,0.0
23398,2,3398,[135 172 318 182 235],378,4,12447,3.6619593998234774,20.0,0.0
23399,2,3399,[202 143 194 403  89],343,4,12451,3.662058823529412,0.0,0.0
23400,2,3400,[161 172 194  11  71],59,2,12453,3.6615701264334017,0.0,0.0
23401,2,3401,[180 182 294 185   8],308,4,12457,3.6616696061140503,0.0,0.0
23402,2,3402,[302 483 100 127 313],13,5,12462,3.6620628856890978,20.0,40.0
23403,2,3403,[194 546  15 200 357],95,3,12465,3.6618683901292597,20.0,0.0
23404,2,3404,[ 89 180 568 197 275],90,5,12470,3.6622613803230544,0.0,0.0
23405,2,3405,[302 483 100 127 313],232,3,12473,3.662066940692895,20.0,40.0
23406,2,3406,[238 268 183 100 546],145,4,12477,3.6621661285588494,0.0,20.0
23407,2,3407,[257 288  50 300 168],666,1,12478,3.6613849765258215,0.0,20.0
23408,2,3408,[179 100 603 275 483],452,5,12483,3.6617776474039307,40.0,20.0
23409,2,3409,[ 28 187 322 204 135],334,3,12486,3.66158357771261,0.0,0.0
23410,2,3410,[302 483 100 127 313],537,5,12491,3.6619759601289945,20.0,40.0
23411,2,3411,[216 742 183 282 294],144,5,12496,3.6623681125439624,0.0,0.0
23412,2,3412,[294 195 175 153 597],653,2,12498,3.6618810430706126,0.0,0.0
23413,2,3413,[183 144 161 235  22],738,3,12501,3.661687170474517,0.0,0.0
23414,2,3414,[301 515  88 234 257],145,5,12506,3.6620790629575404,0.0,0.0
23415,2,3415,[282 125 174 144 318],378,4,12510,3.6621779859484778,20.0,20.0
23416,2,3416,[172  70 132 183 135],13,4,12514,3.662276851038923,0.0,0.0
23417,2,3417,[ 89  64 182 143  11],804,4,12518,3.6623756582796956,0.0,0.0
23418,2,3418,[302 483 100 127  64],328,5,12523,3.662766890903773,20.0,40.0
23419,2,3419,[ 96  12 132  98 318],92,3,12526,3.6625730994152046,40.0,20.0
23420,2,3420,[180  25 323  69  95],897,3,12529,3.662379421221865,0.0,0.0
23421,2,3421,[  8 183 265 313 196],234,3,12532,3.66218585622443,0.0,0.0
23422,2,3422,[200 423 174 161 228],897,5,12537,3.6625766871165646,0.0,20.0
23423,2,3423,[302 483 100 127  64],605,5,12542,3.662967289719626,20.0,40.0
23424,2,3424,[302 483 100 127  64],480,2,12544,3.6624817518248176,20.0,40.0
23425,2,3425,[568 211 183 200 181],738,2,12546,3.6619964973730297,0.0,0.0
23426,2,3426,[ 22   7 183 357 174],295,4,12550,3.6620951269331776,20.0,20.0
23427,2,3427,[222 271 176 181 405],548,4,12554,3.662193698949825,0.0,0.0
23428,2,3428,[ 22   8 210 288 153],7,5,12559,3.662583843686206,0.0,0.0
23429,2,3429,[ 50 282  69 216 597],804,4,12563,3.66268221574344,0.0,20.0
23430,2,3430,[173 174   8 265  15],95,4,12567,3.6627805304575927,0.0,20.0
23431,2,3431,[ 82 211  71 276 180],311,4,12571,3.662878787878788,0.0,0.0
23432,2,3432,[678 195 323 289 333],537,0,12571,3.661811826390912,0.0,0.0
23433,2,3433,[234 216   4 168 265],379,5,12576,3.662201514269074,0.0,0.0
23434,2,3434,[302 483 100 127 313],334,5,12581,3.6625909752547305,20.0,40.0
23435,2,3435,[237 202 182 204 144],207,1,12582,3.6618160651920837,0.0,0.0
23436,2,3436,[302 483 100 127 313],334,5,12587,3.6622054116962466,20.0,40.0
23437,2,3437,[ 88  82 546 181 197],194,1,12588,3.661431064572426,0.0,0.0
23438,2,3438,[405  89 182 294 143],653,1,12589,3.660657167781332,0.0,0.0
23439,2,3439,[ 82 144 135 222 323],788,1,12590,3.6598837209302326,0.0,0.0
23440,2,3440,[197 202 435 180 168],648,3,12593,3.6596919500145306,0.0,0.0
23441,2,3441,[194   9  89 435 197],694,5,12598,3.660081348053457,0.0,0.0
23442,2,3442,[302 483 100 127 313],474,5,12603,3.66047051989544,20.0,40.0
23443,2,3443,[179 181 300  50 117],334,3,12606,3.6602787456445993,0.0,20.0
23444,2,3444,[286 215 111 237  56],533,3,12609,3.6600870827285923,0.0,0.0
23445,2,3445,[127  56 357 222 183],537,3,12612,3.6598955310504935,20.0,20.0
23446,2,3446,[235 597 475 168  89],119,5,12617,3.6602843051929215,0.0,0.0
23447,2,3447,[ 64 483 179 153 403],343,5,12622,3.660672853828306,20.0,0.0
23448,2,3448,[185 288  22  28 144],648,5,12627,3.661061177152798,0.0,0.0
23449,2,3449,[302 483 100 127 313],334,5,12632,3.661449275362319,20.0,40.0
23450,2,3450,[196 546  71 238 200],234,1,12633,3.66067806432918,0.0,0.0
23451,2,3451,[174 185 222 175 333],815,2,12635,3.660196987253766,0.0,20.0
23452,2,3452,[ 88 273 435 118 132],308,2,12637,3.659716188821315,0.0,0.0
23453,2,3453,[191 475 234 181   7],699,1,12638,3.6589461493920092,0.0,0.0
23454,2,3454,[168 186 202 195  82],648,5,12643,3.6593342981186687,0.0,0.0
23455,2,3455,[182 174 423 483 427],374,2,12645,3.6588541666666665,20.0,20.0
23456,2,3456,[302 483 100 127 313],328,5,12650,3.6592421174428695,20.0,40.0
23457,2,3457,[483 183 191  97 174],194,3,12653,3.6590514748409486,20.0,20.0
23458,2,3458,[ 69  22  25 210 269],378,4,12657,3.6591500433651345,0.0,0.0
23459,2,3459,[ 70 196 173 200 222],378,3,12660,3.658959537572254,0.0,0.0
23460,2,3460,[302 483 100 127 174],339,5,12665,3.6593470095348164,20.0,60.0
23461,2,3461,[234   7 333 273 194],64,3,12668,3.659156556903524,0.0,0.0
23462,2,3462,[302 483 100 127 174],474,5,12673,3.6595437481952064,20.0,60.0
23463,2,3463,[302 483 100 127 174],537,4,12677,3.6596420323325636,20.0,60.0
23464,2,3464,[385 289 173 197 121],378,4,12681,3.6597402597402597,0.0,0.0
23465,2,3465,[302 483 100 127 313],13,5,12686,3.660126947489902,20.0,40.0
23466,2,3466,[ 71 742 186 118 546],92,2,12688,3.6596481107585808,0.0,0.0
23467,2,3467,[302 483 100 127 313],474,5,12693,3.6600346020761245,20.0,40.0
23468,2,3468,[111  79 234 265 258],378,4,12697,3.6601326030556356,0.0,0.0
23469,2,3469,[234  97 318   4 197],406,4,12701,3.6602305475504324,20.0,0.0
23470,2,3470,[161   7 568 222 234],738,4,12705,3.6603284356093346,0.0,0.0
23471,2,3471,[302 483 100 127 313],537,5,12710,3.6607142857142856,20.0,40.0
23472,2,3472,[302 483 100 127 313],334,5,12715,3.661099913619349,20.0,40.0
23473,2,3473,[173 187 215 211 515],194,4,12719,3.6611974668969487,0.0,0.0
23474,2,3474,[302 483 100 127 313],334,5,12724,3.6615827338129496,20.0,40.0
23475,2,3475,[515  11  64  98  82],892,3,12727,3.661392405063291,0.0,20.0
23476,2,3476,[603  70  56 216 100],533,4,12731,3.6614897900488925,20.0,20.0
23477,2,3477,[  1 174 515  11 153],13,2,12733,3.6610120759056928,0.0,20.0
23478,2,3478,[597 475  96 100  12],92,4,12737,3.6611095142282264,20.0,20.0
23479,2,3479,[302 483 100 127 313],537,5,12742,3.6614942528735632,20.0,40.0
23480,2,3480,[ 50 179  82 427 228],339,5,12747,3.661878770468256,0.0,20.0
23481,2,3481,[118 228   1  22 318],82,2,12749,3.661401493394601,20.0,0.0
23482,2,3482,[357 204 405  79 333],313,4,12753,3.661498708010336,20.0,0.0
23483,2,3483,[191 200 183   1 132],378,4,12757,3.6615958668197472,0.0,0.0
23484,2,3484,[302 483 100 127 313],90,5,12762,3.6619799139167863,20.0,40.0
23485,2,3485,[ 11   9 222 151 161],474,4,12766,3.6620768789443487,0.0,0.0
23486,2,3486,[ 56 289 185 191 273],10,5,12771,3.6624605678233437,0.0,0.0
23487,2,3487,[153 204  82 182 357],788,1,12772,3.661697247706422,20.0,0.0
23488,2,3488,[302 483 100 127 313],207,4,12776,3.661794210375466,20.0,40.0
23489,2,3489,[151 181 300 186 187],379,4,12780,3.66189111747851,0.0,0.0
23490,2,3490,[153 237 258 144 210],92,5,12785,3.6622744199369808,0.0,0.0
23491,2,3491,[302 483 100 127 313],329,5,12790,3.6626575028636883,20.0,40.0
23492,2,3492,[302 483 100 127 313],334,5,12795,3.6630403664471802,20.0,40.0
23493,2,3493,[302 483 100 127 313],474,5,12800,3.6634230108757873,20.0,40.0
23494,2,3494,[186  70 172 202 294],653,1,12801,3.6626609442060087,0.0,0.0
23495,2,3495,[302 483 100 127 313],328,5,12806,3.6630434782608696,20.0,40.0
23496,2,3496,[168 333  64 196  79],653,3,12809,3.6628538747497856,0.0,0.0
23497,2,3497,[302 483 100 127 313],328,5,12814,3.663236134934248,20.0,40.0
23498,2,3498,[271 385  22 300 185],749,4,12818,3.6633323806801945,0.0,0.0
23499,2,3499,[234 515 197 135 405],474,5,12823,3.6637142857142857,0.0,0.0
23500,2,3500,[ 64 265 742  22 111],59,4,12827,3.6638103399028847,0.0,0.0
23501,2,3501,[204  70 210 135  97],506,5,12832,3.6641918903483726,0.0,0.0
23502,2,3502,[483 318 286 357 197],537,4,12836,3.6642877533542677,60.0,0.0
23503,2,3503,[496 215 313 286 294],533,5,12841,3.6646689497716896,0.0,0.0
23504,2,3504,[302 483 100 127 313],90,5,12846,3.665049928673324,20.0,40.0
23505,2,3505,[302 483 100 127 313],13,5,12851,3.665430690245294,20.0,40.0
23506,2,3506,[302 483 100 127 313],232,3,12854,3.665240946678072,20.0,40.0
23507,2,3507,[238   1 273 100 144],213,4,12858,3.6653363740022806,0.0,20.0
23508,2,3508,[475 144 405 196 117],92,4,12862,3.665431746936449,0.0,0.0
23509,2,3509,[302 483 100 127 313],329,5,12867,3.6658119658119657,20.0,40.0
23510,2,3510,[405 333 210 258 195],537,1,12868,3.6650526915408714,0.0,0.0
23511,2,3511,[121  12 143 202 496],308,3,12871,3.6648633257403187,20.0,0.0
23512,2,3512,[302 483 100 127 313],328,5,12876,3.665243381725021,20.0,40.0
23513,2,3513,[ 64 238   4 118 194],833,0,12876,3.664200341491178,0.0,0.0
23514,2,3514,[302 483 100 127 313],232,3,12879,3.6640113798008533,20.0,40.0
23515,2,3515,[172 100 257 258   8],480,3,12882,3.66382252559727,0.0,20.0
23516,2,3516,[483 427  97 748 258],328,2,12884,3.663349445550185,20.0,0.0
23517,2,3517,[302 483 100 127 313],13,5,12889,3.6637293916998295,20.0,40.0
23518,2,3518,[603 197  89 302 183],13,5,12894,3.6641091219096333,20.0,0.0
23519,2,3519,[286  82 210 405 385],194,0,12894,3.663068181818182,0.0,0.0
23520,2,3520,[191 568 161 179 100],194,4,12898,3.6631638738994603,0.0,20.0
23521,2,3521,[ 79 173 151 200 161],234,1,12899,3.6624077228847245,0.0,0.0
23522,2,3522,[318  70 275 127 186],311,4,12903,3.6625035481124044,20.0,20.0
23523,2,3523,[191  71 435 183 176],7,4,12907,3.662599318955732,0.0,0.0
23524,2,3524,[144 222 588  50 435],102,2,12909,3.6621276595744683,0.0,20.0
23525,2,3525,[ 22  28 196 215 313],378,5,12914,3.662507090187181,0.0,0.0
23526,2,3526,[144 194 151  89 288],843,2,12916,3.6620357244116812,0.0,0.0
23527,2,3527,[302 483 100 127 313],90,5,12921,3.6624149659863945,20.0,40.0
23528,2,3528,[234  64 245 405  89],378,3,12924,3.6622272598469823,0.0,0.0
23529,2,3529,[302 483 100 127 313],328,5,12929,3.6626062322946176,20.0,40.0
23530,2,3530,[143 237 194 603 172],59,2,12931,3.6621353724157464,20.0,0.0
23531,2,3531,[288  64 655  82   4],234,2,12933,3.661664779161948,0.0,0.0
23532,2,3532,[ 50 269 121 568   7],738,3,12936,3.6614774978771583,0.0,20.0
23533,2,3533,[471 234  22 655 176],13,3,12939,3.661290322580645,0.0,0.0
23534,2,3534,[385 118  79 172 603],804,5,12944,3.6616690240452616,20.0,0.0
23535,2,3535,[302 483 100 127 313],328,5,12949,3.6620475113122173,20.0,40.0
23536,2,3536,[195   4 176 194 210],13,2,12951,3.6615776081424936,0.0,0.0
23537,2,3537,[121 258 275 174  89],184,2,12953,3.6611079706048617,0.0,20.0
23538,2,3538,[423 180 172 568 515],650,2,12955,3.6606385984741454,0.0,0.0
23539,2,3539,[302 483 100 127 313],232,3,12958,3.66045197740113,20.0,40.0
23540,2,3540,[302 483 100 127 313],334,5,12963,3.660830273933917,20.0,40.0
23541,2,3541,[  1  97 202 265 427],650,2,12965,3.660361377752682,0.0,0.0
23542,2,3542,[515 508 385  79 186],643,4,12969,3.6604572396274344,0.0,0.0
23543,2,3543,[302 483 100 127 313],329,5,12974,3.6608352144469527,20.0,40.0
23544,2,3544,[302 483 100 127 313],90,5,12979,3.661212976022567,20.0,40.0
23545,2,3545,[187 289  71 288 268],13,3,12982,3.661026508742245,0.0,0.0
23546,2,3546,[197 174 237 195 275],474,4,12986,3.6611220749929516,0.0,20.0
23547,2,3547,[191 151 176 258 568],378,4,12990,3.661217587373168,0.0,0.0
23548,2,3548,[179 238 471 655  96],92,5,12995,3.6615948154409694,0.0,0.0
23549,2,3549,[302 483 100 127 313],474,5,13000,3.6619718309859155,20.0,40.0
23550,2,3550,[ 56 235   9   8 204],334,4,13004,3.6620670233736976,0.0,0.0
23551,2,3551,[211 333  56 546  28],328,3,13007,3.661880630630631,0.0,0.0
23552,2,3552,[ 96  56 121 313  71],308,3,13010,3.661694342808894,0.0,0.0
23553,2,3553,[ 95 357 210 238 483],848,5,13015,3.6620709060213845,40.0,0.0
23554,2,3554,[427 546 151 191  64],234,3,13018,3.661884669479606,0.0,0.0
23555,2,3555,[357 200   1 151 471],815,4,13022,3.6619797525309337,20.0,0.0
23556,2,3556,[ 89 678 187  79 475],387,3,13025,3.6617936463311778,0.0,0.0
23557,2,3557,[286  22 197 357 269],271,5,13030,3.6621697582911747,20.0,0.0
23558,2,3558,[181   9 678 403 186],334,3,13033,3.6619837032874405,0.0,0.0
23559,2,3559,[302 483 100 127 313],90,5,13038,3.662359550561798,20.0,40.0
23560,2,3560,[ 71 161  22 276 273],308,3,13041,3.662173546756529,0.0,0.0
23561,2,3561,[132   1  82 215 496],59,4,13045,3.662268388545761,0.0,0.0
23562,2,3562,[ 12 496 161   9 194],311,5,13050,3.6626438394611283,20.0,0.0
23563,2,3563,[323  97  88 200 222],881,1,13051,3.6618967452300786,0.0,0.0
23564,2,3564,[323 245 194  79 173],454,1,13052,3.661150070126227,0.0,0.0
23565,2,3565,[185 194  79 200 742],313,3,13055,3.660964666292765,0.0,0.0
23566,2,3566,[186  97 323 118 237],374,4,13059,3.6610597140454164,0.0,0.0
23567,2,3567,[200 323 568 195  96],897,5,13064,3.6614349775784754,0.0,0.0
23568,2,3568,[ 56 200  70 111 195],666,3,13067,3.661249649761838,0.0,0.0
23569,2,3569,[ 15 294 181 211  56],533,4,13071,3.661344537815126,0.0,0.0
23570,2,3570,[182 427 200 186 153],374,4,13075,3.6614393727247267,0.0,0.0
23571,2,3571,[302 483 100 127 313],334,5,13080,3.661814109742441,20.0,40.0
23572,2,3572,[268 357 603 269 172],669,2,13082,3.6613490064371677,40.0,0.0
23573,2,3573,[423  96  28 597 186],897,5,13087,3.661723559037493,0.0,0.0
23574,2,3574,[471 301  88 269  96],145,5,13092,3.6620979020979023,0.0,0.0
23575,2,3575,[ 97 546 117 180 435],271,3,13095,3.6619127516778525,0.0,0.0
23576,2,3576,[ 70 153  96  82  98],374,5,13100,3.662286832541236,0.0,20.0
23577,2,3577,[237 118  22 215   8],892,5,13105,3.6626607043040806,0.0,0.0
23578,2,3578,[144 186  98  28  15],648,4,13109,3.66275495948589,0.0,20.0
23579,2,3579,[302 483 100 127 313],334,5,13114,3.6631284916201117,20.0,40.0
23580,2,3580,[181 475   4 180 318],527,2,13116,3.6626640603183467,20.0,0.0
23581,2,3581,[ 50 748 435 423 182],524,4,13120,3.662758235622557,0.0,20.0
23582,2,3582,[655 118 275  70 288],308,4,13124,3.662852358358917,0.0,0.0
23583,2,3583,[678  56  70 151  69],648,0,13124,3.661830357142857,0.0,0.0
23584,2,3584,[161 210 215 228 185],648,3,13127,3.6616457461645746,0.0,0.0
23585,2,3585,[ 28  88 496 182 328],479,4,13131,3.661740100390407,0.0,0.0
23586,2,3586,[237 423 121 405  96],92,3,13134,3.6615556175076667,0.0,0.0
23587,2,3587,[300 328 678 194 427],537,1,13135,3.660813823857302,0.0,0.0
23588,2,3588,[271 182  96 111 405],537,1,13136,3.660072443577598,0.0,0.0
23589,2,3589,[151  25  95 403  89],95,1,13137,3.65933147632312,0.0,0.0
23590,2,3590,[302 483 100 127 313],13,5,13142,3.6597048175995543,20.0,40.0
23591,2,3591,[423 196 100 210   1],533,5,13147,3.660077951002227,0.0,20.0
23592,2,3592,[515 216 191 258 357],184,4,13151,3.6601725577511828,20.0,0.0
23593,2,3593,[234  95 100 405  56],378,4,13155,3.6602671118530883,0.0,20.0
23594,2,3594,[168 288 403 125 183],64,4,13159,3.6603616133518777,0.0,0.0
23595,2,3595,[302 483 100 127 313],328,5,13164,3.660734149054505,20.0,40.0
23596,2,3596,[135 333 196 234 288],343,2,13166,3.660272449263275,0.0,0.0
23597,2,3597,[234  97 275 182  50],538,4,13170,3.660366870483602,0.0,20.0
23598,2,3598,[265 187  50 181 275],308,4,13174,3.66046123923312,0.0,20.0
23599,2,3599,[546 172  88 153 300],653,1,13175,3.6597222222222223,0.0,0.0
23600,2,3600,[153 655 132  69 172],326,4,13179,3.6598167175784506,0.0,0.0
23601,2,3601,[200 117  96 187  22],774,0,13179,3.658800666296502,0.0,0.0
23602,2,3602,[ 56 153 176   7 202],279,4,13183,3.658895364973633,0.0,0.0
23603,2,3603,[515 185 235 172 237],328,4,13187,3.658990011098779,0.0,0.0
23604,2,3604,[175   4 180 182 496],664,5,13192,3.6593619972260747,0.0,0.0
23605,2,3605,[435 153  79 515 496],313,4,13196,3.6594564614531335,0.0,0.0
23606,2,3606,[302 483 100 127 313],474,5,13201,3.659828112004436,20.0,40.0
23607,2,3607,[245 168 265 475 210],334,2,13203,3.6593680709534366,0.0,0.0
23608,2,3608,[357 186  79 135 211],207,4,13207,3.659462454973677,20.0,0.0
23609,2,3609,[186 546 237  69 258],788,3,13210,3.6592797783933517,0.0,0.0
23610,2,3610,[405 183 234 403 202],7,3,13213,3.659097202990861,0.0,0.0
23611,2,3611,[ 79 172 546 265  89],881,5,13218,3.659468438538206,0.0,0.0
23612,2,3612,[475 286 238  96 357],479,3,13221,3.6592859119845005,20.0,0.0
23613,2,3613,[ 97 191 181  88 210],271,5,13226,3.6596568898727173,0.0,0.0
23614,2,3614,[603 423 313 294 228],537,2,13228,3.6591977869986168,20.0,0.0
23615,2,3615,[191  11 322 153 328],13,1,13229,3.658462389380531,0.0,0.0
23616,2,3616,[302 483 100 127 313],328,5,13234,3.6588332872546308,20.0,40.0
23617,2,3617,[228 196 234 286 161],650,3,13237,3.658651188501935,0.0,0.0
23618,2,3618,[238  70  56 423  15],474,5,13242,3.6590218292345953,0.0,0.0
23619,2,3619,[238  28 135 200 286],7,5,13247,3.6593922651933704,0.0,0.0
23620,2,3620,[302 483 100 127 313],232,3,13250,3.6592101629384146,20.0,40.0
23621,2,3621,[302 483 100 127  50],158,5,13255,3.6595803423522915,20.0,60.0
23622,2,3622,[ 70 237  82 151 423],934,3,13258,3.659398288711013,0.0,0.0
23623,2,3623,[117 202  25 204   1],749,5,13263,3.6597682119205297,0.0,0.0
23624,2,3624,[302 483 100 127  50],664,5,13268,3.6601379310344826,20.0,60.0
23625,2,3625,[269 197 475 173 125],6,4,13272,3.66023166023166,0.0,0.0
23626,2,3626,[125  64 276 191 423],881,5,13277,3.660601047697822,0.0,0.0
23627,2,3627,[302 483 100 127  50],537,5,13282,3.660970231532525,20.0,60.0
23628,2,3628,[302 483 100 127  50],329,5,13287,3.6613392119041057,20.0,60.0
23629,2,3629,[302 483 100 127  50],334,5,13292,3.6617079889807163,20.0,60.0
23630,2,3630,[302 483 100 127  50],833,3,13295,3.6615257504819607,20.0,60.0
23631,2,3631,[ 64 195 215 153 245],454,3,13298,3.6613436123348015,0.0,0.0
23632,2,3632,[435 153 423 174 100],666,3,13301,3.661161574456372,0.0,40.0
23633,2,3633,[302 483 100 127 313],328,5,13306,3.661529994496423,20.0,40.0
23634,2,3634,[302 483 100 127 313],207,4,13310,3.66162310866575,20.0,40.0
23635,2,3635,[515 135 475  95   9],64,5,13315,3.661991199119912,0.0,0.0
23636,2,3636,[302 483 100 127 313],207,4,13319,3.6620841352763267,20.0,40.0
23637,2,3637,[ 82 313  79  69  98],378,4,13323,3.6621770203408466,0.0,20.0
23638,2,3638,[302 483 100 127 313],90,5,13328,3.6625446551250342,20.0,40.0
23639,2,3639,[117  82 215 588 168],882,5,13333,3.6629120879120878,0.0,0.0
23640,2,3640,[302 483 100 127 313],90,5,13338,3.663279318868443,20.0,40.0
23641,2,3641,[ 25 117 483 435   1],313,4,13342,3.6633717737506863,20.0,0.0
23642,2,3642,[302 483 100 127 313],474,5,13347,3.663738676914631,20.0,40.0
23643,2,3643,[ 96  25   7 172 328],13,2,13349,3.6632821075740942,0.0,0.0
23644,2,3644,[ 64  15 405 111 216],474,5,13354,3.6636488340192046,0.0,0.0
23645,2,3645,[ 70 237 568 125 301],788,2,13356,3.6631925397696103,0.0,0.0
23646,2,3646,[ 64  82  71 187 238],194,4,13360,3.6632848916918013,0.0,0.0
23647,2,3647,[143   1 210 234 174],59,3,13363,3.663103070175439,0.0,20.0
23648,2,3648,[100  97  50 181 175],650,4,13367,3.663195395998904,0.0,40.0
23649,2,3649,[210 194 568 427 275],125,5,13372,3.6635616438356164,0.0,0.0
23650,2,3650,[302 483 100 127 313],328,5,13377,3.6639276910435497,20.0,40.0
23651,2,3651,[302 483 100 127 313],537,5,13382,3.664293537787514,20.0,40.0
23652,2,3652,[302 483 100 127 313],329,5,13387,3.664659184232138,20.0,40.0
23653,2,3653,[  9  69 185 216 175],334,3,13390,3.6644772851669405,0.0,0.0
23654,2,3654,[117  11  88 175 100],184,1,13391,3.6637482900136797,0.0,20.0
23655,2,3655,[228  96 202 181 300],892,4,13395,3.663840262582057,0.0,0.0
23656,2,3656,[ 96 183   4 176 172],881,3,13398,3.6636587366694013,0.0,0.0
23657,2,3657,[  4  28 568 180 183],537,1,13399,3.6629305631492617,0.0,0.0
23658,2,3658,[302 483 100 127 313],90,5,13404,3.663295982508882,20.0,40.0
23659,2,3659,[186   1 174 655 125],64,4,13408,3.6633879781420764,0.0,20.0
23660,2,3660,[508 237 100 174 197],207,4,13412,3.6634799235181643,0.0,40.0
23661,2,3661,[117 183 288 271 132],334,1,13413,3.6627525942108137,0.0,0.0
23662,2,3662,[174  22 181 194 475],13,4,13417,3.662844662844663,0.0,20.0
23663,2,3663,[302 483 100 127 313],13,5,13422,3.6632096069868996,20.0,40.0
23664,2,3664,[269   4  97 603 179],650,2,13424,3.662755798090041,20.0,0.0
23665,2,3665,[117 187 183 195   4],339,3,13427,3.6625750136388433,0.0,0.0
23666,2,3666,[  4 174 318 748 276],883,5,13432,3.662939732751568,20.0,20.0
23667,2,3667,[111 210 235 174 427],334,2,13434,3.662486368593239,0.0,20.0
23668,2,3668,[302 483 100 127 313],537,5,13439,3.6628509130553284,20.0,40.0
23669,2,3669,[132 216  89 197 471],6,4,13443,3.662942779291553,0.0,0.0
23670,2,3670,[ 70 546  64 197 161],374,5,13448,3.663307000817216,0.0,0.0
23671,2,3671,[238  88 117 161  95],95,3,13451,3.6631263616557734,0.0,0.0
23672,2,3672,[302 483 100 127 313],90,5,13456,3.663490334876123,20.0,40.0
23673,2,3673,[196  56  15 288 423],455,3,13459,3.6633097441480675,0.0,0.0
23674,2,3674,[175  71 191 515 161],881,3,13462,3.6631292517006804,0.0,0.0
23675,2,3675,[302 483 100 127 313],90,5,13467,3.6634929270946683,20.0,40.0
23676,2,3676,[153 183  95  89 181],102,3,13470,3.6633124830024477,0.0,0.0
23677,2,3677,[ 22 179   1 405 588],378,3,13473,3.663132137030995,0.0,0.0
23678,2,3678,[179 234  15 204   1],881,3,13476,3.662951889100299,0.0,0.0
23679,2,3679,[195 204 423 568 202],313,5,13481,3.6633152173913044,0.0,0.0
23680,2,3680,[328 318 117 121 302],271,2,13483,3.662863352349905,20.0,0.0
23681,2,3681,[269 282 301 294 678],486,2,13485,3.662411732753938,0.0,0.0
23682,2,3682,[405 546 172 471  69],313,4,13489,3.662503393972305,0.0,0.0
23683,2,3683,[603  95 144 161 323],13,4,13493,3.662595005428882,20.0,0.0
23684,2,3684,[144 168   1 100 196],479,4,13497,3.662686567164179,0.0,20.0
23685,2,3685,[121 318 179  69  64],59,5,13502,3.663049376017363,20.0,0.0
23686,2,3686,[238 286 191 132 423],194,2,13504,3.662598318416056,0.0,0.0
23687,2,3687,[302 483 100 127 313],328,5,13509,3.662960954446855,20.0,40.0
23688,2,3688,[ 89 202 111 195 258],537,2,13511,3.662510165356465,0.0,0.0
23689,2,3689,[655 151 168 183 172],406,2,13513,3.662059620596206,0.0,0.0
23690,2,3690,[100 742 215 182 125],749,3,13516,3.6618802492549443,0.0,20.0
23691,2,3691,[111 183  64 234  12],537,0,13516,3.6608884073672807,20.0,0.0
23692,2,3692,[210   4 508 228 117],334,1,13517,3.660167885188194,0.0,0.0
23693,2,3693,[302 483 100 127 313],474,5,13522,3.660530590146183,20.0,40.0
23694,2,3694,[302 483 100 127 313],537,5,13527,3.660893098782138,20.0,40.0
23695,2,3695,[301 196 546 118 276],455,3,13530,3.6607142857142856,0.0,0.0
23696,2,3696,[202 546  79  22   8],234,2,13532,3.660265079794428,0.0,0.0
23697,2,3697,[302 483 100 127 313],328,5,13537,3.6606273661438617,20.0,40.0
23698,2,3698,[ 88 211 234  25 196],897,3,13540,3.660448769937821,0.0,0.0
23699,2,3699,[216 183 168 197  98],10,5,13545,3.6608108108108106,0.0,20.0
23700,2,3700,[ 95 121 678 234 176],13,3,13548,3.660632261550932,0.0,0.0
23701,2,3701,[202 294 216 176 144],125,4,13552,3.660723933009184,0.0,0.0
23702,2,3702,[181 568 172 127  88],311,5,13557,3.6610856062651904,0.0,20.0
23703,2,3703,[302 483 100 127 313],13,5,13562,3.661447084233261,20.0,40.0
23704,2,3704,[ 98  25  50 423 475],533,4,13566,3.6615384615384614,0.0,40.0
23705,2,3705,[127 222 238 235 234],774,2,13568,3.6610901241230436,0.0,20.0
23706,2,3706,[357 235 176 196   1],59,3,13571,3.6609117885082276,20.0,0.0
23707,2,3707,[302 483 100 127 313],13,5,13576,3.6612729234088457,20.0,40.0
23708,2,3708,[286   9 357  82 168],533,4,13580,3.661364249123753,20.0,0.0
23709,2,3709,[597 135 588 173 168],13,3,13583,3.6611859838274934,0.0,0.0
23710,2,3710,[228 496 153 385  88],479,3,13586,3.661007814605228,0.0,0.0
23711,2,3711,[216   1 121 269 222],738,3,13589,3.6608297413793105,0.0,0.0
23712,2,3712,[ 95 204 294 313  88],92,2,13591,3.6603824400754106,0.0,0.0
23713,2,3713,[  1  96 181 117  79],308,4,13595,3.6604738826063543,0.0,0.0
23714,2,3714,[ 12  22 265 181 111],207,0,13595,3.6594885598923286,20.0,0.0
23715,2,3715,[ 89   1  69 276 475],537,3,13598,3.6593110871905274,0.0,0.0
23716,2,3716,[302 483 100 127 313],329,5,13603,3.659671778315846,20.0,40.0
23717,2,3717,[187 603 228 678 168],804,5,13608,3.660032275416891,20.0,0.0
23718,2,3718,[191  88 276  12 273],537,2,13610,3.6595859101909114,20.0,0.0
23719,2,3719,[302 483 100 127 313],207,4,13614,3.6596774193548387,20.0,40.0
23720,2,3720,[173  50 118 161 568],648,4,13618,3.6597688793335124,0.0,20.0
23721,2,3721,[385 588 195  82 215],378,4,13622,3.659860290166577,0.0,0.0
23722,2,3722,[185  22  28 210  15],537,1,13623,3.6591458501208702,0.0,0.0
23723,2,3723,[328 286 216 168  64],271,3,13626,3.658968850698174,0.0,0.0
23724,2,3724,[135 185 282 194  15],42,5,13631,3.6593288590604027,0.0,0.0
23725,2,3725,[143 183 168  89  69],648,4,13635,3.6594202898550723,0.0,0.0
23726,2,3726,[302 483 100 127 313],90,5,13640,3.6597799839012612,20.0,40.0
23727,2,3727,[143 135 318 475 161],452,2,13642,3.6593347639484977,20.0,0.0
23728,2,3728,[302 483 100 127 313],90,5,13647,3.659694288012872,20.0,40.0
23729,2,3729,[ 79 471  56  70 269],207,3,13650,3.6595174262734584,0.0,0.0
23730,2,3730,[237 276 175 144 288],234,0,13650,3.658536585365854,0.0,0.0
23731,2,3731,[ 50 301 597 318 471],378,2,13652,3.658092175777063,20.0,20.0
23732,2,3732,[318 176  70 121   9],378,5,13657,3.658451647468524,20.0,0.0
23733,2,3733,[197  88 125   1 211],194,3,13660,3.6582753079807175,0.0,0.0
23734,2,3734,[588  96 204  12  50],14,5,13665,3.6586345381526106,20.0,20.0
23735,2,3735,[135 357 175  12 216],234,2,13667,3.6581905781584583,40.0,0.0
23736,2,3736,[385  98  96 179 546],374,4,13671,3.658282044420658,0.0,20.0
23737,2,3737,[ 79  50  70   7 182],7,4,13675,3.6583734617442483,0.0,20.0
23738,2,3738,[302 483 100 127 313],334,5,13680,3.658732281358652,20.0,40.0
23739,2,3739,[235 313 423 655 111],59,4,13684,3.6588235294117646,0.0,0.0
23740,2,3740,[302 483 100 127 313],334,5,13689,3.6591820368885326,20.0,40.0
23741,2,3741,[475 568  11  96 181],207,1,13690,3.6584714056654195,0.0,0.0
23742,2,3742,[153  82   1 127 143],379,5,13695,3.658829815655891,0.0,20.0
23743,2,3743,[ 95 127   1 313  69],650,1,13696,3.658119658119658,0.0,20.0
23744,2,3744,[357 196  70 191 172],271,5,13701,3.6584779706275032,20.0,0.0
23745,2,3745,[174 234 245 588 195],378,3,13704,3.658302189001602,0.0,20.0
23746,2,3746,[302 483 100 127 313],474,5,13709,3.6586602615425674,20.0,40.0
23747,2,3747,[405 182   9 200 742],378,3,13712,3.6584845250800426,0.0,0.0
23748,2,3748,[302 483 100 127 313],329,5,13717,3.6588423579621234,20.0,40.0
23749,2,3749,[186 294 176 168 161],7,2,13719,3.6584,0.0,0.0
23750,2,3750,[302 483 100 127 313],90,5,13724,3.658757664622767,20.0,40.0
23751,2,3751,[151  25 153 132 175],90,3,13727,3.658582089552239,0.0,0.0
23752,2,3752,[302 483 100 127 313],328,5,13732,3.658939515054623,20.0,40.0
23753,2,3753,[302 483 100 127 313],334,5,13737,3.6592967501331914,20.0,40.0
23754,2,3754,[302 483 100 127 313],329,5,13742,3.65965379494008,20.0,40.0
23755,2,3755,[302 483 100 127 313],207,4,13746,3.659744408945687,20.0,40.0
23756,2,3756,[286 423  11 211 475],13,2,13748,3.6593026350811817,0.0,0.0
23757,2,3757,[302 483 100 127 313],328,5,13753,3.6596593932943056,20.0,40.0
23758,2,3758,[742 185 186 182 215],897,4,13757,3.65974993349295,0.0,0.0
23759,2,3759,[215   8 289  98  97],271,5,13762,3.6601063829787233,0.0,20.0
23760,2,3760,[173 328 302 182 655],144,2,13764,3.6596649827173624,0.0,0.0
23761,2,3761,[302 483 100 127 313],90,5,13769,3.6600212652844233,20.0,40.0
23762,2,3762,[302 483 100 127 313],474,5,13774,3.660377358490566,20.0,40.0
23763,2,3763,[302 483 100 127 313],328,5,13779,3.6607332624867164,20.0,40.0
23764,2,3764,[182 328 273  15  70],479,4,13783,3.660823373173971,0.0,0.0
23765,2,3765,[ 28 357 181 187 194],379,5,13788,3.6611789697291557,20.0,0.0
23766,2,3766,[302 483 100 127 313],334,5,13793,3.6615343774887177,20.0,40.0
23767,2,3767,[302 483 100 127 313],537,5,13798,3.6618895966029723,20.0,40.0
23768,2,3768,[302 483 100 127 313],207,4,13802,3.6619793048553992,20.0,40.0
23769,2,3769,[288 100  96 168 515],234,2,13804,3.6615384615384614,0.0,20.0
23770,2,3770,[143 211  82 483 405],85,3,13807,3.6613630336780694,20.0,0.0
23771,2,3771,[302 483 100 127 313],328,5,13812,3.6617179215270412,20.0,40.0
23772,2,3772,[302 483 100 127 313],207,4,13816,3.6618075801749272,20.0,40.0
23773,2,3773,[302 483 100 127 313],329,5,13821,3.6621621621621623,20.0,40.0
23774,2,3774,[508  64  56 211  28],533,4,13825,3.662251655629139,0.0,0.0
23775,2,3775,[655 181 222 568 294],387,2,13827,3.6618114406779663,0.0,0.0
23776,2,3776,[597 515   7 222 238],650,4,13831,3.6619009796134496,0.0,0.0
23777,2,3777,[302 483 100 127 313],334,5,13836,3.6622551614610903,20.0,40.0
23778,2,3778,[ 98 275 301 183 496],6,4,13840,3.6623445355914264,0.0,20.0
23779,2,3779,[204  69 216 143  71],406,2,13842,3.6619047619047618,0.0,0.0
23780,2,3780,[323 121 496 211 183],650,3,13845,3.6617297011372654,0.0,0.0
23781,2,3781,[302 483 100 127 313],232,3,13848,3.6615547329455316,20.0,40.0
23782,2,3782,[118  69 328 483 257],749,3,13851,3.661379857256146,20.0,0.0
23783,2,3783,[276 185 597 318 423],59,4,13855,3.6614693446088795,20.0,0.0
23784,2,3784,[ 96  64 121  12 127],374,5,13860,3.6618229854689566,20.0,20.0
23785,2,3785,[ 28 269 222 121 423],13,3,13863,3.661648177496038,0.0,0.0
23786,2,3786,[302 483 100 127 313],13,5,13868,3.662001584367573,20.0,40.0
23787,2,3787,[302 483 100 127 313],329,5,13873,3.6623548046462515,20.0,40.0
23788,2,3788,[176 289 546 191 202],533,2,13875,3.6619160728424385,0.0,0.0
23789,2,3789,[302 483 100 127 313],328,5,13880,3.662269129287599,20.0,40.0
23790,2,3790,[ 89 483 121 151  11],339,4,13884,3.6623582168293325,20.0,0.0
23791,2,3791,[275 215 127 144 216],843,0,13884,3.661392405063291,0.0,20.0
23792,2,3792,[423  25 196 121  98],308,2,13886,3.660954389665173,0.0,20.0
23793,2,3793,[ 64  88  11 132 117],474,5,13891,3.661307327358988,0.0,0.0
23794,2,3794,[302 483 100 127 313],334,5,13896,3.6616600790513836,20.0,40.0
23795,2,3795,[748  28 216 289  69],92,1,13897,3.660958904109589,0.0,0.0
23796,2,3796,[228 603 197 182 181],524,2,13899,3.660521464313932,20.0,0.0
23797,2,3797,[228 748 238 603 204],524,1,13900,3.6598209583991577,20.0,0.0
23798,2,3798,[200 265 742 121 222],653,3,13903,3.6596472755988416,0.0,0.0
23799,2,3799,[257 185  50 183 588],804,5,13908,3.66,0.0,20.0
23800,2,3800,[302 483 100 127 313],329,5,13913,3.6603525388055775,20.0,40.0
23801,2,3801,[161 237  98 508 275],378,5,13918,3.6607048921620198,0.0,20.0
23802,2,3802,[ 28 211 175 237 204],60,5,13923,3.661057060215619,0.0,0.0
23803,2,3803,[ 69 197 216 183 174],234,3,13926,3.6608832807570977,0.0,20.0
23804,2,3804,[496  12 318 216 222],311,5,13931,3.6612352168199735,40.0,0.0
23805,2,3805,[ 50 135 153 144  69],339,4,13935,3.6613242249080398,0.0,20.0
23806,2,3806,[603 175 173 271 186],843,2,13937,3.660887838192803,20.0,0.0
23807,2,3807,[ 82 211 174 176 405],538,4,13941,3.6609768907563027,0.0,20.0
23808,2,3808,[ 12 588 183 265 245],378,4,13945,3.661065896560777,20.0,0.0
23809,2,3809,[302 483 100 127 313],329,5,13950,3.661417322834646,20.0,40.0
23810,2,3810,[302 483 100 127 313],328,5,13955,3.661768564681186,20.0,40.0
23811,2,3811,[302 483 100 127 313],334,5,13960,3.6621196222455406,20.0,40.0
23812,2,3812,[175 135 168 151 196],474,3,13963,3.661945974298453,0.0,0.0
23813,2,3813,[197 100 161 237 515],474,5,13968,3.6622968012585213,0.0,20.0
23814,2,3814,[313  82   9 257 546],308,3,13971,3.662123197903014,0.0,0.0
23815,2,3815,[ 50  25 111 234 237],378,4,13975,3.6622117400419287,0.0,20.0
23816,2,3816,[ 64 135  50 258 186],343,5,13980,3.6625622216400315,0.0,20.0
23817,2,3817,[300 117 202 143 118],749,4,13984,3.6626506024096384,0.0,0.0
23818,2,3818,[ 64 127 144 173 288],234,2,13986,3.662215239591516,0.0,20.0
23819,2,3819,[302 483 100 127 313],207,4,13990,3.662303664921466,20.0,40.0
23820,2,3820,[186  71 403 234 216],13,3,13993,3.662130332373724,0.0,0.0
23821,2,3821,[  7 196 135 228 215],200,5,13998,3.662480376766091,0.0,0.0
23822,2,3822,[302 483 100 127 313],334,5,14003,3.6628302380329583,20.0,40.0
23823,2,3823,[302 483 100 127 313],13,5,14008,3.6631799163179917,20.0,40.0
23824,2,3824,[211 405 181 161 183],102,1,14009,3.662483660130719,0.0,0.0
23825,2,3825,[302 483 100 127 313],329,5,14014,3.662833246210141,20.0,40.0
23826,2,3826,[328   8 191 211  98],488,3,14017,3.6626600470342305,0.0,20.0
23827,2,3827,[302 483 100 127 313],13,5,14022,3.6630094043887147,20.0,40.0
23828,2,3828,[385 200 197 195 234],543,4,14026,3.6630974144685298,0.0,0.0
23829,2,3829,[179   7 385 144 172],643,4,14030,3.6631853785900783,0.0,0.0
23830,2,3830,[403   9 161 288 508],339,2,14032,3.6627512398851474,0.0,0.0
23831,2,3831,[180 185 276 238  15],881,3,14035,3.662578288100209,0.0,0.0
23832,2,3832,[302 483 100 127 313],90,5,14040,3.6629272110618314,20.0,40.0
23833,2,3833,[300 127 180  79 210],271,4,14044,3.66301512780386,0.0,20.0
23834,2,3834,[181 546 515 143 603],458,3,14047,3.6628422425032596,20.0,0.0
23835,2,3835,[302 483 100 127 313],474,5,14052,3.6631908237747655,20.0,40.0
23836,2,3836,[302 483 100 127 313],537,5,14057,3.663539223351577,20.0,40.0
23837,2,3837,[275 234 168 195  15],537,2,14059,3.663105784262637,0.0,0.0
23838,2,3838,[ 70 405  50  96 185],59,3,14062,3.6629330554831987,0.0,20.0
23839,2,3839,[288  28 333 118 405],666,0,14062,3.661979166666667,0.0,0.0
23840,2,3840,[191   1 294  82 100],379,4,14066,3.6620671700078105,0.0,20.0
23841,2,3841,[302 483 100 127 313],13,5,14071,3.6624154086413325,20.0,40.0
23842,2,3842,[176 187 200 603 181],234,3,14074,3.66224303929222,20.0,0.0
23843,2,3843,[288 200   1 194  98],643,3,14077,3.66207075962539,0.0,20.0
23844,2,3844,[302 483 100 127 313],537,5,14082,3.6624187256176852,20.0,40.0
23845,2,3845,[191 181  71 546 294],95,3,14085,3.6622464898595943,0.0,0.0
23846,2,3846,[ 69 597 318 258 603],899,3,14088,3.6620743436443983,40.0,0.0
23847,2,3847,[100  82 118 200 187],694,5,14093,3.6624220374220373,0.0,20.0
23848,2,3848,[302 483 100 127 313],334,5,14098,3.6627695505326057,20.0,40.0
23849,2,3849,[328 132 135  70  12],90,4,14102,3.662857142857143,20.0,0.0
23850,2,3850,[286  79  11   1 135],13,1,14103,3.6621656712542197,0.0,0.0
23851,2,3851,[ 89 286 197 186 153],339,5,14108,3.6625129802699896,0.0,0.0
23852,2,3852,[180  15  88 265 100],474,5,14113,3.6628601090059694,0.0,20.0
23853,2,3853,[168   9 222 121 175],64,4,14117,3.6629475869226775,0.0,0.0
23854,2,3854,[655 180 175 471 322],308,3,14120,3.662775616083009,0.0,0.0
23855,2,3855,[302 483 100 127 313],474,5,14125,3.6631224066390042,20.0,40.0
23856,2,3856,[202 318 187 183 288],537,2,14127,3.6626912107855847,20.0,0.0
23857,2,3857,[183  97 179 423 125],374,3,14130,3.662519440124417,0.0,0.0
23858,2,3858,[302 483 100 127 313],90,5,14135,3.662866027468256,20.0,40.0
23859,2,3859,[603  98 194 182  95],524,2,14137,3.662435233160622,20.0,20.0
23860,2,3860,[603 333 210  82 195],64,1,14138,3.6617456617456616,20.0,0.0
23861,2,3861,[234 210  11 265 118],102,0,14138,3.6607975142413256,0.0,0.0
23862,2,3862,[ 28 423 588 175  15],881,2,14140,3.660367589955993,0.0,0.0
23863,2,3863,[151 237 117  98   4],788,3,14143,3.6601966873706004,0.0,20.0
23864,2,3864,[302 483 100 127 313],329,5,14148,3.660543337645537,20.0,40.0
23865,2,3865,[427 385 179 275 194],694,5,14153,3.6608898085876875,0.0,0.0
23866,2,3866,[286 117   1 483 300],294,5,14158,3.6612361003361777,20.0,0.0
23867,2,3867,[302 483 100 127 313],474,5,14163,3.6615822130299898,20.0,40.0
23868,2,3868,[302 483 100 127 313],207,4,14167,3.661669682088395,20.0,40.0
23869,2,3869,[195   9 603 237   8],13,3,14170,3.661498708010336,20.0,0.0
23870,2,3870,[196   1   8  11  25],455,3,14173,3.661327822268148,0.0,0.0
23871,2,3871,[ 96 275  69 515 183],13,3,14176,3.6611570247933884,0.0,0.0
23872,2,3872,[194 603 302 175 180],666,4,14180,3.6612445132971856,20.0,0.0
23873,2,3873,[235 273 471 257 258],213,3,14183,3.661073825503356,0.0,0.0
23874,2,3874,[302 483 100 127 313],329,5,14188,3.6614193548387095,20.0,40.0
23875,2,3875,[302 483 100 127 313],329,5,14193,3.661764705882353,20.0,40.0
23876,2,3876,[302 483 100 127 313],232,3,14196,3.661594015991746,20.0,40.0
23877,2,3877,[ 56 515 678 597 483],13,2,14198,3.6611655492521917,20.0,0.0
23878,2,3878,[ 25 603 475  88 211],648,3,14201,3.660995101830369,20.0,0.0
23879,2,3879,[323  95  71 234  64],374,4,14205,3.661082474226804,0.0,0.0
23880,2,3880,[118 323 143  98 483],374,2,14207,3.6606544704972945,20.0,20.0
23881,2,3881,[302 483 100 127 313],90,5,14212,3.6609994848016485,20.0,40.0
23882,2,3882,[496  70  50 269 186],378,3,14215,3.6608292557301056,0.0,20.0
23883,2,3883,[174  98 200 515 313],308,2,14217,3.660401647785788,0.0,40.0
23884,2,3884,[144 313  12 204 403],883,4,14221,3.6604890604890605,20.0,0.0
23885,2,3885,[302 483 100 127 313],207,4,14225,3.6605764282038087,20.0,40.0
23886,2,3886,[ 11 300 186  56 405],328,4,14229,3.6606637509647544,0.0,0.0
23887,2,3887,[302 483 100 127 313],474,5,14234,3.661008230452675,20.0,40.0
23888,2,3888,[302 483 100 127 313],537,5,14239,3.6613525327847776,20.0,40.0
23889,2,3889,[180 294 286 300 265],533,3,14242,3.6611825192802057,0.0,0.0
23890,2,3890,[ 71 276 385 176 173],200,5,14247,3.661526599845798,0.0,0.0
23891,2,3891,[302 483 100 127 313],537,5,14252,3.661870503597122,20.0,40.0
23892,2,3892,[288 182  50 427 195],234,2,14254,3.6614436167480093,0.0,20.0
23893,2,3893,[ 79 357 210 655  25],194,2,14256,3.6610169491525424,20.0,0.0
23894,2,3894,[257  25 655   7 168],804,5,14261,3.6613607188703465,0.0,0.0
23895,2,3895,[216 496 302 144 196],339,3,14264,3.6611909650924024,0.0,0.0
23896,2,3896,[195 257 182 483 216],210,5,14269,3.661534513728509,20.0,0.0
23897,2,3897,[  4  69 269 222  50],378,2,14271,3.6611082606464853,0.0,20.0
23898,2,3898,[173 168 294 655  71],488,3,14274,3.6609387022313413,0.0,0.0
23899,2,3899,[302 483 100 127 313],328,5,14279,3.6612820512820514,20.0,40.0
23900,2,3900,[302 483 100 127 313],90,5,14284,3.6616252243014613,20.0,40.0
23901,2,3901,[172 294  97 228  82],374,3,14287,3.6614556637621734,0.0,0.0
23902,2,3902,[238 588 179 301 173],378,2,14289,3.6610299769408146,0.0,0.0
23903,2,3903,[ 96 143 181 235 286],59,2,14291,3.6606045081967213,0.0,0.0
23904,2,3904,[151 168 173 181  70],60,5,14296,3.660947503201024,0.0,0.0
23905,2,3905,[302 483 100 127 313],329,5,14301,3.661290322580645,20.0,40.0
23906,2,3906,[  8  11 286  89 265],387,3,14304,3.6611210647555668,0.0,0.0
23907,2,3907,[ 28 748 471 328 211],533,4,14308,3.661207778915046,0.0,0.0
23908,2,3908,[168 118 483 183 275],158,4,14312,3.6612944487081096,20.0,0.0
23909,2,3909,[496 357 168 151 127],533,3,14315,3.661125319693095,20.0,20.0
23910,2,3910,[ 50 215 211 275 200],328,4,14319,3.661211966249041,0.0,20.0
23911,2,3911,[302 483 100 127 313],207,4,14323,3.6612985685071573,20.0,40.0
23912,2,3912,[302 483 100 127 313],328,5,14328,3.661640684896499,20.0,40.0
23913,2,3913,[194  71 269 127 237],7,4,14332,3.6617271333673993,0.0,20.0
23914,2,3914,[302 483 100 127 313],13,5,14337,3.6620689655172414,20.0,40.0
23915,2,3915,[ 97 357 288 286 228],234,1,14338,3.6613891726251278,20.0,0.0
23916,2,3916,[143 471 273  82 427],537,1,14339,3.660709726831759,0.0,0.0
23917,2,3917,[403 568 273  28 276],892,4,14343,3.6607963246554363,0.0,0.0
23918,2,3918,[181 175  97 210 135],659,3,14346,3.660627711150804,0.0,0.0
23919,2,3919,[168 132 200 100 568],339,4,14350,3.6607142857142856,0.0,20.0
23920,2,3920,[288  50 183 228 568],648,5,14355,3.6610558530986994,0.0,20.0
23921,2,3921,[302 483 100 127  50],334,5,14360,3.6613972463029065,20.0,60.0
23922,2,3922,[175 234 435  69 204],13,5,14365,3.661738465460107,0.0,0.0
23923,2,3923,[210 238 211 183 186],64,4,14369,3.661824668705403,0.0,0.0
23924,2,3924,[302 483 100 127  50],664,5,14374,3.6621656050955416,20.0,60.0
23925,2,3925,[302 483 100 127  50],664,5,14379,3.662506367804381,20.0,60.0
23926,2,3926,[328   1 568 144 288],378,3,14382,3.6623376623376624,0.0,0.0
23927,2,3927,[302 483 100 127  50],328,5,14387,3.6626782077393076,20.0,60.0
23928,2,3928,[385 121 187  50 200],59,5,14392,3.6630185797912955,0.0,20.0
23929,2,3929,[228 257   7 181 125],881,4,14396,3.6631043256997455,0.0,0.0
23930,2,3930,[  9   7 143 135 427],194,2,14398,3.6626812515899263,0.0,0.0
23931,2,3931,[176 204 143 196 546],200,4,14402,3.662767039674466,0.0,0.0
23932,2,3932,[301 202 475 191 257],6,2,14404,3.6623442664632595,0.0,0.0
23933,2,3933,[191  89 742 215  11],308,4,14408,3.6624300965937975,0.0,0.0
23934,2,3934,[302 483 100 127  50],232,4,14412,3.6625158831003812,20.0,60.0
23935,2,3935,[215  79 191 238 210],804,5,14417,3.662855691056911,0.0,0.0
23936,2,3936,[302 483 100 127  50],339,5,14422,3.6631953263906527,20.0,60.0
23937,2,3937,[ 98 204 143 655 271],334,3,14425,3.6630269172168615,0.0,20.0
23938,2,3938,[302 483 100 127  50],6,5,14430,3.6633663366336635,20.0,60.0
23939,2,3939,[435  15  79 151 588],59,4,14434,3.663451776649746,0.0,0.0
23940,2,3940,[302 483 100 127  50],833,3,14437,3.6632834306013704,20.0,60.0
23941,2,3941,[  7  88  89 588 202],308,5,14442,3.6636225266362255,0.0,0.0
23942,2,3942,[302 483 100 127  50],480,3,14445,3.6634542226730917,20.0,60.0
23943,2,3943,[302 483 100 127  50],232,4,14449,3.6635395537525355,20.0,60.0
23944,2,3944,[302 483 100 127  50],232,4,14453,3.6636248415716097,20.0,60.0
23945,2,3945,[144  15 111 195  71],95,5,14458,3.6639635073492145,0.0,0.0
23946,2,3946,[302 483 100 127  50],537,5,14463,3.664302001520142,20.0,60.0
23947,2,3947,[265 508 742 185 135],334,2,14465,3.6638804457953396,0.0,0.0
23948,2,3948,[302 483 100 127  50],232,4,14469,3.663965560901494,20.0,60.0
23949,2,3949,[423  56 483 237  89],334,5,14474,3.6643037974683543,20.0,0.0
23950,2,3950,[200 435 568 235 191],378,4,14478,3.6643887623386484,0.0,0.0
23951,2,3951,[302 483 100 127  50],524,5,14483,3.6647267206477734,20.0,60.0
23952,2,3952,[302 483 100 127  50],334,5,14488,3.6650645079686313,20.0,60.0
23953,2,3953,[302 483 100 127  50],458,4,14492,3.665149215983814,20.0,60.0
23954,2,3954,[302 483 100 127 313],207,4,14496,3.665233881163085,20.0,40.0
23955,2,3955,[ 70 265 211  22 183],308,4,14500,3.6653185035389284,0.0,0.0
23956,2,3956,[117 181  15 245 508],92,4,14504,3.665403083143796,0.0,0.0
23957,2,3957,[302 483 100 127 313],334,5,14509,3.6657402728650834,20.0,40.0
23958,2,3958,[385 181   4 186 127],87,5,14514,3.6660772922455167,0.0,20.0
23959,2,3959,[302 483 100 127 313],329,5,14519,3.6664141414141413,20.0,40.0
23960,2,3960,[153 200 168 515 118],890,3,14522,3.666245897500631,0.0,0.0
23961,2,3961,[258 186 181  56  98],659,3,14525,3.666077738515901,0.0,20.0
23962,2,3962,[318 135 275  97 194],7,5,14530,3.666414332576331,20.0,0.0
23963,2,3963,[153 271   4 151 211],833,2,14532,3.6659939455095865,0.0,0.0
23964,2,3964,[181 385 172 655 161],85,3,14535,3.6658259773013873,0.0,0.0
23965,2,3965,[237 143 475 257 161],334,3,14538,3.6656580937972767,0.0,0.0
23966,2,3966,[568 282 483 435 403],899,3,14541,3.665490294933199,20.0,0.0
23967,2,3967,[515   9 294 125   4],7,3,14544,3.6653225806451615,0.0,0.0
23968,2,3968,[135 181  70 175 144],666,3,14547,3.6651549508692365,0.0,0.0
23969,2,3969,[ 79  97 182 174 180],650,1,14548,3.66448362720403,0.0,20.0
23970,2,3970,[385 180 286 132  97],881,2,14550,3.664064467388567,0.0,0.0
23971,2,3971,[257 182 187  97 173],804,5,14555,3.664400805639476,0.0,0.0
23972,2,3972,[ 15 508  88 237 143],653,0,14555,3.663478479738233,0.0,0.0
23973,2,3973,[191 143 302 185 173],666,4,14559,3.663563160543533,0.0,0.0
23974,2,3974,[258 125 588 403 182],234,0,14559,3.6626415094339624,0.0,0.0
23975,2,3975,[302 483 100 127 313],232,3,14562,3.6624748490945676,20.0,40.0
23976,2,3976,[301 286 405 117 275],328,4,14566,3.662559718380689,0.0,0.0
23977,2,3977,[302 483 100 127  50],334,5,14571,3.66289592760181,20.0,60.0
23978,2,3978,[302 483 100 127  50],666,4,14575,3.6629806484041216,20.0,60.0
23979,2,3979,[196   7  25 275 655],119,5,14580,3.663316582914573,0.0,0.0
23980,2,3980,[121 288 271 568 235],119,5,14585,3.6636523486561168,0.0,0.0
23981,2,3981,[ 89 195  88 597 210],92,3,14588,3.663485685585133,0.0,0.0
23982,2,3982,[603 216 655  28  56],313,3,14591,3.6633191062013557,20.0,0.0
23983,2,3983,[302 483 100 127 313],90,5,14596,3.6636546184738954,20.0,40.0
23984,2,3984,[302 483 100 127 313],13,5,14601,3.663989962358846,20.0,40.0
23985,2,3985,[333 258 322 265 222],533,4,14605,3.664074259909684,0.0,0.0
23986,2,3986,[302 483 100 127 313],474,5,14610,3.6644093303235517,20.0,40.0
23987,2,3987,[258  12 210 286 153],334,4,14614,3.664493480441324,20.0,0.0
23988,2,3988,[302 483 100 127 313],232,3,14617,3.6643268989721736,20.0,40.0
23989,2,3989,[302 483 100 127 313],13,5,14622,3.6646616541353385,20.0,40.0
23990,2,3990,[234 328 210 322 318],92,2,14624,3.6642445502380356,20.0,0.0
23991,2,3991,[ 64  95 151 313 200],380,4,14628,3.664328657314629,0.0,0.0
23992,2,3992,[ 88 176  97  15 195],533,3,14631,3.664162283996995,0.0,0.0
23993,2,3993,[173 202 143 210 127],234,1,14632,3.6634952428642964,0.0,20.0
23994,2,3994,[302 483 100 127 313],90,5,14637,3.6638297872340426,20.0,40.0
23995,2,3995,[238 195 161  95 211],194,3,14640,3.6636636636636637,0.0,0.0
23996,2,3996,[172  79 276 210 273],643,4,14644,3.6637478108581436,0.0,0.0
23997,2,3997,[ 71 216 211  82 172],64,3,14647,3.6635817908954476,0.0,0.0
23998,2,3998,[100 496 172 204 179],932,5,14652,3.6639159789947486,0.0,20.0
23999,2,3999,[172 191  82 175 385],659,4,14656,3.664,0.0,0.0
24000,2,4000,[385 191 173 168 100],650,5,14661,3.66433391652087,0.0,20.0
24001,2,4001,[237 194 423  69 195],882,4,14665,3.664417791104448,0.0,0.0
24002,2,4002,[385  25 215 204 181],59,5,14670,3.664751436422683,0.0,0.0
24003,2,4003,[ 12 187 508 173 172],406,3,14673,3.6645854145854146,20.0,0.0
24004,2,4004,[302 483 100 127 313],537,5,14678,3.664918851435705,20.0,40.0
24005,2,4005,[ 50 181 742 186 289],833,0,14678,3.6640039940089864,0.0,20.0
24006,2,4006,[301 483 237  69  28],334,2,14680,3.663588719740454,20.0,0.0
24007,2,4007,[172 588 187 204 132],326,2,14682,3.663173652694611,0.0,0.0
24008,2,4008,[ 50  15 210 121 423],474,5,14687,3.6635071090047395,0.0,20.0
24009,2,4009,[302 483 100 127 313],13,5,14692,3.6638403990024937,20.0,40.0
24010,2,4010,[ 50 300  70 273 603],537,3,14695,3.663674894041386,20.0,20.0
24011,2,4011,[144  95 222 216 182],234,0,14695,3.6627617148554337,0.0,0.0
24012,2,4012,[117 328 204 385 435],313,5,14700,3.663094941440319,0.0,0.0
24013,2,4013,[ 98 151 132 176  25],378,4,14704,3.663178873941206,0.0,20.0
24014,2,4014,[301 271  79 323 185],328,2,14706,3.6627646326276464,0.0,0.0
24015,2,4015,[286   1 294 117 257],479,2,14708,3.662350597609562,0.0,0.0
24016,2,4016,[588 496  69   8 173],452,4,14712,3.662434652725915,0.0,0.0
24017,2,4017,[117 603 235 288 179],308,3,14715,3.662269785963166,20.0,0.0
24018,2,4018,[471 286 318 237 435],533,4,14719,3.6623538193580494,20.0,0.0
24019,2,4019,[174 234 385 204 235],59,4,14723,3.6624378109452738,0.0,20.0
24020,2,4020,[ 88 175 405 197   9],194,2,14725,3.6620243720467545,0.0,0.0
24021,2,4021,[357 289 286  71 204],95,4,14729,3.6621084037792144,20.0,0.0
24022,2,4022,[508 173 176 172 282],455,3,14732,3.6619438230176486,0.0,0.0
24023,2,4023,[ 98 182 173  25  82],804,5,14737,3.66227634194831,0.0,20.0
24024,2,4024,[302 483 100 127 313],13,5,14742,3.6626086956521737,20.0,40.0
24025,2,4025,[ 88 265 257 603 333],815,2,14744,3.662195727769498,20.0,0.0
24026,2,4026,[ 98 269  69 100 313],883,1,14745,3.6615346411720884,0.0,40.0
24027,2,4027,[302 483 100 127 313],207,4,14749,3.6616186693147963,20.0,40.0
24028,2,4028,[222 182 238 185  56],210,4,14753,3.6617026557458425,0.0,0.0
24029,2,4029,[117 357 238 405 176],749,3,14756,3.6615384615384614,20.0,0.0
24030,2,4030,[302 483 100 127 313],207,4,14760,3.6616224261969736,20.0,40.0
24031,2,4031,[302 483 100 127 313],537,5,14765,3.661954365079365,20.0,40.0
24032,2,4032,[183 168 357   7 471],95,5,14770,3.6622861393503596,20.0,0.0
24033,2,4033,[603  22 234 173 515],883,4,14774,3.662369856222112,20.0,0.0
24034,2,4034,[302 483 100 127 313],328,5,14779,3.6627013630731104,20.0,40.0
24035,2,4035,[302 483 100 127 313],232,3,14782,3.662537165510406,20.0,40.0
24036,2,4036,[ 97 742 597  22 568],788,1,14783,3.66187763190488,0.0,0.0
24037,2,4037,[ 11 143  28  50 187],188,3,14786,3.6617137196631995,0.0,20.0
24038,2,4038,[215 180 276 435 127],271,4,14790,3.661797474622431,0.0,20.0
24039,2,4039,[ 64 328  96 182 234],749,4,14794,3.661881188118812,0.0,0.0
24040,2,4040,[ 71 257 125 282 100],374,4,14798,3.661964860183123,0.0,20.0
24041,2,4041,[302 483 100 127 313],334,5,14803,3.662295893122217,20.0,40.0
24042,2,4042,[515  79  97  28 655],311,5,14808,3.662626762305219,0.0,0.0
24043,2,4043,[  4 294  25 271 546],92,1,14809,3.6619683481701286,0.0,0.0
24044,2,4044,[302 483 100 127 313],90,5,14814,3.6622991347342397,20.0,40.0
24045,2,4045,[289 286 322 211 238],883,4,14818,3.662382600098863,0.0,0.0
24046,2,4046,[185  88 111 127 135],653,2,14820,3.6619718309859155,0.0,20.0
24047,2,4047,[186 211 210 357 121],653,4,14824,3.6620553359683794,20.0,0.0
24048,2,4048,[302 483 100 127 313],329,5,14829,3.6623857742652506,20.0,40.0
24049,2,4049,[302 483 100 127 313],207,4,14833,3.662469135802469,20.0,40.0
24050,2,4050,[ 96 273 385 195 215],346,4,14837,3.662552456183658,0.0,0.0
24051,2,4051,[257 195  28 144  95],899,4,14841,3.6626357354392893,0.0,0.0
24052,2,4052,[302 483 100 127 313],537,5,14846,3.662965704416482,20.0,40.0
24053,2,4053,[117  12 496  11 175],334,3,14849,3.6628021706956093,20.0,0.0
24054,2,4054,[385 211  22 483 748],804,5,14854,3.6631319358816277,20.0,0.0
24055,2,4055,[273 313 323 174 483],537,2,14856,3.662721893491124,20.0,20.0
24056,2,4056,[302 483 100 127 313],90,5,14861,3.663051515898447,20.0,40.0
24057,2,4057,[546 302 286 222 483],13,2,14863,3.662641695416461,20.0,0.0
24058,2,4058,[195 191   9 168 183],379,4,14867,3.6627248090662725,0.0,0.0
24059,2,4059,[197 185 496 265 111],479,4,14871,3.662807881773399,0.0,0.0
24060,2,4060,[  1 496 175 403 121],653,2,14873,3.6623984240334893,0.0,0.0
24061,2,4061,[318 117  70 121  89],271,2,14875,3.6619891678975875,20.0,0.0
24062,2,4062,[ 25 222 289 191 100],474,4,14879,3.662072360324883,0.0,20.0
24063,2,4063,[173  56 204 258  12],506,5,14884,3.6624015748031495,20.0,0.0
24064,2,4064,[302 483 100 127 313],328,5,14889,3.662730627306273,20.0,40.0
24065,2,4065,[302 483 100 127 313],537,5,14894,3.663059517953763,20.0,40.0
24066,2,4066,[423 288 174 515  98],537,1,14895,3.6624047209245143,0.0,40.0
24067,2,4067,[194 111  82 475 143],452,1,14896,3.6617502458210422,0.0,0.0
24068,2,4068,[ 64 176 204 185 234],308,4,14900,3.661833374293438,0.0,0.0
24069,2,4069,[179 357 100 748 471],13,2,14902,3.6614250614250614,20.0,20.0
24070,2,4070,[172 385 195 288 135],833,2,14904,3.6610169491525424,0.0,0.0
24071,2,4071,[234 313   9 265   4],92,5,14909,3.661345776031434,0.0,0.0
24072,2,4072,[ 22 117 174 515   8],840,3,14912,3.6611834028971275,0.0,20.0
24073,2,4073,[302 483 100 127 313],232,3,14915,3.6610211094747176,20.0,40.0
24074,2,4074,[181  64  88 385 180],378,4,14919,3.6611042944785277,0.0,0.0
24075,2,4075,[111  25 300 435  96],666,1,14920,3.66045142296369,0.0,0.0
24076,2,4076,[161 235 186 194  15],271,2,14922,3.6600441501103753,0.0,0.0
24077,2,4077,[ 12   1 121 265 288],892,5,14927,3.6603727317312407,20.0,0.0
24078,2,4078,[222  88 118 282 286],533,5,14932,3.6607011522431967,0.0,0.0
24079,2,4079,[515 568 174 546 161],200,4,14936,3.66078431372549,0.0,20.0
24080,2,4080,[302 483 100 127 313],334,5,14941,3.6611124724332273,20.0,40.0
24081,2,4081,[ 82 568 204 195  70],102,2,14943,3.6607055365017147,0.0,0.0
24082,2,4082,[265 181   8 194 135],7,4,14947,3.6607886358070045,0.0,0.0
24083,2,4083,[204 234   1  69 228],890,5,14952,3.661116552399608,0.0,0.0
24084,2,4084,[302 483 100 127 313],537,5,14957,3.6614443084455326,20.0,40.0
24085,2,4085,[180 328  89 182  28],271,2,14959,3.661037689672051,0.0,0.0
24086,2,4086,[186 265 216  12 568],7,5,14964,3.661365304624419,20.0,0.0
24087,2,4087,[  4 183  22 427 186],13,5,14969,3.661692759295499,0.0,0.0
24088,2,4088,[302 483 100 127 313],474,5,14974,3.6620200538028858,20.0,40.0
24089,2,4089,[302 483 100 127 313],90,5,14979,3.6623471882640586,20.0,40.0
24090,2,4090,[546 127 183 515  69],207,3,14982,3.6621852847714496,0.0,20.0
24091,2,4091,[234 385 204 197 210],308,3,14985,3.6620234604105573,0.0,0.0
24092,2,4092,[ 70 100 176 144  89],158,5,14990,3.6623503542633764,0.0,20.0
24093,2,4093,[ 97 151 161 273 211],897,4,14994,3.6624328285295555,0.0,0.0
24094,2,4094,[302 483 100 127 313],474,5,14999,3.6627594627594626,20.0,40.0
24095,2,4095,[187 161 195 186  71],881,3,15002,3.66259765625,0.0,0.0
24096,2,4096,[302 483 100 127 313],232,3,15005,3.6624359287283377,20.0,40.0
24097,2,4097,[180 100 496  25 597],650,2,15007,3.6620302586627624,0.0,20.0
24098,2,4098,[302 483 100 127 313],474,5,15012,3.662356672359112,20.0,40.0
24099,2,4099,[588   7 435 183 273],10,5,15017,3.662682926829268,0.0,0.0
24100,2,4100,[302 483 100 127 313],13,5,15022,3.66300902218971,20.0,40.0
24101,2,4101,[286 181 282 161 294],479,2,15024,3.6626036079960995,0.0,0.0
24102,2,4102,[117  96 288 742 655],387,1,15025,3.6619546673165977,0.0,0.0
24103,2,4103,[237 427 187 204 182],234,2,15027,3.6615497076023393,0.0,0.0
24104,2,4104,[588  22 228  97 174],82,3,15030,3.661388550548112,0.0,20.0
24105,2,4105,[ 88 275 748 265 202],883,4,15034,3.6614710180224064,0.0,0.0
24106,2,4106,[475 135 300 268  11],90,3,15037,3.661309958607256,0.0,0.0
24107,2,4107,[302 483 100 127 313],13,5,15042,3.6616358325219083,20.0,40.0
24108,2,4108,[211  15 496 187 568],650,2,15044,3.6612314431735213,0.0,0.0
24109,2,4109,[153 496 182 322 196],488,1,15045,3.6605839416058394,0.0,0.0
24110,2,4110,[302 483 100 127 313],328,5,15050,3.660909754317684,20.0,40.0
24111,2,4111,[211   9 385  89 195],234,0,15050,3.660019455252918,0.0,0.0
24112,2,4112,[ 22 258 187 196 172],537,2,15052,3.659615852176027,0.0,0.0
24113,2,4113,[118   7 475 197 211],648,2,15054,3.659212445308702,0.0,0.0
24114,2,4114,[302 483 100 127 313],90,5,15059,3.659538274605103,20.0,40.0
24115,2,4115,[135 678 268 508  98],92,4,15063,3.6596209912536444,0.0,20.0
24116,2,4116,[ 88 403  96  50 191],881,1,15064,3.6589749817828516,0.0,20.0
24117,2,4117,[ 79 181 144 121 187],188,2,15066,3.6585721223895096,0.0,0.0
24118,2,4118,[200  96 216  69 197],666,2,15068,3.6581694586064577,0.0,0.0
24119,2,4119,[302 483 100 127 313],90,5,15073,3.658495145631068,20.0,40.0
24120,2,4120,[302 483 100 127 313],329,5,15078,3.6588206745935454,20.0,40.0
24121,2,4121,[222   7 318 603 172],13,2,15080,3.658418243571082,40.0,0.0
24122,2,4122,[357 153 302 127 385],328,3,15083,3.658258549599806,20.0,20.0
24123,2,4123,[ 64 151   8 185  97],234,2,15085,3.6578564500484965,0.0,0.0
24124,2,4124,[ 56 269 423  69  15],650,1,15086,3.657212121212121,0.0,0.0
24125,2,4125,[ 79 286 276  89 742],145,3,15089,3.6570528356761995,0.0,0.0
24126,2,4126,[ 12 186 135 194 568],311,4,15093,3.6571359340925613,20.0,0.0
24127,2,4127,[238 471 151 322 174],308,3,15096,3.6569767441860463,0.0,20.0
24128,2,4128,[  1 168 100 202 187],13,4,15100,3.6570598207798497,0.0,20.0
24129,2,4129,[302 483 100 127 313],334,5,15105,3.6573849878934626,20.0,40.0
24130,2,4130,[211 235 742 202 181],308,4,15109,3.6574679254417815,0.0,0.0
24131,2,4131,[204 196 235   4 111],87,4,15113,3.6575508228460794,0.0,0.0
24132,2,4132,[ 50 546 135  95 471],479,4,15117,3.6576336801354947,0.0,20.0
24133,2,4133,[100 483 222 423 228],479,3,15120,3.6574746008708274,20.0,20.0
24134,2,4134,[302 483 100 127 313],232,3,15123,3.6573155985489723,20.0,40.0
24135,2,4135,[187 318 153 118 496],648,3,15126,3.65715667311412,20.0,0.0
24136,2,4136,[333 322 215  22 185],328,2,15128,3.656756103456611,0.0,0.0
24137,2,4137,[655 197 301  79 597],378,2,15130,3.6563557274045433,0.0,0.0
24138,2,4138,[175 385  69   7 215],95,5,15135,3.6566803575742934,0.0,0.0
24139,2,4139,[ 89 143 322 180  56],92,3,15138,3.6565217391304348,0.0,0.0
24140,2,4140,[100 238 288 235  50],479,2,15140,3.656121709731949,0.0,40.0
24141,2,4141,[121  12 127  96 471],308,3,15143,3.6559633027522938,20.0,20.0
24142,2,4142,[302 483 100 127 313],334,5,15148,3.6562877142167514,20.0,40.0
24143,2,4143,[302 483 100 127 313],232,3,15151,3.6561293436293436,20.0,40.0
24144,2,4144,[132 187 508 313 427],533,5,15156,3.656453558504222,0.0,0.0
24145,2,4145,[125 228 258 271 357],749,5,15161,3.656777616980222,20.0,0.0
24146,2,4146,[655 222 117 588 258],815,3,15164,3.6566192428261393,0.0,0.0
24147,2,4147,[302 483 100 127 313],334,5,15169,3.656943105110897,20.0,40.0
24148,2,4148,[  8 328 181  25 508],533,4,15173,3.6570257893468305,0.0,0.0
24149,2,4149,[ 64 187 427 568 222],339,4,15177,3.6571084337349395,0.0,0.0
24150,2,4150,[302 483 100 127 313],207,4,15181,3.657191038304023,20.0,40.0
24151,2,4151,[302 483 100 127 313],329,5,15186,3.657514450867052,20.0,40.0
24152,2,4152,[275 176  82 151  96],882,5,15191,3.6578377076811943,0.0,0.0
24153,2,4153,[168  50 257 175 153],479,5,15196,3.658160808858931,0.0,20.0
24154,2,4154,[ 56 286 194 403 427],533,3,15199,3.658002406738869,0.0,0.0
24155,2,4155,[195 403  70 197 318],536,2,15201,3.6576034648700673,20.0,0.0
24156,2,4156,[655 183 196 181 568],92,4,15205,3.6576858311282177,0.0,0.0
24157,2,4157,[204 186 423 174 118],92,3,15208,3.6575276575276576,0.0,20.0
24158,2,4158,[302 483 100 127 313],329,5,15213,3.657850444818466,20.0,40.0
24159,2,4159,[302 483 100 127 313],232,3,15216,3.6576923076923076,20.0,40.0
24160,2,4160,[121 269 222 748 655],102,0,15216,3.6568132660418167,0.0,0.0
24161,2,4161,[302 483 100 127 313],537,5,15221,3.657135992311389,20.0,40.0
24162,2,4162,[286 117 302 235 182],102,0,15221,3.656257506605813,0.0,0.0
24163,2,4163,[216  82 237  95  64],308,3,15224,3.6560999039385207,0.0,0.0
24164,2,4164,[302 483 100 127 313],328,5,15229,3.656422569027611,20.0,40.0
24165,2,4165,[ 25 127 111 144 328],207,2,15231,3.656024963994239,0.0,20.0
24166,2,4166,[475 289 294  82 196],387,1,15232,3.6553875689944806,0.0,0.0
24167,2,4167,[125 180 288  64 357],59,4,15236,3.6554702495201536,20.0,0.0
24168,2,4168,[211 546 286   1 222],447,1,15237,3.6548332933557206,0.0,0.0
24169,2,4169,[302 483 100 127 313],232,3,15240,3.6546762589928057,20.0,40.0
24170,2,4170,[302 483 100 127 313],232,3,15243,3.654519299928075,20.0,40.0
24171,2,4171,[234 210 318 333 258],85,3,15246,3.6543624161073827,20.0,0.0
24172,2,4172,[ 56 153  25  89 202],387,3,15249,3.6542056074766354,0.0,0.0
24173,2,4173,[234 237 318  96 111],42,4,15253,3.65428845232391,20.0,0.0
24174,2,4174,[183  28  97  79 161],339,4,15257,3.65437125748503,0.0,0.0
24175,2,4175,[222 427  22 143  11],334,4,15261,3.6544540229885056,0.0,0.0
24176,2,4176,[282 302 111 435 185],474,5,15266,3.6547761551352647,0.0,0.0
24177,2,4177,[  4 200 121 215  22],749,4,15270,3.6548587841072284,0.0,0.0
24178,2,4178,[ 50 597 174 135 238],59,4,15274,3.6549413735343386,0.0,40.0
24179,2,4179,[302 483 100 127 313],207,4,15278,3.655023923444976,20.0,40.0
24180,2,4180,[678  82 258 216 655],339,2,15280,3.6546280794068404,0.0,0.0
24181,2,4181,[127 301 175  70  12],666,5,15285,3.6549497847919654,20.0,20.0
24182,2,4182,[471 238 153 191  98],92,5,15290,3.655271336361463,0.0,20.0
24183,2,4183,[100  12 127 546 185],548,5,15295,3.6555927342256216,20.0,40.0
24184,2,4184,[302 483 100 127 313],207,4,15299,3.6556750298685783,20.0,40.0
24185,2,4185,[515  50 185 318 174],235,5,15304,3.6559961777353083,20.0,40.0
24186,2,4186,[ 89  79 603 179  96],308,5,15309,3.6563171721996657,20.0,0.0
24187,2,4187,[161  82 228 182 144],387,3,15312,3.656160458452722,0.0,0.0
24188,2,4188,[302 483 100 127 313],329,5,15317,3.65648126044402,20.0,40.0
24189,2,4189,[435 405 238 748 174],474,4,15321,3.656563245823389,0.0,20.0
24190,2,4190,[ 82 161  79 183 181],774,1,15322,3.6559293724648056,0.0,0.0
24191,2,4191,[179  22  71 235 546],648,4,15326,3.6560114503816794,0.0,0.0
24192,2,4192,[302 483 100 127 313],232,3,15329,3.655854996422609,20.0,40.0
24193,2,4193,[302 483 100 127 313],328,5,15334,3.6561754887935147,20.0,40.0
24194,2,4194,[655 175 546 121 403],378,4,15338,3.6562574493444577,0.0,0.0
24195,2,4195,[121 100 215  22 183],881,4,15342,3.6563393708293614,0.0,20.0
24196,2,4196,[237 210 313 216 132],64,4,15346,3.6564212532761498,0.0,0.0
24197,2,4197,[302 483 100 127 313],232,3,15349,3.6562648880419246,20.0,40.0
24198,2,4198,[ 71 508  98 483 100],85,3,15352,3.6561085972850678,20.0,40.0
24199,2,4199,[ 95 435 403 144 282],378,5,15357,3.6564285714285716,0.0,0.0
24200,2,4200,[496 405  71 111 175],42,3,15360,3.656272316115211,0.0,0.0
24201,2,4201,[238 427  64 333 403],13,2,15362,3.6558781532603524,0.0,0.0
24202,2,4202,[471   8 127 328 313],271,3,15365,3.6557221032595764,0.0,20.0
24203,2,4203,[234 185 423 143 180],650,2,15367,3.6553282588011418,0.0,0.0
24204,2,4204,[302 483 100 127 313],13,5,15372,3.6556480380499408,20.0,40.0
24205,2,4205,[302 483 100 127 313],537,5,15377,3.655967665240133,20.0,40.0
24206,2,4206,[302 483 100 127 313],329,5,15382,3.6562871404801522,20.0,40.0
24207,2,4207,[132 588 174 125 182],59,3,15385,3.6561311787072244,0.0,20.0
24208,2,4208,[ 56 179  25 286 135],650,1,15386,3.6555001187930625,0.0,0.0
24209,2,4209,[302 483 100 127 313],328,5,15391,3.6558194774346795,20.0,40.0
24210,2,4210,[302 483 100 127 313],232,3,15394,3.655663737829494,20.0,40.0
24211,2,4211,[302 483 100 127  50],158,5,15399,3.655982905982906,20.0,60.0
24212,2,4212,[302 483 100 127  50],360,5,15404,3.6563019226204605,20.0,60.0
24213,2,4213,[234 181 318 127 135],59,5,15409,3.6566207878500236,20.0,20.0
24214,2,4214,[302 483 100 127  50],480,3,15412,3.656465005931198,20.0,60.0
24215,2,4215,[196 174  11  50  98],666,2,15414,3.6560721062618597,0.0,60.0
24216,2,4216,[ 71 191   9 423 168],648,3,15417,3.6559165283376807,0.0,0.0
24217,2,4217,[182  96 385 179 196],374,3,15420,3.655761024182077,0.0,0.0
24218,2,4218,[ 12 187  28 508   1],533,5,15425,3.6560796397250535,20.0,0.0
24219,2,4219,[173 174 176 153 655],848,5,15430,3.656398104265403,0.0,20.0
24220,2,4220,[302 483 100 127 313],90,5,15435,3.656716417910448,20.0,40.0
24221,2,4221,[100 475  28 276 322],207,1,15436,3.656087162482236,0.0,20.0
24222,2,4222,[286 180  22 265 204],653,5,15441,3.6564053990054464,0.0,0.0
24223,2,4223,[423 121 185 588  89],184,4,15445,3.656486742424242,0.0,0.0
24224,2,4224,[302 483 100 127 313],13,5,15450,3.6568047337278107,20.0,40.0
24225,2,4225,[302 483 100 127 313],13,5,15455,3.6571225745385707,20.0,40.0
24226,2,4226,[302 294 222 748 215],328,1,15456,3.6564939673527324,0.0,0.0
24227,2,4227,[ 56 318 168   1  95],648,2,15458,3.6561021759697256,20.0,0.0
24228,2,4228,[ 11 603 357 234  79],643,5,15463,3.6564199574367464,40.0,0.0
24229,2,4229,[185  25  96 269 313],207,4,15467,3.656501182033097,0.0,0.0
24230,2,4230,[294 125   8 318 282],144,5,15472,3.6568187189789647,20.0,0.0
24231,2,4231,[302 483 100 127 313],334,5,15477,3.6571361058601135,20.0,40.0
24232,2,4232,[ 50 197  25  69  70],666,2,15479,3.6567446255610676,0.0,20.0
24233,2,4233,[302 483 100 127 313],329,5,15484,3.6570618800188948,20.0,40.0
24234,2,4234,[ 56  88 197 405 172],738,3,15487,3.6569067296340023,0.0,0.0
24235,2,4235,[302 483 100 127 313],329,5,15492,3.6572237960339944,20.0,40.0
24236,2,4236,[508 100 568 186 153],13,3,15495,3.6570686806702857,0.0,20.0
24237,2,4237,[237  50  95 143 268],234,1,15496,3.6564417177914113,0.0,20.0
24238,2,4238,[176 180  25 216   8],378,4,15500,3.6565227648030194,0.0,0.0
24239,2,4239,[ 96 258   1 197 568],454,4,15504,3.6566037735849055,0.0,0.0
24240,2,4240,[302 483 100 127 313],90,5,15509,3.6569205376090546,20.0,40.0
24241,2,4241,[302 483 100 127 313],90,5,15514,3.6572371522866574,20.0,40.0
24242,2,4242,[111 118  64 211  89],524,4,15518,3.6573179354230496,0.0,0.0
24243,2,4243,[313 202 302 471 135],378,2,15520,3.6569274269557024,0.0,0.0
24244,2,4244,[302 483 100 127 313],207,4,15524,3.6570082449941106,20.0,40.0
24245,2,4245,[742 144 435  82  97],788,1,15525,3.6563824776260008,0.0,0.0
24246,2,4246,[204  71 174 182 268],92,5,15530,3.656698846244408,0.0,20.0
24247,2,4247,[  1 180 222 294 172],881,4,15534,3.656779661016949,0.0,0.0
24248,2,4248,[435 515  15  97 202],537,1,15535,3.656154389268063,0.0,0.0
24249,2,4249,[302 483 100 127 313],537,5,15540,3.656470588235294,20.0,40.0
24250,2,4250,[235  70 568   7 271],119,4,15544,3.656551399670666,0.0,0.0
24251,2,4251,[483 269 237 275 151],6,3,15547,3.6563969896519284,20.0,0.0
24252,2,4252,[191 182 357 385 168],194,3,15550,3.656242652245474,20.0,0.0
24253,2,4253,[185 471  69 597   4],374,4,15554,3.6563234602726844,0.0,0.0
24254,2,4254,[302 483 100 127 313],13,5,15559,3.6566392479435956,20.0,40.0
24255,2,4255,[265 302 186 318 515],207,4,15563,3.65671992481203,20.0,0.0
24256,2,4256,[475   1 300 546 258],479,2,15565,3.656330749354005,0.0,0.0
24257,2,4257,[302 483 100 127 313],334,5,15570,3.6566463128229216,20.0,40.0
24258,2,4258,[175 748 121  98 132],346,4,15574,3.656726931204508,0.0,20.0
24259,2,4259,[234 222 435 125  97],804,4,15578,3.6568075117370893,0.0,0.0
24260,2,4260,[121 194 196 100 144],13,5,15583,3.657122741140577,0.0,20.0
24261,2,4261,[302 483 100 127 313],13,5,15588,3.657437822618489,20.0,40.0
24262,2,4262,[302 483 100 127 313],474,5,15593,3.657752756274924,20.0,40.0
24263,2,4263,[211 300 496 196 153],346,3,15596,3.6575984990619137,0.0,0.0
24264,2,4264,[302 483 100 127 313],537,5,15601,3.657913247362251,20.0,40.0
24265,2,4265,[121  89 286 197 265],13,4,15605,3.6579934364744493,0.0,0.0
24266,2,4266,[302 483 100 127 313],232,3,15608,3.657839231310054,20.0,40.0
24267,2,4267,[294 427  25 471 168],882,4,15612,3.6579194001874415,0.0,0.0
24268,2,4268,[196 174 195 183 151],881,3,15615,3.657765284609979,0.0,20.0
24269,2,4269,[302 483 100 127 313],328,5,15620,3.65807962529274,20.0,40.0
24270,2,4270,[ 50 204 289 655  71],92,4,15624,3.658159681573402,0.0,20.0
24271,2,4271,[185  11 568 235 435],64,5,15629,3.6584737827715355,0.0,0.0
24272,2,4272,[257   4 168 222  25],881,2,15631,3.6580856541071847,0.0,0.0
24273,2,4273,[ 64 588 144  97 143],804,4,15635,3.658165652784277,0.0,0.0
24274,2,4274,[302 483 100 127 313],334,5,15640,3.6584795321637427,20.0,40.0
24275,2,4275,[302 483 100 127 313],90,5,15645,3.658793264733396,20.0,40.0
24276,2,4276,[144 174 423 357 173],892,5,15650,3.659106850596212,20.0,20.0
24277,2,4277,[273 195  96 323 294],378,2,15652,3.6587190275829826,0.0,0.0
24278,2,4278,[515 175 202 588 228],59,4,15656,3.658798784762795,0.0,0.0
24279,2,4279,[  4 175 301 204 603],334,3,15659,3.658644859813084,20.0,0.0
24280,2,4280,[144 151 748  96 568],901,4,15663,3.6587245970567626,0.0,0.0
24281,2,4281,[ 12 238 168 180 182],7,5,15668,3.6590378327884165,20.0,0.0
24282,2,4282,[181  56 265 403 182],378,5,15673,3.6593509222507588,0.0,0.0
24283,2,4283,[100 357 179 191 496],311,3,15676,3.6591970121381885,20.0,20.0
24284,2,4284,[282 294 265 117  11],92,4,15680,3.6592765460910153,0.0,0.0
24285,2,4285,[597 197 328 313   8],378,2,15682,3.658889407372842,0.0,0.0
24286,2,4286,[427 403 234 258 118],533,3,15685,3.6587357126195474,0.0,0.0
24287,2,4287,[181 475 265 275 195],64,5,15690,3.6590485074626864,0.0,0.0
24288,2,4288,[655  56 195 300 222],843,1,15691,3.658428538120774,0.0,0.0
24289,2,4289,[183 234 197 238 182],7,5,15696,3.6587412587412587,0.0,0.0
24290,2,4290,[117 294 435 191 323],378,2,15698,3.6583546958750874,0.0,0.0
24291,2,4291,[300 127  71 210 121],313,5,15703,3.6586672879776327,0.0,20.0
24292,2,4292,[302 483 100 127 313],537,5,15708,3.6589797344514325,20.0,40.0
24293,2,4293,[302 483 100 127 313],328,5,15713,3.65929203539823,20.0,40.0
24294,2,4294,[161  50 678 323 289],13,2,15715,3.658905704307334,0.0,20.0
24295,2,4295,[302 483 100 127 313],90,5,15720,3.659217877094972,20.0,40.0
24296,2,4296,[288 195 111  69 174],452,3,15723,3.6590644635792415,0.0,20.0
24297,2,4297,[183 121  70  89 211],666,4,15727,3.659143787808283,0.0,0.0
24298,2,4298,[211 180 168 121  95],271,3,15730,3.6589904628983483,0.0,0.0
24299,2,4299,[302 483 100 127 313],329,5,15735,3.6593023255813955,20.0,40.0
24300,2,4300,[ 82 427 210 216 202],13,2,15737,3.658916531039293,0.0,0.0
24301,2,4301,[234 273 179 211 515],59,4,15741,3.6589958158995817,0.0,0.0
24302,2,4302,[175  82  12 183 176],666,4,15745,3.659075063908901,20.0,0.0
24303,2,4303,[204  71  96 742 111],524,2,15747,3.658689591078067,0.0,0.0
24304,2,4304,[  7  89   1  15 143],378,5,15752,3.6590011614401856,0.0,0.0
24305,2,4305,[302 483 100 127 313],474,5,15757,3.6593125870877845,20.0,40.0
24306,2,4306,[403 300 322 179 182],13,1,15758,3.658695147434409,0.0,0.0
24307,2,4307,[302 483 100 127 313],474,5,15763,3.6590064995357476,20.0,40.0
24308,2,4308,[234  82  15 483  88],313,2,15765,3.65862148990485,20.0,0.0
24309,2,4309,[ 71 132 197 186 172],664,5,15770,3.6589327146171695,0.0,0.0
24310,2,4310,[ 28  22  69 172 423],92,2,15772,3.658547900719091,0.0,0.0
24311,2,4311,[ 71 204  96  28  50],892,4,15776,3.6586270871985156,0.0,20.0
24312,2,4312,[202 100 294   1  28],374,3,15779,3.6584743797820543,0.0,20.0
24313,2,4313,[302 483 100 127 313],474,5,15784,3.65878535002318,20.0,40.0
24314,2,4314,[195 194 183 215 210],882,4,15788,3.658864426419467,0.0,0.0
24315,2,4315,[ 12 174 286  97 143],7,4,15792,3.658943466172382,20.0,20.0
24316,2,4316,[302 483 100 127 313],207,4,15796,3.659022469307389,20.0,40.0
24317,2,4317,[ 79 180 603 161 301],524,4,15800,3.6591014358499305,20.0,0.0
24318,2,4318,[183 405  89 118   4],788,3,15803,3.658948830747858,0.0,0.0
24319,2,4319,[302 483 100 127 313],329,5,15808,3.6592592592592594,20.0,40.0
24320,2,4320,[144 423 245 655 173],454,2,15810,3.6588752603563988,0.0,0.0
24321,2,4321,[423 135 127 194 508],474,4,15814,3.6589541878759833,0.0,20.0
24322,2,4322,[302 483 100 127 313],207,4,15818,3.659033078880407,20.0,40.0
24323,2,4323,[302 483 100 127 313],474,5,15823,3.6593432007400555,20.0,40.0
24324,2,4324,[202 197 216  56 196],7,4,15827,3.659421965317919,0.0,0.0
24325,2,4325,[185  15 143 301 183],650,2,15829,3.6590383726306057,0.0,0.0
24326,2,4326,[ 79  98  69   1 216],194,3,15832,3.6588860642477465,0.0,20.0
24327,2,4327,[302 483 100 127 313],537,5,15837,3.659195933456562,20.0,40.0
24328,2,4328,[200 238 191  50 258],271,4,15841,3.6592746592746592,0.0,20.0
24329,2,4329,[211 435 181 143 508],13,3,15844,3.659122401847575,0.0,0.0
24330,2,4330,[143 187 234 496 333],346,2,15846,3.658739321172939,0.0,0.0
24331,2,4331,[302 483 100 127 313],328,5,15851,3.6590489381348106,20.0,40.0
24332,2,4332,[302 483 100 127 313],207,4,15855,3.6591276252019385,20.0,40.0
24333,2,4333,[302 483 100 127 313],13,5,15860,3.6594370096908166,20.0,40.0
24334,2,4334,[172 515 237 427 175],474,5,15865,3.6597462514417534,0.0,0.0
24335,2,4335,[302 483 100 127 313],90,5,15870,3.6600553505535056,20.0,40.0
24336,2,4336,[435 172   8 143   4],312,4,15874,3.660133732995158,0.0,0.0
24337,2,4337,[125 258 475 257 508],213,5,15879,3.660442600276625,0.0,0.0
24338,2,4338,[257 204 135  15 568],308,4,15883,3.660520857340401,0.0,0.0
24339,2,4339,[180 211 202 121 174],533,4,15887,3.6605990783410136,0.0,20.0
24340,2,4340,[ 50  71 403 471 153],899,4,15891,3.6606772633033864,0.0,20.0
24341,2,4341,[  8 423 144   4 357],144,5,15896,3.6609857208659604,20.0,0.0
24342,2,4342,[237 183 318 197 286],455,3,15899,3.660833525212986,20.0,0.0
24343,2,4343,[  9 286 215  70 182],184,5,15904,3.6611418047882136,0.0,0.0
24344,2,4344,[174 191 132 423 471],90,5,15909,3.6614499424626006,0.0,20.0
24345,2,4345,[302 483 100 127 313],207,4,15913,3.6615278416935113,20.0,40.0
24346,2,4346,[302 483 100 127 313],537,5,15918,3.6618357487922704,20.0,40.0
24347,2,4347,[ 28 328 174 588 403],234,1,15919,3.6612235510579576,0.0,20.0
24348,2,4348,[275  97 194 318 175],189,5,15924,3.6615313865256383,20.0,0.0
24349,2,4349,[302 483 100 127 313],474,5,15929,3.66183908045977,20.0,40.0
24350,2,4350,[483 234 496 475   8],452,3,15932,3.6616869685129854,20.0,0.0
24351,2,4351,[202  28 135  50 328],653,4,15936,3.661764705882353,0.0,20.0
24352,2,4352,[ 12 286  98 175 127],385,3,15939,3.6616126809097174,20.0,40.0
24353,2,4353,[302 483 100 127 313],207,4,15943,3.661690399632522,20.0,40.0
24354,2,4354,[127 186 179 435 483],897,2,15945,3.661308840413318,20.0,20.0
24355,2,4355,[333 471 289 228 322],537,0,15945,3.6604683195592287,0.0,0.0
24356,2,4356,[181 173 328  95 180],85,3,15948,3.6603167316961214,0.0,0.0
24357,2,4357,[ 50 183 135 204 174],91,5,15953,3.6606241395135384,0.0,40.0
24358,2,4358,[302 483 100 127 313],207,4,15957,3.6607019958706126,20.0,40.0
24359,2,4359,[ 12  69  97 185 385],42,4,15961,3.6607798165137613,20.0,0.0
24360,2,4360,[117 237 238  69 173],524,3,15964,3.6606282962623253,0.0,0.0
24361,2,4361,[302 483 100 127 313],537,5,15969,3.660935350756534,20.0,40.0
24362,2,4362,[132 678 237   4 111],474,4,15973,3.6610130644052257,0.0,0.0
24363,2,4363,[302 483 100 127 313],328,5,15978,3.6613198900091657,20.0,40.0
24364,2,4364,[302 483 100 127 313],474,5,15983,3.6616265750286368,20.0,40.0
24365,2,4365,[143   1 191 204 276],311,4,15987,3.6617040769583142,0.0,0.0
24366,2,4366,[302 483 100 127 313],537,5,15992,3.6620105335470576,20.0,40.0
24367,2,4367,[302 483 100 127 313],232,3,15995,3.6618589743589745,20.0,40.0
24368,2,4368,[ 28 176 216 546 496],899,4,15999,3.6619363698786906,0.0,0.0
24369,2,4369,[173 275 302 427 257],334,5,16004,3.6622425629290616,0.0,0.0
24370,2,4370,[302 483 100 127 313],334,5,16009,3.6625486158773737,20.0,40.0
24371,2,4371,[  1 228   9 183  56],200,5,16014,3.662854528819762,0.0,0.0
24372,2,4372,[515 168 161   4 222],774,0,16014,3.6620169220214955,0.0,0.0
24373,2,4373,[302 483 100 127 313],329,5,16019,3.662322816643804,20.0,40.0
24374,2,4374,[ 95  50 202 181  89],275,2,16021,3.661942857142857,0.0,20.0
24375,2,4375,[302 483 100 127 313],474,5,16026,3.6622486288848264,20.0,40.0
24376,2,4376,[216 183 271 187 204],158,3,16029,3.662097326936258,0.0,0.0
24377,2,4377,[ 95 151 143 678 222],537,0,16029,3.6612608497030608,0.0,0.0
24378,2,4378,[228 286 405 100 200],145,3,16032,3.6611098424297785,0.0,20.0
24379,2,4379,[187 117 144 313  28],13,4,16036,3.6611872146118722,0.0,0.0
24380,2,4380,[  1 258 216  56 121],59,3,16039,3.6610362930837708,0.0,0.0
24381,2,4381,[235 427 172 483  64],406,5,16044,3.6613418530351436,20.0,0.0
24382,2,4382,[357 265 135 235  97],290,2,16046,3.6609628108601413,20.0,0.0
24383,2,4383,[197 496 211 357  79],804,5,16051,3.6612682481751824,20.0,0.0
24384,2,4384,[302 483 100 127 313],474,5,16056,3.6615735461801595,20.0,40.0
24385,2,4385,[ 71 172 405 357  69],313,4,16060,3.6616507067943456,20.0,0.0
24386,2,4386,[302 483 100 127 313],334,5,16065,3.661955778436289,20.0,40.0
24387,2,4387,[196 173 234 603 144],454,2,16067,3.661577028258888,20.0,0.0
24388,2,4388,[237 301  89 196  25],666,2,16069,3.661198450672135,0.0,0.0
24389,2,4389,[302 483 100 127 313],334,5,16074,3.661503416856492,20.0,40.0
24390,2,4390,[215 403  98 313 187],328,3,16077,3.661352767023457,0.0,20.0
24391,2,4391,[322 111 194  25 286],119,5,16082,3.661657559198543,0.0,0.0
24392,2,4392,[ 25  95 144 118 135],308,3,16085,3.661506942863647,0.0,0.0
24393,2,4393,[153 132 204 496 405],295,5,16090,3.6618115612198454,0.0,0.0
24394,2,4394,[186 748 211 265 423],804,4,16094,3.6618885096700797,0.0,0.0
24395,2,4395,[ 96 237  95 300 173],749,3,16097,3.661737943585077,0.0,0.0
24396,2,4396,[ 71 568 235 121 172],313,4,16101,3.6618148737775758,0.0,0.0
24397,2,4397,[118  22 302 127 111],13,5,16106,3.662119145065939,0.0,20.0
24398,2,4398,[302 483 100 127 313],328,5,16111,3.6624232780177315,20.0,40.0
24399,2,4399,[182  79 742 202 237],184,2,16113,3.6620454545454546,0.0,0.0
24400,2,4400,[302 483 100 127 313],13,5,16118,3.6623494660304474,20.0,40.0
24401,2,4401,[ 64 403 597 235 328],92,2,16120,3.6619718309859155,0.0,0.0
24402,2,4402,[202 300 132 289 328],533,4,16124,3.662048603225074,0.0,0.0
24403,2,4403,[  4 176 196 185 181],374,2,16126,3.661671207992734,0.0,0.0
24404,2,4404,[318 568 127 234  50],194,2,16128,3.661293984108967,20.0,40.0
24405,2,4405,[423 294  50 176 678],648,3,16131,3.66114389468906,0.0,20.0
24406,2,4406,[237 300 258 286 245],423,4,16135,3.6612207851145904,0.0,0.0
24407,2,4407,[185  70 496 435  64],932,4,16139,3.6612976406533577,0.0,0.0
24408,2,4408,[515 117 204 191 405],406,3,16142,3.661147652528918,0.0,0.0
24409,2,4409,[302 483 100 127 313],474,5,16147,3.661451247165533,20.0,40.0
24410,2,4410,[238  82 196  96  64],92,4,16151,3.661527998186352,0.0,0.0
24411,2,4411,[427 176 185 403 515],890,4,16155,3.661604714415231,0.0,0.0
24412,2,4412,[546 174 228  70 151],60,5,16160,3.661907999093587,0.0,20.0
24413,2,4413,[655  89  22 423  97],474,5,16165,3.6622111463525147,0.0,0.0
24414,2,4414,[118 313 172 257 245],653,2,16167,3.6618346545866363,0.0,0.0
24415,2,4415,[100 235  11 135 483],447,4,16171,3.661911231884058,20.0,20.0
24416,2,4416,[  4 588  71 161  25],387,0,16171,3.661082182476794,0.0,0.0
24417,2,4417,[ 82 483   7 742 318],200,5,16176,3.6613852421910367,40.0,0.0
24418,2,4418,[180 546  11 185 323],328,2,16178,3.661009278117221,0.0,0.0
24419,2,4419,[302 483 100 127 313],232,3,16181,3.660859728506787,20.0,40.0
24420,2,4420,[268 144 405 597 125],92,3,16184,3.660710246550554,0.0,0.0
24421,2,4421,[302 483 100 127 313],334,5,16189,3.661013116236997,20.0,40.0
24422,2,4422,[176 222 173 289 435],387,2,16191,3.660637576305675,0.0,0.0
24423,2,4423,[302 483 100 127 313],537,5,16196,3.6609403254972874,20.0,40.0
24424,2,4424,[ 71  95 471 132 748],454,1,16197,3.6603389830508473,0.0,0.0
24425,2,4425,[435  22 179 655 403],59,5,16202,3.6606416629010394,0.0,0.0
24426,2,4426,[302 483 100 127 313],207,4,16206,3.660718319403659,20.0,40.0
24427,2,4427,[143  95 191 195 185],313,3,16209,3.660569105691057,0.0,0.0
24428,2,4428,[265 135 508 322   7],13,2,16211,3.6601941747572817,0.0,0.0
24429,2,4429,[ 50 197 121 151 168],749,4,16215,3.660270880361174,0.0,20.0
24430,2,4430,[ 12  22  50  15 289],271,4,16219,3.660347551342812,20.0,20.0
24431,2,4431,[302 483 100 127 313],90,5,16224,3.660649819494585,20.0,40.0
24432,2,4432,[515 174 180 742 173],387,4,16228,3.66072637040379,0.0,20.0
24433,2,4433,[603 174 302 216 235],13,3,16231,3.660577356788453,20.0,20.0
24434,2,4434,[294 204 269 179 174],13,2,16233,3.6602029312288615,0.0,20.0
24435,2,4435,[302 483 100 127 313],334,5,16238,3.6605049594229033,20.0,40.0
24436,2,4436,[258 111 197 202 294],537,2,16240,3.6601307189542482,0.0,0.0
24437,2,4437,[  8 655 222   1 204],795,2,16242,3.6597566471383507,0.0,0.0
24438,2,4438,[302 483 100 127 313],329,5,16247,3.6600585717503944,20.0,40.0
24439,2,4439,[  1  89 182 210  70],537,3,16250,3.65990990990991,0.0,0.0
24440,2,4440,[  8 282 275 117  97],271,3,16253,3.6597613150191397,0.0,0.0
24441,2,4441,[333 222 300 100 405],13,1,16254,3.659162539396668,0.0,20.0
24442,2,4442,[ 22  25 197  28 215],59,5,16259,3.6594643259059194,0.0,0.0
24443,2,4443,[182 100  69 200  64],653,4,16263,3.6595409540954096,0.0,20.0
24444,2,4444,[302 483 100 127 313],328,5,16268,3.6598425196850393,20.0,40.0
24445,2,4445,[302 483 100 127 313],334,5,16273,3.660143949617634,20.0,40.0
24446,2,4446,[ 71 181  70 196  96],474,5,16278,3.6604452439847086,0.0,0.0
24447,2,4447,[302 483 100 127 313],232,3,16281,3.660296762589928,20.0,40.0
24448,2,4448,[302 483 100 127 313],329,5,16286,3.6605978871656553,20.0,40.0
24449,2,4449,[100  50  12 257  11],447,4,16290,3.660674157303371,20.0,40.0
24450,2,4450,[234 515 257 186 172],666,1,16291,3.66007638732869,0.0,0.0
24451,2,4451,[288 269 173 144 265],650,3,16294,3.659928122192273,0.0,0.0
24452,2,4452,[302 483 100 127 313],232,3,16297,3.6597799236469797,20.0,40.0
24453,2,4453,[322 161  70 275 234],454,2,16299,3.6594072743601256,0.0,0.0
24454,2,4454,[302 483 100 127 313],334,5,16304,3.6597081930415265,20.0,40.0
24455,2,4455,[187 202 427 182  56],308,5,16309,3.660008976660682,0.0,0.0
24456,2,4456,[302 483 100 127 313],232,3,16312,3.659860892977339,20.0,40.0
24457,2,4457,[405 174 127  64 151],474,4,16316,3.6599371915657244,0.0,40.0
24458,2,4458,[181 183 597 180 144],447,4,16320,3.660013455931823,0.0,0.0
24459,2,4459,[127 228  98 186   9],533,4,16324,3.660089686098655,0.0,40.0
24460,2,4460,[121 210 153 185  97],843,0,16324,3.6592692221475005,0.0,0.0
24461,2,4461,[ 11 187 175 289  69],234,3,16327,3.659121470192739,0.0,0.0
24462,2,4462,[197 508 403 168 405],385,1,16328,3.6585256553887517,0.0,0.0
24463,2,4463,[144 471 588   9 121],378,4,16332,3.6586021505376345,0.0,0.0
24464,2,4464,[174 288 258  71 328],378,3,16335,3.658454647256439,0.0,20.0
24465,2,4465,[174 132 678 289 118],454,2,16337,3.6580832960143304,0.0,20.0
24466,2,4466,[132  12  70 173  15],474,5,16342,3.658383702708753,20.0,0.0
24467,2,4467,[216 111 144 655 181],643,4,16346,3.6584601611459266,0.0,0.0
24468,2,4468,[  9  12 161  50 237],271,4,16350,3.658536585365854,20.0,20.0
24469,2,4469,[302 483 100 127 313],329,5,16355,3.6588366890380315,20.0,40.0
24470,2,4470,[302 483 100 127 313],90,5,16360,3.6591366584656675,20.0,40.0
24471,2,4471,[  7 742 216   9 176],145,4,16364,3.6592128801431127,0.0,0.0
24472,2,4472,[111 173 265  70 194],474,5,16369,3.6595126313436173,0.0,0.0
24473,2,4473,[204 181 385  28 174],774,0,16369,3.6586946803755027,0.0,20.0
24474,2,4474,[ 50 121  89 748 180],899,4,16373,3.65877094972067,0.0,20.0
24475,2,4475,[182 135   7 172 258],380,1,16374,3.658176943699732,0.0,0.0
24476,2,4476,[302 483 100 127 313],328,5,16379,3.6584766584766584,20.0,40.0
24477,2,4477,[ 64 215 121   9  50],64,4,16383,3.658552925413131,0.0,20.0
24478,2,4478,[515 257 471 179 202],308,3,16386,3.6584058941728066,0.0,0.0
24479,2,4479,[302 483 100 127 313],207,4,16390,3.658482142857143,20.0,40.0
24480,2,4480,[302 483 100 127 313],329,5,16395,3.6587815219817004,20.0,40.0
24481,2,4481,[135  71 385 235 655],92,4,16399,3.6588576528335564,0.0,0.0
24482,2,4482,[302 483 100 127 313],474,5,16404,3.659156814633058,20.0,40.0
24483,2,4483,[185 238  50 313 210],64,4,16408,3.6592328278322928,0.0,20.0
24484,2,4484,[302 483 100 127 313],90,5,16413,3.6595317725752508,20.0,40.0
24485,2,4485,[238 603 597 204 179],899,2,16415,3.65916183682568,20.0,0.0
24486,2,4486,[302 483 100 127 313],329,5,16420,3.6594606641408514,20.0,40.0
24487,2,4487,[111  96 322  88 300],454,3,16423,3.659313725490196,0.0,0.0
24488,2,4488,[496 742   1  22  97],653,2,16425,3.658944085542437,0.0,0.0
24489,2,4489,[302 483 100 127 313],329,5,16430,3.65924276169265,20.0,40.0
24490,2,4490,[546  70 216 111 179],643,3,16433,3.659095969717212,0.0,0.0
24491,2,4491,[ 25   7 183 187 117],387,3,16436,3.658949243098842,0.0,0.0
24492,2,4492,[302 483 100 127 313],90,5,16441,3.659247718673492,20.0,40.0
24493,2,4493,[322 238 318 245 228],804,5,16446,3.65954606141522,20.0,0.0
24494,2,4494,[194   4 196  56  96],326,2,16448,3.6591768631813126,0.0,0.0
24495,2,4495,[302 483 100 127 313],537,5,16453,3.6594750889679717,20.0,40.0
24496,2,4496,[288 265 222 748   1],102,0,16453,3.658661329775406,0.0,0.0
24497,2,4497,[435 183 302 135   9],378,4,16457,3.658737216540685,0.0,0.0
24498,2,4498,[302 483 100 127 313],232,3,16460,3.6585907979551013,20.0,40.0
24499,2,4499,[385 151 258 127 180],666,3,16463,3.6584444444444446,0.0,20.0
24500,2,4500,[197 588 143 182 132],13,4,16467,3.658520328815819,0.0,0.0
24501,2,4501,[195 173 135 196 153],804,4,16471,3.6585961794757886,0.0,0.0
24502,2,4502,[ 96 357   9 258 228],311,5,16476,3.658894070619587,20.0,0.0
24503,2,4503,[  7 125  71 168 427],6,3,16479,3.6587477797513324,0.0,0.0
24504,2,4504,[117 172 132  11  22],334,2,16481,3.658379578246393,0.0,0.0
24505,2,4505,[ 69  25   4 191 200],378,2,16483,3.658011540168664,0.0,0.0
24506,2,4506,[127 216 328 235 210],313,4,16487,3.6580874195695583,0.0,20.0
24507,2,4507,[508 235 655   4  12],334,2,16489,3.657719609582964,20.0,0.0
24508,2,4508,[172 215 182 238  70],64,5,16494,3.6580172987358615,0.0,0.0
24509,2,4509,[ 15 568 117 100 204],194,3,16497,3.657871396895787,0.0,20.0
24510,2,4510,[176  71 546 323 125],897,5,16502,3.658168920416759,0.0,0.0
24511,2,4511,[655 143   8 185 313],234,2,16504,3.6578014184397163,0.0,0.0
24512,2,4512,[258 568 180 234 288],339,2,16506,3.6574340793263906,0.0,0.0
24513,2,4513,[195 186 194 144 323],378,2,16508,3.6570669029685425,0.0,0.0
24514,2,4514,[258 275  82 333 161],13,2,16510,3.6566998892580287,0.0,0.0
24515,2,4515,[302 483 100 127 313],90,5,16515,3.656997342781222,20.0,40.0
24516,2,4516,[271 211 258 153 132],64,2,16517,3.656630506973655,0.0,0.0
24517,2,4517,[180 238   7 153  64],840,4,16521,3.6567065073041167,0.0,0.0
24518,2,4518,[302 483 100 127 313],13,5,16526,3.6570037618942246,20.0,40.0
24519,2,4519,[215  98 182 328  22],753,3,16529,3.656858407079646,0.0,20.0
24520,2,4520,[435   8 179  28 403],387,3,16532,3.6567131165671314,0.0,0.0
24521,2,4521,[302 483 100 127 313],13,5,16537,3.6570101724900486,20.0,40.0
24522,2,4522,[742  79   7 179 111],524,3,16540,3.6568649126685826,0.0,0.0
24523,2,4523,[275 568 385 179 202],648,5,16545,3.657161803713528,0.0,0.0
24524,2,4524,[302 483 100 127 313],232,3,16548,3.6570165745856356,20.0,40.0
24525,2,4525,[125   1 678 179  82],554,1,16549,3.6564295183384887,0.0,0.0
24526,2,4526,[ 15 508 234  95 228],60,5,16554,3.656726308813784,0.0,0.0
24527,2,4527,[328 357 238 301 427],85,2,16556,3.6563604240282683,20.0,0.0
24528,2,4528,[357 333 268 187 168],13,3,16559,3.6562155001103998,20.0,0.0
24529,2,4529,[302 483 100 127 313],232,3,16562,3.6560706401766003,20.0,40.0
24530,2,4530,[200 515 269 118 237],145,4,16566,3.656146546016332,0.0,0.0
24531,2,4531,[185  12 546 385 435],194,3,16569,3.6560017652250663,20.0,0.0
24532,2,4532,[568  98 269 117  64],524,2,16571,3.655636443856166,0.0,20.0
24533,2,4533,[181  64  89 258 182],537,3,16574,3.6554918394353773,0.0,0.0
24534,2,4534,[135 483 302 496 187],666,5,16579,3.6557883131201763,20.0,0.0
24535,2,4535,[194 204 143  79  22],749,5,16584,3.6560846560846563,0.0,0.0
24536,2,4536,[597  70 121 222   1],84,3,16587,3.6559400484901916,0.0,0.0
24537,2,4537,[302 483 100 127 313],232,3,16590,3.6557955046275894,20.0,40.0
24538,2,4538,[302 483 100 127 313],90,5,16595,3.6560916501432033,20.0,40.0
24539,2,4539,[ 69 322 135 288 289],234,3,16598,3.6559471365638765,0.0,0.0
24540,2,4540,[125 286  88 275  15],406,1,16599,3.65536225500991,0.0,0.0
24541,2,4541,[323 118 318 273 748],13,2,16601,3.654997798326728,20.0,0.0
24542,2,4542,[302 483 100 127 313],329,5,16606,3.6552938586836894,20.0,40.0
24543,2,4543,[117 144 235  97   7],788,3,16609,3.655149647887324,0.0,0.0
24544,2,4544,[302 483 100 127 313],207,4,16613,3.6552255225522554,20.0,40.0
24545,2,4545,[302 483 100 127 313],13,5,16618,3.6555213374395072,20.0,40.0
24546,2,4546,[187 269 118 215 135],7,3,16621,3.655377171761601,0.0,0.0
24547,2,4547,[268 132 238 405  50],85,3,16624,3.6552330694810906,0.0,20.0
24548,2,4548,[302 483 100 127 313],13,5,16629,3.6555286876236535,20.0,40.0
24549,2,4549,[196 187 427 258 288],343,4,16633,3.6556043956043958,0.0,0.0
24550,2,4550,[302 483 100 127 313],207,4,16637,3.6556800703142165,20.0,40.0
24551,2,4551,[187 313 179 196  71],64,4,16641,3.655755711775044,0.0,0.0
24552,2,4552,[ 98 655 496 435  11],454,1,16642,3.6551724137931036,0.0,20.0
24553,2,4553,[  7 144 185  95 180],308,4,16646,3.6552481335090032,0.0,0.0
24554,2,4554,[176 275 237 597 194],899,4,16650,3.655323819978046,0.0,0.0
24555,2,4555,[175 118  64 268  50],7,3,16653,3.6551799824407376,0.0,20.0
24556,2,4556,[143 172 210 185 204],524,1,16654,3.654597322800088,0.0,0.0
24557,2,4557,[357 238 195  11 435],840,4,16658,3.654673102237824,20.0,0.0
24558,2,4558,[195  64  89  11 423],840,4,16662,3.6547488484316735,0.0,0.0
24559,2,4559,[655 603  89  88 191],13,4,16666,3.6548245614035086,20.0,0.0
24560,2,4560,[172  71 435 121   7],13,4,16670,3.6549002411751808,0.0,0.0
24561,2,4561,[294  22  82 118  88],378,4,16674,3.6549758877685226,0.0,0.0
24562,2,4562,[ 11 100 655 186 313],207,3,16677,3.6548323471400392,0.0,20.0
24563,2,4563,[302 483 100 127 313],537,5,16682,3.6551270815074495,20.0,40.0
24564,2,4564,[215 234 200 228 153],788,1,16683,3.6545454545454548,0.0,0.0
24565,2,4565,[302 483 100 127 313],328,5,16688,3.6548401226456417,20.0,40.0
24566,2,4566,[302 483 100 127 313],328,5,16693,3.655134661703525,20.0,40.0
24567,2,4567,[151 187  98 403 238],7,5,16698,3.655429071803853,0.0,20.0
24568,2,4568,[132 118 435 215  70],13,4,16702,3.6555044867585904,0.0,0.0
24569,2,4569,[302 483 100 127 313],329,5,16707,3.6557986870897157,20.0,40.0
24570,2,4570,[ 28 496 118 191 228],7,4,16711,3.6558739881863924,0.0,0.0
24571,2,4571,[100 161 276 546 173],339,4,16715,3.655949256342957,0.0,20.0
24572,2,4572,[318   1 427  96 288],533,4,16719,3.656024491581019,20.0,0.0
24573,2,4573,[234  95 183  96 132],506,5,16724,3.656318320944469,0.0,0.0
24574,2,4574,[191 515  71 237 180],95,3,16727,3.656174863387978,0.0,0.0
24575,2,4575,[302 483 100 127 313],334,5,16732,3.6564685314685317,20.0,40.0
24576,2,4576,[168 176 179   9 515],339,5,16737,3.656762071225694,0.0,0.0
24577,2,4577,[423  79 742 289 282],92,2,16739,3.6564001747487986,0.0,0.0
24578,2,4578,[174 176 127 210 405],102,1,16740,3.655820048045425,0.0,40.0
24579,2,4579,[168  64   7 200 357],10,5,16745,3.656113537117904,20.0,0.0
24580,2,4580,[302 483 100 127 313],207,4,16749,3.656188605108055,20.0,40.0
24581,2,4581,[  1  98 435 288 655],804,3,16752,3.656045395024007,0.0,20.0
24582,2,4582,[ 71 265  50 200  96],95,3,16755,3.655902247436177,0.0,20.0
24583,2,4583,[182 333 132 118 357],653,2,16757,3.6555410122164047,20.0,0.0
24584,2,4584,[302 483 100 127 313],90,5,16762,3.655834242093784,20.0,40.0
24585,2,4585,[194 322 180 427  96],474,5,16767,3.6561273440907107,0.0,0.0
24586,2,4586,[ 28 275  15 180 196],189,4,16771,3.65620231087857,0.0,0.0
24587,2,4587,[302 483 100 127 313],474,5,16776,3.656495204882302,20.0,40.0
24588,2,4588,[172   1 603 186 174],648,5,16781,3.656787971235563,20.0,20.0
24589,2,4589,[235 200 210 173 161],804,4,16785,3.656862745098039,0.0,0.0
24590,2,4590,[302 483 100 127 313],328,5,16790,3.6571553038553692,20.0,40.0
24591,2,4591,[ 88  50 127 181 143],643,3,16793,3.6570121951219514,0.0,40.0
24592,2,4592,[302 483 100 127 313],328,5,16798,3.657304593947311,20.0,40.0
24593,2,4593,[302 483 100 127 313],328,5,16803,3.657596865476709,20.0,40.0
24594,2,4594,[318   4 234 173 121],271,4,16807,3.657671381936888,20.0,0.0
24595,2,4595,[302 483 100 127 313],537,5,16812,3.657963446475196,20.0,40.0
24596,2,4596,[121 179 183 143 678],92,3,16815,3.657820317598434,0.0,0.0
24597,2,4597,[  9 318   7 168 172],380,2,16817,3.6574597651152674,20.0,0.0
24598,2,4598,[ 15 194  97 471 515],313,4,16821,3.6575342465753424,0.0,0.0
24599,2,4599,[181 135 195 216  97],533,3,16824,3.657391304347826,0.0,0.0
24600,2,4600,[302 483 100 127 313],207,4,16828,3.6574657683112366,20.0,40.0
24601,2,4601,[302 483 100 127 313],329,5,16833,3.6577574967405475,20.0,40.0
24602,2,4602,[ 71 403 405 357  56],60,3,16836,3.6576145991744515,20.0,0.0
24603,2,4603,[302 483 100 127 313],474,5,16841,3.6579061685490877,20.0,40.0
24604,2,4604,[258  28 269 196 357],85,4,16845,3.6579804560260585,20.0,0.0
24605,2,4605,[302 483 100 127 313],474,5,16850,3.6582718193660444,20.0,40.0
24606,2,4606,[144 568 132 202 118],308,2,16852,3.6579118732363796,0.0,0.0
24607,2,4607,[216 508 603 135 179],60,5,16857,3.658203125,20.0,0.0
24608,2,4608,[100 202  88 210 742],650,1,16858,3.657626383163376,0.0,20.0
24609,2,4609,[204 127   4 313 111],533,4,16862,3.657700650759219,0.0,20.0
24610,2,4610,[300  64 423 286 483],380,2,16864,3.6573411407503795,20.0,0.0
24611,2,4611,[300 195  64 405 403],13,1,16865,3.656764960971379,0.0,0.0
24612,2,4612,[ 69  82 222 200 183],328,4,16869,3.6568393670062864,0.0,0.0
24613,2,4613,[302 483 100 127 313],13,5,16874,3.657130472475076,20.0,40.0
24614,2,4614,[215 286  79 435 187],406,1,16875,3.656554712892741,0.0,0.0
24615,2,4615,[258 588 153  22 191],144,5,16880,3.65684575389948,0.0,0.0
24616,2,4616,[ 88 174  50 403  64],533,4,16884,3.6569200779727096,0.0,40.0
24617,2,4617,[197 603   9 161  79],308,3,16887,3.6567778258986574,20.0,0.0
24618,2,4618,[211 215 471 275 216],328,2,16889,3.6564191383416325,0.0,0.0
24619,2,4619,[ 28 318 121 289 118],92,1,16890,3.655844155844156,20.0,0.0
24620,2,4620,[ 69 215 127 271  79],328,3,16893,3.655702228954772,0.0,20.0
24621,2,4621,[302 483 100 127 313],474,5,16898,3.655993076590221,20.0,40.0
24622,2,4622,[302 483 100 127 313],90,5,16903,3.6562837983993077,20.0,40.0
24623,2,4623,[196 144 318 483 237],694,5,16908,3.656574394463668,40.0,0.0
24624,2,4624,[ 79 183 423 405 175],840,5,16913,3.6568648648648647,0.0,0.0
24625,2,4625,[194  11 318 117 179],406,5,16918,3.6571552096843924,20.0,0.0
24626,2,4626,[302 483 100 127 313],328,5,16923,3.657445429003674,20.0,40.0
24627,2,4627,[302 483 100 127 313],13,5,16928,3.657735522904062,20.0,40.0
24628,2,4628,[  9 117 435 204 300],788,3,16931,3.657593432706848,0.0,0.0
24629,2,4629,[302 483 100 127 313],474,5,16936,3.6578833693304538,20.0,40.0
24630,2,4630,[302 483 100 127 313],474,5,16941,3.6581731807385016,20.0,40.0
24631,2,4631,[302  12 100 186 174],537,3,16944,3.6580310880829017,20.0,40.0
24632,2,4632,[427 496 235 405  79],271,3,16947,3.657889056766674,0.0,0.0
24633,2,4633,[ 64 300 328 265  22],653,5,16952,3.6581786793267157,0.0,0.0
24634,2,4634,[ 69   4  22 143 265],334,1,16953,3.6576051779935277,0.0,0.0
24635,2,4635,[302 483 100 127 313],207,4,16957,3.657679033649698,20.0,40.0
24636,2,4636,[302 483 100 127 313],232,3,16960,3.657537200776364,20.0,40.0
24637,2,4637,[ 64 111 286 475 186],207,2,16962,3.6571798188874514,0.0,0.0
24638,2,4638,[302 483 100 127 313],329,5,16967,3.6574692821728823,20.0,40.0
24639,2,4639,[302 483 100 127 313],334,5,16972,3.657758620689655,20.0,40.0
24640,2,4640,[588 176 135  70 655],881,3,16975,3.6576168929110104,0.0,0.0
24641,2,4641,[302 483 100 127 313],334,5,16980,3.6579060749676864,20.0,40.0
24642,2,4642,[288 318 174 234 328],533,3,16983,3.6577643764807237,20.0,20.0
24643,2,4643,[202 211 197 271 194],379,4,16987,3.657838070628768,0.0,0.0
24644,2,4644,[ 69 603 211  82 301],13,3,16990,3.657696447793326,20.0,0.0
24645,2,4645,[161 200  82 172  98],387,4,16994,3.657770124838571,0.0,20.0
24646,2,4646,[216 318 195  50  97],738,4,16998,3.657843770174306,20.0,20.0
24647,2,4647,[294 678 183 168 216],82,3,17001,3.6577022375215145,0.0,0.0
24648,2,4648,[302 483 100 127 313],537,5,17006,3.6579909657990965,20.0,40.0
24649,2,4649,[275 300 271 172 182],871,4,17010,3.6580645161290324,0.0,0.0
24650,2,4650,[195 276 151  15 210],892,5,17015,3.6583530423564823,0.0,0.0
24651,2,4651,[403 742  70 121  82],158,5,17020,3.658641444539983,0.0,0.0
24652,2,4652,[ 11 173 515  22 333],537,2,17022,3.6582849774339135,0.0,0.0
24653,2,4653,[ 28 385 288 181 185],897,3,17025,3.6581435324452083,0.0,0.0
24654,2,4654,[216 282 300  79 144],653,2,17027,3.6577873254564985,0.0,0.0
24655,2,4655,[117  70 678 211 174],13,2,17029,3.6574312714776633,0.0,20.0
24656,2,4656,[302 483 100 127 313],90,5,17034,3.657719561949753,20.0,40.0
24657,2,4657,[ 89 200  22  98 289],537,1,17035,3.6571489909832544,0.0,20.0
24658,2,4658,[194 655  88 269 508],537,1,17036,3.65657866494956,0.0,0.0
24659,2,4659,[121 258 168 357 301],650,2,17038,3.6562231759656654,20.0,0.0
24660,2,4660,[302 483 100 127 313],334,5,17043,3.6565114782235573,20.0,40.0
24661,2,4661,[313 117 100 237 111],537,2,17045,3.656156156156156,0.0,20.0
24662,2,4662,[168  64 385  88 181],774,0,17045,3.6553720780613337,0.0,0.0
24663,2,4663,[302 483 100 127 313],232,3,17048,3.6552315608919383,20.0,40.0
24664,2,4664,[172 200 173 211 313],738,3,17051,3.655091103965702,0.0,0.0
24665,2,4665,[302 483 100 127 313],474,5,17056,3.655379339905701,20.0,40.0
24666,2,4666,[237  70 234 180  15],234,1,17057,3.654810370687808,0.0,0.0
24667,2,4667,[276 196 186  56  98],339,5,17062,3.6550985432733505,0.0,20.0
24668,2,4668,[515  98 195 185  89],95,3,17065,3.65495823516813,0.0,20.0
24669,2,4669,[ 71 176 168 183  96],308,5,17070,3.6552462526766596,0.0,0.0
24670,2,4670,[302 483 100 127 313],328,5,17075,3.6555341468636264,20.0,40.0
24671,2,4671,[153 328 185 191 200],13,1,17076,3.6549657534246576,0.0,0.0
24672,2,4672,[475 322 238  82 405],92,2,17078,3.654611598544832,0.0,0.0
24673,2,4673,[265  11   8  79 132],308,3,17081,3.654471544715447,0.0,0.0
24674,2,4674,[234  96  82 588 385],326,0,17081,3.6536898395721926,0.0,0.0
24675,2,4675,[302 483 100 127 313],328,5,17086,3.653977758768178,20.0,40.0
24676,2,4676,[289 151 100 117  70],406,2,17088,3.6536241180243745,0.0,20.0
24677,2,4677,[302 483 100 127 313],328,5,17093,3.6539119281744337,20.0,40.0
24678,2,4678,[174 273 385 237 265],537,0,17093,3.6531310108997648,0.0,20.0
24679,2,4679,[161 186 269 144 211],738,3,17096,3.652991452991453,0.0,0.0
24680,2,4680,[ 12 153 423 202  69],666,3,17099,3.652851954710532,20.0,0.0
24681,2,4681,[318   7  25 423 405],374,2,17101,3.6524989320803076,20.0,0.0
24682,2,4682,[302 483 100 127 313],329,5,17106,3.6527866752082,20.0,40.0
24683,2,4683,[ 28 118 132 144 318],454,4,17110,3.652860802732707,20.0,0.0
24684,2,4684,[302 483 100 127 313],328,5,17115,3.6531483457844183,20.0,40.0
24685,2,4685,[302 483 100 127 313],474,5,17120,3.6534357661118224,20.0,40.0
24686,2,4686,[302 483 100 127 313],90,5,17125,3.6537230637934712,20.0,40.0
24687,2,4687,[286 258 328 185 216],334,3,17128,3.65358361774744,0.0,0.0
24688,2,4688,[245   7  82 100 216],92,3,17131,3.653444231179356,0.0,20.0
24689,2,4689,[302 483 100 127 313],90,5,17136,3.653731343283582,20.0,40.0
24690,2,4690,[302 483 100 127 313],232,3,17139,3.6535919846514604,20.0,40.0
24691,2,4691,[195 322 276  97 161],881,3,17142,3.653452685421995,0.0,0.0
24692,2,4692,[111 546 257 265 121],92,2,17144,3.6531003622416365,0.0,0.0
24693,2,4693,[ 89 100 423  56 215],385,3,17147,3.6529612270984235,0.0,20.0
24694,2,4694,[313 322  82 403 228],883,3,17150,3.652822151224707,0.0,0.0
24695,2,4695,[197 176 655   9 200],379,5,17155,3.653109028960818,0.0,0.0
24696,2,4696,[135 294  79 173 216],474,4,17159,3.6531828826910795,0.0,0.0
24697,2,4697,[216  64  70  56 143],474,5,17164,3.6534695615155384,0.0,0.0
24698,2,4698,[302 483 100 127 313],328,5,17169,3.6537561183230474,20.0,40.0
24699,2,4699,[655  11 496 515 258],339,4,17173,3.6538297872340424,0.0,0.0
24700,2,4700,[135 191  98 318 313],233,5,17178,3.654116145500957,20.0,20.0
24701,2,4701,[228 257 294 191 180],749,3,17181,3.6539770310506166,0.0,0.0
24702,2,4702,[216 168  98  64  71],533,5,17186,3.6542632362321923,0.0,20.0
24703,2,4703,[237  56 313 176 186],474,5,17191,3.654549319727891,0.0,0.0
24704,2,4704,[172 235 100 183 174],537,1,17192,3.6539851222104143,0.0,40.0
24705,2,4705,[302 483 100 127 313],537,5,17197,3.6542711432214197,20.0,40.0
24706,2,4706,[ 95  22 210 196 301],83,4,17201,3.6543445931591245,0.0,0.0
24707,2,4707,[302 483 100 127 313],232,3,17204,3.6542056074766354,20.0,40.0
24708,2,4708,[173 257 121 245 238],92,3,17207,3.654066680823954,0.0,0.0
24709,2,4709,[302 483 100 127 313],90,5,17212,3.654352441613588,20.0,40.0
24710,2,4710,[204  97 210 515 100],87,5,17217,3.654638081086818,0.0,20.0
24711,2,4711,[195  89 118   7 403],92,4,17221,3.6547113752122242,0.0,0.0
24712,2,4712,[  4 322 183 289 268],13,3,17224,3.6545724591555273,0.0,0.0
24713,2,4713,[302 483 100 127 313],328,5,17229,3.65485787017395,20.0,40.0
24714,2,4714,[153 234  22 117  98],648,4,17233,3.654931071049841,0.0,20.0
24715,2,4715,[135 143   1  70 323],311,3,17236,3.6547921967769295,0.0,0.0
24716,2,4716,[655 228 191 257 282],334,5,17241,3.655077379690481,0.0,0.0
24717,2,4717,[435 211 318 195 216],666,3,17244,3.654938533276812,20.0,0.0
24718,2,4718,[ 97 195 132 172 176],474,5,17249,3.6552235643144733,0.0,0.0
24719,2,4719,[151 403   4 210  79],738,3,17252,3.655084745762712,0.0,0.0
24720,2,4720,[  9 475 300 191 132],605,3,17255,3.654945986019911,0.0,0.0
24721,2,4721,[302 483 100 127 313],537,5,17260,3.655230834392207,20.0,40.0
24722,2,4722,[211 132 222 289  88],13,3,17263,3.655092102477239,0.0,0.0
24723,2,4723,[423 127 132  96 204],643,4,17267,3.6551651143099066,0.0,20.0
24724,2,4724,[182 194 210 403 187],650,1,17268,3.6546031746031744,0.0,0.0
24725,2,4725,[302 483 100 127 313],90,5,17273,3.6548878544223444,20.0,40.0
24726,2,4726,[275  98 222 153 127],406,2,17275,3.6545377617939496,0.0,40.0
24727,2,4727,[125 318 435 100 265],194,4,17279,3.654610829103215,20.0,20.0
24728,2,4728,[302 483 100 127 313],90,5,17284,3.6548953267075492,20.0,40.0
24729,2,4729,[302 100 483 216 186],158,3,17287,3.6547568710359406,20.0,20.0
24730,2,4730,[238 143   1  15 161],95,4,17291,3.654829845698584,0.0,0.0
24731,2,4731,[302 483 100 127 313],334,5,17296,3.655114116652578,20.0,40.0
24732,2,4732,[ 28 174 294 405 222],374,4,17300,3.655186984998944,0.0,20.0
24733,2,4733,[ 12 176 328 333 597],548,5,17305,3.655471060414026,20.0,0.0
24734,2,4734,[173 196 172 174 132],326,5,17310,3.655755015839493,0.0,20.0
24735,2,4735,[405  89 271 121 143],13,2,17312,3.6554054054054053,0.0,0.0
24736,2,4736,[144 153 117   1  64],95,5,17317,3.655689254802618,0.0,0.0
24737,2,4737,[597 181 174 186 748],899,3,17320,3.655550865344027,0.0,20.0
24738,2,4738,[204 186 187 172 258],334,3,17323,3.6554125342899346,0.0,0.0
24739,2,4739,[143  12 176 294 195],311,4,17327,3.6554852320675106,20.0,0.0
24740,2,4740,[216 168 186 195  89],59,5,17332,3.655768825142375,0.0,0.0
24741,2,4741,[202 118  98 496 483],643,2,17334,3.655419654154365,20.0,20.0
24742,2,4742,[ 69 282 100 151 118],374,4,17338,3.655492304448661,0.0,20.0
24743,2,4743,[302 483 100 127 313],13,5,17343,3.655775716694772,20.0,40.0
24744,2,4744,[144 215 143 403 191],749,5,17348,3.656059009483667,0.0,0.0
24745,2,4745,[302 483 100 127 313],90,5,17353,3.6563421828908553,20.0,40.0
24746,2,4746,[302 483 100 127 313],474,5,17358,3.6566252369917844,20.0,40.0
24747,2,4747,[117  70  25 597  95],455,1,17359,3.6560657118786857,0.0,0.0
24748,2,4748,[603 323 173 151  95],897,3,17362,3.6559275636976207,20.0,0.0
24749,2,4749,[ 12 655  25 403 210],59,5,17367,3.6562105263157894,20.0,0.0
24750,2,4750,[588 301  97 132   1],184,3,17370,3.6560724058093035,0.0,0.0
24751,2,4751,[603 118 144 322  89],749,4,17374,3.656144781144781,20.0,0.0
24752,2,4752,[302   1 237  89 483],454,2,17376,3.6557963391542185,20.0,0.0
24753,2,4753,[  9  79 234 333 187],328,4,17380,3.6558687421119056,0.0,0.0
24754,2,4754,[302 483 100 127 313],90,5,17385,3.6561514195583595,20.0,40.0
24755,2,4755,[588 357 318 127  96],892,5,17390,3.6564339781328847,40.0,20.0
24756,2,4756,[186 172 210 127 200],643,4,17394,3.656506201387429,0.0,20.0
24757,2,4757,[215 144  95 180 195],843,1,17395,3.6559478772593526,0.0,0.0
24758,2,4758,[302 385 294 197  95],378,3,17398,3.6558100441269175,0.0,0.0
24759,2,4759,[302 483 100 127 313],207,4,17402,3.6558823529411764,20.0,40.0
24760,2,4760,[100 168 318 742 269],488,3,17405,3.65574459147238,20.0,20.0
24761,2,4761,[275  12  64 210 508],474,3,17408,3.655606887862243,20.0,0.0
24762,2,4762,[302 483 100 127 313],329,5,17413,3.655889145496536,20.0,40.0
24763,2,4763,[302 483 100 127 313],537,5,17418,3.6561712846347607,20.0,40.0
24764,2,4764,[  4 187 269 186 132],650,3,17421,3.6560335781741866,0.0,0.0
24765,2,4765,[185 322 237 176   9],234,0,17421,3.6552664708350817,0.0,0.0
24766,2,4766,[269 186 173 257 121],271,4,17425,3.655338787497378,0.0,0.0
24767,2,4767,[275 238   7 678 204],308,4,17429,3.6554110738255035,0.0,0.0
24768,2,4768,[302 483 100 127 313],207,4,17433,3.6554833298385407,20.0,40.0
24769,2,4769,[294 210 286  79 282],200,5,17438,3.6557651991614257,0.0,0.0
24770,2,4770,[742 173  70 515 204],207,2,17440,3.655418151330958,0.0,0.0
24771,2,4771,[302 483 100 127 313],334,5,17445,3.6556999161777033,20.0,40.0
24772,2,4772,[228 238 286 265 515],234,1,17446,3.655143515608632,0.0,0.0
24773,2,4773,[174 179 323 568  69],537,1,17447,3.654587348135735,0.0,20.0
24774,2,4774,[427  79 196 222 186],343,5,17452,3.654869109947644,0.0,0.0
24775,2,4775,[234 515 588 496 204],7,4,17456,3.6549413735343386,0.0,0.0
24776,2,4776,[211 204  22 144   9],7,5,17461,3.6552229432698344,0.0,0.0
24777,2,4777,[151  71 195 235 238],313,3,17464,3.655085809962327,0.0,0.0
24778,2,4778,[187 196  88 153 143],339,5,17469,3.6553672316384183,0.0,0.0
24779,2,4779,[210 286 173 222 603],387,4,17473,3.655439330543933,20.0,0.0
24780,2,4780,[175 568  95 200 204],881,3,17476,3.655302238025518,0.0,0.0
24781,2,4781,[ 56  69 603 288  50],843,1,17477,3.6547469677959015,20.0,20.0
24782,2,4782,[ 98  11  71 228 172],13,4,17481,3.6548191511603596,0.0,20.0
24783,2,4783,[ 71 655 135 216 211],406,2,17483,3.654473244147157,0.0,0.0
24784,2,4784,[427 546 121  70 357],271,3,17486,3.6543364681295714,20.0,0.0
24785,2,4785,[  1 180 179   8 228],536,4,17490,3.654408692018387,0.0,0.0
24786,2,4786,[597 216 405  70 235],882,3,17493,3.6542719866304574,0.0,0.0
24787,2,4787,[ 96 318  79 200 117],543,3,17496,3.654135338345865,20.0,0.0
24788,2,4788,[318 100  71 173 275],6,5,17501,3.6544163708498645,20.0,20.0
24789,2,4789,[302 483 100 127 313],232,3,17504,3.6542797494780794,20.0,40.0
24790,2,4790,[302 483 100 127 313],474,5,17509,3.654560634523064,20.0,40.0
24791,2,4791,[234 118  89 427 182],194,1,17510,3.6540066777963274,0.0,0.0
24792,2,4792,[258 176 186   8  95],271,3,17513,3.65387022741498,0.0,0.0
24793,2,4793,[181  69 135 471  22],524,2,17515,3.6535252398831872,0.0,0.0
24794,2,4794,[  8 191 181 211  11],64,5,17520,3.653806047966632,0.0,0.0
24795,2,4795,[302 483 100 127 313],90,5,17525,3.654086738949124,20.0,40.0
24796,2,4796,[ 82 475 588 385 237],64,4,17529,3.6541588492808006,0.0,0.0
24797,2,4797,[302 483 100 127 313],90,5,17534,3.6544393497290537,20.0,40.0
24798,2,4798,[302 483 100 127 313],474,5,17539,3.654719733277766,20.0,40.0
24799,2,4799,[ 79  22 289 357 515],488,4,17543,3.6547916666666667,20.0,0.0
24800,2,4800,[496 385 161 143 100],59,3,17546,3.6546552801499685,0.0,20.0
24801,2,4801,[302 483 100 127 313],537,5,17551,3.654935443565181,20.0,40.0
24802,2,4802,[200 603 151   1 197],648,2,17553,3.654590880699563,20.0,0.0
24803,2,4803,[301 269 546 273 186],279,3,17556,3.6544546211490423,0.0,0.0
24804,2,4804,[ 69  96 742 185 135],543,4,17560,3.6545265348595213,0.0,0.0
24805,2,4805,[748 194 153   8 269],64,3,17563,3.6543903454015814,0.0,0.0
24806,2,4806,[ 98 237 271 385   1],749,3,17566,3.6542542126066153,0.0,20.0
24807,2,4807,[403 143 196 179 423],650,2,17568,3.653910149750416,0.0,0.0
24808,2,4808,[ 97 258  69  79 288],339,3,17571,3.6537741734248286,0.0,0.0
24809,2,4809,[121 471 187 235 588],194,2,17573,3.6534303534303536,0.0,0.0
24810,2,4810,[228 385  88 182 176],506,5,17578,3.6537102473498235,0.0,0.0
24811,2,4811,[302 483 100 127 313],474,5,17583,3.653990024937656,20.0,40.0
24812,2,4812,[302 483 100 127 313],329,5,17588,3.6542696862663617,20.0,40.0
24813,2,4813,[ 70  12 228  69 568],194,2,17590,3.653926049023681,20.0,0.0
24814,2,4814,[302 483 100 127 313],328,5,17595,3.6542056074766354,20.0,40.0
24815,2,4815,[427 211 173 588 385],452,3,17598,3.6540697674418605,0.0,0.0
24816,2,4816,[302 483 100 127 313],232,3,17601,3.653933983807349,20.0,40.0
24817,2,4817,[204 135 273 197 405],479,5,17606,3.6542133665421335,0.0,0.0
24818,2,4818,[ 89 508 121  50 269],378,5,17611,3.654492633326416,0.0,20.0
24819,2,4819,[197 405 471 275 183],378,2,17613,3.654149377593361,0.0,0.0
24820,2,4820,[  7 204 127  70 475],6,2,17615,3.6538062642605267,0.0,20.0
24821,2,4821,[288 197 483 435 100],452,3,17618,3.6536706760680215,20.0,20.0
24822,2,4822,[204 222 258  89 294],474,4,17622,3.653742483931163,0.0,0.0
24823,2,4823,[302 483 100 127 313],474,5,17627,3.654021558872305,20.0,40.0
24824,2,4824,[302 483 100 127 313],328,5,17632,3.6543005181347152,20.0,40.0
24825,2,4825,[302 483 100 127 313],474,5,17637,3.6545793617903026,20.0,40.0
24826,2,4826,[302 483 100 127 313],232,3,17640,3.6544437538844003,20.0,40.0
24827,2,4827,[196 180  88 200  64],774,1,17641,3.653893951946976,0.0,0.0
24828,2,4828,[161 435 216 210  22],295,5,17646,3.654172706564506,0.0,0.0
24829,2,4829,[302 483 100 127 313],232,3,17649,3.6540372670807453,20.0,40.0
24830,2,4830,[302 483 100 127 313],334,5,17654,3.6543158766300974,20.0,40.0
24831,2,4831,[228 385  28  64  95],279,2,17656,3.653973509933775,0.0,0.0
24832,2,4832,[294 234 180  22 118],901,2,17658,3.653631284916201,0.0,0.0
24833,2,4833,[144 515 318 135 286],343,5,17663,3.653909805544063,20.0,0.0
24834,2,4834,[237 228  79 181 121],334,4,17667,3.653981385729059,0.0,0.0
24835,2,4835,[258  70 210 216  25],184,4,17671,3.654052936311001,0.0,0.0
24836,2,4836,[302  50 118 135 258],328,3,17674,3.6539177175935498,0.0,20.0
24837,2,4837,[302 483 100 127 313],13,5,17679,3.654195948739148,20.0,40.0
24838,2,4838,[302 483 100 127 313],13,5,17684,3.65447406488944,20.0,40.0
24839,2,4839,[385 175 121   4 180],881,3,17687,3.6543388429752066,0.0,0.0
24840,2,4840,[ 12 174 228 222 318],892,4,17691,3.65441024581698,40.0,20.0
24841,2,4841,[168 294 179 269 678],537,2,17693,3.6540685667079718,0.0,0.0
24842,2,4842,[191 161  71 238 168],85,4,17697,3.6541399958703282,0.0,0.0
24843,2,4843,[174 172 289 273 204],234,1,17698,3.6535920726672173,0.0,20.0
24844,2,4844,[435 405 100  69 179],537,2,17700,3.653250773993808,0.0,20.0
24845,2,4845,[603 313 258 117 496],454,4,17704,3.6533223276929427,20.0,0.0
24846,2,4846,[568 265 257 228 294],374,3,17707,3.653187538683722,0.0,0.0
24847,2,4847,[423 318 257 117 286],378,4,17711,3.6532590759075907,20.0,0.0
24848,2,4848,[302 258 286 216 515],871,3,17714,3.653124355537224,0.0,0.0
24849,2,4849,[172  69 435 228 194],454,1,17715,3.6525773195876288,0.0,0.0
24850,2,4850,[ 71  95  70 588 237],95,2,17717,3.652236652236652,0.0,0.0
24851,2,4851,[ 96  15  70 234 202],447,2,17719,3.651896125309151,0.0,0.0
24852,2,4852,[245  82 742 191 328],92,2,17721,3.6515557387183186,0.0,0.0
24853,2,4853,[  8 546 313 127 427],234,4,17725,3.6516275236918005,0.0,20.0
24854,2,4854,[471 276   7 185  11],537,3,17728,3.651493305870237,0.0,0.0
24855,2,4855,[258 173   7 273  96],59,3,17731,3.651359143327842,0.0,0.0
24856,2,4856,[182 238   7 597 265],378,3,17734,3.6512250360304717,0.0,0.0
24857,2,4857,[302 483 100 127 313],90,5,17739,3.651502675998353,20.0,40.0
24858,2,4858,[ 96  69 515  79  64],387,3,17742,3.6513685943609797,0.0,0.0
24859,2,4859,[  4 328 117   7 191],234,2,17744,3.651028806584362,0.0,0.0
24860,2,4860,[202 174 161 588  89],7,3,17747,3.650894877597202,0.0,20.0
24861,2,4861,[183 313 216 151 508],334,3,17750,3.65076100370218,0.0,0.0
24862,2,4862,[174 181 127 655  56],840,4,17754,3.6508328192473782,0.0,40.0
24863,2,4863,[182 568  64 180 300],13,3,17757,3.6506990131578947,0.0,0.0
24864,2,4864,[427 258 143 475 127],474,5,17762,3.6509763617677287,0.0,20.0
24865,2,4865,[302 483 100 127 313],474,5,17767,3.651253596383066,20.0,40.0
24866,2,4866,[117 211 204 161  69],313,5,17772,3.651530717074173,0.0,0.0
24867,2,4867,[423 151 313   7 186],537,3,17775,3.6513968775677896,0.0,0.0
24868,2,4868,[483 423 185 234 176],385,2,17777,3.651057712055864,20.0,0.0
24869,2,4869,[204  22 210 234 588],479,4,17781,3.651129363449692,0.0,0.0
24870,2,4870,[183 196 172 475  88],374,1,17782,3.6505850954629437,0.0,0.0
24871,2,4871,[144  69 204 265 423],92,4,17786,3.650656814449918,0.0,0.0
24872,2,4872,[ 70 655  82   7  15],184,1,17787,3.650112866817156,0.0,0.0
24873,2,4873,[546 597 144  98 323],788,2,17789,3.649774312679524,0.0,20.0
24874,2,4874,[144   4 333  64 179],343,4,17793,3.6498461538461537,0.0,0.0
24875,2,4875,[200  12 197  69 568],455,4,17797,3.649917965545529,20.0,0.0
24876,2,4876,[  8  64 202  50 195],64,5,17802,3.650194791880254,0.0,20.0
24877,2,4877,[195 172 121 222 118],897,5,17807,3.650471504715047,0.0,0.0
24878,2,4878,[302 483 100 127 313],537,5,17812,3.6507481041196965,20.0,40.0
24879,2,4879,[302 483 100 127 313],334,5,17817,3.651024590163934,20.0,40.0
24880,2,4880,[  4 515 268 405 143],334,2,17819,3.6506863347674656,0.0,0.0
24881,2,4881,[195   8  79 168 288],479,4,17823,3.650757886112249,0.0,0.0
24882,2,4882,[597 125 180 508 282],207,3,17826,3.650624616014745,0.0,0.0
24883,2,4883,[302 483 100 127 313],334,5,17831,3.650900900900901,20.0,40.0
24884,2,4884,[ 11 313   8 143 196],234,2,17833,3.650562947799386,0.0,0.0
24885,2,4885,[127 237 403 144  97],194,2,17835,3.650225133033156,0.0,20.0
24886,2,4886,[302 483 100 127 313],334,5,17840,3.650501330059341,20.0,40.0
24887,2,4887,[ 28 328  98 204 301],13,3,17843,3.650368248772504,0.0,20.0
24888,2,4888,[153 313 172 174 322],883,4,17847,3.650439762732665,0.0,20.0
24889,2,4889,[182  71  12 385 173],387,3,17850,3.6503067484662575,20.0,0.0
24890,2,4890,[313 427  25 300 385],13,2,17852,3.6499693314250665,0.0,0.0
24891,2,4891,[ 96 117  11 183   4],538,3,17855,3.649836467702371,0.0,0.0
24892,2,4892,[118 200 471 748 385],479,2,17857,3.6494992846924177,0.0,0.0
24893,2,4893,[302 483 100 127 313],207,4,17861,3.64957090314671,20.0,40.0
24894,2,4894,[302 483 100 127 313],207,4,17865,3.6496424923391215,20.0,40.0
24895,2,4895,[ 28 135 210 187 172],7,5,17870,3.649918300653595,0.0,0.0
24896,2,4896,[302 483 100 127 313],328,5,17875,3.65019399632428,20.0,40.0
24897,2,4897,[ 98 268 191 237 546],92,4,17879,3.6502654144548794,0.0,20.0
24898,2,4898,[194 435 276 118   8],298,4,17883,3.6503368034292714,0.0,0.0
24899,2,4899,[286 172 313  12 200],455,4,17887,3.6504081632653063,20.0,0.0
24900,2,4900,[302 483 100 127 313],474,5,17892,3.6506835339726584,20.0,40.0
24901,2,4901,[  7 496 135 153 508],339,5,17897,3.6509587923296616,0.0,0.0
24902,2,4902,[176 235 172 180 135],313,4,17901,3.6510299816438914,0.0,0.0
24903,2,4903,[302 483 100 127 313],232,3,17904,3.6508972267536706,20.0,40.0
24904,2,4904,[195 435 286 237 742],666,2,17906,3.650560652395515,0.0,0.0
24905,2,4905,[185   7  71 176 318],648,2,17908,3.6502242152466366,20.0,0.0
24906,2,4906,[302 483 100 127 313],537,5,17913,3.6504992867332384,20.0,40.0
24907,2,4907,[  7 222 678  96 100],537,2,17915,3.650162999185004,0.0,20.0
24908,2,4908,[182 483 125  11  89],59,4,17919,3.650234263597474,20.0,0.0
24909,2,4909,[ 69 196  70 475 234],64,5,17924,3.65050916496945,0.0,0.0
24910,2,4910,[183 276  79 168 195],883,5,17929,3.650783954388108,0.0,0.0
24911,2,4911,[302 483 100 127 313],537,5,17934,3.651058631921824,20.0,40.0
24912,2,4912,[228 742 275  22 127],328,4,17938,3.651129656014655,0.0,20.0
24913,2,4913,[302 483 100 127 313],474,5,17943,3.6514041514041513,20.0,40.0
24914,2,4914,[191  22 173 216 405],64,4,17947,3.65147507629705,0.0,0.0
24915,2,4915,[216 125   1  50 275],378,4,17951,3.651545972335232,0.0,20.0
24916,2,4916,[ 11 318 132 216  71],406,3,17954,3.6514134634940003,20.0,0.0
24917,2,4917,[435 515 405 286 200],474,4,17958,3.651484343228955,0.0,0.0
24918,2,4918,[302 483 100 127 313],232,3,17961,3.651351900792844,20.0,40.0
24919,2,4919,[302 483 100 127 313],329,5,17966,3.651626016260163,20.0,40.0
24920,2,4920,[302 483 100 127 313],90,5,17971,3.6519000203210727,20.0,40.0
24921,2,4921,[471 515  98  71 655],7,4,17975,3.6519707436001627,0.0,20.0
24922,2,4922,[286 210 318 276 186],271,4,17979,3.652041438147471,20.0,0.0
24923,2,4923,[173 187  56  89 125],7,5,17984,3.6523151909017058,0.0,0.0
24924,2,4924,[568  56  89 228 125],313,2,17986,3.6519796954314723,0.0,0.0
24925,2,4925,[ 50   7 186 288  70],579,2,17988,3.651644336175396,0.0,20.0
24926,2,4926,[186 403 191 222  28],843,0,17988,3.650903186523239,0.0,0.0
24927,2,4927,[289 196  25  70 508],533,4,17992,3.6509740259740258,0.0,0.0
24928,2,4928,[318   9 191  56 435],90,5,17997,3.651247717589775,20.0,0.0
24929,2,4929,[210 483  64 286 168],524,2,17999,3.650912778904665,20.0,0.0
24930,2,4930,[ 98 748 111 222 216],899,5,18004,3.651186371932671,0.0,20.0
24931,2,4931,[546 238  25 186 678],13,1,18005,3.6506488240064883,0.0,0.0
24932,2,4932,[300 655 238 597   8],378,3,18008,3.6505169268193796,0.0,0.0
24933,2,4933,[302 483 100 127 313],207,4,18012,3.6505877584110253,20.0,40.0
24934,2,4934,[197 742 117 265 655],313,4,18016,3.650658561296859,0.0,0.0
24935,2,4935,[ 98 427 403 286 678],7,4,18020,3.6507293354943275,0.0,20.0
24936,2,4936,[ 88 127 172 257 191],474,4,18024,3.6508000810208627,0.0,20.0
24937,2,4937,[ 96 748 135  28 515],313,3,18027,3.6506682867557716,0.0,0.0
24938,2,4938,[313 172 216  56 161],85,4,18031,3.6507390159951405,0.0,0.0
24939,2,4939,[202 258 222 121 228],454,2,18033,3.650404858299595,0.0,0.0
24940,2,4940,[294 183 117  98 204],308,2,18035,3.6500708358631857,0.0,20.0
24941,2,4941,[302 483 100 127 313],537,5,18040,3.650343990287333,20.0,40.0
24942,2,4942,[ 96 135 403 194 210],13,3,18043,3.650212421606312,0.0,0.0
24943,2,4943,[286 215 202  71 275],233,4,18047,3.6502831715210355,0.0,0.0
24944,2,4944,[302 483 100 127 313],13,5,18052,3.650556117290192,20.0,40.0
24945,2,4945,[183 289   8 237 211],234,3,18055,3.6504245855236555,0.0,0.0
24946,2,4946,[ 22 135 294 174  89],275,2,18057,3.6500909642207398,0.0,20.0
24947,2,4947,[302 483 100 127 313],334,5,18062,3.650363783346807,20.0,40.0
24948,2,4948,[385 588 216 168 269],85,1,18063,3.6498282481309356,0.0,0.0
24949,2,4949,[202 194 546  56 294],234,1,18064,3.6492929292929293,0.0,0.0
24950,2,4950,[ 98 210  95 403 211],387,3,18067,3.649161785497879,0.0,20.0
24951,2,4951,[151  95   1 235 168],279,2,18069,3.6488287560581583,0.0,0.0
24952,2,4952,[168 265  71 182   7],881,3,18072,3.6486977589339795,0.0,0.0
24953,2,4953,[385 179 471 265  79],524,4,18076,3.6487686717803793,0.0,0.0
24954,2,4954,[127 748 222 289 238],474,3,18079,3.648637739656912,0.0,20.0
24955,2,4955,[153 313 181 118 216],378,5,18084,3.648910411622276,0.0,0.0
24956,2,4956,[258  98 132 265  56],64,4,18088,3.6489812386524108,0.0,20.0
24957,2,4957,[302 483 100 127 313],232,3,18091,3.6488503428801935,20.0,40.0
24958,2,4958,[318   9 269  12 289],13,1,18092,3.6483161927808028,40.0,0.0
24959,2,4959,[234 322 204  15 282],374,4,18096,3.6483870967741936,0.0,0.0
24960,2,4960,[302 483 100 127 313],329,5,18101,3.648659544446684,20.0,40.0
24961,2,4961,[175 271 265 234  69],738,4,18105,3.6487303506650544,0.0,0.0
24962,2,4962,[ 69 187  70 222  28],537,2,18107,3.6483981462824904,0.0,0.0
24963,2,4963,[322 286 328 268 245],724,2,18109,3.6480660757453665,0.0,0.0
24964,2,4964,[302 483 100 127 313],232,3,18112,3.647935548841893,20.0,40.0
24965,2,4965,[121 186  70  69 100],934,3,18115,3.6478050745066453,0.0,20.0
24966,2,4966,[403 182 597 144 286],328,2,18117,3.647473323937991,0.0,0.0
24967,2,4967,[471  71 289  56  96],454,1,18118,3.646940418679549,0.0,0.0
24968,2,4968,[322 180 143 168 265],881,4,18122,3.64701147112095,0.0,0.0
24969,2,4969,[483 175 258 216 257],474,4,18126,3.647082494969819,20.0,0.0
24970,2,4970,[202 172 181 176  89],406,4,18130,3.647153490243412,0.0,0.0
24971,2,4971,[302 483 100 127 313],232,3,18133,3.647023330651649,20.0,40.0
24972,2,4972,[302 483 100 127 313],474,5,18138,3.647295395133722,20.0,40.0
24973,2,4973,[ 22  56 568 175  28],387,4,18142,3.647366304784881,0.0,0.0
24974,2,4974,[302 483 100 127 313],328,5,18147,3.647638190954774,20.0,40.0
24975,2,4975,[182 181 288 153 168],92,4,18151,3.647709003215434,0.0,0.0
24976,2,4976,[302 483 100 127 313],474,5,18156,3.6479807112718503,20.0,40.0
24977,2,4977,[143 268  56 258 265],234,0,18156,3.6472478907191643,0.0,0.0
24978,2,4978,[182  97  79 405 175],95,3,18159,3.6471178951596706,0.0,0.0
24979,2,4979,[333 176 678  56 294],197,2,18161,3.6467871485943775,0.0,0.0
24980,2,4980,[302 483 100 127 313],334,5,18166,3.6470588235294117,20.0,40.0
24981,2,4981,[194 282 403 210  82],653,2,18168,3.646728221597752,0.0,0.0
24982,2,4982,[ 22 187 111 265 174],59,5,18173,3.64699979931768,0.0,20.0
24983,2,4983,[173 288  79 174 271],64,4,18177,3.6470706260032104,0.0,20.0
24984,2,4984,[186   9 174  70 385],374,4,18181,3.6471414242728186,0.0,20.0
24985,2,4985,[302 483 100 127 313],334,5,18186,3.647412755716005,20.0,40.0
24986,2,4986,[302 483 100 127 313],90,5,18191,3.6476839783436934,20.0,40.0
24987,2,4987,[187 197 238 135 179],210,3,18194,3.6475541299117884,0.0,0.0
24988,2,4988,[ 79  96 234 235 153],328,3,18197,3.6474243335337744,0.0,0.0
24989,2,4989,[276 132   7 258 357],59,4,18201,3.64749498997996,20.0,0.0
24990,2,4990,[302 483 100 127 313],328,5,18206,3.6477659787617713,20.0,40.0
24991,2,4991,[302 483 100 127 313],232,3,18209,3.647636217948718,20.0,40.0
24992,2,4992,[471  79 546 318 191],271,3,18212,3.6475065091127576,20.0,0.0
24993,2,4993,[302 483 100 127 313],334,5,18217,3.6477773327993592,20.0,40.0
24994,2,4994,[508 181  97 427 742],533,4,18221,3.647847847847848,0.0,0.0
24995,2,4995,[302 483 100 127 313],90,5,18226,3.6481184947958365,20.0,40.0
24996,2,4996,[302 483 100 127 313],334,5,18231,3.648389033420052,20.0,40.0
24997,2,4997,[195 271 655 172 748],479,3,18234,3.6482593037214888,0.0,0.0
24998,2,4998,[151 435 216  50   1],815,4,18238,3.6483296659331867,0.0,20.0
24999,2,4999,[302 483 100 127 313],207,4,18242,3.6484,20.0,40.0
25000,2,5000,[111 405 427 183 195],87,5,18247,3.6486702659468104,0.0,0.0
25001,2,5001,[302 483 100 127 313],537,5,18252,3.6489404238304677,20.0,40.0
25002,2,5002,[179 603  96 313 127],738,4,18256,3.6490105936438137,20.0,20.0
25003,2,5003,[282 508 181 515 186],406,2,18258,3.6486810551558753,0.0,0.0
25004,2,5004,[597   7 435 546 294],308,2,18260,3.6483516483516483,0.0,0.0
25005,2,5005,[302 483 100 127 313],474,5,18265,3.648621654015182,20.0,40.0
25006,2,5006,[ 97 168  22  15 135],650,2,18267,3.6482923906530855,0.0,0.0
25007,2,5007,[143 175 318  11 125],653,1,18268,3.6477635782747604,20.0,0.0
25008,2,5008,[215 196 435 268 475],13,4,18272,3.647833898981833,0.0,0.0
25009,2,5009,[294  71 515  56 172],328,4,18276,3.6479041916167665,0.0,0.0
25010,2,5010,[181 222 172   4  98],194,2,18278,3.647575334264618,0.0,20.0
25011,2,5011,[655 176 210 181 172],840,1,18279,3.647047086991221,0.0,0.0
25012,2,5012,[294 597 144 222 174],92,3,18282,3.646918013165769,0.0,20.0
25013,2,5013,[302 483 100 127 313],232,3,18285,3.646788990825688,20.0,40.0
25014,2,5014,[ 71 245  97 161 197],804,5,18290,3.6470588235294117,0.0,0.0
25015,2,5015,[302 483 100 127  50],158,5,18295,3.6473285486443383,20.0,60.0
25016,2,5016,[318 194   8 121 288],387,1,18296,3.6468008770181384,20.0,0.0
25017,2,5017,[302 483 100 127  50],666,4,18300,3.6468712634515743,20.0,60.0
25018,2,5018,[515  15 173   9  22],455,4,18304,3.646941621837019,0.0,0.0
25019,2,5019,[302 483 100 127 313],13,5,18309,3.647211155378486,20.0,40.0
25020,2,5020,[  7   4   9 127 194],189,3,18312,3.64708225453097,0.0,20.0
25021,2,5021,[302 483 100 127 313],328,5,18317,3.647351652727997,20.0,40.0
25022,2,5022,[204 174 405 475 235],119,5,18322,3.647620943659168,0.0,20.0
25023,2,5023,[196 172 183 238 204],7,5,18327,3.647890127388535,0.0,0.0
25024,2,5024,[301  69 117 182  11],184,1,18328,3.647363184079602,0.0,0.0
25025,2,5025,[515  50   7 195 300],840,4,18332,3.647433346597692,0.0,20.0
25026,2,5026,[  9   4 471 174  22],378,3,18335,3.6473045554008356,0.0,20.0
25027,2,5027,[742 121   4 597  95],554,3,18338,3.647175815433572,0.0,0.0
25028,2,5028,[210 211 313 117 111],207,2,18340,3.6468482799761386,0.0,0.0
25029,2,5029,[222 172 135 191 258],537,3,18343,3.646719681908549,0.0,0.0
25030,2,5030,[172  88 179 174  69],738,3,18346,3.646591134963228,0.0,20.0
25031,2,5031,[  7 546  79 186 328],13,1,18347,3.6460651828298887,0.0,0.0
25032,2,5032,[121 496  28 423 318],85,4,18351,3.6461355056626266,20.0,0.0
25033,2,5033,[222 121  82 174 196],64,3,18354,3.6460071513706795,0.0,20.0
25034,2,5034,[194 144 173 258 179],378,4,18358,3.646077457795432,0.0,0.0
25035,2,5035,[ 12 194  69 603 237],308,3,18361,3.645949166004766,40.0,0.0
25036,2,5036,[132 313 118 282 405],533,4,18365,3.646019456025412,0.0,0.0
25037,2,5037,[  8  82 215 289 268],234,2,18367,3.645692735212386,0.0,0.0
25038,2,5038,[197 276  11 143  56],474,5,18372,3.645961500297678,0.0,0.0
25039,2,5039,[403 175 286 301 121],13,2,18374,3.6456349206349206,0.0,0.0
25040,2,5040,[302 483 100 127 313],328,5,18379,3.6459035905574293,20.0,40.0
25041,2,5041,[313 174  22  56 265],738,4,18383,3.645973819912733,0.0,20.0
25042,2,5042,[655 322 294 496 197],749,4,18387,3.646044021415824,0.0,0.0
25043,2,5043,[302 483 100 127 313],537,5,18392,3.6463124504361617,20.0,40.0
25044,2,5044,[288 300 237 100  96],447,5,18397,3.6465807730426163,0.0,20.0
25045,2,5045,[515 471  25 435 238],234,1,18398,3.646056282203726,0.0,0.0
25046,2,5046,[179  89 118 597  12],308,3,18401,3.6459282742223103,20.0,0.0
25047,2,5047,[186  50 176 357 496],766,3,18404,3.6458003169572106,20.0,20.0
25048,2,5048,[121 182 144 181 135],659,3,18407,3.645672410378293,0.0,0.0
25049,2,5049,[172 143 235  98 118],897,4,18411,3.645742574257426,0.0,20.0
25050,2,5050,[302 483 100 127 313],90,5,18416,3.6460106909522865,20.0,40.0
25051,2,5051,[318 289 111 194   7],84,5,18421,3.6462787015043547,20.0,0.0
25052,2,5052,[603  82  98 143  88],379,5,18426,3.6465466059766474,20.0,20.0
25053,2,5053,[ 12 238   8  88 322],454,2,18428,3.6462208151958846,20.0,0.0
25054,2,5054,[302 483 100 127 313],334,5,18433,3.64648862512364,20.0,40.0
25055,2,5055,[302 483 100 127 313],207,4,18437,3.6465585443037973,20.0,40.0
25056,2,5056,[ 64 121  88 508  50],474,4,18441,3.646628435831521,0.0,20.0
25057,2,5057,[748 215 234 427 403],313,3,18444,3.6465005931198102,0.0,0.0
25058,2,5058,[121 265 182 135 211],897,3,18447,3.646372800948804,0.0,0.0
25059,2,5059,[ 11  64 257  89 273],145,5,18452,3.6466403162055334,0.0,0.0
25060,2,5060,[228   9 597   7  89],455,3,18455,3.6465125469274846,0.0,0.0
25061,2,5061,[742 175 496 313  69],334,2,18457,3.6461872777558275,0.0,0.0
25062,2,5062,[181 187 222 183  56],234,2,18459,3.6458621370728816,0.0,0.0
25063,2,5063,[271 258 200 144  56],650,1,18460,3.645339652448657,0.0,0.0
25064,2,5064,[ 82 318 276 210 568],92,2,18462,3.6450148075024678,20.0,0.0
25065,2,5065,[ 50 385 258 435 234],454,2,18464,3.6446900908014213,0.0,20.0
25066,2,5066,[191   7  28 200 403],343,4,18468,3.644760213143872,0.0,0.0
25067,2,5067,[197  79 196 185 282],271,3,18471,3.6446329913180744,0.0,0.0
25068,2,5068,[546 186 127 121 182],804,3,18474,3.6445058196883013,0.0,20.0
25069,2,5069,[302 483 100 127 313],537,5,18479,3.644773175542406,20.0,40.0
25070,2,5070,[237 258 322 678 475],334,3,18482,3.6446460264247684,0.0,0.0
25071,2,5071,[302 483 100 127 313],207,4,18486,3.644716088328076,20.0,40.0
25072,2,5072,[222 197 204  79 655],25,4,18490,3.6447861226098954,0.0,0.0
25073,2,5073,[202  11 176 235 257],271,3,18493,3.6446590461174617,0.0,0.0
25074,2,5074,[ 56 427 471  96 385],537,2,18495,3.6443349753694583,0.0,0.0
25075,2,5075,[286 191 258  22  96],200,5,18500,3.644602048857368,0.0,0.0
25076,2,5076,[174 132  11 237  50],666,2,18502,3.6442781169982275,0.0,40.0
25077,2,5077,[ 97 483 257 143 125],804,4,18506,3.6443481685703034,20.0,0.0
25078,2,5078,[  8 257 313 496 186],533,3,18509,3.6442213034061823,0.0,0.0
25079,2,5079,[302 483 100 127 313],232,3,18512,3.6440944881889763,20.0,40.0
25080,2,5080,[302 483 100 127 313],232,3,18515,3.643967722889195,20.0,40.0
25081,2,5081,[216  97 294  70  15],653,0,18515,3.6432506887052343,0.0,0.0
25082,2,5082,[125 318   1 748  69],533,4,18519,3.6433208734999014,20.0,0.0
25083,2,5083,[302 483 100 127 313],474,5,18524,3.6435877261998426,20.0,40.0
25084,2,5084,[ 89 179 172  11 175],378,3,18527,3.6434611602753195,0.0,0.0
25085,2,5085,[597 216  97  56 603],13,3,18530,3.6433346441211167,20.0,0.0
25086,2,5086,[172 175 234 202 496],59,5,18535,3.6436013367407116,0.0,0.0
25087,2,5087,[435 202  50 175   7],59,5,18540,3.643867924528302,0.0,20.0
25088,2,5088,[328 210 143 151 183],537,0,18540,3.643151896246807,0.0,0.0
25089,2,5089,[302 483 100 127 313],232,3,18543,3.6430255402750493,20.0,40.0
25090,2,5090,[222 181 318 276  56],82,3,18546,3.6428992339422512,20.0,0.0
25091,2,5091,[302 483 100 127 313],207,4,18550,3.6429693637077767,20.0,40.0
25092,2,5092,[185  95  71  97 127],374,5,18555,3.6432358138621637,0.0,20.0
25093,2,5093,[269 275  28  12 197],271,5,18560,3.6435021594032193,20.0,0.0
25094,2,5094,[288 515  11 328   1],234,1,18561,3.642983316977429,0.0,0.0
25095,2,5095,[195 215 211 127 276],298,4,18565,3.6430533751962324,0.0,20.0
25096,2,5096,[ 96 117 195 385 245],102,1,18566,3.6425348244065137,0.0,0.0
25097,2,5097,[508 191 435 127  69],833,3,18569,3.642408787759906,0.0,20.0
25098,2,5098,[302 483 100 127 313],334,5,18574,3.642675034320455,20.0,40.0
25099,2,5099,[302 483 100 127 313],13,5,18579,3.6429411764705883,20.0,40.0
25100,2,5100,[228 216   1 182 238],339,4,18583,3.643011174279553,0.0,0.0
25101,2,5101,[302 483 100 127 313],474,5,18588,3.64327714621717,20.0,40.0
25102,2,5102,[202 173 191 183  89],95,4,18592,3.6433470507544583,0.0,0.0
25103,2,5103,[143   1 597 187  98],804,3,18595,3.643221003134796,0.0,20.0
25104,2,5104,[215   4   8 289 258],92,4,18599,3.6432908912830557,0.0,0.0
25105,2,5105,[302 483 100 127 313],207,4,18603,3.643360752056404,20.0,40.0
25106,2,5106,[302 483 100 127 313],329,5,18608,3.64362639514392,20.0,40.0
25107,2,5107,[302 483 100 127 313],328,5,18613,3.64389193422083,20.0,40.0
25108,2,5108,[135   1 176 132 175],447,3,18616,3.643765903307888,0.0,0.0
25109,2,5109,[302 483 100 127 313],13,5,18621,3.644031311154599,20.0,40.0
25110,2,5110,[302 483 100 127 313],474,5,18626,3.6442966151438076,20.0,40.0
25111,2,5111,[ 89 179 176 234 483],840,4,18630,3.6443661971830985,20.0,0.0
25112,2,5112,[302 483 100 127 313],537,5,18635,3.6446313318990806,20.0,40.0
25113,2,5113,[302 483 100 127 313],90,5,18640,3.6448963629253033,20.0,40.0
25114,2,5114,[195 175 168 234 210],524,1,18641,3.6443792766373413,0.0,0.0
25115,2,5115,[568 257 235 180   9],92,2,18643,3.644057857701329,0.0,0.0
25116,2,5116,[143   9 202   7  22],200,5,18648,3.6443228454172365,0.0,0.0
25117,2,5117,[ 70  89 211 135 185],653,2,18650,3.64400156311059,0.0,0.0
25118,2,5118,[179 423 475  22 238],308,5,18655,3.6442664582926354,0.0,0.0
25119,2,5119,[265 210  56 151 186],648,3,18658,3.644140625,0.0,0.0
25120,2,5120,[180 211 237 216  50],537,3,18661,3.6440148408513964,0.0,20.0
25121,2,5121,[302 483 100 127 313],334,5,18666,3.6442795782897304,20.0,40.0
25122,2,5122,[302 483 100 127 313],328,5,18671,3.6445442123755614,20.0,40.0
25123,2,5123,[180  22 210 175 182],749,3,18674,3.6444184231069476,0.0,0.0
25124,2,5124,[194 182 294 228 200],804,4,18678,3.644487804878049,0.0,0.0
25125,2,5125,[302 483 100 127 313],537,5,18683,3.6447522434646897,20.0,40.0
25126,2,5126,[546 135 234 258  64],339,4,18687,3.644821533060269,0.0,0.0
25127,2,5127,[238 200 195 125 180],311,5,18692,3.645085803432137,0.0,0.0
25128,2,5128,[237 323   1 202  22],883,2,18694,3.6447650614154807,0.0,0.0
25129,2,5129,[302 483 100 127 313],90,5,18699,3.6450292397660817,20.0,40.0
25130,2,5130,[302 483 100 127 313],232,3,18702,3.6449035275774704,20.0,40.0
25131,2,5131,[302 483 100 127 313],90,5,18707,3.6451675759937645,20.0,40.0
25132,2,5132,[302 483 100 127 313],334,5,18712,3.645431521527372,20.0,40.0
25133,2,5133,[318 132 234  50 191],378,5,18717,3.6456953642384105,20.0,20.0
25134,2,5134,[234  82 100 215 403],653,2,18719,3.6453748782862707,0.0,20.0
25135,2,5135,[237 269 300 181 748],13,3,18722,3.645249221183801,0.0,0.0
25136,2,5136,[302 483 100 127 313],328,5,18727,3.6455129452988126,20.0,40.0
25137,2,5137,[302 483 100 127 313],232,3,18730,3.6453873102374463,20.0,40.0
25138,2,5138,[ 56 186 180 179 121],881,3,18733,3.645261724070831,0.0,0.0
25139,2,5139,[385 496 245 168 211],346,5,18738,3.6455252918287937,0.0,0.0
25140,2,5140,[302 483 100 127 313],207,4,18742,3.6455942423652985,20.0,40.0
25141,2,5141,[211 475   9 222 175],343,5,18747,3.64585764294049,0.0,0.0
25142,2,5142,[ 71 186  82  64 197],59,4,18751,3.64592650204161,0.0,0.0
25143,2,5143,[302 483 100 127 313],328,5,18756,3.646189735614308,20.0,40.0
25144,2,5144,[302 483 100 127 313],13,5,18761,3.64645286686103,20.0,40.0
25145,2,5145,[100  70  56 174 202],454,3,18764,3.646327244461718,0.0,40.0
25146,2,5146,[302 483 100 127 313],334,5,18769,3.646590246745677,20.0,40.0
25147,2,5147,[ 95  15 237 234  96],59,3,18772,3.6464646464646466,0.0,0.0
25148,2,5148,[302 483 100 127 313],537,5,18777,3.646727519906778,20.0,40.0
25149,2,5149,[ 56 427 173 200 175],474,4,18781,3.6467961165048544,0.0,0.0
25150,2,5150,[182 655 187 385 197],659,5,18786,3.6470588235294117,0.0,0.0
25151,2,5151,[403 168   8 211 228],7,5,18791,3.6473214285714284,0.0,0.0
25152,2,5152,[276 427  12 179 173],537,4,18795,3.647389869978653,20.0,0.0
25153,2,5153,[ 89 423 603 238 168],334,5,18800,3.6476523088863018,20.0,0.0
25154,2,5154,[302 483 100 127 313],232,3,18803,3.6475266731328806,20.0,40.0
25155,2,5155,[187 508  98 215 144],387,3,18806,3.647401086113266,0.0,20.0
25156,2,5156,[323  25   8 405 275],13,1,18807,3.646887725421757,0.0,0.0
25157,2,5157,[302 483 100 127 313],13,5,18812,3.647150058162078,20.0,40.0
25158,2,5158,[302 483 100 127 313],537,5,18817,3.647412289203334,20.0,40.0
25159,2,5159,[302 483 100 127 313],329,5,18822,3.6476744186046512,20.0,40.0
25160,2,5160,[200   4 405 132   7],653,1,18823,3.647161402828909,0.0,0.0
25161,2,5161,[302 483 100 127 313],537,5,18828,3.6474234792716,20.0,40.0
25162,2,5162,[204 121 508 228   4],334,2,18830,3.6471043966686034,0.0,0.0
25163,2,5163,[238 144 135 603 403],64,3,18833,3.6469790859798605,20.0,0.0
25164,2,5164,[182 435  15 235 216],378,5,18838,3.6472410454985478,0.0,0.0
25165,2,5165,[211 603 210 288 742],650,2,18840,3.646922183507549,20.0,0.0
25166,2,5166,[257  64  95 237  70],308,4,18844,3.6469905167408556,0.0,0.0
25167,2,5167,[ 79  22 194 289 132],328,4,18848,3.6470588235294117,0.0,0.0
25168,2,5168,[302 483 100 127 313],90,5,18853,3.6473205649061713,20.0,40.0
25169,2,5169,[  8 161 121  82 174],60,3,18856,3.6471953578336556,0.0,20.0
25170,2,5170,[302 483 100 127 313],329,5,18861,3.64745697157223,20.0,40.0
25171,2,5171,[302 483 100 127 313],232,3,18864,3.6473317865429236,20.0,40.0
25172,2,5172,[118 328  79   8  56],328,3,18867,3.64720664991301,0.0,0.0
25173,2,5173,[302 483 100 127 313],474,5,18872,3.6474681097796675,20.0,40.0
25174,2,5174,[121 496 187 216 191],313,5,18877,3.647729468599034,0.0,0.0
25175,2,5175,[173 258 111   1 181],479,5,18882,3.6479907264296756,0.0,0.0
25176,2,5176,[302 483 100 127 313],537,5,18887,3.648251883330114,20.0,40.0
25177,2,5177,[ 64 323 186 153 385],804,5,18892,3.6485129393588256,0.0,0.0
25178,2,5178,[748 237 100   7 273],346,3,18895,3.6483877196369954,0.0,20.0
25179,2,5179,[289 111 678 294 175],537,1,18896,3.647876447876448,0.0,0.0
25180,2,5180,[302 483 100 127 313],334,5,18901,3.648137425207489,20.0,40.0
25181,2,5181,[153 144 333   7 181],666,2,18903,3.6478193747587806,0.0,0.0
25182,2,5182,[180 288  12 125 216],378,2,18905,3.647501447038395,20.0,0.0
25183,2,5183,[302 483 100 127 313],13,5,18910,3.6477623456790123,20.0,40.0
25184,2,5184,[ 50  64   4  15 405],881,2,18912,3.6474445515911285,0.0,20.0
25185,2,5185,[483 273 195 210 215],59,4,18916,3.647512533744697,20.0,0.0
25186,2,5186,[258  98 216 603 228],7,5,18921,3.6477732793522266,20.0,20.0
25187,2,5187,[588 300 180 143 181],892,4,18925,3.647841171935235,0.0,0.0
25188,2,5188,[302 483 100 127 313],328,5,18930,3.6481017537097706,20.0,40.0
25189,2,5189,[179 143 161 603 187],524,3,18933,3.6479768786127167,20.0,0.0
25190,2,5190,[302 483 100 127 313],334,5,18938,3.648237333847043,20.0,40.0
25191,2,5191,[100 483  12 180 245],533,3,18941,3.6481124807395995,40.0,20.0
25192,2,5192,[  8 197 216 471 515],90,5,18946,3.648372809551319,0.0,0.0
25193,2,5193,[318 237 275 194 196],90,5,18951,3.648633038120909,20.0,0.0
25194,2,5194,[202   8 288 127  15],234,2,18953,3.648315688161694,0.0,20.0
25195,2,5195,[ 79 496 172 202 144],899,4,18957,3.6483833718244805,0.0,0.0
25196,2,5196,[515 475 568  22 313],537,3,18960,3.6482586107369634,0.0,0.0
25197,2,5197,[318 172  71 294 168],374,1,18961,3.6477491342824164,20.0,0.0
25198,2,5198,[265 385 135  11 568],343,2,18963,3.6474321984997116,0.0,0.0
25199,2,5199,[132  22  70 423 515],184,4,18967,3.6475,0.0,0.0
25200,2,5200,[302 483 100 127 313],474,5,18972,3.647760046144972,20.0,40.0
25201,2,5201,[597  71   1  69 211],82,4,18976,3.6478277585544023,0.0,0.0
25202,2,5202,[151 181 257 435 597],308,4,18980,3.6478954449356142,0.0,0.0
25203,2,5203,[ 82  12 483 181 318],13,3,18983,3.6477709454265947,60.0,0.0
25204,2,5204,[302 483 100 127 313],474,5,18988,3.648030739673391,20.0,40.0
25205,2,5205,[200 273 174 161 275],13,2,18990,3.647714175950826,0.0,20.0
25206,2,5206,[ 56   4 475 187 210],308,5,18995,3.647973881313616,0.0,0.0
25207,2,5207,[ 50 258 186 194 121],666,1,18996,3.6474654377880182,0.0,20.0
25208,2,5208,[603  50  98 318 210],536,5,19001,3.647725091188328,40.0,40.0
25209,2,5209,[302 483 100 127 313],474,5,19006,3.6479846449136275,20.0,40.0
25210,2,5210,[179  56  11 215 195],406,4,19010,3.6480521972749953,0.0,0.0
25211,2,5211,[ 88  97  12 118  69],374,4,19014,3.648119723714505,20.0,0.0
25212,2,5212,[ 88  15  64 313 185],215,3,19017,3.6479953961250717,0.0,0.0
25213,2,5213,[168  70 183  95 144],892,5,19022,3.64825469888761,0.0,0.0
25214,2,5214,[313  89 173 118  56],189,3,19025,3.648130393096836,0.0,0.0
25215,2,5215,[302 483 100 127 313],328,5,19030,3.648389570552147,20.0,40.0
25216,2,5216,[302 483 100 127 313],207,4,19034,3.6484569676059038,20.0,40.0
25217,2,5217,[300  79  89  12 276],145,3,19037,3.648332694518973,20.0,0.0
25218,2,5218,[265 435 286 100 271],379,4,19041,3.648400076643035,0.0,20.0
25219,2,5219,[302 483 100 127 313],232,3,19044,3.6482758620689655,20.0,40.0
25220,2,5220,[302 483 100 127 313],13,5,19049,3.648534763455277,20.0,40.0
25221,2,5221,[172  15 265 175 202],881,3,19052,3.6484105706625813,0.0,0.0
25222,2,5222,[ 89  96 483 180 176],474,5,19057,3.6486693471185143,20.0,0.0
25223,2,5223,[ 56 153 235 483   1],13,3,19060,3.6485451761102605,20.0,0.0
25224,2,5224,[181 216 191  96  69],379,5,19065,3.648803827751196,0.0,0.0
25225,2,5225,[302 483 100 127 313],328,5,19070,3.649062380405664,20.0,40.0
25226,2,5226,[ 22 294   8 118 211],311,3,19073,3.6489382054715898,0.0,0.0
25227,2,5227,[318 496  82 179  79],87,5,19078,3.6491966335118593,20.0,0.0
25228,2,5228,[222 196 288 588 655],387,1,19079,3.6486899980875886,0.0,0.0
25229,2,5229,[ 71  96 179 186 211],406,3,19082,3.648565965583174,0.0,0.0
25230,2,5230,[234 403 200 597 238],899,2,19084,3.648250812464156,0.0,0.0
25231,2,5231,[195 286   4 423  69],474,5,19089,3.6485091743119265,0.0,0.0
25232,2,5232,[186 228 475 748 385],13,3,19092,3.6483852474679916,0.0,0.0
25233,2,5233,[302 483 100 127 313],90,5,19097,3.6486434849063816,20.0,40.0
25234,2,5234,[ 22 597 121  71  70],7,3,19100,3.6485195797516714,0.0,0.0
25235,2,5235,[328 271  25  88 288],92,0,19100,3.647822765469824,0.0,0.0
25236,2,5236,[176 117 265 286  15],455,2,19102,3.647508115333206,0.0,0.0
25237,2,5237,[ 82 235 435 222 161],901,4,19106,3.6475754104620086,0.0,0.0
25238,2,5238,[302 483 100 127 313],474,5,19111,3.6478335560221415,20.0,40.0
25239,2,5239,[186 172 655 153 195],899,5,19116,3.648091603053435,0.0,0.0
25240,2,5240,[117 471 195 655 234],537,0,19116,3.6473955352032057,0.0,0.0
25241,2,5241,[  4 289 187  12 301],318,3,19119,3.6472720335749713,20.0,0.0
25242,2,5242,[ 79   8  82  69 215],85,3,19122,3.6471485790577916,0.0,0.0
25243,2,5243,[ 12  11   7 742 135],92,4,19126,3.6472158657513347,20.0,0.0
25244,2,5244,[ 95  11  25 125  96],59,3,19129,3.6470924690181126,0.0,0.0
25245,2,5245,[496 294  15 508  69],653,1,19130,3.646587876477316,0.0,0.0
25246,2,5246,[245 282 322 111 597],92,2,19132,3.646274061368401,0.0,0.0
25247,2,5247,[302 483 100 127 313],90,5,19137,3.646532012195122,20.0,40.0
25248,2,5248,[234  82 200 144 185],666,2,19139,3.646218327300438,0.0,0.0
25249,2,5249,[302 483 100 127 313],537,5,19144,3.6464761904761906,20.0,40.0
25250,2,5250,[302 483 100 127 313],328,5,19149,3.6467339554370595,20.0,40.0
25251,2,5251,[ 56 403 111 235 238],92,3,19152,3.6466108149276466,0.0,0.0
25252,2,5252,[302 483 100 127 313],334,5,19157,3.646868456120312,20.0,40.0
25253,2,5253,[176 546 275 151 313],378,3,19160,3.6467453368861817,0.0,0.0
25254,2,5254,[302 483 100 127 313],329,5,19165,3.6470028544243576,20.0,40.0
25255,2,5255,[302 483 100 127 313],537,5,19170,3.6472602739726026,20.0,40.0
25256,2,5256,[302 483 100 127 313],232,3,19173,3.6471371504660453,20.0,40.0
25257,2,5257,[ 69 100  97  98 181],378,4,19177,3.6472042601749717,0.0,40.0
25258,2,5258,[294 174  79 196  28],379,4,19181,3.647271344362046,0.0,20.0
25259,2,5259,[302 483 100 127 313],329,5,19186,3.647528517110266,20.0,40.0
25260,2,5260,[302 483 100 127 313],537,5,19191,3.647785592092758,20.0,40.0
25261,2,5261,[183 191 196  98  22],378,5,19196,3.6480425693652605,0.0,20.0
25262,2,5262,[210 135 202 328 196],234,1,19197,3.6475394261827856,0.0,0.0
25263,2,5263,[200 194 121 143 202],343,3,19200,3.6474164133738602,0.0,0.0
25264,2,5264,[385   1  64  70 483],59,3,19203,3.6472934472934475,20.0,0.0
25265,2,5265,[ 95 215 194 121 265],60,5,19208,3.647550322825674,0.0,0.0
25266,2,5266,[ 70  25 143  64 175],892,4,19212,3.647617239415227,0.0,0.0
25267,2,5267,[237 117 276 111 483],605,2,19214,3.6473044798785117,20.0,0.0
25268,2,5268,[742 222 196 183  12],378,4,19218,3.647371417726324,20.0,0.0
25269,2,5269,[302 483 100 127 313],334,5,19223,3.647628083491461,20.0,40.0
25270,2,5270,[302 483 100 127 313],328,5,19228,3.647884651868716,20.0,40.0
25271,2,5271,[111  88  95 151 125],374,2,19230,3.6475720789074355,0.0,0.0
25272,2,5272,[180 405 210 127 211],7,4,19234,3.6476389152285225,0.0,20.0
25273,2,5273,[302 483 100 127 313],232,3,19237,3.6475161167993932,20.0,40.0
25274,2,5274,[174  64 568  11 471],378,3,19240,3.64739336492891,0.0,20.0
25275,2,5275,[275 483 546 196  98],533,4,19244,3.6474601971190297,20.0,20.0
25276,2,5276,[265 423 186 125   9],64,4,19248,3.6475270039795338,0.0,0.0
25277,2,5277,[ 95 427  88 403 289],194,1,19249,3.647025388404699,0.0,0.0
25278,2,5278,[176 228  82 294  22],774,2,19251,3.6467133926880093,0.0,0.0
25279,2,5279,[302 483 100 127 313],537,5,19256,3.646969696969697,20.0,40.0
25280,2,5280,[302 483 100 127 313],474,5,19261,3.6472259041848134,20.0,40.0
25281,2,5281,[678 385 568  11 144],13,1,19262,3.6467247254827715,0.0,0.0
25282,2,5282,[385 197 176 258 423],533,4,19266,3.6467915956842702,0.0,0.0
25283,2,5283,[302 483 100 127 313],334,5,19271,3.6470476911430736,20.0,40.0
25284,2,5284,[204 161 174 197  50],313,5,19276,3.6473036896877957,0.0,40.0
25285,2,5285,[435 197 258 245  69],313,3,19279,3.6471812334468408,0.0,0.0
25286,2,5286,[132 496 204 238 300],537,2,19281,3.6468696803480234,0.0,0.0
25287,2,5287,[ 89  97 257 143  95],95,3,19284,3.646747352496218,0.0,0.0
25288,2,5288,[121 257 546 100  98],804,4,19288,3.6468141425600304,0.0,40.0
25289,2,5289,[215 202 294 238  56],194,3,19291,3.6466918714555767,0.0,0.0
25290,2,5290,[302 483 100 127 313],232,3,19294,3.6465696465696467,20.0,40.0
25291,2,5291,[302 483 100 127 313],537,5,19299,3.6468253968253967,20.0,40.0
25292,2,5292,[204 265  79 427 117],374,4,19303,3.64689212167013,0.0,0.0
25293,2,5293,[302 483 100 127 313],329,5,19308,3.647147714393653,20.0,40.0
25294,2,5294,[275  28   7 211  64],527,2,19310,3.646836638338055,0.0,0.0
25295,2,5295,[135 179 175  11  71],334,4,19314,3.64690332326284,0.0,0.0
25296,2,5296,[ 79 176 603 333 475],537,2,19316,3.6465924107985654,20.0,0.0
25297,2,5297,[100 302 195 322 435],328,3,19319,3.6464703661759152,0.0,20.0
25298,2,5298,[385 176 153 275  64],60,4,19323,3.6465370824683903,0.0,0.0
25299,2,5299,[302 483 100 127 313],13,5,19328,3.6467924528301885,20.0,40.0
25300,2,5300,[302 483 100 127 313],474,5,19333,3.647047726843992,20.0,40.0
25301,2,5301,[174 100  96 357 204],840,4,19337,3.64711429649189,20.0,40.0
25302,2,5302,[197 125 194  22 100],881,3,19340,3.646992268527249,0.0,20.0
25303,2,5303,[302 483 100 127 313],90,5,19345,3.6472473604826545,20.0,40.0
25304,2,5304,[182 173 118 318 197],59,5,19350,3.647502356267672,20.0,0.0
25305,2,5305,[210  79  98 191  25],184,4,19354,3.647568790049001,0.0,20.0
25306,2,5306,[515 186   8 215 191],387,3,19357,3.6474467684190692,0.0,0.0
25307,2,5307,[286 435   8 423 187],385,2,19359,3.6471363978899776,0.0,0.0
25308,2,5308,[405 132 179 603 403],7,4,19363,3.6472028630627236,20.0,0.0
25309,2,5309,[ 12 258 111 195   9],64,4,19367,3.6472693032015067,20.0,0.0
25310,2,5310,[143 568 180 302 475],207,3,19370,3.6471474298625495,0.0,0.0
25311,2,5311,[268  69 435  79 210],234,1,19371,3.6466490963855422,0.0,0.0
25312,2,5312,[302 483 100 127 313],328,5,19376,3.6469038208168643,20.0,40.0
25313,2,5313,[174 276 471  28 385],42,4,19380,3.6469702672186677,0.0,20.0
25314,2,5314,[323 258 181 204 357],254,3,19383,3.646848541862653,20.0,0.0
25315,2,5315,[302 483 100 127 313],328,5,19388,3.6471030850263357,20.0,40.0
25316,2,5316,[302 483 100 127 313],329,5,19393,3.647357532443107,20.0,40.0
25317,2,5317,[508 568  82 427 210],59,5,19398,3.64761188416698,0.0,0.0
25318,2,5318,[245  64 275 237 181],452,3,19401,3.647490129723632,0.0,0.0
25319,2,5319,[302 483 100 127 313],13,5,19406,3.6477443609022555,20.0,40.0
25320,2,5320,[216 546 405 117 385],13,0,19406,3.6470588235294117,0.0,0.0
25321,2,5321,[302 483 100 127 313],334,5,19411,3.647313040210447,20.0,40.0
25322,2,5322,[168  15 125 215 176],406,2,19413,3.647003569415743,0.0,0.0
25323,2,5323,[302 483 100 127 313],90,5,19418,3.6472577009767093,20.0,40.0
25324,2,5324,[322 174 655 144 748],102,1,19419,3.6467605633802815,0.0,20.0
25325,2,5325,[435 202 216  88  25],749,5,19424,3.6470146451370633,0.0,0.0
25326,2,5326,[302 483 100 127 313],537,5,19429,3.647268631499906,20.0,40.0
25327,2,5327,[302 483 100 127 313],537,5,19434,3.6475225225225225,20.0,40.0
25328,2,5328,[471 475 742 268 258],92,4,19438,3.647588665790955,0.0,0.0
25329,2,5329,[144 215 568 143 508],385,0,19438,3.646904315196998,0.0,0.0
25330,2,5330,[302 483 100 127 313],328,5,19443,3.647158131682611,20.0,40.0
25331,2,5331,[153 588 427  69 194],650,3,19446,3.6470367591897976,0.0,0.0
25332,2,5332,[302 483 100 127 313],537,5,19451,3.6472904556534784,20.0,40.0
25333,2,5333,[603 153 508 496 194],326,4,19455,3.6473565804274464,20.0,0.0
25334,2,5334,[302 483 100 127 313],537,5,19460,3.647610121836926,20.0,40.0
25335,2,5335,[302 483 100 127 313],474,5,19465,3.647863568215892,20.0,40.0
25336,2,5336,[357 175  25 144 194],360,2,19467,3.6475548060708265,20.0,0.0
25337,2,5337,[ 88  50 173 210  15],42,5,19472,3.6478081678531287,0.0,20.0
25338,2,5338,[302 483 100 127 313],232,3,19475,3.6476868327402134,20.0,40.0
25339,2,5339,[153 273 173 197 300],378,4,19479,3.647752808988764,0.0,0.0
25340,2,5340,[265   1  50 435 132],892,5,19484,3.6480059913873806,0.0,20.0
25341,2,5341,[302 483 100 127 313],329,5,19489,3.6482590789966305,20.0,40.0
25342,2,5342,[302 483 100 127 313],537,5,19494,3.648512071869736,20.0,40.0
25343,2,5343,[172 176 202 546 405],92,2,19496,3.6482035928143715,0.0,0.0
25344,2,5344,[176 748  25   8 144],899,3,19499,3.6480823199251637,0.0,0.0
25345,2,5345,[183   1 151  69 588],406,4,19503,3.6481481481481484,0.0,0.0
25346,2,5346,[435 323 483   4 195],788,1,19504,3.647652889470731,20.0,0.0
25347,2,5347,[168 403   1 195 117],749,5,19509,3.647905759162304,0.0,0.0
25348,2,5348,[174 228 211  56 269],339,5,19514,3.6481585343054777,0.0,20.0
25349,2,5349,[302 483 100 127 313],537,5,19519,3.648411214953271,20.0,40.0
25350,2,5350,[196 742 187 204 508],59,4,19523,3.6484769202018312,0.0,0.0
25351,2,5351,[118  56 333 183 125],653,2,19525,3.648168908819133,0.0,0.0
25352,2,5352,[302 483 100 127 313],90,5,19530,3.6484214459181765,20.0,40.0
25353,2,5353,[405 204 183  11 173],200,4,19534,3.6484871124392977,0.0,0.0
25354,2,5354,[121  11 195 143 200],213,5,19539,3.6487394957983192,0.0,0.0
25355,2,5355,[  4 265 132  25 168],308,3,19542,3.648618371919343,0.0,0.0
25356,2,5356,[403   4 144 183 597],650,1,19543,3.6481239499719993,0.0,0.0
25357,2,5357,[216 202 405 195  97],7,3,19546,3.6480029861888763,0.0,0.0
25358,2,5358,[302 483 100 127 313],537,5,19551,3.648255271505878,20.0,40.0
25359,2,5359,[182 385 300 185  70],90,3,19554,3.648134328358209,0.0,0.0
25360,2,5360,[302 483 100 127 313],90,5,19559,3.6483864950568923,20.0,40.0
25361,2,5361,[302 483 100 127 313],232,3,19562,3.648265572547557,20.0,40.0
25362,2,5362,[302 483 100 127 313],90,5,19567,3.6485176207346632,20.0,40.0
25363,2,5363,[322  50 471 125   7],894,3,19570,3.6483967188665174,0.0,20.0
25364,2,5364,[197 275 211 286 210],452,4,19574,3.6484622553588073,0.0,0.0
25365,2,5365,[302 483 100 127 313],334,5,19579,3.6487141259783824,20.0,40.0
25366,2,5366,[302 483 100 127 313],90,5,19584,3.6489659027389605,20.0,40.0
25367,2,5367,[302 483 100 127 313],474,5,19589,3.6492175856929956,20.0,40.0
25368,2,5368,[302 483 100 127 313],328,5,19594,3.6494691748929036,20.0,40.0
25369,2,5369,[357 427  96 282 265],474,5,19599,3.6497206703910616,20.0,0.0
25370,2,5370,[ 82 191 172 268 182],92,4,19603,3.649785887171849,0.0,0.0
25371,2,5371,[302 483 100 127 313],329,5,19608,3.650037230081906,20.0,40.0
25372,2,5372,[183 238 168  11   9],82,3,19611,3.6499162479061975,0.0,0.0
25373,2,5373,[111 215 288  79 179],643,4,19615,3.649981391886863,0.0,0.0
25374,2,5374,[202 322  71 127 161],311,5,19620,3.650232558139535,0.0,20.0
25375,2,5375,[194 100 515 195 200],650,5,19625,3.650483630952381,0.0,20.0
25376,2,5376,[ 50 385 121 132 191],95,4,19629,3.650548633066766,0.0,20.0
25377,2,5377,[302 483 100 127 313],474,5,19634,3.650799553737449,20.0,40.0
25378,2,5378,[ 12 655 271 175 385],13,3,19637,3.6506785647889943,20.0,0.0
25379,2,5379,[302 483 100 127 313],232,3,19640,3.650557620817844,20.0,40.0
25380,2,5380,[215 143 211 515 195],474,5,19645,3.650808399925664,0.0,0.0
25381,2,5381,[333 187 403 143 289],881,3,19648,3.6506874767744333,0.0,0.0
25382,2,5382,[ 12 135  98 483 183],194,3,19651,3.650566598550994,40.0,20.0
25383,2,5383,[568 180 258 186  89],749,5,19656,3.650817236255572,0.0,0.0
25384,2,5384,[302 483 100 127 313],13,5,19661,3.6510677808727947,20.0,40.0
25385,2,5385,[ 89   7 546 237 275],7,5,19666,3.6513182324545115,0.0,0.0
25386,2,5386,[ 50 235 204  28 265],738,4,19670,3.651382958975311,0.0,20.0
25387,2,5387,[211 300 187 222 204],234,1,19671,3.650890868596882,0.0,0.0
25388,2,5388,[302 483 100 127 313],207,4,19675,3.6509556503989606,20.0,40.0
25389,2,5389,[302 483 100 127 313],334,5,19680,3.6512059369202228,20.0,40.0
25390,2,5390,[ 15 235 276 135  28],200,4,19684,3.6512706362455947,0.0,0.0
25391,2,5391,[302 483 100 127 313],329,5,19689,3.6515207715133533,20.0,40.0
25392,2,5392,[  9 655 176 475  89],13,2,19691,3.6512145373632485,0.0,0.0
25393,2,5393,[175 182 423 194 294],95,3,19694,3.651093807934742,0.0,0.0
25394,2,5394,[172  82 515   8  56],85,4,19698,3.651158480074143,0.0,0.0
25395,2,5395,[181 186 202 323 194],648,5,19703,3.6514084507042255,0.0,0.0
25396,2,5396,[216 655 191 228 187],506,5,19708,3.65165832870113,0.0,0.0
25397,2,5397,[ 69 216 180 273 423],328,3,19711,3.6515376065209337,0.0,0.0
25398,2,5398,[237 403 655  64 127],194,3,19714,3.6514169290609373,0.0,20.0
25399,2,5399,[302 483 100 127 313],474,5,19719,3.651666666666667,20.0,40.0
25400,2,5400,[302 483 100 127 313],13,5,19724,3.6519163117941122,20.0,40.0
25401,2,5401,[194 179 655 271 175],843,3,19727,3.651795631247686,0.0,0.0
25402,2,5402,[302 483 100 127 313],328,5,19732,3.6520451600962427,20.0,40.0
25403,2,5403,[405 151 197 215 118],59,4,19736,3.6521095484826054,0.0,0.0
25404,2,5404,[288 172 210 121  98],882,4,19740,3.652173913043478,0.0,20.0
25405,2,5405,[168 273 153  97 403],308,3,19743,3.6520532741398446,0.0,0.0
25406,2,5406,[215  69 276 144 216],308,1,19744,3.6515627889772517,0.0,0.0
25407,2,5407,[125 385 427 191 228],295,5,19749,3.6518121301775146,0.0,0.0
25408,2,5408,[603 655 496 216 175],537,3,19752,3.6516916250693288,20.0,0.0
25409,2,5409,[  8 175  89 288 471],234,1,19753,3.651201478743068,0.0,0.0
25410,2,5410,[435 174  22 238 222],254,3,19756,3.6510811310293847,0.0,20.0
25411,2,5411,[435 200  56 300 132],234,2,19758,3.6507760532150777,0.0,0.0
25412,2,5412,[302 483 100 127 313],13,5,19763,3.6510253094402363,20.0,40.0
25413,2,5413,[302 483 100 127 313],474,5,19768,3.6512744735869966,20.0,40.0
25414,2,5414,[ 88 275  98 175  11],537,2,19770,3.6509695290858724,0.0,20.0
25415,2,5415,[195 191 185 276 294],234,1,19771,3.650480059084195,0.0,0.0
25416,2,5416,[ 88 228   4 172 200],749,5,19776,3.6507291858962527,0.0,0.0
25417,2,5417,[ 69 200  64 475 143],339,5,19781,3.6509782207456625,0.0,0.0
25418,2,5418,[153 275 161 195 118],648,4,19785,3.651042627791105,0.0,0.0
25419,2,5419,[ 50 125  89 318 597],59,3,19788,3.6509225092250923,20.0,20.0
25420,2,5420,[302 483 100 127 313],90,5,19793,3.651171370595831,20.0,40.0
25421,2,5421,[302 483 100 127 313],207,4,19797,3.651235706381409,20.0,40.0
25422,2,5422,[435 210 323 515  97],290,1,19798,3.650746819103817,0.0,0.0
25423,2,5423,[174 186 300 323 276],13,3,19801,3.6506268436578173,0.0,20.0
25424,2,5424,[ 11   7  82 588  25],184,2,19803,3.6503225806451614,0.0,0.0
25425,2,5425,[125   7 245 174  82],200,4,19807,3.6503870254331,0.0,20.0
25426,2,5426,[153 202 588 403 180],378,3,19810,3.650267182605491,0.0,0.0
25427,2,5427,[  7  95 191 151 271],537,2,19812,3.6499631540162123,0.0,0.0
25428,2,5428,[121 333 258 748 302],548,4,19816,3.650027629397679,0.0,0.0
25429,2,5429,[ 69 202  11 276 111],59,5,19821,3.6502762430939226,0.0,0.0
25430,2,5430,[302 483 100 127 313],329,5,19826,3.6505247652366046,20.0,40.0
25431,2,5431,[ 25 174 179 127  56],406,4,19830,3.6505891016200294,0.0,40.0
25432,2,5432,[144 603 151 135 176],7,4,19834,3.6506534143198968,20.0,0.0
25433,2,5433,[302 483 100 127 313],537,5,19839,3.650901729849098,20.0,40.0
25434,2,5434,[265 173 100  96 568],738,3,19842,3.650781968721251,0.0,20.0
25435,2,5435,[238 185 168 269  89],239,5,19847,3.6510301692420897,0.0,0.0
25436,2,5436,[235 211 144 176 748],313,3,19850,3.6509104285451537,0.0,0.0
25437,2,5437,[403  11 135   8 234],308,4,19854,3.65097462302317,0.0,0.0
25438,2,5438,[127 176 187 257 118],479,4,19858,3.6510387938959368,0.0,20.0
25439,2,5439,[403 405 144 333 180],328,3,19861,3.650919117647059,0.0,0.0
25440,2,5440,[135 181 210  64 276],452,3,19864,3.650799485388715,0.0,0.0
25441,2,5441,[  4  98 194   9  11],339,5,19869,3.651047409040794,0.0,20.0
25442,2,5442,[ 50 742 294 100 403],381,4,19873,3.6511115193826935,0.0,40.0
25443,2,5443,[286   1  89 302 318],378,5,19878,3.651359294636297,20.0,0.0
25444,2,5444,[174  11  64 748 100],788,2,19880,3.6510560146923785,0.0,40.0
25445,2,5445,[403  71 235 597 313],92,3,19883,3.65093646713184,0.0,0.0
25446,2,5446,[302 483 100 127 313],537,5,19888,3.6511841380576464,20.0,40.0
25447,2,5447,[127 172 357 742 121],313,4,19892,3.6512481644640236,20.0,20.0
25448,2,5448,[302 483 100 127 313],474,5,19897,3.65149568728207,20.0,40.0
25449,2,5449,[286  56  98   7 117],406,4,19901,3.651559633027523,0.0,20.0
25450,2,5450,[286 215  82 301  15],184,2,19903,3.6512566501559345,0.0,0.0
25451,2,5451,[222 313  82 118 300],102,0,19903,3.650586940572267,0.0,0.0
25452,2,5452,[265 496  56 423 191],311,5,19908,3.650834403080873,0.0,0.0
25453,2,5453,[215 258 282 234 173],479,4,19912,3.6508984231756507,0.0,0.0
25454,2,5454,[302 483 100 127 313],474,5,19917,3.651145737855179,20.0,40.0
25455,2,5455,[357 194 180 186 183],328,4,19921,3.651209677419355,20.0,0.0
25456,2,5456,[135 748   1 143 125],533,3,19924,3.6510903426791277,0.0,0.0
25457,2,5457,[568 748 515 496 185],488,4,19928,3.65115426896299,0.0,0.0
25458,2,5458,[302 483 100 127 313],13,5,19933,3.6514013555596265,20.0,40.0
25459,2,5459,[357  98 597 678  70],308,2,19935,3.651098901098901,20.0,20.0
25460,2,5460,[ 89   4 423 276  22],343,4,19939,3.6511627906976742,0.0,0.0
25461,2,5461,[302 483 100 127 313],90,5,19944,3.65140974002197,20.0,40.0
25462,2,5462,[302 483 100 127 313],232,3,19947,3.6512904997254254,20.0,40.0
25463,2,5463,[302 483 100 127 313],474,5,19952,3.651537335285505,20.0,40.0
25464,2,5464,[257  22 118  69 603],840,2,19954,3.651235132662397,20.0,0.0
25465,2,5465,[302 483 100 127 313],90,5,19959,3.6514818880351263,20.0,40.0
25466,2,5466,[211  56 603 265   8],533,2,19961,3.6511798061093836,20.0,0.0
25467,2,5467,[186 496 235 603 117],398,4,19965,3.6512435991221652,20.0,0.0
25468,2,5468,[302 483 100 127 313],232,3,19968,3.6511245200219418,20.0,40.0
25469,2,5469,[132 182 153 175 173],795,3,19971,3.6510054844606947,0.0,0.0
25470,2,5470,[427 179  79  64 127],13,3,19974,3.6508864924145494,0.0,20.0
25471,2,5471,[302 483 100 127 313],334,5,19979,3.6511330409356724,20.0,40.0
25472,2,5472,[186  56 742 265  69],207,4,19983,3.651196784213411,0.0,0.0
25473,2,5473,[323 289 194  71 300],788,3,19986,3.6510778224333214,0.0,0.0
25474,2,5474,[100  79   1 483 423],881,5,19991,3.651324200913242,20.0,20.0
25475,2,5475,[ 22 597 144 216 603],650,2,19993,3.6510226442658875,20.0,0.0
25476,2,5476,[588  98  11 153 194],308,4,19997,3.651086361146613,0.0,20.0
25477,2,5477,[  1 294 273   7  98],378,4,20001,3.6511500547645124,0.0,20.0
25478,2,5478,[ 22  15 678  25 508],455,2,20003,3.650848695017339,0.0,0.0
25479,2,5479,[302 483 100 127 313],207,4,20007,3.6509124087591243,20.0,40.0
25480,2,5480,[496  97 318  50  56],653,3,20010,3.6507936507936507,20.0,20.0
25481,2,5481,[603 173 195 294 194],537,2,20012,3.6504925209777452,20.0,0.0
25482,2,5482,[276 179  88   1  50],374,2,20014,3.6501915010031003,0.0,20.0
25483,2,5483,[302 483 100 127 313],537,5,20019,3.650437636761488,20.0,40.0
25484,2,5484,[ 56   7 200 435 135],666,5,20024,3.650683682771194,0.0,0.0
25485,2,5485,[302 483 100 127 313],13,5,20029,3.6509296390812978,20.0,40.0
25486,2,5486,[302 483 100 127 313],328,5,20034,3.651175505740842,20.0,40.0
25487,2,5487,[100 182 328 678   7],92,3,20037,3.6510568513119535,0.0,20.0
25488,2,5488,[234 176 125 385 153],7,4,20041,3.651120422663509,0.0,0.0
25489,2,5489,[302 483 100 127 313],90,5,20046,3.6513661202185794,20.0,40.0
25490,2,5490,[328 273 144 135 195],378,2,20048,3.6510653797122563,0.0,0.0
25491,2,5491,[302 483 100 127 313],232,3,20051,3.6509468317552805,20.0,40.0
25492,2,5492,[196   8 100 300   7],7,5,20056,3.6511924267249225,0.0,20.0
25493,2,5493,[237 216 403  96 197],378,4,20060,3.65125591554423,0.0,0.0
25494,2,5494,[568 181 182  12  50],387,4,20064,3.651319381255687,20.0,20.0
25495,2,5495,[302 483 100 127 313],207,4,20068,3.651382823871907,20.0,40.0
25496,2,5496,[ 69 515 111 174 216],488,4,20072,3.651446243405494,0.0,20.0
25497,2,5497,[117 286 151 127  25],339,4,20076,3.6515096398690434,0.0,20.0
25498,2,5498,[385 273 655 286 132],10,5,20081,3.651754864520822,0.0,0.0
25499,2,5499,[174 121 515 194 222],339,4,20085,3.651818181818182,0.0,20.0
25500,2,5500,[ 64 742 151 174 180],833,2,20087,3.651517905835303,0.0,20.0
25501,2,5501,[234 265 194 187 174],312,4,20091,3.6515812431842964,0.0,20.0
25502,2,5502,[ 50   7 385 215  22],653,3,20094,3.651462838451754,0.0,20.0
25503,2,5503,[235  71   7 210  82],184,2,20096,3.6511627906976742,0.0,0.0
25504,2,5504,[ 71 180 185 403 197],749,5,20101,3.6514078110808357,0.0,0.0
25505,2,5505,[100  97 276  89 483],90,5,20106,3.651652742462768,20.0,20.0
25506,2,5506,[318 603   1 204 125],648,3,20109,3.6515344107499548,40.0,0.0
25507,2,5507,[742 588   1 435 597],804,3,20112,3.6514161220043575,0.0,0.0
25508,2,5508,[302 483 100 127 313],537,5,20117,3.651660918497005,20.0,40.0
25509,2,5509,[161 265 117  95 568],374,5,20122,3.6519056261343015,0.0,0.0
25510,2,5510,[271 176 183 302 385],833,2,20124,3.6516058791507895,0.0,0.0
25511,2,5511,[132 200 568 275 197],13,2,20126,3.6513062409288826,0.0,0.0
25512,2,5512,[597  97 427 210  28],59,4,20130,3.651369490295665,0.0,0.0
25513,2,5513,[ 97 475 678 176  88],339,4,20134,3.651432716721074,0.0,0.0
25514,2,5514,[ 71 202 435 234 111],59,4,20138,3.6514959202175885,0.0,0.0
25515,2,5515,[ 15 742 546 151  98],313,2,20140,3.651196519216824,0.0,20.0
25516,2,5516,[333 323  50 173  95],506,4,20144,3.6512597426137394,0.0,20.0
25517,2,5517,[302 483 100 127 313],474,5,20149,3.6515041681768756,20.0,40.0
25518,2,5518,[234  69 144 313  22],308,1,20150,3.6510237361840914,0.0,0.0
25519,2,5519,[ 11   8 117 271  96],92,4,20154,3.651086956521739,0.0,0.0
25520,2,5520,[289 194 182 423 515],234,4,20158,3.6511501539576163,0.0,0.0
25521,2,5521,[435 245 179 200 496],10,5,20163,3.651394422310757,0.0,0.0
25522,2,5522,[200 265  56  70 173],537,3,20166,3.6512764801738187,0.0,0.0
25523,2,5523,[423 515 121 204 172],290,4,20170,3.6513396089790007,0.0,0.0
25524,2,5524,[ 50 191  69 237 151],664,2,20172,3.6510407239819003,0.0,20.0
25525,2,5525,[568 742 403 318 181],313,3,20175,3.6509229098805647,20.0,0.0
25526,2,5526,[678  22 179 475  88],474,4,20179,3.6509860683915325,0.0,0.0
25527,2,5527,[302 483 100 127 313],328,5,20184,3.65123010130246,20.0,40.0
25528,2,5528,[323 118   8 318  28],328,2,20186,3.6509314523421956,20.0,0.0
25529,2,5529,[168 211 197 127 100],738,2,20188,3.650632911392405,0.0,40.0
25530,2,5530,[211 196 423 202  25],537,1,20189,3.6501536792623397,0.0,0.0
25531,2,5531,[302 483 100 127 313],207,4,20193,3.6502169197396963,20.0,40.0
25532,2,5532,[403  64 471 202   8],543,4,20197,3.6502801373576723,0.0,0.0
25533,2,5533,[ 11  89 237  22 194],883,1,20198,3.6498012287676183,0.0,0.0
25534,2,5534,[100 118 181  79 328],313,5,20203,3.650045167118338,0.0,20.0
25535,2,5535,[  8 235 568 597  70],308,3,20206,3.64992774566474,0.0,0.0
25536,2,5536,[483 111  82 475 471],533,4,20210,3.649990969839263,20.0,0.0
25537,2,5537,[286 196 125 678 143],254,2,20212,3.64969302997472,0.0,0.0
25538,2,5538,[405 237  22 202 222],343,5,20217,3.6499368116988626,0.0,0.0
25539,2,5539,[294 678 151  56  28],387,2,20219,3.649638989169675,0.0,0.0
25540,2,5540,[204 197 222 195  82],194,2,20221,3.649341274138242,0.0,0.0
25541,2,5541,[ 12 161 216 508  11],474,4,20225,3.6494045470949117,20.0,0.0
25542,2,5542,[186  95 211  98 678],537,2,20227,3.64910698177882,0.0,20.0
25543,2,5543,[302 483 100 127 313],13,5,20232,3.6493506493506493,20.0,40.0
25544,2,5544,[187  69  11 294 475],207,2,20234,3.6490532010820558,0.0,0.0
25545,2,5545,[257 568 357 515  98],343,3,20237,3.648936170212766,20.0,20.0
25546,2,5546,[385 153 172 125 655],295,5,20242,3.6491797367946637,0.0,0.0
25547,2,5547,[144 194 234 175   9],339,4,20246,3.649242970439798,0.0,0.0
25548,2,5548,[127 403  79 235 210],374,3,20249,3.649125968642999,0.0,20.0
25549,2,5549,[405  12 121  98  22],774,1,20250,3.6486486486486487,20.0,20.0
25550,2,5550,[ 12 588 135 222 483],234,2,20252,3.6483516483516483,40.0,0.0
25551,2,5551,[302 483 100 127 313],328,5,20257,3.6485951008645534,20.0,40.0
25552,2,5552,[286 100 265 496 228],343,4,20261,3.6486583828561137,0.0,20.0
25553,2,5553,[ 56 161 125 176 185],7,3,20264,3.6485415916456607,0.0,0.0
25554,2,5554,[ 15 423 496 144  25],234,2,20266,3.648244824482448,0.0,0.0
25555,2,5555,[302 483 100 127 313],207,4,20270,3.648308135349172,20.0,40.0
25556,2,5556,[423 318 508 323 235],537,2,20272,3.6480115170055787,20.0,0.0
25557,2,5557,[168 597 194  50 216],643,4,20276,3.6480748470672903,0.0,20.0
25558,2,5558,[194  89  12 173 475],387,3,20279,3.6479582658751575,20.0,0.0
25559,2,5559,[181 180 222 275  89],901,2,20281,3.647661870503597,0.0,0.0
25560,2,5560,[222  98 385 176   1],343,4,20285,3.64772522927531,0.0,20.0
25561,2,5561,[  7 100 748 515   8],92,4,20289,3.6477885652642934,0.0,20.0
25562,2,5562,[302 483 100 127 313],328,5,20294,3.6480316376056083,20.0,40.0
25563,2,5563,[100 515  22 211 276],339,5,20299,3.648274622573688,0.0,20.0
25564,2,5564,[302 483 100 127 313],13,5,20304,3.6485175202156332,20.0,40.0
25565,2,5565,[302 483 100 127 313],537,5,20309,3.6487603305785123,20.0,40.0
25566,2,5566,[302 483 100 127 313],537,5,20314,3.6490030537093587,20.0,40.0
25567,2,5567,[427 333 195 385  11],666,2,20316,3.648706896551724,0.0,0.0
25568,2,5568,[435 234 678 323 117],454,0,20316,3.648051714850063,0.0,0.0
25569,2,5569,[ 97 211 288 748 265],533,1,20317,3.647576301615799,0.0,0.0
25570,2,5570,[257   1  50  22 515],95,5,20322,3.6478190630048464,0.0,20.0
25571,2,5571,[302 483 100 127 313],537,5,20327,3.6480617372577173,20.0,40.0
25572,2,5572,[322  64  95 127 125],804,3,20330,3.6479454512829714,0.0,20.0
25573,2,5573,[118 222 333   9  70],699,2,20332,3.647649802655185,0.0,0.0
25574,2,5574,[302 483 100 127 313],474,5,20337,3.6478923766816145,20.0,40.0
25575,2,5575,[  1 483   8 200 132],488,0,20337,3.6472381635581064,20.0,0.0
25576,2,5576,[204  89  79 153 269],883,4,20341,3.6473014165321858,0.0,0.0
25577,2,5577,[195  97 168 181 100],452,5,20346,3.6475439225528863,0.0,20.0
25578,2,5578,[318 286  56 323 289],378,4,20350,3.6476070980462447,20.0,0.0
25579,2,5579,[508 234 276 655 197],537,3,20353,3.6474910394265234,0.0,0.0
25580,2,5580,[143 328  12 475 237],13,2,20355,3.647195843038882,20.0,0.0
25581,2,5581,[238 300 121  89  69],378,3,20358,3.647079899677535,0.0,0.0
25582,2,5582,[237 187 186 181 121],313,3,20361,3.646963997850618,0.0,0.0
25583,2,5583,[302 483 100 127 313],334,5,20366,3.6472063037249285,20.0,40.0
25584,2,5584,[288 568 210  98 161],387,2,20368,3.646911369740376,0.0,20.0
25585,2,5585,[125 143 322 265 121],311,4,20372,3.6469745793054065,0.0,0.0
25586,2,5586,[132 215 234 153 300],454,2,20374,3.646679792375157,0.0,0.0
25587,2,5587,[153 405  82  11 182],13,2,20376,3.64638511095204,0.0,0.0
25588,2,5588,[273  71 215  89 222],524,1,20377,3.645911612095187,0.0,0.0
25589,2,5589,[748 496 228 333 546],64,2,20379,3.6456171735241503,0.0,0.0
25590,2,5590,[302 483 100 127 313],13,5,20384,3.6458594169200502,20.0,40.0
25591,2,5591,[302 483 100 127 313],90,5,20389,3.646101573676681,20.0,40.0
25592,2,5592,[117 187   1  79 180],458,5,20394,3.646343643840515,0.0,0.0
25593,2,5593,[423 200  98 276 588],881,3,20397,3.6462281015373614,0.0,20.0
25594,2,5594,[ 56  70 435 194 181],7,3,20400,3.6461126005361932,0.0,0.0
25595,2,5595,[471 202  69 195 172],378,1,20401,3.645639742673338,0.0,0.0
25596,2,5596,[ 89 181 197   8 151],881,3,20404,3.6455243880650348,0.0,0.0
25597,2,5597,[117  98  88 302 300],145,4,20408,3.6455877098963914,0.0,20.0
25598,2,5598,[475  82 127 100 603],10,5,20413,3.6458296124307914,20.0,40.0
25599,2,5599,[ 56 186 135 144 427],328,3,20416,3.645714285714286,0.0,0.0
25600,2,5600,[111 197 195 515  96],95,5,20421,3.6459560792715586,0.0,0.0
25601,2,5601,[302 483 100 127 313],207,4,20425,3.6460192788289896,20.0,40.0
25602,2,5602,[302 483 100 127 313],329,5,20430,3.6462609316437624,20.0,40.0
25603,2,5603,[ 28 300 238  12 210],7,5,20435,3.6465024982155603,20.0,0.0
25604,2,5604,[194 302 588  98  50],13,5,20440,3.646743978590544,0.0,40.0
25605,2,5605,[176   9 202 286 323],200,4,20444,3.646806992508027,0.0,0.0
25606,2,5606,[302 483 100 127 313],13,5,20449,3.647048332441591,20.0,40.0
25607,2,5607,[302 483 100 127 313],90,5,20454,3.6472895863052783,20.0,40.0
25608,2,5608,[302 483 100 127 313],329,5,20459,3.647530754145124,20.0,40.0
25609,2,5609,[195 245 678  50 121],749,3,20462,3.647415329768271,0.0,20.0
25610,2,5610,[302 483 100 127 313],13,5,20467,3.6476563892354306,20.0,40.0
25611,2,5611,[302 483 100 127 313],329,5,20472,3.647897362794013,20.0,40.0
25612,2,5612,[ 98 515 161 173 135],339,4,20476,3.647960092642081,0.0,20.0
25613,2,5613,[302 483 100 127 313],334,5,20481,3.648200926255789,20.0,40.0
25614,2,5614,[ 15   8  28 275 286],243,3,20484,3.6480854853072127,0.0,0.0
25615,2,5615,[ 97  28 151 322 127],374,4,20488,3.6481481481481484,0.0,20.0
25616,2,5616,[302 483 100 127 313],207,4,20492,3.64821078867723,20.0,40.0
25617,2,5617,[143 748 294 210 195],346,3,20495,3.6480954076183694,0.0,0.0
25618,2,5618,[302 483 100 127 313],537,5,20500,3.648336002847482,20.0,40.0
25619,2,5619,[187 313 546 204 183],650,3,20503,3.648220640569395,0.0,0.0
25620,2,5620,[302 483 100 127 313],537,5,20508,3.648461127913183,20.0,40.0
25621,2,5621,[302 483 100 127 313],207,4,20512,3.648523657061544,20.0,40.0
25622,2,5622,[ 79 183  28 427 132],42,5,20517,3.6487640049795482,0.0,0.0
25623,2,5623,[302 483 100 127 313],90,5,20522,3.6490042674253202,20.0,40.0
25624,2,5624,[151 748 172  82 144],653,2,20524,3.648711111111111,0.0,0.0
25625,2,5625,[183 318 435  98 313],328,5,20529,3.648951297547103,20.0,20.0
25626,2,5626,[302 483 100 127 313],329,5,20534,3.649191398613826,20.0,40.0
25627,2,5627,[268 185 597 135 515],7,2,20536,3.648898365316276,0.0,0.0
25628,2,5628,[742 655 179 211 273],387,3,20539,3.6487830875821636,0.0,0.0
25629,2,5629,[483   1 318  12 300],788,4,20543,3.6488454706927174,60.0,0.0
25630,2,5630,[222  11  96 161 435],804,4,20547,3.648907831646244,0.0,0.0
25631,2,5631,[172  71 288   9 475],533,3,20550,3.6487926136363638,0.0,0.0
25632,2,5632,[222  69 185 117 196],13,2,20552,3.6484999112373515,0.0,0.0
25633,2,5633,[282 194  89  64  71],804,5,20557,3.648739794107206,0.0,0.0
25634,2,5634,[195 238 211 289   8],454,2,20559,3.648447204968944,0.0,0.0
25635,2,5635,[302 483 100 127 313],232,3,20562,3.64833215046132,20.0,40.0
25636,2,5636,[144 483 655 234 508],213,5,20567,3.6485719354266455,20.0,0.0
25637,2,5637,[  4 176 202 173 405],538,2,20569,3.6482795317488472,0.0,0.0
25638,2,5638,[318 289  28 191   8],387,3,20572,3.6481645681858486,20.0,0.0
25639,2,5639,[197 471 174 427  89],899,5,20577,3.648404255319149,0.0,20.0
25640,2,5640,[ 50 748 191 323 127],488,3,20580,3.6482893104059566,0.0,40.0
25641,2,5641,[302 483 100 127 313],13,5,20585,3.6485288904643745,20.0,40.0
25642,2,5642,[127 483 603 111 204],643,4,20589,3.648591174906964,40.0,20.0
25643,2,5643,[210 135  15 357 216],313,4,20593,3.6486534372785258,20.0,0.0
25644,2,5644,[496  82  89 748 235],64,2,20595,3.6483613817537646,0.0,0.0
25645,2,5645,[181 175 202  71  15],234,0,20595,3.6477151965993624,0.0,0.0
25646,2,5646,[ 88 194 286 168 508],339,5,20600,3.6479546661944395,0.0,0.0
25647,2,5647,[216 211 195 215 427],313,5,20605,3.6481940509915014,0.0,0.0
25648,2,5648,[302 483 100 127 313],537,5,20610,3.6484333510355813,20.0,40.0
25649,2,5649,[234 143 568   7 185],189,4,20614,3.648495575221239,0.0,0.0
25650,2,5650,[132 269 185 143 237],334,2,20616,3.6482038577242966,0.0,0.0
25651,2,5651,[176 258 187 228 655],774,2,20618,3.6479122434536446,0.0,0.0
25652,2,5652,[302 483 100 127 313],13,5,20623,3.6481514240226427,20.0,40.0
25653,2,5653,[  7  22 200  71 216],7,5,20628,3.648390519985851,0.0,0.0
25654,2,5654,[125 196 237 313  64],533,4,20632,3.6484526967285587,0.0,0.0
25655,2,5655,[143 191   1 202  98],379,5,20637,3.648691654879774,0.0,20.0
25656,2,5656,[210 127 143 175 168],64,4,20641,3.64875375640799,0.0,20.0
25657,2,5657,[186 100  22 175 172],524,1,20642,3.6482856132909154,0.0,20.0
25658,2,5658,[196 135 276  69 174],13,5,20647,3.6485244742887435,0.0,20.0
25659,2,5659,[144 222 289 161 127],328,4,20651,3.6485865724381625,0.0,20.0
25660,2,5660,[302 483 100 127 313],232,3,20654,3.648472001413178,20.0,40.0
25661,2,5661,[302 483 100 127 313],90,5,20659,3.6487107029318264,20.0,40.0
25662,2,5662,[302 483 100 127 313],207,4,20663,3.6487727352993113,20.0,40.0
25663,2,5663,[302 483 100 127 313],334,5,20668,3.649011299435028,20.0,40.0
25664,2,5664,[405 135 496 202  79],815,4,20672,3.6490732568402473,0.0,0.0
25665,2,5665,[405 204 200 286  88],537,0,20672,3.6484292269678784,0.0,0.0
25666,2,5666,[748 194 328 288  50],102,1,20673,3.647961884595024,0.0,20.0
25667,2,5667,[302 483 100 127 313],232,3,20676,3.647847565278758,20.0,40.0
25668,2,5668,[288 423 300 186 174],334,2,20678,3.647556888340095,0.0,20.0
25669,2,5669,[211 127 237  25 276],82,2,20680,3.6472663139329806,0.0,20.0
25670,2,5670,[357 144 186 258 182],653,2,20682,3.646975842003174,20.0,0.0
25671,2,5671,[ 95 121 127  69 195],648,2,20684,3.646685472496474,0.0,20.0
25672,2,5672,[483 471  64 200  15],308,2,20686,3.6463952053587168,20.0,0.0
25673,2,5673,[216 215 183 471 143],815,3,20689,3.6462812830454707,0.0,0.0
25674,2,5674,[144 187 127 385 100],64,4,20693,3.646343612334802,0.0,40.0
25675,2,5675,[187 121 603 127 196],664,4,20697,3.6464059196617336,20.0,20.0
25676,2,5676,[257 265  11   1 121],92,4,20701,3.646468205037872,0.0,0.0
25677,2,5677,[202 191 174 143 300],666,2,20703,3.6461782317717506,0.0,20.0
25678,2,5678,[182 403 302 117 237],378,4,20707,3.6462405353055116,0.0,0.0
25679,2,5679,[173  15  50  88 216],42,5,20712,3.6464788732394364,0.0,20.0
25680,2,5680,[202 276 186 200 302],378,2,20714,3.6461890512233763,0.0,0.0
25681,2,5681,[313 151 435  88 546],650,2,20716,3.645899331221401,0.0,0.0
25682,2,5682,[ 64  88 183 194 678],339,4,20720,3.6459616399788843,0.0,0.0
25683,2,5683,[144 143 174 427 179],7,4,20724,3.646023926812104,0.0,20.0
25684,2,5684,[302 483 100 127 313],328,5,20729,3.6462620932277923,20.0,40.0
25685,2,5685,[194 655  56 176 181],379,5,20734,3.646500175870559,0.0,0.0
25686,2,5686,[186  12 282 196 143],533,4,20738,3.646562335150343,20.0,0.0
25687,2,5687,[302 483 100 127 313],334,5,20743,3.6468002812939524,20.0,40.0
25688,2,5688,[546 271  11 117 515],102,0,20743,3.6461592547020567,0.0,0.0
25689,2,5689,[302 483 100 127 313],329,5,20748,3.646397188049209,20.0,40.0
25690,2,5690,[216 144  69 132 403],308,1,20749,3.6459321736074504,0.0,0.0
25691,2,5691,[302 483 100 127 313],537,5,20754,3.646170063246662,20.0,40.0
25692,2,5692,[ 98 313 183 222 257],738,4,20758,3.6462322150008784,0.0,20.0
25693,2,5693,[195 211 210 385  88],102,1,20759,3.645767474534598,0.0,0.0
25694,2,5694,[302 483 100 127 313],13,5,20764,3.646005267778753,20.0,40.0
25695,2,5695,[100 286 496 117  71],406,3,20767,3.6458918539325844,0.0,20.0
25696,2,5696,[302 222 333 135 121],328,2,20769,3.6456029489204846,0.0,0.0
25697,2,5697,[302 483 100 127 313],334,5,20774,3.645840645840646,20.0,40.0
25698,2,5698,[742 357   4  70 195],804,5,20779,3.6460782593437444,20.0,0.0
25699,2,5699,[  1 427   7 301  79],650,2,20781,3.6457894736842107,0.0,0.0
25700,2,5700,[ 97  25 269  98 286],537,0,20781,3.6451499736888264,0.0,20.0
25701,2,5701,[475 182   8 211 427],90,3,20784,3.645036829182743,0.0,0.0
25702,2,5702,[182  98 216 269 215],537,1,20785,3.644573031737682,0.0,20.0
25703,2,5703,[185 180 127 202 197],326,2,20787,3.6442847124824684,0.0,20.0
25704,2,5704,[  8 357 235 183 187],406,4,20791,3.644347063978966,20.0,0.0
25705,2,5705,[174 210   8 153   9],207,3,20794,3.644234139502278,0.0,20.0
25706,2,5706,[302 483 100 127 313],537,5,20799,3.6444717014193095,20.0,40.0
25707,2,5707,[175 215 228 333 405],13,3,20802,3.6443587946741416,0.0,0.0
25708,2,5708,[302 483 100 127 313],207,4,20806,3.644421089507795,20.0,40.0
25709,2,5709,[302 483 100 127 313],329,5,20811,3.644658493870403,20.0,40.0
25710,2,5710,[ 11 678 153 215 496],488,2,20813,3.644370513045001,0.0,0.0
25711,2,5711,[179 385 237 216 161],653,3,20816,3.6442577030812324,0.0,0.0
25712,2,5712,[132  28   1 151 423],64,4,20820,3.6443199719936987,0.0,0.0
25713,2,5713,[302 483 100 127 313],232,3,20823,3.644207210360518,20.0,40.0
25714,2,5714,[288  89 185 174 427],13,3,20826,3.6440944881889763,0.0,20.0
25715,2,5715,[ 50 196 294   4 197],774,1,20827,3.6436319104268717,0.0,20.0
25716,2,5716,[302 483 100 127 313],328,5,20832,3.6438691621479795,20.0,40.0
25717,2,5717,[568 222 333 288 300],64,3,20835,3.643756558237146,0.0,0.0
25718,2,5718,[ 95 143 237 183  64],60,4,20839,3.6438188494492043,0.0,0.0
25719,2,5719,[180 182 196 175  22],537,3,20842,3.643706293706294,0.0,0.0
25720,2,5720,[204 153 151  25 174],339,4,20846,3.6437685719279846,0.0,20.0
25721,2,5721,[ 69 423 471 322 181],308,2,20848,3.6434813002446695,0.0,0.0
25722,2,5722,[238 175 121  71   8],334,3,20851,3.643368862484711,0.0,0.0
25723,2,5723,[302 483 100 127 313],207,4,20855,3.6434311670160726,20.0,40.0
25724,2,5724,[187 282 323 204 175],474,4,20859,3.6434934497816593,0.0,0.0
25725,2,5725,[328 132   4 194 174],537,0,20859,3.642857142857143,0.0,20.0
25726,2,5726,[222 268 286 173 318],85,3,20862,3.642744892613934,20.0,0.0
25727,2,5727,[173 197 322 403 182],374,3,20865,3.642632681564246,0.0,0.0
25728,2,5728,[161 168 179 748  97],474,3,20868,3.6425205096875546,0.0,0.0
25729,2,5729,[ 15 276   8 186 151],234,1,20869,3.642059336823735,0.0,0.0
25730,2,5730,[176 135  25 288   1],374,5,20874,3.6422962833711394,0.0,0.0
25731,2,5731,[186  70 153   1 173],95,5,20879,3.642533147243545,0.0,0.0
25732,2,5732,[215 172 143 403 318],815,5,20884,3.6427699284842143,20.0,0.0
25733,2,5733,[ 97 403 258 135 265],533,1,20885,3.6423090338332753,0.0,0.0
25734,2,5734,[302 483 100 127 313],328,5,20890,3.6425457715780296,20.0,40.0
25735,2,5735,[ 97 405 655 435 121],295,5,20895,3.6427824267782425,0.0,0.0
25736,2,5736,[117 176 515 175 318],313,5,20900,3.6430189994770785,20.0,0.0
25737,2,5737,[496 173 144 127  56],659,5,20905,3.6432554897176717,0.0,20.0
25738,2,5738,[  8 196 215 135 568],766,2,20907,3.6429691583899633,0.0,0.0
25739,2,5739,[ 96 194  71 318 568],311,5,20912,3.643205574912892,20.0,0.0
25740,2,5740,[181 173 180 100 183],385,3,20915,3.6430935377112,0.0,20.0
25741,2,5741,[ 28  89  22 173  82],538,3,20918,3.6429815395332636,0.0,0.0
25742,2,5742,[588 153 181 210 197],263,2,20920,3.642695455336932,0.0,0.0
25743,2,5743,[143 318 655  79 508],343,5,20925,3.6429317548746516,20.0,0.0
25744,2,5744,[302 483 100 127 313],329,5,20930,3.6431679721496955,20.0,40.0
25745,2,5745,[185 197 216   7 127],653,1,20931,3.6427079707622694,0.0,20.0
25746,2,5746,[238   8 175 182 143],6,4,20935,3.642770140943101,0.0,0.0
25747,2,5747,[197 194 435 238 118],380,1,20936,3.6423103688239387,0.0,0.0
25748,2,5748,[302 483 100 127 313],207,4,20940,3.642372586536789,20.0,40.0
25749,2,5749,[  8 196 194 210 269],378,5,20945,3.6426086956521737,0.0,0.0
25750,2,5750,[ 69 118   7 216 515],184,2,20947,3.642323074247957,0.0,0.0
25751,2,5751,[168 405 496 183  12],379,4,20951,3.6423852573018083,20.0,0.0
25752,2,5752,[200  71 161 175 269],334,2,20953,3.64209977403094,0.0,0.0
25753,2,5753,[118 202 195 423 313],738,4,20957,3.6421619742787628,0.0,0.0
25754,2,5754,[286 216 127   4 196],318,2,20959,3.641876629018245,0.0,20.0
25755,2,5755,[235 435 655  96 180],788,1,20960,3.6414176511466296,0.0,0.0
25756,2,5756,[234  50 222  88 235],479,4,20964,3.641479937467431,0.0,20.0
25757,2,5757,[  1 183 237 238 597],92,4,20968,3.6415422021535253,0.0,0.0
25758,2,5758,[276 132 194 258  82],537,2,20970,3.641257162701858,0.0,0.0
25759,2,5759,[302 483 100 127 313],13,5,20975,3.6414930555555554,20.0,40.0
25760,2,5760,[302 483 100 127 313],537,5,20980,3.64172886651623,20.0,40.0
25761,2,5761,[302 483 100 127 313],328,5,20985,3.6419645956265185,20.0,40.0
25762,2,5762,[302 483 100 127 313],329,5,20990,3.64220024292903,20.0,40.0
25763,2,5763,[286 181 183  56 265],145,4,20994,3.642262317834837,0.0,0.0
25764,2,5764,[ 50 143 302 423 125],378,4,20998,3.6423243712055506,0.0,20.0
25765,2,5765,[118 200  15 186  97],313,2,21000,3.6420395421436003,0.0,0.0
25766,2,5766,[302 483 100 127 313],329,5,21005,3.6422750130050288,20.0,40.0
25767,2,5767,[508 176 200 318 483],474,3,21008,3.6421636615811375,40.0,0.0
25768,2,5768,[302 483 100 127 313],329,5,21013,3.642399029294505,20.0,40.0
25769,2,5769,[210 153   8  98  96],326,3,21016,3.6422876949740033,0.0,20.0
25770,2,5770,[237 435   8 143 288],533,2,21018,3.642003119043493,0.0,0.0
25771,2,5771,[302 483 100 127 313],13,5,21023,3.6422383922383923,20.0,40.0
25772,2,5772,[125 196 202  25 151],378,2,21025,3.641953923436688,0.0,0.0
25773,2,5773,[323 385  25 423 111],474,4,21029,3.6420159334949775,0.0,0.0
25774,2,5774,[302 483 100 127 313],90,5,21034,3.6422510822510823,20.0,40.0
25775,2,5775,[172 210   8 322  25],13,2,21036,3.64196675900277,0.0,0.0
25776,2,5776,[328  96 216  69  95],378,3,21039,3.6418556344123245,0.0,0.0
25777,2,5777,[215   1 153 135 196],749,5,21044,3.642090688819661,0.0,0.0
25778,2,5778,[258 191  64 176 187],474,5,21049,3.6423256618792177,0.0,0.0
25779,2,5779,[175  56 508  79 151],524,3,21052,3.6422145328719724,0.0,0.0
25780,2,5780,[302 483 100 127 313],329,5,21057,3.6424494032174364,20.0,40.0
25781,2,5781,[302 483 100 127 313],232,3,21060,3.642338291248703,20.0,40.0
25782,2,5782,[603 172  69 204 265],650,4,21064,3.6424001383365034,20.0,0.0
25783,2,5783,[323 257 161 238  69],804,5,21069,3.642634854771784,0.0,0.0
25784,2,5784,[328 313 286 546 200],145,3,21072,3.642523768366465,0.0,0.0
25785,2,5785,[ 96 357 273 181 200],13,2,21074,3.642239889388178,20.0,0.0
25786,2,5786,[302 483 100 127 313],232,3,21077,3.6421289096250216,20.0,40.0
25787,2,5787,[302 483 100 127 313],13,5,21082,3.6423635107118177,20.0,40.0
25788,2,5788,[ 50 546 187 151 300],64,2,21084,3.642079806529625,0.0,20.0
25789,2,5789,[175  89 603  25 568],308,5,21089,3.642314335060449,20.0,0.0
25790,2,5790,[176 238 144  89 515],488,3,21092,3.6422034190986015,0.0,0.0
25791,2,5791,[275  11 423 748 215],882,5,21097,3.6424378453038675,0.0,0.0
25792,2,5792,[210 135  98 385 174],311,5,21102,3.6426721905748316,0.0,40.0
25793,2,5793,[471 200 144 186 191],313,3,21105,3.6425612702795997,0.0,0.0
25794,2,5794,[ 50 194 234 588 161],7,4,21109,3.642622950819672,0.0,20.0
25795,2,5795,[ 88   1 144 228 265],279,3,21112,3.642512077294686,0.0,0.0
25796,2,5796,[302 483 100 127 313],329,5,21117,3.642746248059341,20.0,40.0
25797,2,5797,[588 180 496  98 385],452,4,21121,3.6428078647809587,0.0,20.0
25798,2,5798,[322 183 471 211 302],13,3,21124,3.642697016727022,0.0,0.0
25799,2,5799,[  9 471 172 435 117],271,3,21127,3.6425862068965515,0.0,0.0
25800,2,5800,[302 483 100 127 313],474,5,21132,3.6428202034132044,20.0,40.0
25801,2,5801,[302 483 100 127 313],13,5,21137,3.6430541192692174,20.0,40.0
25802,2,5802,[ 88  98 191 216 176],92,3,21140,3.6429433051869724,0.0,20.0
25803,2,5803,[515 435 289  79 333],328,4,21144,3.6430048242591315,0.0,0.0
25804,2,5804,[568 546   9 185 186],881,3,21147,3.6428940568475454,0.0,0.0
25805,2,5805,[302 483 100 127 313],207,4,21151,3.6429555632104718,20.0,40.0
25806,2,5806,[302 483 100 127 313],329,5,21156,3.6431892543482003,20.0,40.0
25807,2,5807,[181 204  97  28 515],311,5,21161,3.643422865013774,0.0,0.0
25808,2,5808,[302 483 100 127 313],90,5,21166,3.643656395248752,20.0,40.0
25809,2,5809,[289 191 288 268  12],234,2,21168,3.6433734939759037,20.0,0.0
25810,2,5810,[302 483 100 127 313],90,5,21173,3.6436069523317847,20.0,40.0
25811,2,5811,[302 483 100 127 313],13,5,21178,3.643840330350998,20.0,40.0
25812,2,5812,[302 483 100 127 313],328,5,21183,3.644073628075004,20.0,40.0
25813,2,5813,[273 216  70 288 496],666,2,21185,3.6437908496732025,0.0,0.0
25814,2,5814,[323 742 180 200  11],328,3,21188,3.6436801375752363,0.0,0.0
25815,2,5815,[ 64 357 216 135 179],738,3,21191,3.6435694635488307,20.0,0.0
25816,2,5816,[194 191  71 196  22],311,5,21196,3.643802647412756,0.0,0.0
25817,2,5817,[302 483 100 127 313],13,5,21201,3.6440357511172223,20.0,40.0
25818,2,5818,[197 245 427 180 289],90,3,21204,3.643925073036604,0.0,0.0
25819,2,5819,[302 483 100 127 313],328,5,21209,3.6441580756013745,20.0,40.0
25820,2,5820,[172  82 202 132 174],506,5,21214,3.6443909981102904,0.0,20.0
25821,2,5821,[302 483 100 127 313],329,5,21219,3.6446238406046034,20.0,40.0
25822,2,5822,[403   7 143   1 187],184,2,21221,3.6443414047741713,0.0,0.0
25823,2,5823,[275 215 202 276 197],233,5,21226,3.6445741758241756,0.0,0.0
25824,2,5824,[132  98 175 276 282],378,5,21231,3.6448068669527895,0.0,20.0
25825,2,5825,[328 234 168 182 211],95,2,21233,3.6445245451424646,0.0,0.0
25826,2,5826,[222   8 151 144  22],901,3,21236,3.6444139351295695,0.0,0.0
25827,2,5827,[  9 313  89  98 228],85,4,21240,3.644474948524365,0.0,20.0
25828,2,5828,[181 100 151 313 508],378,4,21244,3.6445359409847313,0.0,20.0
25829,2,5829,[100 273   7 322 117],537,2,21246,3.644253859348199,0.0,20.0
25830,2,5830,[302 483 100 127 313],474,5,21251,3.6444863659749616,20.0,40.0
25831,2,5831,[546 180  89 187 183],749,3,21254,3.6443758573388205,0.0,0.0
25832,2,5832,[302 483 100 127 313],329,5,21259,3.6446082633293333,20.0,40.0
25833,2,5833,[210 265 153 161  82],60,3,21262,3.6444977716832363,0.0,0.0
25834,2,5834,[168   7 273 111 603],666,3,21265,3.644387317909169,20.0,0.0
25835,2,5835,[191 508 111 235 161],524,4,21269,3.644448252227553,0.0,0.0
25836,2,5836,[302 483 100 127 313],13,5,21274,3.6446804865513105,20.0,40.0
25837,2,5837,[144 269 237 405 276],883,2,21276,3.6443987667009248,0.0,0.0
25838,2,5838,[ 79 174 423 603 237],13,4,21280,3.6444596677513275,20.0,20.0
25839,2,5839,[111 174 195 187 191],452,3,21283,3.644349315068493,0.0,20.0
25840,2,5840,[257 238 135 215 187],271,5,21288,3.6445814072932716,0.0,0.0
25841,2,5841,[ 50 175   9 211 475],648,2,21290,3.6442998972954466,0.0,20.0
25842,2,5842,[216 143 180 423 132],694,5,21295,3.6445319185349994,0.0,0.0
25843,2,5843,[ 50 215 197  96 546],7,5,21300,3.64476386036961,0.0,20.0
25844,2,5844,[258 176 655 121  98],659,5,21305,3.6449957228400343,0.0,20.0
25845,2,5845,[238   4 568 100 179],87,4,21309,3.645056448853917,0.0,20.0
25846,2,5846,[ 71 238  79   8 318],479,4,21313,3.6451171540961176,20.0,0.0
25847,2,5847,[174 483 546  25 183],666,3,21316,3.6450068399452804,20.0,20.0
25848,2,5848,[302 483 100 127 313],537,5,21321,3.6452385023080867,20.0,40.0
25849,2,5849,[215   9 427 273  97],7,4,21325,3.6452991452991452,0.0,0.0
25850,2,5850,[ 88 194 144 135 183],840,3,21328,3.6451888566057082,0.0,0.0
25851,2,5851,[204 423 194 483 196],666,1,21329,3.6447368421052633,20.0,0.0
25852,2,5852,[118 588  71 143 568],897,5,21334,3.6449683922774647,0.0,0.0
25853,2,5853,[ 71 597 200 403 228],788,1,21335,3.6445165698667576,0.0,0.0
25854,2,5854,[302 483 100 127 313],13,5,21340,3.644748078565329,20.0,40.0
25855,2,5855,[ 15 508 204 174   8],60,4,21344,3.6448087431693987,0.0,20.0
25856,2,5856,[302 483 100 127 313],474,5,21349,3.6450401229298275,20.0,40.0
25857,2,5857,[302 483 100 127 313],474,5,21354,3.6452714236940937,20.0,40.0
25858,2,5858,[302 483 100 127 313],90,5,21359,3.6455026455026456,20.0,40.0
25859,2,5859,[302 483 100 127 313],334,5,21364,3.6457337883959045,20.0,40.0
25860,2,5860,[302 483 100 127 313],334,5,21369,3.645964852414264,20.0,40.0
25861,2,5861,[302 483 100 127 313],537,5,21374,3.646195837598089,20.0,40.0
25862,2,5862,[ 64 173 168 496 435],194,5,21379,3.6464267439877194,0.0,0.0
25863,2,5863,[258 405 153  69  71],738,3,21382,3.6463165075034105,0.0,0.0
25864,2,5864,[144  11  50   7 238],13,2,21384,3.6460358056265987,0.0,20.0
25865,2,5865,[597 286 186 294 172],7,3,21387,3.6459256733719743,0.0,0.0
25866,2,5866,[302 483 100 127 313],13,5,21392,3.646156468382478,20.0,40.0
25867,2,5867,[276 121 211 357 127],339,4,21396,3.6462167689161555,20.0,20.0
25868,2,5868,[ 69 175 286  97  11],90,3,21399,3.646106662123019,0.0,0.0
25869,2,5869,[195  28 588 204 210],263,2,21401,3.645826235093697,0.0,0.0
25870,2,5870,[222  50 215 216 197],533,5,21406,3.646056889797309,0.0,20.0
25871,2,5871,[121 496  56 187 268],334,3,21409,3.6459468664850134,0.0,0.0
25872,2,5872,[302 483 100 127 313],474,5,21414,3.646177422101141,20.0,40.0
25873,2,5873,[302 483 100 127 313],328,5,21419,3.646407899216888,20.0,40.0
25874,2,5874,[385 174 568 132 183],650,4,21423,3.646468085106383,0.0,20.0
25875,2,5875,[215 111 655 186 275],378,3,21426,3.646358066712049,0.0,0.0
25876,2,5876,[302 483 100 127 313],474,5,21431,3.64658839543985,20.0,40.0
25877,2,5877,[ 96  97 195 168 111],95,5,21436,3.6468186457978904,0.0,0.0
25878,2,5878,[300 427  95  98  25],843,0,21436,3.6461983330498384,0.0,20.0
25879,2,5879,[546 168 515  15 161],290,2,21438,3.6459183673469386,0.0,0.0
25880,2,5880,[423 204  12  64  97],533,4,21442,3.6459785750722666,20.0,0.0
25881,2,5881,[  8 515 323 655 197],881,3,21445,3.6458687521251276,0.0,0.0
25882,2,5882,[215 333 235 288 265],343,2,21447,3.6455889852116266,0.0,0.0
25883,2,5883,[273 258  79 748 195],328,2,21449,3.64530931339225,0.0,0.0
25884,2,5884,[168 405 588 357 195],13,2,21451,3.645029736618522,20.0,0.0
25885,2,5885,[176  88  64 183 197],215,4,21455,3.645090044172613,0.0,0.0
25886,2,5886,[204 210 427 197  69],694,5,21460,3.645320197044335,0.0,0.0
25887,2,5887,[302 483 100 127 313],328,5,21465,3.6455502717391304,20.0,40.0
25888,2,5888,[191  69   1 174 546],804,4,21469,3.645610460179997,0.0,20.0
25889,2,5889,[435  50   9 318   7],474,5,21474,3.645840407470289,20.0,20.0
25890,2,5890,[237   1  15 216  96],533,4,21478,3.645900526226447,0.0,0.0
25891,2,5891,[235 222  82 496  79],313,2,21480,3.645621181262729,0.0,0.0
25892,2,5892,[276  25 678 515   8],474,4,21484,3.645681316816562,0.0,0.0
25893,2,5893,[ 22 202 597  71 357],7,3,21487,3.645571767899559,20.0,0.0
25894,2,5894,[302 483 100 127 313],474,5,21492,3.645801526717557,20.0,40.0
25895,2,5895,[222 200 515  89 597],328,3,21495,3.6456919945725916,0.0,0.0
25896,2,5896,[234 286 151 289  96],788,2,21497,3.6454129218246565,0.0,0.0
25897,2,5897,[ 25 172 185 405 197],95,2,21499,3.645133943709732,0.0,0.0
25898,2,5898,[ 95  28 282  22 228],92,2,21501,3.6448550601796916,0.0,0.0
25899,2,5899,[302 483 100 127 313],334,5,21506,3.645084745762712,20.0,40.0
25900,2,5900,[111 210 289  88  28],454,3,21509,3.6449754278935775,0.0,0.0
25901,2,5901,[173 117  56  11 405],840,3,21512,3.6448661470687904,0.0,0.0
25902,2,5902,[302 483 100 127 313],90,5,21517,3.645095714043707,20.0,40.0
25903,2,5903,[302 483 100 127 313],207,4,21521,3.6451558265582658,20.0,40.0
25904,2,5904,[191  22 385 546 211],194,3,21524,3.645046570702794,0.0,0.0
25905,2,5905,[ 28 181 216 153  69],648,4,21528,3.645106671181849,0.0,0.0
25906,2,5906,[302 483 100 127 313],13,5,21533,3.645336041984087,20.0,40.0
25907,2,5907,[194 180 211 132   8],897,4,21537,3.6453960731211916,0.0,0.0
25908,2,5908,[168 186 161 238 174],774,1,21538,3.6449483838212897,0.0,20.0
25909,2,5909,[302 483 100 127 313],232,3,21541,3.644839255499154,20.0,40.0
25910,2,5910,[302 483 100 127 313],90,5,21546,3.645068516325495,20.0,40.0
25911,2,5911,[515  22 153  70  25],308,4,21550,3.645128552097429,0.0,0.0
25912,2,5912,[100 435  97 183 286],59,4,21554,3.6451885675629967,0.0,20.0
25913,2,5913,[302 483 100 127 313],207,4,21558,3.6452485627324993,20.0,40.0
25914,2,5914,[181 228 161 237 568],95,3,21561,3.6451394759087066,0.0,0.0
25915,2,5915,[179  28 111 357 597],59,4,21565,3.6451994590939822,20.0,0.0
25916,2,5916,[475  50 405 546  88],92,2,21567,3.6449214128781477,0.0,20.0
25917,2,5917,[175   7 496 211 176],379,5,21572,3.6451503886448124,0.0,0.0
25918,2,5918,[357 186 471 265 195],313,4,21576,3.645210339584389,20.0,0.0
25919,2,5919,[ 22 357 258  97 215],271,4,21580,3.64527027027027,20.0,0.0
25920,2,5920,[144  56 153  50   4],643,5,21585,3.6454990711028543,0.0,20.0
25921,2,5921,[302 483 100 127 313],90,5,21590,3.645727794663965,20.0,40.0
25922,2,5922,[302 483 100 127 313],232,3,21593,3.6456187742697956,20.0,40.0
25923,2,5923,[323 276 143 168 144],374,2,21595,3.6453409858203916,0.0,0.0
25924,2,5924,[282 180 196 245 118],92,4,21599,3.6454008438818564,0.0,0.0
25925,2,5925,[173  22 196 202 161],207,2,21601,3.6451231859601756,0.0,0.0
25926,2,5926,[111 173 168 172  22],271,4,21605,3.6451830605702717,0.0,0.0
25927,2,5927,[257 678   1 276  79],339,4,21609,3.645242914979757,0.0,0.0
25928,2,5928,[302 483 100 127 313],537,5,21614,3.645471411705178,20.0,40.0
25929,2,5929,[288 258  12  95   4],378,3,21617,3.645362563237774,20.0,0.0
25930,2,5930,[187   8 385 258 228],64,4,21621,3.6454223571067272,0.0,0.0
25931,2,5931,[197 496 318 143 216],85,4,21625,3.6454821308159135,20.0,0.0
25932,2,5932,[483 210 144 301 357],13,2,21627,3.6452047867857744,40.0,0.0
25933,2,5933,[144  56 196 202 182],666,3,21630,3.6450960566228514,0.0,0.0
25934,2,5934,[258 117 294  50 546],653,2,21632,3.6448188711036225,0.0,20.0
25935,2,5935,[195 182 403 471 385],194,0,21632,3.6442048517520216,0.0,0.0
25936,2,5936,[302 483 100 127 313],13,5,21637,3.6444332154286676,20.0,40.0
25937,2,5937,[302 483 100 127 313],232,3,21640,3.6443246884472886,20.0,40.0
25938,2,5938,[427 176 603 210 121],815,2,21642,3.644047819498232,20.0,0.0
25939,2,5939,[265 151  97 176 423],533,1,21643,3.6436026936026935,0.0,0.0
25940,2,5940,[196 161 186 173 181],85,3,21646,3.64349436121865,0.0,0.0
25941,2,5941,[302 483 100 127 313],537,5,21651,3.643722652305621,20.0,40.0
25942,2,5942,[179 515  97 282 546],666,4,21655,3.6437826013797747,0.0,0.0
25943,2,5943,[294 174 176 195 197],13,2,21657,3.643506056527591,0.0,20.0
25944,2,5944,[181 588  79 125 118],881,4,21661,3.643566021867115,0.0,0.0
25945,2,5945,[111 405 143 168 196],92,2,21663,3.643289606458123,0.0,0.0
25946,2,5946,[228 132 265  82 322],524,4,21667,3.643349588027577,0.0,0.0
25947,2,5947,[302 483 100 127 313],90,5,21672,3.643577673167451,20.0,40.0
25948,2,5948,[405 385 117  96  12],774,0,21672,3.642965204236006,20.0,0.0
25949,2,5949,[301 238  89 215 210],85,3,21675,3.642857142857143,0.0,0.0
25950,2,5950,[ 56 357  88 200 289],271,4,21679,3.642917156780373,20.0,0.0
25951,2,5951,[127  28 515 200  69],328,5,21684,3.6431451612903225,0.0,20.0
25952,2,5952,[161 143 195 405 100],479,2,21686,3.6428691416092724,0.0,20.0
25953,2,5953,[176 174 289 258 204],334,3,21689,3.6427611689620423,0.0,20.0
25954,2,5954,[302 483 100 127 313],334,5,21694,3.6429890848026867,20.0,40.0
25955,2,5955,[228 194 183 174 161],339,4,21698,3.643049026192075,0.0,20.0
25956,2,5956,[302 483 100 127 313],13,5,21703,3.643276817189861,20.0,40.0
25957,2,5957,[655 294  98 153 210],666,3,21706,3.643168848606915,0.0,20.0
25958,2,5958,[302 483 100 127 313],232,3,21709,3.643060916261118,20.0,40.0
25959,2,5959,[318 235 175 258 180],479,4,21713,3.6431208053691275,20.0,0.0
25960,2,5960,[ 12 508 182 143   1],92,4,21717,3.6431806743834927,20.0,0.0
25961,2,5961,[273 181 357   1 265],479,5,21722,3.643408252264341,20.0,0.0
25962,2,5962,[568  25 265 427 748],882,4,21726,3.6434680529934598,0.0,0.0
25963,2,5963,[302 483 100 127  50],334,5,21731,3.6436955063715626,20.0,60.0
25964,2,5964,[  1 216 228 603  15],145,3,21734,3.643587594300084,20.0,0.0
25965,2,5965,[302 483 100 127  50],474,5,21739,3.643814951391217,20.0,60.0
25966,2,5966,[302 483 100 127  50],339,5,21744,3.6440422322775263,20.0,60.0
25967,2,5967,[302 483 100 127  50],232,4,21748,3.6441018766756033,20.0,60.0
25968,2,5968,[  7 180  89 176  88],60,5,21753,3.644329033338918,0.0,0.0
25969,2,5969,[302 483 100 127  50],745,2,21755,3.6440536013400333,20.0,60.0
25970,2,5970,[121  70 211 174  28],479,5,21760,3.6442806900016746,0.0,20.0
25971,2,5971,[183 322 234 182 546],102,1,21761,3.6438379102478233,0.0,0.0
25972,2,5972,[179  89  28 127 183],339,5,21766,3.644064958982086,0.0,20.0
25973,2,5973,[302 483 100 127 313],207,4,21770,3.6441245396719117,20.0,40.0
25974,2,5974,[118 210   9  98 403],184,3,21773,3.6440167364016736,0.0,20.0
25975,2,5975,[245 144 196 195 742],92,4,21777,3.6440763052208833,0.0,0.0
25976,2,5976,[603 435 273 318 286],458,5,21782,3.6443031621214654,40.0,0.0
25977,2,5977,[202 234 357  28 151],215,5,21787,3.644529943124791,20.0,0.0
25978,2,5978,[302 483 100 127 313],474,5,21792,3.6447566482689413,20.0,40.0
25979,2,5979,[588 508 228 176   7],537,2,21794,3.6444816053511704,0.0,0.0
25980,2,5980,[143 161  12 357 117],643,3,21797,3.6443738505266676,40.0,0.0
25981,2,5981,[302 483 100 127 313],474,5,21802,3.6446004680708795,20.0,40.0
25982,2,5982,[423 183 200 191 174],313,4,21806,3.6446598696306203,0.0,20.0
25983,2,5983,[423 257  69 100 234],374,3,21809,3.644552139037433,0.0,20.0
25984,2,5984,[483 300  56 742 328],328,5,21814,3.644778613199666,20.0,0.0
25985,2,5985,[302 483 100 127 313],90,5,21819,3.6450050116939527,20.0,40.0
25986,2,5986,[204 238 173  28  64],899,3,21822,3.6448972774344415,0.0,0.0
25987,2,5987,[273 678  95 258 276],92,3,21825,3.6447895791583167,0.0,0.0
25988,2,5988,[313 508 678 132  95],537,2,21827,3.6445149440641176,0.0,0.0
25989,2,5989,[237 111 515 357 289],271,5,21832,3.6447412353923205,20.0,0.0
25990,2,5990,[302 483 100 127 313],537,5,21837,3.644967451176765,20.0,40.0
25991,2,5991,[603 471 211  82 180],13,3,21840,3.6448598130841123,20.0,0.0
25992,2,5992,[191 435  56  22 196],144,5,21845,3.645085933589187,0.0,0.0
25993,2,5993,[ 96 300 228 235 118],313,3,21848,3.6449783116449783,0.0,0.0
25994,2,5994,[302 483 100 127 313],232,3,21851,3.6448707256046706,20.0,40.0
25995,2,5995,[ 96 403 204 144  89],650,3,21854,3.6447631754503003,0.0,0.0
25996,2,5996,[210   8 175  98 238],334,4,21858,3.644822411205603,0.0,20.0
25997,2,5997,[435 183 117 216 546],308,2,21860,3.644548182727576,0.0,0.0
25998,2,5998,[ 56 194 179 237 127],207,5,21865,3.6447741290215037,0.0,20.0
25999,2,5999,[597 185 318 186 294],374,3,21868,3.6446666666666667,20.0,0.0
26000,2,6000,[403  22 144  70 127],234,2,21870,3.644392601233128,0.0,20.0
26001,2,6001,[228 121 127  69 427],537,2,21872,3.644118627124292,0.0,20.0
26002,2,6002,[ 95 655 195  88 294],479,4,21876,3.6441779110444776,0.0,0.0
26003,2,6003,[175 176 235 301 216],334,1,21877,3.6437375083277814,0.0,0.0
26004,2,6004,[508 127 603   4 144],326,2,21879,3.643463780183181,20.0,20.0
26005,2,6005,[286 427 435 179 235],343,5,21884,3.6436896436896435,0.0,0.0
26006,2,6006,[ 15 546  89 161 322],749,3,21887,3.643582487098385,0.0,0.0
26007,2,6007,[204 238 273  22  82],207,1,21888,3.6431424766977365,0.0,0.0
26008,2,6008,[288 323  70 471 568],455,2,21890,3.6428690297886503,0.0,0.0
26009,2,6009,[238 603   9  82 294],308,4,21894,3.642928452579035,20.0,0.0
26010,2,6010,[269 204 483 228 597],650,4,21898,3.6429878555980704,20.0,0.0
26011,2,6011,[357 194  64 300 588],311,5,21903,3.6432135728542914,20.0,0.0
26012,2,6012,[475 180 173  88 172],92,3,21906,3.64310660236155,0.0,0.0
26013,2,6013,[195 175 273 144 151],479,5,21911,3.6433322248087796,0.0,0.0
26014,2,6014,[222   9 183 144 195],788,3,21914,3.6432252701579384,0.0,0.0
26015,2,6015,[211  96 403 678 294],804,4,21918,3.643284574468085,0.0,0.0
26016,2,6016,[238   9 258  88 405],474,5,21923,3.643510054844607,0.0,0.0
26017,2,6017,[172 191   4  79  97],524,4,21927,3.643569292123629,0.0,0.0
26018,2,6018,[273  79  64   9  50],59,4,21931,3.6436285097192225,0.0,20.0
26019,2,6019,[179  64 294 173 238],234,1,21932,3.643189368770764,0.0,0.0
26020,2,6020,[385  97   8 202 216],87,5,21937,3.643414715163594,0.0,0.0
26021,2,6021,[185 210 195 197  64],215,5,21942,3.643639986715377,0.0,0.0
26022,2,6022,[302 483 100 127 313],537,5,21947,3.64386518346339,20.0,40.0
26023,2,6023,[135 191 257 200 179],308,5,21952,3.644090305444887,0.0,0.0
26024,2,6024,[197 216  98 423  69],778,2,21954,3.6438174273858923,0.0,20.0
26025,2,6025,[603  50 161 180  82],7,3,21957,3.6437105874543643,20.0,20.0
26026,2,6026,[  9 172 215  97  96],234,0,21957,3.643106022896964,0.0,0.0
26027,2,6027,[ 98 588 182 100  69],194,4,21961,3.6431652289316525,0.0,40.0
26028,2,6028,[ 95 328 323  50  64],537,1,21962,3.64272682036822,0.0,20.0
26029,2,6029,[483 173 127  70  28],85,4,21966,3.6427860696517413,20.0,20.0
26030,2,6030,[ 28 496 144 168 742],298,4,21970,3.6428452992870173,0.0,0.0
26031,2,6031,[302 483 100 127 313],328,5,21975,3.6430702917771884,20.0,40.0
26032,2,6032,[302 483 100 127 313],207,4,21979,3.6431294546660036,20.0,40.0
26033,2,6033,[302 483 100 127 313],328,5,21984,3.6433543254888963,20.0,40.0
26034,2,6034,[289   8 265 568 181],387,3,21987,3.643247721623861,0.0,0.0
26035,2,6035,[197 222 211 588  98],537,2,21989,3.6429754804506294,0.0,20.0
26036,2,6036,[186 435 265 135  15],378,3,21992,3.6428689746562863,0.0,0.0
26037,2,6037,[ 71 742 237  70 118],328,4,21996,3.642928121894667,0.0,0.0
26038,2,6038,[  1 302 588 144 173],454,2,21998,3.642656068885577,0.0,0.0
26039,2,6039,[313  50 515  96   1],308,3,22001,3.6425496688741723,0.0,20.0
26040,2,6040,[  1 496 195  28  98],298,5,22006,3.6427743751034596,0.0,20.0
26041,2,6041,[182 202 144 357  25],13,3,22009,3.642667990731546,20.0,0.0
26042,2,6042,[302 483 100 127  50],666,4,22013,3.6427271222902533,20.0,60.0
26043,2,6043,[  1 210 496 546 405],378,2,22015,3.6424553275976175,0.0,0.0
26044,2,6044,[302 483 100 127 313],207,4,22019,3.6425144747725393,20.0,40.0
26045,2,6045,[127 294 385 175 180],881,3,22022,3.6424082037710885,0.0,20.0
26046,2,6046,[235  50 258 471   1],779,5,22027,3.6426327104349263,0.0,20.0
26047,2,6047,[183 100 185 118  98],380,4,22031,3.642691798941799,0.0,40.0
26048,2,6048,[302 483 100 127 313],90,5,22036,3.6429161844933047,20.0,40.0
26049,2,6049,[302 483 100 127 313],90,5,22041,3.6431404958677684,20.0,40.0
26050,2,6050,[ 69 180 185 655 179],527,3,22044,3.643034209221616,0.0,0.0
26051,2,6051,[515 235  71 175  97],524,2,22046,3.6427627230667547,0.0,0.0
26052,2,6052,[357 153  82 333 269],263,3,22049,3.6426565339501074,20.0,0.0
26053,2,6053,[132 235 275   8  71],378,5,22054,3.642880740006607,0.0,0.0
26054,2,6054,[471 228 204 318  82],13,2,22056,3.6426094137076794,20.0,0.0
26055,2,6055,[ 56 228 135 286 568],881,2,22058,3.642338177014531,0.0,0.0
26056,2,6056,[176  71 143 179 121],694,5,22063,3.642562324583127,0.0,0.0
26057,2,6057,[302 483 100 127 313],13,5,22068,3.642786398151205,20.0,40.0
26058,2,6058,[603 153  50  69 187],64,3,22071,3.6426803102822247,20.0,20.0
26059,2,6059,[ 79 172  22 211 515],234,2,22073,3.6424092409240925,0.0,0.0
26060,2,6060,[302 483 100 127 313],207,4,22077,3.6424682395644283,20.0,40.0
26061,2,6061,[288 174 357 196 183],479,4,22081,3.6425272187396898,20.0,20.0
26062,2,6062,[302 483 100 127 313],13,5,22086,3.6427511133102426,20.0,40.0
26063,2,6063,[405 245 282  95   9],334,2,22088,3.642480211081794,0.0,0.0
26064,2,6064,[302 483 100 127 313],334,5,22093,3.642704039571311,20.0,40.0
26065,2,6065,[423 508  98 196   1],653,1,22094,3.6422683811407848,0.0,20.0
26066,2,6066,[121  50 286 202  82],233,3,22097,3.6421625185429374,0.0,20.0
26067,2,6067,[125 181 182 191 127],334,3,22100,3.6420566908371788,0.0,20.0
26068,2,6068,[186 153 176 172 234],312,3,22103,3.6419508980062614,0.0,0.0
26069,2,6069,[302 483 100 127 313],474,5,22108,3.642174629324547,20.0,40.0
26070,2,6070,[181 194 268  50 237],7,3,22111,3.642068851918959,0.0,20.0
26071,2,6071,[  1 265  12 153   4],92,5,22116,3.642292490118577,20.0,0.0
26072,2,6072,[183 143 127 187 132],311,4,22120,3.6423513914045778,0.0,20.0
26073,2,6073,[204 173 211 176 161],7,3,22123,3.6422456371419165,0.0,0.0
26074,2,6074,[191 357 568 174 427],940,4,22127,3.6423045267489713,20.0,20.0
26075,2,6075,[ 28 238 302 118 161],13,4,22131,3.642363396971692,0.0,0.0
26076,2,6076,[ 95  50  82 118 186],524,3,22134,3.642257692940596,0.0,20.0
26077,2,6077,[742 275 496 196  71],308,3,22137,3.6421520236920037,0.0,0.0
26078,2,6078,[195 179 216 210 211],474,5,22142,3.642375390689258,0.0,0.0
26079,2,6079,[143 403  56 197 216],378,4,22146,3.6424342105263157,0.0,0.0
26080,2,6080,[322  64 174 385 204],788,2,22148,3.6421641177437922,0.0,20.0
26081,2,6081,[235  25 200 121 127],308,3,22151,3.6420585333771784,0.0,20.0
26082,2,6082,[144   8 174  79   7],795,4,22155,3.6421173762945913,0.0,20.0
26083,2,6083,[161  82 258 174  88],378,5,22160,3.6423405654174883,0.0,20.0
26084,2,6084,[ 28  79 515  98 196],882,5,22165,3.6425636811832374,0.0,20.0
26085,2,6085,[302 483 100 127 313],13,5,22170,3.6427867236279985,20.0,40.0
26086,2,6086,[302 483 100 127 313],537,5,22175,3.6430096927879085,20.0,40.0
26087,2,6087,[302 483 100 127 313],90,5,22180,3.64323258869908,20.0,40.0
26088,2,6088,[ 79 245 174 127 228],488,4,22184,3.6432911808178683,0.0,40.0
26089,2,6089,[222 301 483 286 288],13,1,22185,3.642857142857143,20.0,0.0
26090,2,6090,[238 471 748 475  22],92,3,22188,3.6427516007223772,0.0,0.0
26091,2,6091,[ 22  69 515 179   1],92,4,22192,3.6428102429415627,0.0,0.0
26092,2,6092,[ 11 185 603  12 204],454,2,22194,3.642540620384047,40.0,0.0
26093,2,6093,[181   4  15 435  69],271,4,22198,3.642599277978339,0.0,0.0
26094,2,6094,[ 69   7 100  98 135],524,2,22200,3.642329778506973,0.0,40.0
26095,2,6095,[302 483 100 127 313],90,5,22205,3.64255249343832,20.0,40.0
26096,2,6096,[ 22 234 435  89 121],447,5,22210,3.6427751353124487,0.0,0.0
26097,2,6097,[181 237 211  64 194],215,5,22215,3.6429977041653,0.0,0.0
26098,2,6098,[200 496 271 216   1],749,5,22220,3.6432202000327925,0.0,0.0
26099,2,6099,[294  79  82  11 121],158,4,22224,3.6432786885245902,0.0,0.0
26100,2,6100,[302 483 100 127 313],90,5,22229,3.643501065399115,20.0,40.0
26101,2,6101,[ 64 187 655 215  11],749,4,22233,3.6435594886922322,0.0,0.0
26102,2,6102,[302 483 100 127 313],232,3,22236,3.6434540389972145,20.0,40.0
26103,2,6103,[ 89   7 181 168  97],840,3,22239,3.643348623853211,0.0,0.0
26104,2,6104,[302 483 100 127 313],334,5,22244,3.6435708435708434,20.0,40.0
26105,2,6105,[117 269 179  96 328],13,1,22245,3.643137897150344,0.0,0.0
26106,2,6106,[302 483 100 127 313],474,5,22250,3.64336007859833,20.0,40.0
26107,2,6107,[302 483 100 127 313],334,5,22255,3.64358218729535,20.0,40.0
26108,2,6108,[ 89 153 215 288 174],144,3,22258,3.6434768374529383,0.0,20.0
26109,2,6109,[191 176 179 302 405],378,3,22261,3.6433715220949265,0.0,0.0
26110,2,6110,[302 483 100 127 313],334,5,22266,3.6435935198821796,20.0,40.0
26111,2,6111,[597  69 161 568 403],59,3,22269,3.643488219895288,0.0,0.0
26112,2,6112,[294 173  88  64  98],145,5,22274,3.6437101259610665,0.0,20.0
26113,2,6113,[302 483 100 127 313],90,5,22279,3.643931959437357,20.0,40.0
26114,2,6114,[302 483 100 127 313],232,3,22282,3.6438266557645136,20.0,40.0
26115,2,6115,[161 144 143  71 234],92,3,22285,3.643721386527142,0.0,0.0
26116,2,6116,[302 483 100 127 313],474,5,22290,3.643943109367337,20.0,40.0
26117,2,6117,[302 483 100 127 313],13,5,22295,3.6441647597254003,20.0,40.0
26118,2,6118,[161 318 151 118 222],374,3,22298,3.6440594868442555,20.0,0.0
26119,2,6119,[ 64 435  70  69 269],378,4,22302,3.6441176470588235,0.0,0.0
26120,2,6120,[300 204   4 301 151],378,2,22304,3.6438490442738116,0.0,0.0
26121,2,6121,[302 483 100 127 313],328,5,22309,3.6440705651747796,20.0,40.0
26122,2,6122,[237 176 144 385 204],455,1,22310,3.6436387391801404,0.0,0.0
26123,2,6123,[269 742   4 215 423],650,1,22311,3.6432070542129327,0.0,0.0
26124,2,6124,[222   7 403 127 286],650,2,22313,3.642938775510204,0.0,20.0
26125,2,6125,[183 276 234 423 357],59,5,22318,3.643160300359125,20.0,0.0
26126,2,6126,[ 82 423 143 403   8],64,4,22322,3.643218540884609,0.0,0.0
26127,2,6127,[302 483 100 127 313],207,4,22326,3.6432767624020888,20.0,40.0
26128,2,6128,[ 95 196 161 302 185],380,4,22330,3.643334964920868,0.0,0.0
26129,2,6129,[194  70 132 183 655],13,4,22334,3.6433931484502446,0.0,0.0
26130,2,6130,[427 238 234 168  96],527,5,22339,3.643614418528788,0.0,0.0
26131,2,6131,[179 289 603 475 210],13,1,22340,3.6431833007175474,20.0,0.0
26132,2,6132,[234  50  79 173 117],194,1,22341,3.6427523234958423,0.0,20.0
26133,2,6133,[182   1 423  22   7],64,5,22346,3.642973589827193,0.0,0.0
26134,2,6134,[194 546 174 168 603],82,4,22350,3.643031784841076,20.0,20.0
26135,2,6135,[187  98  89 176 216],650,4,22354,3.643089960886571,0.0,20.0
26136,2,6136,[200 174 216  96 313],537,1,22355,3.6426592797783934,0.0,20.0
26137,2,6137,[323 151 181 121 289],881,2,22357,3.642391658520691,0.0,0.0
26138,2,6138,[302 483 100 127 313],13,5,22362,3.642612803388174,20.0,40.0
26139,2,6139,[135 258  98  56 176],533,2,22364,3.6423452768729643,0.0,20.0
26140,2,6140,[302 483 100 127 313],328,5,22369,3.6425663572708027,20.0,40.0
26141,2,6141,[302 483 100 127 313],90,5,22374,3.642787365678932,20.0,40.0
26142,2,6142,[405 202  95 173 282],479,5,22379,3.6430083021325084,0.0,0.0
26143,2,6143,[ 50 143  96  95   1],42,5,22384,3.6432291666666665,0.0,20.0
26144,2,6144,[ 28  15 235 182 471],374,3,22387,3.6431244914564687,0.0,0.0
26145,2,6145,[168  71 215 196  15],194,3,22390,3.643019850309144,0.0,0.0
26146,2,6146,[302 483 100 127 313],90,5,22395,3.643240605173255,20.0,40.0
26147,2,6147,[ 64  28 200 179 135],537,2,22397,3.6429733246584255,0.0,0.0
26148,2,6148,[144 153 183  95 174],102,3,22400,3.642868759147829,0.0,20.0
26149,2,6149,[153  22 204 318 180],234,2,22402,3.64260162601626,20.0,0.0
26150,2,6150,[276 176 125 235  82],378,4,22406,3.642659730125183,0.0,0.0
26151,2,6151,[234 496 197  89 228],537,3,22409,3.642555266579974,0.0,0.0
26152,2,6152,[ 25 117 100 245 222],533,4,22413,3.642613359336909,0.0,20.0
26153,2,6153,[127 275 234 118 174],343,3,22416,3.642508937276568,0.0,40.0
26154,2,6154,[257 127  28  97 471],474,3,22419,3.642404549147035,0.0,20.0
26155,2,6155,[197 168 258 385  69],537,3,22422,3.642300194931774,0.0,0.0
26156,2,6156,[ 89 117 403  56 194],648,3,22425,3.64219587461426,0.0,0.0
26157,2,6157,[ 15  50 276 678 275],82,2,22427,3.641929197791491,0.0,20.0
26158,2,6158,[265 175  22 257 180],804,5,22432,3.6421496996265628,0.0,0.0
26159,2,6159,[302 483 100 127 313],537,5,22437,3.64237012987013,20.0,40.0
26160,2,6160,[210 200 135 132 143],749,5,22442,3.6425904885570524,0.0,0.0
26161,2,6161,[ 97 435 655  69 143],804,3,22445,3.642486205777345,0.0,0.0
26162,2,6162,[302 483 100 127 313],474,5,22450,3.642706474119747,20.0,40.0
26163,2,6163,[302 483 100 127 313],329,5,22455,3.642926670992862,20.0,40.0
26164,2,6164,[302 483 100 127 313],474,5,22460,3.643146796431468,20.0,40.0
26165,2,6165,[302 483 100 127 313],90,5,22465,3.643366850470321,20.0,40.0
26166,2,6166,[588 127  69 222  22],650,1,22466,3.6429382195557,0.0,20.0
26167,2,6167,[655 161 234 276 235],92,3,22469,3.642833981841764,0.0,0.0
26168,2,6168,[286 182 276 202 234],288,5,22474,3.6430539795752956,0.0,0.0
26169,2,6169,[245 180 168 655 265],313,3,22477,3.6429497568881684,0.0,0.0
26170,2,6170,[204 127  69 333 180],653,5,22482,3.643169664560039,0.0,20.0
26171,2,6171,[302 483 100 127 313],537,5,22487,3.643389500972132,20.0,40.0
26172,2,6172,[403 100 161  89 173],334,4,22491,3.64344727037097,0.0,20.0
26173,2,6173,[127 183 197 185 118],653,1,22492,3.6430191124068676,0.0,20.0
26174,2,6174,[ 15 118 300 318  89],454,3,22495,3.642914979757085,20.0,0.0
26175,2,6175,[318 483 294 191  64],406,4,22499,3.6429727979274613,40.0,0.0
26176,2,6176,[483 132 195 275 423],533,5,22504,3.643192488262911,20.0,0.0
26177,2,6177,[200 118 180  71   1],92,3,22507,3.643088378115895,0.0,0.0
26178,2,6178,[318  56 423   4  69],7,5,22512,3.64330797863732,20.0,0.0
26179,2,6179,[ 98 143 258 286 176],59,2,22514,3.643042071197411,0.0,20.0
26180,2,6180,[302 483 100 127 313],537,5,22519,3.6432616081540203,20.0,40.0
26181,2,6181,[238 215 197 568 211],13,3,22522,3.6431575541895826,0.0,0.0
26182,2,6182,[546   7 121  25 216],308,2,22524,3.6428918000970403,0.0,0.0
26183,2,6183,[ 25 237 603 289  28],474,4,22528,3.642949547218629,20.0,0.0
26184,2,6184,[423 216 185 183  82],328,4,22532,3.6430072756669363,0.0,0.0
26185,2,6185,[302 483 100 127 313],328,5,22537,3.6432266408018106,20.0,40.0
26186,2,6186,[302 483 100 127 313],474,5,22542,3.6434459350250523,20.0,40.0
26187,2,6187,[302 483 100 127 313],207,4,22546,3.643503555268261,20.0,40.0
26188,2,6188,[302 483 100 127 313],474,5,22551,3.643722733882695,20.0,40.0
26189,2,6189,[237 168  70 185 597],95,2,22553,3.6434571890145397,0.0,0.0
26190,2,6190,[195 423 135 385 603],7,5,22558,3.643676304312712,20.0,0.0
26191,2,6191,[191 151 222  64 194],537,1,22559,3.643249354005168,0.0,0.0
26192,2,6192,[144  89 423  28 475],339,3,22562,3.6431454868399804,0.0,0.0
26193,2,6193,[ 98 100 435 515 204],380,3,22565,3.6430416532127867,0.0,40.0
26194,2,6194,[275 475 173  15  22],648,3,22568,3.6429378531073446,0.0,0.0
26195,2,6195,[ 71 194  70 117 222],474,5,22573,3.643156875403486,0.0,0.0
26196,2,6196,[100 151 176 168 265],653,2,22575,3.642891721800871,0.0,20.0
26197,2,6197,[ 96 678 483 265 117],308,1,22576,3.642465311390771,20.0,0.0
26198,2,6198,[168 288  22 100  15],452,4,22580,3.6425229875786416,0.0,20.0
26199,2,6199,[176 117 357 322  64],313,4,22584,3.6425806451612903,20.0,0.0
26200,2,6200,[302 483 100 127 313],207,4,22588,3.642638284147718,20.0,40.0
26201,2,6201,[111 132  97 385 179],666,3,22591,3.6425346662366977,0.0,0.0
26202,2,6202,[302 483 100 127 313],328,5,22596,3.6427535063678866,20.0,40.0
26203,2,6203,[302 483 100 127 313],232,3,22599,3.642649903288201,20.0,40.0
26204,2,6204,[302 483 100 127 313],329,5,22604,3.6428686543110396,20.0,40.0
26205,2,6205,[ 22 187 258 235 655],537,2,22606,3.6426039316790204,0.0,0.0
26206,2,6206,[228 111  50 182 100],653,3,22609,3.642500402771065,0.0,40.0
26207,2,6207,[302 483 100 127 313],334,5,22614,3.6427190721649483,20.0,40.0
26208,2,6208,[302 483 100 127 313],329,5,22619,3.642937671122564,20.0,40.0
26209,2,6209,[302 483 100 127 313],334,5,22624,3.643156199677939,20.0,40.0
26210,2,6210,[ 50 125 183 237 173],234,2,22626,3.6428916438576717,0.0,20.0
26211,2,6211,[496 216 196 172   1],184,5,22631,3.6431101094655505,0.0,0.0
26212,2,6212,[655  50 228 275 483],406,2,22633,3.642845646225656,20.0,20.0
26213,2,6213,[265 603  88 202 173],537,2,22635,3.642581268104281,20.0,0.0
26214,2,6214,[ 79 196 234 168 216],738,2,22637,3.642316975060338,0.0,0.0
26215,2,6215,[276 216 288 179 265],92,3,22640,3.642213642213642,0.0,0.0
26216,2,6216,[187  50 289 173  64],387,3,22643,3.6421103426089756,0.0,20.0
26217,2,6217,[302 483 100 127 313],474,5,22648,3.6423287230620778,20.0,40.0
26218,2,6218,[302 483 100 127 313],329,5,22653,3.642547033285094,20.0,40.0
26219,2,6219,[546 176 475 118 237],548,5,22658,3.642765273311897,0.0,0.0
26220,2,6220,[302 483 100 127 313],474,5,22663,3.6429834431763384,20.0,40.0
26221,2,6221,[ 50 222 228 603 176],648,5,22668,3.643201542912247,20.0,20.0
26222,2,6222,[302 483 100 127 313],13,5,22673,3.6434195725534306,20.0,40.0
26223,2,6223,[302 483 100 127 313],329,5,22678,3.6436375321336762,20.0,40.0
26224,2,6224,[ 82 168 197 475  56],537,4,22682,3.643694779116466,0.0,0.0
26225,2,6225,[302 483 100 127 313],329,5,22687,3.6439126244779954,20.0,40.0
26226,2,6226,[181 265 173   9 194],194,4,22691,3.64396980889674,0.0,0.0
26227,2,6227,[678  98 216 471  70],537,1,22692,3.6435452793834298,0.0,20.0
26228,2,6228,[ 15  22 289 179 257],271,4,22696,3.643602504414834,0.0,0.0
26229,2,6229,[597   8 200 423 172],13,3,22699,3.643499197431782,0.0,0.0
26230,2,6230,[385 151 100 181 183],833,3,22702,3.6433959236077675,0.0,20.0
26231,2,6231,[286 186  82  12 144],13,3,22705,3.643292682926829,20.0,0.0
26232,2,6232,[191   1 111 471 211],699,0,22705,3.642708166212097,0.0,0.0
26233,2,6233,[427 318 234 143 180],537,3,22708,3.64260506897658,20.0,0.0
26234,2,6234,[ 11 132 135 176   4],788,2,22710,3.6423416198877305,0.0,0.0
26235,2,6235,[187 183 174 153  82],788,2,22712,3.6420782552918536,0.0,20.0
26236,2,6236,[302 483 100 127 313],90,5,22717,3.642295975629309,20.0,40.0
26237,2,6237,[302 483 100 127 313],334,5,22722,3.6425136261622315,20.0,40.0
26238,2,6238,[302 483 100 127 313],90,5,22727,3.6427312069241866,20.0,40.0
26239,2,6239,[435  98 294   9 471],6,3,22730,3.6426282051282053,0.0,20.0
26240,2,6240,[302 483 100 127 313],537,5,22735,3.642845697804839,20.0,40.0
26241,2,6241,[496  22 117 172 195],538,4,22739,3.642902915732137,0.0,0.0
26242,2,6242,[135  95 194 216 385],650,4,22743,3.642960115329169,0.0,0.0
26243,2,6243,[204 603 210 180  22],409,4,22747,3.6430172966047407,20.0,0.0
26244,2,6244,[153 215  15  98  71],194,3,22750,3.642914331465172,0.0,20.0
26245,2,6245,[ 64 568 286 175 135],13,3,22753,3.642811399295549,0.0,0.0
26246,2,6246,[ 95 161 185 405  79],479,4,22757,3.64286857691692,0.0,0.0
26247,2,6247,[302 483 100 127 313],329,5,22762,3.6430857874519846,20.0,40.0
26248,2,6248,[302 483 100 127 313],474,5,22767,3.643302928468555,20.0,40.0
26249,2,6249,[185  11 179 111 197],271,4,22771,3.64336,0.0,0.0
26250,2,6250,[ 96 238 172  79 181],13,3,22774,3.6432570788673813,0.0,0.0
26251,2,6251,[302 483 100 127 313],13,5,22779,3.6434740882917467,20.0,40.0
26252,2,6252,[127 144 215 235 143],643,4,22783,3.6435311050695667,0.0,20.0
26253,2,6253,[215 173  71  89 357],454,1,22784,3.643108410617205,20.0,0.0
26254,2,6254,[125 121  98 269  25],25,5,22789,3.6433253397282175,0.0,20.0
26255,2,6255,[302 483 100 127 313],329,5,22794,3.643542199488491,20.0,40.0
26256,2,6256,[210 181 135  95 132],263,4,22798,3.6435991689307974,0.0,0.0
26257,2,6257,[313 182   1 143   7],650,3,22801,3.6434963247043783,0.0,0.0
26258,2,6258,[475 597 357  28   8],207,2,22803,3.6432337434094904,20.0,0.0
26259,2,6259,[143 100 323  96  28],881,3,22806,3.6431309904153353,0.0,20.0
26260,2,6260,[194 357 181  64 204],774,0,22806,3.642549113560134,20.0,0.0
26261,2,6261,[427 508 185 132 742],59,4,22810,3.6426061961034812,0.0,0.0
26262,2,6262,[302 483 100 127 313],537,5,22815,3.642822928309117,20.0,40.0
26263,2,6263,[323 204 235  97 135],788,0,22815,3.6422413793103448,0.0,0.0
26264,2,6264,[ 15 385 268  89 483],537,3,22818,3.6421388667198724,20.0,0.0
26265,2,6265,[151 168 234 194 186],60,5,22823,3.642355569741462,0.0,0.0
26266,2,6266,[302 483 100 127 313],90,5,22828,3.642572203606191,20.0,40.0
26267,2,6267,[172 186  82  69 168],97,4,22832,3.642629227823867,0.0,0.0
26268,2,6268,[ 71 204 118 173 275],7,4,22836,3.6426862338490986,0.0,0.0
26269,2,6269,[276  28 427 515 117],6,2,22838,3.6424242424242426,0.0,0.0
26270,2,6270,[286 289 265   8 237],474,4,22842,3.6424812629564665,0.0,0.0
26271,2,6271,[302 483 100 127 313],207,4,22846,3.6425382653061225,20.0,40.0
26272,2,6272,[483 385 318 183   4],308,4,22850,3.6425952494819067,40.0,0.0
26273,2,6273,[173 197 143 117 515],95,5,22855,3.6428116034427798,0.0,0.0
26274,2,6274,[302 483 100 127 313],328,5,22860,3.6430278884462153,20.0,40.0
26275,2,6275,[ 12 175 153 655 187],527,3,22863,3.642925430210325,20.0,0.0
26276,2,6276,[161  95 195 135 168],804,3,22866,3.6428230046200416,0.0,0.0
26277,2,6277,[ 88 210  98 202 181],379,5,22871,3.643039184453648,0.0,20.0
26278,2,6278,[405 187   4 194 173],271,4,22875,3.6430960344003824,0.0,0.0
26279,2,6279,[269 168 237 273 357],13,2,22877,3.6428343949044586,20.0,0.0
26280,2,6280,[302 483 100 127 313],207,4,22881,3.6428912593536062,20.0,40.0
26281,2,6281,[302 483 100 127 313],537,5,22886,3.6431072906717605,20.0,40.0
26282,2,6282,[  7 568 127  25 435],892,5,22891,3.6433232532229827,0.0,20.0
26283,2,6283,[265 403 357  79   4],387,3,22894,3.6432208784213875,20.0,0.0
26284,2,6284,[302 483 100 127 313],328,5,22899,3.643436754176611,20.0,40.0
26285,2,6285,[403   4 603 180 135],387,3,22902,3.6433343938911866,20.0,0.0
26286,2,6286,[603 100 172 238  82],694,4,22906,3.643391124542707,20.0,20.0
26287,2,6287,[302 483 100 127 313],90,5,22911,3.6436068702290076,20.0,40.0
26288,2,6288,[257 234 271 603 222],749,3,22914,3.6435045317220545,20.0,0.0
26289,2,6289,[ 71 174   4  50 234],455,3,22917,3.643402225755167,0.0,40.0
26290,2,6290,[655   7 273  71 588],378,5,22922,3.6436178667938326,0.0,0.0
26291,2,6291,[ 70 176 268  22 111],234,1,22923,3.6431977113795297,0.0,0.0
26292,2,6292,[302 483 100 127 313],13,5,22928,3.643413316383283,20.0,40.0
26293,2,6293,[200 655 385 568 175],387,2,22930,3.6431522084524945,0.0,0.0
26294,2,6294,[ 25 237 185 194 173],59,3,22933,3.643050039714059,0.0,0.0
26295,2,6295,[234 172 588 173   4],234,2,22935,3.642789072426938,0.0,0.0
26296,2,6296,[234 275  97  28  96],378,5,22940,3.6430046053676355,0.0,0.0
26297,2,6297,[302 483 100 127 313],334,5,22945,3.6432200698634487,20.0,40.0
26298,2,6298,[153 216 191  70 144],194,2,22947,3.6429591998729958,0.0,0.0
26299,2,6299,[257 118 144 546 403],479,2,22949,3.6426984126984125,0.0,0.0
26300,2,6300,[313 117 111  28 144],378,3,22952,3.6425964132677353,0.0,0.0
26301,2,6301,[194 403  56 238  70],234,1,22953,3.6421770866391623,0.0,0.0
26302,2,6302,[176 435 127 161 655],339,4,22957,3.642233856893543,0.0,20.0
26303,2,6303,[173 186 269 204   9],6,4,22961,3.642290609137056,0.0,0.0
26304,2,6304,[403 238  89   1 742],795,2,22963,3.64203013481364,0.0,0.0
26305,2,6305,[302 483 100 127 313],474,5,22968,3.642245480494767,20.0,40.0
26306,2,6306,[  8 265 423  11 183],334,4,22972,3.642302203900428,0.0,0.0
26307,2,6307,[143 588 273  15 742],308,3,22975,3.6422003804692453,0.0,0.0
26308,2,6308,[181 161 357 180 172],659,2,22977,3.641940085592011,20.0,0.0
26309,2,6309,[302 483 100 127 313],90,5,22982,3.6421553090332806,20.0,40.0
26310,2,6310,[132 655 187 222 265],328,4,22986,3.6422120107748377,0.0,0.0
26311,2,6311,[182 328 222 125 271],749,3,22989,3.642110266159696,0.0,0.0
26312,2,6312,[ 79 258 435 748 655],899,4,22993,3.6421669570727073,0.0,0.0
26313,2,6313,[568 427  56 135 180],308,5,22998,3.642382008235667,0.0,0.0
26314,2,6314,[302 483 100 127 313],334,5,23003,3.642596991290578,20.0,40.0
26315,2,6315,[302 483 100 127 313],474,5,23008,3.642811906269791,20.0,40.0
26316,2,6316,[302 483 100 127 313],232,3,23011,3.6427101472217824,20.0,40.0
26317,2,6317,[197 117 286 200 237],378,2,23013,3.6424501424501425,0.0,0.0
26318,2,6318,[655  82  56 483 385],659,5,23018,3.6426649786358603,20.0,0.0
26319,2,6319,[302 483 100 127 313],328,5,23023,3.642879746835443,20.0,40.0
26320,2,6320,[302 483 100 127 313],334,5,23028,3.643094447081158,20.0,40.0
26321,2,6321,[ 28  69  96   1 197],378,3,23031,3.6429927238215756,0.0,0.0
26322,2,6322,[302 483 100 127 313],474,5,23036,3.643207338288787,20.0,40.0
26323,2,6323,[ 97 273 294 385 318],537,1,23037,3.6427893738140416,20.0,0.0
26324,2,6324,[216 118 204 597 508],83,2,23039,3.642529644268775,0.0,0.0
26325,2,6325,[302 483 100 127 313],207,4,23043,3.6425861523869743,20.0,40.0
26326,2,6326,[ 11 300 216 100 191],749,4,23047,3.6426426426426426,0.0,20.0
26327,2,6327,[237 135  15 216  56],194,2,23049,3.642383059418458,0.0,0.0
26328,2,6328,[568 121 161   4 228],533,4,23053,3.6424395639121503,0.0,0.0
26329,2,6329,[268 318 153  12 483],6,4,23057,3.6424960505529227,60.0,0.0
26330,2,6330,[194  12 197 276 135],474,5,23062,3.6427104722792607,20.0,0.0
26331,2,6331,[288 405 294 143  96],479,2,23064,3.6424510423247,0.0,0.0
26332,2,6332,[302 483 100 127 313],90,5,23069,3.6426654034422863,20.0,40.0
26333,2,6333,[  4 180 471 176 172],144,5,23074,3.6428796968740134,0.0,0.0
26334,2,6334,[182 215 196 118 496],479,2,23076,3.642620363062352,0.0,0.0
26335,2,6335,[127 168 179 172 423],7,5,23081,3.642834595959596,0.0,20.0
26336,2,6336,[302 483 100 127 313],207,4,23085,3.6428909578664985,20.0,40.0
26337,2,6337,[597 265 323 196 471],83,3,23088,3.6427895235089935,0.0,0.0
26338,2,6338,[302 483 100 127 313],329,5,23093,3.6430036283325444,20.0,40.0
26339,2,6339,[288  97 182 742 176],387,1,23094,3.6425867507886434,0.0,0.0
26340,2,6340,[172  82  50 183 603],650,4,23098,3.6426431162277244,20.0,20.0
26341,2,6341,[228 294 211 172 202],766,1,23099,3.6422264269946387,0.0,0.0
26342,2,6342,[143 222 405 483  95],537,1,23100,3.6418098691470915,20.0,0.0
26343,2,6343,[117 222 475 357 403],339,3,23103,3.6417087011349305,20.0,0.0
26344,2,6344,[ 11  71 172  22 182],328,3,23106,3.6416075650118205,0.0,0.0
26345,2,6345,[302 483 100 127 313],537,5,23111,3.6418216199180584,20.0,40.0
26346,2,6346,[111 181  28  50 301],334,2,23113,3.641562943122735,0.0,20.0
26347,2,6347,[168 515 125   9 161],92,4,23117,3.6416194076874606,0.0,0.0
26348,2,6348,[302 483 100 127 313],329,5,23122,3.6418333595841865,20.0,40.0
26349,2,6349,[135 210 215 216 181],64,4,23126,3.6418897637795276,0.0,0.0
26350,2,6350,[294 111 742 333 275],533,5,23131,3.6421036057313807,0.0,0.0
26351,2,6351,[ 88 302  56 435 222],454,2,23133,3.641845088161209,0.0,0.0
26352,2,6352,[294  96 210  97 151],308,3,23136,3.6417440579253895,0.0,0.0
26353,2,6353,[100   4 215 318  69],474,5,23141,3.6419578218445072,20.0,20.0
26354,2,6354,[182 302  15 200 204],378,4,23145,3.6420141620771047,0.0,0.0
26355,2,6355,[176  12 204 191 427],339,4,23149,3.642070484581498,20.0,0.0
26356,2,6356,[ 98 222 405 597 742],374,5,23154,3.642284096271826,0.0,20.0
26357,2,6357,[496 216 186  97 196],379,4,23158,3.6423403586033345,0.0,0.0
26358,2,6358,[265  64  70 210 276],892,5,23163,3.6425538606699166,0.0,0.0
26359,2,6359,[273 276 318 475  12],144,3,23166,3.642452830188679,40.0,0.0
26360,2,6360,[135 168 301 182 196],650,3,23169,3.642351831473039,0.0,0.0
26361,2,6361,[423 195  25  98 237],13,3,23172,3.6422508645080165,0.0,20.0
26362,2,6362,[ 88  89  64 385 100],774,0,23172,3.6416784535596416,0.0,20.0
26363,2,6363,[ 12 318 183 515 508],774,1,23173,3.6412633563796355,40.0,0.0
26364,2,6364,[302 483 100 127 313],329,5,23178,3.641476826394344,20.0,40.0
26365,2,6365,[302 483 100 127 313],13,5,23183,3.6416902293433866,20.0,40.0
26366,2,6366,[ 97 161 603   8 211],379,3,23186,3.6415894455787656,20.0,0.0
26367,2,6367,[302 483 100 127 313],474,5,23191,3.6418027638190953,20.0,40.0
26368,2,6368,[423 153  22 333 405],334,4,23195,3.641859004553305,0.0,0.0
26369,2,6369,[333  22  98 318  64],64,4,23199,3.6419152276295135,20.0,20.0
26370,2,6370,[475 423  95  96  69],537,1,23200,3.641500549364307,0.0,0.0
26371,2,6371,[181 318 435 179 185],271,4,23204,3.6415568110483365,20.0,0.0
26372,2,6372,[273  82  96 168 175],387,5,23209,3.6417699670484858,0.0,0.0
26373,2,6373,[302 483 100 127 313],334,5,23214,3.641983056165673,20.0,40.0
26374,2,6374,[237 322 385 144 568],883,2,23216,3.6417254901960785,0.0,0.0
26375,2,6375,[175 186  82  98 515],207,3,23219,3.641624843161857,0.0,20.0
26376,2,6376,[286 202 268 234  22],288,5,23224,3.641837854790654,0.0,0.0
26377,2,6377,[302 483 100 127 313],474,5,23229,3.6420507996237066,20.0,40.0
26378,2,6378,[ 69   1  56 125 215],378,3,23232,3.641950148926164,0.0,0.0
26379,2,6379,[168 204 111 172   9],533,5,23237,3.642163009404389,0.0,0.0
26380,2,6380,[435 195 121 403 423],210,5,23242,3.642375803165648,0.0,0.0
26381,2,6381,[144  96  12   8  56],892,5,23247,3.6425885302413037,20.0,0.0
26382,2,6382,[ 96 357 216  71 235],804,5,23252,3.6428011906626976,20.0,0.0
26383,2,6383,[302 483 100 127 313],537,5,23257,3.6430137844611528,20.0,40.0
26384,2,6384,[234 144 179  56 258],378,4,23261,3.643069694596711,0.0,0.0
26385,2,6385,[322  50  28 238 276],311,5,23266,3.643282179768243,0.0,20.0
26386,2,6386,[204 187 435 483 180],533,4,23270,3.643338030374198,20.0,0.0
26387,2,6387,[302 483 100 127 313],207,4,23274,3.6433938634940515,20.0,40.0
26388,2,6388,[121 181  28   4  11],13,4,23278,3.643449679136015,0.0,0.0
26389,2,6389,[258 238 195 286 100],387,4,23282,3.643505477308294,0.0,20.0
26390,2,6390,[294 222 597 515 153],92,3,23285,3.6434047879831013,0.0,0.0
26391,2,6391,[302 483 100 127 313],329,5,23290,3.643617021276596,20.0,40.0
26392,2,6392,[204 515 172 121 176],406,4,23294,3.6436727670890035,0.0,0.0
26393,2,6393,[302 483 100 127 313],232,3,23297,3.643572098842665,20.0,40.0
26394,2,6394,[111 173  71 483   1],749,4,23301,3.643627834245504,20.0,0.0
26395,2,6395,[200 187 228 100 269],537,2,23303,3.643370856785491,0.0,20.0
26396,2,6396,[181 322  95 117 300],263,2,23305,3.643113959668595,0.0,0.0
26397,2,6397,[588 318 191  79  28],387,3,23308,3.6430134417005315,20.0,0.0
26398,2,6398,[435 215 204 191 603],232,4,23312,3.6430692295671196,20.0,0.0
26399,2,6399,[211 423  15 357 161],210,5,23317,3.64328125,20.0,0.0
26400,2,6400,[258 183 175   9 151],64,3,23320,3.643180753007343,0.0,0.0
26401,2,6401,[100 172 322  56 546],788,2,23322,3.642924086223055,0.0,20.0
26402,2,6402,[302 483 100 127 313],13,5,23327,3.643136029985944,20.0,40.0
26403,2,6403,[302 483 100 127 313],90,5,23332,3.6433479075577764,20.0,40.0
26404,2,6404,[258 197 176   9 748],488,4,23336,3.6434035909445743,0.0,0.0
26405,2,6405,[300 742  22 228   8],454,3,23339,3.643303153293787,0.0,0.0
26406,2,6406,[302 483 100 127 313],328,5,23344,3.6435149055720304,20.0,40.0
26407,2,6407,[302 483 100 127 313],13,5,23349,3.6437265917602994,20.0,40.0
26408,2,6408,[288  95   7 161  70],455,3,23352,3.643626150725542,0.0,0.0
26409,2,6409,[603  88 181 180 179],897,3,23355,3.643525741029641,20.0,0.0
26410,2,6410,[302 483 100 127 313],474,5,23360,3.6437373264701294,20.0,40.0
26411,2,6411,[235  25 173  79 200],271,3,23363,3.643636930754835,0.0,0.0
26412,2,6412,[333 168 385 238 435],666,3,23366,3.6435365663496024,0.0,0.0
26413,2,6413,[215 328  88 179 127],234,1,23367,3.6431244153414406,0.0,20.0
26414,2,6414,[302 483 100 127 313],329,5,23372,3.643335931410756,20.0,40.0
26415,2,6415,[234 174 144 357 153],454,2,23374,3.6430798004987532,20.0,20.0
26416,2,6416,[100 603  50 194 238],537,4,23378,3.6431354215365435,20.0,40.0
26417,2,6417,[302 483 100 127 313],13,5,23383,3.6433468370208786,20.0,40.0
26418,2,6418,[ 50 294   4 197 257],144,5,23388,3.643558186633432,0.0,20.0
26419,2,6419,[742 597  50 423  70],95,4,23392,3.643613707165109,0.0,20.0
26420,2,6420,[302 483 100 127 313],328,5,23397,3.643824949384831,20.0,40.0
26421,2,6421,[161 202  79   8 265],92,3,23400,3.6437246963562755,0.0,0.0
26422,2,6422,[471  50 187  56   8],213,3,23403,3.6436244745446054,0.0,20.0
26423,2,6423,[ 12  71 288 182 427],7,5,23408,3.643835616438356,20.0,0.0
26424,2,6424,[302 483 100 127 313],90,5,23413,3.644046692607004,20.0,40.0
26425,2,6425,[172 153 435 200  96],815,5,23418,3.6442577030812324,0.0,0.0
26426,2,6426,[496 322 300 111 179],537,2,23420,3.6440018671230745,0.0,0.0
26427,2,6427,[302 483 100 127 313],90,5,23425,3.644212818917237,20.0,40.0
26428,2,6428,[  9 173  25 238 258],92,3,23428,3.6441126147145746,0.0,0.0
26429,2,6429,[302 483 100 127 313],13,5,23433,3.6443234836702953,20.0,40.0
26430,2,6430,[161  70 588 215 275],64,4,23437,3.6443787902348004,0.0,0.0
26431,2,6431,[275 302 483 111 357],6,4,23441,3.64443407960199,40.0,0.0
26432,2,6432,[121 508 132  70 568],13,2,23443,3.6441784548422196,0.0,0.0
26433,2,6433,[179 151  22  28 328],537,1,23444,3.6437674852346906,0.0,0.0
26434,2,6434,[302 483 100 127 313],13,5,23449,3.643978243978244,20.0,40.0
26435,2,6435,[302 483 100 127 313],13,5,23454,3.644188937228092,20.0,40.0
26436,2,6436,[302 483 100 127 313],328,5,23459,3.6443995650147585,20.0,40.0
26437,2,6437,[238 313 483  56 228],13,4,23463,3.6444547996272134,20.0,0.0
26438,2,6438,[ 64   7 111 144 237],666,2,23465,3.6441994098462493,0.0,0.0
26439,2,6439,[ 15 195  28 200   4],474,4,23469,3.644254658385093,0.0,0.0
26440,2,6440,[302 483 100 127 313],474,5,23474,3.6444651451637946,20.0,40.0
26441,2,6441,[403  64 183 204 194],379,5,23479,3.644675566594225,0.0,0.0
26442,2,6442,[515 483 191  98 174],334,5,23484,3.6448859227068136,20.0,40.0
26443,2,6443,[127 603 546  25 300],313,4,23488,3.644941030415891,20.0,20.0
26444,2,6444,[ 22 289 357 204  70],788,4,23492,3.64499612102405,20.0,0.0
26445,2,6445,[ 25 186  88 385 435],650,3,23495,3.6448960595718276,0.0,0.0
26446,2,6446,[286 211 111 183 210],385,0,23495,3.6443306964479603,0.0,0.0
26447,2,6447,[302 483 100 127 313],474,5,23500,3.6445409429280398,20.0,40.0
26448,2,6448,[144 174 132 237 202],298,4,23504,3.644596061404869,0.0,20.0
26449,2,6449,[302 483 100 127 313],90,5,23509,3.6448062015503875,20.0,40.0
26450,2,6450,[222  79 179 322 385],749,3,23512,3.644706247093474,0.0,0.0
26451,2,6451,[153 276 288 176 655],643,5,23517,3.644916305021699,0.0,0.0
26452,2,6452,[  1 161 179 245  71],200,4,23521,3.6449713311638,0.0,0.0
26453,2,6453,[216 427  98 186 234],452,2,23523,3.644716454911683,0.0,20.0
26454,2,6454,[182 117 257 181 423],144,4,23527,3.6447714949651435,0.0,0.0
26455,2,6455,[ 69 322 161 100 200],13,3,23530,3.6446716232961585,0.0,20.0
26456,2,6456,[302 483 100 127 313],90,5,23535,3.6448815239275207,20.0,40.0
26457,2,6457,[302 483 100 127 313],329,5,23540,3.6450913595540415,20.0,40.0
26458,2,6458,[302 483 100 127 313],90,5,23545,3.6453011302059144,20.0,40.0
26459,2,6459,[196 210  70 271 286],13,1,23546,3.6448916408668732,0.0,0.0
26460,2,6460,[ 15 211 161  28 215],311,4,23550,3.6449466026930817,0.0,0.0
26461,2,6461,[318 483 204 185 275],13,2,23552,3.6446920458062517,40.0,0.0
26462,2,6462,[168 357 191 176 289],406,3,23555,3.644592294600031,20.0,0.0
26463,2,6463,[202  79 588 125 211],804,5,23560,3.64480198019802,0.0,0.0
26464,2,6464,[475 173  69 357 215],13,2,23562,3.6445475638051046,20.0,0.0
26465,2,6465,[181 173 603  82   7],379,5,23567,3.6447571914630372,20.0,0.0
26466,2,6466,[265 211 546 588 168],897,3,23570,3.644657491881862,0.0,0.0
26467,2,6467,[322 276  50 151   1],374,3,23573,3.6445578231292517,0.0,20.0
26468,2,6468,[333 222 385 132 234],488,4,23577,3.6446127685886536,0.0,0.0
26469,2,6469,[ 70 135 496   1 211],6,4,23581,3.6446676970633693,0.0,0.0
26470,2,6470,[496 176  64 275  88],95,3,23584,3.644568072940813,0.0,0.0
26471,2,6471,[258 294 234  56 546],749,2,23586,3.6443139678615575,0.0,0.0
26472,2,6472,[235 187 210 204   1],308,4,23590,3.6443689170400124,0.0,0.0
26473,2,6473,[302 483 100 127 313],328,5,23595,3.644578313253012,20.0,40.0
26474,2,6474,[204 216 568 235  28],92,1,23596,3.644169884169884,0.0,0.0
26475,2,6475,[302 483 100 127 313],328,5,23601,3.644379246448425,20.0,40.0
26476,2,6476,[275 210   9  95 191],13,1,23602,3.643970974216458,0.0,0.0
26477,2,6477,[181 176 211 144 496],804,5,23607,3.6441803025625195,0.0,0.0
26478,2,6478,[275 288 216 597 132],533,3,23610,3.6440808766785,0.0,0.0
26479,2,6479,[ 69 269 176 175 603],650,4,23614,3.644135802469136,20.0,0.0
26480,2,6480,[  9 742 197 328 168],334,3,23617,3.6440364141336214,0.0,0.0
26481,2,6481,[125 328 117 322 191],313,3,23620,3.6439370564640545,0.0,0.0
26482,2,6482,[187 168 132 268 151],334,4,23624,3.643991979022058,0.0,0.0
26483,2,6483,[302 483 100 127 313],537,5,23629,3.644201110425663,20.0,40.0
26484,2,6484,[ 96 546 135  15  95],749,3,23632,3.644101773323053,0.0,0.0
26485,2,6485,[302 483 100 127 313],90,5,23637,3.6443108233117485,20.0,40.0
26486,2,6486,[100 258 568 271 151],650,1,23638,3.6439031909973796,0.0,20.0
26487,2,6487,[ 79 174 127 322 216],311,5,23643,3.6441122071516645,0.0,40.0
26488,2,6488,[161  12 194 191 483],524,4,23647,3.6441670519340423,40.0,0.0
26489,2,6489,[405 183 275  11   9],7,3,23650,3.6440677966101696,0.0,0.0
26490,2,6490,[471 603 286 385 194],524,3,23653,3.6439685718687413,20.0,0.0
26491,2,6491,[515  98 275 121 289],328,5,23658,3.644177449168207,0.0,20.0
26492,2,6492,[186 742  28 282 313],334,2,23660,3.643924226089635,0.0,0.0
26493,2,6493,[215 127 748 275 195],524,1,23661,3.6435170927009546,0.0,20.0
26494,2,6494,[117 276 186  56 168],308,4,23665,3.6435719784449576,0.0,0.0
26495,2,6495,[200 222  79 483 288],474,3,23668,3.643472906403941,20.0,0.0
26496,2,6496,[302 483 100 127 313],207,4,23672,3.6435277820532552,20.0,40.0
26497,2,6497,[ 12  56   1 195 435],378,4,23676,3.6435826408125576,20.0,0.0
26498,2,6498,[222 333  89 121 216],85,1,23677,3.643175873211263,0.0,0.0
26499,2,6499,[302 483 100 127 313],13,5,23682,3.6433846153846154,20.0,40.0
26500,2,6500,[302 483 100 127 313],328,5,23687,3.643593293339486,20.0,40.0
26501,2,6501,[111  12  98 300  71],334,2,23689,3.6433405106121195,20.0,20.0
26502,2,6502,[302 483 100 127 313],207,4,23693,3.643395355989543,20.0,40.0
26503,2,6503,[276 118 174 597 117],374,5,23698,3.6436039360393604,0.0,20.0
26504,2,6504,[  4 186 286 269 265],524,4,23702,3.6436587240584166,0.0,0.0
26505,2,6505,[187 234 204  11 173],271,5,23707,3.643867199508146,0.0,0.0
26506,2,6506,[268  15 318 215 173],92,2,23709,3.643614568925772,20.0,0.0
26507,2,6507,[228 515 238  69  82],881,2,23711,3.643362015980332,0.0,0.0
26508,2,6508,[302 483 100 127 313],13,5,23716,3.643570440927946,20.0,40.0
26509,2,6509,[302 483 100 127 313],537,5,23721,3.643778801843318,20.0,40.0
26510,2,6510,[  7 228  50  11 546],200,4,23725,3.6438335125172783,0.0,20.0
26511,2,6511,[302 483 100 127 313],207,4,23729,3.6438882063882065,20.0,40.0
26512,2,6512,[ 70 191   4 174 173],940,3,23732,3.643789344388147,0.0,20.0
26513,2,6513,[ 11 228 508  97 234],343,4,23736,3.643844028246853,0.0,0.0
26514,2,6514,[132 475 186 175  56],308,4,23740,3.6438986953184958,0.0,0.0
26515,2,6515,[385   8  64 127  71],311,5,23745,3.644106813996317,0.0,20.0
26516,2,6516,[302 483 100 127 313],329,5,23750,3.6443148688046647,20.0,40.0
26517,2,6517,[ 22 186 323   4  70],474,4,23754,3.6443694384780607,0.0,0.0
26518,2,6518,[289 568 508 187   4],533,3,23757,3.644270593649333,0.0,0.0
26519,2,6519,[302 483 100 127 313],207,4,23761,3.644325153374233,20.0,40.0
26520,2,6520,[172   1 118 135 234],454,1,23762,3.6439196442263455,0.0,0.0
26521,2,6521,[748  64 111 508 194],653,2,23764,3.643667586629868,0.0,0.0
26522,2,6522,[187 271 748 143 405],479,2,23766,3.643415606316112,0.0,0.0
26523,2,6523,[328 127 187 173 588],144,4,23770,3.6434702636419374,0.0,20.0
26524,2,6524,[655  28 195  97 357],42,3,23773,3.6433716475095785,20.0,0.0
26525,2,6525,[258 471 508 313 423],537,3,23776,3.643273061599755,0.0,0.0
26526,2,6526,[302 483 100 127 313],329,5,23781,3.6434809253868545,20.0,40.0
26527,2,6527,[546  96 273 176 742],158,3,23784,3.6433823529411766,0.0,0.0
26528,2,6528,[ 50 174 168 185 300],234,1,23785,3.6429774850666257,0.0,40.0
26529,2,6529,[302 483 100 127 313],329,5,23790,3.643185298621746,20.0,40.0
26530,2,6530,[191 423 121 172 187],666,2,23792,3.6429337008115144,0.0,0.0
26531,2,6531,[301 282 202 302 235],378,3,23795,3.642835272504593,0.0,0.0
26532,2,6532,[302 483 100 127 313],537,5,23800,3.643043012398592,20.0,40.0
26533,2,6533,[ 70 302  64  12  89],537,3,23803,3.642944597490052,20.0,0.0
26534,2,6534,[100   4 275 173 496],474,4,23807,3.642999234889059,0.0,20.0
26535,2,6535,[144 742 655 322 183],488,2,23809,3.642747858017136,0.0,0.0
26536,2,6536,[121  70 183 174 182],87,5,23814,3.6429554841670493,0.0,20.0
26537,2,6537,[405 748 678 175 546],749,0,23814,3.6423982869379015,0.0,0.0
26538,2,6538,[  4 191 385 294 222],804,5,23819,3.642605903043279,0.0,0.0
26539,2,6539,[200  12 222   4   1],234,2,23821,3.642354740061162,20.0,0.0
26540,2,6540,[132 294 118   1 288],554,2,23823,3.6421036538755542,0.0,0.0
26541,2,6541,[117 135 174 222 127],313,4,23827,3.642158361357383,0.0,40.0
26542,2,6542,[323 302 597 289 333],13,1,23828,3.641754546843955,0.0,0.0
26543,2,6543,[197  11 318 300 161],653,3,23831,3.641656479217604,20.0,0.0
26544,2,6544,[302 483 100 127 313],232,3,23834,3.6415584415584417,20.0,40.0
26545,2,6545,[  8 153 238  89  56],378,4,23838,3.6416131989000915,0.0,0.0
26546,2,6546,[ 12 135  56 276 173],537,4,23842,3.6416679395142815,20.0,0.0
26547,2,6547,[175   1 179  50  56],77,5,23847,3.6418753817959684,0.0,20.0
26548,2,6548,[435 135 180 187 153],804,3,23850,3.6417773705909298,0.0,0.0
26549,2,6549,[302 483 100 127 313],207,4,23854,3.6418320610687025,20.0,40.0
26550,2,6550,[ 15 125 289 515 187],194,3,23857,3.641734086399023,0.0,0.0
26551,2,6551,[302 483 100 127 313],329,5,23862,3.641941391941392,20.0,40.0
26552,2,6552,[238 546 168 183 234],666,4,23866,3.6419960323515945,0.0,0.0
26553,2,6553,[ 69   9  70 475 181],334,3,23869,3.6418980775099175,0.0,0.0
26554,2,6554,[288  11 748 121 300],64,2,23871,3.6416475972540048,0.0,0.0
26555,2,6555,[144 173 168 195 318],234,1,23872,3.6412446613788894,20.0,0.0
26556,2,6556,[302 172 144 423  89],454,3,23875,3.641146865944792,0.0,0.0
26557,2,6557,[302 483 100 127 313],334,5,23880,3.6413540713632204,20.0,40.0
26558,2,6558,[302 483 100 127 313],328,5,23885,3.6415612135996343,20.0,40.0
26559,2,6559,[313 144 197  56  50],454,4,23889,3.6416158536585366,0.0,20.0
26560,2,6560,[302 483 100 127 313],329,5,23894,3.6418228928516996,20.0,40.0
26561,2,6561,[180 197 176 215 172],13,4,23898,3.6418774763791526,0.0,0.0
26562,2,6562,[302 483 100 127 313],474,5,23903,3.6420844126161818,20.0,40.0
26563,2,6563,[179 100 471 268 271],894,3,23906,3.641986593540524,0.0,20.0
26564,2,6564,[302 483 100 127 313],329,5,23911,3.642193450114242,20.0,40.0
26565,2,6565,[302 483 100 127 313],328,5,23916,3.6424002436795613,20.0,40.0
26566,2,6566,[302 483 100 127 313],474,5,23921,3.6426069742652656,20.0,40.0
26567,2,6567,[  4 216 175 318 173],326,2,23923,3.6423568818514007,20.0,0.0
26568,2,6568,[276 435 357 183 187],537,3,23926,3.6422590957527783,20.0,0.0
26569,2,6569,[405 182  95 568  50],795,2,23928,3.642009132420091,0.0,20.0
26570,2,6570,[603 183   8 678  50],82,3,23931,3.6419114290062393,20.0,20.0
26571,2,6571,[323  95 200 568 597],455,3,23934,3.641813755325624,0.0,0.0
26572,2,6572,[302 483 100 127 313],207,4,23938,3.6418682488970027,20.0,40.0
26573,2,6573,[ 50 118  95   7 182],664,3,23941,3.641770611499848,0.0,20.0
26574,2,6574,[ 22 180 161 132 127],271,4,23945,3.641825095057034,0.0,20.0
26575,2,6575,[ 82 191 288 235   7],13,0,23945,3.641271289537713,0.0,0.0
26576,2,6576,[125 216 186 483  88],848,5,23950,3.6414778774517256,20.0,0.0
26577,2,6577,[ 97 211 568 100 357],379,4,23954,3.6415323806628153,20.0,20.0
26578,2,6578,[288  22 423 153 286],144,4,23958,3.6415868673050618,0.0,0.0
26579,2,6579,[302 483 100 127 313],90,5,23963,3.641793313069909,20.0,40.0
26580,2,6580,[  9 265 210 216 318],648,3,23966,3.6416957909132353,20.0,0.0
26581,2,6581,[302 483 100 127 313],329,5,23971,3.6419021573989667,20.0,40.0
26582,2,6582,[301 144 427 151 403],788,1,23972,3.641500835485341,0.0,0.0
26583,2,6583,[168  28  97 257 238],210,4,23976,3.6415552855407047,0.0,0.0
26584,2,6584,[153  69 496 187 135],64,4,23980,3.6416097190584664,0.0,0.0
26585,2,6585,[302 483 100 127 313],474,5,23985,3.6418159732766475,20.0,40.0
26586,2,6586,[181 210  98  69 313],738,5,23990,3.6420221648701987,0.0,20.0
26587,2,6587,[168 153 195 121   4],666,3,23993,3.6419247115968427,0.0,0.0
26588,2,6588,[ 69 204  12 275 168],6,3,23996,3.6418272879040825,20.0,0.0
26589,2,6589,[215 568 237 125  88],892,5,24001,3.642033383915023,0.0,0.0
26590,2,6590,[237  98 174 100 405],804,5,24006,3.6422394173873465,0.0,60.0
26591,2,6591,[322 333 228 175 435],13,3,24009,3.642141990291262,0.0,0.0
26592,2,6592,[302 483 100 127 313],90,5,24014,3.6423479447899285,20.0,40.0
26593,2,6593,[318 204 180 125 237],653,3,24017,3.642250530785563,20.0,0.0
26594,2,6594,[173 185  22 568 176],339,4,24021,3.6423047763457164,0.0,0.0
26595,2,6595,[302 483 100 127 313],328,5,24026,3.6425106124924196,20.0,40.0
26596,2,6596,[ 56  96 235  50 168],804,4,24030,3.6425648021828105,0.0,20.0
26597,2,6597,[237 127 100 222 508],486,4,24034,3.642618975447105,0.0,40.0
26598,2,6598,[100 286 144 195 257],934,5,24039,3.6428246704046066,0.0,20.0
26599,2,6599,[302 483 100 127 313],329,5,24044,3.643030303030303,20.0,40.0
26600,2,6600,[202  25 515 475  50],308,4,24048,3.6430843811543707,0.0,20.0
26601,2,6601,[302 483 100 127 313],329,5,24053,3.643289912147834,20.0,40.0
26602,2,6602,[121  98 257 742 179],899,4,24057,3.643343934575193,0.0,20.0
26603,2,6603,[194 228  89  97 121],454,2,24059,3.6430950938824953,0.0,0.0
26604,2,6604,[302 483 100 127 313],537,5,24064,3.6433005299015897,20.0,40.0
26605,2,6605,[302 483 100 127 313],328,5,24069,3.6435059037238875,20.0,40.0
26606,2,6606,[228 211 202 238  69],804,5,24074,3.6437112153776297,0.0,0.0
26607,2,6607,[302 483 100 127 313],90,5,24079,3.643916464891041,20.0,40.0
26608,2,6608,[ 97 195 174 187 121],653,4,24083,3.6439703434710244,0.0,20.0
26609,2,6609,[ 82  79  71 748 197],454,4,24087,3.6440242057488654,0.0,0.0
26610,2,6610,[121  79 197 265 180],899,4,24091,3.6440780517319618,0.0,0.0
26611,2,6611,[273  82 546 302 568],13,1,24092,3.6436781609195403,0.0,0.0
26612,2,6612,[515 546 238 235 475],339,4,24096,3.643732042945713,0.0,0.0
26613,2,6613,[302 483 100 127 313],207,4,24100,3.6437859086785607,20.0,40.0
26614,2,6614,[181 204 294 222 678],506,4,24104,3.6438397581254724,0.0,0.0
26615,2,6615,[135 168 423  95  82],308,5,24109,3.6440447400241838,0.0,0.0
26616,2,6616,[237 435  22 234 483],13,5,24114,3.644249659966752,20.0,0.0
26617,2,6617,[302 483 100 127 313],13,5,24119,3.6444545179812633,20.0,40.0
26618,2,6618,[302 483 100 127 313],474,5,24124,3.644659314095785,20.0,40.0
26619,2,6619,[  4 200 135  69 204],378,1,24125,3.644259818731118,0.0,0.0
26620,2,6620,[215 180  69 117 257],474,4,24129,3.644313547802447,0.0,0.0
26621,2,6621,[121 265 483 258 168],59,4,24133,3.64436726064633,20.0,0.0
26622,2,6622,[ 56 471 245 258 515],666,4,24137,3.6444209572701194,0.0,0.0
26623,2,6623,[ 28 100  96   1  22],447,4,24141,3.644474637681159,0.0,20.0
26624,2,6624,[302 483 100 127 313],90,5,24146,3.644679245283019,20.0,40.0
26625,2,6625,[  1 125  82 202 185],398,3,24149,3.6445819498943557,0.0,0.0
26626,2,6626,[302 483 100 127 313],329,5,24154,3.6447864795533422,20.0,40.0
26627,2,6627,[118  98  69 515 265],200,5,24159,3.6449909474954736,0.0,20.0
26628,2,6628,[ 97 216 179 151 194],95,4,24163,3.645044501433097,0.0,0.0
26629,2,6629,[176 143  97 182 423],650,2,24165,3.6447963800904977,0.0,0.0
26630,2,6630,[ 89 222  22 186 173],378,3,24168,3.644699140401146,0.0,0.0
26631,2,6631,[742 195 144   9  28],648,4,24172,3.6447527141133897,0.0,0.0
26632,2,6632,[186  97 475   7 204],374,3,24175,3.6446555103271523,0.0,0.0
26633,2,6633,[215 423 172 216  22],64,5,24180,3.6448598130841123,0.0,0.0
26634,2,6634,[302 483 100 127 313],334,5,24185,3.645064054257724,20.0,40.0
26635,2,6635,[161 423 603 546 357],899,4,24189,3.6451175406871608,40.0,0.0
26636,2,6636,[435  25 483   9  12],59,5,24194,3.6453216814825975,40.0,0.0
26637,2,6637,[ 64  82 328 118 191],653,4,24198,3.645375112985839,0.0,0.0
26638,2,6638,[302 483 100 127 313],474,5,24203,3.645579153486971,20.0,40.0
26639,2,6639,[302 483 100 127 313],13,5,24208,3.6457831325301204,20.0,40.0
26640,2,6640,[603  82 322 313 143],334,3,24211,3.6456858906791147,20.0,0.0
26641,2,6641,[127  15  89 179 210],271,3,24214,3.6455886781090032,0.0,20.0
26642,2,6642,[302 483 100 127 313],537,5,24219,3.6457925636007826,20.0,40.0
26643,2,6643,[318 265 127 748 151],883,4,24223,3.6458458759783263,20.0,20.0
26644,2,6644,[117 269 125 132 111],334,0,24223,3.6452972159518433,0.0,0.0
26645,2,6645,[302 483 100 127 313],207,4,24227,3.645350586819139,20.0,40.0
26646,2,6646,[302 483 100 127 313],474,5,24232,3.6455543854370394,20.0,40.0
26647,2,6647,[118 174  56  25 237],690,4,24236,3.6456077015643804,0.0,20.0
26648,2,6648,[302 483 100 127 313],232,3,24239,3.6455106030982103,20.0,40.0
26649,2,6649,[302 483 100 127 313],13,5,24244,3.645714285714286,20.0,40.0
26650,2,6650,[333 471 328 195 258],13,1,24245,3.645316493760337,0.0,0.0
26651,2,6651,[ 97 423 273 204 153],7,4,24249,3.6453698135898978,0.0,0.0
26652,2,6652,[173 215 742 132  95],749,4,24253,3.6454231173906506,0.0,0.0
26653,2,6653,[302 483 100 127 313],537,5,24258,3.6456266907123536,20.0,40.0
26654,2,6654,[127 435 427 328 186],271,4,24262,3.645679939894816,0.0,20.0
26655,2,6655,[ 50  56 117  28 235],200,4,24266,3.645733173076923,0.0,20.0
26656,2,6656,[196 135 215 237 273],59,3,24269,3.6456361724500526,0.0,0.0
26657,2,6657,[302 483 100 127 313],207,4,24273,3.64568939621508,20.0,40.0
26658,2,6658,[161 300  79 288  15],378,4,24277,3.6457426039945937,0.0,0.0
26659,2,6659,[271 265 143  71 179],843,2,24279,3.6454954954954957,0.0,0.0
26660,2,6660,[ 15 135 172 202  79],374,2,24281,3.645248461192013,0.0,0.0
26661,2,6661,[185  98 210 195 289],48,3,24284,3.645151606124287,0.0,20.0
26662,2,6662,[237 153 121 186 118],194,1,24285,3.6447546150382713,0.0,0.0
26663,2,6663,[237 286 276  97 172],474,5,24290,3.6449579831932772,0.0,0.0
26664,2,6664,[302 483 100 127 313],334,5,24295,3.6451612903225805,20.0,40.0
26665,2,6665,[302 483 100 127 313],207,4,24299,3.645214521452145,20.0,40.0
26666,2,6666,[ 50 191 179 294 125],200,5,24304,3.6454177291135443,0.0,20.0
26667,2,6667,[515 258 121 275 211],537,4,24308,3.6454709058188364,0.0,0.0
26668,2,6668,[100 403 127 180 302],13,4,24312,3.6455240665766984,0.0,40.0
26669,2,6669,[302 483 100 127 313],13,5,24317,3.645727136431784,20.0,40.0
26670,2,6670,[471 179 228 423 222],479,3,24320,3.6456303402788186,0.0,0.0
26671,2,6671,[257 313 678 475 173],455,4,24324,3.6456834532374103,0.0,0.0
26672,2,6672,[  9  79 200  96 357],543,5,24329,3.6458864079124833,20.0,0.0
26673,2,6673,[222  64 175 151 172],524,0,24329,3.6453401258615523,0.0,0.0
26674,2,6674,[302 483 100 127 313],13,5,24334,3.6455430711610486,20.0,40.0
26675,2,6675,[603 435  70 196  12],234,1,24335,3.6451467944877174,40.0,0.0
26676,2,6676,[117  64 172 216  97],406,4,24339,3.645199940092856,0.0,0.0
26677,2,6677,[181 125 210   8 132],64,3,24342,3.6451033243486073,0.0,0.0
26678,2,6678,[161 153 195  79 318],308,4,24346,3.645156460547986,20.0,0.0
26679,2,6679,[302 117 289 603 435],458,4,24350,3.645209580838323,20.0,0.0
26680,2,6680,[302 483 100 127 313],474,5,24355,3.6454123634186497,20.0,40.0
26681,2,6681,[ 69 483  95 215 161],648,1,24356,3.6450164621370846,20.0,0.0
26682,2,6682,[294 174 100 168 265],676,5,24361,3.6452192129283256,0.0,40.0
26683,2,6683,[210 238 235 483  25],194,2,24363,3.6449730700179535,20.0,0.0
26684,2,6684,[  8  79 748 172  96],200,4,24367,3.6450261780104714,0.0,0.0
26685,2,6685,[748  88  15 496 143],653,1,24368,3.644630571343105,0.0,0.0
26686,2,6686,[121 301 265 275 423],328,4,24372,3.6446837146702555,0.0,0.0
26687,2,6687,[302 483 100 127 313],334,5,24377,3.6448863636363638,20.0,40.0
26688,2,6688,[302 483 100 127 313],329,5,24382,3.645088952010764,20.0,40.0
26689,2,6689,[222   1 235 176 121],210,4,24386,3.6451420029895365,0.0,0.0
26690,2,6690,[302 483 100 127 313],13,5,24391,3.645344492602003,20.0,40.0
26691,2,6691,[172 175 222 234 322],13,3,24394,3.6452480573819486,0.0,0.0
26692,2,6692,[245 153 286   4 258],207,3,24397,3.6451516509786344,0.0,0.0
26693,2,6693,[302 483 100 127 313],474,5,24402,3.6453540484015536,20.0,40.0
26694,2,6694,[271 168 179 322 268],13,2,24404,3.645108289768484,0.0,0.0
26695,2,6695,[302 483 100 127 313],537,5,24409,3.645310633213859,20.0,40.0
26696,2,6696,[ 96 228 181 196 161],387,3,24412,3.645214275048529,0.0,0.0
26697,2,6697,[302 483 100 127 313],537,5,24417,3.6454165422514184,20.0,40.0
26698,2,6698,[ 28 515 135 143 194],95,4,24421,3.64546947305568,0.0,0.0
26699,2,6699,[302 483 100 127 313],13,5,24426,3.645671641791045,20.0,40.0
26700,2,6700,[191 282 196 265  25],194,2,24428,3.6454260558125653,0.0,0.0
26701,2,6701,[172 202 143  28  98],897,4,24432,3.6454789615040286,0.0,20.0
26702,2,6702,[127 603 183 181 269],659,4,24436,3.6455318514098165,20.0,20.0
26703,2,6703,[191 161 127 204 271],650,2,24438,3.645286396181384,0.0,20.0
26704,2,6704,[318 357 268   8 125],7,4,24442,3.6453392990305744,40.0,0.0
26705,2,6705,[301  71 204 268 173],234,0,24442,3.644795705338503,0.0,0.0
26706,2,6706,[302 483 100 127 313],474,5,24447,3.6449977635306396,20.0,40.0
26707,2,6707,[132 318 210 191 496],311,5,24452,3.6451997614788314,20.0,0.0
26708,2,6708,[ 98 144  15 568  79],95,5,24457,3.645401699210016,0.0,20.0
26709,2,6709,[151 175  50 222 508],334,4,24461,3.6454545454545455,0.0,20.0
26710,2,6710,[269 197 143 181 475],13,2,24463,3.645209357770824,0.0,0.0
26711,2,6711,[496  89 286 742 568],488,3,24466,3.645113230035757,0.0,0.0
26712,2,6712,[302 483 100 127 313],334,5,24471,3.6453150603307014,20.0,40.0
26713,2,6713,[302 483 100 127 313],232,3,24474,3.645218945487042,20.0,40.0
26714,2,6714,[496 151 174 427 180],650,3,24477,3.6451228592702902,0.0,20.0
26715,2,6715,[655   4 234 204 172],102,1,24478,3.6447290053603334,0.0,0.0
26716,2,6716,[302 483 100 127 313],537,5,24483,3.644930772666369,20.0,40.0
26717,2,6717,[237 742 748 234 176],749,3,24486,3.6448347722536467,0.0,0.0
26718,2,6718,[215 204 238 179  69],234,1,24487,3.6444411370739695,0.0,0.0
26719,2,6719,[ 82  79 153 172 179],738,3,24490,3.644345238095238,0.0,0.0
26720,2,6720,[ 56 127 168 273 197],13,4,24494,3.644398155036453,0.0,20.0
26721,2,6721,[333  70 121 568 143],64,3,24497,3.644302290984826,0.0,0.0
26722,2,6722,[168 300 282 100 191],666,3,24500,3.6442064554514353,0.0,20.0
26723,2,6723,[173 234 187 204 143],452,1,24501,3.6438132064247473,0.0,0.0
26724,2,6724,[302 483 100 127 313],90,5,24506,3.644014869888476,20.0,40.0
26725,2,6725,[385 183  70   8  97],474,5,24511,3.644216473386857,0.0,0.0
26726,2,6726,[ 96  79  70  15 471],537,1,24512,3.6438233982458748,0.0,0.0
26727,2,6727,[ 22  28  12 174 125],7,5,24517,3.644024970273484,20.0,20.0
26728,2,6728,[ 82 195  50 100   1],934,4,24521,3.644077871897756,0.0,40.0
26729,2,6729,[245 405  82 597 546],102,0,24521,3.6435364041604754,0.0,0.0
26730,2,6730,[215 403 211 742 222],42,4,24525,3.6435893626504234,0.0,0.0
26731,2,6731,[302 483 100 127 313],13,5,24530,3.6437908496732025,20.0,40.0
26732,2,6732,[168 301 271 179 185],334,3,24533,3.6436952324372496,0.0,0.0
26733,2,6733,[302 483 100 127 313],232,3,24536,3.6435996435996434,20.0,40.0
26734,2,6734,[302 483 100 127 313],328,5,24541,3.6438010393466964,20.0,40.0
26735,2,6735,[  1 191 196  98 238],41,4,24545,3.643853919239905,0.0,20.0
26736,2,6736,[132 546  69 204  82],881,3,24548,3.6437583494136856,0.0,0.0
26737,2,6737,[302 483 100 127 313],537,5,24553,3.6439596319382606,20.0,40.0
26738,2,6738,[117 174 181 427 237],398,4,24557,3.6440124647573824,0.0,20.0
26739,2,6739,[286  82   4 282 204],881,3,24560,3.6439169139465877,0.0,0.0
26740,2,6740,[245 216   9  25 234],92,3,24563,3.643821391484943,0.0,0.0
26741,2,6741,[302 483 100 127 313],329,5,24568,3.6440225452388018,20.0,40.0
26742,2,6742,[302 483 100 127 313],90,5,24573,3.644223639329675,20.0,40.0
26743,2,6743,[302 483 100 127 313],474,5,24578,3.6444246737841044,20.0,40.0
26744,2,6744,[ 15 294 121 215 265],479,2,24580,3.644180874722016,0.0,0.0
26745,2,6745,[ 64 483 211 288 180],343,4,24584,3.6442336199229173,20.0,0.0
26746,2,6746,[195 196 385 276 204],194,1,24585,3.6438417074255223,0.0,0.0
26747,2,6747,[302 483 100 127 313],537,5,24590,3.644042679312389,20.0,40.0
26748,2,6748,[245 185 197 153 322],313,2,24592,3.6437990813453847,0.0,0.0
26749,2,6749,[302 483 100 127 313],232,3,24595,3.6437037037037037,20.0,40.0
26750,2,6750,[194 228 294 172 127],406,3,24598,3.643608354317879,0.0,20.0
26751,2,6751,[515 427 286 187  11],7,3,24601,3.6435130331753554,0.0,0.0
26752,2,6752,[  7 183 168 318 174],653,2,24603,3.643269657929809,20.0,20.0
26753,2,6753,[204 742 475 483 196],334,4,24607,3.6433224755700326,20.0,0.0
26754,2,6754,[302 483 100 127 313],328,5,24612,3.643523316062176,20.0,40.0
26755,2,6755,[ 12 235 742 302  11],145,5,24617,3.643724097098875,20.0,0.0
26756,2,6756,[ 25 471 748 275 222],634,2,24619,3.643480834689951,0.0,0.0
26757,2,6757,[302 483 100 127 313],90,5,24624,3.6436815625924828,20.0,40.0
26758,2,6758,[265 742  98 153 143],666,2,24626,3.643438378458352,0.0,20.0
26759,2,6759,[302 483 100 127 313],232,3,24629,3.6433431952662723,20.0,40.0
26760,2,6760,[ 22   8 118 423  89],479,3,24632,3.643248040230735,0.0,0.0
26761,2,6761,[200 125 186 258   1],378,2,24634,3.643005028098196,0.0,0.0
26762,2,6762,[174 282 196 173  71],311,5,24639,3.643205677953571,0.0,20.0
26763,2,6763,[302 483 100 127 313],90,5,24644,3.6434062684801893,20.0,40.0
26764,2,6764,[302 483 100 127 313],207,4,24648,3.643458980044346,20.0,40.0
26765,2,6765,[302 483 100 127 313],90,5,24653,3.6436594738397874,20.0,40.0
26766,2,6766,[ 70 174  82  50 265],13,3,24656,3.6435643564356437,0.0,40.0
26767,2,6767,[ 96 237 403  64 100],234,2,24658,3.643321513002364,0.0,20.0
26768,2,6768,[ 12   9 174  70  98],6,4,24662,3.643374205938839,20.0,40.0
26769,2,6769,[471 273 183 175 181],378,4,24666,3.643426883308715,0.0,0.0
26770,2,6770,[238 186 273 385 475],387,2,24668,3.6431841677743315,0.0,0.0
26771,2,6771,[196  88 111 117 191],92,3,24671,3.6430891907855876,0.0,0.0
26772,2,6772,[302 483 100 127 313],537,5,24676,3.6432895319651557,20.0,40.0
26773,2,6773,[313 222 111 568 515],92,3,24679,3.643194567463832,0.0,0.0
26774,2,6774,[302 483 100 127 313],329,5,24684,3.6433948339483395,20.0,40.0
26775,2,6775,[302 483 100 127 313],90,5,24689,3.643595041322314,20.0,40.0
26776,2,6776,[302 483 100 127 313],207,4,24693,3.6436476316954405,20.0,40.0
26777,2,6777,[ 89 471 269 191  97],666,5,24698,3.643847742696961,0.0,0.0
26778,2,6778,[471 168 186  70 300],311,4,24702,3.643900280277327,0.0,0.0
26779,2,6779,[216 435 200 118 161],308,2,24704,3.6436578171091445,0.0,0.0
26780,2,6780,[515 403 132 483  89],343,4,24708,3.6437103672024773,20.0,0.0
26781,2,6781,[302 483 100 127 313],537,5,24713,3.6439103509289295,20.0,40.0
26782,2,6782,[173 143 655  56 275],378,5,24718,3.644110275689223,0.0,0.0
26783,2,6783,[197 238   9 121 435],648,2,24720,3.643867924528302,0.0,0.0
26784,2,6784,[204 258 302 180 127],666,4,24724,3.643920412675018,0.0,20.0
26785,2,6785,[286  69 385 483 238],10,5,24729,3.6441202475685235,20.0,0.0
26786,2,6786,[300 168 121 234   9],13,3,24732,3.6440253425666715,0.0,0.0
26787,2,6787,[302 483 100 127 313],474,5,24737,3.6442251031231585,20.0,40.0
26788,2,6788,[181 313 125 174 234],455,4,24741,3.6442775077330976,0.0,20.0
26789,2,6789,[265  56 235  50 174],804,4,24745,3.6443298969072164,0.0,40.0
26790,2,6790,[ 11  95 288 175 121],537,1,24746,3.643940509497865,0.0,0.0
26791,2,6791,[302 483 100 127 313],537,5,24751,3.6441401648998824,20.0,40.0
26792,2,6792,[302 483 100 127 313],90,5,24756,3.644339761519211,20.0,40.0
26793,2,6793,[333   4 496  11 117],653,2,24758,3.644097733294083,0.0,0.0
26794,2,6794,[515  79  82 496 273],308,2,24760,3.6438557763061072,0.0,0.0
26795,2,6795,[302 483 100 127 313],232,3,24763,3.6437610359034727,20.0,40.0
26796,2,6796,[302 483 100 127 313],232,3,24766,3.643666323377961,20.0,40.0
26797,2,6797,[ 22 742   4 257 546],653,1,24767,3.6432774345395704,0.0,0.0
26798,2,6798,[ 25   4 176 294 179],378,2,24769,3.643035740550081,0.0,0.0
26799,2,6799,[302 483 100 127 313],334,5,24774,3.643235294117647,20.0,40.0
26800,2,6800,[ 82 172 186  50  95],59,4,24778,3.6432877518012057,0.0,20.0
26801,2,6801,[588 180 186 655  22],95,3,24781,3.6431931784769187,0.0,0.0
26802,2,6802,[258 597 182 183 127],102,2,24783,3.642951638982802,0.0,20.0
26803,2,6803,[302 483 100 127 313],537,5,24788,3.643151087595532,20.0,40.0
26804,2,6804,[234 195 180 603 357],13,3,24791,3.6430565760470244,40.0,0.0
26805,2,6805,[483 197 204  50 186],881,2,24793,3.64281516309139,20.0,20.0
26806,2,6806,[302 483 100 127 313],207,4,24797,3.6428676362567947,20.0,40.0
26807,2,6807,[161 655 275  82 172],328,5,24802,3.6430669800235016,0.0,0.0
26808,2,6808,[ 89 748  88 182 265],102,1,24803,3.642678807460714,0.0,0.0
26809,2,6809,[471  71  95 515 273],92,4,24807,3.6427312775330396,0.0,0.0
26810,2,6810,[ 50 655 185 174 172],194,3,24810,3.64263691087946,0.0,40.0
26811,2,6811,[603 174 286 195 238],10,5,24815,3.642836171462126,20.0,20.0
26812,2,6812,[ 89 237  70  12 588],13,4,24819,3.642888595332453,20.0,0.0
26813,2,6813,[ 95 678 423 294 186],13,3,24822,3.642794247138245,0.0,0.0
26814,2,6814,[288 268 118 546 200],13,2,24824,3.6425531914893616,0.0,0.0
26815,2,6815,[237 483  82 300 546],328,4,24828,3.642605633802817,20.0,0.0
26816,2,6816,[ 28 204 568  98   7],883,2,24830,3.6423646765439344,0.0,20.0
26817,2,6817,[302 483 100 127 313],90,5,24835,3.6425638017013786,20.0,40.0
26818,2,6818,[302 483 100 127 313],328,5,24840,3.6427628684557853,20.0,40.0
26819,2,6819,[  1 235  64 228 222],738,4,24844,3.642815249266862,0.0,0.0
26820,2,6820,[302 483 100 127 313],90,5,24849,3.6430142207887406,20.0,40.0
26821,2,6821,[748  71 546   9 268],92,3,24852,3.642919964819701,0.0,0.0
26822,2,6822,[302 483 100 127 313],537,5,24857,3.6431188626703794,20.0,40.0
26823,2,6823,[302 483 100 127 313],537,5,24862,3.643317702227433,20.0,40.0
26824,2,6824,[265 475 222 187  96],387,4,24866,3.643369963369963,0.0,0.0
26825,2,6825,[302 483 100 127 313],474,5,24871,3.643568707881629,20.0,40.0
26826,2,6826,[302 483 100 127 313],537,5,24876,3.6437673941702067,20.0,40.0
26827,2,6827,[ 56 257 655 196 222],378,4,24880,3.6438195664909196,0.0,0.0
26828,2,6828,[ 88   9 197  15 194],881,0,24880,3.6432859862351736,0.0,0.0
26829,2,6829,[ 69  89 237 174 258],184,2,24882,3.6430453879941433,0.0,20.0
26830,2,6830,[302 483 100 127 313],13,5,24887,3.6432440345483825,20.0,40.0
26831,2,6831,[302 483 100 127 313],328,5,24892,3.6434426229508197,20.0,40.0
26832,2,6832,[135 603 200  50 234],13,4,24896,3.643494804624616,20.0,20.0
26833,2,6833,[ 56 172  25 435  71],892,4,24900,3.643546971027217,0.0,0.0
26834,2,6834,[ 56 175   4   8 333],343,4,24904,3.6435991221653254,0.0,0.0
26835,2,6835,[ 89 174 318  25  97],59,5,24909,3.6437975424224693,20.0,20.0
26836,2,6836,[515 237 186 238 471],207,3,24912,3.6437033786748576,0.0,0.0
26837,2,6837,[111 168  82  11 323],537,1,24913,3.643316759286341,0.0,0.0
26838,2,6838,[302 483 100 127 313],13,5,24918,3.64351513379149,20.0,40.0
26839,2,6839,[435  96  28 204 125],899,3,24921,3.643421052631579,0.0,0.0
26840,2,6840,[275 175  25 403 191],308,5,24926,3.6436193538956294,0.0,0.0
26841,2,6841,[302 483 100 127 313],334,5,24931,3.643817597193803,20.0,40.0
26842,2,6842,[161 191 127 204 143],318,4,24935,3.643869647815286,0.0,20.0
26843,2,6843,[ 50 143  22  15 183],378,5,24940,3.6440677966101696,0.0,20.0
26844,2,6844,[174 172  89 127 191],843,2,24942,3.643827611395179,0.0,40.0
26845,2,6845,[ 50 180 186   4 143],474,5,24947,3.644025708442886,0.0,20.0
26846,2,6846,[195   8  69  89 435],326,3,24950,3.6439316488973272,0.0,0.0
26847,2,6847,[302 483 100 127 313],90,5,24955,3.644129672897196,20.0,40.0
26848,2,6848,[ 98 211 568  96  79],543,4,24959,3.6441816323550884,0.0,20.0
26849,2,6849,[475   4 568 496  97],387,0,24959,3.643649635036496,0.0,0.0
26850,2,6850,[302 483 100 127 313],207,4,24963,3.643701649394249,20.0,40.0
26851,2,6851,[ 88 471 216 313 173],145,5,24968,3.643899591360187,0.0,0.0
26852,2,6852,[302 483 100 127 313],474,5,24973,3.6440974755581497,20.0,40.0
26853,2,6853,[403 174 257  95  88],815,3,24976,3.644003501604902,0.0,20.0
26854,2,6854,[ 70 568 302 238 655],537,3,24979,3.6439095550692926,0.0,0.0
26855,2,6855,[196  22 655 597 161],13,4,24983,3.6439614935822635,0.0,0.0
26856,2,6856,[603 135  69  15 204],694,5,24988,3.6441592533177776,20.0,0.0
26857,2,6857,[302 483 100 127 313],13,5,24993,3.6443569553805775,20.0,40.0
26858,2,6858,[211 172 471  28  71],234,1,24994,3.64397142440589,0.0,0.0
26859,2,6859,[ 89 191 117 234 121],13,3,24997,3.6438775510204082,0.0,0.0
26860,2,6860,[168  11 588 172 196],840,3,25000,3.6437837049992714,0.0,0.0
26861,2,6861,[211 153 127 187 191],339,5,25005,3.6439813465461963,0.0,20.0
26862,2,6862,[237 405 742 257 196],647,3,25008,3.6438875127495263,0.0,0.0
26863,2,6863,[174 655 194 144  95],398,5,25013,3.6440850815850814,0.0,20.0
26864,2,6864,[286 175 435 546 195],158,4,25017,3.6441369264384558,0.0,0.0
26865,2,6865,[  7  71 546 204 211],328,3,25020,3.6440431109816487,0.0,0.0
26866,2,6866,[302 483 100 127 313],13,5,25025,3.6442405708460752,20.0,40.0
26867,2,6867,[333 216  88   9  69],145,3,25028,3.644146767617938,0.0,0.0
26868,2,6868,[302 483 100 127 313],334,5,25033,3.6443441548988207,20.0,40.0
26869,2,6869,[ 97 185  95 427 483],406,5,25038,3.6445414847161572,20.0,0.0
26870,2,6870,[ 70  11 175  25 181],213,4,25042,3.6445932178722167,0.0,0.0
26871,2,6871,[302 483 100 127 313],90,5,25047,3.644790454016298,20.0,40.0
26872,2,6872,[302 483 100 127 313],537,5,25052,3.6449876327658957,20.0,40.0
26873,2,6873,[135 187 471 228 132],653,3,25055,3.644893802734943,0.0,0.0
26874,2,6874,[568 289 300 265  89],13,2,25057,3.6446545454545456,0.0,0.0
26875,2,6875,[265 603   4 385 132],234,3,25060,3.64456079115765,20.0,0.0
26876,2,6876,[322 288 168 176 186],374,4,25064,3.6446124763705106,0.0,0.0
26877,2,6877,[313 322 117   7 211],328,4,25068,3.644664146554231,0.0,0.0
26878,2,6878,[258 215   9 135 117],815,3,25071,3.6445704317488006,0.0,0.0
26879,2,6879,[179  12 496 748  70],311,4,25075,3.644622093023256,20.0,0.0
26880,2,6880,[748 238 151 100 282],479,3,25078,3.644528411568086,0.0,20.0
26881,2,6881,[302 483 100 127 313],329,5,25083,3.6447253705318223,20.0,40.0
26882,2,6882,[257 181 405 121 185],548,5,25088,3.6449222722650005,0.0,0.0
26883,2,6883,[302 483 100 127 313],207,4,25092,3.644973852411389,20.0,40.0
26884,2,6884,[194 257 161   9 196],749,2,25094,3.644734931009441,0.0,0.0
26885,2,6885,[655 471 268 265  25],537,1,25095,3.6443508568109206,0.0,0.0
26886,2,6886,[302 483 100 127 313],474,5,25100,3.644547698562509,20.0,40.0
26887,2,6887,[385  64 288 172 168],7,5,25105,3.6447444831591174,0.0,0.0
26888,2,6888,[496 175 182 144 294],666,3,25108,3.6446508927275367,0.0,0.0
26889,2,6889,[302 483 100 127 313],334,5,25113,3.644847605224964,20.0,40.0
26890,2,6890,[742 289  12 655 144],92,3,25116,3.6447540269917282,20.0,0.0
26891,2,6891,[742 181 173 496 546],804,4,25120,3.644805571677307,0.0,0.0
26892,2,6892,[302 483 100 127 313],328,5,25125,3.6450021761207023,20.0,40.0
26893,2,6893,[175 258  98 475 161],92,4,25129,3.6450536698578473,0.0,20.0
26894,2,6894,[ 15 202 216 118 176],311,4,25133,3.6451051486584483,0.0,0.0
26895,2,6895,[483  95 588  79 197],85,3,25136,3.645011600928074,20.0,0.0
26896,2,6896,[471 202 603 496 191],666,5,25141,3.645208061476004,20.0,0.0
26897,2,6897,[385  71 603  28  64],42,5,25146,3.6454044650623367,20.0,0.0
26898,2,6898,[385 144 173 187 257],659,4,25150,3.645455863168575,0.0,0.0
26899,2,6899,[175 357  50  25 182],339,5,25155,3.6456521739130436,20.0,20.0
26900,2,6900,[302 483 100 127 313],329,5,25160,3.645848427764092,20.0,40.0
26901,2,6901,[118 183 173  89 294],13,3,25163,3.645754853665604,0.0,0.0
26902,2,6902,[302 483 100 127 313],90,5,25168,3.645951035781544,20.0,40.0
26903,2,6903,[302 483 100 127 313],537,5,25173,3.6461471610660485,20.0,40.0
26904,2,6904,[302 483 100 127 313],207,4,25177,3.6461984069514846,20.0,40.0
26905,2,6905,[  9 273  12 186  11],308,4,25181,3.6462496379959455,20.0,0.0
26906,2,6906,[ 82 187 597 127 211],7,3,25184,3.646156073548574,0.0,20.0
26907,2,6907,[211   8 237 185 179],13,3,25187,3.6460625361899246,0.0,0.0
26908,2,6908,[471 588 333  71 153],13,3,25190,3.6459690259082356,0.0,0.0
26909,2,6909,[302 483 100 127 313],207,4,25194,3.6460202604920404,20.0,40.0
26910,2,6910,[302 483 100 127 313],537,5,25199,3.6462161771089567,20.0,40.0
26911,2,6911,[294 257 546 100 273],92,2,25201,3.645978009259259,0.0,20.0
26912,2,6912,[496   1 111 423 234],271,4,25205,3.6460292203095617,0.0,0.0
26913,2,6913,[302 483 100 127 313],334,5,25210,3.6462250506219265,20.0,40.0
26914,2,6914,[302 483 100 127 313],474,5,25215,3.646420824295011,20.0,40.0
26915,2,6915,[302 483 100 127 313],334,5,25220,3.6466165413533833,20.0,40.0
26916,2,6916,[423 180 111 132 151],474,4,25224,3.6466676304756396,0.0,0.0
26917,2,6917,[176 185 235  50 211],271,2,25226,3.646429603931772,0.0,20.0
26918,2,6918,[180 174 655 186 403],378,3,25229,3.6463361757479404,0.0,20.0
26919,2,6919,[302 483 100 127 313],334,5,25234,3.6465317919075146,20.0,40.0
26920,2,6920,[302 483 100 127 313],537,5,25239,3.646727351538795,20.0,40.0
26921,2,6921,[748 144  64 121  88],346,5,25244,3.6469228546662813,0.0,0.0
26922,2,6922,[176 483 168   7 175],840,4,25248,3.6469738552650584,20.0,0.0
26923,2,6923,[282 143 186 183 333],298,4,25252,3.6470248411322936,0.0,0.0
26924,2,6924,[117  12  15  98 423],474,5,25257,3.647220216606498,20.0,20.0
26925,2,6925,[174  12 483  64 475],308,4,25261,3.6472711521801906,40.0,20.0
26926,2,6926,[187 183   8 515 179],194,3,25264,3.6471777104085463,0.0,0.0
26927,2,6927,[302 483 100 127 313],90,5,25269,3.6473729792147807,20.0,40.0
26928,2,6928,[302 483 100 127 313],329,5,25274,3.647568191658248,20.0,40.0
26929,2,6929,[302 483 100 127 313],334,5,25279,3.6477633477633478,20.0,40.0
26930,2,6930,[ 79  95  25  28 228],882,4,25283,3.6478141682296927,0.0,0.0
26931,2,6931,[202 153 318 200   4],653,2,25285,3.6475764570109637,20.0,0.0
26932,2,6932,[385 588   8 181 144],479,3,25288,3.647483052069811,0.0,0.0
26933,2,6933,[ 70 202  69  89 257],934,5,25293,3.647678107874243,0.0,0.0
26934,2,6934,[302 483 100 127 313],334,5,25298,3.6478731074260997,20.0,40.0
26935,2,6935,[302 483 100 127 313],334,5,25303,3.648068050749712,20.0,40.0
26936,2,6936,[179 125 195 176  79],378,2,25305,3.6478304742684156,0.0,0.0
26937,2,6937,[200 174 318 403 195],899,4,25309,3.647881233784952,20.0,20.0
26938,2,6938,[182 238 237 435 117],13,3,25312,3.6477878656866984,0.0,0.0
26939,2,6939,[125  50 211 216 168],648,4,25316,3.6478386167146972,0.0,20.0
26940,2,6940,[302 483 100 127 313],329,5,25321,3.648033424578591,20.0,40.0
26941,2,6941,[172  22 268 179 161],7,3,25324,3.647940074906367,0.0,0.0
26942,2,6942,[135 172  50 286  89],334,4,25328,3.6479907820826734,0.0,20.0
26943,2,6943,[302 483 100 127 313],90,5,25333,3.6481854838709675,20.0,40.0
26944,2,6944,[302 483 100 127 313],329,5,25338,3.6483801295896328,20.0,40.0
26945,2,6945,[302 483 100 127 313],232,3,25341,3.6482867837604376,20.0,40.0
26946,2,6946,[173 508  12 568  22],13,2,25343,3.648049517777458,20.0,0.0
26947,2,6947,[238 187 546 175 742],804,4,25347,3.6481001727115716,0.0,0.0
26948,2,6948,[655 191  95 234 237],194,2,25349,3.647863001870773,0.0,0.0
26949,2,6949,[ 71 318   7  96 313],455,3,25352,3.6477697841726617,20.0,0.0
26950,2,6950,[302 483 100 127 313],334,5,25357,3.647964321680334,20.0,40.0
26951,2,6951,[182 175 271 161 196],92,3,25360,3.6478711162255464,0.0,0.0
26952,2,6952,[ 79  97 127 191 186],189,3,25363,3.6477779375809005,0.0,20.0
26953,2,6953,[302 483 100 127 313],13,5,25368,3.647972389991372,20.0,40.0
26954,2,6954,[302 483 100 127 313],207,4,25372,3.6480230050323508,20.0,40.0
26955,2,6955,[678 286 194 176 471],213,3,25375,3.6479298447383552,0.0,0.0
26956,2,6956,[181 238 483 100 423],524,4,25379,3.64798045134397,20.0,20.0
26957,2,6957,[185  69 742 435 204],897,3,25382,3.647887323943662,0.0,0.0
26958,2,6958,[ 69 117   7 182  28],328,4,25386,3.6479379221152466,0.0,0.0
26959,2,6959,[302 483 100 127 313],13,5,25391,3.648132183908046,20.0,40.0
26960,2,6960,[257 174 215 234 313],308,2,25393,3.647895417325097,0.0,20.0
26961,2,6961,[302 483 100 127 313],13,5,25398,3.6480896294168343,20.0,40.0
26962,2,6962,[180 175 288 235  28],13,3,25401,3.6479965532098233,0.0,0.0
26963,2,6963,[238  98  50 143 289],95,4,25405,3.648047099368179,0.0,40.0
26964,2,6964,[71  8 97 28 15],254,3,25408,3.647954055994257,0.0,0.0
26965,2,6965,[  9 176 276 496 132],605,5,25413,3.6481481481481484,0.0,0.0
26966,2,6966,[257 435 603 202  25],533,5,25418,3.6483421845844695,20.0,0.0
26967,2,6967,[172 127 318 323 294],311,4,25422,3.6483926521239955,20.0,20.0
26968,2,6968,[132 180 174 176 300],288,4,25426,3.648443105180083,0.0,20.0
26969,2,6969,[176 276 288 195   7],378,3,25429,3.6483500717360116,0.0,0.0
26970,2,6970,[405  11  97 185  70],881,3,25432,3.648257064983503,0.0,0.0
26971,2,6971,[405 515 125 118 132],59,3,25435,3.648164084911073,0.0,0.0
26972,2,6972,[ 98 216 496 176 180],346,3,25438,3.6480711315072423,0.0,20.0
26973,2,6973,[483 603  11  22 183],339,5,25443,3.6482649842271293,40.0,0.0
26974,2,6974,[197 211   8 597 195],774,0,25443,3.647741935483871,0.0,0.0
26975,2,6975,[121 132 271 269 176],650,3,25446,3.6476490825688073,0.0,0.0
26976,2,6976,[  1 118   9 197 655],308,3,25449,3.647556256270603,0.0,0.0
26977,2,6977,[135 423 742 385  95],200,5,25454,3.647750071653769,0.0,0.0
26978,2,6978,[183 187 423  97 238],543,2,25456,3.647513970482877,0.0,0.0
26979,2,6979,[302 483 100 127 313],334,5,25461,3.647707736389685,20.0,40.0
26980,2,6980,[508  28 216 191 257],378,5,25466,3.6479014467841284,0.0,0.0
26981,2,6981,[302 483 100 127 313],207,4,25470,3.6479518762532224,20.0,40.0
26982,2,6982,[ 64 742 357 191 183],488,4,25474,3.64800229127882,20.0,0.0
26983,2,6983,[ 56 269 655 508  71],334,2,25476,3.647766323024055,0.0,0.0
26984,2,6984,[742 282 289 210 211],95,3,25479,3.6476735862562633,0.0,0.0
26985,2,6985,[318 237 286  98 597],452,4,25483,3.6477240194675065,20.0,20.0
26986,2,6986,[118 496  11 121 483],643,4,25487,3.6477744382424504,20.0,0.0
26987,2,6987,[588 100 191 210 197],406,5,25492,3.647967945048655,0.0,20.0
26988,2,6988,[117 357 197 515 191],406,4,25496,3.6480183144942053,20.0,0.0
26989,2,6989,[ 64 423 313 237 333],328,4,25500,3.648068669527897,0.0,0.0
26990,2,6990,[186 210 182  56 194],378,4,25504,3.6481190101559147,0.0,0.0
26991,2,6991,[ 15 179 121 483  79],95,3,25507,3.648026315789474,20.0,0.0
26992,2,6992,[302 483 100 127 313],537,5,25512,3.6482196482196483,20.0,40.0
26993,2,6993,[403 475 174 496 173],339,4,25516,3.6482699456677152,0.0,20.0
26994,2,6994,[125 135 172 191 265],234,2,25518,3.6480343102215866,0.0,0.0
26995,2,6995,[216   4 546 238 318],13,1,25519,3.6476558033161806,20.0,0.0
26996,2,6996,[172  79 234 173   1],59,4,25523,3.6477061597827642,0.0,0.0
26997,2,6997,[175 515  15 185  28],234,2,25525,3.647470705915976,0.0,0.0
26998,2,6998,[202 117 302 211 135],207,2,25527,3.647235319331333,0.0,0.0
26999,2,6999,[125 153 176 271 185],64,2,25529,3.647,0.0,0.0
27000,2,7000,[302 483 100 127 313],232,3,25532,3.646907584630767,20.0,40.0
27001,2,7001,[125  95 427  82 186],374,4,25536,3.6469580119965723,0.0,0.0
27002,2,7002,[174 216 132  15 191],749,5,25541,3.6471512209053265,0.0,20.0
27003,2,7003,[173 313  25 286  22],650,2,25543,3.6469160479725873,0.0,0.0
27004,2,7004,[603  25 228   7 118],650,4,25547,3.6469664525339045,20.0,0.0
27005,2,7005,[302 483 100 127 313],537,5,25552,3.6471595775049956,20.0,40.0
27006,2,7006,[275  89 235  12 483],560,4,25556,3.6472099329242185,40.0,0.0
27007,2,7007,[302 483 100 127 313],90,5,25561,3.6474029680365296,20.0,40.0
27008,2,7008,[597 196 515   4 135],92,4,25565,3.6474532743615353,0.0,0.0
27009,2,7009,[678 202 496  69 186],664,3,25568,3.6473609129814553,0.0,0.0
27010,2,7010,[302 483 100 127 313],13,5,25573,3.6475538439594923,20.0,40.0
27011,2,7011,[515  97 117 172 196],311,5,25578,3.647746719908728,0.0,0.0
27012,2,7012,[405 275  98 318 508],378,4,25582,3.6477969485241695,20.0,20.0
27013,2,7013,[302 483 100 127 313],537,5,25587,3.647989734816082,20.0,40.0
27014,2,7014,[302 483 100 127 313],232,3,25590,3.647897362794013,20.0,40.0
27015,2,7015,[742 181 204 182  82],666,1,25591,3.6475199543899657,0.0,0.0
27016,2,7016,[265 195 302 211 568],543,4,25595,3.6475701866894683,0.0,0.0
27017,2,7017,[508 100 403 117 286],144,4,25599,3.647620404673696,0.0,20.0
27018,2,7018,[222 269 210  15 423],537,0,25599,3.6471007265992306,0.0,0.0
27019,2,7019,[200   7  11 175 197],213,5,25604,3.6472934472934475,0.0,0.0
27020,2,7020,[ 79 235  12 357 515],13,1,25605,3.6469163936761144,40.0,0.0
27021,2,7021,[183 132 273 181 588],59,3,25608,3.646824266590715,0.0,0.0
27022,2,7022,[333 546 237 127  12],666,3,25611,3.6467321657411365,20.0,20.0
27023,2,7023,[151  50 483  22 300],313,3,25614,3.646640091116173,20.0,20.0
27024,2,7024,[176  97 117  11  12],387,1,25615,3.6462633451957296,20.0,0.0
27025,2,7025,[  8 210 228  88  98],892,4,25619,3.6463136920011388,0.0,20.0
27026,2,7026,[302 483 100 127 313],329,5,25624,3.6465063327166645,20.0,40.0
27027,2,7027,[ 56 194 127 200 195],59,4,25628,3.646556630620376,0.0,20.0
27028,2,7028,[302 483 100 127 313],329,5,25633,3.6467491819604496,20.0,40.0
27029,2,7029,[286 186  28 300 275],328,5,25638,3.646941678520626,0.0,0.0
27030,2,7030,[210  79 174 195 176],506,5,25643,3.6471341203242784,0.0,20.0
27031,2,7031,[ 56 191 153 234  28],653,3,25646,3.647042093287827,0.0,0.0
27032,2,7032,[302 483 100 127 313],329,5,25651,3.6472344660884404,20.0,40.0
27033,2,7033,[ 71 175 186 546 211],313,4,25655,3.647284617571794,0.0,0.0
27034,2,7034,[302 483 100 127 313],207,4,25659,3.6473347547974413,20.0,40.0
27035,2,7035,[195  25 357 603 588],14,3,25662,3.6472427515633883,40.0,0.0
27036,2,7036,[302 483 100 127 313],207,4,25666,3.6472928804888447,20.0,40.0
27037,2,7037,[ 98 655  97 174 173],311,5,25671,3.6474850809889174,0.0,40.0
27038,2,7038,[161 318 276 515 127],308,3,25674,3.647393095610172,20.0,20.0
27039,2,7039,[ 56 269  79 301 183],666,4,25678,3.647443181818182,0.0,0.0
27040,2,7040,[181 423 228 294 302],328,3,25681,3.6473512285186764,0.0,0.0
27041,2,7041,[210 228 655  97 294],95,4,25685,3.647401306447032,0.0,0.0
27042,2,7042,[275 172 237  71 196],64,4,25689,3.6474513701547635,0.0,0.0
27043,2,7043,[204 276 172 174 144],119,4,25693,3.647501419647927,0.0,20.0
27044,2,7044,[302 483 100 127 313],232,3,25696,3.6474095102909865,20.0,40.0
27045,2,7045,[216  98 269 508 174],85,2,25698,3.647175702526256,0.0,40.0
27046,2,7046,[ 50 168 200 216 318],59,5,25703,3.6473676741875978,20.0,20.0
27047,2,7047,[ 64 153 196 222  28],378,4,25707,3.647417707150965,0.0,0.0
27048,2,7048,[302 483 100 127 313],90,5,25712,3.6476095900127676,20.0,40.0
27049,2,7049,[302 483 100 127 313],232,3,25715,3.647517730496454,20.0,40.0
27050,2,7050,[302 483 100 127 313],207,4,25719,3.647567720890654,20.0,40.0
27051,2,7051,[302 483 100 127 313],537,5,25724,3.6477595008508223,20.0,40.0
27052,2,7052,[204   4 100 228 183],579,2,25726,3.6475258755139657,0.0,20.0
27053,2,7053,[300 111  82 151  56],537,1,25727,3.6471505528778,0.0,0.0
27054,2,7054,[302 483 100 127 313],329,5,25732,3.6473423104181433,20.0,40.0
27055,2,7055,[405 403  22 204 173],7,4,25736,3.647392290249433,0.0,0.0
27056,2,7056,[195  12 742  97 151],533,3,25739,3.647300552642766,20.0,0.0
27057,2,7057,[176 301 180 234 117],650,3,25742,3.647208841031454,0.0,0.0
27058,2,7058,[302 483 100 127 313],334,5,25747,3.6474004816546253,20.0,40.0
27059,2,7059,[187 508 328  96 546],207,2,25749,3.6471671388101985,0.0,0.0
27060,2,7060,[294 234 603   8 483],533,3,25752,3.6470754850587737,40.0,0.0
27061,2,7061,[  1   7 435  28  79],59,4,25756,3.647125460209572,0.0,0.0
27062,2,7062,[568  56 144 238  64],125,3,25759,3.647033838312332,0.0,0.0
27063,2,7063,[ 97 174 515 182 471],313,5,25764,3.6472253680634203,0.0,20.0
27064,2,7064,[161  28   9  25 508],455,4,25768,3.6472753007784853,0.0,0.0
27065,2,7065,[302 483 100 127 313],328,5,25773,3.6474667421454856,20.0,40.0
27066,2,7066,[435  11 228  71 475],64,4,25777,3.6475166265742183,0.0,0.0
27067,2,7067,[187 153 181 286  96],102,0,25777,3.6470005659309566,0.0,0.0
27068,2,7068,[168 286  50 257 182],95,4,25781,3.647050502192672,0.0,20.0
27069,2,7069,[174 186  12 276  82],385,0,25781,3.6465346534653467,20.0,20.0
27070,2,7070,[183 228  64 238 182],7,5,25786,3.6467260642059114,0.0,0.0
27071,2,7071,[302 483 100 127 313],328,5,25791,3.6469174208144794,20.0,40.0
27072,2,7072,[302 483 100 127 313],537,5,25796,3.647108723314011,20.0,40.0
27073,2,7073,[127 174 173 228  89],643,4,25800,3.64715860899067,0.0,40.0
27074,2,7074,[318   1 211 385 111],653,3,25803,3.6470671378091875,20.0,0.0
27075,2,7075,[302 483 100 127 313],232,3,25806,3.646975692481628,20.0,40.0
27076,2,7076,[475 211  11  28 204],308,4,25810,3.6470255758089585,0.0,0.0
27077,2,7077,[  1 245 125 288 435],378,2,25812,3.6467928793444475,0.0,0.0
27078,2,7078,[302 483 100 127 313],334,5,25817,3.646984037293403,20.0,40.0
27079,2,7079,[  9 269 121 195  89],7,4,25821,3.647033898305085,0.0,0.0
27080,2,7080,[471  96 202 121   1],145,3,25824,3.6469425222426213,0.0,0.0
27081,2,7081,[302 483 100 127 313],232,3,25827,3.6468511719853147,20.0,40.0
27082,2,7082,[125 144  98 132  69],298,4,25831,3.646901030636736,0.0,20.0
27083,2,7083,[302 483 100 127 313],13,5,25836,3.6470920383963863,20.0,40.0
27084,2,7084,[302 483 100 127 313],334,5,25841,3.6472829922371206,20.0,40.0
27085,2,7085,[173 183 143 742  98],92,2,25843,3.6470505221563645,0.0,20.0
27086,2,7086,[ 28 385  11 194 174],207,3,25846,3.646959221109073,0.0,20.0
27087,2,7087,[286  79 228 235   1],788,2,25848,3.646726862302483,0.0,0.0
27088,2,7088,[180 475 435 127  25],343,4,25852,3.646776696290027,0.0,20.0
27089,2,7089,[204 176  82 245 423],804,4,25856,3.6468265162200284,0.0,0.0
27090,2,7090,[265 135   1 748 210],488,4,25860,3.646876322098435,0.0,0.0
27091,2,7091,[302 483 100 127 313],90,5,25865,3.647067117879301,20.0,40.0
27092,2,7092,[117  11 475  82  98],537,1,25866,3.6466939235866347,0.0,20.0
27093,2,7093,[172 200  79 322 135],308,4,25870,3.6467437270933183,0.0,0.0
27094,2,7094,[194 496 483 121 603],897,4,25874,3.6467935165609586,40.0,0.0
27095,2,7095,[117   8  50 127  98],334,4,25878,3.6468432919954905,0.0,60.0
27096,2,7096,[302 483 100 127 313],328,5,25883,3.647033958010427,20.0,40.0
27097,2,7097,[211   4  11 222  96],653,1,25884,3.646661031276416,0.0,0.0
27098,2,7098,[194 197 111 202  96],537,1,25885,3.646288209606987,0.0,0.0
27099,2,7099,[301 204 185   8   4],13,3,25888,3.6461971830985918,0.0,0.0
27100,2,7100,[144 202 269 300 235],378,4,25892,3.6462470074637374,0.0,0.0
27101,2,7101,[179  70 161 183 186],13,3,25895,3.646156012390876,0.0,0.0
27102,2,7102,[143  89 173 742 135],378,4,25899,3.646205828523159,0.0,0.0
27103,2,7103,[176 191 301 333 276],537,2,25901,3.645974099099099,0.0,0.0
27104,2,7104,[153 237 168 546 182],653,0,25901,3.645460942997889,0.0,0.0
27105,2,7105,[ 98 385  88 294 135],308,3,25904,3.6453701097663944,0.0,20.0
27106,2,7106,[748  56  15 179  79],474,4,25908,3.6454200084423807,0.0,0.0
27107,2,7107,[237 216 210 483 175],234,1,25909,3.6450478334271246,20.0,0.0
27108,2,7108,[302 483 100 127 313],90,5,25914,3.6452384301589533,20.0,40.0
27109,2,7109,[143 197 173  79  82],454,4,25918,3.6452883263009843,0.0,0.0
27110,2,7110,[568 117  95 234 222],537,0,25918,3.6447756996203067,0.0,0.0
27111,2,7111,[175 186 483 568 323],59,5,25923,3.6449662542182226,20.0,0.0
27112,2,7112,[471  25  28 289 302],474,3,25926,3.644875579924083,0.0,0.0
27113,2,7113,[168  70 597 403 173],7,3,25929,3.6447849311217317,0.0,0.0
27114,2,7114,[302 483 100 127 313],537,5,25934,3.644975404075896,20.0,40.0
27115,2,7115,[ 89 196 183  50 568],538,4,25938,3.6450252951096123,0.0,20.0
27116,2,7116,[302 483 100 127 313],537,5,25943,3.645215680764367,20.0,40.0
27117,2,7117,[ 64 179 210 180 161],13,3,25946,3.6451250351222253,0.0,0.0
27118,2,7118,[302 483 100 127 313],334,5,25951,3.645315353279955,20.0,40.0
27119,2,7119,[179  82 568 191 196],387,3,25954,3.645224719101124,0.0,0.0
27120,2,7120,[204 121 202 300 197],666,2,25956,3.6449936806628283,0.0,0.0
27121,2,7121,[222 161 181 282 405],479,4,25960,3.6450435270991295,0.0,0.0
27122,2,7122,[211 496 117  50 385],454,2,25962,3.6448125789695354,0.0,20.0
27123,2,7123,[302 483 100 127 313],90,5,25967,3.6450028074115663,20.0,40.0
27124,2,7124,[  7 483  56 288 228],59,5,25972,3.64519298245614,20.0,0.0
27125,2,7125,[265 435 655   7  82],339,4,25976,3.6452427729441483,0.0,0.0
27126,2,7126,[ 22 385 275 179 597],7,4,25980,3.6452925494598007,0.0,0.0
27127,2,7127,[186  11  69 179  22],308,4,25984,3.6453423120089785,0.0,0.0
27128,2,7128,[151 191 210 333  50],666,1,25985,3.644971244213775,0.0,20.0
27129,2,7129,[302 483 100 127 313],329,5,25990,3.6451612903225805,20.0,40.0
27130,2,7130,[302 483 100 127 313],474,5,25995,3.6453512831299957,20.0,40.0
27131,2,7131,[228 127 318 210 180],13,3,25998,3.645260796410544,20.0,20.0
27132,2,7132,[302 483 100 127 313],537,5,26003,3.645450721996355,20.0,40.0
27133,2,7133,[125 237 191 276 121],554,2,26005,3.645220072890384,0.0,0.0
27134,2,7134,[302 483 100 127 313],328,5,26010,3.6454099509460405,20.0,40.0
27135,2,7135,[302 483 100 127 313],207,4,26014,3.6454596412556053,20.0,40.0
27136,2,7136,[271 294 742 196  22],119,4,26018,3.645509317640465,0.0,0.0
27137,2,7137,[ 22 288 423 195   8],308,5,26023,3.6456990753712524,0.0,0.0
27138,2,7138,[302 483 100 127 313],334,5,26028,3.6458887799411683,20.0,40.0
27139,2,7139,[222 182 100   9 228],339,5,26033,3.646078431372549,0.0,20.0
27140,2,7140,[121 111 294 182  50],479,4,26037,3.6461279932782524,0.0,20.0
27141,2,7141,[211 204 210  79   8],194,2,26039,3.645897507700924,0.0,0.0
27142,2,7142,[183 117 202 423  12],374,3,26042,3.645807083858323,20.0,0.0
27143,2,7143,[ 70 179 202 168 176],374,2,26044,3.6455767077267636,0.0,0.0
27144,2,7144,[385 111 117 161 237],13,3,26047,3.645486354093772,0.0,0.0
27145,2,7145,[210 597 172  89 118],137,5,26052,3.645675902602855,0.0,0.0
27146,2,7146,[182 180 357 678 194],213,5,26057,3.64586539806912,20.0,0.0
27147,2,7147,[204 483 268 135 195],537,3,26060,3.645775041969782,20.0,0.0
27148,2,7148,[515  12  89   4 132],334,3,26063,3.6456847111484123,20.0,0.0
27149,2,7149,[471 405 111 200 328],653,2,26065,3.6454545454545455,0.0,0.0
27150,2,7150,[237 211 276  64 318],234,2,26067,3.6452244441336874,20.0,0.0
27151,2,7151,[302 483 100 127 313],537,5,26072,3.645413870246085,20.0,40.0
27152,2,7152,[302 483 100 127 313],90,5,26077,3.64560324339438,20.0,40.0
27153,2,7153,[151 234  28 568 191],379,5,26082,3.6457925636007826,0.0,0.0
27154,2,7154,[302 483 100 127 313],474,5,26087,3.645981830887491,20.0,40.0
27155,2,7155,[191 294 475 313 173],13,1,26088,3.645612073784237,0.0,0.0
27156,2,7156,[143 202 222 173 265],537,1,26089,3.6452424200083833,0.0,0.0
27157,2,7157,[ 98  82 195 127 237],85,2,26091,3.6450125733445096,0.0,40.0
27158,2,7158,[302 483 100 127 313],13,5,26096,3.6452018438329374,20.0,40.0
27159,2,7159,[302 483 100 127 313],207,4,26100,3.6452513966480447,20.0,40.0
27160,2,7160,[ 12 176 127 289 597],328,4,26104,3.645300935623516,20.0,20.0
27161,2,7161,[302 483 100 127 313],232,3,26107,3.645210834962301,20.0,40.0
27162,2,7162,[228 318 211 385 181],313,4,26111,3.6452603657685327,20.0,0.0
27163,2,7163,[100 175 125 238 180],6,4,26115,3.6453098827470685,0.0,20.0
27164,2,7164,[117  56 288   9 173],92,3,26118,3.6452198185624565,0.0,0.0
27165,2,7165,[195 222 143  50  79],454,4,26122,3.645269327379291,0.0,20.0
27166,2,7166,[135   1 286 143 265],13,2,26124,3.645039765592298,0.0,0.0
27167,2,7167,[289 258  25 508 237],474,3,26127,3.6449497767857144,0.0,0.0
27168,2,7168,[ 95 300 568  82 117],749,4,26131,3.6449993025526575,0.0,0.0
27169,2,7169,[ 22  82 286 191 172],334,4,26135,3.6450488145048814,0.0,0.0
27170,2,7170,[385 211 357 210 258],59,4,26139,3.6450983126481664,20.0,0.0
27171,2,7171,[302 483 100 127 313],537,5,26144,3.645287228109314,20.0,40.0
27172,2,7172,[483 175 196 496 153],840,4,26148,3.645336679213718,20.0,0.0
27173,2,7173,[151 385 144 194 127],95,5,26153,3.6455255087817116,0.0,20.0
27174,2,7174,[276 245  64 282   8],458,3,26156,3.6454355400696863,0.0,0.0
27175,2,7175,[ 56 125 742 176 200],92,3,26159,3.645345596432553,0.0,0.0
27176,2,7176,[294 173  97 496 300],666,3,26162,3.64525567785983,0.0,0.0
27177,2,7177,[268 179   1  11 265],92,5,26167,3.6454444134856505,0.0,0.0
27178,2,7178,[180 276 185 235 216],271,2,26169,3.6452152110321774,0.0,0.0
27179,2,7179,[ 50 195  71 294 186],387,2,26171,3.6449860724233982,0.0,20.0
27180,2,7180,[182  71 300 117 197],234,1,26172,3.644617741261663,0.0,0.0
27181,2,7181,[302 483 100 127 313],13,5,26177,3.6448064605959343,20.0,40.0
27182,2,7182,[302 483 100 127 313],474,5,26182,3.6449951273841013,20.0,40.0
27183,2,7183,[168 288 405 121  96],102,0,26182,3.644487750556793,0.0,0.0
27184,2,7184,[200  88 194 228 191],506,5,26187,3.644676409185804,0.0,0.0
27185,2,7185,[211 125 187 135 186],6,4,26191,3.644725855830782,0.0,0.0
27186,2,7186,[181 195 210 222 196],506,5,26196,3.6449144288298316,0.0,0.0
27187,2,7187,[237  50  56 276 322],308,3,26199,3.6448247078464107,0.0,20.0
27188,2,7188,[183 603 200 215 173],643,3,26202,3.6447350118236193,20.0,0.0
27189,2,7189,[318 153 427 471 300],454,3,26205,3.644645340751043,20.0,0.0
27190,2,7190,[302 483 100 127 313],334,5,26210,3.6448338200528436,20.0,40.0
27191,2,7191,[483 216 405 204  96],13,3,26213,3.6447441601779755,20.0,0.0
27192,2,7192,[135 222 194 183  88],537,1,26214,3.644376477130544,0.0,0.0
27193,2,7193,[302 483 100 127 313],329,5,26219,3.644564915207117,20.0,40.0
27194,2,7194,[187 195 742   4 515],804,5,26224,3.644753300903405,0.0,0.0
27195,2,7195,[ 69 186 181 286  64],85,4,26228,3.6448026681489716,0.0,0.0
27196,2,7196,[100 121  96   4  56],538,3,26231,3.644713074892316,0.0,20.0
27197,2,7197,[423  69 483  12 237],308,2,26233,3.644484579049736,40.0,0.0
27198,2,7198,[222 742 183  28  69],788,3,26236,3.6443950548687316,0.0,0.0
27199,2,7199,[153 328 183 175 174],749,4,26240,3.6444444444444444,0.0,20.0
27200,2,7200,[174 508  96 185 195],774,0,26240,3.6439383418969586,0.0,20.0
27201,2,7201,[302 483 100 127 313],537,5,26245,3.6441266314912526,20.0,40.0
27202,2,7202,[210  98  70 286 196],334,3,26248,3.6440372067194224,0.0,20.0
27203,2,7203,[151 234 185  88 144],479,5,26253,3.644225430316491,0.0,0.0
27204,2,7204,[210 655 742 186 678],749,4,26257,3.644274809160305,0.0,0.0
27205,2,7205,[302 483 100 127 313],329,5,26262,3.6444629475437136,20.0,40.0
27206,2,7206,[111 168 194 471 234],13,4,26266,3.6445122797280423,0.0,0.0
27207,2,7207,[  7 200 132 328 318],804,4,26270,3.6445615982241955,20.0,0.0
27208,2,7208,[423   8 197 228 117],194,1,26271,3.644194756554307,0.0,0.0
27209,2,7209,[302 483 100 127 313],329,5,26276,3.644382801664355,20.0,40.0
27210,2,7210,[405  11 172 173  71],897,3,26279,3.6442934405768965,0.0,0.0
27211,2,7211,[ 97 181   7 135  25],7,3,26282,3.64420410427066,0.0,0.0
27212,2,7212,[273 204 423 323 202],537,0,26282,3.643698877027589,0.0,0.0
27213,2,7213,[186 271 258 195  98],92,4,26286,3.6437482672581094,0.0,20.0
27214,2,7214,[302 483 100 127 313],232,3,26289,3.6436590436590435,20.0,40.0
27215,2,7215,[333 222 276 508 655],334,4,26293,3.6437084257206207,0.0,0.0
27216,2,7216,[196   1  97  28 172],59,4,26297,3.6437577940972705,0.0,0.0
27217,2,7217,[322  64 216 245 182],90,3,26300,3.6436686062621226,0.0,0.0
27218,2,7218,[ 96 186  95  88 117],374,4,26304,3.6437179664773516,0.0,0.0
27219,2,7219,[211 496 144  88 125],194,3,26307,3.643628808864266,0.0,0.0
27220,2,7220,[603  25 176  82 195],13,1,26308,3.6432627059963996,20.0,0.0
27221,2,7221,[172  88 182  98  64],892,5,26313,3.6434505677097757,0.0,20.0
27222,2,7222,[322 187  64 496 180],90,5,26318,3.64363837740551,0.0,0.0
27223,2,7223,[238 265 588 237 655],804,5,26323,3.643826135105205,0.0,0.0
27224,2,7224,[302 483 100 127 313],537,5,26328,3.64401384083045,20.0,40.0
27225,2,7225,[302 483 100 127 313],334,5,26333,3.644201494602823,20.0,40.0
27226,2,7226,[125 228  71 318  15],234,1,26334,3.643835616438356,20.0,0.0
27227,2,7227,[111 175  79 127 273],158,4,26338,3.643884892086331,0.0,20.0
27228,2,7228,[  9  79 111 195 483],59,5,26343,3.644072485820999,20.0,0.0
27229,2,7229,[ 98  69  70 179  56],664,3,26346,3.6439834024896265,0.0,20.0
27230,2,7230,[302 483 100 127 313],329,5,26351,3.644170930714977,20.0,40.0
27231,2,7231,[655   4 176 216 568],804,5,26356,3.644358407079646,0.0,0.0
27232,2,7232,[111  95 435 588  98],537,0,26356,3.6438545555094706,0.0,20.0
27233,2,7233,[111 301 215 273  28],13,3,26359,3.643765551562068,0.0,0.0
27234,2,7234,[151 180 181 194 161],7,3,26362,3.643676572218383,0.0,0.0
27235,2,7235,[ 28  82 100   1 234],488,3,26365,3.6435876174682145,0.0,20.0
27236,2,7236,[483 143 195  15 173],406,3,26368,3.643498687301368,20.0,0.0
27237,2,7237,[286 294 333 179 265],387,2,26370,3.643271621995026,0.0,0.0
27238,2,7238,[515 496 228  82 423],313,3,26373,3.6431827600497306,0.0,0.0
27239,2,7239,[427  88 546 132 210],13,3,26376,3.643093922651934,0.0,0.0
27240,2,7240,[423  64 132 161  79],234,3,26379,3.6430051097914653,0.0,0.0
27241,2,7241,[196  89 144  97   7],308,2,26381,3.6427782380557856,0.0,0.0
27242,2,7242,[302 483 100 127 313],537,5,26386,3.6429656219798425,20.0,40.0
27243,2,7243,[118 568 174 748 173],200,4,26390,3.643014908890116,0.0,20.0
27244,2,7244,[302 483 100 127 313],537,5,26395,3.6432022084196,20.0,40.0
27245,2,7245,[211   8  50 257 282],474,4,26399,3.643251449075352,0.0,20.0
27246,2,7246,[135 237  97  15  25],82,1,26400,3.6428867117427903,0.0,0.0
27247,2,7247,[385 496 423 435 603],899,3,26403,3.642798013245033,20.0,0.0
27248,2,7248,[ 98 175 182 143 515],7,3,26406,3.6427093392192025,0.0,20.0
27249,2,7249,[302 483 100 127 313],537,5,26411,3.642896551724138,20.0,40.0
27250,2,7250,[185 237 204 121  28],694,5,26416,3.6430837125913667,0.0,0.0
27251,2,7251,[174 289  96 211 275],883,5,26421,3.6432708218422505,0.0,20.0
27252,2,7252,[302 483 100 127 313],474,5,26426,3.6434578794981385,20.0,40.0
27253,2,7253,[125 742 179 187 194],881,4,26430,3.643507030603805,0.0,0.0
27254,2,7254,[302 483 100 127 313],90,5,26435,3.6436940041350794,20.0,40.0
27255,2,7255,[302 483 100 127 313],474,5,26440,3.643880926130099,20.0,40.0
27256,2,7256,[302 483 100 127 313],329,5,26445,3.6440677966101696,20.0,40.0
27257,2,7257,[300 271 268  25  88],145,3,26448,3.643979057591623,0.0,0.0
27258,2,7258,[135 181 265 322 161],207,1,26449,3.6436148229783716,0.0,0.0
27259,2,7259,[275 258 121 385  64],343,3,26452,3.643526170798898,0.0,0.0
27260,2,7260,[194 273 483 210 100],385,2,26454,3.6432998209613,20.0,20.0
27261,2,7261,[ 64 195 318 588 210],406,5,26459,3.6434866427981274,20.0,0.0
27262,2,7262,[302 483 100 127 313],13,5,26464,3.643673413190142,20.0,40.0
27263,2,7263,[588 273 222 118 282],479,3,26467,3.6435848017621146,0.0,0.0
27264,2,7264,[302 483 100 127 313],334,5,26472,3.643771507226428,20.0,40.0
27265,2,7265,[ 79  89 271  71 180],650,1,26473,3.643407652078172,0.0,0.0
27266,2,7266,[546 215 268 748 288],13,3,26476,3.6433191138021193,0.0,0.0
27267,2,7267,[357  96  28 125   4],804,5,26481,3.6435057787561913,20.0,0.0
27268,2,7268,[302 483 100 127 313],328,5,26486,3.64369239235108,20.0,40.0
27269,2,7269,[168 328 132  56  88],653,2,26488,3.6434662998624483,0.0,0.0
27270,2,7270,[288 100 508 204 385],833,2,26490,3.6432402695640214,0.0,20.0
27271,2,7271,[302 483 100 127 313],334,5,26495,3.6434268426842684,20.0,40.0
27272,2,7272,[175 313 185  22 237],90,4,26499,3.643475869654888,0.0,0.0
27273,2,7273,[ 22 265 183 202  50],738,4,26503,3.6435248831454494,0.0,20.0
27274,2,7274,[302 483 100 127 313],474,5,26508,3.6437113402061856,20.0,40.0
27275,2,7275,[ 82 588 403  71  95],650,0,26508,3.6432105552501373,0.0,0.0
27276,2,7276,[302 483 100 127 313],328,5,26513,3.6433970042599975,20.0,40.0
27277,2,7277,[323 210 161 186  71],506,4,26517,3.6434460016488046,0.0,0.0
27278,2,7278,[117 318 125 235 172],648,2,26519,3.643220222558044,20.0,0.0
27279,2,7279,[ 25 427 135 172 318],452,3,26522,3.643131868131868,20.0,0.0
27280,2,7280,[282  70 273  96 475],374,3,26525,3.643043537975553,0.0,0.0
27281,2,7281,[ 71 216 161 183 173],7,4,26529,3.643092556989838,0.0,0.0
27282,2,7282,[302 483 100 127 313],328,5,26534,3.643278868598105,20.0,40.0
27283,2,7283,[191  97 186 228 496],537,3,26537,3.6431905546403076,0.0,0.0
27284,2,7284,[ 82 183 588  11 100],234,2,26539,3.642964996568291,0.0,20.0
27285,2,7285,[273 183 258  88  79],102,2,26541,3.6427395004117487,0.0,0.0
27286,2,7286,[ 28 191 183 195 483],312,5,26546,3.6429257581995333,20.0,0.0
27287,2,7287,[748 202   4 127 265],653,3,26549,3.6428375411635567,0.0,20.0
27288,2,7288,[302 483 100 127 313],474,5,26554,3.643023734394293,20.0,40.0
27289,2,7289,[385 187 216 423 174],479,2,26556,3.642798353909465,0.0,20.0
27290,2,7290,[  9 435 172 403 194],328,3,26559,3.6427101906460018,0.0,0.0
27291,2,7291,[117 483 603 202   1],749,5,26564,3.6428963247394406,40.0,0.0
27292,2,7292,[302 483 100 127 313],207,4,26568,3.6429452900041137,20.0,40.0
27293,2,7293,[186  50 175 143  28],666,1,26569,3.642582944886208,0.0,20.0
27294,2,7294,[121 173  95 427  28],13,4,26573,3.6426319396847155,0.0,0.0
27295,2,7295,[257  98 187 276 180],308,4,26577,3.6426809210526314,0.0,20.0
27296,2,7296,[385 496 144 179 173],379,4,26581,3.642729888995478,0.0,0.0
27297,2,7297,[302 483 100 127 313],329,5,26586,3.6429158673609208,20.0,40.0
27298,2,7298,[196  89 182  88 238],774,2,26588,3.6426907795588437,0.0,0.0
27299,2,7299,[187 132 328 222 118],533,5,26593,3.6428767123287673,0.0,0.0
27300,2,7300,[302 483 100 127 313],328,5,26598,3.643062594165183,20.0,40.0
27301,2,7301,[181 216 117 185 237],406,3,26601,3.642974527526705,0.0,0.0
27302,2,7302,[172  69 597 181 118],374,3,26604,3.6428864850061617,0.0,0.0
27303,2,7303,[302 483 100 127 313],334,5,26609,3.6430722891566263,20.0,40.0
27304,2,7304,[302 483 100 127 313],90,5,26614,3.6432580424366874,20.0,40.0
27305,2,7305,[257 475 300 111 405],294,4,26618,3.6433068710648784,0.0,0.0
27306,2,7306,[144 173  25 216 186],13,2,26620,3.6430819761872177,0.0,0.0
27307,2,7307,[271   8  96  95  82],940,4,26624,3.6431308155446085,0.0,0.0
27308,2,7308,[302 483 100 127 313],232,3,26627,3.6430428239157204,20.0,40.0
27309,2,7309,[302 483 100 127 313],90,5,26632,3.6432284541723665,20.0,40.0
27310,2,7310,[121 318 300  11 515],13,1,26633,3.6428669128710163,20.0,0.0
27311,2,7311,[ 22 194 100 475 182],474,5,26638,3.6430525164113785,0.0,20.0
27312,2,7312,[144  64 204   1 235],738,4,26642,3.643101326405032,0.0,0.0
27313,2,7313,[302 483 100 127 313],329,5,26647,3.6432868471424666,20.0,40.0
27314,2,7314,[435 265  50 568  98],290,3,26650,3.643198906356801,0.0,40.0
27315,2,7315,[302 483 100 127 313],207,4,26654,3.643247676325861,20.0,40.0
27316,2,7316,[302 483 100 127 313],334,5,26659,3.643433100997677,20.0,40.0
27317,2,7317,[257 174 181  64  95],749,3,26662,3.6433451762776716,0.0,20.0
27318,2,7318,[234 132 258  98   8],271,4,26666,3.6433939062713487,0.0,20.0
27319,2,7319,[234 742 508 211 194],533,4,26670,3.6434426229508197,0.0,0.0
27320,2,7320,[211 222 210  50   4],234,2,26672,3.6432181395984156,0.0,20.0
27321,2,7321,[475 288 174 275 121],14,3,26675,3.6431302922698716,0.0,20.0
27322,2,7322,[294 271 200 471  97],537,0,26675,3.642632800764714,0.0,0.0
27323,2,7323,[302 483 100 127 313],232,3,26678,3.6425450573457128,20.0,40.0
27324,2,7324,[174 180 181  22  95],380,3,26681,3.642457337883959,0.0,20.0
27325,2,7325,[385 588 323 265 210],537,0,26681,3.641960141960142,0.0,0.0
27326,2,7326,[302 483 100 127 313],13,5,26686,3.6421454892862015,20.0,40.0
27327,2,7327,[  8 173  56 135   4],234,3,26689,3.6420578602620086,0.0,0.0
27328,2,7328,[ 50 195  22 118 748],648,4,26693,3.6421066994132896,0.0,20.0
27329,2,7329,[435 118 294 172 186],13,4,26697,3.6421555252387448,0.0,0.0
27330,2,7330,[289 182 121 187 405],13,3,26700,3.6420679307052244,0.0,0.0
27331,2,7331,[286 483 186 185 288],329,2,26702,3.641843971631206,20.0,0.0
27332,2,7332,[302 483 100 127 313],13,5,26707,3.6420291831446883,20.0,40.0
27333,2,7333,[ 71 546 118 235 191],83,2,26709,3.641805290428143,0.0,0.0
27334,2,7334,[135 196 742 405 423],666,1,26710,3.641445126107703,0.0,0.0
27335,2,7335,[ 97 176 265 180 318],380,1,26711,3.64108505997819,20.0,0.0
27336,2,7336,[187 238 257  79  71],650,1,26712,3.640725091999455,0.0,0.0
27337,2,7337,[302 483 100 127 313],334,5,26717,3.6409103297901337,20.0,40.0
27338,2,7338,[302 483 100 127 313],13,5,26722,3.6410955171004225,20.0,40.0
27339,2,7339,[302 483 100 127 313],329,5,26727,3.6412806539509535,20.0,40.0
27340,2,7340,[202 211  50 435 168],59,5,26732,3.6414657403623485,0.0,20.0
27341,2,7341,[191   8 204 483 435],536,4,26736,3.6415145736856442,20.0,0.0
27342,2,7342,[ 11 216 194 204 202],892,4,26740,3.6415633937082936,0.0,0.0
27343,2,7343,[403  89 435 237 118],328,3,26743,3.6414760348583877,0.0,0.0
27344,2,7344,[ 12 202 405 183 181],833,3,26746,3.6413886997957796,20.0,0.0
27345,2,7345,[ 50 172  82  28 118],804,5,26751,3.641573645521372,0.0,20.0
27346,2,7346,[302 483 100 127 313],474,5,26756,3.6417585409010482,20.0,40.0
27347,2,7347,[ 88  79  70 546 268],234,0,26756,3.641262928688078,0.0,0.0
27348,2,7348,[588  56   9 435  82],308,5,26761,3.641447816029392,0.0,0.0
27349,2,7349,[132  69  70 186 143],312,4,26765,3.641496598639456,0.0,0.0
27350,2,7350,[282  15 216 286  69],881,2,26767,3.6412732961501835,0.0,0.0
27351,2,7351,[204 275  88 210 194],60,5,26772,3.6414581066376495,0.0,0.0
27352,2,7352,[185 222 328   1 204],537,1,26773,3.64109887120903,0.0,0.0
27353,2,7353,[132 197 210 181 143],184,4,26777,3.6411476747348384,0.0,0.0
27354,2,7354,[180  71  88 143 483],308,4,26781,3.641196464989803,20.0,0.0
27355,2,7355,[179  96 200 328 180],378,1,26782,3.6408374116367592,0.0,0.0
27356,2,7356,[151 357   4 181  11],339,5,26787,3.641022155770015,20.0,0.0
27357,2,7357,[302 483 100 127 313],328,5,26792,3.641206849687415,20.0,40.0
27358,2,7358,[275 216  12 265 172],524,2,26794,3.6409838293246364,20.0,0.0
27359,2,7359,[ 12 211 276   9 258],474,5,26799,3.6411684782608695,20.0,0.0
27360,2,7360,[302 483 100 127 313],90,5,26804,3.6413530770275777,20.0,40.0
27361,2,7361,[313   9 234 204  69],200,5,26809,3.641537625645205,0.0,0.0
27362,2,7362,[ 69 181 186  15 191],378,3,26812,3.6414504957218523,0.0,0.0
27363,2,7363,[603   8 222  96 151],897,4,26816,3.641499185225421,20.0,0.0
27364,2,7364,[483 118 403 235 210],650,2,26818,3.641276306856755,20.0,0.0
27365,2,7365,[302 483 100 127 313],537,5,26823,3.641460765680152,20.0,40.0
27366,2,7366,[222 235 471  82   9],92,3,26826,3.6413736934980316,0.0,0.0
27367,2,7367,[197  12   9 117 289],194,3,26829,3.64128664495114,20.0,0.0
27368,2,7368,[186   4  15 121  69],207,4,26833,3.6413353236531414,0.0,0.0
27369,2,7369,[135 215 435 234 200],13,4,26837,3.6413839891451834,0.0,0.0
27370,2,7370,[211 183 403 135 186],325,2,26839,3.6411613078279745,0.0,0.0
27371,2,7371,[ 96 294 176 196  97],479,3,26842,3.641074335322843,0.0,0.0
27372,2,7372,[194  15 294  28 132],234,3,26845,3.640987386409874,0.0,0.0
27373,2,7373,[265 288 403 515 435],59,5,26850,3.6411716842961757,0.0,0.0
27374,2,7374,[168 588 603  82 597],804,4,26854,3.6412203389830506,20.0,0.0
27375,2,7375,[273 286 195 151 228],59,3,26857,3.641133405639913,0.0,0.0
27376,2,7376,[197  95  88 678 196],881,1,26858,3.6407753829469973,0.0,0.0
27377,2,7377,[182 286 237 435 405],537,1,26859,3.640417457305503,0.0,0.0
27378,2,7378,[302 483 100 127 313],474,5,26864,3.6406017075484485,20.0,40.0
27379,2,7379,[ 25 121  15  97 483],406,4,26868,3.640650406504065,20.0,0.0
27380,2,7380,[302 483 100 127 313],329,5,26873,3.6408345752608047,20.0,40.0
27381,2,7381,[200 197 168 182 357],13,3,26876,3.6407477648333786,20.0,0.0
27382,2,7382,[ 56 121 187 143 269],343,4,26880,3.6407964242177977,0.0,0.0
27383,2,7383,[ 22 183  11 222 483],234,3,26883,3.6407096424702057,20.0,0.0
27384,2,7384,[ 97 678 546 186 216],339,3,26886,3.64062288422478,0.0,0.0
27385,2,7385,[195 271  95  98 568],102,3,26889,3.640536149471974,0.0,20.0
27386,2,7386,[235 181 423  79 182],64,5,26894,3.640720184107215,0.0,0.0
27387,2,7387,[302 483 100 127 313],537,5,26899,3.640904168922577,20.0,40.0
27388,2,7388,[175 403 211 111 234],479,4,26903,3.6409527676275544,0.0,0.0
27389,2,7389,[117  56   1 194 185],194,4,26907,3.641001353179973,0.0,0.0
27390,2,7390,[127 182 153 174  25],374,5,26912,3.641185225273982,0.0,40.0
27391,2,7391,[153 211 238 121 286],650,3,26915,3.641098484848485,0.0,0.0
27392,2,7392,[ 50  25 117 144 357],892,5,26920,3.6412822940619507,20.0,20.0
27393,2,7393,[302 483 100 127 313],474,5,26925,3.641466053556938,20.0,40.0
27394,2,7394,[302 483 100 127 313],537,5,26930,3.6416497633536173,20.0,40.0
27395,2,7395,[302 483 100 127 313],328,5,26935,3.6418334234721472,20.0,40.0
27396,2,7396,[168 275 282   9  56],334,5,26940,3.6420170339326754,0.0,0.0
27397,2,7397,[176  28  96 405 435],881,3,26943,3.6419302514193026,0.0,0.0
27398,2,7398,[127 475  71 357 111],82,3,26946,3.641843492363833,20.0,20.0
27399,2,7399,[302 483 100 127 313],329,5,26951,3.642027027027027,20.0,40.0
27400,2,7400,[ 82 238 111 174 237],454,3,26954,3.6419402783407646,0.0,20.0
27401,2,7401,[435 121 181 195 185],210,5,26959,3.6421237503377464,0.0,0.0
27402,2,7402,[427   1 403 151 546],536,2,26961,3.6419019316493313,0.0,0.0
27403,2,7403,[302 483 100 127 313],328,5,26966,3.6420853592652622,20.0,40.0
27404,2,7404,[  7 200 204 222  96],653,3,26969,3.641998649561107,0.0,0.0
27405,2,7405,[302 483 100 127 313],474,5,26974,3.6421820145827706,20.0,40.0
27406,2,7406,[302 483 100 127 313],207,4,26978,3.642230322667747,20.0,40.0
27407,2,7407,[ 97  79 265 186 100],387,3,26981,3.6421436285097193,0.0,20.0
27408,2,7408,[302 483 100 127 313],13,5,26986,3.642326899716561,20.0,40.0
27409,2,7409,[210 194 182 117  96],158,4,26990,3.642375168690958,0.0,0.0
27410,2,7410,[175 132 135 215  89],524,2,26992,3.64215355552557,0.0,0.0
27411,2,7411,[302 196 235 204  56],537,2,26994,3.6419320021586614,0.0,0.0
27412,2,7412,[313  15 215 301 496],537,2,26996,3.6417105085660326,0.0,0.0
27413,2,7413,[603 313 172 269 180],650,4,27000,3.641758834637173,20.0,0.0
27414,2,7414,[127   7 172 204  69],7,5,27005,3.641942009440324,0.0,20.0
27415,2,7415,[28  1  9 22 25],271,3,27008,3.6418554476806904,0.0,0.0
27416,2,7416,[302 483 100 127 313],328,5,27013,3.6420385600647163,20.0,40.0
27417,2,7417,[302 483 100 127 313],232,3,27016,3.6419520086276624,20.0,40.0
27418,2,7418,[ 22 211 195 288 423],13,3,27019,3.6418654805229815,0.0,0.0
27419,2,7419,[357 216 234   1 200],379,5,27024,3.6420485175202155,20.0,0.0
27420,2,7420,[238 423 288 187 161],650,1,27025,3.641692494273009,0.0,0.0
27421,2,7421,[168  22 273 127 427],234,3,27028,3.6416060361088656,0.0,20.0
27422,2,7422,[151   4 216  79 222],295,5,27033,3.6417890340832546,0.0,0.0
27423,2,7423,[302 483 100 127 313],207,4,27037,3.6418372844827585,20.0,40.0
27424,2,7424,[403  64 271 195  25],13,1,27038,3.6414814814814815,0.0,0.0
27425,2,7425,[181 257 174 111   4],378,3,27041,3.641395098303259,0.0,20.0
27426,2,7426,[302 483 100 127 313],334,5,27046,3.6415780261209103,20.0,40.0
27427,2,7427,[328  89  96 403 175],13,3,27049,3.6414916532040924,0.0,0.0
27428,2,7428,[302 483 100 127 313],474,5,27054,3.6416745187777626,20.0,40.0
27429,2,7429,[302 483 100 127 313],474,5,27059,3.64185733512786,20.0,40.0
27430,2,7430,[237 135 294 215 471],605,2,27061,3.641636388103889,0.0,0.0
27431,2,7431,[ 12   9 328 597 235],328,3,27064,3.6415500538213132,20.0,0.0
27432,2,7432,[175 117 153 135  22],378,3,27067,3.641463742768734,0.0,0.0
27433,2,7433,[235  96  50 181  89],13,4,27071,3.6415119720204467,0.0,20.0
27434,2,7434,[191   7 204 588  28],95,4,27075,3.641560188298588,0.0,0.0
27435,2,7435,[275  88 508 302  28],13,3,27078,3.64147391070468,0.0,0.0
27436,2,7436,[435 385 176   1  95],537,0,27078,3.6409842678499396,0.0,0.0
27437,2,7437,[ 79 385  96 423 197],311,5,27083,3.6411669803710676,0.0,0.0
27438,2,7438,[269 423  96  79  69],659,4,27087,3.6412152170990724,0.0,0.0
27439,2,7439,[302 483 100 127 313],334,5,27092,3.6413978494623658,20.0,40.0
27440,2,7440,[603 121 275  70 174],537,3,27095,3.641311651659723,20.0,20.0
27441,2,7441,[302 483 100 127 313],474,5,27100,3.6414942219833377,20.0,40.0
27442,2,7442,[202 546  97 161   4],271,3,27103,3.6414080343947335,0.0,0.0
27443,2,7443,[271 196 475 300 385],119,5,27108,3.6415905427189683,0.0,0.0
27444,2,7444,[ 82  25 191   8  50],378,5,27113,3.641773002014775,0.0,20.0
27445,2,7445,[302 483 100 127 313],334,5,27118,3.641955412301907,20.0,40.0
27446,2,7446,[302 483 100 127 313],207,4,27122,3.642003491338794,20.0,40.0
27447,2,7447,[271 508 235 273 313],144,3,27125,3.6419172932330826,0.0,0.0
27448,2,7448,[302 483 100 127 313],207,4,27129,3.6419653644784535,20.0,40.0
27449,2,7449,[258 302  98 435 222],666,4,27133,3.642013422818792,0.0,20.0
27450,2,7450,[  4  15 655 216  56],406,2,27135,3.6417930479130316,0.0,0.0
27451,2,7451,[168 135 196  56  98],271,3,27138,3.64170692431562,0.0,20.0
27452,2,7452,[135 153 173  12 200],13,3,27141,3.6416208238293306,20.0,0.0
27453,2,7453,[302 483 100 127 313],90,5,27146,3.641803058760397,20.0,40.0
27454,2,7454,[286 197 323  25 423],650,1,27147,3.6414486921529177,0.0,0.0
27455,2,7455,[ 89 245 228  96 385],197,4,27151,3.64149678111588,0.0,0.0
27456,2,7456,[302 483 100 127 313],232,3,27154,3.6414107549953063,20.0,40.0
27457,2,7457,[302 483 100 127 313],232,3,27157,3.641324751944221,20.0,40.0
27458,2,7458,[302 483 100 127 313],232,3,27160,3.6412387719533448,20.0,40.0
27459,2,7459,[302 483 100 127 313],537,5,27165,3.64142091152815,20.0,40.0
27460,2,7460,[182 276  69  95 151],308,4,27169,3.641468971987669,0.0,0.0
27461,2,7461,[ 28 204  70 385  98],308,3,27172,3.6413830072366657,0.0,20.0
27462,2,7462,[427  50 276 385 357],537,4,27176,3.6414310598954844,20.0,20.0
27463,2,7463,[302 483 100 127 313],207,4,27180,3.6414790996784565,20.0,40.0
27464,2,7464,[173   1  15 196 144],479,4,27184,3.641527126590757,0.0,0.0
27465,2,7465,[302 483 100 127 313],329,5,27189,3.6417090811679613,20.0,40.0
27466,2,7466,[302 483 100 127 313],232,3,27192,3.641623141824026,20.0,40.0
27467,2,7467,[215  25 100 385 151],313,3,27195,3.6415372254954472,0.0,20.0
27468,2,7468,[185 181 153 121  97],339,4,27199,3.6415852189048064,0.0,0.0
27469,2,7469,[357 182  79 172 100],892,5,27204,3.6417670682730923,20.0,20.0
27470,2,7470,[ 25 172 179 403 204],387,2,27206,3.6415473162896532,0.0,0.0
27471,2,7471,[  8 257 191 174  69],95,5,27211,3.6417291220556747,0.0,20.0
27472,2,7472,[172 234 515 222 121],455,4,27215,3.6417770640974174,0.0,0.0
27473,2,7473,[302 483 100 127 313],334,5,27220,3.641958790473642,20.0,40.0
27474,2,7474,[302 483 100 127 313],329,5,27225,3.6421404682274248,20.0,40.0
27475,2,7475,[127 385 210 143 423],13,2,27227,3.641920813269128,0.0,20.0
27476,2,7476,[385 173 234 300  71],749,4,27231,3.641968704025679,0.0,0.0
27477,2,7477,[ 88 265 235  95  28],271,4,27235,3.64201658197379,0.0,0.0
27478,2,7478,[302 483 100 127 313],537,5,27240,3.642198154833534,20.0,40.0
27479,2,7479,[168 174 176 597 228],533,3,27243,3.6421122994652406,0.0,20.0
27480,2,7480,[483 211 181 182 237],215,4,27247,3.6421601390188476,20.0,0.0
27481,2,7481,[ 79 403 173 175 603],7,5,27252,3.6423416198877305,20.0,0.0
27482,2,7482,[181 276 186  12 195],892,4,27256,3.642389416009622,20.0,0.0
27483,2,7483,[603 176 210   9 276],533,3,27259,3.642303580972742,20.0,0.0
27484,2,7484,[195 546 185  25 301],666,3,27262,3.6422177688710753,0.0,0.0
27485,2,7485,[132 357 121  11  98],308,2,27264,3.6419983970077476,20.0,20.0
27486,2,7486,[302 483 100 127 313],334,5,27269,3.642179778282356,20.0,40.0
27487,2,7487,[302 483 100 127 313],207,4,27273,3.6422275641025643,20.0,40.0
27488,2,7488,[ 28 135  11   1 197],308,3,27276,3.6421418079850447,0.0,0.0
27489,2,7489,[302 483 100 127 313],537,5,27281,3.6423230974632843,20.0,40.0
27490,2,7490,[302 483 100 127 313],328,5,27286,3.642504338539581,20.0,40.0
27491,2,7491,[ 70 435 153 172 228],87,5,27291,3.6426855312333157,0.0,0.0
27492,2,7492,[ 71 183 135  28  69],387,3,27294,3.642599759775791,0.0,0.0
27493,2,7493,[211  79 588 275 183],82,2,27296,3.6423805711235655,0.0,0.0
27494,2,7494,[302 483 100 127 313],13,5,27301,3.6425617078052035,20.0,40.0
27495,2,7495,[302 483 100 127 313],334,5,27306,3.642742796157951,20.0,40.0
27496,2,7496,[302 483 100 127 313],232,3,27309,3.6426570628251302,20.0,40.0
27497,2,7497,[  1 202 385 357 151],379,4,27313,3.6427047212590025,20.0,0.0
27498,2,7498,[173 194   4 180 301],666,4,27317,3.6427523669822643,0.0,0.0
27499,2,7499,[423 196 258 211 275],843,1,27318,3.6424,0.0,0.0
27500,2,7500,[302 483 100 127 313],474,5,27323,3.64258098920144,20.0,40.0
27501,2,7501,[302 483 100 127 313],474,5,27328,3.6427619301519596,20.0,40.0
27502,2,7502,[302 483 100 127 313],537,5,27333,3.6429428228708516,20.0,40.0
27503,2,7503,[175  12 286  82 405],385,1,27334,3.642590618336887,20.0,0.0
27504,2,7504,[211 588 655 204 496],234,1,27335,3.642238507661559,0.0,0.0
27505,2,7505,[302 483 100 127 313],329,5,27340,3.642419397815081,20.0,40.0
27506,2,7506,[ 89 151 185 568   1],882,5,27345,3.642600239776209,0.0,0.0
27507,2,7507,[302 483 100 127 313],329,5,27350,3.6427810335641984,20.0,40.0
27508,2,7508,[302 483 100 127 313],329,5,27355,3.6429617791982953,20.0,40.0
27509,2,7509,[302 483 100 127 313],537,5,27360,3.6431424766977365,20.0,40.0
27510,2,7510,[294 182 111 211 546],234,0,27360,3.642657435760884,0.0,0.0
27511,2,7511,[302 483 100 127 313],537,5,27365,3.6428381256656017,20.0,40.0
27512,2,7512,[483 180 427 301 195],458,4,27369,3.6428856648475976,20.0,0.0
27513,2,7513,[286  56 427 678  79],474,4,27373,3.642933191376098,0.0,0.0
27514,2,7514,[302 483 100 127 313],13,5,27378,3.6431137724550897,20.0,40.0
27515,2,7515,[194 508 496 191  15],653,1,27379,3.6427621075039913,0.0,0.0
27516,2,7516,[678 294 197 435 121],7,3,27382,3.6426765997073303,0.0,0.0
27517,2,7517,[302 483 100 127 313],13,5,27387,3.642857142857143,20.0,40.0
27518,2,7518,[ 82 202 515 403 268],387,2,27389,3.6426386487564835,0.0,0.0
27519,2,7519,[202 174  50  28  70],479,5,27394,3.6428191489361703,0.0,40.0
27520,2,7520,[151 228  71 210  22],479,4,27398,3.642866640074458,0.0,0.0
27521,2,7521,[127 202 191  71  28],398,4,27402,3.6429141185854825,0.0,20.0
27522,2,7522,[275   7 127 603 288],843,2,27404,3.6426957330852052,20.0,20.0
27523,2,7523,[302 483 100 127 313],90,5,27409,3.642876129718235,20.0,40.0
27524,2,7524,[194 183 237 185 318],6,4,27413,3.642923588039867,20.0,0.0
27525,2,7525,[302 483 100 127 313],90,5,27418,3.6431039064576134,20.0,40.0
27526,2,7526,[238 180 216 275 195],6,5,27423,3.6432841769629336,0.0,0.0
27527,2,7527,[302 483 100 127 313],13,5,27428,3.64346439957492,20.0,40.0
27528,2,7528,[  9 191 132 300 161],234,2,27430,3.643246115021915,0.0,0.0
27529,2,7529,[182 257 195 202  97],653,1,27431,3.642895086321381,0.0,0.0
27530,2,7530,[183  11 515 186 568],339,4,27435,3.642942504315496,0.0,0.0
27531,2,7531,[183 318  11 276 111],378,3,27438,3.642857142857143,20.0,0.0
27532,2,7532,[302 483 100 127 313],232,3,27441,3.642771804062127,20.0,40.0
27533,2,7533,[357 471 182  89 204],6,3,27444,3.6426864879214227,20.0,0.0
27534,2,7534,[135 186  82 508 515],59,5,27449,3.642866622428666,0.0,0.0
27535,2,7535,[328 182 174 194 294],537,1,27450,3.642515923566879,0.0,20.0
27536,2,7536,[742 181 300  97 195],666,1,27451,3.642165317765689,0.0,0.0
27537,2,7537,[302 483 100 127 313],13,5,27456,3.6423454497214114,20.0,40.0
27538,2,7538,[322 228 176 742 237],788,3,27459,3.642260246717071,0.0,0.0
27539,2,7539,[282  56 215 173  22],378,5,27464,3.6424403183023872,0.0,0.0
27540,2,7540,[181 496 222  89 405],666,2,27466,3.642222516907572,0.0,0.0
27541,2,7541,[475 269  12 196 237],119,3,27469,3.642137364094405,20.0,0.0
27542,2,7542,[403  56   1 195 135],13,2,27471,3.6419196606124884,0.0,0.0
27543,2,7543,[302 483 100 127 313],474,5,27476,3.6420996818663838,20.0,40.0
27544,2,7544,[475 333  28 742 328],334,2,27478,3.6418820410868125,0.0,0.0
27545,2,7545,[204  98 173 197 215],7,5,27483,3.64206201961304,0.0,20.0
27546,2,7546,[118 265 302 313  95],271,4,27487,3.642109447462568,0.0,0.0
27547,2,7547,[288  97 194   9 357],59,4,27491,3.642156862745098,20.0,0.0
27548,2,7548,[302 483 100 127 313],13,5,27496,3.6423367333421646,20.0,40.0
27549,2,7549,[194 222  11 125 294],213,3,27499,3.642251655629139,0.0,0.0
27550,2,7550,[173 191   7 197  97],339,5,27504,3.642431466030989,0.0,0.0
27551,2,7551,[302 483 100 127 313],334,5,27509,3.6426112288135593,20.0,40.0
27552,2,7552,[288  97 269 144 153],64,2,27511,3.6423937508274857,0.0,0.0
27553,2,7553,[  8 132 187 475  89],308,4,27515,3.6424410908128144,0.0,0.0
27554,2,7554,[179  79 185 202 216],374,3,27518,3.642356055592323,0.0,0.0
27555,2,7555,[  1 174 257 245 265],92,4,27522,3.642403388035998,0.0,20.0
27556,2,7556,[302 483 100 127 313],13,5,27527,3.642583035596136,20.0,40.0
27557,2,7557,[228 195 269  69 194],339,4,27531,3.642630325482932,0.0,0.0
27558,2,7558,[173 483   1 435  89],350,5,27536,3.642809895488821,20.0,0.0
27559,2,7559,[179 172 300 151 143],334,2,27538,3.6425925925925924,0.0,0.0
27560,2,7560,[180 168 183 228  25],650,3,27541,3.642507604814178,0.0,0.0
27561,2,7561,[161  89 135 118 211],650,4,27545,3.642554879661465,0.0,0.0
27562,2,7562,[603 515 275  89  69],843,1,27546,3.6422054740182466,20.0,0.0
27563,2,7563,[302 483 100 127 313],232,3,27549,3.642120571126388,20.0,40.0
27564,2,7564,[ 71  95  79 238 568],313,4,27553,3.64216787838731,0.0,0.0
27565,2,7565,[191 197 168 204 483],233,5,27558,3.642347343378271,20.0,0.0
27566,2,7566,[196 200  82 237 265],804,4,27562,3.642394608167041,0.0,0.0
27567,2,7567,[333 211  82 276 200],10,5,27567,3.64257399577167,0.0,0.0
27568,2,7568,[151 588  70 546 435],234,0,27567,3.6420927467300834,0.0,0.0
27569,2,7569,[172 496 183 121 195],64,4,27571,3.6421400264200794,0.0,0.0
27570,2,7570,[483 568 176 655 182],95,2,27573,3.641923127724211,20.0,0.0
27571,2,7571,[318 515  50  79 265],346,5,27578,3.6421024828314845,20.0,20.0
27572,2,7572,[173 187 405 265 238],804,5,27583,3.642281790571768,0.0,0.0
27573,2,7573,[302 483 100 127 313],329,5,27588,3.6424610509638238,20.0,40.0
27574,2,7574,[302 483 100 127 313],474,5,27593,3.6426402640264026,20.0,40.0
27575,2,7575,[191  95   9 265 313],234,2,27595,3.6424234424498416,0.0,0.0
27576,2,7576,[135  28 202  79 427],406,2,27597,3.642206678104791,0.0,0.0
27577,2,7577,[228   8   1  22  11],454,2,27599,3.6419899709685932,0.0,0.0
27578,2,7578,[318 742  82 405 302],334,3,27602,3.6419052645467738,20.0,0.0
27579,2,7579,[195   7 175 234 322],346,2,27604,3.641688654353562,0.0,0.0
27580,2,7580,[435  69  25  96 405],474,5,27609,3.6418678274633955,0.0,0.0
27581,2,7581,[ 88   1  70 196  15],106,2,27611,3.641651279345819,0.0,0.0
27582,2,7582,[ 56 168 132 403 153],385,3,27614,3.641566662270869,0.0,0.0
27583,2,7583,[ 25 357 182  22 143],194,2,27616,3.6413502109704643,20.0,0.0
27584,2,7584,[ 97 127 181 174  64],465,2,27618,3.6411338167435727,0.0,40.0
27585,2,7585,[ 50 269 546  15 135],271,3,27621,3.641049301344582,0.0,20.0
27586,2,7586,[546  95 483 286 210],200,4,27625,3.641096612626862,20.0,0.0
27587,2,7587,[302 483 100 127 313],90,5,27630,3.6412756984712704,20.0,40.0
27588,2,7588,[228 181 135 483  28],899,3,27633,3.6411911977862697,20.0,0.0
27589,2,7589,[ 50 182  82 742 496],653,2,27635,3.6409749670619234,0.0,20.0
27590,2,7590,[302 483 100 127 313],207,4,27639,3.6410222632064286,20.0,40.0
27591,2,7591,[204 182 301 216 265],537,1,27640,3.640674394099052,0.0,0.0
27592,2,7592,[ 22  12 196 276  98],892,5,27645,3.6408534176214933,20.0,20.0
27593,2,7593,[179   9 196 195 427],406,4,27649,3.640900711087701,0.0,0.0
27594,2,7594,[302 483 100 127 313],537,5,27654,3.6410796576695192,20.0,40.0
27595,2,7595,[ 70 568 196 222  28],454,3,27657,3.640995260663507,0.0,0.0
27596,2,7596,[678 172 180 121 328],92,3,27660,3.6409108858760035,0.0,0.0
27597,2,7597,[302 483 100 127 313],329,5,27665,3.64108976046328,20.0,40.0
27598,2,7598,[568 194 197 173 196],207,4,27669,3.6411369917094354,0.0,0.0
27599,2,7599,[ 12 181 483 328  11],537,1,27670,3.6407894736842104,40.0,0.0
27600,2,7600,[302 483 100 127 313],207,4,27674,3.640836732008946,20.0,40.0
27601,2,7601,[302 483 100 127 313],474,5,27679,3.6410155222309917,20.0,40.0
27602,2,7602,[302 483 100 127 313],207,4,27683,3.6410627383927396,20.0,40.0
27603,2,7603,[302 483 100 127 313],328,5,27688,3.641241451867438,20.0,40.0
27604,2,7604,[302 483 100 127 313],334,5,27693,3.6414201183431953,20.0,40.0
27605,2,7605,[385 121 496 191  89],659,5,27698,3.6415987378385486,0.0,0.0
27606,2,7606,[302 483 100 127 313],13,5,27703,3.6417773103720257,20.0,40.0
27607,2,7607,[302 483 100 127 313],232,3,27706,3.641692954784437,20.0,40.0
27608,2,7608,[483 100 210  82 187],538,4,27710,3.6417400446839268,20.0,20.0
27609,2,7609,[182 174 216 172 257],92,3,27713,3.6416557161629437,0.0,20.0
27610,2,7610,[302 483 100 127 313],334,5,27718,3.6418341873603994,20.0,40.0
27611,2,7611,[258 289 483 265  22],474,4,27722,3.641881240147136,20.0,0.0
27612,2,7612,[302 483 100 127 313],329,5,27727,3.6420596348351504,20.0,40.0
27613,2,7613,[302 483 100 127 313],334,5,27732,3.6422379826635147,20.0,40.0
27614,2,7614,[302 483 100 127 313],90,5,27737,3.6424162836506895,20.0,40.0
27615,2,7615,[ 50  56 238   1 172],406,4,27741,3.6424632352941178,0.0,20.0
27616,2,7616,[302 483 100 127 313],474,5,27746,3.6426414598923462,20.0,40.0
27617,2,7617,[215 111 200 588 357],234,2,27748,3.6424258335521134,20.0,0.0
27618,2,7618,[181 286 202 182  95],378,4,27752,3.642472765454784,0.0,0.0
27619,2,7619,[187   7 603 185  50],116,1,27753,3.6421259842519684,20.0,20.0
27620,2,7620,[181  98  28  89 127],13,5,27758,3.642304159559113,0.0,40.0
27621,2,7621,[196 286 496 603 483],339,5,27763,3.642482288113356,40.0,0.0
27622,2,7622,[301 215 228 182  56],537,2,27765,3.642266824085006,0.0,0.0
27623,2,7623,[ 22 568 276  50 357],200,5,27770,3.6424449108079746,20.0,20.0
27624,2,7624,[302 483 100 127 313],13,5,27775,3.642622950819672,20.0,40.0
27625,2,7625,[185  89 483 222 405],666,3,27778,3.6425386834513507,20.0,0.0
27626,2,7626,[ 79  98 435 216 118],840,4,27782,3.6425855513307983,0.0,20.0
27627,2,7627,[ 22  96  71 275 151],648,3,27785,3.6425013109596223,0.0,0.0
27628,2,7628,[135 323 237 176 211],328,3,27788,3.642417092672696,0.0,0.0
27629,2,7629,[196 313 300 181 546],13,3,27791,3.642332896461337,0.0,0.0
27630,2,7630,[302 483 100 127 313],328,5,27796,3.642510811164985,20.0,40.0
27631,2,7631,[ 71  97 195 405 427],13,3,27799,3.6424266247379453,0.0,0.0
27632,2,7632,[302 483 100 127 313],90,5,27804,3.642604480545002,20.0,40.0
27633,2,7633,[302 483 100 127 313],207,4,27808,3.642651296829971,20.0,40.0
27634,2,7634,[302 483 100 127 313],328,5,27813,3.642829076620825,20.0,40.0
27635,2,7635,[300 176 175  89 216],13,2,27815,3.642613933996857,0.0,0.0
27636,2,7636,[237 302 748 117 333],26,1,27816,3.642267906245908,0.0,0.0
27637,2,7637,[302 483 100 127 313],207,4,27820,3.6423147420790785,20.0,40.0
27638,2,7638,[161 333   9 151 483],533,4,27824,3.642361565649954,20.0,0.0
27639,2,7639,[302 483 100 127 313],232,3,27827,3.6422774869109946,20.0,40.0
27640,2,7640,[ 89 182  69 273 181],833,2,27829,3.6420625572569034,0.0,0.0
27641,2,7641,[385 258  89 175 216],378,5,27834,3.64224025124313,0.0,0.0
27642,2,7642,[302 483 100 127 313],13,5,27839,3.642417898730865,20.0,40.0
27643,2,7643,[302 483 100 127 313],334,5,27844,3.642595499738357,20.0,40.0
27644,2,7644,[302 483 100 127 313],13,5,27849,3.6427730542838455,20.0,40.0
27645,2,7645,[143 196  12 173 186],7,4,27853,3.6428197750457754,20.0,0.0
27646,2,7646,[ 25 191 183 135  95],308,5,27858,3.6429972538250293,0.0,0.0
27647,2,7647,[153 182  79 100 265],207,2,27860,3.6427824267782425,0.0,20.0
27648,2,7648,[302 483 100 127 313],90,5,27865,3.6429598640345144,20.0,40.0
27649,2,7649,[302 483 100 127 313],90,5,27870,3.6431372549019607,20.0,40.0
27650,2,7650,[161 655 186 174 300],102,2,27872,3.6429224937916613,0.0,20.0
27651,2,7651,[302 483 100 127 313],474,5,27877,3.643099843178254,20.0,40.0
27652,2,7652,[300 127  79 678 318],455,3,27880,3.643015810793153,20.0,20.0
27653,2,7653,[302 483 100 127 313],334,5,27885,3.6431931016461983,20.0,40.0
27654,2,7654,[168 204 235 181  15],650,3,27888,3.6431090790333114,0.0,0.0
27655,2,7655,[186  11 423  71 216],378,3,27891,3.643025078369906,0.0,0.0
27656,2,7656,[ 70 172 288  89 286],119,4,27895,3.6430716990988636,0.0,0.0
27657,2,7657,[182 318 185 238  89],774,2,27897,3.642857142857143,20.0,0.0
27658,2,7658,[  8 228   1 496 597],533,3,27900,3.6427732079905994,0.0,0.0
27659,2,7659,[180 215 357 153 197],848,4,27904,3.6428198433420365,20.0,0.0
27660,2,7660,[ 50   8 185 405  69],897,4,27908,3.6428664665187314,0.0,20.0
27661,2,7661,[125 237 588  89 385],295,5,27913,3.6430435917515007,0.0,0.0
27662,2,7662,[191 597 179 180 568],13,1,27914,3.6426986819783376,0.0,0.0
27663,2,7663,[121 186 496 471  70],7,4,27918,3.6427453027139873,0.0,0.0
27664,2,7664,[302 483 100 127 313],474,5,27923,3.6429223744292236,20.0,40.0
27665,2,7665,[313 403 265 204  95],815,4,27927,3.6429689538220713,0.0,0.0
27666,2,7666,[125 196 238 176   9],881,2,27929,3.642754662840746,0.0,0.0
27667,2,7667,[202 174 172  25 153],92,3,27932,3.6426708398539382,0.0,20.0
27668,2,7668,[  1 195 568 121 191],13,1,27933,3.642326248533055,0.0,0.0
27669,2,7669,[173 117 182 257  56],334,3,27936,3.6422425032594523,0.0,0.0
27670,2,7670,[302 483 100 127 313],90,5,27941,3.642419502020597,20.0,40.0
27671,2,7671,[161 174  95 191 385],234,1,27942,3.642075078206465,0.0,20.0
27672,2,7672,[302 483 100 127 313],328,5,27947,3.642252052652157,20.0,40.0
27673,2,7673,[302 483 100 127 313],474,5,27952,3.64242898097472,20.0,40.0
27674,2,7674,[ 70 216  79 194 144],892,5,27957,3.6426058631921823,0.0,0.0
27675,2,7675,[427 173 483  64  22],194,5,27962,3.642782699322564,20.0,0.0
27676,2,7676,[302 483 100 127 313],334,5,27967,3.6429594893838737,20.0,40.0
27677,2,7677,[234 245 200  98 333],488,3,27970,3.642875748892941,0.0,20.0
27678,2,7678,[179 435 195 597  95],650,2,27972,3.642661804922516,0.0,0.0
27679,2,7679,[302 483 100 127 313],232,3,27975,3.642578125,20.0,40.0
27680,2,7680,[471 286 202 403 423],95,4,27979,3.642624658247624,0.0,0.0
27681,2,7681,[237 132 748 191 182],13,4,27983,3.6426711793803697,0.0,0.0
27682,2,7682,[302 483 100 127 313],13,5,27988,3.6428478458935314,20.0,40.0
27683,2,7683,[655 228 168 175 144],64,4,27992,3.6428943258719415,0.0,0.0
27684,2,7684,[127 301 172 181 403],210,5,27997,3.643070917371503,0.0,20.0
27685,2,7685,[302 483 100 127 313],334,5,28002,3.643247462919594,20.0,40.0
27686,2,7686,[302 483 100 127 313],207,4,28006,3.6432938727722126,20.0,40.0
27687,2,7687,[288 194 200 405 143],378,2,28008,3.643080124869927,0.0,0.0
27688,2,7688,[ 88 191  89 496   7],474,5,28013,3.6432566003381455,0.0,0.0
27689,2,7689,[302 483 100 127 313],328,5,28018,3.6434330299089726,20.0,40.0
27690,2,7690,[302 483 100 127 313],207,4,28022,3.6434793914965544,20.0,40.0
27691,2,7691,[302 483 100 127 313],334,5,28027,3.6436557462298493,20.0,40.0
27692,2,7692,[ 98   1 546   4  79],64,3,28030,3.6435720785129337,0.0,20.0
27693,2,7693,[161 153  70 118  69],804,5,28035,3.6437483753574216,0.0,0.0
27694,2,7694,[ 56   7 210 275 196],64,4,28039,3.6437946718648475,0.0,0.0
27695,2,7695,[403  82 197 168 357],650,3,28042,3.6437110187110187,20.0,0.0
27696,2,7696,[302 483 100 127 313],207,4,28046,3.6437573080420944,20.0,40.0
27697,2,7697,[ 96 258 238 216 742],59,3,28049,3.643673681475708,0.0,0.0
27698,2,7698,[258 153 202 151 161],378,3,28052,3.643590076633329,0.0,0.0
27699,2,7699,[228 405   4 245 546],804,4,28056,3.6436363636363636,0.0,0.0
27700,2,7700,[185 323 100   7  70],374,3,28059,3.6435527853525516,0.0,20.0
27701,2,7701,[313   7 333   8 300],334,4,28063,3.643599065177876,0.0,0.0
27702,2,7702,[258 151 215   7  79],64,3,28066,3.6435155134363235,0.0,0.0
27703,2,7703,[151 318  22 405   9],334,4,28070,3.6435617860851504,20.0,0.0
27704,2,7704,[ 50  82 210 471  69],653,4,28074,3.6436080467229073,0.0,20.0
27705,2,7705,[302 483 100 127 313],232,3,28077,3.6435245263431093,20.0,40.0
27706,2,7706,[265 323  69 268 202],537,1,28078,3.643181523290515,0.0,0.0
27707,2,7707,[427 245 294 333 200],666,2,28080,3.6429683445770626,0.0,0.0
27708,2,7708,[200 546  98 483 191],7,5,28085,3.6431443767025553,20.0,20.0
27709,2,7709,[302 483 100 127 313],232,3,28088,3.6430609597924772,20.0,40.0
27710,2,7710,[273 427  96 276 215],90,3,28091,3.6429775645182207,0.0,0.0
27711,2,7711,[318 435 125 185 127],207,5,28096,3.6431535269709543,20.0,20.0
27712,2,7712,[423 655 181  97   8],328,3,28099,3.6430701413198494,0.0,0.0
27713,2,7713,[302 483 100 127 313],207,4,28103,3.6431164117189527,20.0,40.0
27714,2,7714,[ 88 117  50 210 194],643,3,28106,3.6430330524951393,0.0,20.0
27715,2,7715,[300 176 568 385 195],102,1,28107,3.6426905132192844,0.0,0.0
27716,2,7716,[302 483 100 127 313],90,5,28112,3.6428663988596606,20.0,40.0
27717,2,7717,[121 174 202   7 222],554,4,28116,3.6429126716766,0.0,20.0
27718,2,7718,[302 483 100 127 313],537,5,28121,3.6430884829641146,20.0,40.0
27719,2,7719,[257 237 301  98 288],455,2,28123,3.6428756476683937,0.0,20.0
27720,2,7720,[234 357 235 195 127],738,4,28127,3.642921901308121,20.0,20.0
27721,2,7721,[546 496 211 301 269],650,3,28130,3.642838642838643,0.0,0.0
27722,2,7722,[302 483 100 127 313],474,5,28135,3.643014372653114,20.0,40.0
27723,2,7723,[ 56 187 496 151 405],385,2,28137,3.6428016571724493,0.0,0.0
27724,2,7724,[302 483 100 127 313],328,5,28142,3.6429773462783173,20.0,40.0
27725,2,7725,[ 96 235 748 196 175],64,4,28146,3.6430235568211233,0.0,0.0
27726,2,7726,[286  28 508   9   4],207,4,28150,3.6430697554031317,0.0,0.0
27727,2,7727,[258  50 357 118  15],653,2,28152,3.642857142857143,20.0,20.0
27728,2,7728,[257 143 288 196  11],308,4,28156,3.642903351015655,0.0,0.0
27729,2,7729,[471   1  64 172 328],360,3,28159,3.6428201811125485,0.0,0.0
27730,2,7730,[302 483 100 127 313],232,3,28162,3.642737032725391,20.0,40.0
27731,2,7731,[302 483 100 127 313],334,5,28167,3.6429125711329537,20.0,40.0
27732,2,7732,[ 98   4 117 121 174],308,2,28169,3.642700116384327,0.0,40.0
27733,2,7733,[  7 202 183  98 271],379,4,28173,3.642746314972847,0.0,20.0
27734,2,7734,[ 64 234 183  98 182],10,5,28178,3.6429217840982546,0.0,20.0
27735,2,7735,[427  71 172 435 385],295,5,28183,3.6430972078593586,0.0,0.0
27736,2,7736,[187 172  28 300 237],85,3,28186,3.643014088147861,0.0,0.0
27737,2,7737,[318 655   1 471  22],232,3,28189,3.642930989919876,20.0,0.0
27738,2,7738,[496 204 515 588   7],308,3,28192,3.642847913167076,0.0,0.0
27739,2,7739,[302 483 100 127 313],329,5,28197,3.6430232558139535,20.0,40.0
27740,2,7740,[588 161 269 275 211],452,3,28200,3.6429401886061235,0.0,0.0
27741,2,7741,[ 89   1 204 175 276],6,3,28203,3.642857142857143,0.0,0.0
27742,2,7742,[183  82 144 423  69],650,1,28204,3.642515820741315,0.0,0.0
27743,2,7743,[182 294 597 313 385],328,1,28205,3.6421745867768593,0.0,0.0
27744,2,7744,[302 483 100 127 313],90,5,28210,3.642349903163331,20.0,40.0
27745,2,7745,[268 135 127  64 471],13,4,28214,3.6423960753937514,0.0,20.0
27746,2,7746,[302 483 100 127 313],474,5,28219,3.642571317929521,20.0,40.0
27747,2,7747,[302 483 100 127 313],474,5,28224,3.642746515229737,20.0,40.0
27748,2,7748,[125  25 175  11 194],7,3,28227,3.642663569492838,0.0,0.0
27749,2,7749,[302 483 100 127 313],334,5,28232,3.6428387096774193,20.0,40.0
27750,2,7750,[357 211 403 191 302],343,5,28237,3.6430138046703653,20.0,0.0
27751,2,7751,[302 483 100 127 313],328,5,28242,3.643188854489164,20.0,40.0
27752,2,7752,[151  15 111  70 655],474,4,28246,3.643234876821875,0.0,0.0
27753,2,7753,[588  88 196 194  12],454,1,28247,3.642893990198607,20.0,0.0
27754,2,7754,[ 50 222 144  12  15],901,5,28252,3.643068987749839,20.0,20.0
27755,2,7755,[302 483 100 127 313],329,5,28257,3.6432439401753482,20.0,40.0
27756,2,7756,[238 215  88 186 222],537,2,28259,3.643032100038675,0.0,0.0
27757,2,7757,[655 471  88 288  70],308,4,28263,3.6430781129157,0.0,0.0
27758,2,7758,[132  79 603  11 435],804,4,28267,3.643124113932208,20.0,0.0
27759,2,7759,[302 483 100 127 313],207,4,28271,3.6431701030927837,20.0,40.0
27760,2,7760,[302 483 100 127 313],334,5,28276,3.643344929777091,20.0,40.0
27761,2,7761,[182 180  88 161 210],346,4,28280,3.6433908786395257,0.0,0.0
27762,2,7762,[302 483 100 127 313],328,5,28285,3.6435656318433596,20.0,40.0
27763,2,7763,[302 483 100 127 313],328,5,28290,3.643740340030912,20.0,40.0
27764,2,7764,[ 79 168  15 496 210],479,3,28293,3.643657437218287,0.0,0.0
27765,2,7765,[322 191 204 174 168],804,5,28298,3.6438320885912954,0.0,20.0
27766,2,7766,[ 28  79 161   8 135],328,3,28301,3.643749195313506,0.0,0.0
27767,2,7767,[211 151  79  11  96],90,4,28305,3.6437950566426363,0.0,0.0
27768,2,7768,[176 597 265  50 191],200,5,28310,3.643969622860085,0.0,20.0
27769,2,7769,[302 483 100 127 313],329,5,28315,3.644144144144144,20.0,40.0
27770,2,7770,[222 322  28 403 196],804,4,28319,3.644189936945052,0.0,0.0
27771,2,7771,[302 483 100 127 313],328,5,28324,3.644364384971693,20.0,40.0
27772,2,7772,[191 180  98 187 318],308,4,28328,3.6444101376559885,20.0,20.0
27773,2,7773,[ 88 111 357 275 471],95,4,28332,3.644455878569591,20.0,0.0
27774,2,7774,[302 483 100 127 313],90,5,28337,3.6446302250803857,20.0,40.0
27775,2,7775,[185 174 153 175 135],90,4,28341,3.644675925925926,0.0,20.0
27776,2,7776,[191 144  89 176 228],406,3,28344,3.6445930307316448,0.0,0.0
27777,2,7777,[302 483 100 127 313],328,5,28349,3.6447672923630754,20.0,40.0
27778,2,7778,[228  79  82 194 483],788,3,28352,3.644684406736084,20.0,0.0
27779,2,7779,[294   7  12 228 132],788,3,28355,3.6446015424164524,20.0,0.0
27780,2,7780,[288 742 301 265 427],650,2,28357,3.644390181210641,0.0,0.0
27781,2,7781,[302 483 100 127 313],537,5,28362,3.6445643793369316,20.0,40.0
27782,2,7782,[302 483 100 127 313],232,3,28365,3.644481562379545,20.0,40.0
27783,2,7783,[151 222 143 216 153],60,3,28368,3.6443987667009248,0.0,0.0
27784,2,7784,[276 121 427 423  79],458,3,28371,3.6443159922928707,0.0,0.0
27785,2,7785,[515  11 196 175  88],343,5,28376,3.644490110454662,0.0,0.0
27786,2,7786,[302 483 100 127 313],232,3,28379,3.64440734557596,20.0,40.0
27787,2,7787,[196  64 258 328   4],92,4,28383,3.644453004622496,0.0,0.0
27788,2,7788,[ 28 144 588 191 195],892,5,28388,3.644627038130697,0.0,0.0
27789,2,7789,[ 98  70  22   1 588],406,3,28391,3.644544287548139,0.0,20.0
27790,2,7790,[168 173  98 210   4],374,2,28393,3.6443332049801054,0.0,20.0
27791,2,7791,[301 143 234 597 132],13,2,28395,3.6441221765913756,0.0,0.0
27792,2,7792,[268 275 323 300 546],13,1,28396,3.6437828820736557,0.0,0.0
27793,2,7793,[302 483 100 127 313],474,5,28401,3.6439568899153194,20.0,40.0
27794,2,7794,[302 483 100 127 313],232,3,28404,3.643874278383579,20.0,40.0
27795,2,7795,[ 15 235 117 127 357],144,4,28408,3.6439199589533096,20.0,20.0
27796,2,7796,[235 302 181 597 313],144,3,28411,3.643837373348724,0.0,0.0
27797,2,7797,[302 483 100 127 313],232,3,28414,3.6437548089253653,20.0,40.0
27798,2,7798,[174 196 144 313  97],650,3,28417,3.6436722656750864,0.0,20.0
27799,2,7799,[300 286 195 182 187],144,3,28420,3.6435897435897435,0.0,0.0
27800,2,7800,[273  82 435 423 215],387,2,28422,3.64337905396744,0.0,0.0
27801,2,7801,[200 275 187  69 117],271,4,28426,3.6434247628813123,0.0,0.0
27802,2,7802,[302 483 100 127 313],537,5,28431,3.643598615916955,20.0,40.0
27803,2,7803,[ 82 173 323  25 748],804,5,28436,3.6437724243977447,0.0,0.0
27804,2,7804,[  4 200 211  56  82],387,4,28440,3.643818065342729,0.0,0.0
27805,2,7805,[ 28 181   7  11 195],406,4,28444,3.643863694593902,0.0,0.0
27806,2,7806,[302 483 100 127 313],334,5,28449,3.644037402331241,20.0,40.0
27807,2,7807,[273   4 181 423  82],87,3,28452,3.643954918032787,0.0,0.0
27808,2,7808,[ 79  95  12 143 655],537,0,28452,3.6434882827506723,20.0,0.0
27809,2,7809,[ 28  98 117  79 210],92,4,28456,3.6435339308578745,0.0,20.0
27810,2,7810,[300   9 288 471 181],119,5,28461,3.6437075918576367,0.0,0.0
27811,2,7811,[302 483 100 127 313],328,5,28466,3.6438812083973375,20.0,40.0
27812,2,7812,[302 483 100 127 313],13,5,28471,3.644054780494048,20.0,40.0
27813,2,7813,[302 483 100 127 313],13,5,28476,3.6442283081648323,20.0,40.0
27814,2,7814,[302 483 100 127 313],334,5,28481,3.6444017914267435,20.0,40.0
27815,2,7815,[568 118 125 183 204],374,5,28486,3.644575230296827,0.0,0.0
27816,2,7816,[144  25  95 568  70],95,3,28489,3.644492772163234,0.0,0.0
27817,2,7817,[302 483 100 127 313],207,4,28493,3.644538245075467,20.0,40.0
27818,2,7818,[302 483 100 127 313],329,5,28498,3.6447115999488426,20.0,40.0
27819,2,7819,[588 182 195 132 191],454,2,28500,3.6445012787723785,0.0,0.0
27820,2,7820,[200 603  28 245 125],334,2,28502,3.644291011379619,20.0,0.0
27821,2,7821,[302 483 100 127 313],207,4,28506,3.644336486832012,20.0,40.0
27822,2,7822,[ 50  69 435   4  82],666,2,28508,3.6441262942605137,0.0,20.0
27823,2,7823,[172 174 183 153 546],643,4,28512,3.644171779141104,0.0,20.0
27824,2,7824,[172   4 508  25 385],387,2,28514,3.643961661341853,0.0,0.0
27825,2,7825,[265 333 100 200 143],343,2,28516,3.6437515972399694,0.0,20.0
27826,2,7826,[289 286  12 211 210],409,4,28520,3.6437971125590902,20.0,0.0
27827,2,7827,[187 172 204 196 197],308,3,28523,3.643714869698518,0.0,0.0
27828,2,7828,[180 215  96  71   7],474,5,28528,3.643888108315238,0.0,0.0
27829,2,7829,[385 427 282 172 153],374,3,28531,3.6438058748403575,0.0,0.0
27830,2,7830,[302 483 100 127 313],474,5,28536,3.643979057591623,20.0,40.0
27831,2,7831,[302 483 100 127 313],329,5,28541,3.644152196118488,20.0,40.0
27832,2,7832,[ 97  82 588 194  70],452,3,28544,3.644069960423848,0.0,0.0
27833,2,7833,[ 88 151 135 423 748],901,4,28548,3.6441153944345164,0.0,0.0
27834,2,7834,[294 471 276  56  69],232,2,28550,3.6439055520102106,0.0,0.0
27835,2,7835,[183 127 181   7 185],95,4,28554,3.6439509954058193,0.0,20.0
27836,2,7836,[302 483 100 127 313],329,5,28559,3.6441240270511677,20.0,40.0
27837,2,7837,[ 70  28  89 568 144],378,5,28564,3.644297014544527,0.0,0.0
27838,2,7838,[286 111 237  69  25],243,2,28566,3.6440872560275546,0.0,0.0
27839,2,7839,[ 28 258 195 186  15],474,5,28571,3.6442602040816325,0.0,0.0
27840,2,7840,[302 483 100 127 313],207,4,28575,3.6443055732687157,20.0,40.0
27841,2,7841,[121 265 276   7 180],447,5,28580,3.644478449375159,0.0,0.0
27842,2,7842,[302 483 100 127 313],13,5,28585,3.6446512813974246,20.0,40.0
27843,2,7843,[ 98 322 427 508 215],537,2,28587,3.6444416114227436,0.0,20.0
27844,2,7844,[127  56 435 328  70],85,4,28591,3.644486934353091,0.0,20.0
27845,2,7845,[216 322 603 117 197],234,2,28593,3.6442773387713485,20.0,0.0
27846,2,7846,[168 200  97 265 179],380,2,28595,3.6440677966101696,0.0,0.0
27847,2,7847,[185 127  28 196 271],334,3,28598,3.643985728848114,0.0,20.0
27848,2,7848,[  4 174 215 275   1],13,3,28601,3.6439036819977066,0.0,20.0
27849,2,7849,[ 95 269  98 435 603],271,5,28606,3.644076433121019,20.0,20.0
27850,2,7850,[132 269 322 435 276],13,3,28609,3.6439943956183924,0.0,0.0
27851,2,7851,[568  97 475 222 238],387,2,28611,3.643785022924096,0.0,0.0
27852,2,7852,[302 483 100 127 313],13,5,28616,3.643957723163122,20.0,40.0
27853,2,7853,[191  22 135 568 237],804,4,28620,3.6440030557677616,0.0,0.0
27854,2,7854,[302 483 100 127 313],474,5,28625,3.6441756842775304,20.0,40.0
27855,2,7855,[196  50 597  28 194],119,5,28630,3.644348268839104,0.0,20.0
27856,2,7856,[302 483 100 127 313],474,5,28635,3.644520809469263,20.0,40.0
27857,2,7857,[202 357 276 191 273],308,4,28639,3.64456604734029,20.0,0.0
27858,2,7858,[508 186 237  70 194],537,3,28642,3.644484031047207,0.0,0.0
27859,2,7859,[245 275  79  50 121],554,4,28646,3.644529262086514,0.0,20.0
27860,2,7860,[127  79 483 655 435],343,5,28651,3.6447016918967052,20.0,20.0
27861,2,7861,[302 483 100 127 313],329,5,28656,3.644874077842788,20.0,40.0
27862,2,7862,[302 483 100 127 313],329,5,28661,3.6450464199414983,20.0,40.0
27863,2,7863,[100 168 508 289 294],406,2,28663,3.6448372329603256,0.0,20.0
27864,2,7864,[302 483 100 127 313],329,5,28668,3.6450095359186268,20.0,40.0
27865,2,7865,[144 117 228  69  98],815,4,28672,3.6450546656496314,0.0,20.0
27866,2,7866,[302 483 100 127 313],537,5,28677,3.6452268971653745,20.0,40.0
27867,2,7867,[ 89 323  82 294 423],374,1,28678,3.64489069649212,0.0,0.0
27868,2,7868,[132 196 194 111 183],749,4,28682,3.6449358241199645,0.0,0.0
27869,2,7869,[121 508 238 289 174],387,3,28685,3.644853875476493,0.0,20.0
27870,2,7870,[183 216 200  95 180],537,1,28686,3.644517850336679,0.0,0.0
27871,2,7871,[302 483 100 127 313],334,5,28691,3.6446900406504064,20.0,40.0
27872,2,7872,[288 258 333 282 118],666,1,28692,3.644354121681697,0.0,0.0
27873,2,7873,[100 237 211  56 568],537,3,28695,3.644272288544577,0.0,20.0
27874,2,7874,[216 181 191  69 588],378,4,28699,3.64431746031746,0.0,0.0
27875,2,7875,[302 483 100 127 313],328,5,28704,3.644489588623667,20.0,40.0
27876,2,7876,[302 483 100 127 313],13,5,28709,3.644661673225847,20.0,40.0
27877,2,7877,[151  12   1 238 100],213,4,28713,3.6447067783701446,20.0,20.0
27878,2,7878,[302 483 100 127 313],334,5,28718,3.644878791724838,20.0,40.0
27879,2,7879,[100 195 405  64 200],774,0,28718,3.644416243654822,0.0,20.0
27880,2,7880,[302 483 100 127 313],90,5,28723,3.644588250222053,20.0,40.0
27881,2,7881,[183 216  96  95 385],42,5,28728,3.644760213143872,0.0,0.0
27882,2,7882,[ 28 300  22  56 151],892,5,28733,3.6449321324368893,0.0,0.0
27883,2,7883,[132 202   4 117 302],271,4,28737,3.644977168949772,0.0,0.0
27884,2,7884,[238 403 185 175 423],385,3,28740,3.6448953709575145,0.0,0.0
27885,2,7885,[302 483 100 127 313],232,3,28743,3.644813593710373,20.0,40.0
27886,2,7886,[302 483 100 127 313],328,5,28748,3.6449854190439965,20.0,40.0
27887,2,7887,[302 483 100 127 313],328,5,28753,3.645157200811359,20.0,40.0
27888,2,7888,[ 56 210  97 257 182],271,3,28756,3.645075421472937,0.0,0.0
27889,2,7889,[588 471 301  56  96],378,3,28759,3.644993662864385,0.0,0.0
27890,2,7890,[ 70  22 405 597 322],788,4,28763,3.6450386516284374,0.0,0.0
27891,2,7891,[179 678 175  70 153],615,4,28767,3.6450836289913835,0.0,0.0
27892,2,7892,[174   9 151 678  28],554,4,28771,3.645128594957557,0.0,20.0
27893,2,7893,[302 483 100 127 313],232,3,28774,3.645046871041297,20.0,40.0
27894,2,7894,[603 275  79   8 301],13,2,28776,3.644838505383154,20.0,0.0
27895,2,7895,[187  82  71 121  69],308,3,28779,3.644756838905775,0.0,0.0
27896,2,7896,[143  50  56 215 172],454,3,28782,3.644675193111308,0.0,20.0
27897,2,7897,[181 204 172  64 258],455,5,28787,3.6448467966573816,0.0,0.0
27898,2,7898,[187 748 742 144 273],328,3,28790,3.644765160146854,0.0,0.0
27899,2,7899,[302 483 100 127 313],329,5,28795,3.6449367088607594,20.0,40.0
27900,2,7900,[186 276  70 151 655],664,3,28798,3.644855081635236,0.0,0.0
27901,2,7901,[204  70 603 200 423],543,4,28802,3.644900025310048,20.0,0.0
27902,2,7902,[271 385 151 288 515],843,2,28804,3.6446918891560167,0.0,0.0
27903,2,7903,[302 483 100 127 313],207,4,28808,3.6447368421052633,20.0,40.0
27904,2,7904,[151 323 211 301 179],537,2,28810,3.644528779253637,0.0,0.0
27905,2,7905,[302 483 100 127 313],207,4,28814,3.644573741462181,20.0,40.0
27906,2,7906,[302 483 100 127 313],537,5,28819,3.6447451625142278,20.0,40.0
27907,2,7907,[175  69 237 228 196],42,4,28823,3.644790085988872,0.0,0.0
27908,2,7908,[302 483 100 127 313],329,5,28828,3.644961436338349,20.0,40.0
27909,2,7909,[ 89  97 202 237  12],59,4,28832,3.6450063211125157,20.0,0.0
27910,2,7910,[174 275 475 245 125],533,3,28835,3.644924788269498,0.0,20.0
27911,2,7911,[176 222 179  97 405],13,1,28836,3.6445904954499495,0.0,0.0
27912,2,7912,[302 483 100 127 313],328,5,28841,3.644761784405409,20.0,40.0
27913,2,7913,[313  12  50 385 357],13,3,28844,3.644680313368714,40.0,20.0
27914,2,7914,[265 238 655  12 258],378,4,28848,3.64472520530638,20.0,0.0
27915,2,7915,[ 70 202 216 196 180],87,5,28853,3.644896412329459,0.0,0.0
27916,2,7916,[ 96 135  70 546 172],788,1,28854,3.6445623342175066,0.0,0.0
27917,2,7917,[  9 385  22 238  70],883,2,28856,3.6443546350088405,0.0,0.0
27918,2,7918,[302 483 100 127 313],90,5,28861,3.6445258239676726,20.0,40.0
27919,2,7919,[328 237 176 127 173],234,1,28862,3.644191919191919,0.0,20.0
27920,2,7920,[302 483 100 127 313],474,5,28867,3.6443630854690063,20.0,40.0
27921,2,7921,[ 82 132 323 181 597],378,3,28870,3.6442817470335775,0.0,0.0
27922,2,7922,[186 234 151 748 211],749,4,28874,3.6443266439479993,0.0,0.0
27923,2,7923,[289 117  50 121 176],378,4,28878,3.6443715295305403,0.0,20.0
27924,2,7924,[427  56 151 215 597],59,4,28882,3.644416403785489,0.0,0.0
27925,2,7925,[215 496 357  79 423],804,4,28886,3.6444612667171334,20.0,0.0
27926,2,7926,[ 71 288  89 435 403],830,4,28890,3.644506118329759,0.0,0.0
27927,2,7927,[302 483 100 127 313],232,3,28893,3.6444248234106964,20.0,40.0
27928,2,7928,[300 275 405 427 678],13,1,28894,3.6440913103796193,0.0,0.0
27929,2,7929,[302 483 100 127 313],207,4,28898,3.644136191677175,20.0,40.0
27930,2,7930,[546 228   7 300 118],87,3,28901,3.6440549741520614,0.0,0.0
27931,2,7931,[211 222  11  98 135],447,4,28905,3.6440998487140694,0.0,20.0
27932,2,7932,[172 121 515  50 237],882,5,28910,3.6442707676793145,0.0,20.0
27933,2,7933,[135  71  97 423 197],650,2,28912,3.6440635240736072,0.0,0.0
27934,2,7934,[135 211 238 194  50],313,5,28917,3.644234404536862,0.0,20.0
27935,2,7935,[302 483 100 127 313],537,5,28922,3.644405241935484,20.0,40.0
27936,2,7936,[276 288 328 210 172],119,4,28926,3.644450044097266,0.0,0.0
27937,2,7937,[179  28 265 403 135],92,4,28930,3.6444948349710256,0.0,0.0
27938,2,7938,[302 483 100 127 313],207,4,28934,3.644539614561028,20.0,40.0
27939,2,7939,[435 294 508 475 187],13,2,28936,3.6443324937027706,0.0,0.0
27940,2,7940,[302 483 100 127 313],334,5,28941,3.644503211182471,20.0,40.0
27941,2,7941,[ 15  11 323 258 191],59,4,28945,3.6445479728028203,0.0,0.0
27942,2,7942,[302 483 100 127 313],537,5,28950,3.644718620168702,20.0,40.0
27943,2,7943,[496 235 222 211 210],738,3,28953,3.6446374622356497,0.0,0.0
27944,2,7944,[153 182 117 100 179],92,5,28958,3.6448080553807425,0.0,20.0
27945,2,7945,[269 204 100 289 483],85,2,28960,3.6446010571356657,20.0,20.0
27946,2,7946,[153  95 179 300  56],85,3,28963,3.644519944633195,0.0,0.0
27947,2,7947,[405 180 483 135 127],848,3,28966,3.6444388525415197,20.0,20.0
27948,2,7948,[202 269 195 318 228],64,5,28971,3.6446093848282803,20.0,0.0
27949,2,7949,[655   7 483 289 588],194,3,28974,3.6445283018867927,20.0,0.0
27950,2,7950,[182 282 235 258 496],334,2,28976,3.6443214689976102,0.0,0.0
27951,2,7951,[200 176  12 423 257],339,4,28980,3.6443661971830985,20.0,0.0
27952,2,7952,[302 483 100 127 313],207,4,28984,3.6444109141204577,20.0,40.0
27953,2,7953,[276 118   4 275 403],343,4,28988,3.64445561981393,0.0,0.0
27954,2,7954,[302 483 100 127 313],207,4,28992,3.644500314267756,20.0,40.0
27955,2,7955,[546 135  12  95 234],308,3,28995,3.644419306184012,20.0,0.0
27956,2,7956,[181 211 257 127 117],271,4,28999,3.644463993967576,0.0,20.0
27957,2,7957,[302 483 100 127 313],537,5,29004,3.644634330233727,20.0,40.0
27958,2,7958,[153 742 286 302 117],454,1,29005,3.6443020479959793,0.0,0.0
27959,2,7959,[265 195 273 423 210],59,4,29009,3.6443467336683417,0.0,0.0
27960,2,7960,[174 168 210 127  12],527,5,29014,3.6445170204748147,20.0,40.0
27961,2,7961,[302 483 100 127 313],90,5,29019,3.6446872645064055,20.0,40.0
27962,2,7962,[127 174 210   4 183],197,4,29023,3.644731884967977,0.0,40.0
27963,2,7963,[302 483 100 127 313],328,5,29028,3.6449020592667,20.0,40.0
27964,2,7964,[286 678 179 180   7],881,3,29031,3.644821092278719,0.0,0.0
27965,2,7965,[228 385 546 318  28],533,4,29035,3.644865679136329,20.0,0.0
27966,2,7966,[302 483 100 127 313],328,5,29040,3.6450357725618177,20.0,40.0
27967,2,7967,[161 127 300  56 333],346,4,29044,3.6450803212851404,0.0,20.0
27968,2,7968,[185 515 182 483 143],881,4,29048,3.6451248588279586,20.0,0.0
27969,2,7969,[302 483 100 127 313],207,4,29052,3.645169385194479,20.0,40.0
27970,2,7970,[210 204 515 202 125],194,2,29054,3.6449629908418015,0.0,0.0
27971,2,7971,[  1 318 357 216 294],234,2,29056,3.6447566482689413,40.0,0.0
27972,2,7972,[228 144 403  11   4],643,4,29060,3.644801204063715,0.0,0.0
27973,2,7973,[302 483 100 127 313],232,3,29063,3.644720341108603,20.0,40.0
27974,2,7974,[302 483 100 127 313],328,5,29068,3.6448902821316613,20.0,40.0
27975,2,7975,[ 22 222 515 117 125],290,2,29070,3.6446840521564696,0.0,0.0
27976,2,7976,[269 423 300  22 313],64,4,29074,3.6447285947097905,0.0,0.0
27977,2,7977,[423 185 127 179 237],694,5,29079,3.6448984707946854,0.0,20.0
27978,2,7978,[568 143 118 357 181],313,4,29083,3.6449429753101894,20.0,0.0
27979,2,7979,[  4 183  82 127 132],804,4,29087,3.644987468671679,0.0,20.0
27980,2,7980,[197 603 475 275 546],533,3,29090,3.6449066533015912,20.0,0.0
27981,2,7981,[180 216  96 300 151],346,4,29094,3.6449511400651464,0.0,0.0
27982,2,7982,[302 483 100 127 313],232,3,29097,3.6448703494926717,20.0,40.0
27983,2,7983,[132 271 181  22 161],290,3,29100,3.6447895791583167,0.0,0.0
27984,2,7984,[403 135   9  82 175],64,4,29104,3.6448340638697556,0.0,0.0
27985,2,7985,[471 328 258 288 508],533,4,29108,3.644878537440521,0.0,0.0
27986,2,7986,[475  69 237 117  79],455,3,29111,3.6447977964191813,0.0,0.0
27987,2,7987,[302 483 100 127 313],232,3,29114,3.64471707561342,20.0,40.0
27988,2,7988,[195 328 222  25 111],749,3,29117,3.6446363750156463,0.0,0.0
27989,2,7989,[132 322 313   7  69],328,4,29121,3.6446808510638298,0.0,0.0
27990,2,7990,[196 234 265 508  96],59,5,29126,3.6448504567638595,0.0,0.0
27991,2,7991,[423  88   7 228 427],343,5,29131,3.64502002002002,0.0,0.0
27992,2,7992,[117 568  88 275  82],901,4,29135,3.645064431377455,0.0,0.0
27993,2,7993,[ 95 194 181 238 174],295,5,29140,3.645233925444083,0.0,20.0
27994,2,7994,[121 176  22 173 132],13,3,29143,3.645153220762977,0.0,0.0
27995,2,7995,[ 64 328 302 194 111],13,4,29147,3.6451975987994,0.0,0.0
27996,2,7996,[ 82  79 175 117 202],840,3,29150,3.645116918844567,0.0,0.0
27997,2,7997,[151 179 742 182 257],374,2,29152,3.6449112278069515,0.0,0.0
27998,2,7998,[302 483 100 127 313],328,5,29157,3.6450806350793847,20.0,40.0
27999,2,7999,[546 173   4 496 187],64,3,29160,3.645,0.0,0.0
28000,2,8000,[268 216 313  50 294],13,3,29163,3.6449193850768653,0.0,20.0
28001,2,8001,[ 11 435 202 132 118],804,4,29167,3.644963759060235,0.0,0.0
28002,2,8002,[302 483 100 127 313],13,5,29172,3.6451330750968385,20.0,40.0
28003,2,8003,[286  82 195 191 427],537,2,29174,3.6449275362318843,0.0,0.0
28004,2,8004,[210  89 423 300 197],64,1,29175,3.6445971267957527,0.0,0.0
28005,2,8005,[  4 423 257  28 405],92,1,29176,3.644266799900075,0.0,0.0
28006,2,8006,[144 288 143 127 300],188,4,29180,3.6443112276757836,0.0,20.0
28007,2,8007,[  1 323  79 276 546],374,4,29184,3.6443556443556444,0.0,0.0
28008,2,8008,[300  12 172 294  71],234,0,29184,3.643900611811712,20.0,0.0
28009,2,8009,[257 125 215 172  25],749,4,29188,3.64394506866417,0.0,0.0
28010,2,8010,[302 483 100 127 313],90,5,29193,3.6441143427786793,20.0,40.0
28011,2,8011,[ 71 194 427 496 515],899,4,29197,3.644158761857214,0.0,0.0
28012,2,8012,[282  97  70 151 186],881,1,29198,3.6438287782353673,0.0,0.0
28013,2,8013,[ 69 276  50 191 179],378,3,29201,3.643748440229598,0.0,20.0
28014,2,8014,[313 276 168 496 100],308,3,29204,3.6436681222707423,0.0,20.0
28015,2,8015,[257 508 302 496  97],474,3,29207,3.6435878243512976,0.0,0.0
28016,2,8016,[302 483 100 127 313],334,5,29212,3.643757016340277,20.0,40.0
28017,2,8017,[385  15 234 125  96],881,2,29214,3.6435520079820405,0.0,0.0
28018,2,8018,[471 174 300   4  12],537,0,29214,3.643097643097643,20.0,20.0
28019,2,8019,[302 483 100 127 313],232,3,29217,3.6430174563591025,20.0,40.0
28020,2,8020,[322 245 237 313 121],328,4,29221,3.6430619623488343,0.0,0.0
28021,2,8021,[508 144 100 204 742],387,2,29223,3.642857142857143,0.0,20.0
28022,2,8022,[ 71  95 180 195 187],85,4,29227,3.6429016577340145,0.0,0.0
28023,2,8023,[302 483 100 127 313],328,5,29232,3.6430707876370887,20.0,40.0
28024,2,8024,[ 69 185 588 568  25],882,4,29236,3.643115264797508,0.0,0.0
28025,2,8025,[ 64 357  89 173 222],339,5,29241,3.6432843259406926,20.0,0.0
28026,2,8026,[191 118 318 125 222],295,4,29245,3.643328765416719,20.0,0.0
28027,2,8027,[ 70 197 117  96 333],13,2,29247,3.643124065769806,0.0,0.0
28028,2,8028,[228 117 257 186  64],533,4,29251,3.643168514136256,0.0,0.0
28029,2,8029,[302 483 100 127 313],13,5,29256,3.643337484433375,20.0,40.0
28030,2,8030,[191 153  95  97 302],454,3,29259,3.6432573776615613,0.0,0.0
28031,2,8031,[748 191 286 135 385],653,5,29264,3.643426294820717,0.0,0.0
28032,2,8032,[  4 238 313  71 186],234,2,29266,3.6432217104444167,0.0,0.0
28033,2,8033,[302 483 100 127 313],232,3,29269,3.643141647996017,20.0,40.0
28034,2,8034,[182 173 322 118 195],749,3,29272,3.6430616054760425,0.0,0.0
28035,2,8035,[181 174  70 483  69],533,5,29277,3.643230462916874,20.0,20.0
28036,2,8036,[ 98 118  97   4  22],788,2,29279,3.6430260047281324,0.0,20.0
28037,2,8037,[302 483 100 127 313],232,3,29282,3.642946006469271,20.0,40.0
28038,2,8038,[197 603 191 318 176],313,5,29287,3.6431148152755317,40.0,0.0
28039,2,8039,[  1 222 181 423 286],380,2,29289,3.642910447761194,0.0,0.0
28040,2,8040,[427 655 135 187 568],788,1,29290,3.6425817684367616,0.0,0.0
28041,2,8041,[183 471 294 475 302],6,3,29293,3.64250186520766,0.0,0.0
28042,2,8042,[302 483 100 127 313],334,5,29298,3.6426706452816116,20.0,40.0
28043,2,8043,[200  88  89 265 423],313,3,29301,3.642590750870214,0.0,0.0
28044,2,8044,[174  89 222  64 194],339,5,29306,3.6427594779366066,0.0,20.0
28045,2,8045,[302 483 100 127 313],90,5,29311,3.642928163062391,20.0,40.0
28046,2,8046,[ 88 202  50  82 385],650,2,29313,3.6427239965204423,0.0,20.0
28047,2,8047,[302 483 100 127 313],207,4,29317,3.6427683896620278,20.0,40.0
28048,2,8048,[ 79 655 172  70 179],537,2,29319,3.642564293701081,0.0,0.0
28049,2,8049,[  4 215 286  64 186],318,2,29321,3.642360248447205,0.0,0.0
28050,2,8050,[127 289 265   4 180],881,3,29324,3.642280462054403,0.0,20.0
28051,2,8051,[180 197  11 191  96],13,3,29327,3.642200695479384,0.0,0.0
28052,2,8052,[121 132 144  98 357],295,5,29332,3.6423693033652054,20.0,20.0
28053,2,8053,[655 175 143 121  69],666,2,29334,3.642165383660293,0.0,0.0
28054,2,8054,[ 50  15 603   7   1],145,3,29337,3.6420856610800745,20.0,20.0
28055,2,8055,[302 483 100 127 313],474,5,29342,3.6422542204568025,20.0,40.0
28056,2,8056,[ 96 161 173  71  97],95,4,29346,3.6422986223159985,0.0,0.0
28057,2,8057,[302 483 100 127 313],334,5,29351,3.6424671134276494,20.0,40.0
28058,2,8058,[271 194 588  97 234],64,3,29354,3.6423873929767963,0.0,0.0
28059,2,8059,[328 153 173  96  79],102,0,29354,3.641935483870968,0.0,0.0
28060,2,8060,[265 215 127 300  96],533,4,29358,3.6419799032378117,0.0,20.0
28061,2,8061,[195 423  97  11   8],897,3,29361,3.64190027288514,0.0,0.0
28062,2,8062,[302 483 100 127 313],329,5,29366,3.6420687089172765,20.0,40.0
28063,2,8063,[483 275 215 135 194],533,4,29370,3.6421130952380953,20.0,0.0
28064,2,8064,[100 385 175 546  11],881,4,29374,3.642157470551767,0.0,20.0
28065,2,8065,[204   1 216 286 153],144,4,29378,3.6422018348623855,0.0,0.0
28066,2,8066,[302 483 100 127 313],334,5,29383,3.642370149993802,20.0,40.0
28067,2,8067,[496 151 423 176 172],899,4,29387,3.642414476945959,0.0,0.0
28068,2,8068,[275 268 313 496  70],90,5,29392,3.642582724005453,0.0,0.0
28069,2,8069,[302 483 100 127 313],329,5,29397,3.6427509293680296,20.0,40.0
28070,2,8070,[302 483 100 127 313],207,4,29401,3.642795192665097,20.0,40.0
28071,2,8071,[302 483 100 127 313],207,4,29405,3.6428394449950448,20.0,40.0
28072,2,8072,[294 143 153  22 144],653,1,29406,3.642512077294686,0.0,0.0
28073,2,8073,[125  64 427 508 222],533,5,29411,3.6426802080753036,0.0,0.0
28074,2,8074,[302 483 100 127 313],328,5,29416,3.6428482972136225,20.0,40.0
28075,2,8075,[302 483 100 127 313],207,4,29420,3.6428925210500247,20.0,40.0
28076,2,8076,[302 483 100 127 313],537,5,29425,3.6430605422805495,20.0,40.0
28077,2,8077,[302 483 100 127 313],207,4,29429,3.6431047288932903,20.0,40.0
28078,2,8078,[302 483 100 127 313],13,5,29434,3.643272682262656,20.0,40.0
28079,2,8079,[302 483 100 127 313],329,5,29439,3.643440594059406,20.0,40.0
28080,2,8080,[185 117  89  15 357],311,4,29443,3.6434847172379654,20.0,0.0
28081,2,8081,[ 98 275 118  25  97],378,5,29448,3.643652561247216,0.0,20.0
28082,2,8082,[  1  89 191  71   8],6,5,29453,3.643820363726339,0.0,0.0
28083,2,8083,[194 118 234 237 273],524,3,29456,3.643740722414646,0.0,0.0
28084,2,8084,[204 265  97 275   4],474,4,29460,3.6437847866419295,0.0,0.0
28085,2,8085,[289 127 215 172 196],406,2,29462,3.6435814988869653,0.0,20.0
28086,2,8086,[302 483 100 127 313],90,5,29467,3.6437492271546925,20.0,40.0
28087,2,8087,[ 11 385 143 546 200],643,2,29469,3.6435459940652817,0.0,0.0
28088,2,8088,[194 204 286 210 568],378,5,29474,3.6437136852515764,0.0,0.0
28089,2,8089,[210 508 204  71 174],387,3,29477,3.6436341161928305,0.0,20.0
28090,2,8090,[ 64 289 678  15 588],82,2,29479,3.6434309726857004,0.0,0.0
28091,2,8091,[172 176  50 257 238],653,1,29480,3.643104300543747,0.0,20.0
28092,2,8092,[302 483 100 127 313],474,5,29485,3.6432719634251822,20.0,40.0
28093,2,8093,[258 403 121 176  22],749,4,29489,3.643316036570299,0.0,0.0
28094,2,8094,[508 475 238 318 181],537,4,29493,3.643360098826436,20.0,0.0
28095,2,8095,[276 172 228  70 237],398,4,29497,3.6434041501976284,0.0,0.0
28096,2,8096,[187 269 175 204  28],6,3,29500,3.643324688156107,0.0,0.0
28097,2,8097,[174 265 179 655 597],378,3,29503,3.643245245739689,0.0,20.0
28098,2,8098,[508 180  28  71 276],13,4,29507,3.6432892949746885,0.0,0.0
28099,2,8099,[ 25 176  79 172 132],13,2,29509,3.6430864197530863,0.0,0.0
28100,2,8100,[174  95 173 144 427],234,1,29510,3.6427601530675227,0.0,20.0
28101,2,8101,[172 195 403 144 179],387,3,29513,3.642680819550728,0.0,0.0
28102,2,8102,[302 483 100 127 313],13,5,29518,3.6428483277798347,20.0,40.0
28103,2,8103,[196 318  22  96 427],406,3,29521,3.6427690029615003,20.0,0.0
28104,2,8104,[127 302 258  15 328],360,3,29524,3.6426896977174583,0.0,20.0
28105,2,8105,[175 282 179 318 269],666,4,29528,3.6427337774488033,20.0,0.0
28106,2,8106,[302 483 100 127 313],232,3,29531,3.642654496114469,20.0,40.0
28107,2,8107,[ 50 403 179 603 483],648,5,29536,3.6428219042920573,40.0,20.0
28108,2,8108,[403 483 117 187  69],308,2,29538,3.6426193118756935,20.0,0.0
28109,2,8109,[302 483 100 127 313],329,5,29543,3.642786683107275,20.0,40.0
28110,2,8110,[ 12 405 127 173 197],406,3,29546,3.6427074343484156,20.0,20.0
28111,2,8111,[302 483 100 127 313],328,5,29551,3.6428747534516766,20.0,40.0
28112,2,8112,[ 82 289 301 185 183],328,4,29555,3.6429187723406877,0.0,0.0
28113,2,8113,[302 276 121 238  71],334,3,29558,3.6428395366034017,0.0,0.0
28114,2,8114,[ 98 174 471 204 496],194,4,29562,3.642883548983364,0.0,40.0
28115,2,8115,[176 204  96 194  82],882,4,29566,3.6429275505174963,0.0,0.0
28116,2,8116,[ 12 427 385 135 172],379,4,29570,3.6429715412098065,20.0,0.0
28117,2,8117,[333  97 127 289 210],871,2,29572,3.642769154964277,0.0,20.0
28118,2,8118,[655 333 196 179  88],13,3,29575,3.6426899864515336,0.0,0.0
28119,2,8119,[211 655 111  28 245],207,3,29578,3.642610837438424,0.0,0.0
28120,2,8120,[176 210 423 300 313],653,3,29581,3.642531707917744,0.0,0.0
28121,2,8121,[202   7 132  56 238],892,5,29586,3.642698842649594,0.0,0.0
28122,2,8122,[302 483 100 127 313],13,5,29591,3.6428659362304567,20.0,40.0
28123,2,8123,[195  50  97  89  25],313,4,29595,3.6429098966026587,0.0,20.0
28124,2,8124,[302 483 100 127 313],329,5,29600,3.643076923076923,20.0,40.0
28125,2,8125,[210 211 515   8 181],387,5,29605,3.643243908442038,0.0,0.0
28126,2,8126,[302 483 100 127 313],207,4,29609,3.643287806078504,20.0,40.0
28127,2,8127,[302 483 100 127 313],474,5,29614,3.6434547244094486,20.0,40.0
28128,2,8128,[655   7  12   8  98],328,4,29618,3.6434985853118467,20.0,20.0
28129,2,8129,[271 385  95 313 153],64,3,29621,3.643419434194342,0.0,0.0
28130,2,8130,[118  50 185 100 180],380,3,29624,3.643340302545812,0.0,40.0
28131,2,8131,[302 483 100 127 313],232,3,29627,3.6432611903590755,20.0,40.0
28132,2,8132,[  1 202 275 276  50],298,2,29629,3.6430591417681053,0.0,20.0
28133,2,8133,[302 483 100 127 313],90,5,29634,3.643225965084829,20.0,40.0
28134,2,8134,[ 69 245 187  71  50],334,2,29636,3.6430239704978487,0.0,20.0
28135,2,8135,[318 176 405 234 195],64,4,29640,3.6430678466076696,20.0,0.0
28136,2,8136,[288   4 174 179  79],648,4,29644,3.643111711933145,0.0,20.0
28137,2,8137,[191 435 185 143 195],881,4,29648,3.6431555664782502,0.0,0.0
28138,2,8138,[302 483 100 127 313],474,5,29653,3.643322275463816,20.0,40.0
28139,2,8139,[302 483 100 127 313],329,5,29658,3.6434889434889435,20.0,40.0
28140,2,8140,[546 118  79 183 185],881,5,29663,3.6436555705687264,0.0,0.0
28141,2,8141,[ 50 174 496 151 385],64,4,29667,3.6436993367722916,0.0,40.0
28142,2,8142,[174 151 144 405 180],290,1,29668,3.6433746776372344,0.0,20.0
28143,2,8143,[302 483 100 127 313],537,5,29673,3.643541257367387,20.0,40.0
28144,2,8144,[195  89 204 427 185],7,5,29678,3.643707796193984,0.0,0.0
28145,2,8145,[ 22 215   8 276   7],92,4,29682,3.643751534495458,0.0,0.0
28146,2,8146,[302 483 100 127 313],90,5,29687,3.6439180066282066,20.0,40.0
28147,2,8147,[282 403   9  56 405],144,4,29691,3.643961708394698,0.0,0.0
28148,2,8148,[235 211 195  50 179],194,2,29693,3.6437599705485337,0.0,20.0
28149,2,8149,[742 568  50 237 385],374,4,29697,3.6438036809815952,0.0,20.0
28150,2,8150,[475 200 289 276  25],474,3,29700,3.6437246963562755,0.0,0.0
28151,2,8151,[176 238 405  69 546],653,1,29701,3.6434003925417078,0.0,0.0
28152,2,8152,[302 483 100 127 313],232,3,29704,3.643321476757022,20.0,40.0
28153,2,8153,[302 483 100 127 313],328,5,29709,3.643487858719647,20.0,40.0
28154,2,8154,[483 117 215 322 323],788,3,29712,3.643408951563458,20.0,0.0
28155,2,8155,[302 483 100 127 313],232,3,29715,3.6433300637567436,20.0,40.0
28156,2,8156,[ 89 286 238 111 197],479,4,29719,3.6433737893833515,0.0,0.0
28157,2,8157,[245 144 127  22 125],653,3,29722,3.6432949252267712,0.0,20.0
28158,2,8158,[302 483 100 127 313],329,5,29727,3.6434612084814315,20.0,40.0
28159,2,8159,[238  96 135 597 174],833,2,29729,3.6432598039215685,0.0,20.0
28160,2,8160,[322  88 427 238 210],481,5,29734,3.643426050729077,0.0,0.0
28161,2,8161,[302 483 100 127 313],537,5,29739,3.643592256799804,20.0,40.0
28162,2,8162,[195 228 216  15 357],311,5,29744,3.64375842214872,20.0,0.0
28163,2,8163,[302 483 100 127 313],474,5,29749,3.643924546790789,20.0,40.0
28164,2,8164,[ 28 173 234 183  95],843,2,29751,3.643723208818126,0.0,0.0
28165,2,8165,[603 182  88  50   1],533,4,29755,3.6437668381092334,20.0,20.0
28166,2,8166,[  8 121   4 742 216],158,4,29759,3.6438104567160523,0.0,0.0
28167,2,8167,[181  56  82 176 496],326,2,29761,3.643609206660137,0.0,0.0
28168,2,8168,[ 12 194 132 151 215],308,3,29764,3.6435304198800345,20.0,0.0
28169,2,8169,[302 483 100 127 313],474,5,29769,3.6436964504283966,20.0,40.0
28170,2,8170,[302 483 100 127 313],90,5,29774,3.64386244033778,20.0,40.0
28171,2,8171,[268 496  89 286 180],836,3,29777,3.6437836514929027,0.0,0.0
28172,2,8172,[302 483 100 127 313],207,4,29781,3.643827236021045,20.0,40.0
28173,2,8173,[302 483 100 127 313],537,5,29786,3.643993149009053,20.0,40.0
28174,2,8174,[302 483 100 127 313],474,5,29791,3.6441590214067276,20.0,40.0
28175,2,8175,[301   1  96 238 288],234,0,29791,3.6437133072407044,0.0,0.0
28176,2,8176,[300 132 275   1 237],64,4,29795,3.6437568790509967,0.0,0.0
28177,2,8177,[100  22 196 273 168],59,4,29799,3.643800440205429,0.0,20.0
28178,2,8178,[603  71  96 187 546],13,4,29803,3.6438439907079103,20.0,0.0
28179,2,8179,[132 471 176 258 135],447,5,29808,3.6440097799511,0.0,0.0
28180,2,8180,[183 143 180 173 121],882,5,29813,3.6441755286639776,0.0,0.0
28181,2,8181,[ 82 515 216 174 222],313,3,29816,3.6440967978489365,0.0,20.0
28182,2,8182,[  7 180 294  98 568],881,4,29820,3.644140290846878,0.0,20.0
28183,2,8183,[215 144 357 405  15],406,2,29822,3.643939393939394,20.0,0.0
28184,2,8184,[ 12 196 742 269 175],207,3,29825,3.643860720830788,20.0,0.0
28185,2,8185,[228 191 222 405 286],85,2,29827,3.6436599071585634,0.0,0.0
28186,2,8186,[132  70 234 172  64],308,3,29830,3.6435812874068647,0.0,0.0
28187,2,8187,[ 50 323 357 678 328],804,5,29835,3.6437469467513433,20.0,20.0
28188,2,8188,[235 313 237 168   8],13,4,29839,3.6437904506044694,0.0,0.0
28189,2,8189,[180 143 568 174  71],881,5,29844,3.643956043956044,0.0,20.0
28190,2,8190,[117  64 196  50   4],194,2,29846,3.6437553412281773,0.0,20.0
28191,2,8191,[405 471 135 161 210],479,4,29850,3.643798828125,0.0,0.0
28192,2,8192,[475 153 197 302 135],334,5,29855,3.643964359819358,0.0,0.0
28193,2,8193,[ 22 195 117 222  79],311,5,29860,3.6441298511105686,0.0,0.0
28194,2,8194,[180 179 235 111   7],537,3,29863,3.64405125076266,0.0,0.0
28195,2,8195,[302 483 100 127 313],232,3,29866,3.643972669594924,20.0,40.0
28196,2,8196,[ 56  28 258   1 173],234,1,29867,3.6436501158960595,0.0,0.0
28197,2,8197,[228 288 257 196 385],533,4,29871,3.643693583800927,0.0,0.0
28198,2,8198,[168  89  50 427 172],385,2,29873,3.6434931089157216,0.0,20.0
28199,2,8199,[121 215 204 174 125],313,4,29877,3.6435365853658537,0.0,20.0
28200,2,8200,[302 483 100 127 313],232,3,29880,3.643458114864041,20.0,40.0
28201,2,8201,[216  97 168 385 100],398,2,29882,3.6432577420141428,0.0,20.0
28202,2,8202,[302 483 100 127 313],329,5,29887,3.6434231378763866,20.0,40.0
28203,2,8203,[302 483 100 127 313],13,5,29892,3.643588493417845,20.0,40.0
28204,2,8204,[143 216 483 151 180],59,4,29896,3.6436319317489336,20.0,0.0
28205,2,8205,[289 135 204   9 655],92,4,29900,3.643675359493054,0.0,0.0
28206,2,8206,[302 483 100 127 313],232,3,29903,3.643596929450469,20.0,40.0
28207,2,8207,[245  11 174 322 273],346,4,29907,3.643640350877193,0.0,20.0
28208,2,8208,[302 483 100 127 313],13,5,29912,3.643805579242295,20.0,40.0
28209,2,8209,[268 273 328 245   8],92,4,29916,3.6438489646772227,0.0,0.0
28210,2,8210,[172 546 235 121 568],290,2,29918,3.6436487638533674,0.0,0.0
28211,2,8211,[ 28 294 237 186 282],207,4,29922,3.6436921578178274,0.0,0.0
28212,2,8212,[265 357  89 211  22],343,3,29925,3.6436137830269084,20.0,0.0
28213,2,8213,[302 483 100 127 313],13,5,29930,3.6437789140491845,20.0,40.0
28214,2,8214,[ 82 286 204 183 237],788,3,29933,3.643700547778454,0.0,0.0
28215,2,8215,[186 187 191 174   7],659,3,29936,3.643622200584226,0.0,20.0
28216,2,8216,[  9  56  11 405 237],64,4,29940,3.6436655713764146,0.0,0.0
28217,2,8217,[276  70 204 655 546],690,2,29942,3.6434655633974202,0.0,0.0
28218,2,8218,[143 603  98 175  25],42,3,29945,3.6433872733909234,20.0,20.0
28219,2,8219,[186 135 144 153 183],653,2,29947,3.6431873479318733,0.0,0.0
28220,2,8220,[471 186 125 568 483],313,3,29950,3.6431091108137696,20.0,0.0
28221,2,8221,[302 483 100 127 313],207,4,29954,3.643152517635612,20.0,40.0
28222,2,8222,[313 238 515 161  28],271,4,29958,3.6431959139000365,0.0,0.0
28223,2,8223,[ 12 357 195  11 475],10,5,29963,3.643360894941634,40.0,0.0
28224,2,8224,[211 132  71 275 174],298,4,29967,3.643404255319149,0.0,20.0
28225,2,8225,[302 483 100 127 313],329,5,29972,3.6435691709214684,20.0,40.0
28226,2,8226,[ 98 234 172  82 173],64,4,29976,3.643612495441838,0.0,20.0
28227,2,8227,[423 603  64 194  97],233,5,29981,3.6437773456490032,20.0,0.0
28228,2,8228,[302 483 100 127 313],537,5,29986,3.643942155790497,20.0,40.0
28229,2,8229,[302 483 100 127 313],329,5,29991,3.6441069258809233,20.0,40.0
28230,2,8230,[515   9 194 174  97],233,5,29996,3.6442716559348804,0.0,20.0
28231,2,8231,[302 483 100 127 313],232,3,29999,3.6441933916423714,20.0,40.0
28232,2,8232,[186 588  22  71  28],897,5,30004,3.6443580711769705,0.0,0.0
28233,2,8233,[ 11  95  89 197 210],749,4,30008,3.644401263055623,0.0,0.0
28234,2,8234,[471  69 121  71 173],194,3,30011,3.6443230115361263,0.0,0.0
28235,2,8235,[546  64 172 403   4],374,2,30013,3.644123360854784,0.0,0.0
28236,2,8236,[302 483 100 127 313],232,3,30016,3.6440451620735703,20.0,40.0
28237,2,8237,[211 423 496   4  88],474,5,30021,3.6442097596504004,0.0,0.0
28238,2,8238,[302 483 100 127 313],90,5,30026,3.6443743172715135,20.0,40.0
28239,2,8239,[302 483 100 127 313],474,5,30031,3.6445388349514563,20.0,40.0
28240,2,8240,[269 508 237 405 385],85,0,30031,3.6440965902196334,0.0,0.0
28241,2,8241,[118   1 196  95  50],374,3,30034,3.644018442125698,0.0,20.0
28242,2,8242,[ 89 135 174 195 237],313,4,30038,3.644061628048041,0.0,20.0
28243,2,8243,[302 483 100 127 313],328,5,30043,3.6442261038330908,20.0,40.0
28244,2,8244,[ 69 202 204  50  70],295,5,30048,3.644390539721043,0.0,20.0
28245,2,8245,[153 678 300 191 197],13,2,30050,3.6441911229687123,0.0,0.0
28246,2,8246,[172 403  28  79  64],833,0,30050,3.64374924214866,0.0,0.0
28247,2,8247,[427  12 333 385 234],328,2,30052,3.643549951503395,20.0,0.0
28248,2,8248,[187 121 237 111 288],334,2,30054,3.64335070917687,0.0,0.0
28249,2,8249,[302 483 100 127 313],537,5,30059,3.6435151515151514,20.0,40.0
28250,2,8250,[121 282 181   4  11],115,4,30063,3.6435583565628407,0.0,0.0
28251,2,8251,[496 546 234  22  70],95,3,30066,3.6434803683955406,0.0,0.0
28252,2,8252,[678 181 245 125 655],804,5,30071,3.6436447352477885,0.0,0.0
28253,2,8253,[ 15 118 228  71 222],92,3,30074,3.6435667555124787,0.0,0.0
28254,2,8254,[678   4 258   1 471],455,3,30077,3.643488794669897,0.0,0.0
28255,2,8255,[127 546 258  89 173],271,2,30079,3.6432897286821704,0.0,20.0
28256,2,8256,[302 483 100 127 313],232,3,30082,3.643211820273707,20.0,40.0
28257,2,8257,[  9 282  69 202  15],533,5,30087,3.6433761201259385,0.0,0.0
28258,2,8258,[228 161 603 185 288],643,4,30091,3.643419300157404,20.0,0.0
28259,2,8259,[210 196  25 300 215],85,2,30093,3.643220338983051,0.0,0.0
28260,2,8260,[302  56  12 301 187],524,4,30097,3.643263527417988,20.0,0.0
28261,2,8261,[161 127 568  56 238],804,3,30100,3.64318566932946,0.0,20.0
28262,2,8262,[195 273 161 176  69],749,4,30104,3.643228851506717,0.0,0.0
28263,2,8263,[302 483 100 127 313],207,4,30108,3.643272023233301,20.0,40.0
28264,2,8264,[427 235 403 568 435],343,4,30112,3.6433151845130065,0.0,0.0
28265,2,8265,[181 173 100 182 405],749,2,30114,3.6431163803532542,0.0,20.0
28266,2,8266,[276 496 427 151 475],334,4,30118,3.6431595500181446,0.0,0.0
28267,2,8267,[161 655  71  64 180],13,5,30123,3.643323657474601,0.0,0.0
28268,2,8268,[237 173  98 357 228],13,3,30126,3.643245858023945,20.0,20.0
28269,2,8269,[ 22 588 603 216 323],650,2,30128,3.6430471584038693,20.0,0.0
28270,2,8270,[302 483 100 127 313],329,5,30133,3.6432112199250395,20.0,40.0
28271,2,8271,[302 483 100 127 313],329,5,30138,3.643375241779497,20.0,40.0
28272,2,8272,[127 174 183 176  50],339,5,30143,3.643539223981627,0.0,60.0
28273,2,8273,[302 483 100 127 313],232,3,30146,3.6434614454919023,20.0,40.0
28274,2,8274,[ 89 678 100 302 655],474,4,30150,3.6435045317220545,0.0,20.0
28275,2,8275,[ 50 427  64 172 273],666,2,30152,3.643305944900918,0.0,20.0
28276,2,8276,[403  15 269 151 323],378,3,30155,3.6432282227860338,0.0,0.0
28277,2,8277,[191 172 125 176  95],406,4,30159,3.6432713215752597,0.0,0.0
28278,2,8278,[ 22 385 269 508 168],537,2,30161,3.6430728348834402,0.0,0.0
28279,2,8279,[183 216 405   4   7],194,1,30162,3.6427536231884057,0.0,0.0
28280,2,8280,[655 258 180 125 678],749,4,30166,3.6427967636758845,0.0,0.0
28281,2,8281,[211   1  22  89 405],279,2,30168,3.6425984061820817,0.0,0.0
28282,2,8282,[204 234 289   8  22],194,2,30170,3.6424000965833634,0.0,0.0
28283,2,8283,[210 151 211 100  56],804,3,30173,3.6423225494929987,0.0,20.0
28284,2,8284,[403 172 204  25 427],59,5,30178,3.6424864212432104,0.0,0.0
28285,2,8285,[172 204 153 568 117],308,4,30182,3.642529567945933,0.0,0.0
28286,2,8286,[302 483 100 127 313],232,3,30185,3.642452033305177,20.0,40.0
28287,2,8287,[191 185 175 211 588],234,1,30186,3.6421332046332044,0.0,0.0
28288,2,8288,[121  97 197  22 265],343,3,30189,3.642055736518277,0.0,0.0
28289,2,8289,[318 100 483 289 748],524,4,30193,3.6420989143546443,40.0,20.0
28290,2,8290,[302 483 100 127 313],90,5,30198,3.642262694487999,20.0,40.0
28291,2,8291,[268  56 385 237  70],119,4,30202,3.6423058369512784,0.0,0.0
28292,2,8292,[301 151 276 475 234],90,3,30205,3.642228385385265,0.0,0.0
28293,2,8293,[135  69 195 132 318],194,2,30207,3.642030383409694,20.0,0.0
28294,2,8294,[302 483 100 127 313],13,5,30212,3.6421940928270042,20.0,40.0
28295,2,8295,[ 69 237 265 132 385],295,5,30217,3.642357762777242,0.0,0.0
28296,2,8296,[ 89 289  64 174 328],13,3,30220,3.642280342292395,0.0,20.0
28297,2,8297,[ 82 195 194 471 282],95,4,30224,3.6423234514340805,0.0,0.0
28298,2,8298,[496  25 200 118   4],666,3,30227,3.6422460537414145,0.0,0.0
28299,2,8299,[423 132 546 182 180],378,3,30230,3.6421686746987953,0.0,0.0
28300,2,8300,[216  28 282 294  12],194,3,30233,3.642091314299482,20.0,0.0
28301,2,8301,[302 483 100 127 313],207,4,30237,3.6421344254396533,20.0,40.0
28302,2,8302,[302 483 100 127 313],474,5,30242,3.6422979645911115,20.0,40.0
28303,2,8303,[132  95 176 423  88],200,5,30247,3.642461464354528,0.0,0.0
28304,2,8304,[228 423 603 333 475],533,4,30251,3.6425045153521975,20.0,0.0
28305,2,8305,[ 50   7 194 385  28],833,0,30251,3.6420659764026007,0.0,20.0
28306,2,8306,[302 483 100 127 313],232,3,30254,3.6419886842422056,20.0,40.0
28307,2,8307,[282  56 276 237 655],194,2,30256,3.6417910447761193,0.0,0.0
28308,2,8308,[176 125 405  12 183],7,3,30259,3.6417138043085813,20.0,0.0
28309,2,8309,[302 483 100 127 313],232,3,30262,3.6416365824308063,20.0,40.0
28310,2,8310,[655 172  97 435 302],210,5,30267,3.641800024064493,0.0,0.0
28311,2,8311,[302 483 100 127 313],329,5,30272,3.641963426371511,20.0,40.0
28312,2,8312,[151 211  50 215  12],380,3,30275,3.641886202333694,20.0,20.0
28313,2,8313,[302 483 100 127 313],232,3,30278,3.641808996872745,20.0,40.0
28314,2,8314,[186 273 127  96  70],374,4,30282,3.641852074564041,0.0,20.0
28315,2,8315,[568 268 603  64 153],13,4,30286,3.6418951418951417,20.0,0.0
28316,2,8316,[100 118  50 183 179],479,2,30288,3.6416977275459903,0.0,40.0
28317,2,8317,[301 678 180 121 546],13,2,30290,3.641500360663621,0.0,0.0
28318,2,8318,[302 483 100 127 313],334,5,30295,3.641663661497776,20.0,40.0
28319,2,8319,[ 11 175 182 151 195],387,3,30298,3.6415865384615387,0.0,0.0
28320,2,8320,[127  70  12 143   8],64,5,30303,3.641749789688739,20.0,20.0
28321,2,8321,[515 204 118 222 385],194,2,30305,3.641552511415525,0.0,0.0
28322,2,8322,[187 423   4 333 210],334,3,30308,3.6414754295326204,0.0,0.0
28323,2,8323,[172  71 588 300 176],7,4,30312,3.6415185007208075,0.0,0.0
28324,2,8324,[135 153   4 496 216],650,4,30316,3.6415615615615615,0.0,0.0
28325,2,8325,[ 28 294 118  56 187],533,4,30320,3.6416046120586114,0.0,0.0
28326,2,8326,[302 483 100 127 313],207,4,30324,3.641647652215684,20.0,40.0
28327,2,8327,[211  98 678 191 655],488,2,30326,3.641450528338136,0.0,20.0
28328,2,8328,[302 483 100 127 313],13,5,30331,3.641613639092328,20.0,40.0
28329,2,8329,[ 95 168 181 118 151],749,3,30334,3.6415366146458585,0.0,0.0
28330,2,8330,[302 483 100 127 313],207,4,30338,3.641579642299844,20.0,40.0
28331,2,8331,[ 97  12 546 228 748],524,2,30340,3.641382621219395,20.0,0.0
28332,2,8332,[ 88 195 294 483 151],848,4,30344,3.641425657026281,20.0,0.0
28333,2,8333,[238 174  25  98 286],59,4,30348,3.6414686825053995,0.0,40.0
28334,2,8334,[302 483 100 127 313],13,5,30353,3.641631673665267,20.0,40.0
28335,2,8335,[173 313   9 655 323],378,4,30357,3.6416746641074855,0.0,0.0
28336,2,8336,[282  95 258  88 216],92,2,30359,3.6414777497900923,0.0,0.0
28337,2,8337,[302 483 100 127 313],90,5,30364,3.641640681218518,20.0,40.0
28338,2,8338,[ 25 333 185  69 748],881,2,30366,3.6414438182036215,0.0,0.0
28339,2,8339,[  1 168 202 301 288],234,0,30366,3.6410071942446045,0.0,0.0
28340,2,8340,[302 483 100 127 313],232,3,30369,3.640930344083443,20.0,40.0
28341,2,8341,[202 181  89 258 294],479,4,30373,3.640973387676816,0.0,0.0
28342,2,8342,[276  97 153  79 197],664,4,30377,3.641016420951696,0.0,0.0
28343,2,8343,[294 135  22 273   1],145,4,30381,3.641059443911793,0.0,0.0
28344,2,8344,[ 25 183 132 186 185],749,5,30386,3.641222288795686,0.0,0.0
28345,2,8345,[268  11  79 265 187],234,1,30387,3.6409058231488136,0.0,0.0
28346,2,8346,[302 483 100 127 313],329,5,30392,3.641068647418234,20.0,40.0
28347,2,8347,[237 318 333 294 216],653,2,30394,3.640872065165309,20.0,0.0
28348,2,8348,[427  70 183 194 135],537,3,30397,3.6407953048269253,0.0,0.0
28349,2,8349,[742 211 216 132  64],346,4,30401,3.6408383233532935,0.0,0.0
28350,2,8350,[182   1 132  12 288],533,3,30404,3.6407615854388697,20.0,0.0
28351,2,8351,[121 222 328 204   1],479,5,30409,3.6409243295019156,0.0,0.0
28352,2,8352,[176 257 180 151 265],653,2,30411,3.640727882198013,0.0,0.0
28353,2,8353,[302 483 100 127 313],90,5,30416,3.640890591333493,20.0,40.0
28354,2,8354,[175 180 268  82 135],537,4,30420,3.6409335727109515,0.0,0.0
28355,2,8355,[323 275 153 238  15],648,3,30423,3.640856869315462,0.0,0.0
28356,2,8356,[258 186 357  15 168],59,4,30427,3.6408998444417855,20.0,0.0
28357,2,8357,[496 191 385 118  95],650,4,30431,3.640942809284518,0.0,0.0
28358,2,8358,[127  25 742 100 515],387,3,30434,3.6408661323124774,0.0,40.0
28359,2,8359,[ 56 211 235 286 289],788,3,30437,3.6407894736842104,0.0,0.0
28360,2,8360,[302   9 483  64 275],90,5,30442,3.640952039229757,20.0,0.0
28361,2,8361,[302 483 100 127 313],537,5,30447,3.641114565893327,20.0,40.0
28362,2,8362,[121 187 176 161 173],648,3,30450,3.6410379050579937,0.0,0.0
28363,2,8363,[222 176 172 588 204],387,2,30452,3.640841702534672,0.0,0.0
28364,2,8364,[182  71 187 276 151],406,2,30454,3.6406455469216974,0.0,0.0
28365,2,8365,[302 483 100 127 313],90,5,30459,3.6408080325125507,20.0,40.0
28366,2,8366,[302 483 100 127 313],13,5,30464,3.6409704792637743,20.0,40.0
28367,2,8367,[655 153  12 117 222],406,2,30466,3.640774378585086,20.0,0.0
28368,2,8368,[302 483 100 127 313],232,3,30469,3.640697813358824,20.0,40.0
28369,2,8369,[423 405 111  69 235],901,3,30472,3.640621266427718,0.0,0.0
28370,2,8370,[180 161 186 211 496],326,3,30475,3.640544737785211,0.0,0.0
28371,2,8371,[143 515 423 210 323],311,3,30478,3.640468227424749,0.0,0.0
28372,2,8372,[302 483 100 127 313],232,3,30481,3.6403917353397826,20.0,40.0
28373,2,8373,[435 588 144 161  97],454,3,30484,3.640315261523764,0.0,0.0
28374,2,8374,[496 222 202  95 196],290,5,30489,3.6404776119402986,0.0,0.0
28375,2,8375,[302 483 100 127 313],232,3,30492,3.640401146131805,20.0,40.0
28376,2,8376,[333 179 151 186 300],666,1,30493,3.6400859496239706,0.0,0.0
28377,2,8377,[302 483 100 127 313],474,5,30498,3.640248269276677,20.0,40.0
28378,2,8378,[357 132  22  64 496],749,5,30503,3.640410550184986,20.0,0.0
28379,2,8379,[748  95 132  15 180],881,2,30505,3.6402147971360383,0.0,0.0
28380,2,8380,[742 546 276 568 117],374,5,30510,3.6403770433122538,0.0,0.0
28381,2,8381,[302 483 100 127 313],232,3,30513,3.640300644237652,20.0,40.0
28382,2,8382,[302 483 100 127 313],207,4,30517,3.640343552427532,20.0,40.0
28383,2,8383,[ 28 175 143  95 121],334,1,30518,3.6400286259541983,0.0,0.0
28384,2,8384,[302 483 100 127 313],328,5,30523,3.640190816935003,20.0,40.0
28385,2,8385,[ 97 603 153 748 271],13,4,30527,3.6402337228714523,20.0,0.0
28386,2,8386,[172  96 180  50   4],346,5,30532,3.6403958507213545,0.0,20.0
28387,2,8387,[302 483 100 127 313],474,5,30537,3.640557939914163,20.0,40.0
28388,2,8388,[ 64 195 568 172  50],311,5,30542,3.6407199904637024,0.0,20.0
28389,2,8389,[ 28  97 483 403 210],7,5,30547,3.64088200238379,20.0,0.0
28390,2,8390,[265 288 357  64 191],666,3,30550,3.6408056250744845,20.0,0.0
28391,2,8391,[ 50 313 195 475  25],13,2,30552,3.640610104861773,0.0,20.0
28392,2,8392,[  1 313  56 318 435],537,3,30555,3.6405337781484572,20.0,0.0
28393,2,8393,[302 117  50  56 195],158,4,30559,3.6405766023350012,0.0,20.0
28394,2,8394,[471 301 186 210  56],524,3,30562,3.6405002977963075,0.0,0.0
28395,2,8395,[385  12  79 111 175],524,2,30564,3.6403049070986184,20.0,0.0
28396,2,8396,[172  88 546 238 174],648,4,30568,3.640347743241634,0.0,20.0
28397,2,8397,[302 483 100 127 313],334,5,30573,3.640509645153608,20.0,40.0
28398,2,8398,[302 483 100 127 313],13,5,30578,3.640671508512918,20.0,40.0
28399,2,8399,[423 273 427 187 228],59,4,30582,3.6407142857142856,0.0,0.0
28400,2,8400,[100 173 135 161 168],474,4,30586,3.640757052731818,0.0,20.0
28401,2,8401,[302 483 100 127 313],232,3,30589,3.6406807902880267,20.0,40.0
28402,2,8402,[237 257  28 204 132],533,4,30593,3.6407235511126976,0.0,0.0
28403,2,8403,[  9  25 202  97  95],194,1,30594,3.640409328891004,0.0,0.0
28404,2,8404,[191 182 405 228 322],334,2,30596,3.6402141582391434,0.0,0.0
28405,2,8405,[302 483 100 127 313],474,5,30601,3.6403759219605045,20.0,40.0
28406,2,8406,[200  98  15 191 238],653,2,30603,3.6401808017128583,0.0,20.0
28407,2,8407,[ 89 161 174 508 286],940,3,30606,3.640104662226451,0.0,20.0
28408,2,8408,[186 180   8 195  70],60,4,30610,3.640147461053633,0.0,0.0
28409,2,8409,[748 258 568 275 222],882,4,30614,3.640190249702735,0.0,0.0
28410,2,8410,[121 187 143 742 153],313,2,30616,3.6399952443229107,0.0,0.0
28411,2,8411,[168 111 172 228 200],643,4,30620,3.640038040893961,0.0,0.0
28412,2,8412,[187 174 216 238 258],653,2,30622,3.6398430999643407,0.0,20.0
28413,2,8413,[302 483 100 127 313],13,5,30627,3.6400047539814593,20.0,40.0
28414,2,8414,[228 234  70  28 183],506,5,30632,3.640166369578134,0.0,0.0
28415,2,8415,[222 271  22 258 655],328,3,30635,3.6400903041825097,0.0,0.0
28416,2,8416,[ 70  98  56 144 181],374,4,30639,3.6401330640370677,0.0,20.0
28417,2,8417,[302 483 100 127 313],329,5,30644,3.640294606794963,20.0,40.0
28418,2,8418,[508 405  22 197 100],560,3,30647,3.6402185532723603,0.0,20.0
28419,2,8419,[302 483 100 127 313],90,5,30652,3.6403800475059382,20.0,40.0
28420,2,8420,[183 132 471  95 117],92,3,30655,3.6403040019000117,0.0,0.0
28421,2,8421,[ 79 546 228 603 143],13,2,30657,3.6401092377107576,20.0,0.0
28422,2,8422,[ 25  28 196 655 197],339,5,30662,3.6402706874035378,0.0,0.0
28423,2,8423,[174 603  96 271 322],13,3,30665,3.6401946818613484,20.0,20.0
28424,2,8424,[117 161 174 125 427],194,3,30668,3.640118694362018,0.0,20.0
28425,2,8425,[186  15 185  79 173],474,5,30673,3.640280085449798,0.0,0.0
28426,2,8426,[282 168 186 216 173],804,5,30678,3.640441438234247,0.0,0.0
28427,2,8427,[182 172   7 328 273],234,0,30678,3.6400094921689607,0.0,0.0
28428,2,8428,[302 483 100 127 313],329,5,30683,3.64017083877091,20.0,40.0
28429,2,8429,[302 483 100 127 313],474,5,30688,3.640332147093713,20.0,40.0
28430,2,8430,[117   1 194 748 180],533,3,30691,3.6402561973668606,0.0,0.0
28431,2,8431,[302 483 100 127 313],207,4,30695,3.6402988614800758,20.0,40.0
28432,2,8432,[200 269  98 172 210],488,2,30697,3.64010435195067,0.0,20.0
28433,2,8433,[678 179 172 194 546],13,2,30699,3.63990988854636,0.0,0.0
28434,2,8434,[302 483 100 127 313],207,4,30703,3.63995257854179,20.0,40.0
28435,2,8435,[176  82 196  98 111],64,4,30707,3.639995258416311,0.0,20.0
28436,2,8436,[302 483 100 127 313],328,5,30712,3.640156453715776,20.0,40.0
28437,2,8437,[ 11   9 238 121  79],145,3,30715,3.6400805878170184,0.0,0.0
28438,2,8438,[ 71  70 144 235 111],398,3,30718,3.6400047398980924,0.0,0.0
28439,2,8439,[302 275  70 515 357],271,5,30723,3.6401658767772513,20.0,0.0
28440,2,8440,[215   4  12 238 172],378,3,30726,3.6400900367255065,20.0,0.0
28441,2,8441,[496 111 182 318 258],454,3,30729,3.6400142146410803,20.0,0.0
28442,2,8442,[200 144  96   4 427],788,2,30731,3.639819969205259,0.0,0.0
28443,2,8443,[215 282 183 185 597],643,2,30733,3.6396257697773566,0.0,0.0
28444,2,8444,[471 200 202 273 222],13,1,30734,3.639313203078745,0.0,0.0
28445,2,8445,[173 273 196 195 405],538,2,30736,3.6391191096376985,0.0,0.0
28446,2,8446,[175 174 182 176   7],804,5,30741,3.639280217828815,0.0,20.0
28447,2,8447,[172 471 216  95 121],13,3,30744,3.6392045454545454,0.0,0.0
28448,2,8448,[357 265 228 172  15],881,3,30747,3.639128890993017,20.0,0.0
28449,2,8449,[118 546  64 237 151],378,3,30750,3.63905325443787,0.0,0.0
28450,2,8450,[ 12 546 182  28 318],328,3,30753,3.6389776357827475,40.0,0.0
28451,2,8451,[435 257  71 742 195],533,5,30758,3.639138665404638,0.0,0.0
28452,2,8452,[302 215 435 275  98],474,4,30762,3.6391813557316928,0.0,20.0
28453,2,8453,[222 275 210 318 175],648,3,30765,3.6391057487579843,20.0,0.0
28454,2,8454,[132 186 385  64 276],13,4,30769,3.639148432879953,0.0,0.0
28455,2,8455,[302 143 257 294  15],378,4,30773,3.6391911069063387,0.0,0.0
28456,2,8456,[180 678 234 276 195],881,3,30776,3.6391155256000944,0.0,0.0
28457,2,8457,[143 174 237 191 182],892,4,30780,3.6391581934263417,0.0,20.0
28458,2,8458,[300 405  98 265 215],7,4,30784,3.63920085116444,0.0,20.0
28459,2,8459,[302 483 100 127 313],232,3,30787,3.6391252955082742,20.0,40.0
28460,2,8460,[176 302  98 180 282],378,4,30791,3.639167947051176,0.0,20.0
28461,2,8461,[423 475  79 515 135],387,3,30794,3.6390924131411015,0.0,0.0
28462,2,8462,[195 111 238  96 197],207,1,30795,3.638780574264445,0.0,0.0
28463,2,8463,[302 483 100 127 313],537,5,30800,3.6389413988657844,20.0,40.0
28464,2,8464,[216 546 238 588  25],295,5,30805,3.6391021854695804,0.0,0.0
28465,2,8465,[302 483 100 127 313],232,3,30808,3.6390266950153554,20.0,40.0
28466,2,8466,[318 172  28 210 282],42,5,30813,3.6391874335656076,20.0,0.0
28467,2,8467,[302 483 100 127 313],328,5,30818,3.639348134152102,20.0,40.0
28468,2,8468,[117  15 211 132 144],447,4,30822,3.6393907190931634,0.0,0.0
28469,2,8469,[302 483 100 127 313],207,4,30826,3.6394332939787484,20.0,40.0
28470,2,8470,[173 228 405  95 187],892,4,30830,3.639475858812419,0.0,0.0
28471,2,8471,[  8  82 235 655  70],308,4,30834,3.6395184135977336,0.0,0.0
28472,2,8472,[269 275 302 265  89],883,3,30837,3.639442936386168,0.0,0.0
28473,2,8473,[ 96 258 117 357 135],328,4,30841,3.639485485012981,20.0,0.0
28474,2,8474,[655  98   1 153 127],379,5,30846,3.639646017699115,0.0,40.0
28475,2,8475,[235 168 185 180 143],537,3,30849,3.6395705521472395,0.0,0.0
28476,2,8476,[143 200 276 748 180],92,2,30851,3.6393771381384923,0.0,0.0
28477,2,8477,[385 328 357 186   4],833,1,30852,3.6390658174097665,20.0,0.0
28478,2,8478,[282   1 328 333  25],141,4,30856,3.6391083854228095,0.0,0.0
28479,2,8479,[237 194 234 288 269],64,5,30861,3.639268867924528,0.0,0.0
28480,2,8480,[211 603 294 276 275],308,4,30865,3.6393114019573165,20.0,0.0
28481,2,8481,[187 183   8 333 195],458,4,30869,3.6393539259608585,0.0,0.0
28482,2,8482,[ 50 235  70 237  95],378,5,30874,3.639514322763173,0.0,20.0
28483,2,8483,[302 483 100 127 313],207,4,30878,3.6395568128241393,20.0,40.0
28484,2,8484,[125 471 191 258 328],313,3,30881,3.6394814378314675,0.0,0.0
28485,2,8485,[179 168 748 187  71],13,4,30885,3.6395239217534763,0.0,0.0
28486,2,8486,[515 748 235 121 678],294,2,30887,3.6393307411334983,0.0,0.0
28487,2,8487,[475 168 286 143 153],343,5,30892,3.6394910461828465,0.0,0.0
28488,2,8488,[187 228  96 323 273],328,2,30894,3.639297914948757,0.0,0.0
28489,2,8489,[302 483 100 127 313],90,5,30899,3.6394581861012956,20.0,40.0
28490,2,8490,[186 302 483 313 204],474,5,30904,3.639618419503003,20.0,0.0
28491,2,8491,[286 182 173 294 496],271,3,30907,3.639543099387659,0.0,0.0
28492,2,8492,[435 423 143  22  97],650,2,30909,3.639350052984811,0.0,0.0
28493,2,8493,[ 71 197 135 181 496],454,2,30911,3.639157052036732,0.0,0.0
28494,2,8494,[121 234 403 135   7],833,1,30912,3.638846380223661,0.0,0.0
28495,2,8495,[302 483 100 127 313],232,3,30915,3.6387711864406778,20.0,40.0
28496,2,8496,[194 237 111  70 175],537,2,30917,3.6385783217606216,0.0,0.0
28497,2,8497,[215 185 427  79 318],380,4,30921,3.638620851965168,20.0,0.0
28498,2,8498,[ 79 204  12 127 181],892,5,30926,3.6387810330627133,20.0,20.0
28499,2,8499,[ 97 265 197 176 508],387,2,30928,3.6385882352941175,0.0,0.0
28500,2,8500,[302 483 100 127 313],207,4,30932,3.638630749323609,20.0,40.0
28501,2,8501,[276 191 258 313 175],537,5,30937,3.638790872735827,0.0,0.0
28502,2,8502,[ 82  15 323  79 265],374,3,30940,3.6387157473832765,0.0,0.0
28503,2,8503,[172 546 483 186 182],374,3,30943,3.638640639698965,20.0,0.0
28504,2,8504,[194 288  88  82 546],533,3,30946,3.638565549676661,0.0,0.0
28505,2,8505,[245 180 118 742 597],804,4,30950,3.6386080413825534,0.0,0.0
28506,2,8506,[125 127 385  15 153],194,2,30952,3.6384154225931584,0.0,20.0
28507,2,8507,[211 176 597  88 289],533,2,30954,3.6382228490832156,0.0,0.0
28508,2,8508,[228 265 222 180 357],533,2,30956,3.6380303208367613,20.0,0.0
28509,2,8509,[302 483 100 127 313],537,5,30961,3.638190364277321,20.0,40.0
28510,2,8510,[144 211 483 194   4],398,4,30965,3.6382328751028084,20.0,0.0
28511,2,8511,[302 483 100 127 313],90,5,30970,3.638392857142857,20.0,40.0
28512,2,8512,[302 483 100 127 313],13,5,30975,3.6385528015975566,20.0,40.0
28513,2,8513,[153 508  82  25  64],343,4,30979,3.638595254874325,0.0,0.0
28514,2,8514,[302 483 100 127 313],537,5,30984,3.638755137991779,20.0,40.0
28515,2,8515,[ 69 269  96 265  28],537,0,30984,3.638327853452325,0.0,0.0
28516,2,8516,[204  12 483 144   9],374,3,30987,3.6382529059528004,40.0,0.0
28517,2,8517,[276 125 403 288 405],59,3,30990,3.638177976050716,0.0,0.0
28518,2,8518,[265 151 568   9 210],374,3,30993,3.6381030637398757,0.0,0.0
28519,2,8519,[200 111 318 288  79],537,1,30994,3.6377934272300467,20.0,0.0
28520,2,8520,[132 181 357 153   1],13,3,30997,3.6377185776317336,20.0,0.0
28521,2,8521,[300  64  15 333  69],537,0,30997,3.6372917155597277,0.0,0.0
28522,2,8522,[515 194 100 322 215],90,4,31001,3.6373342719699635,0.0,20.0
28523,2,8523,[302 483 100 127 313],232,3,31004,3.6372595025809478,20.0,40.0
28524,2,8524,[174 197  88 151 135],479,5,31009,3.6374193548387095,0.0,20.0
28525,2,8525,[  8 143 546 588 216],7,4,31013,3.6374618813042456,0.0,0.0
28526,2,8526,[  8 111 405 508  64],474,4,31017,3.637504397795239,0.0,0.0
28527,2,8527,[194 276 300 385  28],378,5,31022,3.6376641651031894,0.0,0.0
28528,2,8528,[655  28 135 196 234],738,4,31026,3.6377066479071405,0.0,0.0
28529,2,8529,[302 483 100 127 313],328,5,31031,3.6378663540445486,20.0,40.0
28530,2,8530,[ 50 204 127   7 121],892,5,31036,3.638026022740593,0.0,40.0
28531,2,8531,[  4  71 151 196 210],804,4,31040,3.6380684481950305,0.0,0.0
28532,2,8532,[ 89 471 597 127 423],13,3,31043,3.637993671627798,0.0,20.0
28533,2,8533,[302 483 100 127 313],474,5,31048,3.638153269275838,20.0,40.0
28534,2,8534,[385 121 182 748 423],533,3,31051,3.6380785002929117,0.0,0.0
28535,2,8535,[237 181 357 196  88],454,2,31053,3.6378865979381443,20.0,0.0
28536,2,8536,[302 483 100 127 313],537,5,31058,3.6380461520440437,20.0,40.0
28537,2,8537,[ 82  95 117 588 127],313,3,31061,3.6379714218786603,0.0,20.0
28538,2,8538,[ 56 323 237 333 234],537,1,31062,3.6376624897528984,0.0,0.0
28539,2,8539,[151  96 228 237 300],653,3,31065,3.6375878220140514,0.0,0.0
28540,2,8540,[423 144  56 435 153],788,2,31067,3.637396089450884,0.0,0.0
28541,2,8541,[234 127 597  88 405],102,0,31067,3.636970264575041,0.0,20.0
28542,2,8542,[282 597 174 238 195],95,4,31071,3.6370127589839636,0.0,20.0
28543,2,8543,[405 197 121 282 111],334,2,31073,3.6368211610486894,0.0,0.0
28544,2,8544,[258 172 546   7 181],64,3,31076,3.6367466354593327,0.0,0.0
28545,2,8545,[127 546  95 237   1],271,3,31079,3.6366721273110225,0.0,20.0
28546,2,8546,[302 483 100 127 313],328,5,31084,3.6368316368316367,20.0,40.0
28547,2,8547,[302 483 100 127 313],232,3,31087,3.636757136172204,20.0,40.0
28548,2,8548,[182 435 153 204 742],144,3,31090,3.6366826529418645,0.0,0.0
28549,2,8549,[385  56 144 180  88],92,4,31094,3.6367251461988306,0.0,0.0
28550,2,8550,[185   9 215 286 172],881,2,31096,3.6365337387440064,0.0,0.0
28551,2,8551,[  9  50 151 135  12],59,5,31101,3.636693171188026,20.0,20.0
28552,2,8552,[302 483 100 127 313],328,5,31106,3.636852566350988,20.0,40.0
28553,2,8553,[546 153 179 143 175],207,3,31109,3.63677811550152,0.0,0.0
28554,2,8554,[496 405  96  25 588],200,4,31113,3.6368205727644654,0.0,0.0
28555,2,8555,[125  25  98 111 257],749,3,31116,3.6367461430575037,0.0,20.0
28556,2,8556,[161 196 288 181 588],387,1,31117,3.636438003973355,0.0,0.0
28557,2,8557,[ 11 176 435 127   8],455,3,31120,3.6363636363636362,0.0,20.0
28558,2,8558,[302 483 100 127 313],232,3,31123,3.636289286131557,20.0,40.0
28559,2,8559,[196 515 215 153 265],64,4,31127,3.636331775700935,0.0,0.0
28560,2,8560,[302 483 100 127 313],537,5,31132,3.6364910641280224,20.0,40.0
28561,2,8561,[323  98 435 168 403],13,3,31135,3.636416725064237,0.0,20.0
28562,2,8562,[  7  88 515 588 181],102,1,31136,3.636108840359687,0.0,0.0
28563,2,8563,[ 56 300 151 216   8],215,3,31139,3.636034563288183,0.0,0.0
28564,2,8564,[302 483 100 127 313],334,5,31144,3.636193812025686,20.0,40.0
28565,2,8565,[302 483 100 127 313],207,4,31148,3.6362362829792203,20.0,40.0
28566,2,8566,[357 483 318 222   1],380,4,31152,3.6362787440177424,60.0,0.0
28567,2,8567,[ 11 238 144  71 202],406,1,31153,3.635971055088702,0.0,0.0
28568,2,8568,[118 196  25 546 258],882,2,31155,3.6357801377056833,0.0,0.0
28569,2,8569,[294 187 403 176 210],650,1,31156,3.6354725787631272,0.0,0.0
28570,2,8570,[215 125 183 127  69],7,5,31161,3.6356317815890793,0.0,20.0
28571,2,8571,[302 483 100 127 313],13,5,31166,3.635790947270182,20.0,40.0
28572,2,8572,[302 483 100 127 313],207,4,31170,3.6358334305377347,20.0,40.0
28573,2,8573,[405 143 235 228 176],479,3,31173,3.6357592722183343,0.0,0.0
28574,2,8574,[144 185 135 603 204],213,5,31178,3.635918367346939,20.0,0.0
28575,2,8575,[302 483 100 127 313],329,5,31183,3.6360774253731343,20.0,40.0
28576,2,8576,[742 216 300 161 496],313,4,31187,3.6361198554273058,0.0,0.0
28577,2,8577,[322 153   9  69 228],13,3,31190,3.6360456982979716,0.0,0.0
28578,2,8578,[222 546 318 168 568],374,3,31193,3.6359715584566965,20.0,0.0
28579,2,8579,[176  96  97   9  70],60,4,31197,3.636013986013986,0.0,0.0
28580,2,8580,[302 483 100 127 313],90,5,31202,3.636172940216758,20.0,40.0
28581,2,8581,[  7 187 191 196 435],406,3,31205,3.6360988114658586,0.0,0.0
28582,2,8582,[302 483 100 127 313],328,5,31210,3.636257718746359,20.0,40.0
28583,2,8583,[496 385   9 211 210],234,1,31211,3.635950605778192,0.0,0.0
28584,2,8584,[423 211 302 275 405],560,5,31216,3.6361094933022713,0.0,0.0
28585,2,8585,[302 483 100 127 313],232,3,31219,3.636035406475658,20.0,40.0
28586,2,8586,[302 483 100 127 313],328,5,31224,3.636194247117736,20.0,40.0
28587,2,8587,[302 222 288 100  89],339,4,31228,3.6362366092221703,0.0,20.0
28588,2,8588,[185 265  71   9 286],234,0,31228,3.635813249505181,0.0,0.0
28589,2,8589,[202 289  11 228  95],92,2,31230,3.6356228172293363,0.0,0.0
28590,2,8590,[302 483 100 127 313],329,5,31235,3.635781631940403,20.0,40.0
28591,2,8591,[121  97 132 483  82],7,4,31239,3.6358240223463687,20.0,0.0
28592,2,8592,[302 483 100 127 313],537,5,31244,3.635982776678692,20.0,40.0
28593,2,8593,[194  64 257 237 568],533,4,31248,3.636025133814289,0.0,0.0
28594,2,8594,[179 269 144  22 475],207,2,31250,3.6358347876672483,0.0,0.0
28595,2,8595,[302 483 100 127 313],328,5,31255,3.6359934853420195,20.0,40.0
28596,2,8596,[153 100   4 175 471],92,5,31260,3.636152146097476,0.0,20.0
28597,2,8597,[202 546 168 127 403],313,3,31263,3.6360781577110957,0.0,20.0
28598,2,8598,[302 483 100 127 313],90,5,31268,3.6362367717176416,20.0,40.0
28599,2,8599,[200 655 268 194 187],7,4,31272,3.6362790697674416,0.0,0.0
28600,2,8600,[302 483 100 127 313],329,5,31277,3.6364376235321476,20.0,40.0
28601,2,8601,[302 483 100 127 313],90,5,31282,3.6365961404324576,20.0,40.0
28602,2,8602,[276 435   9 301 100],458,4,31286,3.6366383819597816,0.0,20.0
28603,2,8603,[483 271 180 175 403],833,4,31290,3.6366806136680614,20.0,0.0
28604,2,8604,[302 483 100 127 313],474,5,31295,3.6368390470656595,20.0,40.0
28605,2,8605,[471 196 328 271 546],479,3,31298,3.6367650476411804,0.0,0.0
28606,2,8606,[ 69 191 172 187 508],13,3,31301,3.636691065411874,0.0,0.0
28607,2,8607,[302 483 100 127 313],537,5,31306,3.636849442379182,20.0,40.0
28608,2,8608,[302 483 100 127 313],328,5,31311,3.637007782553142,20.0,40.0
28609,2,8609,[475 273 168 195 302],13,2,31313,3.636817653890825,0.0,0.0
28610,2,8610,[423  22 678  69 211],387,2,31315,3.636627569387992,0.0,0.0
28611,2,8611,[302 483 100 127 313],207,4,31319,3.636669763121226,20.0,40.0
28612,2,8612,[302 483 100 127 313],334,5,31324,3.636828050621154,20.0,40.0
28613,2,8613,[118 276  11 234   7],447,5,31329,3.636986301369863,0.0,0.0
28614,2,8614,[161  79 216 180 238],308,3,31332,3.636912362159025,0.0,0.0
28615,2,8615,[258 132  96 168  98],474,4,31336,3.636954503249768,0.0,20.0
28616,2,8616,[144 194 173 742 100],378,5,31341,3.63711268422885,0.0,20.0
28617,2,8617,[302 483 100 127 313],207,4,31345,3.637154792295196,20.0,40.0
28618,2,8618,[181 186 742 183 143],308,5,31350,3.6373129133310127,0.0,0.0
28619,2,8619,[ 25  97 385 173 182],85,1,31351,3.6370069605568447,0.0,0.0
28620,2,8620,[196 318 228 385 508],533,5,31356,3.637165062057766,20.0,0.0
28621,2,8621,[117   9  15 742  96],144,5,31361,3.6373231268847137,0.0,0.0
28622,2,8622,[748 235  89 546 275],328,2,31363,3.6371332482894583,0.0,0.0
28623,2,8623,[ 22 276 172   8 603],13,5,31368,3.637291280148423,20.0,0.0
28624,2,8624,[235 385 289 405 174],378,4,31372,3.6373333333333333,0.0,20.0
28625,2,8625,[ 15  88  79   8 508],406,3,31375,3.637259448179921,0.0,0.0
28626,2,8626,[ 69 294 151 173 228],387,2,31377,3.637069665005216,0.0,0.0
28627,2,8627,[271  98 294 748 186],92,2,31379,3.6368799258229023,0.0,20.0
28628,2,8628,[302 483 100 127 313],207,4,31383,3.6369220071850736,20.0,40.0
28629,2,8629,[302 483 100 127 313],474,5,31388,3.637079953650058,20.0,40.0
28630,2,8630,[257  82 210 515 174],290,4,31392,3.6371220020855057,0.0,20.0
28631,2,8631,[302 483 100 127 313],334,5,31397,3.637279888785913,20.0,40.0
28632,2,8632,[ 25 234 289 183 475],374,3,31400,3.637206069732422,0.0,0.0
28633,2,8633,[357 153  69  12 197],527,5,31405,3.6373639101227706,40.0,0.0
28634,2,8634,[ 12   4 265  71 215],387,2,31407,3.6371742906774753,20.0,0.0
28635,2,8635,[302 483 100 127 313],232,3,31410,3.6371005094951365,20.0,40.0
28636,2,8636,[ 69  79 276  97 222],194,1,31411,3.6367951835127936,0.0,0.0
28637,2,8637,[100 153 204 118 180],378,4,31415,3.6368372308404724,0.0,20.0
28638,2,8638,[568  71  82  50 515],184,3,31418,3.636763514295636,0.0,20.0
28639,2,8639,[144 100   4 288 403],308,4,31422,3.6368055555555556,0.0,20.0
28640,2,8640,[302 483 100 127 313],537,5,31427,3.6369633144312,20.0,40.0
28641,2,8641,[302 483 100 127 313],329,5,31432,3.637121036797038,20.0,40.0
28642,2,8642,[515 144  22 100 234],883,4,31436,3.6371630220988083,0.0,20.0
28643,2,8643,[302 483 100 127 313],328,5,31441,3.6373206848681168,20.0,40.0
28644,2,8644,[322 172 175   1 318],804,5,31446,3.6374783111625217,20.0,0.0
28645,2,8645,[183 210 204  70  25],804,5,31451,3.6376359009946797,0.0,0.0
28646,2,8646,[ 11   9   7 181 294],374,1,31452,3.637330866196369,0.0,0.0
28647,2,8647,[302 483 100 127 313],232,3,31455,3.6372571692876967,20.0,40.0
28648,2,8648,[603 175 135 496  69],474,5,31460,3.6374147300265927,20.0,0.0
28649,2,8649,[302 483 100 127 313],90,5,31465,3.63757225433526,20.0,40.0
28650,2,8650,[143 238  28 196 200],653,2,31467,3.63738296150734,0.0,0.0
28651,2,8651,[187 546 161 234 318],328,4,31471,3.637424872861766,20.0,0.0
28652,2,8652,[ 98 603 132  88 181],313,4,31475,3.637466774529065,20.0,20.0
28653,2,8653,[ 22 546 111 403 127],64,4,31479,3.6375086665125953,0.0,20.0
28654,2,8654,[118   7 182 202 405],795,2,31481,3.637319468515309,0.0,0.0
28655,2,8655,[302 483 100 127 313],207,4,31485,3.637361367837338,20.0,40.0
28656,2,8656,[568   8 180 286 179],85,4,31489,3.6374032574794963,0.0,0.0
28657,2,8657,[302 483 100 127 313],474,5,31494,3.6375606375606377,20.0,40.0
28658,2,8658,[  4  97 238 496   1],308,3,31497,3.6374870077376142,0.0,0.0
28659,2,8659,[302 483 100 127 313],537,5,31502,3.6376443418013857,20.0,40.0
28660,2,8660,[195 269 301 286 127],6,3,31505,3.6375707193164764,0.0,20.0
28661,2,8661,[185 258 288 483 435],234,1,31506,3.6372662202724544,20.0,0.0
28662,2,8662,[172 328 403 153 194],804,4,31510,3.6373080918850285,0.0,0.0
28663,2,8663,[276   9 597 282 357],605,4,31514,3.6373499538319485,20.0,0.0
28664,2,8664,[ 22 300  15 276 181],447,4,31518,3.6373918061165607,0.0,0.0
28665,2,8665,[302 483 100 127 313],537,5,31523,3.637549042234018,20.0,40.0
28666,2,8666,[180 435 238 175 153],6,5,31528,3.6377062420676127,0.0,0.0
28667,2,8667,[302 483 100 127 313],329,5,31533,3.6378634056299033,20.0,40.0
28668,2,8668,[185 294  28 301  56],13,2,31535,3.637674472257469,0.0,0.0
28669,2,8669,[ 69 357 234  89 405],343,3,31538,3.63760092272203,20.0,0.0
28670,2,8670,[176 286 135 196 100],144,5,31543,3.6377580440548956,0.0,20.0
28671,2,8671,[180 655 183 435 197],833,2,31545,3.637569188191882,0.0,0.0
28672,2,8672,[302 483 100 127 313],474,5,31550,3.6377262769514584,20.0,40.0
28673,2,8673,[176  69   1  96  64],899,3,31553,3.6376527553608486,0.0,0.0
28674,2,8674,[ 71 197 405  69 181],455,3,31556,3.637579250720461,0.0,0.0
28675,2,8675,[ 11   9 183   8  96],488,2,31558,3.6373905025357307,0.0,0.0
28676,2,8676,[286 323 135 423 132],788,3,31561,3.6373170450616574,0.0,0.0
28677,2,8677,[187 181 179  82  28],774,1,31562,3.6370131366674348,0.0,0.0
28678,2,8678,[318 603 144  15 194],308,3,31565,3.6369397396013365,40.0,0.0
28679,2,8679,[185  71 318 196 568],13,2,31567,3.6367511520737326,20.0,0.0
28680,2,8680,[ 56 195 144   4 180],738,5,31572,3.6369081903006566,0.0,0.0
28681,2,8681,[423 125 427 483 186],374,2,31574,3.636719649850265,20.0,0.0
28682,2,8682,[302 483 100 127 313],334,5,31579,3.6368766555338015,20.0,40.0
28683,2,8683,[228  96  28 597 181],328,3,31582,3.636803316444035,0.0,0.0
28684,2,8684,[302 483 100 127 313],537,5,31587,3.6369602763385145,20.0,40.0
28685,2,8685,[ 96 173  64  56 268],387,3,31590,3.6368869445084044,0.0,0.0
28686,2,8686,[132 215 187 228 202],194,1,31591,3.636583400483481,0.0,0.0
28687,2,8687,[180 186 161 275  12],378,3,31594,3.636510128913444,20.0,0.0
28688,2,8688,[302 483 100 127 313],232,3,31597,3.6364368742087696,20.0,40.0
28689,2,8689,[182  97   9  50  96],64,4,31601,3.6364787111622556,0.0,20.0
28690,2,8690,[ 97 210 125 313   7],234,1,31602,3.6361753538142905,0.0,0.0
28691,2,8691,[273  71 275 313  79],64,3,31605,3.6361021629084216,0.0,0.0
28692,2,8692,[118 175  71 176  88],738,2,31607,3.6359139537558955,0.0,0.0
28693,2,8693,[161  89 117 405  56],648,2,31609,3.635725787899701,0.0,0.0
28694,2,8694,[588  96  98 117 294],897,3,31612,3.6356526739505464,0.0,20.0
28695,2,8695,[172 515 153 210 174],313,4,31616,3.6356945722171115,0.0,20.0
28696,2,8696,[302 483 100 127 313],474,5,31621,3.635851443026331,20.0,40.0
28697,2,8697,[ 28  98 194 546 508],207,4,31625,3.6358933088066223,0.0,20.0
28698,2,8698,[125 228 196   7  98],194,1,31626,3.635590297735372,0.0,20.0
28699,2,8699,[318 237 185 161 216],374,4,31630,3.635632183908046,20.0,0.0
28700,2,8700,[ 12 191 508  22 161],524,3,31633,3.6355591311343525,20.0,0.0
28701,2,8701,[143  96  12 153 191],406,3,31636,3.63548609515054,20.0,0.0
28702,2,8702,[302 483 100 127 313],90,5,31641,3.6356428817649085,20.0,40.0
28703,2,8703,[302 483 100 127 313],537,5,31646,3.635799632352941,20.0,40.0
28704,2,8704,[302 483 100 127 313],334,5,31651,3.6359563469270535,20.0,40.0
28705,2,8705,[127  28 269 191 180],339,5,31656,3.636113025499655,0.0,20.0
28706,2,8706,[385 271  96 215 196],479,2,31658,3.6359251177213734,0.0,0.0
28707,2,8707,[202 195 435  25 180],848,2,31660,3.635737253100597,0.0,0.0
28708,2,8708,[302 483 100 127 313],207,4,31664,3.6357790791135605,20.0,40.0
28709,2,8709,[302 483 100 127 313],13,5,31669,3.6359357060849598,20.0,40.0
28710,2,8710,[423 100 118 238  79],378,4,31673,3.6359774997130065,0.0,20.0
28711,2,8711,[302 483 100 127 313],13,5,31678,3.63613406795225,20.0,40.0
28712,2,8712,[ 79 228 191 127 151],524,3,31681,3.636061058188913,0.0,20.0
28713,2,8713,[302 483 100 127 313],329,5,31686,3.636217580904292,20.0,40.0
28714,2,8714,[302 483 100 127 313],334,5,31691,3.6363740676993688,20.0,40.0
28715,2,8715,[603 100 216 151  79],82,3,31694,3.6363010555300597,20.0,20.0
28716,2,8716,[302 483 100 127 313],328,5,31699,3.636457496845245,20.0,40.0
28717,2,8717,[180 117 211 161   8],313,4,31703,3.6364991970635465,0.0,0.0
28718,2,8718,[302 483 100 127 313],232,3,31706,3.6364261956646406,20.0,40.0
28719,2,8719,[302 483 100 127 313],474,5,31711,3.6365825688073397,20.0,40.0
28720,2,8720,[161 168 143 125 286],533,5,31716,3.6367389060887514,0.0,0.0
28721,2,8721,[ 15   4 265 161  69],83,4,31720,3.6367805549185968,0.0,0.0
28722,2,8722,[302 483 100 127 313],13,5,31725,3.636936833658145,20.0,40.0
28723,2,8723,[286 546 427  25 127],533,4,31729,3.636978450252178,0.0,20.0
28724,2,8724,[508 385  79  96 172],378,5,31734,3.637134670487106,0.0,0.0
28725,2,8725,[187 222 748 568 294],533,4,31738,3.637176254870502,0.0,0.0
28726,2,8726,[132 588  64  56  97],64,4,31742,3.6372178297238453,0.0,0.0
28727,2,8727,[ 22 483 515 235 181],334,4,31746,3.6372593950504126,20.0,0.0
28728,2,8728,[423 204 111 568  89],385,1,31747,3.6369572688738687,0.0,0.0
28729,2,8729,[302 483 100 127 313],90,5,31752,3.6371134020618556,20.0,40.0
28730,2,8730,[302 483 100 127 313],232,3,31755,3.63704043064941,20.0,40.0
28731,2,8731,[302 483 100 127 313],537,5,31760,3.6371965185524506,20.0,40.0
28732,2,8732,[302 483 100 127 313],329,5,31765,3.6373525707088055,20.0,40.0
28733,2,8733,[ 96 603 181 100 234],312,5,31770,3.6375085871307533,20.0,20.0
28734,2,8734,[403  98 508 302 200],378,4,31774,3.6375500858614767,0.0,20.0
28735,2,8735,[302 483 100 127 313],474,5,31779,3.637706043956044,20.0,40.0
28736,2,8736,[175 276 588   7 515],194,2,31781,3.6375185990614627,0.0,0.0
28737,2,8737,[125 483  70 181 210],158,3,31784,3.637445639734493,20.0,0.0
28738,2,8738,[302 483 100 127 313],329,5,31789,3.637601556242133,20.0,40.0
28739,2,8739,[215 313 678 603 200],308,2,31791,3.6374141876430204,20.0,0.0
28740,2,8740,[405 127 173 546  56],749,2,31793,3.6372268619151127,0.0,20.0
28741,2,8741,[237 200 276  95 172],59,3,31796,3.6371539693434,0.0,0.0
28742,2,8742,[302 483 100 127 603],480,3,31799,3.6370810934461857,40.0,40.0
28743,2,8743,[151 118 288  96 546],897,5,31804,3.6372369624885637,0.0,0.0
28744,2,8744,[151 423 318 117 300],234,2,31806,3.6370497427101203,20.0,0.0
28745,2,8745,[176 175 132  11 300],234,1,31807,3.636748227761262,0.0,0.0
28746,2,8746,[302 483 100 127 603],458,5,31812,3.636904081399337,40.0,40.0
28747,2,8747,[271 508 678 275 187],537,3,31815,3.6368312757201644,0.0,0.0
28748,2,8748,[153 302 144 168 237],346,3,31818,3.6367584866841924,0.0,0.0
28749,2,8749,[  4 151 294 127 132],189,5,31823,3.6369142857142855,0.0,20.0
28750,2,8750,[302 483 100 127 603],474,5,31828,3.6370700491372414,40.0,40.0
28751,2,8751,[ 50 153   1 385 238],387,4,31832,3.637111517367459,0.0,20.0
28752,2,8752,[132 153 286 423  79],184,3,31835,3.63703872957843,0.0,0.0
28753,2,8753,[216 210 228  71 161],64,2,31837,3.6368517249257484,0.0,0.0
28754,2,8754,[302 483 100 127 603],666,5,31842,3.6370074243289547,40.0,40.0
28755,2,8755,[210   4 286  28 423],234,3,31845,3.636934673366834,0.0,0.0
28756,2,8756,[135  79 273 211 174],897,3,31848,3.6368619390202124,0.0,20.0
28757,2,8757,[182 173  79  97 135],454,2,31850,3.636675039963462,0.0,0.0
28758,2,8758,[200  22 204 301 245],334,3,31853,3.6366023518666513,0.0,0.0
28759,2,8759,[197 153   4  56 143],385,3,31856,3.636529680365297,0.0,0.0
28760,2,8760,[195 196  88 265 132],42,4,31860,3.636571167674923,0.0,0.0
28761,2,8761,[210 423 323  70  50],83,4,31864,3.6366126455147225,0.0,20.0
28762,2,8762,[313 268 508 202 471],92,4,31868,3.636654113887938,0.0,0.0
28763,2,8763,[302 483 100 127 603],458,5,31873,3.636809675947056,40.0,40.0
28764,2,8764,[ 89 288 546 215 118],343,1,31874,3.6365088419851683,0.0,0.0
28765,2,8765,[302 496 222 196 210],454,3,31877,3.636436230892083,0.0,0.0
28766,2,8766,[318 655 211  50 204],774,1,31878,3.6361355081555833,20.0,20.0
28767,2,8767,[302 483 100 127 603],10,5,31883,3.6362910583941606,40.0,40.0
28768,2,8768,[302 483 100 127 603],10,5,31888,3.636446573155434,40.0,40.0
28769,2,8769,[ 56 222 187 323 175],506,4,31892,3.6364880273660205,0.0,0.0
28770,2,8770,[222 111 228 175 176],653,1,31893,3.636187435868202,0.0,0.0
28771,2,8771,[322  56 588 100  97],313,3,31896,3.6361149110807114,0.0,20.0
28772,2,8772,[302 483 100 127 603],480,3,31899,3.636042402826855,40.0,40.0
28773,2,8773,[302 483 100 127 603],13,5,31904,3.636197857305676,40.0,40.0
28774,2,8774,[302 483 100 127 603],334,5,31909,3.6363532763532764,40.0,40.0
28775,2,8775,[211  28 678  11  12],537,1,31910,3.6360528714676392,20.0,0.0
28776,2,8776,[215 427 210 276 496],298,4,31914,3.6360943374729406,0.0,0.0
28777,2,8777,[ 56 496 151 403 161],334,3,31917,3.636021872863978,0.0,0.0
28778,2,8778,[302 483 100 127 603],10,5,31922,3.6361772411436384,40.0,40.0
28779,2,8779,[286 423 210 282  28],207,3,31925,3.6361047835990887,0.0,0.0
28780,2,8780,[405 276   4   7 179],59,4,31929,3.636146224803553,0.0,0.0
28781,2,8781,[302 483 100 127 603],334,5,31934,3.636301525848326,40.0,40.0
28782,2,8782,[403 588 100 179 197],194,4,31938,3.6363429352157577,0.0,20.0
28783,2,8783,[302 483 100 127 603],13,5,31943,3.636498178506375,40.0,40.0
28784,2,8784,[302 483 100 127 603],745,3,31946,3.6364257256687536,40.0,40.0
28785,2,8785,[194 405 427  88 100],13,4,31950,3.636467106760756,0.0,20.0
28786,2,8786,[318 423 143 172 483],313,4,31954,3.6365084784340502,40.0,0.0
28787,2,8787,[210 174 742 300 127],288,3,31957,3.636436049157943,0.0,40.0
28788,2,8788,[302 483 100 127 603],474,5,31962,3.6365911935373765,40.0,40.0
28789,2,8789,[132 300 289 153  82],328,4,31966,3.636632536973834,0.0,0.0
28790,2,8790,[ 15 742 258 385 117],749,4,31970,3.636673871004436,0.0,0.0
28791,2,8791,[ 98   8 100 186 180],92,5,31975,3.6368289353958145,0.0,40.0
28792,2,8792,[235  98   1  50 191],650,3,31978,3.636756510860912,0.0,40.0
28793,2,8793,[313 235 174 405 322],13,2,31980,3.6365703889015237,0.0,20.0
28794,2,8794,[ 56 204   9  98 288],474,4,31984,3.6366117111995453,0.0,20.0
28795,2,8795,[197 603 257 427 200],308,4,31988,3.6366530241018644,20.0,0.0
28796,2,8796,[302 483 100 127 603],232,4,31992,3.6366943276116857,40.0,40.0
28797,2,8797,[357 405 185 301  50],537,3,31995,3.6366219595362583,20.0,20.0
28798,2,8798,[269 161 182  69 180],85,4,31999,3.636663257188317,0.0,0.0
28799,2,8799,[ 56 117 234  98 195],533,3,32002,3.636590909090909,0.0,20.0
28800,2,8800,[496 179 237  89 286],7,5,32007,3.6367458243381434,0.0,0.0
28801,2,8801,[238 275 194   9 210],7,5,32012,3.636900704385367,0.0,0.0
28802,2,8802,[302 483 100 127 603],664,5,32017,3.6370555492445757,40.0,40.0
28803,2,8803,[222 597 204 186 603],897,5,32022,3.63721035892776,20.0,0.0
28804,2,8804,[302 483 100 127 603],10,5,32027,3.637365133446905,40.0,40.0
28805,2,8805,[302 483 100 127 603],666,5,32032,3.6375198728139906,40.0,40.0
28806,2,8806,[289 405 197 294  50],881,1,32033,3.6372203928693083,0.0,20.0
28807,2,8807,[302 483 100 127 603],13,5,32038,3.637375113533152,40.0,40.0
28808,2,8808,[179 238 435 496 483],766,3,32041,3.6373027585424,20.0,0.0
28809,2,8809,[187  64 180 427 237],6,4,32045,3.637343927355278,0.0,0.0
28810,2,8810,[ 96 121 125 235 181],897,3,32048,3.6372715923277723,0.0,0.0
28811,2,8811,[302 483 100 127 603],664,5,32053,3.637426236949614,40.0,40.0
28812,2,8812,[ 50 121 125 195 475],669,1,32054,3.6371269715193466,0.0,20.0
28813,2,8813,[323 568 202  70 258],378,3,32057,3.637054685727252,0.0,0.0
28814,2,8814,[117 161 282 216 288],92,2,32059,3.636868973340896,0.0,0.0
28815,2,8815,[302 483 100 127 603],537,5,32064,3.6370235934664246,40.0,40.0
28816,2,8816,[302 483 100 603 127],480,3,32067,3.6369513439945558,40.0,40.0
28817,2,8817,[302 483 100 603 127],524,4,32071,3.636992515309594,40.0,40.0
28818,2,8818,[302 483 100 127 603],232,4,32075,3.637033677287674,40.0,40.0
28819,2,8819,[  7 385 168 258 508],343,4,32079,3.6370748299319726,0.0,0.0
28820,2,8820,[302 483 100 127 603],664,5,32084,3.637229339077202,40.0,40.0
28821,2,8821,[302 483 100 127 603],474,5,32089,3.637383813194287,40.0,40.0
28822,2,8822,[ 98  12 273 323  79],548,5,32094,3.637538252295138,20.0,20.0
28823,2,8823,[302 483 100 127 603],664,5,32099,3.637692656391659,40.0,40.0
28824,2,8824,[ 96 678  71 742 175],881,2,32101,3.6375070821529745,0.0,0.0
28825,2,8825,[302 483 100 127 603],745,3,32104,3.637434851574892,40.0,40.0
28826,2,8826,[302 483 100 127 603],339,5,32109,3.6375892149088025,40.0,40.0
28827,2,8827,[302 483 100 603 127],334,5,32114,3.637743543271409,40.0,40.0
28828,2,8828,[322  70 496 176 135],804,4,32118,3.63778457356439,0.0,0.0
28829,2,8829,[168 211 172 323 271],506,4,32122,3.6378255945639864,0.0,0.0
28830,2,8830,[302 483 100 603 127],13,5,32127,3.6379798437323068,40.0,40.0
28831,2,8831,[302 483 100 603 127],458,5,32132,3.6381340579710146,40.0,40.0
28832,2,8832,[ 79 234 385 191 175],59,5,32137,3.6382882372919734,0.0,0.0
28833,2,8833,[185  56 748 286 237],454,2,32139,3.6381027846954948,0.0,0.0
28834,2,8834,[302 483 100 603 127],524,4,32143,3.6381437464629314,40.0,40.0
28835,2,8835,[302 483 100 127 603],664,5,32148,3.6382978723404253,40.0,40.0
28836,2,8836,[302 483 100 127 603],13,5,32153,3.6384519633359735,40.0,40.0
28837,2,8837,[483 427  56  69  50],454,3,32156,3.6383797239194386,20.0,20.0
28838,2,8838,[181 258 508 435 237],378,5,32161,3.6385337707885506,0.0,0.0
28839,2,8839,[302 483 100 127 603],339,5,32166,3.63868778280543,40.0,40.0
28840,2,8840,[245 288 678   9 183],92,3,32169,3.6386155412283676,0.0,0.0
28841,2,8841,[118 403 385 204 127],892,3,32172,3.638543315991857,0.0,20.0
28842,2,8842,[182 174 294  11 161],7,2,32174,3.638358023295262,0.0,20.0
28843,2,8843,[210 568  22 405  11],92,2,32176,3.6381727725011306,0.0,0.0
28844,2,8844,[168  15 172 234 179],406,4,32180,3.638213680045223,0.0,0.0
28845,2,8845,[302 483 100 127 603],524,4,32184,3.6382545783404927,40.0,40.0
28846,2,8846,[194 204 179 748 357],899,4,32188,3.638295467390076,20.0,0.0
28847,2,8847,[121 588 318 161  95],378,5,32193,3.6384493670886076,20.0,0.0
28848,2,8848,[ 70 276 234 496 275],883,3,32196,3.6383772177647193,0.0,0.0
28849,2,8849,[302 483 100 127 603],339,5,32201,3.6385310734463276,40.0,40.0
28850,2,8850,[271 678 435 483  88],13,3,32204,3.6384589311942155,20.0,0.0
28851,2,8851,[301 269  69 435 496],6,3,32207,3.6383868052417534,0.0,0.0
28852,2,8852,[515 258 135 191 269],339,4,32211,3.638427651643511,0.0,0.0
28853,2,8853,[302 483 100 127 603],334,5,32216,3.638581432121075,40.0,40.0
28854,2,8854,[195 185   9 289 125],234,1,32217,3.63828345567476,0.0,0.0
28855,2,8855,[204 568 294 655  11],538,1,32218,3.637985546522132,0.0,0.0
28856,2,8856,[ 82 742 118 121 275],328,4,32222,3.638026419780964,0.0,0.0
28857,2,8857,[302 483 100 127 603],537,5,32227,3.638180176111989,40.0,40.0
28858,2,8858,[302 483 100 127 603],474,5,32232,3.638333897731121,40.0,40.0
28859,2,8859,[234 175 286 603 318],213,4,32236,3.6383747178329573,40.0,0.0
28860,2,8860,[ 98 405 132  11 111],334,2,32238,3.638189820562013,0.0,20.0
28861,2,8861,[143 118 216 197 211],524,4,32242,3.6382306477093205,0.0,0.0
28862,2,8862,[174  69   4 111 132],13,5,32247,3.6383842942570235,0.0,20.0
28863,2,8863,[  9   7 258 197 257],144,4,32251,3.6384250902527078,0.0,0.0
28864,2,8864,[568 174 211 475   9],90,4,32255,3.638465877044557,0.0,20.0
28865,2,8865,[302 483 100 127 603],232,4,32259,3.638506654635687,40.0,40.0
28866,2,8866,[655   9 322 196 235],308,2,32261,3.6383218675989624,0.0,0.0
28867,2,8867,[302 483 100 127 603],13,5,32266,3.6384754172304916,40.0,40.0
28868,2,8868,[ 95 197 186 222 172],749,3,32269,3.6384034276694104,0.0,0.0
28869,2,8869,[100 210 588 211 111],13,4,32273,3.638444193912063,0.0,20.0
28870,2,8870,[302 483 100 127 603],474,5,32278,3.6385976778266262,40.0,40.0
28871,2,8871,[405 216 127 678 475],648,2,32280,3.638412984670875,0.0,20.0
28872,2,8872,[202  96 121 235 144],804,5,32285,3.638566437507044,0.0,0.0
28873,2,8873,[302 483 100 127 603],10,5,32290,3.6387198557583953,40.0,40.0
28874,2,8874,[302 483 100 127 603],339,5,32295,3.6388732394366197,40.0,40.0
28875,2,8875,[174  50 151 194 211],60,5,32300,3.6390265885534023,0.0,40.0
28876,2,8876,[302 483 100 127 603],474,5,32305,3.6391799031204237,40.0,40.0
28877,2,8877,[  1 405   7 483  98],537,2,32307,3.638995269204776,20.0,20.0
28878,2,8878,[302 483 100 603 127],334,5,32312,3.639148552764951,40.0,40.0
28879,2,8879,[ 98 183 245 435 216],804,4,32316,3.639189189189189,0.0,20.0
28880,2,8880,[301 333 427 282  79],85,1,32317,3.63889201666479,0.0,0.0
28881,2,8881,[191 153 302 742 132],378,5,32322,3.6390452600765593,0.0,0.0
28882,2,8882,[191 222   4 204 127],804,4,32326,3.6390858944050435,0.0,20.0
28883,2,8883,[302 483 100 603 127],13,5,32331,3.6392390814948223,40.0,40.0
28884,2,8884,[204 151 176 273 194],378,4,32335,3.639279684862127,0.0,0.0
28885,2,8885,[ 28 508 132 222 175],537,2,32337,3.6390952059419313,0.0,0.0
28886,2,8886,[182 211 168 228  69],650,3,32340,3.6390232924496457,0.0,0.0
28887,2,8887,[302 483 100 603 127],664,5,32345,3.6391764176417642,40.0,40.0
28888,2,8888,[211 357  88 318 143],648,3,32348,3.6391045111936102,40.0,0.0
28889,2,8889,[234 276  25 235 182],406,4,32352,3.6391451068616423,0.0,0.0
28890,2,8890,[302 483 100 603 127],13,5,32357,3.6392981666854123,40.0,40.0
28891,2,8891,[204 196 153 385  88],326,2,32359,3.6391138101664415,0.0,0.0
28892,2,8892,[302 483 100 603 127],666,5,32364,3.6392668390869223,40.0,40.0
28893,2,8893,[302 483 100 603 127],745,3,32367,3.6391949628963345,40.0,40.0
28894,2,8894,[302 483 100 603 127],232,4,32371,3.6392355255761664,40.0,40.0
28895,2,8895,[302 483 100 603 127],537,5,32376,3.639388489208633,40.0,40.0
28896,2,8896,[678   4 132 196  89],92,3,32379,3.6393166235809824,0.0,0.0
28897,2,8897,[302 483 100 603 127],524,4,32383,3.639357158912115,40.0,40.0
28898,2,8898,[191 151 216  98 135],474,4,32387,3.639397685133161,0.0,20.0
28899,2,8899,[435 197 200 427 179],59,5,32392,3.6395505617977526,0.0,0.0
28900,2,8900,[302 483 100 603 127],13,5,32397,3.6397034041118976,40.0,40.0
28901,2,8901,[121 435  64 333 182],666,3,32400,3.6396315434733766,0.0,0.0
28902,2,8902,[302 483 100 603 127],480,3,32403,3.6395596989778727,40.0,40.0
28903,2,8903,[288 245  50 153 176],102,1,32404,3.6392632524707995,0.0,20.0
28904,2,8904,[302 483 100 603 127],10,5,32409,3.6394160583941604,40.0,40.0
28905,2,8905,[302 483 100 603 127],480,3,32412,3.639344262295082,40.0,40.0
28906,2,8906,[  8 302  56 269 276],232,3,32415,3.6392724823172786,0.0,0.0
28907,2,8907,[496 483 475  88 276],339,5,32420,3.6394252357431522,20.0,0.0
28908,2,8908,[742 237 151 186 245],653,2,32422,3.6392412167471098,0.0,0.0
28909,2,8909,[405  56 176 568 257],533,2,32424,3.639057239057239,0.0,0.0
28910,2,8910,[288 204 210   7  50],308,5,32429,3.639209965211536,0.0,20.0
28911,2,8911,[  9  82 211 269 121],207,3,32432,3.639138240574506,0.0,0.0
28912,2,8912,[302 483 100 603 127],474,5,32437,3.639290923370358,40.0,40.0
28913,2,8913,[302 483 100 603 127],664,5,32442,3.639443571909356,40.0,40.0
28914,2,8914,[302 483 100 603 127],232,4,32446,3.6394840157038697,40.0,40.0
28915,2,8915,[191  22 228 187 215],387,4,32450,3.6395244504262,0.0,0.0
28916,2,8916,[228 276 127 403 288],13,3,32453,3.6394527307390376,0.0,20.0
28917,2,8917,[121 286 234 180 182],7,5,32458,3.6396052926665172,0.0,0.0
28918,2,8918,[132 127 180  50 234],452,3,32461,3.6395335799977575,0.0,40.0
28919,2,8919,[216 168  22 187 515],6,4,32465,3.6395739910313902,0.0,0.0
28920,2,8920,[257 238 655 200 423],210,4,32469,3.6396143930052687,0.0,0.0
28921,2,8921,[302 483 100 603 127],537,5,32474,3.6397668684151534,40.0,40.0
28922,2,8922,[568  96   8 117   1],311,5,32479,3.6399193096492213,0.0,0.0
28923,2,8923,[302 483 100 603 127],537,5,32484,3.64007171671896,40.0,40.0
28924,2,8924,[318  11 289 186 194],13,2,32486,3.639887955182073,20.0,0.0
28925,2,8925,[302 483 100 603 127],90,5,32491,3.640040331615505,40.0,40.0
28926,2,8926,[435 127 318 175  12],194,4,32495,3.6400806541951383,40.0,20.0
28927,2,8927,[302 483 100 603 127],90,5,32500,3.6402329749103943,40.0,40.0
28928,2,8928,[211 127 403 187 435],385,2,32502,3.6400492776346733,0.0,20.0
28929,2,8929,[302 483 100 603 127],339,5,32507,3.64020156774916,40.0,40.0
28930,2,8930,[435  79  89 180  69],85,4,32511,3.6402418542156534,0.0,0.0
28931,2,8931,[ 70 174 151 195 135],378,2,32513,3.6400582176444245,0.0,20.0
28932,2,8932,[125  97 435  69  89],815,5,32518,3.6402104556140156,0.0,0.0
28933,2,8933,[588 288  97  71 210],387,1,32519,3.6399149317215134,0.0,0.0
28934,2,8934,[302 483 100 603 127],90,5,32524,3.6400671516508116,40.0,40.0
28935,2,8935,[  1 182 187 173 568],488,1,32525,3.639771709937332,0.0,0.0
28936,2,8936,[195 257 265 496  82],804,5,32530,3.639923911827235,0.0,0.0
28937,2,8937,[302 483 100 603 127],10,5,32535,3.6400760796598792,40.0,40.0
28938,2,8938,[153 168 546 275 385],95,3,32538,3.640004474773465,0.0,0.0
28939,2,8939,[187 194  89 289 678],387,2,32540,3.639821029082774,0.0,0.0
28940,2,8940,[302 483 100 603 127],339,5,32545,3.639973157364948,40.0,40.0
28941,2,8941,[195 496  25 197  12],234,2,32547,3.6397897562066652,20.0,0.0
28942,2,8942,[181 135 153 588  96],815,4,32551,3.639830034663983,0.0,0.0
28943,2,8943,[132 238 183 427 483],313,5,32556,3.6399821109123436,20.0,0.0
28944,2,8944,[302 483 100 603 127],458,5,32561,3.640134153158189,40.0,40.0
28945,2,8945,[302 483 100 603 127],90,5,32566,3.640286161412922,40.0,40.0
28946,2,8946,[151 191 121   4 385],83,3,32569,3.640214597071644,0.0,0.0
28947,2,8947,[121 385 176 435  56],13,3,32572,3.6401430487259723,0.0,0.0
28948,2,8948,[ 15 588 191 172 195],313,4,32576,3.6401832606995197,0.0,0.0
28949,2,8949,[302 483 100 603 127],480,3,32579,3.6401117318435756,40.0,40.0
28950,2,8950,[289  69  12 385 161],454,2,32581,3.639928499608982,20.0,0.0
28951,2,8951,[357 238 742 168  98],881,3,32584,3.6398570151921357,20.0,20.0
28952,2,8952,[174 435 161 357 210],59,4,32588,3.6398972411482187,20.0,20.0
28953,2,8953,[302 483 100 603 127],745,3,32591,3.6398257761894124,40.0,40.0
28954,2,8954,[286 302 568 135  70],13,2,32593,3.63964265773311,0.0,0.0
28955,2,8955,[202 568 427 515 211],343,4,32597,3.639682894149174,0.0,0.0
28956,2,8956,[132 286 403  69  25],934,5,32602,3.639834766104723,0.0,0.0
28957,2,8957,[302 483 100 603 127],232,4,32606,3.639874972091985,40.0,40.0
28958,2,8958,[302 483 100 603 127],745,3,32609,3.6398035495032928,40.0,40.0
28959,2,8959,[302 483 100 603 127],13,5,32614,3.639955357142857,40.0,40.0
28960,2,8960,[302 483 100 603 127],13,5,32619,3.640107130900569,40.0,40.0
28961,2,8961,[302 483 100 603 127],745,3,32622,3.6400357063155546,40.0,40.0
28962,2,8962,[ 97 238 423 288 228],64,4,32626,3.640075867455093,0.0,0.0
28963,2,8963,[302 483 100 603 127],334,5,32631,3.640227576974565,40.0,40.0
28964,2,8964,[603 161 385 176 211],326,2,32633,3.6400446179587282,20.0,0.0
28965,2,8965,[216 228  15 202 322],234,0,32633,3.6396386348427394,0.0,0.0
28966,2,8966,[302 483 100 603 127],90,5,32638,3.639790342366455,40.0,40.0
28967,2,8967,[273 181 269   7 276],486,4,32642,3.639830508474576,0.0,0.0
28968,2,8968,[202 135 238 748 210],543,2,32644,3.639647675326123,0.0,0.0
28969,2,8969,[183 174  97  28  50],234,3,32647,3.639576365663322,0.0,40.0
28970,2,8970,[235 176 228 313 405],738,3,32650,3.639505071898339,0.0,0.0
28971,2,8971,[258 234   8 210 181],13,4,32654,3.6395452518947837,0.0,0.0
28972,2,8972,[111 117 235 181 151],294,4,32658,3.639585422935473,0.0,0.0
28973,2,8973,[302 483 100 603 127],664,5,32663,3.6397370180521507,40.0,40.0
28974,2,8974,[302 483 100 603 127],232,4,32667,3.6397771587743732,40.0,40.0
28975,2,8975,[210 228 318 144 121],387,2,32669,3.6395944741532977,20.0,0.0
28976,2,8976,[302 483 100 603 127],664,5,32674,3.6397460176005345,40.0,40.0
28977,2,8977,[302 483 100 603 127],745,3,32677,3.6396747605257294,40.0,40.0
28978,2,8978,[ 70 144   4   1 161],378,4,32681,3.639714890299588,0.0,0.0
28979,2,8979,[ 22 423 322 202  69],537,0,32681,3.6393095768374164,0.0,0.0
28980,2,8980,[151 181   7 161 196],374,1,32682,3.6390156998107117,0.0,0.0
28981,2,8981,[302 483 100 603 127],339,5,32687,3.63916722333556,40.0,40.0
28982,2,8982,[194 215 132 265 204],7,5,32692,3.6393187131247915,0.0,0.0
28983,2,8983,[302 483 100 603 127],745,3,32695,3.639247551202137,40.0,40.0
28984,2,8984,[195 117 222  56  69],537,1,32696,3.6389538119087366,0.0,0.0
28985,2,8985,[173 185  89 176 183],897,4,32700,3.6389939906521254,0.0,0.0
28986,2,8986,[302 483 100 603 127],664,5,32705,3.639145432291087,40.0,40.0
28987,2,8987,[ 56 187  95 276 111],59,4,32709,3.639185580774366,0.0,0.0
28988,2,8988,[ 50 328  11 200   8],334,4,32713,3.6392257203248413,0.0,20.0
28989,2,8989,[294  71 127 143  88],374,2,32715,3.639043381535039,0.0,20.0
28990,2,8990,[168 153  89 258 496],64,2,32717,3.6388610833055277,0.0,0.0
28991,2,8991,[204 172 180  71 742],313,4,32721,3.6389012455516014,0.0,0.0
28992,2,8992,[302 289 117 435 234],13,3,32724,3.6388302012676528,0.0,0.0
28993,2,8993,[265 202 127 185 200],234,2,32726,3.638647987547254,0.0,20.0
28994,2,8994,[302 483 100 603 127],339,5,32731,3.638799332962757,40.0,40.0
28995,2,8995,[302 483 100 603 127],524,4,32735,3.638839484215207,40.0,40.0
28996,2,8996,[302 483 100 603 127],474,5,32740,3.6389907747026786,40.0,40.0
28997,2,8997,[135 271  56 603 180],843,2,32742,3.6388086241386977,20.0,0.0
28998,2,8998,[302 483 100 603 127],524,4,32746,3.6388487609734415,40.0,40.0
28999,2,8999,[265 144  71 210 185],488,3,32749,3.638777777777778,0.0,0.0
29000,2,9000,[302 483 100 603 127],480,3,32752,3.638706810354405,40.0,40.0
29001,2,9001,[302 483 100 603 127],90,5,32757,3.6388580315485446,40.0,40.0
29002,2,9002,[172  69 151 211 294],387,2,32759,3.6386759968899254,0.0,0.0
29003,2,9003,[202  28 405  22  70],279,1,32760,3.638382940915149,0.0,0.0
29004,2,9004,[ 11 546 275 597  89],560,3,32763,3.6383120488617435,0.0,0.0
29005,2,9005,[ 56 182 496 282 276],533,2,32765,3.6381301354652456,0.0,0.0
29006,2,9006,[423 200 186  64 258],666,3,32768,3.63805928722105,0.0,0.0
29007,2,9007,[216 182 204 179  22],406,3,32771,3.637988454706927,0.0,0.0
29008,2,9008,[  1 286 100 180 288],537,2,32773,3.6378066378066376,0.0,20.0
29009,2,9009,[ 22 265 127  50 180],488,4,32777,3.6378468368479466,0.0,40.0
29010,2,9010,[302 483 100 603 127],10,5,32782,3.6379980024414604,40.0,40.0
29011,2,9011,[143 183 282  97  11],804,4,32786,3.6380381713271195,0.0,0.0
29012,2,9012,[238  88  50 318  71],848,5,32791,3.6381892821480086,20.0,20.0
29013,2,9013,[475 257 228 546   1],479,3,32794,3.638118482360772,0.0,0.0
29014,2,9014,[ 50  70  22 111 405],271,4,32798,3.6381586245146975,0.0,20.0
29015,2,9015,[210 174  79  70 180],653,4,32802,3.638198757763975,0.0,20.0
29016,2,9016,[302 483 100 603 127],232,4,32806,3.638238882111567,40.0,40.0
29017,2,9017,[403 515 181 173 132],92,3,32809,3.6381681082279886,0.0,0.0
29018,2,9018,[ 98  71  95 222 568],892,4,32813,3.6382082270761726,0.0,20.0
29019,2,9019,[276 176 181 328 603],548,4,32817,3.6382483370288248,20.0,0.0
29020,2,9020,[323 742 127 194  95],881,3,32820,3.638177585633522,0.0,20.0
29021,2,9021,[302 483 100 603 127],334,5,32825,3.638328530259366,40.0,40.0
29022,2,9022,[ 79 180  82 286 118],666,2,32827,3.638146957774576,0.0,0.0
29023,2,9023,[211  98 168  95  56],313,2,32829,3.637965425531915,0.0,20.0
29024,2,9024,[186 132 179  96 151],95,3,32832,3.6378947368421053,0.0,0.0
29025,2,9025,[302 483 100 603 127],458,5,32837,3.6380456459118102,40.0,40.0
29026,2,9026,[ 98 357  88 483  69],311,5,32842,3.6381965215464716,40.0,20.0
29027,2,9027,[302 483 100 603 127],664,5,32847,3.6383473637572,40.0,40.0
29028,2,9028,[302 483 100 603 127],334,5,32852,3.6384981725551,40.0,40.0
29029,2,9029,[172 318 237 153 603],454,3,32855,3.6384274640088594,40.0,0.0
29030,2,9030,[211 204 121 286  71],380,2,32857,3.638246041412911,0.0,0.0
29031,2,9031,[302 483 100 603 127],666,5,32862,3.6383968113374667,40.0,40.0
29032,2,9032,[302 483 100 603 127],474,5,32867,3.6385475478799956,40.0,40.0
29033,2,9033,[302 483 100 603 127],232,4,32871,3.6385875581137923,40.0,40.0
29034,2,9034,[  4 210 202 127 515],537,2,32873,3.638406198118428,0.0,20.0
29035,2,9035,[603 202  88 100 496],840,5,32878,3.638556883576804,20.0,20.0
29036,2,9036,[302 483 100 603 127],458,5,32883,3.638707535686622,40.0,40.0
29037,2,9037,[427 144  22 182 200],788,3,32886,3.638636866563399,0.0,0.0
29038,2,9038,[302 483 100 603 127],745,3,32889,3.638566213076668,40.0,40.0
29039,2,9039,[302 483 100 603 127],474,5,32894,3.638716814159292,40.0,40.0
29040,2,9040,[302 483 100 603 127],480,3,32897,3.6386461674593518,40.0,40.0
29041,2,9041,[  1   9 423 121 173],374,2,32899,3.6384649413846493,0.0,0.0
29042,2,9042,[ 82 132  89 282  98],92,3,32902,3.638394338162114,0.0,20.0
29043,2,9043,[181 176  69 228  70],59,4,32906,3.63843432109686,0.0,0.0
29044,2,9044,[323  98  22 210 483],488,3,32909,3.6383637368711996,20.0,20.0
29045,2,9045,[302 483 100 603 127],339,5,32914,3.6385142604466063,40.0,40.0
29046,2,9046,[302 483 100 603 127],524,4,32918,3.63855421686747,40.0,40.0
29047,2,9047,[302 483 100 603 127],745,3,32921,3.6384836427939877,40.0,40.0
29048,2,9048,[238 135 132  97 655],378,3,32924,3.6384130843187092,0.0,0.0
29049,2,9049,[135 168 435 597  69],13,4,32928,3.638453038674033,0.0,0.0
29050,2,9050,[313 200 275  56  89],145,4,32932,3.638492984200641,0.0,0.0
29051,2,9051,[302 483 100 603 127],334,5,32937,3.6386433937251437,40.0,40.0
29052,2,9052,[ 71 748 515 588 117],311,5,32942,3.6387937700209876,0.0,0.0
29053,2,9053,[302 483 100 603 127],537,5,32947,3.638944113099183,40.0,40.0
29054,2,9054,[302 483 100 603 127],745,3,32950,3.638873550524572,40.0,40.0
29055,2,9055,[588  95 191 182 175],64,5,32955,3.639023851590106,0.0,0.0
29056,2,9056,[175 211 385  22  89],479,4,32959,3.639063707629458,0.0,0.0
29057,2,9057,[132 496 172 143 210],200,5,32964,3.6392139545153457,0.0,0.0
29058,2,9058,[228 546 144 168 200],343,3,32967,3.63914339331052,0.0,0.0
29059,2,9059,[302 483 100 603 127],90,5,32972,3.6392935982339956,40.0,40.0
29060,2,9060,[132   4  96   9 153],326,2,32974,3.6391126807195673,0.0,0.0
29061,2,9061,[143 185 135  96 196],95,3,32977,3.6390421540498785,0.0,0.0
29062,2,9062,[ 97 210  11  96 185],537,1,32978,3.6387509654639745,0.0,0.0
29063,2,9063,[302 483 100 603 127],10,5,32983,3.638901147396293,40.0,40.0
29064,2,9064,[357 385  79 174 568],648,4,32987,3.638940981798125,20.0,20.0
29065,2,9065,[216  12 403  28 204],234,1,32988,3.638649900727995,20.0,0.0
29066,2,9066,[302 483 100 603 127],13,5,32993,3.6388000441160253,40.0,40.0
29067,2,9067,[515  28  50   7 471],234,3,32996,3.638729598588443,0.0,20.0
29068,2,9068,[ 79 742 228 153   7],92,4,33000,3.6387694343367514,0.0,0.0
29069,2,9069,[ 95 323  11 161 215],59,3,33003,3.638699007717751,0.0,0.0
29070,2,9070,[403 168 276  12 405],92,4,33007,3.638738838055341,20.0,0.0
29071,2,9071,[151 100 186 276 302],378,3,33010,3.638668430335097,0.0,20.0
29072,2,9072,[302 483 100 603 127],339,5,33015,3.6388184723906094,40.0,40.0
29073,2,9073,[302 483 100 603 127],232,4,33019,3.638858276394093,40.0,40.0
29074,2,9074,[235 121 180 405   1],479,4,33023,3.6388980716253445,0.0,0.0
29075,2,9075,[265  82 211  96 202],830,3,33026,3.638827677390921,0.0,0.0
29076,2,9076,[302 483 100 603 127],90,5,33031,3.6389776357827475,40.0,40.0
29077,2,9077,[405 100  79  11 588],537,1,33032,3.6386869354483364,0.0,20.0
29078,2,9078,[357  25  96  79  11],804,5,33037,3.6388368763079635,20.0,0.0
29079,2,9079,[194 655 100 289  22],788,4,33041,3.638876651982379,0.0,20.0
29080,2,9080,[288 121  71 237 273],64,2,33043,3.63869617883493,0.0,0.0
29081,2,9081,[294 172 508 186 179],774,1,33044,3.6384056375247744,0.0,0.0
29082,2,9082,[302 483 100 603 127],232,4,33048,3.6384454475393593,40.0,40.0
29083,2,9083,[333  98 143   1 197],298,5,33053,3.638595332452664,0.0,20.0
29084,2,9084,[125  71 151 423 135],892,4,33057,3.638635112823335,0.0,0.0
29085,2,9085,[302 483 100 603 127],664,5,33062,3.6387849438696898,40.0,40.0
29086,2,9086,[235 678 168 211  88],308,3,33065,3.6387146472983383,0.0,0.0
29087,2,9087,[302 483 100 603 127],90,5,33070,3.6388644366197185,40.0,40.0
29088,2,9088,[125 182 185  97 294],7,4,33074,3.638904169875674,0.0,0.0
29089,2,9089,[302 483 100 603 127],664,5,33079,3.639053905390539,40.0,40.0
29090,2,9090,[202  98  79 118  97],454,3,33082,3.638983610163898,0.0,20.0
29091,2,9091,[302 483 100 603 127],480,3,33085,3.638913330400352,40.0,40.0
29092,2,9092,[197 216 546 322 435],308,1,33086,3.638623116683163,0.0,0.0
29093,2,9093,[302 483 100 603 127],666,5,33091,3.638772817242138,40.0,40.0
29094,2,9094,[151 202 194 257 237],749,3,33094,3.638702583837273,0.0,0.0
29095,2,9095,[121 333 286 204 179],85,3,33097,3.63863236587511,0.0,0.0
29096,2,9096,[271 333 302 268 222],537,2,33099,3.6384522370012093,0.0,0.0
29097,2,9097,[302 483 100 603 127],666,5,33104,3.6386018905253903,40.0,40.0
29098,2,9098,[302 483 100 603 127],664,5,33109,3.638751511155072,40.0,40.0
29099,2,9099,[423  96 172   7 175],378,5,33114,3.638901098901099,0.0,0.0
29100,2,9100,[302 483 100 603 127],537,5,33119,3.6390506537743104,40.0,40.0
29101,2,9101,[483  89 235 257 405],290,2,33121,3.638870577894968,20.0,0.0
29102,2,9102,[300 210 328 179 222],749,4,33125,3.6389102493683403,0.0,0.0
29103,2,9103,[302 483 100 603 127],664,5,33130,3.6390597539543057,40.0,40.0
29104,2,9104,[328   1 194  28  12],378,4,33134,3.6390993959362987,20.0,0.0
29105,2,9105,[194 179 238  82 173],648,4,33138,3.639139029211509,0.0,0.0
29106,2,9106,[302 483 100 603 127],524,4,33142,3.6391786537828046,40.0,40.0
29107,2,9107,[ 89 546 173 211 405],95,1,33143,3.638888888888889,0.0,0.0
29108,2,9108,[135 294 202 179 200],653,3,33146,3.6388187506861347,0.0,0.0
29109,2,9109,[ 64 273  79 176  50],749,5,33151,3.6389681668496157,0.0,20.0
29110,2,9110,[302 483 100 603 127],339,5,33156,3.639117550214027,40.0,40.0
29111,2,9111,[121  95 200 183 210],92,3,33159,3.6390474100087795,0.0,0.0
29112,2,9112,[302 483 100 603 127],537,5,33164,3.6391967518929,40.0,40.0
29113,2,9113,[302 483 100 603 127],666,5,33169,3.639346061005047,40.0,40.0
29114,2,9114,[403 496 117 405 151],95,3,33172,3.63927591881514,0.0,0.0
29115,2,9115,[ 89   1   8 655  56],690,4,33176,3.639315489249671,0.0,0.0
29116,2,9116,[127 483  71 300 187],749,4,33180,3.6393550510036197,20.0,20.0
29117,2,9117,[ 12 195  70  28 423],892,5,33185,3.6395042772537836,20.0,0.0
29118,2,9118,[ 95 168 286 153 111],648,3,33188,3.639434148481193,0.0,0.0
29119,2,9119,[172 186 144 222 237],653,1,33189,3.639144736842105,0.0,0.0
29120,2,9120,[302 483 100 603 127],666,5,33194,3.6392939370683037,40.0,40.0
29121,2,9121,[194 211 187  98 228],638,1,33195,3.6390046042534534,0.0,20.0
29122,2,9122,[183  71 176 313 471],815,4,33199,3.639044174065549,0.0,0.0
29123,2,9123,[302 483 100 603 127],524,4,33203,3.639083735203858,40.0,40.0
29124,2,9124,[302 483 100 603 127],232,4,33207,3.6391232876712327,40.0,40.0
29125,2,9125,[182 118 172 323  89],454,1,33208,3.638834100372562,0.0,0.0
29126,2,9126,[204 161 496 127 568],659,4,33212,3.6388736715240495,0.0,20.0
29127,2,9127,[173   9   1 172 132],200,5,33217,3.639022787028922,0.0,0.0
29128,2,9128,[117 215  71  95 132],92,3,33220,3.638952787819038,0.0,0.0
29129,2,9129,[234 403 185 127 496],653,1,33221,3.6386637458926616,0.0,20.0
29130,2,9130,[238 172 185 318 588],479,4,33225,3.638703318366006,20.0,0.0
29131,2,9131,[302 483 100 603 127],537,5,33230,3.6388523872098117,40.0,40.0
29132,2,9132,[257 323 117 132 515],881,3,33233,3.6387824373152307,0.0,0.0
29133,2,9133,[302 483 100 603 127],474,5,33238,3.63893146485658,40.0,40.0
29134,2,9134,[ 50 202 204 258 182],666,3,33241,3.638861521620142,0.0,20.0
29135,2,9135,[302 483 100 603 127],334,5,33246,3.6390105078809105,40.0,40.0
29136,2,9136,[302 483 100 603 127],745,3,33249,3.6389405713034915,40.0,40.0
29137,2,9137,[186 234 191   4 405],189,3,33252,3.63887065003283,0.0,0.0
29138,2,9138,[302 483 100 603 127],664,5,33257,3.6390195863880073,40.0,40.0
29139,2,9139,[194 185 181 151 568],804,4,33261,3.639059080962801,0.0,0.0
29140,2,9140,[302 483 100 603 127],664,5,33266,3.6392079641177113,40.0,40.0
29141,2,9141,[496 174 127 294 200],537,2,33268,3.6390286589367755,0.0,40.0
29142,2,9142,[  7 568 265 301 181],13,2,33270,3.638849392978235,0.0,0.0
29143,2,9143,[191 176 323 151 196],881,2,33272,3.6386701662292213,0.0,0.0
29144,2,9144,[302 180 322  50 301],328,3,33275,3.638600328048114,0.0,20.0
29145,2,9145,[742 301 100 161 132],378,4,33279,3.638639842554122,0.0,20.0
29146,2,9146,[302 483 100 603 127],10,5,33284,3.6387886738821473,40.0,40.0
29147,2,9147,[302 483 100 603 127],232,4,33288,3.638828159160472,40.0,40.0
29148,2,9148,[546 176 216 180 186],882,4,33292,3.638867635807192,0.0,0.0
29149,2,9149,[302 483 100 603 127],232,4,33296,3.6389071038251366,40.0,40.0
29150,2,9150,[228   9 196 117 132],815,4,33300,3.638946563217135,0.0,0.0
29151,2,9151,[135 301   8 222 180],85,4,33304,3.638986013986014,0.0,0.0
29152,2,9152,[302 483 100 603 127],745,3,33307,3.6389162023380313,40.0,40.0
29153,2,9153,[302 483 100 603 127],90,5,33312,3.63906488966572,40.0,40.0
29154,2,9154,[258 423  69 483 515],474,5,33317,3.639213544511196,20.0,0.0
29155,2,9155,[ 98 196 515 475 127],64,5,33322,3.639362166885103,0.0,40.0
29156,2,9156,[  9 216 301   4  50],940,2,33324,3.639183138582505,0.0,20.0
29157,2,9157,[265 132  69 288  98],488,3,33327,3.639113343524787,0.0,20.0
29158,2,9158,[186 182 176 357 289],10,5,33332,3.639261928158096,20.0,0.0
29159,2,9159,[127 125 211  82 238],207,3,33335,3.6391921397379914,0.0,20.0
29160,2,9160,[302 483 100 603 127],480,3,33338,3.6391223665538694,40.0,40.0
29161,2,9161,[742  64  50   1 187],313,4,33342,3.6391617550753113,0.0,20.0
29162,2,9162,[515 215 197  95  15],194,3,33345,3.639092000436538,0.0,0.0
29163,2,9163,[118 197 132 245 191],313,4,33349,3.639131383675251,0.0,0.0
29164,2,9164,[216 183  64  89 546],145,4,33353,3.6391707583196946,0.0,0.0
29165,2,9165,[ 11 678 496 271 238],334,2,33355,3.638991926685577,0.0,0.0
29166,2,9166,[302 483 100 603 127],537,5,33360,3.639140394894731,40.0,40.0
29167,2,9167,[300 202 357  69 180],311,5,33365,3.6392888307155324,20.0,0.0
29168,2,9168,[175  70   9  56 286],10,4,33369,3.6393281710110155,0.0,0.0
29169,2,9169,[168 228  22  28 195],892,4,33373,3.6393675027262815,0.0,0.0
29170,2,9170,[302 483 100 603 127],745,3,33376,3.639297786500927,40.0,40.0
29171,2,9171,[275 186 118 216 204],7,4,33380,3.639337112952464,0.0,0.0
29172,2,9172,[ 69  56  50 211   4],804,4,33384,3.639376430829609,0.0,20.0
29173,2,9173,[435 215 282 151  28],406,1,33385,3.6390887290167866,0.0,0.0
29174,2,9174,[ 79 151 182 174 269],64,4,33389,3.6391280653950955,0.0,20.0
29175,2,9175,[234 100  79 603 238],64,4,33393,3.639167393199651,20.0,20.0
29176,2,9176,[302 483 100 603 127],745,3,33396,3.6390977443609023,40.0,40.0
29177,2,9177,[ 56  28  95 405 228],313,0,33396,3.6387012421006757,0.0,0.0
29178,2,9178,[237 286  25  12 385],455,1,33397,3.638413770563242,20.0,0.0
29179,2,9179,[179 265 597 204 210],59,4,33401,3.6384531590413944,0.0,0.0
29180,2,9180,[ 69 121 210 168 288],64,3,33404,3.6383836183422287,0.0,0.0
29181,2,9181,[  4 265 117 546   1],455,2,33406,3.6382051840557614,0.0,0.0
29182,2,9182,[302 483 100 603 127],537,5,33411,3.6383534792551453,40.0,40.0
29183,2,9183,[302 483 100 603 127],666,5,33416,3.6385017421602788,40.0,40.0
29184,2,9184,[403 172 118 300 302],328,3,33419,3.6384322264561786,0.0,0.0
29185,2,9185,[302 483 100 603 127],10,5,33424,3.6385804485086,40.0,40.0
29186,2,9186,[322 144  22  98 515],488,3,33427,3.63851093937085,0.0,20.0
29187,2,9187,[302 483 100 603 127],339,5,33432,3.6386591205920764,40.0,40.0
29188,2,9188,[195 471  89 118   4],13,3,33435,3.6385896180215473,0.0,0.0
29189,2,9189,[588 546 742 282 168],881,3,33438,3.6385201305767136,0.0,0.0
29190,2,9190,[ 70  28 475  79 197],334,3,33441,3.6384506582526384,0.0,0.0
29191,2,9191,[172  69  28 186 323],59,5,33446,3.6385987815491734,0.0,0.0
29192,2,9192,[302 483 100 603 127],232,4,33450,3.6386380942021104,40.0,40.0
29193,2,9193,[273 275  69 117 180],537,2,33452,3.638459865129432,0.0,0.0
29194,2,9194,[302 483 100 603 127],10,5,33457,3.6386079390973354,40.0,40.0
29195,2,9195,[302 483 100 603 127],664,5,33462,3.638755980861244,40.0,40.0
29196,2,9196,[302 483 100 603 127],664,5,33467,3.6389039904316625,40.0,40.0
29197,2,9197,[302 483 100 603 127],664,5,33472,3.639051967819091,40.0,40.0
29198,2,9198,[435  95 135 196  97],378,4,33476,3.639091205565822,0.0,0.0
29199,2,9199,[183  64  25   9  50],339,5,33481,3.6392391304347824,0.0,20.0
29200,2,9200,[195 181 175 318 265],59,5,33486,3.6393870231496575,20.0,0.0
29201,2,9201,[ 88  82 234 238  98],92,3,33489,3.6393175396652904,0.0,20.0
29202,2,9202,[302 483 100 603 127],666,5,33494,3.6394653917200914,40.0,40.0
29203,2,9203,[302 483 100 603 127],458,5,33499,3.63961321164711,40.0,40.0
29204,2,9204,[405 742 151 210 117],290,1,33500,3.639326453014666,0.0,0.0
29205,2,9205,[357 228  15  69 204],194,4,33504,3.6393656311101457,20.0,0.0
29206,2,9206,[ 15 294 238   9  69],474,4,33508,3.6394048006951234,0.0,0.0
29207,2,9207,[302 483 100 603 127],666,5,33513,3.6395525629887056,40.0,40.0
29208,2,9208,[483  69 117 175 238],184,2,33515,3.639374524921273,20.0,0.0
29209,2,9209,[117 357 135 286 132],653,4,33519,3.6394136807817588,20.0,0.0
29210,2,9210,[302 483 100 603 127],666,5,33524,3.6395613939854523,40.0,40.0
29211,2,9211,[302 483 100 603 127],334,5,33529,3.6397090751194097,40.0,40.0
29212,2,9212,[200  50 228  71 176],254,2,33531,3.639531097362423,0.0,20.0
29213,2,9213,[118 435 568 742 215],650,2,33533,3.6393531582374647,0.0,0.0
29214,2,9214,[187 216  12 143  69],13,3,33536,3.639283776451438,20.0,0.0
29215,2,9215,[196 294 195 186  98],207,3,33539,3.6392144097222223,0.0,20.0
29216,2,9216,[597 265  50 483   4],308,2,33541,3.639036562872952,20.0,20.0
29217,2,9217,[302 483 100 603 127],537,5,33546,3.639184204816663,40.0,40.0
29218,2,9218,[300 328  71 181 161],378,4,33550,3.6392233430957805,0.0,0.0
29219,2,9219,[302 483 100 603 127],474,5,33555,3.639370932754881,40.0,40.0
29220,2,9220,[ 15  95 143 179 132],406,4,33559,3.639410042294762,0.0,0.0
29221,2,9221,[302 483 100 603 127],458,5,33564,3.639557579700716,40.0,40.0
29222,2,9222,[  8 182 202 405 211],897,3,33567,3.639488235931909,0.0,0.0
29223,2,9223,[ 15 135 172 175 322],749,4,33571,3.6395273200346923,0.0,0.0
29224,2,9224,[194 655 143 483  89],474,5,33576,3.6396747967479675,20.0,0.0
29225,2,9225,[271 194  82  88 172],506,5,33581,3.639822241491437,0.0,0.0
29226,2,9226,[174 204 222   4 172],650,4,33585,3.6398612766879808,0.0,20.0
29227,2,9227,[197 187 186 258 496],488,3,33588,3.639791937581274,0.0,0.0
29228,2,9228,[117 265  79  22  64],95,4,33592,3.6398309676021237,0.0,0.0
29229,2,9229,[302 483 100 603 127],524,4,33596,3.639869989165764,40.0,40.0
29230,2,9230,[302 483 100 603 127],537,5,33601,3.640017332900011,40.0,40.0
29231,2,9231,[302 483 100 603 127],90,5,33606,3.640164644714038,40.0,40.0
29232,2,9232,[143 191  70  64 196],653,2,33608,3.6399870031409076,0.0,0.0
29233,2,9233,[302 483 100 603 127],232,4,33612,3.640025990903184,40.0,40.0
29234,2,9234,[302 483 100 603 127],339,5,33617,3.6401732539252842,40.0,40.0
29235,2,9235,[100 222 234 180 228],881,3,33620,3.640103941100043,0.0,20.0
29236,2,9236,[ 82 222 333 237 313],533,4,33624,3.6401429035401103,0.0,0.0
29237,2,9237,[357  98 257 286 483],666,4,33628,3.640181857544923,40.0,20.0
29238,2,9238,[ 89  96  98 234 132],537,1,33629,3.63989609265072,0.0,20.0
29239,2,9239,[174 111 186 204 182],378,3,33632,3.63982683982684,0.0,20.0
29240,2,9240,[302 483 100 603 127],474,5,33637,3.6399740287847635,40.0,40.0
29241,2,9241,[323 322 195 121 288],13,1,33638,3.6396883791387147,0.0,0.0
29242,2,9242,[282 196  22   1 234],378,5,33643,3.6398355512279563,0.0,0.0
29243,2,9243,[302 483 100 603 127],458,5,33648,3.6399826914755518,40.0,40.0
29244,2,9244,[302 483 100 603 127],458,5,33653,3.6401297998918336,40.0,40.0
29245,2,9245,[302 483 100 603 127],474,5,33658,3.6402768764871296,40.0,40.0
29246,2,9246,[ 15 588 197 195 423],454,3,33661,3.640207634908619,0.0,0.0
29247,2,9247,[228 183 186 496 100],406,3,33664,3.640138408304498,0.0,20.0
29248,2,9248,[143 210  98 204 496],653,2,33666,3.6399610768731754,0.0,20.0
29249,2,9249,[302 483 100 603 127],480,3,33669,3.639891891891892,40.0,40.0
29250,2,9250,[302 483 100 603 127],13,5,33674,3.640038914711923,40.0,40.0
29251,2,9251,[258 187  64  96 269],64,4,33678,3.640077821011673,0.0,0.0
29252,2,9252,[ 22 175 273 135  98],883,3,33681,3.640008645844591,0.0,20.0
29253,2,9253,[183  97 173  12 515],339,5,33686,3.640155608385563,20.0,0.0
29254,2,9254,[265 603 216 181 179],650,4,33690,3.640194489465154,20.0,0.0
29255,2,9255,[302 483 100 603 127],745,3,33693,3.6401253241140883,40.0,40.0
29256,2,9256,[302 483 100 603 127],10,5,33698,3.640272226423247,40.0,40.0
29257,2,9257,[302 483 100 603 127],666,5,33703,3.6404190969971917,40.0,40.0
29258,2,9258,[245 151 328 153 143],334,2,33705,3.6402419267739496,0.0,0.0
29259,2,9259,[302 483 100 603 127],524,4,33709,3.640280777537797,40.0,40.0
29260,2,9260,[301   7  56  12  79],524,3,33712,3.64021164021164,20.0,0.0
29261,2,9261,[204 181   1  96 121],843,0,33712,3.639818613690348,0.0,0.0
29262,2,9262,[ 50   1  79 168 597],882,5,33717,3.6399654539566013,0.0,20.0
29263,2,9263,[216  95 144 265 195],899,4,33721,3.640004317789292,0.0,0.0
29264,2,9264,[302 483 100 603 127],232,4,33725,3.6400431732325957,40.0,40.0
29265,2,9265,[435 210  11 181 117],378,3,33728,3.6399740988560327,0.0,0.0
29266,2,9266,[385 118 265 237 174],524,3,33731,3.6399050393870724,0.0,20.0
29267,2,9267,[100 748  95 269 333],13,3,33734,3.639835994820889,0.0,20.0
29268,2,9268,[ 95 496 258 228  89],234,1,33735,3.6395511921458628,0.0,0.0
29269,2,9269,[302 483 100 603 127],334,5,33740,3.639697950377562,40.0,40.0
29270,2,9270,[302 483 100 603 127],524,4,33744,3.639736813720203,40.0,40.0
29271,2,9271,[222 200   7 238 427],334,5,33749,3.6398835202761,0.0,0.0
29272,2,9272,[ 12 176  79 496  70],883,3,33752,3.639814515259355,20.0,0.0
29273,2,9273,[ 50 153 423 471 121],95,5,33757,3.6399611817985766,0.0,20.0
29274,2,9274,[302 483 100 603 127],474,5,33762,3.6401078167115903,40.0,40.0
29275,2,9275,[302 483 100 603 127],745,3,33765,3.640038809831824,40.0,40.0
29276,2,9276,[302 483 100 603 127],664,5,33770,3.640185404764471,40.0,40.0
29277,2,9277,[302 483 100 603 127],524,4,33774,3.640224186247036,40.0,40.0
29278,2,9278,[174 257 196  70 173],378,5,33779,3.6403707296044834,0.0,20.0
29279,2,9279,[118  82 515 187 313],308,2,33781,3.6401939655172413,0.0,0.0
29280,2,9280,[302 483 100 603 127],232,4,33785,3.640232733541644,40.0,40.0
29281,2,9281,[603 357 151 173 286],213,4,33789,3.6402714932126696,40.0,0.0
29282,2,9282,[302 483 100 603 127],339,5,33794,3.6404179683292037,40.0,40.0
29283,2,9283,[302 483 100 603 127],334,5,33799,3.640564411891426,40.0,40.0
29284,2,9284,[202  25 210 200 182],7,3,33802,3.640495422724825,0.0,0.0
29285,2,9285,[302 483 100 603 127],458,5,33807,3.6406418264053415,40.0,40.0
29286,2,9286,[ 88 125  64 742 182],533,4,33811,3.640680521158609,0.0,0.0
29287,2,9287,[302 483 100 603 127],666,5,33816,3.640826873385013,40.0,40.0
29288,2,9288,[742 176 235 204 322],92,2,33818,3.6406502314565614,0.0,0.0
29289,2,9289,[302 483 100 603 127],666,5,33823,3.6407965554359527,40.0,40.0
29290,2,9290,[215 173 588 211  89],537,3,33826,3.640727585835755,0.0,0.0
29291,2,9291,[196 228 385  79 322],749,4,33830,3.640766250538097,0.0,0.0
29292,2,9292,[288 196 194 423  82],339,3,33833,3.64069729904229,0.0,0.0
29293,2,9293,[302 483 100 603 127],745,3,33836,3.640628362384334,40.0,40.0
29294,2,9294,[185  79  15 200  97],488,4,33840,3.64066702528241,0.0,0.0
29295,2,9295,[ 69 174 168 144 182],833,3,33843,3.6405981067125643,0.0,20.0
29296,2,9296,[235  88 275 655 153],13,3,33846,3.6405292029686995,0.0,0.0
29297,2,9297,[215   4 265 180 403],194,2,33848,3.6403527640352764,0.0,0.0
29298,2,9298,[302 483 100 603 127],13,5,33853,3.6404989783847728,40.0,40.0
29299,2,9299,[  4 182 427 153 216],234,2,33855,3.640322580645161,0.0,0.0
29300,2,9300,[302 483 100 603 127],666,5,33860,3.640468766799269,40.0,40.0
29301,2,9301,[302 483 100 603 127],232,4,33864,3.6405074177596215,40.0,40.0
29302,2,9302,[ 69  25 273  56  22],308,3,33867,3.6404385682038054,0.0,0.0
29303,2,9303,[191 597   1 143 403],653,3,33870,3.6403697334479794,0.0,0.0
29304,2,9304,[302 483 100 603 127],334,5,33875,3.6405158516926384,40.0,40.0
29305,2,9305,[328 588 748 568 403],647,4,33879,3.640554480980013,0.0,0.0
29306,2,9306,[144  98  89  82 265],308,2,33881,3.6403782099495006,0.0,20.0
29307,2,9307,[117 204 300  79 195],479,3,33884,3.640309411259132,0.0,0.0
29308,2,9308,[475 238  50  25  15],537,3,33887,3.6402406273498764,0.0,20.0
29309,2,9309,[302 483 100 603 127],524,4,33891,3.640279269602578,40.0,40.0
29310,2,9310,[118   9 168  79 144],308,3,33894,3.640210503705295,0.0,0.0
29311,2,9311,[168 175 161 357 151],804,4,33898,3.640249140893471,20.0,0.0
29312,2,9312,[211 202 235  98  71],738,2,33900,3.6400730162138943,0.0,20.0
29313,2,9313,[125  82 118  11 187],7,2,33902,3.639896929353661,0.0,0.0
29314,2,9314,[211 200  79 143 153],479,4,33906,3.639935587761675,0.0,0.0
29315,2,9315,[121 405  97 427 588],13,4,33910,3.6399742378703306,0.0,0.0
29316,2,9316,[302 483 100 603 127],458,5,33915,3.6401202103681443,40.0,40.0
29317,2,9317,[302 483 100 603 127],745,3,33918,3.6400515132002575,40.0,40.0
29318,2,9318,[302 483 100 603 127],474,5,33923,3.6401974460779054,40.0,40.0
29319,2,9319,[302 483 100 603 127],339,5,33928,3.640343347639485,40.0,40.0
29320,2,9320,[302 483 100 603 127],524,4,33932,3.6403819332689626,40.0,40.0
29321,2,9321,[302 483 100 603 127],664,5,33937,3.6405277837373955,40.0,40.0
29322,2,9322,[496 168 195 483 515],474,4,33941,3.6405663413064464,20.0,0.0
29323,2,9323,[546 508 168 187 172],833,3,33944,3.6404976404976406,0.0,0.0
29324,2,9324,[ 71 515 286  98  56],488,3,33947,3.6404289544235926,0.0,20.0
29325,2,9325,[194 143 174 357 132],882,4,33951,3.6404675101865753,20.0,20.0
29326,2,9326,[302 483 100 603 127],458,5,33956,3.6406132732925913,40.0,40.0
29327,2,9327,[215  89 302  96 276],90,4,33960,3.6406518010291595,0.0,0.0
29328,2,9328,[302 483 100 603 127],537,5,33965,3.640797513131097,40.0,40.0
29329,2,9329,[302 483 100 603 127],339,5,33970,3.6409431939978565,40.0,40.0
29330,2,9330,[143 151 172 185 204],406,3,33973,3.640874504340371,0.0,0.0
29331,2,9331,[289 385 121 202  22],538,2,33975,3.6406986712387486,0.0,0.0
29332,2,9332,[117 275 174 181   7],184,2,33977,3.6405228758169934,0.0,20.0
29333,2,9333,[237  71 282 318 173],899,4,33981,3.640561388472252,20.0,0.0
29334,2,9334,[302 483 100 603 127],13,5,33986,3.640707016604178,40.0,40.0
29335,2,9335,[ 97 176 508   9 423],184,4,33990,3.640745501285347,0.0,0.0
29336,2,9336,[302 483 100 603 127],334,5,33995,3.640891078504873,40.0,40.0
29337,2,9337,[ 79 211 125 288  70],64,4,33999,3.6409295352323836,0.0,0.0
29338,2,9338,[194 323 211 235 742],328,2,34001,3.64075382803298,0.0,0.0
29339,2,9339,[200 357 174 121 257],749,3,34004,3.6406852248394004,20.0,20.0
29340,2,9340,[234 222 179  56  79],843,2,34006,3.640509581415266,0.0,0.0
29341,2,9341,[174 286 427  89  98],60,5,34011,3.640655105973025,0.0,40.0
29342,2,9342,[302 483 100 603 127],745,3,34014,3.640586535374077,40.0,40.0
29343,2,9343,[597  15  96  71 191],378,4,34018,3.640625,0.0,0.0
29344,2,9344,[302 483 100 603 127],458,5,34023,3.6407704654895667,40.0,40.0
29345,2,9345,[175 195 183 228 125],77,3,34026,3.6407019045580995,0.0,0.0
29346,2,9346,[302 483 100 603 127],524,4,34030,3.64074034449556,40.0,40.0
29347,2,9347,[288 357 273 176  69],643,3,34033,3.6406718014548565,20.0,0.0
29348,2,9348,[ 82 196  50 235 234],308,2,34035,3.6404963097657506,0.0,20.0
29349,2,9349,[182 300  22 597  82],378,4,34039,3.640534759358289,0.0,0.0
29350,2,9350,[302 483 100 603 127],458,5,34044,3.640680141161373,40.0,40.0
29351,2,9351,[302 483 100 603 127],10,5,34049,3.640825491873396,40.0,40.0
29352,2,9352,[302 483 100 603 127],664,5,34054,3.64097081150433,40.0,40.0
29353,2,9353,[117 144 187 508 176],543,4,34058,3.6410091939277316,0.0,0.0
29354,2,9354,[ 12 153 183 127 174],339,5,34063,3.6411544628540886,20.0,40.0
29355,2,9355,[385   8 269  28 289],455,3,34066,3.6410859341598973,0.0,0.0
29356,2,9356,[302  11 655 161 100],13,4,34070,3.6411242919739233,0.0,20.0
29357,2,9357,[  4 132   8 655 185],64,4,34074,3.6411626415900833,0.0,0.0
29358,2,9358,[302 483 100 603 127],458,5,34079,3.6413078320333367,40.0,40.0
29359,2,9359,[200  15 183 313 275],145,3,34082,3.641239316239316,0.0,0.0
29360,2,9360,[302 483 100 603 127],480,3,34085,3.6411708150838584,40.0,40.0
29361,2,9361,[302 483 100 603 127],474,5,34090,3.641315958128605,40.0,40.0
29362,2,9362,[302 483 100 603 127],664,5,34095,3.6414610701698176,40.0,40.0
29363,2,9363,[121 286 427   7 187],339,4,34099,3.6414993592481846,0.0,0.0
29364,2,9364,[185 333 210 228 435],313,4,34103,3.641537640149493,0.0,0.0
29365,2,9365,[318 100 117 153  28],479,3,34106,3.641469143711296,20.0,20.0
29366,2,9366,[302 483 100 603 127],480,3,34109,3.641400661898153,40.0,40.0
29367,2,9367,[302 483 100 603 127],232,4,34113,3.6414389410760033,40.0,40.0
29368,2,9368,[435 132  82 135 118],524,4,34117,3.6414772120823993,0.0,0.0
29369,2,9369,[302 483 100 603 127],524,4,34121,3.641515474919957,40.0,40.0
29370,2,9370,[655  64  71 265 276],311,5,34126,3.6416604417884963,0.0,0.0
29371,2,9371,[258  28 161 568   4],378,4,34130,3.6416986769099444,0.0,0.0
29372,2,9372,[ 56 175 196 385 195],843,2,34132,3.6415235250186706,0.0,0.0
29373,2,9373,[245 435 143 588  50],804,3,34135,3.641455088542778,0.0,20.0
29374,2,9374,[302 483 100 603 127],745,3,34138,3.6413866666666665,40.0,40.0
29375,2,9375,[288 173 427  22 405],59,4,34142,3.641424914675768,0.0,0.0
29376,2,9376,[234 168  22 200  89],543,3,34145,3.6413565106110695,0.0,0.0
29377,2,9377,[302 483 100 603 127],339,5,34150,3.641501386223075,40.0,40.0
29378,2,9378,[  1 385 678 211 125],804,5,34155,3.641646230941465,0.0,0.0
29379,2,9379,[117 222 597 135   1],275,2,34157,3.6414712153518125,0.0,0.0
29380,2,9380,[222  82   7 258  96],200,5,34162,3.641616032405927,0.0,0.0
29381,2,9381,[357  22 182 603 195],313,4,34166,3.6416542315071414,40.0,0.0
29382,2,9382,[265  22  70 186  95],543,2,34168,3.641479271022061,0.0,0.0
29383,2,9383,[302 483 100 603 127],458,5,34173,3.641624040920716,40.0,40.0
29384,2,9384,[302 483 100 603 127],474,5,34178,3.641768779968034,40.0,40.0
29385,2,9385,[ 22  96 185 483 187],326,3,34181,3.6417004048582995,20.0,0.0
29386,2,9386,[211  11 588 185 275],454,0,34181,3.6413124533929904,0.0,0.0
29387,2,9387,[  7  28 143  82   4],92,2,34183,3.6411376224968044,0.0,0.0
29388,2,9388,[210 135   7 483 435],194,2,34185,3.6409628288422624,20.0,0.0
29389,2,9389,[143 186  69 183   7],374,3,34188,3.6408945686900958,0.0,0.0
29390,2,9390,[302 483 100 603 127],232,4,34192,3.640932808007667,40.0,40.0
29391,2,9391,[302 483 100 603 127],666,5,34197,3.6410775127768313,40.0,40.0
29392,2,9392,[294 357 202  15 271],650,1,34198,3.640796337698286,20.0,0.0
29393,2,9393,[ 56  12  69 742 288],334,2,34200,3.6406216734085586,20.0,0.0
29394,2,9394,[196 228 191 603  50],454,3,34203,3.6405534858967536,20.0,20.0
29395,2,9395,[ 96 748 323  69 222],328,2,34205,3.640378884631758,0.0,0.0
29396,2,9396,[302 483 100 603 127],537,5,34210,3.6405235713525594,40.0,40.0
29397,2,9397,[471 603 121 195 183],308,3,34213,3.6404554160459672,20.0,0.0
29398,2,9398,[302 483 100 603 127],339,5,34218,3.6406000638365783,40.0,40.0
29399,2,9399,[ 12 237 265 313 483],207,3,34221,3.640531914893617,40.0,0.0
29400,2,9400,[302 483 100 603 127],334,5,34226,3.640676523774067,40.0,40.0
29401,2,9401,[302 483 100 603 127],474,5,34231,3.640821101893214,40.0,40.0
29402,2,9402,[318 269 435 286 483],13,2,34233,3.6406466021482506,40.0,0.0
29403,2,9403,[748 173 200 197 121],899,4,34237,3.640684814972352,0.0,0.0
29404,2,9404,[302 483 100 603 127],339,5,34242,3.640829346092504,40.0,40.0
29405,2,9405,[302 483 100 603 127],524,4,34246,3.64086753136296,40.0,40.0
29406,2,9406,[302 483 100 603 127],458,5,34251,3.6410120123312426,40.0,40.0
29407,2,9407,[180 515 328   9   1],271,3,34254,3.6409438775510203,0.0,0.0
29408,2,9408,[191 603 475 195  89],13,2,34256,3.6407694760335847,20.0,0.0
29409,2,9409,[302 483 100 603 127],339,5,34261,3.640913921360255,40.0,40.0
29410,2,9410,[168 288 210 403 196],334,3,34264,3.640845818722771,0.0,0.0
29411,2,9411,[235 174  15 196  96],144,4,34268,3.6408839779005526,0.0,20.0
29412,2,9412,[121 222   9  50   7],328,4,34272,3.6409221289705727,0.0,20.0
29413,2,9413,[ 22 238 435 117 313],271,4,34276,3.6409602719354153,0.0,0.0
29414,2,9414,[ 70 168 234 173 187],64,5,34281,3.6411046202867765,0.0,0.0
29415,2,9415,[508 111  64 135 237],543,5,34286,3.64124893797791,0.0,0.0
29416,2,9416,[427  28 100 121 228],334,3,34289,3.6411808431559947,0.0,20.0
29417,2,9417,[302 483 100 603 127],480,3,34292,3.6411127627946485,40.0,40.0
29418,2,9418,[282 234 196 313 328],85,3,34295,3.6410446968892662,0.0,0.0
29419,2,9419,[ 95 235 211 603 385],64,4,34299,3.641082802547771,20.0,0.0
29420,2,9420,[ 64 151  50 423 403],524,3,34302,3.64101475427237,0.0,20.0
29421,2,9421,[185  82 496  88 197],184,3,34305,3.64094672044152,0.0,0.0
29422,2,9422,[302 483 100 603 313],454,4,34309,3.6409848243659133,40.0,20.0
29423,2,9423,[237 191 435 111  79],474,5,34314,3.6411290322580645,0.0,0.0
29424,2,9424,[ 56 135 357 301 222],328,2,34316,3.6409549071618037,20.0,0.0
29425,2,9425,[323 405   4 546 313],455,1,34317,3.640674729471674,0.0,0.0
29426,2,9426,[187 385 168 318 228],488,4,34321,3.6407128460804072,20.0,0.0
29427,2,9427,[202   4 286 222 186],158,3,34324,3.6406448875689437,0.0,0.0
29428,2,9428,[ 64 187 318 435 180],533,4,34328,3.6406829992576095,20.0,0.0
29429,2,9429,[204  70 588 235 655],537,1,34329,3.640402969247084,0.0,0.0
29430,2,9430,[483 118 405 235  88],290,3,34332,3.640335065210476,20.0,0.0
29431,2,9431,[202 222 196  89  69],881,3,34335,3.640267175572519,0.0,0.0
29432,2,9432,[403  71 318  89  88],815,5,34340,3.6404113219548395,20.0,0.0
29433,2,9433,[222  11 228 179 185],339,5,34345,3.6405554377782487,0.0,0.0
29434,2,9434,[179  69 322 257 235],308,2,34347,3.6403815580286167,0.0,0.0
29435,2,9435,[191  11 186 195   9],749,4,34351,3.64041966935142,0.0,0.0
29436,2,9436,[273 111 125   9 179],894,2,34353,3.64024584083925,0.0,0.0
29437,2,9437,[318 588 475 546 210],308,4,34357,3.6402839584657767,20.0,0.0
29438,2,9438,[302 483 100 603 313],334,5,34362,3.64042801144189,40.0,20.0
29439,2,9439,[195 121  50 258  11],749,4,34366,3.640466101694915,0.0,20.0
29440,2,9440,[294 172  56 121  11],7,3,34369,3.6403982628958795,0.0,0.0
29441,2,9441,[176 181 151 235  79],313,3,34372,3.640330438466427,0.0,0.0
29442,2,9442,[197  96 300 187 265],537,2,34374,3.640156729852801,0.0,0.0
29443,2,9443,[183 546 423 588 496],295,4,34378,3.6401948326980094,0.0,0.0
29444,2,9444,[302 483 100 603 313],537,5,34383,3.6403388035997883,40.0,20.0
29445,2,9445,[  9 179  25   7 597],92,3,34386,3.640271014185899,0.0,0.0
29446,2,9446,[ 79 405 191 302  69],474,5,34391,3.6404149465438764,0.0,0.0
29447,2,9447,[302 483 100 603 313],334,5,34396,3.640558848433531,40.0,20.0
29448,2,9448,[475  79  89  11 313],13,2,34398,3.640385225949836,0.0,0.0
29449,2,9449,[216   9 191 546  88],339,4,34402,3.6404232804232803,0.0,0.0
29450,2,9450,[302 483 100 603 313],474,5,34407,3.64056713575283,40.0,20.0
29451,2,9451,[515 135 318 194 288],213,5,34412,3.64071096064325,20.0,0.0
29452,2,9452,[237 245 135  88 132],533,2,34414,3.6405373955358087,0.0,0.0
29453,2,9453,[435 269 328 322 211],537,1,34415,3.6402580918129894,0.0,0.0
29454,2,9454,[228 235 197 202 597],774,2,34417,3.6400846113167638,0.0,0.0
29455,2,9455,[385 288 118   7  64],59,5,34422,3.640228426395939,0.0,0.0
29456,2,9456,[118 546 144  82 168],648,5,34427,3.64037221106059,0.0,0.0
29457,2,9457,[302 483 100 603 313],13,5,34432,3.640515965320364,40.0,20.0
29458,2,9458,[ 22 276 174 496 222],334,4,34436,3.6405539697642455,0.0,20.0
29459,2,9459,[475 143 175 273   1],479,3,34439,3.6404862579281185,0.0,0.0
29460,2,9460,[127  69 269 180 174],343,5,34444,3.640629954550259,0.0,40.0
29461,2,9461,[258   8   7 179 180],92,5,34449,3.6407736207989854,0.0,0.0
29462,2,9462,[238 179 215  56 403],64,5,34454,3.640917256683927,0.0,0.0
29463,2,9463,[302 483 100 603 313],13,5,34459,3.6410608622147085,40.0,20.0
29464,2,9464,[135 275 546 483 588],82,2,34461,3.6408874801901745,20.0,0.0
29465,2,9465,[302 483 100 603 313],383,4,34465,3.640925417282907,40.0,20.0
29466,2,9466,[655 111 118 323 423],13,4,34469,3.6409633463610436,0.0,0.0
29467,2,9467,[  1 211  79  69 135],804,4,34473,3.641001267427123,0.0,0.0
29468,2,9468,[427 313 483 234 302],328,4,34477,3.6410391804836837,20.0,0.0
29469,2,9469,[173 211 117 483 127],6,4,34481,3.641077085533263,20.0,20.0
29470,2,9470,[313  79 153  15 403],543,2,34483,3.640903811635519,0.0,0.0
29471,2,9471,[121 185 216 269 268],334,2,34485,3.640730574324324,0.0,0.0
29472,2,9472,[302 483 100 603 127],334,5,34490,3.6408740631267813,40.0,40.0
29473,2,9473,[216 403  56 161 200],648,2,34492,3.640700865526705,0.0,0.0
29474,2,9474,[ 89 183  12 172 405],13,4,34496,3.6407387862796834,20.0,0.0
29475,2,9475,[302 483 100 603 127],10,5,34501,3.6408822287885183,40.0,40.0
29476,2,9476,[302 483 100 603 127],745,3,34504,3.640814603777567,40.0,40.0
29477,2,9477,[302 483 100 603 127],524,4,34508,3.6408525005275374,40.0,40.0
29478,2,9478,[302 483 100 603 127],480,3,34511,3.6407848929211943,40.0,40.0
29479,2,9479,[176 588  64 234   1],42,4,34515,3.6408227848101267,0.0,0.0
29480,2,9480,[121 183  98 143 403],95,4,34519,3.640860668705833,0.0,20.0
29481,2,9481,[302 483 100 603 313],13,5,34524,3.6410040075933345,40.0,20.0
29482,2,9482,[194 195 234 181 603],804,5,34529,3.641147316250132,20.0,0.0
29483,2,9483,[302 483 100 603 313],90,5,34534,3.6412905946857865,40.0,20.0
29484,2,9484,[153 168 275 185 197],64,3,34537,3.641222983658408,0.0,0.0
29485,2,9485,[121  89  12 222 127],387,4,34541,3.641260805397428,20.0,20.0
29486,2,9486,[181 125 357 100 228],749,4,34545,3.641298619163065,20.0,20.0
29487,2,9487,[427 175 276  96 328],234,1,34546,3.6410202360876895,0.0,0.0
29488,2,9488,[ 96   7 301 286 427],13,2,34548,3.64084729687006,0.0,0.0
29489,2,9489,[302 483 100 603 313],383,4,34552,3.6408851422550055,40.0,20.0
29490,2,9490,[328 172 191 265 182],378,4,34556,3.640922979664946,0.0,0.0
29491,2,9491,[211  50 748 143 215],533,4,34560,3.640960809102402,0.0,20.0
29492,2,9492,[228 144 172 204 222],738,5,34565,3.6411039713473086,0.0,0.0
29493,2,9493,[ 50 597  71 294 515],279,1,34566,3.6408257847061303,0.0,20.0
29494,2,9494,[ 71 176  96 318 588],59,3,34569,3.6407582938388625,20.0,0.0
29495,2,9495,[302 483 100 603 127],664,5,34574,3.6409014321819715,40.0,40.0
29496,2,9496,[302 483 100 603 127],537,5,34579,3.641044540381173,40.0,40.0
29497,2,9497,[302 483 100 603 127],664,5,34584,3.6411876184459886,40.0,40.0
29498,2,9498,[135 273 234 121  79],749,4,34588,3.641225392146542,0.0,0.0
29499,2,9499,[200 216  28  98 186],804,4,34592,3.6412631578947368,0.0,20.0
29500,2,9500,[ 69 515  12 288 235],308,2,34594,3.641090411535628,20.0,0.0
29501,2,9501,[ 50 275 174 276 268],189,4,34598,3.641128183540307,0.0,40.0
29502,2,9502,[435 318 357  11 322],537,2,34600,3.6409554877407135,40.0,0.0
29503,2,9503,[100 302 435 118 258],380,3,34603,3.640888047138047,0.0,20.0
29504,2,9504,[508  69 273 179 483],537,3,34606,3.640820620725934,20.0,0.0
29505,2,9505,[302 483 100 603 127],745,3,34609,3.640753208499895,40.0,40.0
29506,2,9506,[603 318 313 265 174],234,3,34612,3.640685810455454,40.0,20.0
29507,2,9507,[302 483 100 603 313],232,4,34616,3.6407236011779553,40.0,20.0
29508,2,9508,[508 153 234 435 515],406,3,34619,3.6406562204227573,0.0,0.0
29509,2,9509,[ 25  88  70 197 174],13,3,34622,3.6405888538380653,0.0,20.0
29510,2,9510,[265  25  28 300   7],378,5,34627,3.640731784249816,0.0,0.0
29511,2,9511,[603 143  89 121 742],804,4,34631,3.6407695542472664,20.0,0.0
29512,2,9512,[202 385 234 748  97],64,3,34634,3.6407021969935878,0.0,0.0
29513,2,9513,[135   8 237 235  79],343,5,34639,3.640845070422535,0.0,0.0
29514,2,9514,[ 11  95  56   7 265],387,3,34642,3.640777719390436,0.0,0.0
29515,2,9515,[ 96 196 153 269 175],738,4,34646,3.640815468684321,0.0,0.0
29516,2,9516,[197 180 121 168 515],650,3,34649,3.6407481349164654,0.0,0.0
29517,2,9517,[181  71 173  56 194],892,4,34653,3.6407858793864256,0.0,0.0
29518,2,9518,[294  98 318 257 597],92,1,34654,3.6405084567706694,20.0,20.0
29519,2,9519,[302 483 100 603 127],524,4,34658,3.640546218487395,40.0,40.0
29520,2,9520,[302 234 135 269  22],524,3,34661,3.6404789412876797,0.0,0.0
29521,2,9521,[302 483 100 603 127],334,5,34666,3.640621718126444,40.0,40.0
29522,2,9522,[111  28 204 222 603],533,5,34671,3.640764464979523,20.0,0.0
29523,2,9523,[ 89 286 125 294 328],378,2,34673,3.640592188156237,0.0,0.0
29524,2,9524,[302 483 100 603 127],339,5,34678,3.640734908136483,40.0,40.0
29525,2,9525,[210  88 173 186  96],102,1,34679,3.640457694730212,0.0,0.0
29526,2,9526,[174 185 333 471  11],653,2,34681,3.640285504356041,0.0,20.0
29527,2,9527,[  1  89 143 403 185],479,3,34684,3.6402183039462637,0.0,0.0
29528,2,9528,[  8 276 357  12 385],385,2,34686,3.640046174834715,40.0,0.0
29529,2,9529,[ 95 200  79 127 268],13,3,34689,3.6399790136411334,0.0,20.0
29530,2,9530,[215  25 748 323  71],648,1,34690,3.6397020249711467,0.0,0.0
29531,2,9531,[174 179 151 435  96],843,2,34692,3.639530004196391,0.0,20.0
29532,2,9532,[117 161 405   4 423],92,2,34694,3.639358019511172,0.0,0.0
29533,2,9533,[302 483 100 603 127],524,4,34698,3.639395846444305,40.0,40.0
29534,2,9534,[181 172  98 100 300],380,2,34700,3.6392239119035135,0.0,40.0
29535,2,9535,[302 483 100 603 127],480,3,34703,3.6391568791946307,40.0,40.0
29536,2,9536,[161   7 515 202  12],7,2,34705,3.6389850057670126,20.0,0.0
29537,2,9537,[238 435 568  15 234],749,4,34709,3.6390228559446425,0.0,0.0
29538,2,9538,[ 98 313 742  71 288],334,2,34711,3.6388510326029984,0.0,20.0
29539,2,9539,[302 483 100 603 127],666,5,34716,3.6389937106918238,40.0,40.0
29540,2,9540,[ 98 132  70  56 427],474,5,34721,3.6391363588722356,0.0,20.0
29541,2,9541,[  4 257 191 202 180],343,4,34725,3.6391741773213164,0.0,0.0
29542,2,9542,[ 64 118  50  69 385],374,4,34729,3.6392119878444933,0.0,20.0
29543,2,9543,[302 483 100 603 127],90,5,34734,3.639354568315172,40.0,40.0
29544,2,9544,[176   4  22 508   9],92,4,34738,3.639392352016763,0.0,0.0
29545,2,9545,[302  88  11 288 568],343,3,34741,3.6393253718835115,0.0,0.0
29546,2,9546,[276 179 288 215 210],474,4,34745,3.6393631507279776,0.0,0.0
29547,2,9547,[ 70   4  25 121 222],406,1,34746,3.639086719731881,0.0,0.0
29548,2,9548,[302 483 100 603 127],458,5,34751,3.6392292386637344,40.0,40.0
29549,2,9549,[294   4  98  11  88],881,2,34753,3.6390575916230365,0.0,20.0
29550,2,9550,[135 168 176 117 172],815,2,34755,3.6388859805255995,0.0,0.0
29551,2,9551,[323 196 245 257 100],119,5,34760,3.6390284757118927,0.0,20.0
29552,2,9552,[302 483 100 603 127],13,5,34765,3.639170941065634,40.0,40.0
29553,2,9553,[ 25 742  56  11 153],387,2,34767,3.6389993719907894,0.0,0.0
29554,2,9554,[302 483 100 603 127],10,5,34772,3.639141810570382,40.0,40.0
29555,2,9555,[228 288  88  15 135],533,3,34775,3.6390749267475933,0.0,0.0
29556,2,9556,[302 483 100 603 127],524,4,34779,3.639112692267448,40.0,40.0
29557,2,9557,[302 483 100 603 127],664,5,34784,3.639255074283323,40.0,40.0
29558,2,9558,[127 288 161  25  28],455,3,34787,3.639188199602469,0.0,20.0
29559,2,9559,[302 483 100 603 127],90,5,34792,3.6393305439330543,40.0,40.0
29560,2,9560,[161 211 100 196 403],653,2,34794,3.6391590837778476,0.0,20.0
29561,2,9561,[302 483 100 603 127],90,5,34799,3.6393014013804645,40.0,40.0
29562,2,9562,[302 483 100 603 127],745,3,34802,3.63923454982746,40.0,40.0
29563,2,9563,[302 483 100 603 127],537,5,34807,3.6393768297783353,40.0,40.0
29564,2,9564,[174 121   8  96 202],207,1,34808,3.6391008886565603,0.0,20.0
29565,2,9565,[ 79  12  88 183 180],92,4,34812,3.6391386159314236,20.0,0.0
29566,2,9566,[483 471 202  50 185],666,4,34816,3.639176335319327,20.0,20.0
29567,2,9567,[328 483 678 258 175],334,3,34819,3.6391095317725752,20.0,0.0
29568,2,9568,[187 197 168  96 202],527,4,34823,3.6391472463162295,0.0,0.0
29569,2,9569,[403   9 200 302 118],543,4,34827,3.639184952978056,0.0,0.0
29570,2,9570,[127 546 588  88 182],308,4,34831,3.6392226517605266,0.0,20.0
29571,2,9571,[302 483 100 603 127],745,3,34834,3.6391558712912664,40.0,40.0
29572,2,9572,[302 483 100 603 127],480,3,34837,3.639089104773843,40.0,40.0
29573,2,9573,[196 403  64 318 174],533,4,34841,3.6391268017547524,20.0,20.0
29574,2,9574,[294 161  22  95 186],378,3,34844,3.639060052219321,0.0,0.0
29575,2,9575,[ 22 211 301 144 435],328,4,34848,3.6390977443609023,0.0,0.0
29576,2,9576,[302 483 100 603 313],334,5,34853,3.6392398454630888,40.0,20.0
29577,2,9577,[302 483 100 603 313],383,4,34857,3.6392775109626228,40.0,20.0
29578,2,9578,[302 483 100 603 127],664,5,34862,3.6394195636287714,40.0,40.0
29579,2,9579,[302 483 100 603 127],664,5,34867,3.639561586638831,40.0,40.0
29580,2,9580,[302 483 100 603 127],745,3,34870,3.6394948335246844,40.0,40.0
29581,2,9581,[194 483 301  56 496],650,3,34873,3.6394280943435606,20.0,0.0
29582,2,9582,[471 265 185 294 546],648,4,34877,3.6394657205468017,0.0,0.0
29583,2,9583,[302 483 100 603 313],454,4,34881,3.6395033388981637,40.0,20.0
29584,2,9584,[153  98 228  25 237],295,5,34886,3.6396452790818987,0.0,20.0
29585,2,9585,[135 181 405 176   7],59,4,34890,3.6396828708533278,0.0,0.0
29586,2,9586,[302 483 100 603 313],383,4,34894,3.639720454782518,40.0,20.0
29587,2,9587,[174 175  56 125  11],334,4,34898,3.6397580308719233,0.0,20.0
29588,2,9588,[151 187 191 125  97],313,3,34901,3.63969131296277,0.0,0.0
29589,2,9589,[302 483 100 603 191],537,5,34906,3.6398331595411886,40.0,20.0
29590,2,9590,[228 191 215 117 678],749,4,34910,3.6398707121259513,0.0,0.0
29591,2,9591,[ 71 655 678 403 100],749,3,34913,3.6398040033361134,0.0,20.0
29592,2,9592,[302 483 100 603 191],524,4,34917,3.639841551131033,40.0,20.0
29593,2,9593,[302 483 100 603 191],10,5,34922,3.6399833229101524,40.0,20.0
29594,2,9594,[144 235 204 475  88],339,2,34924,3.639812402292861,0.0,0.0
29595,2,9595,[302 483 100 603 191],339,5,34929,3.639954147561484,40.0,20.0
29596,2,9596,[286 135 222 204 186],13,3,34932,3.63988746483276,0.0,0.0
29597,2,9597,[168 435  25 191  15],82,3,34935,3.6398207959991664,0.0,0.0
29598,2,9598,[216 301  12 245  22],334,2,34937,3.6396499635378685,20.0,0.0
29599,2,9599,[197 655 275 276 135],311,5,34942,3.6397916666666665,0.0,0.0
29600,2,9600,[302 483 100 603 191],334,5,34947,3.6399333402770546,40.0,20.0
29601,2,9601,[143 318 121   4 237],406,2,34949,3.639762549468861,20.0,0.0
29602,2,9602,[318  98  89 427 289],788,4,34953,3.6398000624804747,20.0,20.0
29603,2,9603,[273 151  50 191 195],749,5,34958,3.639941690962099,0.0,20.0
29604,2,9604,[302 483 100 603 191],664,4,34962,3.6399791775117127,40.0,20.0
29605,2,9605,[ 25 117 180 508 174],533,4,34966,3.640016656256506,0.0,20.0
29606,2,9606,[268 238 175  79 197],6,3,34969,3.6399500364317685,0.0,0.0
29607,2,9607,[ 64 176 357 275  98],60,5,34974,3.640091590341382,20.0,20.0
29608,2,9608,[  1 289 269 153 258],125,3,34977,3.640024976584452,0.0,0.0
29609,2,9609,[ 89 182 187 237 127],271,3,34980,3.639958376690947,0.0,20.0
29610,2,9610,[302 483 100 603 191],458,5,34985,3.64009988554781,40.0,20.0
29611,2,9611,[302 483 100 603 191],339,5,34990,3.640241364960466,40.0,20.0
29612,2,9612,[302 483 100 603 191],474,5,34995,3.640382814938105,40.0,20.0
29613,2,9613,[288 200  25 588 196],234,1,34996,3.640108175577283,0.0,0.0
29614,2,9614,[ 69 238 483 357 118],892,5,35001,3.6402496099843993,40.0,0.0
29615,2,9615,[302 483 100 603 191],454,4,35005,3.640287021630616,40.0,20.0
29616,2,9616,[302 483 100 603 191],537,5,35010,3.6404284080274514,40.0,20.0
29617,2,9617,[180 161 568  71  50],95,3,35013,3.640361821584529,0.0,20.0
29618,2,9618,[302 483 100 603 191],90,5,35018,3.640503170807776,40.0,20.0
29619,2,9619,[186 200 181 276 427],474,4,35022,3.6405405405405404,0.0,0.0
29620,2,9620,[  4 318  64 357 237],318,4,35026,3.640577902504937,40.0,0.0
29621,2,9621,[ 71  97 182 282 333],533,3,35029,3.6405113282061943,0.0,0.0
29622,2,9622,[197   4 180 515 204],406,3,35032,3.6404447677439467,0.0,0.0
29623,2,9623,[ 96 508   4 323   9],378,3,35035,3.640378221113882,0.0,0.0
29624,2,9624,[302 483 100 603 191],474,5,35040,3.6405194805194805,40.0,20.0
29625,2,9625,[271 135 385  98 117],328,2,35042,3.640349054643673,0.0,20.0
29626,2,9626,[302 483 100 603 191],334,5,35047,3.6404902877324194,40.0,20.0
29627,2,9627,[238 186 300 427 333],334,3,35050,3.6404237640216035,0.0,0.0
29628,2,9628,[ 12 121 273   8 405],7,3,35053,3.6403572541281544,20.0,0.0
29629,2,9629,[185 301 318 211 313],328,4,35057,3.640394600207684,20.0,0.0
29630,2,9630,[258  89 655 132   9],749,4,35061,3.6404319385318242,0.0,0.0
29631,2,9631,[483   9 265 475   4],339,4,35065,3.64046926910299,20.0,0.0
29632,2,9632,[302 483 100 603 191],339,5,35070,3.640610401744005,40.0,20.0
29633,2,9633,[603 182 185 678 228],13,3,35073,3.6405439069960557,20.0,0.0
29634,2,9634,[302 483 100 603 191],232,5,35078,3.6406850025947066,40.0,20.0
29635,2,9635,[191 286  95 151 173],664,4,35082,3.640722291407223,0.0,0.0
29636,2,9636,[313 301 269 289   7],13,1,35083,3.6404482722839058,0.0,0.0
29637,2,9637,[300 197 176   8 273],144,4,35087,3.6404855779207304,0.0,0.0
29638,2,9638,[294 153  50 483 271],650,3,35090,3.640419130615209,20.0,20.0
29639,2,9639,[215 135 210   1 385],42,5,35095,3.6405601659751037,0.0,0.0
29640,2,9640,[301 403 427 742 318],328,2,35097,3.640390001037237,20.0,0.0
29641,2,9641,[172 186  50 127 215],308,4,35101,3.6404272972412364,0.0,40.0
29642,2,9642,[181 328 546 111  82],533,4,35105,3.640464585709841,0.0,0.0
29643,2,9643,[302 483 100 603 191],454,4,35109,3.6405018664454585,40.0,20.0
29644,2,9644,[302 483 100 603 191],666,5,35114,3.640642820114049,40.0,20.0
29645,2,9645,[333 286 121 143  96],666,1,35115,3.640369064897367,0.0,0.0
29646,2,9646,[200 333 423 172 385],881,4,35119,3.6404063439411214,0.0,0.0
29647,2,9647,[302 483 100 603 191],10,5,35124,3.640547263681592,40.0,20.0
29648,2,9648,[302 483 100 603 191],90,5,35129,3.6406881542128717,40.0,20.0
29649,2,9649,[ 11 195   7 132 172],328,3,35132,3.640621761658031,0.0,0.0
29650,2,9650,[ 95 143  64 275 238],85,3,35135,3.6405553828618795,0.0,0.0
29651,2,9651,[302 483 100 603 191],454,4,35139,3.6405926232905097,40.0,20.0
29652,2,9652,[245 333 471 294 257],548,4,35143,3.640629856003315,0.0,0.0
29653,2,9653,[210 300  71 588  64],454,3,35146,3.6405634969960636,0.0,0.0
29654,2,9654,[405 257 172 196 215],144,5,35151,3.6407042982910407,0.0,0.0
29655,2,9655,[275 117 222 202 385],533,5,35156,3.640845070422535,0.0,0.0
29656,2,9656,[228 238 427 151 175],932,3,35159,3.640778709744227,0.0,0.0
29657,2,9657,[302 483 100 603 191],458,5,35164,3.640919445019673,40.0,20.0
29658,2,9658,[302 483 100 603 191],524,4,35168,3.6409566207681956,40.0,20.0
29659,2,9659,[111 191  28 204 471],83,3,35171,3.640890269151139,0.0,0.0
29660,2,9660,[ 70 173 515 216 403],59,4,35175,3.6409274402235794,0.0,0.0
29661,2,9661,[302 483 100 603 191],339,5,35180,3.6410681018422686,40.0,20.0
29662,2,9662,[ 50  82 265 210 153],102,1,35181,3.6407947842285004,0.0,20.0
29663,2,9663,[ 95 161 258 210  56],650,0,35181,3.640418046357616,0.0,0.0
29664,2,9664,[302 483 100 603 191],524,4,35185,3.6404552509053283,40.0,20.0
29665,2,9665,[187  28 385 546 301],788,2,35187,3.6402855369335816,0.0,0.0
29666,2,9666,[302 483 100 603 191],232,5,35192,3.6404261922002688,40.0,20.0
29667,2,9667,[195 245 172 273 200],328,3,35195,3.6403599503516757,0.0,0.0
29668,2,9668,[302 483 100 603 191],666,5,35200,3.6405005688282137,40.0,20.0
29669,2,9669,[132 144  50 546 215],343,4,35204,3.6405377456049637,0.0,20.0
29670,2,9670,[  9 202 515 179  28],207,4,35208,3.6405749146934134,0.0,0.0
29671,2,9671,[174 118 276  88  82],13,4,35212,3.6406120760959473,0.0,20.0
29672,2,9672,[302 483 100 603 191],10,5,35217,3.6407526103587307,40.0,20.0
29673,2,9673,[302 483 100 603 191],537,5,35222,3.6408931155675006,40.0,20.0
29674,2,9674,[176  95 228 144  96],313,3,35225,3.640826873385013,0.0,0.0
29675,2,9675,[143 237 318  70 185],184,4,35229,3.6408639933856968,20.0,0.0
29676,2,9676,[286 222  64 100 265],537,1,35230,3.6405910922806655,0.0,20.0
29677,2,9677,[302 483 100 603 191],537,5,35235,3.640731556106634,40.0,20.0
29678,2,9678,[302 483 100 603 191],232,5,35240,3.6408719909081517,40.0,20.0
29679,2,9679,[172 258 237  11 328],653,1,35241,3.640599173553719,0.0,0.0
29680,2,9680,[302 483 100 603 191],480,4,35245,3.640636297903109,40.0,20.0
29681,2,9681,[173 210 181  15 403],210,5,35250,3.6407766990291264,0.0,0.0
29682,2,9682,[302 483 100 603 191],664,4,35254,3.640813797376846,40.0,20.0
29683,2,9683,[302 483 100 603 191],537,5,35259,3.6409541511771994,40.0,20.0
29684,2,9684,[195 302 135 202 161],13,4,35263,3.640991223541559,0.0,0.0
29685,2,9685,[302 483 100 603 191],458,5,35268,3.6411315300433618,40.0,20.0
29686,2,9686,[302 483 100 603 191],474,5,35273,3.6412718075771653,40.0,20.0
29687,2,9687,[234 288  98 151 405],804,3,35276,3.6412056151940546,0.0,20.0
29688,2,9688,[ 89 144 196 161 597],455,2,35278,3.641036226648777,0.0,0.0
29689,2,9689,[  1 211 265 385 191],308,4,35282,3.6410732714138287,0.0,0.0
29690,2,9690,[ 64 235 483 204 216],194,3,35285,3.641007120008255,20.0,0.0
29691,2,9691,[117 204 258 182 191],815,3,35288,3.640940982253405,0.0,0.0
29692,2,9692,[144 200 265 204 748],543,4,35292,3.6409780253791397,0.0,0.0
29693,2,9693,[302 483 100 603 191],474,5,35297,3.6411182174540953,40.0,20.0
29694,2,9694,[496 183 237 172 748],653,1,35298,3.6408457968024757,0.0,0.0
29695,2,9695,[302 483 100 603 191],664,4,35302,3.6408828382838285,40.0,20.0
29696,2,9696,[ 79 318 180 191 176],537,3,35305,3.6408167474476643,20.0,0.0
29697,2,9697,[151 202 100 179 185],59,5,35310,3.6409568983295526,0.0,20.0
29698,2,9698,[546 185 275 515 276],548,3,35313,3.6408908134859264,0.0,0.0
29699,2,9699,[ 82 328 423  95 111],13,3,35316,3.640824742268041,0.0,0.0
29700,2,9700,[100 258 211   7 187],13,4,35320,3.640861766828162,0.0,20.0
29701,2,9701,[318 181 405 546 132],271,3,35323,3.6407957122242838,20.0,0.0
29702,2,9702,[180 197  22 118 210],13,4,35327,3.6408327321446974,0.0,0.0
29703,2,9703,[302 483 100 603 191],524,4,35331,3.6408697444352844,40.0,20.0
29704,2,9704,[318 313 222 180 508],378,3,35334,3.64080370942813,20.0,0.0
29705,2,9705,[174 237 515 265 322],234,1,35335,3.6405316299196375,0.0,20.0
29706,2,9706,[471  28 435 117  11],378,2,35337,3.640362624909859,0.0,0.0
29707,2,9707,[302 483 100 603 191],339,5,35342,3.6405026782035437,40.0,20.0
29708,2,9708,[ 64 132 151   7 183],788,4,35346,3.6405397054279534,0.0,0.0
29709,2,9709,[234 168 471 202   8],343,4,35350,3.640576725025747,0.0,0.0
29710,2,9710,[302 483 100 603 191],232,5,35355,3.6407167130058697,40.0,20.0
29711,2,9711,[234  12   1  79 403],883,4,35359,3.6407537067545306,20.0,0.0
29712,2,9712,[302 483 100 603 191],339,5,35364,3.6408936476886646,40.0,20.0
29713,2,9713,[ 22  96 435  95 276],13,5,35369,3.6410335598105825,0.0,0.0
29714,2,9714,[288 127 204 265 568],339,1,35370,3.64076170869789,0.0,20.0
29715,2,9715,[  1 172  89  64  95],380,3,35373,3.64069575957184,0.0,0.0
29716,2,9716,[302 483 100 603 191],480,4,35377,3.6407327364412883,40.0,20.0
29717,2,9717,[187 182  50  97 185],406,4,35381,3.6407697057007615,0.0,20.0
29718,2,9718,[215 127 288 180  96],144,4,35385,3.6408066673526083,0.0,20.0
29719,2,9719,[210  96  64 273 118],7,3,35388,3.640740740740741,0.0,0.0
29720,2,9720,[127  89 318 265 508],524,5,35393,3.6408805678428147,20.0,20.0
29721,2,9721,[235 265 234  22 222],343,3,35396,3.640814647191936,0.0,0.0
29722,2,9722,[204 238 100 234 196],92,5,35401,3.64095443793068,0.0,20.0
29723,2,9723,[  1  56  79 135  71],406,3,35404,3.6408885232414643,0.0,0.0
29724,2,9724,[289  96 597 228 546],95,2,35406,3.640719794344473,0.0,0.0
29725,2,9725,[302 483 100 603 191],480,4,35410,3.6407567345260126,40.0,20.0
29726,2,9726,[234  95 161  98  96],95,2,35412,3.6405880538706694,0.0,20.0
29727,2,9727,[216   1 194  97 322],533,4,35416,3.640625,0.0,0.0
29728,2,9728,[302 483 100 603 191],524,4,35420,3.640661938534279,40.0,20.0
29729,2,9729,[127 185   1 181 228],537,2,35422,3.64049331963001,0.0,20.0
29730,2,9730,[302 483 100 603 191],537,5,35427,3.6406330284657282,40.0,20.0
29731,2,9731,[275 174  28 191 385],64,5,35432,3.6407727085902177,0.0,20.0
29732,2,9732,[302 483 100 603 191],334,5,35437,3.640912360012329,40.0,20.0
29733,2,9733,[197  69  56 357 508],144,5,35442,3.6410519827409082,20.0,0.0
29734,2,9734,[222 318 423  50 200],328,4,35446,3.6410888546481766,20.0,20.0
29735,2,9735,[302 483 100 603 191],10,5,35451,3.6412284305669678,40.0,20.0
29736,2,9736,[187 603 174 483 135],537,4,35455,3.6412652767792957,40.0,20.0
29737,2,9737,[172 127 195 125 222],653,2,35457,3.6410967344423906,0.0,20.0
29738,2,9738,[302 483 100 603 191],454,4,35461,3.6411335866105348,40.0,20.0
29739,2,9739,[496 222   4  15 603],749,4,35465,3.641170431211499,20.0,0.0
29740,2,9740,[194 322  89 197 143],13,3,35468,3.6411046093830204,0.0,0.0
29741,2,9741,[302 483 100 603 191],334,5,35473,3.641244097721207,40.0,20.0
29742,2,9742,[302 483 100 603 191],524,4,35477,3.6412809196346094,40.0,20.0
29743,2,9743,[302 483 100 603 191],480,4,35481,3.6413177339901477,40.0,20.0
29744,2,9744,[175 603 204 194 385],326,2,35483,3.6411493073370957,20.0,0.0
29745,2,9745,[302 483 100 603 191],458,5,35488,3.641288733839524,40.0,20.0
29746,2,9746,[302 483 100 603 191],480,4,35492,3.641325536062378,40.0,20.0
29747,2,9747,[302 483 100 603 191],524,4,35496,3.6413623307345095,40.0,20.0
29748,2,9748,[ 70 175 435 135 173],934,4,35500,3.6413991178582417,0.0,0.0
29749,2,9749,[276  70 172  11 185],234,0,35500,3.641025641025641,0.0,0.0
29750,2,9750,[ 69 655 508 318 191],387,2,35502,3.640857347964311,20.0,0.0
29751,2,9751,[135  56 276 196 435],537,3,35505,3.640791632485644,0.0,0.0
29752,2,9752,[302 483 100 603 191],480,4,35509,3.6408284630370145,40.0,20.0
29753,2,9753,[515 125 215 318  15],92,3,35512,3.6407627639942586,20.0,0.0
29754,2,9754,[302 483 100 603 191],524,4,35516,3.6407995899538697,40.0,20.0
29755,2,9755,[302 483 100 603 191],537,5,35521,3.640938909389094,40.0,20.0
29756,2,9756,[196 174 195  96 135],13,4,35525,3.6409757097468485,0.0,20.0
29757,2,9757,[678 173 333 237 238],334,4,35529,3.6410125025620004,0.0,0.0
29758,2,9758,[ 97 234 168 195 228],881,1,35530,3.640741879290911,0.0,0.0
29759,2,9759,[ 71 258 161 234 186],899,5,35535,3.6408811475409837,0.0,0.0
29760,2,9760,[302 483 100 603 191],232,5,35540,3.6410203872554043,40.0,20.0
29761,2,9761,[211 405 185 228  64],804,5,35545,3.641159598442942,0.0,0.0
29762,2,9762,[302 483 100 603 191],334,5,35550,3.641298781112363,40.0,20.0
29763,2,9763,[132   8  15 153 135],95,3,35553,3.6412331011880377,0.0,0.0
29764,2,9764,[258  28 153   1 597],653,3,35556,3.641167434715822,0.0,0.0
29765,2,9765,[179 216 333 127 100],85,2,35558,3.640999385623592,0.0,40.0
29766,2,9766,[508 168   1 153 222],406,2,35560,3.6408313709429714,0.0,0.0
29767,2,9767,[302 483 100 603 191],480,4,35564,3.640868140868141,40.0,20.0
29768,2,9768,[302 483 100 603 191],334,5,35569,3.641007267888218,40.0,20.0
29769,2,9769,[302 483 100 603 191],537,5,35574,3.6411463664278405,40.0,20.0
29770,2,9770,[385  97  71 168 143],881,3,35577,3.6410807491556647,0.0,0.0
29771,2,9771,[100 195 135  89 181],13,4,35581,3.641117478510029,0.0,20.0
29772,2,9772,[186 222 568  22  96],87,5,35586,3.641256523073775,0.0,0.0
29773,2,9773,[302 483 100 603 191],339,5,35591,3.6413955391855946,40.0,20.0
29774,2,9774,[496 210 143  97 191],537,2,35593,3.641227621483376,0.0,0.0
29775,2,9775,[318 357 748  70 161],648,0,35593,3.6408551554828152,40.0,0.0
29776,2,9776,[302 483 100 603 191],10,5,35598,3.640994169990795,40.0,20.0
29777,2,9777,[302 483 100 603 191],474,5,35603,3.641133156064635,40.0,20.0
29778,2,9778,[ 70 132 475 202 655],64,5,35608,3.641272113713059,0.0,0.0
29779,2,9779,[294 234  25   9 216],648,2,35610,3.6411042944785277,0.0,0.0
29780,2,9780,[742  70 175 186 174],59,3,35613,3.6410387485942133,0.0,20.0
29781,2,9781,[132 200   4 289 215],234,4,35617,3.6410754446943367,0.0,0.0
29782,2,9782,[ 89 222 210 144 135],194,1,35618,3.6408054788919553,0.0,0.0
29783,2,9783,[302 483 100 603 191],10,5,35623,3.640944399018806,40.0,20.0
29784,2,9784,[174 302  98 111 546],833,0,35623,3.6405723045477774,0.0,40.0
29785,2,9785,[302 483 100 603 191],13,4,35627,3.640609033312896,40.0,20.0
29786,2,9786,[121 181 508 322 187],334,2,35629,3.6404414018596096,0.0,0.0
29787,2,9787,[275   7 210  96 269],452,4,35633,3.6404781364936656,0.0,0.0
29788,2,9788,[302 483 100 603 191],334,5,35638,3.640617019103075,40.0,20.0
29789,2,9789,[265 385 175   4 195],883,3,35641,3.6405515832482123,0.0,0.0
29790,2,9790,[385 182  15 265 174],313,4,35645,3.640588295373302,0.0,20.0
29791,2,9791,[204 300 195 222 603],749,4,35649,3.640625,20.0,0.0
29792,2,9792,[302 483 100 603 191],537,5,35654,3.640763810885326,40.0,20.0
29793,2,9793,[238 132   7 186 143],881,2,35656,3.64059628343884,0.0,0.0
29794,2,9794,[302 483 100 603 191],524,4,35660,3.6406329760081673,40.0,20.0
29795,2,9795,[ 70  79 172 175  25],42,2,35662,3.6404654961208656,0.0,0.0
29796,2,9796,[475 435  89 204 200],648,3,35665,3.6404001224864753,0.0,0.0
29797,2,9797,[168 496  56 603 403],64,4,35669,3.6404368238416005,20.0,0.0
29798,2,9798,[ 96 143 176 258 153],28,4,35673,3.6404735177058885,0.0,0.0
29799,2,9799,[302 483 100 603 191],454,4,35677,3.640510204081633,40.0,20.0
29800,2,9800,[ 79  11 175  12 111],447,2,35679,3.640342822161004,20.0,0.0
29801,2,9801,[258  64  96 300 197],13,4,35683,3.6403795143848194,0.0,0.0
29802,2,9802,[197 546 405 603 588],536,1,35684,3.6401101703560133,20.0,0.0
29803,2,9803,[176  69 385 168 568],883,2,35686,3.6399428804569562,0.0,0.0
29804,2,9804,[302 483 100 603 191],232,5,35691,3.640081591024987,40.0,20.0
29805,2,9805,[ 11  82   7 471  98],13,1,35692,3.6398123597797265,0.0,20.0
29806,2,9806,[435 475 655 197   4],13,4,35696,3.6398490873865605,0.0,0.0
29807,2,9807,[191 300 172 546  89],271,2,35698,3.6396818923327894,0.0,0.0
29808,2,9808,[176 234 100 182 153],378,5,35703,3.6398205729432154,0.0,20.0
29809,2,9809,[655 200 265  25 237],92,3,35706,3.6397553516819574,0.0,0.0
29810,2,9810,[313 196 258  70  56],215,3,35709,3.639690143716237,0.0,0.0
29811,2,9811,[423   8  50 183 300],455,5,35714,3.6398287810843866,0.0,20.0
29812,2,9812,[302 483 100 603 191],537,5,35719,3.639967390196678,40.0,20.0
29813,2,9813,[302 483 100 603 191],524,4,35723,3.6400040758100674,40.0,20.0
29814,2,9814,[186 215 182 125 111],378,2,35725,3.6398369842078453,0.0,0.0
29815,2,9815,[302 483 100 603 191],90,5,35730,3.6399755501222493,40.0,20.0
29816,2,9816,[216 187 238  69 588],308,3,35733,3.6399103595803197,0.0,0.0
29817,2,9817,[215 357 168 191 173],882,5,35738,3.6400488897942553,20.0,0.0
29818,2,9818,[125 161 265 238 405],59,2,35740,3.6398818616967104,0.0,0.0
29819,2,9819,[302 483 100 603 191],524,4,35744,3.639918533604888,40.0,20.0
29820,2,9820,[286 194  50 275  28],60,5,35749,3.640057020669993,0.0,20.0
29821,2,9821,[ 97 216 258 286  82],59,3,35752,3.6399918550193444,0.0,0.0
29822,2,9822,[302 483 100 603 191],232,5,35757,3.6401303064236994,40.0,20.0
29823,2,9823,[357 748 186 228 215],804,5,35762,3.640268729641694,20.0,0.0
29824,2,9824,[ 50 180 211 174 508],385,1,35763,3.64,0.0,40.0
29825,2,9825,[ 28  11 313 273 132],64,4,35767,3.640036637492367,0.0,0.0
29826,2,9826,[302 483 100 603 191],474,5,35772,3.6401750279841254,40.0,20.0
29827,2,9827,[286 111 508 234  25],378,4,35776,3.64021164021164,0.0,0.0
29828,2,9828,[302 483 100 603 191],334,5,35781,3.6403499847390375,40.0,20.0
29829,2,9829,[176  50 194 187 515],804,5,35786,3.6404883011190234,0.0,20.0
29830,2,9830,[176 202 435  12 211],883,5,35791,3.640626589360187,20.0,0.0
29831,2,9831,[302 483 100 603 191],524,4,35795,3.6406631407648495,40.0,20.0
29832,2,9832,[172 275 173 168 153],452,5,35800,3.640801383097732,0.0,0.0
29833,2,9833,[ 15 318 568 471  50],648,3,35803,3.640736221273134,20.0,20.0
29834,2,9834,[603 483 237 508 289],533,3,35806,3.6406710726995426,40.0,0.0
29835,2,9835,[483 180 294 196 302],666,3,35809,3.6406059373729156,20.0,0.0
29836,2,9836,[302 483 100 191 603],537,5,35814,3.640744129307716,40.0,20.0
29837,2,9837,[300 257 204   8 181],533,4,35818,3.6407806464728605,0.0,0.0
29838,2,9838,[135  22 288 235 294],804,3,35821,3.6407155198699055,0.0,0.0
29839,2,9839,[318 265 135  50 483],326,4,35825,3.640752032520325,40.0,20.0
29840,2,9840,[302 483 100 191 603],664,4,35829,3.6407885377502285,40.0,20.0
29841,2,9841,[302 483 100 603 191],339,5,35834,3.640926640926641,40.0,20.0
29842,2,9842,[ 71  25 161 125  69],374,5,35839,3.641064716041857,0.0,0.0
29843,2,9843,[238 568 742 174 215],92,3,35842,3.6409995936611135,0.0,20.0
29844,2,9844,[302 483 100 603 191],334,5,35847,3.6411376333164043,40.0,20.0
29845,2,9845,[ 82 483 515  22  71],452,3,35850,3.6410725167580744,20.0,0.0
29846,2,9846,[135 588  79 168  89],85,3,35853,3.6410074134254087,0.0,0.0
29847,2,9847,[180  79 185 153  50],840,4,35857,3.6410438667749796,0.0,20.0
29848,2,9848,[302 483 100 603 191],10,5,35862,3.6411818458726772,40.0,20.0
29849,2,9849,[302 483 100 603 191],334,5,35867,3.6413197969543147,40.0,20.0
29850,2,9850,[302 483 100 603 191],458,5,35872,3.6414577200284235,40.0,20.0
29851,2,9851,[405  98 174 228  79],643,3,35875,3.641392610637434,0.0,40.0
29852,2,9852,[515 127 210  69  89],774,2,35877,3.641226022531209,0.0,20.0
29853,2,9853,[211 168 173 423 210],643,5,35882,3.6413639131317233,0.0,0.0
29854,2,9854,[111 117  64 655 258],899,5,35887,3.641501775748351,0.0,0.0
29855,2,9855,[435  97 180 111 655],59,5,35892,3.6416396103896105,0.0,0.0
29856,2,9856,[597 322 235 117   4],102,0,35892,3.6412701633357005,0.0,0.0
29857,2,9857,[ 79 180 174 161 168],380,3,35895,3.6412051125989042,0.0,20.0
29858,2,9858,[302 483 100 603 191],334,5,35900,3.641342935388985,40.0,20.0
29859,2,9859,[302 483 100 603 191],666,5,35905,3.641480730223124,40.0,20.0
29860,2,9860,[302 483 100 603 191],480,4,35909,3.641517087516479,40.0,20.0
29861,2,9861,[302 483 100 603 191],664,4,35913,3.6415534374366256,40.0,20.0
29862,2,9862,[302 483 100 603 191],10,5,35918,3.6416911690155125,40.0,20.0
29863,2,9863,[191 210 216  95 435],85,3,35921,3.641626115166261,0.0,0.0
29864,2,9864,[288 179 435 546 174],650,2,35923,3.641459706031424,0.0,20.0
29865,2,9865,[ 88 100 268  12 286],537,2,35925,3.641293330630448,20.0,20.0
29866,2,9866,[194 269  28 186 100],343,5,35930,3.6414310327353805,0.0,20.0
29867,2,9867,[302 483 100 603 191],666,5,35935,3.641568706931496,40.0,20.0
29868,2,9868,[302 483 100 603 191],480,4,35939,3.641605025838484,40.0,20.0
29869,2,9869,[405 483 238 117 323],648,3,35942,3.6415400202634247,20.0,0.0
29870,2,9870,[302 483 100 603 191],524,4,35946,3.6415763347178602,40.0,20.0
29871,2,9871,[121 111 568 176 180],92,3,35949,3.6415113452188006,0.0,0.0
29872,2,9872,[121 385 748 144 286],653,4,35953,3.6415476552213106,0.0,0.0
29873,2,9873,[185 222  95  89   9],648,3,35956,3.6414826817905612,0.0,0.0
29874,2,9874,[302 483 100 603 191],458,5,35961,3.641620253164557,40.0,20.0
29875,2,9875,[748 191  50 333 742],488,4,35965,3.6416565411097612,0.0,20.0
29876,2,9876,[302 483 100 603 191],90,5,35970,3.6417940670244002,40.0,20.0
29877,2,9877,[302 483 100 603 191],13,4,35974,3.641830330026321,40.0,20.0
29878,2,9878,[496 483  71 183 179],479,2,35976,3.6416641360461584,20.0,0.0
29879,2,9879,[238 405 597 508  89],643,1,35977,3.641396761133603,0.0,0.0
29880,2,9880,[496 301   9 276 294],6,2,35979,3.641230644671592,0.0,0.0
29881,2,9881,[185 258 135 678 151],749,4,35983,3.6412669500101194,0.0,0.0
29882,2,9882,[302 483 100 603 191],458,5,35988,3.6414044318526764,40.0,20.0
29883,2,9883,[302 483 100 603 191],664,4,35992,3.641440712262242,40.0,20.0
29884,2,9884,[210 174 597   1 423],308,4,35996,3.6414769853313103,0.0,20.0
29885,2,9885,[435 132 588 318 182],7,5,36001,3.641614404207971,20.0,0.0
29886,2,9886,[427 235 385 195 153],313,3,36004,3.6415495094568624,0.0,0.0
29887,2,9887,[176 235 301 276 427],334,2,36006,3.641383495145631,0.0,0.0
29888,2,9888,[258  88 655 471 168],234,0,36006,3.641015269491354,0.0,0.0
29889,2,9889,[172   4  64 258  11],378,3,36009,3.6409504550050555,0.0,0.0
29890,2,9890,[302 483 100 603 191],664,4,36013,3.6409867556364373,40.0,20.0
29891,2,9891,[ 56 211  98  11 294],10,4,36017,3.641023048928427,0.0,20.0
29892,2,9892,[435 121 302 234 196],271,4,36021,3.6410593348832507,0.0,0.0
29893,2,9893,[302 483 100 603 191],474,5,36026,3.6411966848595108,40.0,20.0
29894,2,9894,[ 50 405 318 194 273],666,1,36027,3.640929762506316,20.0,20.0
29895,2,9895,[302 483 100 603 191],232,5,36032,3.6410670978173,40.0,20.0
29896,2,9896,[ 22 258 385 195 111],378,3,36035,3.6410023239365463,0.0,0.0
29897,2,9897,[180 215  70 172 234],488,2,36037,3.6408365326328553,0.0,0.0
29898,2,9898,[204 151 228 194 471],653,2,36039,3.64067077482574,0.0,0.0
29899,2,9899,[194 117 483 222 603],669,1,36040,3.6404040404040403,40.0,0.0
29900,2,9900,[302 483 100 603 191],10,5,36045,3.6405413594586404,40.0,20.0
29901,2,9901,[302 483 100 603 191],480,4,36049,3.64057766107857,40.0,20.0
29902,2,9902,[302 483 100 603 191],537,5,36054,3.640714934868222,40.0,20.0
29903,2,9903,[302 483 100 603 191],537,5,36059,3.6408521809369954,40.0,20.0
29904,2,9904,[ 64 475 210   1  56],387,3,36062,3.6407874810701664,0.0,0.0
29905,2,9905,[302 483 100 603 191],13,4,36066,3.640823743185948,40.0,20.0
29906,2,9906,[202 117   4 194  12],308,4,36070,3.6408599979812255,20.0,0.0
29907,2,9907,[234 313  22 118 176],533,3,36073,3.6407953169156237,0.0,0.0
29908,2,9908,[258 100 195 282 748],328,2,36075,3.6406297305479867,0.0,20.0
29909,2,9909,[211  22 515 127  15],288,5,36080,3.6407669021190716,0.0,20.0
29910,2,9910,[318  28 185 153 181],64,4,36084,3.6408031480173544,20.0,0.0
29911,2,9911,[302 483 100 603 191],454,4,36088,3.6408393866020985,40.0,20.0
29912,2,9912,[302 483 100 603 191],666,5,36093,3.6409764955109454,40.0,20.0
29913,2,9913,[302 483 100 603 191],454,4,36097,3.64101270929998,40.0,20.0
29914,2,9914,[302 483 100 603 191],666,5,36102,3.6411497730711044,40.0,20.0
29915,2,9915,[135 568 182  56 655],488,2,36104,3.6409842678499396,0.0,0.0
29916,2,9916,[302 196  28 546  25],343,3,36107,3.6409196329535143,0.0,0.0
29917,2,9917,[405 235  71 185 195],788,2,36109,3.640754184311353,0.0,0.0
29918,2,9918,[196  50 186 257 483],650,4,36113,3.640790402258292,20.0,20.0
29919,2,9919,[ 28 289 180 182  89],13,4,36117,3.6408266129032256,0.0,0.0
29920,2,9920,[117 405  64 742 216],328,4,36121,3.640862816248362,0.0,0.0
29921,2,9921,[195 294 323  22 111],13,2,36123,3.6406974400322514,0.0,0.0
29922,2,9922,[323 185  88 403 202],13,2,36125,3.6405320971480397,0.0,0.0
29923,2,9923,[144 121 245 135 173],454,2,36127,3.640366787585651,0.0,0.0
29924,2,9924,[ 79 111 135  95 153],454,1,36128,3.6401007556675062,0.0,0.0
29925,2,9925,[ 22 183 271 235 135],537,1,36129,3.639834777352408,0.0,0.0
29926,2,9926,[302 483 100 603 191],454,4,36133,3.6398710587287195,40.0,20.0
29927,2,9927,[328 568 273 313 318],13,1,36134,3.6396051571313457,20.0,0.0
29928,2,9928,[302 483 100 603 191],458,5,36139,3.6397421694027594,40.0,20.0
29929,2,9929,[302 483 100 603 191],524,4,36143,3.639778449144008,40.0,20.0
29930,2,9930,[508   4 588  89 172],144,4,36147,3.6398147215788943,0.0,0.0
29931,2,9931,[  7 273 568 235  70],213,3,36150,3.639750302053967,0.0,0.0
29932,2,9932,[496  97  71 276 180],194,2,36152,3.6395852209805697,0.0,0.0
29933,2,9933,[ 96 143 357 125 174],749,5,36157,3.639722166297564,20.0,20.0
29934,2,9934,[174 275 357  70 483],82,4,36161,3.639758429793659,40.0,20.0
29935,2,9935,[302 483 100 603 191],480,4,36165,3.639794685990338,40.0,20.0
29936,2,9936,[302 483 100 603 191],90,5,36170,3.639931568883969,40.0,20.0
29937,2,9937,[183 588   1  70 161],804,5,36175,3.6400684242302273,0.0,0.0
29938,2,9938,[187 215 176 186 183],881,3,36178,3.6400040245497536,0.0,0.0
29939,2,9939,[117 237 288 153  79],447,4,36182,3.640040241448692,0.0,0.0
29940,2,9940,[302 483 100 603 191],339,5,36187,3.6401770445629213,40.0,20.0
29941,2,9941,[302 483 100 603 191],454,4,36191,3.640213236773285,40.0,20.0
29942,2,9942,[302 483 100 603 191],13,4,36195,3.6402494217037114,40.0,20.0
29943,2,9943,[ 98 195  89 546 144],899,3,36198,3.6401850362027353,0.0,20.0
29944,2,9944,[302 483 100 603 191],474,5,36203,3.6403217697335344,40.0,20.0
29945,2,9945,[183  82 508 175 204],378,5,36208,3.6404584757691536,0.0,0.0
29946,2,9946,[302 483 100 603 191],10,5,36213,3.640595154317885,40.0,20.0
29947,2,9947,[183 196 182  82  71],59,4,36217,3.6406312826698835,0.0,0.0
29948,2,9948,[302 483 100 603 191],480,4,36221,3.640667403759172,40.0,20.0
29949,2,9949,[121 496  89  28   8],64,3,36224,3.640603015075377,0.0,0.0
29950,2,9950,[313 176 588  56 181],13,4,36228,3.6406391317455533,0.0,0.0
29951,2,9951,[323 357 182 276 508],13,2,36230,3.640474276527331,20.0,0.0
29952,2,9952,[302 483 100 603 191],339,5,36235,3.6406108710941423,40.0,20.0
29953,2,9953,[302 483 100 603 191],10,5,36240,3.6407474382157927,40.0,20.0
29954,2,9954,[228  56 161   1 210],158,4,36244,3.6407835258663988,0.0,0.0
29955,2,9955,[302 483 100 603 191],664,4,36248,3.6408196062675775,40.0,20.0
29956,2,9956,[151 144   1  98   7],64,3,36251,3.6407552475645275,0.0,20.0
29957,2,9957,[385 202 183 135 161],694,5,36256,3.6408917453303875,0.0,0.0
29958,2,9958,[ 98 235 185 294 125],271,1,36257,3.640626568932624,0.0,20.0
29959,2,9959,[286 748 471  15  28],653,3,36260,3.640562248995984,0.0,0.0
29960,2,9960,[302 483 100 603 191],334,5,36265,3.6406987250276077,40.0,20.0
29961,2,9961,[302 483 100 603 191],524,4,36269,3.6407347922103996,40.0,20.0
29962,2,9962,[235 333 202  98 117],13,2,36271,3.640570109404798,0.0,20.0
29963,2,9963,[204 258  70 318 111],6,1,36272,3.640305098354075,20.0,0.0
29964,2,9964,[515 313 127 568 153],308,3,36275,3.6402408429503263,0.0,20.0
29965,2,9965,[185 186 222 603 282],474,5,36280,3.6403772827613885,20.0,0.0
29966,2,9966,[168   4 151 318  50],385,0,36280,3.6400120397311126,20.0,20.0
29967,2,9967,[135 153 228   9 597],447,3,36283,3.6399478330658104,0.0,0.0
29968,2,9968,[ 82  56  28 121 151],387,3,36286,3.6398836392817735,0.0,0.0
29969,2,9969,[302 483 100 603 191],13,4,36290,3.6399197592778334,40.0,20.0
29970,2,9970,[302 483 100 603 191],10,5,36295,3.64005616287233,40.0,20.0
29971,2,9971,[111  98 121  64 655],42,3,36298,3.639991977537104,0.0,20.0
29972,2,9972,[302 483 100 603 191],10,5,36303,3.640128346535646,40.0,20.0
29973,2,9973,[191 118 194 234 204],543,3,36306,3.640064166833768,0.0,0.0
29974,2,9974,[185 271 475 151   9],699,2,36308,3.6398997493734337,0.0,0.0
29975,2,9975,[385 204 435   1 143],313,4,36312,3.639935846030473,0.0,0.0
29976,2,9976,[302 483 100 603 191],334,5,36317,3.640072165981758,40.0,20.0
29977,2,9977,[ 95 180 588 357 435],85,4,36321,3.6401082381238727,20.0,0.0
29978,2,9978,[ 97 211 483 357 168],479,4,36325,3.6401443030363763,40.0,0.0
29979,2,9979,[228  96 181 211 132],488,3,36328,3.6400801603206414,0.0,0.0
29980,2,9980,[238 268 195 228 273],145,5,36333,3.6402164111812443,0.0,0.0
29981,2,9981,[427 200 403 222 300],788,2,36335,3.6400520937687837,0.0,0.0
29982,2,9982,[302 483 100 603 191],480,4,36339,3.640088149854753,40.0,20.0
29983,2,9983,[  7 483  79 168 423],650,3,36342,3.6400240384615383,20.0,0.0
29984,2,9984,[302 483 100 603 191],524,4,36346,3.640060090135203,40.0,20.0
29985,2,9985,[302 483 100 603 191],454,4,36350,3.6400961345884237,40.0,20.0
29986,2,9986,[302 483 100 603 191],334,5,36355,3.64023230199259,40.0,20.0
29987,2,9987,[ 82 204 182  50 300],215,1,36356,3.6399679615538645,0.0,20.0
29988,2,9988,[ 50  64 179 273 153],374,2,36358,3.639803784162579,0.0,20.0
29989,2,9989,[302 483 100 603 191],480,4,36362,3.6398398398398397,40.0,20.0
29990,2,9990,[302 483 100 603 191],666,5,36367,3.6399759783805425,40.0,20.0
29991,2,9991,[302 483 100 603 191],480,4,36371,3.6400120096076862,40.0,20.0
29992,2,9992,[187 195 435 597  22],13,3,36374,3.6399479635745022,0.0,0.0
29993,2,9993,[191   9 196 655 100],92,5,36379,3.640084050430258,0.0,20.0
29994,2,9994,[302 483 100 603 191],537,5,36384,3.6402201100550275,40.0,20.0
29995,2,9995,[302 483 100 603 191],454,4,36388,3.6402561024409765,40.0,20.0
29996,2,9996,[427 186 174  95 181],271,5,36393,3.6403921176352907,0.0,20.0
29997,2,9997,[302 483 100 603 191],537,5,36398,3.640528105621124,40.0,20.0
29998,2,9998,[302 483 100 603 191],666,5,36403,3.6406640664066408,40.0,20.0
29999,2,9999,[  8 196 200 168 183],13,4,36407,3.6407,0.0,0.0
30000,3,0,[258 132 180 182 597],328,3,3,3.0,0.0,0.0
30001,3,1,[ 15   1  97   8 135],454,2,5,2.5,0.0,0.0
30002,3,2,[ 97   8 180 258 132],311,5,10,3.3333333333333335,0.0,0.0
30003,3,3,[228   7 234 215 294],194,1,11,2.75,0.0,0.0
30004,3,4,[ 97   8 294 180 258],774,1,12,2.4,0.0,0.0
30005,3,5,[183 257 318 282 288],455,2,14,2.3333333333333335,20.0,0.0
30006,3,6,[168 588  56 471 603],234,1,15,2.142857142857143,20.0,0.0
30007,3,7,[195 423 174 186 508],326,3,18,2.25,0.0,20.0
30008,3,8,[181 182 234  89 294],506,5,23,2.5555555555555554,0.0,0.0
30009,3,9,[222  95 161  96 313],738,5,28,2.8,0.0,0.0
30010,3,10,[153 222 187 245 196],666,2,30,2.727272727272727,0.0,0.0
30011,3,11,[ 96 257  95 603 153],899,5,35,2.9166666666666665,20.0,0.0
30012,3,12,[ 96 257  95 603 153],749,3,38,2.923076923076923,20.0,0.0
30013,3,13,[216 187 288 286 742],334,2,40,2.857142857142857,0.0,0.0
30014,3,14,[ 96 174 603 132 153],64,3,43,2.8666666666666667,20.0,20.0
30015,3,15,[238 125 496 211 237],271,4,47,2.9375,0.0,0.0
30016,3,16,[176  11  12 200  22],537,0,47,2.764705882352941,20.0,0.0
30017,3,17,[ 64 405 515 228  28],279,1,48,2.6666666666666665,0.0,0.0
30018,3,18,[ 96 180 186 132 174],7,5,53,2.789473684210526,0.0,20.0
30019,3,19,[ 96 180 186 132 174],406,4,57,2.85,0.0,20.0
30020,3,20,[ 96 180 132 174 183],263,5,62,2.9523809523809526,0.0,20.0
30021,3,21,[ 96 180 132 174 183],881,3,65,2.9545454545454546,0.0,20.0
30022,3,22,[211 180 238 174 183],694,4,69,3.0,0.0,20.0
30023,3,23,[202  22 257 172 216],883,4,73,3.0416666666666665,0.0,0.0
30024,3,24,[211 180 174 183 187],13,5,78,3.12,0.0,20.0
30025,3,25,[127  88 197 181 187],271,5,83,3.1923076923076925,0.0,20.0
30026,3,26,[588 294  79 196 125],804,5,88,3.259259259259259,0.0,0.0
30027,3,27,[ 70 286 515 143 405],13,0,88,3.142857142857143,0.0,0.0
30028,3,28,[  1 471 496  11 234],378,2,90,3.103448275862069,0.0,0.0
30029,3,29,[180  88 183 197 237],60,5,95,3.1666666666666665,0.0,0.0
30030,3,30,[ 56 258 289 132 286],454,1,96,3.096774193548387,0.0,0.0
30031,3,31,[180  88 183 197 237],313,3,99,3.09375,0.0,0.0
30032,3,32,[318 211  50 215   9],194,3,102,3.090909090909091,20.0,20.0
30033,3,33,[180   9 197 183  89],406,5,107,3.1470588235294117,0.0,0.0
30034,3,34,[180   9 197 183  89],474,5,112,3.2,0.0,0.0
30035,3,35,[288 173 294 121 194],882,3,115,3.1944444444444446,0.0,0.0
30036,3,36,[195 174 172 180  89],87,5,120,3.2432432432432434,0.0,20.0
30037,3,37,[174 405 135 257 196],653,2,122,3.210526315789474,0.0,20.0
30038,3,38,[742 483 176   4 294],648,3,125,3.2051282051282053,20.0,0.0
30039,3,39,[ 22 471 423 181 185],524,3,128,3.2,0.0,0.0
30040,3,40,[121 143 423 483  28],538,2,130,3.1707317073170733,20.0,0.0
30041,3,41,[111 210 257 655 117],479,4,134,3.1904761904761907,0.0,0.0
30042,3,42,[655 180 127  79 211],774,2,136,3.1627906976744184,0.0,20.0
30043,3,43,[194 357 183  64 211],42,5,141,3.2045454545454546,20.0,0.0
30044,3,44,[187  89 210 180 174],648,3,144,3.2,0.0,20.0
30045,3,45,[496 257 423 183 238],749,3,147,3.1956521739130435,0.0,0.0
30046,3,46,[196  11 471 118  56],271,2,149,3.1702127659574466,0.0,0.0
30047,3,47,[423 191 568 176  28],538,3,152,3.1666666666666665,0.0,0.0
30048,3,48,[172 173 195   9  89],234,0,152,3.1020408163265305,0.0,0.0
30049,3,49,[197 127 183 191 483],537,4,156,3.12,20.0,20.0
30050,3,50,[197 127 191 483 174],833,3,159,3.1176470588235294,20.0,40.0
30051,3,51,[202 210 111 357 161],653,3,162,3.1153846153846154,20.0,0.0
30052,3,52,[228  22 588 135 238],650,3,165,3.1132075471698113,0.0,0.0
30053,3,53,[151 603  64  97 174],64,2,167,3.0925925925925926,20.0,20.0
30054,3,54,[423  15 118  82 475],374,2,169,3.0727272727272728,0.0,0.0
30055,3,55,[ 82 483 313 210 185],234,2,171,3.0535714285714284,20.0,0.0
30056,3,56,[144  22 515  69 257],559,3,174,3.0526315789473686,0.0,0.0
30057,3,57,[275 135 385 496 357],311,5,179,3.086206896551724,20.0,0.0
30058,3,58,[483 161 191 357  69],311,5,184,3.1186440677966103,40.0,0.0
30059,3,59,[483 161 191 357  69],188,3,187,3.1166666666666667,40.0,0.0
30060,3,60,[483 385 357  69 144],899,2,189,3.098360655737705,40.0,0.0
30061,3,61,[323 197 111  15 183],537,1,190,3.064516129032258,0.0,0.0
30062,3,62,[423 282 174  82 588],95,3,193,3.0634920634920637,0.0,20.0
30063,3,63,[ 12 196 234 172  15],398,4,197,3.078125,20.0,0.0
30064,3,64,[313 357 127 275 483],184,5,202,3.1076923076923078,40.0,20.0
30065,3,65,[204  50 111 289 235],378,4,206,3.121212121212121,0.0,20.0
30066,3,66,[313 127 204 357 275],308,4,210,3.1343283582089554,20.0,20.0
30067,3,67,[ 25 202 121 234 265],279,4,214,3.1470588235294117,0.0,0.0
30068,3,68,[ 95 191 288 268 187],13,3,217,3.1449275362318843,0.0,0.0
30069,3,69,[275 483 265 268 357],7,4,221,3.157142857142857,40.0,0.0
30070,3,70,[268  64 118  96 265],145,4,225,3.1690140845070425,0.0,0.0
30071,3,71,[ 97 427 655 100 423],194,3,228,3.1666666666666665,0.0,20.0
30072,3,72,[275 100 357 204 483],454,2,230,3.1506849315068495,40.0,20.0
30073,3,73,[237 183 322 161  96],313,3,233,3.1486486486486487,0.0,0.0
30074,3,74,[ 25 427 204 100 265],234,2,235,3.1333333333333333,0.0,20.0
30075,3,75,[271 475  89 174 328],537,2,237,3.1184210526315788,0.0,20.0
30076,3,76,[151 603 405  25 318],42,4,241,3.1298701298701297,40.0,0.0
30077,3,77,[ 28 202  96 168   9],815,4,245,3.141025641025641,0.0,0.0
30078,3,78,[ 50 196 216 515 257],669,2,247,3.1265822784810124,0.0,20.0
30079,3,79,[ 97 318 435 194 234],308,3,250,3.125,20.0,0.0
30080,3,80,[435  82 294  56 235],537,1,251,3.0987654320987654,0.0,0.0
30081,3,81,[127 427 100 180  96],7,5,256,3.1219512195121952,0.0,40.0
30082,3,82,[127 427 100 180  96],737,3,259,3.1204819277108435,0.0,40.0
30083,3,83,[127 100 180 483 357],311,4,263,3.130952380952381,40.0,40.0
30084,3,84,[127 180 483 357 197],749,5,268,3.152941176470588,40.0,20.0
30085,3,85,[127 180 483 357 197],233,5,273,3.1744186046511627,40.0,20.0
30086,3,86,[127 180 483 357 197],13,4,277,3.1839080459770117,40.0,20.0
30087,3,87,[127 180 483 197 174],766,2,279,3.1704545454545454,20.0,40.0
30088,3,88,[127 180 483  89 357],215,4,283,3.1797752808988764,40.0,20.0
30089,3,89,[265 423  70  64 603],452,4,287,3.188888888888889,20.0,0.0
30090,3,90,[127 318 238 294 210],653,3,290,3.1868131868131866,20.0,20.0
30091,3,91,[127 180 483  89 357],409,5,295,3.2065217391304346,40.0,20.0
30092,3,92,[127 180  89 483 357],892,5,300,3.225806451612903,40.0,20.0
30093,3,93,[127 180  89 483 357],648,2,302,3.2127659574468086,40.0,20.0
30094,3,94,[127  89 483 180 183],339,5,307,3.231578947368421,20.0,20.0
30095,3,95,[313 117 405  70  50],271,3,310,3.2291666666666665,0.0,20.0
30096,3,96,[323  70 748  22  82],311,4,314,3.2371134020618557,0.0,0.0
30097,3,97,[748 127  89 483 180],488,3,317,3.2346938775510203,20.0,20.0
30098,3,98,[748 127  89 183 483],479,4,321,3.242424242424242,20.0,20.0
30099,3,99,[127  89 183 483 180],666,5,326,3.26,20.0,20.0
30100,3,100,[127  89 183 483 180],234,3,329,3.257425742574257,20.0,20.0
30101,3,101,[127 183 483  89  96],313,5,334,3.2745098039215685,20.0,20.0
30102,3,102,[127 183 483  89  96],452,4,338,3.2815533980582523,20.0,20.0
30103,3,103,[168 180  97 496  22],664,3,341,3.2788461538461537,0.0,0.0
30104,3,104,[127 183  89 483 180],694,5,346,3.295238095238095,20.0,20.0
30105,3,105,[127 183  89 483 180],6,5,351,3.311320754716981,20.0,20.0
30106,3,106,[180 273 405   7   4],774,1,352,3.289719626168224,0.0,0.0
30107,3,107,[603 427 132 183 143],308,4,356,3.2962962962962963,20.0,0.0
30108,3,108,[127 183  89 483 180],234,3,359,3.293577981651376,20.0,20.0
30109,3,109,[175 228  88 286  50],648,3,362,3.290909090909091,0.0,20.0
30110,3,110,[127 183 483  89 187],897,4,366,3.2972972972972974,20.0,20.0
30111,3,111,[ 70 403  11 405 183],788,3,369,3.294642857142857,0.0,0.0
30112,3,112,[127 183 483  89 187],694,5,374,3.309734513274336,20.0,20.0
30113,3,113,[127 183 187 483  89],694,5,379,3.324561403508772,20.0,20.0
30114,3,114,[405  50 132 211  25],934,5,384,3.3391304347826085,0.0,20.0
30115,3,115,[197 265 238  12  97],380,1,385,3.3189655172413794,20.0,0.0
30116,3,116,[127 183 187 483  89],311,5,390,3.3333333333333335,20.0,20.0
30117,3,117,[127 183 187 483  89],326,3,393,3.330508474576271,20.0,20.0
30118,3,118,[127 183 483  89 211],479,5,398,3.3445378151260505,20.0,20.0
30119,3,119,[127 183  89 483 211],766,4,402,3.35,20.0,20.0
30120,3,120,[423   8 161 597 294],774,0,402,3.322314049586777,0.0,0.0
30121,3,121,[127 183  89 211 483],749,5,407,3.3360655737704916,20.0,20.0
30122,3,122,[127 183 211  89 483],694,5,412,3.3495934959349594,20.0,20.0
30123,3,123,[127 183 211  89 483],328,5,417,3.3629032258064515,20.0,20.0
30124,3,124,[127 183 211  89 483],95,2,419,3.352,20.0,20.0
30125,3,125,[127 183  89 483 211],479,5,424,3.365079365079365,20.0,20.0
30126,3,126,[318  69  22 302 228],328,4,428,3.37007874015748,20.0,0.0
30127,3,127,[302 127 183  89 211],474,5,433,3.3828125,0.0,20.0
30128,3,128,[302   9 276 135 180],378,3,436,3.37984496124031,0.0,0.0
30129,3,129,[175 187 211 257   4],343,4,440,3.3846153846153846,0.0,0.0
30130,3,130,[153 179  69  97 144],7,5,445,3.3969465648854964,0.0,0.0
30131,3,131,[475 318 196 185 200],13,1,446,3.378787878787879,20.0,0.0
30132,3,132,[  7  15 100 313 176],308,3,449,3.3759398496240602,0.0,20.0
30133,3,133,[ 79 588 568 328 118],378,4,453,3.3805970149253732,0.0,0.0
30134,3,134,[143 258 182 111 153],666,3,456,3.3777777777777778,0.0,0.0
30135,3,135,[603   9 496 215  97],90,4,460,3.3823529411764706,20.0,0.0
30136,3,136,[357 328 323 515 125],263,4,464,3.386861313868613,20.0,0.0
30137,3,137,[301  64 216 268  96],90,5,469,3.398550724637681,0.0,0.0
30138,3,138,[483 435 294 323 300],537,1,470,3.381294964028777,20.0,0.0
30139,3,139,[  8 496 228 204  50],200,5,475,3.392857142857143,0.0,20.0
30140,3,140,[144 191 318 186 435],666,3,478,3.3900709219858154,20.0,0.0
30141,3,141,[197 180 403 179 195],339,3,481,3.387323943661972,0.0,0.0
30142,3,142,[ 25 144 235  70 357],406,2,483,3.3776223776223775,20.0,0.0
30143,3,143,[185  96 125 117 328],749,5,488,3.388888888888889,0.0,0.0
30144,3,144,[276 179 301 302 127],537,4,492,3.393103448275862,0.0,20.0
30145,3,145,[276 302 179 127 183],207,3,495,3.3904109589041096,0.0,20.0
30146,3,146,[271  69  50   4 475],537,2,497,3.380952380952381,0.0,20.0
30147,3,147,[234 235 117   1  69],648,3,500,3.3783783783783785,0.0,0.0
30148,3,148,[185 216 748 186 204],524,2,502,3.3691275167785233,0.0,0.0
30149,3,149,[179 300 172 183  79],234,1,503,3.3533333333333335,0.0,0.0
30150,3,150,[302 127 183  89  50],158,4,507,3.357615894039735,0.0,40.0
30151,3,151,[302 127 183  50  89],474,5,512,3.3684210526315788,0.0,40.0
30152,3,152,[ 15 180  98 183 268],92,4,516,3.372549019607843,0.0,20.0
30153,3,153,[302  98 127 183  50],346,3,519,3.3701298701298703,0.0,60.0
30154,3,154,[ 64 568 238  28  50],92,3,522,3.367741935483871,0.0,20.0
30155,3,155,[313 423  28 515 173],85,4,526,3.371794871794872,0.0,0.0
30156,3,156,[127  50 183  89 302],664,4,530,3.375796178343949,0.0,40.0
30157,3,157,[127  50  89 183 302],883,5,535,3.3860759493670884,0.0,40.0
30158,3,158,[ 69  89 176 276 118],59,5,540,3.3962264150943398,0.0,0.0
30159,3,159,[597 181 183 282 427],458,2,542,3.3875,0.0,0.0
30160,3,160,[ 71 176 151 215  69],664,4,546,3.391304347826087,0.0,0.0
30161,3,161,[318 176 322 194 118],788,4,550,3.3950617283950617,20.0,0.0
30162,3,162,[ 71 742 117  50 215],200,5,555,3.4049079754601226,0.0,20.0
30163,3,163,[286 357  82 151 300],7,4,559,3.408536585365854,20.0,0.0
30164,3,164,[180 496   7 168 273],537,4,563,3.412121212121212,0.0,0.0
30165,3,165,[143 238 286 546 180],650,2,565,3.4036144578313254,0.0,0.0
30166,3,166,[181 118  64  56  89],454,2,567,3.395209580838323,0.0,0.0
30167,3,167,[196  98  28  82 257],815,4,571,3.3988095238095237,0.0,20.0
30168,3,168,[ 89 202  88 118 174],653,2,573,3.3905325443786984,0.0,20.0
30169,3,169,[181 100 194  82 289],378,5,578,3.4,0.0,20.0
30170,3,170,[ 71 127  50 302 183],13,5,583,3.409356725146199,0.0,40.0
30171,3,171,[313 403  98 211 357],234,3,586,3.4069767441860463,20.0,20.0
30172,3,172,[ 25 100 144 135 187],207,2,588,3.398843930635838,0.0,20.0
30173,3,173,[403 300  82 471 186],13,1,589,3.3850574712643677,0.0,0.0
30174,3,174,[ 25 161 496 289 100],234,3,592,3.382857142857143,0.0,20.0
30175,3,175,[  4  97 200  56 265],308,3,595,3.3806818181818183,0.0,0.0
30176,3,176,[471 202  22 328  79],378,2,597,3.3728813559322033,0.0,0.0
30177,3,177,[204 100 216 161 191],295,5,602,3.3820224719101124,0.0,20.0
30178,3,178,[423  64 161 153 210],738,5,607,3.3910614525139664,0.0,0.0
30179,3,179,[265   7 117 275 471],524,2,609,3.3833333333333333,0.0,0.0
30180,3,180,[ 71 127  50 302 183],6,5,614,3.3922651933701657,0.0,40.0
30181,3,181,[179 176 186 597 161],92,3,617,3.39010989010989,0.0,0.0
30182,3,182,[ 71 127  50 302 183],334,4,621,3.3934426229508197,0.0,40.0
30183,3,183,[172 180  71  64 161],59,3,624,3.391304347826087,0.0,0.0
30184,3,184,[100 357 117 423 179],474,5,629,3.4,20.0,20.0
30185,3,185,[318   8  70 118 275],554,5,634,3.4086021505376345,20.0,0.0
30186,3,186,[127  50 302 183  64],6,5,639,3.4171122994652405,0.0,40.0
30187,3,187,[427  97 318 153 235],13,3,642,3.4148936170212765,20.0,0.0
30188,3,188,[127  50 302  64 183],833,2,644,3.4074074074074074,0.0,40.0
30189,3,189,[127 183  50 496  89],488,5,649,3.4157894736842107,0.0,40.0
30190,3,190,[127 183  50 496  89],385,2,651,3.4083769633507854,0.0,40.0
30191,3,191,[127 183  89 153 176],538,5,656,3.4166666666666665,0.0,20.0
30192,3,192,[496  82 176 222 187],488,4,660,3.4196891191709846,0.0,0.0
30193,3,193,[288  64  69 172 403],387,1,661,3.4072164948453607,0.0,0.0
30194,3,194,[127 176 183 153  89],350,3,664,3.405128205128205,0.0,20.0
30195,3,195,[127 176  89 183 357],648,3,667,3.4030612244897958,20.0,20.0
30196,3,196,[471 265 161 302 475],13,3,670,3.401015228426396,0.0,0.0
30197,3,197,[ 64 195 234 235 483],59,4,674,3.404040404040404,20.0,0.0
30198,3,198,[127 176  89 183 302],666,5,679,3.4120603015075375,0.0,20.0
30199,3,199,[187  97 237  96 195],871,3,682,3.41,0.0,0.0
30200,3,200,[269 276 302 127 195],537,3,685,3.4079601990049753,0.0,20.0
30201,3,201,[ 79 127 168 187 294],6,3,688,3.405940594059406,0.0,20.0
30202,3,202,[  4 172 273 168 181],537,1,689,3.394088669950739,0.0,0.0
30203,3,203,[  9 182 323  11 111],378,2,691,3.3872549019607843,0.0,0.0
30204,3,204,[182   8  69 168 275],474,3,694,3.3853658536585365,0.0,0.0
30205,3,205,[127 176  89 302 183],13,4,698,3.3883495145631066,0.0,20.0
30206,3,206,[211 385 143 273  70],7,2,700,3.3816425120772946,0.0,0.0
30207,3,207,[127  89 302 183   9],883,5,705,3.389423076923077,0.0,20.0
30208,3,208,[405 275 322  82 118],533,4,709,3.3923444976076556,0.0,0.0
30209,3,209,[127 302  89   9 183],13,4,713,3.395238095238095,0.0,20.0
30210,3,210,[127 302  89 183  50],474,5,718,3.4028436018957344,0.0,40.0
30211,3,211,[127 302  89 183  50],833,3,721,3.400943396226415,0.0,40.0
30212,3,212,[204 175  25 200   1],378,4,725,3.403755868544601,0.0,0.0
30213,3,213,[127  89 183 302 483],334,5,730,3.411214953271028,20.0,20.0
30214,3,214,[211 496 234 427  97],650,4,734,3.4139534883720932,0.0,0.0
30215,3,215,[195 289 135 427 568],788,1,735,3.4027777777777777,0.0,0.0
30216,3,216,[127  89 183 302 483],6,5,740,3.410138248847926,20.0,20.0
30217,3,217,[  1 515  22  50 655],308,4,744,3.4128440366972477,0.0,20.0
30218,3,218,[ 97 322 471 228 195],454,2,746,3.406392694063927,0.0,0.0
30219,3,219,[127  89 183 302 483],13,5,751,3.4136363636363636,20.0,20.0
30220,3,220,[127  89 183 302 483],474,5,756,3.420814479638009,20.0,20.0
30221,3,221,[185 257 385  98 282],374,4,760,3.4234234234234235,0.0,20.0
30222,3,222,[  4 515 597   9 210],13,1,761,3.412556053811659,0.0,0.0
30223,3,223,[186 588 234 483 515],840,5,766,3.419642857142857,20.0,0.0
30224,3,224,[194 153 183 132 588],892,5,771,3.4266666666666667,0.0,0.0
30225,3,225,[127  89 183 302 483],480,3,774,3.424778761061947,20.0,20.0
30226,3,226,[132 748 276   1 117],311,5,779,3.4317180616740086,0.0,0.0
30227,3,227,[127  89 183 302 483],480,3,782,3.4298245614035086,20.0,20.0
30228,3,228,[483 496  71 185 202],308,3,785,3.427947598253275,20.0,0.0
30229,3,229,[127  89 183 302 179],474,5,790,3.4347826086956523,0.0,20.0
30230,3,230,[603 471 405 234 132],524,3,793,3.432900432900433,20.0,0.0
30231,3,231,[151 132  12 181 127],474,4,797,3.435344827586207,20.0,20.0
30232,3,232,[181 678 496 237  98],308,1,798,3.424892703862661,0.0,20.0
30233,3,233,[742 211  69 200 273],833,1,799,3.4145299145299144,0.0,0.0
30234,3,234,[127  89 183 302 179],664,4,803,3.4170212765957446,0.0,20.0
30235,3,235,[194  11 265 271  89],883,1,804,3.406779661016949,0.0,0.0
30236,3,236,[127  89 302 183 179],664,4,808,3.409282700421941,0.0,20.0
30237,3,237,[282   4  70 423 195],653,1,809,3.399159663865546,0.0,0.0
30238,3,238,[202 135 186  11 132],64,5,814,3.405857740585774,0.0,0.0
30239,3,239,[135 181 183 187 318],666,4,818,3.408333333333333,20.0,0.0
30240,3,240,[475 258  64 183 265],207,2,820,3.4024896265560165,0.0,0.0
30241,3,241,[118  95 194 172 235],650,3,823,3.4008264462809916,0.0,0.0
30242,3,242,[176 515 172 175 678],474,4,827,3.403292181069959,0.0,0.0
30243,3,243,[127  89 302 179 183],13,4,831,3.4057377049180326,0.0,20.0
30244,3,244,[127  89 302 183 176],346,4,835,3.4081632653061225,0.0,20.0
30245,3,245,[496 143 183 100 127],379,5,840,3.4146341463414633,0.0,40.0
30246,3,246,[127  89 302 176 183],158,4,844,3.417004048582996,0.0,20.0
30247,3,247,[742 423 275 191 405],524,2,846,3.411290322580645,0.0,0.0
30248,3,248,[127  89 302 176 183],883,5,851,3.4176706827309236,0.0,20.0
30249,3,249,[  9 294 471 323 118],374,2,853,3.412,0.0,0.0
30250,3,250,[ 64 588 215 135 597],13,4,857,3.414342629482072,0.0,0.0
30251,3,251,[127  89 176 302 183],197,4,861,3.4166666666666665,0.0,20.0
30252,3,252,[127  89 176 302 183],666,5,866,3.4229249011857705,0.0,20.0
30253,3,253,[187 496 118 322  28],533,5,871,3.4291338582677167,0.0,0.0
30254,3,254,[127  89 176 302 183],339,5,876,3.4352941176470586,0.0,20.0
30255,3,255,[127  89 176 302 183],144,3,879,3.43359375,0.0,20.0
30256,3,256,[127  89 176 183 302],883,5,884,3.4396887159533076,0.0,20.0
30257,3,257,[127  89 176 183 302],158,4,888,3.441860465116279,0.0,20.0
30258,3,258,[127 176  89 183 302],115,5,893,3.447876447876448,0.0,20.0
30259,3,259,[  4 286 275  88 238],406,0,893,3.4346153846153844,0.0,0.0
30260,3,260,[ 82 111 294 313 121],13,3,896,3.4329501915708813,0.0,0.0
30261,3,261,[ 64   1 175 238 302],360,3,899,3.431297709923664,0.0,0.0
30262,3,262,[204 301 245 313  79],328,3,902,3.429657794676806,0.0,0.0
30263,3,263,[323  96  28 211 678],13,3,905,3.428030303030303,0.0,0.0
30264,3,264,[185 235 288  56   7],804,3,908,3.4264150943396228,0.0,0.0
30265,3,265,[271 161 135 179  50],749,4,912,3.4285714285714284,0.0,20.0
30266,3,266,[127 176  89 302 183],346,4,916,3.4307116104868913,0.0,20.0
30267,3,267,[286 471 234 135  56],474,4,920,3.4328358208955225,0.0,0.0
30268,3,268,[127 176  89 183 100],892,5,925,3.4386617100371746,0.0,40.0
30269,3,269,[127 176  89 183 100],387,4,929,3.4407407407407407,0.0,40.0
30270,3,270,[127  89 176 183 100],643,4,933,3.4428044280442807,0.0,40.0
30271,3,271,[127  89 176 100 183],311,4,937,3.4448529411764706,0.0,40.0
30272,3,272,[127  89 176 183  50],8,5,942,3.4505494505494507,0.0,40.0
30273,3,273,[127  89 176 183  50],643,4,946,3.4525547445255476,0.0,40.0
30274,3,274,[127 176  89 183  50],666,4,950,3.4545454545454546,0.0,40.0
30275,3,275,[ 64 125  96 168 222],745,3,953,3.4528985507246377,0.0,0.0
30276,3,276,[322  79 222 125 210],749,4,957,3.454873646209386,0.0,0.0
30277,3,277,[127 176  89 183  96],77,3,960,3.4532374100719423,0.0,20.0
30278,3,278,[  9 237 286  28 427],406,2,962,3.4480286738351253,0.0,0.0
30279,3,279,[ 50 300  56 403  71],334,3,965,3.4464285714285716,0.0,20.0
30280,3,280,[257 143  96 294 385],92,2,967,3.4412811387900355,0.0,0.0
30281,3,281,[ 11 200 173 172 568],59,5,972,3.4468085106382977,0.0,0.0
30282,3,282,[300  28 238 144 222],454,3,975,3.4452296819787986,0.0,0.0
30283,3,283,[127 176  89 183 302],197,4,979,3.4471830985915495,0.0,20.0
30284,3,284,[127 176  89 183 276],59,5,984,3.4526315789473685,0.0,20.0
30285,3,285,[588 175 173 132  98],59,4,988,3.4545454545454546,0.0,20.0
30286,3,286,[127 176  89 183 276],184,5,993,3.4599303135888504,0.0,20.0
30287,3,287,[151 313 179 385  97],59,5,998,3.4652777777777777,0.0,0.0
30288,3,288,[127 176  89 183 276],234,2,1000,3.4602076124567476,0.0,20.0
30289,3,289,[258  64 135 173 282],378,4,1004,3.462068965517241,0.0,0.0
30290,3,290,[235 403  79 322  97],524,4,1008,3.463917525773196,0.0,0.0
30291,3,291,[ 11 183 286   4 275],158,4,1012,3.4657534246575343,0.0,0.0
30292,3,292,[  1 302 655 357 318],454,2,1014,3.460750853242321,40.0,0.0
30293,3,293,[127  89 176 183 258],8,5,1019,3.4659863945578233,0.0,20.0
30294,3,294,[153 127 204  56 318],653,4,1023,3.4677966101694917,20.0,20.0
30295,3,295,[127 176  89 258 183],350,3,1026,3.4662162162162162,0.0,20.0
30296,3,296,[143 403  71 202 427],533,4,1030,3.468013468013468,0.0,0.0
30297,3,297,[127 176  89 183 179],653,3,1033,3.466442953020134,0.0,20.0
30298,3,298,[127  89 176 179 183],881,5,1038,3.471571906354515,0.0,20.0
30299,3,299,[195 144 182  88 200],92,3,1041,3.47,0.0,0.0
30300,3,300,[132 603 265 121 197],843,0,1041,3.4584717607973423,20.0,0.0
30301,3,301,[127  89 176 179 183],766,4,1045,3.4602649006622515,0.0,20.0
30302,3,302,[237  71  97 181 202],308,3,1048,3.458745874587459,0.0,0.0
30303,3,303,[127  89 179 176 183],694,5,1053,3.463815789473684,0.0,20.0
30304,3,304,[127  89 179 176 183],379,5,1058,3.4688524590163934,0.0,20.0
30305,3,305,[127  89 179 176 183],694,5,1063,3.473856209150327,0.0,20.0
30306,3,306,[289 216 286 186   8],334,2,1065,3.469055374592834,0.0,0.0
30307,3,307,[127  89 179 176 183],843,4,1069,3.470779220779221,0.0,20.0
30308,3,308,[  1 237 187 300 294],788,3,1072,3.469255663430421,0.0,0.0
30309,3,309,[211   1 282 294 333],653,2,1074,3.464516129032258,0.0,0.0
30310,3,310,[ 98  82  97 187 483],788,3,1077,3.463022508038585,20.0,20.0
30311,3,311,[333 127  89 179 176],537,3,1080,3.4615384615384617,0.0,20.0
30312,3,312,[127  89 179 183 176],350,4,1084,3.463258785942492,0.0,20.0
30313,3,313,[127 179  89 176 183],474,5,1089,3.468152866242038,0.0,20.0
30314,3,314,[403 265 603 313 187],234,3,1092,3.466666666666667,20.0,0.0
30315,3,315,[215 153 435 508 174],385,1,1093,3.4588607594936707,0.0,20.0
30316,3,316,[127 179  89 176 183],881,5,1098,3.4637223974763405,0.0,20.0
30317,3,317,[183  64 323  69 475],474,4,1102,3.4654088050314464,0.0,0.0
30318,3,318,[302  88 318 135 216],883,5,1107,3.470219435736677,20.0,0.0
30319,3,319,[127 179  89 176 183],650,3,1110,3.46875,0.0,20.0
30320,3,320,[127  89 179 176 183],749,5,1115,3.473520249221184,0.0,20.0
30321,3,321,[ 69  56 200 405 597],455,3,1118,3.472049689440994,0.0,0.0
30322,3,322,[333 385  89 328 197],313,5,1123,3.476780185758514,0.0,0.0
30323,3,323,[238 144 273 275  56],158,4,1127,3.478395061728395,0.0,0.0
30324,3,324,[151 173 196 216 100],892,5,1132,3.483076923076923,0.0,20.0
30325,3,325,[195  11 678 215 200],7,3,1135,3.48159509202454,0.0,0.0
30326,3,326,[127  89 179 176 183],387,4,1139,3.4831804281345566,0.0,20.0
30327,3,327,[127  89 179 183 385],374,3,1142,3.481707317073171,0.0,20.0
30328,3,328,[127  89 385 183 187],488,4,1146,3.4832826747720365,0.0,20.0
30329,3,329,[313  95 127  88 228],537,2,1148,3.478787878787879,0.0,20.0
30330,3,330,[127  89 385 183 179],890,4,1152,3.4803625377643503,0.0,20.0
30331,3,331,[127  89 385 179 183],374,3,1155,3.4789156626506026,0.0,20.0
30332,3,332,[ 79 258  71  22 215],474,5,1160,3.4834834834834836,0.0,0.0
30333,3,333,[127 385  89 183 176],749,4,1164,3.4850299401197606,0.0,20.0
30334,3,334,[211 200 161 286  56],271,3,1167,3.4835820895522387,0.0,0.0
30335,3,335,[143   8 258 215  95],92,3,1170,3.482142857142857,0.0,0.0
30336,3,336,[127  89 183 176  64],474,5,1175,3.486646884272997,0.0,20.0
30337,3,337,[127  89 183 176  64],184,5,1180,3.4911242603550297,0.0,20.0
30338,3,338,[127  89  64 183 176],653,3,1183,3.489675516224189,0.0,20.0
30339,3,339,[202 195 210 144 322],374,3,1186,3.488235294117647,0.0,0.0
30340,3,340,[127  89  64 183 313],455,4,1190,3.4897360703812317,0.0,20.0
30341,3,341,[183 132 302 100  98],474,5,1195,3.4941520467836256,0.0,40.0
30342,3,342,[127  89  64 183 313],184,5,1200,3.498542274052478,0.0,20.0
30343,3,343,[127  89  64 313 183],883,4,1204,3.5,0.0,20.0
30344,3,344,[127  89  64 183 176],892,5,1209,3.5043478260869567,0.0,20.0
30345,3,345,[127  89  64 183 176],95,3,1212,3.5028901734104045,0.0,20.0
30346,3,346,[127  64  89 183 100],892,5,1217,3.5072046109510087,0.0,40.0
30347,3,347,[235   7   1 183  25],13,1,1218,3.5,0.0,0.0
30348,3,348,[475 742  28 216  88],506,4,1222,3.501432664756447,0.0,0.0
30349,3,349,[127  64  89 183 100],339,5,1227,3.505714285714286,0.0,40.0
30350,3,350,[127  64  89 183 100],455,4,1231,3.507122507122507,0.0,40.0
30351,3,351,[127  64  89 183 100],184,5,1236,3.5113636363636362,0.0,40.0
30352,3,352,[127  64  89 100 183],339,5,1241,3.5155807365439093,0.0,40.0
30353,3,353,[127  64  89 100 183],87,5,1246,3.519774011299435,0.0,40.0
30354,3,354,[127  64  89 100 183],749,4,1250,3.5211267605633805,0.0,40.0
30355,3,355,[127  64  89 183 100],892,5,1255,3.5252808988764044,0.0,40.0
30356,3,356,[127  64  89 183 100],480,3,1258,3.5238095238095237,0.0,40.0
30357,3,357,[210  12 204 435 161],378,5,1263,3.5279329608938546,20.0,0.0
30358,3,358,[235 173   9 748 678],648,2,1265,3.5236768802228413,0.0,0.0
30359,3,359,[127  64  89 183 100],452,5,1270,3.5277777777777777,0.0,40.0
30360,3,360,[127  64  89 183 100],892,5,1275,3.53185595567867,0.0,40.0
30361,3,361,[471 301 286 748 132],328,2,1277,3.527624309392265,0.0,0.0
30362,3,362,[127  64  89 183 100],59,5,1282,3.53168044077135,0.0,40.0
30363,3,363,[ 89 153 180 186  98],749,5,1287,3.5357142857142856,0.0,20.0
30364,3,364,[127  64  89 183 100],537,3,1290,3.5342465753424657,0.0,40.0
30365,3,365,[127  89  64 100 183],892,5,1295,3.5382513661202184,0.0,40.0
30366,3,366,[144 191 568 313  79],13,2,1297,3.534059945504087,0.0,0.0
30367,3,367,[127  89  64 100 183],339,5,1302,3.5380434782608696,0.0,40.0
30368,3,368,[127  89  64 100 183],87,5,1307,3.5420054200542004,0.0,40.0
30369,3,369,[216 403 603 427 483],59,5,1312,3.545945945945946,40.0,0.0
30370,3,370,[333  50 202 195 405],13,2,1314,3.5417789757412397,0.0,20.0
30371,3,371,[127  89  64 100 183],234,4,1318,3.543010752688172,0.0,40.0
30372,3,372,[127 100  64  89 183],488,4,1322,3.544235924932976,0.0,40.0
30373,3,373,[265 427 200 435 546],308,3,1325,3.5427807486631018,0.0,0.0
30374,3,374,[127  64  89 183 100],406,5,1330,3.546666666666667,0.0,40.0
30375,3,375,[204 216 423 328 197],334,3,1333,3.5452127659574466,0.0,0.0
30376,3,376,[127  64  89 183 100],455,4,1337,3.546419098143236,0.0,40.0
30377,3,377,[357 276 143 515 265],537,3,1340,3.544973544973545,20.0,0.0
30378,3,378,[748 268 216 597  98],13,3,1343,3.5435356200527703,0.0,20.0
30379,3,379,[127  64  89 183 100],7,5,1348,3.5473684210526315,0.0,40.0
30380,3,380,[127  64  89 183 100],804,4,1352,3.5485564304461943,0.0,40.0
30381,3,381,[127  64  89 100 183],346,4,1356,3.549738219895288,0.0,40.0
30382,3,382,[127  64  89 183 100],480,3,1359,3.548302872062663,0.0,40.0
30383,3,383,[127  89  64 183 100],387,4,1363,3.5494791666666665,0.0,40.0
30384,3,384,[127  89 183  64 100],184,5,1368,3.553246753246753,0.0,40.0
30385,3,385,[  1 222 211  22 273],387,5,1373,3.55699481865285,0.0,0.0
30386,3,386,[276  11 300 603 200],234,2,1375,3.55297157622739,20.0,0.0
30387,3,387,[496 143 197   1  12],194,4,1379,3.554123711340206,20.0,0.0
30388,3,388,[127  89 183  64 100],881,5,1384,3.557840616966581,0.0,40.0
30389,3,389,[127  89 183  64 100],455,4,1388,3.5589743589743588,0.0,40.0
30390,3,390,[357 197 191 204 322],533,4,1392,3.5601023017902813,20.0,0.0
30391,3,391,[ 12 121  96 385 288],374,5,1397,3.563775510204082,20.0,0.0
30392,3,392,[ 22 258 210 238 121],334,3,1400,3.5623409669211195,0.0,0.0
30393,3,393,[127  89 183  64 100],379,5,1405,3.565989847715736,0.0,40.0
30394,3,394,[  7  69 357  25 275],843,1,1406,3.559493670886076,20.0,0.0
30395,3,395,[127  89 183  64 100],184,5,1411,3.563131313131313,0.0,40.0
30396,3,396,[127  89 183  64 100],144,4,1415,3.5642317380352644,0.0,40.0
30397,3,397,[588 289 181 183 168],387,3,1418,3.562814070351759,0.0,0.0
30398,3,398,[127 183  64 100  89],488,4,1422,3.56390977443609,0.0,40.0
30399,3,399,[228 179   7 435 471],537,2,1424,3.56,0.0,0.0
30400,3,400,[127 183  64  89 100],64,4,1428,3.561097256857855,0.0,40.0
30401,3,401,[127 183  64  89 100],892,5,1433,3.5646766169154227,0.0,40.0
30402,3,402,[127  64 183  89 100],406,5,1438,3.568238213399504,0.0,40.0
30403,3,403,[127  64 183  89 100],328,5,1443,3.5717821782178216,0.0,40.0
30404,3,404,[186 603 588 135 176],308,5,1448,3.5753086419753086,20.0,0.0
30405,3,405,[186 153 183  50 118],87,5,1453,3.5788177339901477,0.0,20.0
30406,3,406,[127  64 183  89 100],840,5,1458,3.5823095823095823,0.0,40.0
30407,3,407,[127  64 183  89 100],313,5,1463,3.5857843137254903,0.0,40.0
30408,3,408,[ 98 117 245 655 318],334,3,1466,3.584352078239609,20.0,20.0
30409,3,409,[318 655 568 273 282],378,5,1471,3.5878048780487806,20.0,0.0
30410,3,410,[127  64 183  89 100],13,5,1476,3.591240875912409,0.0,40.0
30411,3,411,[515 204 127 678 118],455,4,1480,3.592233009708738,0.0,20.0
30412,3,412,[ 95 191 179 174 144],650,2,1482,3.5883777239709445,0.0,20.0
30413,3,413,[127  64 183 100  89],387,4,1486,3.5893719806763285,0.0,40.0
30414,3,414,[121 271 435 135   9],328,3,1489,3.5879518072289156,0.0,0.0
30415,3,415,[127 183  64 100  89],452,5,1494,3.5913461538461537,0.0,40.0
30416,3,416,[127 183  64 100  89],87,5,1499,3.594724220623501,0.0,40.0
30417,3,417,[275 265 288 181  97],455,4,1503,3.5956937799043063,0.0,0.0
30418,3,418,[ 12  95  50 196 288],59,4,1507,3.596658711217184,20.0,20.0
30419,3,419,[127 183  64 100  89],6,5,1512,3.6,0.0,40.0
30420,3,420,[265  96  25 238 100],295,4,1516,3.6009501187648456,0.0,20.0
30421,3,421,[179 508 273 294  95],537,2,1518,3.5971563981042656,0.0,0.0
30422,3,422,[127 183 100  64  89],311,4,1522,3.5981087470449173,0.0,40.0
30423,3,423,[127 183  64  89 100],774,2,1524,3.5943396226415096,0.0,40.0
30424,3,424,[127 183  64  89 100],653,4,1528,3.5952941176470588,0.0,40.0
30425,3,425,[215 100 423  22 111],474,5,1533,3.5985915492957745,0.0,20.0
30426,3,426,[483 288  96 179 313],13,3,1536,3.5971896955503513,20.0,0.0
30427,3,427,[202 322  25 143 195],749,5,1541,3.600467289719626,0.0,0.0
30428,3,428,[127 183  64  89 100],374,4,1545,3.6013986013986012,0.0,40.0
30429,3,429,[238 568 228  97  95],85,1,1546,3.5953488372093023,0.0,0.0
30430,3,430,[127 183  64  89 100],474,5,1551,3.5986078886310904,0.0,40.0
30431,3,431,[127 183  64  89 100],13,5,1556,3.6018518518518516,0.0,40.0
30432,3,432,[234 403  11 204   9],339,3,1559,3.600461893764434,0.0,0.0
30433,3,433,[127 183  64  89 100],804,4,1563,3.6013824884792625,0.0,40.0
30434,3,434,[127 183  64  89 100],311,4,1567,3.6022988505747127,0.0,40.0
30435,3,435,[127 183  64  89 100],883,5,1572,3.6055045871559632,0.0,40.0
30436,3,436,[127 183  64  89 100],313,5,1577,3.608695652173913,0.0,40.0
30437,3,437,[127 183  64  89 100],455,4,1581,3.6095890410958904,0.0,40.0
30438,3,438,[127 183  64  89 100],833,4,1585,3.6104783599088837,0.0,40.0
30439,3,439,[187 357 318  64 286],666,5,1590,3.6136363636363638,40.0,0.0
30440,3,440,[127 183  64  89 100],313,5,1595,3.616780045351474,0.0,40.0
30441,3,441,[127 183  64  89 100],537,3,1598,3.6153846153846154,0.0,40.0
30442,3,442,[127 183  89  64 100],653,4,1602,3.616252821670429,0.0,40.0
30443,3,443,[678 121 187 328 423],749,2,1604,3.6126126126126126,0.0,0.0
30444,3,444,[175 117 655  28 202],387,2,1606,3.608988764044944,0.0,0.0
30445,3,445,[ 22  70   9 216 151],474,4,1610,3.609865470852018,0.0,0.0
30446,3,446,[127 183  89  64 100],774,2,1612,3.606263982102908,0.0,40.0
30447,3,447,[196 186 174 603 121],666,1,1613,3.6004464285714284,20.0,20.0
30448,3,448,[546 118 187 125 300],749,2,1615,3.596881959910913,0.0,0.0
30449,3,449,[275  97 222 186 471],474,3,1618,3.5955555555555554,0.0,0.0
30450,3,450,[118 508 100 200 471],378,3,1621,3.5942350332594235,0.0,20.0
30451,3,451,[127 183  89 100  64],738,4,1625,3.5951327433628317,0.0,40.0
30452,3,452,[181  22 194 172 174],465,1,1626,3.589403973509934,0.0,20.0
30453,3,453,[483  82 125 222 121],648,4,1630,3.590308370044053,20.0,0.0
30454,3,454,[127 183  89  64 100],313,5,1635,3.5934065934065935,0.0,40.0
30455,3,455,[127 183  89  64 100],194,3,1638,3.5921052631578947,0.0,40.0
30456,3,456,[127 183  64  89 100],833,4,1642,3.5929978118161925,0.0,40.0
30457,3,457,[588  70 655  88 215],406,1,1643,3.587336244541485,0.0,0.0
30458,3,458,[  1 118 322 273 508],634,2,1645,3.5838779956427014,0.0,0.0
30459,3,459,[ 56 144 210 127 196],194,3,1648,3.582608695652174,0.0,20.0
30460,3,460,[ 89  22 385 333 179],881,5,1653,3.585683297180043,0.0,0.0
30461,3,461,[127 183  89 100  64],87,5,1658,3.588744588744589,0.0,40.0
30462,3,462,[127 183  89 100  64],749,4,1662,3.58963282937365,0.0,40.0
30463,3,463,[127 183  89  64 385],881,5,1667,3.5926724137931036,0.0,20.0
30464,3,464,[174 195  96 588 144],536,4,1671,3.5935483870967744,0.0,20.0
30465,3,465,[423  69 228 127  28],339,4,1675,3.5944206008583692,0.0,20.0
30466,3,466,[127 183  89 385  64],234,3,1678,3.5931477516059958,0.0,20.0
30467,3,467,[127 183  89  64 100],374,4,1682,3.594017094017094,0.0,40.0
30468,3,468,[245  28 318  69 121],378,3,1685,3.5927505330490406,20.0,0.0
30469,3,469,[127 183  64  89 100],883,5,1690,3.595744680851064,0.0,40.0
30470,3,470,[127 183  64  89 100],379,5,1695,3.5987261146496814,0.0,40.0
30471,3,471,[127 183  64  89 100],64,4,1699,3.5995762711864407,0.0,40.0
30472,3,472,[127 183  64  89 100],653,4,1703,3.6004228329809727,0.0,40.0
30473,3,473,[ 89  64 301 196 588],13,4,1707,3.6012658227848102,0.0,0.0
30474,3,474,[127 183  64 100  89],13,5,1712,3.6042105263157893,0.0,40.0
30475,3,475,[127 183  64 100  89],738,4,1716,3.6050420168067228,0.0,40.0
30476,3,476,[183  28 127  64   9],374,4,1720,3.6058700209643604,0.0,20.0
30477,3,477,[127 183  64  89 100],883,5,1725,3.6087866108786613,0.0,40.0
30478,3,478,[  4 125   7 196 187],64,3,1728,3.607515657620042,0.0,0.0
30479,3,479,[132 294 127 183 423],897,4,1732,3.6083333333333334,0.0,20.0
30480,3,480,[127 183  64  89 100],664,4,1736,3.6091476091476093,0.0,40.0
30481,3,481,[197  96 181  28 121],374,4,1740,3.6099585062240664,0.0,0.0
30482,3,482,[185 228  70 318 174],311,4,1744,3.610766045548654,20.0,20.0
30483,3,483,[ 64  11 257 405 597],213,4,1748,3.6115702479338845,0.0,0.0
30484,3,484,[127 183  64  89 100],537,3,1751,3.6103092783505155,0.0,40.0
30485,3,485,[127 183  64  89 100],374,4,1755,3.611111111111111,0.0,40.0
30486,3,486,[313 175  11 176  25],13,2,1757,3.6078028747433266,0.0,0.0
30487,3,487,[127 183  64  89 100],346,4,1761,3.6086065573770494,0.0,40.0
30488,3,488,[483 405 211 588  69],85,3,1764,3.607361963190184,20.0,0.0
30489,3,489,[127 183  64  89 318],87,5,1769,3.610204081632653,20.0,20.0
30490,3,490,[127 183  64  89 318],313,5,1774,3.6130346232179225,20.0,20.0
30491,3,491,[127 183  64 318  89],328,5,1779,3.6158536585365852,20.0,20.0
30492,3,492,[333 245   1 100  15],634,3,1782,3.614604462474645,0.0,20.0
30493,3,493,[118  82 748 322 194],454,3,1785,3.61336032388664,0.0,0.0
30494,3,494,[257 182 127 276 496],385,2,1787,3.61010101010101,0.0,20.0
30495,3,495,[127 183  64 318  89],537,3,1790,3.6088709677419355,20.0,20.0
30496,3,496,[508 265 180 238 423],92,4,1794,3.6096579476861166,0.0,0.0
30497,3,497,[127 183 318  64  89],664,4,1798,3.610441767068273,20.0,20.0
30498,3,498,[ 69 294 125 318 228],234,2,1800,3.6072144288577155,20.0,0.0
30499,3,499,[ 88 483 289 216 508],406,2,1802,3.604,20.0,0.0
30500,3,500,[127 318 183  64  89],87,5,1807,3.6067864271457086,20.0,20.0
30501,3,501,[127 318 183  64  89],537,3,1810,3.605577689243028,20.0,20.0
30502,3,502,[127 318 183  64  89],234,4,1814,3.606361829025845,20.0,20.0
30503,3,503,[127 318 183  64  89],311,5,1819,3.609126984126984,20.0,20.0
30504,3,504,[168 180 742 748  82],92,2,1821,3.605940594059406,0.0,0.0
30505,3,505,[127 318 183  64  89],452,5,1826,3.608695652173913,20.0,20.0
30506,3,506,[127 318 183  64  89],406,5,1831,3.611439842209073,20.0,20.0
30507,3,507,[117 275  28 568  25],648,3,1834,3.6102362204724407,0.0,0.0
30508,3,508,[127 318 183  64  89],311,5,1839,3.612966601178782,20.0,20.0
30509,3,509,[ 11 515 403 168   4],59,5,1844,3.615686274509804,0.0,0.0
30510,3,510,[515 301  89 273 546],102,1,1845,3.6105675146771037,0.0,0.0
30511,3,511,[357 173 121 168 269],13,2,1847,3.607421875,20.0,0.0
30512,3,512,[127 318 183  64  89],774,2,1849,3.604288499025341,20.0,20.0
30513,3,513,[127 318 183  64  89],64,4,1853,3.605058365758755,20.0,20.0
30514,3,514,[185 237 200 568 135],543,4,1857,3.6058252427184465,0.0,0.0
30515,3,515,[127 318 183  64 182],207,3,1860,3.604651162790698,20.0,20.0
30516,3,516,[  9  95 204 151 235],374,2,1862,3.6015473887814315,0.0,0.0
30517,3,517,[127 318 183  64  89],311,5,1867,3.6042471042471043,20.0,20.0
30518,3,518,[127 318 183  64  89],144,4,1871,3.605009633911368,20.0,20.0
30519,3,519,[127 318 183  64  89],328,5,1876,3.6076923076923078,20.0,20.0
30520,3,520,[127 318 183  64  89],308,5,1881,3.6103646833013436,20.0,20.0
30521,3,521,[194 228 328 144  11],328,2,1883,3.60727969348659,0.0,0.0
30522,3,522,[127 318 183  64  89],7,5,1888,3.609942638623327,20.0,20.0
30523,3,523,[127 318 183  64  89],804,4,1892,3.6106870229007635,20.0,20.0
30524,3,524,[357 187 403 195 176],59,5,1897,3.6133333333333333,20.0,0.0
30525,3,525,[168 323 215 265  15],474,3,1900,3.612167300380228,0.0,0.0
30526,3,526,[196 180 483 546   1],308,2,1902,3.609108159392789,20.0,0.0
30527,3,527,[187 135 655 182  50],387,4,1906,3.609848484848485,0.0,20.0
30528,3,528,[127 318 183  64  89],144,4,1910,3.610586011342155,20.0,20.0
30529,3,529,[275 435 235 228 427],343,5,1915,3.6132075471698113,0.0,0.0
30530,3,530,[ 28 265 423 183  22],7,5,1920,3.615819209039548,0.0,0.0
30531,3,531,[323 568 118 235 172],87,3,1923,3.6146616541353382,0.0,0.0
30532,3,532,[127 318 183  64 427],59,5,1928,3.617260787992495,20.0,20.0
30533,3,533,[222 328 318  15 302],537,2,1930,3.614232209737828,20.0,0.0
30534,3,534,[271 100  22 289 194],328,3,1933,3.6130841121495325,0.0,20.0
30535,3,535,[179 678  64 268 191],387,2,1935,3.610074626865672,0.0,0.0
30536,3,536,[655 275 132 135 215],85,3,1938,3.6089385474860336,0.0,0.0
30537,3,537,[  9  88 258  96 186],234,0,1938,3.6022304832713754,0.0,0.0
30538,3,538,[127 318 183  64 427],194,4,1942,3.602968460111317,20.0,20.0
30539,3,539,[ 82 318 328 179 161],334,3,1945,3.6018518518518516,20.0,0.0
30540,3,540,[125 603   8  28 216],7,5,1950,3.6044362292051755,20.0,0.0
30541,3,541,[328 117  96 185  89],13,2,1952,3.6014760147601477,0.0,0.0
30542,3,542,[245 174  69 132 289],334,1,1953,3.596685082872928,0.0,20.0
30543,3,543,[127 318 427 183  64],664,4,1957,3.5974264705882355,20.0,20.0
30544,3,544,[471   1  70 265 357],882,4,1961,3.598165137614679,20.0,0.0
30545,3,545,[127 318 427  64 183],234,5,1966,3.600732600732601,20.0,20.0
30546,3,546,[100   1 191 153 289],454,2,1968,3.5978062157221204,0.0,20.0
30547,3,547,[282  28 204  25 546],899,3,1971,3.596715328467153,0.0,0.0
30548,3,548,[127 318 427  64 183],87,5,1976,3.599271402550091,20.0,20.0
30549,3,549,[127 318 427  64 183],406,5,1981,3.601818181818182,20.0,20.0
30550,3,550,[127 318 427  64 183],374,3,1984,3.6007259528130673,20.0,20.0
30551,3,551,[127 318  64 183 427],59,5,1989,3.6032608695652173,20.0,20.0
30552,3,552,[127 318  64 183 427],474,5,1994,3.605786618444846,20.0,20.0
30553,3,553,[127 318  64 183 427],313,5,1999,3.608303249097473,20.0,20.0
30554,3,554,[ 15 173 238 175 187],406,2,2001,3.6054054054054054,0.0,0.0
30555,3,555,[301 172 187 168 204],666,3,2004,3.6043165467625897,0.0,0.0
30556,3,556,[143  97 180 471 216],90,5,2009,3.606822262118492,0.0,0.0
30557,3,557,[127 318  64 427 183],6,5,2014,3.609318996415771,20.0,20.0
30558,3,558,[ 22 174  88 186 403],87,4,2018,3.6100178890876564,0.0,20.0
30559,3,559,[117 183  95 357 204],738,4,2022,3.6107142857142858,20.0,0.0
30560,3,560,[ 98 179 210 515 328],271,4,2026,3.6114081996434937,0.0,20.0
30561,3,561,[127 318 427  64 183],194,4,2030,3.6120996441281137,20.0,20.0
30562,3,562,[127 318 427  64 183],452,5,2035,3.6145648312611014,20.0,20.0
30563,3,563,[234  22 603 185 294],650,2,2037,3.6117021276595747,20.0,0.0
30564,3,564,[182 496 328   8 237],313,3,2040,3.6106194690265485,0.0,0.0
30565,3,565,[288 515 286 180 196],7,4,2044,3.6113074204946995,0.0,0.0
30566,3,566,[127 318 427  64 183],91,5,2049,3.613756613756614,20.0,20.0
30567,3,567,[118 245 302 286  70],605,2,2051,3.6109154929577465,0.0,0.0
30568,3,568,[197 289 228 179 423],234,3,2054,3.609841827768014,0.0,0.0
30569,3,569,[172 265 180 313 357],271,5,2059,3.612280701754386,20.0,0.0
30570,3,570,[127 318 427  64 183],7,5,2064,3.6147110332749564,20.0,20.0
30571,3,571,[ 79 423 483 196 234],189,4,2068,3.6153846153846154,20.0,0.0
30572,3,572,[ 25 202  79  98 235],271,3,2071,3.614310645724258,0.0,20.0
30573,3,573,[204  89 265 197 211],234,1,2072,3.6097560975609757,0.0,0.0
30574,3,574,[127 318 427  64 183],452,5,2077,3.6121739130434785,20.0,20.0
30575,3,575,[ 98 655 202 222 144],102,2,2079,3.609375,0.0,20.0
30576,3,576,[117 183 238 742 257],145,5,2084,3.611785095320624,0.0,0.0
30577,3,577,[172 234 180 238  71],881,3,2087,3.610726643598616,0.0,0.0
30578,3,578,[181 405 258 289 173],474,4,2091,3.61139896373057,0.0,0.0
30579,3,579,[235 257 215 546 471],343,3,2094,3.610344827586207,0.0,0.0
30580,3,580,[748 288 143 210  50],200,4,2098,3.6110154905335627,0.0,20.0
30581,3,581,[ 96 215 200 180 228],311,5,2103,3.61340206185567,0.0,0.0
30582,3,582,[127 318 427  64 183],452,5,2108,3.615780445969125,20.0,20.0
30583,3,583,[127 318 427  64 183],234,5,2113,3.618150684931507,20.0,20.0
30584,3,584,[127 318 427  64 183],13,4,2117,3.618803418803419,20.0,20.0
30585,3,585,[275 125   7  28 127],406,2,2119,3.6160409556313993,0.0,20.0
30586,3,586,[ 69  97 235 215 185],537,1,2120,3.6115843270868826,0.0,0.0
30587,3,587,[127 427 318  64 183],234,5,2125,3.6139455782312924,20.0,20.0
30588,3,588,[127 427 318  64 183],452,5,2130,3.6162988115449917,20.0,20.0
30589,3,589,[  8 183 151 176  28],882,5,2135,3.6186440677966103,0.0,0.0
30590,3,590,[294 423 568  22 405],13,2,2137,3.6159052453468696,0.0,0.0
30591,3,591,[127 427 318  64 183],308,5,2142,3.6182432432432434,20.0,20.0
30592,3,592,[127 427 318  64 183],458,5,2147,3.6205733558178754,20.0,20.0
30593,3,593,[127 427 318  64 183],7,5,2152,3.622895622895623,20.0,20.0
30594,3,594,[118 276   7   1  15],141,3,2155,3.6218487394957983,0.0,0.0
30595,3,595,[127 427 318  64 183],527,3,2158,3.620805369127517,20.0,20.0
30596,3,596,[127 427 318  64 183],406,5,2163,3.6231155778894473,20.0,20.0
30597,3,597,[127 427 318  64 183],326,4,2167,3.6237458193979935,20.0,20.0
30598,3,598,[222 403 200 153   1],387,4,2171,3.624373956594324,0.0,0.0
30599,3,599,[127 427 318  64 183],664,4,2175,3.625,20.0,20.0
30600,3,600,[127 427 318  64 183],308,5,2180,3.627287853577371,20.0,20.0
30601,3,601,[127 427 318  64 183],406,5,2185,3.629568106312292,20.0,20.0
30602,3,602,[127 427 318  64 183],374,3,2188,3.628524046434494,20.0,20.0
30603,3,603,[127 427 318  64 183],474,5,2193,3.630794701986755,20.0,20.0
30604,3,604,[  1 186 173 172 257],378,4,2197,3.631404958677686,0.0,0.0
30605,3,605,[183  79 194 186 143],881,3,2200,3.6303630363036303,0.0,0.0
30606,3,606,[127 427 318  64 183],91,5,2205,3.632619439868204,20.0,20.0
30607,3,607,[127 427 318  64 183],527,3,2208,3.6315789473684212,20.0,20.0
30608,3,608,[127 427 318  64 183],7,5,2213,3.6338259441707716,20.0,20.0
30609,3,609,[  4 195   7 182 234],406,4,2217,3.634426229508197,0.0,0.0
30610,3,610,[118 403 135 183  50],848,3,2220,3.6333878887070377,0.0,20.0
30611,3,611,[127 427 318  64 183],406,5,2225,3.6356209150326797,20.0,20.0
30612,3,612,[234 197 121 180 294],804,5,2230,3.637846655791191,0.0,0.0
30613,3,613,[121 276 258 161 180],271,1,2231,3.6335504885993486,0.0,0.0
30614,3,614,[127 427 318  64 183],458,5,2236,3.635772357723577,20.0,20.0
30615,3,615,[ 97 118 597 204 117],13,3,2239,3.63474025974026,0.0,0.0
30616,3,616,[172  64 191 234 423],232,4,2243,3.635332252836305,0.0,0.0
30617,3,617,[173 265 179 228 117],537,2,2245,3.632686084142395,0.0,0.0
30618,3,618,[127 427 318  64 183],374,3,2248,3.631663974151858,20.0,20.0
30619,3,619,[127 427  64 318 183],537,3,2251,3.6306451612903228,20.0,20.0
30620,3,620,[127 427 318  64 183],234,5,2256,3.632850241545894,20.0,20.0
30621,3,621,[597 187  96 186 175],833,3,2259,3.6318327974276525,0.0,0.0
30622,3,622,[127 427 318  64 183],374,3,2262,3.6308186195826644,20.0,20.0
30623,3,623,[180 265 475  98 187],13,4,2266,3.6314102564102564,0.0,20.0
30624,3,624,[385 222 238 144  11],454,1,2267,3.6272,0.0,0.0
30625,3,625,[127 427  64  98 183],313,5,2272,3.6293929712460065,0.0,40.0
30626,3,626,[127 427  98  64 183],59,5,2277,3.6315789473684212,0.0,40.0
30627,3,627,[118 289  64 135 385],92,3,2280,3.6305732484076434,0.0,0.0
30628,3,628,[127 427  98  64 183],313,5,2285,3.6327503974562796,0.0,40.0
30629,3,629,[210  96 275 144 471],13,2,2287,3.63015873015873,0.0,0.0
30630,3,630,[127 427  98  64 183],666,5,2292,3.6323296354992074,0.0,40.0
30631,3,631,[ 71 423   7 172 289],234,2,2294,3.6297468354430378,0.0,0.0
30632,3,632,[222  50 182 275 568],537,3,2297,3.6287519747235386,0.0,20.0
30633,3,633,[127  98 427  64 183],308,4,2301,3.6293375394321767,0.0,40.0
30634,3,634,[151 181 195 273 200],385,0,2301,3.6236220472440945,0.0,0.0
30635,3,635,[127 427  64 183 318],406,5,2306,3.6257861635220126,20.0,20.0
30636,3,636,[222 135 228 200 568],488,3,2309,3.6248037676609104,0.0,0.0
30637,3,637,[318 423 187 238   7],524,4,2313,3.6253918495297808,20.0,0.0
30638,3,638,[168 183   1  28 228],13,4,2317,3.6259780907668233,0.0,0.0
30639,3,639,[127 427  64 183 318],308,5,2322,3.628125,20.0,20.0
30640,3,640,[127 427  64 183 318],59,5,2327,3.6302652106084246,20.0,20.0
30641,3,641,[ 88 216 508 111 423],207,3,2330,3.629283489096573,0.0,0.0
30642,3,642,[333 265 127   7 194],13,3,2333,3.6283048211508553,0.0,20.0
30643,3,643,[127 427  64 318 183],666,5,2338,3.630434782608696,20.0,20.0
30644,3,644,[174  79 289 258 357],13,2,2340,3.627906976744186,20.0,20.0
30645,3,645,[127 427  64 318 183],194,4,2344,3.628482972136223,20.0,20.0
30646,3,646,[ 12 135 568 182 175],194,1,2345,3.624420401854714,20.0,0.0
30647,3,647,[294 143 603  50 100],13,3,2348,3.623456790123457,20.0,40.0
30648,3,648,[173  82 191  28 496],766,4,2352,3.6240369799691834,0.0,0.0
30649,3,649,[127 427  64 318 183],537,3,2355,3.623076923076923,20.0,20.0
30650,3,650,[127 427  64 318 183],527,3,2358,3.622119815668203,20.0,20.0
30651,3,651,[423  97  15 403 181],533,3,2361,3.621165644171779,0.0,0.0
30652,3,652,[127 427  64 318 183],458,5,2366,3.6232771822358347,20.0,20.0
30653,3,653,[194   9 655 546 258],234,1,2367,3.6192660550458715,0.0,0.0
30654,3,654,[127 427  64 318 183],308,5,2372,3.621374045801527,20.0,20.0
30655,3,655,[ 98 180  82 235 496],308,2,2374,3.6189024390243905,0.0,20.0
30656,3,656,[ 64 471 237 282 234],474,4,2378,3.619482496194825,0.0,0.0
30657,3,657,[127 427  64 318 183],87,5,2383,3.621580547112462,20.0,20.0
30658,3,658,[127 427  64 318 183],234,5,2388,3.6236722306525038,20.0,20.0
30659,3,659,[294 196 172 385 268],92,4,2392,3.624242424242424,0.0,0.0
30660,3,660,[144 300 168 181 153],479,4,2396,3.6248108925869893,0.0,0.0
30661,3,661,[  7 228  11 135 323],59,5,2401,3.6268882175226587,0.0,0.0
30662,3,662,[127 427  64 318 183],6,5,2406,3.6289592760180995,20.0,20.0
30663,3,663,[127 427  64 318 183],91,5,2411,3.6310240963855422,20.0,20.0
30664,3,664,[191  12 143 271 265],334,2,2413,3.6285714285714286,20.0,0.0
30665,3,665,[471  64 196 144  56],454,2,2415,3.626126126126126,0.0,0.0
30666,3,666,[127 427  64 318 183],474,5,2420,3.628185907046477,20.0,20.0
30667,3,667,[127 427  64 318 183],374,3,2423,3.627245508982036,20.0,20.0
30668,3,668,[127 427  64 183 318],234,5,2428,3.6292974588938716,20.0,20.0
30669,3,669,[127 427  64 183 318],328,4,2432,3.629850746268657,20.0,20.0
30670,3,670,[403 546  22 176  89],653,2,2434,3.6274217585692994,0.0,0.0
30671,3,671,[127 427  64 183 318],313,5,2439,3.6294642857142856,20.0,20.0
30672,3,672,[180 161 153  88 238],92,3,2442,3.6285289747399703,0.0,0.0
30673,3,673,[127 427  64 183 318],527,3,2445,3.6275964391691393,20.0,20.0
30674,3,674,[127 427  64 183  50],474,5,2450,3.6296296296296298,0.0,40.0
30675,3,675,[ 89 385 144   7 257],378,5,2455,3.6316568047337277,0.0,0.0
30676,3,676,[ 28 132 568 187  22],313,3,2458,3.6307237813884785,0.0,0.0
30677,3,677,[ 11 258 427 302  22],537,3,2461,3.629793510324484,0.0,0.0
30678,3,678,[127 427  64 183  50],745,2,2463,3.6273932253313697,0.0,40.0
30679,3,679,[180 174 127 405 215],892,5,2468,3.6294117647058823,0.0,40.0
30680,3,680,[127 427  64 183 318],374,3,2471,3.6284875183553598,20.0,20.0
30681,3,681,[127 427  64 183 318],194,4,2475,3.629032258064516,20.0,20.0
30682,3,682,[127 427  64 183 318],452,5,2480,3.6310395314787702,20.0,20.0
30683,3,683,[127 427  64 183 318],308,5,2485,3.6330409356725144,20.0,20.0
30684,3,684,[742   4  22  70 275],533,4,2489,3.6335766423357665,0.0,0.0
30685,3,685,[175   4 269 483 121],537,2,2491,3.631195335276968,20.0,0.0
30686,3,686,[168 435 405 182   9],815,3,2494,3.6302765647743813,0.0,0.0
30687,3,687,[127 427  64 183 318],664,4,2498,3.630813953488372,20.0,20.0
30688,3,688,[ 12 168   7 211 144],339,4,2502,3.6313497822931784,20.0,0.0
30689,3,689,[179 423 211  28 216],271,5,2507,3.6333333333333333,0.0,0.0
30690,3,690,[127 427  64 183 318],308,5,2512,3.635311143270622,20.0,20.0
30691,3,691,[127 427  64 183 318],458,5,2517,3.63728323699422,20.0,20.0
30692,3,692,[127 427  64 183 318],234,5,2522,3.6392496392496394,20.0,20.0
30693,3,693,[127 427  64 183 318],59,5,2527,3.6412103746397695,20.0,20.0
30694,3,694,[121 172 210 222 168],666,1,2528,3.6374100719424463,0.0,0.0
30695,3,695,[127 427  64 183 318],6,5,2533,3.639367816091954,20.0,20.0
30696,3,696,[ 50  64  88 186 196],840,5,2538,3.6413199426111906,0.0,20.0
30697,3,697,[127 427  64 183 318],313,5,2543,3.6432664756446993,20.0,20.0
30698,3,698,[127 427  64 183 318],328,4,2547,3.643776824034335,20.0,20.0
30699,3,699,[174 215 258  64 328],749,5,2552,3.645714285714286,0.0,20.0
30700,3,700,[127 427  64 183 318],87,5,2557,3.6476462196861625,20.0,20.0
30701,3,701,[237 322 100 151 174],308,3,2560,3.646723646723647,0.0,40.0
30702,3,702,[313 187  15  71 173],830,4,2564,3.647226173541963,0.0,0.0
30703,3,703,[127 427  64 318 183],6,5,2569,3.649147727272727,20.0,20.0
30704,3,704,[286 216 173 508 322],13,0,2569,3.6439716312056736,0.0,0.0
30705,3,705,[357   7 603 288 427],339,4,2573,3.644475920679887,40.0,0.0
30706,3,706,[127 427  64 318 183],527,3,2576,3.6435643564356437,20.0,20.0
30707,3,707,[187 238  97  28 195],774,1,2577,3.639830508474576,0.0,0.0
30708,3,708,[ 89  11 568 597 588],59,3,2580,3.6389280677009874,0.0,0.0
30709,3,709,[127 427  64 183 318],474,5,2585,3.640845070422535,20.0,20.0
30710,3,710,[127 427  64 183 318],374,3,2588,3.639943741209564,20.0,20.0
30711,3,711,[127 427  64 183 318],374,3,2591,3.639044943820225,20.0,20.0
30712,3,712,[127  64 427 183 180],13,5,2596,3.640953716690042,0.0,20.0
30713,3,713,[127  64 427 183 180],13,5,2601,3.642857142857143,0.0,20.0
30714,3,714,[  4 179  56 435 172],666,4,2605,3.6433566433566433,0.0,0.0
30715,3,715,[127  64 427 183 180],59,5,2610,3.6452513966480447,0.0,20.0
30716,3,716,[427 187  70 202 313],308,4,2614,3.6457461645746165,0.0,0.0
30717,3,717,[127  64 427 183 180],458,5,2619,3.647632311977716,0.0,20.0
30718,3,718,[127  64 427 183 180],6,5,2624,3.6495132127955494,0.0,20.0
30719,3,719,[  7 603 257  28 202],815,3,2627,3.6486111111111112,20.0,0.0
30720,3,720,[132 288   9 191 471],474,3,2630,3.647711511789182,0.0,0.0
30721,3,721,[ 97  22   1  82 276],537,1,2631,3.64404432132964,0.0,0.0
30722,3,722,[403  25 435 286 125],234,0,2631,3.6390041493775933,0.0,0.0
30723,3,723,[568  96 471 546 174],13,2,2633,3.636740331491713,0.0,20.0
30724,3,724,[127  64 427 183 180],6,5,2638,3.6386206896551725,0.0,20.0
30725,3,725,[ 70 153 183 168  96],804,5,2643,3.6404958677685952,0.0,0.0
30726,3,726,[127  64 427 183 180],452,5,2648,3.6423658872077027,0.0,20.0
30727,3,727,[289  89  96 172 121],95,3,2651,3.6414835164835164,0.0,0.0
30728,3,728,[127  64 427 183 180],326,3,2654,3.6406035665294922,0.0,20.0
30729,3,729,[111 118 655 173 200],643,3,2657,3.6397260273972605,0.0,0.0
30730,3,730,[127  64 427 183 180],7,5,2662,3.6415868673050618,0.0,20.0
30731,3,731,[ 88 301 202 271 269],102,1,2663,3.637978142076503,0.0,0.0
30732,3,732,[127  64 427 183 180],7,5,2668,3.639836289222374,0.0,20.0
30733,3,733,[127  64 427 183 180],664,4,2672,3.6403269754768393,0.0,20.0
30734,3,734,[288 245 222 282  82],666,0,2672,3.635374149659864,0.0,0.0
30735,3,735,[127  64 427 183 180],326,3,2675,3.6345108695652173,0.0,20.0
30736,3,736,[127 427  64 183 100],398,4,2679,3.635006784260516,0.0,40.0
30737,3,737,[127 427  64 183 180],537,3,2682,3.6341463414634148,0.0,20.0
30738,3,738,[127 427  64 183 180],326,3,2685,3.6332882273342353,0.0,20.0
30739,3,739,[127 427  64 183 318],59,5,2690,3.635135135135135,20.0,20.0
30740,3,740,[127 427  64 183 318],59,5,2695,3.6369770580296894,20.0,20.0
30741,3,741,[180 597 288 191 121],308,3,2698,3.6361185983827493,0.0,0.0
30742,3,742,[127 427  64 183 318],87,5,2703,3.6379542395693134,20.0,20.0
30743,3,743,[471 186  69 176  28],271,3,2706,3.6370967741935485,0.0,0.0
30744,3,744,[127 427  64 183 318],7,5,2711,3.6389261744966444,20.0,20.0
30745,3,745,[435  28 135 238 276],210,4,2715,3.6394101876675604,0.0,0.0
30746,3,746,[127 427  64 183 318],7,5,2720,3.641231593038822,20.0,20.0
30747,3,747,[276 125 258 215 196],200,5,2725,3.643048128342246,0.0,0.0
30748,3,748,[496  89  95 228  15],537,2,2727,3.6408544726301737,0.0,0.0
30749,3,749,[235 121 655 172 186],102,1,2728,3.6373333333333333,0.0,0.0
30750,3,750,[200 151 194 143  98],234,3,2731,3.6364846870838883,0.0,20.0
30751,3,751,[216 322 197 318  70],524,5,2736,3.6382978723404253,20.0,0.0
30752,3,752,[  4 282  79 180 357],328,3,2739,3.637450199203187,20.0,0.0
30753,3,753,[127 427  64 183 318],91,5,2744,3.6392572944297084,20.0,20.0
30754,3,754,[143 435 742 427  82],454,3,2747,3.63841059602649,0.0,0.0
30755,3,755,[ 64  69 194 181 215],328,3,2750,3.6375661375661377,0.0,0.0
30756,3,756,[127 427  64 183 318],59,5,2755,3.6393659180977544,20.0,20.0
30757,3,757,[127 427  64 183 318],7,5,2760,3.6411609498680737,20.0,20.0
30758,3,758,[194 174  97 151 265],42,3,2763,3.6403162055335967,0.0,20.0
30759,3,759,[125  97  70 588 127],234,1,2764,3.636842105263158,0.0,20.0
30760,3,760,[127 427  64 183 318],7,5,2769,3.6386333771353483,20.0,20.0
30761,3,761,[127 427  64 183 318],406,5,2774,3.6404199475065617,20.0,20.0
30762,3,762,[  1 179 568   9 125],378,3,2777,3.6395806028833553,0.0,0.0
30763,3,763,[127 427  64 183 318],374,3,2780,3.6387434554973823,20.0,20.0
30764,3,764,[405 237 153 322 222],334,3,2783,3.637908496732026,0.0,0.0
30765,3,765,[ 64 471 597 546 268],7,3,2786,3.637075718015666,0.0,0.0
30766,3,766,[127 427  64 183 318],527,3,2789,3.636245110821382,20.0,20.0
30767,3,767,[168 125 191 568 194],313,3,2792,3.6354166666666665,0.0,0.0
30768,3,768,[127 427  64 183 318],234,5,2797,3.637191157347204,20.0,20.0
30769,3,769,[258 333  22 175 118],313,3,2800,3.6363636363636362,0.0,0.0
30770,3,770,[127 427  64 183 318],326,4,2804,3.636835278858625,20.0,20.0
30771,3,771,[127 427  64 183 318],664,4,2808,3.6373056994818653,20.0,20.0
30772,3,772,[127 427  64 183 318],328,4,2812,3.6377749029754205,20.0,20.0
30773,3,773,[127 427  64 183 318],664,4,2816,3.6382428940568476,20.0,20.0
30774,3,774,[210  79 168 118 144],102,0,2816,3.6335483870967744,0.0,0.0
30775,3,775,[202 228 496   1 328],664,4,2820,3.634020618556701,0.0,0.0
30776,3,776,[ 28 173 385 228 117],374,4,2824,3.6344916344916345,0.0,0.0
30777,3,777,[121  89 288 235 273],92,3,2827,3.633676092544987,0.0,0.0
30778,3,778,[180   8 597 194 483],7,4,2831,3.6341463414634148,20.0,0.0
30779,3,779,[127 427  64 183 318],406,5,2836,3.635897435897436,20.0,20.0
30780,3,780,[127 427  64 183 318],6,5,2841,3.63764404609475,20.0,20.0
30781,3,781,[191 276 181  50  71],398,5,2846,3.639386189258312,0.0,20.0
30782,3,782,[127 427  64 183 318],6,5,2851,3.6411238825031926,20.0,20.0
30783,3,783,[313 748  12  98   8],13,5,2856,3.642857142857143,20.0,20.0
30784,3,784,[245  69   1 215 289],378,3,2859,3.6420382165605094,0.0,0.0
30785,3,785,[ 25 328 135 161  64],95,2,2861,3.6399491094147582,0.0,0.0
30786,3,786,[111 603 234 273 194],13,4,2865,3.6404066073697585,20.0,0.0
30787,3,787,[ 15 153 132  89  22],749,5,2870,3.6421319796954315,0.0,0.0
30788,3,788,[655 597 211 423  98],643,3,2873,3.641318124207858,0.0,20.0
30789,3,789,[403 168 265 435 222],339,3,2876,3.640506329113924,0.0,0.0
30790,3,790,[127 427  64 183 318],308,5,2881,3.6422250316055624,20.0,20.0
30791,3,791,[127 427  64 183 318],313,5,2886,3.643939393939394,20.0,20.0
30792,3,792,[181  69 100 197 603],738,4,2890,3.6443883984867593,20.0,20.0
30793,3,793,[127 427  64 183 318],234,5,2895,3.646095717884131,20.0,20.0
30794,3,794,[127 427  64 183 318],458,5,2900,3.647798742138365,20.0,20.0
30795,3,795,[127 427  64 183 318],91,5,2905,3.649497487437186,20.0,20.0
30796,3,796,[127 427  64 183 318],666,5,2910,3.6511919698870767,20.0,20.0
30797,3,797,[318 405 257 273  11],213,4,2914,3.6516290726817044,20.0,0.0
30798,3,798,[ 98 125 258 588  22],7,5,2919,3.653316645807259,0.0,20.0
30799,3,799,[144 181 168  70 194],666,2,2921,3.65125,0.0,0.0
30800,3,800,[127 427  64 183 318],6,5,2926,3.6529338327091136,20.0,20.0
30801,3,801,[435 588 496  97 211],537,2,2928,3.650872817955112,0.0,0.0
30802,3,802,[127 427  64 183 318],313,5,2933,3.652552926525529,20.0,20.0
30803,3,803,[127 427  64 183 318],458,5,2938,3.654228855721393,20.0,20.0
30804,3,804,[ 97 265 294 546 216],7,4,2942,3.6546583850931675,0.0,0.0
30805,3,805,[194 435  97 181 276],892,5,2947,3.6563275434243176,0.0,0.0
30806,3,806,[183 742 471 265  97],543,2,2949,3.654275092936803,0.0,0.0
30807,3,807,[603 197 235 174 180],213,4,2953,3.6547029702970297,20.0,20.0
30808,3,808,[127 427  64 183 318],6,5,2958,3.6563658838071693,20.0,20.0
30809,3,809,[127 427  64 183 318],234,5,2963,3.6580246913580248,20.0,20.0
30810,3,810,[186  28 144  96  69],263,4,2967,3.658446362515413,0.0,0.0
30811,3,811,[127 427  64 183 318],452,5,2972,3.6600985221674875,20.0,20.0
30812,3,812,[228 508   1  50 181],447,3,2975,3.6592865928659286,0.0,20.0
30813,3,813,[161  15 216 176 313],308,1,2976,3.656019656019656,0.0,0.0
30814,3,814,[235  11 385 117 515],537,1,2977,3.652760736196319,0.0,0.0
30815,3,815,[127 427  64 183 318],406,5,2982,3.6544117647058822,20.0,20.0
30816,3,816,[127 427  64 183 318],666,5,2987,3.656058751529988,20.0,20.0
30817,3,817,[194 289  15 508  70],406,3,2990,3.6552567237163816,0.0,0.0
30818,3,818,[423 186   7   8 195],328,3,2993,3.6544566544566544,0.0,0.0
30819,3,819,[204 197  98 328 403],653,2,2995,3.652439024390244,0.0,20.0
30820,3,820,[127 427  64 183 318],374,3,2998,3.651644336175396,20.0,20.0
30821,3,821,[471 258 405  12 483],7,4,3002,3.6520681265206814,40.0,0.0
30822,3,822,[237 100 197 423  95],308,3,3005,3.651275820170109,0.0,20.0
30823,3,823,[182 588 100 143 235],313,3,3008,3.650485436893204,0.0,20.0
30824,3,824,[202  56 385 100  82],738,4,3012,3.650909090909091,0.0,20.0
30825,3,825,[127  64 427 183 318],474,5,3017,3.652542372881356,20.0,20.0
30826,3,826,[182 286 403 121 301],13,2,3019,3.6505441354292625,0.0,0.0
30827,3,827,[ 82 215  28 597  98],92,2,3021,3.648550724637681,0.0,20.0
30828,3,828,[ 88 423 181 135 655],308,5,3026,3.650180940892642,0.0,0.0
30829,3,829,[144 403 603 385  28],804,4,3030,3.6506024096385543,20.0,0.0
30830,3,830,[100 195 483  98 175],194,3,3033,3.6498194945848375,20.0,40.0
30831,3,831,[328 655 204 117 238],378,2,3035,3.6478365384615383,0.0,0.0
30832,3,832,[238   1 121 655 196],339,4,3039,3.6482593037214888,0.0,0.0
30833,3,833,[186   8 173  69 435],892,4,3043,3.6486810551558753,0.0,0.0
30834,3,834,[210 323  88 496 235],290,3,3046,3.6479041916167665,0.0,0.0
30835,3,835,[127  64 427 183 318],326,4,3050,3.648325358851675,20.0,20.0
30836,3,836,[ 50 117  70 300 423],840,2,3052,3.6463560334528076,0.0,20.0
30837,3,837,[182  64 328  69 117],144,3,3055,3.6455847255369926,0.0,0.0
30838,3,838,[127  64 427 183 318],91,5,3060,3.6471990464839092,20.0,20.0
30839,3,839,[127  64 427 183 318],328,4,3064,3.6476190476190475,20.0,20.0
30840,3,840,[127  64 427 183 318],194,4,3068,3.648038049940547,20.0,20.0
30841,3,841,[237  88 168 186  15],92,3,3071,3.647268408551069,0.0,0.0
30842,3,842,[211 313 143 258 215],59,3,3074,3.6465005931198102,0.0,0.0
30843,3,843,[174 742  50 405 269],145,4,3078,3.646919431279621,0.0,40.0
30844,3,844,[ 82 153 294  96 181],207,1,3079,3.6437869822485207,0.0,0.0
30845,3,845,[127  64 427 183 318],527,3,3082,3.6430260047281324,20.0,20.0
30846,3,846,[127  64 427 183 318],666,5,3087,3.644628099173554,20.0,20.0
30847,3,847,[265  69 181 423 174],326,3,3090,3.643867924528302,0.0,20.0
30848,3,848,[200   1  11 322 215],788,2,3092,3.6419316843345113,0.0,0.0
30849,3,849,[127  64 427 183 318],7,5,3097,3.643529411764706,20.0,20.0
30850,3,850,[127  64 427 183 318],458,5,3102,3.645123384253819,20.0,20.0
30851,3,851,[127  64 427 183 318],474,5,3107,3.646713615023474,20.0,20.0
30852,3,852,[ 25  96  88 173 216],892,5,3112,3.648300117233294,0.0,0.0
30853,3,853,[127  64 427 183 318],474,5,3117,3.649882903981265,20.0,20.0
30854,3,854,[258 215 195 186 216],64,4,3121,3.650292397660819,0.0,0.0
30855,3,855,[742 323   7 100  79],804,5,3126,3.6518691588785046,0.0,20.0
30856,3,856,[655 151   4 196   1],664,4,3130,3.6522753792298714,0.0,0.0
30857,3,857,[127  64 427 183 318],474,5,3135,3.6538461538461537,20.0,20.0
30858,3,858,[127  64 427 183 318],527,3,3138,3.653084982537835,20.0,20.0
30859,3,859,[127 427  64 183 318],194,4,3142,3.6534883720930234,20.0,20.0
30860,3,860,[435  50   7 228 282],406,3,3145,3.6527293844367015,0.0,20.0
30861,3,861,[153 546  95 182 269],102,1,3146,3.6496519721577725,0.0,0.0
30862,3,862,[168 597 496  69 238],308,2,3148,3.6477404403244496,0.0,0.0
30863,3,863,[127 427  64 183  50],374,3,3151,3.646990740740741,0.0,40.0
30864,3,864,[222 196 597 173  96],650,4,3155,3.647398843930636,0.0,0.0
30865,3,865,[191 403 175 289  50],524,4,3159,3.647806004618938,0.0,20.0
30866,3,866,[742  50 210  69  15],749,5,3164,3.6493656286043827,0.0,20.0
30867,3,867,[180  96 234 168 183],59,5,3169,3.6509216589861753,0.0,0.0
30868,3,868,[597 496  28 117 235],378,2,3171,3.6490218642117376,0.0,0.0
30869,3,869,[127  64 427 183 318],7,5,3176,3.650574712643678,20.0,20.0
30870,3,870,[403 180  25 151 194],533,2,3178,3.6486796785304247,0.0,0.0
30871,3,871,[127  64 427 183 318],664,4,3182,3.6490825688073394,20.0,20.0
30872,3,872,[194 258 265 118 318],13,4,3186,3.649484536082474,20.0,0.0
30873,3,873,[ 56 222   1 508 202],447,1,3187,3.6464530892448512,0.0,0.0
30874,3,874,[127  64 427 183 318],328,4,3191,3.646857142857143,20.0,20.0
30875,3,875,[127  64 427 183 318],13,4,3195,3.6472602739726026,20.0,20.0
30876,3,876,[176 222 191 423  28],474,5,3200,3.6488027366020526,0.0,0.0
30877,3,877,[127  64 427 183 191],398,5,3205,3.650341685649203,0.0,20.0
30878,3,878,[127  64 427 183 191],833,3,3208,3.6496018202502842,0.0,20.0
30879,3,879,[127  64 427 183 191],194,4,3212,3.65,0.0,20.0
30880,3,880,[ 56 132 234  89 197],643,4,3216,3.6503972758229284,0.0,0.0
30881,3,881,[127  64 427 191 183],313,5,3221,3.6519274376417235,0.0,20.0
30882,3,882,[234 211 742 125 151],653,0,3221,3.6477916194790487,0.0,0.0
30883,3,883,[127  64 427 191 183],527,4,3225,3.6481900452488687,0.0,20.0
30884,3,884,[127  64 191 427 183],313,5,3230,3.6497175141242937,0.0,20.0
30885,3,885,[238 176 181 508 151],474,3,3233,3.648984198645598,0.0,0.0
30886,3,886,[191   7 222   9 235],699,0,3233,3.6448703494926717,0.0,0.0
30887,3,887,[168 215 100  28 183],234,3,3236,3.644144144144144,0.0,20.0
30888,3,888,[117  98 153 195 185],13,2,3238,3.642294713160855,0.0,20.0
30889,3,889,[ 98 588 286 143 181],234,1,3239,3.6393258426966293,0.0,20.0
30890,3,890,[ 12 175 211 300 405],537,2,3241,3.6374859708193044,20.0,0.0
30891,3,891,[175  70 318 180  95],234,1,3242,3.6345291479820627,20.0,0.0
30892,3,892,[127  64 427 183 191],406,5,3247,3.6360582306830906,0.0,20.0
30893,3,893,[117 237  97  64 144],378,4,3251,3.6364653243847873,0.0,0.0
30894,3,894,[ 11 125 175  56 496],64,4,3255,3.636871508379888,0.0,0.0
30895,3,895,[127  64 427 183 191],664,3,3258,3.6361607142857144,0.0,20.0
30896,3,896,[127  64 427 183 318],326,4,3262,3.6365663322185062,20.0,20.0
30897,3,897,[238  70 202 176  50],271,4,3266,3.636971046770601,0.0,20.0
30898,3,898,[228   7 568 135 435],13,3,3269,3.636262513904338,0.0,0.0
30899,3,899,[127  64 427 183 318],87,5,3274,3.637777777777778,20.0,20.0
30900,3,900,[288  64 403 176  96],13,2,3276,3.6359600443951163,0.0,0.0
30901,3,901,[127  64 427 183 318],328,4,3280,3.6363636363636362,20.0,20.0
30902,3,902,[127  64 427 183 318],7,5,3285,3.637873754152824,20.0,20.0
30903,3,903,[ 97 195  64 117  82],653,4,3289,3.6382743362831858,0.0,0.0
30904,3,904,[423 228  56 742 127],804,2,3291,3.63646408839779,0.0,20.0
30905,3,905,[127  64 427 183 318],91,5,3296,3.6379690949227372,20.0,20.0
30906,3,906,[181 294 435 175 216],194,2,3298,3.6361631753031975,0.0,0.0
30907,3,907,[ 25 222  82 435 282],666,1,3299,3.633259911894273,0.0,0.0
30908,3,908,[127  64 427 183 318],308,5,3304,3.6347634763476346,20.0,20.0
30909,3,909,[127  64 427 183 318],91,5,3309,3.6362637362637362,20.0,20.0
30910,3,910,[127  64 427 183 318],7,5,3314,3.637760702524698,20.0,20.0
30911,3,911,[ 50 175 191 258 508],92,5,3319,3.6392543859649122,0.0,20.0
30912,3,912,[127  64 427 183 318],666,5,3324,3.6407447973713034,20.0,20.0
30913,3,913,[273   7 546 655 194],378,4,3328,3.641137855579869,0.0,0.0
30914,3,914,[127  64 427 183 318],666,5,3333,3.642622950819672,20.0,20.0
30915,3,915,[127  64 427 183 318],234,5,3338,3.6441048034934496,20.0,20.0
30916,3,916,[ 25 333 127 196 173],85,2,3340,3.642311886586696,0.0,20.0
30917,3,917,[127  64 427 183 318],87,5,3345,3.6437908496732025,20.0,20.0
30918,3,918,[127  64 427 183 318],328,4,3349,3.6441784548422196,20.0,20.0
30919,3,919,[127  64 427 183 318],406,5,3354,3.6456521739130436,20.0,20.0
30920,3,920,[357  96 195  82   4],643,4,3358,3.6460369163952224,20.0,0.0
30921,3,921,[127  64 427 183 318],234,5,3363,3.6475054229934925,20.0,20.0
30922,3,922,[ 69 234 173 403 168],738,3,3366,3.646803900325027,0.0,0.0
30923,3,923,[357 143  79 151   7],881,4,3370,3.6471861471861473,20.0,0.0
30924,3,924,[127  64 427 183 318],308,5,3375,3.6486486486486487,20.0,20.0
30925,3,925,[276 300 333 268 118],699,2,3377,3.646868250539957,0.0,0.0
30926,3,926,[357 483 153 265 742],666,3,3380,3.646170442286947,40.0,0.0
30927,3,927,[ 50  70 196 185 748],13,3,3383,3.6454741379310347,0.0,20.0
30928,3,928,[204 496 135 180 144],738,5,3388,3.6469321851453174,0.0,0.0
30929,3,929,[127  64 427 183 318],194,4,3392,3.6473118279569894,20.0,20.0
30930,3,930,[127  64 427 183 318],537,3,3395,3.6466165413533833,20.0,20.0
30931,3,931,[515 265 655 195 182],194,3,3398,3.6459227467811157,0.0,0.0
30932,3,932,[322 175 135 357 216],207,2,3400,3.6441586280814575,20.0,0.0
30933,3,933,[127  64 427 183 318],6,5,3405,3.645610278372591,20.0,20.0
30934,3,934,[ 70 228 300 117  79],788,4,3409,3.6459893048128342,0.0,0.0
30935,3,935,[180 265  56 318 182],488,3,3412,3.6452991452991452,20.0,0.0
30936,3,936,[  4  22 172 143 276],406,2,3414,3.6435432230522946,0.0,0.0
30937,3,937,[385 210  98 228 185],311,4,3418,3.6439232409381663,0.0,20.0
30938,3,938,[186  98 197 132  97],85,3,3421,3.643237486687966,0.0,20.0
30939,3,939,[294 132 238 179 186],653,2,3423,3.641489361702128,0.0,0.0
30940,3,940,[265 655 318 405 127],13,3,3426,3.640807651434644,20.0,20.0
30941,3,941,[127  64 427 183 318],59,5,3431,3.642250530785563,20.0,20.0
30942,3,942,[196 179 125 135 273],374,2,3433,3.64050901378579,0.0,0.0
30943,3,943,[143 191  22 216 175],13,2,3435,3.6387711864406778,0.0,0.0
30944,3,944,[143 301 568 175 200],378,3,3438,3.638095238095238,0.0,0.0
30945,3,945,[174 435 121 228  82],194,2,3440,3.6363636363636362,0.0,20.0
30946,3,946,[127  64 427 183 318],537,3,3443,3.6356916578669485,20.0,20.0
30947,3,947,[127  64 427 183 318],91,5,3448,3.6371308016877637,20.0,20.0
30948,3,948,[237 228  11 268 200],7,3,3451,3.636459430979979,0.0,0.0
30949,3,949,[127  64 427 183 318],313,5,3456,3.6378947368421053,20.0,20.0
30950,3,950,[385 191 186  15 182],653,3,3459,3.637223974763407,0.0,0.0
30951,3,951,[127  64 427 183 318],6,5,3464,3.638655462184874,20.0,20.0
30952,3,952,[ 56 100  50 173 181],346,3,3467,3.6379853095487933,0.0,40.0
30953,3,953,[318   1 238 185 302],271,3,3470,3.6373165618448637,20.0,0.0
30954,3,954,[197 135 144 182 202],64,3,3473,3.636649214659686,0.0,0.0
30955,3,955,[127  64 427 183 318],234,5,3478,3.6380753138075312,20.0,20.0
30956,3,956,[121 228 357 483 588],479,4,3482,3.638453500522466,40.0,0.0
30957,3,957,[238  15 211  70 135],311,4,3486,3.638830897703549,0.0,0.0
30958,3,958,[127  64 427 183 318],59,5,3491,3.6402502606882168,20.0,20.0
30959,3,959,[127  64 427 183 318],87,5,3496,3.6416666666666666,20.0,20.0
30960,3,960,[127  64 427 183 318],194,4,3500,3.6420395421436003,20.0,20.0
30961,3,961,[  4 235 276 435 313],144,3,3503,3.641372141372141,0.0,0.0
30962,3,962,[127  64 427 318 183],87,5,3508,3.6427829698857734,20.0,20.0
30963,3,963,[127  64 427 318 183],666,5,3513,3.6441908713692945,20.0,20.0
30964,3,964,[127  64 427 318 183],194,4,3517,3.644559585492228,20.0,20.0
30965,3,965,[ 11 176   4 117  79],308,4,3521,3.6449275362318843,0.0,0.0
30966,3,966,[  8 496 181 588 174],313,4,3525,3.6452947259565667,0.0,20.0
30967,3,967,[328 132 273 237   8],92,3,3528,3.644628099173554,0.0,0.0
30968,3,968,[127  64 427 318 183],374,3,3531,3.6439628482972135,20.0,20.0
30969,3,969,[258 183 100 678 111],13,4,3535,3.6443298969072164,0.0,20.0
30970,3,970,[194  50 204 121 245],328,3,3538,3.643666323377961,0.0,20.0
30971,3,971,[127  64 427 183 318],666,5,3543,3.6450617283950617,20.0,20.0
30972,3,972,[127  64 427 183 318],664,4,3547,3.645426515930113,20.0,20.0
30973,3,973,[127  64 427 318 183],313,5,3552,3.646817248459959,20.0,20.0
30974,3,974,[127  64 427 318 183],527,3,3555,3.646153846153846,20.0,20.0
30975,3,975,[117 313 269   4 405],13,2,3557,3.644467213114754,0.0,0.0
30976,3,976,[127  64 427 183 318],308,5,3562,3.6458546571136132,20.0,20.0
30977,3,977,[ 56  50 403 161  88],830,4,3566,3.6462167689161555,0.0,20.0
30978,3,978,[568 238 161 182 405],774,2,3568,3.644535240040858,0.0,0.0
30979,3,979,[127  64 427 183 318],308,5,3573,3.6459183673469386,20.0,20.0
30980,3,980,[127  64 427 183 318],313,5,3578,3.6472986748216107,20.0,20.0
30981,3,981,[135  28 216  95 405],804,3,3581,3.6466395112016294,0.0,0.0
30982,3,982,[127  64 427 183 318],664,4,3585,3.646998982706002,20.0,20.0
30983,3,983,[742 294 333 216 195],666,0,3585,3.643292682926829,0.0,0.0
30984,3,984,[127  64 427 318 183],537,3,3588,3.6426395939086293,20.0,20.0
30985,3,985,[127 427  64 318  50],452,5,3593,3.6440162271805274,20.0,40.0
30986,3,986,[127 427  64 318  50],666,4,3597,3.6443768996960486,20.0,40.0
30987,3,987,[ 96 181 215   4 234],406,3,3600,3.6437246963562755,0.0,0.0
30988,3,988,[655 153 357 423 173],899,4,3604,3.6440849342770476,20.0,0.0
30989,3,989,[127 427  64 318 183],6,5,3609,3.6454545454545455,20.0,20.0
30990,3,990,[588 273 546  64 182],378,4,3613,3.6458123107971745,0.0,0.0
30991,3,991,[117 185 258 211 245],749,5,3618,3.6471774193548385,0.0,0.0
30992,3,992,[135 182  25 173 197],194,2,3620,3.6455186304128904,0.0,0.0
30993,3,993,[475 216 588   1  56],537,2,3622,3.643863179074447,0.0,0.0
30994,3,994,[183   7 191 176 483],200,5,3627,3.6452261306532665,20.0,0.0
30995,3,995,[238 268 202 471 301],234,0,3627,3.641566265060241,0.0,0.0
30996,3,996,[294  95 403  69 195],901,3,3630,3.6409227683049146,0.0,0.0
30997,3,997,[302 496  64  96 195],524,2,3632,3.6392785571142285,0.0,0.0
30998,3,998,[179  71 135 180 588],766,3,3635,3.6386386386386387,0.0,0.0
30999,3,999,[ 79 237  71 405 211],406,1,3636,3.636,0.0,0.0
31000,3,1000,[475 471 678 183 204],537,1,3637,3.6333666333666335,0.0,0.0
31001,3,1001,[127 427  64 318 183],234,5,3642,3.6347305389221556,20.0,20.0
31002,3,1002,[127 427  64 318 183],537,3,3645,3.634097706879362,20.0,20.0
31003,3,1003,[127 427  64 318 183],458,5,3650,3.635458167330677,20.0,20.0
31004,3,1004,[153 323 328 215 603],804,5,3655,3.63681592039801,20.0,0.0
31005,3,1005,[182 168 546 179   9],339,5,3660,3.6381709741550696,0.0,0.0
31006,3,1006,[127 427  64 318 183],59,5,3665,3.6395233366434954,20.0,20.0
31007,3,1007,[435 282 655 483 195],194,3,3668,3.638888888888889,20.0,0.0
31008,3,1008,[603 176 228 204 144],13,4,3672,3.639246778989098,20.0,0.0
31009,3,1009,[118  56 200 322 117],13,2,3674,3.6376237623762377,0.0,0.0
31010,3,1010,[294 302 603 508 655],474,3,3677,3.6369930761622156,20.0,0.0
31011,3,1011,[127 427  64 318 183],6,5,3682,3.6383399209486167,20.0,20.0
31012,3,1012,[172  64 173 127 289],883,5,3687,3.639684106614018,0.0,20.0
31013,3,1013,[127 427  64 318 183],328,4,3691,3.6400394477317555,20.0,20.0
31014,3,1014,[300 258  12 194 276],537,2,3693,3.6384236453201972,20.0,0.0
31015,3,1015,[127 427  64 318 183],59,5,3698,3.6397637795275593,20.0,20.0
31016,3,1016,[603 191 215 423 197],234,4,3702,3.640117994100295,20.0,0.0
31017,3,1017,[202  69 385 216 100],738,3,3705,3.6394891944990175,0.0,20.0
31018,3,1018,[127 427  64 318 183],328,4,3709,3.6398429833169774,20.0,20.0
31019,3,1019,[200 185 318  79 180],488,3,3712,3.6392156862745098,20.0,0.0
31020,3,1020,[515 313 546 151 173],200,3,3715,3.6385896180215473,0.0,0.0
31021,3,1021,[127  64 427 318 183],234,5,3720,3.639921722113503,20.0,20.0
31022,3,1022,[ 98   4 202 143 215],643,2,3722,3.638318670576735,0.0,20.0
31023,3,1023,[127  64 427 318 183],91,5,3727,3.6396484375,20.0,20.0
31024,3,1024,[185 237 200 302  89],13,3,3730,3.6390243902439026,0.0,0.0
31025,3,1025,[127  64 427 318 183],666,5,3735,3.6403508771929824,20.0,20.0
31026,3,1026,[176 187   7 195  12],64,5,3740,3.641674780915287,20.0,0.0
31027,3,1027,[127  64 427 318 183],308,5,3745,3.6429961089494163,20.0,20.0
31028,3,1028,[ 79 175  70   4 603],664,4,3749,3.6433430515063168,20.0,0.0
31029,3,1029,[127  64 427 318 183],87,5,3754,3.644660194174757,20.0,20.0
31030,3,1030,[151 200 323 194 403],788,2,3756,3.6430649854510184,0.0,0.0
31031,3,1031,[127  64 427 318 183],666,5,3761,3.6443798449612403,20.0,20.0
31032,3,1032,[127  64 427 318 183],664,4,3765,3.6447241045498546,20.0,20.0
31033,3,1033,[127  64 427 318 183],59,5,3770,3.646034816247582,20.0,20.0
31034,3,1034,[215 301 515 183 161],328,3,3773,3.6454106280193237,0.0,0.0
31035,3,1035,[276 496 597 245 269],452,3,3776,3.6447876447876446,0.0,0.0
31036,3,1036,[117 286 200 195 216],650,4,3780,3.645130183220829,0.0,0.0
31037,3,1037,[127  64 427 318 183],326,4,3784,3.6454720616570326,20.0,20.0
31038,3,1038,[211 175 403 127 100],379,5,3789,3.6467757459095282,0.0,40.0
31039,3,1039,[127  64 427 318 183],328,4,3793,3.6471153846153848,20.0,20.0
31040,3,1040,[127  64 427 318 183],6,5,3798,3.648414985590778,20.0,20.0
31041,3,1041,[318  22 322 179 238],13,1,3799,3.645873320537428,20.0,0.0
31042,3,1042,[216 546 234  22  28],881,4,3803,3.6462128475551294,0.0,0.0
31043,3,1043,[471 357 194  64 234],454,1,3804,3.6436781609195403,20.0,0.0
31044,3,1044,[172 100 318 135  98],313,5,3809,3.644976076555024,20.0,40.0
31045,3,1045,[313 180 655 191  70],474,5,3814,3.6462715105162524,0.0,0.0
31046,3,1046,[ 95 121  96 185 323],804,4,3818,3.646609360076409,0.0,0.0
31047,3,1047,[222  64  25  50 210],194,1,3819,3.644083969465649,0.0,20.0
31048,3,1048,[ 25  98 282  89 655],804,5,3824,3.6453765490943755,0.0,20.0
31049,3,1049,[265 132 313 282  71],533,4,3828,3.645714285714286,0.0,0.0
31050,3,1050,[127  64 427 318 183],537,3,3831,3.6450999048525214,20.0,20.0
31051,3,1051,[172 475 435 322 678],13,2,3833,3.643536121673004,0.0,0.0
31052,3,1052,[282 603 211 144 187],643,4,3837,3.6438746438746437,20.0,0.0
31053,3,1053,[127  64 427 318 183],452,5,3842,3.6451612903225805,20.0,20.0
31054,3,1054,[127  64 427 318 183],234,5,3847,3.6464454976303315,20.0,20.0
31055,3,1055,[173  69 302 273  28],207,4,3851,3.646780303030303,0.0,0.0
31056,3,1056,[234 202 181 179 286],527,2,3853,3.6452223273415325,0.0,0.0
31057,3,1057,[127  64 427 318 183],326,4,3857,3.645557655954631,20.0,20.0
31058,3,1058,[289 179 288 271  12],833,3,3860,3.6449480642115204,20.0,0.0
31059,3,1059,[100 222 423 288 216],234,2,3862,3.6433962264150943,0.0,20.0
31060,3,1060,[ 70 515  64 357 204],406,3,3865,3.642789820923657,20.0,0.0
31061,3,1061,[196 132  71 300 186],506,4,3869,3.6431261770244823,0.0,0.0
31062,3,1062,[515 210 196 597 197],650,3,3872,3.642521166509878,0.0,0.0
31063,3,1063,[195 318 222  71   7],374,2,3874,3.6409774436090228,20.0,0.0
31064,3,1064,[127  64 427 318 183],326,4,3878,3.64131455399061,20.0,20.0
31065,3,1065,[127  64 427 318 183],374,3,3881,3.6407129455909946,20.0,20.0
31066,3,1066,[211 200 385  96 180],788,3,3884,3.6401124648547327,0.0,0.0
31067,3,1067,[127  64 427 318 183],308,5,3889,3.641385767790262,20.0,20.0
31068,3,1068,[173  64 265 191 175],207,2,3891,3.6398503274087934,0.0,0.0
31069,3,1069,[127  64 427 318 183],194,4,3895,3.6401869158878504,20.0,20.0
31070,3,1070,[185  56  50 238  79],881,2,3897,3.638655462184874,0.0,20.0
31071,3,1071,[ 64 172 286 118 100],881,4,3901,3.638992537313433,0.0,20.0
31072,3,1072,[235 100 185 143   7],804,4,3905,3.6393289841565704,0.0,20.0
31073,3,1073,[179 168  82 204  69],650,2,3907,3.6378026070763503,0.0,0.0
31074,3,1074,[127  64 427 318 183],313,5,3912,3.6390697674418604,20.0,20.0
31075,3,1075,[265 197 179 186 180],234,1,3913,3.636617100371747,0.0,0.0
31076,3,1076,[282 182 300  56  97],378,5,3918,3.637883008356546,0.0,0.0
31077,3,1077,[215 471 200   9 135],234,2,3920,3.6363636363636362,0.0,0.0
31078,3,1078,[ 25  15 211 258   7],474,5,3925,3.6376274328081557,0.0,0.0
31079,3,1079,[655   4 191 475 161],308,4,3929,3.637962962962963,0.0,0.0
31080,3,1080,[161 200 273   7  88],13,2,3931,3.6364477335800185,0.0,0.0
31081,3,1081,[197 234   1 435 183],843,2,3933,3.634935304990758,0.0,0.0
31082,3,1082,[423   7 176 405  69],882,5,3938,3.6361957525392428,0.0,0.0
31083,3,1083,[127  64 427 318 183],313,5,3943,3.6374538745387452,20.0,20.0
31084,3,1084,[471   8 228 175 435],234,1,3944,3.6350230414746543,0.0,0.0
31085,3,1085,[127  64 427 318 183],234,5,3949,3.636279926335175,20.0,20.0
31086,3,1086,[237 286  56 180   4],533,1,3950,3.6338546458141674,0.0,0.0
31087,3,1087,[202 403 603   9 423],308,5,3955,3.635110294117647,20.0,0.0
31088,3,1088,[127  64 427 318 183],313,5,3960,3.6363636363636362,20.0,20.0
31089,3,1089,[ 97 181  28 245 333],328,3,3963,3.6357798165137614,0.0,0.0
31090,3,1090,[127  64 427 318 183],537,3,3966,3.6351970669110907,20.0,20.0
31091,3,1091,[127  64 427 318 183],452,5,3971,3.6364468864468864,20.0,20.0
31092,3,1092,[153  25 111 186 132],234,1,3972,3.6340347666971637,0.0,0.0
31093,3,1093,[ 11  69 121 174 508],537,1,3973,3.6316270566727606,0.0,20.0
31094,3,1094,[127  64 427 318 183],406,5,3978,3.632876712328767,20.0,20.0
31095,3,1095,[ 98 471 153 151  28],815,4,3982,3.633211678832117,0.0,20.0
31096,3,1096,[127  64 427 318 183],328,4,3986,3.633546034639927,20.0,20.0
31097,3,1097,[127  64 427 318 183],6,5,3991,3.634790528233151,20.0,20.0
31098,3,1098,[127  64 427 318 183],6,5,3996,3.6360327570518653,20.0,20.0
31099,3,1099,[301   7 153 176  96],788,2,3998,3.6345454545454547,0.0,0.0
31100,3,1100,[127  64 427 318 183],326,4,4002,3.6348773841961854,20.0,20.0
31101,3,1101,[405 333 174 183 132],334,3,4005,3.634301270417423,0.0,20.0
31102,3,1102,[127  64 427 318 183],234,5,4010,3.6355394378966457,20.0,20.0
31103,3,1103,[475 127  70  56  50],533,3,4013,3.634963768115942,0.0,40.0
31104,3,1104,[127  64 427 318 183],527,3,4016,3.634389140271493,20.0,20.0
31105,3,1105,[282 144 435 182   8],458,4,4020,3.634719710669078,0.0,0.0
31106,3,1106,[127  64 427 318 183],7,5,4025,3.635953026196929,20.0,20.0
31107,3,1107,[127  64 427 318 183],527,3,4028,3.6353790613718413,20.0,20.0
31108,3,1108,[127 427  64 318 183],308,5,4033,3.636609558160505,20.0,20.0
31109,3,1109,[ 95  50 168 257 135],479,5,4038,3.637837837837838,0.0,20.0
31110,3,1110,[ 97 176 117 235 204],406,5,4043,3.639063906390639,0.0,0.0
31111,3,1111,[127 427  64 318 183],664,4,4047,3.639388489208633,20.0,20.0
31112,3,1112,[127 427  64 318 183],91,5,4052,3.6406109613656783,20.0,20.0
31113,3,1113,[127 427  64 318 183],326,4,4056,3.6409335727109515,20.0,20.0
31114,3,1114,[117  12  70 161 423],455,2,4058,3.639461883408072,20.0,0.0
31115,3,1115,[127 427  64 318 183],666,5,4063,3.640681003584229,20.0,20.0
31116,3,1116,[294 216 196 423 235],537,0,4063,3.6374216651745748,0.0,0.0
31117,3,1117,[173 515 258  97 100],339,4,4067,3.637745974955277,0.0,20.0
31118,3,1118,[127 427  64 318 183],664,4,4071,3.6380697050938338,20.0,20.0
31119,3,1119,[127 427  64 318 183],234,5,4076,3.6392857142857142,20.0,20.0
31120,3,1120,[127 427  64 318 183],666,5,4081,3.64049955396967,20.0,20.0
31121,3,1121,[405 216   8 258 276],378,4,4085,3.640819964349376,0.0,0.0
31122,3,1122,[127 427  64 318 183],308,5,4090,3.6420302760463046,20.0,20.0
31123,3,1123,[127 427  64 318 183],13,4,4094,3.6423487544483986,20.0,20.0
31124,3,1124,[127 427  64 318 183],474,5,4099,3.6435555555555554,20.0,20.0
31125,3,1125,[ 97 182 323 235 403],804,4,4103,3.6438721136767316,0.0,0.0
31126,3,1126,[127 427  64 318 183],7,5,4108,3.645075421472937,20.0,20.0
31127,3,1127,[127 427  64 318 183],406,5,4113,3.646276595744681,20.0,20.0
31128,3,1128,[127 427  64 318 183],326,4,4117,3.646589902568645,20.0,20.0
31129,3,1129,[ 89 483  15  98   7],474,5,4122,3.647787610619469,20.0,20.0
31130,3,1130,[127 427  64 318 183],374,3,4125,3.647214854111406,20.0,20.0
31131,3,1131,[127  64 427 318 183],6,5,4130,3.648409893992933,20.0,20.0
31132,3,1132,[ 11 183 588 202 427],59,4,4134,3.648720211827008,0.0,0.0
31133,3,1133,[117  89 318  79  88],311,5,4139,3.6499118165784834,20.0,0.0
31134,3,1134,[127  64 427 318 183],406,5,4144,3.651101321585903,20.0,20.0
31135,3,1135,[127  64 427 318 183],406,5,4149,3.652288732394366,20.0,20.0
31136,3,1136,[ 15  96 168 742 496],488,4,4153,3.65259454705365,0.0,0.0
31137,3,1137,[222  97 515 423 258],843,1,4154,3.650263620386643,0.0,0.0
31138,3,1138,[204 132 294 655 215],537,0,4154,3.6470588235294117,0.0,0.0
31139,3,1139,[127  64 427 318 183],91,5,4159,3.648245614035088,20.0,20.0
31140,3,1140,[117 210 245   7 238],92,5,4164,3.64943032427695,0.0,0.0
31141,3,1141,[435 603 191 202  95],848,4,4168,3.649737302977233,20.0,0.0
31142,3,1142,[127  64 427 318 183],59,5,4173,3.6509186351706036,20.0,20.0
31143,3,1143,[234 196 546 111 403],42,2,4175,3.6494755244755246,0.0,0.0
31144,3,1144,[187 143  82 357   7],537,3,4178,3.6489082969432314,20.0,0.0
31145,3,1145,[127  64 427 318 183],452,5,4183,3.650087260034904,20.0,20.0
31146,3,1146,[127  64 427 318 183],194,4,4187,3.6503923278116828,20.0,20.0
31147,3,1147,[127  64 427 318 183],474,5,4192,3.6515679442508713,20.0,20.0
31148,3,1148,[144 385  11 174  95],374,5,4197,3.6527415143603132,0.0,20.0
31149,3,1149,[127  64 427 318 183],326,4,4201,3.6530434782608694,20.0,20.0
31150,3,1150,[515 135 238 588 748],313,4,4205,3.6533449174630754,0.0,0.0
31151,3,1151,[275 200 117 385 173],311,5,4210,3.654513888888889,0.0,0.0
31152,3,1152,[127  64 427 318 183],6,5,4215,3.655680832610581,20.0,20.0
31153,3,1153,[144 435 183  82 228],694,5,4220,3.65684575389948,0.0,0.0
31154,3,1154,[127  64 427 318 183],406,5,4225,3.658008658008658,20.0,20.0
31155,3,1155,[132 204  56 182 210],194,2,4227,3.656574394463668,0.0,0.0
31156,3,1156,[  8 211 588 172 151],897,4,4231,3.6568712186689716,0.0,0.0
31157,3,1157,[127 427  64 318 183],87,5,4236,3.6580310880829017,20.0,20.0
31158,3,1158,[  8 210 125  96 313],234,2,4238,3.6566005176876617,0.0,0.0
31159,3,1159,[127 427  64 318 183],474,5,4243,3.657758620689655,20.0,20.0
31160,3,1160,[127 427  64 318 183],666,5,4248,3.6589147286821704,20.0,20.0
31161,3,1161,[127 427  64 318 183],308,5,4253,3.6600688468158347,20.0,20.0
31162,3,1162,[286 187   8 245 196],488,0,4253,3.656921754084265,0.0,0.0
31163,3,1163,[144 185 211  22  69],328,5,4258,3.6580756013745703,0.0,0.0
31164,3,1164,[127 427  64 318 183],328,4,4262,3.658369098712446,20.0,20.0
31165,3,1165,[273 471 568 322 195],308,2,4264,3.6569468267581473,0.0,0.0
31166,3,1166,[127  64 427 318 183],59,5,4269,3.658097686375321,20.0,20.0
31167,3,1167,[127  64 427 318 183],406,5,4274,3.6592465753424657,20.0,20.0
31168,3,1168,[127  64 427 318 183],326,4,4278,3.6595380667236954,20.0,20.0
31169,3,1169,[568 194 265 235 276],308,3,4281,3.658974358974359,0.0,0.0
31170,3,1170,[174 423 185 742 175],653,1,4282,3.6567036720751496,0.0,20.0
31171,3,1171,[127  64 427 318 183],234,5,4287,3.657849829351536,20.0,20.0
31172,3,1172,[127  64 427 318 183],87,5,4292,3.658994032395567,20.0,20.0
31173,3,1173,[ 28 333 202  98  50],666,2,4294,3.6575809199318567,0.0,40.0
31174,3,1174,[258 655 204 117   7],788,3,4297,3.657021276595745,0.0,0.0
31175,3,1175,[200 186   7 238 405],774,1,4298,3.6547619047619047,0.0,0.0
31176,3,1176,[302 183  12 258  69],378,4,4302,3.655055225148683,20.0,0.0
31177,3,1177,[127  64 427 318 183],87,5,4307,3.6561969439728355,20.0,20.0
31178,3,1178,[288 176  71 135 318],59,4,4311,3.6564885496183206,20.0,0.0
31179,3,1179,[127  64 427 318 183],59,5,4316,3.6576271186440676,20.0,20.0
31180,3,1180,[127  64 427 318 183],6,5,4321,3.6587637595258258,20.0,20.0
31181,3,1181,[196 153 471 318  71],194,2,4323,3.6573604060913705,20.0,0.0
31182,3,1182,[127  64 427 318 183],7,5,4328,3.658495350803043,20.0,20.0
31183,3,1183,[127  64 427 318 183],328,4,4332,3.6587837837837838,20.0,20.0
31184,3,1184,[175 588 286  15  88],184,2,4334,3.657383966244726,0.0,0.0
31185,3,1185,[111  28 265 496 546],653,2,4336,3.6559865092748733,0.0,0.0
31186,3,1186,[127  64 427 318 183],326,4,4340,3.6562763268744733,20.0,20.0
31187,3,1187,[ 98 294 168  88 258],650,2,4342,3.654882154882155,0.0,20.0
31188,3,1188,[235 237 144  56 200],308,2,4344,3.653490328006728,0.0,0.0
31189,3,1189,[496 294 194  79  11],308,3,4347,3.652941176470588,0.0,0.0
31190,3,1190,[127  64 427 318 183],328,4,4351,3.653232577665827,20.0,20.0
31191,3,1191,[181 471 475 216 182],13,2,4353,3.6518456375838926,0.0,0.0
31192,3,1192,[238 175 180 179 403],749,3,4356,3.6512992455993296,0.0,0.0
31193,3,1193,[127  64 427 318 183],59,5,4361,3.652428810720268,20.0,20.0
31194,3,1194,[ 15 427 294   8 172],234,2,4363,3.6510460251046024,0.0,0.0
31195,3,1195,[127  64 427 318 183],406,5,4368,3.652173913043478,20.0,20.0
31196,3,1196,[ 89 180 111  15 185],452,4,4372,3.6524644945697577,0.0,0.0
31197,3,1197,[127  64 427 318 183],308,5,4377,3.6535893155258763,20.0,20.0
31198,3,1198,[175 132 603 678 186],474,4,4381,3.653878231859883,20.0,0.0
31199,3,1199,[127  64 427 318 183],664,4,4385,3.654166666666667,20.0,20.0
31200,3,1200,[176 183 423  70 211],666,4,4389,3.6544546211490423,0.0,0.0
31201,3,1201,[204 483 172 186  88],13,5,4394,3.655574043261231,20.0,0.0
31202,3,1202,[127  64 427 318 183],7,5,4399,3.656691604322527,20.0,20.0
31203,3,1203,[ 82  97  12 176 403],378,5,4404,3.6578073089700998,20.0,0.0
31204,3,1204,[403  96  69  71 135],804,3,4407,3.6572614107883816,0.0,0.0
31205,3,1205,[237 742 176 385 471],378,4,4411,3.657545605306799,0.0,0.0
31206,3,1206,[127  64 427 318 183],527,3,4414,3.657000828500414,20.0,20.0
31207,3,1207,[118 427 151  96  15],533,4,4418,3.6572847682119205,0.0,0.0
31208,3,1208,[127  64 427 318 183],87,5,4423,3.6583953680727874,20.0,20.0
31209,3,1209,[ 11   7 269 197 496],343,5,4428,3.659504132231405,0.0,0.0
31210,3,1210,[258 276 180   4 181],339,4,4432,3.6597853014037987,0.0,0.0
31211,3,1211,[127  64 427 318 183],308,5,4437,3.660891089108911,20.0,20.0
31212,3,1212,[ 71 153  11 318 234],454,1,4438,3.6586974443528444,20.0,0.0
31213,3,1213,[125 748  69 385 191],653,4,4442,3.658978583196046,0.0,0.0
31214,3,1214,[127  64 427 318 183],452,5,4447,3.6600823045267488,20.0,20.0
31215,3,1215,[127  64 427 318 183],537,3,4450,3.6595394736842106,20.0,20.0
31216,3,1216,[127  64 427 318 183],406,5,4455,3.6606409202958092,20.0,20.0
31217,3,1217,[127  64 427 318 183],406,5,4460,3.6617405582922826,20.0,20.0
31218,3,1218,[210  22 237  25 185],184,4,4464,3.6620180475799837,0.0,0.0
31219,3,1219,[265 275 286 127 211],883,3,4467,3.661475409836066,0.0,20.0
31220,3,1220,[127  64 427 318 183],328,4,4471,3.661752661752662,20.0,20.0
31221,3,1221,[ 50 216 215   9 161],474,5,4476,3.662847790507365,0.0,20.0
31222,3,1222,[357 496 176 323 132],474,4,4480,3.6631234668847097,20.0,0.0
31223,3,1223,[127  64 427 318 183],13,4,4484,3.6633986928104574,20.0,20.0
31224,3,1224,[ 96 132 238 176 222],488,2,4486,3.6620408163265306,0.0,0.0
31225,3,1225,[127  64 427 318 183],87,5,4491,3.663132137030995,20.0,20.0
31226,3,1226,[268  22 313 216 172],13,4,4495,3.6634066829665852,0.0,0.0
31227,3,1227,[210  69 237  89 301],524,3,4498,3.6628664495114007,0.0,0.0
31228,3,1228,[127  64 427 318 183],374,3,4501,3.662327095199349,20.0,20.0
31229,3,1229,[127  64 427 318 183],6,5,4506,3.6634146341463416,20.0,20.0
31230,3,1230,[405 333 655 172 475],334,3,4509,3.662875710804224,0.0,0.0
31231,3,1231,[ 79 180 742  12 210],378,4,4513,3.6631493506493507,20.0,0.0
31232,3,1232,[127  64 427 318 183],308,5,4518,3.664233576642336,20.0,20.0
31233,3,1233,[127  64 427 318 183],666,5,4523,3.6653160453808753,20.0,20.0
31234,3,1234,[127  64 427 318 183],326,4,4527,3.665587044534413,20.0,20.0
31235,3,1235,[127  64 427 318 183],527,3,4530,3.6650485436893203,20.0,20.0
31236,3,1236,[181 300 153 197 333],85,2,4532,3.6637025060630557,0.0,0.0
31237,3,1237,[234 196 186 475  96],374,3,4535,3.6631663974151856,0.0,0.0
31238,3,1238,[127  64 427 318 183],527,3,4538,3.662631154156578,20.0,20.0
31239,3,1239,[257  89 265 228  11],455,3,4541,3.6620967741935484,0.0,0.0
31240,3,1240,[  8 322 318  97 181],313,3,4544,3.661563255439162,20.0,0.0
31241,3,1241,[286 195 742 175 172],653,2,4546,3.6602254428341383,0.0,0.0
31242,3,1242,[127  64 427 318 183],7,5,4551,3.66130329847144,20.0,20.0
31243,3,1243,[176 385 215 211  56],343,4,4555,3.6615755627009645,0.0,0.0
31244,3,1244,[127  64 427 318 183],537,3,4558,3.6610441767068274,20.0,20.0
31245,3,1245,[603 328 100  71 127],804,4,4562,3.6613162118780096,20.0,40.0
31246,3,1246,[127  64 427 318 183],666,5,4567,3.6623897353648758,20.0,20.0
31247,3,1247,[357 144 423 435 678],308,3,4570,3.6618589743589745,20.0,0.0
31248,3,1248,[197 597 471  96 275],7,4,4574,3.6621297037630103,0.0,0.0
31249,3,1249,[127  64 427 318 183],234,5,4579,3.6632,20.0,20.0
31250,3,1250,[ 12   7 655 211 200],7,5,4584,3.6642685851318944,20.0,0.0
31251,3,1251,[127  64 427 318 183],326,4,4588,3.6645367412140577,20.0,20.0
31252,3,1252,[168  11 211 182  64],804,5,4593,3.6656025538707104,0.0,0.0
31253,3,1253,[127  64 427 318 183],13,4,4597,3.6658692185007973,20.0,20.0
31254,3,1254,[127  64 427 318 183],664,4,4601,3.666135458167331,20.0,20.0
31255,3,1255,[204 179 235 182 405],774,2,4603,3.664808917197452,0.0,0.0
31256,3,1256,[127  64 427 318 183],406,5,4608,3.6658711217183773,20.0,20.0
31257,3,1257,[197 742 174 508 191],543,4,4612,3.6661367249602543,0.0,20.0
31258,3,1258,[127  64 427 318 183],537,3,4615,3.6656076250992853,20.0,20.0
31259,3,1259,[200 318 117  79 176],313,4,4619,3.6658730158730157,20.0,0.0
31260,3,1260,[127 427  64 318 183],326,4,4623,3.6661379857256144,20.0,20.0
31261,3,1261,[121 423  82  64 237],455,4,4627,3.6664025356576864,0.0,0.0
31262,3,1262,[202 237  69 210 546],7,4,4631,3.6666666666666665,0.0,0.0
31263,3,1263,[127 427  64 318 183],234,5,4636,3.6677215189873418,20.0,20.0
31264,3,1264,[100 143 196 182 302],537,3,4639,3.667193675889328,0.0,20.0
31265,3,1265,[127 427  64 318 183],458,5,4644,3.6682464454976302,20.0,20.0
31266,3,1266,[127 427  64 318 183],666,5,4649,3.6692975532754537,20.0,20.0
31267,3,1267,[322 173 546 176 202],749,4,4653,3.669558359621451,0.0,0.0
31268,3,1268,[127 427  64 318 183],458,5,4658,3.670606776989756,20.0,20.0
31269,3,1269,[186 151  79 111 655],537,1,4659,3.668503937007874,0.0,0.0
31270,3,1270,[127 427  64 318 183],308,5,4664,3.6695515342250196,20.0,20.0
31271,3,1271,[127 427  64 318 183],326,4,4668,3.669811320754717,20.0,20.0
31272,3,1272,[222 435 427  79 313],380,3,4671,3.669285153181461,0.0,0.0
31273,3,1273,[176 282 483 301 204],788,3,4674,3.6687598116169546,20.0,0.0
31274,3,1274,[135 161 286  64 174],234,2,4676,3.667450980392157,0.0,20.0
31275,3,1275,[185 181   9 144 515],194,4,4680,3.6677115987460813,0.0,0.0
31276,3,1276,[127 427  64 318 183],474,5,4685,3.668754894283477,20.0,20.0
31277,3,1277,[300   4 471 333 144],13,2,4687,3.667449139280125,0.0,0.0
31278,3,1278,[127 427  64 318 183],474,5,4692,3.668491008600469,20.0,20.0
31279,3,1279,[194  69 357   7 200],666,3,4695,3.66796875,20.0,0.0
31280,3,1280,[127 427  64 318 183],194,4,4699,3.6682279469164714,20.0,20.0
31281,3,1281,[97 82  9 98 12],339,5,4704,3.6692667706708266,20.0,20.0
31282,3,1282,[127 427  64 318 183],6,5,4709,3.6703039750584567,20.0,20.0
31283,3,1283,[127 427  64 318 183],313,5,4714,3.6713395638629285,20.0,20.0
31284,3,1284,[117 121   1  15 265],308,1,4715,3.669260700389105,0.0,0.0
31285,3,1285,[127 427  64 318 183],664,4,4719,3.6695178849144634,20.0,20.0
31286,3,1286,[127 427  64 318 183],406,5,4724,3.6705516705516708,20.0,20.0
31287,3,1287,[ 56  98  64  28 174],537,1,4725,3.6684782608695654,0.0,40.0
31288,3,1288,[301 117 271 172   9],328,3,4728,3.6679596586501164,0.0,0.0
31289,3,1289,[127 427  64 318 183],527,3,4731,3.667441860465116,20.0,20.0
31290,3,1290,[127 427  64 318 183],7,5,4736,3.66847405112316,20.0,20.0
31291,3,1291,[127 427  64 318 183],13,4,4740,3.668730650154799,20.0,20.0
31292,3,1292,[508  15 282  56 275],474,3,4743,3.668213457076566,0.0,0.0
31293,3,1293,[127 427  64 318 183],87,5,4748,3.669242658423493,20.0,20.0
31294,3,1294,[294 204 475 195 546],213,4,4752,3.6694980694980694,0.0,0.0
31295,3,1295,[186  11 515 258 180],13,3,4755,3.6689814814814814,0.0,0.0
31296,3,1296,[265 483 191 195 515],234,3,4758,3.6684656900539707,20.0,0.0
31297,3,1297,[289   7  95  15  70],95,3,4761,3.667950693374422,0.0,0.0
31298,3,1298,[127 427  64 318 183],406,5,4766,3.6689761354888377,20.0,20.0
31299,3,1299,[238 168  50 172 546],194,2,4768,3.667692307692308,0.0,20.0
31300,3,1300,[127 427  64 318 183],234,5,4773,3.668716372021522,20.0,20.0
31301,3,1301,[183 194 215 191 357],650,4,4777,3.6689708141321042,20.0,0.0
31302,3,1302,[118 211 748 483 153],804,5,4782,3.6699923254029163,20.0,0.0
31303,3,1303,[127 427  64 318 183],59,5,4787,3.6710122699386503,20.0,20.0
31304,3,1304,[151 588 191 235 153],795,2,4789,3.6697318007662836,0.0,0.0
31305,3,1305,[127 427  64 318 183],87,5,4794,3.670750382848392,20.0,20.0
31306,3,1306,[127 427  64 318 183],13,4,4798,3.671002295332823,20.0,20.0
31307,3,1307,[179 180 182 195   9],308,5,4803,3.6720183486238533,0.0,0.0
31308,3,1308,[127 427  64 318 183],326,4,4807,3.672268907563025,20.0,20.0
31309,3,1309,[127 427  64 318 183],194,4,4811,3.6725190839694655,20.0,20.0
31310,3,1310,[127 427  64 318 183],328,4,4815,3.6727688787185353,20.0,20.0
31311,3,1311,[153 100 187 168 211],194,4,4819,3.6730182926829267,0.0,20.0
31312,3,1312,[127 427  64 318 183],666,5,4824,3.674028941355674,20.0,20.0
31313,3,1313,[127 427  64 318 183],527,3,4827,3.67351598173516,20.0,20.0
31314,3,1314,[235 282 100 125 276],374,4,4831,3.673764258555133,0.0,20.0
31315,3,1315,[127 427  64 318 183],326,4,4835,3.6740121580547114,20.0,20.0
31316,3,1316,[427 182  96  79 172],666,2,4837,3.6727410782080487,0.0,0.0
31317,3,1317,[  8 210 655  88 176],92,4,4841,3.67298937784522,0.0,0.0
31318,3,1318,[127 427  64 318 183],374,3,4844,3.672479150871873,20.0,20.0
31319,3,1319,[127 427  64 318 183],458,5,4849,3.6734848484848484,20.0,20.0
31320,3,1320,[127 427  64 318 183],313,5,4854,3.6744890234670704,20.0,20.0
31321,3,1321,[ 70 265 143 483 405],533,3,4857,3.6739788199697427,20.0,0.0
31322,3,1322,[405 196 143 210 185],840,4,4861,3.674225245653817,0.0,0.0
31323,3,1323,[ 70 273 194 655 186],64,4,4865,3.6744712990936557,0.0,0.0
31324,3,1324,[127 427  64 318 183],374,3,4868,3.6739622641509433,20.0,20.0
31325,3,1325,[294 186 286 161   8],387,1,4869,3.671945701357466,0.0,0.0
31326,3,1326,[127 427  64 318 183],527,3,4872,3.6714393368500375,20.0,20.0
31327,3,1327,[127 427  64 183 318],194,4,4876,3.6716867469879517,20.0,20.0
31328,3,1328,[127 237 282 173  64],374,4,4880,3.671933784800602,0.0,20.0
31329,3,1329,[289 282 111 403  97],533,2,4882,3.6706766917293234,0.0,0.0
31330,3,1330,[127 427  64 318 183],374,3,4885,3.6701728024042075,20.0,20.0
31331,3,1331,[357 471 435  28 195],234,2,4887,3.668918918918919,20.0,0.0
31332,3,1332,[ 97 186   7 179  69],524,3,4890,3.668417104276069,0.0,0.0
31333,3,1333,[127 427  64 183 318],234,5,4895,3.6694152923538232,20.0,20.0
31334,3,1334,[176 183 211 187 195],325,0,4895,3.6666666666666665,0.0,0.0
31335,3,1335,[237 742  89 228  97],524,2,4897,3.6654191616766467,0.0,0.0
31336,3,1336,[127 427  64 183 318],59,5,4902,3.6664173522812264,20.0,20.0
31337,3,1337,[127 427  64 183 318],59,5,4907,3.6674140508221225,20.0,20.0
31338,3,1338,[127 427  64 183 318],7,5,4912,3.6684092606422705,20.0,20.0
31339,3,1339,[132 678 323  50  71],13,3,4915,3.667910447761194,0.0,20.0
31340,3,1340,[210  97 271 435 132],890,4,4919,3.668158090976883,0.0,0.0
31341,3,1341,[194 100  50 423 186],339,4,4923,3.668405365126677,0.0,40.0
31342,3,1342,[ 22 194 195 172  82],524,2,4925,3.6671630677587492,0.0,0.0
31343,3,1343,[127 427  64 183 318],664,4,4929,3.6674107142857144,20.0,20.0
31344,3,1344,[127 427  64 318 183],474,5,4934,3.6684014869888477,20.0,20.0
31345,3,1345,[127 427  64 318 183],87,5,4939,3.6693907875185734,20.0,20.0
31346,3,1346,[ 89 176 210 204 603],694,5,4944,3.670378619153675,20.0,0.0
31347,3,1347,[175 435 211 182 196],804,4,4948,3.6706231454005933,0.0,0.0
31348,3,1348,[144 282  70 121 403],643,2,4950,3.669384729429207,0.0,0.0
31349,3,1349,[276 328  50  98 286],144,3,4953,3.668888888888889,0.0,40.0
31350,3,1350,[127 427  64 318 183],234,5,4958,3.669874167283494,20.0,20.0
31351,3,1351,[127 427  64 318 183],664,4,4962,3.6701183431952664,20.0,20.0
31352,3,1352,[ 95 276  97  50 286],234,1,4963,3.6681448632668143,0.0,20.0
31353,3,1353,[127 427  64 318 183],6,5,4968,3.6691285081240768,20.0,20.0
31354,3,1354,[195 483 153 127 234],452,4,4972,3.6693726937269373,20.0,20.0
31355,3,1355,[127 427  64 318 183],326,4,4976,3.669616519174041,20.0,20.0
31356,3,1356,[127 427  64 318 183],666,5,4981,3.6705969049373617,20.0,20.0
31357,3,1357,[187 215 132  89 655],308,3,4984,3.670103092783505,0.0,0.0
31358,3,1358,[144 237  28 427  97],60,4,4988,3.670345842531273,0.0,0.0
31359,3,1359,[127 427  64 318 183],474,5,4993,3.6713235294117648,20.0,20.0
31360,3,1360,[323 748 121   4 179],13,3,4996,3.6708302718589274,0.0,0.0
31361,3,1361,[127 427  64 318 183],664,4,5000,3.671071953010279,20.0,20.0
31362,3,1362,[196 289 269  98 211],85,3,5003,3.6705796038151135,0.0,20.0
31363,3,1363,[127 427  64 318 183],474,5,5008,3.6715542521994133,20.0,20.0
31364,3,1364,[202  22 655   4 121],59,5,5013,3.6725274725274724,0.0,0.0
31365,3,1365,[195 179 427 271 143],536,3,5016,3.67203513909224,0.0,0.0
31366,3,1366,[ 22  82 194 180  89],95,2,5018,3.6708119970738844,0.0,0.0
31367,3,1367,[127 427  64 318 183],194,4,5022,3.6710526315789473,20.0,20.0
31368,3,1368,[127 427  64 318 183],406,5,5027,3.6720233747260775,20.0,20.0
31369,3,1369,[127 427  64 318 183],13,4,5031,3.6722627737226277,20.0,20.0
31370,3,1370,[127 427  64 318 183],666,5,5036,3.6732312180889863,20.0,20.0
31371,3,1371,[127 427  64 318 183],328,4,5040,3.673469387755102,20.0,20.0
31372,3,1372,[127 427  64 318 183],13,4,5044,3.6737072104879824,20.0,20.0
31373,3,1373,[127 427  64 318 183],474,5,5049,3.6746724890829694,20.0,20.0
31374,3,1374,[127 427  64 318 183],537,3,5052,3.674181818181818,20.0,20.0
31375,3,1375,[435 181 186 546 328],271,3,5055,3.6736918604651163,0.0,0.0
31376,3,1376,[222 215 238 161 282],479,3,5058,3.673202614379085,0.0,0.0
31377,3,1377,[127 427  64 318 183],313,5,5063,3.674165457184325,20.0,20.0
31378,3,1378,[357 125  15 427  88],533,4,5067,3.674401740391588,20.0,0.0
31379,3,1379,[385  98 588 235 200],378,4,5071,3.67463768115942,0.0,20.0
31380,3,1380,[127 427  64 318 183],458,5,5076,3.675597393193338,20.0,20.0
31381,3,1381,[234 257 127 275   7],548,4,5080,3.675832127351664,0.0,20.0
31382,3,1382,[127 427  64 318 183],537,3,5083,3.6753434562545193,20.0,20.0
31383,3,1383,[  1 121  69 257 118],254,2,5085,3.6741329479768785,0.0,0.0
31384,3,1384,[ 22  15 202 196 200],378,3,5088,3.6736462093862814,0.0,0.0
31385,3,1385,[127 427  64 318 183],7,5,5093,3.6746031746031744,20.0,20.0
31386,3,1386,[ 71  50 435  70 568],85,4,5097,3.6748377793799567,0.0,20.0
31387,3,1387,[127 427  64 318 183],91,5,5102,3.675792507204611,20.0,20.0
31388,3,1388,[127 427  64 318 183],194,4,5106,3.676025917926566,20.0,20.0
31389,3,1389,[289  97   4 176 276],271,3,5109,3.675539568345324,0.0,0.0
31390,3,1390,[127 427  64 318 183],313,5,5114,3.676491732566499,20.0,20.0
31391,3,1391,[127 427  64 318 183],664,4,5118,3.6767241379310347,20.0,20.0
31392,3,1392,[127 427  64 318 191],13,3,5121,3.676238334529792,20.0,20.0
31393,3,1393,[ 22 196   9 176 237],406,2,5123,3.6750358680057387,0.0,0.0
31394,3,1394,[ 64 258 195 196 204],378,4,5127,3.675268817204301,0.0,0.0
31395,3,1395,[127 427  64 318 183],326,4,5131,3.6755014326647566,20.0,20.0
31396,3,1396,[215 194 269 216 678],615,4,5135,3.6757337151037937,0.0,0.0
31397,3,1397,[174 423   1 180 181],901,4,5139,3.6759656652360513,0.0,20.0
31398,3,1398,[ 98 202 179 176 742],899,4,5143,3.6761972837741244,0.0,20.0
31399,3,1399,[204 216  25 175 183],207,2,5145,3.675,0.0,0.0
31400,3,1400,[258   1 515 313  82],184,3,5148,3.674518201284797,0.0,0.0
31401,3,1401,[127 427  64 318 183],537,3,5151,3.674037089871612,20.0,20.0
31402,3,1402,[222 168 238 294 200],666,3,5154,3.6735566642908055,0.0,0.0
31403,3,1403,[127 427  64 318 483],308,4,5158,3.673789173789174,40.0,20.0
31404,3,1404,[655 197 196 202 100],804,5,5163,3.674733096085409,0.0,20.0
31405,3,1405,[202   4 118 100 405],533,3,5166,3.67425320056899,0.0,20.0
31406,3,1406,[403  28  22 125   8],194,2,5168,3.6730632551528073,0.0,0.0
31407,3,1407,[127 427  64 318 183],234,5,5173,3.6740056818181817,20.0,20.0
31408,3,1408,[127 427  64 318 183],87,5,5178,3.6749467707594037,20.0,20.0
31409,3,1409,[125 204 403  95 172],398,4,5182,3.675177304964539,0.0,0.0
31410,3,1410,[127 427  64 318 183],91,5,5187,3.67611622962438,20.0,20.0
31411,3,1411,[132  15 423 546 181],60,5,5192,3.677053824362606,0.0,0.0
31412,3,1412,[195 245  98 185 546],102,2,5194,3.6758669497523,0.0,20.0
31413,3,1413,[ 64  98 294 483 183],374,3,5197,3.6753889674681752,20.0,20.0
31414,3,1414,[197  82 423 258  50],378,4,5201,3.675618374558304,0.0,20.0
31415,3,1415,[100 427 186 151 185],385,3,5204,3.675141242937853,0.0,20.0
31416,3,1416,[127 427  64 318 183],91,5,5209,3.676076217360621,20.0,20.0
31417,3,1417,[211 153 655 294 161],749,3,5212,3.675599435825106,0.0,0.0
31418,3,1418,[127 427  64 318 183],7,5,5217,3.6765327695560255,20.0,20.0
31419,3,1419,[322 215 111  97 318],13,3,5220,3.676056338028169,20.0,0.0
31420,3,1420,[127 427  64 318 183],328,4,5224,3.6762843068261786,20.0,20.0
31421,3,1421,[127 427  64 318 183],6,5,5229,3.6772151898734178,20.0,20.0
31422,3,1422,[ 56  22 197 276  50],343,5,5234,3.6781447645818695,0.0,20.0
31423,3,1423,[268 403 215 655 357],387,1,5235,3.6762640449438204,20.0,0.0
31424,3,1424,[127 427  64 318 183],313,5,5240,3.6771929824561402,20.0,20.0
31425,3,1425,[127 427  64 318 183],537,3,5243,3.67671809256662,20.0,20.0
31426,3,1426,[127 427  64 318 183],7,5,5248,3.677645409950946,20.0,20.0
31427,3,1427,[127 427  64 318 183],328,4,5252,3.6778711484593836,20.0,20.0
31428,3,1428,[127 427  64 318 183],527,3,5255,3.67739678096571,20.0,20.0
31429,3,1429,[127  15 143 151   8],881,3,5258,3.6769230769230767,0.0,20.0
31430,3,1430,[127 427  64 318 183],308,5,5263,3.6778476589797346,20.0,20.0
31431,3,1431,[357 483 301 173 200],6,3,5266,3.6773743016759775,40.0,0.0
31432,3,1432,[175 597  64 117 185],95,3,5269,3.6769016050244243,0.0,0.0
31433,3,1433,[496 151 300 483 202],90,2,5271,3.6757322175732217,20.0,0.0
31434,3,1434,[127 427  64 318 183],234,5,5276,3.6766550522648083,20.0,20.0
31435,3,1435,[153 200 258 603  79],234,2,5278,3.6754874651810585,20.0,0.0
31436,3,1436,[127 427  64 318 183],537,3,5281,3.6750173973556017,20.0,20.0
31437,3,1437,[121 181 211 197 200],666,3,5284,3.674547983310153,0.0,0.0
31438,3,1438,[ 69 117 196  56  95],892,5,5289,3.6754690757470465,0.0,0.0
31439,3,1439,[ 79 185 121 135  70],804,4,5293,3.6756944444444444,0.0,0.0
31440,3,1440,[127 427  64 318 183],59,5,5298,3.676613462873005,20.0,20.0
31441,3,1441,[127 427  64 318 183],458,5,5303,3.67753120665742,20.0,20.0
31442,3,1442,[405 215 289 187 318],85,3,5306,3.677061677061677,20.0,0.0
31443,3,1443,[127 427  64 318 183],91,5,5311,3.67797783933518,20.0,20.0
31444,3,1444,[127 427  64 318 183],406,5,5316,3.678892733564014,20.0,20.0
31445,3,1445,[127 427  64 318 183],59,5,5321,3.6798063623789763,20.0,20.0
31446,3,1446,[127 427  64 318 183],452,5,5326,3.6807187284035936,20.0,20.0
31447,3,1447,[  8 333   7 194  79],343,4,5330,3.680939226519337,0.0,0.0
31448,3,1448,[127 427  64 318 183],91,5,5335,3.6818495514147687,20.0,20.0
31449,3,1449,[121 483 127 289 180],85,3,5338,3.681379310344828,20.0,20.0
31450,3,1450,[127 427  64 318 183],91,5,5343,3.6822880771881463,20.0,20.0
31451,3,1451,[127 427  64 318 183],374,3,5346,3.6818181818181817,20.0,20.0
31452,3,1452,[276 282  71 175 132],881,3,5349,3.681348933241569,0.0,0.0
31453,3,1453,[471 238 546 196  64],378,2,5351,3.6801925722145805,0.0,0.0
31454,3,1454,[ 50 143  98 196 132],346,2,5353,3.679037800687285,0.0,40.0
31455,3,1455,[127 427  64 318 183],7,5,5358,3.6799450549450547,20.0,20.0
31456,3,1456,[127 427  64 318 183],328,4,5362,3.680164722031572,20.0,20.0
31457,3,1457,[135  79 318 118 294],308,3,5365,3.679698216735254,20.0,0.0
31458,3,1458,[111 483 403 180 405],749,3,5368,3.6792323509252913,20.0,0.0
31459,3,1459,[ 70   8 118 568 748],13,3,5371,3.6787671232876713,0.0,0.0
31460,3,1460,[475 183 168  79 191],506,4,5375,3.6789869952087613,0.0,0.0
31461,3,1461,[211  71 111 200  22],234,2,5377,3.6778385772913817,0.0,0.0
31462,3,1462,[265  97 121 288 100],7,5,5382,3.6787423103212578,0.0,20.0
31463,3,1463,[127 427  64 318 183],328,4,5386,3.67896174863388,20.0,20.0
31464,3,1464,[127 427  64 318 183],91,5,5391,3.679863481228669,20.0,20.0
31465,3,1465,[127 427  64 318 183],474,5,5396,3.680763983628922,20.0,20.0
31466,3,1466,[174 427  28 197 245],533,4,5400,3.6809815950920246,0.0,20.0
31467,3,1467,[127 427  64 318 183],6,5,5405,3.681880108991826,20.0,20.0
31468,3,1468,[127 427  64 318 183],313,5,5410,3.6827773995915587,20.0,20.0
31469,3,1469,[300 151 117 216 275],537,1,5411,3.6809523809523808,0.0,0.0
31470,3,1470,[127 427  64 318 183],328,4,5415,3.681169272603671,20.0,20.0
31471,3,1471,[127  64 427 318 183],374,3,5418,3.6807065217391304,20.0,20.0
31472,3,1472,[ 71  28 294  79 181],506,5,5423,3.681602172437203,0.0,0.0
31473,3,1473,[125 174 117  97 211],290,1,5424,3.679782903663501,0.0,20.0
31474,3,1474,[ 71  69 168 288 125],533,4,5428,3.68,0.0,0.0
31475,3,1475,[185 257  96 174   9],815,3,5431,3.6795392953929538,0.0,20.0
31476,3,1476,[127  64 427 318 183],666,5,5436,3.680433310765064,20.0,20.0
31477,3,1477,[127  64 427 318 183],13,4,5440,3.6806495263870094,20.0,20.0
31478,3,1478,[195 471 161 403 300],378,3,5443,3.680189317106153,0.0,0.0
31479,3,1479,[172 143   8 197  89],308,4,5447,3.6804054054054056,0.0,0.0
31480,3,1480,[ 89 216 237 655 318],378,5,5452,3.6812964213369344,20.0,0.0
31481,3,1481,[127  64 427 318 183],537,3,5455,3.680836707152497,20.0,20.0
31482,3,1482,[127  64 427 318 183],13,4,5459,3.6810519217801754,20.0,20.0
31483,3,1483,[496 211  12   1 286],339,5,5464,3.6819407008086253,20.0,0.0
31484,3,1484,[127  64 427 318 183],458,5,5469,3.682828282828283,20.0,20.0
31485,3,1485,[127  64 427 318 183],234,5,5474,3.68371467025572,20.0,20.0
31486,3,1486,[127  64 427 318 183],194,4,5478,3.683927370544721,20.0,20.0
31487,3,1487,[127  89 153  98 210],840,3,5481,3.683467741935484,0.0,40.0
31488,3,1488,[597 161   4 202 196],374,2,5483,3.6823371390194763,0.0,0.0
31489,3,1489,[144 216 234 195 568],543,4,5487,3.6825503355704696,0.0,0.0
31490,3,1490,[127  64 427 318 183],59,5,5492,3.6834339369550637,20.0,20.0
31491,3,1491,[127  64 427 318 183],458,5,5497,3.6843163538873993,20.0,20.0
31492,3,1492,[403 194  56  79 118],308,4,5501,3.6845277963831213,0.0,0.0
31493,3,1493,[144 238 197  95 215],194,3,5504,3.6840696117804552,0.0,0.0
31494,3,1494,[135 194 111  95 678],749,2,5506,3.682943143812709,0.0,0.0
31495,3,1495,[127  64 427 318 183],374,3,5509,3.682486631016043,20.0,20.0
31496,3,1496,[127  64 427 318 183],91,5,5514,3.6833667334669338,20.0,20.0
31497,3,1497,[  7 282 742  11 515],92,4,5518,3.683578104138852,0.0,0.0
31498,3,1498,[127  64 427 318 183],308,5,5523,3.684456304202802,20.0,20.0
31499,3,1499,[127  64 427 318 183],328,4,5527,3.6846666666666668,20.0,20.0
31500,3,1500,[183 405 234 245  98],378,3,5530,3.6842105263157894,0.0,20.0
31501,3,1501,[ 11   1  15 168 288],882,4,5534,3.684420772303595,0.0,0.0
31502,3,1502,[ 11 202 318 161  22],7,2,5536,3.6833000665335995,20.0,0.0
31503,3,1503,[127  64 427 318 183],91,5,5541,3.6841755319148937,20.0,20.0
31504,3,1504,[127  64 427 318 183],458,5,5546,3.685049833887043,20.0,20.0
31505,3,1505,[286 181 180 132   9],447,3,5549,3.684594953519256,0.0,0.0
31506,3,1506,[127  64 427 318 183],308,5,5554,3.685467816854678,20.0,20.0
31507,3,1507,[265 286 183 127  98],537,1,5555,3.68368700265252,0.0,40.0
31508,3,1508,[121 118 196 172 302],666,1,5556,3.6819085487077534,0.0,0.0
31509,3,1509,[127  64 427 318 183],328,4,5560,3.6821192052980134,20.0,20.0
31510,3,1510,[127  64 427 318 183],666,5,5565,3.6829913964262078,20.0,20.0
31511,3,1511,[127  64 427 318 183],6,5,5570,3.683862433862434,20.0,20.0
31512,3,1512,[127  64 427 318 183],13,4,5574,3.6840713813615333,20.0,20.0
31513,3,1513,[127  64 427 318 183],527,3,5577,3.6836195508586527,20.0,20.0
31514,3,1514,[265 238 180 333 289],488,2,5579,3.6825082508250824,0.0,0.0
31515,3,1515,[127  64 427 318 183],6,5,5584,3.683377308707124,20.0,20.0
31516,3,1516,[275 483 125 546  22],82,1,5585,3.6816084377059988,20.0,0.0
31517,3,1517,[435 174  56  12  64],533,4,5589,3.6818181818181817,20.0,20.0
31518,3,1518,[655 385  89 515 228],643,3,5592,3.6813693219223174,0.0,0.0
31519,3,1519,[153 185 288  12 204],334,4,5596,3.681578947368421,20.0,0.0
31520,3,1520,[496  97 228 204 435],398,5,5601,3.6824457593688362,0.0,0.0
31521,3,1521,[127  64 427 318 183],537,3,5604,3.6819973718791066,20.0,20.0
31522,3,1522,[127  64 427 318 183],326,4,5608,3.6822061720288906,20.0,20.0
31523,3,1523,[ 22 202 234  69  98],883,2,5610,3.6811023622047245,0.0,20.0
31524,3,1524,[211 483 179 427 289],85,3,5613,3.680655737704918,20.0,0.0
31525,3,1525,[235 228   1  79 187],804,5,5618,3.6815203145478375,0.0,0.0
31526,3,1526,[ 28 435 215 182 403],387,2,5620,3.6804191224623444,0.0,0.0
31527,3,1527,[234 275 515 288 235],279,0,5620,3.6780104712041886,0.0,0.0
31528,3,1528,[127  64 427 318 183],194,4,5624,3.6782210595160234,20.0,20.0
31529,3,1529,[143 333 258 210 204],653,3,5627,3.6777777777777776,0.0,0.0
31530,3,1530,[357 655 182 191 179],85,4,5631,3.6779882429784454,20.0,0.0
31531,3,1531,[127  64 427 318 183],452,5,5636,3.6788511749347257,20.0,20.0
31532,3,1532,[333 211 168  98 288],346,3,5639,3.6784083496412263,0.0,20.0
31533,3,1533,[127  64 427 318 183],59,5,5644,3.679269882659713,20.0,20.0
31534,3,1534,[127  64 427 318 183],452,5,5649,3.680130293159609,20.0,20.0
31535,3,1535,[ 69 237 151 275  96],882,5,5654,3.6809895833333335,0.0,0.0
31536,3,1536,[127  64 427 318 183],91,5,5659,3.681847755367599,20.0,20.0
31537,3,1537,[127  64 427 318 183],6,5,5664,3.682704811443433,20.0,20.0
31538,3,1538,[118 222 597 276 273],168,3,5667,3.682261208576998,0.0,0.0
31539,3,1539,[127  64 427 318 183],7,5,5672,3.6831168831168832,20.0,20.0
31540,3,1540,[ 98  89 216 181 127],374,3,5675,3.682673588578845,0.0,40.0
31541,3,1541,[132 183 179 294 186],95,2,5677,3.681582360570687,0.0,0.0
31542,3,1542,[405 172 173 185 135],64,4,5681,3.681788723266364,0.0,0.0
31543,3,1543,[121 173 197 179 191],194,4,5685,3.68199481865285,0.0,0.0
31544,3,1544,[127  64 427 318 183],313,5,5690,3.6828478964401294,20.0,20.0
31545,3,1545,[127  64 427 318 183],458,5,5695,3.6836998706338937,20.0,20.0
31546,3,1546,[173 405   8 195 475],64,4,5699,3.6839043309631543,0.0,0.0
31547,3,1547,[127  64 427 318 183],474,5,5704,3.6847545219638245,20.0,20.0
31548,3,1548,[127  64 427 318 183],6,5,5709,3.6856036152356357,20.0,20.0
31549,3,1549,[127  64 427 318 183],374,3,5712,3.6851612903225806,20.0,20.0
31550,3,1550,[318  12  71 204 234],406,4,5716,3.6853642811089617,40.0,0.0
31551,3,1551,[313 496  97 234 200],308,1,5717,3.6836340206185567,0.0,0.0
31552,3,1552,[127  64 427 318 183],7,5,5722,3.684481648422408,20.0,20.0
31553,3,1553,[  7 323 318 435 257],474,3,5725,3.684041184041184,20.0,0.0
31554,3,1554,[127  64 427 318 183],91,5,5730,3.684887459807074,20.0,20.0
31555,3,1555,[168  98 111 215  25],95,4,5734,3.685089974293059,0.0,20.0
31556,3,1556,[ 11  15 276 273 265],207,2,5736,3.684007707129094,0.0,0.0
31557,3,1557,[ 56 197   1 294 234],374,4,5740,3.6842105263157894,0.0,0.0
31558,3,1558,[508   8   4 153 161],334,2,5742,3.68313021167415,0.0,0.0
31559,3,1559,[144 196 258 238 235],92,4,5746,3.683333333333333,0.0,0.0
31560,3,1560,[ 50 289 176 204 216],125,4,5750,3.683536194746957,0.0,20.0
31561,3,1561,[127  64 427 318 183],527,3,5753,3.683098591549296,20.0,20.0
31562,3,1562,[127  64 427 318 183],13,4,5757,3.6833013435700575,20.0,20.0
31563,3,1563,[127  64 427 318 183],328,4,5761,3.6835038363171355,20.0,20.0
31564,3,1564,[174  82  12   9 475],92,4,5765,3.68370607028754,20.0,20.0
31565,3,1565,[127  64 427 318 183],87,5,5770,3.684546615581098,20.0,20.0
31566,3,1566,[121 100 210 265 515],638,4,5774,3.684747925973197,0.0,20.0
31567,3,1567,[ 70  98 508 174 172],60,5,5779,3.6855867346938775,0.0,40.0
31568,3,1568,[ 82  89  95  15 144],92,2,5781,3.6845124282982793,0.0,0.0
31569,3,1569,[ 12 194 318 496  71],311,5,5786,3.6853503184713374,40.0,0.0
31570,3,1570,[127  64 427 318 183],537,3,5789,3.6849140674729473,20.0,20.0
31571,3,1571,[127  64 427 318 183],474,5,5794,3.6857506361323153,20.0,20.0
31572,3,1572,[127  64 427 318 183],194,4,5798,3.6859504132231407,20.0,20.0
31573,3,1573,[187   9 403 176  71],328,4,5802,3.6861499364675985,0.0,0.0
31574,3,1574,[ 64 175 174  96  69],543,4,5806,3.6863492063492065,0.0,20.0
31575,3,1575,[127  64 427 318 183],87,5,5811,3.6871827411167515,20.0,20.0
31576,3,1576,[175  25 204 238 180],378,3,5814,3.6867469879518073,0.0,0.0
31577,3,1577,[127  64 427 318 183],326,4,5818,3.6869455006337137,20.0,20.0
31578,3,1578,[508 323  12 182 237],59,4,5822,3.687143761874604,20.0,0.0
31579,3,1579,[211 100 265 168 173],279,5,5827,3.687974683544304,0.0,20.0
31580,3,1580,[168  11 180 175 194],840,3,5830,3.687539531941809,0.0,0.0
31581,3,1581,[301 302 132 194 183],666,4,5834,3.6877370417193425,0.0,0.0
31582,3,1582,[172 483 546  70  89],328,4,5838,3.687934301958307,20.0,0.0
31583,3,1583,[ 15 161 403 100 237],184,2,5840,3.686868686868687,0.0,20.0
31584,3,1584,[143 185 286 603 228],234,1,5841,3.685173501577287,20.0,0.0
31585,3,1585,[ 82 111 176 403 174],13,2,5843,3.6841109709962168,0.0,20.0
31586,3,1586,[127  64 427 318 183],537,3,5846,3.683679899180844,20.0,20.0
31587,3,1587,[127  64 427 318 302],90,5,5851,3.684508816120907,20.0,20.0
31588,3,1588,[216 194 288 318 182],804,4,5855,3.68470736312146,20.0,0.0
31589,3,1589,[176   4 173 603 175],218,2,5857,3.6836477987421383,20.0,0.0
31590,3,1590,[ 50 318 515 180  69],313,5,5862,3.684475172847266,20.0,20.0
31591,3,1591,[127  64 427 318 603],7,5,5867,3.6853015075376883,40.0,20.0
31592,3,1592,[186 515  79 294 210],92,4,5871,3.6854990583804144,0.0,0.0
31593,3,1593,[655 483 300  56 176],488,3,5874,3.685069008782936,20.0,0.0
31594,3,1594,[144 195  97  95  28],843,1,5875,3.683385579937304,0.0,0.0
31595,3,1595,[234 204 328 301 181],328,3,5878,3.682957393483709,0.0,0.0
31596,3,1596,[181 202 143 228 423],454,2,5880,3.6819035691922353,0.0,0.0
31597,3,1597,[ 98 313 151 655 282],378,4,5884,3.6821026282853566,0.0,20.0
31598,3,1598,[ 95  64  88 475 322],374,3,5887,3.681676047529706,0.0,0.0
31599,3,1599,[127  64 427 318 603],686,5,5892,3.6825,40.0,20.0
31600,3,1600,[435  88 286 197  64],234,2,5894,3.6814490943160525,0.0,0.0
31601,3,1601,[257 269   4 271 427],650,2,5896,3.68039950062422,0.0,0.0
31602,3,1602,[127  64 427 603 318],474,5,5901,3.6812227074235806,40.0,20.0
31603,3,1603,[ 79 173 176 385 597],346,3,5904,3.680798004987531,0.0,0.0
31604,3,1604,[ 82 181 202 333 603],506,5,5909,3.681619937694704,20.0,0.0
31605,3,1605,[168  56 183 180 204],311,5,5914,3.6824408468244085,0.0,0.0
31606,3,1606,[117 403 318  28  98],234,3,5917,3.6820161792159305,20.0,20.0
31607,3,1607,[127  64 427 603 318],537,4,5921,3.682213930348259,40.0,20.0
31608,3,1608,[175 265 125 127   8],7,5,5926,3.683032939714108,0.0,20.0
31609,3,1609,[127  64 427 603 318],533,5,5931,3.6838509316770187,40.0,20.0
31610,3,1610,[127  64 427 603 318],234,5,5936,3.6846679081315954,40.0,20.0
31611,3,1611,[173 132 125 172 121],815,4,5940,3.684863523573201,0.0,0.0
31612,3,1612,[238 135  64  28 328],271,4,5944,3.685058896466212,0.0,0.0
31613,3,1613,[ 15   1  11 294 183],537,0,5944,3.6827757125154896,0.0,0.0
31614,3,1614,[127  64 427 603 318],664,5,5949,3.68359133126935,40.0,20.0
31615,3,1615,[195 181  96  11  71],882,5,5954,3.6844059405940595,0.0,0.0
31616,3,1616,[385 174  64 185 288],474,4,5958,3.684601113172542,0.0,20.0
31617,3,1617,[127  64 427 603 318],90,5,5963,3.685414091470952,40.0,20.0
31618,3,1618,[403 471 168 265 181],234,0,5963,3.6831377393452747,0.0,0.0
31619,3,1619,[127  64 427 603 318],59,5,5968,3.6839506172839505,40.0,20.0
31620,3,1620,[127  64 427 603 318],271,5,5973,3.6847624922887108,40.0,20.0
31621,3,1621,[127  64 427 603 318],13,4,5977,3.684956843403206,40.0,20.0
31622,3,1622,[127  64 603 427 318],234,5,5982,3.6857670979667283,40.0,20.0
31623,3,1623,[127 603  64 427 318],313,5,5987,3.686576354679803,40.0,20.0
31624,3,1624,[127 603  64 427 318],7,5,5992,3.6873846153846155,40.0,20.0
31625,3,1625,[186 117 185  97  70],194,2,5994,3.6863468634686347,0.0,0.0
31626,3,1626,[127 603  64 427 318],452,5,5999,3.6871542716656425,40.0,20.0
31627,3,1627,[127 603  64 427 318],452,5,6004,3.687960687960688,40.0,20.0
31628,3,1628,[143 172 403 151 385],533,3,6007,3.687538367096378,0.0,0.0
31629,3,1629,[127 603  64 427 318],537,4,6011,3.687730061349693,40.0,20.0
31630,3,1630,[200 210 588  98 187],308,4,6015,3.6879215205395464,0.0,20.0
31631,3,1631,[ 97  15 168 228  98],850,4,6019,3.688112745098039,0.0,20.0
31632,3,1632,[127 603 427  64 318],537,4,6023,3.6883037354562154,40.0,20.0
31633,3,1633,[276  98   9 196 191],271,4,6027,3.6884944920440637,0.0,20.0
31634,3,1634,[211 286  89 597 216],7,4,6031,3.68868501529052,0.0,0.0
31635,3,1635,[318 405  70  11  97],82,4,6035,3.6888753056234718,20.0,0.0
31636,3,1636,[322  12 187  22 211],90,5,6040,3.689676237018937,20.0,0.0
31637,3,1637,[187 216 180 210 186],13,3,6043,3.6892551892551895,0.0,0.0
31638,3,1638,[210 405 357  64 186],774,0,6043,3.6870042708968884,20.0,0.0
31639,3,1639,[ 79  96 568 127 357],749,5,6048,3.6878048780487807,20.0,20.0
31640,3,1640,[174 153  97 185 328],90,4,6052,3.6879951249238268,0.0,20.0
31641,3,1641,[121 333 111 197 597],13,3,6055,3.6875761266747866,0.0,0.0
31642,3,1642,[127 603 427  64 318],313,5,6060,3.688374923919659,40.0,20.0
31643,3,1643,[161 258 197 237 182],271,2,6062,3.687347931873479,0.0,0.0
31644,3,1644,[ 28  97 403 118 211],543,3,6065,3.68693009118541,0.0,0.0
31645,3,1645,[ 11 427  56 183  28],328,3,6068,3.686512758201701,0.0,0.0
31646,3,1646,[127 603 427  64 318],686,5,6073,3.687310261080753,40.0,20.0
31647,3,1647,[127 603 427  64 318],666,5,6078,3.688106796116505,40.0,20.0
31648,3,1648,[127 603 427  64 318],458,5,6083,3.6889023650697395,40.0,20.0
31649,3,1649,[127 603 427  64 318],308,5,6088,3.6896969696969695,40.0,20.0
31650,3,1650,[127 603 427  64 318],686,5,6093,3.6904906117504543,40.0,20.0
31651,3,1651,[127 603 427  64 318],537,4,6097,3.690677966101695,40.0,20.0
31652,3,1652,[179  69 546 185 403],13,1,6098,3.689050211736237,0.0,0.0
31653,3,1653,[127 603 427  64 318],666,5,6103,3.6898428053204353,40.0,20.0
31654,3,1654,[508  12  79 100 273],524,3,6106,3.6894259818731117,20.0,20.0
31655,3,1655,[127 603 427  64 318],527,3,6109,3.689009661835749,40.0,20.0
31656,3,1656,[127 603 427  64 318],533,5,6114,3.6898008449004225,40.0,20.0
31657,3,1657,[127 603 427  64 318],458,5,6119,3.6905910735826297,40.0,20.0
31658,3,1658,[265 222 121 216  64],82,4,6123,3.690777576853526,0.0,0.0
31659,3,1659,[127 603 427  64 318],527,3,6126,3.6903614457831324,40.0,20.0
31660,3,1660,[403 265  22 168  12],13,4,6130,3.6905478627332933,20.0,0.0
31661,3,1661,[ 79 238  70 151 181],279,2,6132,3.6895306859205776,0.0,0.0
31662,3,1662,[127 603 427  64 318],308,5,6137,3.6903187011425134,40.0,20.0
31663,3,1663,[ 89 181   8 196 172],479,5,6142,3.691105769230769,0.0,0.0
31664,3,1664,[127 603 427  64 318],537,4,6146,3.691291291291291,40.0,20.0
31665,3,1665,[176 182 200 427 273],7,3,6149,3.6908763505402162,0.0,0.0
31666,3,1666,[127 603 427  64 318],313,5,6154,3.691661667666467,40.0,20.0
31667,3,1667,[127 603 427  64 318],458,5,6159,3.6924460431654675,40.0,20.0
31668,3,1668,[127 603 427  64 318],271,5,6164,3.693229478729778,40.0,20.0
31669,3,1669,[185 118 216 172 127],271,3,6167,3.692814371257485,0.0,20.0
31670,3,1670,[302 210 185  96 118],454,4,6171,3.6929982046678638,0.0,0.0
31671,3,1671,[237 175 135 197 182],194,1,6172,3.6913875598086126,0.0,0.0
31672,3,1672,[245 568 143  88 742],749,5,6177,3.6921697549312613,0.0,0.0
31673,3,1673,[127 603 427  64 318],527,3,6180,3.6917562724014337,40.0,20.0
31674,3,1674,[  4 127 302 183 328],102,1,6181,3.6901492537313434,0.0,20.0
31675,3,1675,[496 742 186 302 172],378,3,6184,3.6897374701670644,0.0,0.0
31676,3,1676,[127 603 427  64 318],271,5,6189,3.690518783542039,40.0,20.0
31677,3,1677,[ 98 117 161 515  15],455,3,6192,3.6901072705601905,0.0,20.0
31678,3,1678,[127 603 427  64 318],234,5,6197,3.6908874329958308,40.0,20.0
31679,3,1679,[172 176 151 215  50],42,4,6201,3.6910714285714286,0.0,20.0
31680,3,1680,[127 603 427  64 318],7,5,6206,3.6918500892325996,40.0,20.0
31681,3,1681,[200 300 568 318   7],774,0,6206,3.689655172413793,20.0,0.0
31682,3,1682,[181 191   8 322 748],311,5,6211,3.6904337492572785,0.0,0.0
31683,3,1683,[603 210 127 268  50],537,4,6215,3.6906175771971497,20.0,40.0
31684,3,1684,[ 97 186 300 153 204],7,5,6220,3.691394658753709,0.0,0.0
31685,3,1685,[ 69 181 117 186 202],899,3,6223,3.690984578884935,0.0,0.0
31686,3,1686,[ 22  96 195 183  98],95,5,6228,3.6917605216360405,0.0,20.0
31687,3,1687,[127 603 427  64 318],234,5,6233,3.6925355450236967,40.0,20.0
31688,3,1688,[174 294 508 568  97],13,2,6235,3.6915334517465954,0.0,20.0
31689,3,1689,[127 603 427  64 318],474,5,6240,3.6923076923076925,40.0,20.0
31690,3,1690,[127 603 427  64 318],313,5,6245,3.693081017149616,40.0,20.0
31691,3,1691,[127 603 427  64 318],666,5,6250,3.693853427895981,40.0,20.0
31692,3,1692,[655 215   4 588 333],387,0,6250,3.691671588895452,0.0,0.0
31693,3,1693,[127 603 427  64 318],666,5,6255,3.692443919716647,40.0,20.0
31694,3,1694,[ 97 515 496  71  79],184,3,6258,3.6920353982300886,0.0,0.0
31695,3,1695,[127 603 427  64 318],234,5,6263,3.692806603773585,40.0,20.0
31696,3,1696,[153  50 423 195 496],648,5,6268,3.6935769004124928,0.0,20.0
31697,3,1697,[127 603 427  64 318],271,5,6273,3.6943462897526502,40.0,20.0
31698,3,1698,[237 423  98 546 172],749,3,6276,3.693937610359035,0.0,20.0
31699,3,1699,[127 603 427  64 318],533,5,6281,3.6947058823529413,40.0,20.0
31700,3,1700,[135 275  25 748 568],882,4,6285,3.694885361552028,0.0,0.0
31701,3,1701,[127 603 427  64 318],664,5,6290,3.6956521739130435,40.0,20.0
31702,3,1702,[546 235  15 185 405],194,2,6292,3.6946564885496183,0.0,0.0
31703,3,1703,[125  28 179 475 100],92,4,6296,3.6948356807511735,0.0,20.0
31704,3,1704,[194 496 161 100 186],387,1,6297,3.6932551319648095,0.0,20.0
31705,3,1705,[222 216 271 215 200],92,2,6299,3.6922626025791323,0.0,0.0
31706,3,1706,[211  25 515  82 237],95,1,6300,3.6906854130052724,0.0,0.0
31707,3,1707,[127 603 427  64 318],7,5,6305,3.6914519906323187,40.0,20.0
31708,3,1708,[127 603 427  64 318],13,4,6309,3.6916325336454068,40.0,20.0
31709,3,1709,[127 603 427  64 318],91,5,6314,3.6923976608187132,40.0,20.0
31710,3,1710,[210 100 204 265  56],653,5,6319,3.6931618936294566,0.0,20.0
31711,3,1711,[427 222 204 483 597],328,1,6320,3.691588785046729,20.0,0.0
31712,3,1712,[234 195  88 288 328],479,4,6324,3.691768826619965,0.0,0.0
31713,3,1713,[603 127 427  64 318],313,5,6329,3.692532088681447,40.0,20.0
31714,3,1714,[181  64 174 228 186],215,5,6334,3.6932944606413995,0.0,20.0
31715,3,1715,[100 423  15 302 176],271,3,6337,3.6928904428904428,0.0,20.0
31716,3,1716,[742 132 333 100 127],881,4,6341,3.6930693069306932,0.0,40.0
31717,3,1717,[603 127 427  64 318],271,5,6346,3.6938300349243307,40.0,20.0
31718,3,1718,[215 204 173 603 289],524,2,6348,3.6928446771378707,20.0,0.0
31719,3,1719,[ 97 276 435 127 282],298,4,6352,3.6930232558139533,0.0,20.0
31720,3,1720,[127 603 427  64 318],7,5,6357,3.693782684485764,40.0,20.0
31721,3,1721,[191 655  11  98 238],64,5,6362,3.694541231126597,0.0,20.0
31722,3,1722,[ 11 423  22  96 546],653,2,6364,3.693557748113755,0.0,0.0
31723,3,1723,[127 603 427  64 318],452,5,6369,3.6943155452436196,40.0,20.0
31724,3,1724,[176 173 423 200 357],387,3,6372,3.6939130434782608,20.0,0.0
31725,3,1725,[202 234  28 546   8],774,1,6373,3.6923522595596756,0.0,0.0
31726,3,1726,[125  56 172 289  25],378,4,6377,3.692530399536769,0.0,0.0
31727,3,1727,[132 515 179 204 181],311,4,6381,3.6927083333333335,0.0,0.0
31728,3,1728,[127 603 427  64 318],666,5,6386,3.6934644303065354,40.0,20.0
31729,3,1729,[ 64 273  22 181 427],59,4,6390,3.69364161849711,0.0,0.0
31730,3,1730,[127 603 427  64 318],313,5,6395,3.6943963027151936,40.0,20.0
31731,3,1731,[127 603 427  64 318],13,4,6399,3.6945727482678983,40.0,20.0
31732,3,1732,[ 79 195 597 323 215],650,1,6400,3.693017888055395,0.0,0.0
31733,3,1733,[127 603 427  64 318],474,5,6405,3.6937716262975777,40.0,20.0
31734,3,1734,[127 603 427  64 318],7,5,6410,3.6945244956772334,40.0,20.0
31735,3,1735,[127 603 427  64 318],91,5,6415,3.6952764976958523,40.0,20.0
31736,3,1736,[161 185   4  82 265],194,4,6419,3.6954519286125502,0.0,0.0
31737,3,1737,[127 603 427  64 318],452,5,6424,3.6962025316455698,40.0,20.0
31738,3,1738,[127 603 427  64 318],326,4,6428,3.696377228292122,40.0,20.0
31739,3,1739,[195 127 176 151 427],474,4,6432,3.696551724137931,0.0,20.0
31740,3,1740,[275 174  88 210 215],311,5,6437,3.697300402067777,0.0,20.0
31741,3,1741,[748 288 183 328 222],804,4,6441,3.6974741676234215,0.0,0.0
31742,3,1742,[515 301 258 144 187],102,1,6442,3.695926563396443,0.0,0.0
31743,3,1743,[144 300 174 288 294],102,1,6443,3.694380733944954,0.0,20.0
31744,3,1744,[111  97 597 121  79],95,4,6447,3.6945558739255016,0.0,0.0
31745,3,1745,[127 603 427  64 318],13,4,6451,3.6947308132875145,40.0,20.0
31746,3,1746,[194 275 318 132 483],474,4,6455,3.694905552375501,40.0,0.0
31747,3,1747,[245 257  71 508  69],455,3,6458,3.694508009153318,0.0,0.0
31748,3,1748,[127 603 427  64 318],664,5,6463,3.695254431103488,40.0,20.0
31749,3,1749,[127 603 427  64 318],234,5,6468,3.696,40.0,20.0
31750,3,1750,[301 195  50 289 385],328,2,6470,3.6950314106225015,0.0,20.0
31751,3,1751,[168 202  69 238 153],883,4,6474,3.6952054794520546,0.0,0.0
31752,3,1752,[176   7 318   9  82],343,5,6479,3.6959498003422704,20.0,0.0
31753,3,1753,[127 603 427  64 318],686,5,6484,3.6966932725199544,40.0,20.0
31754,3,1754,[127 603 427  64 318],271,5,6489,3.6974358974358976,40.0,20.0
31755,3,1755,[257 258 125 175 180],92,4,6493,3.697608200455581,0.0,0.0
31756,3,1756,[222 257 153 323 132],290,2,6495,3.6966420034149117,0.0,0.0
31757,3,1757,[127 603 427  64 318],308,5,6500,3.697383390216155,40.0,20.0
31758,3,1758,[174 294 496 276 143],538,2,6502,3.6964184195565664,0.0,20.0
31759,3,1759,[191   7  12 288  96],892,5,6507,3.697159090909091,20.0,0.0
31760,3,1760,[385 181 172 202 282],92,4,6511,3.6973310618966497,0.0,0.0
31761,3,1761,[603 127 427  64 318],91,5,6516,3.6980703745743475,40.0,20.0
31762,3,1762,[186 195 210  25 196],474,5,6521,3.6988088485536017,0.0,0.0
31763,3,1763,[117  15  97 678 257],455,2,6523,3.697845804988662,0.0,0.0
31764,3,1764,[121 196 268   4 168],13,5,6528,3.6985835694050992,0.0,0.0
31765,3,1765,[423 183 235  89 144],339,2,6530,3.69762174405436,0.0,0.0
31766,3,1766,[603 127 427  64 318],7,5,6535,3.6983588002263725,40.0,20.0
31767,3,1767,[ 69 180 597   8 282],899,2,6537,3.697398190045249,0.0,0.0
31768,3,1768,[ 71 269 132  50 183],378,5,6542,3.698134539287733,0.0,20.0
31769,3,1769,[742  15 174  89 135],290,3,6545,3.6977401129943503,0.0,20.0
31770,3,1770,[603 127 427  64 318],533,5,6550,3.6984754376058726,40.0,20.0
31771,3,1771,[151 195 678 135 174],213,5,6555,3.69920993227991,0.0,20.0
31772,3,1772,[603 127 427  64 318],271,5,6560,3.699943598420756,40.0,20.0
31773,3,1773,[597 655 144  69 186],643,3,6563,3.6995490417136416,0.0,0.0
31774,3,1774,[603 127 427  64 318],686,5,6568,3.7002816901408453,40.0,20.0
31775,3,1775,[235 483 191   4  89],406,4,6572,3.7004504504504503,20.0,0.0
31776,3,1776,[603 127 427  64 318],59,5,6577,3.7011817670230727,40.0,20.0
31777,3,1777,[176 286   7  56 234],339,5,6582,3.701912260967379,0.0,0.0
31778,3,1778,[185  70 196 333  11],537,2,6584,3.700955593029792,0.0,0.0
31779,3,1779,[603 127 427  64 318],7,5,6589,3.701685393258427,40.0,20.0
31780,3,1780,[173 235 175 286 118],524,3,6592,3.701291409320606,0.0,0.0
31781,3,1781,[603 127 427  64 318],313,5,6597,3.702020202020202,40.0,20.0
31782,3,1782,[603 127 427  64 318],271,5,6602,3.7027481772293886,40.0,20.0
31783,3,1783,[403 748 172 183 173],749,4,6606,3.7029147982062782,0.0,0.0
31784,3,1784,[603 127 427  64 318],313,5,6611,3.703641456582633,40.0,20.0
31785,3,1785,[ 79 508  12 289 288],387,3,6614,3.7032474804031357,20.0,0.0
31786,3,1786,[385  79 258 301 100],85,2,6616,3.70229434806939,0.0,20.0
31787,3,1787,[153 210  95 265 181],234,0,6616,3.7002237136465324,0.0,0.0
31788,3,1788,[603 127 427  64 318],91,5,6621,3.7009502515371717,40.0,20.0
31789,3,1789,[ 82  98  71 385  22],804,5,6626,3.701675977653631,0.0,20.0
31790,3,1790,[185 183  64 403   1],653,2,6628,3.7007258514796204,0.0,0.0
31791,3,1791,[333 210 132 245 435],313,4,6632,3.700892857142857,0.0,0.0
31792,3,1792,[603 127 427  64 318],664,5,6637,3.701617401003904,40.0,20.0
31793,3,1793,[603 168 176  95 385],59,4,6641,3.701783723522854,20.0,0.0
31794,3,1794,[603 127 427  64 318],474,5,6646,3.702506963788301,40.0,20.0
31795,3,1795,[121 186  22 183 216],339,3,6649,3.7021158129175946,0.0,0.0
31796,3,1796,[603 127 427  64 318],666,5,6654,3.702838063439065,40.0,20.0
31797,3,1797,[132 288 204 195   8],213,4,6658,3.703003337041157,0.0,0.0
31798,3,1798,[222 191 427  71 153],312,3,6661,3.7026125625347417,0.0,0.0
31799,3,1799,[132 204 678  28 144],13,4,6665,3.702777777777778,0.0,0.0
31800,3,1800,[603 127 427  64 318],537,4,6669,3.7029428095502497,40.0,20.0
31801,3,1801,[603 127 427  64 318],91,5,6674,3.7036625971143176,40.0,20.0
31802,3,1802,[603 127 427  64 318],666,5,6679,3.704381586245147,40.0,20.0
31803,3,1803,[496  96  69 143 202],90,3,6682,3.703991130820399,0.0,0.0
31804,3,1804,[603 127 427  64 318],686,5,6687,3.7047091412742383,40.0,20.0
31805,3,1805,[204 176 271 328 237],334,2,6689,3.703765227021041,0.0,0.0
31806,3,1806,[403 153  98 174 301],788,1,6690,3.7022689540675153,0.0,40.0
31807,3,1807,[603 127 427  64 318],533,5,6695,3.702986725663717,40.0,20.0
31808,3,1808,[179 196 183 174  79],379,5,6700,3.7037037037037037,0.0,20.0
31809,3,1809,[  8  89 176  79  98],328,4,6704,3.7038674033149173,0.0,20.0
31810,3,1810,[603 127 427  64 318],537,4,6708,3.7040309221424628,40.0,20.0
31811,3,1811,[258 546 385 200 238],92,3,6711,3.7036423841059603,0.0,0.0
31812,3,1812,[179 423 288 135 186],897,3,6714,3.703254274682846,0.0,0.0
31813,3,1813,[603 127 427  64 318],91,5,6719,3.7039691289966923,40.0,20.0
31814,3,1814,[257 143 568 168 235],308,4,6723,3.7041322314049587,0.0,0.0
31815,3,1815,[121  88   8 153  64],378,5,6728,3.7048458149779737,0.0,0.0
31816,3,1816,[289 182 300 195 597],378,3,6731,3.704457897633462,0.0,0.0
31817,3,1817,[603 127 427  64 318],91,5,6736,3.7051705170517053,40.0,20.0
31818,3,1818,[121 357 135 475 289],82,2,6738,3.7042330951072016,20.0,0.0
31819,3,1819,[211   7  64 597 546],279,3,6741,3.703846153846154,0.0,0.0
31820,3,1820,[748  79  12 187 143],13,3,6744,3.7034596375617794,20.0,0.0
31821,3,1821,[603 127 427  64 318],234,5,6749,3.70417124039517,40.0,20.0
31822,3,1822,[435   9 181 161 655],59,4,6753,3.7043335161821176,0.0,0.0
31823,3,1823,[603 127 427  64 318],533,5,6758,3.705043859649123,40.0,20.0
31824,3,1824,[588 328 135 405 172],85,2,6760,3.7041095890410958,0.0,0.0
31825,3,1825,[121   4  56 546 215],533,2,6762,3.7031763417305585,0.0,0.0
31826,3,1826,[ 98 435 132 202 385],308,3,6765,3.702791461412151,0.0,20.0
31827,3,1827,[127 435 483 216  50],234,3,6768,3.702407002188184,20.0,40.0
31828,3,1828,[603 127 427  64 318],13,4,6772,3.702569710224166,40.0,20.0
31829,3,1829,[ 25 222 216 258 269],537,1,6773,3.7010928961748633,0.0,0.0
31830,3,1830,[161  89 678 100 121],474,4,6777,3.7012561441835063,0.0,20.0
31831,3,1831,[423 200 176 234 318],271,4,6781,3.701419213973799,20.0,0.0
31832,3,1832,[288 385 508 132  89],92,3,6784,3.701036552100382,0.0,0.0
31833,3,1833,[603 127 427  64 318],474,5,6789,3.701744820065431,40.0,20.0
31834,3,1834,[237  82 742  79 313],207,4,6793,3.701907356948229,0.0,0.0
31835,3,1835,[168 427 143 265 435],650,5,6798,3.7026143790849675,0.0,0.0
31836,3,1836,[603 127 427  64 318],326,4,6802,3.702776265650517,40.0,20.0
31837,3,1837,[ 96 269  22  98   4],455,4,6806,3.702937976060936,0.0,20.0
31838,3,1838,[125 204 423 357 435],298,4,6810,3.703099510603589,20.0,0.0
31839,3,1839,[603 127 427  64 318],664,5,6815,3.703804347826087,40.0,20.0
31840,3,1840,[603 127 427  64 318],59,5,6820,3.7045084193373166,40.0,20.0
31841,3,1841,[ 22 655  97 118 127],738,2,6822,3.7035830618892507,0.0,20.0
31842,3,1842,[603 127 427  64 318],271,5,6827,3.7042864894194247,40.0,20.0
31843,3,1843,[603 127 427  64 318],234,5,6832,3.704989154013015,40.0,20.0
31844,3,1844,[271 183 174 151 210],536,2,6834,3.7040650406504065,0.0,20.0
31845,3,1845,[603 127 427  64 318],90,5,6839,3.7047670639219934,40.0,20.0
31846,3,1846,[ 97 181 200 127 151],890,5,6844,3.705468327016784,0.0,20.0
31847,3,1847,[603 127 427  64 318],13,4,6848,3.705627705627706,40.0,20.0
31848,3,1848,[603 127 427  64 318],90,5,6853,3.706327744726879,40.0,20.0
31849,3,1849,[237   8 143 194  11],90,5,6858,3.707027027027027,0.0,0.0
31850,3,1850,[215 282 216 197 435],804,4,6862,3.7071853052404107,0.0,0.0
31851,3,1851,[603 127 427  64 318],91,5,6867,3.7078833693304536,40.0,20.0
31852,3,1852,[111   4 121  50 357],13,4,6871,3.708041014570966,20.0,20.0
31853,3,1853,[153 172 423 173 168],97,4,6875,3.708198489751888,0.0,0.0
31854,3,1854,[197 118 235 405 357],59,3,6878,3.7078167115902967,20.0,0.0
31855,3,1855,[ 28   9  11 151 174],788,2,6880,3.706896551724138,0.0,20.0
31856,3,1856,[176 172 427  98  95],234,2,6882,3.7059773828756057,0.0,20.0
31857,3,1857,[603 127 427  64 318],7,5,6887,3.706673842841765,40.0,20.0
31858,3,1858,[228 125   9 288 222],374,4,6891,3.706831629908553,0.0,0.0
31859,3,1859,[603 127 427  64 318],686,5,6896,3.70752688172043,40.0,20.0
31860,3,1860,[187 117 100 237 508],184,4,6900,3.707684040838259,0.0,20.0
31861,3,1861,[ 64   9 215  12  69],194,4,6904,3.707841031149302,20.0,0.0
31862,3,1862,[603 127 427  64 318],90,5,6909,3.7085346215781,40.0,20.0
31863,3,1863,[603 127 427  64 318],234,5,6914,3.709227467811159,40.0,20.0
31864,3,1864,[222 176 182  56 118],533,2,6916,3.7083109919571045,0.0,0.0
31865,3,1865,[603 127 427  64 318],474,5,6921,3.7090032154340835,40.0,20.0
31866,3,1866,[ 64 172  11 275 245],119,5,6926,3.7096946973754688,0.0,0.0
31867,3,1867,[603 127 427  64 318],271,5,6931,3.7103854389721627,40.0,20.0
31868,3,1868,[ 11 176 204 215 357],271,4,6935,3.7105403959336543,20.0,0.0
31869,3,1869,[ 11 313  88 187 301],537,2,6937,3.7096256684491977,0.0,0.0
31870,3,1870,[603 127 427  64 318],527,3,6940,3.709246392303581,40.0,20.0
31871,3,1871,[282 258 132 143 111],533,5,6945,3.7099358974358974,0.0,0.0
31872,3,1872,[603 127 427  64 318],90,5,6950,3.7106246663107316,40.0,20.0
31873,3,1873,[301 483  22 258  79],788,4,6954,3.710779082177161,20.0,0.0
31874,3,1874,[144  56  69  70 405],328,5,6959,3.7114666666666665,0.0,0.0
31875,3,1875,[603 127 427  64 318],527,3,6962,3.711087420042644,40.0,20.0
31876,3,1876,[427  89 200 322 174],537,2,6964,3.7101758124667024,0.0,20.0
31877,3,1877,[496 135 435  79 210],385,0,6964,3.708200212992545,0.0,0.0
31878,3,1878,[183 588 168  95 151],537,1,6965,3.7067589143161257,0.0,0.0
31879,3,1879,[603 127 427  64 318],308,5,6970,3.7074468085106385,40.0,20.0
31880,3,1880,[172 588 216 204  28],7,5,6975,3.708133971291866,0.0,0.0
31881,3,1881,[286 568 435 597 258],788,2,6977,3.7072263549415516,0.0,0.0
31882,3,1882,[603 127 427  64 318],527,3,6980,3.706850770047796,40.0,20.0
31883,3,1883,[603 127 427  64 318],59,5,6985,3.7075371549893843,40.0,20.0
31884,3,1884,[258  50   8  89 496],454,4,6989,3.707692307692308,0.0,20.0
31885,3,1885,[ 28 121  82 196 268],119,4,6993,3.707847295864263,0.0,0.0
31886,3,1886,[100  64 294 151 405],374,3,6996,3.707472178060413,0.0,20.0
31887,3,1887,[603 127 427  64 318],13,4,7000,3.707627118644068,40.0,20.0
31888,3,1888,[ 22 302 238   1  97],380,3,7003,3.7072525145579673,0.0,0.0
31889,3,1889,[603 127 427  64 318],13,4,7007,3.7074074074074073,40.0,20.0
31890,3,1890,[603 127 427  64 318],458,5,7012,3.708090957165521,40.0,20.0
31891,3,1891,[175 132  11 194 289],90,3,7015,3.7077167019027484,0.0,0.0
31892,3,1892,[ 70 194 357  15 175],653,1,7016,3.706286318013735,20.0,0.0
31893,3,1893,[603 127 427  64 318],13,4,7020,3.706441393875396,40.0,20.0
31894,3,1894,[603 127 427  64 318],458,5,7025,3.70712401055409,40.0,20.0
31895,3,1895,[ 11 186 185 471 181],271,3,7028,3.7067510548523206,0.0,0.0
31896,3,1896,[161 483 125 179 210],334,2,7030,3.705851344227728,20.0,0.0
31897,3,1897,[603 127 427  64 318],666,5,7035,3.706533192834563,40.0,20.0
31898,3,1898,[210 144 200 405 185],60,5,7040,3.7072143233280674,0.0,0.0
31899,3,1899,[603 127 427  64 318],686,5,7045,3.707894736842105,40.0,20.0
31900,3,1900,[603 127 427  64 318],533,5,7050,3.7085744345081535,40.0,20.0
31901,3,1901,[603 127 427  64 318],90,5,7055,3.7092534174553102,40.0,20.0
31902,3,1902,[ 11 588   1 211 181],102,1,7056,3.7078297425118234,0.0,0.0
31903,3,1903,[ 95  64 176 100 183],64,5,7061,3.7085084033613445,0.0,20.0
31904,3,1904,[603 127 427  64 318],452,5,7066,3.7091863517060366,40.0,20.0
31905,3,1905,[180 132 282 121 275],311,5,7071,3.7098635886673663,0.0,0.0
31906,3,1906,[289 471 496 197 172],533,4,7075,3.7100157315154694,0.0,0.0
31907,3,1907,[ 98 234 210 143 151],406,3,7078,3.709643605870021,0.0,20.0
31908,3,1908,[ 50 323 100 211 185],59,5,7083,3.710319539025668,0.0,40.0
31909,3,1909,[471 228 234   4 235],194,1,7084,3.7089005235602093,0.0,0.0
31910,3,1910,[603 127 427  64 318],308,5,7089,3.709576138147567,40.0,20.0
31911,3,1911,[176 265 187 385  22],774,1,7090,3.7081589958158996,0.0,0.0
31912,3,1912,[496  28 197 748  12],533,4,7094,3.7083115525352848,20.0,0.0
31913,3,1913,[603 127 427  64 318],686,5,7099,3.7089864158829675,40.0,20.0
31914,3,1914,[603 127 427  64 318],59,5,7104,3.7096605744125326,40.0,20.0
31915,3,1915,[603 127 427  64 318],527,3,7107,3.7092901878914404,40.0,20.0
31916,3,1916,[210 496 168  25 172],295,5,7112,3.709963484611372,0.0,0.0
31917,3,1917,[ 56 172  15 257 127],749,3,7115,3.7095933263816474,0.0,20.0
31918,3,1918,[603 127 427  64 318],537,4,7119,3.709744658676394,40.0,20.0
31919,3,1919,[603 127 427  64 318],13,4,7123,3.7098958333333334,40.0,20.0
31920,3,1920,[603 127 427  64 191],313,5,7128,3.71056741280583,20.0,20.0
31921,3,1921,[603 127 427  64 191],666,5,7133,3.7112382934443287,20.0,20.0
31922,3,1922,[181  15 275 144 182],308,3,7136,3.7108684347373897,0.0,0.0
31923,3,1923,[603 127 427  64 191],666,5,7141,3.7115384615384617,20.0,20.0
31924,3,1924,[174 173  89 183  95],334,4,7145,3.7116883116883117,0.0,20.0
31925,3,1925,[603 127 427  64 191],398,5,7150,3.7123572170301142,20.0,20.0
31926,3,1926,[603 127 427  64 191],398,5,7155,3.7130254281266217,20.0,20.0
31927,3,1927,[748 200 168 405 174],881,2,7157,3.712136929460581,0.0,20.0
31928,3,1928,[603 127 427  64 191],664,4,7161,3.7122861586314153,20.0,20.0
31929,3,1929,[135  82 211 204 357],537,3,7164,3.711917098445596,20.0,0.0
31930,3,1930,[603 127 427  64 318],537,4,7168,3.71206628689798,40.0,20.0
31931,3,1931,[300 238  56 588 187],64,4,7172,3.712215320910973,0.0,0.0
31932,3,1932,[603 127 427  64 318],59,5,7177,3.7128815312984997,40.0,20.0
31933,3,1933,[ 28  25 423  96 135],398,4,7181,3.713029989658738,0.0,0.0
31934,3,1934,[603 127 427  64 318],308,5,7186,3.7136950904392765,40.0,20.0
31935,3,1935,[111 200 323 179 186],474,3,7189,3.7133264462809916,0.0,0.0
31936,3,1936,[603 127 427  64 318],308,5,7194,3.7139907072792977,40.0,20.0
31937,3,1937,[200 202 173 175  96],648,3,7197,3.7136222910216716,0.0,0.0
31938,3,1938,[475 403 333 204 435],533,3,7200,3.7132542547705003,0.0,0.0
31939,3,1939,[185  12 597  28  96],374,5,7205,3.713917525773196,20.0,0.0
31940,3,1940,[603 127 427  64 318],271,5,7210,3.7145801133436374,40.0,20.0
31941,3,1941,[ 70 322 182 655  64],454,2,7212,3.713697219361483,0.0,0.0
31942,3,1942,[603 127 427  64 318],686,5,7217,3.714359238291302,40.0,20.0
31943,3,1943,[385 172   9  82 175],85,3,7220,3.713991769547325,0.0,0.0
31944,3,1944,[151 276 204 175  15],6,1,7221,3.7125964010282777,0.0,0.0
31945,3,1945,[603 127 427  64 318],686,5,7226,3.7132579650565263,40.0,20.0
31946,3,1946,[143 282 144 318 182],804,4,7230,3.7134052388289676,20.0,0.0
31947,3,1947,[603 127 427  64 318],91,5,7235,3.7140657084188913,40.0,20.0
31948,3,1948,[ 11 151 210 237  98],892,4,7239,3.71421241662391,0.0,20.0
31949,3,1949,[546 153 748 182 322],749,2,7241,3.7133333333333334,0.0,0.0
31950,3,1950,[ 56 435 161 151  64],234,1,7242,3.7119425935417736,0.0,0.0
31951,3,1951,[603 127 427  64 318],7,5,7247,3.7126024590163933,40.0,20.0
31952,3,1952,[237 265 179 194 276],13,4,7251,3.7127496159754223,0.0,0.0
31953,3,1953,[603 127 427  64 318],91,5,7256,3.713408393039918,40.0,20.0
31954,3,1954,[603 127 427  64 318],666,5,7261,3.714066496163683,40.0,20.0
31955,3,1955,[174  88 117 318 228],92,3,7264,3.7137014314928427,20.0,20.0
31956,3,1956,[603 127 427  64 318],686,5,7269,3.7143587123147674,40.0,20.0
31957,3,1957,[179  15 357 234 265],95,2,7271,3.7134831460674156,20.0,0.0
31958,3,1958,[ 22 235   4 202 294],648,3,7274,3.7131189382337926,0.0,0.0
31959,3,1959,[ 64 180 423   4 191],749,5,7279,3.7137755102040817,0.0,0.0
31960,3,1960,[211 588  22 276 333],537,2,7281,3.712901580826109,0.0,0.0
31961,3,1961,[194 423  22 204   4],650,2,7283,3.7120285423037718,0.0,0.0
31962,3,1962,[ 71 748 117 195  22],543,2,7285,3.7111563932755987,0.0,0.0
31963,3,1963,[294 195 196 202  71],650,2,7287,3.710285132382892,0.0,0.0
31964,3,1964,[194  71 385 181 197],524,2,7289,3.70941475826972,0.0,0.0
31965,3,1965,[603 127 427  64 318],313,5,7294,3.7100712105798577,40.0,20.0
31966,3,1966,[603 127 427  64 318],527,3,7297,3.709710218607016,40.0,20.0
31967,3,1967,[603 127 427  64 318],91,5,7302,3.7103658536585367,40.0,20.0
31968,3,1968,[603 127 427  64 318],91,5,7307,3.7110208227526664,40.0,20.0
31969,3,1969,[603 127 427  64 318],666,5,7312,3.7116751269035535,40.0,20.0
31970,3,1970,[603 127 427  64 318],458,5,7317,3.712328767123288,40.0,20.0
31971,3,1971,[603 127 427  64 318],452,5,7322,3.712981744421907,40.0,20.0
31972,3,1972,[603 127 427  64 318],271,5,7327,3.7136340598074,40.0,20.0
31973,3,1973,[180  15 195 161 568],378,3,7330,3.713272543059777,0.0,0.0
31974,3,1974,[435 603 191 132 405],815,4,7334,3.7134177215189874,20.0,0.0
31975,3,1975,[603 127 427  64 318],452,5,7339,3.7140688259109313,40.0,20.0
31976,3,1976,[603 127 427  64 318],308,5,7344,3.714719271623672,40.0,20.0
31977,3,1977,[603 127 427  64 318],666,5,7349,3.7153690596562186,40.0,20.0
31978,3,1978,[603 127 427  64 318],537,4,7353,3.715512885295604,40.0,20.0
31979,3,1979,[ 88 151 222 200 357],313,1,7354,3.714141414141414,20.0,0.0
31980,3,1980,[187  88 185  89 100],308,5,7359,3.7147905098435134,0.0,20.0
31981,3,1981,[172 121 357 135   7],200,5,7364,3.715438950554995,20.0,0.0
31982,3,1982,[ 82 174 211   8 357],882,5,7369,3.7160867372667674,20.0,20.0
31983,3,1983,[603 127 427  64 318],91,5,7374,3.716733870967742,40.0,20.0
31984,3,1984,[603 127 427  64 318],664,5,7379,3.7173803526448363,40.0,20.0
31985,3,1985,[197 111 135 471 204],533,4,7383,3.717522658610272,0.0,0.0
31986,3,1986,[187 173  98 471 186],271,4,7387,3.7176648213387016,0.0,20.0
31987,3,1987,[603 127 427  64 318],326,4,7391,3.7178068410462775,40.0,20.0
31988,3,1988,[183   1 144 385 215],653,2,7393,3.716943187531423,0.0,0.0
31989,3,1989,[143  82 183 215 135],92,3,7396,3.7165829145728644,0.0,0.0
31990,3,1990,[603 127 427  64 318],533,5,7401,3.717227523857358,40.0,20.0
31991,3,1991,[603 127 427  64 318],326,4,7405,3.7173694779116464,40.0,20.0
31992,3,1992,[403 175 183 179 216],653,1,7406,3.716006021073758,0.0,0.0
31993,3,1993,[ 98 194 288 405 258],102,2,7408,3.715145436308927,0.0,20.0
31994,3,1994,[603 127 427  64 318],326,4,7412,3.7152882205513786,40.0,20.0
31995,3,1995,[228  82 172  96   7],328,4,7416,3.715430861723447,0.0,0.0
31996,3,1996,[135 385 318 174 173],804,4,7420,3.71557336004006,20.0,20.0
31997,3,1997,[603 127 427  64 318],533,5,7425,3.7162162162162162,40.0,20.0
31998,3,1998,[179 234  82 257 515],339,5,7430,3.716858429214607,0.0,0.0
31999,3,1999,[603 127 427  64 318],326,4,7434,3.717,40.0,20.0
32000,3,2000,[322 265  25 294 257],804,5,7439,3.717641179410295,0.0,0.0
32001,3,2001,[  1  15  50 175 282],92,4,7443,3.7177822177822177,0.0,20.0
32002,3,2002,[603 127 427  64 318],313,5,7448,3.7184223664503246,40.0,20.0
32003,3,2003,[ 56  96 222 174 153],234,0,7448,3.716566866267465,0.0,20.0
32004,3,2004,[ 28  71 183 357 588],194,4,7452,3.716708229426434,20.0,0.0
32005,3,2005,[179 258 185  79   8],271,3,7455,3.7163509471585243,0.0,0.0
32006,3,2006,[603 127 427  64 318],458,5,7460,3.7169905331340307,40.0,20.0
32007,3,2007,[603 127 427  64 318],664,5,7465,3.7176294820717133,40.0,20.0
32008,3,2008,[118   7 204 215  82],7,3,7468,3.717272274763564,0.0,0.0
32009,3,2009,[603 127 427  64 318],313,5,7473,3.717910447761194,40.0,20.0
32010,3,2010,[ 11 318 234 483 191],804,5,7478,3.7185479860765787,40.0,0.0
32011,3,2011,[603 127 427  64 318],527,3,7481,3.7181908548707754,40.0,20.0
32012,3,2012,[183 161 423 179 180],339,3,7484,3.7178340784898163,0.0,0.0
32013,3,2013,[ 56 202  12 655  71],387,2,7486,3.7169811320754715,20.0,0.0
32014,3,2014,[111 328 127   7 125],294,4,7490,3.7171215880893302,0.0,20.0
32015,3,2015,[603 127 427  64 318],13,4,7494,3.7172619047619047,40.0,20.0
32016,3,2016,[597 655 742 127  70],804,3,7497,3.716906296479921,0.0,20.0
32017,3,2017,[483 237 258 100 427],90,4,7501,3.7170465807730424,20.0,20.0
32018,3,2018,[603 127 427  64 191],669,4,7505,3.717186726102031,20.0,20.0
32019,3,2019,[435 318  82 300 245],666,2,7507,3.7163366336633663,20.0,0.0
32020,3,2020,[318 187 273 121  25],59,4,7511,3.7164769915883227,20.0,0.0
32021,3,2021,[265 238 423 515  82],194,3,7514,3.716122650840752,0.0,0.0
32022,3,2022,[ 25 197 301 546  12],13,2,7516,3.7152743450321304,20.0,0.0
32023,3,2023,[ 95   1  50 117 294],779,5,7521,3.715909090909091,0.0,20.0
32024,3,2024,[603 127 427  64 318],474,5,7526,3.7165432098765434,40.0,20.0
32025,3,2025,[603 127 427  64 318],90,5,7531,3.717176702862784,40.0,20.0
32026,3,2026,[204 195   1 100 179],308,5,7536,3.717809570794277,0.0,20.0
32027,3,2027,[186 435 175 546 483],13,4,7540,3.717948717948718,20.0,0.0
32028,3,2028,[603 127 427  64 318],90,5,7545,3.7185805815672746,40.0,20.0
32029,3,2029,[385 210 197 121 100],313,5,7550,3.7192118226600983,0.0,20.0
32030,3,2030,[196 168 237 174 117],474,4,7554,3.7193500738552436,0.0,20.0
32031,3,2031,[161 180 483 427 195],694,5,7559,3.71998031496063,20.0,0.0
32032,3,2032,[603 127 427  64 318],452,5,7564,3.720609936055091,40.0,20.0
32033,3,2033,[603 127 427  64 318],308,5,7569,3.7212389380530975,40.0,20.0
32034,3,2034,[168 191 187 258 515],234,3,7572,3.7208845208845207,0.0,0.0
32035,3,2035,[603 127 427  64 318],533,5,7577,3.7215127701375246,40.0,20.0
32036,3,2036,[194  11 357 286 265],474,5,7582,3.722140402552774,20.0,0.0
32037,3,2037,[ 96  50 286 294 435],102,1,7583,3.7208047105004907,0.0,20.0
32038,3,2038,[597 483 181 515 403],7,2,7585,3.719960765080922,20.0,0.0
32039,3,2039,[603 127 427  64 318],59,5,7590,3.7205882352941178,40.0,20.0
32040,3,2040,[603 127 427  64 318],666,5,7595,3.7212150906418424,40.0,20.0
32041,3,2041,[603 127 427  64 318],474,5,7600,3.721841332027424,40.0,20.0
32042,3,2042,[603 127 427  64 318],664,5,7605,3.7224669603524227,40.0,20.0
32043,3,2043,[603 127 427  64 318],527,3,7608,3.7221135029354206,40.0,20.0
32044,3,2044,[568  95 228 222 215],92,3,7611,3.721760391198044,0.0,0.0
32045,3,2045,[603 127 427  64 318],7,5,7616,3.7223851417399803,40.0,20.0
32046,3,2046,[427  82 174  97 265],666,2,7618,3.721543722520762,0.0,20.0
32047,3,2047,[ 15  12 118  71  96],378,5,7623,3.72216796875,20.0,0.0
32048,3,2048,[ 56 423 515 204 597],882,5,7628,3.7227916056612984,0.0,0.0
32049,3,2049,[603 127 427  64 318],90,5,7633,3.7234146341463417,40.0,20.0
32050,3,2050,[603 127 427  64 318],452,5,7638,3.7240370550950757,40.0,20.0
32051,3,2051,[603 127 427  64 318],234,5,7643,3.7246588693957117,40.0,20.0
32052,3,2052,[603 127 427  64 318],308,5,7648,3.7252800779347295,40.0,20.0
32053,3,2053,[100 181 135 111 151],59,5,7653,3.725900681596884,0.0,20.0
32054,3,2054,[603 127 427  64 318],13,4,7657,3.726034063260341,40.0,20.0
32055,3,2055,[603 127 427  64 318],13,4,7661,3.7261673151750974,40.0,20.0
32056,3,2056,[143  89 173 194 186],897,4,7665,3.726300437530384,0.0,0.0
32057,3,2057,[222  22 186 427  82],328,3,7668,3.7259475218658893,0.0,0.0
32058,3,2058,[603 127 427  64 318],326,4,7672,3.7260806216610005,40.0,20.0
32059,3,2059,[257 185 357 300  69],271,3,7675,3.7257281553398056,20.0,0.0
32060,3,2060,[ 12  95 294  69 197],308,2,7677,3.7248908296943233,20.0,0.0
32061,3,2061,[603 127 427  64 318],308,5,7682,3.7255092143549953,40.0,20.0
32062,3,2062,[215 168 117 183 228],387,3,7685,3.7251575375666506,0.0,0.0
32063,3,2063,[655 322 168 216 111],474,4,7689,3.7252906976744184,0.0,0.0
32064,3,2064,[603 127 427  64 318],452,5,7694,3.72590799031477,40.0,20.0
32065,3,2065,[288 222   7 168 515],882,4,7698,3.7260406582768635,0.0,0.0
32066,3,2066,[603 127 427  64 318],13,4,7702,3.726173197871311,40.0,20.0
32067,3,2067,[496 405 194 100 187],643,4,7706,3.7263056092843327,0.0,20.0
32068,3,2068,[175 172 186  98 748],524,0,7706,3.72450459159014,0.0,20.0
32069,3,2069,[271 475 118 748  69],92,2,7708,3.723671497584541,0.0,0.0
32070,3,2070,[546  96 117 257 238],881,3,7711,3.723322066634476,0.0,0.0
32071,3,2071,[269 258  64 273 475],90,2,7713,3.7224903474903477,0.0,0.0
32072,3,2072,[603 127 427  64 318],271,5,7718,3.7231066087795464,40.0,20.0
32073,3,2073,[ 88 181 100 180 204],313,4,7722,3.7232401157184185,0.0,20.0
32074,3,2074,[435 385  96 228  11],59,5,7727,3.7238554216867468,0.0,0.0
32075,3,2075,[546 121 271 204 289],13,2,7729,3.723025048169557,0.0,0.0
32076,3,2076,[603 127 427  64 318],313,5,7734,3.723639865190178,40.0,20.0
32077,3,2077,[  1 276  69 132 257],308,3,7737,3.723291626564004,0.0,0.0
32078,3,2078,[603 127 427  64 318],59,5,7742,3.723905723905724,40.0,20.0
32079,3,2079,[603 127 427  64 318],234,5,7747,3.7245192307692307,40.0,20.0
32080,3,2080,[ 98 183 173 568 483],650,4,7751,3.7246516098029794,20.0,20.0
32081,3,2081,[603 127 427  64 318],271,5,7756,3.7252641690682036,40.0,20.0
32082,3,2082,[603 127 427  64 318],7,5,7761,3.725876140182429,40.0,20.0
32083,3,2083,[202 153   9 143 111],374,1,7762,3.724568138195777,0.0,0.0
32084,3,2084,[603 127 427  64 318],59,5,7767,3.725179856115108,40.0,20.0
32085,3,2085,[235  25 200 211 403],648,3,7770,3.7248322147651005,0.0,0.0
32086,3,2086,[603 127 427  64 318],313,5,7775,3.725443219932918,40.0,20.0
32087,3,2087,[301 200 132 300  95],378,3,7778,3.725095785440613,0.0,0.0
32088,3,2088,[210 185 186 211 215],311,2,7780,3.7242699856390615,0.0,0.0
32089,3,2089,[132 357  11 405 678],881,3,7783,3.7239234449760765,20.0,0.0
32090,3,2090,[ 22 603 258 289 322],13,3,7786,3.7235772357723578,20.0,0.0
32091,3,2091,[ 28 127 100 121 288],374,5,7791,3.7241873804971317,0.0,40.0
32092,3,2092,[191 228 210 100  79],295,5,7796,3.7247969421882465,0.0,20.0
32093,3,2093,[603 127 427  64 318],59,5,7801,3.725405921680993,40.0,20.0
32094,3,2094,[357 151 294 172 211],308,4,7805,3.7255369928400954,20.0,0.0
32095,3,2095,[185 182 186 132 179],339,5,7810,3.726145038167939,0.0,0.0
32096,3,2096,[ 28  69 187 603  56],387,4,7814,3.726275631855031,20.0,0.0
32097,3,2097,[ 56 100 655 180 265],343,4,7818,3.726406101048618,0.0,20.0
32098,3,2098,[182 180 185 322   8],13,3,7821,3.7260600285850405,0.0,0.0
32099,3,2099,[515 357  22 496 289],194,4,7825,3.7261904761904763,20.0,0.0
32100,3,2100,[603 127 427  64 318],91,5,7830,3.726796763445978,40.0,20.0
32101,3,2101,[ 82 313 179  96 588],59,4,7834,3.7269267364414844,0.0,0.0
32102,3,2102,[603 127 427  64 318],686,5,7839,3.72753209700428,40.0,20.0
32103,3,2103,[144  95 127 185  22],650,0,7839,3.7257604562737643,0.0,20.0
32104,3,2104,[423 111 179 118  96],92,2,7841,3.724940617577197,0.0,0.0
32105,3,2105,[ 22 678 195 238 204],537,1,7842,3.7236467236467234,0.0,0.0
32106,3,2106,[603 127 427  64 318],90,5,7847,3.7242524916943522,40.0,20.0
32107,3,2107,[603 127 427  64 318],7,5,7852,3.724857685009488,40.0,20.0
32108,3,2108,[603 127 427  64 318],326,4,7856,3.7249881460407774,40.0,20.0
32109,3,2109,[603 127 427  64 318],537,4,7860,3.7251184834123223,40.0,20.0
32110,3,2110,[257 515 282 496 179],899,3,7863,3.7247749881572716,0.0,0.0
32111,3,2111,[603 127 427  64 318],686,5,7868,3.725378787878788,40.0,20.0
32112,3,2112,[603 127 427  64 318],458,5,7873,3.725982016090866,40.0,20.0
32113,3,2113,[117 403 313 179 127],815,2,7875,3.725165562913907,0.0,20.0
32114,3,2114,[603 127 427  64 318],452,5,7880,3.7257683215130024,40.0,20.0
32115,3,2115,[300 603  98  70 257],666,3,7883,3.7254253308128544,20.0,20.0
32116,3,2116,[603 127 427  64 318],234,5,7888,3.7260273972602738,40.0,20.0
32117,3,2117,[603 127 427  64 318],91,5,7893,3.726628895184136,40.0,20.0
32118,3,2118,[300 475 222 176 215],13,1,7894,3.7253421425200566,0.0,0.0
32119,3,2119,[603 127 427  64 318],7,5,7899,3.7259433962264152,40.0,20.0
32120,3,2120,[603 127 427  64 318],664,5,7904,3.7265440829797267,40.0,20.0
32121,3,2121,[603 127 427  64 318],666,5,7909,3.7271442035815268,40.0,20.0
32122,3,2122,[  9 200 168  71 216],60,4,7913,3.727272727272727,0.0,0.0
32123,3,2123,[275 294 204 435 175],158,4,7917,3.727401129943503,0.0,0.0
32124,3,2124,[603 127 427  64 318],666,5,7922,3.728,40.0,20.0
32125,3,2125,[125 268  28 328 196],119,5,7927,3.72859830667921,0.0,0.0
32126,3,2126,[ 96 234   1 288  97],533,2,7929,3.7277856135401977,0.0,0.0
32127,3,2127,[182 286 180 135 294],378,2,7931,3.726973684210526,0.0,0.0
32128,3,2128,[603 127 427  64 318],308,5,7936,3.72757162987318,40.0,20.0
32129,3,2129,[603 127 427  64 318],313,5,7941,3.728169014084507,40.0,20.0
32130,3,2130,[185 268 183 483  82],643,4,7945,3.728296574378226,20.0,0.0
32131,3,2131,[174 301 210 211 257],279,5,7950,3.7288930581613506,0.0,20.0
32132,3,2132,[273   8 153  12 180],234,1,7951,3.727613689639006,20.0,0.0
32133,3,2133,[301 276  25 265   4],234,1,7952,3.726335520149953,0.0,0.0
32134,3,2134,[ 64 179  56 100 143],458,5,7957,3.7269320843091336,0.0,20.0
32135,3,2135,[603 127 427  64 318],7,5,7962,3.7275280898876404,40.0,20.0
32136,3,2136,[603 127 427  64 318],686,5,7967,3.7281235376696302,40.0,20.0
32137,3,2137,[196   8  98 181  95],406,4,7971,3.7282507015902713,0.0,20.0
32138,3,2138,[153  11 151 597  97],7,3,7974,3.7279102384291725,0.0,0.0
32139,3,2139,[603 127 427  64 318],458,5,7979,3.7285046728971962,40.0,20.0
32140,3,2140,[204  79 288 385  22],455,3,7982,3.7281644091546005,0.0,0.0
32141,3,2141,[603 127 427  64 318],452,5,7987,3.7287581699346406,40.0,20.0
32142,3,2142,[153 403 748 204 135],328,0,7987,3.7270181987867477,0.0,0.0
32143,3,2143,[603 127 427  64 318],527,3,7990,3.7266791044776117,40.0,20.0
32144,3,2144,[603 127 427  64 318],308,5,7995,3.727272727272727,40.0,20.0
32145,3,2145,[496 423 282 100 127],533,5,8000,3.7278657968313142,0.0,40.0
32146,3,2146,[603 127 427  64 318],308,5,8005,3.728458313926409,40.0,20.0
32147,3,2147,[603 127 427  64 318],234,5,8010,3.7290502793296088,40.0,20.0
32148,3,2148,[603 405 496 568 174],59,4,8014,3.7291763610981854,20.0,20.0
32149,3,2149,[603 127 427  64 318],452,5,8019,3.729767441860465,40.0,20.0
32150,3,2150,[385  79 405 228 568],7,4,8023,3.729893072989307,0.0,0.0
32151,3,2151,[603 127 427  64 318],13,4,8027,3.7300185873605947,40.0,20.0
32152,3,2152,[603 127 427  64 318],271,5,8032,3.7306084533209476,40.0,20.0
32153,3,2153,[216 294 427 176 403],650,3,8035,3.7302692664809656,0.0,0.0
32154,3,2154,[603 127 427  64 318],664,5,8040,3.730858468677494,40.0,20.0
32155,3,2155,[  4 405 202 515  79],87,5,8045,3.731447124304267,0.0,0.0
32156,3,2156,[603 127 427  64 318],527,3,8048,3.7311080203987017,40.0,20.0
32157,3,2157,[603 127 427  64 318],308,5,8053,3.731696014828545,40.0,20.0
32158,3,2158,[603 127 427  64 318],271,5,8058,3.732283464566929,40.0,20.0
32159,3,2159,[603 127 427  64 318],664,5,8063,3.7328703703703705,40.0,20.0
32160,3,2160,[ 88   1  82 151 132],308,4,8067,3.7329939842665434,0.0,0.0
32161,3,2161,[179 194 678  11  96],13,2,8069,3.7321924144310823,0.0,0.0
32162,3,2162,[ 50 748  71 322  28],13,4,8073,3.7323162274618586,0.0,20.0
32163,3,2163,[202  82 161 328   8],207,1,8074,3.7310536044362292,0.0,0.0
32164,3,2164,[176 135 210 191 742],543,3,8077,3.730715935334873,0.0,0.0
32165,3,2165,[ 12 483  70 200 238],308,4,8081,3.7308402585410896,40.0,0.0
32166,3,2166,[100 258 222 289 183],474,4,8085,3.730964467005076,0.0,20.0
32167,3,2167,[603 127 427  64 318],686,5,8090,3.731549815498155,40.0,20.0
32168,3,2168,[597 121  11 546 245],102,0,8090,3.7298294144767175,0.0,0.0
32169,3,2169,[588 268  95 508 235],13,3,8093,3.7294930875576036,0.0,0.0
32170,3,2170,[385 121 180 204 655],749,3,8096,3.729157070474436,0.0,0.0
32171,3,2171,[603 127 427  64 318],271,5,8101,3.729742173112339,40.0,20.0
32172,3,2172,[111 200   8 300 228],334,3,8104,3.72940635066728,0.0,0.0
32173,3,2173,[603 127 427  64 318],474,5,8109,3.729990800367985,40.0,20.0
32174,3,2174,[168 173 151 181  28],479,5,8114,3.730574712643678,0.0,0.0
32175,3,2175,[603 127 427  64 318],666,5,8119,3.731158088235294,40.0,20.0
32176,3,2176,[655 121 496 742 546],690,3,8122,3.7308222324299494,0.0,0.0
32177,3,2177,[ 50 322  89 118 180],524,5,8127,3.731404958677686,0.0,20.0
32178,3,2178,[135 127 144 288 403],804,1,8128,3.7301514456172558,0.0,20.0
32179,3,2179,[238  71 121  56 161],92,4,8132,3.7302752293577983,0.0,0.0
32180,3,2180,[603 127 427  64 318],271,5,8137,3.730857404860156,40.0,20.0
32181,3,2181,[603 127 427  64 318],59,5,8142,3.7314390467461043,40.0,20.0
32182,3,2182,[603 127 427  64 318],686,5,8147,3.732020155748969,40.0,20.0
32183,3,2183,[603 127 427  64 318],458,5,8152,3.7326007326007327,40.0,20.0
32184,3,2184,[269 186 471 245 234],666,2,8154,3.731807780320366,0.0,0.0
32185,3,2185,[294  97 143  12 194],378,4,8158,3.7319304666056725,20.0,0.0
32186,3,2186,[174  71 273 121 588],892,4,8162,3.732053040695016,0.0,20.0
32187,3,2187,[153  11  70 174 151],378,3,8165,3.7317184643510055,0.0,20.0
32188,3,2188,[258 182  70 357 496],184,4,8169,3.7318410232983097,20.0,0.0
32189,3,2189,[603 127 427  64 318],452,5,8174,3.732420091324201,40.0,20.0
32190,3,2190,[173 211 121  82  96],738,4,8178,3.7325422181652215,0.0,0.0
32191,3,2191,[172 181 204  88 187],538,2,8180,3.7317518248175183,0.0,0.0
32192,3,2192,[ 82 483 172 185 210],815,3,8183,3.731418148654811,20.0,0.0
32193,3,2193,[603 127 427  64 318],666,5,8188,3.731996353691887,40.0,20.0
32194,3,2194,[238   4 176 151 175],406,2,8190,3.7312072892938497,0.0,0.0
32195,3,2195,[603 127 427  64 318],452,5,8195,3.7317850637522767,40.0,20.0
32196,3,2196,[ 15 403 427 202 168],533,4,8199,3.7319071461083295,0.0,0.0
32197,3,2197,[215 176 132  50 181],766,3,8202,3.731574158325751,0.0,20.0
32198,3,2198,[161  96  88 186 191],881,1,8203,3.730331969076853,0.0,0.0
32199,3,2199,[603 127 427  64 318],686,5,8208,3.730909090909091,40.0,20.0
32200,3,2200,[302  82 144 313 275],883,3,8211,3.7305770104497955,0.0,0.0
32201,3,2201,[475 151 161 100  64],932,2,8213,3.7297910990009084,0.0,20.0
32202,3,2202,[603 127 427  64 318],308,5,8218,3.7303676804357693,40.0,20.0
32203,3,2203,[603 127 427  64 318],90,5,8223,3.7309437386569875,40.0,20.0
32204,3,2204,[603 127 427  64 318],533,5,8228,3.731519274376417,40.0,20.0
32205,3,2205,[300 588 121 183 273],7,4,8232,3.731640979147779,0.0,0.0
32206,3,2206,[  9 427  98  96 211],60,5,8237,3.7322156773901223,0.0,20.0
32207,3,2207,[153 289 111 144  28],378,4,8241,3.7323369565217392,0.0,0.0
32208,3,2208,[174 222 180 143  82],882,5,8246,3.732910819375283,0.0,20.0
32209,3,2209,[271  96 161 144   4],749,4,8250,3.733031674208145,0.0,0.0
32210,3,2210,[435   7 273  82 195],102,1,8251,3.731795567616463,0.0,0.0
32211,3,2211,[117 318  64  82 135],454,3,8254,3.7314647377938517,20.0,0.0
32212,3,2212,[200 186 181 318   4],92,3,8257,3.7311342069588793,20.0,0.0
32213,3,2213,[546 405 471  50 678],7,3,8260,3.7308039747064137,0.0,20.0
32214,3,2214,[215 300 276 294  89],537,2,8262,3.7300225733634313,0.0,0.0
32215,3,2215,[603 127 427  64 318],7,5,8267,3.7305956678700363,40.0,20.0
32216,3,2216,[496 176 211  96  11],897,4,8271,3.7307171853856564,0.0,0.0
32217,3,2217,[678  79  64 182  56],881,2,8273,3.729936880072137,0.0,0.0
32218,3,2218,[  7 204  56 286 301],334,4,8277,3.730058584948175,0.0,0.0
32219,3,2219,[603 127 427  64 318],313,5,8282,3.7306306306306305,40.0,20.0
32220,3,2220,[603 127 427  64 318],271,5,8287,3.7312021611886537,40.0,20.0
32221,3,2221,[202  70 191 204   7],95,5,8292,3.7317731773177316,0.0,0.0
32222,3,2222,[603 127 427  64 318],452,5,8297,3.7323436797121006,40.0,20.0
32223,3,2223,[ 22 603 234  97  96],738,4,8301,3.7324640287769784,20.0,0.0
32224,3,2224,[ 71   4 276 678 228],881,2,8303,3.731685393258427,0.0,0.0
32225,3,2225,[603 127 427  64 318],666,5,8308,3.7322551662174304,40.0,20.0
32226,3,2226,[603 127 427  64 318],452,5,8313,3.732824427480916,40.0,20.0
32227,3,2227,[603 127 427  64 318],91,5,8318,3.7333931777378817,40.0,20.0
32228,3,2228,[403 161   4 172 179],87,4,8322,3.733512786002692,0.0,0.0
32229,3,2229,[161 186 179 748 195],92,3,8325,3.733183856502242,0.0,0.0
32230,3,2230,[ 89 323 117 603 210],537,2,8327,3.7324069923800987,20.0,0.0
32231,3,2231,[603 127 427  64 318],666,5,8332,3.7329749103942653,40.0,20.0
32232,3,2232,[435  82 196 515 202],7,2,8334,3.7321988356471114,0.0,0.0
32233,3,2233,[603 127 427  64 318],271,5,8339,3.732766338406446,40.0,20.0
32234,3,2234,[603 127 427  64 318],474,5,8344,3.7333333333333334,40.0,20.0
32235,3,2235,[204  25 286 168 132],95,3,8347,3.733005366726297,0.0,0.0
32236,3,2236,[276  97 127 234 742],881,3,8350,3.732677693339294,0.0,20.0
32237,3,2237,[ 88   7 183 483 211],13,4,8354,3.732797140303843,20.0,0.0
32238,3,2238,[168  88 195   1 258],650,2,8356,3.7320232246538634,0.0,0.0
32239,3,2239,[282 196 204 318 176],92,4,8360,3.732142857142857,20.0,0.0
32240,3,2240,[215 185 191 508 211],13,2,8362,3.7313699241410085,0.0,0.0
32241,3,2241,[655   9  69 322 143],474,5,8367,3.731935771632471,0.0,0.0
32242,3,2242,[179 197 655  28 238],194,5,8372,3.7325011145786893,0.0,0.0
32243,3,2243,[603 127 427  64 318],308,5,8377,3.733065953654189,40.0,20.0
32244,3,2244,[195  71  56 286  82],200,5,8382,3.733630289532294,0.0,0.0
32245,3,2245,[603 127 427  64 318],234,5,8387,3.734194122885129,40.0,20.0
32246,3,2246,[603 127 427  64 318],308,5,8392,3.7347574543836224,40.0,20.0
32247,3,2247,[234 194  25 121 515],452,3,8395,3.7344306049822062,0.0,0.0
32248,3,2248,[483  15 423 258 132],215,3,8398,3.7341040462427744,20.0,0.0
32249,3,2249,[234 235 471 100 228],402,3,8401,3.7337777777777776,0.0,20.0
32250,3,2250,[181  56 405  98 118],881,4,8405,3.7338960462016884,0.0,20.0
32251,3,2251,[508 257 258 288 144],339,2,8407,3.733126110124334,0.0,0.0
32252,3,2252,[603 127 427  64 318],458,5,8412,3.733688415446072,40.0,20.0
32253,3,2253,[237 200 475 216 328],537,1,8413,3.7324755989352263,0.0,0.0
32254,3,2254,[603 127 427  64 318],452,5,8418,3.7330376940133037,40.0,20.0
32255,3,2255,[603 127 427  64 318],13,4,8422,3.733156028368794,40.0,20.0
32256,3,2256,[603 127 427  64 318],7,5,8427,3.733717323881258,40.0,20.0
32257,3,2257,[183 215  25  96 195],882,4,8431,3.733835252435784,0.0,0.0
32258,3,2258,[183 328  15 318 195],313,4,8435,3.7339530765825586,20.0,0.0
32259,3,2259,[603 127 427  64 318],13,4,8439,3.734070796460177,40.0,20.0
32260,3,2260,[603 127 427  64 318],308,5,8444,3.7346306943830165,40.0,20.0
32261,3,2261,[603 127 427  64 318],313,5,8449,3.735190097259063,40.0,20.0
32262,3,2262,[176 215 173 275 211],7,4,8453,3.7353071144498453,0.0,0.0
32263,3,2263,[182 196 186  64 655],59,5,8458,3.7358657243816253,0.0,0.0
32264,3,2264,[ 71 268   8  82 111],334,3,8461,3.735540838852097,0.0,0.0
32265,3,2265,[195 423 603 135 385],843,2,8463,3.73477493380406,20.0,0.0
32266,3,2266,[603 127 427  64 318],234,5,8468,3.7353330392589323,40.0,20.0
32267,3,2267,[210 204  96  69 322],524,3,8471,3.7350088183421515,0.0,0.0
32268,3,2268,[216 191 496 294 180],95,3,8474,3.734684883208462,0.0,0.0
32269,3,2269,[286 127 597 100 117],548,4,8478,3.7348017621145373,0.0,40.0
32270,3,2270,[132  97 385 183  82],694,5,8483,3.735358872743285,0.0,0.0
32271,3,2271,[597  98 196   4 288],346,1,8484,3.734154929577465,0.0,20.0
32272,3,2272,[603 127 427  64 318],326,4,8488,3.7342718873735152,40.0,20.0
32273,3,2273,[173 215 191 153 238],194,3,8491,3.733948988566403,0.0,0.0
32274,3,2274,[678 210 496 176  56],334,1,8492,3.7327472527472527,0.0,0.0
32275,3,2275,[603 127 427  64 318],458,5,8497,3.733304042179262,40.0,20.0
32276,3,2276,[174 268 187  96 275],537,3,8500,3.732981993851559,0.0,20.0
32277,3,2277,[603 127 427  64 318],533,5,8505,3.7335381913959615,40.0,20.0
32278,3,2278,[603 127 427  64 318],313,5,8510,3.734093900833699,40.0,20.0
32279,3,2279,[603 127 427  64 318],527,3,8513,3.7337719298245613,40.0,20.0
32280,3,2280,[  4 423 546  70 748],653,1,8514,3.732573432704954,0.0,0.0
32281,3,2281,[603 127 427  64 318],474,5,8519,3.733128834355828,40.0,20.0
32282,3,2282,[ 22 508 405 483 121],447,3,8522,3.732807709154621,20.0,0.0
32283,3,2283,[588 197 191 427 195],13,3,8525,3.7324868651488616,0.0,0.0
32284,3,2284,[603 127 427  64 318],271,5,8530,3.7330415754923414,40.0,20.0
32285,3,2285,[603 127 427  64 318],666,5,8535,3.7335958005249346,40.0,20.0
32286,3,2286,[603 127 427  64 318],271,5,8540,3.7341495408832532,40.0,20.0
32287,3,2287,[603 127 427  64 318],7,5,8545,3.734702797202797,40.0,20.0
32288,3,2288,[603 127 427  64 318],452,5,8550,3.7352555701179555,40.0,20.0
32289,3,2289,[603 127 427  64 318],458,5,8555,3.7358078602620086,40.0,20.0
32290,3,2290,[153 210 313 211 183],102,1,8556,3.7346137058053253,0.0,0.0
32291,3,2291,[127 215 546  69 328],234,2,8558,3.7338568935427574,0.0,20.0
32292,3,2292,[ 89 185 176 742 127],189,4,8562,3.733972961186219,0.0,20.0
32293,3,2293,[603 127 427  64 318],91,5,8567,3.7345248474280734,40.0,20.0
32294,3,2294,[234 423   1 173 121],200,5,8572,3.7350762527233115,0.0,0.0
32295,3,2295,[475 471 258 238 215],13,2,8574,3.734320557491289,0.0,0.0
32296,3,2296,[603 127 427  64 318],533,5,8579,3.7348715716151504,40.0,20.0
32297,3,2297,[603 127 427  64 318],271,5,8584,3.7354221061792865,40.0,20.0
32298,3,2298,[603 127 427  64 318],326,4,8588,3.7355371900826446,40.0,20.0
32299,3,2299,[603 127 427  64 318],474,5,8593,3.736086956521739,40.0,20.0
32300,3,2300,[  4 318 204 179 210],92,4,8597,3.7362016514558887,20.0,0.0
32301,3,2301,[  7  89 405 132 235],447,3,8600,3.735881841876629,0.0,0.0
32302,3,2302,[603 127 427  64 318],664,5,8605,3.73643074250977,40.0,20.0
32303,3,2303,[603 127 427  64 318],452,5,8610,3.7369791666666665,40.0,20.0
32304,3,2304,[301 215  89  97  79],537,1,8611,3.7357917570498915,0.0,0.0
32305,3,2305,[  7 475  50 197  71],474,5,8616,3.7363399826539463,0.0,20.0
32306,3,2306,[ 71 211 172  69 195],533,5,8621,3.736887732986563,0.0,0.0
32307,3,2307,[603 168 289 172 427],234,3,8624,3.736568457538995,20.0,0.0
32308,3,2308,[204 257 403 144 496],749,4,8628,3.736682546556951,0.0,0.0
32309,3,2309,[268  56 202 597 187],13,4,8632,3.736796536796537,0.0,0.0
32310,3,2310,[603 127 427  64 318],59,5,8637,3.7373431414971874,40.0,20.0
32311,3,2311,[603 127 427  64 318],452,5,8642,3.7378892733564015,40.0,20.0
32312,3,2312,[603 127 427  64 318],452,5,8647,3.738434932987462,40.0,20.0
32313,3,2313,[210 127 204 180 175],479,5,8652,3.738980121002593,0.0,20.0
32314,3,2314,[435 204 508 175 258],59,4,8656,3.739092872570194,0.0,0.0
32315,3,2315,[  1 132 318 135 228],313,4,8660,3.7392055267702937,20.0,0.0
32316,3,2316,[603 127 427  64 318],474,5,8665,3.7397496763055678,40.0,20.0
32317,3,2317,[603 127 427  64 318],90,5,8670,3.740293356341674,40.0,20.0
32318,3,2318,[603 127 427  64 318],474,5,8675,3.740836567485985,40.0,20.0
32319,3,2319,[196 222 403 508 182],653,0,8675,3.7392241379310347,0.0,0.0
32320,3,2320,[603 127 427  64 318],13,4,8679,3.7393364928909953,40.0,20.0
32321,3,2321,[603 127 427  64 318],474,5,8684,3.7398794142980187,40.0,20.0
32322,3,2322,[603 127 427  64 318],313,5,8689,3.740421868273784,40.0,20.0
32323,3,2323,[ 11 182 121 515  56],474,5,8694,3.7409638554216866,0.0,0.0
32324,3,2324,[603 127 427  64 318],234,5,8699,3.741505376344086,40.0,20.0
32325,3,2325,[ 79  25 237 211 265],666,1,8700,3.7403267411865864,0.0,0.0
32326,3,2326,[  8  71 427 568 100],7,5,8705,3.740868070477009,0.0,20.0
32327,3,2327,[603 127 427  64 318],666,5,8710,3.741408934707904,40.0,20.0
32328,3,2328,[ 69  25  70  12 176],7,2,8712,3.7406612279948477,20.0,0.0
32329,3,2329,[603 265 100  12 655],339,4,8716,3.740772532188841,40.0,20.0
32330,3,2330,[603 127 427  64 318],533,5,8721,3.741312741312741,40.0,20.0
32331,3,2331,[603 127 427  64 318],458,5,8726,3.741852487135506,40.0,20.0
32332,3,2332,[322 176  79 181 197],804,5,8731,3.7423917702528935,0.0,0.0
32333,3,2333,[603 127 427  64 318],90,5,8736,3.7429305912596402,40.0,20.0
32334,3,2334,[603 127 427  64 318],308,5,8741,3.7434689507494645,40.0,20.0
32335,3,2335,[603 127 427  64 318],458,5,8746,3.7440068493150687,40.0,20.0
32336,3,2336,[603 127 427  64 318],474,5,8751,3.7445442875481385,40.0,20.0
32337,3,2337,[210 603 483 655 173],326,4,8755,3.744653550042772,40.0,0.0
32338,3,2338,[603 127 427  64 318],326,4,8759,3.744762719110731,40.0,20.0
32339,3,2339,[603 127 427  64 318],537,4,8763,3.744871794871795,40.0,20.0
32340,3,2340,[127 210 111 294 202],158,4,8767,3.744980777445536,0.0,20.0
32341,3,2341,[603 127 427  64 318],664,5,8772,3.745516652433817,40.0,20.0
32342,3,2342,[496 216 132 191 318],7,5,8777,3.746052069995732,20.0,0.0
32343,3,2343,[603 127 427  64 318],666,5,8782,3.7465870307167237,40.0,20.0
32344,3,2344,[603 127 427  64 318],452,5,8787,3.7471215351812366,40.0,20.0
32345,3,2345,[237 196 234 265 175],343,3,8790,3.7468030690537084,0.0,0.0
32346,3,2346,[603 127 427  64 318],686,5,8795,3.7473370259906265,40.0,20.0
32347,3,2347,[  7   8 435 121 197],82,4,8799,3.7474446337308347,0.0,0.0
32348,3,2348,[603 127 427  64 318],59,5,8804,3.7479778629203917,40.0,20.0
32349,3,2349,[603 127 427  64 318],90,5,8809,3.7485106382978723,40.0,20.0
32350,3,2350,[603 127 427  64 318],59,5,8814,3.749042960442365,40.0,20.0
32351,3,2351,[603 127 427  64 318],59,5,8819,3.749574829931973,40.0,20.0
32352,3,2352,[603 127 427  64 318],537,4,8823,3.749681257968551,40.0,20.0
32353,3,2353,[ 11   1 294 471 588],234,0,8823,3.748088360237893,0.0,0.0
32354,3,2354,[196 202 568 173 100],311,4,8827,3.7481953290870487,0.0,20.0
32355,3,2355,[121 195  79 678 288],308,3,8830,3.7478777589134125,0.0,0.0
32356,3,2356,[191 143 132  25  28],843,0,8830,3.7462876537971996,0.0,0.0
32357,3,2357,[427 471 234 318 258],666,4,8834,3.746395250212044,20.0,0.0
32358,3,2358,[168 423 182  70  15],479,3,8837,3.7460788469690547,0.0,0.0
32359,3,2359,[181 161 282 568 174],643,2,8839,3.7453389830508477,0.0,20.0
32360,3,2360,[603 127 427  64 318],686,5,8844,3.7458703939008893,40.0,20.0
32361,3,2361,[111  15 471 182 204],271,2,8846,3.7451312447078746,0.0,0.0
32362,3,2362,[603 127 427  64 318],664,5,8851,3.745662293694456,40.0,20.0
32363,3,2363,[603 127 427  64 318],533,5,8856,3.746192893401015,40.0,20.0
32364,3,2364,[603 127 427  64 318],91,5,8861,3.746723044397463,40.0,20.0
32365,3,2365,[603 127 427  64 318],7,5,8866,3.7472527472527473,40.0,20.0
32366,3,2366,[302 204  71  79 323],474,4,8870,3.7473595268272075,0.0,0.0
32367,3,2367,[603 127 427  64 318],537,4,8874,3.7474662162162162,40.0,20.0
32368,3,2368,[234 187  98 117 265],897,3,8877,3.747150696496412,0.0,20.0
32369,3,2369,[588 195 258 172 496],882,4,8881,3.747257383966245,0.0,0.0
32370,3,2370,[603 127 427  64 318],474,5,8886,3.7477857444116407,40.0,20.0
32371,3,2371,[603 127 427  64 318],91,5,8891,3.7483136593591904,40.0,20.0
32372,3,2372,[323 423 202 211 181],290,3,8894,3.7479983143699958,0.0,0.0
32373,3,2373,[603 127 427  64 318],271,5,8899,3.7485256950294863,40.0,20.0
32374,3,2374,[265 186 483  82 127],339,4,8903,3.7486315789473683,20.0,20.0
32375,3,2375,[603 127 427  64 318],7,5,8908,3.749158249158249,40.0,20.0
32376,3,2376,[181 475 748  15 385],92,3,8911,3.74884307951199,0.0,0.0
32377,3,2377,[271 200 483   7 210],537,2,8913,3.748107653490328,20.0,0.0
32378,3,2378,[175 496 603 435 483],666,5,8918,3.748633879781421,40.0,0.0
32379,3,2379,[ 22 194 435 191 183],406,4,8922,3.7487394957983193,0.0,0.0
32380,3,2380,[333 175 135 195 286],881,3,8925,3.74842503149937,0.0,0.0
32381,3,2381,[275  64  98 183 216],7,5,8930,3.7489504617968095,0.0,20.0
32382,3,2382,[603 127 427  64 318],91,5,8935,3.7494754511120436,40.0,20.0
32383,3,2383,[204 294 237 168 111],749,2,8937,3.748741610738255,0.0,0.0
32384,3,2384,[194  95 275  98  79],64,5,8942,3.749266247379455,0.0,20.0
32385,3,2385,[132  69 483 196  12],308,1,8943,3.748113998323554,40.0,0.0
32386,3,2386,[405 173 603 234  11],897,3,8946,3.7478005865102637,20.0,0.0
32387,3,2387,[742 174 215 194 265],804,5,8951,3.7483249581239533,0.0,20.0
32388,3,2388,[603 127 427  64 318],234,5,8956,3.7488488907492674,40.0,20.0
32389,3,2389,[603 127 427  64 318],474,5,8961,3.7493723849372387,40.0,20.0
32390,3,2390,[174 294 597  95 143],650,2,8963,3.7486407360936846,0.0,20.0
32391,3,2391,[318 183  70 258 195],64,4,8967,3.7487458193979935,20.0,0.0
32392,3,2392,[  7 748 294 237 125],788,2,8969,3.7480150438779773,0.0,0.0
32393,3,2393,[603 127 427  64 318],13,4,8973,3.7481203007518795,40.0,20.0
32394,3,2394,[ 95 235 237 168  15],901,3,8976,3.7478079331941543,0.0,0.0
32395,3,2395,[294 176   1 179 186],653,3,8979,3.7474958263772953,0.0,0.0
32396,3,2396,[603 127 427  64 318],7,5,8984,3.7480183562786817,40.0,20.0
32397,3,2397,[603 127 427  64 318],537,4,8988,3.7481234361968307,40.0,20.0
32398,3,2398,[117  15 111 328 405],554,5,8993,3.7486452688620258,0.0,0.0
32399,3,2399,[603 127 427  64 318],326,4,8997,3.74875,40.0,20.0
32400,3,2400,[ 15   1 182 176 286],271,1,8998,3.7476051645147854,0.0,0.0
32401,3,2401,[603 127 427  64 318],308,5,9003,3.7481265611990007,40.0,20.0
32402,3,2402,[546 121 216  28 127],83,5,9008,3.748647523928423,0.0,20.0
32403,3,2403,[603 127 427  64 318],7,5,9013,3.7491680532445923,40.0,20.0
32404,3,2404,[181  97 196 282 168],374,2,9015,3.7484407484407485,0.0,0.0
32405,3,2405,[197 117 191  88 385],543,3,9018,3.748129675810474,0.0,0.0
32406,3,2406,[546 742  95 121 168],271,1,9019,3.746987951807229,0.0,0.0
32407,3,2407,[  4 288 191 268  50],234,3,9022,3.7466777408637872,0.0,20.0
32408,3,2408,[603 127 427  64 318],308,5,9027,3.74719800747198,40.0,20.0
32409,3,2409,[186 405 196 289   9],378,3,9030,3.7468879668049793,0.0,0.0
32410,3,2410,[238 508  71 151 175],82,2,9032,3.746163417669017,0.0,0.0
32411,3,2411,[245  22 144 111 211],653,2,9034,3.7454394693200666,0.0,0.0
32412,3,2412,[603 127 427  64 318],90,5,9039,3.7459593866556156,40.0,20.0
32413,3,2413,[196 202 117 144 174],378,3,9042,3.745650372825186,0.0,20.0
32414,3,2414,[ 22 483 742 655 427],833,1,9043,3.744513457556936,20.0,0.0
32415,3,2415,[  1 187 471 144 257],479,5,9048,3.7450331125827816,0.0,0.0
32416,3,2416,[174 357 118 176   4],749,4,9052,3.745138601572197,20.0,20.0
32417,3,2417,[183  89 168   8  69],452,5,9057,3.7456575682382134,0.0,0.0
32418,3,2418,[182 568 132 181 215],506,5,9062,3.7461761058288547,0.0,0.0
32419,3,2419,[100 313 385  11 121],454,3,9065,3.7458677685950414,0.0,20.0
32420,3,2420,[ 71 288 210 237 546],882,3,9068,3.7455596860801323,0.0,0.0
32421,3,2421,[603 127 427  64 318],533,5,9073,3.7460776218001652,40.0,20.0
32422,3,2422,[174 175 742 237  89],653,2,9075,3.7453569954601735,0.0,20.0
32423,3,2423,[  7 475 132 238 172],13,2,9077,3.7446369636963697,0.0,0.0
32424,3,2424,[ 71 258 423 588 191],234,2,9079,3.743917525773196,0.0,0.0
32425,3,2425,[168 187 328 135 181],537,3,9082,3.74361088211047,0.0,0.0
32426,3,2426,[435 210 568 168 323],125,4,9086,3.7437165224557067,0.0,0.0
32427,3,2427,[258 196 234  96 269],7,4,9090,3.743822075782537,0.0,0.0
32428,3,2428,[174  98  96 357 742],804,5,9095,3.744339234252779,20.0,40.0
32429,3,2429,[603 127 427  64 318],313,5,9100,3.7448559670781894,40.0,20.0
32430,3,2430,[100 268 179 118 282],643,3,9103,3.74454956807898,0.0,20.0
32431,3,2431,[183 235 318  28   8],82,2,9105,3.7438322368421053,20.0,0.0
32432,3,2432,[603 127 427  64 318],527,3,9108,3.743526510480888,40.0,20.0
32433,3,2433,[179 268 183 322 197],537,3,9111,3.7432210353327857,0.0,0.0
32434,3,2434,[603 127 427  64 318],537,4,9115,3.7433264887063653,40.0,20.0
32435,3,2435,[ 25 546 204 195 197],378,2,9117,3.7426108374384235,0.0,0.0
32436,3,2436,[603 127 427  64 318],533,5,9122,3.743126795240049,40.0,20.0
32437,3,2437,[603 127 427  64 318],271,5,9127,3.743642329778507,40.0,20.0
32438,3,2438,[603 127 427  64 318],59,5,9132,3.7441574415744157,40.0,20.0
32439,3,2439,[173 172 175   7 144],932,3,9135,3.7438524590163933,0.0,0.0
32440,3,2440,[ 97  64 191 180 216],233,5,9140,3.74436706267923,0.0,0.0
32441,3,2441,[603 127 427  64 318],533,5,9145,3.744881244881245,40.0,20.0
32442,3,2442,[603 127 427  64 318],452,5,9150,3.745395006139992,40.0,20.0
32443,3,2443,[ 11 234   9 546 222],343,3,9153,3.7450900163666123,0.0,0.0
32444,3,2444,[471   1 588 328 117],234,0,9153,3.743558282208589,0.0,0.0
32445,3,2445,[603 194 196   8 173],379,5,9158,3.744071954210957,20.0,0.0
32446,3,2446,[ 69  89 135 182 333],328,2,9160,3.743359215365754,0.0,0.0
32447,3,2447,[153 210 265 318 237],326,3,9163,3.7430555555555554,20.0,0.0
32448,3,2448,[603 127 427  64 318],308,5,9168,3.7435688035933032,40.0,20.0
32449,3,2449,[153 161 496  25  70],804,5,9173,3.744081632653061,0.0,0.0
32450,3,2450,[271 603  25 405  88],537,1,9174,3.7429620563035497,20.0,0.0
32451,3,2451,[357 385  64  50 181],60,5,9179,3.74347471451876,20.0,20.0
32452,3,2452,[176 237   1 265 222],533,2,9181,3.7427639624949043,0.0,0.0
32453,3,2453,[175 597 196 125  69],207,3,9184,3.7424612876935615,0.0,0.0
32454,3,2454,[603 127 427  64 318],308,5,9189,3.7429735234215884,40.0,20.0
32455,3,2455,[748 179 237 385 216],543,3,9192,3.742671009771987,0.0,0.0
32456,3,2456,[483 403  71 174 118],804,4,9196,3.7427757427757427,20.0,20.0
32457,3,2457,[603 127 427  64 318],474,5,9201,3.743287225386493,40.0,20.0
32458,3,2458,[257 435 276 265 313],271,4,9205,3.7433916226108175,0.0,0.0
32459,3,2459,[603 127 427  64 318],7,5,9210,3.7439024390243905,40.0,20.0
32460,3,2460,[194 228 210 235  95],524,1,9211,3.742787484762292,0.0,0.0
32461,3,2461,[603 127 427  64 318],686,5,9216,3.743298131600325,40.0,20.0
32462,3,2462,[ 56 132 508 742 568],533,4,9220,3.7434023548518067,0.0,0.0
32463,3,2463,[197 195 211 275  69],883,4,9224,3.7435064935064934,0.0,0.0
32464,3,2464,[603 127 427  64 318],59,5,9229,3.7440162271805275,40.0,20.0
32465,3,2465,[323 174  11 117 234],13,2,9231,3.74330900243309,0.0,20.0
32466,3,2466,[  1 125 153 211  22],804,5,9236,3.7438184029185244,0.0,0.0
32467,3,2467,[603 127 427  64 318],59,5,9241,3.744327390599676,40.0,20.0
32468,3,2468,[603 127 427  64 318],474,5,9246,3.7448359659781287,40.0,20.0
32469,3,2469,[603 127 427  64 318],271,5,9251,3.7453441295546557,40.0,20.0
32470,3,2470,[603 127 427  64 318],13,4,9255,3.745447187373533,40.0,20.0
32471,3,2471,[ 12 496  28  25 143],666,2,9257,3.7447411003236244,20.0,0.0
32472,3,2472,[237 187 288 588 238],64,5,9262,3.7452486858067124,0.0,0.0
32473,3,2473,[185 118 294 234 174],897,4,9266,3.7453516572352465,0.0,20.0
32474,3,2474,[174 172  50 282  64],326,4,9270,3.7454545454545456,0.0,40.0
32475,3,2475,[603 127 427  64 318],666,5,9275,3.745961227786753,40.0,20.0
32476,3,2476,[603 127 427  64 318],533,5,9280,3.7464675010092856,40.0,20.0
32477,3,2477,[603 127 427  64 318],7,5,9285,3.7469733656174333,40.0,20.0
32478,3,2478,[603 127 427  64 318],91,5,9290,3.7474788221056876,40.0,20.0
32479,3,2479,[235 282  25 496   7],194,1,9291,3.7463709677419357,0.0,0.0
32480,3,2480,[603 127 427  64 318],234,5,9296,3.746876259572753,40.0,20.0
32481,3,2481,[603 127 427  64 318],452,5,9301,3.7473811442385174,40.0,20.0
32482,3,2482,[603 127 427  64 318],7,5,9306,3.747885622231172,40.0,20.0
32483,3,2483,[161   1  96 125  69],897,5,9311,3.748389694041868,0.0,0.0
32484,3,2484,[  4   1 546 655 423],13,3,9314,3.748088531187123,0.0,0.0
32485,3,2485,[603 127 427  64 318],474,5,9319,3.748592115848753,40.0,20.0
32486,3,2486,[603 127 427  64 318],7,5,9324,3.749095295536791,40.0,20.0
32487,3,2487,[ 28 161 235 204 568],59,3,9327,3.7487942122186495,0.0,0.0
32488,3,2488,[175 173 153  28 357],804,5,9332,3.749296906388108,20.0,0.0
32489,3,2489,[603 127 427  64 318],271,5,9337,3.7497991967871487,40.0,20.0
32490,3,2490,[603 127 427  64 318],664,5,9342,3.7503010839020474,40.0,20.0
32491,3,2491,[197 515   7 238 286],339,5,9347,3.7508025682182984,0.0,0.0
32492,3,2492,[603 127 427  64 318],527,3,9350,3.7505014039310067,40.0,20.0
32493,3,2493,[603 127 427  64 318],527,3,9353,3.7502004811547716,40.0,20.0
32494,3,2494,[  7  71 515 127  89],804,4,9357,3.750300601202405,0.0,20.0
32495,3,2495,[127 174 357 191 405],194,4,9361,3.750400641025641,20.0,40.0
32496,3,2496,[ 56 475 117 275  70],125,1,9362,3.749299158990789,0.0,0.0
32497,3,2497,[ 98 385  96 515 286],666,3,9365,3.7489991993594876,0.0,20.0
32498,3,2498,[603 127 427  64 318],686,5,9370,3.749499799919968,40.0,20.0
32499,3,2499,[603 127 427  64 318],234,5,9375,3.75,40.0,20.0
32500,3,2500,[603 127 427  64 318],91,5,9380,3.750499800079968,40.0,20.0
32501,3,2501,[357 181 211 318  98],207,4,9384,3.7505995203836933,40.0,20.0
32502,3,2502,[161 748  89  96 289],474,3,9387,3.750299640431482,0.0,0.0
32503,3,2503,[405 215 294 546  12],378,2,9389,3.7496006389776357,20.0,0.0
32504,3,2504,[603 127 427  64 318],271,5,9394,3.7500998003992017,40.0,20.0
32505,3,2505,[ 82 276  56 215 288],643,3,9397,3.749800478850758,0.0,0.0
32506,3,2506,[ 70 427 194  71   9],59,2,9399,3.7491025129637015,0.0,0.0
32507,3,2507,[603 127 427  64 318],533,5,9404,3.7496012759170654,40.0,20.0
32508,3,2508,[ 98 222 742 202 496],804,5,9409,3.750099641291351,0.0,20.0
32509,3,2509,[  7 237 546 195 216],346,3,9412,3.749800796812749,0.0,0.0
32510,3,2510,[603 127 427  64 318],90,5,9417,3.750298685782557,40.0,20.0
32511,3,2511,[151 269 302 282 132],334,3,9420,3.75,0.0,0.0
32512,3,2512,[222  69 234   1 323],881,2,9422,3.7493036211699162,0.0,0.0
32513,3,2513,[603 127 427  64 318],533,5,9427,3.7498011137629277,40.0,20.0
32514,3,2514,[603 127 427  64 318],664,5,9432,3.7502982107355867,40.0,20.0
32515,3,2515,[603 127 427  64 318],458,5,9437,3.7507949125596185,40.0,20.0
32516,3,2516,[265 197 210 153 655],379,5,9442,3.7512912197059993,0.0,0.0
32517,3,2517,[ 28 496 202  79 144],125,5,9447,3.751787132644956,0.0,0.0
32518,3,2518,[180 515 237 118 194],328,3,9450,3.7514886859865024,0.0,0.0
32519,3,2519,[181 483 125 100 427],59,4,9454,3.7515873015873016,20.0,20.0
32520,3,2520,[603 127 427  64 318],271,5,9459,3.7520825069416897,40.0,20.0
32521,3,2521,[222 483  69 603 216],234,3,9462,3.7517842981760507,40.0,0.0
32522,3,2522,[294 185 655 194 237],13,3,9465,3.751486325802616,0.0,0.0
32523,3,2523,[275 235 357 174 183],882,4,9469,3.7515847860538827,20.0,20.0
32524,3,2524,[182 496 202 357 176],892,5,9474,3.752079207920792,20.0,0.0
32525,3,2525,[603 127 427  64 318],474,5,9479,3.7525732383214567,40.0,20.0
32526,3,2526,[603 127 427  64 318],326,4,9483,3.7526711515631184,40.0,20.0
32527,3,2527,[742  97 186 161  71],95,4,9487,3.752768987341772,0.0,0.0
32528,3,2528,[603 127 427  64 318],271,5,9492,3.753262158956109,40.0,20.0
32529,3,2529,[603 127 427  64 318],271,5,9497,3.7537549407114623,40.0,20.0
32530,3,2530,[603 127 427  64 318],533,5,9502,3.754247333069933,40.0,20.0
32531,3,2531,[603 127 427  64 318],59,5,9507,3.754739336492891,40.0,20.0
32532,3,2532,[603 127 427  64 318],686,5,9512,3.755230951440979,40.0,20.0
32533,3,2533,[603 127 427  64 318],666,5,9517,3.755722178374112,40.0,20.0
32534,3,2534,[135   4 385  82 742],788,0,9517,3.754240631163708,0.0,0.0
32535,3,2535,[603 127 427  64 318],527,3,9520,3.7539432176656153,40.0,20.0
32536,3,2536,[603 127 427  64 318],474,5,9525,3.7544343713046904,40.0,20.0
32537,3,2537,[161  11  79 222 185],474,5,9530,3.7549251379038613,0.0,0.0
32538,3,2538,[ 89  96 180 186 265],882,5,9535,3.755415517920441,0.0,0.0
32539,3,2539,[132 186   9 294  11],7,3,9538,3.7551181102362206,0.0,0.0
32540,3,2540,[  7 194 181 275  15],648,3,9541,3.7548209366391183,0.0,0.0
32541,3,2541,[603 127 427  64 318],458,5,9546,3.755310778914241,40.0,20.0
32542,3,2542,[603 127 427  64 318],533,5,9551,3.755800235941801,40.0,20.0
32543,3,2543,[603 127 427  64 318],527,3,9554,3.755503144654088,40.0,20.0
32544,3,2544,[ 96 258 385  89  22],454,3,9557,3.7552062868369354,0.0,0.0
32545,3,2545,[603 127 427  64 318],271,5,9562,3.7556952081696777,40.0,20.0
32546,3,2546,[603 127 427  64 318],458,5,9567,3.756183745583039,40.0,20.0
32547,3,2547,[603 127 427  64 318],90,5,9572,3.7566718995290422,40.0,20.0
32548,3,2548,[182 186 748 195   4],749,3,9575,3.7563750490388386,0.0,0.0
32549,3,2549,[603 127 427  64 318],474,5,9580,3.756862745098039,40.0,20.0
32550,3,2550,[603 127 427  64 318],7,5,9585,3.7573500588004705,40.0,20.0
32551,3,2551,[289 286  69 179 194],271,5,9590,3.7578369905956115,0.0,0.0
32552,3,2552,[603 127 427  64 318],234,5,9595,3.7583235409322366,40.0,20.0
32553,3,2553,[603 127 427  64 318],664,5,9600,3.758809710258418,40.0,20.0
32554,3,2554,[237 258 179 187  64],666,4,9604,3.758904109589041,0.0,0.0
32555,3,2555,[603 127 427  64 318],458,5,9609,3.7593896713615025,40.0,20.0
32556,3,2556,[  4 202  79 234 211],326,3,9612,3.7590926867422763,0.0,0.0
32557,3,2557,[268 269 237   9 286],486,3,9615,3.7587959343236905,0.0,0.0
32558,3,2558,[ 70 228 186 323 294],648,3,9618,3.758499413833529,0.0,0.0
32559,3,2559,[118  82  97 235 328],479,2,9620,3.7578125,0.0,0.0
32560,3,2560,[603 127 427  64 318],537,4,9624,3.7579070675517374,40.0,20.0
32561,3,2561,[603 127 427  64 318],91,5,9629,3.758391881342701,40.0,20.0
32562,3,2562,[294  22 117  12  15],474,4,9633,3.758486149044089,20.0,0.0
32563,3,2563,[185 186 191 496 238],385,2,9635,3.7578003120124803,0.0,0.0
32564,3,2564,[181 276  15  89  79],892,5,9640,3.7582846003898633,0.0,0.0
32565,3,2565,[568 135 405   8 275],85,2,9642,3.7575993764614184,0.0,0.0
32566,3,2566,[176 294  98 143 228],200,5,9647,3.75808336579665,0.0,20.0
32567,3,2567,[172 179 211 385   9],59,5,9652,3.7585669781931466,0.0,0.0
32568,3,2568,[603 127 427  64 318],474,5,9657,3.759050214091086,40.0,20.0
32569,3,2569,[603 127 427  64 318],326,4,9661,3.7591439688715953,40.0,20.0
32570,3,2570,[235   7 121 483 191],13,2,9663,3.7584597432905484,20.0,0.0
32571,3,2571,[216 568  82  71 195],892,3,9666,3.7581648522550544,0.0,0.0
32572,3,2572,[603 127 427  64 318],326,4,9670,3.7582588418188885,40.0,20.0
32573,3,2573,[603 127 427  64 318],458,5,9675,3.7587412587412588,40.0,20.0
32574,3,2574,[302 168 603 269  69],13,4,9679,3.758834951456311,20.0,0.0
32575,3,2575,[302 496 435   9 234],474,5,9684,3.7593167701863353,0.0,0.0
32576,3,2576,[403 216 228 111 194],533,4,9688,3.7594101668606905,0.0,0.0
32577,3,2577,[603 127 427  64 318],527,3,9691,3.7591155934833203,40.0,20.0
32578,3,2578,[603 127 427  64 318],666,5,9696,3.759596742923614,40.0,20.0
32579,3,2579,[ 70  64 194 427 174],308,5,9701,3.760077519379845,0.0,20.0
32580,3,2580,[ 82 271 483 286  88],650,1,9702,3.7590081363812478,20.0,0.0
32581,3,2581,[ 89 427 202 357 125],313,4,9706,3.759101471727343,20.0,0.0
32582,3,2582,[603 127 427  64 318],533,5,9711,3.759581881533101,40.0,20.0
32583,3,2583,[ 88 405 195  22 181],538,2,9713,3.7589009287925697,0.0,0.0
32584,3,2584,[603 127 427  64 318],474,5,9718,3.7593810444874274,40.0,20.0
32585,3,2585,[ 28 197 603 273 748],13,4,9722,3.759474091260634,20.0,0.0
32586,3,2586,[603 127 427  64 318],474,5,9727,3.759953614224971,40.0,20.0
32587,3,2587,[196 200 183 135 222],488,3,9730,3.7596599690880987,0.0,0.0
32588,3,2588,[603 127 427  64 318],533,5,9735,3.7601390498261877,40.0,20.0
32589,3,2589,[127 289 301 357 153],90,4,9739,3.76023166023166,20.0,20.0
32590,3,2590,[603 127 427  64 318],686,5,9744,3.7607101505210343,40.0,20.0
32591,3,2591,[323 211 125 183  82],254,2,9746,3.760030864197531,0.0,0.0
32592,3,2592,[603 127 427  64 318],313,5,9751,3.7605090628615505,40.0,20.0
32593,3,2593,[603 127 427  64 318],537,4,9755,3.7606013878180415,40.0,20.0
32594,3,2594,[  7 180 191 265 135],95,2,9757,3.759922928709056,0.0,0.0
32595,3,2595,[423 183 289  89 496],378,4,9761,3.760015408320493,0.0,0.0
32596,3,2596,[100 117 182 183 655],334,3,9764,3.759722757027339,0.0,20.0
32597,3,2597,[197 191 187 245 173],749,4,9768,3.759815242494226,0.0,0.0
32598,3,2598,[228 603  82 200 403],815,4,9772,3.7599076567910736,20.0,0.0
32599,3,2599,[117   4   9 289  11],378,2,9774,3.7592307692307694,0.0,0.0
32600,3,2600,[603 127 427  64 318],326,4,9778,3.7593233371780084,40.0,20.0
32601,3,2601,[234 168 603 678 180],339,4,9782,3.759415833973866,20.0,0.0
32602,3,2602,[ 82  70 210 288 196],59,4,9786,3.759508259700346,0.0,0.0
32603,3,2603,[603 127 427  64 318],686,5,9791,3.759984639016897,40.0,20.0
32604,3,2604,[181  56 385 328 245],197,3,9794,3.7596928982725526,0.0,0.0
32605,3,2605,[603 127 427  64 318],90,5,9799,3.7601688411358403,40.0,20.0
32606,3,2606,[258  25 269 471   7],378,4,9803,3.7602608362102035,0.0,0.0
32607,3,2607,[588  88 187   4 173],406,1,9804,3.7592024539877302,0.0,0.0
32608,3,2608,[427 195  79 202 143],406,2,9806,3.7585281717133,0.0,0.0
32609,3,2609,[603 127 427  64 318],686,5,9811,3.7590038314176244,40.0,20.0
32610,3,2610,[603 127 427  64 318],686,5,9816,3.759479126771352,40.0,20.0
32611,3,2611,[603 127 427  64 318],474,5,9821,3.759954058192956,40.0,20.0
32612,3,2612,[603 127 427  64 318],13,4,9825,3.760045924225029,40.0,20.0
32613,3,2613,[135 175 161 508 204],387,3,9828,3.7597551644988525,0.0,0.0
32614,3,2614,[603 127 427  64 318],271,5,9833,3.7602294455066922,40.0,20.0
32615,3,2615,[603 127 427  64 318],90,5,9838,3.760703363914373,40.0,20.0
32616,3,2616,[135 183 174 172 127],537,2,9840,3.7600305693542224,0.0,40.0
32617,3,2617,[603 127 427  64 318],527,3,9843,3.75974025974026,40.0,20.0
32618,3,2618,[603 127 427  64 318],91,5,9848,3.7602138220694923,40.0,20.0
32619,3,2619,[197  71 191 180 282],311,5,9853,3.7606870229007634,0.0,0.0
32620,3,2620,[181 176  82 100  22],455,4,9857,3.760778328882106,0.0,20.0
32621,3,2621,[118 153 185 216  25],184,3,9860,3.7604881769641496,0.0,0.0
32622,3,2622,[144 515 222 328 313],328,4,9864,3.7605794891345785,0.0,0.0
32623,3,2623,[216 181  15   8 195],901,4,9868,3.760670731707317,0.0,0.0
32624,3,2624,[603 127 427  64 318],234,5,9873,3.761142857142857,40.0,20.0
32625,3,2625,[125 144 496 211 200],298,3,9876,3.7608530083777607,0.0,0.0
32626,3,2626,[211   4 234  98 588],234,3,9879,3.76056338028169,0.0,20.0
32627,3,2627,[603 127 427  64 318],664,5,9884,3.7610350076103503,40.0,20.0
32628,3,2628,[603 127 427  64 318],91,5,9889,3.7615062761506275,40.0,20.0
32629,3,2629,[603 127 427  64 318],7,5,9894,3.7619771863117872,40.0,20.0
32630,3,2630,[211  89 187 222 228],311,4,9898,3.7620676548840746,0.0,0.0
32631,3,2631,[172 289 135 196 546],455,3,9901,3.76177811550152,0.0,0.0
32632,3,2632,[603 127 427  64 318],91,5,9906,3.7622483858716294,40.0,20.0
32633,3,2633,[ 22 127 385 483 191],311,5,9911,3.7627182991647685,20.0,20.0
32634,3,2634,[195 194 403 204 187],194,3,9914,3.7624288425047436,0.0,0.0
32635,3,2635,[603 127 427  64 318],533,5,9919,3.7628983308042487,40.0,20.0
32636,3,2636,[121 191 568 144  50],454,5,9924,3.763367463026166,0.0,20.0
32637,3,2637,[603 127 427  64 318],452,5,9929,3.763836239575436,40.0,20.0
32638,3,2638,[196 197  69 153 187],207,5,9934,3.764304660856385,0.0,0.0
32639,3,2639,[245 179 176   4  98],92,5,9939,3.764772727272727,0.0,20.0
32640,3,2640,[603 127 427  64 318],7,5,9944,3.7652404392275653,40.0,20.0
32641,3,2641,[603 127 427  64 318],271,5,9949,3.765707797123391,40.0,20.0
32642,3,2642,[603 127 427  64 318],271,5,9954,3.7661748013620886,40.0,20.0
32643,3,2643,[328 235  22 135  98],13,3,9957,3.7658850226928897,0.0,20.0
32644,3,2644,[603 127 427  64 318],234,5,9962,3.766351606805293,40.0,20.0
32645,3,2645,[603 127 427  64 318],474,5,9967,3.7668178382464097,40.0,20.0
32646,3,2646,[271  89 125 742 216],92,2,9969,3.7661503588968643,0.0,0.0
32647,3,2647,[ 71 301  70 294   9],378,3,9972,3.7658610271903323,0.0,0.0
32648,3,2648,[603 127 427  64 318],527,3,9975,3.7655719139297847,40.0,20.0
32649,3,2649,[181 196  15  79 197],184,3,9978,3.7652830188679247,0.0,0.0
32650,3,2650,[603 127 427  64 318],527,3,9981,3.764994341757827,40.0,20.0
32651,3,2651,[179 483 194  89 168],648,5,9986,3.7654600301659125,20.0,0.0
32652,3,2652,[603 127 427  64 318],537,4,9990,3.765548435733132,40.0,20.0
32653,3,2653,[603 127 427  64 318],686,5,9995,3.7660135644310473,40.0,20.0
32654,3,2654,[301 187 300  50 135],334,3,9998,3.7657250470809793,0.0,20.0
32655,3,2655,[603 127 427  64 318],664,5,10003,3.7661897590361444,40.0,20.0
32656,3,2656,[588 125 483 258 357],234,2,10005,3.7655250282273243,40.0,0.0
32657,3,2657,[174  50 210 161 275],378,5,10010,3.7659894657637323,0.0,40.0
32658,3,2658,[603 127 427  64 318],537,4,10014,3.7660774727341106,40.0,20.0
32659,3,2659,[301  69  98 121 202],210,5,10019,3.7665413533834586,0.0,20.0
32660,3,2660,[603 127 427  64 318],313,5,10024,3.7670048853814357,40.0,20.0
32661,3,2661,[318  71  95   9 228],85,4,10028,3.767092411720511,20.0,0.0
32662,3,2662,[183 195 215  82 211],749,5,10033,3.7675553886594066,0.0,0.0
32663,3,2663,[197 175 483 385 228],194,2,10035,3.766891891891892,20.0,0.0
32664,3,2664,[ 64 655 275 237 289],328,5,10040,3.7673545966228894,0.0,0.0
32665,3,2665,[603 127 427  64 318],7,5,10045,3.7678169542385596,40.0,20.0
32666,3,2666,[603 127 427  64 318],91,5,10050,3.7682789651293587,40.0,20.0
32667,3,2667,[603 127 427  64 318],234,5,10055,3.7687406296851576,40.0,20.0
32668,3,2668,[603 127 427  64 318],474,5,10060,3.7692019482952417,40.0,20.0
32669,3,2669,[603 127 427  64 318],527,3,10063,3.7689138576779024,40.0,20.0
32670,3,2670,[143   9   7  70 238],234,0,10063,3.767502807937102,0.0,0.0
32671,3,2671,[300 222 748 151 508],533,3,10066,3.7672155688622753,0.0,0.0
32672,3,2672,[ 64 204 187  69 132],804,5,10071,3.7676767676767677,0.0,0.0
32673,3,2673,[183  69 496 655  88],184,2,10073,3.7670157068062826,0.0,0.0
32674,3,2674,[  9 161 215 234  96],59,4,10077,3.7671028037383176,0.0,0.0
32675,3,2675,[ 95 235 144 313 597],378,4,10081,3.767189835575486,0.0,0.0
32676,3,2676,[ 11 135 168 153  50],7,4,10085,3.767276802390736,0.0,20.0
32677,3,2677,[603 127 427  64 318],326,4,10089,3.767363704256908,40.0,20.0
32678,3,2678,[603 127 427  64 318],234,5,10094,3.7678238148562895,40.0,20.0
32679,3,2679,[313 174 269 357   7],14,3,10097,3.7675373134328356,20.0,20.0
32680,3,2680,[603 127 427  64 318],59,5,10102,3.7679970160387914,40.0,20.0
32681,3,2681,[258 301 182 210 168],102,1,10103,3.76696495152871,0.0,0.0
32682,3,2682,[179   1  64 194 196],406,4,10107,3.7670518076779724,0.0,0.0
32683,3,2683,[216  82 228 161 204],339,2,10109,3.7663934426229506,0.0,0.0
32684,3,2684,[603 127 427  64 318],59,5,10114,3.766852886405959,40.0,20.0
32685,3,2685,[176  89 151 235 153],374,2,10116,3.7661950856291884,0.0,0.0
32686,3,2686,[258 181 182 435   1],454,1,10117,3.765165612206922,0.0,0.0
32687,3,2687,[  1 185 655  25 111],42,2,10119,3.7645089285714284,0.0,0.0
32688,3,2688,[603 127 427  64 318],271,5,10124,3.7649683897359614,40.0,20.0
32689,3,2689,[183 173   9 161 176],940,2,10126,3.7643122676579925,0.0,0.0
32690,3,2690,[ 95 151 144 588 127],64,3,10129,3.764028242289112,0.0,20.0
32691,3,2691,[234 423  98 588 132],378,5,10134,3.764487369985141,0.0,20.0
32692,3,2692,[174  89 204   7  97],339,4,10138,3.764574823616784,0.0,20.0
32693,3,2693,[603 127 427  64 318],90,5,10143,3.7650334075723833,40.0,20.0
32694,3,2694,[117   1 197  69  98],648,2,10145,3.764378478664193,0.0,20.0
32695,3,2695,[603 127 427  64 318],452,5,10150,3.7648367952522257,40.0,20.0
32696,3,2696,[603  98 185  96 204],543,5,10155,3.765294771968854,20.0,20.0
32697,3,2697,[328   1 289 153 234],788,2,10157,3.7646404744255,0.0,0.0
32698,3,2698,[603 127 427  64 318],91,5,10162,3.7650981845127824,40.0,20.0
32699,3,2699,[211 118 210 215 435],308,3,10165,3.7648148148148146,0.0,0.0
32700,3,2700,[435  82 222 143 294],378,3,10168,3.7645316549426138,0.0,0.0
32701,3,2701,[603 127 427  64 318],527,3,10171,3.7642487046632125,40.0,20.0
32702,3,2702,[603 127 427  64 318],474,5,10176,3.764705882352941,40.0,20.0
32703,3,2703,[238 546 496 183  12],378,2,10178,3.76405325443787,20.0,0.0
32704,3,2704,[603 127 427  64 318],666,5,10183,3.7645101663585954,40.0,20.0
32705,3,2705,[603 127 427  64 318],13,4,10187,3.7645971914264598,40.0,20.0
32706,3,2706,[597 282  12 117 322],119,4,10191,3.7646841521980052,20.0,0.0
32707,3,2707,[603 127 427  64 318],537,4,10195,3.764771048744461,40.0,20.0
32708,3,2708,[144 385 125 237 678],7,4,10199,3.764857881136951,0.0,0.0
32709,3,2709,[ 22 186 483  50  11],215,3,10202,3.7645756457564574,20.0,20.0
32710,3,2710,[496 168  89 313   7],59,5,10207,3.765031353744006,0.0,0.0
32711,3,2711,[  8 132 515  50 282],328,3,10210,3.7647492625368733,0.0,20.0
32712,3,2712,[111 196 204 515 191],452,3,10213,3.7644673792849246,0.0,0.0
32713,3,2713,[151   1 144 568 202],892,5,10218,3.7649226234340456,0.0,0.0
32714,3,2714,[603 127 427  64 318],474,5,10223,3.765377532228361,40.0,20.0
32715,3,2715,[ 71   9 195  28 132],694,5,10228,3.7658321060382915,0.0,0.0
32716,3,2716,[ 11 191 265 135   9],7,4,10232,3.765918292234082,0.0,0.0
32717,3,2717,[385 603 196 216 286],474,5,10237,3.766372332597498,20.0,0.0
32718,3,2718,[603 127 427  64 318],91,5,10242,3.766826038984921,40.0,20.0
32719,3,2719,[286 173 118 172 435],102,0,10242,3.7654411764705884,0.0,0.0
32720,3,2720,[ 64 196 258 176 204],13,4,10246,3.7655273796398383,0.0,0.0
32721,3,2721,[  7 269 245 655  70],378,4,10250,3.7656135194709774,0.0,0.0
32722,3,2722,[603 127 427  64 318],271,5,10255,3.7660668380462723,40.0,20.0
32723,3,2723,[195 427 471 211 194],42,5,10260,3.7665198237885464,0.0,0.0
32724,3,2724,[603 127 427  64 318],271,5,10265,3.76697247706422,40.0,20.0
32725,3,2725,[603 127 427  64 318],13,4,10269,3.7670579603815115,40.0,20.0
32726,3,2726,[603 127 427  64 318],313,5,10274,3.7675100843417675,40.0,20.0
32727,3,2727,[496  28 211  64 196],537,2,10276,3.7668621700879767,0.0,0.0
32728,3,2728,[603 127 427  64 318],686,5,10281,3.7673140344448517,40.0,20.0
32729,3,2729,[117   1 118 179 183],749,4,10285,3.7673992673992673,0.0,0.0
32730,3,2730,[211  22 186 423  96],774,0,10285,3.7660197729769314,0.0,0.0
32731,3,2731,[603 127 427  64 318],458,5,10290,3.766471449487555,40.0,20.0
32732,3,2732,[191  28 318 153 234],234,4,10294,3.7665568971825834,20.0,0.0
32733,3,2733,[234 603  28 403 183],883,4,10298,3.7666422823701535,20.0,0.0
32734,3,2734,[ 28 121 273 403 423],328,3,10301,3.76636197440585,0.0,0.0
32735,3,2735,[179 655 300 173 174],840,4,10305,3.7664473684210527,0.0,20.0
32736,3,2736,[603 127 427  64 318],664,5,10310,3.7668980635732554,40.0,20.0
32737,3,2737,[603 127 427  64 318],527,3,10313,3.766617969320672,40.0,20.0
32738,3,2738,[111 237  89 302 153],543,4,10317,3.7667031763417307,0.0,0.0
32739,3,2739,[603 127 427  64 318],313,5,10322,3.767153284671533,40.0,20.0
32740,3,2740,[181   8 323 215 282],474,4,10326,3.7672382342210873,0.0,0.0
32741,3,2741,[403 237 238 215 546],524,3,10329,3.7669584245076586,0.0,0.0
32742,3,2742,[603 127 427  64 318],686,5,10334,3.7674079475027344,40.0,20.0
32743,3,2743,[603 127 427  64 318],533,5,10339,3.767857142857143,40.0,20.0
32744,3,2744,[603 127 427  64 318],664,5,10344,3.7683060109289617,40.0,20.0
32745,3,2745,[216  98 215 196 182],537,1,10345,3.7672978878368535,0.0,20.0
32746,3,2746,[245 597  56  96 403],346,3,10348,3.767018565708045,0.0,0.0
32747,3,2747,[ 11 238 328 183 185],234,1,10349,3.7660116448326053,0.0,0.0
32748,3,2748,[ 56 117 174 183 153],648,3,10352,3.765732993815933,0.0,20.0
32749,3,2749,[603 127 427  64 318],313,5,10357,3.7661818181818183,40.0,20.0
32750,3,2750,[ 71 168 234  56  15],398,4,10361,3.7662668120683387,0.0,0.0
32751,3,2751,[181 483 121 197 125],313,4,10365,3.7663517441860463,20.0,0.0
32752,3,2752,[121 144 508 143  89],378,5,10370,3.7667998547039594,0.0,0.0
32753,3,2753,[603 127 427  64 318],234,5,10375,3.7672476397966594,40.0,20.0
32754,3,2754,[  1 172  11 168  98],488,2,10377,3.766606170598911,0.0,20.0
32755,3,2755,[211 135  96 144 742],650,3,10380,3.7663280116110305,0.0,0.0
32756,3,2756,[  9 235   4 288 175],378,3,10383,3.766050054406964,0.0,0.0
32757,3,2757,[186  69 143   9 282],374,3,10386,3.7657722987672226,0.0,0.0
32758,3,2758,[222 286 385 568 135],200,5,10391,3.76621964479884,0.0,0.0
32759,3,2759,[603 127 427  64 318],686,5,10396,3.7666666666666666,40.0,20.0
32760,3,2760,[603 127 427  64 318],686,5,10401,3.7671133647229267,40.0,20.0
32761,3,2761,[ 22 216 117 515 172],892,5,10406,3.7675597393193336,0.0,0.0
32762,3,2762,[265  56 496 216   8],883,3,10409,3.7672819399203763,0.0,0.0
32763,3,2763,[603 127 427  64 318],13,4,10413,3.7673661360347324,40.0,20.0
32764,3,2764,[427 483 132 210 546],313,5,10418,3.7678119349005423,20.0,0.0
32765,3,2765,[603 127 427  64 318],474,5,10423,3.7682574114244396,40.0,20.0
32766,3,2766,[216 678 322  50 135],749,4,10427,3.768341163715215,0.0,20.0
32767,3,2767,[143 258 323 568  69],378,3,10430,3.768063583815029,0.0,0.0
32768,3,2768,[546 328 597   4 216],533,2,10432,3.767425063199711,0.0,0.0
32769,3,2769,[603 127 427  64 318],90,5,10437,3.767870036101083,40.0,20.0
32770,3,2770,[427 186 211 202 235],313,3,10440,3.7675929267412487,0.0,0.0
32771,3,2771,[187 180  11  50 237],308,4,10444,3.7676767676767677,0.0,20.0
32772,3,2772,[603 127 427  64 318],537,4,10448,3.767760548142806,40.0,20.0
32773,3,2773,[405 195  56 286 257],533,3,10451,3.7674837779379957,0.0,0.0
32774,3,2774,[118   4 125 568 748],749,3,10454,3.7672072072072074,0.0,0.0
32775,3,2775,[603 127 427  64 318],537,4,10458,3.7672910662824206,40.0,20.0
32776,3,2776,[173 153 286 194 187],387,3,10461,3.7670147641339575,0.0,0.0
32777,3,2777,[603 127 427  64 318],537,4,10465,3.7670986321094313,40.0,20.0
32778,3,2778,[603 127 427  64 318],308,5,10470,3.7675422813961856,40.0,20.0
32779,3,2779,[186 187 235  69   1],788,2,10472,3.7669064748201437,0.0,0.0
32780,3,2780,[ 97  79  95 483  56],664,4,10476,3.766990291262136,20.0,0.0
32781,3,2781,[483 181 180 132 179],194,2,10478,3.7663551401869158,20.0,0.0
32782,3,2782,[183 405 265 135  15],374,4,10482,3.766439094502336,0.0,0.0
32783,3,2783,[  1 153 257 132 655],378,5,10487,3.766882183908046,0.0,0.0
32784,3,2784,[  8  64  56 286 216],234,2,10489,3.7662477558348293,0.0,0.0
32785,3,2785,[100 742 357 211 333],533,4,10493,3.7663316582914574,20.0,20.0
32786,3,2786,[ 25 195 176 144 257],749,4,10497,3.766415500538213,0.0,0.0
32787,3,2787,[603 127 427  64 318],666,5,10502,3.7668579626972742,40.0,20.0
32788,3,2788,[603 127 427  64 318],313,5,10507,3.7673001075654358,40.0,20.0
32789,3,2789,[603 127 427  64 318],313,5,10512,3.767741935483871,40.0,20.0
32790,3,2790,[603 127 427  64 318],271,5,10517,3.7681834467932642,40.0,20.0
32791,3,2791,[603 127 427  64 318],527,3,10520,3.767908309455587,40.0,20.0
32792,3,2792,[151 127 403 202 118],59,5,10525,3.7683494450411743,0.0,20.0
32793,3,2793,[603 127 427  64 318],90,5,10530,3.768790264853257,40.0,20.0
32794,3,2794,[603 127 427  64 318],664,5,10535,3.769230769230769,40.0,20.0
32795,3,2795,[603 127 427  64 318],666,5,10540,3.7696709585121604,40.0,20.0
32796,3,2796,[  9 196 174 328 357],207,4,10544,3.7697533071147658,20.0,20.0
32797,3,2797,[568 151 475 172 175],387,2,10546,3.769120800571837,0.0,0.0
32798,3,2798,[117 265 144  50 403],815,4,10550,3.769203286888174,0.0,20.0
32799,3,2799,[172 357 186 282 121],788,3,10553,3.7689285714285714,20.0,0.0
32800,3,2800,[168 748 204  79 181],313,3,10556,3.7686540521242415,0.0,0.0
32801,3,2801,[ 15 191 183  11 405],537,1,10557,3.767665952890792,0.0,0.0
32802,3,2802,[603 127 427  64 318],664,5,10562,3.768105601141634,40.0,20.0
32803,3,2803,[603 127 427  64 318],686,5,10567,3.7685449358059913,40.0,20.0
32804,3,2804,[111 215 496  56 471],474,4,10571,3.768627450980392,0.0,0.0
32805,3,2805,[ 64   4 183 173 475],339,5,10576,3.769066286528867,0.0,0.0
32806,3,2806,[174 427 186  12 222],343,5,10581,3.769504809405059,20.0,20.0
32807,3,2807,[ 70 204 174 294 121],659,5,10586,3.7699430199430197,0.0,20.0
32808,3,2808,[ 71 135  50 427 216],650,4,10590,3.77002491990032,0.0,20.0
32809,3,2809,[100 187 186  96 216],840,3,10593,3.7697508896797154,0.0,20.0
32810,3,2810,[603 127 427  64 318],452,5,10598,3.770188545001779,40.0,20.0
32811,3,2811,[603 127 427  64 318],527,3,10601,3.769914651493599,40.0,20.0
32812,3,2812,[238 333 282 161  69],653,3,10604,3.7696409527195165,0.0,0.0
32813,3,2813,[151 153 144 742 357],666,2,10606,3.7690120824449185,20.0,0.0
32814,3,2814,[ 50 186 182 153 742],804,5,10611,3.769449378330373,0.0,20.0
32815,3,2815,[ 12  50 265  98 179],311,4,10615,3.76953125,20.0,40.0
32816,3,2816,[603 127 427  64  50],745,3,10618,3.769258075967341,20.0,40.0
32817,3,2817,[  7 182  79 202 265],64,5,10623,3.769694819020582,0.0,0.0
32818,3,2818,[228 748 403 265 111],533,2,10625,3.7690670450514365,0.0,0.0
32819,3,2819,[179 235 403 483 655],325,3,10628,3.7687943262411348,20.0,0.0
32820,3,2820,[678 269  50 328  15],63,1,10629,3.7678128323289615,0.0,20.0
32821,3,2821,[603 127 427  64 318],90,5,10634,3.7682494684620838,40.0,20.0
32822,3,2822,[603 127 427  64 318],686,5,10639,3.7686857952532766,40.0,20.0
32823,3,2823,[228  79 423 210 194],648,5,10644,3.7691218130311617,0.0,0.0
32824,3,2824,[ 79 210 276 282 174],194,1,10645,3.768141592920354,0.0,20.0
32825,3,2825,[238 151 176 100   8],881,3,10648,3.7678697806086343,0.0,20.0
32826,3,2826,[176 427 678   9 546],7,3,10651,3.7675981605942694,0.0,0.0
32827,3,2827,[603 127 427  64 318],533,5,10656,3.768033946251768,40.0,20.0
32828,3,2828,[603 127 427  64 318],458,5,10661,3.768469423824673,40.0,20.0
32829,3,2829,[603 127 427  64 318],533,5,10666,3.7689045936395758,40.0,20.0
32830,3,2830,[245 318 197 435  98],313,4,10670,3.7689862239491347,20.0,20.0
32831,3,2831,[202 191 200  71 271],506,5,10675,3.7694209039548023,0.0,0.0
32832,3,2832,[322 496 135 175 121],804,4,10679,3.769502294387575,0.0,0.0
32833,3,2833,[228 197 144 196  96],932,4,10683,3.7695836273817926,0.0,0.0
32834,3,2834,[195 258   8 202 234],64,4,10687,3.7696649029982363,0.0,0.0
32835,3,2835,[603 127 427  64 318],458,5,10692,3.770098730606488,40.0,20.0
32836,3,2836,[ 28 289 275 168 135],474,2,10694,3.769474797321114,0.0,0.0
32837,3,2837,[603 127 427  64 318],313,5,10699,3.769908386187456,40.0,20.0
32838,3,2838,[603 127 427  64 318],326,4,10703,3.769989432898908,40.0,20.0
32839,3,2839,[175 496 294 174 385],346,4,10707,3.7700704225352113,0.0,20.0
32840,3,2840,[ 70  64 175 211 117],543,3,10710,3.7697993664202745,0.0,0.0
32841,3,2841,[197   8 185 234 132],213,4,10714,3.7698803659394793,0.0,0.0
32842,3,2842,[161 215   8 153 235],328,1,10715,3.7689060851213507,0.0,0.0
32843,3,2843,[ 12 483 471 300 125],533,5,10720,3.769338959212377,40.0,0.0
32844,3,2844,[603 127 427  64 318],271,5,10725,3.7697715289982425,40.0,20.0
32845,3,2845,[603 127 427  64 318],90,5,10730,3.770203794799719,40.0,20.0
32846,3,2846,[603 127 427  64 318],271,5,10735,3.7706357569371267,40.0,20.0
32847,3,2847,[603 127 427  64 318],664,5,10740,3.771067415730337,40.0,20.0
32848,3,2848,[403 173 235 273 197],64,3,10743,3.7707967707967707,0.0,0.0
32849,3,2849,[603 127 427  64 318],537,4,10747,3.7708771929824563,40.0,20.0
32850,3,2850,[357   1 180 211 176],313,5,10752,3.771308312872676,20.0,0.0
32851,3,2851,[603 427 127  64 318],533,5,10757,3.7717391304347827,40.0,20.0
32852,3,2852,[423 234 228 588  88],454,2,10759,3.7711181212758498,0.0,0.0
32853,3,2853,[  1  50 194  98 328],804,5,10764,3.7715487035739312,0.0,40.0
32854,3,2854,[125 187 182 282 132],788,3,10767,3.771278458844133,0.0,0.0
32855,3,2855,[ 28 322  98   9 185],883,3,10770,3.7710084033613445,0.0,20.0
32856,3,2856,[153 275 111  12  96],454,1,10771,3.770038501925096,20.0,0.0
32857,3,2857,[603 427 127  64 318],313,5,10776,3.7704688593421976,40.0,20.0
32858,3,2858,[185  56 196 179  64],311,3,10779,3.770199370409234,0.0,0.0
32859,3,2859,[195 483 117 427 127],474,5,10784,3.7706293706293708,20.0,20.0
32860,3,2860,[286 183   1 258 176],254,2,10786,3.7700104858441104,0.0,0.0
32861,3,2861,[ 71 204 603  50 181],848,5,10791,3.770440251572327,20.0,20.0
32862,3,2862,[603 427 127  64 318],664,5,10796,3.770869717079986,40.0,20.0
32863,3,2863,[186 678 185 271 568],13,1,10797,3.7699022346368714,0.0,0.0
32864,3,2864,[603 427 127  64 318],527,3,10800,3.769633507853403,40.0,20.0
32865,3,2865,[546 195  95 234 302],13,3,10803,3.769364968597348,0.0,0.0
32866,3,2866,[603 427 127  64 318],533,5,10808,3.769794209975584,40.0,20.0
32867,3,2867,[151  22 144 471 655],479,5,10813,3.7702231520223153,0.0,0.0
32868,3,2868,[603 427 127  64 318],474,5,10818,3.77065179505054,40.0,20.0
32869,3,2869,[ 97  71  69 127 151],897,5,10823,3.771080139372822,0.0,20.0
32870,3,2870,[603 427 127  64 318],271,5,10828,3.771508185301289,40.0,20.0
32871,3,2871,[161 125 181  89 237],234,0,10828,3.7701949860724233,0.0,0.0
32872,3,2872,[  4 168  89 182  98],308,4,10832,3.7702749738948835,0.0,20.0
32873,3,2873,[603 427 127  64 318],313,5,10837,3.770702853166319,40.0,20.0
32874,3,2874,[603 427 127  64 318],666,5,10842,3.771130434782609,40.0,20.0
32875,3,2875,[210 257 187  98 202],298,4,10846,3.7712100139082056,0.0,20.0
32876,3,2876,[655 515  56 173   4],194,5,10851,3.7716371220020855,0.0,0.0
32877,3,2877,[508 597 435 257   8],455,4,10855,3.771716469770674,0.0,0.0
32878,3,2878,[603 427 127  64 318],474,5,10860,3.7721431052448766,40.0,20.0
32879,3,2879,[603 427 127  64 318],59,5,10865,3.7725694444444446,40.0,20.0
32880,3,2880,[ 28 182  11 238 125],334,2,10867,3.7719541825754948,0.0,0.0
32881,3,2881,[180 435 191  97 153],234,1,10868,3.7709923664122136,0.0,0.0
32882,3,2882,[183 117 200 174 118],378,3,10871,3.770724939299341,0.0,20.0
32883,3,2883,[200  28 135 328 423],788,4,10875,3.7708044382801664,0.0,0.0
32884,3,2884,[202 568 234 127 275],533,4,10879,3.7708838821490467,0.0,20.0
32885,3,2885,[302  56  79  22 435],158,5,10884,3.771309771309771,0.0,0.0
32886,3,2886,[196 568 742  71 328],647,4,10888,3.771388985105646,0.0,0.0
32887,3,2887,[286 100 180 238 210],488,1,10889,3.7704293628808863,0.0,20.0
32888,3,2888,[238 403 210 588  12],7,5,10894,3.7708549671166494,20.0,0.0
32889,3,2889,[328 234 276 258 143],92,3,10897,3.7705882352941176,0.0,0.0
32890,3,2890,[  4 318  79 258 313],738,4,10901,3.770667589069526,20.0,0.0
32891,3,2891,[603 427 127  64 318],13,4,10905,3.770746887966805,40.0,20.0
32892,3,2892,[603 427 127  64 318],666,5,10910,3.771171793985482,40.0,20.0
32893,3,2893,[228  64 174 194 121],387,2,10912,3.7705597788527987,0.0,20.0
32894,3,2894,[174 211 125 238  96],804,5,10917,3.770984455958549,0.0,20.0
32895,3,2895,[603 427 127  64 318],664,5,10922,3.7714088397790055,40.0,20.0
32896,3,2896,[318  28 508  11  89],92,3,10925,3.77114256127028,20.0,0.0
32897,3,2897,[197  25 151 258 121],749,4,10929,3.771221532091097,0.0,0.0
32898,3,2898,[603 427 127  64 318],13,4,10933,3.7713004484304933,40.0,20.0
32899,3,2899,[257 191 168  79 132],385,1,10934,3.770344827586207,0.0,0.0
32900,3,2900,[323 237  25 568  98],804,5,10939,3.770768700448121,0.0,20.0
32901,3,2901,[603 427 127  64 318],664,5,10944,3.7711922811853893,40.0,20.0
32902,3,2902,[603 427 127  64 318],234,5,10949,3.771615570099897,40.0,20.0
32903,3,2903,[132 100 286 235 288],650,2,10951,3.7710055096418733,0.0,20.0
32904,3,2904,[222 405 333 427 435],666,2,10953,3.77039586919105,0.0,0.0
32905,3,2905,[ 50 268  71 179 216],13,3,10956,3.770130763936683,0.0,20.0
32906,3,2906,[603 427 127  64 318],527,3,10959,3.7698658410732713,40.0,20.0
32907,3,2907,[273 289 302 238 183],378,4,10963,3.7699449793672626,0.0,0.0
32908,3,2908,[318 496   7 357 118],666,4,10967,3.770024063251977,40.0,0.0
32909,3,2909,[603 427 127  64 318],326,4,10971,3.770103092783505,40.0,20.0
32910,3,2910,[603 427 127  64 318],533,5,10976,3.7705255925798693,40.0,20.0
32911,3,2911,[168 301 269 427  12],334,3,10979,3.770260989010989,20.0,0.0
32912,3,2912,[ 97 265 597  15 143],653,2,10981,3.7696532784071404,0.0,0.0
32913,3,2913,[603 427 127  64 318],234,5,10986,3.7700754975978037,40.0,20.0
32914,3,2914,[603 427 127  64 318],533,5,10991,3.770497427101201,40.0,20.0
32915,3,2915,[603 427 127  64 318],533,5,10996,3.7709190672153636,40.0,20.0
32916,3,2916,[435 135 276 100 245],533,2,10998,3.7703119643469316,0.0,20.0
32917,3,2917,[ 88 508 515  22 216],184,3,11001,3.7700479780671694,0.0,0.0
32918,3,2918,[603 427 127  64 318],664,5,11006,3.7704693388146624,40.0,20.0
32919,3,2919,[603 427 127  64 318],458,5,11011,3.7708904109589043,40.0,20.0
32920,3,2920,[603 427 127  64 318],13,4,11015,3.770968846285519,40.0,20.0
32921,3,2921,[483 151  89 179 204],932,4,11019,3.771047227926078,20.0,0.0
32922,3,2922,[483 202 211 100 496],533,5,11024,3.7714676702018473,20.0,20.0
32923,3,2923,[603 427 127  64 318],91,5,11029,3.771887824897401,40.0,20.0
32924,3,2924,[603 427 127  64 318],308,5,11034,3.772307692307692,40.0,20.0
32925,3,2925,[175 210 179 161 127],7,4,11038,3.7723855092276146,0.0,20.0
32926,3,2926,[603 427 127  64 318],666,5,11043,3.7728049197130167,40.0,20.0
32927,3,2927,[301  89 483 175 132],524,4,11047,3.772882513661202,20.0,0.0
32928,3,2928,[603 427 127  64 318],686,5,11052,3.7733014680778423,40.0,20.0
32929,3,2929,[603 427 127  64 318],664,5,11057,3.7737201365187714,40.0,20.0
32930,3,2930,[603 427 127  64 318],527,3,11060,3.7734561583077446,40.0,20.0
32931,3,2931,[323 273 655 185  97],13,2,11062,3.772851296043656,0.0,0.0
32932,3,2932,[588 100 197  82 143],64,3,11065,3.772587794067508,0.0,20.0
32933,3,2933,[235 135  25 286  64],378,4,11069,3.77266530334015,0.0,0.0
32934,3,2934,[210 172  25 180 300],271,3,11072,3.7724020442930155,0.0,0.0
32935,3,2935,[603 427 127  64 318],308,5,11077,3.7728201634877383,40.0,20.0
32936,3,2936,[202 546  89  96 435],666,4,11081,3.7728975144705483,0.0,0.0
32937,3,2937,[200 748 211 385 288],474,2,11083,3.7722940776038123,0.0,0.0
32938,3,2938,[603 427 127  64 318],7,5,11088,3.7727118067369854,40.0,20.0
32939,3,2939,[  4 191 172 357 180],385,2,11090,3.772108843537415,20.0,0.0
32940,3,2940,[118 405 748 191  15],533,3,11093,3.771846310778647,0.0,0.0
32941,3,2941,[ 69 186 181 127 161],311,4,11097,3.7719238613188306,0.0,20.0
32942,3,2942,[603 427 127  64 318],234,5,11102,3.7723411484879374,40.0,20.0
32943,3,2943,[603 427 127  64 318],90,5,11107,3.772758152173913,40.0,20.0
32944,3,2944,[742 176  97   4  88],308,4,11111,3.772835314091681,0.0,0.0
32945,3,2945,[ 97 210 357 276 496],537,3,11114,3.772572980312288,20.0,0.0
32946,3,2946,[603 175 597 195 181],650,4,11118,3.7726501526976586,20.0,0.0
32947,3,2947,[603 427 127  64 318],308,5,11123,3.773066485753053,40.0,20.0
32948,3,2948,[ 69 275  56  82 118],7,3,11126,3.772804340454391,0.0,0.0
32949,3,2949,[603 427 127  64 318],326,4,11130,3.772881355932203,40.0,20.0
32950,3,2950,[180 603 385  96 174],313,5,11135,3.7732971873941037,20.0,20.0
32951,3,2951,[603 427 127  64 318],59,5,11140,3.7737127371273713,40.0,20.0
32952,3,2952,[603 427 127  64 318],90,5,11145,3.774128005418219,40.0,20.0
32953,3,2953,[273 301 191 282 135],666,3,11148,3.773865944482058,0.0,0.0
32954,3,2954,[183 151 357 144 132],749,5,11153,3.7742808798646363,20.0,0.0
32955,3,2955,[603 597  98 173 294],213,4,11157,3.774357239512855,20.0,20.0
32956,3,2956,[153  64 182 187 196],664,5,11162,3.774771728102807,0.0,0.0
32957,3,2957,[603 427 127  64 318],59,5,11167,3.7751859364435427,40.0,20.0
32958,3,2958,[235 385 172  95 282],200,4,11171,3.7752619128083813,0.0,0.0
32959,3,2959,[603 427 127  64 318],271,5,11176,3.7756756756756755,40.0,20.0
32960,3,2960,[603 427 127  64 318],7,5,11181,3.7760891590678827,40.0,20.0
32961,3,2961,[603 427 127  64 318],537,4,11185,3.776164753544902,40.0,20.0
32962,3,2962,[603 427 127  64 318],271,5,11190,3.7765777927775903,40.0,20.0
32963,3,2963,[  8 175 588 183 237],7,5,11195,3.7769905533063426,0.0,0.0
32964,3,2964,[603 427 127  64 318],234,5,11200,3.7774030354131534,40.0,20.0
32965,3,2965,[483 588 183 235 176],59,3,11203,3.77714093054619,20.0,0.0
32966,3,2966,[603 427 127  64 318],458,5,11208,3.777553083923155,40.0,20.0
32967,3,2967,[132 194  89 435 197],60,5,11213,3.7779649595687332,0.0,0.0
32968,3,2968,[ 98  71 144 405 546],13,3,11216,3.7777029302795553,0.0,20.0
32969,3,2969,[603 427 127  64 318],13,4,11220,3.7777777777777777,40.0,20.0
32970,3,2970,[222 200 194 195  56],650,4,11224,3.777852574890609,0.0,0.0
32971,3,2971,[603 427 127  64 483],234,5,11229,3.778263795423957,40.0,20.0
32972,3,2972,[603 427 127  64 483],339,5,11234,3.7786747393205515,40.0,20.0
32973,3,2973,[172  50 196 475 117],455,4,11238,3.7787491593813045,0.0,20.0
32974,3,2974,[ 15 211 515  79   4],882,5,11243,3.779159663865546,0.0,0.0
32975,3,2975,[ 28 210 121  70 273],279,2,11245,3.778561827956989,0.0,0.0
32976,3,2976,[603 427 127  64 483],745,3,11248,3.7783003023177697,40.0,20.0
32977,3,2977,[678 238 194  98  79],7,4,11252,3.778374748153123,0.0,20.0
32978,3,2978,[603 427 127  64 318],666,5,11257,3.7787848271231956,40.0,20.0
32979,3,2979,[603 427 127  64 318],91,5,11262,3.779194630872483,40.0,20.0
32980,3,2980,[  1  12 568   7  56],379,5,11267,3.7796041596779606,20.0,0.0
32981,3,2981,[508 238 204  79 125],213,5,11272,3.780013413816231,0.0,0.0
32982,3,2982,[603 427 127  64 318],91,5,11277,3.780422393563527,40.0,20.0
32983,3,2983,[603 427 127  64 318],271,5,11282,3.7808310991957104,40.0,20.0
32984,3,2984,[508  71 282 132  97],533,4,11286,3.7809045226130653,0.0,0.0
32985,3,2985,[222 427 597 286 403],788,1,11287,3.7799732083054254,0.0,0.0
32986,3,2986,[603 427 127  64 318],59,5,11292,3.7803816538332775,40.0,20.0
32987,3,2987,[603 427 127  64 318],271,5,11297,3.780789825970549,40.0,20.0
32988,3,2988,[603 427 127  64 318],474,5,11302,3.781197724991636,40.0,20.0
32989,3,2989,[603 427 127  64 318],313,5,11307,3.7816053511705685,40.0,20.0
32990,3,2990,[403 546  25 234 211],343,2,11309,3.7810096957539283,0.0,0.0
32991,3,2991,[  7 237  89 294 135],788,3,11312,3.7807486631016043,0.0,0.0
32992,3,2992,[ 64   9 222 175 143],749,2,11314,3.7801536919478784,0.0,0.0
32993,3,2993,[603 427 127  64 318],686,5,11319,3.780561122244489,40.0,20.0
32994,3,2994,[568 100 275 323 471],537,2,11321,3.779966611018364,0.0,20.0
32995,3,2995,[603 427 127  64 318],271,5,11326,3.7803738317757007,40.0,20.0
32996,3,2996,[603 427 127  64 318],326,4,11330,3.780447113780447,40.0,20.0
32997,3,2997,[288 183 597 245 515],102,1,11331,3.7795196797865245,0.0,0.0
32998,3,2998,[300 186  97 176 195],774,1,11332,3.778592864288096,0.0,0.0
32999,3,2999,[603 427 127  64 318],271,5,11337,3.779,40.0,20.0
33000,3,3000,[603 427 127  64 318],666,5,11342,3.7794068643785406,40.0,20.0
33001,3,3001,[603 427 127  64 318],91,5,11347,3.77981345769487,40.0,20.0
33002,3,3002,[603 427 127  64 318],90,5,11352,3.78021978021978,40.0,20.0
33003,3,3003,[144 161  69 385 323],13,3,11355,3.7799600532623168,0.0,0.0
33004,3,3004,[748 289 151 405 216],533,1,11356,3.7790349417637272,0.0,0.0
33005,3,3005,[678  70 282 210  89],804,5,11361,3.779441117764471,0.0,0.0
33006,3,3006,[300 237 228  89 111],334,3,11364,3.7791819088792815,0.0,0.0
33007,3,3007,[125   8 257 204 196],254,3,11367,3.7789228723404253,0.0,0.0
33008,3,3008,[202 423  22  70 216],537,1,11368,3.777999335327351,0.0,0.0
33009,3,3009,[603 427 127  64 318],537,4,11372,3.778073089700997,40.0,20.0
33010,3,3010,[135 202  70 222 273],13,2,11374,3.7774825639322485,0.0,0.0
33011,3,3011,[742 182  97  69 176],650,1,11375,3.7765604249667994,0.0,0.0
33012,3,3012,[222 204 144  64  88],454,4,11379,3.776634583471623,0.0,0.0
33013,3,3013,[597   7 174 194 168],653,2,11381,3.776045122760451,0.0,20.0
33014,3,3014,[405  12 275 100 271],537,2,11383,3.7754560530679933,20.0,20.0
33015,3,3015,[742 186  79 111 333],653,3,11386,3.7751989389920424,0.0,0.0
33016,3,3016,[603 427 127  64 318],59,5,11391,3.7756049055353,40.0,20.0
33017,3,3017,[187 265 286   7 300],7,5,11396,3.7760106030483764,0.0,0.0
33018,3,3018,[603 427 127  64 318],313,5,11401,3.776416031798609,40.0,20.0
33019,3,3019,[210 276   9  98 333],605,4,11405,3.7764900662251657,0.0,20.0
33020,3,3020,[603 427 127  64 318],59,5,11410,3.776895067858325,40.0,20.0
33021,3,3021,[603 427 127  64 318],271,5,11415,3.7772998014559893,40.0,20.0
33022,3,3022,[603 427 127  64 318],59,5,11420,3.7777042672841548,40.0,20.0
33023,3,3023,[186 132 289 168  89],474,3,11423,3.7774470899470898,0.0,0.0
33024,3,3024,[ 50 288 268 515  70],537,4,11427,3.7775206611570247,0.0,20.0
33025,3,3025,[ 95 597  79  82 173],650,1,11428,3.7766027759418375,0.0,0.0
33026,3,3026,[603 427 127  64 318],474,5,11433,3.7770069375619424,40.0,20.0
33027,3,3027,[603 427 127  64 318],537,4,11437,3.777080581241744,40.0,20.0
33028,3,3028,[  4 322 179 588 176],308,4,11441,3.777154176295807,0.0,0.0
33029,3,3029,[603 427 127  64 318],686,5,11446,3.7775577557755775,40.0,20.0
33030,3,3030,[228 313 475 427 172],533,4,11450,3.7776311448366875,0.0,0.0
33031,3,3031,[265  95 282  56 313],334,3,11453,3.7773746701846966,0.0,0.0
33032,3,3032,[603 427 127  64 318],537,4,11457,3.777448071216617,40.0,20.0
33033,3,3033,[423 211 275   1 216],6,4,11461,3.777521423862887,0.0,0.0
33034,3,3034,[603 427 127  64 318],452,5,11466,3.7779242174629326,40.0,20.0
33035,3,3035,[603 427 127  64 318],59,5,11471,3.7783267457180503,40.0,20.0
33036,3,3036,[603 427 127  64 318],234,5,11476,3.7787290088903522,40.0,20.0
33037,3,3037,[603 427 127  64 318],533,5,11481,3.7791310072416064,40.0,20.0
33038,3,3038,[174  97 143 210 187],897,5,11486,3.7795327410332344,0.0,20.0
33039,3,3039,[603 427 127  64 318],452,5,11491,3.779934210526316,40.0,20.0
33040,3,3040,[603 427 127  64 318],313,5,11496,3.780335415981585,40.0,20.0
33041,3,3041,[603 427 127  64 318],686,5,11501,3.7807363576594346,40.0,20.0
33042,3,3042,[603 427 127  64 318],537,4,11505,3.780808412750575,40.0,20.0
33043,3,3043,[603 427 127  64 318],537,4,11509,3.780880420499343,40.0,20.0
33044,3,3044,[228  11 181 117 301],145,5,11514,3.78128078817734,0.0,0.0
33045,3,3045,[603 427 127  64 318],234,5,11519,3.781680892974393,40.0,20.0
33046,3,3046,[603 427 127  64 318],474,5,11524,3.7820807351493273,40.0,20.0
33047,3,3047,[603 427 127  64 318],13,4,11528,3.7821522309711284,40.0,20.0
33048,3,3048,[  4 655   8 176   9],308,5,11533,3.7825516562807477,0.0,0.0
33049,3,3049,[185 403 121 678 385],648,4,11537,3.7826229508196723,0.0,0.0
33050,3,3050,[603 427 127  64 318],7,5,11542,3.7830219600131105,40.0,20.0
33051,3,3051,[ 69 185 121 546 182],804,4,11546,3.7830930537352554,0.0,0.0
33052,3,3052,[603 427 127  64 318],326,4,11550,3.783164100884376,40.0,20.0
33053,3,3053,[132 194 228 174 294],234,2,11552,3.782580222658808,0.0,20.0
33054,3,3054,[423 435  71 197 328],85,4,11556,3.7826513911620294,0.0,0.0
33055,3,3055,[603 427 127  64 318],458,5,11561,3.783049738219895,40.0,20.0
33056,3,3056,[ 50 153 427 318 403],13,3,11564,3.7827935884854433,20.0,20.0
33057,3,3057,[ 97 273 276 318 289],90,3,11567,3.7825376062786136,20.0,0.0
33058,3,3058,[405 135  79 195 175],653,3,11570,3.7822817914351097,0.0,0.0
33059,3,3059,[ 11  64 185  98 197],454,2,11572,3.7816993464052286,0.0,20.0
33060,3,3060,[257 179 655 144 196],738,2,11574,3.7811172819340086,0.0,0.0
33061,3,3061,[ 96 191  70 168 173],940,3,11577,3.7808621815806664,0.0,0.0
33062,3,3062,[603 427 127  64 318],59,5,11582,3.781260202415932,40.0,20.0
33063,3,3063,[603 427 127  64 318],533,5,11587,3.781657963446475,40.0,20.0
33064,3,3064,[153 186  50 100 748],328,3,11590,3.7814029363784667,0.0,40.0
33065,3,3065,[ 79 179 161  89 127],59,4,11594,3.781474233529028,0.0,20.0
33066,3,3066,[475 318 121 100 742],533,4,11598,3.7815454841865015,20.0,20.0
33067,3,3067,[200 282 385 288  82],804,3,11601,3.78129074315515,0.0,0.0
33068,3,3068,[603 427 127  64 318],686,5,11606,3.781687846203975,40.0,20.0
33069,3,3069,[603 427 127  64 318],234,5,11611,3.782084690553746,40.0,20.0
33070,3,3070,[132 181 196  98 185],271,4,11615,3.7821556496255293,0.0,20.0
33071,3,3071,[603 427 127  64 318],527,3,11618,3.7819010416666665,40.0,20.0
33072,3,3072,[  4 143 183 496 173],194,3,11621,3.781646599414253,0.0,0.0
33073,3,3073,[245 273 204 603 597],458,3,11624,3.781392322706571,20.0,0.0
33074,3,3074,[603 427 127  64  50],13,5,11629,3.781788617886179,20.0,40.0
33075,3,3075,[204   1  69 222 132],313,4,11633,3.78185955786736,0.0,0.0
33076,3,3076,[258  82 568 597  71],788,1,11634,3.780955476113097,0.0,0.0
33077,3,3077,[603 427 127  64  50],537,4,11638,3.7810266406757633,20.0,40.0
33078,3,3078,[176 153 144  97 294],234,0,11638,3.7797986359207534,0.0,0.0
33079,3,3079,[174 176 496 471 187],7,4,11642,3.77987012987013,0.0,20.0
33080,3,3080,[603 427 127  64  50],308,5,11647,3.7802661473547547,20.0,40.0
33081,3,3081,[202 179 200 483 176],95,1,11648,3.7793640493186245,20.0,0.0
33082,3,3082,[603 427 127  64  50],13,5,11653,3.779759974051249,20.0,40.0
33083,3,3083,[603 427 127  64  50],326,4,11657,3.7798313878080414,20.0,40.0
33084,3,3084,[313 161 187   7 168],13,4,11661,3.779902755267423,0.0,0.0
33085,3,3085,[603 427 127  64  50],339,5,11666,3.780298120544394,20.0,40.0
33086,3,3086,[603 427 127  64  50],234,5,11671,3.7806932296728215,20.0,40.0
33087,3,3087,[515 471 313 286 288],474,3,11674,3.780440414507772,0.0,0.0
33088,3,3088,[ 88 328 117  64 235],537,0,11674,3.7792165749433475,0.0,0.0
33089,3,3089,[603 427 127  64  50],7,5,11679,3.7796116504854367,20.0,40.0
33090,3,3090,[435 210  95  98 427],234,2,11681,3.7790359107085085,0.0,20.0
33091,3,3091,[603 427 127  64  50],313,5,11686,3.7794307891332473,20.0,40.0
33092,3,3092,[603 427 127  64  50],686,5,11691,3.7798254122211445,20.0,40.0
33093,3,3093,[ 96 328 204 405 202],533,4,11695,3.779896574014221,0.0,0.0
33094,3,3094,[172 173 588 100 132],234,2,11697,3.7793214862681745,0.0,20.0
33095,3,3095,[405 180 121  64 135],213,4,11701,3.779392764857881,0.0,0.0
33096,3,3096,[603 427 127  64  50],745,3,11704,3.7791411042944785,20.0,40.0
33097,3,3097,[258 215 678 300   9],488,4,11708,3.7792123950936087,0.0,0.0
33098,3,3098,[655 515  96 144 175],13,4,11712,3.7792836398838334,0.0,0.0
33099,3,3099,[603 427 127  64  50],91,5,11717,3.779677419354839,20.0,40.0
33100,3,3100,[172 258 175  79 187],85,4,11721,3.7797484682360527,0.0,0.0
33101,3,3101,[603 427 127  64  50],458,4,11725,3.779819471308833,20.0,40.0
33102,3,3102,[195   9  28  98   4],194,4,11729,3.779890428617467,0.0,20.0
33103,3,3103,[678  64  56 238  50],474,4,11733,3.7799613402061856,0.0,20.0
33104,3,3104,[ 69  98 179 483 294],753,4,11737,3.7800322061191625,20.0,20.0
33105,3,3105,[603 427 127  64 318],666,5,11742,3.780424983902125,40.0,20.0
33106,3,3106,[ 79 118 202 176 172],650,3,11745,3.7801738010943033,0.0,0.0
33107,3,3107,[603 427 127  64 318],59,5,11750,3.7805662805662807,40.0,20.0
33108,3,3108,[ 28 435 210  97 200],298,4,11754,3.7806368607269216,0.0,0.0
33109,3,3109,[269 191 257 168 185],339,5,11759,3.7810289389067524,0.0,0.0
33110,3,3110,[234 211 175 286 333],343,3,11762,3.7807778849244618,0.0,0.0
33111,3,3111,[328 237 186 318 475],533,2,11764,3.7802056555269923,20.0,0.0
33112,3,3112,[245 357 100  64 153],90,4,11768,3.780276260841632,20.0,20.0
33113,3,3113,[603 427 127  64 318],7,5,11773,3.780667951188182,40.0,20.0
33114,3,3114,[ 15 423 328 289  70],271,3,11776,3.780417335473515,0.0,0.0
33115,3,3115,[546 235 742 186 204],833,1,11777,3.779525032092426,0.0,0.0
33116,3,3116,[ 71 121 294 276  50],13,4,11781,3.7795957651588066,0.0,20.0
33117,3,3117,[603 427 127  64 318],666,5,11786,3.7799871712636306,40.0,20.0
33118,3,3118,[603 427 127  64 318],234,5,11791,3.7803783263866624,40.0,20.0
33119,3,3119,[ 56 588 275 276 328],378,4,11795,3.780448717948718,0.0,0.0
33120,3,3120,[357 742 117 172 151],653,2,11797,3.779878244152515,20.0,0.0
33121,3,3121,[275  12  89 197  50],378,4,11801,3.7799487508007688,20.0,20.0
33122,3,3122,[603 427 127  64 318],533,5,11806,3.7803394172270255,40.0,20.0
33123,3,3123,[215 168 328  71 200],749,5,11811,3.7807298335467348,0.0,0.0
33124,3,3124,[ 82 222 423  98 322],537,0,11811,3.77952,0.0,20.0
33125,3,3125,[228 471 196 180 117],479,4,11815,3.7795905310300704,0.0,0.0
33126,3,3126,[185 125 302 301  11],788,2,11817,3.7790214262871764,0.0,0.0
33127,3,3127,[603 427 127  64 318],91,5,11822,3.7794117647058822,40.0,20.0
33128,3,3128,[265 200 204  50 168],890,4,11826,3.779482262703739,0.0,20.0
33129,3,3129,[191   7 135 186 194],666,3,11829,3.7792332268370608,0.0,0.0
33130,3,3130,[568 257 143 151 200],374,2,11831,3.7786649632705207,0.0,0.0
33131,3,3131,[603 427 127  64 318],537,4,11835,3.778735632183908,40.0,20.0
33132,3,3132,[216 100 265 174 294],194,4,11839,3.778806255984679,0.0,40.0
33133,3,3133,[603 427 127  64 318],90,5,11844,3.7791959157626036,40.0,20.0
33134,3,3134,[603 427 127  64 318],537,4,11848,3.7792663476874004,40.0,20.0
33135,3,3135,[603 427 127  64 318],474,5,11853,3.779655612244898,40.0,20.0
33136,3,3136,[286 328 174  82 143],207,2,11855,3.77908830092445,0.0,20.0
33137,3,3137,[234 183 185  50 546],339,5,11860,3.779477374123646,0.0,20.0
33138,3,3138,[211   9 275 603   1],13,2,11862,3.778910481044919,20.0,0.0
33139,3,3139,[405 588 181  82 144],194,2,11864,3.778343949044586,0.0,0.0
33140,3,3140,[195  11  28 385  95],387,2,11866,3.7777777777777777,0.0,0.0
33141,3,3141,[603 427 127  64 318],664,5,11871,3.7781667727562063,40.0,20.0
33142,3,3142,[603 427 127  64 318],7,5,11876,3.778555520203627,40.0,20.0
33143,3,3143,[ 98 135  95 127   1],234,3,11879,3.7783078880407124,0.0,40.0
33144,3,3144,[515 357  50 174 546],774,1,11880,3.7774244833068362,20.0,40.0
33145,3,3145,[182 118 301 179 286],666,4,11884,3.7774952320406867,0.0,0.0
33146,3,3146,[603 427 127  64 318],91,5,11889,3.7778836987607245,40.0,20.0
33147,3,3147,[603 427 127  64 318],664,5,11894,3.778271918678526,40.0,20.0
33148,3,3148,[603 427 127  64 318],537,4,11898,3.778342330898698,40.0,20.0
33149,3,3149,[435 121 144 183 742],666,2,11900,3.7777777777777777,0.0,0.0
33150,3,3150,[603 427 127  64 318],91,5,11905,3.7781656616947,40.0,20.0
33151,3,3151,[135 153  28 196   4],334,3,11908,3.777918781725888,0.0,0.0
33152,3,3152,[186 143 174   8  69],343,5,11913,3.7783063748810655,0.0,20.0
33153,3,3153,[ 79 403  97 196 238],379,4,11917,3.778376664552949,0.0,0.0
33154,3,3154,[603 427 127  64 318],664,5,11922,3.7787638668779713,40.0,20.0
33155,3,3155,[603 427 127  64 318],458,5,11927,3.77915082382763,40.0,20.0
33156,3,3156,[603 427 127  64 318],326,4,11931,3.779220779220779,40.0,20.0
33157,3,3157,[603 427 127  64 318],308,5,11936,3.779607346421786,40.0,20.0
33158,3,3158,[144 202 748  71 603],454,3,11939,3.779360557138335,20.0,0.0
33159,3,3159,[ 82 196 168 210  97],840,2,11941,3.7787974683544303,0.0,0.0
33160,3,3160,[603 427 127  64 318],234,5,11946,3.779183802594116,40.0,20.0
33161,3,3161,[385 475 265 235  96],374,3,11949,3.7789373814041745,0.0,0.0
33162,3,3162,[603 427 127  64 318],664,5,11954,3.779323427126146,40.0,20.0
33163,3,3163,[180 144 118 234 403],543,4,11958,3.779393173198483,0.0,0.0
33164,3,3164,[  1  89 176 313   7],815,5,11963,3.7797788309636653,0.0,0.0
33165,3,3165,[  9 182 301 568 471],119,5,11968,3.7801642451042325,0.0,0.0
33166,3,3166,[172 568 176 153 271],883,3,11971,3.7799179033785917,0.0,0.0
33167,3,3167,[357 180 132 100 328],313,5,11976,3.7803030303030303,20.0,20.0
33168,3,3168,[313  98  22 475  12],13,4,11980,3.7803723572104766,20.0,20.0
33169,3,3169,[ 95 328 271 204 234],537,0,11980,3.779179810725552,0.0,0.0
33170,3,3170,[276 195 471  97 313],537,2,11982,3.7786187322611164,0.0,0.0
33171,3,3171,[276 191 180 748 186],207,2,11984,3.7780580075662042,0.0,0.0
33172,3,3172,[  9   8  69 185 508],406,5,11989,3.7784431137724552,0.0,0.0
33173,3,3173,[603 427 127  64 318],533,5,11994,3.77882797731569,40.0,20.0
33174,3,3174,[603 427 127  64 318],533,5,11999,3.7792125984251967,40.0,20.0
33175,3,3175,[ 89  69  56 265 496],804,4,12003,3.7792821158690177,0.0,0.0
33176,3,3176,[ 82 153  50 276 144],538,4,12007,3.77935158954989,0.0,20.0
33177,3,3177,[191 127 322  79  56],90,5,12012,3.7797356828193833,0.0,20.0
33178,3,3178,[603 427 127  64 318],234,5,12017,3.7801195344447938,40.0,20.0
33179,3,3179,[603 427 127  64 318],90,5,12022,3.780503144654088,40.0,20.0
33180,3,3180,[179   8 204 195 196],378,3,12025,3.780257780572147,0.0,0.0
33181,3,3181,[ 96 215  22  69 588],144,5,12030,3.7806411062225016,0.0,0.0
33182,3,3182,[257 210 357 197 496],95,5,12035,3.7810241910147657,20.0,0.0
33183,3,3183,[  9 496 216 100  50],308,3,12038,3.7807788944723617,0.0,40.0
33184,3,3184,[603 427 127  64  50],452,5,12043,3.78116169544741,20.0,40.0
33185,3,3185,[603 427 127  64  50],59,5,12048,3.7815442561205272,20.0,40.0
33186,3,3186,[603 427 127  64  50],533,5,12053,3.7819265767179164,20.0,40.0
33187,3,3187,[204 185 269 132 216],650,4,12057,3.7819949811794227,0.0,0.0
33188,3,3188,[603 427 127  64  50],59,5,12062,3.782376920664785,20.0,40.0
33189,3,3189,[603 427 127  64  50],452,5,12067,3.782758620689655,20.0,40.0
33190,3,3190,[ 22 273 237 173 546],378,4,12071,3.7828267000940143,0.0,0.0
33191,3,3191,[151 258 121 300 328],395,2,12073,3.782268170426065,0.0,0.0
33192,3,3192,[ 12  15 427 117 172],374,2,12075,3.781709990604447,20.0,0.0
33193,3,3193,[603 427 127  64  50],271,5,12080,3.7820914214151533,20.0,40.0
33194,3,3194,[603 427 127  64  50],326,4,12084,3.7821596244131457,20.0,40.0
33195,3,3195,[268   7 265 302 603],537,4,12088,3.782227784730914,20.0,0.0
33196,3,3196,[ 82 385 300 235  70],87,3,12091,3.781983109164842,0.0,0.0
33197,3,3197,[603 427 127  64  50],537,4,12095,3.782051282051282,20.0,40.0
33198,3,3198,[603 427 127  64  50],474,5,12100,3.782432010003126,20.0,40.0
33199,3,3199,[322  50 483  70 427],308,3,12103,3.7821875,20.0,20.0
33200,3,3200,[603 427 127  64  50],398,5,12108,3.782567947516401,20.0,40.0
33201,3,3201,[603 427 127  64  50],308,5,12113,3.782948157401624,20.0,40.0
33202,3,3202,[294 597 132 313   4],533,3,12116,3.7827037152669374,0.0,0.0
33203,3,3203,[603 427 127  64  50],398,5,12121,3.783083645443196,20.0,40.0
33204,3,3204,[603 427 127  64  50],527,4,12125,3.783151326053042,20.0,40.0
33205,3,3205,[118 172  56 234   4],643,4,12129,3.783218964441672,0.0,0.0
33206,3,3206,[603 427 127  50  64],59,5,12134,3.7835983785469285,20.0,40.0
33207,3,3207,[603 427 127  50  64],664,5,12139,3.7839775561097255,20.0,40.0
33208,3,3208,[603 427 127  50  64],59,5,12144,3.7843564973511996,20.0,40.0
33209,3,3209,[603 427 127  50  64],527,4,12148,3.784423676012461,20.0,40.0
33210,3,3210,[318 275 196 423 161],64,4,12152,3.7844908128308936,20.0,0.0
33211,3,3211,[318 121 185 179 269],7,4,12156,3.784557907845579,20.0,0.0
33212,3,3212,[181 174  71 483 118],7,3,12159,3.784313725490196,20.0,20.0
33213,3,3213,[603 427 127  50  64],379,5,12164,3.7846919726197883,20.0,40.0
33214,3,3214,[603 427 127  50  64],7,5,12169,3.7850699844479005,20.0,40.0
33215,3,3215,[483  22 210 655  25],207,3,12172,3.7848258706467663,20.0,0.0
33216,3,3216,[515 153 183 202 194],7,3,12175,3.7845819086105066,0.0,0.0
33217,3,3217,[603 427 127  50  64],745,3,12178,3.7843380981976384,20.0,40.0
33218,3,3218,[ 79  22 144 191 357],7,5,12183,3.7847157502329916,20.0,0.0
33219,3,3219,[  7 197 168 202 210],64,3,12186,3.784472049689441,0.0,0.0
33220,3,3220,[603 427 127  64  50],271,5,12191,3.78484942564421,20.0,40.0
33221,3,3221,[ 98 603 125 121 333],815,2,12193,3.7842954686530104,20.0,20.0
33222,3,3222,[603 427 127  64  50],59,5,12198,3.78467266521874,20.0,40.0
33223,3,3223,[603 427 127  50  64],664,5,12203,3.785049627791563,20.0,40.0
33224,3,3224,[603 427 127  50  64],537,4,12207,3.785116279069767,20.0,40.0
33225,3,3225,[276 597  15  89 294],308,2,12209,3.7845629262244267,0.0,0.0
33226,3,3226,[508 174 282  88 288],378,4,12213,3.784629687015804,0.0,20.0
33227,3,3227,[603 427 127  50  64],533,5,12218,3.785006195786865,20.0,40.0
33228,3,3228,[  4 216  98 186 237],690,4,12222,3.78507277794983,0.0,20.0
33229,3,3229,[603 427 127  50  64],686,5,12227,3.7854489164086687,20.0,40.0
33230,3,3230,[603 427 127  50  64],474,5,12232,3.7858248220365214,20.0,40.0
33231,3,3231,[603 427 127  50  64],664,5,12237,3.786200495049505,20.0,40.0
33232,3,3232,[202 546 168 195 125],92,3,12240,3.7859573151871326,0.0,0.0
33233,3,3233,[191 187  70 186 288],474,4,12244,3.7860235003092146,0.0,0.0
33234,3,3234,[603 427 127  50  64],452,5,12249,3.7863987635239567,20.0,40.0
33235,3,3235,[603 427 127  50  64],379,5,12254,3.7867737948084055,20.0,40.0
33236,3,3236,[603 427 127  50  64],474,5,12259,3.78714859437751,20.0,40.0
33237,3,3237,[ 89 288 286 235 289],334,2,12261,3.7865966646077824,0.0,0.0
33238,3,3238,[603 427 127  50  64],91,5,12266,3.7869712874343935,20.0,40.0
33239,3,3239,[ 79 273  89 318  25],7,3,12269,3.7867283950617283,20.0,0.0
33240,3,3240,[603 427 127  50  64],308,5,12274,3.787102746066029,20.0,40.0
33241,3,3241,[603 427 127  50  64],458,4,12278,3.787168414558914,20.0,40.0
33242,3,3242,[603 427 127  50  64],686,5,12283,3.7875423990132595,20.0,40.0
33243,3,3243,[196 423 318  64 143],311,4,12287,3.787607891491985,20.0,0.0
33244,3,3244,[  8 357  50 385 333],13,2,12289,3.787057010785824,20.0,20.0
33245,3,3245,[603 427 127  50  64],527,4,12293,3.7871226124460873,20.0,40.0
33246,3,3246,[ 25 333  56 181 603],13,3,12296,3.78688019710502,20.0,0.0
33247,3,3247,[125  22  96 176 333],313,3,12299,3.7866379310344827,0.0,0.0
33248,3,3248,[238 423  96  98 183],295,3,12302,3.786395814096645,0.0,20.0
33249,3,3249,[603 427 127  50  64],7,5,12307,3.786769230769231,20.0,40.0
33250,3,3250,[228 515 238 222   8],311,5,12312,3.787142417717625,0.0,0.0
33251,3,3251,[603 427 127  50  64],452,5,12317,3.7875153751537516,20.0,40.0
33252,3,3252,[195 132  98  22 289],474,4,12321,3.7875806947433137,0.0,20.0
33253,3,3253,[603 427 127  50  64],13,5,12326,3.7879532882606024,20.0,40.0
33254,3,3254,[603 427 127  50  64],686,5,12331,3.788325652841782,20.0,40.0
33255,3,3255,[603 427 127  50  64],537,4,12335,3.7883906633906634,20.0,40.0
33256,3,3256,[194 186 238 197  50],840,4,12339,3.788455634019036,0.0,20.0
33257,3,3257,[183 742 144 294 191],378,4,12343,3.7885205647636586,0.0,0.0
33258,3,3258,[603 427 127  50  64],91,5,12348,3.7888922982509974,20.0,40.0
33259,3,3259,[603 427 127  50  64],234,5,12353,3.789263803680982,20.0,40.0
33260,3,3260,[603 427 127  50  64],326,4,12357,3.7893284268629257,20.0,40.0
33261,3,3261,[  9   7 197 181 180],60,5,12362,3.7896995708154506,0.0,0.0
33262,3,3262,[121  50 117 323 289],564,4,12366,3.789764020839718,0.0,20.0
33263,3,3263,[603 427 127  50  64],7,5,12371,3.7901348039215685,20.0,40.0
33264,3,3264,[603 427 127  50  64],527,4,12375,3.790199081163859,20.0,40.0
33265,3,3265,[ 71 100 357 475  98],533,3,12378,3.789957134109002,20.0,40.0
33266,3,3266,[603 427 127  50  64],326,4,12382,3.7900214263850627,20.0,40.0
33267,3,3267,[603 427 127  50  64],533,5,12387,3.790391676866585,20.0,40.0
33268,3,3268,[603 427 127  50  64],308,5,12392,3.7907617008259407,20.0,40.0
33269,3,3269,[603 427 127  50  64],686,5,12397,3.791131498470948,20.0,40.0
33270,3,3270,[302 288 546 435  79],339,4,12401,3.7911953531030265,0.0,0.0
33271,3,3271,[603 427 127  50  64],745,3,12404,3.790953545232274,20.0,40.0
33272,3,3272,[121 748 200 423  98],474,3,12407,3.7907118851206842,0.0,20.0
33273,3,3273,[471 228 111   4  79],537,0,12407,3.789554062309102,0.0,0.0
33274,3,3274,[603 427 127  50  64],474,5,12412,3.789923664122137,20.0,40.0
33275,3,3275,[603 427 127  50  64],669,5,12417,3.79029304029304,20.0,40.0
33276,3,3276,[603 427 127  50  64],398,5,12422,3.7906621910283795,20.0,40.0
33277,3,3277,[132 211 191 135 234],385,1,12423,3.789810860280659,0.0,0.0
33278,3,3278,[603 427 127  50  64],326,4,12427,3.7898749618786214,20.0,40.0
33279,3,3279,[191 423 200  89 483],13,3,12430,3.7896341463414633,20.0,0.0
33280,3,3280,[603 427 127  50  64],458,4,12434,3.789698262724779,20.0,40.0
33281,3,3281,[100 471 385 286 185],524,4,12438,3.789762340036563,0.0,20.0
33282,3,3282,[603 427 127  50  64],527,4,12442,3.7898263783125192,20.0,40.0
33283,3,3283,[603 427 127  50  64],398,5,12447,3.7901948842874544,20.0,40.0
33284,3,3284,[603 427 127  50  64],271,5,12452,3.7905631659056316,20.0,40.0
33285,3,3285,[603 427 127  50  64],745,3,12455,3.7903225806451615,20.0,40.0
33286,3,3286,[153  28 173 294 234],804,5,12460,3.7906905993306967,0.0,0.0
33287,3,3287,[385 202  64 153   8],398,2,12462,3.79014598540146,0.0,0.0
33288,3,3288,[603 427 127  50  64],527,4,12466,3.7902097902097904,20.0,40.0
33289,3,3289,[211   8 161 222 121],474,5,12471,3.790577507598784,0.0,0.0
33290,3,3290,[405   8 168 173  56],7,4,12475,3.7906411425098754,0.0,0.0
33291,3,3291,[603 427 127  50  64],533,5,12480,3.7910085054678007,20.0,40.0
33292,3,3292,[168 471 210 237 202],13,3,12483,3.790768296386274,0.0,0.0
33293,3,3293,[204 181 286 603 200],474,4,12487,3.7908318154219796,20.0,0.0
33294,3,3294,[257 234  22 286 427],454,3,12490,3.7905918057663124,0.0,0.0
33295,3,3295,[603 427 127  50  64],398,5,12495,3.7909587378640777,20.0,40.0
33296,3,3296,[197 288 235 496 215],378,2,12497,3.7904155292690325,0.0,0.0
33297,3,3297,[546 211 168  50 196],234,1,12498,3.7895694360218313,0.0,20.0
33298,3,3298,[603 427 127  50  64],686,5,12503,3.789936344346772,20.0,40.0
33299,3,3299,[603 427 127  50  64],664,5,12508,3.7903030303030305,20.0,40.0
33300,3,3300,[508 174 121 269 117],334,1,12509,3.789457740078764,0.0,20.0
33301,3,3301,[603 427 127  50  64],91,5,12514,3.789824348879467,20.0,40.0
33302,3,3302,[118 238  22 195  71],804,5,12519,3.790190735694823,0.0,0.0
33303,3,3303,[603 427 127  50  64],7,5,12524,3.790556900726392,20.0,40.0
33304,3,3304,[603 427 127  50  64],7,5,12529,3.790922844175492,20.0,40.0
33305,3,3305,[  1 238 655 216 143],406,1,12530,3.7900786448880823,0.0,0.0
33306,3,3306,[237 125 258 235 216],64,3,12533,3.7898397338977925,0.0,0.0
33307,3,3307,[435 655  89 204 423],378,5,12538,3.790205562273277,0.0,0.0
33308,3,3308,[603 427 127  50  64],664,5,12543,3.7905711695376247,20.0,40.0
33309,3,3309,[127 161 194 196 597],452,5,12548,3.7909365558912387,0.0,20.0
33310,3,3310,[603 427 127  50  64],313,5,12553,3.7913017215342797,20.0,40.0
33311,3,3311,[143  82 216 135 172],379,5,12558,3.7916666666666665,0.0,0.0
33312,3,3312,[121 194 195   9 222],85,2,12560,3.7911258677935407,0.0,0.0
33313,3,3313,[144 238  88 127 423],643,3,12563,3.790887145443573,0.0,20.0
33314,3,3314,[603 427 127  50  64],91,5,12568,3.7912518853695323,20.0,40.0
33315,3,3315,[597   8 216 235 403],328,0,12568,3.790108564535585,0.0,0.0
33316,3,3316,[603 427 127  50  64],537,4,12572,3.790171842025927,20.0,40.0
33317,3,3317,[603 427 127  50  64],745,3,12575,3.789933694996986,20.0,40.0
33318,3,3318,[603 427 127  50  64],7,5,12580,3.7902982826152454,20.0,40.0
33319,3,3319,[286  28 185 135 216],271,4,12584,3.7903614457831325,0.0,0.0
33320,3,3320,[276 200  12   1  11],145,3,12587,3.7901234567901234,20.0,0.0
33321,3,3321,[268   4  28 210 111],537,1,12588,3.7892835641180014,0.0,0.0
33322,3,3322,[235 282 187  71 173],479,3,12591,3.789046042732471,0.0,0.0
33323,3,3323,[265 313   8 515 496],334,3,12594,3.788808664259928,0.0,0.0
33324,3,3324,[483 127 125 186 286],7,5,12599,3.789172932330827,20.0,20.0
33325,3,3325,[ 69 678 515 273   4],387,2,12601,3.7886349969933852,0.0,0.0
33326,3,3326,[174  50 144 197 276],194,3,12604,3.7883979561166217,0.0,40.0
33327,3,3327,[ 95 483 405 127 235],897,2,12606,3.787860576923077,20.0,20.0
33328,3,3328,[603 427 127  64  50],91,5,12611,3.7882246920997296,20.0,40.0
33329,3,3329,[603 427 127  50  64],379,5,12616,3.7885885885885884,20.0,40.0
33330,3,3330,[603 427 127  50  64],7,5,12621,3.7889522665866107,20.0,40.0
33331,3,3331,[ 96 174 742 234  82],200,5,12626,3.7893157262905164,0.0,20.0
33332,3,3332,[603 427 127  50  64],666,4,12630,3.7893789378937894,20.0,40.0
33333,3,3333,[ 88  97 135 496 151],95,4,12634,3.7894421115776846,0.0,0.0
33334,3,3334,[603 427 127  64  50],59,5,12639,3.7898050974512745,20.0,40.0
33335,3,3335,[228 187 655 179 238],343,5,12644,3.790167865707434,0.0,0.0
33336,3,3336,[275 234 427 313  15],533,4,12648,3.790230746179203,0.0,0.0
33337,3,3337,[603 427 127  64  50],91,5,12653,3.7905931695626123,20.0,40.0
33338,3,3338,[603 427 127  64  50],398,5,12658,3.7909553758610364,20.0,40.0
33339,3,3339,[182 202 655 302 483],537,3,12661,3.7907185628742517,20.0,0.0
33340,3,3340,[603 427 127  64  50],686,5,12666,3.7910805148159232,20.0,40.0
33341,3,3341,[603 427 127  64  50],234,5,12671,3.7914422501496112,20.0,40.0
33342,3,3342,[603 427 127  64  50],313,5,12676,3.791803769069698,20.0,40.0
33343,3,3343,[151 235 234  88   8],308,3,12679,3.791566985645933,0.0,0.0
33344,3,3344,[603 427 127  64  50],313,5,12684,3.7919282511210763,20.0,40.0
33345,3,3345,[603 427 127  64  50],664,5,12689,3.7922893006575014,20.0,40.0
33346,3,3346,[265  28 182  96 153],815,4,12693,3.792351359426352,0.0,0.0
33347,3,3347,[603 427 127  50  64],308,5,12698,3.792712066905615,20.0,40.0
33348,3,3348,[234 258 427 100 471],328,3,12701,3.79247536578083,0.0,20.0
33349,3,3349,[237 276 294 204 423],554,2,12703,3.7919402985074626,0.0,0.0
33350,3,3350,[ 11 405   8 181   1],13,2,12705,3.7914055505819158,0.0,0.0
33351,3,3351,[275  71 191  56 185],454,1,12706,3.7905727923627683,0.0,0.0
33352,3,3352,[215   4 258  97 161],59,3,12709,3.790337011631375,0.0,0.0
33353,3,3353,[603 427 127  50  64],527,4,12713,3.7903995229576624,20.0,40.0
33354,3,3354,[748 237 286 546 153],328,2,12715,3.789865871833085,0.0,0.0
33355,3,3355,[603 427 127  50  64],537,4,12719,3.7899284862932063,20.0,40.0
33356,3,3356,[197 151 496 176 333],64,2,12721,3.789395293416741,0.0,0.0
33357,3,3357,[603 427 127  50  64],686,5,12726,3.789755807027993,20.0,40.0
33358,3,3358,[603 427 127  50  64],452,5,12731,3.7901161059839237,20.0,40.0
33359,3,3359,[603 427 127  50  64],452,5,12736,3.7904761904761903,20.0,40.0
33360,3,3360,[215 176 196 127 258],653,1,12737,3.7896459387087176,0.0,20.0
33361,3,3361,[603   8 151 191 588],308,5,12742,3.790005948839976,20.0,0.0
33362,3,3362,[161  28 117   7 144],13,3,12745,3.7897710377639013,0.0,0.0
33363,3,3363,[181 471 173 215 435],454,1,12746,3.7889417360285376,0.0,0.0
33364,3,3364,[216 173 204 258 143],474,5,12751,3.789301634472511,0.0,0.0
33365,3,3365,[603 427 127  50  64],527,4,12755,3.789364230540701,20.0,40.0
33366,3,3366,[603 427 127  50  64],474,5,12760,3.78972378972379,20.0,40.0
33367,3,3367,[678  96 132 186 269],7,3,12763,3.7894893111638956,0.0,0.0
33368,3,3368,[603 427 127  50  64],458,4,12767,3.7895517957850995,20.0,40.0
33369,3,3369,[603 427 127  50  64],271,5,12772,3.7899109792284866,20.0,40.0
33370,3,3370,[603 427 127  50  64],527,4,12776,3.789973301690893,20.0,40.0
33371,3,3371,[435 127 357 286  28],339,5,12781,3.790332147093713,20.0,20.0
33372,3,3372,[603 427 127  50  64],664,5,12786,3.7906907797213165,20.0,40.0
33373,3,3373,[603 427 127  50  64],91,5,12791,3.7910491997628926,20.0,40.0
33374,3,3374,[603 427 127  50  64],91,5,12796,3.7914074074074073,20.0,40.0
33375,3,3375,[  1 187 483 748 403],311,5,12801,3.791765402843602,20.0,0.0
33376,3,3376,[603 427 127  50  64],308,5,12806,3.7921231862599942,20.0,40.0
33377,3,3377,[603 427 127  50  64],234,5,12811,3.7924807578448787,20.0,40.0
33378,3,3378,[183  82 300 186 385],64,3,12814,3.7922462266942882,0.0,0.0
33379,3,3379,[603 427 127  50  64],13,5,12819,3.792603550295858,20.0,40.0
33380,3,3380,[655 222 237 258 496],749,3,12822,3.792369121561668,0.0,0.0
33381,3,3381,[275 215 179 180  56],524,3,12825,3.792134831460674,0.0,0.0
33382,3,3382,[603 427 127  50  64],452,5,12830,3.7924918711203075,20.0,40.0
33383,3,3383,[603 427 127  50  64],527,4,12834,3.7925531914893615,20.0,40.0
33384,3,3384,[144  97 210 238 204],666,2,12836,3.7920236336779913,0.0,0.0
33385,3,3385,[135  22 313 265   1],537,2,12838,3.791494388659185,0.0,0.0
33386,3,3386,[603 427 127  50  64],527,4,12842,3.7915559492175968,20.0,40.0
33387,3,3387,[ 79 200 286 269 144],666,3,12845,3.791322314049587,0.0,0.0
33388,3,3388,[300 475 237 322 405],486,4,12849,3.7913838890528178,0.0,0.0
33389,3,3389,[318 271 568 118 678],13,1,12850,3.7905604719764012,20.0,0.0
33390,3,3390,[603 427 127  50  64],666,4,12854,3.7906222353288115,20.0,40.0
33391,3,3391,[  4 294 245 186 118],83,1,12855,3.7897995283018866,0.0,0.0
33392,3,3392,[ 12  70 135 269 117],6,3,12858,3.7895667550839964,20.0,0.0
33393,3,3393,[603 427 127  50  64],686,5,12863,3.789923394225103,20.0,40.0
33394,3,3394,[435  69 204 318 603],232,4,12867,3.789985272459499,40.0,0.0
33395,3,3395,[182 117  88  64 294],881,2,12869,3.7894581861012955,0.0,0.0
33396,3,3396,[603 427 127  50  64],379,5,12874,3.7898145422431555,20.0,40.0
33397,3,3397,[194 204 257 286 210],378,5,12879,3.7901706886403765,0.0,0.0
33398,3,3398,[435   7 234 195  82],648,4,12883,3.7902324213003826,0.0,0.0
33399,3,3399,[  1  96 191  50 288],144,4,12887,3.790294117647059,0.0,20.0
33400,3,3400,[603 427 127  50  64],666,4,12891,3.7903557777124375,20.0,40.0
33401,3,3401,[172  70 194 180 196],215,3,12894,3.7901234567901234,0.0,0.0
33402,3,3402,[204 475  79 405 496],6,2,12896,3.7895974140464297,0.0,0.0
33403,3,3403,[  9 195 282  82   7],788,3,12899,3.789365452408931,0.0,0.0
33404,3,3404,[300 294 269 323 153],125,2,12901,3.788839941262849,0.0,0.0
33405,3,3405,[603 427 127  50  64],59,5,12906,3.7891955372871404,20.0,40.0
33406,3,3406,[385 181   1  50 276],533,4,12910,3.78925741121221,0.0,20.0
33407,3,3407,[508 237  89  56 323],474,3,12913,3.789025821596244,0.0,0.0
33408,3,3408,[603 427 127  50  64],686,5,12918,3.7893810501613374,20.0,40.0
33409,3,3409,[603 427 127  50  64],339,5,12923,3.7897360703812315,20.0,40.0
33410,3,3410,[603 427 127  50  64],745,3,12926,3.7895045441219586,20.0,40.0
33411,3,3411,[ 11 197 245 435 121],454,2,12928,3.7889800703399765,0.0,0.0
33412,3,3412,[603 427 127  64  50],398,5,12933,3.7893348959859363,20.0,40.0
33413,3,3413,[ 22 183 211 202 179],527,3,12936,3.789103690685413,0.0,0.0
33414,3,3414,[ 96 405 196 121 100],738,3,12939,3.7888726207906296,0.0,20.0
33415,3,3415,[100 496 111 508 257],6,2,12941,3.7883489461358315,0.0,20.0
33416,3,3416,[302 276 300 435   1],13,3,12944,3.788118232367574,0.0,0.0
33417,3,3417,[603 427 127  64  50],666,4,12948,3.7881802223522527,20.0,40.0
33418,3,3418,[603 427 127  64  50],13,5,12953,3.7885346592570928,20.0,40.0
33419,3,3419,[357 132  50  64 288],308,4,12957,3.7885964912280703,20.0,20.0
33420,3,3420,[ 50   1  98 197  79],738,4,12961,3.78865828705057,0.0,40.0
33421,3,3421,[286 176 100 302 318],788,5,12966,3.789012273524255,20.0,20.0
33422,3,3422,[603 427 127  64  50],669,5,12971,3.789366053169734,20.0,40.0
33423,3,3423,[603 427 127  64  50],308,5,12976,3.789719626168224,20.0,40.0
33424,3,3424,[483 143 176 195 568],95,3,12979,3.7894890510948906,20.0,0.0
33425,3,3425,[603  56 174 273 211],749,4,12983,3.7895504962054876,20.0,20.0
33426,3,3426,[471 546 187 288 125],648,3,12986,3.789320105048147,0.0,0.0
33427,3,3427,[603 427 127  64  50],458,4,12990,3.7893815635939325,20.0,40.0
33428,3,3428,[174  98  71 357 265],738,4,12994,3.78944298629338,20.0,40.0
33429,3,3429,[603 427 127  64  50],669,5,12999,3.789795918367347,20.0,40.0
33430,3,3430,[515 174 322 182 483],90,4,13003,3.7898571844943167,20.0,20.0
33431,3,3431,[ 97  89 204 588  70],295,5,13008,3.7902097902097904,0.0,0.0
33432,3,3432,[121  22 423  64  97],308,3,13011,3.789979609670842,0.0,0.0
33433,3,3433,[194 496 202 174 176],892,5,13016,3.790331974373908,0.0,20.0
33434,3,3434,[603 427 127  64  50],234,5,13021,3.790684133915575,20.0,40.0
33435,3,3435,[603 427 127  64  50],527,4,13025,3.790745052386496,20.0,40.0
33436,3,3436,[603 427 127  64  50],313,5,13030,3.791096886819901,20.0,40.0
33437,3,3437,[603 427 127  64  50],313,5,13035,3.7914485165794067,20.0,40.0
33438,3,3438,[202 276 121 300  79],145,2,13037,3.790927595231172,0.0,0.0
33439,3,3439,[603 427 127  64  50],271,5,13042,3.791279069767442,20.0,40.0
33440,3,3440,[228  96 168 302 172],537,2,13044,3.7907585004359197,0.0,0.0
33441,3,3441,[603 427 127  64  50],745,3,13047,3.7905287623474724,20.0,40.0
33442,3,3442,[603 427 127  64 302],271,5,13052,3.7908800464711008,20.0,20.0
33443,3,3443,[289 228  96   8 405],455,3,13055,3.790650406504065,0.0,0.0
33444,3,3444,[603 427 127  64 302],669,5,13060,3.79100145137881,20.0,20.0
33445,3,3445,[603 427 127  64 302],666,5,13065,3.7913522925130585,20.0,20.0
33446,3,3446,[603 427 127  64 302],537,4,13069,3.7914128227444155,20.0,20.0
33447,3,3447,[603 427 127  64 302],666,5,13074,3.7917633410672855,20.0,20.0
33448,3,3448,[ 56  79 748 222 174],883,4,13078,3.791823717019426,0.0,20.0
33449,3,3449,[603 427 127 302  64],745,4,13082,3.7918840579710147,20.0,20.0
33450,3,3450,[ 79 181 176   8  70],7,2,13084,3.7913648217907854,0.0,0.0
33451,3,3451,[603 427 127 302  64],537,4,13088,3.791425260718424,20.0,20.0
33452,3,3452,[318 222  11  12 237],455,0,13088,3.7903272516652184,40.0,0.0
33453,3,3453,[121 194  50 111 288],452,3,13091,3.790098436595252,0.0,20.0
33454,3,3454,[238  79 182 187 161],474,5,13096,3.7904486251808973,0.0,0.0
33455,3,3455,[603 427 127 302  64],339,5,13101,3.790798611111111,20.0,20.0
33456,3,3456,[161 238 125 216 588],881,2,13103,3.790280590107029,0.0,0.0
33457,3,3457,[202 127 333 194 568],881,4,13107,3.790341237709659,0.0,20.0
33458,3,3458,[603 427 127 302  64],745,4,13111,3.7904018502457357,20.0,20.0
33459,3,3459,[603 427 127 302  64],458,5,13116,3.790751445086705,20.0,20.0
33460,3,3460,[333 127  82 228 237],533,4,13120,3.790811904073967,0.0,20.0
33461,3,3461,[ 96 588 235 258 403],59,2,13122,3.7902946273830156,0.0,0.0
33462,3,3462,[748  79  70  82 117],882,4,13126,3.790355183367023,0.0,0.0
33463,3,3463,[603 427 127 302  64],271,5,13131,3.790704387990762,20.0,20.0
33464,3,3464,[603 427 127 302  64],271,5,13136,3.7910533910533912,20.0,20.0
33465,3,3465,[286 173 258 183 174],378,5,13141,3.791402192729371,0.0,20.0
33466,3,3466,[ 69 265 143 191   8],334,2,13143,3.7908854917796364,0.0,0.0
33467,3,3467,[ 56 174 161  89 176],379,4,13147,3.7909457900807384,0.0,20.0
33468,3,3468,[ 56   4 405 742 197],833,1,13148,3.7901412510810033,0.0,0.0
33469,3,3469,[603 427 127 302  64],745,4,13152,3.790201729106628,20.0,20.0
33470,3,3470,[496 423  95 196 186],398,5,13157,3.7905502736963412,0.0,0.0
33471,3,3471,[603 427 127 302  64],666,5,13162,3.790898617511521,20.0,20.0
33472,3,3472,[210 276 194  95   1],194,2,13164,3.790382954218255,0.0,0.0
33473,3,3473,[475 235  95 181 195],537,1,13165,3.78957973517559,0.0,0.0
33474,3,3474,[603 427 127 302  64],664,5,13170,3.789928057553957,20.0,20.0
33475,3,3475,[603 427 127 302  64],666,5,13175,3.790276179516686,20.0,20.0
33476,3,3476,[  7 143 238 117   8],378,3,13178,3.7900488927236125,0.0,0.0
33477,3,3477,[603 427 127 302  64],339,5,13183,3.790396779758482,20.0,20.0
33478,3,3478,[200  11 161 357 174],881,3,13186,3.7901695889623457,20.0,20.0
33479,3,3479,[603 427 127 302  64],90,5,13191,3.7905172413793102,20.0,20.0
33480,3,3480,[151 405 135 313  88],934,3,13194,3.7902901465096237,0.0,0.0
33481,3,3481,[597 127 289 483 678],13,2,13196,3.7897759908098796,20.0,20.0
33482,3,3482,[211 176 748  28  56],648,3,13199,3.789549239161642,0.0,0.0
33483,3,3483,[603 427 127 302  64],13,5,13204,3.7898966704936856,20.0,20.0
33484,3,3484,[ 25 182  95 121 210],194,0,13204,3.788809182209469,0.0,0.0
33485,3,3485,[181 100 118 301   7],560,2,13206,3.7882960413080893,0.0,20.0
33486,3,3486,[179 235 265 328 546],92,2,13208,3.7877831947232576,0.0,0.0
33487,3,3487,[603 427 127 302  64],13,5,13213,3.788130733944954,20.0,20.0
33488,3,3488,[603 125 216 403 568],749,5,13218,3.7884780739466897,20.0,0.0
33489,3,3489,[603 427 127 302  64],339,5,13223,3.7888252148997132,20.0,20.0
33490,3,3490,[318  82 132 173 423],311,5,13228,3.789172156975079,20.0,0.0
33491,3,3491,[176 302  50 173 117],158,4,13232,3.7892325315005726,0.0,20.0
33492,3,3492,[183 195 328  70 269],13,1,13233,3.7884340108789005,0.0,0.0
33493,3,3493,[258 742 135 300 143],749,5,13238,3.788780767029193,0.0,0.0
33494,3,3494,[197  11 333  98 265],387,2,13240,3.78826895565093,0.0,20.0
33495,3,3495,[742 215 546 127 183],346,4,13244,3.788329519450801,0.0,20.0
33496,3,3496,[186  71   9 194 100],378,4,13248,3.788390048613097,0.0,20.0
33497,3,3497,[603 427 127 302  64],537,4,13252,3.7884505431675244,20.0,20.0
33498,3,3498,[603 222  22 678 182],749,2,13254,3.78793941126036,20.0,0.0
33499,3,3499,[197  64  98  89 742],59,4,13258,3.788,0.0,20.0
33500,3,3500,[508 181  12 288 603],213,5,13263,3.7883461868037704,40.0,0.0
33501,3,3501,[168   8 194 318  95],13,4,13267,3.7884066247858366,20.0,0.0
33502,3,3502,[603 427 127 302  64],537,4,13271,3.7884670282614903,20.0,20.0
33503,3,3503,[ 56  28 603 180  50],533,3,13274,3.78824200913242,20.0,20.0
33504,3,3504,[127  79 216 195 173],804,4,13278,3.78830242510699,0.0,20.0
33505,3,3505,[174 161 357 204  98],653,4,13282,3.7883628066172275,20.0,40.0
33506,3,3506,[180  71 245 132 313],92,4,13286,3.788423153692615,0.0,0.0
33507,3,3507,[603 427 127 302  64],664,5,13291,3.7887685290763966,20.0,20.0
33508,3,3508,[258 121 318  82  97],666,3,13294,3.7885437446565975,20.0,0.0
33509,3,3509,[  7 118 161   1   9],184,2,13296,3.788034188034188,0.0,0.0
33510,3,3510,[603 427 127 302  64],669,5,13301,3.788379379094275,20.0,20.0
33511,3,3511,[603 427 127 302  64],13,5,13306,3.7887243735763096,20.0,20.0
33512,3,3512,[603 427 127 302  64],271,5,13311,3.789069171648164,20.0,20.0
33513,3,3513,[174 238 423  50 222],738,5,13316,3.7894137734775186,0.0,40.0
33514,3,3514,[546 603 161 222 748],64,1,13317,3.788620199146515,20.0,0.0
33515,3,3515,[204 135 182 655  25],85,3,13320,3.78839590443686,0.0,0.0
33516,3,3516,[210 118 186 300 143],313,3,13323,3.7881717372760875,0.0,0.0
33517,3,3517,[483 385 328 179 515],207,3,13326,3.7879476975554294,20.0,0.0
33518,3,3518,[603  79 238 237  50],537,3,13329,3.78772378516624,20.0,20.0
33519,3,3519,[603 427 127 302  64],474,5,13334,3.788068181818182,20.0,20.0
33520,3,3520,[483 176  98  12 202],643,3,13337,3.7878443623970464,40.0,20.0
33521,3,3521,[257  28 143 181 180],290,4,13341,3.7879045996592846,0.0,0.0
33522,3,3522,[100  98 588 313 161],378,5,13346,3.788248651717286,0.0,40.0
33523,3,3523,[111 153 200 269 180],666,4,13350,3.7883087400681044,0.0,0.0
33524,3,3524,[151 385 200 176 186],833,2,13352,3.787801418439716,0.0,0.0
33525,3,3525,[655 385 318 403 117],13,1,13353,3.787010777084515,20.0,0.0
33526,3,3526,[ 70 181 202 187   7],653,2,13355,3.786504111142614,0.0,0.0
33527,3,3527,[196  96 322 265 568],533,4,13359,3.7865646258503403,0.0,0.0
33528,3,3528,[121 100 117  89 238],454,2,13361,3.7860583734769055,0.0,20.0
33529,3,3529,[ 70 151 323 161 125],648,1,13362,3.785269121813031,0.0,0.0
33530,3,3530,[135 546 273 181 180],308,3,13365,3.7850467289719627,0.0,0.0
33531,3,3531,[603 427 127 302  64],339,5,13370,3.785390713476784,20.0,20.0
33532,3,3532,[603 427 127 302  64],458,5,13375,3.785734503255024,20.0,20.0
33533,3,3533,[357 313 175  95 322],537,3,13378,3.785512167515563,20.0,0.0
33534,3,3534,[195 174 245 143 210],378,3,13381,3.7852899575671852,0.0,20.0
33535,3,3535,[118 202 187   4 597],774,1,13382,3.784502262443439,0.0,0.0
33536,3,3536,[182  96 132 173 234],897,4,13386,3.7845631891433418,0.0,0.0
33537,3,3537,[265 471 655 135 121],207,1,13387,3.783776144714528,0.0,0.0
33538,3,3538,[603 427 127 302  64],669,5,13392,3.784119807855326,20.0,20.0
33539,3,3539,[603 427 127 302  64],669,5,13397,3.784463276836158,20.0,20.0
33540,3,3540,[173 313 181 153 235],334,4,13401,3.7845241457215475,0.0,0.0
33541,3,3541,[603 427 127 302  64],474,5,13406,3.784867306606437,20.0,20.0
33542,3,3542,[603 427 127 302  64],90,5,13411,3.785210273779283,20.0,20.0
33543,3,3543,[ 22 216 183 175 237],474,5,13416,3.785553047404063,0.0,0.0
33544,3,3544,[257  96 195 300 215],840,2,13418,3.785049365303244,0.0,0.0
33545,3,3545,[118 161  22 204  79],653,4,13422,3.785109983079526,0.0,0.0
33546,3,3546,[180  56 174 153 197],387,4,13426,3.785170566676064,0.0,20.0
33547,3,3547,[173 175 144 168  25],13,3,13429,3.7849492671927845,0.0,0.0
33548,3,3548,[144 195  50 204 403],308,4,13433,3.785009861932939,0.0,20.0
33549,3,3549,[181 216 568 405 211],537,1,13434,3.784225352112676,0.0,0.0
33550,3,3550,[180 143  95 655 186],537,2,13436,3.7837228949591664,0.0,0.0
33551,3,3551,[603 427 127 302  64],458,5,13441,3.784065315315315,20.0,20.0
33552,3,3552,[603 427 127 302  64],339,5,13446,3.7844075429214747,20.0,20.0
33553,3,3553,[ 69 117 471 288 211],447,5,13451,3.784749577940349,0.0,0.0
33554,3,3554,[185 275  56 161 403],648,3,13454,3.7845288326300985,0.0,0.0
33555,3,3555,[405 597 182 172 275],533,2,13456,3.7840269966254216,0.0,0.0
33556,3,3556,[135 403  15 508 121],92,4,13460,3.7840877143660387,0.0,0.0
33557,3,3557,[603 427 127 302  64],666,5,13465,3.7844294547498594,20.0,20.0
33558,3,3558,[603 427 127 302  64],474,5,13470,3.7847710030907558,20.0,20.0
33559,3,3559,[202 568 282 301 435],378,3,13473,3.7845505617977526,0.0,0.0
33560,3,3560,[202 197  95 258 288],378,2,13475,3.7840494243190115,0.0,0.0
33561,3,3561,[603 427 127 302  64],669,5,13480,3.7843907916900617,20.0,20.0
33562,3,3562,[742 196 191 135 151],804,3,13483,3.784170642716812,0.0,0.0
33563,3,3563,[603 427 127 302  64],271,5,13488,3.7845117845117846,20.0,20.0
33564,3,3564,[172 216 197 196  89],378,4,13492,3.7845722300140254,0.0,0.0
33565,3,3565,[ 95 117  97  96 322],881,3,13495,3.7843522153673583,0.0,0.0
33566,3,3566,[ 12 151 125 182 202],745,2,13497,3.783851976450799,20.0,0.0
33567,3,3567,[603 427 127 302  64],458,5,13502,3.7841928251121075,20.0,20.0
33568,3,3568,[603 427 127 302  64],271,5,13507,3.7845334827682824,20.0,20.0
33569,3,3569,[200 546 294  88  71],374,3,13510,3.784313725490196,0.0,0.0
33570,3,3570,[603 427 127 302  64],745,4,13514,3.7843741248949874,20.0,20.0
33571,3,3571,[603 427 127 302  64],666,5,13519,3.7847144456886896,20.0,20.0
33572,3,3572,[603 427 127 302  64],537,4,13523,3.784774699132382,20.0,20.0
33573,3,3573,[603 427 127 302  64],90,5,13528,3.7851147174034696,20.0,20.0
33574,3,3574,[603 427 127 302  64],474,5,13533,3.7854545454545456,20.0,20.0
33575,3,3575,[210 235 405 175 427],537,2,13535,3.7849552572706937,0.0,0.0
33576,3,3576,[ 56 483  70 135 191],804,3,13538,3.7847358121330723,20.0,0.0
33577,3,3577,[ 12 151 168 186 483],833,4,13542,3.7847959754052543,40.0,0.0
33578,3,3578,[181 121 515  98 405],406,3,13545,3.784576697401509,0.0,20.0
33579,3,3579,[603 427 127 302  64],474,5,13550,3.7849162011173183,20.0,20.0
33580,3,3580,[238 385 403 191  22],308,5,13555,3.7852555152192124,0.0,0.0
33581,3,3581,[117 222  82   4  28],92,3,13558,3.785036292573981,0.0,0.0
33582,3,3582,[294 161 237 195 216],188,1,13559,3.784259000837287,0.0,0.0
33583,3,3583,[603 427 127 302  64],13,5,13564,3.7845982142857144,20.0,20.0
33584,3,3584,[603 427 127 302  64],90,5,13569,3.7849372384937237,20.0,20.0
33585,3,3585,[ 88 121  95 496 185],537,2,13571,3.7844394868934748,0.0,0.0
33586,3,3586,[405 196 181 423 200],537,0,13571,3.7833844438249233,0.0,0.0
33587,3,3587,[175 237 204 132 172],474,5,13576,3.7837235228539576,0.0,0.0
33588,3,3588,[603 427 127 302  64],90,5,13581,3.7840624129283924,20.0,20.0
33589,3,3589,[174 173 597 328 385],207,1,13582,3.7832869080779945,0.0,20.0
33590,3,3590,[135 603 234 237   7],7,5,13587,3.783625730994152,20.0,0.0
33591,3,3591,[132  22 237 318  15],184,3,13590,3.7834075723830733,20.0,0.0
33592,3,3592,[185  56 211  82 603],379,5,13595,3.783746173114389,20.0,0.0
33593,3,3593,[  7 328 195 210 568],13,0,13595,3.7826933778519756,0.0,0.0
33594,3,3594,[357  69 403  88 132],210,5,13600,3.7830319888734354,20.0,0.0
33595,3,3595,[603 427 127 302  64],669,5,13605,3.7833704115684093,20.0,20.0
33596,3,3596,[ 22 179  70 143   4],207,3,13608,3.7831526271893243,0.0,0.0
33597,3,3597,[ 22 127 301  79 117],328,4,13612,3.783212896053363,0.0,20.0
33598,3,3598,[603 427 127 302  64],669,5,13617,3.783550986385107,20.0,20.0
33599,3,3599,[300   7 269  69 678],7,3,13620,3.783333333333333,0.0,0.0
33600,3,3600,[196  97 210  96 237],378,5,13625,3.7836712024437658,0.0,0.0
33601,3,3601,[603   1 132 403 286],13,2,13627,3.7831760133259302,20.0,0.0
33602,3,3602,[197  82 186 405 423],64,2,13629,3.7826810990840967,0.0,0.0
33603,3,3603,[195  69 603 742 204],59,4,13633,3.782741398446171,20.0,0.0
33604,3,3604,[603 427 127 302  64],458,5,13638,3.7830790568654646,20.0,20.0
33605,3,3605,[546  56 237 289  22],234,2,13640,3.7825845812534666,0.0,0.0
33606,3,3606,[323 144 435 269 202],13,3,13643,3.782367618519545,0.0,0.0
33607,3,3607,[603 427 127 302  64],458,5,13648,3.7827050997782705,20.0,20.0
33608,3,3608,[515 191 271 176 258],843,3,13651,3.782488223884733,0.0,0.0
33609,3,3609,[127  71 173 174 195],804,4,13655,3.7825484764542936,0.0,40.0
33610,3,3610,[603 427 127 302  64],537,4,13659,3.782608695652174,20.0,20.0
33611,3,3611,[357 276 127  70  12],406,4,13663,3.782668881506091,40.0,20.0
33612,3,3612,[ 89 288  82  64 168],387,3,13666,3.78245225574315,0.0,0.0
33613,3,3613,[423  88 181 210 144],840,2,13668,3.7819590481460983,0.0,0.0
33614,3,3614,[195  69   1 216 132],537,0,13668,3.7809128630705393,0.0,0.0
33615,3,3615,[183 483 197 515 111],474,5,13673,3.78125,20.0,0.0
33616,3,3616,[135   8 200 100  79],455,5,13678,3.7815869505114734,0.0,20.0
33617,3,3617,[603 427 127 302  64],339,5,13683,3.7819237147595355,20.0,20.0
33618,3,3618,[742 210  64 357  89],313,4,13687,3.781983973473335,20.0,0.0
33619,3,3619,[603 427 127 302  64],339,5,13692,3.7823204419889502,20.0,20.0
33620,3,3620,[286 176  98 204 168],13,3,13695,3.7821043910521954,0.0,20.0
33621,3,3621,[153 186  79 211 546],650,3,13698,3.781888459414688,0.0,0.0
33622,3,3622,[603 427 127 302  64],537,4,13702,3.781948661330389,20.0,20.0
33623,3,3623,[603 427 127 302  64],458,5,13707,3.7822847682119205,20.0,20.0
33624,3,3624,[603 427 127 302  64],13,5,13712,3.7826206896551726,20.0,20.0
33625,3,3625,[423  71 161 238 597],650,1,13713,3.781853281853282,0.0,0.0
33626,3,3626,[117 655 322 194 313],474,5,13718,3.7821891370278466,0.0,0.0
33627,3,3627,[603 427 127 302  64],458,5,13723,3.7825248070562294,20.0,20.0
33628,3,3628,[228 161 234 197 153],934,4,13727,3.7825847340865253,0.0,0.0
33629,3,3629,[423 191 427 194 181],452,5,13732,3.7829201101928374,0.0,0.0
33630,3,3630,[117 282  56 182  89],271,0,13732,3.781878270448912,0.0,0.0
33631,3,3631,[427  12  70 151 286],474,4,13736,3.7819383259911894,20.0,0.0
33632,3,3632,[215  82  71 172 403],42,4,13740,3.781998348472337,0.0,0.0
33633,3,3633,[ 50 186 475   9  96],648,3,13743,3.7817831590533846,0.0,20.0
33634,3,3634,[603 427 127 302  64],90,5,13748,3.782118294360385,20.0,20.0
33635,3,3635,[588  70   9  25 180],308,5,13753,3.7824532453245325,0.0,0.0
33636,3,3636,[603 427 127 302  64],458,5,13758,3.7827880120978827,20.0,20.0
33637,3,3637,[ 64 179  22 216 435],13,3,13761,3.7825728422210005,0.0,0.0
33638,3,3638,[202  56 180 245 405],378,1,13762,3.7818081890629296,0.0,0.0
33639,3,3639,[603 427 127 302  64],271,5,13767,3.782142857142857,20.0,20.0
33640,3,3640,[655 153 435 423  25],398,5,13772,3.782477341389728,0.0,0.0
33641,3,3641,[161 748  88 742 135],92,1,13773,3.7817133443163096,0.0,0.0
33642,3,3642,[603 427 127 302  64],745,4,13777,3.7817732637935766,20.0,20.0
33643,3,3643,[427 182 211 275  56],533,3,13780,3.7815587266739845,0.0,0.0
33644,3,3644,[603 427 127 302  64],745,4,13784,3.78161865569273,20.0,20.0
33645,3,3645,[210 176 144 288 168],804,4,13788,3.78167855183763,0.0,0.0
33646,3,3646,[603 427 127 302  64],666,5,13793,3.782012613106663,20.0,20.0
33647,3,3647,[742  25  96 235  50],795,1,13794,3.78125,0.0,20.0
33648,3,3648,[405   7  79 748   1],84,3,13797,3.7810359002466427,0.0,0.0
33649,3,3649,[603 427 127 302  64],669,5,13802,3.7813698630136985,20.0,20.0
33650,3,3650,[ 70  64 289 286 323],883,3,13805,3.7811558477129554,0.0,0.0
33651,3,3651,[ 50   1 483 211 265],59,4,13809,3.781215772179628,20.0,20.0
33652,3,3652,[603 427 127 302  64],666,5,13814,3.7815494114426498,20.0,20.0
33653,3,3653,[603 427 127 302  64],664,5,13819,3.7818828680897645,20.0,20.0
33654,3,3654,[180 515 194  50  71],328,4,13823,3.7819425444596444,0.0,20.0
33655,3,3655,[427  95 135 215 357],313,4,13827,3.7820021881838075,20.0,0.0
33656,3,3656,[322  89   9 300 195],234,0,13827,3.7809680065627562,0.0,0.0
33657,3,3657,[ 96 127 427 435 237],537,2,13829,3.780481137233461,0.0,20.0
33658,3,3658,[  7 245  12 161 151],346,3,13832,3.780267832741186,20.0,0.0
33659,3,3659,[  7  79 174 202  98],833,1,13833,3.7795081967213116,0.0,40.0
33660,3,3660,[265   9 655  12  79],343,4,13837,3.7795684239278886,20.0,0.0
33661,3,3661,[435 197 508  64  22],207,4,13841,3.7796286182413983,0.0,0.0
33662,3,3662,[515  70 245 289 197],334,2,13843,3.779142779142779,0.0,0.0
33663,3,3663,[603 427 127 302  64],537,4,13847,3.779203056768559,20.0,20.0
33664,3,3664,[ 50 237 179 215 322],524,3,13850,3.7789904502046383,0.0,20.0
33665,3,3665,[405 275 180 245 257],378,2,13852,3.778505182760502,0.0,0.0
33666,3,3666,[568 216 204 742 111],899,5,13857,3.7788382874284157,0.0,0.0
33667,3,3667,[144 200 168  82 323],648,4,13861,3.7788985823336967,0.0,0.0
33668,3,3668,[ 69 265 100 496 215],59,5,13866,3.7792313982011447,0.0,20.0
33669,3,3669,[603 427 127 302  64],666,5,13871,3.7795640326975475,20.0,20.0
33670,3,3670,[603 427 127 302  64],90,5,13876,3.779896485971125,20.0,20.0
33671,3,3671,[603 427 127 302  64],666,5,13881,3.7802287581699345,20.0,20.0
33672,3,3672,[151 385 153  97  95],650,2,13883,3.779744078410019,0.0,0.0
33673,3,3673,[496 483 678  70 196],804,5,13888,3.780076211213936,20.0,0.0
33674,3,3674,[568 204 200  12 333],506,5,13893,3.780408163265306,20.0,0.0
33675,3,3675,[603 427 127 302  64],271,5,13898,3.7807399347116433,20.0,20.0
33676,3,3676,[125 423 153 194 435],7,5,13903,3.781071525700299,0.0,0.0
33677,3,3677,[234 182 195  64  89],524,3,13906,3.780859162588363,0.0,0.0
33678,3,3678,[  8 258 405 196 385],200,4,13910,3.7809187279151946,0.0,0.0
33679,3,3679,[603 427 302 127  64],669,5,13915,3.78125,20.0,20.0
33680,3,3680,[ 50  28 174 118 132],59,5,13920,3.7815810920945396,0.0,40.0
33681,3,3681,[603 427 302 127  64],537,4,13924,3.78164041281912,20.0,20.0
33682,3,3682,[172 403 228 215 197],650,3,13927,3.7814281835460224,0.0,0.0
33683,3,3683,[100 168  69 300 435],533,5,13932,3.781758957654723,0.0,20.0
33684,3,3684,[257 748 405 238 435],749,1,13933,3.7810040705563095,0.0,0.0
33685,3,3685,[269 322   7 286 328],26,1,13934,3.780249593054802,0.0,0.0
33686,3,3686,[475  88 210 153   9],648,3,13937,3.780037971250339,0.0,0.0
33687,3,3687,[161  50   4 271 202],158,4,13941,3.7800976138828633,0.0,20.0
33688,3,3688,[603 427 302 127  64],474,5,13946,3.780428300352399,20.0,20.0
33689,3,3689,[186 168 288 265 161],897,3,13949,3.7802168021680216,0.0,0.0
33690,3,3690,[603 427 302 127  64],666,5,13954,3.780547277160661,20.0,20.0
33691,3,3691,[ 25 197 187 168 173],749,4,13958,3.7806067172264357,0.0,0.0
33692,3,3692,[603 427 302 127  64],339,5,13963,3.7809369076631465,20.0,20.0
33693,3,3693,[194 118 546 748 125],804,4,13967,3.7809962100703842,0.0,0.0
33694,3,3694,[603 427 302 127  64],339,5,13972,3.7813261163734775,20.0,20.0
33695,3,3695,[186  28 135 200 191],666,3,13975,3.7811147186147185,0.0,0.0
33696,3,3696,[603 427 302 127  64],537,4,13979,3.781173924803895,20.0,20.0
33697,3,3697,[176 204  22 197 111],648,4,13983,3.7812330989724177,0.0,0.0
33698,3,3698,[111 181 546 144 125],749,3,13986,3.781021897810219,0.0,0.0
33699,3,3699,[302 276  82 289   7],378,5,13991,3.7813513513513515,0.0,0.0
33700,3,3700,[313 194 294 258  64],119,3,13994,3.78114023236963,0.0,0.0
33701,3,3701,[603 427 302 127  64],458,5,13999,3.781469475958941,20.0,20.0
33702,3,3702,[210 300 111 748 568],533,4,14003,3.7815284904131783,0.0,0.0
33703,3,3703,[ 28 301 385 294   9],378,3,14006,3.7813174946004318,0.0,0.0
33704,3,3704,[423  56 191 195 161],749,3,14009,3.78110661268556,0.0,0.0
33705,3,3705,[603 427 302 127  64],664,5,14014,3.78143550998381,20.0,20.0
33706,3,3706,[151 197 153   8 100],479,4,14018,3.7814944699217694,0.0,20.0
33707,3,3707,[258 135 216 678 357],7,4,14022,3.7815533980582523,20.0,0.0
33708,3,3708,[603 427 302 127  64],13,5,14027,3.7818819088703153,20.0,20.0
33709,3,3709,[143 588  56  22  98],13,4,14031,3.7819407008086254,0.0,20.0
33710,3,3710,[742 300 508 121 328],388,4,14035,3.7819994610617083,0.0,0.0
33711,3,3711,[603 427 302 127  64],339,5,14040,3.7823275862068964,20.0,20.0
33712,3,3712,[603 427 302 127  64],13,5,14045,3.7826555346081334,20.0,20.0
33713,3,3713,[603 427 302 127  64],339,5,14050,3.7829833064081853,20.0,20.0
33714,3,3714,[603 427 302 127  64],537,4,14054,3.783041722745626,20.0,20.0
33715,3,3715,[172 161  79 204 423],313,5,14059,3.7833692142088267,0.0,0.0
33716,3,3716,[385 186 276  98 132],308,3,14062,3.7831584611245628,0.0,20.0
33717,3,3717,[111 603 183 282 235],643,4,14066,3.7832167832167833,20.0,0.0
33718,3,3718,[186 678 182 132 144],308,2,14068,3.7827372949717666,0.0,0.0
33719,3,3719,[588  70 275 508 238],406,2,14070,3.782258064516129,0.0,0.0
33720,3,3720,[202 435  22 222 748],883,3,14073,3.7820478366030637,0.0,0.0
33721,3,3721,[603 427 302 127  64],537,4,14077,3.7821063944116067,20.0,20.0
33722,3,3722,[211 333 265 172  71],488,3,14080,3.7818963201719042,0.0,0.0
33723,3,3723,[288 300  28 121 235],13,2,14082,3.7814178302900108,0.0,0.0
33724,3,3724,[186  64   8 302 181],271,5,14087,3.781744966442953,0.0,0.0
33725,3,3725,[289 508 168 435 132],524,4,14091,3.781803542673108,0.0,0.0
33726,3,3726,[603 427 302 127  64],271,5,14096,3.78213039978535,20.0,20.0
33727,3,3727,[182 471 135 191 333],13,2,14098,3.7816523605150216,0.0,0.0
33728,3,3728,[603 427 302 127  64],458,5,14103,3.7819790828640385,20.0,20.0
33729,3,3729,[ 89 168 216 289 197],881,2,14105,3.7815013404825737,0.0,0.0
33730,3,3730,[603 427 302 127  64],90,5,14110,3.7818279281693914,20.0,20.0
33731,3,3731,[603 427 302 127  64],474,5,14115,3.782154340836013,20.0,20.0
33732,3,3732,[ 95 496  69 118 403],194,2,14117,3.7816769354406645,0.0,0.0
33733,3,3733,[237 323 273 471 125],294,2,14119,3.7811997857525443,0.0,0.0
33734,3,3734,[603 427 302 127  64],339,5,14124,3.781526104417671,20.0,20.0
33735,3,3735,[245 176 111 180 288],533,1,14125,3.7807815845824413,0.0,0.0
33736,3,3736,[271 195  22 117 179],738,1,14126,3.78003746320578,0.0,0.0
33737,3,3737,[286 269 185 172 222],102,0,14126,3.7790262172284645,0.0,0.0
33738,3,3738,[603 427 302 127  64],745,4,14130,3.7790853169296605,20.0,20.0
33739,3,3739,[568 182 289 121  79],85,1,14131,3.778342245989305,0.0,0.0
33740,3,3740,[202 174 318 185  70],648,3,14134,3.778134188719594,20.0,20.0
33741,3,3741,[603 427 302 127  64],537,4,14138,3.7781934794227685,20.0,20.0
33742,3,3742,[742 176 748 234 197],313,3,14141,3.77798557306973,0.0,0.0
33743,3,3743,[603 427 302 127  64],664,5,14146,3.778311965811966,20.0,20.0
33744,3,3744,[300 282  25 237  70],271,2,14148,3.777837116154873,0.0,0.0
33745,3,3745,[300 328 117  25 322],749,5,14153,3.778163374265884,0.0,0.0
33746,3,3746,[ 79  89 186 100 202],271,4,14157,3.77822257806245,0.0,20.0
33747,3,3747,[427 258  28 196 176],537,2,14159,3.7777481323372464,0.0,0.0
33748,3,3748,[603 427 302 127  64],271,5,14164,3.7780741531074953,20.0,20.0
33749,3,3749,[196  97 228 234 258],85,3,14167,3.7778666666666667,0.0,0.0
33750,3,3750,[301 151 187 197   4],537,2,14169,3.777392695281258,0.0,0.0
33751,3,3751,[423 202 496  95 588],882,5,14174,3.7777185501066097,0.0,0.0
33752,3,3752,[100 228 183  71  64],13,5,14179,3.7780442312816414,0.0,20.0
33753,3,3753,[268 173 181 568 111],537,2,14181,3.7775705913692064,0.0,0.0
33754,3,3754,[603 427 302 127  64],537,4,14185,3.77762982689747,20.0,20.0
33755,3,3755,[282 202 237  95  22],554,3,14188,3.7774227902023427,0.0,0.0
33756,3,3756,[603 427 302 127  64],458,5,14193,3.7777482033537395,20.0,20.0
33757,3,3757,[132 403 423 237 282],334,4,14197,3.7778073443320914,0.0,0.0
33758,3,3758,[174 186 273 597  89],13,3,14200,3.7776004256451183,0.0,20.0
33759,3,3759,[181 222 483  12 742],454,0,14200,3.776595744680851,40.0,0.0
33760,3,3760,[286  88 204 294 194],881,1,14201,3.775857484711513,0.0,0.0
33761,3,3761,[234 475 423 385 333],506,4,14205,3.7759170653907494,0.0,0.0
33762,3,3762,[ 95 471 655  15 182],454,0,14205,3.7749136327398354,0.0,0.0
33763,3,3763,[222 216 655 127 515],406,1,14206,3.7741764080765146,0.0,20.0
33764,3,3764,[603 427 302 127  64],745,4,14210,3.7742363877822047,20.0,20.0
33765,3,3765,[ 70  56 496  28   4],378,3,14213,3.774030801911843,0.0,0.0
33766,3,3766,[603 427 302 127  64],13,5,14218,3.774356251659145,20.0,20.0
33767,3,3767,[211 323  98 173 678],474,3,14221,3.7741507430997876,0.0,20.0
33768,3,3768,[144 125   4  69  22],378,2,14223,3.7736800212257893,0.0,0.0
33769,3,3769,[603 427 302 127  64],669,5,14228,3.774005305039788,20.0,20.0
33770,3,3770,[182 300 301 172 216],234,0,14228,3.7730045080880403,0.0,0.0
33771,3,3771,[276  56 546 172 588],234,0,14228,3.772004241781548,0.0,0.0
33772,3,3772,[323 483 174 210 234],200,4,14232,3.7720646700238536,20.0,20.0
33773,3,3773,[603 427 302 127  64],666,5,14237,3.7723900370959194,20.0,20.0
33774,3,3774,[161 181 176 202 172],659,2,14239,3.7719205298013243,0.0,0.0
33775,3,3775,[603 427 302 127  64],90,5,14244,3.7722457627118646,20.0,20.0
33776,3,3776,[603 427 302 127  64],669,5,14249,3.7725708234048185,20.0,20.0
33777,3,3777,[603 427 302 127  64],271,5,14254,3.77289571201694,20.0,20.0
33778,3,3778,[258 202 294 318 333],387,1,14255,3.7721619476051864,20.0,0.0
33779,3,3779,[182  88  79 318 194],271,4,14259,3.772222222222222,20.0,0.0
33780,3,3780,[ 96 216 475 135 215],92,4,14263,3.7722824649563607,0.0,0.0
33781,3,3781,[ 95 176 385 483 211],537,2,14265,3.77181385510312,20.0,0.0
33782,3,3782,[282 276  95 176 235],374,4,14269,3.7718741739360295,0.0,0.0
33783,3,3783,[234 182 294  64 151],308,3,14272,3.7716701902748415,0.0,0.0
33784,3,3784,[194 211  22   9 286],380,3,14275,3.771466314398943,0.0,0.0
33785,3,3785,[200 202 187 117  79],648,2,14277,3.770998415213946,0.0,0.0
33786,3,3786,[ 64 187 135  69 216],90,4,14281,3.7710588856614735,0.0,0.0
33787,3,3787,[ 96 603   8 200 385],379,4,14285,3.771119324181626,20.0,0.0
33788,3,3788,[603 427 302 127  64],666,5,14290,3.771443652678807,20.0,20.0
33789,3,3789,[288 323 118 333  98],699,3,14293,3.771240105540897,0.0,20.0
33790,3,3790,[ 28  64 276 132 100],881,4,14297,3.7713004484304933,0.0,20.0
33791,3,3791,[597  71 143 153 234],7,3,14300,3.771097046413502,0.0,0.0
33792,3,3792,[603 427 302 127  64],339,5,14305,3.7714210387556024,20.0,20.0
33793,3,3793,[ 11 282  79 173 234],145,5,14310,3.7717448603057457,0.0,0.0
33794,3,3794,[228  96  97 276  22],13,5,14315,3.772068511198946,0.0,0.0
33795,3,3795,[271 132 202 182 288],64,4,14319,3.7721285563751317,0.0,0.0
33796,3,3796,[174  71  96 258 181],7,4,14323,3.7721885699236237,0.0,20.0
33797,3,3797,[603 427 302 127  64],458,5,14328,3.772511848341232,20.0,20.0
33798,3,3798,[323  79  98 300 100],537,1,14329,3.771782047907344,0.0,40.0
33799,3,3799,[603 427 302 127  64],458,5,14334,3.772105263157895,20.0,20.0
33800,3,3800,[182 603 496 357  98],804,5,14339,3.7724283083399106,40.0,20.0
33801,3,3801,[ 50 211  82 597   1],653,4,14343,3.772488164124145,0.0,20.0
33802,3,3802,[161 144 748 471 282],207,2,14345,3.772022087825401,0.0,0.0
33803,3,3803,[603 427 302 127  64],339,5,14350,3.7723449001051526,20.0,20.0
33804,3,3804,[597 197 181 191 282],804,4,14354,3.7724047306176085,0.0,0.0
33805,3,3805,[ 95 161 172  89 496],506,5,14359,3.772727272727273,0.0,0.0
33806,3,3806,[ 64 121  88   1 161],311,5,14364,3.773049645390071,0.0,0.0
33807,3,3807,[ 69 238 194 202 132],499,4,14368,3.773109243697479,0.0,0.0
33808,3,3808,[423 222 153 282 357],85,2,14370,3.772643738514046,20.0,0.0
33809,3,3809,[ 98  64  11 588 151],406,4,14374,3.772703412073491,0.0,20.0
33810,3,3810,[234 135 475  82 216],339,4,14378,3.7727630543164525,0.0,0.0
33811,3,3811,[ 50 204  56 200 210],92,4,14382,3.7728226652675763,0.0,20.0
33812,3,3812,[268 269  96 302 182],145,5,14387,3.7731445056386046,0.0,0.0
33813,3,3813,[603 427 302 127  64],664,5,14392,3.773466177241741,20.0,20.0
33814,3,3814,[313 143  88 132 153],454,3,14395,3.7732634338138924,0.0,0.0
33815,3,3815,[471 172   4 118  71],524,3,14398,3.7730607966457024,0.0,0.0
33816,3,3816,[603 427 302 127  64],666,5,14403,3.7733822373591828,20.0,20.0
33817,3,3817,[748 273  22   9 187],64,3,14406,3.7731796752226296,0.0,0.0
33818,3,3818,[568 546 176 357 153],13,1,14407,3.7724535218643624,20.0,0.0
33819,3,3819,[546 435  12 179  98],60,5,14412,3.7727748691099476,20.0,20.0
33820,3,3820,[265 237 508   9 197],343,4,14416,3.7728343365611097,0.0,0.0
33821,3,3821,[286   4 172 215 204],788,1,14417,3.772108843537415,0.0,0.0
33822,3,3822,[273  95  88 183  12],42,4,14421,3.7721684540936438,20.0,0.0
33823,3,3823,[385 185 111 475 204],474,5,14426,3.772489539748954,0.0,0.0
33824,3,3824,[ 25 257 182 471 268],119,5,14431,3.7728104575163397,0.0,0.0
33825,3,3825,[196 215 234 405 174],897,4,14435,3.7728698379508625,0.0,20.0
33826,3,3826,[185 271 211 210 238],13,1,14436,3.772145283511889,0.0,0.0
33827,3,3827,[603 427 302 127  64],271,5,14441,3.7724660397074192,20.0,20.0
33828,3,3828,[200 483 182 234 238],804,4,14445,3.772525463567511,20.0,0.0
33829,3,3829,[568 172 200 194 100],643,4,14449,3.772584856396867,0.0,20.0
33830,3,3830,[603 427 302 127  64],13,5,14454,3.772905246671887,20.0,20.0
33831,3,3831,[228  56 275 286 179],537,3,14457,3.7727035490605427,0.0,0.0
33832,3,3832,[597 568 748 515 318],328,2,14459,3.772241064440386,20.0,0.0
33833,3,3833,[603 427 302 127  64],669,5,14464,3.7725612936880544,20.0,20.0
33834,3,3834,[603 427 302 127  64],474,5,14469,3.772881355932203,20.0,20.0
33835,3,3835,[286 471 204 228  25],447,4,14473,3.7729405630865487,0.0,0.0
33836,3,3836,[603 427 302 127  64],664,5,14478,3.773260359655981,20.0,20.0
33837,3,3837,[603 427 302 127  64],13,5,14483,3.773579989577905,20.0,20.0
33838,3,3838,[ 89 245 742 237 597],346,4,14487,3.773638968481375,0.0,0.0
33839,3,3839,[175 132 268 508 405],537,3,14490,3.7734375,0.0,0.0
33840,3,3840,[173 215  98 302  11],454,2,14492,3.7729757875553243,0.0,20.0
33841,3,3841,[ 89 222 211   4 121],328,3,14495,3.7727745965642896,0.0,0.0
33842,3,3842,[603 427 302 127  64],458,5,14500,3.773093937028363,20.0,20.0
33843,3,3843,[603 427 302 127  64],13,5,14505,3.773413111342352,20.0,20.0
33844,3,3844,[603 427 302 127  64],339,5,14510,3.773732119635891,20.0,20.0
33845,3,3845,[603 427 302 127  64],664,5,14515,3.7740509620384817,20.0,20.0
33846,3,3846,[ 71 216  70 237   8],406,1,14516,3.7733298674291658,0.0,0.0
33847,3,3847,[216 508 475 191 168],537,4,14520,3.773388773388773,0.0,0.0
33848,3,3848,[496 313 222 185 483],537,4,14524,3.7734476487399324,20.0,0.0
33849,3,3849,[210 323 568  89  70],883,3,14527,3.7732467532467533,0.0,0.0
33850,3,3850,[603 427 302 127  64],90,5,14532,3.7735653077122824,20.0,20.0
33851,3,3851,[603 427 302 127  64],745,4,14536,3.7736240913811008,20.0,20.0
33852,3,3852,[471 496 427 194  22],308,3,14539,3.7734233065144043,0.0,0.0
33853,3,3853,[603 427 302 127  64],669,5,14544,3.773741567202906,20.0,20.0
33854,3,3854,[603 427 302 127  64],664,5,14549,3.774059662775616,20.0,20.0
33855,3,3855,[ 82  22 176   8 161],479,4,14553,3.774118257261411,0.0,0.0
33856,3,3856,[603 427 302 127  64],537,4,14557,3.774176821363754,20.0,20.0
33857,3,3857,[  4 496 118 175 288],308,3,14560,3.773976153447382,0.0,0.0
33858,3,3858,[144 180 197  25   8],899,2,14562,3.773516455040166,0.0,0.0
33859,3,3859,[603 427 302 127  64],666,5,14567,3.7738341968911917,20.0,20.0
33860,3,3860,[603 427 302 127  64],271,5,14572,3.774151774151774,20.0,20.0
33861,3,3861,[603 471 174 195 182],666,3,14575,3.773951320559296,20.0,20.0
33862,3,3862,[191 222   8   7 118],882,5,14580,3.7742687030805073,0.0,0.0
33863,3,3863,[603 427 302 127  64],90,5,14585,3.774585921325052,20.0,20.0
33864,3,3864,[181 568 258 238 282],92,4,14589,3.7746442432082796,0.0,0.0
33865,3,3865,[216 228  71 183 289],488,2,14591,3.774185204345577,0.0,0.0
33866,3,3866,[603 427 302 127  64],271,5,14596,3.7745021980863718,20.0,20.0
33867,3,3867,[ 28 258 117 186  25],92,3,14599,3.7743019648397103,0.0,0.0
33868,3,3868,[161 211 182 568 100],328,3,14602,3.774101835099509,0.0,20.0
33869,3,3869,[603 427 302 127  64],537,4,14606,3.774160206718346,20.0,20.0
33870,3,3870,[151 121 194 235 546],901,3,14609,3.7739602169981916,0.0,0.0
33871,3,3871,[603 427 302 127  64],537,4,14613,3.7740185950413223,20.0,20.0
33872,3,3872,[204  79 185 173  71],882,5,14618,3.7743351407177896,0.0,0.0
33873,3,3873,[603 427 302 127  64],669,5,14623,3.7746515229736706,20.0,20.0
33874,3,3874,[228 215 180 742 427],533,4,14627,3.774709677419355,0.0,0.0
33875,3,3875,[181 168 200 238 483],897,2,14629,3.774251805985552,20.0,0.0
33876,3,3876,[333 289 237 135 269],85,1,14630,3.7735362393603302,0.0,0.0
33877,3,3877,[276 196 181 385  96],311,5,14635,3.7738525012893245,0.0,0.0
33878,3,3878,[603 427 302 127  64],537,4,14639,3.773910801753029,20.0,20.0
33879,3,3879,[ 97  22 172  25 302],145,4,14643,3.7739690721649484,0.0,0.0
33880,3,3880,[ 70 144 172  25  69],378,4,14647,3.7740273125483124,0.0,0.0
33881,3,3881,[ 22 273   4 161 153],207,4,14651,3.7740855229263266,0.0,0.0
33882,3,3882,[603 427 302 127  64],271,5,14656,3.77440123615761,20.0,20.0
33883,3,3883,[200 475 748 568 191],13,1,14657,3.773686920700309,0.0,0.0
33884,3,3884,[ 89 238 194 322  64],474,5,14662,3.774002574002574,0.0,0.0
33885,3,3885,[322  98 111 125 323],374,3,14665,3.773803396809058,0.0,20.0
33886,3,3886,[237 144 328  25 151],749,4,14669,3.773861589915102,0.0,0.0
33887,3,3887,[153  22 471 678 258],454,2,14671,3.773405349794239,0.0,0.0
33888,3,3888,[603 427 302 127  64],90,5,14676,3.7737207508356905,20.0,20.0
33889,3,3889,[597 603 100 265 153],13,4,14680,3.7737789203084833,20.0,20.0
33890,3,3890,[  1  88 423 475 228],479,3,14683,3.773580056540735,0.0,0.0
33891,3,3891,[603 427 302 127  64],13,5,14688,3.7738951695786227,20.0,20.0
33892,3,3892,[357 173 403   1 197],648,3,14691,3.7736963781145647,20.0,0.0
33893,3,3893,[475 748  97 179 471],479,1,14692,3.772984078068824,0.0,0.0
33894,3,3894,[183 678 423 111 174],648,4,14696,3.7730423620025673,0.0,20.0
33895,3,3895,[228 237  95  70  12],406,2,14698,3.77258726899384,20.0,0.0
33896,3,3896,[603 302 427 127  64],90,5,14703,3.772902232486528,20.0,20.0
33897,3,3897,[168 258 125 195 111],6,2,14705,3.7724474089276554,0.0,0.0
33898,3,3898,[597 273 132 385 288],13,1,14706,3.771736342651962,0.0,0.0
33899,3,3899,[655 678 385 515   1],13,1,14707,3.771025641025641,0.0,0.0
33900,3,3900,[603 302 427 127  64],271,5,14712,3.771340681876442,20.0,20.0
33901,3,3901,[357 135 127 111 118],749,3,14715,3.7711430035879037,20.0,20.0
33902,3,3902,[ 88 294 197 282  69],533,5,14720,3.771457852933641,0.0,0.0
33903,3,3903,[ 22 111 276  69 597],82,3,14723,3.7712602459016393,0.0,0.0
33904,3,3904,[603 302 427 127  64],745,4,14727,3.7713188220230474,20.0,20.0
33905,3,3905,[282 202 181 211 194],653,1,14728,3.770609318996416,0.0,0.0
33906,3,3906,[173  82 515 127 187],64,4,14732,3.770668031737906,0.0,20.0
33907,3,3907,[  1 176 191  12  88],271,3,14735,3.7704708290685773,20.0,0.0
33908,3,3908,[603 302 427 127  64],90,5,14740,3.7707853671015603,20.0,20.0
33909,3,3909,[125 179 174 288  11],374,4,14744,3.770843989769821,0.0,20.0
33910,3,3910,[603 302 427 127  64],666,5,14749,3.7711582715418053,20.0,20.0
33911,3,3911,[ 79 172 228 222  88],145,5,14754,3.771472392638037,0.0,0.0
33912,3,3912,[603 302 427 127  64],339,5,14759,3.771786353181702,20.0,20.0
33913,3,3913,[603 302 427 127  64],537,4,14763,3.7718446601941746,20.0,20.0
33914,3,3914,[603 302 427 127  64],339,5,14768,3.7721583652618134,20.0,20.0
33915,3,3915,[234  88 238   9  71],92,4,14772,3.7722165474974463,0.0,0.0
33916,3,3916,[  9 181 678 238 289],82,2,14774,3.7717641051825375,0.0,0.0
33917,3,3917,[603 302 427 127  64],537,4,14778,3.771822358346095,20.0,20.0
33918,3,3918,[258 423 179 174 496],387,3,14781,3.7716254146465937,0.0,20.0
33919,3,3919,[603 302 427 127  64],13,5,14786,3.771938775510204,20.0,20.0
33920,3,3920,[603 302 427 127  64],90,5,14791,3.7722519765365976,20.0,20.0
33921,3,3921,[228  11  28 168 748],92,3,14794,3.7720550739418663,0.0,0.0
33922,3,3922,[127 187 210 286 200],488,2,14796,3.7716033647718583,0.0,20.0
33923,3,3923,[603 302 427 127  64],669,5,14801,3.7719164118246686,20.0,20.0
33924,3,3924,[265  22 301 405 183],13,3,14804,3.77171974522293,0.0,0.0
33925,3,3925,[  7 211 125 135 127],6,3,14807,3.771523178807947,0.0,20.0
33926,3,3926,[ 69 151 186 175 238],7,5,14812,3.771836007130125,0.0,0.0
33927,3,3927,[125 515 471 318 215],815,4,14816,3.7718940936863543,20.0,0.0
33928,3,3928,[318 175 161 268 176],92,3,14819,3.7716976329854925,20.0,0.0
33929,3,3929,[132 204 100 180 211],650,4,14823,3.7717557251908396,0.0,20.0
33930,3,3930,[603 302 427 127  64],13,5,14828,3.772068176036632,20.0,20.0
33931,3,3931,[ 64 197 275 222 742],899,5,14833,3.772380467955239,0.0,0.0
33932,3,3932,[258  70 238 191 151],234,1,14834,3.771675565725909,0.0,0.0
33933,3,3933,[ 82 265 678  22 181],387,4,14838,3.771733604473818,0.0,0.0
33934,3,3934,[603 302 427 127  64],458,5,14843,3.7720457433290977,20.0,20.0
33935,3,3935,[ 79 405 228 172  15],479,4,14847,3.7721036585365852,0.0,0.0
33936,3,3936,[186 197 333 742 132],488,3,14850,3.7719075438150877,0.0,0.0
33937,3,3937,[588 200 210 515 302],537,2,14852,3.771457592686643,0.0,0.0
33938,3,3938,[603 302 427 127  64],745,4,14856,3.7715156130997713,20.0,20.0
33939,3,3939,[515 235 195 322 210],313,3,14859,3.7713197969543146,0.0,0.0
33940,3,3940,[603 302 427 127  64],666,5,14864,3.771631565592489,20.0,20.0
33941,3,3941,[322  28 202 215  96],537,0,14864,3.7706747843734143,0.0,0.0
33942,3,3942,[357 515 471  28 194],7,4,14868,3.7707329444585342,20.0,0.0
33943,3,3943,[276 435 222 187 288],474,4,14872,3.77079107505071,0.0,0.0
33944,3,3944,[265 202 196  15 153],308,2,14874,3.770342205323194,0.0,0.0
33945,3,3945,[603 302 427 127  64],90,5,14879,3.770653826659909,20.0,20.0
33946,3,3946,[603 302 427 127  64],90,5,14884,3.7709652900937423,20.0,20.0
33947,3,3947,[ 11 427 328 153 183],13,3,14887,3.770770010131712,0.0,0.0
33948,3,3948,[603 302 427 127  64],13,5,14892,3.7710812864016208,20.0,20.0
33949,3,3949,[204 282 568 318  97],194,2,14894,3.770632911392405,20.0,0.0
33950,3,3950,[245 174 496  97 211],313,4,14898,3.7706909643128323,0.0,20.0
33951,3,3951,[603 302 427 127  64],474,5,14903,3.771002024291498,20.0,20.0
33952,3,3952,[143 100 174 471 237],605,1,14904,3.7703010371869468,0.0,40.0
33953,3,3953,[603 173 135 194  79],59,4,14908,3.770359129994942,20.0,0.0
33954,3,3954,[151 210 222 195  89],650,3,14911,3.770164348925411,0.0,0.0
33955,3,3955,[ 82 196 127 151 204],897,4,14915,3.770222446916077,0.0,20.0
33956,3,3956,[603 302 427 127  64],13,5,14920,3.7705332322466516,20.0,20.0
33957,3,3957,[603 302 427 127  64],745,4,14924,3.770591207680647,20.0,20.0
33958,3,3958,[275 435 174 215 273],90,3,14927,3.7703965647890882,0.0,20.0
33959,3,3959,[176 258   7  98 143],234,1,14928,3.7696969696969695,0.0,20.0
33960,3,3960,[175  64 187 318 118],308,4,14932,3.769755112345367,20.0,0.0
33961,3,3961,[603 302 427 127  64],474,5,14937,3.770065623422514,20.0,20.0
33962,3,3962,[173 546 423 185  50],897,4,14941,3.7701236437042644,0.0,20.0
33963,3,3963,[603 302 427 127  64],745,4,14945,3.7701816347124115,20.0,20.0
33964,3,3964,[603 302 427 127  64],458,5,14950,3.7704918032786887,20.0,20.0
33965,3,3965,[603 302 427 127  64],90,5,14955,3.770801815431165,20.0,20.0
33966,3,3966,[181  98 385 194  89],537,1,14956,3.7701033526594405,0.0,20.0
33967,3,3967,[748 153 200  11 423],804,3,14959,3.7699092741935485,0.0,0.0
33968,3,3968,[603 302 427 127  64],339,5,14964,3.7702191987906275,20.0,20.0
33969,3,3969,[603 302 427 127  64],474,5,14969,3.7705289672544082,20.0,20.0
33970,3,3970,[603 302 427 127  64],669,5,14974,3.7708385797028456,20.0,20.0
33971,3,3971,[ 22  12 423  50 405],6,2,14976,3.770392749244713,20.0,20.0
33972,3,3972,[ 25 179 215 234 385],343,2,14978,3.769947143216713,0.0,0.0
33973,3,3973,[603 302 427 127  64],13,5,14983,3.7702566683442376,20.0,20.0
33974,3,3974,[132  96 191 257  82],881,3,14986,3.770062893081761,0.0,0.0
33975,3,3975,[194 289  79 328  89],537,1,14987,3.7693661971830985,0.0,0.0
33976,3,3976,[603 302 427 127  64],13,5,14992,3.769675634900679,20.0,20.0
33977,3,3977,[257   1 173 200 117],795,3,14995,3.769482151835093,0.0,0.0
33978,3,3978,[603 302 427 127  64],474,5,15000,3.7697914048755967,20.0,20.0
33979,3,3979,[603 302 427 127  64],458,5,15005,3.770100502512563,20.0,20.0
33980,3,3980,[603 302 427 127  64],664,5,15010,3.7704094448630996,20.0,20.0
33981,3,3981,[427 181 237  89 405],882,5,15015,3.770718232044199,0.0,0.0
33982,3,3982,[111 211 195 132 405],64,4,15019,3.7707757971378357,0.0,0.0
33983,3,3983,[603 302 427 127  64],745,4,15023,3.7708333333333335,20.0,20.0
33984,3,3984,[135 475 357 191 168],10,5,15028,3.771141781681305,20.0,0.0
33985,3,3985,[603 302 427 127  64],474,5,15033,3.771450075263422,20.0,20.0
33986,3,3986,[286  95 168 197 161],95,3,15036,3.7712565838976673,0.0,0.0
33987,3,3987,[161 194  98 289 216],378,5,15041,3.771564694082247,0.0,20.0
33988,3,3988,[603 302 427 127  64],537,4,15045,3.7716219603910757,20.0,20.0
33989,3,3989,[ 97 323  22 238 748],804,5,15050,3.7719298245614037,0.0,0.0
33990,3,3990,[144 187 222 282 328],479,5,15055,3.7722375344525183,0.0,0.0
33991,3,3991,[603 302 427 127  64],90,5,15060,3.7725450901803605,20.0,20.0
33992,3,3992,[100  82 678  95  56],940,4,15064,3.772602053593789,0.0,20.0
33993,3,3993,[496  64 111 357 597],95,4,15068,3.772658988482724,20.0,0.0
33994,3,3994,[748  88 289 313 286],13,3,15071,3.772465581977472,0.0,0.0
33995,3,3995,[301   7 238  96 215],940,3,15074,3.7722722722722724,0.0,0.0
33996,3,3996,[143  69 289 117 318],378,3,15077,3.772079059294471,20.0,0.0
33997,3,3997,[161 588 323 238 405],804,5,15082,3.772386193096548,0.0,0.0
33998,3,3998,[179 143 273  70 111],59,2,15084,3.7719429857464366,0.0,0.0
33999,3,3999,[603 302 427 127  64],474,5,15089,3.77225,20.0,20.0
34000,3,4000,[603 302 427 127  64],271,5,15094,3.7725568607848037,20.0,20.0
34001,3,4001,[603 302 427 127  64],537,4,15098,3.7726136931534233,20.0,20.0
34002,3,4002,[475  98 181 168  22],537,2,15100,3.7721708718461153,0.0,20.0
34003,3,4003,[  9 186  56   8 496],343,5,15105,3.7724775224775224,0.0,0.0
34004,3,4004,[300 204  50 294  82],850,5,15110,3.772784019975031,0.0,20.0
34005,3,4005,[603 302 427 127  64],271,5,15115,3.77309036445332,20.0,20.0
34006,3,4006,[187  69 234  97 151],804,4,15119,3.7731469927626655,0.0,0.0
34007,3,4007,[202 288 186   7 135],13,3,15122,3.7729540918163673,0.0,0.0
34008,3,4008,[333 245 132 127 427],334,3,15125,3.772761287104016,0.0,20.0
34009,3,4009,[215 568  71 742 168],92,3,15128,3.772568578553616,0.0,0.0
34010,3,4010,[ 88  50 603 268  56],13,5,15133,3.7728745948641236,20.0,20.0
34011,3,4011,[357 175 273 276 135],234,2,15135,3.772432701894317,20.0,0.0
34012,3,4012,[161 196 173 100 197],7,4,15139,3.772489409419387,0.0,20.0
34013,3,4013,[186 403 194 143 215],295,5,15144,3.772795216741405,0.0,0.0
34014,3,4014,[603 302 427 127  64],666,5,15149,3.7731008717310086,20.0,20.0
34015,3,4015,[181 132 161 403  70],210,5,15154,3.773406374501992,0.0,0.0
34016,3,4016,[328 195 172 403  96],804,4,15158,3.773462783171521,0.0,0.0
34017,3,4017,[196 597 423 180 275],378,3,15161,3.7732702837232455,0.0,0.0
34018,3,4018,[ 22 405 195 403 202],279,2,15163,3.7728290619557106,0.0,0.0
34019,3,4019,[603 302 427 127  64],458,5,15168,3.773134328358209,20.0,20.0
34020,3,4020,[151 176 282 117 180],474,4,15172,3.7731907485700074,0.0,0.0
34021,3,4021,[ 69 313 655 258 118],328,4,15176,3.773247140726007,0.0,0.0
34022,3,4022,[204 423 275 318 187],533,5,15181,3.7735520755654983,20.0,0.0
34023,3,4023,[603 302 427 127  64],339,5,15186,3.7738568588469183,20.0,20.0
34024,3,4024,[385 257 483 216 191],290,4,15190,3.773913043478261,20.0,0.0
34025,3,4025,[603 302 427 127  64],271,5,15195,3.7742175856929956,20.0,20.0
34026,3,4026,[222 282  89  70 100],455,1,15196,3.7735286814005464,0.0,20.0
34027,3,4027,[603 302 427 127  64],90,5,15201,3.7738331678252233,20.0,20.0
34028,3,4028,[603 302 427 127  64],745,4,15205,3.7738893025564657,20.0,20.0
34029,3,4029,[603 302 427 127  64],669,5,15210,3.774193548387097,20.0,20.0
34030,3,4030,[ 56 191 471 211 568],7,5,15215,3.7744976432646986,0.0,0.0
34031,3,4031,[603 302 427 127  64],458,5,15220,3.7748015873015874,20.0,20.0
34032,3,4032,[186 568  89 196 187],881,3,15223,3.774609471857178,0.0,0.0
34033,3,4033,[186 322 179   8 187],409,2,15225,3.7741695587506197,0.0,0.0
34034,3,4034,[603 302 427 127  64],339,5,15230,3.774473358116481,20.0,20.0
34035,3,4035,[483 194 143 196   7],59,3,15233,3.7742814667988105,20.0,0.0
34036,3,4036,[187 181 168  70 204],102,1,15234,3.773594253158286,0.0,0.0
34037,3,4037,[276  71 143 176 288],92,3,15237,3.773402674591382,0.0,0.0
34038,3,4038,[143 655 313 603 202],64,4,15241,3.7734587769249814,20.0,0.0
34039,3,4039,[204 174  89 403  79],804,4,15245,3.7735148514851486,0.0,20.0
34040,3,4040,[176 195 181 275 175],14,4,15249,3.773570898292502,0.0,0.0
34041,3,4041,[603 302 427 127  64],474,5,15254,3.7738743196437405,20.0,20.0
34042,3,4042,[603 302 427 127  64],13,5,15259,3.7741775908978483,20.0,20.0
34043,3,4043,[603 302 427 127  64],13,5,15264,3.7744807121661723,20.0,20.0
34044,3,4044,[ 71 197 385 294 118],804,5,15269,3.7747836835599506,0.0,0.0
34045,3,4045,[423 173  56 483  79],666,3,15272,3.774592189817103,20.0,0.0
34046,3,4046,[ 69 588  97 151 202],64,3,15275,3.7744007907091675,0.0,0.0
34047,3,4047,[  8 191 302   1 144],144,4,15279,3.7744565217391304,0.0,0.0
34048,3,4048,[ 95 180 435 202 237],59,3,15282,3.77426525067918,0.0,0.0
34049,3,4049,[603 302 427 127  64],537,4,15286,3.774320987654321,20.0,20.0
34050,3,4050,[  1  69 357 181  22],144,5,15291,3.774623549740805,20.0,0.0
34051,3,4051,[275  56 143 435 183],536,2,15293,3.7741855873642645,0.0,0.0
34052,3,4052,[603 302 427 127  64],90,5,15298,3.774488033555391,20.0,20.0
34053,3,4053,[ 25   9 275  22 385],648,3,15301,3.774296990626542,0.0,0.0
34054,3,4054,[135   1  28 151 185],42,5,15306,3.7745992601726264,0.0,0.0
34055,3,4055,[100 655 185 117 182],328,4,15310,3.77465483234714,0.0,20.0
34056,3,4056,[323 748  22 153  56],488,3,15313,3.7744638895735765,0.0,0.0
34057,3,4057,[288 385 216 179 435],666,2,15315,3.7740266140956136,0.0,0.0
34058,3,4058,[258 204 179  28 237],215,3,15318,3.7738359201773837,0.0,0.0
34059,3,4059,[603 302 427 127  64],474,5,15323,3.774137931034483,20.0,20.0
34060,3,4060,[603 302 427 127  64],669,5,15328,3.7744397931543956,20.0,20.0
34061,3,4061,[ 95 235  79  50 100],795,2,15330,3.774002954209749,0.0,40.0
34062,3,4062,[  9 237  28 183 168],374,3,15333,3.773812453851834,0.0,0.0
34063,3,4063,[748 215 423 385  71],200,4,15337,3.7738681102362204,0.0,0.0
34064,3,4064,[ 64 423 117 180 228],92,4,15341,3.7739237392373925,0.0,0.0
34065,3,4065,[603 302 427 127  64],666,5,15346,3.7742252828332514,20.0,20.0
34066,3,4066,[603 302 427 127  64],669,5,15351,3.774526678141136,20.0,20.0
34067,3,4067,[ 56 313 269 204 132],232,3,15354,3.774336283185841,0.0,0.0
34068,3,4068,[211 181 603 183 182],537,3,15357,3.7741459818137133,20.0,0.0
34069,3,4069,[222 111 200 195 742],648,4,15361,3.7742014742014742,0.0,0.0
34070,3,4070,[568 603 143  15  82],650,2,15363,3.77376565954311,20.0,0.0
34071,3,4071,[568 168 294 228 186],13,3,15366,3.7735756385068764,0.0,0.0
34072,3,4072,[546  15  95 151  12],42,4,15370,3.773631230051559,20.0,0.0
34073,3,4073,[603 302 427 127  64],271,5,15375,3.7739322533136965,20.0,20.0
34074,3,4074,[172 195 508   4  64],653,2,15377,3.7734969325153376,0.0,0.0
34075,3,4075,[603 302 427 127  64],458,5,15382,3.7737978410206083,20.0,20.0
34076,3,4076,[180 143   4 318 204],308,5,15387,3.7740986019131713,20.0,0.0
34077,3,4077,[ 95 300 265   8 568],455,5,15392,3.7743992153016186,0.0,0.0
34078,3,4078,[603 302 427 127  64],669,5,15397,3.774699681294435,20.0,20.0
34079,3,4079,[183 143 196  89  96],882,5,15402,3.775,0.0,0.0
34080,3,4080,[275 423   7  98 143],648,4,15406,3.7750551335456994,0.0,20.0
34081,3,4081,[588 204 100 333 385],85,1,15407,3.77437530622244,0.0,20.0
34082,3,4082,[ 96 176 216 202  50],378,4,15411,3.77443056576047,0.0,20.0
34083,3,4083,[603 302 427 127  64],537,4,15415,3.7744857982370226,20.0,20.0
34084,3,4084,[301 182 185 235 173],524,4,15419,3.7745410036719704,0.0,0.0
34085,3,4085,[603 302 427 127  64],474,5,15424,3.7748409202153694,20.0,20.0
34086,3,4086,[235 483  88  15 186],313,1,15425,3.7741619770002446,20.0,0.0
34087,3,4087,[603 302 427 127  64],271,5,15430,3.774461839530333,20.0,20.0
34088,3,4088,[135  82 153 175 180],10,4,15434,3.7745169968207386,0.0,0.0
34089,3,4089,[603 302 427 127  64],666,5,15439,3.7748166259168703,20.0,20.0
34090,3,4090,[187  50 197 655 286],213,4,15443,3.774871669518455,0.0,20.0
34091,3,4091,[173 143 100 180 568],892,4,15447,3.7749266862170088,0.0,20.0
34092,3,4092,[144  98   4 210 125],64,1,15448,3.7742487173222576,0.0,20.0
34093,3,4093,[294 183 282 195 168],406,2,15450,3.7738153395212506,0.0,0.0
34094,3,4094,[ 71 180 176 423 174],648,3,15453,3.7736263736263735,0.0,20.0
34095,3,4095,[132  28 153 127 215],7,5,15458,3.77392578125,0.0,20.0
34096,3,4096,[508 202  22 172 161],92,2,15460,3.7734927996094703,0.0,0.0
34097,3,4097,[238 300 655  82  96],313,4,15464,3.7735480722303563,0.0,0.0
34098,3,4098,[ 12 211 168 187  22],311,4,15468,3.77360331788241,20.0,0.0
34099,3,4099,[ 79 515 238 185 275],184,4,15472,3.7736585365853657,0.0,0.0
34100,3,4100,[ 79  69 268 588  64],537,1,15473,3.7729821994635455,0.0,0.0
34101,3,4101,[603 302 427 127  64],90,5,15478,3.77328132618235,20.0,20.0
34102,3,4102,[191 238 257  12  64],343,4,15482,3.7733365829880574,20.0,0.0
34103,3,4103,[168 180 196 271 175],92,4,15486,3.7733918128654973,0.0,0.0
34104,3,4104,[  1 210 127  89 483],897,4,15490,3.7734470158343485,20.0,20.0
34105,3,4105,[471 216 403 333  88],533,4,15494,3.7735021919142717,0.0,0.0
34106,3,4106,[175 588 173 121  69],815,3,15497,3.7733138543949356,0.0,0.0
34107,3,4107,[588 174 172 423 191],892,5,15502,3.773612463485881,0.0,20.0
34108,3,4108,[603 302 427 127  64],90,5,15507,3.7739109272329032,20.0,20.0
34109,3,4109,[603 302 427 127  64],458,5,15512,3.7742092457420924,20.0,20.0
34110,3,4110,[603 302 427 127  64],339,5,15517,3.774507419119436,20.0,20.0
34111,3,4111,[237 100 286 125  96],234,1,15518,3.7738326848249026,0.0,20.0
34112,3,4112,[603 302 427 127  64],745,4,15522,3.773887673231218,20.0,20.0
34113,3,4113,[100 181  69  98 111],334,3,15525,3.773699562469616,0.0,40.0
34114,3,4114,[286 300 194 181 257],119,5,15530,3.7739975698663426,0.0,0.0
34115,3,4115,[121 483 318 655  82],804,5,15535,3.7742954324586977,40.0,0.0
34116,3,4116,[603 302 427 127  64],271,5,15540,3.774593150352198,20.0,20.0
34117,3,4117,[216 153 186 222 269],64,4,15544,3.7746478873239435,0.0,0.0
34118,3,4118,[179 216 100  79 228],7,5,15549,3.7749453750910416,0.0,20.0
34119,3,4119,[151 187 121 496  89],346,4,15553,3.775,0.0,0.0
34120,3,4120,[546 423 288  95 294],308,3,15556,3.7748119388497936,0.0,0.0
34121,3,4121,[121 173 603   4 127],64,2,15558,3.7743813682678313,20.0,20.0
34122,3,4122,[603 302 427 127  64],666,5,15563,3.774678632064031,20.0,20.0
34123,3,4123,[211 117 423 300  64],328,5,15568,3.774975751697381,0.0,0.0
34124,3,4124,[603 302 427 127  64],90,5,15573,3.775272727272727,20.0,20.0
34125,3,4125,[181   1 118 385  25],804,5,15578,3.7755695588948135,0.0,0.0
34126,3,4126,[603 302 427 127  64],90,5,15583,3.775866246668282,20.0,20.0
34127,3,4127,[603 302 427 127  64],745,4,15587,3.775920542635659,20.0,20.0
34128,3,4128,[333  22 678  71 483],13,3,15590,3.7757326229111166,20.0,0.0
34129,3,4129,[196 187  56 475 237],343,5,15595,3.776029055690073,0.0,0.0
34130,3,4130,[603 302 427 127  64],474,5,15600,3.776325344952796,20.0,20.0
34131,3,4131,[191 195 265 357 176],95,3,15603,3.776137463697967,20.0,0.0
34132,3,4132,[  4 187   8 181 357],115,5,15608,3.776433583353496,20.0,0.0
34133,3,4133,[603 302 427 127  64],90,5,15613,3.7767295597484276,20.0,20.0
34134,3,4134,[405 678  89  11  25],881,3,15616,3.776541717049577,0.0,0.0
34135,3,4135,[603 302 427 127  64],664,5,15621,3.7768375241779495,20.0,20.0
34136,3,4136,[117 258 215 405 568],533,4,15625,3.7768914672467973,0.0,0.0
34137,3,4137,[603 302 427 127  64],90,5,15630,3.777187046882552,20.0,20.0
34138,3,4138,[603 302 427 127  64],664,5,15635,3.777482483691713,20.0,20.0
34139,3,4139,[323 117 144 258  56],788,3,15638,3.7772946859903382,0.0,0.0
34140,3,4140,[ 22 286  64  96 257],119,5,15643,3.7775899541173628,0.0,0.0
34141,3,4141,[603 302 427 127  64],669,5,15648,3.7778850796716563,20.0,20.0
34142,3,4142,[117  11 265 215 191],234,1,15649,3.7772145788076275,0.0,0.0
34143,3,4143,[603 302 427 127  64],271,5,15654,3.7775096525096523,20.0,20.0
34144,3,4144,[222  12 471 118 276],42,4,15658,3.7775633293124247,20.0,0.0
34145,3,4145,[313 268 269 294 286],205,0,15658,3.776652194886638,0.0,0.0
34146,3,4146,[603 302 427 127  64],745,4,15662,3.7767060525681218,20.0,20.0
34147,3,4147,[286 435 403 546 265],7,5,15667,3.777000964320154,0.0,0.0
34148,3,4148,[603 302 427 127  64],13,5,15672,3.777295733911786,20.0,20.0
34149,3,4149,[195 183 182 655 153],406,3,15675,3.7771084337349397,0.0,0.0
34150,3,4150,[483  98 135 603 168],932,5,15680,3.7774030354131534,40.0,20.0
34151,3,4151,[179 187 269   4   8],64,4,15684,3.777456647398844,0.0,0.0
34152,3,4152,[273  98 258 678  56],145,4,15688,3.7775102335660966,0.0,20.0
34153,3,4153,[211  96 127 435  79],843,0,15688,3.776600866634569,0.0,20.0
34154,3,4154,[603 302 427 127  64],664,5,15693,3.7768953068592057,20.0,20.0
34155,3,4155,[323 496 215 168 175],650,3,15696,3.776708373435996,0.0,0.0
34156,3,4156,[  7 111 100 179   4],579,2,15698,3.776280971854703,0.0,20.0
34157,3,4157,[210 603 174 211 204],298,5,15703,3.7765752765752767,20.0,20.0
34158,3,4158,[271 265  70 182 135],334,1,15704,3.775907670113008,0.0,0.0
34159,3,4159,[603 302 427 127  64],13,5,15709,3.7762019230769233,20.0,20.0
34160,3,4160,[143 210 282 496 276],200,5,15714,3.7764960346070655,0.0,0.0
34161,3,4161,[515 257 211   8 132],95,3,15717,3.7763094666025947,0.0,0.0
34162,3,4162,[179  25 197 186 121],13,3,15720,3.776122988229642,0.0,0.0
34163,3,4163,[603 302 427 127  64],664,5,15725,3.7764169068203652,20.0,20.0
34164,3,4164,[289 258 655  70 185],537,3,15728,3.776230492196879,0.0,0.0
34165,3,4165,[172 268   1   9 191],13,2,15730,3.7758041286605857,0.0,0.0
34166,3,4166,[603 302 427 127  64],666,5,15735,3.776097912167027,20.0,20.0
34167,3,4167,[ 22 228 546  89 179],343,3,15738,3.775911708253359,0.0,0.0
34168,3,4168,[471 118 185 234  15],194,2,15740,3.7754857279923244,0.0,0.0
34169,3,4169,[265 127 187 179 423],64,5,15745,3.775779376498801,0.0,20.0
34170,3,4170,[ 70 194  11 294   4],378,2,15747,3.7753536322224885,0.0,0.0
34171,3,4171,[ 56 175 328 288 181],334,3,15750,3.7751677852348995,0.0,0.0
34172,3,4172,[135 215  69 153 496],60,4,15754,3.7752216630721303,0.0,0.0
34173,3,4173,[ 95 175 135 301 265],234,1,15755,3.774556780067082,0.0,0.0
34174,3,4174,[176   7 151 191 228],406,3,15758,3.77437125748503,0.0,0.0
34175,3,4175,[603 302 427 127  64],745,4,15762,3.7744252873563218,20.0,20.0
34176,3,4176,[597 215 173 742 191],804,4,15766,3.7744792913574337,0.0,0.0
34177,3,4177,[603 302 427 127  64],664,5,15771,3.7747726184777406,20.0,20.0
34178,3,4178,[603 302 427 127  64],664,5,15776,3.775065805216559,20.0,20.0
34179,3,4179,[603 302 427 127  64],13,5,15781,3.7753588516746412,20.0,20.0
34180,3,4180,[603 302 427 127  64],458,5,15786,3.7756517579526427,20.0,20.0
34181,3,4181,[603 302 427 127  64],271,5,15791,3.775944524151124,20.0,20.0
34182,3,4182,[144 597 275 313  56],328,4,15795,3.775998087497012,0.0,0.0
34183,3,4183,[234 742 195 183  96],145,5,15800,3.7762906309751436,0.0,0.0
34184,3,4184,[ 82 385 181 515 179],207,2,15802,3.7758661887694145,0.0,0.0
34185,3,4185,[603 302 427 127  64],669,5,15807,3.776158623984711,20.0,20.0
34186,3,4186,[603 302 427 127  64],474,5,15812,3.7764509195127776,20.0,20.0
34187,3,4187,[176 181  98   4  56],7,3,15815,3.7762655205348614,0.0,20.0
34188,3,4188,[182 135 282 200 257],374,4,15819,3.7763189305323466,0.0,0.0
34189,3,4189,[186  98  50 180 678],664,4,15823,3.7763723150357995,0.0,40.0
34190,3,4190,[ 25  50 181  11  56],447,5,15828,3.7766642806012887,0.0,20.0
34191,3,4191,[603 302 427 127  64],537,4,15832,3.7767175572519083,20.0,20.0
34192,3,4192,[181 187   4 132 125],334,2,15834,3.7762938230383973,0.0,0.0
34193,3,4193,[603 302 427 127  64],90,5,15839,3.7765855984740107,20.0,20.0
34194,3,4194,[ 70 238 181 187   8],13,3,15842,3.7764004767580452,0.0,0.0
34195,3,4195,[ 12 286  22 215  50],59,4,15846,3.7764537654909436,20.0,20.0
34196,3,4196,[603 302 427 127  64],669,5,15851,3.776745294257803,20.0,20.0
34197,3,4197,[269 228 186 100 748],579,1,15852,3.77608384945212,0.0,20.0
34198,3,4198,[282   8 508 195 228],326,3,15855,3.775899023577042,0.0,0.0
34199,3,4199,[168 172   8 195 588],479,4,15859,3.775952380952381,0.0,0.0
34200,3,4200,[323  25 265 132 197],537,1,15860,3.775291597238753,0.0,0.0
34201,3,4201,[187 483 210 216 204],234,2,15862,3.774869109947644,20.0,0.0
34202,3,4202,[276 117 238 427 211],194,3,15865,3.7746847489888173,0.0,0.0
34203,3,4203,[603 302 427 127  64],339,5,15870,3.774976213130352,20.0,20.0
34204,3,4204,[132 182 151   7 483],788,3,15873,3.7747919143876336,20.0,0.0
34205,3,4205,[603 302 427 127  64],13,5,15878,3.7750832144555395,20.0,20.0
34206,3,4206,[172  88 187 496 127],653,2,15880,3.7746612788210125,0.0,20.0
34207,3,4207,[603 302 427 127  64],339,5,15885,3.77495247148289,20.0,20.0
34208,3,4208,[151 132 237 322 258],788,4,15889,3.7750059396531244,0.0,0.0
34209,3,4209,[144 186 289 282 182],406,1,15890,3.7743467933491686,0.0,0.0
34210,3,4210,[ 96 328 191 286 302],207,2,15892,3.7739254333887438,0.0,0.0
34211,3,4211,[  9 176 748 135  11],749,3,15895,3.773741690408357,0.0,0.0
34212,3,4212,[ 71  12 655 228 117],788,2,15897,3.7733206741039638,20.0,0.0
34213,3,4213,[191 238 475  25  79],308,5,15902,3.773611770289511,0.0,0.0
34214,3,4214,[135 273  28 328 183],92,3,15905,3.7734282325029658,0.0,0.0
34215,3,4215,[ 28 357   1 275  82],311,5,15910,3.773719165085389,20.0,0.0
34216,3,4216,[121   9 742   7 475],486,3,15913,3.7735356888783493,0.0,0.0
34217,3,4217,[603 302 427 127  64],666,5,15918,3.7738264580369845,20.0,20.0
34218,3,4218,[ 50 289 294  88 475],374,0,15918,3.772931974401517,0.0,20.0
34219,3,4219,[180  11 179 269 603],7,3,15921,3.7727488151658766,20.0,0.0
34220,3,4220,[ 12 132 268 121  50],288,3,15924,3.7725657427149963,20.0,20.0
34221,3,4221,[655 301 282  25 132],85,2,15926,3.7721459024159167,0.0,0.0
34222,3,4222,[300 185 328  89 271],479,3,15929,3.7719630594364197,0.0,0.0
34223,3,4223,[172  98 174 195 435],883,4,15933,3.7720170454545454,0.0,40.0
34224,3,4224,[216 121  28 235  22],804,5,15938,3.772307692307692,0.0,0.0
34225,3,4225,[173 300 603 180 237],749,4,15942,3.7723615712257454,20.0,0.0
34226,3,4226,[179 161 204 423 234],210,4,15946,3.7724154246510526,0.0,0.0
34227,3,4227,[174 191 655  69   8],95,5,15951,3.7727057710501417,0.0,20.0
34228,3,4228,[603 302 427 127  64],474,5,15956,3.772995980137148,20.0,20.0
34229,3,4229,[268  12 211 276 427],288,5,15961,3.7732860520094564,20.0,0.0
34230,3,4230,[195 276 318  50 508],474,4,15965,3.7733396360198537,20.0,20.0
34231,3,4231,[176  82 151 125 185],848,4,15969,3.7733931947069945,0.0,0.0
34232,3,4232,[603 302 427 127  64],90,5,15974,3.7736829671627685,20.0,20.0
34233,3,4233,[183 405  12 300  96],144,4,15978,3.773736419461502,20.0,0.0
34234,3,4234,[202 357 237 168  11],59,4,15982,3.7737898465171194,20.0,0.0
34235,3,4235,[174 100 357 216 483],90,5,15987,3.7740793201133145,40.0,40.0
34236,3,4236,[328  22 234  89 121],788,4,15991,3.7741326410195892,0.0,0.0
34237,3,4237,[328 496 435 172 210],85,3,15994,3.7739499764039643,0.0,0.0
34238,3,4238,[403 143 385 161 174],64,4,15998,3.774003302665723,0.0,20.0
34239,3,4239,[183   1 196 222 742],881,4,16002,3.7740566037735848,0.0,0.0
34240,3,4240,[603 302 427 127  64],664,5,16007,3.774345673190285,20.0,20.0
34241,3,4241,[ 25 100  98  79 405],213,4,16011,3.7743988684582743,0.0,40.0
34242,3,4242,[313 153 144 117 186],738,4,16015,3.7744520386518974,0.0,0.0
34243,3,4243,[ 12 258 168 121 117],334,3,16018,3.7742695570216775,20.0,0.0
34244,3,4244,[  8 195 161 143  64],60,3,16021,3.7740871613663134,0.0,0.0
34245,3,4245,[185 161 143 423 435],194,3,16024,3.773904851625059,0.0,0.0
34246,3,4246,[748 161 183 143 197],13,4,16028,3.7739580880621615,0.0,0.0
34247,3,4247,[603 302 427 127  64],666,5,16033,3.7742467043314503,20.0,20.0
34248,3,4248,[100  79 238 276 144],538,4,16037,3.7742998352553543,0.0,20.0
34249,3,4249,[603 302 427 127  64],745,4,16041,3.7743529411764705,20.0,20.0
34250,3,4250,[603 302 427 127  64],271,5,16046,3.774641260879793,20.0,20.0
34251,3,4251,[216 197 182  28 215],533,4,16050,3.774694261523989,0.0,0.0
34252,3,4252,[323 135 655 357 144],488,2,16052,3.77427698095462,20.0,0.0
34253,3,4253,[427 435 200 238 173],843,0,16052,3.773389750822755,0.0,0.0
34254,3,4254,[187 183 228  56  69],664,3,16055,3.773207990599295,0.0,0.0
34255,3,4255,[603 302 427 127  64],537,4,16059,3.7732612781954886,20.0,20.0
34256,3,4256,[196 172 323 195  82],378,3,16062,3.7730796335447496,0.0,0.0
34257,3,4257,[603 302 427 127  64],537,4,16066,3.7731329262564586,20.0,20.0
34258,3,4258,[603 302 427 127  64],745,4,16070,3.77318619394224,20.0,20.0
34259,3,4259,[403 603  70 228 568],59,4,16074,3.7732394366197184,20.0,0.0
34260,3,4260,[423 180  79 427   7],59,5,16079,3.7735273409997654,0.0,0.0
34261,3,4261,[603 302 427 127  64],339,5,16084,3.7738151102768653,20.0,20.0
34262,3,4262,[603 302 427 127  64],537,4,16088,3.773868167956838,20.0,20.0
34263,3,4263,[603 302 427 127  64],537,4,16092,3.773921200750469,20.0,20.0
34264,3,4264,[ 98  11 234 204 515],643,3,16095,3.7737397420867524,0.0,20.0
34265,3,4265,[603 302 427 127  64],745,4,16099,3.773792780121894,20.0,20.0
34266,3,4266,[121  96 173 300 118],455,5,16104,3.7740801499882823,0.0,0.0
34267,3,4267,[357 200 197 180 215],537,3,16107,3.7738987816307406,20.0,0.0
34268,3,4268,[603 302 427 127  64],745,4,16111,3.7739517451393767,20.0,20.0
34269,3,4269,[603 302 427 127  64],537,4,16115,3.7740046838407495,20.0,20.0
34270,3,4270,[132 286  98 568 200],343,3,16118,3.773823460547881,0.0,20.0
34271,3,4271,[  9 215  15  97 597],308,1,16119,3.773174157303371,0.0,0.0
34272,3,4272,[603 302 427 127  64],474,5,16124,3.7734612684296747,20.0,20.0
34273,3,4273,[194 603  15 294 245],533,4,16128,3.773514272344408,20.0,0.0
34274,3,4274,[603 302 427 127  64],664,5,16133,3.7738011695906435,20.0,20.0
34275,3,4275,[185  97 265  89  82],479,4,16137,3.7738540692235736,0.0,0.0
34276,3,4276,[202 127 121 318  98],738,5,16142,3.7741407528641573,20.0,40.0
34277,3,4277,[328 191   4 258 222],92,4,16146,3.774193548387097,0.0,0.0
34278,3,4278,[286 210   1 423  96],479,3,16149,3.7740126197709745,0.0,0.0
34279,3,4279,[403 210 286 186 127],59,4,16153,3.774065420560748,0.0,20.0
34280,3,4280,[603 302 427 127  64],474,5,16158,3.774351786965662,20.0,20.0
34281,3,4281,[ 22 655  79 385 294],378,4,16162,3.7744044838860344,0.0,0.0
34282,3,4282,[603 302 427 127  64],271,5,16167,3.774690637403689,20.0,20.0
34283,3,4283,[385 294 403   1  15],533,4,16171,3.7747432306255835,0.0,0.0
34284,3,4284,[603 302 427 127  64],271,5,16176,3.775029171528588,20.0,20.0
34285,3,4285,[100 151 153 144 210],374,4,16180,3.7750816612225853,0.0,20.0
34286,3,4286,[603 302 427 127  64],537,4,16184,3.775134126428738,20.0,20.0
34287,3,4287,[603 302 427 127  64],537,4,16188,3.775186567164179,20.0,20.0
34288,3,4288,[172 117 568 121  79],648,4,16192,3.775238983446025,0.0,0.0
34289,3,4289,[405 238 245 125 181],92,4,16196,3.7752913752913755,0.0,0.0
34290,3,4290,[125 135 143 276 235],406,3,16199,3.775110696807271,0.0,0.0
34291,3,4291,[603 302 427 127  64],669,5,16204,3.7753960857409132,20.0,20.0
34292,3,4292,[ 15 294 427 655 151],474,3,16207,3.7752154670393665,0.0,0.0
34293,3,4293,[405 204 135 211 286],271,4,16211,3.7752678155565906,0.0,0.0
34294,3,4294,[603 302 427 127  64],13,5,16216,3.7755529685681024,20.0,20.0
34295,3,4295,[ 89 423 181   8 202],766,3,16219,3.7753724394785846,0.0,0.0
34296,3,4296,[ 22  82 153 273  28],479,5,16224,3.7756574354200607,0.0,0.0
34297,3,4297,[603 302 427 127  64],458,5,16229,3.7759422987436015,20.0,20.0
34298,3,4298,[286 200 655 117 603],234,2,16231,3.7755291928355432,20.0,0.0
34299,3,4299,[238 276  70   7 151],82,2,16233,3.7751162790697674,0.0,0.0
34300,3,4300,[603 302 427 127  64],271,5,16238,3.7754010695187166,20.0,20.0
34301,3,4301,[603 302 427 127  64],339,5,16243,3.7756857275685727,20.0,20.0
34302,3,4302,[568 483 144 216 234],385,1,16244,3.775040669300488,20.0,0.0
34303,3,4303,[603 302 427 127  64],458,5,16249,3.775325278810409,20.0,20.0
34304,3,4304,[182 300  96 183 211],843,1,16250,3.7746806039488967,0.0,0.0
34305,3,4305,[515 202 179 121 132],64,4,16254,3.7747329307942405,0.0,0.0
34306,3,4306,[200  56 508 173 180],6,3,16257,3.7745530531692593,0.0,0.0
34307,3,4307,[603 302 427 127  64],458,5,16262,3.774837511606314,20.0,20.0
34308,3,4308,[ 98 132 742   9  79],447,2,16264,3.7744256207936875,0.0,20.0
34309,3,4309,[258 257 179  98 427],666,4,16268,3.774477958236659,0.0,20.0
34310,3,4310,[748  56 568 195 515],64,4,16272,3.7745302713987474,0.0,0.0
34311,3,4311,[603 302 427 127  64],669,5,16277,3.7748144712430425,20.0,20.0
34312,3,4312,[ 82 568 174 742 258],25,5,16282,3.7750985392997913,0.0,20.0
34313,3,4313,[273 143 185 100 132],90,4,16286,3.775150672229949,0.0,20.0
34314,3,4314,[143  71 357 235 427],59,2,16288,3.774739281575898,20.0,0.0
34315,3,4315,[603 302 427 127  64],90,5,16293,3.7750231696014827,20.0,20.0
34316,3,4316,[515  11 216 194 176],666,3,16296,3.774843641417651,0.0,0.0
34317,3,4317,[237 176 228  88 216],42,4,16300,3.774895785085688,0.0,0.0
34318,3,4318,[  8  79 111 318 435],454,3,16303,3.7747163695299837,20.0,0.0
34319,3,4319,[195 301 168 191   4],13,2,16305,3.7743055555555554,0.0,0.0
34320,3,4320,[153 183  28 176 323],290,3,16308,3.7741263596389723,0.0,0.0
34321,3,4321,[603 302 427 127  64],13,5,16313,3.7744099953725128,20.0,20.0
34322,3,4322,[ 82 258 435 288 211],339,3,16316,3.774230858200324,0.0,0.0
34323,3,4323,[ 82 238 186  56 234],313,2,16318,3.7738205365402404,0.0,0.0
34324,3,4324,[483 286 235 161 318],184,3,16321,3.77364161849711,40.0,0.0
34325,3,4325,[603 302 427 127  64],669,5,16326,3.7739251040221915,20.0,20.0
34326,3,4326,[174 187 194 483 180],897,4,16330,3.773977351513751,20.0,20.0
34327,3,4327,[603 302 427 127  64],664,5,16335,3.7742606284658042,20.0,20.0
34328,3,4328,[603 302 427 127  64],666,5,16340,3.7745437745437744,20.0,20.0
34329,3,4329,[173 268 655 385 288],13,2,16342,3.774133949191686,0.0,0.0
34330,3,4330,[333 268 172 300 210],85,2,16344,3.7737243130916647,0.0,0.0
34331,3,4331,[234 302  64 238 275],458,5,16349,3.7740073868882735,0.0,0.0
34332,3,4332,[302 496 483   8  70],474,5,16354,3.7742903300253867,20.0,0.0
34333,3,4333,[  1 483 181 269 173],488,2,16356,3.7738809413936316,20.0,0.0
34334,3,4334,[118 194 435 200 179],308,4,16360,3.7739331026528258,0.0,0.0
34335,3,4335,[222 143 100  89  97],795,2,16362,3.7735239852398523,0.0,20.0
34336,3,4336,[191 100  28   9 151],7,5,16367,3.77380677887941,0.0,20.0
34337,3,4337,[258  88 257 222 385],92,3,16370,3.7736284001844167,0.0,0.0
34338,3,4338,[ 69 185 300 597  22],774,1,16371,3.7729891680110623,0.0,0.0
34339,3,4339,[603 302 427 127  64],745,4,16375,3.7730414746543777,20.0,20.0
34340,3,4340,[100 655 237 117 211],313,4,16379,3.773093757198802,0.0,20.0
34341,3,4341,[302  12 483 268  96],13,5,16384,3.773376324274528,40.0,0.0
34342,3,4342,[603 302 427 127  64],745,4,16388,3.7734285056412618,20.0,20.0
34343,3,4343,[603 302 427 127  64],474,5,16393,3.773710865561694,20.0,20.0
34344,3,4344,[121  89 153 180 200],899,4,16397,3.7737629459148447,0.0,0.0
34345,3,4345,[204 175 100   8   1],234,2,16399,3.7733548090197884,0.0,20.0
34346,3,4346,[603 302 427 127  64],537,4,16403,3.773406947319991,20.0,20.0
34347,3,4347,[  8 257 175   1 515],308,4,16407,3.7734590616375345,0.0,0.0
34348,3,4348,[603 302 427 127  64],664,5,16412,3.7737410899057253,20.0,20.0
34349,3,4349,[179  79 204 215 176],474,5,16417,3.774022988505747,0.0,0.0
34350,3,4350,[294  11 471 194 111],666,2,16419,3.7736152608595726,0.0,0.0
34351,3,4351,[ 25 237  89 405 176],749,3,16422,3.7734375,0.0,0.0
34352,3,4352,[508 200 144 182  50],326,2,16424,3.7730300941879165,0.0,20.0
34353,3,4353,[ 56  71 174 180 211],279,3,16427,3.7728525493798806,0.0,20.0
34354,3,4354,[603 302 427 127  64],666,5,16432,3.773134328358209,20.0,20.0
34355,3,4355,[176 385 318  70 322],883,3,16435,3.7729568411386594,20.0,0.0
34356,3,4356,[187 195 568   8  56],64,5,16440,3.7732384668349783,0.0,0.0
34357,3,4357,[603 302 427 127  64],339,5,16445,3.773519963285911,20.0,20.0
34358,3,4358,[185 174 196  50   8],334,5,16450,3.7738013305804086,0.0,40.0
34359,3,4359,[194 196 265 288 179],537,1,16451,3.773165137614679,0.0,0.0
34360,3,4360,[588 228  56 403 194],387,2,16453,3.7727585416188947,0.0,0.0
34361,3,4361,[186 655 210 357 132],85,2,16455,3.7723521320495186,20.0,0.0
34362,3,4362,[289 125 121 111 322],334,0,16455,3.7714875085950035,0.0,0.0
34363,3,4363,[258 265 238  64 202],92,4,16459,3.7715398716773603,0.0,0.0
34364,3,4364,[ 28 174 265 196 202],881,4,16463,3.7715922107674684,0.0,20.0
34365,3,4365,[603 302 427 127  64],339,5,16468,3.771873568483738,20.0,20.0
34366,3,4366,[603 302 427 127  64],745,4,16472,3.771925807190291,20.0,20.0
34367,3,4367,[603 302 427 127  64],666,5,16477,3.77220695970696,20.0,20.0
34368,3,4368,[  7 655 187 496 179],7,5,16482,3.7724879835202563,0.0,0.0
34369,3,4369,[ 15 132 179 135   9],474,5,16487,3.7727688787185354,0.0,0.0
34370,3,4370,[496 435 100  28 191],537,3,16490,3.7725920841912606,0.0,20.0
34371,3,4371,[603 302 427 127  64],458,5,16495,3.7728728270814273,20.0,20.0
34372,3,4372,[603 302 427 127  64],90,5,16500,3.7731534415732906,20.0,20.0
34373,3,4373,[ 56 301 111 100 235],537,2,16502,3.772748056698674,0.0,20.0
34374,3,4374,[121 328 302 210 191],13,2,16504,3.772342857142857,0.0,0.0
34375,3,4375,[151  56 210   4 748],474,3,16507,3.772166361974406,0.0,0.0
34376,3,4376,[245 182 333 322 235],313,2,16509,3.771761480466073,0.0,0.0
34377,3,4377,[ 22 181  15   1 289],554,4,16513,3.771813613522156,0.0,0.0
34378,3,4378,[195 204 403 168   1],158,5,16518,3.7720940854076273,0.0,0.0
34379,3,4379,[  1 678 117 187 173],387,3,16521,3.771917808219178,0.0,0.0
34380,3,4380,[183 258 678 228  12],506,4,16525,3.7719698698927187,20.0,0.0
34381,3,4381,[179  25 210 515 302],666,3,16528,3.7717937015061618,0.0,0.0
34382,3,4382,[603 302 427 127  64],664,5,16533,3.7720739219712525,20.0,20.0
34383,3,4383,[603 302 427 127  64],537,4,16537,3.772125912408759,20.0,20.0
34384,3,4384,[181 238 135 191 144],308,4,16541,3.7721778791334093,0.0,0.0
34385,3,4385,[238 300 237  25 318],537,2,16543,3.7717738258093934,20.0,0.0
34386,3,4386,[603 302 427 127  64],458,5,16548,3.7720537953043083,20.0,20.0
34387,3,4387,[179  11   1 288 161],234,0,16548,3.771194165907019,0.0,0.0
34388,3,4388,[403  97  89  88 183],290,2,16550,3.770790612895876,0.0,0.0
34389,3,4389,[603 302 427 127  64],664,5,16555,3.7710706150341684,20.0,20.0
34390,3,4390,[ 28 173 357 204 180],409,3,16558,3.7708950125256204,20.0,0.0
34391,3,4391,[175 568 117   1 194],213,4,16562,3.7709471766848814,0.0,0.0
34392,3,4392,[603 302 427 127  64],90,5,16567,3.771226951969042,20.0,20.0
34393,3,4393,[127 216  82  95 603],334,3,16570,3.7710514337733274,20.0,20.0
34394,3,4394,[228 496  28 161 197],479,3,16573,3.7708759954493742,0.0,0.0
34395,3,4395,[151  96 204  98 191],650,4,16577,3.7709281164695176,0.0,20.0
34396,3,4396,[603 302 427 127  64],13,5,16582,3.7712076415738003,20.0,20.0
34397,3,4397,[182  71 427 588  69],85,3,16585,3.771032287403365,0.0,0.0
34398,3,4398,[161 176 135 546 603],897,4,16589,3.7710843373493974,20.0,0.0
34399,3,4399,[597 186 185 194 151],650,2,16591,3.770681818181818,0.0,0.0
34400,3,4400,[ 89 200 257 294 322],374,2,16593,3.7702794819359235,0.0,0.0
34401,3,4401,[127 173  89 183 357],474,5,16598,3.7705588368923215,20.0,20.0
34402,3,4402,[568  56 210  22 318],538,3,16601,3.7703838292073586,20.0,0.0
34403,3,4403,[568 286 508  97 228],524,4,16605,3.7704359673024523,0.0,0.0
34404,3,4404,[357 172 265 496   4],295,5,16610,3.7707150964812715,20.0,0.0
34405,3,4405,[302 405 245 237 275],334,3,16613,3.770540172492056,0.0,0.0
34406,3,4406,[210 546 196 288  69],378,2,16615,3.770138416156115,0.0,0.0
34407,3,4407,[603 302 427 127  64],666,5,16620,3.7704174228675136,20.0,20.0
34408,3,4408,[174 508 301 471  25],83,1,16621,3.7697890678158315,0.0,20.0
34409,3,4409,[301  88 235 181 195],102,1,16622,3.7691609977324263,0.0,0.0
34410,3,4410,[603 302 427 127  64],90,5,16627,3.769440036272954,20.0,20.0
34411,3,4411,[ 69 423 282 127  12],318,5,16632,3.769718948322756,20.0,20.0
34412,3,4412,[ 97 191 423 204 515],387,2,16634,3.7693179243145254,0.0,0.0
34413,3,4413,[111   1 515  95  12],59,3,16637,3.769143633892161,20.0,0.0
34414,3,4414,[ 69 483 238  28 118],313,4,16641,3.7691959229898075,20.0,0.0
34415,3,4415,[603 302 427 127  64],474,5,16646,3.769474637681159,20.0,20.0
34416,3,4416,[603 302 427 127  64],669,5,16651,3.7697532261716096,20.0,20.0
34417,3,4417,[ 28  69 655  50 483],308,2,16653,3.76935264825713,20.0,20.0
34418,3,4418,[ 70 174 127 216 302],210,5,16658,3.7696311382665764,0.0,40.0
34419,3,4419,[135 215  22 282 423],194,1,16659,3.7690045248868778,0.0,0.0
34420,3,4420,[111   1 185  56   7],6,3,16662,3.768830581316444,0.0,0.0
34421,3,4421,[ 28  56 427 174  82],313,2,16664,3.768430574400724,0.0,20.0
34422,3,4422,[194 228 282 333  79],328,1,16665,3.767804657472304,0.0,0.0
34423,3,4423,[318 153 196 173 181],387,3,16668,3.767631103074141,20.0,0.0
34424,3,4424,[ 71 187  12 385 195],506,5,16673,3.767909604519774,20.0,0.0
34425,3,4425,[313 273 288 117 423],234,2,16675,3.7675101671938545,0.0,0.0
34426,3,4426,[603 302 427 127  64],271,5,16680,3.7677885701377907,20.0,20.0
34427,3,4427,[  7 125 216   8 211],82,3,16683,3.7676151761517613,0.0,0.0
34428,3,4428,[237  70 333 234  96],653,2,16685,3.767216075863626,0.0,0.0
34429,3,4429,[328 234 318  69  95],271,4,16689,3.767268623024831,20.0,0.0
34430,3,4430,[183 197 196 204  82],207,2,16691,3.7668697810877907,0.0,0.0
34431,3,4431,[357 161 153 568 185],194,3,16694,3.766696750902527,20.0,0.0
34432,3,4432,[405 143 197 175 181],379,4,16698,3.7667493796526053,0.0,0.0
34433,3,4433,[357 742  64 318  56],804,4,16702,3.76680198466396,40.0,0.0
34434,3,4434,[603 265 237 195 174],59,4,16706,3.7668545659526496,20.0,20.0
34435,3,4435,[603 302 427 127  64],666,5,16711,3.7671325518485124,20.0,20.0
34436,3,4436,[100 125 173 211 195],311,3,16714,3.766959657426189,0.0,20.0
34437,3,4437,[151 258 423 222 435],788,2,16716,3.7665615141955837,0.0,0.0
34438,3,4438,[603 302 427 127  64],339,5,16721,3.766839378238342,20.0,20.0
34439,3,4439,[603 302 427 127  64],271,5,16726,3.767117117117117,20.0,20.0
34440,3,4440,[603 302 427 127  64],13,5,16731,3.76739473091646,20.0,20.0
34441,3,4441,[202 183 237   8  82],13,4,16735,3.7674470959027464,0.0,0.0
34442,3,4442,[423 276 100  89  82],194,1,16736,3.7668242178708082,0.0,20.0
34443,3,4443,[195 228 273 288  71],279,2,16738,3.7664266426642663,0.0,0.0
34444,3,4444,[172 435  95 568 238],749,3,16741,3.766254218222722,0.0,0.0
34445,3,4445,[603 302 427 127  64],474,5,16746,3.766531713900135,20.0,20.0
34446,3,4446,[144 275 423  50 185],843,0,16746,3.765684731279514,0.0,20.0
34447,3,4447,[200 182 195 176 385],537,1,16747,3.7650629496402876,0.0,0.0
34448,3,4448,[603 302 427 127  64],474,5,16752,3.76534052596089,20.0,20.0
34449,3,4449,[174 423  71 265 111],474,5,16757,3.76561797752809,0.0,20.0
34450,3,4450,[211 187 357 427 483],298,5,16762,3.7658953044259715,40.0,0.0
34451,3,4451,[603 302 427 127  64],537,4,16766,3.765947888589398,20.0,20.0
34452,3,4452,[603 302 427 127  64],90,5,16771,3.766225016842578,20.0,20.0
34453,3,4453,[ 64 265 200  88 194],774,0,16771,3.7653794342164346,0.0,0.0
34454,3,4454,[144 176 742 182 161],749,3,16774,3.7652076318742984,0.0,0.0
34455,3,4455,[117 195  50 333 182],537,2,16776,3.7648114901256733,0.0,20.0
34456,3,4456,[ 28  12  88 268 197],234,2,16778,3.7644155261386585,20.0,0.0
34457,3,4457,[172 194 210 588  56],406,5,16783,3.764692687303724,0.0,0.0
34458,3,4458,[121 603 301 748 228],13,4,16787,3.76474545862301,20.0,0.0
34459,3,4459,[ 96 423   4 403  70],643,3,16790,3.7645739910313902,0.0,0.0
34460,3,4460,[603 302 427 127  64],664,5,16795,3.7648509302846893,20.0,20.0
34461,3,4461,[196 153 211 135 202],234,1,16796,3.7642312864186462,0.0,0.0
34462,3,4462,[  9 228 568 195 187],881,3,16799,3.764060049294197,0.0,0.0
34463,3,4463,[357 172  28 286 228],60,5,16804,3.764336917562724,20.0,0.0
34464,3,4464,[603 302 427 127  64],669,5,16809,3.76461366181411,20.0,20.0
34465,3,4465,[161 182 403  71 655],506,5,16814,3.7648902821316614,0.0,0.0
34466,3,4466,[603 302 427 127  64],537,4,16818,3.7649429147078575,20.0,20.0
34467,3,4467,[603 302 427 127  64],537,4,16822,3.7649955237242616,20.0,20.0
34468,3,4468,[318 385 302  50 132],13,3,16825,3.7648243454911614,20.0,20.0
34469,3,4469,[603 302 427 127  64],537,4,16829,3.764876957494407,20.0,20.0
34470,3,4470,[603 302 427 127  64],339,5,16834,3.7651532095728024,20.0,20.0
34471,3,4471,[121  79 180 211  96],833,2,16836,3.764758497316637,0.0,0.0
34472,3,4472,[  9 211 195  64 238],883,5,16841,3.765034652358596,0.0,0.0
34473,3,4473,[603 302 427 127  64],13,5,16846,3.765310683951721,20.0,20.0
34474,3,4474,[603 302 427 127  64],339,5,16851,3.765586592178771,20.0,20.0
34475,3,4475,[258 144 405 168 143],538,1,16852,3.76496872207328,0.0,0.0
34476,3,4476,[603 302 427 127  64],13,5,16857,3.7652445834264014,20.0,20.0
34477,3,4477,[117 471  56  50 265],524,4,16861,3.7652970075926753,0.0,20.0
34478,3,4478,[603 302 427 127  64],339,5,16866,3.7655726724715337,20.0,20.0
34479,3,4479,[258 265 153 111 215],479,4,16870,3.765625,0.0,0.0
34480,3,4480,[180 173 742 175 211],648,3,16873,3.7654541397009598,0.0,0.0
34481,3,4481,[195 302  95 187 176],102,2,16875,3.7650602409638556,0.0,0.0
34482,3,4482,[300 435 294 187 161],197,5,16880,3.7653357126923934,0.0,0.0
34483,3,4483,[603 302 427 127  64],664,5,16885,3.7656110615521854,20.0,20.0
34484,3,4484,[603 302 427 127  64],13,5,16890,3.765886287625418,20.0,20.0
34485,3,4485,[ 15 195 185 211 234],650,3,16893,3.765715559518502,0.0,0.0
34486,3,4486,[127 185 655 194 302],10,5,16898,3.765990639625585,0.0,20.0
34487,3,4487,[ 64 173 125 187   4],234,3,16901,3.765819964349376,0.0,0.0
34488,3,4488,[603 302 427 127  64],13,5,16906,3.7660948986411227,20.0,20.0
34489,3,4489,[286 300  96 271 173],144,3,16909,3.765924276169265,0.0,0.0
34490,3,4490,[ 69 200 435 117 118],650,4,16913,3.7659763972389224,0.0,0.0
34491,3,4491,[ 89  79 268 423 597],7,3,16916,3.765805877114871,0.0,0.0
34492,3,4492,[603 302 427 127  64],271,5,16921,3.7660805697752058,20.0,20.0
34493,3,4493,[ 15 186 182 151  98],406,3,16924,3.7659101023587005,0.0,20.0
34494,3,4494,[603 302 427 127  64],669,5,16929,3.7661846496106786,20.0,20.0
34495,3,4495,[151 483 111  28 191],234,3,16932,3.7660142348754446,20.0,0.0
34496,3,4496,[180  79 471   9 275],311,5,16937,3.7662886368690236,0.0,0.0
34497,3,4497,[603 302 427 127  64],339,5,16942,3.7665629168519343,20.0,20.0
34498,3,4498,[228 423 210  50 185],13,3,16945,3.7663925316737052,0.0,20.0
34499,3,4499,[180 435 182 289 175],194,1,16946,3.7657777777777777,0.0,0.0
34500,3,4500,[603 302 427 127  64],474,5,16951,3.766051988447012,20.0,20.0
34501,3,4501,[161 179   9  97  28],339,4,16955,3.7661039537983116,0.0,0.0
34502,3,4502,[603 302 427 127  64],90,5,16960,3.766377970242061,20.0,20.0
34503,3,4503,[515   7 286 318 202],6,2,16962,3.765985790408526,20.0,0.0
34504,3,4504,[  9 186   1 173 265],64,5,16967,3.7662597114317427,0.0,0.0
34505,3,4505,[200 100  69   8 202],313,3,16970,3.7660896582334664,0.0,20.0
34506,3,4506,[216 238 191   7 180],892,5,16975,3.7663634346571997,0.0,0.0
34507,3,4507,[235 265 195 257 238],479,4,16979,3.7664152617568765,0.0,0.0
34508,3,4508,[546 333  98 568 174],313,5,16984,3.766688844533156,0.0,40.0
34509,3,4509,[125  89 655 176  25],59,4,16988,3.766740576496674,0.0,0.0
34510,3,4510,[603 302 427 127  64],666,5,16993,3.7670139658612283,20.0,20.0
34511,3,4511,[  1 235 405  22 289],82,1,16994,3.7664007092198584,0.0,0.0
34512,3,4512,[125 144 222 173 118],92,3,16997,3.7662308885442055,0.0,0.0
34513,3,4513,[318 172 276 196  96],452,3,17000,3.7660611431103233,20.0,0.0
34514,3,4514,[603 302 427 127  64],271,5,17005,3.7663344407530452,20.0,20.0
34515,3,4515,[603 302 427 127  64],271,5,17010,3.766607617360496,20.0,20.0
34516,3,4516,[222 200 282  79  28],311,5,17015,3.7668806730130617,0.0,0.0
34517,3,4517,[603 302 427 127  64],458,5,17020,3.767153607791058,20.0,20.0
34518,3,4518,[603 302 427 127  64],339,5,17025,3.767426421774729,20.0,20.0
34519,3,4519,[183 318 546 597 294],378,2,17027,3.7670353982300884,20.0,0.0
34520,3,4520,[ 56 237  79 210 588],308,4,17031,3.7670869276708694,0.0,0.0
34521,3,4521,[603 302 427 127  64],13,5,17036,3.767359575409111,20.0,20.0
34522,3,4522,[ 22 288  50 258 211],488,4,17040,3.767411010391333,0.0,20.0
34523,3,4523,[603 302 427 127  64],537,4,17044,3.7674624226348365,20.0,20.0
34524,3,4524,[235 191 183 196  82],537,1,17045,3.766850828729282,0.0,0.0
34525,3,4525,[210  98 568 403 286],648,4,17049,3.766902342023862,0.0,20.0
34526,3,4526,[132 144 202 286   7],666,4,17053,3.7669538325601946,0.0,0.0
34527,3,4527,[180 496  56 135  69],892,5,17058,3.767226148409894,0.0,0.0
34528,3,4528,[603 302 427 127  64],458,5,17063,3.767498344005299,20.0,20.0
34529,3,4529,[300 323 471 603 195],454,3,17066,3.767328918322296,20.0,0.0
34530,3,4530,[603 302 427 127  64],339,5,17071,3.76760097108806,20.0,20.0
34531,3,4531,[265 496  69 294  79],311,5,17076,3.767872903795234,0.0,0.0
34532,3,4532,[185 191 286  12 143],339,5,17081,3.768144716523274,20.0,0.0
34533,3,4533,[603 302 427 127  64],458,5,17086,3.7684164093515657,20.0,20.0
34534,3,4534,[ 56 423   7 200 194],378,4,17090,3.768467475192944,0.0,0.0
34535,3,4535,[194   4 216 181 318],308,4,17094,3.7685185185185186,20.0,0.0
34536,3,4536,[132 322 483 161  95],308,1,17095,3.767908309455587,20.0,0.0
34537,3,4537,[173 265  98 435 237],295,5,17100,3.7681798148964303,0.0,20.0
34538,3,4538,[174 403 265 176 168],313,3,17103,3.7680105750165236,0.0,20.0
34539,3,4539,[603 302 427 127  64],669,5,17108,3.768281938325991,20.0,20.0
34540,3,4540,[603 302 427 127  64],666,5,17113,3.768553182118476,20.0,20.0
34541,3,4541,[603 302 427 127  64],745,4,17117,3.7686041391457508,20.0,20.0
34542,3,4542,[603 302 427 127  64],666,5,17122,3.768875192604006,20.0,20.0
34543,3,4543,[603 302 427 127  64],666,5,17127,3.7691461267605635,20.0,20.0
34544,3,4544,[405 258 180 153  69],666,3,17130,3.768976897689769,0.0,0.0
34545,3,4545,[  1 238  22  50 195],308,5,17135,3.7692476902771666,0.0,20.0
34546,3,4546,[603 302 427 127  64],339,5,17140,3.769518363756323,20.0,20.0
34547,3,4547,[603 302 427 127  64],669,5,17145,3.769788918205805,20.0,20.0
34548,3,4548,[603 302 427 127  64],474,5,17150,3.7700593537041107,20.0,20.0
34549,3,4549,[603 302 427 127  64],458,5,17155,3.7703296703296703,20.0,20.0
34550,3,4550,[125 269 111 222  11],334,2,17157,3.769940672379697,0.0,0.0
34551,3,4551,[237 435 132  50  89],7,5,17162,3.7702108963093144,0.0,20.0
34552,3,4552,[ 88 175 568 405 655],738,1,17163,3.7696024599165385,0.0,0.0
34553,3,4553,[546 125  69 176 276],92,4,17167,3.7696530522617477,0.0,0.0
34554,3,4554,[603 302 427 127  64],745,4,17171,3.7697036223929747,20.0,20.0
34555,3,4555,[603 302 427 127  64],90,5,17176,3.7699736611062336,20.0,20.0
34556,3,4556,[515 385 111 168  69],13,3,17179,3.769804696071977,0.0,0.0
34557,3,4557,[603 302 427 127  64],666,5,17184,3.7700745941202283,20.0,20.0
34558,3,4558,[603 302 427 127  64],666,5,17189,3.770344373766177,20.0,20.0
34559,3,4559,[174 318 185 234 179],308,4,17193,3.770394736842105,20.0,20.0
34560,3,4560,[603 302 427 127  64],664,5,17198,3.770664327998246,20.0,20.0
34561,3,4561,[118 403 183  56 385],892,3,17201,3.770495396755809,0.0,0.0
34562,3,4562,[597 179 403 271 125],92,3,17204,3.770326539557309,0.0,0.0
34563,3,4563,[111 328 210 435 182],749,3,17207,3.7701577563540756,0.0,0.0
34564,3,4564,[603 302 427 127  64],537,4,17211,3.770208105147864,20.0,20.0
34565,3,4565,[ 82 161 202 234 144],290,3,17214,3.7700394218134035,0.0,0.0
34566,3,4566,[603 302 427 127  64],745,4,17218,3.770089774469017,20.0,20.0
34567,3,4567,[423 196 118 173  11],271,4,17222,3.7701401050788093,0.0,0.0
34568,3,4568,[603 302 427 127  64],474,5,17227,3.7704092799299627,20.0,20.0
34569,3,4569,[603 172 228 143  95],42,5,17232,3.7706783369803065,20.0,0.0
34570,3,4570,[135 127 202 182 185],749,4,17236,3.7707285057974187,0.0,20.0
34571,3,4571,[603 302 427 127  64],664,5,17241,3.770997375328084,20.0,20.0
34572,3,4572,[603 302 427 127  64],537,4,17245,3.7710474524382245,20.0,20.0
34573,3,4573,[603 302 427 127  64],271,5,17250,3.7713161346742456,20.0,20.0
34574,3,4574,[603 161 181  69 144],326,3,17253,3.7711475409836064,20.0,0.0
34575,3,4575,[603 302 427 127  64],458,5,17258,3.7714160839160837,20.0,20.0
34576,3,4576,[301 405  69 100 323],13,2,17260,3.771029058335154,0.0,20.0
34577,3,4577,[172 471  50   8 196],7,5,17265,3.77129750982962,0.0,20.0
34578,3,4578,[144  64 183 258 435],263,4,17269,3.7713474557763704,0.0,0.0
34579,3,4579,[603 302 427 127  64],339,5,17274,3.7716157205240175,20.0,20.0
34580,3,4580,[603 302 427 127  64],90,5,17279,3.771883868151059,20.0,20.0
34581,3,4581,[182 216 183 197 161],650,3,17282,3.7717154081187254,0.0,0.0
34582,3,4582,[603 302 427 127  64],458,5,17287,3.77198341697578,20.0,20.0
34583,3,4583,[ 89 132  70 172  71],148,5,17292,3.7722513089005236,0.0,0.0
34584,3,4584,[603 302 427 127  64],669,5,17297,3.7725190839694656,20.0,20.0
34585,3,4585,[603 302 427 127  64],745,4,17301,3.772568687309202,20.0,20.0
34586,3,4586,[  9 403 385 168 135],326,0,17301,3.771746239372139,0.0,0.0
34587,3,4587,[237  70 197 180 182],474,5,17306,3.7720139494333043,0.0,0.0
34588,3,4588,[132 151 405 234 286],881,1,17307,3.7714098932229243,0.0,0.0
34589,3,4589,[603 302 427 127  64],458,5,17312,3.7716775599128542,20.0,20.0
34590,3,4590,[515 143 210 191 121],207,3,17315,3.7715094750599,0.0,0.0
34591,3,4591,[172  69  97 301  96],524,4,17319,3.7715592334494774,0.0,0.0
34592,3,4592,[302  11 175  70 125],207,2,17321,3.77117352492924,0.0,0.0
34593,3,4593,[237  97  28 286 405],13,3,17324,3.7710056595559425,0.0,0.0
34594,3,4594,[603 302 427 127  64],669,5,17329,3.7712731229597387,20.0,20.0
34595,3,4595,[175 132 435 258 182],666,5,17334,3.7715404699738904,0.0,0.0
34596,3,4596,[603 302 427 127  64],669,5,17339,3.7718077006743527,20.0,20.0
34597,3,4597,[588 200  56 300 172],843,0,17339,3.7709873858199217,0.0,0.0
34598,3,4598,[  4 568 161 180 496],59,4,17343,3.771037181996086,0.0,0.0
34599,3,4599,[  7 245 118   8 237],378,4,17347,3.771086956521739,0.0,0.0
34600,3,4600,[ 79 121   7 568 238],194,1,17348,3.7704846772440774,0.0,0.0
34601,3,4601,[268 323 483 235 427],13,3,17351,3.7703172533681006,20.0,0.0
34602,3,4602,[ 56 132 286 194 215],406,3,17354,3.770149902237671,0.0,0.0
34603,3,4603,[423 151 172  79 222],334,4,17358,3.770199826238054,0.0,0.0
34604,3,4604,[265 202 153  25  64],899,4,17362,3.7702497285559176,0.0,0.0
34605,3,4605,[603 302 427 127  64],666,5,17367,3.770516717325228,20.0,20.0
34606,3,4606,[228 153   7 301  56],102,1,17368,3.7699153462122856,0.0,0.0
34607,3,4607,[603 302 427 127  64],90,5,17373,3.7701822916666665,20.0,20.0
34608,3,4608,[603 302 427 127  64],458,5,17378,3.7704491212844435,20.0,20.0
34609,3,4609,[318 181 118  98 405],804,5,17383,3.7707158351409977,20.0,20.0
34610,3,4610,[173 185 269  79 258],271,3,17386,3.770548687920191,0.0,0.0
34611,3,4611,[  9 100  97 143 180],694,5,17391,3.77081526452732,0.0,20.0
34612,3,4612,[603 302 427 127  64],474,5,17396,3.771081725558205,20.0,20.0
34613,3,4613,[ 96 179  28 161 471],234,1,17397,3.770481144343303,0.0,0.0
34614,3,4614,[603 302 427 127  64],90,5,17402,3.770747562296858,20.0,20.0
34615,3,4615,[ 89  97 357  28 228],60,4,17406,3.770797227036395,20.0,0.0
34616,3,4616,[318  82 597  56 179],308,4,17410,3.770846870262075,20.0,0.0
34617,3,4617,[275 215 143  70 161],378,5,17415,3.771113035946297,0.0,0.0
34618,3,4618,[181 234   4 222  96],795,3,17418,3.770946092227755,0.0,0.0
34619,3,4619,[ 88  56 265 100  64],374,4,17422,3.770995670995671,0.0,20.0
34620,3,4620,[172 196 183  89 257],840,3,17425,3.770828824929669,0.0,0.0
34621,3,4621,[168 196 187 483 127],343,5,17430,3.7710947641713544,20.0,20.0
34622,3,4622,[121  88 161 151  11],295,5,17435,3.771360588362535,0.0,0.0
34623,3,4623,[603 302 427 127  64],666,5,17440,3.7716262975778547,20.0,20.0
34624,3,4624,[748 176 200 742 313],92,2,17442,3.7712432432432434,0.0,0.0
34625,3,4625,[161 597  28 202 191],308,2,17444,3.770860354517942,0.0,0.0
34626,3,4626,[603 302 427 127  64],13,5,17449,3.7711259995677544,20.0,20.0
34627,3,4627,[194 515  89 603 202],271,4,17453,3.7711754537597235,20.0,0.0
34628,3,4628,[603 302 427 127  64],13,5,17458,3.771440915964571,20.0,20.0
34629,3,4629,[204 483 237 215 515],194,3,17461,3.7712742980561553,20.0,0.0
34630,3,4630,[603 302 427 127  64],664,5,17466,3.771539624271216,20.0,20.0
34631,3,4631,[603 302 427 127  64],666,5,17471,3.771804835924007,20.0,20.0
34632,3,4632,[125 121 181  95 144],295,5,17476,3.7720699330887113,0.0,0.0
34633,3,4633,[258  89 265 175 546],666,4,17480,3.7721191195511437,0.0,0.0
34634,3,4634,[603 302 427 127  64],458,5,17485,3.772384034519957,20.0,20.0
34635,3,4635,[603 302 427 127  64],745,4,17489,3.7724331320103537,20.0,20.0
34636,3,4636,[204 174 117 135 180],653,5,17494,3.772697864998922,0.0,20.0
34637,3,4637,[603 302 427 127  64],90,5,17499,3.772962483829237,20.0,20.0
34638,3,4638,[ 22   7 182  96 275],328,4,17503,3.7730114248760507,0.0,0.0
34639,3,4639,[172 197  82  88   4],13,4,17507,3.773060344827586,0.0,0.0
34640,3,4640,[179 588 172  96  56],59,4,17511,3.773109243697479,0.0,0.0
34641,3,4641,[603 302 427 127  64],664,5,17516,3.773373545885394,20.0,20.0
34642,3,4642,[186 234 174 403 196],92,5,17521,3.7736377342235623,0.0,20.0
34643,3,4643,[153  82 185 197 603],883,4,17525,3.773686477174849,20.0,0.0
34644,3,4644,[603 302 427 127  64],474,5,17530,3.7739504843918192,20.0,20.0
34645,3,4645,[603 302 427 127  64],474,5,17535,3.774214377959535,20.0,20.0
34646,3,4646,[ 11 196 175   4 183],346,4,17539,3.7742629653539916,0.0,0.0
34647,3,4647,[186 483  50 435 515],537,4,17543,3.7743115318416525,20.0,20.0
34648,3,4648,[ 12 111  56 143 237],334,3,17546,3.774144977414498,20.0,0.0
34649,3,4649,[603 302 427 127  64],339,5,17551,3.7744086021505376,20.0,20.0
34650,3,4650,[187 185  82 195 427],326,3,17554,3.7742420984734464,0.0,0.0
34651,3,4651,[603 302 427 127  64],537,4,17558,3.7742906276870163,20.0,20.0
34652,3,4652,[603 302 427 127  64],90,5,17563,3.7745540511497957,20.0,20.0
34653,3,4653,[117 483 238 183 276],194,2,17565,3.774172754619682,20.0,0.0
34654,3,4654,[ 88  89 135 215   4],650,2,17567,3.7737916219119225,0.0,0.0
34655,3,4655,[ 82   1 655 588  56],387,3,17570,3.7736254295532645,0.0,0.0
34656,3,4656,[496  28 515 118 100],194,4,17574,3.7736740390809533,0.0,20.0
34657,3,4657,[238 546   8 228 127],13,3,17577,3.7735079433233145,0.0,20.0
34658,3,4658,[603 302 427 127  64],745,4,17581,3.773556557201116,20.0,20.0
34659,3,4659,[603 302 427 127  64],339,5,17586,3.7738197424892705,20.0,20.0
34660,3,4660,[603 302 427 127  64],666,5,17591,3.7740828148465995,20.0,20.0
34661,3,4661,[215  64  12   8 204],234,2,17593,3.773702273702274,20.0,0.0
34662,3,4662,[603 302 427 127  64],13,5,17598,3.773965258417328,20.0,20.0
34663,3,4663,[ 88 197 111  89 300],653,2,17600,3.7735849056603774,0.0,0.0
34664,3,4664,[121 186 427 313 234],308,2,17602,3.7732047159699893,0.0,0.0
34665,3,4665,[603 302 427 127  64],664,5,17607,3.7734676382340333,20.0,20.0
34666,3,4666,[546 196  50 328 210],378,3,17610,3.7733019070066423,0.0,20.0
34667,3,4667,[117 196 237 318 508],334,3,17613,3.7731362467866325,20.0,0.0
34668,3,4668,[216  89 173 234 265],648,5,17618,3.773399014778325,0.0,0.0
34669,3,4669,[  8 288 269  95  11],64,5,17623,3.773661670235546,0.0,0.0
34670,3,4670,[ 82 172 100   9 121],115,4,17627,3.773710126311282,0.0,20.0
34671,3,4671,[475 196 235 194 100],339,4,17631,3.773758561643836,0.0,20.0
34672,3,4672,[603 302 427 127  64],669,5,17636,3.774020971538626,20.0,20.0
34673,3,4673,[603 302 427 127  64],474,5,17641,3.774283269148481,20.0,20.0
34674,3,4674,[216 483 132 222 357],881,4,17645,3.774331550802139,40.0,0.0
34675,3,4675,[173 185 161 153 237],454,2,17647,3.7739520958083834,0.0,0.0
34676,3,4676,[183 168 328 191  50],92,4,17651,3.7740004276245456,0.0,20.0
34677,3,4677,[483 185 161 742 318],328,5,17656,3.774262505344164,40.0,0.0
34678,3,4678,[180 197 183 258 186],650,3,17659,3.7740970292797607,0.0,0.0
34679,3,4679,[182  95  69 186   9],881,1,17660,3.7735042735042734,0.0,0.0
34680,3,4680,[ 50 258 403 427 238],843,1,17661,3.7729117709891047,0.0,20.0
34681,3,4681,[603 302 427 127  64],90,5,17666,3.7731738573259292,20.0,20.0
34682,3,4682,[ 12 200 191 204  64],833,3,17669,3.7730087550715354,20.0,0.0
34683,3,4683,[603 302 427 127  64],271,5,17674,3.7732707087959008,20.0,20.0
34684,3,4684,[603 302 427 127  64],90,5,17679,3.7735325506937034,20.0,20.0
34685,3,4685,[603 302 427 127  64],537,4,17683,3.773580879214682,20.0,20.0
34686,3,4686,[423 176 161  97  22],378,5,17688,3.7738425432046085,0.0,0.0
34687,3,4687,[ 88 181 235 173 275],537,2,17690,3.7734641638225255,0.0,0.0
34688,3,4688,[603 302 427 127  64],458,5,17695,3.7737257410961824,20.0,20.0
34689,3,4689,[ 15 286  71  22 405],488,2,17697,3.7733475479744136,0.0,0.0
34690,3,4690,[228 265   7  11  25],59,5,17702,3.7736090385845236,0.0,0.0
34691,3,4691,[180 269 268 100 173],6,4,17706,3.7736572890025575,0.0,20.0
34692,3,4692,[174  89  95 111 403],479,4,17710,3.7737055188578736,0.0,20.0
34693,3,4693,[197 161 168  15 471],533,5,17715,3.773966766084363,0.0,0.0
34694,3,4694,[603 302 427 127  64],537,4,17719,3.774014909478168,20.0,20.0
34695,3,4695,[603 302 427 127  64],666,5,17724,3.77427597955707,20.0,20.0
34696,3,4696,[175  95 423 117  96],749,3,17727,3.7741111347668723,0.0,0.0
34697,3,4697,[508 301 222  69  11],378,1,17728,3.7735206470838656,0.0,0.0
34698,3,4698,[237 172 194  97  50],194,1,17729,3.7729304107256865,0.0,20.0
34699,3,4699,[181 161 180 475  28],387,3,17732,3.7727659574468086,0.0,0.0
34700,3,4700,[191 269 405  64 181],271,4,17736,3.772814294830887,0.0,0.0
34701,3,4701,[228 385 151   7 168],892,3,17739,3.7726499361973627,0.0,0.0
34702,3,4702,[238 180  15 568 515],892,5,17744,3.7729109079311076,0.0,0.0
34703,3,4703,[ 25 121 181 200 197],804,4,17748,3.7729591836734695,0.0,0.0
34704,3,4704,[318 483 135  28 174],815,4,17752,3.7730074388947927,40.0,20.0
34705,3,4705,[204 216   7 144  22],653,2,17754,3.7726306842328943,0.0,0.0
34706,3,4706,[603 302 427 127  64],666,5,17759,3.772891438283408,20.0,20.0
34707,3,4707,[100  12   7 121 185],194,3,17762,3.772727272727273,20.0,20.0
34708,3,4708,[748  89 238 204 195],524,2,17764,3.772350817583351,0.0,0.0
34709,3,4709,[302 435 179  25 265],666,3,17767,3.772186836518047,0.0,0.0
34710,3,4710,[135 216 127 182  11],7,4,17771,3.772235194226279,0.0,20.0
34711,3,4711,[603 302 427 127  64],339,5,17776,3.7724957555178267,20.0,20.0
34712,3,4712,[588 204 403  79 180],311,5,17781,3.772756206238065,0.0,0.0
34713,3,4713,[179 117  28  11 423],474,5,17786,3.773016546457361,0.0,0.0
34714,3,4714,[603 302 427 127  64],90,5,17791,3.7732767762460235,20.0,20.0
34715,3,4715,[153 273 318 151 286],7,4,17795,3.7733248515691264,20.0,0.0
34716,3,4716,[655  95 294 515 182],406,2,17797,3.7729489082043672,0.0,0.0
34717,3,4717,[742  71 435 568  64],328,4,17801,3.7729970326409497,0.0,0.0
34718,3,4718,[603 302 427 127  64],90,5,17806,3.7732570459843187,20.0,20.0
34719,3,4719,[475 143  50 568  82],537,2,17808,3.772881355932203,0.0,20.0
34720,3,4720,[282   1 238  98 173],95,5,17813,3.7731412836263503,0.0,20.0
34721,3,4721,[ 64 302 328  71  96],788,3,17816,3.7729775518847948,0.0,0.0
34722,3,4722,[ 22   4  96 245 161],346,4,17820,3.773025619309761,0.0,0.0
34723,3,4723,[603 302 427 127  64],474,5,17825,3.773285351397121,20.0,20.0
34724,3,4724,[200 195 211 357 135],59,5,17830,3.7735449735449738,20.0,0.0
34725,3,4725,[135  50 196 153 403],64,4,17834,3.7735928903935676,0.0,20.0
34726,3,4726,[597  71 210 175 211],7,4,17838,3.773640786968479,0.0,0.0
34727,3,4727,[471 172  96 194 222],13,3,17841,3.7734771573604062,0.0,0.0
34728,3,4728,[118  22   4 121 161],804,5,17846,3.7737365193486996,0.0,0.0
34729,3,4729,[603 302 427 127  64],537,4,17850,3.773784355179704,20.0,20.0
34730,3,4730,[603 302 427 127  64],664,5,17855,3.7740435425914183,20.0,20.0
34731,3,4731,[172  50  15 385 135],308,4,17859,3.7740912933220625,0.0,20.0
34732,3,4732,[603 302 427 127  64],664,5,17864,3.7743503063596027,20.0,20.0
34733,3,4733,[127 288 318 237 211],452,2,17866,3.7739754964089567,20.0,20.0
34734,3,4734,[ 22 282 161  98  12],378,5,17871,3.774234424498416,20.0,20.0
34735,3,4735,[603 302 427 127  64],669,5,17876,3.7744932432432434,20.0,20.0
34736,3,4736,[ 95 475  22 546 385],92,2,17878,3.7741186404897613,0.0,0.0
34737,3,4737,[603 302 427 127  64],458,5,17883,3.7743773744195863,20.0,20.0
34738,3,4738,[185 471 357 275 194],13,1,17884,3.773791939227685,20.0,0.0
34739,3,4739,[  7 748 238 168 186],881,1,17885,3.773206751054852,0.0,0.0
34740,3,4740,[405 597 483  50 238],7,3,17888,3.7730436616747522,20.0,20.0
34741,3,4741,[151 168 508   7 423],560,2,17890,3.7726697595951078,0.0,0.0
34742,3,4742,[273 168 603  28 748],883,4,17894,3.772717689226228,20.0,0.0
34743,3,4743,[403 271 508 265 597],13,1,17895,3.7721332209106238,0.0,0.0
34744,3,4744,[742 179  97 135 175],378,3,17898,3.7719704952581665,0.0,0.0
34745,3,4745,[603 302 427 127  64],339,5,17903,3.772229245680573,20.0,20.0
34746,3,4746,[153 186 235 143  70],13,2,17905,3.7718559089951547,0.0,0.0
34747,3,4747,[168 175 135 228  22],766,2,17907,3.7714827295703452,0.0,0.0
34748,3,4748,[603 302 427 127  64],458,5,17912,3.771741419246157,20.0,20.0
34749,3,4749,[603 302 427 127  64],339,5,17917,3.772,20.0,20.0
34750,3,4750,[127  70 235  95 333],334,2,17919,3.7716270258892863,0.0,20.0
34751,3,4751,[273 176 202 174 385],7,2,17921,3.771254208754209,0.0,20.0
34752,3,4752,[245 100 153   8 515],207,2,17923,3.770881548495687,0.0,20.0
34753,3,4753,[603 302 427 127  64],664,5,17928,3.771140092553639,20.0,20.0
34754,3,4754,[515 135 483 588 132],308,2,17930,3.7707676130389065,20.0,0.0
34755,3,4755,[475  79 603 185 197],213,5,17935,3.771026072329689,20.0,0.0
34756,3,4756,[186 435 313 427 144],328,4,17939,3.7710742064326257,0.0,0.0
34757,3,4757,[603 302 427 127  64],474,5,17944,3.771332492643968,20.0,20.0
34758,3,4758,[471  22 176 111 211],13,3,17947,3.771170413952511,0.0,0.0
34759,3,4759,[603 302 427 127  64],537,4,17951,3.771218487394958,20.0,20.0
34760,3,4760,[603 302 427 127  64],458,5,17956,3.7714765805503045,20.0,20.0
34761,3,4761,[269   4  71  79 328],378,3,17959,3.771314573708526,0.0,0.0
34762,3,4762,[403  11 215  22 302],13,3,17962,3.7711526348939746,0.0,0.0
34763,3,4763,[ 88 328 323  64 265],378,3,17965,3.770990764063812,0.0,0.0
34764,3,4764,[135   4 215 318  96],653,3,17968,3.770828961175236,20.0,0.0
34765,3,4765,[176 195 357 151 181],537,1,17969,3.7702475870751155,20.0,0.0
34766,3,4766,[546 288 423 202 183],13,3,17972,3.7700860079714706,0.0,0.0
34767,3,4767,[603 302 427 127  64],664,5,17977,3.7703439597315436,20.0,20.0
34768,3,4768,[603 302 427 127  64],474,5,17982,3.7706018033130637,20.0,20.0
34769,3,4769,[328 276  50 471  56],119,4,17986,3.770649895178197,0.0,20.0
34770,3,4770,[132  98 333 176  56],881,3,17989,3.7704883672186122,0.0,20.0
34771,3,4771,[ 50 117 742  11 143],346,4,17993,3.770536462699078,0.0,20.0
34772,3,4772,[405 333 228 196 471],343,4,17997,3.7705845380263985,0.0,0.0
34773,3,4773,[748 313 597 187 121],328,3,18000,3.7704231252618348,0.0,0.0
34774,3,4774,[ 56  11 191 185 195],833,5,18005,3.770680628272251,0.0,0.0
34775,3,4775,[603 302 427 127  64],271,5,18010,3.7709380234505865,20.0,20.0
34776,3,4776,[211 194 143  98 435],13,4,18014,3.7709859744609586,0.0,20.0
34777,3,4777,[496  96 427 273  97],234,2,18016,3.770615320217664,0.0,0.0
34778,3,4778,[135 215  69  50 234],144,5,18021,3.770872567482737,0.0,20.0
34779,3,4779,[603 302 427 127  64],745,4,18025,3.7709205020920504,20.0,20.0
34780,3,4780,[127 187 121 181 195],158,4,18029,3.7709684166492368,0.0,20.0
34781,3,4781,[202 423  89 234 174],90,4,18033,3.7710163111668757,0.0,20.0
34782,3,4782,[603 302 427 127  64],664,5,18038,3.7712732594605898,20.0,20.0
34783,3,4783,[603 302 427 127  64],474,5,18043,3.771530100334448,20.0,20.0
34784,3,4784,[271 385  64 186  70],13,2,18045,3.7711598746081503,0.0,0.0
34785,3,4785,[328  50  22 153  88],749,5,18050,3.7714166318428752,0.0,20.0
34786,3,4786,[603 302 427 127  64],669,5,18055,3.771673281804888,20.0,20.0
34787,3,4787,[603 302 427 127  64],666,5,18060,3.7719298245614037,20.0,20.0
34788,3,4788,[161 172 196 288  56],346,2,18062,3.7715598245980373,0.0,0.0
34789,3,4789,[202 282 125 173 100],378,3,18065,3.7713987473903967,0.0,20.0
34790,3,4790,[282 515  11  56 182],145,5,18070,3.7716551868085992,0.0,0.0
34791,3,4791,[ 12 111 153 187 210],334,3,18073,3.7714941569282137,20.0,0.0
34792,3,4792,[181 183 135 185 196],659,3,18076,3.771333194241602,0.0,0.0
34793,3,4793,[265 238 655  89 185],95,2,18078,3.7709637046307884,0.0,0.0
34794,3,4794,[ 82   7 237 403 742],374,3,18081,3.770802919708029,0.0,0.0
34795,3,4795,[603 302 427 127  64],90,5,18086,3.7710592160133443,20.0,20.0
34796,3,4796,[132 181  96 275  97],474,4,18090,3.7711069418386494,0.0,0.0
34797,3,4797,[234  97  95 357 568],454,2,18092,3.770737807419758,20.0,0.0
34798,3,4798,[144   9   1 197 234],308,2,18094,3.770368826838925,0.0,0.0
34799,3,4799,[603 302 427 127  64],339,5,18099,3.770625,20.0,20.0
34800,3,4800,[196 197  70 183  96],934,4,18103,3.770672776504895,0.0,0.0
34801,3,4801,[603 302 427 127  64],745,4,18107,3.7707205331112035,20.0,20.0
34802,3,4802,[100  50 588 181  98],308,4,18111,3.7707682698313554,0.0,60.0
34803,3,4803,[427  70 405 508 269],537,3,18114,3.770607826810991,0.0,0.0
34804,3,4804,[118 211 132 435 121],454,2,18116,3.770239334027055,0.0,0.0
34805,3,4805,[269 235  70 210 313],378,5,18121,3.770495214315439,0.0,0.0
34806,3,4806,[173   9  22 258  25],271,3,18124,3.770334928229665,0.0,0.0
34807,3,4807,[125  28 200 172 173],59,4,18128,3.7703826955074877,0.0,0.0
34808,3,4808,[603 302 427 127  64],13,5,18133,3.7706383863589106,20.0,20.0
34809,3,4809,[ 95 186  12  15 427],537,2,18135,3.77027027027027,20.0,0.0
34810,3,4810,[174 135 202  56 403],87,4,18139,3.7703180212014136,0.0,20.0
34811,3,4811,[603 302 427 127  64],339,5,18144,3.770573566084788,20.0,20.0
34812,3,4812,[748 200 202 211  88],479,4,18148,3.77062123415749,0.0,0.0
34813,3,4813,[603 302 427 127  64],339,5,18153,3.7708766098878272,20.0,20.0
34814,3,4814,[257  56 211   1 191],533,4,18157,3.7709241952232606,0.0,0.0
34815,3,4815,[323 180  70 333 357],13,1,18158,3.770348837209302,20.0,0.0
34816,3,4816,[  1 117 210 215 121],650,1,18159,3.769773718081794,0.0,0.0
34817,3,4817,[597 186  11   7 127],643,4,18163,3.769821502698215,0.0,20.0
34818,3,4818,[144 197 475 237 328],207,2,18165,3.769454243619008,0.0,0.0
34819,3,4819,[121  12  98 289 273],374,3,18168,3.7692946058091286,20.0,20.0
34820,3,4820,[204  12 234  69 475],458,4,18172,3.7693424600705248,20.0,0.0
34821,3,4821,[427  71 405 216  95],406,2,18174,3.7689755288262132,0.0,0.0
34822,3,4822,[ 98 172 211  89  50],13,5,18179,3.769230769230769,0.0,40.0
34823,3,4823,[234  70 603 655   4],64,3,18182,3.7690713101160864,20.0,0.0
34824,3,4824,[183 176 245 546  22],346,5,18187,3.7693264248704663,0.0,0.0
34825,3,4825,[ 89 161 318 228  79],648,3,18190,3.7691670120182343,20.0,0.0
34826,3,4826,[ 56 228  96 181 132],804,4,18194,3.7692148332297495,0.0,0.0
34827,3,4827,[603 302 427 127  64],664,5,18199,3.76946975973488,20.0,20.0
34828,3,4828,[603 302 427 127  64],458,5,18204,3.7697245806585213,20.0,20.0
34829,3,4829,[ 88  50   4 257 318],883,5,18209,3.7699792960662526,20.0,20.0
34830,3,4830,[275 195 144 597 151],378,2,18211,3.769612916580418,0.0,0.0
34831,3,4831,[603 302 427 127  64],271,5,18216,3.769867549668874,20.0,20.0
34832,3,4832,[ 22 179 742 185 187],207,4,18220,3.7699151665632114,0.0,0.0
34833,3,4833,[161  96  11 313 187],653,4,18224,3.7699627637567232,0.0,0.0
34834,3,4834,[273 194 127 187 235],13,3,18227,3.7698035160289556,0.0,20.0
34835,3,4835,[216 202 121 588 237],82,4,18231,3.7698511166253104,0.0,0.0
34836,3,4836,[  1 288 403 238 183],643,3,18234,3.7696919578250982,0.0,0.0
34837,3,4837,[603 302 427 127  64],271,5,18239,3.7699462587846218,20.0,20.0
34838,3,4838,[603  70  89 302 174],271,4,18243,3.7699938003719775,20.0,20.0
34839,3,4839,[603 302 427 127  64],666,5,18248,3.7702479338842974,20.0,20.0
34840,3,4840,[180 153 172 121 427],650,3,18251,3.770088824623012,0.0,0.0
34841,3,4841,[215 127 210 588  82],897,5,18256,3.7703428335398597,0.0,20.0
34842,3,4842,[603 302 427 127  64],537,4,18260,3.770390253974809,20.0,20.0
34843,3,4843,[603 302 427 127  64],474,5,18265,3.7706440957886045,20.0,20.0
34844,3,4844,[216 111  69 748 228],648,3,18268,3.770485036119711,0.0,0.0
34845,3,4845,[  9 202 100 111  11],13,3,18271,3.7703260420965745,0.0,20.0
34846,3,4846,[265 496  98 135 183],882,5,18276,3.770579740045389,0.0,20.0
34847,3,4847,[265  89 191 496 161],95,2,18278,3.770214521452145,0.0,0.0
34848,3,4848,[357 197 191 322 655],13,2,18280,3.769849453495566,20.0,0.0
34849,3,4849,[603 302 427 127  64],458,5,18285,3.770103092783505,20.0,20.0
34850,3,4850,[603 302 427 127  64],745,4,18289,3.770150484436199,20.0,20.0
34851,3,4851,[181 211 175  98 111],14,3,18292,3.7699917559769167,0.0,20.0
34852,3,4852,[603 302 427 127  64],664,5,18297,3.77024520914898,20.0,20.0
34853,3,4853,[151 483 117 144 197],899,3,18300,3.7700865265760197,20.0,0.0
34854,3,4854,[603 302 427 127  64],474,5,18305,3.7703398558187438,20.0,20.0
34855,3,4855,[603 302 427 127  64],13,5,18310,3.7705930807248764,20.0,20.0
34856,3,4856,[185 161 403  98 273],7,3,18313,3.7704344245418984,0.0,20.0
34857,3,4857,[269 121 568 678 471],13,1,18314,3.7698641416220666,0.0,0.0
34858,3,4858,[318 210  28 238 403],334,3,18317,3.7697057007614734,20.0,0.0
34859,3,4859,[603 302 427 127  64],13,5,18322,3.7699588477366257,20.0,20.0
34860,3,4860,[603 302 427 127  64],537,4,18326,3.770006171569636,20.0,20.0
34861,3,4861,[603 302 427 127  64],13,5,18331,3.770259152612094,20.0,20.0
34862,3,4862,[  4  70  89 508 258],59,3,18334,3.7701007608472135,0.0,0.0
34863,3,4863,[603 302 427 127  64],13,5,18339,3.7703536184210527,20.0,20.0
34864,3,4864,[603 302 427 127  64],458,5,18344,3.7706063720452208,20.0,20.0
34865,3,4865,[357  56 483   4  28],537,3,18347,3.770448006576243,40.0,0.0
34866,3,4866,[742 204  25 237  89],447,4,18351,3.7704951715635917,0.0,0.0
34867,3,4867,[ 98  25 235  97 174],343,4,18355,3.770542317173377,0.0,40.0
34868,3,4868,[118 234  98 313   4],59,5,18360,3.770794824399261,0.0,20.0
34869,3,4869,[603 302 427 127  64],537,4,18364,3.770841889117043,20.0,20.0
34870,3,4870,[603 302 427 127  64],474,5,18369,3.771094231164032,20.0,20.0
34871,3,4871,[603 302 427 127  64],339,5,18374,3.7713464696223316,20.0,20.0
34872,3,4872,[603 302 427 127  64],13,5,18379,3.7715986045557153,20.0,20.0
34873,3,4873,[ 98  89 135 273 328],144,3,18382,3.7714402954452195,0.0,20.0
34874,3,4874,[603 302 427 127  64],458,5,18387,3.771692307692308,20.0,20.0
34875,3,4875,[215 182  70 194 496],90,3,18390,3.7715340442986056,0.0,0.0
34876,3,4876,[200 678 268 257 111],145,3,18393,3.7713758458068485,0.0,0.0
34877,3,4877,[269 546 174 100 181],524,4,18397,3.771422714227142,0.0,40.0
34878,3,4878,[216  25  69 357   4],308,3,18400,3.7712646034023365,20.0,0.0
34879,3,4879,[603 302 427 127  64],339,5,18405,3.771516393442623,20.0,20.0
34880,3,4880,[603 302 427 127  64],339,5,18410,3.7717680803114115,20.0,20.0
34881,3,4881,[151  22 118   1 180],290,3,18413,3.7716099959033182,0.0,0.0
34882,3,4882,[603 302 427 127  64],666,5,18418,3.771861560516076,20.0,20.0
34883,3,4883,[603 302 427 127  64],13,5,18423,3.772113022113022,20.0,20.0
34884,3,4884,[ 28  11 210 265  12],234,1,18424,3.7715455475946777,20.0,0.0
34885,3,4885,[  7   4 195 180 222],13,2,18426,3.7711829717560374,0.0,0.0
34886,3,4886,[ 96 215 678 276 143],474,4,18430,3.771229793329241,0.0,0.0
34887,3,4887,[603 302 427 127  64],664,5,18435,3.771481178396072,20.0,20.0
34888,3,4888,[173  64 257 191 211],271,5,18440,3.771732460625895,0.0,0.0
34889,3,4889,[288 174 191 357 211],14,4,18444,3.7717791411042945,20.0,20.0
34890,3,4890,[603 302 427 127  64],537,4,18448,3.7718258024943774,20.0,20.0
34891,3,4891,[603 302 427 127  64],537,4,18452,3.7718724448078493,20.0,20.0
34892,3,4892,[603 302 427 127  64],458,5,18457,3.7721234416513387,20.0,20.0
34893,3,4893,[603 302 427 127  64],666,5,18462,3.7723743359215365,20.0,20.0
34894,3,4894,[ 25 268 202 275 216],90,4,18466,3.772420837589377,0.0,0.0
34895,3,4895,[172 187 100 185  50],833,3,18469,3.772263071895425,0.0,40.0
34896,3,4896,[318 135  12 603 258],90,4,18473,3.7723095772922197,60.0,0.0
34897,3,4897,[100 168  50 132 121],13,5,18478,3.7725602286647613,0.0,40.0
34898,3,4898,[117 742  15 127 202],749,5,18483,3.772810777709737,0.0,20.0
34899,3,4899,[603 302 427 127  64],537,4,18487,3.7728571428571427,20.0,20.0
34900,3,4900,[ 56 289 179  88 245],92,3,18490,3.772699449092022,0.0,0.0
34901,3,4901,[603 302 427 127  64],90,5,18495,3.7729498164014688,20.0,20.0
34902,3,4902,[603 302 427 127  64],458,5,18500,3.7732000815827043,20.0,20.0
34903,3,4903,[603 302 427 127  64],339,5,18505,3.7734502446982057,20.0,20.0
34904,3,4904,[161  50 568 222  11],897,4,18509,3.7734964322120286,0.0,20.0
34905,3,4905,[179 132 200 111 258],474,4,18513,3.773542600896861,0.0,0.0
34906,3,4906,[597 427 275 508  70],533,4,18517,3.7735887507642145,0.0,0.0
34907,3,4907,[603 302 427 127  64],474,5,18522,3.773838630806846,20.0,20.0
34908,3,4908,[176 168  11 144  64],308,4,18526,3.7738847015685475,0.0,0.0
34909,3,4909,[197 318 196 179 357],90,5,18531,3.7741344195519346,40.0,0.0
34910,3,4910,[202 182 318 111 655],207,2,18533,3.7737731622887396,20.0,0.0
34911,3,4911,[  4 200 269 273 275],13,1,18534,3.7732084690553744,0.0,0.0
34912,3,4912,[276 678 211 405 300],699,0,18534,3.7724404640749034,0.0,0.0
34913,3,4913,[ 11  95 182 118 655],184,2,18536,3.7720797720797723,0.0,0.0
34914,3,4914,[603 302 427 127  64],664,5,18541,3.772329603255341,20.0,20.0
34915,3,4915,[ 22 181 179  98   7],339,5,18546,3.7725793327908868,0.0,20.0
34916,3,4916,[603 302 427 127  64],90,5,18551,3.772828960748424,20.0,20.0
34917,3,4917,[ 11 179  69 234 318],343,4,18555,3.7728751525010167,20.0,0.0
34918,3,4918,[603 302 427 127  64],745,4,18559,3.772921325472657,20.0,20.0
34919,3,4919,[603 302 427 127  64],271,5,18564,3.773170731707317,20.0,20.0
34920,3,4920,[ 22 144 191 222  25],279,2,18566,3.7728104043893516,0.0,0.0
34921,3,4921,[197 275 172 435   9],883,5,18571,3.773059731816335,0.0,0.0
34922,3,4922,[603 302 427 127  64],664,5,18576,3.773308957952468,20.0,20.0
34923,3,4923,[603 302 427 127  64],664,5,18581,3.7735580828594637,20.0,20.0
34924,3,4924,[228 117   7 121 185],145,4,18585,3.7736040609137054,0.0,0.0
34925,3,4925,[187 427 191 483  82],313,4,18589,3.7736500203004466,20.0,0.0
34926,3,4926,[603 302 427 127  64],13,5,18594,3.7738989242947025,20.0,20.0
34927,3,4927,[603 302 427 127  64],745,4,18598,3.7739448051948052,20.0,20.0
34928,3,4928,[748 546 385 423 183],749,2,18600,3.7735849056603774,0.0,0.0
34929,3,4929,[435  97 183  89 483],537,2,18602,3.7732251521298172,20.0,0.0
34930,3,4930,[143 117 191 515   4],308,3,18605,3.7730683431352667,0.0,0.0
34931,3,4931,[286  70  56  69 121],533,4,18609,3.7731143552311437,0.0,0.0
34932,3,4932,[ 28 568 121 135 117],290,3,18612,3.7729576322724507,0.0,0.0
34933,3,4933,[603 302 427 127  64],745,4,18616,3.7730036481556546,20.0,20.0
34934,3,4934,[100   4 135  97 173],59,5,18621,3.7732522796352583,0.0,20.0
34935,3,4935,[135 328  71 228 202],533,4,18625,3.7732982171799025,0.0,0.0
34936,3,4936,[288 183 265 161 174],374,5,18630,3.77354668827223,0.0,20.0
34937,3,4937,[183 269  70 196 288],537,1,18631,3.7729850141757795,0.0,0.0
34938,3,4938,[603 183 185  28 194],648,5,18636,3.77323344806641,20.0,0.0
34939,3,4939,[515 423 161 405  11],92,2,18638,3.7728744939271257,0.0,0.0
34940,3,4940,[238 200 175 282  64],653,2,18640,3.772515685083991,0.0,0.0
34941,3,4941,[603 302 427 127  64],474,5,18645,3.772764063132335,20.0,20.0
34942,3,4942,[168 238 211  64 385],308,5,18650,3.7730123406837954,0.0,0.0
34943,3,4943,[265 475 238 181 215],474,5,18655,3.773260517799353,0.0,0.0
34944,3,4944,[ 71 265 118  69 515],524,4,18659,3.7733063700707787,0.0,0.0
34945,3,4945,[ 97   8  56 234 655],328,3,18662,3.7731500202183583,0.0,0.0
34946,3,4946,[181 748 286  50  71],479,2,18664,3.7727915908631493,0.0,20.0
34947,3,4947,[471  11 265 181  79],666,2,18666,3.772433306386419,0.0,0.0
34948,3,4948,[ 96 181  64 175  28],738,5,18671,3.77268134976763,0.0,0.0
34949,3,4949,[385 238 228 655 216],92,4,18675,3.772727272727273,0.0,0.0
34950,3,4950,[603 302 427 127  64],90,5,18680,3.7729751565340335,20.0,20.0
34951,3,4951,[603 302 427 127  64],666,5,18685,3.773222940226171,20.0,20.0
34952,3,4952,[ 79 403   7 175 568],339,3,18688,3.7730668281849384,0.0,0.0
34953,3,4953,[ 71 168 234 496 121],648,4,18692,3.7731126362535323,0.0,0.0
34954,3,4954,[235 268 172 143 185],643,5,18697,3.7733602421796166,0.0,0.0
34955,3,4955,[ 88 187 313 179  96],207,3,18700,3.7732041969330106,0.0,0.0
34956,3,4956,[294  22 183   8  71],378,4,18704,3.77324994956627,0.0,0.0
34957,3,4957,[603 302 427 127  64],13,5,18709,3.77349737797499,20.0,20.0
34958,3,4958,[655 172 234   8 216],840,4,18713,3.773543053034886,0.0,0.0
34959,3,4959,[  1 191 153 180 176],650,3,18716,3.7733870967741936,0.0,0.0
34960,3,4960,[132 125  12  15  88],406,3,18719,3.773231203386414,20.0,0.0
34961,3,4961,[603 302 427 127  64],271,5,18724,3.7734784361144698,20.0,20.0
34962,3,4962,[357 187 318  71 385],694,5,18729,3.77372556921217,40.0,0.0
34963,3,4963,[ 82 216  12 100 427],234,2,18731,3.773368251410153,20.0,20.0
34964,3,4964,[603 302 427 127  64],458,5,18736,3.7736153071500502,20.0,20.0
34965,3,4965,[100  50 403  89 111],479,3,18739,3.7734595247684255,0.0,40.0
34966,3,4966,[111  98 546 151 483],899,3,18742,3.7733038051137506,20.0,20.0
34967,3,4967,[210 235 175 234 144],804,5,18747,3.773550724637681,0.0,0.0
34968,3,4968,[174 222 118   9 435],788,1,18748,3.7729925538337694,0.0,20.0
34969,3,4969,[194 655 245 202 186],804,5,18753,3.7732394366197184,0.0,0.0
34970,3,4970,[603 302 427 127  64],664,5,18758,3.7734862200764434,20.0,20.0
34971,3,4971,[191  79  69 435 168],881,2,18760,3.773129525341915,0.0,0.0
34972,3,4972,[286 322 318 302 176],13,1,18761,3.7725718881962598,20.0,0.0
34973,3,4973,[742 238 318 179 300],653,3,18764,3.7724165661439484,20.0,0.0
34974,3,4974,[603 302 427 127  64],13,5,18769,3.7726633165829146,20.0,20.0
34975,3,4975,[515 118 204 144 294],102,1,18770,3.772106109324759,0.0,0.0
34976,3,4976,[204 211 121  97 172],890,3,18773,3.77195097448262,0.0,0.0
34977,3,4977,[196 496 423 179 191],234,3,18776,3.771795901968662,0.0,0.0
34978,3,4978,[258  82 100 179 210],653,4,18780,3.7718417352882105,0.0,20.0
34979,3,4979,[269 185  70 228   7],524,3,18783,3.771686746987952,0.0,0.0
34980,3,4980,[186 294 328 245  88],579,2,18785,3.7713310580204777,0.0,0.0
34981,3,4981,[475 121 174 322 194],13,3,18788,3.7711762344439985,0.0,20.0
34982,3,4982,[ 96 228  79 195 318],653,5,18793,3.7714228376480032,20.0,0.0
34983,3,4983,[  7 117  96  11 237],145,5,18798,3.771669341894061,0.0,0.0
34984,3,4984,[234  71 127 257 196],881,3,18801,3.7715145436308926,0.0,20.0
34985,3,4985,[603 357 175 117 385],234,2,18803,3.7711592458884877,40.0,0.0
34986,3,4986,[202 194  97  69 196],295,5,18808,3.771405654702226,0.0,0.0
34987,3,4987,[405 185 294 435 182],7,3,18811,3.7712510024057737,0.0,0.0
34988,3,4988,[197 275 546 300 276],271,2,18813,3.7708959711365004,0.0,0.0
34989,3,4989,[ 69 405 357 191 168],82,4,18817,3.7709418837675353,20.0,0.0
34990,3,4990,[ 70 121 655  98 183],207,2,18819,3.770587056702064,0.0,20.0
34991,3,4991,[405 173 172 288  82],7,3,18822,3.7704326923076925,0.0,0.0
34992,3,4992,[603 302 427 127  64],339,5,18827,3.770678950530743,20.0,20.0
34993,3,4993,[172 143  95  12 435],454,1,18828,3.7701241489787747,20.0,0.0
34994,3,4994,[323  56 121 273  22],59,4,18832,3.77017017017017,0.0,0.0
34995,3,4995,[202 173 276 195 111],378,2,18834,3.7698158526821457,0.0,0.0
34996,3,4996,[405   8 183   7 238],82,1,18835,3.7692615569341603,0.0,0.0
34997,3,4997,[603 302 427 127  64],666,5,18840,3.7695078031212486,20.0,20.0
34998,3,4998,[195 483 234 172 175],932,4,18844,3.7695539107821565,20.0,0.0
34999,3,4999,[228  82 403 197 186],194,2,18846,3.7692,0.0,0.0
35000,3,5000,[132 471  25  96 515],308,2,18848,3.7688462307538493,0.0,0.0
35001,3,5001,[603 302 427 127  64],664,5,18853,3.769092363054778,20.0,20.0
35002,3,5002,[603 302 427 127  64],669,5,18858,3.769338396961823,20.0,20.0
35003,3,5003,[603 302 427 127  64],664,5,18863,3.769584332533973,20.0,20.0
35004,3,5004,[182 742 143 568 273],897,3,18866,3.7694305694305696,0.0,0.0
35005,3,5005,[238 118 176 194 508],643,3,18869,3.7692768677586894,0.0,0.0
35006,3,5006,[603 302 427 127  64],90,5,18874,3.76952266826443,20.0,20.0
35007,3,5007,[302 182 180 183 357],6,5,18879,3.7697683706070286,20.0,0.0
35008,3,5008,[603 302 427 127  64],669,5,18884,3.7700139748452783,20.0,20.0
35009,3,5009,[568 496  96 202   9],378,3,18887,3.769860279441118,0.0,0.0
35010,3,5010,[ 56 238 258  12 300],271,2,18889,3.7695070844142884,20.0,0.0
35011,3,5011,[  9 117 179  97 742],458,4,18893,3.7695530726256985,0.0,0.0
35012,3,5012,[603 302 427 127  64],13,5,18898,3.769798523838021,20.0,20.0
35013,3,5013,[603 302 427 127  64],474,5,18903,3.770043877143997,20.0,20.0
35014,3,5014,[603 302 427 127  64],745,4,18907,3.770089730807577,20.0,20.0
35015,3,5015,[286 210  82 172 568],648,4,18911,3.770135566188198,0.0,0.0
35016,3,5016,[603 302 427 127  64],13,5,18916,3.7703807056009566,20.0,20.0
35017,3,5017,[265   7  50 194 196],378,5,18921,3.770625747309685,0.0,20.0
35018,3,5018,[100 118 423 174 318],554,4,18925,3.7706714484957162,20.0,40.0
35019,3,5019,[475 385 435  98 211],64,5,18930,3.770916334661355,0.0,20.0
35020,3,5020,[ 11 151 268 265 273],234,0,18930,3.770165305715993,0.0,0.0
35021,3,5021,[603 302 427 127  64],271,5,18935,3.7704101951413778,20.0,20.0
35022,3,5022,[603 302 427 127  64],90,5,18940,3.770654987059526,20.0,20.0
35023,3,5023,[200   4 318 483 127],474,4,18944,3.770700636942675,40.0,20.0
35024,3,5024,[ 79 496 153   7 195],339,4,18948,3.7707462686567164,0.0,0.0
35025,3,5025,[216 182  71 357 132],843,0,18948,3.7699960206923997,20.0,0.0
35026,3,5026,[ 12 302 216 275 183],474,4,18952,3.770041774418142,20.0,0.0
35027,3,5027,[403 185   9 173 427],379,5,18957,3.770286396181384,0.0,0.0
35028,3,5028,[603 302 427 127  64],537,4,18961,3.7703320739709683,20.0,20.0
35029,3,5029,[276   4 216 322  12],13,3,18964,3.770178926441352,20.0,0.0
35030,3,5030,[180 288   9  98 215],378,3,18967,3.7700258397932815,0.0,20.0
35031,3,5031,[275 496  11 276   9],308,4,18971,3.7700715421303657,0.0,0.0
35032,3,5032,[216 172 185 176 289],13,1,18972,3.7695211603417444,0.0,0.0
35033,3,5033,[181 175 328 313 483],537,3,18975,3.769368295589988,20.0,0.0
35034,3,5034,[318 222 228 172 135],883,4,18979,3.7694141012909634,20.0,0.0
35035,3,5035,[603 302 427 127  64],458,5,18984,3.7696584590945195,20.0,20.0
35036,3,5036,[603 302 427 127  64],13,5,18989,3.7699027198729405,20.0,20.0
35037,3,5037,[603 302 427 127  64],474,5,18994,3.7701468836840015,20.0,20.0
35038,3,5038,[286 168 318  22 210],59,4,18998,3.7701924985116095,20.0,0.0
35039,3,5039,[405 257 403 328 603],533,3,19001,3.7700396825396827,20.0,0.0
35040,3,5040,[496  28  15 235 385],290,4,19005,3.770085300535608,0.0,0.0
35041,3,5041,[257  79 186  97 655],840,3,19008,3.7699325664418883,0.0,0.0
35042,3,5042,[210 179 403  69  70],234,1,19009,3.7693833035891333,0.0,0.0
35043,3,5043,[135 742 161 118 204],92,2,19011,3.7690325138778746,0.0,0.0
35044,3,5044,[603 302 427 127  64],339,5,19016,3.769276511397423,20.0,20.0
35045,3,5045,[603 302 427 127  64],13,5,19021,3.7695204122076893,20.0,20.0
35046,3,5046,[655 385 276 235 100],343,4,19025,3.7695660788587277,0.0,20.0
35047,3,5047,[  1 195 323 182 143],454,2,19027,3.769215530903328,0.0,0.0
35048,3,5048,[603 302 427 127  64],669,5,19032,3.769459298871064,20.0,20.0
35049,3,5049,[603 302 427 127  64],666,5,19037,3.7697029702970295,20.0,20.0
35050,3,5050,[180  15 238   8 276],234,1,19038,3.769154622846961,0.0,0.0
35051,3,5051,[  4 678 187 100 215],7,4,19042,3.769200316706255,0.0,20.0
35052,3,5052,[300 144 435 318 385],64,3,19045,3.7690480902434196,20.0,0.0
35053,3,5053,[603 302 427 127  64],458,5,19050,3.7692916501780767,20.0,20.0
35054,3,5054,[ 82  50 202  69  88],200,5,19055,3.7695351137487636,0.0,20.0
35055,3,5055,[ 96 269 161  28 100],455,5,19060,3.7697784810126582,0.0,20.0
35056,3,5056,[ 69 168  97 180 289],13,4,19064,3.7698240063278625,0.0,0.0
35057,3,5057,[  1 172  88 216  71],650,2,19066,3.7694741004349543,0.0,0.0
35058,3,5058,[173  98 176 135 132],60,5,19071,3.7697173354417868,0.0,20.0
35059,3,5059,[180 153 182  15 175],406,4,19075,3.7697628458498023,0.0,0.0
35060,3,5060,[235 151 515  71 257],650,1,19076,3.7692155700454455,0.0,0.0
35061,3,5061,[603 302 427 127  64],537,4,19080,3.769261161596207,20.0,20.0
35062,3,5062,[ 69   8  28  50 186],13,5,19085,3.7695042464941735,0.0,20.0
35063,3,5063,[568 288 117  69 143],378,2,19087,3.7691548183254344,0.0,0.0
35064,3,5064,[471  79 568 597 151],378,2,19089,3.7688055281342545,0.0,0.0
35065,3,5065,[742 483 127 234 235],524,3,19092,3.7686537702329255,20.0,20.0
35066,3,5066,[603 302 427 127  64],339,5,19097,3.7688967831063747,20.0,20.0
35067,3,5067,[301 181 268 118 185],13,3,19100,3.7687450670876084,0.0,0.0
35068,3,5068,[603 302 427 127  64],271,5,19105,3.768987966068258,20.0,20.0
35069,3,5069,[603 302 427 127  64],745,4,19109,3.769033530571992,20.0,20.0
35070,3,5070,[ 79   1  56 496 143],537,2,19111,3.768684677578387,0.0,0.0
35071,3,5071,[  4 294 100 603  69],650,2,19113,3.7683359621451102,20.0,20.0
35072,3,5072,[181 237   9 174 288],374,3,19116,3.7681845062093435,0.0,20.0
35073,3,5073,[ 69 197  98 127 237],64,4,19120,3.768230193141506,0.0,40.0
35074,3,5074,[186 151 238  89 265],379,5,19125,3.768472906403941,0.0,0.0
35075,3,5075,[603 302 427 127  64],474,5,19130,3.768715524034673,20.0,20.0
35076,3,5076,[603 302 427 127  64],90,5,19135,3.768958046090211,20.0,20.0
35077,3,5077,[603 302 427 127  64],271,5,19140,3.7692004726270185,20.0,20.0
35078,3,5078,[282 194 196 143  15],311,4,19144,3.7692459145501083,0.0,0.0
35079,3,5079,[603 302 427 127  64],13,5,19149,3.769488188976378,20.0,20.0
35080,3,5080,[496 228  15  70 748],653,2,19151,3.7691399330840385,0.0,0.0
35081,3,5081,[603 302 427 127  64],664,5,19156,3.7693821330184965,20.0,20.0
35082,3,5082,[204  88 174 196  56],83,4,19160,3.7694275034428486,0.0,20.0
35083,3,5083,[222 276 179 294  88],92,3,19163,3.7692761605035403,0.0,0.0
35084,3,5084,[603 302 427 127  64],13,5,19168,3.769518190757129,20.0,20.0
35085,3,5085,[568 191 118  22  56],13,3,19171,3.76936688950059,0.0,0.0
35086,3,5086,[ 82 204 282   7 333],666,1,19172,3.768822488696678,0.0,0.0
35087,3,5087,[603 302 427 127  64],339,5,19177,3.769064465408805,20.0,20.0
35088,3,5088,[603 174   9  50  79],189,3,19180,3.768913342503439,20.0,40.0
35089,3,5089,[603 302 427 127  64],669,5,19185,3.769155206286837,20.0,20.0
35090,3,5090,[238   4 195 211 191],385,1,19186,3.768611274798664,0.0,0.0
35091,3,5091,[603 302 427 127  64],271,5,19191,3.76885310290652,20.0,20.0
35092,3,5092,[515  82 423 288 588],7,3,19194,3.768702140192421,0.0,0.0
35093,3,5093,[  8 210 143 258  71],92,4,19198,3.768747546132705,0.0,0.0
35094,3,5094,[603 302 427 127  64],474,5,19203,3.768989205103042,20.0,20.0
35095,3,5095,[144 174  69 196 357],290,3,19206,3.7688383045525904,20.0,20.0
35096,3,5096,[597   9   7 286 301],486,3,19209,3.768687463213655,0.0,0.0
35097,3,5097,[  7 204 181   8 597],308,4,19213,3.768732836406434,0.0,0.0
35098,3,5098,[603 302 427 127  64],474,5,19218,3.768974308687978,20.0,20.0
35099,3,5099,[301 168 333 183 275],334,4,19222,3.7690196078431373,0.0,0.0
35100,3,5100,[603 302 427 127  64],271,5,19227,3.7692609292295627,20.0,20.0
35101,3,5101,[603 302 427 127  64],669,5,19232,3.769502156017248,20.0,20.0
35102,3,5102,[161 196 496 153 135],326,3,19235,3.7693513619439547,0.0,0.0
35103,3,5103,[186 127  79  70 318],664,4,19239,3.769396551724138,20.0,20.0
35104,3,5104,[181   4  64 483  98],374,2,19241,3.7690499510284035,20.0,20.0
35105,3,5105,[ 25 483 161 234 323],374,3,19244,3.7688993341167256,20.0,0.0
35106,3,5106,[ 88  11 202 181 174],892,4,19248,3.7689445858625414,0.0,20.0
35107,3,5107,[678  79 187 302 282],334,4,19252,3.768989819890368,0.0,0.0
35108,3,5108,[258 301  15 182 234],145,4,19256,3.769035036210609,0.0,0.0
35109,3,5109,[194 234 385 273 222],537,0,19256,3.768297455968689,0.0,0.0
35110,3,5110,[151 568  11 100 475],213,5,19261,3.768538446487967,0.0,20.0
35111,3,5111,[603 302 427 127  64],537,4,19265,3.76858372456964,20.0,20.0
35112,3,5112,[322 195 204 435 655],328,2,19267,3.7682378251515742,0.0,0.0
35113,3,5113,[603 302 427 127  64],745,4,19271,3.7682831443097378,20.0,20.0
35114,3,5114,[257 183  98 144  70],840,2,19273,3.767937438905181,0.0,20.0
35115,3,5115,[603 302 427 127  64],90,5,19278,3.7681782642689603,20.0,20.0
35116,3,5116,[475 210 268 111 172],537,2,19280,3.767832714481141,0.0,0.0
35117,3,5117,[ 79 135  12 302 153],788,3,19283,3.767682688550215,20.0,0.0
35118,3,5118,[603 302 427 127  64],271,5,19288,3.7679234225434657,20.0,20.0
35119,3,5119,[423 655  79 234  95],881,4,19292,3.76796875,0.0,0.0
35120,3,5120,[215 100 187 183 195],892,5,19297,3.768209334114431,0.0,20.0
35121,3,5121,[153 405 245 357 222],749,3,19300,3.768059351815697,20.0,0.0
35122,3,5122,[603 302 427 127  64],90,5,19305,3.7682998243216863,20.0,20.0
35123,3,5123,[603 302 427 127  64],90,5,19310,3.7685402029664323,20.0,20.0
35124,3,5124,[357   9 257 179 175],379,5,19315,3.768780487804878,20.0,0.0
35125,3,5125,[172 195 135 181 597],882,5,19320,3.7690206788919234,0.0,0.0
35126,3,5126,[276  69 282 238 300],311,5,19325,3.7692607762824264,0.0,0.0
35127,3,5127,[132 288 282 181 423],533,4,19329,3.769305772230889,0.0,0.0
35128,3,5128,[234   9  89 742 211],271,3,19332,3.7691557808539677,0.0,0.0
35129,3,5129,[143  11 546  50 176],749,4,19336,3.7692007797270954,0.0,20.0
35130,3,5130,[151 300 515 269 302],26,4,19340,3.769245761060222,0.0,0.0
35131,3,5131,[742  22 118  56 151],188,3,19343,3.769095869056898,0.0,0.0
35132,3,5132,[546  71  11   9 117],374,4,19347,3.7691408533021624,0.0,0.0
35133,3,5133,[173 273 197 175 182],234,1,19348,3.7686014803272303,0.0,0.0
35134,3,5134,[216  15 204 471 180],92,3,19351,3.768451801363194,0.0,0.0
35135,3,5135,[ 25 222 268 195 161],387,2,19353,3.768107476635514,0.0,0.0
35136,3,5136,[180 172 269 475 100],537,3,19356,3.767957952112128,0.0,20.0
35137,3,5137,[357 179 286 289  64],85,4,19360,3.7680031140521604,20.0,0.0
35138,3,5138,[603 302 427 127  64],664,5,19365,3.7682428488032693,20.0,20.0
35139,3,5139,[603 302 427 127  64],474,5,19370,3.7684824902723735,20.0,20.0
35140,3,5140,[603 302 427 127  64],13,5,19375,3.768722038513908,20.0,20.0
35141,3,5141,[121 323 483 215  56],454,2,19377,3.768378063010502,20.0,0.0
35142,3,5142,[181  89 144 282 588],378,5,19382,3.768617538401711,0.0,0.0
35143,3,5143,[603 302 427 127  64],666,5,19387,3.7688569206842923,20.0,20.0
35144,3,5144,[427 172 215  97 186],60,4,19391,3.768901846452867,0.0,0.0
35145,3,5145,[176 144 318 258 100],328,5,19396,3.7691410804508356,20.0,20.0
35146,3,5146,[603 302 427 127  64],745,4,19400,3.7691859335535263,20.0,20.0
35147,3,5147,[603 302 427 127  64],13,5,19405,3.7694250194250194,20.0,20.0
35148,3,5148,[603 302 427 127  64],666,5,19410,3.769664012429598,20.0,20.0
35149,3,5149,[ 70 546 216  96 483],295,4,19414,3.7697087378640775,20.0,0.0
35150,3,5150,[603 302 427 127  64],537,4,19418,3.7697534459328286,20.0,20.0
35151,3,5151,[180 258 111 200 173],378,2,19420,3.7694099378881987,0.0,0.0
35152,3,5152,[ 56  98  71 238 176],92,5,19425,3.76964874830196,0.0,20.0
35153,3,5153,[111 161 172 168 435],59,4,19429,3.7696934419868064,0.0,0.0
35154,3,5154,[151 269 275  11 435],537,1,19430,3.7691561590688654,0.0,0.0
35155,3,5155,[603 302 427 127  64],669,5,19435,3.7693948797517454,20.0,20.0
35156,3,5156,[135 228 655 111  56],64,5,19440,3.769633507853403,0.0,0.0
35157,3,5157,[228 333 742 385  70],328,2,19442,3.7692904226444357,0.0,0.0
35158,3,5158,[603 302 427 127  64],90,5,19447,3.7695289784842023,20.0,20.0
35159,3,5159,[483   7 132 515 301],334,3,19450,3.7693798449612403,20.0,0.0
35160,3,5160,[603 302 427 127  64],745,4,19454,3.76942453012982,20.0,20.0
35161,3,5161,[603 302 427 127  64],271,5,19459,3.769662921348315,20.0,20.0
35162,3,5162,[ 11   8  56  82 182],387,4,19463,3.769707534379237,0.0,0.0
35163,3,5163,[ 22 471 748 475 742],648,3,19466,3.7695584817970564,0.0,0.0
35164,3,5164,[ 95 172  69 168 483],892,5,19471,3.7697967086156825,20.0,0.0
35165,3,5165,[427 257 237 183 515],666,3,19474,3.769647696476965,0.0,0.0
35166,3,5166,[603 302 427 127  64],666,5,19479,3.769885813818463,20.0,20.0
35167,3,5167,[603 302 427 127  64],271,5,19484,3.7701238390092877,20.0,20.0
35168,3,5168,[603 302 427 127  64],339,5,19489,3.7703617721029214,20.0,20.0
35169,3,5169,[ 82 204 238 111 328],749,3,19492,3.7702127659574467,0.0,0.0
35170,3,5170,[603 302 427 127  64],666,5,19497,3.7704505898278864,20.0,20.0
35171,3,5171,[323 191 328   7 313],116,2,19499,3.7701082753286927,0.0,0.0
35172,3,5172,[403 228 328  95 302],334,3,19502,3.769959404600812,0.0,0.0
35173,3,5173,[185 568 288 357  96],13,1,19503,3.76942404329339,20.0,0.0
35174,3,5174,[216  96 234 286 265],378,5,19508,3.769661835748792,0.0,0.0
35175,3,5175,[179 200  79 172  89],833,3,19511,3.76951313755796,0.0,0.0
35176,3,5176,[ 97 121 603 435   7],650,3,19514,3.769364496812826,20.0,0.0
35177,3,5177,[161 127  69 153 168],95,4,19518,3.769409038238702,0.0,20.0
35178,3,5178,[322  98 172  15 435],537,0,19518,3.768681212589303,0.0,20.0
35179,3,5179,[175 515 202 234 187],308,3,19521,3.7685328185328184,0.0,0.0
35180,3,5180,[603 302 427 127  64],664,5,19526,3.768770507624011,20.0,20.0
35181,3,5181,[603 302 427 127  64],13,5,19531,3.7690081049787727,20.0,20.0
35182,3,5182,[  1 211 202 143 496],897,4,19535,3.769052672197569,0.0,0.0
35183,3,5183,[ 98 194 185 568 508],13,2,19537,3.768711419753086,0.0,20.0
35184,3,5184,[143 210 195 282 216],42,5,19542,3.7689488910318225,0.0,0.0
35185,3,5185,[258  12  15 748 117],454,2,19544,3.7686077902043964,20.0,0.0
35186,3,5186,[ 79 143 186 153 172],313,2,19546,3.7682668208984,0.0,0.0
35187,3,5187,[151 427 191  98 125],234,3,19549,3.768118735543562,0.0,20.0
35188,3,5188,[435  98 245  28 603],458,2,19551,3.767777991905955,20.0,20.0
35189,3,5189,[257 153 173 135 228],339,5,19556,3.7680154142581888,0.0,0.0
35190,3,5190,[423  69 151 197 194],7,5,19561,3.768252745135812,0.0,0.0
35191,3,5191,[603 302 427 127  64],537,4,19565,3.768297380585516,20.0,20.0
35192,3,5192,[603 302 427 127  64],90,5,19570,3.7685345657616023,20.0,20.0
35193,3,5193,[127 153 191 288 196],666,3,19573,3.768386599922988,0.0,20.0
35194,3,5194,[151  95 202 161 180],804,3,19576,3.7682386910490857,0.0,0.0
35195,3,5195,[222 403  56 180 100],279,2,19578,3.7678983833718247,0.0,20.0
35196,3,5196,[603 302 427 127  64],271,5,19583,3.7681354627669807,20.0,20.0
35197,3,5197,[ 69  25  82 427 496],308,3,19586,3.767987687572143,0.0,0.0
35198,3,5198,[271 405 423 195 161],479,2,19588,3.7676476245431814,0.0,0.0
35199,3,5199,[ 50 151 179  64 357],7,5,19593,3.7678846153846153,20.0,20.0
35200,3,5200,[100 245   9 655 322],334,3,19596,3.767736973658912,0.0,20.0
35201,3,5201,[ 28 546 234  11  56],339,5,19601,3.7679738562091503,0.0,0.0
35202,3,5202,[471 211 216  64 200],313,4,19605,3.7680184508937153,0.0,0.0
35203,3,5203,[175  71 196  12 222],334,4,19609,3.768063028439662,20.0,0.0
35204,3,5204,[742 568 483 405 195],804,5,19614,3.768299711815562,20.0,0.0
35205,3,5205,[603 302 427 127  64],745,4,19618,3.768344218209758,20.0,20.0
35206,3,5206,[173 678 234  79  95],506,4,19622,3.7683887075091222,0.0,0.0
35207,3,5207,[ 28  82 742 200 216],666,1,19623,3.767857142857143,0.0,0.0
35208,3,5208,[  1 318 185 655  50],815,3,19626,3.7677097331541565,20.0,20.0
35209,3,5209,[385   1 234 127 286],881,3,19629,3.7675623800383877,0.0,20.0
35210,3,5210,[405   4 294 168  12],406,1,19630,3.7670312799846477,20.0,0.0
35211,3,5211,[603 302 427 127  64],669,5,19635,3.7672678434382196,20.0,20.0
35212,3,5212,[603 302 427 127  64],745,4,19639,3.7673124880107425,20.0,20.0
35213,3,5213,[238 742 405 496 427],313,3,19642,3.7671653241273493,0.0,0.0
35214,3,5214,[161 125 202  25 276],194,1,19643,3.7666347075743047,0.0,0.0
35215,3,5215,[237  82 216 258  79],92,3,19646,3.7664877300613497,0.0,0.0
35216,3,5216,[603 302 427 127  64],666,5,19651,3.76672417097949,20.0,20.0
35217,3,5217,[603 302 427 127  64],666,5,19656,3.766960521272518,20.0,20.0
35218,3,5218,[603 302 427 127  64],13,5,19661,3.7671967809925273,20.0,20.0
35219,3,5219,[515 144 318 143 196],346,3,19664,3.767049808429119,20.0,0.0
35220,3,5220,[603 302 427 127  64],13,5,19669,3.767285960543957,20.0,20.0
35221,3,5221,[245  89  50 222 322],119,5,19674,3.7675220222137114,0.0,20.0
35222,3,5222,[597  56 174 385 135],308,4,19678,3.767566532644074,0.0,20.0
35223,3,5223,[273 403 195  79 197],234,1,19679,3.7670367534456357,0.0,0.0
35224,3,5224,[603 302 427 127  64],666,5,19684,3.767272727272727,20.0,20.0
35225,3,5225,[216 151 237 195  70],533,3,19687,3.7671259089169538,0.0,0.0
35226,3,5226,[191 183 135  28 100],474,5,19692,3.767361775396977,0.0,20.0
35227,3,5227,[603 302 427 127  64],669,5,19697,3.7675975516449887,20.0,20.0
35228,3,5228,[204 496 151 435 678],474,3,19700,3.7674507554025625,0.0,0.0
35229,3,5229,[603 302 427 127  64],458,5,19705,3.7676864244741872,20.0,20.0
35230,3,5230,[603 302 427 127  64],458,5,19710,3.767922003441025,20.0,20.0
35231,3,5231,[ 95 175 294 181  79],506,5,19715,3.76815749235474,0.0,0.0
35232,3,5232,[180 275 496 216 423],7,5,19720,3.7683928912669598,0.0,0.0
35233,3,5233,[ 88 100 313 268 117],145,5,19725,3.76862820022927,0.0,20.0
35234,3,5234,[603 302 427 127  64],537,4,19729,3.7686723973256924,20.0,20.0
35235,3,5235,[603 302 427 127  64],271,5,19734,3.76890756302521,20.0,20.0
35236,3,5236,[174 161   8 117 144],234,1,19735,3.7683788428489593,0.0,20.0
35237,3,5237,[496 151 144 237 515],892,5,19740,3.7686139747995417,0.0,0.0
35238,3,5238,[273 176  98 234 182],92,5,19745,3.768849016987975,0.0,20.0
35239,3,5239,[568 183 748 176   1],804,5,19750,3.769083969465649,0.0,0.0
35240,3,5240,[318 323 222 179 196],474,4,19754,3.7691280290020988,20.0,0.0
35241,3,5241,[125  69 385 515   1],59,3,19757,3.7689813048454788,0.0,0.0
35242,3,5242,[603 302 427 127  64],458,5,19762,3.7692160976540148,20.0,20.0
35243,3,5243,[182 423 286 483  82],650,1,19763,3.7686880244088483,20.0,0.0
35244,3,5244,[282 216  89 435 210],194,1,19764,3.7681601525262156,0.0,0.0
35245,3,5245,[328  82 546 471 117],653,3,19767,3.7680137247426613,0.0,0.0
35246,3,5246,[603 302 427 127  64],664,5,19772,3.768248522965504,20.0,20.0
35247,3,5247,[183  70 546 175 216],194,0,19772,3.767530487804878,0.0,0.0
35248,3,5248,[ 56   8 174  82 215],536,4,19776,3.7675747761478378,0.0,20.0
35249,3,5249,[ 89  98 748 282 245],804,5,19781,3.767809523809524,0.0,20.0
35250,3,5250,[603 302 427 127  64],339,5,19786,3.7680441820605597,20.0,20.0
35251,3,5251,[603 302 427 127  64],666,5,19791,3.7682787509520184,20.0,20.0
35252,3,5252,[179 204 222 121 403],311,4,19795,3.768322863125833,0.0,0.0
35253,3,5253,[385 172 173  50  22],295,5,19800,3.7685572896840505,0.0,20.0
35254,3,5254,[237  70 153  89 515],452,4,19804,3.7686013320647005,0.0,0.0
35255,3,5255,[127 403 265 174  89],650,3,19807,3.768455098934551,0.0,40.0
35256,3,5256,[289 185 195 187 118],194,2,19809,3.7681186988776867,0.0,0.0
35257,3,5257,[ 25 202 197 132 121],537,1,19810,3.7675922403955875,0.0,0.0
35258,3,5258,[151   1 288 357 403],843,1,19811,3.7670659821258794,20.0,0.0
35259,3,5259,[300 173 176  79 508],537,2,19813,3.7667300380228137,0.0,0.0
35260,3,5260,[597 301 288 196 276],13,2,19815,3.766394221630869,0.0,0.0
35261,3,5261,[603 302 427 127  64],664,5,19820,3.766628658304827,20.0,20.0
35262,3,5262,[181  96 483 496 234],749,5,19825,3.7668630058901766,20.0,0.0
35263,3,5263,[210 496 117 174 196],882,5,19830,3.76709726443769,0.0,20.0
35264,3,5264,[603 302 427 127  64],271,5,19835,3.7673314339981006,20.0,20.0
35265,3,5265,[603 302 427 127  64],13,5,19840,3.767565514622104,20.0,20.0
35266,3,5266,[121 174 273 294 471],537,0,19840,3.7668501993544714,0.0,20.0
35267,3,5267,[210 182 257 168 288],650,1,19841,3.7663249810174637,0.0,0.0
35268,3,5268,[603 302 427 127  64],474,5,19846,3.766559119377491,20.0,20.0
35269,3,5269,[196 333 228 176 204],537,0,19846,3.7658444022770396,0.0,0.0
35270,3,5270,[176 195  64 194 405],379,3,19849,3.7656991083285902,0.0,0.0
35271,3,5271,[ 79 222 204 200 176],897,5,19854,3.7659332321699543,0.0,0.0
35272,3,5272,[ 64 282 127 175  15],474,5,19859,3.766167267210317,0.0,20.0
35273,3,5273,[603 302 427 127  64],458,5,19864,3.7664012135001896,20.0,20.0
35274,3,5274,[603 302 427 127  64],339,5,19869,3.7666350710900476,20.0,20.0
35275,3,5275,[275 222 143 180  98],524,1,19870,3.7661106899166037,0.0,20.0
35276,3,5276,[ 71 121 143 245   8],200,4,19874,3.7661550123176046,0.0,0.0
35277,3,5277,[300 216 161 258 182],7,4,19878,3.766199317923456,0.0,0.0
35278,3,5278,[196 357 168 153 117],308,3,19881,3.7660541769274483,20.0,0.0
35279,3,5279,[204 423 181 174 257],374,2,19883,3.765719696969697,0.0,20.0
35280,3,5280,[172 127 196 187 257],334,4,19887,3.765764059837152,0.0,20.0
35281,3,5281,[143 271 194 748 186],64,3,19890,3.765619083680424,0.0,0.0
35282,3,5282,[234   9  82 265 403],234,1,19891,3.765095589627106,0.0,0.0
35283,3,5283,[ 22  89 322 234 286],537,1,19892,3.7645722937168813,0.0,0.0
35284,3,5284,[ 12 357 181  79  11],13,2,19894,3.7642384105960267,40.0,0.0
35285,3,5285,[603 302 427 127  64],664,5,19899,3.764472190692395,20.0,20.0
35286,3,5286,[403 135 318 742 313],308,4,19903,3.764516739171553,20.0,0.0
35287,3,5287,[  7 185 181 200 546],374,3,19906,3.764372163388805,0.0,0.0
35288,3,5288,[322  22 385 234 161],346,2,19908,3.7640385706182644,0.0,0.0
35289,3,5289,[603 302 427 127  64],664,5,19913,3.7642722117202267,20.0,20.0
35290,3,5290,[603 302 427 127  64],13,5,19918,3.7645057645057647,20.0,20.0
35291,3,5291,[603 302 427 127  64],664,5,19923,3.7647392290249435,20.0,20.0
35292,3,5292,[238 179  88 234 273],234,1,19924,3.7642168902323823,0.0,0.0
35293,3,5293,[508  12 168 423 194],533,5,19929,3.764450321118247,20.0,0.0
35294,3,5294,[603 302 427 127  64],537,4,19933,3.764494806421152,20.0,20.0
35295,3,5295,[286  69 496 132 179],452,4,19937,3.7645392749244713,0.0,0.0
35296,3,5296,[172 234 300 183 216],379,4,19941,3.7645837266377193,0.0,0.0
35297,3,5297,[ 28 228 318 125 173],42,5,19946,3.76481691204228,20.0,0.0
35298,3,5298,[117 175 176 100 228],892,4,19950,3.7648612945838837,0.0,20.0
35299,3,5299,[100 286  70  22  96],883,2,19952,3.7645283018867923,0.0,20.0
35300,3,5300,[313 100 357 173   1],650,4,19956,3.7645727221279004,20.0,20.0
35301,3,5301,[603 302 427 127  64],458,5,19961,3.7648057336854017,20.0,20.0
35302,3,5302,[195 173 186  12   1],374,3,19964,3.7646615123514993,20.0,0.0
35303,3,5303,[603 302 427 127  64],13,5,19969,3.764894419306184,20.0,20.0
35304,3,5304,[ 88 173 215 195 185],897,4,19973,3.7649387370405276,0.0,0.0
35305,3,5305,[603 302 427 127  64],666,5,19978,3.7651715039577835,20.0,20.0
35306,3,5306,[172 403 111 603 385],385,1,19979,3.7646504616544187,20.0,0.0
35307,3,5307,[357   8 187 194 132],313,4,19983,3.7646948003014318,20.0,0.0
35308,3,5308,[235  95 286 289 143],334,1,19984,3.764174044076097,0.0,0.0
35309,3,5309,[496 132 202 144   7],840,4,19988,3.7642184557438796,0.0,0.0
35310,3,5310,[176 258 588 118 357],311,4,19992,3.764262850687253,20.0,0.0
35311,3,5311,[322 180 357 423 333],328,3,19995,3.7641189759036147,20.0,0.0
35312,3,5312,[ 25 174 176  56 172],666,2,19997,3.7637869376999813,0.0,20.0
35313,3,5313,[603 302 427 127  64],745,4,20001,3.763831388784343,20.0,20.0
35314,3,5314,[603 302 427 127  64],745,4,20005,3.7638758231420506,20.0,20.0
35315,3,5315,[357 228 597 100 258],653,4,20009,3.7639202407825434,20.0,20.0
35316,3,5316,[603 302 427 127  64],90,5,20014,3.76415271769795,20.0,20.0
35317,3,5317,[301 195  79 228  22],537,0,20014,3.7634449040992854,0.0,0.0
35318,3,5318,[423 546  56 172 515],882,4,20018,3.7634893777025757,0.0,0.0
35319,3,5319,[258 234 385 100 471],313,4,20022,3.763533834586466,0.0,20.0
35320,3,5320,[151 194 475 258  22],669,1,20023,3.7630144709641047,0.0,0.0
35321,3,5321,[603 302 427 127  64],537,4,20027,3.7630590003757987,20.0,20.0
35322,3,5322,[215 471 597 172   9],788,1,20028,3.7625399210971255,0.0,0.0
35323,3,5323,[ 70 197 172  15   4],144,5,20033,3.7627723516153266,0.0,0.0
35324,3,5324,[603 302 427 127  64],537,4,20037,3.7628169014084505,20.0,20.0
35325,3,5325,[603 302 427 127  64],537,4,20041,3.7628614344723994,20.0,20.0
35326,3,5326,[603 302 427 127  64],474,5,20046,3.7630936737375635,20.0,20.0
35327,3,5327,[475 161 546 125 174],92,3,20049,3.7629504504504503,0.0,20.0
35328,3,5328,[ 82 403 546 282 318],42,3,20052,3.762807280915744,20.0,0.0
35329,3,5329,[603 302 427 127  64],339,5,20057,3.7630393996247653,20.0,20.0
35330,3,5330,[603 302 427 127  64],745,4,20061,3.763083849184018,20.0,20.0
35331,3,5331,[ 69   1 185 181  97],234,1,20062,3.7625656414103528,0.0,0.0
35332,3,5332,[471  95 181 265 423],524,3,20065,3.7624226514157133,0.0,0.0
35333,3,5333,[603 302 427 127  64],90,5,20070,3.762654668166479,20.0,20.0
35334,3,5334,[ 11 127 235  50 322],374,3,20073,3.7625117150890346,0.0,40.0
35335,3,5335,[143 603 200 235 187],650,3,20076,3.762368815592204,20.0,0.0
35336,3,5336,[174 275 282 286 655],318,4,20080,3.762413340828181,0.0,20.0
35337,3,5337,[234  79  11 194 216],543,3,20083,3.762270513300862,0.0,0.0
35338,3,5338,[603 302 427 127  64],745,4,20087,3.7623150402697134,20.0,20.0
35339,3,5339,[286   4 168 211 245],102,0,20087,3.7616104868913856,0.0,0.0
35340,3,5340,[603 302 427 127  64],271,5,20092,3.761842351619547,20.0,20.0
35341,3,5341,[742 186 423 132  82],653,2,20094,3.7615125421190565,0.0,0.0
35342,3,5342,[176 269 357 328 234],263,5,20099,3.761744338386674,20.0,0.0
35343,3,5343,[ 25  89 222   8  82],200,5,20104,3.7619760479041915,0.0,0.0
35344,3,5344,[515 176 151  64 161],234,2,20106,3.761646398503274,0.0,0.0
35345,3,5345,[597 187 204 117  22],788,3,20109,3.761503928170595,0.0,0.0
35346,3,5346,[258 181 655  64 234],311,5,20114,3.7617355526463436,0.0,0.0
35347,3,5347,[385 211 197   1 186],738,4,20118,3.761780104712042,0.0,0.0
35348,3,5348,[385 237 132  88 234],533,3,20121,3.7616376892877175,0.0,0.0
35349,3,5349,[204 238  89 202 185],650,3,20124,3.7614953271028035,0.0,0.0
35350,3,5350,[ 25 294 288 328 117],13,0,20124,3.7607923752569614,0.0,0.0
35351,3,5351,[161 175 202 179 222],234,0,20124,3.7600896860986546,0.0,0.0
35352,3,5352,[ 89 174   1  15 403],308,4,20128,3.7601345040164396,0.0,20.0
35353,3,5353,[175 405 173 176 508],334,2,20130,3.7598057527082553,0.0,0.0
35354,3,5354,[197 257 185 546  15],271,2,20132,3.7594771241830065,0.0,0.0
35355,3,5355,[603 302 427 127  64],90,5,20137,3.7597087378640777,20.0,20.0
35356,3,5356,[427 185 144  28  50],7,5,20142,3.7599402650737352,0.0,20.0
35357,3,5357,[268 215 313  64 117],537,2,20144,3.759611795446062,0.0,0.0
35358,3,5358,[175 173 168 238 228],537,4,20148,3.759656652360515,0.0,0.0
35359,3,5359,[603 302 427 127  64],537,4,20152,3.7597014925373133,20.0,20.0
35360,3,5360,[603 302 427 127  64],537,4,20156,3.7597463159858235,20.0,20.0
35361,3,5361,[173 435 197 132 135],398,4,20160,3.759791122715405,0.0,0.0
35362,3,5362,[603 302 427 127  64],90,5,20165,3.7600223755360807,20.0,20.0
35363,3,5363,[603 302 427 127  64],339,5,20170,3.7602535421327365,20.0,20.0
35364,3,5364,[ 50 175  71 508  15],406,4,20174,3.7602982292637464,0.0,20.0
35365,3,5365,[202 121 168  70  89],374,2,20176,3.759970182631383,0.0,0.0
35366,3,5366,[603 302 427 127  64],664,5,20181,3.7602012297372833,20.0,20.0
35367,3,5367,[151  82  50   4 186],653,3,20184,3.7600596125186287,0.0,20.0
35368,3,5368,[265 174 202 173 204],295,5,20189,3.7602905569007263,0.0,20.0
35369,3,5369,[603 302 427 127  64],271,5,20194,3.7605214152700186,20.0,20.0
35370,3,5370,[ 95 121 176  64   9],378,5,20199,3.7607521876745484,0.0,0.0
35371,3,5371,[118  50 181 313 597],145,4,20203,3.7607967237527924,0.0,20.0
35372,3,5372,[276 117 405 180 161],533,2,20205,3.7604690117252932,0.0,0.0
35373,3,5373,[ 22 174 515 118 197],650,4,20209,3.7605135839225903,0.0,20.0
35374,3,5374,[238 269 125   8 181],25,5,20214,3.760744186046512,0.0,0.0
35375,3,5375,[546 181 435  71  15],60,4,20218,3.7607886904761907,0.0,0.0
35376,3,5376,[603 302 427 127  64],458,5,20223,3.7610191556630093,20.0,20.0
35377,3,5377,[427 211  89   4   8],882,5,20228,3.761249535143176,0.0,0.0
35378,3,5378,[  8 222  89   4 144],87,5,20233,3.7614798289644917,0.0,0.0
35379,3,5379,[153 258 265 172 211],387,5,20238,3.7617100371747214,0.0,0.0
35380,3,5380,[269  82 597 172 179],378,3,20241,3.7615684816948525,0.0,0.0
35381,3,5381,[603 302 427 127  64],474,5,20246,3.7617985878855444,20.0,20.0
35382,3,5382,[742  88 245  25  71],92,2,20248,3.761471298532417,0.0,0.0
35383,3,5383,[245 176 385  50  79],200,4,20252,3.761515601783061,0.0,20.0
35384,3,5384,[275  28 234  97  98],474,4,20256,3.761559888579387,0.0,20.0
35385,3,5385,[603 302 427 127  64],537,4,20260,3.761604158930561,20.0,20.0
35386,3,5386,[179   4 197 333  82],387,2,20262,3.7612771486912937,0.0,0.0
35387,3,5387,[185  98 127 179 197],686,5,20267,3.7615070527097254,0.0,40.0
35388,3,5388,[603 302 427 127  64],90,5,20272,3.7617368714047132,20.0,20.0
35389,3,5389,[603 302 427 127  64],474,5,20277,3.7619666048237477,20.0,20.0
35390,3,5390,[603 302 427 127  64],458,5,20282,3.762196253014283,20.0,20.0
35391,3,5391,[ 28 235  97 405 496],59,3,20285,3.762054896142433,0.0,0.0
35392,3,5392,[ 98 180 228 286  50],664,5,20290,3.762284442796217,0.0,40.0
35393,3,5393,[187  69 161 427   8],7,4,20294,3.7623285131627733,0.0,0.0
35394,3,5394,[257  88 143 195  79],474,4,20298,3.762372567191844,0.0,0.0
35395,3,5395,[603 302 427 127  64],537,4,20302,3.762416604892513,20.0,20.0
35396,3,5396,[515 181  28 276 322],537,2,20304,3.762090050027793,0.0,0.0
35397,3,5397,[238 210   8 118 176],311,4,20308,3.762134123749537,0.0,0.0
35398,3,5398,[ 22  70 100 195  96],804,5,20313,3.7623634006297464,0.0,20.0
35399,3,5399,[135 172 179 275 111],271,5,20318,3.7625925925925925,0.0,0.0
35400,3,5400,[ 71 748 289 234 405],92,2,20320,3.762266246991298,0.0,0.0
35401,3,5401,[603 302 427 127  64],537,4,20324,3.7623102554609402,20.0,20.0
35402,3,5402,[435 742 111   7  56],378,4,20328,3.7623542476402,0.0,0.0
35403,3,5403,[405 655 216 143 191],95,4,20332,3.7623982235381197,0.0,0.0
35404,3,5404,[603 302 427 127  64],666,5,20337,3.762627197039778,20.0,20.0
35405,3,5405,[121 268 403 180 175],92,5,20342,3.7628560858305584,0.0,0.0
35406,3,5406,[603 302 427 127  64],474,5,20347,3.7630848899574625,20.0,20.0
35407,3,5407,[161 211 143  28 323],59,3,20350,3.7629437869822486,0.0,0.0
35408,3,5408,[211 515  70 175 471],537,4,20354,3.7629876132371973,0.0,0.0
35409,3,5409,[603 302 427 127  64],339,5,20359,3.7632162661737523,20.0,20.0
35410,3,5410,[603 302 427 127  64],271,5,20364,3.763444834596193,20.0,20.0
35411,3,5411,[111 245  89 175 237],749,2,20366,3.763118994826312,0.0,0.0
35412,3,5412,[153 357 195 194  82],804,5,20371,3.763347496767042,20.0,0.0
35413,3,5413,[294 318   4 313 173],234,3,20374,3.763206501662357,20.0,0.0
35414,3,5414,[ 89 200  50 176  22],833,2,20376,3.762880886426593,0.0,20.0
35415,3,5415,[191  50 237 204 151],533,3,20379,3.7627400295420976,0.0,20.0
35416,3,5416,[181 265 234 117 289],533,2,20381,3.76241462063873,0.0,0.0
35417,3,5417,[180   9 258 194   1],6,4,20385,3.762458471760797,0.0,0.0
35418,3,5418,[196 143  88 655   1],308,4,20389,3.7625023066986527,0.0,0.0
35419,3,5419,[603 302 427 127  64],745,4,20393,3.7625461254612547,20.0,20.0
35420,3,5420,[496 132 357 234 121],271,4,20397,3.762589928057554,20.0,0.0
35421,3,5421,[603 302 427 127  64],537,4,20401,3.762633714496496,20.0,20.0
35422,3,5422,[179 211  15  79 215],474,5,20406,3.7628618845657384,0.0,0.0
35423,3,5423,[194 357  71 202 100],194,4,20410,3.762905604719764,20.0,20.0
35424,3,5424,[ 12 276 176  22 427],474,5,20415,3.7631336405529954,20.0,0.0
35425,3,5425,[603 302 427 127  64],474,5,20420,3.7633615923332107,20.0,20.0
35426,3,5426,[ 12 153 172 655  22],664,3,20423,3.763220932375161,20.0,0.0
35427,3,5427,[603 302 427 127  64],666,5,20428,3.763448784082535,20.0,20.0
35428,3,5428,[603 302 427 127  64],339,5,20433,3.7636765518511694,20.0,20.0
35429,3,5429,[175  88 186 118 183],13,5,20438,3.76390423572744,0.0,0.0
35430,3,5430,[405 568 202 742 323],881,4,20442,3.7639477076044927,0.0,0.0
35431,3,5431,[603 302 427 127  64],13,5,20447,3.7641752577319587,20.0,20.0
35432,3,5432,[603 302 427 127  64],664,5,20452,3.7644027240935025,20.0,20.0
35433,3,5433,[100 302  95 471 238],13,3,20455,3.764262053735738,0.0,20.0
35434,3,5434,[ 15 234 195 182 180],313,4,20459,3.764305427782889,0.0,0.0
35435,3,5435,[403 273  56 100 117],234,1,20460,3.7637969094922736,0.0,20.0
35436,3,5436,[603 302 427 127  64],339,5,20465,3.764024278094537,20.0,20.0
35437,3,5437,[191 143 127  50 403],749,5,20470,3.76425156307466,0.0,40.0
35438,3,5438,[ 64  79 173  95 245],378,4,20474,3.76429490715205,0.0,0.0
35439,3,5439,[111 385  25 182 211],87,5,20479,3.7645220588235295,0.0,0.0
35440,3,5440,[603 302 427 127  64],666,5,20484,3.7647491269987134,20.0,20.0
35441,3,5441,[204 172 588 435 215],897,4,20488,3.764792355751562,0.0,0.0
35442,3,5442,[186 237 588  25 435],85,1,20489,3.7642844019841997,0.0,0.0
35443,3,5443,[603 302 427 127  64],666,5,20494,3.7645113886847907,20.0,20.0
35444,3,5444,[ 28 151 288 176  11],334,2,20496,3.7641873278236915,0.0,0.0
35445,3,5445,[ 28 597  70 153  98],788,3,20499,3.764047006977598,0.0,20.0
35446,3,5446,[ 22   4  98   1 258],387,4,20503,3.7640903249495135,0.0,20.0
35447,3,5447,[603 302 427 127  64],664,5,20508,3.76431718061674,20.0,20.0
35448,3,5448,[273 228 423  12  71],64,3,20511,3.7641769131950817,20.0,0.0
35449,3,5449,[258 181 168 196 204],339,3,20514,3.7640366972477066,0.0,0.0
35450,3,5450,[333 258 168 603 187],13,4,20518,3.764079985323794,20.0,0.0
35451,3,5451,[173 191  79 357 127],339,5,20523,3.7643066764490096,20.0,20.0
35452,3,5452,[269 100 603 288 183],315,3,20526,3.7641665138455895,20.0,20.0
35453,3,5453,[655 313   9 265 515],207,4,20530,3.764209754308764,0.0,0.0
35454,3,5454,[603 302 427 127  64],90,5,20535,3.7644362969752523,20.0,20.0
35455,3,5455,[  1 265  56   7 508],59,4,20539,3.7644794721407626,0.0,0.0
35456,3,5456,[603 302 427 127  64],664,5,20544,3.764705882352941,20.0,20.0
35457,3,5457,[135 515  12  98 234],474,5,20549,3.764932209600586,20.0,20.0
35458,3,5458,[195  82 180 176 257],533,3,20552,3.7647920864627222,0.0,0.0
35459,3,5459,[603 302 427 127  64],90,5,20557,3.765018315018315,20.0,20.0
35460,3,5460,[216 435 143  70 135],207,3,20560,3.7648782274308736,0.0,0.0
35461,3,5461,[195 143 135 121 204],474,5,20565,3.7651043573782497,0.0,0.0
35462,3,5462,[385 125 191 194 153],64,3,20568,3.7649643053267434,0.0,0.0
35463,3,5463,[204 135 121 423   8],271,4,20572,3.7650073206442167,0.0,0.0
35464,3,5464,[603 302 427 127  64],664,5,20577,3.7652333028362306,20.0,20.0
35465,3,5465,[322 483 265 216 276],533,3,20580,3.765093304061471,20.0,0.0
35466,3,5466,[603 302 427 127  64],745,4,20584,3.7651362721785255,20.0,20.0
35467,3,5467,[603 302 427 127  64],90,5,20589,3.765362106803219,20.0,20.0
35468,3,5468,[603 302 427 127  64],474,5,20594,3.7655878588407385,20.0,20.0
35469,3,5469,[186 427  98 181 568],326,5,20599,3.76581352833638,0.0,20.0
35470,3,5470,[302  11 286  97 546],788,2,20601,3.765490769511972,0.0,0.0
35471,3,5471,[204 194  95 235 175],378,5,20606,3.765716374269006,0.0,0.0
35472,3,5472,[ 79 181 197 172  69],334,3,20609,3.765576466289055,0.0,0.0
35473,3,5473,[603 302 427 127  64],339,5,20614,3.7658019729630983,20.0,20.0
35474,3,5474,[265 496 182 175 318],766,3,20617,3.765662100456621,20.0,0.0
35475,3,5475,[215 273 496 515  12],90,3,20620,3.7655222790357925,20.0,0.0
35476,3,5476,[234  79 153 258 191],653,2,20622,3.765199926967318,0.0,0.0
35477,3,5477,[603 302 427 127  64],745,4,20626,3.7652427893391747,20.0,20.0
35478,3,5478,[222 228 185  28 186],380,2,20628,3.7649206059499907,0.0,0.0
35479,3,5479,[257  70 100 183 471],144,5,20633,3.76514598540146,0.0,20.0
35480,3,5480,[568 269 742  96 182],378,5,20638,3.7653712826126617,0.0,0.0
35481,3,5481,[603 302 427 127  64],271,5,20643,3.7655964976286027,20.0,20.0
35482,3,5482,[210 172 323 588 161],454,2,20645,3.7652744847711106,0.0,0.0
35483,3,5483,[196  50 111 173 143],92,2,20647,3.764952589350839,0.0,20.0
35484,3,5484,[357 196 275 276 197],533,3,20650,3.764813126709207,20.0,0.0
35485,3,5485,[322 153 173 234 182],102,0,20650,3.764126868392271,0.0,0.0
35486,3,5486,[288 194  82 588 174],102,2,20652,3.763805358119191,0.0,20.0
35487,3,5487,[ 98   4 237 183  88],326,2,20654,3.763483965014577,0.0,20.0
35488,3,5488,[197 269 357 195  69],85,3,20657,3.7633448715613045,20.0,0.0
35489,3,5489,[603 302 427 127  64],13,5,20662,3.7635701275045537,20.0,20.0
35490,3,5490,[294 111 328  96 597],653,3,20665,3.7634310690220363,0.0,0.0
35491,3,5491,[174  22 435 180 265],447,5,20670,3.7636562272396215,0.0,20.0
35492,3,5492,[603 302 427 127  64],745,4,20674,3.763699253595485,20.0,20.0
35493,3,5493,[603 302 427 127  64],669,5,20679,3.763924281033855,20.0,20.0
35494,3,5494,[603 302 427 127  64],474,5,20684,3.7641492265696086,20.0,20.0
35495,3,5495,[288 216  56 176 228],64,5,20689,3.7643740902474527,0.0,0.0
35496,3,5496,[603 302 427 127  64],13,5,20694,3.764598872112061,20.0,20.0
35497,3,5497,[202 588 186   1 333],387,1,20695,3.76409603492179,0.0,0.0
35498,3,5498,[  4 196 265 222 318],387,2,20697,3.7637752318603384,20.0,0.0
35499,3,5499,[194 161 742 597 200],653,3,20700,3.7636363636363637,0.0,0.0
35500,3,5500,[603 302 427 127  64],664,5,20705,3.763861116160698,20.0,20.0
35501,3,5501,[603 302 427 127  64],537,4,20709,3.7639040348964015,20.0,20.0
35502,3,5502,[603 302 427 127  64],271,5,20714,3.7641286570961294,20.0,20.0
35503,3,5503,[423 475 748 515 204],13,3,20717,3.7639898255813953,0.0,0.0
35504,3,5504,[168 322  96  79 222],524,3,20720,3.7638510445049955,0.0,0.0
35505,3,5505,[405 275  70 234   9],64,4,20724,3.7638939338903015,0.0,0.0
35506,3,5506,[ 96 323 385  69 435],474,4,20728,3.7639368076992916,0.0,0.0
35507,3,5507,[546 127 173 275 195],95,3,20731,3.7637981118373274,0.0,20.0
35508,3,5508,[294 118 196 197 228],194,2,20733,3.7634779451806137,0.0,0.0
35509,3,5509,[228 143   4 748  79],881,2,20735,3.763157894736842,0.0,0.0
35510,3,5510,[186 323 423 471   7],378,2,20737,3.762837960442751,0.0,0.0
35511,3,5511,[603 289 300 204 168],334,3,20740,3.7626995645863572,20.0,0.0
35512,3,5512,[385 323 655 742 100],378,4,20744,3.7627426083801923,0.0,20.0
35513,3,5513,[196 313 357 135 202],271,5,20749,3.762966993108451,20.0,0.0
35514,3,5514,[ 28  79  25 135  97],13,3,20752,3.7628286491387124,0.0,0.0
35515,3,5515,[ 70 508 211 196 216],13,2,20754,3.7625090645395214,0.0,0.0
35516,3,5516,[143 405   8 117 588],313,2,20756,3.762189595794816,0.0,0.0
35517,3,5517,[385 175 300  97 200],313,4,20760,3.762232693004712,0.0,0.0
35518,3,5518,[ 64 234 237 568 195],263,4,20764,3.7622757745968474,0.0,0.0
35519,3,5519,[403 144 200 228  15],95,3,20767,3.7621376811594205,0.0,0.0
35520,3,5520,[ 25 186 135 144 204],934,4,20771,3.7621807643542837,0.0,0.0
35521,3,5521,[161   7 111 210 100],334,2,20773,3.761861644331764,0.0,20.0
35522,3,5522,[471 435  98 200  96],447,4,20777,3.761904761904762,0.0,20.0
35523,3,5523,[  7 111 228  98  79],92,4,20781,3.761947863866763,0.0,20.0
35524,3,5524,[210 176 294   8 215],92,4,20785,3.7619909502262443,0.0,0.0
35525,3,5525,[515 144 179  56 273],207,4,20789,3.762034020991676,0.0,0.0
35526,3,5526,[357 125 405  89 568],194,1,20790,3.7615342862312287,20.0,0.0
35527,3,5527,[ 22  98   8 385 173],883,2,20792,3.761215629522431,0.0,20.0
35528,3,5528,[588 176 153 403 202],184,2,20794,3.7608970880810273,0.0,0.0
35529,3,5529,[603 302 427 127  64],666,5,20799,3.761121157323689,20.0,20.0
35530,3,5530,[  1  25 182 168  69],650,1,20800,3.7606219490146446,0.0,0.0
35531,3,5531,[603 302 427 127  64],271,5,20805,3.7608459869848154,20.0,20.0
35532,3,5532,[313 179  70 597 185],59,3,20808,3.760708476414242,0.0,0.0
35533,3,5533,[ 79 273  69 238 655],749,4,20812,3.7607517166606432,0.0,0.0
35534,3,5534,[273   9 288 186 174],7,4,20816,3.760794941282746,0.0,20.0
35535,3,5535,[286 127 125 202   8],533,4,20820,3.7608381502890174,0.0,20.0
35536,3,5536,[603 302 427 127  64],458,5,20825,3.7610619469026547,20.0,20.0
35537,3,5537,[195 168 211 210 175],653,2,20827,3.760743950884796,0.0,0.0
35538,3,5538,[603 302 427 127  64],90,5,20832,3.760967683697418,20.0,20.0
35539,3,5539,[603 302 427 127  64],537,4,20836,3.76101083032491,20.0,20.0
35540,3,5540,[216  22 186 202 568],766,0,20836,3.7603320700234613,0.0,0.0
35541,3,5541,[ 56 172  50 176 322],633,1,20837,3.7598339949476722,0.0,20.0
35542,3,5542,[603 302 427 127  64],745,4,20841,3.7598773227494138,20.0,20.0
35543,3,5543,[603 302 427 127  64],666,5,20846,3.76010101010101,20.0,20.0
35544,3,5544,[  1 515 161 568   8],200,5,20851,3.7603246167718667,0.0,0.0
35545,3,5545,[603 302 427 127  64],474,5,20856,3.7605481428056255,20.0,20.0
35546,3,5546,[ 95 202 655 182 179],406,3,20859,3.760411032990806,0.0,0.0
35547,3,5547,[603 302 427 127  64],669,5,20864,3.7606344628695023,20.0,20.0
35548,3,5548,[211 245 181  64 289],454,1,20865,3.7601369616147053,0.0,0.0
35549,3,5549,[603 302 427 127  64],13,5,20870,3.76036036036036,20.0,20.0
35550,3,5550,[508 655 176 186  71],92,5,20875,3.7605836786164657,0.0,0.0
35551,3,5551,[300   8 153 195  22],479,4,20879,3.7606268011527377,0.0,0.0
35552,3,5552,[288 357 100 186 435],650,4,20883,3.7606699081577526,20.0,20.0
35553,3,5553,[405 211  22  11 180],653,2,20885,3.7603528988116675,0.0,0.0
35554,3,5554,[ 12   1 258 179 215],64,4,20889,3.76039603960396,20.0,0.0
35555,3,5555,[183 435   7 194   8],234,3,20892,3.760259179265659,0.0,0.0
35556,3,5556,[313  70 185 202 204],215,3,20895,3.760122368184272,0.0,0.0
35557,3,5557,[568  11 588 423 196],13,3,20898,3.7599856063332133,0.0,0.0
35558,3,5558,[294 117 258 273  11],102,1,20899,3.7594891167476163,0.0,0.0
35559,3,5559,[603 302 427 127  64],458,5,20904,3.7597122302158272,20.0,20.0
35560,3,5560,[603 302 427 127  64],669,5,20909,3.759935263441827,20.0,20.0
35561,3,5561,[603 302 427 127  64],339,5,20914,3.7601582164688963,20.0,20.0
35562,3,5562,[603 302 427 127  64],537,4,20918,3.7602013302175084,20.0,20.0
35563,3,5563,[603 302 427 127  64],90,5,20923,3.7604241552839683,20.0,20.0
35564,3,5564,[ 64 273 546 435 161],524,3,20926,3.7602875112309073,0.0,0.0
35565,3,5565,[603 302 427 127  64],745,4,20930,3.760330578512397,20.0,20.0
35566,3,5566,[603 302 427 127  64],537,4,20934,3.7603736303215376,20.0,20.0
35567,3,5567,[276 483 151 183 222],474,4,20938,3.7604166666666665,20.0,0.0
35568,3,5568,[603 302 427 127  64],271,5,20943,3.7606392530077213,20.0,20.0
35569,3,5569,[603 302 427 127  64],664,5,20948,3.760861759425494,20.0,20.0
35570,3,5570,[175 191 269 204 180],666,4,20952,3.7609046849757672,0.0,0.0
35571,3,5571,[603 302 427 127  64],745,4,20956,3.7609475951184494,20.0,20.0
35572,3,5572,[268  82 385 153 357],7,3,20959,3.760811053292661,20.0,0.0
35573,3,5573,[151   1 127 118 181],897,4,20963,3.760853964836742,0.0,20.0
35574,3,5574,[111 286 210  97 202],378,3,20966,3.7607174887892376,0.0,0.0
35575,3,5575,[144   7  96 508 471],92,5,20971,3.7609397417503585,0.0,0.0
35576,3,5576,[603 302 427 127  64],90,5,20976,3.761161915008069,20.0,20.0
35577,3,5577,[568 173  12 237 127],883,3,20979,3.7610254571531017,20.0,20.0
35578,3,5578,[603 302 427 127  64],669,5,20984,3.7612475354006096,20.0,20.0
35579,3,5579,[603 302 427 127  64],271,5,20989,3.761469534050179,20.0,20.0
35580,3,5580,[ 25 186 245 168 273],666,1,20990,3.760974735710446,0.0,0.0
35581,3,5581,[427 125 216 200 483],313,3,20993,3.7608384091723397,20.0,0.0
35582,3,5582,[603 302 427 127  64],339,5,20998,3.7610603618126457,20.0,20.0
35583,3,5583,[ 12  82 276 183 211],643,4,21002,3.7611031518624642,20.0,0.0
35584,3,5584,[ 64 655 144 238 200],666,4,21006,3.761145926589078,0.0,0.0
35585,3,5585,[ 79 483  25  11 153],295,5,21011,3.7613677049767276,20.0,0.0
35586,3,5586,[269  22  71 588  70],7,3,21014,3.7612314301056022,0.0,0.0
35587,3,5587,[144 515   8 238 182],488,1,21015,3.7607372942018613,0.0,0.0
35588,3,5588,[182 197 194 216   7],6,4,21019,3.760780103775273,0.0,0.0
35589,3,5589,[258   8 222 172  12],64,4,21023,3.7608228980322003,20.0,0.0
35590,3,5590,[302 301 265  25 174],537,1,21024,3.760329100339832,0.0,20.0
35591,3,5591,[ 98  22 318 515 300],780,2,21026,3.7600143061516453,20.0,20.0
35592,3,5592,[161 234  96 127 423],804,3,21029,3.7598784194528876,0.0,20.0
35593,3,5593,[328 294 471  79 546],653,2,21031,3.7595638183768325,0.0,0.0
35594,3,5594,[ 22 216 117 269 385],13,1,21032,3.759070598748883,0.0,0.0
35595,3,5595,[176 153  98  56 183],218,4,21036,3.7591136526090065,0.0,20.0
35596,3,5596,[194 322 172 323 168],13,3,21039,3.7589780239413972,0.0,0.0
35597,3,5597,[222  12 258  79  95],28,4,21043,3.75902107895677,20.0,0.0
35598,3,5598,[603 302 427 127  64],664,5,21048,3.7592427219146276,20.0,20.0
35599,3,5599,[ 88 265  95  22 125],892,5,21053,3.759464285714286,0.0,0.0
35600,3,5600,[603 302 427 127  64],745,4,21057,3.7595072308516335,20.0,20.0
35601,3,5601,[603 302 427 127  64],271,5,21062,3.7597286683327384,20.0,20.0
35602,3,5602,[125 403 210 196  12],42,4,21066,3.7597715509548455,20.0,0.0
35603,3,5603,[111 216 742 427 258],59,3,21069,3.7596359743040684,0.0,0.0
35604,3,5604,[  4 357 215 322 197],308,2,21071,3.759322033898305,20.0,0.0
35605,3,5605,[603 302 427 127  64],271,5,21076,3.759543346414556,20.0,20.0
35606,3,5606,[228 328 496 175 322],234,1,21077,3.7590511860174782,0.0,0.0
35607,3,5607,[603 302 427 127  64],339,5,21082,3.7592724679029956,20.0,20.0
35608,3,5608,[180  71   9 301  56],788,2,21084,3.7589588161882688,0.0,0.0
35609,3,5609,[603 302 427 127  64],537,4,21088,3.759001782531194,20.0,20.0
35610,3,5610,[210 176 153 275  98],7,4,21092,3.7590447335590804,0.0,20.0
35611,3,5611,[597   1 202  89 125],200,5,21097,3.759265858873842,0.0,0.0
35612,3,5612,[603 302 427 127  64],339,5,21102,3.759486905398183,20.0,20.0
35613,3,5613,[275 185 427  89 282],328,3,21105,3.7593516209476308,0.0,0.0
35614,3,5614,[211 235  89 172 204],650,4,21109,3.7593944790739093,0.0,0.0
35615,3,5615,[546 568 204   8 144],378,4,21113,3.759437321937322,0.0,0.0
35616,3,5616,[ 70 471 180 357  28],7,4,21117,3.759480149546021,20.0,0.0
35617,3,5617,[323  79 185 333 228],537,1,21118,3.7589889640441436,0.0,0.0
35618,3,5618,[257  28 234  95 222],374,4,21122,3.759031856202171,0.0,0.0
35619,3,5619,[183 403 288  25 168],374,3,21125,3.758896797153025,0.0,0.0
35620,3,5620,[546 182 483 196  15],749,3,21128,3.7587617861590465,20.0,0.0
35621,3,5621,[ 50 269 172 132 313],13,4,21132,3.7588046958377803,0.0,20.0
35622,3,5622,[546 204 200 179 300],653,4,21136,3.758847590254313,0.0,0.0
35623,3,5623,[603 302 427 127  64],537,4,21140,3.758890469416785,20.0,20.0
35624,3,5624,[ 89 286 144 238  70],95,4,21144,3.7589333333333332,0.0,0.0
35625,3,5625,[174 187  50 435 191],7,5,21149,3.759153928190544,0.0,40.0
35626,3,5626,[238  79 435  95  22],313,3,21152,3.7590190154611696,0.0,0.0
35627,3,5627,[ 97 187 427 471  64],90,5,21157,3.7592395167022032,0.0,0.0
35628,3,5628,[603 302 427 127  64],458,5,21162,3.7594599395985075,20.0,20.0
35629,3,5629,[ 97 286 215  28  22],328,3,21165,3.7593250444049735,0.0,0.0
35630,3,5630,[275 127 121 568 111],95,4,21169,3.7593677854732728,0.0,20.0
35631,3,5631,[200 127 276 357  82],13,2,21171,3.759055397727273,20.0,20.0
35632,3,5632,[222 302 403  22 496],334,4,21175,3.759098171489437,0.0,0.0
35633,3,5633,[427  82   4  56  79],87,5,21180,3.759318423855165,0.0,0.0
35634,3,5634,[187   1 132  56 300],669,4,21184,3.759361135758651,0.0,0.0
35635,3,5635,[ 69 174 323 318 515],488,4,21188,3.7594038325053227,20.0,20.0
35636,3,5636,[ 82 111 496 200 265],334,2,21190,3.7590917154514814,0.0,0.0
35637,3,5637,[603 302 427 127  64],664,5,21195,3.7593118126995386,20.0,20.0
35638,3,5638,[403  22   4 195 144],13,3,21198,3.7591771590707572,0.0,0.0
35639,3,5639,[655 172 289 180  98],234,2,21200,3.7588652482269502,0.0,20.0
35640,3,5640,[603 302 427 127  64],537,4,21204,3.758907995036341,20.0,20.0
35641,3,5641,[318  95  96 603  56],313,3,21207,3.7587734845799363,40.0,0.0
35642,3,5642,[603 302 427 127  64],90,5,21212,3.7589934432039693,20.0,20.0
35643,3,5643,[196 144 187 175  69],234,2,21214,3.758681785967399,0.0,0.0
35644,3,5644,[ 12 588   4 603 471],308,4,21218,3.758724534986714,40.0,0.0
35645,3,5645,[181 161  56 200 265],378,4,21222,3.7587672688629117,0.0,0.0
35646,3,5646,[603 302 427 127  64],745,4,21226,3.7588099876040375,20.0,20.0
35647,3,5647,[603 302 427 127  64],90,5,21231,3.759029745042493,20.0,20.0
35648,3,5648,[603 302 427 127  64],537,4,21235,3.7590724021950788,20.0,20.0
35649,3,5649,[435 121 238 215 403],892,4,21239,3.7591150442477876,0.0,0.0
35650,3,5650,[588 118 546 135   9],378,3,21242,3.758980711378517,0.0,0.0
35651,3,5651,[471 655 186  97 228],343,5,21247,3.7592002830856335,0.0,0.0
35652,3,5652,[216 183 257   4 282],334,3,21250,3.759065982664072,0.0,0.0
35653,3,5653,[603 302 427 127  64],666,5,21255,3.759285461620092,20.0,20.0
35654,3,5654,[132   9 172  97 215],85,4,21259,3.7593280282935457,0.0,0.0
35655,3,5655,[273 195 182  22 546],833,2,21261,3.7590169731258842,0.0,0.0
35656,3,5656,[200  79 423 153 546],666,3,21264,3.758882800070709,0.0,0.0
35657,3,5657,[405 172 273 211 294],666,1,21265,3.7583951926475785,0.0,0.0
35658,3,5658,[603 302 427 127  64],474,5,21270,3.758614596218413,20.0,20.0
35659,3,5659,[603 302 427 127  64],13,5,21275,3.758833922261484,20.0,20.0
35660,3,5660,[603 302 427 127  64],666,5,21280,3.7590531708178765,20.0,20.0
35661,3,5661,[603 302 427 127  64],90,5,21285,3.7592723419286473,20.0,20.0
35662,3,5662,[258 678 288 215 211],488,3,21288,3.7591382659367825,0.0,0.0
35663,3,5663,[318 197 300  95 588],313,4,21292,3.759180790960452,20.0,0.0
35664,3,5664,[ 69 265  89 328 357],13,3,21295,3.759046778464254,20.0,0.0
35665,3,5665,[  9 111  98 435 210],378,4,21299,3.7590893046240734,0.0,20.0
35666,3,5666,[238  25   4 597 151],279,5,21304,3.7593082759837655,0.0,0.0
35667,3,5667,[603 302 427 127  64],271,5,21309,3.7595271700776287,20.0,20.0
35668,3,5668,[403  28 202 313 748],92,2,21311,3.7592167930852,0.0,0.0
35669,3,5669,[168 179 180 211 603],749,5,21316,3.759435626102293,20.0,0.0
35670,3,5670,[603 302 427 127  64],537,4,21320,3.759478046199965,20.0,20.0
35671,3,5671,[182 125  50 496 143],533,4,21324,3.7595204513399154,0.0,20.0
35672,3,5672,[ 98 195 603 405  56],738,4,21328,3.759562841530055,20.0,20.0
35673,3,5673,[603 302 427 127  64],474,5,21333,3.7597814592879804,20.0,20.0
35674,3,5674,[121   4   7 179  12],343,4,21337,3.7598237885462553,20.0,0.0
35675,3,5675,[508 515 268   4   1],643,5,21342,3.7600422832980973,0.0,0.0
35676,3,5676,[603 302 427 127  64],13,5,21347,3.760260701074511,20.0,20.0
35677,3,5677,[  7 597 234 111 333],653,2,21349,3.759950686861571,0.0,0.0
35678,3,5678,[181 282 238 275 125],554,2,21351,3.7596407818277866,0.0,0.0
35679,3,5679,[603 302 427 127  64],537,4,21355,3.7596830985915495,20.0,20.0
35680,3,5680,[268  70  28  56 191],85,5,21360,3.759901425805316,0.0,0.0
35681,3,5681,[144 496 215  82  15],215,2,21362,3.759591693065822,0.0,0.0
35682,3,5682,[289   9 183 333 176],334,3,21365,3.759458032729192,0.0,0.0
35683,3,5683,[603 302 427 127  64],666,5,21370,3.7596762843068263,20.0,20.0
35684,3,5684,[135 313 121 191 515],537,4,21374,3.75971855760774,0.0,0.0
35685,3,5685,[603 302 427 127  64],666,5,21379,3.7599366865986634,20.0,20.0
35686,3,5686,[181 172 234  50 323],311,4,21383,3.7599788992438894,0.0,20.0
35687,3,5687,[603 302 427 127  64],745,4,21387,3.7600210970464136,20.0,20.0
35688,3,5688,[603 302 427 127  64],666,5,21392,3.7602390578309017,20.0,20.0
35689,3,5689,[603 302 427 127  64],664,5,21397,3.7604569420035148,20.0,20.0
35690,3,5690,[603 302 427 127  64],458,5,21402,3.760674749604639,20.0,20.0
35691,3,5691,[ 97  98 234 435 322],313,4,21406,3.7607167955024594,0.0,20.0
35692,3,5692,[323 300 273 268 100],537,2,21408,3.760407518004567,0.0,20.0
35693,3,5693,[603 302 427 127  64],745,4,21412,3.7604495960660342,20.0,20.0
35694,3,5694,[322 210 183 269 144],488,2,21414,3.760140474100088,0.0,0.0
35695,3,5695,[125 301  50 191 257],334,3,21417,3.76000702247191,0.0,20.0
35696,3,5696,[ 89   7 161  69 135],379,4,21421,3.760049148674741,0.0,0.0
35697,3,5697,[603 302 427 127  64],339,5,21426,3.7602667602667603,20.0,20.0
35698,3,5698,[603 302 427 127  64],664,5,21431,3.760484295490437,20.0,20.0
35699,3,5699,[328 275 111 475 228],13,2,21433,3.7601754385964914,0.0,0.0
35700,3,5700,[276   4 257  11  89],334,4,21437,3.760217505700754,0.0,0.0
35701,3,5701,[ 56 127 237 176  98],184,4,21441,3.7602595580498073,0.0,40.0
35702,3,5702,[603 302 427 127  64],339,5,21446,3.7604769419603716,20.0,20.0
35703,3,5703,[603 302 427 127  64],537,4,21450,3.7605189340813463,20.0,20.0
35704,3,5704,[603 302 427 127  64],474,5,21455,3.7607361963190185,20.0,20.0
35705,3,5705,[258 175 187 328  89],653,3,21458,3.760602874167543,0.0,0.0
35706,3,5706,[603 302 427 127  64],458,5,21463,3.7608200455580865,20.0,20.0
35707,3,5707,[ 88 313  79 180 546],13,3,21466,3.760686755430974,0.0,0.0
35708,3,5708,[185 168 135 210 187],13,3,21469,3.760553511998599,0.0,0.0
35709,3,5709,[322 191 318 265 245],488,2,21471,3.760245183887916,20.0,0.0
35710,3,5710,[742  11 546 289 210],374,4,21475,3.760287165119944,0.0,0.0
35711,3,5711,[118 238 471 186  82],308,3,21478,3.76015406162465,0.0,0.0
35712,3,5712,[655 276  71 196 405],184,3,21481,3.760021004726063,0.0,0.0
35713,3,5713,[186 117 238 135 194],897,3,21484,3.75988799439972,0.0,0.0
35714,3,5714,[385 678 237 435 117],455,1,21485,3.7594050743657044,0.0,0.0
35715,3,5715,[603 302 427 127  64],271,5,21490,3.75962211336599,20.0,20.0
35716,3,5716,[  9 211 405 655 508],343,5,21495,3.7598390764386918,0.0,0.0
35717,3,5717,[ 50 117 273 300 127],346,5,21500,3.760055963623645,0.0,40.0
35718,3,5718,[153 202   1 100 405],92,3,21503,3.7599230634726353,0.0,20.0
35719,3,5719,[ 22 508   4 357 435],387,3,21506,3.75979020979021,20.0,0.0
35720,3,5720,[210 385  50 496  70],474,5,21511,3.7600069917846533,0.0,20.0
35721,3,5721,[603 302 427 127  64],90,5,21516,3.7602236980076897,20.0,20.0
35722,3,5722,[515  64 191 333  11],488,3,21519,3.7600908614363098,0.0,0.0
35723,3,5723,[288 597 265   8  79],13,2,21521,3.759783368273934,0.0,0.0
35724,3,5724,[603 302 427 127  64],669,5,21526,3.76,20.0,20.0
35725,3,5725,[603 302 427 127  64],664,5,21531,3.760216556060077,20.0,20.0
35726,3,5726,[588 258 405 180 143],537,2,21533,3.759909202025493,0.0,0.0
35727,3,5727,[603 302 427 127  64],474,5,21538,3.7601256983240225,20.0,20.0
35728,3,5728,[568 286 357 210 435],533,4,21542,3.760167568511084,20.0,0.0
35729,3,5729,[405 172  25 215 181],533,4,21546,3.7602094240837696,0.0,0.0
35730,3,5730,[603 302 427 127  64],666,5,21551,3.7604257546675974,20.0,20.0
35731,3,5731,[423  95 588 211  69],85,4,21555,3.760467550593161,0.0,0.0
35732,3,5732,[603 302 427 127  64],458,5,21560,3.7606837606837606,20.0,20.0
35733,3,5733,[603 302 427 127  64],664,5,21565,3.7608998953610047,20.0,20.0
35734,3,5734,[118 185 100  98 210],454,3,21568,3.760767218831735,0.0,40.0
35735,3,5735,[603 302 427 127  64],458,5,21573,3.7609832635983262,20.0,20.0
35736,3,5736,[603 302 427 127  64],474,5,21578,3.761199233048632,20.0,20.0
35737,3,5737,[173  95 175 132 655],664,4,21582,3.7612408504705472,0.0,0.0
35738,3,5738,[603 302 427 127  64],745,4,21586,3.761282453389092,20.0,20.0
35739,3,5739,[603 302 427 127  64],537,4,21590,3.7613240418118465,20.0,20.0
35740,3,5740,[271 180 210  11  98],92,4,21594,3.7613656157463855,0.0,20.0
35741,3,5741,[385 269 235 183 403],650,3,21597,3.7612330198537096,0.0,0.0
35742,3,5742,[603 302 427 127  64],339,5,21602,3.76144872018109,20.0,20.0
35743,3,5743,[ 25 471 427  98 748],533,4,21606,3.761490250696379,0.0,20.0
35744,3,5744,[603 302 427 127  64],669,5,21611,3.761705831157528,20.0,20.0
35745,3,5745,[357 222 176 483   1],650,4,21615,3.761747302471284,40.0,0.0
35746,3,5746,[121 318 328 257  22],378,4,21619,3.7617887593527057,20.0,0.0
35747,3,5747,[200 151 237 427 196],308,3,21622,3.7616562282533055,0.0,0.0
35748,3,5748,[286 195  89 269 182],524,4,21626,3.761697686554183,0.0,0.0
35749,3,5749,[471 385  96 210 211],666,2,21628,3.761391304347826,0.0,0.0
35750,3,5750,[603 302 427 127  64],745,4,21632,3.761432794296644,20.0,20.0
35751,3,5751,[ 95 204 328 245 483],334,2,21634,3.761126564673157,20.0,0.0
35752,3,5752,[117 282  64 180  50],406,4,21638,3.7611680862158874,0.0,20.0
35753,3,5753,[385 288  12 168 200],374,4,21642,3.761209593326382,20.0,0.0
35754,3,5754,[603 302 427 127  64],90,5,21647,3.7614248479582972,20.0,20.0
35755,3,5755,[603 302 427 127  64],90,5,21652,3.7616400277970814,20.0,20.0
35756,3,5756,[185  89 603 117 222],234,1,21653,3.7611603265589717,20.0,0.0
35757,3,5757,[211  82 496 183  69],882,5,21658,3.7613754775963875,0.0,0.0
35758,3,5758,[273 174 515 175 318],213,5,21663,3.7615905539156103,20.0,20.0
35759,3,5759,[273 211   9 186 127],207,5,21668,3.7618055555555556,0.0,20.0
35760,3,5760,[603 302 427 127  64],458,5,21673,3.762020482555112,20.0,20.0
35761,3,5761,[258 546  88  50   7],145,4,21677,3.762061784102742,0.0,20.0
35762,3,5762,[ 98  88 603 515 168],883,4,21681,3.7621030713170223,20.0,20.0
35763,3,5763,[289 127  89 269 135],13,3,21684,3.761970853573907,0.0,20.0
35764,3,5764,[603 302 427 127  64],13,5,21689,3.7621856027753684,20.0,20.0
35765,3,5765,[191  69 175 185 271],843,2,21691,3.761879986125564,0.0,0.0
35766,3,5766,[603 302 427 127  64],664,5,21696,3.7620946766082883,20.0,20.0
35767,3,5767,[603 302 427 127  64],13,5,21701,3.7623092926490984,20.0,20.0
35768,3,5768,[603 302 427 127  64],537,4,21705,3.7623504940197607,20.0,20.0
35769,3,5769,[100 403 153 196 197],339,4,21709,3.7623916811091855,0.0,20.0
35770,3,5770,[603 302 427 127  64],458,5,21714,3.76260613411887,20.0,20.0
35771,3,5771,[161 210 191  28 202],13,3,21717,3.7624740124740126,0.0,0.0
35772,3,5772,[568  79 294  50  95],263,4,21721,3.7625151567642474,0.0,20.0
35773,3,5773,[118 210  89 168 276],374,3,21724,3.762383096640111,0.0,0.0
35774,3,5774,[603 302 427 127  64],669,5,21729,3.7625974025974025,20.0,20.0
35775,3,5775,[294 182 118 323 748],13,3,21732,3.762465373961219,0.0,0.0
35776,3,5776,[742  56 216  64 194],804,4,21736,3.7625064912584385,0.0,0.0
35777,3,5777,[ 25 483 204 179  11],339,4,21740,3.762547594323295,20.0,0.0
35778,3,5778,[ 69 176  98 111 322],749,4,21744,3.762588683163177,0.0,20.0
35779,3,5779,[423   1 276 186  89],343,4,21748,3.7626297577854673,0.0,0.0
35780,3,5780,[427 181  12 179 603],527,4,21752,3.762670818197544,40.0,0.0
35781,3,5781,[318 237 322 748 385],92,2,21754,3.7623659633344864,20.0,0.0
35782,3,5782,[222 161 235 197 286],13,2,21756,3.7620612139028187,0.0,0.0
35783,3,5783,[357 200 135 181 179],308,5,21761,3.7622752420470262,20.0,0.0
35784,3,5784,[318 546 173   4  71],455,1,21762,3.761797752808989,20.0,0.0
35785,3,5785,[181 546 143  22 515],881,5,21767,3.7620117525060492,0.0,0.0
35786,3,5786,[603 302 427 127  64],13,5,21772,3.7622256782443406,20.0,20.0
35787,3,5787,[603 302 427 127  64],90,5,21777,3.762439530062198,20.0,20.0
35788,3,5788,[132 678 496 271 300],537,1,21778,3.761962342373467,0.0,0.0
35789,3,5789,[200  28  88 328  22],313,1,21779,3.7614853195164075,0.0,0.0
35790,3,5790,[ 98 655  88 546 195],313,4,21783,3.7615265066482473,0.0,20.0
35791,3,5791,[132  69 144 121 655],843,0,21783,3.7608770718232045,0.0,0.0
35792,3,5792,[603 302 427 127  64],90,5,21788,3.761090971862593,20.0,20.0
35793,3,5793,[603 302 427 127  64],90,5,21793,3.761304798066966,20.0,20.0
35794,3,5794,[  4 195 273  11  22],59,4,21797,3.7613459879206212,0.0,0.0
35795,3,5795,[603 302 427 127  64],666,5,21802,3.7615596963423052,20.0,20.0
35796,3,5796,[196 423 183 185 265],474,5,21807,3.761773331033293,0.0,0.0
35797,3,5797,[  8  25  89 204 475],452,2,21809,3.7614694722318043,0.0,0.0
35798,3,5798,[603 302 427 127  64],458,5,21814,3.7616830488015176,20.0,20.0
35799,3,5799,[405 196 121 568 179],881,4,21818,3.7617241379310347,0.0,0.0
35800,3,5800,[245  79 185 132 204],313,4,21822,3.7617652128943284,0.0,0.0
35801,3,5801,[496  11 403 179 742],387,1,21823,3.761289210617029,0.0,0.0
35802,3,5802,[603 302 427 127  64],669,5,21828,3.7615026710322246,20.0,20.0
35803,3,5803,[228 323 597  89 182],788,1,21829,3.761026878015162,0.0,0.0
35804,3,5804,[144 357 143  50 175],385,2,21831,3.7607235142118864,20.0,20.0
35805,3,5805,[313 245 257  95  12],455,3,21834,3.760592490527041,20.0,0.0
35806,3,5806,[568 471   4  88 234],378,3,21837,3.7604615119683142,0.0,0.0
35807,3,5807,[357 588  22  96 118],7,4,21841,3.7605027548209367,20.0,0.0
35808,3,5808,[603 302 427 127  64],664,5,21846,3.7607161301428818,20.0,20.0
35809,3,5809,[748 127 194 135 175],207,2,21848,3.7604130808950087,0.0,20.0
35810,3,5810,[603 302 427 127  64],339,5,21853,3.7606263982102908,20.0,20.0
35811,3,5811,[289 174   8  15  95],378,5,21858,3.7608396421197523,0.0,20.0
35812,3,5812,[197 318 195 151 273],213,5,21863,3.7610528126612763,20.0,0.0
35813,3,5813,[204 546  28 228 127],455,4,21867,3.76109391124871,0.0,20.0
35814,3,5814,[603 302 427 127  64],474,5,21872,3.7613069647463457,20.0,20.0
35815,3,5815,[ 96 118 195  56  89],308,4,21876,3.761348005502063,0.0,0.0
35816,3,5816,[302 678 238  11 282],334,4,21880,3.761389032147155,0.0,0.0
35817,3,5817,[655 496   8 385  98],387,2,21882,3.7610862839463732,0.0,20.0
35818,3,5818,[186 333 276  70  11],10,5,21887,3.761299192301083,0.0,0.0
35819,3,5819,[603 302 427 127  64],666,5,21892,3.761512027491409,20.0,20.0
35820,3,5820,[216 228 276 111  11],59,5,21897,3.761724789555059,0.0,0.0
35821,3,5821,[143  88  96 508   9],474,4,21901,3.761765716248712,0.0,0.0
35822,3,5822,[ 11 328  25 204 273],234,0,21901,3.7611196977503005,0.0,0.0
35823,3,5823,[603 302 427 127  64],458,5,21906,3.7613324175824174,20.0,20.0
35824,3,5824,[ 12 423 546 196 385],343,3,21909,3.7612017167381975,20.0,0.0
35825,3,5825,[ 50 172 143 151 191],334,3,21912,3.761071060762101,0.0,20.0
35826,3,5826,[288 194  70 286  11],119,4,21916,3.761112064527201,0.0,0.0
35827,3,5827,[143 161 153 471  82],308,3,21919,3.760981468771448,0.0,0.0
35828,3,5828,[471 175 568 294 222],537,1,21920,3.7605078057985932,0.0,0.0
35829,3,5829,[603 302 427 127  64],669,5,21925,3.760720411663808,20.0,20.0
35830,3,5830,[603 302 427 127  64],666,5,21930,3.760932944606414,20.0,20.0
35831,3,5831,[ 97  70 237 200 161],378,4,21934,3.760973936899863,0.0,0.0
35832,3,5832,[ 11 180 185 132 135],90,5,21939,3.7611863535059147,0.0,0.0
35833,3,5833,[151 568 245 153 228],749,5,21944,3.761398697291738,0.0,0.0
35834,3,5834,[300 210  50  70 234],13,2,21946,3.7610968294772924,0.0,20.0
35835,3,5835,[603 302 427 127  64],664,5,21951,3.7613091158327623,20.0,20.0
35836,3,5836,[ 98 286 125  97 135],881,3,21954,3.7611786876820283,0.0,20.0
35837,3,5837,[ 12 234 191 435 121],233,4,21958,3.76121959575197,20.0,0.0
35838,3,5838,[197 597 234 194 195],452,4,21962,3.761260489809899,0.0,0.0
35839,3,5839,[  4 181 179  96 200],881,2,21964,3.760958904109589,0.0,0.0
35840,3,5840,[603 302 427 127  64],13,5,21969,3.761171032357473,20.0,20.0
35841,3,5841,[603 302 427 127  64],90,5,21974,3.7613830879835675,20.0,20.0
35842,3,5842,[603 302 427 127  64],339,5,21979,3.7615950710251584,20.0,20.0
35843,3,5843,[603 302 427 127  64],474,5,21984,3.761806981519507,20.0,20.0
35844,3,5844,[603 302 427 127  64],474,5,21989,3.7620188195038495,20.0,20.0
35845,3,5845,[603 302 427 127  64],458,5,21994,3.762230585015395,20.0,20.0
35846,3,5846,[603 302 427 127  64],664,5,21999,3.7624422780913287,20.0,20.0
35847,3,5847,[238 127 588 173 195],7,5,22004,3.76265389876881,0.0,20.0
35848,3,5848,[172 125 118  79 179],378,3,22007,3.762523508292016,0.0,0.0
35849,3,5849,[385 186 172 435 282],378,4,22011,3.762564102564103,0.0,0.0
35850,3,5850,[603 302 427 127  64],669,5,22016,3.76277559391557,20.0,20.0
35851,3,5851,[ 97  71 194 222 748],13,4,22020,3.7628161312371837,0.0,0.0
35852,3,5852,[588   9  56 323  25],881,0,22020,3.7621732444900053,0.0,0.0
35853,3,5853,[276 294  95 237 228],406,2,22022,3.7618722241202596,0.0,0.0
35854,3,5854,[603 302 427 127  64],13,5,22027,3.7620836891545686,20.0,20.0
35855,3,5855,[603 200 187 385  70],543,4,22031,3.762124316939891,20.0,0.0
35856,3,5856,[ 50 185  12 210 196],271,4,22035,3.762164930851972,20.0,20.0
35857,3,5857,[385 235 127  97 655],343,4,22039,3.7622055308979174,0.0,20.0
35858,3,5858,[258 300  82 423 228],313,2,22041,3.761904761904762,0.0,0.0
35859,3,5859,[357 210 215 568  28],7,5,22046,3.7621160409556316,20.0,0.0
35860,3,5860,[187 268 144 385  50],643,4,22050,3.7621566285616788,0.0,20.0
35861,3,5861,[435 258  96 265 257],455,5,22055,3.7623677925622654,0.0,0.0
35862,3,5862,[322  89 216 328 655],234,0,22055,3.7617260787992497,0.0,0.0
35863,3,5863,[ 28  79 273  69 508],537,1,22056,3.761255115961801,0.0,0.0
35864,3,5864,[132 191 215  25  71],308,3,22059,3.7611253196930945,0.0,0.0
35865,3,5865,[196 197 179 385 588],308,3,22062,3.7609955676781452,0.0,0.0
35866,3,5866,[603 302 427 127  64],664,5,22067,3.761206749616499,20.0,20.0
35867,3,5867,[357 174  15 172  22],234,2,22069,3.760906612133606,20.0,20.0
35868,3,5868,[ 69 181 258 216 403],184,2,22071,3.7606065769296304,0.0,0.0
35869,3,5869,[ 64 483  89 423  69],328,5,22076,3.760817717206133,20.0,0.0
35870,3,5870,[180 172  22 185 182],13,4,22080,3.7608584568216656,0.0,0.0
35871,3,5871,[  4 143 269 475 118],13,2,22082,3.760558583106267,0.0,0.0
35872,3,5872,[  4 322 496 204 655],474,5,22087,3.7607696237016857,0.0,0.0
35873,3,5873,[588 117 234 282 125],378,3,22090,3.760640108954716,0.0,0.0
35874,3,5874,[405 173 144  25 245],804,5,22095,3.7608510638297874,0.0,0.0
35875,3,5875,[403 118 228  22 100],87,4,22099,3.7608917631041523,0.0,20.0
35876,3,5876,[603 302 427 127  64],271,5,22104,3.761102603369066,20.0,20.0
35877,3,5877,[603 302 427 127  64],90,5,22109,3.7613133718952025,20.0,20.0
35878,3,5878,[603 302 427 127  64],745,4,22113,3.7613539717639055,20.0,20.0
35879,3,5879,[603 302 427 127  64],13,5,22118,3.7615646258503403,20.0,20.0
35880,3,5880,[175 323  22 257  64],883,4,22122,3.7616051691889134,0.0,0.0
35881,3,5881,[289 568  89  50 228],374,2,22124,3.7613056783407006,0.0,20.0
35882,3,5882,[496 174  96  25 135],378,3,22127,3.7611762706102327,0.0,20.0
35883,3,5883,[228 172 273 603 269],145,5,22132,3.761386811692726,20.0,0.0
35884,3,5884,[265 197 161 496 234],308,0,22132,3.7607476635514017,0.0,0.0
35885,3,5885,[235  50 423 211  11],560,4,22136,3.760788311247027,0.0,20.0
35886,3,5886,[385  15 318 135 435],234,2,22138,3.760489213521318,20.0,0.0
35887,3,5887,[173  79 301 202 275],145,4,22142,3.7605298913043477,0.0,0.0
35888,3,5888,[322 323 182  15 588],537,1,22143,3.760061130922058,0.0,0.0
35889,3,5889,[195 403 234 257 196],650,3,22146,3.7599320882852294,0.0,0.0
35890,3,5890,[ 98 216 143 181 257],815,3,22149,3.759803089458496,0.0,20.0
35891,3,5891,[181  12  89  64 333],13,4,22153,3.7598438560760354,20.0,0.0
35892,3,5892,[328 318 200 117 195],479,4,22157,3.759884608857967,20.0,0.0
35893,3,5893,[603 302 427 127  64],90,5,22162,3.7600950118764844,20.0,20.0
35894,3,5894,[603 302 427 127  64],474,5,22167,3.76030534351145,20.0,20.0
35895,3,5895,[313  89 210  22 603],64,2,22169,3.760006784260516,20.0,0.0
35896,3,5896,[ 12 275 515 195 294],13,1,22170,3.759538748516195,20.0,0.0
35897,3,5897,[603 302 427 127  64],745,4,22174,3.759579518480841,20.0,20.0
35898,3,5898,[273 237 245 183 423],378,4,22178,3.7596202746228173,0.0,0.0
35899,3,5899,[603 302 427 127  64],458,5,22183,3.7598305084745762,20.0,20.0
35900,3,5900,[ 89 176 496  71   7],380,3,22186,3.75970174546687,0.0,0.0
35901,3,5901,[132 135 228  70   4],653,2,22188,3.759403592002711,0.0,0.0
35902,3,5902,[179 194 237 235 173],194,3,22191,3.759274944943249,0.0,0.0
35903,3,5903,[323 204 237  64  12],454,3,22194,3.7591463414634148,20.0,0.0
35904,3,5904,[ 71 268 748   4 294],13,4,22198,3.759187129551228,0.0,0.0
35905,3,5905,[603 302 427 127  64],458,5,22203,3.7593972231628854,20.0,20.0
35906,3,5906,[603 302 427 127  64],458,5,22208,3.759607245640765,20.0,20.0
35907,3,5907,[175 742 423 322 185],881,4,22212,3.759647935003385,0.0,0.0
35908,3,5908,[215 265 597 313 202],533,3,22215,3.759519377221188,0.0,0.0
35909,3,5909,[603 302 427 127  64],458,5,22220,3.759729272419628,20.0,20.0
35910,3,5910,[603 302 427 127  64],13,5,22225,3.75993909659956,20.0,20.0
35911,3,5911,[588 603  22 215  69],804,5,22230,3.760148849797023,20.0,0.0
35912,3,5912,[117 161 435  64 179],271,3,22233,3.7600202942668695,0.0,0.0
35913,3,5913,[427 357 172 216 182],59,5,22238,3.7602299628001354,20.0,0.0
35914,3,5914,[603 302 427 127  64],271,5,22243,3.7604395604395604,20.0,20.0
35915,3,5915,[742 211 294  98 195],188,3,22246,3.760311020960108,0.0,20.0
35916,3,5916,[603 302 427 127  64],90,5,22251,3.7605205340544194,20.0,20.0
35917,3,5917,[286 200 234   9 427],380,3,22254,3.760392024332545,0.0,0.0
35918,3,5918,[603 302 427 127  64],664,5,22259,3.760601452948133,20.0,20.0
35919,3,5919,[ 88 286  98 471 238],378,3,22262,3.760472972972973,0.0,20.0
35920,3,5920,[ 69 427  70  50 181],194,2,22264,3.760175646005742,0.0,20.0
35921,3,5921,[588  22 202 100 328],234,2,22266,3.7598784194528876,0.0,20.0
35922,3,5922,[ 89 300 748 328  28],653,5,22271,3.7600877933479655,0.0,0.0
35923,3,5923,[603 302 427 127  64],666,5,22276,3.7602970965563807,20.0,20.0
35924,3,5924,[ 71 204  69 427 185],59,4,22280,3.760337552742616,0.0,0.0
35925,3,5925,[603 302 427 127  64],339,5,22285,3.7605467431657105,20.0,20.0
35926,3,5926,[475 471  95  96 427],374,3,22288,3.760418424160621,0.0,0.0
35927,3,5927,[603 302 427 127  64],669,5,22293,3.7606275303643724,20.0,20.0
35928,3,5928,[197 238 173 195 435],648,3,22296,3.7604992410187217,0.0,0.0
35929,3,5929,[ 50  71 655 318 403],848,5,22301,3.76070826306914,20.0,20.0
35930,3,5930,[603 302 427 127  64],745,4,22305,3.760748609003541,20.0,20.0
35931,3,5931,[ 25 435 183 210 245],804,4,22309,3.7607889413351314,0.0,0.0
35932,3,5932,[276 475 100 273 111],157,3,22312,3.7606607112759143,0.0,20.0
35933,3,5933,[179 742 185 182  79],833,3,22315,3.760532524435457,0.0,0.0
35934,3,5934,[195 405 357 588 222],892,5,22320,3.7607413647851726,20.0,0.0
35935,3,5935,[ 95 182 748 144 234],64,3,22323,3.76061320754717,0.0,0.0
35936,3,5936,[603 302 427 127  64],669,5,22328,3.7608219639548595,20.0,20.0
35937,3,5937,[515 483  50 173 302],13,3,22331,3.7606938363085214,20.0,20.0
35938,3,5938,[322  25 268 132  50],13,3,22334,3.760565751810069,0.0,20.0
35939,3,5939,[403 183 100 175 546],378,4,22338,3.7606060606060607,0.0,20.0
35940,3,5940,[603 302 427 127  64],669,5,22343,3.760814677663693,20.0,20.0
35941,3,5941,[216 288   9 568 385],374,4,22347,3.7608549309996633,0.0,0.0
35942,3,5942,[216 357 172 234 435],13,3,22350,3.7607269056032306,20.0,0.0
35943,3,5943,[603 302 427 127  64],664,5,22355,3.760935397039031,20.0,20.0
35944,3,5944,[211 202  95 318 238],543,2,22357,3.7606391925988225,20.0,0.0
35945,3,5945,[  4 742 186  50 258],59,3,22360,3.760511268079381,0.0,20.0
35946,3,5946,[603 302 427 127  64],90,5,22365,3.7607196906003026,20.0,20.0
35947,3,5947,[117 202 427 172 204],374,2,22367,3.7604236718224615,0.0,0.0
35948,3,5948,[603 302 427 127  64],664,5,22372,3.760632038998151,20.0,20.0
35949,3,5949,[289 222 273  82 269],537,0,22372,3.76,0.0,0.0
35950,3,5950,[603 302 427 127  64],339,5,22377,3.760208368341455,20.0,20.0
35951,3,5951,[603 302 427 127  64],664,5,22382,3.7604166666666665,20.0,20.0
35952,3,5952,[276 215 180 357 168],474,4,22386,3.760456912481102,20.0,0.0
35953,3,5953,[153 423  11   7 301],184,1,22387,3.759993281827343,0.0,0.0
35954,3,5954,[194  88   4  56 508],537,2,22389,3.759697732997481,0.0,0.0
35955,3,5955,[ 28 173  70 181 191],398,5,22394,3.759905977165883,0.0,0.0
35956,3,5956,[603 302 427 127  64],339,5,22399,3.7601141514184993,20.0,20.0
35957,3,5957,[  4   7 435 515 258],474,5,22404,3.7603222557905336,0.0,0.0
35958,3,5958,[597 546   8 200  89],92,2,22406,3.7600268501426415,0.0,0.0
35959,3,5959,[ 11   7  89 202  97],7,3,22409,3.7598993288590603,0.0,0.0
35960,3,5960,[603 302 427 127  64],664,5,22414,3.7601073645361516,20.0,20.0
35961,3,5961,[245 258 210  11 322],102,1,22415,3.7596444146259644,0.0,0.0
35962,3,5962,[161  97 222 151 435],804,3,22418,3.759517021633406,0.0,0.0
35963,3,5963,[174 216 655 678 132],308,2,22420,3.759221998658618,0.0,20.0
35964,3,5964,[603 302 427 127  64],666,5,22425,3.7594300083822296,20.0,20.0
35965,3,5965,[186  22 268  88 127],234,2,22427,3.759135098893731,0.0,20.0
35966,3,5966,[603 302 427 127  64],666,5,22432,3.7593430534607006,20.0,20.0
35967,3,5967,[603 302 427 127  64],664,5,22437,3.7595509383378016,20.0,20.0
35968,3,5968,[153 172  70  88 197],308,4,22441,3.759591221310102,0.0,0.0
35969,3,5969,[118 127 405 403  28],533,3,22444,3.759463986599665,0.0,20.0
35970,3,5970,[111 127 228   8 168],334,4,22448,3.7595042706414334,0.0,20.0
35971,3,5971,[568 427   8  79 286],385,2,22450,3.759209645010047,0.0,0.0
35972,3,5972,[435 204 176 357 191],406,5,22455,3.7594173782019085,20.0,0.0
35973,3,5973,[603 302 427 127  64],745,4,22459,3.759457649815869,20.0,20.0
35974,3,5974,[603 302 427 127  64],474,5,22464,3.759665271966527,20.0,20.0
35975,3,5975,[ 69 222 174  64 191],360,2,22466,3.7593708165997324,0.0,20.0
35976,3,5976,[237 204  50  56 257],92,4,22470,3.7594110757905304,0.0,20.0
35977,3,5977,[603 302 427 127  64],271,5,22475,3.759618601538976,20.0,20.0
35978,3,5978,[ 56 475  15 403  89],308,4,22479,3.7596588058203713,0.0,0.0
35979,3,5979,[318 185 588 237 183],194,3,22482,3.759531772575251,20.0,0.0
35980,3,5980,[333 172 176 100  98],533,4,22486,3.759571977930112,0.0,40.0
35981,3,5981,[603 302 427 127  64],666,5,22491,3.759779338014042,20.0,20.0
35982,3,5982,[508 475 597  79 235],92,3,22494,3.7596523483202406,0.0,0.0
35983,3,5983,[603 302 427 127  64],664,5,22499,3.759859625668449,20.0,20.0
35984,3,5984,[222 211 210 121 168],932,4,22503,3.7598997493734334,0.0,0.0
35985,3,5985,[603 302 427 127  64],474,5,22508,3.7601069161376546,20.0,20.0
35986,3,5986,[603 302 427 127  64],458,5,22513,3.760314013696342,20.0,20.0
35987,3,5987,[181 175  82 196  79],669,3,22516,3.760187040748163,0.0,0.0
35988,3,5988,[385 265 174  70 496],59,4,22520,3.760227082985473,0.0,20.0
35989,3,5989,[294 357 175   1 191],10,3,22523,3.760100166944908,20.0,0.0
35990,3,5990,[603 302 427 127  64],537,4,22527,3.7601402103154733,20.0,20.0
35991,3,5991,[603 302 427 127  64],474,5,22532,3.760347129506008,20.0,20.0
35992,3,5992,[ 25  15 176 121 132],184,3,22535,3.760220256966461,0.0,0.0
35993,3,5993,[603 302 427 127  64],90,5,22540,3.760427093760427,20.0,20.0
35994,3,5994,[186 135 175 181 196],738,5,22545,3.760633861551293,0.0,0.0
35995,3,5995,[603 302 427 127  64],339,5,22550,3.7608405603735826,20.0,20.0
35996,3,5996,[322 289 204 237   4],334,2,22552,3.760546940136735,0.0,0.0
35997,3,5997,[435  25 202 265 200],271,4,22556,3.760586862287429,0.0,0.0
35998,3,5998,[403  11  82 228 273],387,3,22559,3.7604600766794465,0.0,0.0
35999,3,5999,[121 678 195 176 471],13,1,22560,3.76,0.0,0.0
36000,3,6000,[211 748 222 151  50],648,3,22563,3.7598733544409266,0.0,20.0
36001,3,6001,[  9 483 153 185 196],374,2,22565,3.759580139953349,20.0,0.0
36002,3,6002,[144  25   7 403 294],7,3,22568,3.759453606530068,0.0,0.0
36003,3,6003,[300 289 237 216 318],13,1,22569,3.7589940039973353,20.0,0.0
36004,3,6004,[ 95 183  69 515 100],650,3,22572,3.7588676103247294,0.0,20.0
36005,3,6005,[151 202  50 186 597],897,4,22576,3.758907758907759,0.0,20.0
36006,3,6006,[568 423 173 258 172],538,2,22578,3.7586149492259033,0.0,0.0
36007,3,6007,[302  64   7 245 322],346,2,22580,3.7583222370173104,0.0,0.0
36008,3,6008,[  4 427 210 191 483],194,4,22584,3.7583624563155267,20.0,0.0
36009,3,6009,[237 405   8  88 748],883,3,22587,3.758236272878536,0.0,0.0
36010,3,6010,[111 186 100 405  88],374,3,22590,3.7581101314257195,0.0,20.0
36011,3,6011,[187 328 151 228 180],537,2,22592,3.7578176979374582,0.0,0.0
36012,3,6012,[273 216   1 301 655],13,1,22593,3.75735905538001,0.0,0.0
36013,3,6013,[135 238 195 275  28],843,2,22595,3.757066844030595,0.0,0.0
36014,3,6014,[100 111 172  97 515],87,5,22600,3.7572734829592687,0.0,20.0
36015,3,6015,[ 12 245 508   1  15],533,4,22604,3.757313829787234,20.0,0.0
36016,3,6016,[597  79  70 294 269],452,4,22608,3.7573541632042544,0.0,0.0
36017,3,6017,[269  82 127  12  88],13,3,22611,3.7572283150548356,20.0,20.0
36018,3,6018,[496 302  95  22   9],380,4,22615,3.7572686492772887,0.0,0.0
36019,3,6019,[603 302 427 127  64],90,5,22620,3.7574750830564785,20.0,20.0
36020,3,6020,[  4 405  96 742 151],59,3,22623,3.75734927752865,0.0,0.0
36021,3,6021,[ 96 172 435 121   9],406,5,22628,3.757555629359017,0.0,0.0
36022,3,6022,[161 273 597 127 117],207,3,22631,3.7574298522331064,0.0,20.0
36023,3,6023,[313 435 191 288  69],474,4,22635,3.7574701195219125,0.0,0.0
36024,3,6024,[603 302 427 127  64],90,5,22640,3.757676348547718,20.0,20.0
36025,3,6025,[127  64 210   7 423],346,4,22644,3.757716561566545,0.0,20.0
36026,3,6026,[603 302 427 127  64],90,5,22649,3.757922681267629,20.0,20.0
36027,3,6027,[568 202 182 168 144],313,4,22653,3.7579628400796286,0.0,0.0
36028,3,6028,[144  50  71  97  25],374,4,22657,3.758002985569746,0.0,20.0
36029,3,6029,[211 271 385  95 191],290,2,22659,3.7577114427860696,0.0,0.0
36030,3,6030,[234 273   8 111  71],13,4,22663,3.7577516166473224,0.0,0.0
36031,3,6031,[603 302 427 127  64],90,5,22668,3.7579575596816976,20.0,20.0
36032,3,6032,[222  79 125 135 546],749,3,22671,3.7578319244157137,0.0,0.0
36033,3,6033,[168  25  82  96 403],934,5,22676,3.7580377858800134,0.0,0.0
36034,3,6034,[  1 403 238  97 235],738,3,22679,3.7579121789560896,0.0,0.0
36035,3,6035,[435 100 483  79 194],788,4,22683,3.7579522862823063,20.0,20.0
36036,3,6036,[ 79 180 195  95 143],897,4,22687,3.7579923803213515,0.0,0.0
36037,3,6037,[ 12 172 183 271 405],334,2,22689,3.757701225571381,20.0,0.0
36038,3,6038,[127  50 135 568  22],533,4,22693,3.757741347905282,0.0,40.0
36039,3,6039,[216  25 181 125 435],648,3,22696,3.757615894039735,0.0,0.0
36040,3,6040,[322 603 194  98  12],234,3,22699,3.7574904817083263,40.0,20.0
36041,3,6041,[121 258 245  89  79],313,3,22702,3.757365110890434,0.0,0.0
36042,3,6042,[403 194  15  50 197],313,3,22705,3.7572397815654477,0.0,20.0
36043,3,6043,[ 98 286 515 194  56],339,5,22710,3.757445400397088,0.0,20.0
36044,3,6044,[125 127  98   1 118],121,3,22713,3.7573200992555833,0.0,40.0
36045,3,6045,[  8 222 182 197 215],474,5,22718,3.757525636784651,0.0,0.0
36046,3,6046,[496 195   7 238 153],804,5,22723,3.7577311063337193,0.0,0.0
36047,3,6047,[ 82  79 238  25 222],648,3,22726,3.75760582010582,0.0,0.0
36048,3,6048,[603 302 427 127  64],745,4,22730,3.757645891882956,20.0,20.0
36049,3,6049,[118 210 496 546  89],194,1,22731,3.757190082644628,0.0,0.0
36050,3,6050,[603 302 427 127  64],664,5,22736,3.7573954718228393,20.0,20.0
36051,3,6051,[191 186 185 179 515],59,5,22741,3.7576007931262394,0.0,0.0
36052,3,6052,[135  28 603 185  25],271,3,22744,3.7574756319180573,20.0,0.0
36053,3,6053,[288   1 588 655 234],308,4,22748,3.757515692104394,0.0,0.0
36054,3,6054,[603 302 427 127  64],339,5,22753,3.757720891824938,20.0,20.0
36055,3,6055,[  7 194 257 258 216],465,4,22757,3.7577608982826947,0.0,0.0
36056,3,6056,[603 302 427 127  64],669,5,22762,3.7579659897639095,20.0,20.0
36057,3,6057,[  7 318 180 435 273],666,4,22766,3.758005942555299,20.0,0.0
36058,3,6058,[174  69 235 385 172],524,2,22768,3.7577157946855917,0.0,20.0
36059,3,6059,[603 302 427 127  64],458,5,22773,3.757920792079208,20.0,20.0
36060,3,6060,[125 427 204  22 276],6,1,22774,3.7574657647252927,0.0,0.0
36061,3,6061,[603 302 427 127  64],669,5,22779,3.757670735730782,20.0,20.0
36062,3,6062,[183 143 282 127 135],666,3,22782,3.7575457694210788,0.0,20.0
36063,3,6063,[117 202  95 118 187],271,3,22785,3.757420844327177,0.0,0.0
36064,3,6064,[196  64 435 143 180],892,4,22789,3.7574608408903547,0.0,0.0
36065,3,6065,[405  28 546 196 172],7,4,22793,3.757500824266403,0.0,0.0
36066,3,6066,[597  28 118 237 215],308,0,22793,3.7568814900280203,0.0,0.0
36067,3,6067,[ 22 151 288 238 173],334,4,22797,3.7569215557020437,0.0,0.0
36068,3,6068,[603 302 427 127  64],474,5,22802,3.75712637996375,20.0,20.0
36069,3,6069,[603 302 427 127  64],664,5,22807,3.757331136738056,20.0,20.0
36070,3,6070,[423  88 588 172  98],326,2,22809,3.7570416735298964,0.0,20.0
36071,3,6071,[ 71 496  82 211 187],308,4,22813,3.7570816864295127,0.0,0.0
36072,3,6072,[603 302 427 127  64],745,4,22817,3.7571216861518195,20.0,20.0
36073,3,6073,[200 301 173   4  98],537,1,22818,3.756667764241027,0.0,20.0
36074,3,6074,[603 302 427 127  64],474,5,22823,3.7568724279835393,20.0,20.0
36075,3,6075,[603 302 427 127  64],669,5,22828,3.7570770243581304,20.0,20.0
36076,3,6076,[ 70  28 127  71  82],234,2,22830,3.756787888760902,0.0,20.0
36077,3,6077,[ 88 132  64 496 135],378,3,22833,3.756663376110563,0.0,0.0
36078,3,6078,[118  50 127 234 211],738,3,22836,3.75653890442507,0.0,40.0
36079,3,6079,[216 125 508 228 294],406,1,22837,3.7560855263157893,0.0,0.0
36080,3,6080,[  7 435 302 328  50],13,3,22840,3.7559611905936525,0.0,20.0
36081,3,6081,[603 302 427 127  64],745,4,22844,3.7560013153567904,20.0,20.0
36082,3,6082,[603 302 427 127  64],13,5,22849,3.7562058194969588,20.0,20.0
36083,3,6083,[174  89  98  50 273],524,3,22852,3.7560815253122946,0.0,60.0
36084,3,6084,[603 302 427 127  64],474,5,22857,3.7562859490550533,20.0,20.0
36085,3,6085,[603 302 427 127  64],666,5,22862,3.7564903056194545,20.0,20.0
36086,3,6086,[546 235 403  11 385],64,4,22866,3.7565303104977823,0.0,0.0
36087,3,6087,[210 423 117 196 273],537,0,22866,3.7559132720105124,0.0,0.0
36088,3,6088,[603 269 183 202 185],13,3,22869,3.7557891279356217,20.0,0.0
36089,3,6089,[181 174 194   8 175],158,4,22873,3.7558292282430212,0.0,20.0
36090,3,6090,[234 228  82 202 515],95,3,22876,3.755705138729273,0.0,0.0
36091,3,6091,[603 302 427 127  64],271,5,22881,3.755909389363099,20.0,20.0
36092,3,6092,[228 427 111   8 175],234,2,22883,3.7556212046610864,0.0,0.0
36093,3,6093,[111 678 318 127  95],537,2,22885,3.7553331145388906,20.0,20.0
36094,3,6094,[603 302 427 127  64],339,5,22890,3.755537325676784,20.0,20.0
36095,3,6095,[603 302 427 127  64],664,5,22895,3.755741469816273,20.0,20.0
36096,3,6096,[238  25 427 588  50],14,4,22899,3.7557815319009347,0.0,20.0
36097,3,6097,[237 238 268 568 132],85,2,22901,3.755493604460479,0.0,0.0
36098,3,6098,[258 318  56 187 204],533,4,22905,3.7555336940482045,20.0,0.0
36099,3,6099,[  7 127 275 258 132],843,2,22907,3.7552459016393445,0.0,20.0
36100,3,6100,[202 597 294 197  71],95,3,22910,3.755122111129323,0.0,0.0
36101,3,6101,[222 257 546 333 151],548,4,22914,3.7551622418879056,0.0,0.0
36102,3,6102,[597 222 238 216  96],13,1,22915,3.754710797968212,0.0,0.0
36103,3,6103,[186 196  22 172  89],92,4,22919,3.7547509829619923,0.0,0.0
36104,3,6104,[182 151 121 191 172],64,3,22922,3.7546273546273548,0.0,0.0
36105,3,6105,[603 302 427 127  64],271,5,22927,3.7548313134621685,20.0,20.0
36106,3,6106,[237  25 194 294 180],406,2,22929,3.754543965940724,0.0,0.0
36107,3,6107,[118 191 238 333 100],653,3,22932,3.7544204322200394,0.0,20.0
36108,3,6108,[603 302 427 127  64],13,5,22937,3.7546243247667377,20.0,20.0
36109,3,6109,[603 302 427 127  64],666,5,22942,3.7548281505728314,20.0,20.0
36110,3,6110,[603 302 427 127  64],458,5,22947,3.755031909671085,20.0,20.0
36111,3,6111,[471 357 405 174 286],6,2,22949,3.754744764397906,20.0,20.0
36112,3,6112,[ 69  11 196  12 313],59,5,22954,3.754948470472763,20.0,0.0
36113,3,6113,[175 196 475   8 216],207,2,22956,3.7546614327772327,0.0,0.0
36114,3,6114,[ 71  22  89 121 508],378,5,22961,3.754865085854456,0.0,0.0
36115,3,6115,[182 322 273 276  95],374,4,22965,3.7549051667756705,0.0,0.0
36116,3,6116,[ 98 174 161  11 427],334,4,22969,3.75494523459212,0.0,40.0
36117,3,6117,[475 282 172   9 313],533,4,22973,3.7549852893102322,0.0,0.0
36118,3,6118,[603 302 427 127  64],666,5,22978,3.755188756332734,20.0,20.0
36119,3,6119,[323 245 153 132 216],378,3,22981,3.755065359477124,0.0,0.0
36120,3,6120,[603 302 427 127  64],90,5,22986,3.755268746936775,20.0,20.0
36121,3,6121,[196 195 168  88  70],474,4,22990,3.7553087226396604,0.0,0.0
36122,3,6122,[179 195 125 132 204],92,4,22994,3.755348685284991,0.0,0.0
36123,3,6123,[603 302 427 127  64],537,4,22998,3.755388634879164,20.0,20.0
36124,3,6124,[603 302 427 127  64],745,4,23002,3.7554285714285713,20.0,20.0
36125,3,6125,[186   4 174  89   7],87,5,23007,3.755631733594515,0.0,20.0
36126,3,6126,[603 302 427 127  64],669,5,23012,3.755834829443447,20.0,20.0
36127,3,6127,[195 496 313 179 228],64,5,23017,3.756037859007833,0.0,0.0
36128,3,6128,[186 187 144  22 655],840,2,23019,3.755751346059716,0.0,0.0
36129,3,6129,[427 191 275 286 423],343,5,23024,3.7559543230016312,0.0,0.0
36130,3,6130,[588 117 127 111 515],537,2,23026,3.7556679171423912,0.0,20.0
36131,3,6131,[603 302 427 127  64],664,5,23031,3.7558708414872797,20.0,20.0
36132,3,6132,[323 300 748 228 186],488,4,23035,3.7559106473177892,0.0,0.0
36133,3,6133,[603 302 427 127  64],474,5,23040,3.7561134659276165,20.0,20.0
36134,3,6134,[ 69  50   8 191 135],144,5,23045,3.756316218418908,0.0,20.0
36135,3,6135,[ 22  71 435 216 191],694,5,23050,3.7565189048239898,0.0,0.0
36136,3,6136,[183 197   8 568 174],379,5,23055,3.756721525175167,0.0,20.0
36137,3,6137,[603 302 427 127  64],13,5,23060,3.7569240795047247,20.0,20.0
36138,3,6138,[ 69 273 471 302 187],207,4,23064,3.7569636748656134,0.0,0.0
36139,3,6139,[ 22 515  79 234  15],474,5,23069,3.7571661237785015,0.0,0.0
36140,3,6140,[ 82 181 182 271 174],119,4,23073,3.7572056668295066,0.0,20.0
36141,3,6141,[ 22 515 125 268 210],7,3,23076,3.7570823835884077,0.0,0.0
36142,3,6142,[ 79 161 546 269 187],102,0,23076,3.756470779749308,0.0,0.0
36143,3,6143,[603 302 427 127  64],474,5,23081,3.7566731770833335,20.0,20.0
36144,3,6144,[179 588  98 435 180],537,2,23083,3.756387306753458,0.0,20.0
36145,3,6145,[603 302 427 127  64],458,5,23088,3.7565896518060526,20.0,20.0
36146,3,6146,[496 174 127 187 168],648,3,23091,3.756466569058077,0.0,40.0
36147,3,6147,[318 258 216  88 176],184,3,23094,3.7563435263500327,20.0,0.0
36148,3,6148,[603 302 427 127  64],458,5,23099,3.7565457798015935,20.0,20.0
36149,3,6149,[ 71 204 191 132 568],200,5,23104,3.756747967479675,0.0,0.0
36150,3,6150,[234 215   1 173   4],271,4,23108,3.756787514225329,0.0,0.0
36151,3,6151,[196  11  89 333 265],666,2,23110,3.7565019505851756,0.0,0.0
36152,3,6152,[ 15 215 258 228 191],313,2,23112,3.7562164797659676,0.0,0.0
36153,3,6153,[187 357 322 300 271],749,4,23116,3.75625609359766,20.0,0.0
36154,3,6154,[132 173 191  25 143],666,3,23119,3.7561332250203088,0.0,0.0
36155,3,6155,[174 173 200  95 125],59,3,23122,3.7560103963612734,0.0,20.0
36156,3,6156,[603 302 427 127  64],669,5,23127,3.756212441123924,20.0,20.0
36157,3,6157,[100 194 153 127 202],892,5,23132,3.7564144202663203,0.0,40.0
36158,3,6158,[ 82 172   1 385 268],387,3,23135,3.756291605780159,0.0,0.0
36159,3,6159,[ 11 302 313 403 235],334,4,23139,3.756331168831169,0.0,0.0
36160,3,6160,[603 302 427 127  64],666,5,23144,3.7565330303522155,20.0,20.0
36161,3,6161,[273 210  88  28 176],378,5,23149,3.7567348263550797,0.0,0.0
36162,3,6162,[603 302 427 127  64],745,4,23153,3.756774298231381,20.0,20.0
36163,3,6163,[180 294  69 186  15],648,1,23154,3.7563270603504217,0.0,0.0
36164,3,6164,[427   7 181 127 471],194,2,23156,3.756042173560422,0.0,20.0
36165,3,6165,[ 88 318 265 195 179],653,4,23160,3.7560817385663317,20.0,0.0
36166,3,6166,[603 302 427 127  64],458,5,23165,3.7562834441381545,20.0,20.0
36167,3,6167,[603 302 427 127  64],666,5,23170,3.756485084306096,20.0,20.0
36168,3,6168,[603 302 427 127  64],537,4,23174,3.756524558275247,20.0,20.0
36169,3,6169,[603 302 427 127  64],90,5,23179,3.7567260940032416,20.0,20.0
36170,3,6170,[568  98 176 196 588],881,3,23182,3.7566034678334144,0.0,20.0
36171,3,6171,[603 302 427 127  64],271,5,23187,3.756804925469864,20.0,20.0
36172,3,6172,[603 302 427 127  64],13,5,23192,3.7570063178357365,20.0,20.0
36173,3,6173,[302 282 655 204 153],144,3,23195,3.756883705863298,0.0,0.0
36174,3,6174,[515 179   9 300 748],64,3,23198,3.7567611336032387,0.0,0.0
36175,3,6175,[ 69 357 182 186 143],339,5,23203,3.7569624352331608,20.0,0.0
36176,3,6176,[ 22 258 508 496 471],6,1,23204,3.7565161081431113,0.0,0.0
36177,3,6177,[ 88  22 135 194 322],308,4,23208,3.7565555195856266,0.0,0.0
36178,3,6178,[257 176 118 496 234],343,2,23210,3.7562712413011816,0.0,0.0
36179,3,6179,[403 185 273 127 196],59,4,23214,3.7563106796116505,0.0,20.0
36180,3,6180,[211 222 483  56 202],215,5,23219,3.7565118912797284,20.0,0.0
36181,3,6181,[  9 228 153 748 200],749,3,23222,3.756389517955354,0.0,0.0
36182,3,6182,[210 603 172 405  28],42,5,23227,3.756590651787158,20.0,0.0
36183,3,6183,[603 302 427 127  64],474,5,23232,3.7567917205692107,20.0,20.0
36184,3,6184,[286  28 215 546 100],13,3,23235,3.7566693613581243,0.0,20.0
36185,3,6185,[603 302 427 127  64],90,5,23240,3.7568703524086646,20.0,20.0
36186,3,6186,[ 82 117 183  88   4],13,3,23243,3.7567480200420236,0.0,0.0
36187,3,6187,[403 357 235 323 568],290,0,23243,3.7561409179056238,20.0,0.0
36188,3,6188,[403 210 144 172   1],158,5,23248,3.7563418969138795,0.0,0.0
36189,3,6189,[603 302 427 127  64],666,5,23253,3.7565428109854606,20.0,20.0
36190,3,6190,[603 302 427 127  64],458,5,23258,3.7567436601518334,20.0,20.0
36191,3,6191,[603 302 427 127  64],458,5,23263,3.7569444444444446,20.0,20.0
36192,3,6192,[271 603  15 257 228],145,4,23267,3.7569836912643306,20.0,0.0
36193,3,6193,[435 202 427 183 318],406,4,23271,3.7570229254116887,20.0,0.0
36194,3,6194,[151 508  70 181 318],653,2,23273,3.7567393058918483,20.0,0.0
36195,3,6195,[238 405 603 176 118],848,4,23277,3.7567785668173013,20.0,0.0
36196,3,6196,[168 238 132 258  96],653,1,23278,3.7563337098596095,0.0,0.0
36197,3,6197,[210 191   1 196  82],738,5,23283,3.756534365924492,0.0,0.0
36198,3,6198,[ 89  28 186  79 588],881,3,23286,3.756412324568479,0.0,0.0
36199,3,6199,[135 181 748 423 234],524,2,23288,3.7561290322580647,0.0,0.0
36200,3,6200,[603 302 427 127  64],669,5,23293,3.7563296242541524,20.0,20.0
36201,3,6201,[ 50 194 215  15  22],308,3,23296,3.7562076749435667,0.0,20.0
36202,3,6202,[289 216 176 100 475],537,2,23298,3.7559245526358214,0.0,20.0
36203,3,6203,[333 282 200 471  97],653,2,23300,3.7556415215989682,0.0,0.0
36204,3,6204,[323  56 153 135  88],13,4,23304,3.7556809024979856,0.0,0.0
36205,3,6205,[603 302 427 127  64],669,5,23309,3.7558814050918468,20.0,20.0
36206,3,6206,[ 95 132 435   7 210],815,3,23312,3.7557596262284516,0.0,0.0
36207,3,6207,[210   1 172 174 234],932,4,23316,3.755798969072165,0.0,20.0
36208,3,6208,[  8 678 427 181 265],334,3,23319,3.755677242712192,0.0,0.0
36209,3,6209,[ 28 151 238 546 191],795,2,23321,3.7553945249597422,0.0,0.0
36210,3,6210,[603 302 427 127  64],339,5,23326,3.7555949122524552,20.0,20.0
36211,3,6211,[603 302 427 127  64],271,5,23331,3.7557952350289763,20.0,20.0
36212,3,6212,[333  89 313 215 216],13,3,23334,3.755673587638822,0.0,0.0
36213,3,6213,[181 257 403  69 197],934,5,23339,3.755873833279691,0.0,0.0
36214,3,6214,[603 302 427 127  64],458,5,23344,3.756074014481094,20.0,20.0
36215,3,6215,[427 196 216 222 183],815,4,23348,3.756113256113256,0.0,0.0
36216,3,6216,[234 100  71   4  64],749,4,23352,3.7561524851214414,0.0,20.0
36217,3,6217,[258  25 286 100 211],650,2,23354,3.7558700546799613,0.0,20.0
36218,3,6218,[235 603 118 211 175],313,4,23358,3.7559093101784855,20.0,0.0
36219,3,6219,[603 302 427 127  64],474,5,23363,3.7561093247588424,20.0,20.0
36220,3,6220,[132  71 228 111 181],13,5,23368,3.756309275036168,0.0,0.0
36221,3,6221,[318 328 483 172  79],664,4,23372,3.7563484410157506,40.0,0.0
36222,3,6222,[603 302 427 127  64],669,5,23377,3.756548288606781,20.0,20.0
36223,3,6223,[181 143 238 215 597],13,2,23379,3.7562660668380463,0.0,0.0
36224,3,6224,[597 300 121 546 245],328,3,23382,3.756144578313253,0.0,0.0
36225,3,6225,[ 79  98 265 302 111],378,4,23386,3.756183745583039,0.0,20.0
36226,3,6226,[597 423 175  12 508],92,3,23389,3.7560623092982173,20.0,0.0
36227,3,6227,[186  56  97 515 222],666,3,23392,3.755940912010276,0.0,0.0
36228,3,6228,[603 302 427 127  64],458,5,23397,3.756140632525285,20.0,20.0
36229,3,6229,[603 302 427 127  64],458,5,23402,3.7563402889245587,20.0,20.0
36230,3,6230,[127 276   4 132 258],343,5,23407,3.7565398812389663,0.0,20.0
36231,3,6231,[655 268 271 300   7],537,2,23409,3.7562580231065468,0.0,0.0
36232,3,6232,[197 238  98 176 151],64,3,23412,3.7561366918017005,0.0,20.0
36233,3,6233,[100 211 118 405  82],749,2,23414,3.7558549887712545,0.0,20.0
36234,3,6234,[603 302 427 127  64],745,4,23418,3.755894145950281,20.0,20.0
36235,3,6235,[ 11  64  79  28 143],454,4,23422,3.7559332905708787,0.0,0.0
36236,3,6236,[ 12 132  97 191  22],7,5,23427,3.756132756132756,20.0,0.0
36237,3,6237,[302 135 289 100 483],524,4,23431,3.7561718499519077,20.0,20.0
36238,3,6238,[603 302 427 127  64],13,5,23436,3.7563712133354703,20.0,20.0
36239,3,6239,[483 288 151 302 117],474,3,23439,3.75625,20.0,0.0
36240,3,6240,[211 333 286 118 588],298,5,23444,3.7564492869732415,0.0,0.0
36241,3,6241,[ 50 483 276  56 111],13,5,23449,3.756648510092919,20.0,20.0
36242,3,6242,[179   7 357 187  82],881,5,23454,3.7568476693897166,20.0,0.0
36243,3,6243,[268 271 194 117 127],13,3,23457,3.756726457399103,0.0,20.0
36244,3,6244,[435 168  56 423 288],474,3,23460,3.756605284227382,0.0,0.0
36245,3,6245,[  1 483 546 186 174],881,4,23464,3.7566442523214856,20.0,20.0
36246,3,6246,[ 12 234 100 180  98],447,5,23469,3.756843284776693,20.0,40.0
36247,3,6247,[603 302 427 127  64],458,5,23474,3.757042253521127,20.0,20.0
36248,3,6248,[185 151  70 603 333],64,2,23476,3.756761081773084,20.0,0.0
36249,3,6249,[603 302 427 127  64],458,5,23481,3.75696,20.0,20.0
36250,3,6250,[216  22 273 161 135],479,3,23484,3.756838905775076,0.0,0.0
36251,3,6251,[603 302 427 127  64],13,5,23489,3.7570377479206654,20.0,20.0
36252,3,6252,[ 28 186 176 121 403],788,3,23492,3.756916679993603,0.0,0.0
36253,3,6253,[603 302 427 127  64],537,4,23496,3.7569555484489925,20.0,20.0
36254,3,6254,[603 302 427 127  64],474,5,23501,3.757154276578737,20.0,20.0
36255,3,6255,[179   7 568 271 237],92,3,23504,3.7570332480818416,0.0,0.0
36256,3,6256,[ 50 323 215 322 268],537,2,23506,3.7567524372702574,0.0,20.0
36257,3,6257,[603 302 427 127  64],271,5,23511,3.7569511025886864,20.0,20.0
36258,3,6258,[603 302 427 127  64],745,4,23515,3.756989934494328,20.0,20.0
36259,3,6259,[603 302 427 127  64],537,4,23519,3.7570287539936102,20.0,20.0
36260,3,6260,[435 234 181 161 187],339,4,23523,3.757067561092477,0.0,0.0
36261,3,6261,[603 302 427 127  64],537,4,23527,3.75710635579687,20.0,20.0
36262,3,6262,[ 11 173 294 118 655],92,2,23529,3.7568258023311514,0.0,0.0
36263,3,6263,[603 302 427 127  64],458,5,23534,3.7570242656449553,20.0,20.0
36264,3,6264,[  1   8 186 282 268],92,5,23539,3.757222665602554,0.0,0.0
36265,3,6265,[180  15   9 187 258],6,3,23542,3.757101819342483,0.0,0.0
36266,3,6266,[603 302 427 127  64],745,4,23546,3.7571405776288493,20.0,20.0
36267,3,6267,[ 89 435 423 215 132],308,3,23549,3.757019783024888,0.0,0.0
36268,3,6268,[237  64 748 742 153],92,3,23552,3.7568990269580476,0.0,0.0
36269,3,6269,[588 216 182 294  98],13,3,23555,3.7567783094098885,0.0,20.0
36270,3,6270,[603 302 427 127  64],339,5,23560,3.756976558762558,20.0,20.0
36271,3,6271,[191  89  88 276 174],92,4,23564,3.757015306122449,0.0,20.0
36272,3,6272,[603 302 427 127  64],339,5,23569,3.757213454487486,20.0,20.0
36273,3,6273,[216 235  50 385 182],308,3,23572,3.7570927637870577,0.0,20.0
36274,3,6274,[ 82 185 328 204 176],788,3,23575,3.756972111553785,0.0,0.0
36275,3,6275,[ 25 176 427 180 597],882,4,23579,3.757010834926705,0.0,0.0
36276,3,6276,[172 132 186  96 202],279,3,23582,3.7568902341883064,0.0,0.0
36277,3,6277,[483 228 678  50  98],537,2,23584,3.756610385473081,20.0,40.0
36278,3,6278,[435 357 100 121 275],271,4,23588,3.7566491479534956,20.0,20.0
36279,3,6279,[  4 234 237 196 210],64,3,23591,3.756528662420382,0.0,0.0
36280,3,6280,[ 12 168 202 318 385],537,2,23593,3.75624900493552,40.0,0.0
36281,3,6281,[603 302 427 127  64],90,5,23598,3.7564469914040113,20.0,20.0
36282,3,6282,[183  95 568 161 179],543,3,23601,3.756326595575362,0.0,0.0
36283,3,6283,[ 56 265  11 357 385],295,5,23606,3.756524506683641,20.0,0.0
36284,3,6284,[172 357 197  89 471],7,5,23611,3.756722354813047,20.0,0.0
36285,3,6285,[603 302 427 127  64],339,5,23616,3.7569201399936367,20.0,20.0
36286,3,6286,[603 302 427 127  64],474,5,23621,3.757117862255448,20.0,20.0
36287,3,6287,[546 222 385   9 282],200,4,23625,3.7571564885496183,0.0,0.0
36288,3,6288,[483   1  89  28  98],881,5,23630,3.7573541103514074,20.0,20.0
36289,3,6289,[151 435 172  71 258],843,1,23631,3.7569157392686803,0.0,0.0
36290,3,6290,[ 12  71  96 135   7],378,4,23635,3.756954379271976,20.0,0.0
36291,3,6291,[181 333 204 132 234],881,3,23638,3.756834075015893,0.0,0.0
36292,3,6292,[603 302 427 127  64],474,5,23643,3.757031622437629,20.0,20.0
36293,3,6293,[546 161 144 211   1],313,5,23648,3.757229107086114,0.0,0.0
36294,3,6294,[186  97 168 121 318],738,4,23652,3.757267672756156,20.0,0.0
36295,3,6295,[603 302 427 127  64],90,5,23657,3.7574650571791612,20.0,20.0
36296,3,6296,[603 302 427 127  64],458,5,23662,3.7576623789105925,20.0,20.0
36297,3,6297,[204 121 132 275 174],318,4,23666,3.7577008574150526,0.0,20.0
36298,3,6298,[194   1 568 135 176],313,5,23671,3.757898079060168,0.0,0.0
36299,3,6299,[ 88 435  98 294 121],308,2,23673,3.7576190476190474,0.0,20.0
36300,3,6300,[603 302 427 127  64],458,5,23678,3.7578162196476748,20.0,20.0
36301,3,6301,[237 318  11 313 238],234,2,23680,3.757537289749286,20.0,0.0
36302,3,6302,[180 258 117 742 216],313,3,23683,3.757417102966841,0.0,0.0
36303,3,6303,[603 302 427 127  64],745,4,23687,3.7574555837563453,20.0,20.0
36304,3,6304,[ 50  95 195  69 168],506,5,23692,3.7576526566217288,0.0,20.0
36305,3,6305,[211 185 186 603 568],648,5,23697,3.757849666983825,20.0,0.0
36306,3,6306,[ 82 153 238 216   4],940,3,23700,3.7577295068970984,0.0,0.0
36307,3,6307,[603 302 427 127  64],90,5,23705,3.7579264426125554,20.0,20.0
36308,3,6308,[597  95  98 546  50],804,2,23707,3.757647804723411,0.0,40.0
36309,3,6309,[180 176 168  56 475],527,3,23710,3.7575277337559427,0.0,0.0
36310,3,6310,[546 204 173 179 191],207,2,23712,3.757249247345904,0.0,0.0
36311,3,6311,[603 302 427 127  64],745,4,23716,3.7572877059569074,20.0,20.0
36312,3,6312,[ 64 200 288 181 185],213,5,23721,3.757484555678758,0.0,0.0
36313,3,6313,[405 174 282 258 151],479,5,23726,3.7576813430471967,0.0,20.0
36314,3,6314,[603 302 427 127  64],339,5,23731,3.757878068091845,20.0,20.0
36315,3,6315,[603 302 427 127  64],664,5,23736,3.7580747308423055,20.0,20.0
36316,3,6316,[153  11 546 742 127],308,4,23740,3.7581130283362354,0.0,20.0
36317,3,6317,[603 302 427 127  64],90,5,23745,3.758309591642925,20.0,20.0
36318,3,6318,[603 302 427 127  64],537,4,23749,3.7583478398480774,20.0,20.0
36319,3,6319,[427  70 228 423  82],295,5,23754,3.758544303797468,0.0,0.0
36320,3,6320,[273 191   9 127 187],7,4,23758,3.758582502768549,0.0,20.0
36321,3,6321,[183  50 172 132 403],653,1,23759,3.7581461562796585,0.0,20.0
36322,3,6322,[173   7 161 186 181],234,0,23759,3.757551795034003,0.0,0.0
36323,3,6323,[211 678 423 196 144],7,4,23763,3.7575901328273247,0.0,0.0
36324,3,6324,[427 322 127 275 100],328,3,23766,3.7574703557312255,0.0,40.0
36325,3,6325,[182  71 194 603 228],533,4,23770,3.7575086942775844,20.0,0.0
36326,3,6326,[603 302 427 127  64],13,5,23775,3.757705073494547,20.0,20.0
36327,3,6327,[228 357 200 216 125],815,4,23779,3.7577433628318584,20.0,0.0
36328,3,6328,[603 302 427 127  64],13,5,23784,3.7579396429135725,20.0,20.0
36329,3,6329,[546 144  79 132 301],279,2,23786,3.7576619273301737,0.0,0.0
36330,3,6330,[194 496  71  70 588],308,4,23790,3.757700205338809,0.0,0.0
36331,3,6331,[228 435  22   7  11],892,3,23793,3.757580543272268,0.0,0.0
36332,3,6332,[210  11   1 196 204],374,4,23797,3.7576188220432654,0.0,0.0
36333,3,6333,[ 96  69 204 195  15],543,4,23801,3.7576570887275023,0.0,0.0
36334,3,6334,[603 302 427 127  64],664,5,23806,3.7578531965272295,20.0,20.0
36335,3,6335,[127 216 172  15  71],892,4,23810,3.757891414141414,0.0,20.0
36336,3,6336,[174 117 180 508 237],533,3,23813,3.757771816316869,0.0,20.0
36337,3,6337,[ 97 655 144 121 235],795,1,23814,3.757336699274219,0.0,0.0
36338,3,6338,[603 302 427 127  64],339,5,23819,3.7575327338696956,20.0,20.0
36339,3,6339,[265  96  50 132   4],881,1,23820,3.7570977917981074,0.0,20.0
36340,3,6340,[179 289 172 222 182],194,1,23821,3.756662986910582,0.0,0.0
36341,3,6341,[237 427 179 210 194],452,4,23825,3.7567013560391045,0.0,0.0
36342,3,6342,[181  95 195 318 175],313,4,23829,3.7567397130695253,20.0,0.0
36343,3,6343,[182  95 603 135 515],334,3,23832,3.7566204287515763,20.0,0.0
36344,3,6344,[117 269 175 215 318],90,2,23834,3.7563435776201732,20.0,0.0
36345,3,6345,[273  97 300 182 118],7,3,23837,3.756224393318626,0.0,0.0
36346,3,6346,[603 302 427 127  64],271,5,23842,3.7564203560737357,20.0,20.0
36347,3,6347,[127 196 496  22 204],479,4,23846,3.75645872715816,0.0,20.0
36348,3,6348,[603 302 427 127  64],669,5,23851,3.7566545912742164,20.0,20.0
36349,3,6349,[603 302 427 127  64],458,5,23856,3.7568503937007875,20.0,20.0
36350,3,6350,[603 302 427 127  64],669,5,23861,3.757046134467013,20.0,20.0
36351,3,6351,[603 302 427 127  64],664,5,23866,3.757241813602015,20.0,20.0
36352,3,6352,[  1  88 210 427 204],650,2,23868,3.756965213285062,0.0,0.0
36353,3,6353,[173 176 288  95 313],92,2,23870,3.7566887000314764,0.0,0.0
36354,3,6354,[423 265 318 211 216],537,2,23872,3.7564122738001573,20.0,0.0
36355,3,6355,[603 302 427 127  64],669,5,23877,3.7566079295154187,20.0,20.0
36356,3,6356,[301 127 181  11   7],102,0,23877,3.7560169891458237,0.0,20.0
36357,3,6357,[161 234 515 100 168],234,3,23880,3.755898081157597,0.0,20.0
36358,3,6358,[194  12  96 135 180],537,2,23882,3.7556219531372856,20.0,0.0
36359,3,6359,[603 302 427 127  64],537,4,23886,3.7556603773584905,20.0,20.0
36360,3,6360,[603 302 427 127  64],666,5,23891,3.755855997484672,20.0,20.0
36361,3,6361,[180 215 328 127  12],234,1,23892,3.7554228230116316,20.0,20.0
36362,3,6362,[ 79 151 471  88 234],474,3,23895,3.7553041018387554,0.0,0.0
36363,3,6363,[215  98 678 174   8],940,4,23899,3.75534255185418,0.0,40.0
36364,3,6364,[ 50 222 286  82  95],479,4,23903,3.7553809897879025,0.0,20.0
36365,3,6365,[181 238 202 204 173],749,4,23907,3.7554194156456173,0.0,0.0
36366,3,6366,[176 186 222 238 245],488,3,23910,3.755300769593215,0.0,0.0
36367,3,6367,[289 111 191  69 174],537,1,23911,3.7548680904522613,0.0,20.0
36368,3,6368,[210 265 289 237 300],533,2,23913,3.754592557701366,0.0,0.0
36369,3,6369,[ 50  25 187 202 195],13,3,23916,3.75447409733124,0.0,20.0
36370,3,6370,[435  25 427 180 234],85,3,23919,3.7543556741484854,0.0,0.0
36371,3,6371,[200 742 161 210 323],506,4,23923,3.7543942247332076,0.0,0.0
36372,3,6372,[603 302 427 127  64],339,5,23928,3.754589675192217,20.0,20.0
36373,3,6373,[603 302 427 127  64],666,5,23933,3.7547850643238156,20.0,20.0
36374,3,6374,[186 175   9 179  50],13,3,23936,3.7546666666666666,0.0,20.0
36375,3,6375,[603 302 427 127  64],474,5,23941,3.754861982434128,20.0,20.0
36376,3,6376,[ 69 202   4 357  89],543,5,23946,3.755057236945272,20.0,0.0
36377,3,6377,[196  88  79 234 117],271,4,23950,3.755095641266855,0.0,0.0
36378,3,6378,[603 302 427 127  64],339,5,23955,3.75529079793071,20.0,20.0
36379,3,6379,[176 174 180 222 183],653,2,23957,3.755015673981191,0.0,20.0
36380,3,6380,[161  12 216 282 186],334,2,23959,3.7547406362639086,20.0,0.0
36381,3,6381,[202 357 588 132 180],537,2,23961,3.7544656847383266,20.0,0.0
36382,3,6382,[655 121 294 678 222],804,5,23966,3.7546608177972742,0.0,0.0
36383,3,6383,[603 302 427 127  64],745,4,23970,3.7546992481203008,20.0,20.0
36384,3,6384,[286 172 194 357  28],380,4,23974,3.754737666405638,20.0,0.0
36385,3,6385,[286 127 195 181 282],533,5,23979,3.754932665205136,0.0,20.0
36386,3,6386,[273  82  56 216 313],378,5,23984,3.755127602943479,0.0,0.0
36387,3,6387,[121   1  98 200 313],59,4,23988,3.7551659361302443,0.0,20.0
36388,3,6388,[603 302 427 127  64],537,4,23992,3.755204257317264,20.0,20.0
36389,3,6389,[742 216 100  71  82],92,2,23994,3.7549295774647886,0.0,20.0
36390,3,6390,[603 302 427 127  64],474,5,23999,3.7551243936786105,20.0,20.0
36391,3,6391,[603 302 427 127  64],745,4,24003,3.755162703379224,20.0,20.0
36392,3,6392,[180 276   8 318  28],406,4,24007,3.7552010010949477,20.0,0.0
36393,3,6393,[471 179 144   9  89],7,5,24012,3.7553956834532376,0.0,0.0
36394,3,6394,[273 187 271 288 195],64,3,24015,3.755277560594214,0.0,0.0
36395,3,6395,[235 257 172 302 204],334,3,24018,3.75515947467167,0.0,0.0
36396,3,6396,[237 204  11 182 183],215,2,24020,3.754885102391746,0.0,0.0
36397,3,6397,[568 168 435  56 258],650,2,24022,3.7546108158799627,0.0,0.0
36398,3,6398,[196  12 276 210 546],271,3,24025,3.7544928895139864,20.0,0.0
36399,3,6399,[ 96 282  97 405 216],378,4,24029,3.75453125,0.0,0.0
36400,3,6400,[174 300 179 328  88],271,3,24032,3.754413372910483,0.0,20.0
36401,3,6401,[603 302 427 127  64],474,5,24037,3.754607935020306,20.0,20.0
36402,3,6402,[195 187 202 273  50],158,4,24041,3.7546462595658285,0.0,20.0
36403,3,6403,[125  69 300 176  82],892,4,24045,3.754684572142411,0.0,0.0
36404,3,6404,[603 302 427 127  64],13,5,24050,3.7548790007806403,20.0,20.0
36405,3,6405,[403   4   1 328 215],788,1,24051,3.754448954105526,0.0,0.0
36406,3,6406,[603 302 427 127  64],90,5,24056,3.754643358826284,20.0,20.0
36407,3,6407,[603 302 427 127  64],664,5,24061,3.7548377028714106,20.0,20.0
36408,3,6408,[132 100 175 234 151],934,3,24064,3.7547199251053205,0.0,20.0
36409,3,6409,[271  12 181 196   9],13,3,24067,3.7546021840873633,20.0,0.0
36410,3,6410,[603 302 427 127  64],669,5,24072,3.7547964436125407,20.0,20.0
36411,3,6411,[603 302 427 127  64],13,5,24077,3.7549906425452275,20.0,20.0
36412,3,6412,[ 69  12 191 245 405],533,3,24080,3.75487291439264,20.0,0.0
36413,3,6413,[294 237 215  98 405],605,2,24082,3.7545993140006235,0.0,20.0
36414,3,6414,[ 64 403 597 333  25],13,1,24083,3.754169914263445,0.0,0.0
36415,3,6415,[127 228 235 197 318],64,4,24087,3.754208229426434,20.0,20.0
36416,3,6416,[603 302 427 127  64],664,5,24092,3.754402368708119,20.0,20.0
36417,3,6417,[603 302 427 127  64],537,4,24096,3.7544406357120597,20.0,20.0
36418,3,6418,[286 483  89 153 269],13,3,24099,3.7543231032871165,20.0,0.0
36419,3,6419,[ 89 143 313 238 210],85,3,24102,3.7542056074766355,0.0,0.0
36420,3,6420,[195 269 237 172  71],378,4,24106,3.7542438872449773,0.0,0.0
36421,3,6421,[ 69  50  96 313 197],650,4,24110,3.7542821550918717,0.0,20.0
36422,3,6422,[603 302 427 127  64],13,5,24115,3.7544761015101975,20.0,20.0
36423,3,6423,[ 79 132 228  95 318],664,5,24120,3.7546699875467,20.0,0.0
36424,3,6424,[153 508  97 405 183],13,3,24123,3.754552529182879,0.0,0.0
36425,3,6425,[ 89 288  28   4 182],7,5,24128,3.7547463429816372,0.0,0.0
36426,3,6426,[132   1 175 427   7],815,4,24132,3.7547845028784814,0.0,0.0
36427,3,6427,[117  56 187 172 153],650,3,24135,3.7546670815183574,0.0,0.0
36428,3,6428,[176  98 117 235 678],13,1,24136,3.7542386063151345,0.0,20.0
36429,3,6429,[ 71 187 153 144 288],308,4,24140,3.754276827371695,0.0,0.0
36430,3,6430,[174 121  69  96 603],313,5,24145,3.754470533354066,20.0,20.0
36431,3,6431,[168 282 222 185 286],334,5,24150,3.7546641791044775,0.0,0.0
36432,3,6432,[603 302 427 127  64],666,5,24155,3.7548577646510184,20.0,20.0
36433,3,6433,[603 302 427 127  64],474,5,24160,3.7550512900217594,20.0,20.0
36434,3,6434,[ 71 435 385 168 328],234,0,24160,3.7544677544677545,0.0,0.0
36435,3,6435,[186 194 181   8  79],85,3,24163,3.754350528278434,0.0,0.0
36436,3,6436,[333 197 174 300 100],13,3,24166,3.754233338511729,0.0,40.0
36437,3,6437,[135 179 202 328 322],749,5,24171,3.7544268406337373,0.0,0.0
36438,3,6438,[183 742 655 132  79],749,5,24176,3.754620282652586,0.0,0.0
36439,3,6439,[245 273   8  69 173],378,3,24179,3.754503105590062,0.0,0.0
36440,3,6440,[603 302 427 127  64],669,5,24184,3.7546964757025307,20.0,20.0
36441,3,6441,[603 302 427 127  64],458,5,24189,3.7548897857808132,20.0,20.0
36442,3,6442,[ 97 172  71 275  22],454,2,24191,3.7546174142480213,0.0,0.0
36443,3,6443,[603 302 427 127  64],537,4,24195,3.7546554934823093,20.0,20.0
36444,3,6444,[496 151  11  96 186],537,2,24197,3.7543832428238946,0.0,0.0
36445,3,6445,[257 111 118  25 204],92,1,24198,3.7539559416692523,0.0,0.0
36446,3,6446,[603 302 427 127  64],271,5,24203,3.7541492166899335,20.0,20.0
36447,3,6447,[118 237 183 275 301],455,3,24206,3.754032258064516,0.0,0.0
36448,3,6448,[603 302 427 127  64],537,4,24210,3.7540703985113972,20.0,20.0
36449,3,6449,[179 357 194  82 100],774,1,24211,3.753643410852713,20.0,20.0
36450,3,6450,[427  28 318 132  50],454,4,24215,3.7536815997519763,20.0,20.0
36451,3,6451,[234 357 588 228 117],406,4,24219,3.753719776813391,20.0,0.0
36452,3,6452,[273 174  70   8 210],158,4,24223,3.7537579420424607,0.0,20.0
36453,3,6453,[603 302 427 127  64],90,5,24228,3.753951038115897,20.0,20.0
36454,3,6454,[ 79  12  89 276  56],339,5,24233,3.7541440743609606,20.0,0.0
36455,3,6455,[286  22 483 100 222],488,2,24235,3.7538723667905822,20.0,20.0
36456,3,6456,[118 175 127 143 135],194,1,24236,3.7534458726962985,0.0,20.0
36457,3,6457,[603 302 427 127  64],669,5,24241,3.7536388974914834,20.0,20.0
36458,3,6458,[ 89 191 211 117 435],313,5,24246,3.7538318625174174,0.0,0.0
36459,3,6459,[194 174 127 568 333],343,3,24249,3.753715170278638,0.0,40.0
36460,3,6460,[603 302 427 127  64],458,5,24254,3.7539080637672186,20.0,20.0
36461,3,6461,[173 597 228  82 423],200,5,24259,3.7541008975549364,0.0,0.0
36462,3,6462,[655 357 196 271  22],749,5,24264,3.7542936716695032,20.0,0.0
36463,3,6463,[603 302 427 127  64],669,5,24269,3.754486386138614,20.0,20.0
36464,3,6464,[118 275 211 655 127],328,4,24273,3.754524361948956,0.0,20.0
36465,3,6465,[603 302 427 127  64],664,5,24278,3.7547169811320753,20.0,20.0
36466,3,6466,[ 98 300 194  95 175],749,3,24281,3.7546002783361683,0.0,20.0
36467,3,6467,[168 127 210 265 603],890,4,24285,3.754638218923933,20.0,20.0
36468,3,6468,[405 125 515 403 228],881,3,24288,3.7545215643839853,0.0,0.0
36469,3,6469,[180 357 211 196 183],488,3,24291,3.7544049459041733,20.0,0.0
36470,3,6470,[603 302 427 127  64],537,4,24295,3.75444289908824,20.0,20.0
36471,3,6471,[588 173 204 125  98],200,5,24300,3.754635352286774,0.0,20.0
36472,3,6472,[603 302 427 127  64],90,5,24305,3.7548277460219373,20.0,20.0
36473,3,6473,[276 181 222   1  97],406,4,24309,3.7548656163113994,0.0,0.0
36474,3,6474,[183 172 597 228 237],59,3,24312,3.7547490347490347,0.0,0.0
36475,3,6475,[186 176 151  79  89],346,4,24316,3.7547869054972205,0.0,0.0
36476,3,6476,[ 98 678 127   7  96],537,2,24318,3.7545159796201943,0.0,40.0
36477,3,6477,[508 678  96  56 200],940,4,24322,3.7545538746526708,0.0,0.0
36478,3,6478,[275 197 144 471   8],899,4,24326,3.7545917579873436,0.0,0.0
36479,3,6479,[194 143 195 322 294],749,4,24330,3.7546296296296298,0.0,0.0
36480,3,6480,[603 302 427 127  64],13,5,24335,3.754821786761302,20.0,20.0
36481,3,6481,[196 475 313 216  70],334,3,24338,3.7547053378586854,0.0,0.0
36482,3,6482,[357 195 238 496  71],648,2,24340,3.7544346753046427,20.0,0.0
36483,3,6483,[151   8 196  22 235],901,2,24342,3.7541640962368907,0.0,0.0
36484,3,6484,[185 216 313 176 211],653,1,24343,3.753739398612182,0.0,0.0
36485,3,6485,[603 302 427 127  64],271,5,24348,3.753931544865865,20.0,20.0
36486,3,6486,[603 302 427 127  64],664,5,24353,3.754123631879143,20.0,20.0
36487,3,6487,[ 70 403 655 187  28],506,5,24358,3.754315659679408,0.0,0.0
36488,3,6488,[127 143  89 216 215],538,4,24362,3.7543535213438126,0.0,20.0
36489,3,6489,[385 121 265 186 294],378,3,24365,3.7542372881355934,0.0,0.0
36490,3,6490,[603 302 427 127  64],458,5,24370,3.7544292096749343,20.0,20.0
36491,3,6491,[546 143 742 196  70],378,4,24374,3.754467036352434,0.0,0.0
36492,3,6492,[496 161 603 288 196],308,2,24376,3.7541968273525335,20.0,0.0
36493,3,6493,[ 79 191 144 183 405],458,5,24381,3.754388666461349,0.0,0.0
36494,3,6494,[286 185 483 234 197],666,4,24385,3.754426481909161,20.0,0.0
36495,3,6495,[ 15 204  70 210  28],537,1,24386,3.7540024630541873,0.0,0.0
36496,3,6496,[313 135 100 144 385],234,3,24389,3.7538864091118977,0.0,20.0
36497,3,6497,[603 302 427 127  64],745,4,24393,3.7539242843951985,20.0,20.0
36498,3,6498,[268 275 302 603 176],334,4,24397,3.7539621480227727,20.0,0.0
36499,3,6499,[603 302 427 127  64],666,5,24402,3.754153846153846,20.0,20.0
36500,3,6500,[603 302 427 127  64],745,4,24406,3.7541916628211043,20.0,20.0
36501,3,6501,[603 302 427 127  64],666,5,24411,3.754383266687173,20.0,20.0
36502,3,6502,[603 302 427 127  64],90,5,24416,3.7545748116254036,20.0,20.0
36503,3,6503,[153 301 568 286 200],650,2,24418,3.7543050430504303,0.0,0.0
36504,3,6504,[ 64 191 603 117 403],339,3,24421,3.7541890853189854,20.0,0.0
36505,3,6505,[197 186 515 257 143],474,4,24425,3.7542268675069166,0.0,0.0
36506,3,6506,[471 275 385   8 288],474,2,24427,3.7539572767788534,0.0,0.0
36507,3,6507,[603 302 427 127  64],664,5,24432,3.7541487400122926,20.0,20.0
36508,3,6508,[475  96 210  71 427],308,5,24437,3.754340144415425,0.0,0.0
36509,3,6509,[174  56 228 435 273],59,4,24441,3.754377880184332,0.0,20.0
36510,3,6510,[111 186 435 200 197],648,3,24444,3.754262018123176,0.0,0.0
36511,3,6511,[603 302 427 127  64],474,5,24449,3.7544533169533167,20.0,20.0
36512,3,6512,[ 25  56 385 237 286],119,5,24454,3.7546445570397666,0.0,0.0
36513,3,6513,[603 302 427 127  64],13,5,24459,3.754835738409579,20.0,20.0
36514,3,6514,[144  11 483 235 187],328,3,24462,3.7547198772064467,20.0,0.0
36515,3,6515,[603 302 427 127  64],13,5,24467,3.7549109883364027,20.0,20.0
36516,3,6516,[234  82 678 100 475],13,2,24469,3.754641706306583,0.0,20.0
36517,3,6517,[403 204 265  97  11],374,4,24473,3.75467934949371,0.0,0.0
36518,3,6518,[234  11 196 202   4],804,5,24478,3.754870378892468,0.0,0.0
36519,3,6519,[204 118 294 286 435],13,3,24481,3.7547546012269937,0.0,0.0
36520,3,6520,[ 79 385 195 179  96],738,3,24484,3.7546388590706945,0.0,0.0
36521,3,6521,[515   7 234 423  98],308,2,24486,3.7543698252069917,0.0,20.0
36522,3,6522,[ 69 265 151 182 168],892,5,24491,3.7545607849149163,0.0,0.0
36523,3,6523,[405 597 194 168 182],804,4,24495,3.7545984058859596,0.0,0.0
36524,3,6524,[ 64 181 180 435 568],308,5,24500,3.7547892720306515,0.0,0.0
36525,3,6525,[603 302 427 127  64],669,5,24505,3.754980079681275,20.0,20.0
36526,3,6526,[161 678 210 127 483],474,4,24509,3.755017619120576,20.0,20.0
36527,3,6527,[603 302 427 127  64],745,4,24513,3.7550551470588234,20.0,20.0
36528,3,6528,[603 302 427 127  64],13,5,24518,3.755245826313371,20.0,20.0
36529,3,6529,[ 79 191 435 286 655],207,4,24522,3.755283307810107,0.0,0.0
36530,3,6530,[179 183 118 435 265],13,4,24526,3.7553207778288162,0.0,0.0
36531,3,6531,[121  89 475 172  70],64,3,24529,3.75520514390692,0.0,0.0
36532,3,6532,[ 25 194 603   4  50],13,4,24533,3.755242614419103,20.0,20.0
36533,3,6533,[191 151 173 508  97],387,3,24536,3.7551270278543005,0.0,0.0
36534,3,6534,[603 302 427 127  64],537,4,24540,3.7551644988523334,20.0,20.0
36535,3,6535,[427 143 118 121 173],454,4,24544,3.755201958384333,0.0,0.0
36536,3,6536,[403 132 603 385 228],524,2,24546,3.7549334557136302,20.0,0.0
36537,3,6537,[282 742 546 191  28],92,2,24548,3.7546650351789537,0.0,0.0
36538,3,6538,[603 302 427 127  64],458,5,24553,3.754855482489677,20.0,20.0
36539,3,6539,[603 302 427 127  64],669,5,24558,3.755045871559633,20.0,20.0
36540,3,6540,[173 423  82 179 508],378,4,24562,3.7550833205931813,0.0,0.0
36541,3,6541,[294 210 475 174 191],452,3,24565,3.754967899724855,0.0,20.0
36542,3,6542,[302  28 508 300  89],334,2,24567,3.754699679046309,0.0,0.0
36543,3,6543,[603 302 427 127  64],666,5,24572,3.7548899755501224,20.0,20.0
36544,3,6544,[175 179 237 588 202],406,3,24575,3.754774637127578,0.0,0.0
36545,3,6545,[603 302 427 127  64],271,5,24580,3.754964864039108,20.0,20.0
36546,3,6546,[483  12  22 174 237],538,5,24585,3.7551550328394683,40.0,20.0
36547,3,6547,[100 161  28 179 588],234,2,24587,3.7548869883934026,0.0,20.0
36548,3,6548,[216 117 238 135 300],13,1,24588,3.7544663307375172,0.0,0.0
36549,3,6549,[603 302 427 127  64],271,5,24593,3.7546564885496183,20.0,20.0
36550,3,6550,[174  50 194 135 173],804,4,24597,3.7546939398565105,0.0,40.0
36551,3,6551,[603 302 427 127  64],745,4,24601,3.7547313797313797,20.0,20.0
36552,3,6552,[200  98 161  88 135],313,3,24604,3.754616206317717,0.0,20.0
36553,3,6553,[603 302 427 127  64],271,5,24609,3.7548062252059813,20.0,20.0
36554,3,6554,[186 121 161 269 179],452,4,24613,3.754843630816171,0.0,0.0
36555,3,6555,[597  79 132  95 405],59,2,24615,3.7545759609518,0.0,0.0
36556,3,6556,[98 70 69 79 96],653,3,24618,3.754460881500686,0.0,20.0
36557,3,6557,[ 71   4  28 265 186],543,4,24622,3.7544983226593476,0.0,0.0
36558,3,6558,[ 89 183 216   4 508],653,1,24623,3.7540783656045127,0.0,0.0
36559,3,6559,[183 265 475  12 322],334,3,24626,3.7539634146341463,20.0,0.0
36560,3,6560,[197 161 132 121  71],804,5,24631,3.7541533302850176,0.0,0.0
36561,3,6561,[ 50 185  95 168 423],650,2,24633,3.7538860103626943,0.0,20.0
36562,3,6562,[265 210 187 127 211],804,4,24637,3.7539235105896696,0.0,20.0
36563,3,6563,[143 568 235 471 196],194,0,24637,3.7533516148689823,0.0,0.0
36564,3,6564,[288  89 403 275 191],7,5,24642,3.7535415079969536,0.0,0.0
36565,3,6565,[185  28 483  89  82],59,5,24647,3.753731343283582,20.0,0.0
36566,3,6566,[234 237 187 194 483],188,2,24649,3.753464291152733,20.0,0.0
36567,3,6567,[515 197 405 228 181],537,2,24651,3.7531973203410476,0.0,0.0
36568,3,6568,[603 302 427 127  64],90,5,24656,3.7533871213274472,20.0,20.0
36569,3,6569,[183 265 257 191  22],738,3,24659,3.7532724505327244,0.0,0.0
36570,3,6570,[435  69 121 427 405],458,3,24662,3.753157814640085,0.0,0.0
36571,3,6571,[153 132 289 515 405],334,2,24664,3.752891052951917,0.0,0.0
36572,3,6572,[286  64  96   7 385],666,3,24667,3.7527765099650083,0.0,0.0
36573,3,6573,[135 187 211 197 234],343,4,24671,3.752814116215394,0.0,0.0
36574,3,6574,[357 508  96 603 228],59,5,24676,3.753003802281369,40.0,0.0
36575,3,6575,[186  98  88 118 132],343,4,24680,3.7530413625304138,0.0,20.0
36576,3,6576,[174 161 286 318 228],7,4,24684,3.753078911357762,20.0,20.0
36577,3,6577,[603 302 427 127  64],669,5,24689,3.753268470659775,20.0,20.0
36578,3,6578,[328 187 174 132 678],537,1,24690,3.7528499772001824,0.0,20.0
36579,3,6579,[127  69 185  50 546],524,5,24695,3.7530395136778116,0.0,40.0
36580,3,6580,[173  64 603  70 174],234,2,24697,3.752773134781948,20.0,20.0
36581,3,6581,[289 496 191 322  12],409,3,24700,3.752658766332422,20.0,0.0
36582,3,6582,[603 302 427 127  64],474,5,24705,3.752848245480784,20.0,20.0
36583,3,6583,[603 302 427 127  64],271,5,24710,3.753037667071689,20.0,20.0
36584,3,6584,[143 318  15 111 172],374,0,24710,3.7524677296886866,20.0,0.0
36585,3,6585,[238 237  95 144 153],295,5,24715,3.752657151533556,0.0,0.0
36586,3,6586,[273 197 222 568  79],213,4,24719,3.7526947016851375,0.0,0.0
36587,3,6587,[127 121 385 151 179],59,5,24724,3.752884031572556,0.0,20.0
36588,3,6588,[603 302 427 127  64],90,5,24729,3.753073303991501,20.0,20.0
36589,3,6589,[603 302 427 127  64],339,5,24734,3.7532625189681337,20.0,20.0
36590,3,6590,[172 237 234 288 153],666,1,24735,3.7528447883477467,0.0,0.0
36591,3,6591,[357 175 161 197 322],749,3,24738,3.752730582524272,20.0,0.0
36592,3,6592,[200 153 168 195 427],899,5,24743,3.7529197633854086,0.0,0.0
36593,3,6593,[191 151 168   4 265],650,3,24746,3.7528055808310588,0.0,0.0
36594,3,6594,[603 302 427 127  64],474,5,24751,3.752994692949204,20.0,20.0
36595,3,6595,[603 302 427 127  64],13,5,24756,3.7531837477258945,20.0,20.0
36596,3,6596,[135 405  64 121  71],290,4,24760,3.753221161133849,0.0,0.0
36597,3,6597,[118  82 191 276  15],311,4,24764,3.75325856320097,0.0,0.0
36598,3,6598,[  7 471 168 143 172],92,4,24768,3.753295953932414,0.0,0.0
36599,3,6599,[100  97 191 275 211],454,3,24771,3.7531818181818184,0.0,20.0
36600,3,6600,[132  79  64  97 302],524,4,24775,3.7532192092107257,0.0,0.0
36601,3,6601,[603 302 427 127  64],339,5,24780,3.753408058164193,20.0,20.0
36602,3,6602,[ 25 318  11 191  69],892,4,24784,3.753445403604422,20.0,0.0
36603,3,6603,[603 302 427 127  64],339,5,24789,3.753634161114476,20.0,20.0
36604,3,6604,[603 302 427 127  64],458,5,24794,3.7538228614685845,20.0,20.0
36605,3,6605,[603 302 427 127  64],537,4,24798,3.7538601271571297,20.0,20.0
36606,3,6606,[603 302 427 127  64],664,5,24803,3.754048736188891,20.0,20.0
36607,3,6607,[603 302 427 127  64],666,5,24808,3.7542372881355934,20.0,20.0
36608,3,6608,[117 515  79 300 187],102,0,24808,3.7536692389166286,0.0,0.0
36609,3,6609,[118 405 435 100 588],59,3,24811,3.753555219364599,0.0,20.0
36610,3,6610,[238  96 603 144  95],234,1,24812,3.7531387082135836,20.0,0.0
36611,3,6611,[603 302 427 127  64],537,4,24816,3.753176043557169,20.0,20.0
36612,3,6612,[603 302 427 127  64],90,5,24821,3.7533645849085135,20.0,20.0
36613,3,6613,[185  64  69 100 313],380,4,24825,3.753401874811007,0.0,20.0
36614,3,6614,[603 302 427 127  64],339,5,24830,3.7535903250188967,20.0,20.0
36615,3,6615,[313 180 228 118 222],650,4,24834,3.753627569528416,0.0,0.0
36616,3,6616,[301 161 288 515 181],13,2,24836,3.753362551004987,0.0,0.0
36617,3,6617,[ 11 282 200 216 172],92,3,24839,3.7532487156240557,0.0,0.0
36618,3,6618,[427 300  69 357 186],379,4,24843,3.753285994863272,20.0,0.0
36619,3,6619,[423  95  64 282 568],804,3,24846,3.7531722054380663,0.0,0.0
36620,3,6620,[603 302 427 127  64],745,4,24850,3.7532094849720585,20.0,20.0
36621,3,6621,[235 132 183  12 483],334,3,24853,3.7530957414678343,40.0,0.0
36622,3,6622,[276 179   7 265 181],474,5,24858,3.7532840102672504,0.0,0.0
36623,3,6623,[183 211 568 204  64],7,5,24863,3.7534722222222223,0.0,0.0
36624,3,6624,[597 313 185 186 200],653,4,24867,3.753509433962264,0.0,0.0
36625,3,6625,[173 228 313 234 318],883,4,24871,3.753546634470269,20.0,0.0
36626,3,6626,[100 294  70 235  88],271,3,24874,3.7534329259091597,0.0,20.0
36627,3,6627,[132 194 173  71  28],64,4,24878,3.7534701267350634,0.0,0.0
36628,3,6628,[ 56  97 357  22   1],125,2,24880,3.75320561170614,20.0,0.0
36629,3,6629,[313 405  69 175   7],92,4,24884,3.7532428355957768,0.0,0.0
36630,3,6630,[ 98 258 483 153 186],650,4,24888,3.753280048258181,20.0,20.0
36631,3,6631,[196 357 496 597 125],804,4,24892,3.7533172496984317,20.0,0.0
36632,3,6632,[ 98 186  12 179 427],409,5,24897,3.753505201266395,20.0,20.0
36633,3,6633,[176 271 185  95 211],13,2,24899,3.753240880313536,0.0,0.0
36634,3,6634,[117 258 151 100  95],537,2,24901,3.7529766390354182,0.0,20.0
36635,3,6635,[180   7 111 127 405],833,2,24903,3.7527124773960217,0.0,20.0
36636,3,6636,[  1  15  69 211 121],210,5,24908,3.752900406810306,0.0,0.0
36637,3,6637,[603 302 427 127  64],474,5,24913,3.7530882796022897,20.0,20.0
36638,3,6638,[  8 121 275  79 143],452,4,24917,3.753125470703419,0.0,0.0
36639,3,6639,[385 186 282 508 161],643,2,24919,3.7528614457831324,0.0,0.0
36640,3,6640,[603 302 427 127  64],669,5,24924,3.7530492395723534,20.0,20.0
36641,3,6641,[603 302 427 127  64],664,5,24929,3.7532369768142124,20.0,20.0
36642,3,6642,[515 435 238 235 127],87,3,24932,3.753123588740027,0.0,20.0
36643,3,6643,[603 302 427 127  64],271,5,24937,3.7533112582781456,20.0,20.0
36644,3,6644,[  7 286  56 215 427],7,5,24942,3.7534988713318285,0.0,0.0
36645,3,6645,[603 302 427 127  64],458,5,24947,3.7536864279265725,20.0,20.0
36646,3,6646,[269  98 196 276  82],537,1,24948,3.75327215285091,0.0,20.0
36647,3,6647,[268 475  50 191  95],6,3,24951,3.753158844765343,0.0,20.0
36648,3,6648,[603 302 427 127  64],537,4,24955,3.7531959693186945,20.0,20.0
36649,3,6649,[ 88 265 228 271  22],145,5,24960,3.7533834586466166,0.0,0.0
36650,3,6650,[603 302 427 127  64],474,5,24965,3.753570891595249,20.0,20.0
36651,3,6651,[568  28 194 271 258],64,3,24968,3.7534576067348167,0.0,0.0
36652,3,6652,[196   9 173 257 182],334,4,24972,3.753494664061326,0.0,0.0
36653,3,6653,[195 173 273 508  25],378,4,24976,3.753531710249474,0.0,0.0
36654,3,6654,[603 302 427 127  64],13,5,24981,3.7537190082644627,20.0,20.0
36655,3,6655,[ 79 176 153 135 172],738,4,24985,3.7537560096153846,0.0,0.0
36656,3,6656,[ 97 515 483  89 181],452,5,24990,3.7539432176656153,20.0,0.0
36657,3,6657,[237 427 265 210 288],882,4,24994,3.7539801742264944,0.0,0.0
36658,3,6658,[211 265 197 276   4],533,2,24996,3.753716774290434,0.0,0.0
36659,3,6659,[200 318 172 180 121],899,4,25000,3.7537537537537538,20.0,0.0
36660,3,6660,[265 258 423 286 118],343,3,25003,3.7536405945053297,0.0,0.0
36661,3,6661,[153   4 603  70 237],398,3,25006,3.7535274692284597,20.0,0.0
36662,3,6662,[183 405   9 271 127],334,3,25009,3.7534143779078493,0.0,20.0
36663,3,6663,[603 302 427 127  64],339,5,25014,3.7536014405762304,20.0,20.0
36664,3,6664,[174 275  95 191 238],524,3,25017,3.7534883720930234,0.0,20.0
36665,3,6665,[328 202 301 268 405],145,4,25021,3.7535253525352537,0.0,0.0
36666,3,6666,[234 174 475 300 471],479,3,25024,3.7534123293835306,0.0,20.0
36667,3,6667,[191 265 161  79 196],7,4,25028,3.7534493101379725,0.0,0.0
36668,3,6668,[ 50   4 222 173 186],64,4,25032,3.753486279802069,0.0,20.0
36669,3,6669,[603 302 427 127  64],664,5,25037,3.753673163418291,20.0,20.0
36670,3,6670,[405  28 228 515 194],343,5,25042,3.753859991005846,0.0,0.0
36671,3,6671,[282 183 182 238 211],653,0,25042,3.753297362110312,0.0,0.0
36672,3,6672,[603 302 427 127  64],339,5,25047,3.7534841900194813,20.0,20.0
36673,3,6673,[175 179  12 275   4],524,2,25049,3.7532214563979625,20.0,0.0
36674,3,6674,[118 194 172 357 258],774,0,25049,3.7526591760299626,20.0,0.0
36675,3,6675,[200 515 215 153   7],95,4,25053,3.7526962252846015,0.0,0.0
36676,3,6676,[ 12  56  28 403 423],398,4,25057,3.7527332634416655,20.0,0.0
36677,3,6677,[603 302 427 127  64],458,5,25062,3.752920035938904,20.0,20.0
36678,3,6678,[ 15 194 403 111 211],543,3,25065,3.7528073064830063,0.0,0.0
36679,3,6679,[302  98 144 143 265],13,4,25069,3.7528443113772454,0.0,20.0
36680,3,6680,[181 182 435 194 405],749,3,25072,3.7527316270019457,0.0,0.0
36681,3,6681,[186  71 176 143 546],882,4,25076,3.752768632146064,0.0,0.0
36682,3,6682,[245 100 216 269 153],452,3,25079,3.752655992817597,0.0,20.0
36683,3,6683,[191  69 174 187 161],648,2,25081,3.752393776181927,0.0,20.0
36684,3,6684,[ 11 196 245  56  88],454,1,25082,3.751982049364248,0.0,0.0
36685,3,6685,[603 302 427 127  64],745,4,25086,3.752019144481005,20.0,20.0
36686,3,6686,[ 70 117  15 323  82],83,5,25091,3.7522057723941975,0.0,0.0
36687,3,6687,[269 186  89  96 172],239,4,25095,3.7522428229665072,0.0,0.0
36688,3,6688,[ 64 211  56   9 175],234,1,25096,3.751831364927493,0.0,0.0
36689,3,6689,[603 302 427 127  64],90,5,25101,3.752017937219731,20.0,20.0
36690,3,6690,[282 180 271 132 302],788,4,25105,3.7520549992527275,0.0,0.0
36691,3,6691,[173 302 228 202 301],145,5,25110,3.752241482367005,0.0,0.0
36692,3,6692,[ 82 117 111   1 191],13,1,25111,3.7518302704317943,0.0,0.0
36693,3,6693,[655  95 204  22 161],804,4,25115,3.751867343890051,0.0,0.0
36694,3,6694,[603 302 427 127  64],664,5,25120,3.7520537714712474,20.0,20.0
36695,3,6695,[ 50 496 318 180 183],666,4,25124,3.7520908004778972,20.0,20.0
36696,3,6696,[195 405 748 121 265],474,4,25128,3.752127818426161,0.0,0.0
36697,3,6697,[125 603 216 175 161],7,4,25132,3.752164825320991,20.0,0.0
36698,3,6698,[234 161  69 546 176],643,2,25134,3.7519032691446483,0.0,0.0
36699,3,6699,[168 496  56  22 265],234,2,25136,3.751641791044776,0.0,0.0
36700,3,6700,[405 546 597 322 118],825,5,25141,3.751828085360394,0.0,0.0
36701,3,6701,[183  95 234 151 496],380,4,25145,3.751865114891077,0.0,0.0
36702,3,6702,[ 97 546 588 185 496],7,5,25150,3.7520513203043415,0.0,0.0
36703,3,6703,[  9  11 132 194 179],64,5,25155,3.7522374701670644,0.0,0.0
36704,3,6704,[  4 186 403 161  56],318,1,25156,3.751826994780015,0.0,0.0
36705,3,6705,[603 302 427 127  64],271,5,25161,3.752013122576797,20.0,20.0
36706,3,6706,[302   1  69 216 204],339,3,25164,3.751900998956314,0.0,0.0
36707,3,6707,[ 97 496 121 151 143],308,2,25166,3.7516398330351817,0.0,0.0
36708,3,6708,[322  70  22 475 385],119,4,25170,3.7516768519898642,0.0,0.0
36709,3,6709,[228 328  28 318   1],13,2,25172,3.7514157973174367,20.0,0.0
36710,3,6710,[435  15  28 385 187],892,4,25176,3.751452838623156,0.0,0.0
36711,3,6711,[173  25  69  96 655],537,1,25177,3.7510429082240764,0.0,0.0
36712,3,6712,[182 202   9 135 423],6,3,25180,3.750931029346045,0.0,0.0
36713,3,6713,[182 286 515 185 234],90,4,25184,3.750968126303247,0.0,0.0
36714,3,6714,[588 515 127 276 237],184,5,25189,3.751154132539092,0.0,20.0
36715,3,6715,[151   7 235 194 275],648,3,25192,3.75104228707564,0.0,0.0
36716,3,6716,[603 302 427 127  64],13,5,25197,3.751228226887003,20.0,20.0
36717,3,6717,[  1 181 197  50 175],312,4,25201,3.7512652575171184,0.0,20.0
36718,3,6718,[603  95 508 153  89],543,3,25204,3.7511534454531925,20.0,0.0
36719,3,6719,[603  22  12 265 318],308,4,25208,3.751190476190476,60.0,0.0
36720,3,6720,[603 302 427 127  64],474,5,25213,3.751376283291177,20.0,20.0
36721,3,6721,[175 194 328  98 333],13,3,25216,3.7512645046117226,0.0,20.0
36722,3,6722,[  7 135 546 202 194],343,4,25220,3.7513015023055183,0.0,0.0
36723,3,6723,[289  96 132 385 174],13,3,25223,3.751189767995241,0.0,20.0
36724,3,6724,[183 546 185 194   1],102,1,25224,3.7507806691449814,0.0,0.0
36725,3,6725,[ 69 435 175  98 302],343,5,25229,3.7509663990484685,0.0,20.0
36726,3,6726,[603 302 427 127  64],339,5,25234,3.751152073732719,20.0,20.0
36727,3,6727,[ 11  12 182 180 258],537,3,25237,3.751040428061831,20.0,0.0
36728,3,6728,[483  96 127 180 471],308,3,25240,3.7509288155743796,20.0,20.0
36729,3,6729,[357 153 151 197  88],298,3,25243,3.750817236255572,20.0,0.0
36730,3,6730,[603 302 427 127  64],458,5,25248,3.7510028227603627,20.0,20.0
36731,3,6731,[588 294 568 357 117],263,2,25250,3.7507427213309565,20.0,0.0
36732,3,6732,[357 323 174 257 475],474,3,25253,3.7506312193672953,20.0,20.0
36733,3,6733,[742 294 202 204 144],308,3,25256,3.7505197505197505,0.0,0.0
36734,3,6734,[496  98  69 196 258],380,5,25261,3.7507052709725315,0.0,20.0
36735,3,6735,[173 471  82  12 195],374,3,25264,3.7505938242280283,20.0,0.0
36736,3,6736,[288 176  96 483  22],648,5,25269,3.7507792786106577,20.0,0.0
36737,3,6737,[ 96 175  50   8 385],892,4,25273,3.750816265954289,0.0,20.0
36738,3,6738,[318 748 182 204  89],788,2,25275,3.750556462383143,20.0,0.0
36739,3,6739,[603 302 427 127  64],537,4,25279,3.750593471810089,20.0,20.0
36740,3,6740,[328 508   9 286 318],334,3,25282,3.7504821243139,20.0,0.0
36741,3,6741,[117 269 323 289 228],455,2,25284,3.7502224859092257,0.0,0.0
36742,3,6742,[300  96 111 483 121],454,3,25287,3.7501112264570664,20.0,0.0
36743,3,6743,[143 144   4  88 238],378,3,25290,3.75,0.0,0.0
36744,3,6744,[195  28 151   8 204],308,4,25294,3.7500370644922163,0.0,0.0
36745,3,6745,[603 302 427 127  64],669,5,25299,3.750222353987548,20.0,20.0
36746,3,6746,[211 161 153 655   1],308,4,25303,3.750259374536831,0.0,0.0
36747,3,6747,[288   7 403 172 423],7,5,25308,3.7504445761707172,0.0,0.0
36748,3,6748,[ 95  79 191 200  88],738,2,25310,3.7501852126240927,0.0,0.0
36749,3,6749,[508  22 237 196  96],474,4,25314,3.7502222222222223,0.0,0.0
36750,3,6750,[603 302 427 127  64],271,5,25319,3.750407347059695,20.0,20.0
36751,3,6751,[286 161   8  98  22],533,4,25323,3.7504443127962084,0.0,20.0
36752,3,6752,[200  96  70  71 175],378,4,25327,3.750481267584777,0.0,0.0
36753,3,6753,[328 405 275 475  70],334,2,25329,3.75022209061297,0.0,0.0
36754,3,6754,[302 204 111 132   7],334,3,25332,3.7501110288675057,0.0,0.0
36755,3,6755,[603 302 427 127  64],458,5,25337,3.7502960331557134,20.0,20.0
36756,3,6756,[603 302 427 127  64],664,5,25342,3.7504809826846235,20.0,20.0
36757,3,6757,[603 302 427 127  64],13,5,25347,3.7506658774785437,20.0,20.0
36758,3,6758,[603 302 427 127  64],271,5,25352,3.7508507175617694,20.0,20.0
36759,3,6759,[265 100  15 288 111],479,2,25354,3.7505917159763316,0.0,20.0
36760,3,6760,[603 302 427 127  64],666,5,25359,3.750776512350244,20.0,20.0
36761,3,6761,[289 282 245 546 471],92,3,25362,3.750665483584738,0.0,0.0
36762,3,6762,[603 234  56  96 144],379,5,25367,3.7508502144018925,20.0,0.0
36763,3,6763,[ 95 186 144 276 423],308,4,25371,3.7508870490833828,0.0,0.0
36764,3,6764,[603 302 427 127  64],745,4,25375,3.7509238728750924,20.0,20.0
36765,3,6765,[ 56 111 197 357 302],13,4,25379,3.7509606857818505,20.0,0.0
36766,3,6766,[603 302 427 127  64],458,5,25384,3.7511452637801095,20.0,20.0
36767,3,6767,[603 302 427 127  64],669,5,25389,3.7513297872340425,20.0,20.0
36768,3,6768,[ 50 288 144  89 100],643,4,25393,3.751366523858768,0.0,40.0
36769,3,6769,[603 302 427 127  64],474,5,25398,3.7515509601181685,20.0,20.0
36770,3,6770,[603 302 427 127  64],745,4,25402,3.7515876532269976,20.0,20.0
36771,3,6771,[603 302 427 127  64],666,5,25407,3.75177200236267,20.0,20.0
36772,3,6772,[ 11 282 238  98 125],554,2,25409,3.751513361878045,0.0,20.0
36773,3,6773,[603 302 427 127  64],664,5,25414,3.7516976675524063,20.0,20.0
36774,3,6774,[603 302 427 127  64],271,5,25419,3.7518819188191883,20.0,20.0
36775,3,6775,[318 100 204  56 322],454,3,25422,3.751770956316411,20.0,20.0
36776,3,6776,[603 302 427 127  64],745,4,25426,3.751807584476907,20.0,20.0
36777,3,6777,[ 82  88  71 181  28],479,4,25430,3.751844201829448,0.0,0.0
36778,3,6778,[313 276  96 176  15],144,4,25434,3.751880808378817,0.0,0.0
36779,3,6779,[603 302 427 127  64],90,5,25439,3.7520648967551624,20.0,20.0
36780,3,6780,[603 302 427 127  64],745,4,25443,3.752101459961658,20.0,20.0
36781,3,6781,[118 121 125 435 405],194,1,25444,3.7516956649955766,0.0,0.0
36782,3,6782,[288 185 187   9 435],7,5,25449,3.7518796992481205,0.0,0.0
36783,3,6783,[ 79 183 153 173 423],659,5,25454,3.752063679245283,0.0,0.0
36784,3,6784,[603 302 427 127  64],474,5,25459,3.752247605011054,20.0,20.0
36785,3,6785,[603 302 427 127  64],13,5,25464,3.7524314765694076,20.0,20.0
36786,3,6786,[ 89  82 179  69 496],897,4,25468,3.7524679534404006,0.0,0.0
36787,3,6787,[294  95  82 222 357],882,5,25473,3.752651738361815,20.0,0.0
36788,3,6788,[603 302 427 127  64],664,5,25478,3.752835469141258,20.0,20.0
36789,3,6789,[100 195 748  71  50],92,4,25482,3.7528718703976436,0.0,40.0
36790,3,6790,[181 121 127 175  56],346,5,25487,3.753055514651745,0.0,20.0
36791,3,6791,[282  25   4 228 183],194,1,25488,3.7526501766784452,0.0,0.0
36792,3,6792,[496 655 196 405  96],538,3,25491,3.7525393787722656,0.0,0.0
36793,3,6793,[603 302 427 127  64],664,5,25496,3.7527229908743007,20.0,20.0
36794,3,6794,[603 234 475 268 174],90,4,25500,3.752759381898455,20.0,20.0
36795,3,6795,[603 302 427 127  64],537,4,25504,3.7527957622130663,20.0,20.0
36796,3,6796,[427  98 202  79  89],406,3,25507,3.752685008091805,0.0,20.0
36797,3,6797,[603 302 427 127  64],458,5,25512,3.7528684907325682,20.0,20.0
36798,3,6798,[603 302 427 127  64],458,5,25517,3.753051919399912,20.0,20.0
36799,3,6799,[603 302 427 127  64],474,5,25522,3.7532352941176472,20.0,20.0
36800,3,6800,[135 235 127 508 197],833,4,25526,3.7532715777091603,0.0,20.0
36801,3,6801,[176 179 144 294 100],387,2,25528,3.7530138194648632,0.0,20.0
36802,3,6802,[603 302 427 127  64],339,5,25533,3.7531971189181244,20.0,20.0
36803,3,6803,[603 302 427 127  64],90,5,25538,3.7533803644914756,20.0,20.0
36804,3,6804,[603 302 427 127  64],664,5,25543,3.75356355620867,20.0,20.0
36805,3,6805,[603 302 427 127  64],458,5,25548,3.7537466940934467,20.0,20.0
36806,3,6806,[603 302 427 127  64],13,5,25553,3.7539297781695313,20.0,20.0
36807,3,6807,[  1 132  98  50 117],184,4,25557,3.7539659224441833,0.0,40.0
36808,3,6808,[204 328 568 286 173],378,4,25561,3.754002056102218,0.0,0.0
36809,3,6809,[234 496  79 515 322],234,3,25564,3.753891336270191,0.0,0.0
36810,3,6810,[288 183   7 268 187],13,3,25567,3.7537806489502277,0.0,0.0
36811,3,6811,[  1  11 313 423 568],200,5,25572,3.7539635936582503,0.0,0.0
36812,3,6812,[546 742 118 678 597],825,5,25577,3.754146484661676,0.0,0.0
36813,3,6813,[216 257 179 603 237],334,4,25581,3.7541825653067216,20.0,0.0
36814,3,6814,[603 302 427 127  64],745,4,25585,3.7542186353631695,20.0,20.0
36815,3,6815,[125 117  11  82 202],881,5,25590,3.754401408450704,0.0,0.0
36816,3,6816,[ 12  97 151 195 288],234,0,25590,3.7538506674490244,20.0,0.0
36817,3,6817,[ 71 176 173  28 121],406,2,25592,3.753593429158111,0.0,0.0
36818,3,6818,[216   7 200  97 191],653,2,25594,3.753336266314709,0.0,0.0
36819,3,6819,[603 302 427 127  64],339,5,25599,3.7535190615835776,20.0,20.0
36820,3,6820,[603 302 427 127  64],458,5,25604,3.7537018032546547,20.0,20.0
36821,3,6821,[ 98  96 258  64 568],328,4,25608,3.7537379067722076,0.0,20.0
36822,3,6822,[204 202 179 496 121],897,3,25611,3.753627436611461,0.0,0.0
36823,3,6823,[603 302 427 127  64],474,5,25616,3.753810082063306,20.0,20.0
36824,3,6824,[603 302 427 127  64],13,5,25621,3.753992673992674,20.0,20.0
36825,3,6825,[228 302 655 483 173],339,5,25626,3.754175212423088,20.0,0.0
36826,3,6826,[597 333 117  28 222],533,4,25630,3.7542112201552658,0.0,0.0
36827,3,6827,[186 172  11   8 211],13,4,25634,3.7542472173403634,0.0,0.0
36828,3,6828,[183 568 210 603 228],804,5,25639,3.754429638307219,20.0,0.0
36829,3,6829,[202 257 258 173 180],271,4,25643,3.7544655929721817,0.0,0.0
36830,3,6830,[313 168  79 286 282],334,5,25648,3.754647928560972,0.0,0.0
36831,3,6831,[271 546 100   7  56],548,4,25652,3.7546838407494145,0.0,20.0
36832,3,6832,[ 64 568 111  88  79],95,5,25657,3.7548660910288305,0.0,0.0
36833,3,6833,[202 100  69 483   1],234,3,25660,3.7547556335967225,20.0,20.0
36834,3,6834,[603 302 427 127  64],271,5,25665,3.754937820043892,20.0,20.0
36835,3,6835,[603 302 427 127  64],339,5,25670,3.7551199531889994,20.0,20.0
36836,3,6836,[603 302 427 127  64],474,5,25675,3.755302033055434,20.0,20.0
36837,3,6837,[194 301 357 180 200],234,3,25678,3.755191576484352,20.0,0.0
36838,3,6838,[603 302 427 127  64],745,4,25682,3.7552273724228686,20.0,20.0
36839,3,6839,[603 302 427 127  64],458,5,25687,3.755409356725146,20.0,20.0
36840,3,6840,[603 302 427 127  64],666,5,25692,3.7555912878234174,20.0,20.0
36841,3,6841,[603 302 427 127  64],13,5,25697,3.7557731657410116,20.0,20.0
36842,3,6842,[603 302 427 127  64],745,4,25701,3.7558088557650153,20.0,20.0
36843,3,6843,[405 742 568 289  79],881,4,25705,3.7558445353594387,0.0,0.0
36844,3,6844,[211  88 183 265 235],738,2,25707,3.7555880204528855,0.0,0.0
36845,3,6845,[603 302 427 127  64],669,5,25712,3.7557697925796085,20.0,20.0
36846,3,6846,[153  88 117 143  12],234,0,25712,3.7552212647874983,20.0,0.0
36847,3,6847,[603 302 427 127  64],666,5,25717,3.7554030373831777,20.0,20.0
36848,3,6848,[ 98 195  64  56 289],458,3,25720,3.7552927434661996,0.0,20.0
36849,3,6849,[191 135  89 153 181],92,5,25725,3.7554744525547443,0.0,0.0
36850,3,6850,[234 197 196 403 144],234,2,25727,3.7552182163187857,0.0,0.0
36851,3,6851,[200  12  64 111 289],234,3,25730,3.7551079976649153,20.0,0.0
36852,3,6852,[603 302 427 127  64],664,5,25735,3.7552896541660585,20.0,20.0
36853,3,6853,[238 216 405 385   1],648,4,25739,3.7553253574555003,0.0,0.0
36854,3,6854,[275  50 135  88   7],343,5,25744,3.7555069292487238,0.0,20.0
36855,3,6855,[182 100 180 257  15],378,4,25748,3.7555425904317388,0.0,20.0
36856,3,6856,[603 302 427 127  64],458,5,25753,3.75572407758495,20.0,20.0
36857,3,6857,[300 301 185 132 282],666,3,25756,3.7556138815981335,0.0,0.0
36858,3,6858,[301 235   4 179 197],537,2,25758,3.7553579238956116,0.0,0.0
36859,3,6859,[ 22 202  28 357 144],833,3,25761,3.7552478134110787,20.0,0.0
36860,3,6860,[  8 211 322 275  70],311,4,25765,3.755283486372249,0.0,0.0
36861,3,6861,[265 275 135 176 496],311,5,25770,3.7554648790440104,0.0,0.0
36862,3,6862,[228 313 185 235 183],145,5,25775,3.755646218854728,0.0,0.0
36863,3,6863,[ 79 183 427 195 294],474,4,25779,3.7556818181818183,0.0,0.0
36864,3,6864,[603 302 427 127  64],458,5,25784,3.755863073561544,20.0,20.0
36865,3,6865,[603 302 427 127  64],271,5,25789,3.756044276143315,20.0,20.0
36866,3,6866,[143  71 268   8 742],92,3,25792,3.7559341779525264,0.0,0.0
36867,3,6867,[181 234 125  56 117],313,3,25795,3.755824111822947,0.0,0.0
36868,3,6868,[603 302 427 127  64],537,4,25799,3.7558596593390594,20.0,20.0
36869,3,6869,[603 302 427 127  64],271,5,25804,3.7560407569141194,20.0,20.0
36870,3,6870,[603 302 427 127  64],745,4,25808,3.756076262552758,20.0,20.0
36871,3,6871,[ 71 183  22 176 222],380,3,25811,3.755966239813737,0.0,0.0
36872,3,6872,[496  96 282 143 161],42,5,25816,3.7561472428342793,0.0,0.0
36873,3,6873,[153   4 200 508 245],378,2,25818,3.7558917660750653,0.0,0.0
36874,3,6874,[153 185 172 603  28],60,4,25822,3.7559272727272726,20.0,0.0
36875,3,6875,[515 210 245  95  28],92,3,25825,3.7558173356602675,0.0,0.0
36876,3,6876,[  1 748 191  96 195],648,4,25829,3.7558528428093645,0.0,0.0
36877,3,6877,[603 302 427 127  64],339,5,25834,3.756033730735679,20.0,20.0
36878,3,6878,[603 302 427 127  64],271,5,25839,3.75621456607065,20.0,20.0
36879,3,6879,[603 302 427 127  64],474,5,25844,3.7563953488372093,20.0,20.0
36880,3,6880,[222 180 215 173 194],648,3,25847,3.7562854236302865,0.0,0.0
36881,3,6881,[161 179 144 568  97],543,3,25850,3.7561755303690787,0.0,0.0
36882,3,6882,[603 302 427 127  64],537,4,25854,3.756210954525643,20.0,20.0
36883,3,6883,[174 172 168 202 196],271,4,25858,3.7562463683904705,0.0,20.0
36884,3,6884,[202  64  71 276 173],234,1,25859,3.755846042120552,0.0,0.0
36885,3,6885,[603 302 427 127  64],90,5,25864,3.756026720882951,20.0,20.0
36886,3,6886,[228 176   9 118 318],7,3,25867,3.755916944968782,20.0,0.0
36887,3,6887,[328 202  28 322  82],92,0,25867,3.7553716608594656,0.0,0.0
36888,3,6888,[183  89 187 174 175],406,4,25871,3.755407170852083,0.0,20.0
36889,3,6889,[180   8 182 215  22],474,5,25876,3.755587808417997,0.0,0.0
36890,3,6890,[ 88 161 357  89 183],774,1,25877,3.755187926280656,20.0,0.0
36891,3,6891,[603 302 427 127  64],669,5,25882,3.7553685432385375,20.0,20.0
36892,3,6892,[ 96 322 288 210 151],804,3,25885,3.7552589583635574,0.0,0.0
36893,3,6893,[603 302 427 127  64],669,5,25890,3.7554395126196694,20.0,20.0
36894,3,6894,[603 302 427 127  64],271,5,25895,3.7556200145032634,20.0,20.0
36895,3,6895,[603 302 427 127  64],339,5,25900,3.7558004640371228,20.0,20.0
36896,3,6896,[ 79  88 125   8 132],298,4,25904,3.7558358706684065,0.0,0.0
36897,3,6897,[286 202 153 125   8],298,2,25906,3.7555813279211367,0.0,0.0
36898,3,6898,[210 546 237   7  11],346,4,25910,3.7556167560516016,0.0,0.0
36899,3,6899,[125 118   1  64   4],83,3,25913,3.7555072463768115,0.0,0.0
36900,3,6900,[ 69   1 191  95 196],64,5,25918,3.755687581509926,0.0,0.0
36901,3,6901,[187   9 174  28 144],788,4,25922,3.7557229788467112,0.0,20.0
36902,3,6902,[603 302 427 127  64],458,5,25927,3.7559032304795017,20.0,20.0
36903,3,6903,[  4 121 276 153 132],643,5,25932,3.7560834298957126,0.0,0.0
36904,3,6904,[603 302 427 127  64],90,5,25937,3.7562635771180304,20.0,20.0
36905,3,6905,[603 302 427 127  64],13,5,25942,3.7564436721691283,20.0,20.0
36906,3,6906,[603 302 427 127  64],745,4,25946,3.7564789344143623,20.0,20.0
36907,3,6907,[187 185 238 228 258],749,3,25949,3.7563694267515926,0.0,0.0
36908,3,6908,[ 69 546 235 143 180],213,3,25952,3.7562599507888264,0.0,0.0
36909,3,6909,[194 257 186 215 301],378,3,25955,3.756150506512301,0.0,0.0
36910,3,6910,[185 172 194  97 496],890,5,25960,3.7563304876284183,0.0,0.0
36911,3,6911,[289 204 257 191   4],318,3,25963,3.756221064814815,0.0,0.0
36912,3,6912,[ 89 597 121   8 176],92,4,25967,3.756256328656155,0.0,0.0
36913,3,6913,[117 204 275 215 143],308,3,25970,3.756146948221001,0.0,0.0
36914,3,6914,[748 151 132 302 238],524,3,25973,3.7560375994215476,0.0,0.0
36915,3,6915,[603 302 427 127  64],745,4,25977,3.756072874493927,20.0,20.0
36916,3,6916,[127  56 100  28 546],833,3,25980,3.7559635680208183,0.0,40.0
36917,3,6917,[603 302 427 127  64],537,4,25984,3.7559988435964153,20.0,20.0
36918,3,6918,[ 79 204 385 194 742],207,3,25987,3.7558895794189913,0.0,0.0
36919,3,6919,[655 174  82 288 153],378,4,25991,3.7559248554913296,0.0,20.0
36920,3,6920,[111 191 237 181 173],378,4,25995,3.7559601213697444,0.0,0.0
36921,3,6921,[176  69 258  95 200],738,4,25999,3.7559953770586536,0.0,0.0
36922,3,6922,[215 471 288 202  15],533,4,26003,3.756030622562473,0.0,0.0
36923,3,6923,[385 276 176 269 215],343,4,26007,3.7560658578856154,0.0,0.0
36924,3,6924,[603 302 427 127  64],664,5,26012,3.756245487364621,20.0,20.0
36925,3,6925,[125  89  70 655 172],119,4,26016,3.7562806814900376,0.0,0.0
36926,3,6926,[183 121  69 282 210],378,4,26020,3.7563158654540203,0.0,0.0
36927,3,6927,[ 96 187 121 174 435],102,1,26021,3.755918013856813,0.0,20.0
36928,3,6928,[603 302 427 127  64],458,5,26026,3.7560975609756095,20.0,20.0
36929,3,6929,[357 176 197 200 471],543,4,26030,3.756132756132756,20.0,0.0
36930,3,6930,[603 302 427 127  64],13,5,26035,3.7563122204588084,20.0,20.0
36931,3,6931,[496 286 204 179 258],271,4,26039,3.7563473744950953,0.0,0.0
36932,3,6932,[187 176 118 483 135],308,3,26042,3.7562382806865715,20.0,0.0
36933,3,6933,[333 191  97  95 211],537,2,26044,3.755985001442169,0.0,0.0
36934,3,6934,[603 302 427 127  64],339,5,26049,3.756164383561644,20.0,20.0
36935,3,6935,[ 15 127   9 483 546],533,4,26053,3.756199538638985,20.0,20.0
36936,3,6936,[  8 100 153  97 111],452,4,26057,3.7562346835807987,0.0,20.0
36937,3,6937,[603 302 427 127  64],474,5,26062,3.756413952147593,20.0,20.0
36938,3,6938,[289 183 144 132 238],10,5,26067,3.756593169044531,0.0,0.0
36939,3,6939,[210 197 180 194 117],648,2,26069,3.7563400576368875,0.0,0.0
36940,3,6940,[603 302 427 127  64],537,4,26073,3.756375162080392,20.0,20.0
36941,3,6941,[211 173 222 515 234],883,4,26077,3.7564102564102564,0.0,0.0
36942,3,6942,[238 161 194 655  22],833,0,26077,3.755869220797926,0.0,0.0
36943,3,6943,[ 50 181 179 174 180],340,3,26080,3.7557603686635943,0.0,40.0
36944,3,6944,[168 111 121 471 215],533,5,26085,3.7559395248380127,0.0,0.0
36945,3,6945,[186  28  12 215 174],774,0,26085,3.7553987906708897,20.0,20.0
36946,3,6946,[245 196 300 117  97],90,2,26087,3.7551461062329063,0.0,0.0
36947,3,6947,[603 302 427 127  64],458,5,26092,3.7553252734599885,20.0,20.0
36948,3,6948,[183 153 273 257 294],92,3,26095,3.755216577924881,0.0,0.0
36949,3,6949,[603 302 427 127  64],669,5,26100,3.7553956834532376,20.0,20.0
36950,3,6950,[603 302 427 127  64],13,5,26105,3.755574737447849,20.0,20.0
36951,3,6951,[  7 210   8 179 196],87,5,26110,3.755753739930955,0.0,0.0
36952,3,6952,[173 215 179 269 483],537,3,26113,3.755645045304185,20.0,0.0
36953,3,6953,[508  64 275 405 197],455,4,26117,3.755680184066724,0.0,0.0
36954,3,6954,[  7 275 153 288 211],7,5,26122,3.7558590941768513,0.0,0.0
36955,3,6955,[603 302 427 127  64],537,4,26126,3.755894192064405,20.0,20.0
36956,3,6956,[603 302 427 127  64],669,5,26131,3.756073019979876,20.0,20.0
36957,3,6957,[603 302 427 127  64],664,5,26136,3.7562517964932454,20.0,20.0
36958,3,6958,[603 302 427 127  64],664,5,26141,3.7564305216266707,20.0,20.0
36959,3,6959,[603 302 427 127  64],664,5,26146,3.756609195402299,20.0,20.0
36960,3,6960,[173 568  69  22 313],883,1,26147,3.756213187760379,0.0,0.0
36961,3,6961,[515 195   7 273 127],102,1,26148,3.7558172938810688,0.0,20.0
36962,3,6962,[603 302 427 127  64],537,4,26152,3.7558523624874334,20.0,20.0
36963,3,6963,[182 118 144 222 174],788,1,26153,3.755456634118323,0.0,20.0
36964,3,6964,[216 742 228 173  22],804,5,26158,3.7556353194544148,0.0,0.0
36965,3,6965,[174 121  82 257 204],290,5,26163,3.755813953488372,0.0,20.0
36966,3,6966,[234 475 179 211 168],64,5,26168,3.7559925362422852,0.0,0.0
36967,3,6967,[216 151 127 175   4],339,4,26172,3.756027554535017,0.0,20.0
36968,3,6968,[69 98  4 70  8],328,3,26175,3.755919070167886,0.0,20.0
36969,3,6969,[173 228 168 186   4],334,3,26178,3.7558106169296988,0.0,0.0
36970,3,6970,[603 302 427 127  64],474,5,26183,3.7559890976904318,20.0,20.0
36971,3,6971,[127 187  12 301 186],334,3,26186,3.7558806655192196,20.0,20.0
36972,3,6972,[357 175 313 202 153],650,4,26190,3.7559156747454465,20.0,0.0
36973,3,6973,[655  22 678  12 202],387,2,26192,3.7556638944651564,20.0,0.0
36974,3,6974,[328 294 181  98 216],328,3,26195,3.7555555555555555,0.0,20.0
36975,3,6975,[318 435 194 183 265],7,5,26200,3.7557339449541285,20.0,0.0
36976,3,6976,[179 273  15 125 197],749,5,26205,3.755912283216282,0.0,0.0
36977,3,6977,[603 302 427 127  64],271,5,26210,3.7560905703640013,20.0,20.0
36978,3,6978,[215 258 121 265  22],343,3,26213,3.75598223241152,0.0,0.0
36979,3,6979,[180 300   7 678 181],13,2,26215,3.755730659025788,0.0,0.0
36980,3,6980,[603 302 427 127  64],271,5,26220,3.7559088955737,20.0,20.0
36981,3,6981,[678  97 172 282 118],804,5,26225,3.7560870810655973,0.0,0.0
36982,3,6982,[603 302 427 127  64],474,5,26230,3.756265215523414,20.0,20.0
36983,3,6983,[603 302 427 127  64],339,5,26235,3.756443298969072,20.0,20.0
36984,3,6984,[204 143 216 179 496],406,3,26238,3.756335003579098,0.0,0.0
36985,3,6985,[  4 302 127 222 195],339,4,26242,3.7563698826223875,0.0,20.0
36986,3,6986,[603 302 427 127  64],745,4,26246,3.7564047516816945,20.0,20.0
36987,3,6987,[603 302 427 127  64],458,5,26251,3.7565827132226675,20.0,20.0
36988,3,6988,[405 273 100 176 144],328,4,26255,3.756617541851481,0.0,20.0
36989,3,6989,[135  96 180  82 588],650,2,26257,3.7563662374821174,0.0,0.0
36990,3,6990,[  1 182 144 168 258],234,0,26257,3.7558289229008723,0.0,0.0
36991,3,6991,[191 483  12  50  64],343,5,26262,3.7560068649885583,40.0,20.0
36992,3,6992,[435 215 174 143 228],59,4,26266,3.756041756041756,0.0,20.0
36993,3,6993,[603 302 427 127  64],458,5,26271,3.756219616814412,20.0,20.0
36994,3,6994,[ 97   9 191 276 357],533,2,26273,3.7559685489635455,20.0,0.0
36995,3,6995,[603 302 427 127  64],458,5,26278,3.7561463693539165,20.0,20.0
36996,3,6996,[603 302 427 127  64],339,5,26283,3.7563241389166784,20.0,20.0
36997,3,6997,[  4 257 289  96 176],374,2,26285,3.7560731637610747,0.0,0.0
36998,3,6998,[181 588 153  64 275],13,4,26289,3.756108015430776,0.0,0.0
36999,3,6999,[603 302 427 127  64],664,5,26294,3.7562857142857142,20.0,20.0
37000,3,7000,[483 172 286 294  97],452,4,26298,3.7563205256391945,20.0,0.0
37001,3,7001,[603 302 427 127  64],745,4,26302,3.7563553270494143,20.0,20.0
37002,3,7002,[603 302 427 127  64],458,5,26307,3.7565329144652293,20.0,20.0
37003,3,7003,[196  95 268 475 603],537,3,26310,3.75642490005711,20.0,0.0
37004,3,7004,[ 95 181 182 168 172],64,5,26315,3.756602426837973,0.0,0.0
37005,3,7005,[603 302 427 127  64],474,5,26320,3.756779902940337,20.0,20.0
37006,3,7006,[185  56 603   8 121],13,4,26324,3.756814613957471,20.0,0.0
37007,3,7007,[195 135 435 286  15],533,4,26328,3.756849315068493,0.0,0.0
37008,3,7008,[603 302 427 127  64],13,5,26333,3.757026679982879,20.0,20.0
37009,3,7009,[ 22 143 135 423 172],378,4,26337,3.757061340941512,0.0,0.0
37010,3,7010,[186 127 403 435 173],387,2,26339,3.756810726001997,0.0,20.0
37011,3,7011,[186 168 405 496 748],804,5,26344,3.7569880205362236,0.0,0.0
37012,3,7012,[234 496 508 180  95],85,4,26348,3.757022672180237,0.0,0.0
37013,3,7013,[588 597 202  96 258],275,0,26348,3.7564870259481036,0.0,0.0
37014,3,7014,[  7 143 235  50  97],308,3,26351,3.7563791874554524,0.0,20.0
37015,3,7015,[603 302 427 127  64],339,5,26356,3.756556442417332,20.0,20.0
37016,3,7016,[153  50  15  22 183],313,2,26358,3.7563061137238134,0.0,20.0
37017,3,7017,[151 175 144 568 183],308,4,26362,3.75634083784554,0.0,0.0
37018,3,7018,[603 302 427 127  64],271,5,26367,3.756518022510329,20.0,20.0
37019,3,7019,[322  79 197 132 405],313,3,26370,3.7564102564102564,0.0,0.0
37020,3,7020,[603 302 427 127  64],745,4,26374,3.7564449508617006,20.0,20.0
37021,3,7021,[202 515  88 195  22],537,1,26375,3.756052406721732,0.0,0.0
37022,3,7022,[603 302 427 127  64],664,5,26380,3.7562295315392285,20.0,20.0
37023,3,7023,[435 100 405 195  82],313,3,26383,3.756121867881549,0.0,20.0
37024,3,7024,[197 405 200 176 423],13,2,26385,3.7558718861209965,0.0,0.0
37025,3,7025,[257 258 238   7 597],650,2,26387,3.755621975519499,0.0,0.0
37026,3,7026,[  4 172 294 234 328],234,2,26389,3.755372136046677,0.0,0.0
37027,3,7027,[268  56   7 117 357],13,2,26391,3.7551223676721683,20.0,0.0
37028,3,7028,[ 70 151 211 385 185],479,4,26395,3.755157205861431,0.0,0.0
37029,3,7029,[678  50  88 318 127],474,4,26399,3.7551920341394025,20.0,40.0
37030,3,7030,[603 302 427 127  64],669,5,26404,3.7553690797895034,20.0,20.0
37031,3,7031,[ 88 195 186 153 215],749,5,26409,3.7555460750853245,0.0,0.0
37032,3,7032,[ 69 202 234 143  88],653,1,26410,3.7551542727143468,0.0,0.0
37033,3,7033,[603 302 427 127  64],474,5,26415,3.7553312482229173,20.0,20.0
37034,3,7034,[200 111 234  50  96],479,5,26420,3.755508173418621,0.0,20.0
37035,3,7035,[238 191 161 168 127],650,3,26423,3.7554007959067652,0.0,20.0
37036,3,7036,[427  98 276  22  50],59,5,26428,3.7555776609350575,0.0,40.0
37037,3,7037,[742 180 186  25  28],533,3,26431,3.7554703040636546,0.0,0.0
37038,3,7038,[294  82 204 597 245],207,0,26431,3.7549367807927263,0.0,0.0
37039,3,7039,[508  79 174  11 423],543,3,26434,3.7548295454545455,0.0,20.0
37040,3,7040,[ 96 153 301  95 275],378,4,26438,3.7548643658571224,0.0,0.0
37041,3,7041,[211 238  88 427 186],313,3,26441,3.754757171258165,0.0,0.0
37042,3,7042,[603 302 427 127  64],745,4,26445,3.7547919920488426,20.0,20.0
37043,3,7043,[144 132  28 179 197],194,4,26449,3.7548268029528677,0.0,0.0
37044,3,7044,[  7 294  71 265 323],881,3,26452,3.75471965933286,0.0,0.0
37045,3,7045,[603 135  22 237 313],271,5,26457,3.754896395117797,20.0,0.0
37046,3,7046,[ 22 176 197 268 127],13,4,26461,3.754931176387115,0.0,20.0
37047,3,7047,[603 302 427 127  64],13,5,26466,3.7551078320090805,20.0,20.0
37048,3,7048,[603 302 427 127  64],271,5,26471,3.7552844375088665,20.0,20.0
37049,3,7049,[161  50 211  97  96],804,5,26476,3.7554609929078016,0.0,20.0
37050,3,7050,[603 302 427 127  64],669,5,26481,3.755637498227202,20.0,20.0
37051,3,7051,[603 302 427 127  64],666,5,26486,3.755813953488372,20.0,20.0
37052,3,7052,[603 302 427 127  64],745,4,26490,3.7558485750744364,20.0,20.0
37053,3,7053,[289  88 196 181 211],194,1,26491,3.75545789622909,0.0,0.0
37054,3,7054,[423 265 257  96 210],533,4,26495,3.7554925584691707,0.0,0.0
37055,3,7055,[405   7  96 172  28],537,1,26496,3.7551020408163267,0.0,0.0
37056,3,7056,[182 508  82 180   1],92,4,26500,3.7551367436587784,0.0,0.0
37057,3,7057,[ 22 194  79 546  82],897,5,26505,3.755313119863984,0.0,0.0
37058,3,7058,[181 194   7 405 127],102,0,26505,3.7547811304717382,0.0,20.0
37059,3,7059,[191 313 301 322   4],234,3,26508,3.7546742209631727,0.0,0.0
37060,3,7060,[275 100 196  96 268],189,5,26513,3.754850587735448,0.0,20.0
37061,3,7061,[475 121 268  69  22],387,1,26514,3.7544604927782497,0.0,0.0
37062,3,7062,[546   4 191 204 186],882,4,26518,3.7544952569729575,0.0,0.0
37063,3,7063,[742 234 187  82 568],788,1,26519,3.7541053227633068,0.0,0.0
37064,3,7064,[288 318 268 135 176],387,1,26520,3.753715498938429,20.0,0.0
37065,3,7065,[ 98 175 237 183 176],313,4,26524,3.753750353806963,0.0,20.0
37066,3,7066,[197 195 678 258 496],749,4,26528,3.753785198811377,0.0,0.0
37067,3,7067,[100 194 132 515 135],87,5,26533,3.753961516694963,0.0,20.0
37068,3,7068,[275 175 403 204 132],13,3,26536,3.753854859244589,0.0,0.0
37069,3,7069,[603 302 427 127  64],666,5,26541,3.754031117397454,20.0,20.0
37070,3,7070,[ 69  56  25 175 117],234,1,26542,3.753641634846556,0.0,0.0
37071,3,7071,[191  88 186 176 182],650,3,26545,3.7535350678733033,0.0,0.0
37072,3,7072,[265 269 257 183 423],738,3,26548,3.753428531033508,0.0,0.0
37073,3,7073,[197   1 228  98  82],881,3,26551,3.7533220243143908,0.0,20.0
37074,3,7074,[475 742 175   7 238],308,5,26556,3.7534982332155478,0.0,0.0
37075,3,7075,[603 302 427 127  64],474,5,26561,3.753674392312041,20.0,20.0
37076,3,7076,[ 50 117 200   1 168],13,2,26563,3.7534265931892046,0.0,20.0
37077,3,7077,[172 211 161 235  11],64,4,26567,3.7534614297824245,0.0,0.0
37078,3,7078,[238 186 176 215 143],749,4,26571,3.7534962565334085,0.0,0.0
37079,3,7079,[603 302 427 127  64],339,5,26576,3.753672316384181,20.0,20.0
37080,3,7080,[195 186 175  12 191],279,3,26579,3.7535658805253496,20.0,0.0
37081,3,7081,[118 269 257 176 100],145,4,26583,3.75360067777464,0.0,20.0
37082,3,7082,[603 302 427 127  64],474,5,26588,3.753776648312862,20.0,20.0
37083,3,7083,[603 302 427 127  64],666,5,26593,3.7539525691699605,20.0,20.0
37084,3,7084,[197  88 210 175 176],650,3,26596,3.753846153846154,0.0,0.0
37085,3,7085,[ 69 153 742 176 655],833,0,26596,3.7533163985323172,0.0,0.0
37086,3,7086,[168  12  71 172 182],406,3,26599,3.753210103005503,20.0,0.0
37087,3,7087,[174  64   4 333 300],533,4,26603,3.753244920993228,0.0,20.0
37088,3,7088,[182  98 173 153 237],326,3,26606,3.753138665538158,0.0,20.0
37089,3,7089,[100  88 313 127 174],738,3,26609,3.7530324400564177,0.0,60.0
37090,3,7090,[111 135 200 597  12],13,3,26612,3.7529262445353266,20.0,0.0
37091,3,7091,[603 302 427 127  64],13,5,26617,3.753102086858432,20.0,20.0
37092,3,7092,[742 168 496 288 179],308,4,26621,3.753136895530805,0.0,0.0
37093,3,7093,[603 302 427 127  64],666,5,26626,3.7533126585847194,20.0,20.0
37094,3,7094,[161 151 318 288 204],346,3,26629,3.7532064834390417,20.0,0.0
37095,3,7095,[151 173 210  12 742],666,2,26631,3.752959413754228,20.0,0.0
37096,3,7096,[211  95 132 483 357],325,2,26633,3.752712413695928,40.0,0.0
37097,3,7097,[211  12 427 286 168],194,4,26637,3.7527472527472527,20.0,0.0
37098,3,7098,[ 95  11 195  89  64],378,3,26640,3.752641217072827,0.0,0.0
37099,3,7099,[603 302 427 127  64],90,5,26645,3.7528169014084507,20.0,20.0
37100,3,7100,[603 302 427 127  64],90,5,26650,3.7529925362624983,20.0,20.0
37101,3,7101,[742 234   8 427 168],899,5,26655,3.7531681216558717,0.0,0.0
37102,3,7102,[742 197 174 265 196],207,4,26659,3.7532028720259047,0.0,20.0
37103,3,7103,[603 302 427 127  64],664,5,26664,3.7533783783783785,20.0,20.0
37104,3,7104,[603 302 427 127  64],13,5,26669,3.753553835327234,20.0,20.0
37105,3,7105,[603 302 427 127  64],745,4,26673,3.7535885167464116,20.0,20.0
37106,3,7106,[182 385 546  70 265],881,3,26676,3.753482482059941,0.0,0.0
37107,3,7107,[ 22 258 269  12 151],537,1,26677,3.753095104108047,20.0,0.0
37108,3,7108,[200 144 403   9 161],60,4,26681,3.75312983541989,0.0,0.0
37109,3,7109,[153 181  69 127 191],334,4,26685,3.7531645569620253,0.0,20.0
37110,3,7110,[121 180 194 144 496],339,3,26688,3.753058641541274,0.0,0.0
37111,3,7111,[603 302 427 127  64],458,5,26693,3.753233970753656,20.0,20.0
37112,3,7112,[235 300 125  28 135],313,2,26695,3.7529874876985803,0.0,0.0
37113,3,7113,[234 323 210  22 302],13,3,26698,3.7528816418330053,0.0,0.0
37114,3,7114,[174 313 546 603  82],650,3,26701,3.752775825720309,20.0,20.0
37115,3,7115,[435 132 183 168  25],194,2,26703,3.7525295109612142,0.0,0.0
37116,3,7116,[ 11 191  71  70  25],378,4,26707,3.752564282703386,0.0,0.0
37117,3,7117,[187 289 186 302   9],334,3,26710,3.7524585557740937,0.0,0.0
37118,3,7118,[603 302 427 127  64],90,5,26715,3.7526337968815846,20.0,20.0
37119,3,7119,[603 302 427 127  64],537,4,26719,3.7526685393258425,20.0,20.0
37120,3,7120,[ 96 289 323 238 210],13,1,26720,3.752281982867575,0.0,0.0
37121,3,7121,[182 216 191 427 435],7,5,26725,3.7524571749508566,0.0,0.0
37122,3,7122,[238  25 181 228 237],313,2,26727,3.7522111469886283,0.0,0.0
37123,3,7123,[135 435 153  11 215],788,0,26727,3.7516844469399215,0.0,0.0
37124,3,7124,[168  70 268 181 215],643,2,26729,3.7514385964912282,0.0,0.0
37125,3,7125,[197 235 118  64 323],13,3,26732,3.7513331462250914,0.0,0.0
37126,3,7126,[603 302 427 127  64],666,5,26737,3.751508348533745,20.0,20.0
37127,3,7127,[194 403 328 289 655],378,4,26741,3.751543209876543,0.0,0.0
37128,3,7128,[603 302 427 127  64],666,5,26746,3.75171833356712,20.0,20.0
37129,3,7129,[603 302 427 127  64],666,5,26751,3.7518934081346424,20.0,20.0
37130,3,7130,[ 12 475 210 403 111],64,4,26755,3.7519282008133503,20.0,0.0
37131,3,7131,[603 302 427 127  64],13,5,26760,3.752103196859226,20.0,20.0
37132,3,7132,[204  98 195 183 125],200,5,26765,3.752278143838497,0.0,20.0
37133,3,7133,[318 202 228 210 168],7,4,26769,3.752312867956266,20.0,0.0
37134,3,7134,[234 125  12 265 405],271,3,26772,3.7522074281709883,20.0,0.0
37135,3,7135,[175 496 172 302 234],537,3,26775,3.7521020179372195,0.0,0.0
37136,3,7136,[181 318 180 174 183],308,5,26780,3.7522768670309654,20.0,20.0
37137,3,7137,[603 302 427 127  64],669,5,26785,3.7524516671336507,20.0,20.0
37138,3,7138,[603 302 427 127  64],90,5,26790,3.7526264182658635,20.0,20.0
37139,3,7139,[143 271 204 435 195],536,3,26793,3.7525210084033613,0.0,0.0
37140,3,7140,[180 235  12   1 100],194,3,26796,3.7524156280632965,20.0,20.0
37141,3,7141,[258 273 195 100 125],64,2,26798,3.7521702604312517,0.0,20.0
37142,3,7142,[496  22  50 228  82],87,5,26803,3.752344953100938,0.0,20.0
37143,3,7143,[202 200 216  71   4],92,2,26805,3.7520996640537514,0.0,0.0
37144,3,7144,[286 742 508  50 222],26,1,26806,3.7517144856543037,0.0,20.0
37145,3,7145,[265 235 228   9 238],145,4,26810,3.751749230338651,0.0,0.0
37146,3,7146,[435  97  89 210  22],387,3,26813,3.751644046453057,0.0,0.0
37147,3,7147,[121   4 385  98 328],207,2,26815,3.751398992725238,0.0,20.0
37148,3,7148,[294 180 300 175  96],7,4,26819,3.751433766960414,0.0,0.0
37149,3,7149,[ 97 143 546 181  98],308,2,26821,3.751188811188811,0.0,20.0
37150,3,7150,[603 302 427 127  64],664,5,26826,3.751363445671934,20.0,20.0
37151,3,7151,[483 238 323 286 117],648,2,26828,3.751118568232662,20.0,0.0
37152,3,7152,[100  82 496   9  70],234,2,26830,3.750873759261848,0.0,20.0
37153,3,7153,[  8  98 204  11 202],543,4,26834,3.750908582611127,0.0,20.0
37154,3,7154,[603 302 427 127  64],745,4,26838,3.750943396226415,20.0,20.0
37155,3,7155,[603 302 427 127  64],537,4,26842,3.750978200111794,20.0,20.0
37156,3,7156,[603 302 427 127  64],537,4,26846,3.751012994271343,20.0,20.0
37157,3,7157,[ 50 385 118 515 191],311,4,26850,3.7510477787091365,0.0,20.0
37158,3,7158,[127  88 211 143 121],311,3,26853,3.750942869115798,0.0,20.0
37159,3,7159,[603 302 427 127  64],669,5,26858,3.751117318435754,20.0,20.0
37160,3,7160,[216 121 143  96  79],538,3,26861,3.751012428431783,0.0,0.0
37161,3,7161,[603 302 427 127  64],666,5,26866,3.7511868193242113,20.0,20.0
37162,3,7162,[210 200 175  15 204],648,2,26868,3.750942342593885,0.0,0.0
37163,3,7163,[603 302 427 127  64],745,4,26872,3.7509771077610274,20.0,20.0
37164,3,7164,[228  15   1 257  98],145,3,26875,3.7508722958827634,0.0,20.0
37165,3,7165,[603 302 427 127  64],339,5,26880,3.7510466089868824,20.0,20.0
37166,3,7166,[603 302 427 127  64],474,5,26885,3.7512208734477466,20.0,20.0
37167,3,7167,[603 302 427 127  64],13,5,26890,3.7513950892857144,20.0,20.0
37168,3,7168,[405  89  69 173 276],537,3,26893,3.7512902775840424,0.0,0.0
37169,3,7169,[603 302 427 127  64],458,5,26898,3.7514644351464437,20.0,20.0
37170,3,7170,[603 302 427 127  64],271,5,26903,3.7516385441361035,20.0,20.0
37171,3,7171,[427 286 168  56 235],334,4,26907,3.7516731734523145,0.0,0.0
37172,3,7172,[508 238 151 313 197],653,1,26908,3.7512895580649657,0.0,0.0
37173,3,7173,[185 153 182 286 475],479,3,26911,3.751184834123223,0.0,0.0
37174,3,7174,[748 211  11 423 121],346,5,26916,3.7513588850174218,0.0,0.0
37175,3,7175,[603 302 427 127  64],664,5,26921,3.7515328874024525,20.0,20.0
37176,3,7176,[ 15 197 275 161  82],184,2,26923,3.751288839347917,0.0,0.0
37177,3,7177,[271 118  15 127 603],749,4,26927,3.7513234884368907,20.0,20.0
37178,3,7178,[603 302 427 127  64],664,5,26932,3.7514974230394205,20.0,20.0
37179,3,7179,[186 117 423 471 168],313,3,26935,3.751392757660167,0.0,0.0
37180,3,7180,[603 302 427 127  64],669,5,26940,3.7515666341735137,20.0,20.0
37181,3,7181,[603 302 427 127  64],666,5,26945,3.751740462266778,20.0,20.0
37182,3,7182,[603 302 427 127  64],458,5,26950,3.7519142419601836,20.0,20.0
37183,3,7183,[182 121 204 235 200],210,4,26954,3.7519487750556793,0.0,0.0
37184,3,7184,[603 302 427 127  64],90,5,26959,3.7521224773834376,20.0,20.0
37185,3,7185,[191 135 222  97 322],881,4,26963,3.752156971889786,0.0,0.0
37186,3,7186,[195  96 210 748  82],653,5,26968,3.7523305969110896,0.0,0.0
37187,3,7187,[546 174 435 135 117],749,4,26972,3.7523650528658874,0.0,20.0
37188,3,7188,[603 302 427 127  64],90,5,26977,3.7525386006398667,20.0,20.0
37189,3,7189,[200 475 161 179  56],387,3,26980,3.752433936022253,0.0,0.0
37190,3,7190,[603 302 427 127  64],90,5,26985,3.752607425949103,20.0,20.0
37191,3,7191,[172  56 289   1 288],387,3,26988,3.752502780867631,0.0,0.0
37192,3,7192,[ 95 357 742 403 197],881,3,26991,3.752398164882525,20.0,0.0
37193,3,7193,[300   1 515 568  28],488,3,26994,3.7522935779816513,0.0,0.0
37194,3,7194,[168 175 483  50 200],881,1,26995,3.751911049339819,20.0,20.0
37195,3,7195,[603 302 427 127  64],13,5,27000,3.7520844913841023,20.0,20.0
37196,3,7196,[435  82 603  79  64],60,4,27004,3.752118938446575,20.0,0.0
37197,3,7197,[603 302 427 127  64],271,5,27009,3.752292303417616,20.0,20.0
37198,3,7198,[194  25 183 211 271],650,3,27012,3.7521878038616476,0.0,0.0
37199,3,7199,[655 515  50 385 211],833,0,27012,3.7516666666666665,0.0,20.0
37200,3,7200,[234  96 238 118 117],311,4,27016,3.751701152617692,0.0,0.0
37201,3,7201,[603 302 427 127  64],666,5,27021,3.7518744793113026,20.0,20.0
37202,3,7202,[ 69  79   7 568 173],378,4,27025,3.7519089268360406,0.0,0.0
37203,3,7203,[289 328 153   8  98],234,3,27028,3.751804553026097,0.0,20.0
37204,3,7204,[118  97   4 496 187],804,5,27033,3.7519777931991674,0.0,0.0
37205,3,7205,[603 302 427 127  64],664,5,27038,3.752150985290036,20.0,20.0
37206,3,7206,[603 302 427 127  64],339,5,27043,3.7523241293187177,20.0,20.0
37207,3,7207,[ 95  69 196 588  70],233,5,27048,3.7524972253052162,0.0,0.0
37208,3,7208,[603 302 427 127  64],745,4,27052,3.7525315577750034,20.0,20.0
37209,3,7209,[210 216 435 286 125],533,5,27057,3.752704576976422,0.0,0.0
37210,3,7210,[235 151 508 216 265],378,4,27061,3.7527388711690475,0.0,0.0
37211,3,7211,[ 89 286 200  56  28],334,4,27065,3.752773155851359,0.0,0.0
37212,3,7212,[172 173 302 191 197],934,4,27069,3.752807431027312,0.0,0.0
37213,3,7213,[603 302 427 127  64],458,5,27074,3.752980316052121,20.0,20.0
37214,3,7214,[405  79  12  97  98],343,5,27079,3.753153153153153,20.0,20.0
37215,3,7215,[603 302 427 127  64],537,4,27083,3.753187361419069,20.0,20.0
37216,3,7216,[173 204  56 191 181],454,2,27085,3.7529444367465707,0.0,0.0
37217,3,7217,[603 302 427 127  64],474,5,27090,3.7531172069825436,20.0,20.0
37218,3,7218,[603 302 427 127  64],271,5,27095,3.753289929353096,20.0,20.0
37219,3,7219,[ 82 182 235  56  28],788,1,27096,3.752908587257618,0.0,0.0
37220,3,7220,[144  64  25 328 200],234,2,27098,3.7526658357568206,0.0,0.0
37221,3,7221,[ 82 228 132  89  98],313,3,27101,3.7525616172805316,0.0,20.0
37222,3,7222,[603 302 427 127  64],745,4,27105,3.752595874290461,20.0,20.0
37223,3,7223,[ 82 222 180   1 200],788,2,27107,3.7523532668881505,0.0,0.0
37224,3,7224,[182 748 176 185 508],474,3,27110,3.752249134948097,0.0,0.0
37225,3,7225,[275 174  88  95 385],13,3,27113,3.7521450318295044,0.0,20.0
37226,3,7226,[ 22   8 423 603 179],271,5,27118,3.752317697523177,20.0,0.0
37227,3,7227,[313 471 121 475 181],474,4,27122,3.7523519645821803,0.0,0.0
37228,3,7228,[588 603 168 483 286],650,3,27125,3.752247890441278,40.0,0.0
37229,3,7229,[678  15 180 215 174],749,4,27129,3.7522821576763485,0.0,20.0
37230,3,7230,[215   8 228 100 385],234,2,27131,3.752039828516111,0.0,20.0
37231,3,7231,[603 302 427 127  64],13,5,27136,3.752212389380531,20.0,20.0
37232,3,7232,[748 195 172   8  96],313,3,27139,3.7521083920918015,0.0,0.0
37233,3,7233,[117 187 222  82 288],234,1,27140,3.7517279513408903,0.0,0.0
37234,3,7234,[117 202 588  97 385],537,0,27140,3.751209398756047,0.0,0.0
37235,3,7235,[603 302 427 127  64],666,5,27145,3.751381978993919,20.0,20.0
37236,3,7236,[179 508 185 318 172],524,4,27149,3.7514163327345584,20.0,0.0
37237,3,7237,[111 403 385  95 265],59,4,27153,3.751450676982592,0.0,0.0
37238,3,7238,[234 111 273 121  15],479,4,27157,3.7514850117419534,0.0,0.0
37239,3,7239,[237 215 186  50 174],295,5,27162,3.751657458563536,0.0,40.0
37240,3,7240,[603 302 427 127  64],664,5,27167,3.751829857754454,20.0,20.0
37241,3,7241,[603 302 427 127  64],666,5,27172,3.752002209334438,20.0,20.0
37242,3,7242,[603 302 427 127  64],745,4,27176,3.752036448985227,20.0,20.0
37243,3,7243,[132 546 143 215 121],749,3,27179,3.7519326339039205,0.0,0.0
37244,3,7244,[603 302 427 127  64],458,5,27184,3.7521048999309867,20.0,20.0
37245,3,7245,[176 191  79  70 210],648,4,27188,3.752139111233784,0.0,0.0
37246,3,7246,[603 302 427 127  64],666,5,27193,3.752311301228094,20.0,20.0
37247,3,7247,[282  50 202 323 289],378,3,27196,3.7522075055187636,0.0,20.0
37248,3,7248,[ 82 194  89 176  79],749,5,27201,3.7523796385708375,0.0,0.0
37249,3,7249,[603 302 427 127  64],666,5,27206,3.752551724137931,20.0,20.0
37250,3,7250,[603 302 427 127  64],474,5,27211,3.752723762239691,20.0,20.0
37251,3,7251,[603 302 427 127  64],669,5,27216,3.752895752895753,20.0,20.0
37252,3,7252,[ 82  11  89 405  70],881,4,27220,3.7529298221425615,0.0,0.0
37253,3,7253,[  8 357 655 483  25],194,3,27223,3.7528260270195752,40.0,0.0
37254,3,7254,[186 597 117 127 237],13,3,27226,3.752722260509993,0.0,20.0
37255,3,7255,[204 385  89   1   9],326,1,27227,3.7523428886438808,0.0,0.0
37256,3,7256,[183 204 403 228  70],95,4,27231,3.752377015295577,0.0,0.0
37257,3,7257,[603 302 427 127  64],745,4,27235,3.7524111325434,20.0,20.0
37258,3,7258,[  7 127  98 288 508],334,3,27238,3.752307480369197,0.0,40.0
37259,3,7259,[200  15 286 300 313],234,2,27240,3.7520661157024793,0.0,0.0
37260,3,7260,[603 302 427 127  64],90,5,27245,3.752237983748795,20.0,20.0
37261,3,7261,[603 302 427 127  64],90,5,27250,3.752409804461581,20.0,20.0
37262,3,7262,[286 322 185 300  22],13,1,27251,3.752030841250172,0.0,0.0
37263,3,7263,[603 302 427 127  64],669,5,27256,3.752202643171806,20.0,20.0
37264,3,7264,[603 302 427 127  64],669,5,27261,3.75237439779766,20.0,20.0
37265,3,7265,[228  11 121 215  56],881,2,27263,3.752133223231489,0.0,0.0
37266,3,7266,[  8 568 211 273 313],328,2,27265,3.7518921150405946,0.0,0.0
37267,3,7267,[182 200  70 471 258],234,1,27266,3.751513483764447,0.0,0.0
37268,3,7268,[603 302 427 127  64],666,5,27271,3.751685238684826,20.0,20.0
37269,3,7269,[183 143 132 172 181],378,5,27276,3.751856946354883,0.0,0.0
37270,3,7270,[603 302 427 127  64],664,5,27281,3.7520286067941138,20.0,20.0
37271,3,7271,[118 228 282 405 423],653,1,27282,3.7516501650165015,0.0,0.0
37272,3,7272,[597 403  12 195 100],7,4,27286,3.751684311838306,20.0,20.0
37273,3,7273,[603 302 427 127  64],339,5,27291,3.751855925213088,20.0,20.0
37274,3,7274,[211 435 258 202 195],537,2,27293,3.751615120274914,0.0,0.0
37275,3,7275,[ 70  15 187 328 144],488,2,27295,3.7513743815283123,0.0,0.0
37276,3,7276,[ 70 135 286 216 435],474,5,27300,3.7515459667445374,0.0,0.0
37277,3,7277,[603 302 427 127  64],537,4,27304,3.7515801044242925,20.0,20.0
37278,3,7278,[215 258 195 289 202],454,3,27307,3.7514768512158265,0.0,0.0
37279,3,7279,[ 64 238 211 286 289],488,2,27309,3.751236263736264,0.0,0.0
37280,3,7280,[603 302 427 127  64],90,5,27314,3.7514077736574647,20.0,20.0
37281,3,7281,[194   4 100 176 186],638,2,27316,3.75116726174128,0.0,20.0
37282,3,7282,[276 302  12  70 186],378,4,27320,3.751201427982974,20.0,0.0
37283,3,7283,[403  98 191 173 275],648,5,27325,3.751372872048325,0.0,20.0
37284,3,7284,[ 96 234 197 118 323],454,3,27328,3.7512697323266986,0.0,0.0
37285,3,7285,[118 282 117 143  71],311,3,27331,3.751166620916827,0.0,0.0
37286,3,7286,[405 238 174  22 423],295,5,27336,3.751337999176616,0.0,20.0
37287,3,7287,[289 176 204 234 655],833,0,27336,3.7508232711306255,0.0,0.0
37288,3,7288,[603 302 427 127  64],745,4,27340,3.7508574564412127,20.0,20.0
37289,3,7289,[172 257  22  88 174],479,5,27345,3.751028806584362,0.0,20.0
37290,3,7290,[603 302 427 127  64],339,5,27350,3.7512001097243175,20.0,20.0
37291,3,7291,[603 302 427 127  64],666,5,27355,3.751371365880417,20.0,20.0
37292,3,7292,[603 302 427 127  64],474,5,27360,3.7515425750719866,20.0,20.0
37293,3,7293,[288  89 275  50  88],13,3,27363,3.751439539347409,0.0,20.0
37294,3,7294,[ 82   7 143   9 181],92,3,27366,3.7513365318711447,0.0,0.0
37295,3,7295,[ 50 237 172 174  96],360,3,27369,3.7512335526315788,0.0,40.0
37296,3,7296,[161 568 175  98 238],524,3,27372,3.751130601617103,0.0,20.0
37297,3,7297,[ 71 168   8 328   7],95,5,27377,3.751301726500411,0.0,0.0
37298,3,7298,[ 95 168 496 117 186],387,1,27378,3.750924784217016,0.0,0.0
37299,3,7299,[423 117 275 172 238],454,1,27379,3.7505479452054793,0.0,0.0
37300,3,7300,[603 302 427 127  64],664,5,27384,3.7507190795781398,20.0,20.0
37301,3,7301,[ 96 403  82 204  97],60,2,27386,3.7504793207340454,0.0,0.0
37302,3,7302,[515 237 153   9   4],64,3,27389,3.7503765575790773,0.0,0.0
37303,3,7303,[ 89 175 276 168 151],664,5,27394,3.7505476451259585,0.0,0.0
37304,3,7304,[174 153  98 333 423],298,4,27398,3.7505817932922656,0.0,40.0
37305,3,7305,[ 69 151 176 237  96],883,3,27401,3.75047905830824,0.0,0.0
37306,3,7306,[603 302 427 127  64],90,5,27406,3.7506500615847815,20.0,20.0
37307,3,7307,[  9 172 179 427  71],234,1,27407,3.7502736726874657,0.0,0.0
37308,3,7308,[603 302 427 127  64],458,5,27412,3.750444657271857,20.0,20.0
37309,3,7309,[173 200 323  88  28],897,4,27416,3.7504787961696304,0.0,0.0
37310,3,7310,[195 210 118 435 597],102,1,27417,3.750102585145671,0.0,0.0
37311,3,7311,[228 151 132 175 483],804,4,27421,3.750136761487965,20.0,0.0
37312,3,7312,[204 403 655 588 117],102,2,27423,3.7498974429098864,0.0,0.0
37313,3,7313,[151 496 222 301 173],524,2,27425,3.749658189773038,0.0,0.0
37314,3,7314,[603 302 427 127  64],339,5,27430,3.749829118250171,20.0,20.0
37315,3,7315,[ 88 435 235 222 385],290,3,27433,3.7497266265718974,0.0,0.0
37316,3,7316,[603 302 427 127  64],745,4,27437,3.749760830941643,20.0,20.0
37317,3,7317,[153 276 597 117 144],643,3,27440,3.74965837660563,0.0,0.0
37318,3,7318,[176  96 678 168  82],13,2,27442,3.7494193195791774,0.0,0.0
37319,3,7319,[483   1 175  82 268],234,1,27443,3.7490437158469945,20.0,0.0
37320,3,7320,[597  69 289 125 228],533,3,27446,3.7489414014478895,0.0,0.0
37321,3,7321,[385  56 168 210 151],387,3,27449,3.748839114995903,0.0,0.0
37322,3,7322,[ 69 151 211  79 276],339,5,27454,3.749009968592107,0.0,0.0
37323,3,7323,[ 22 181 475 655 180],833,1,27455,3.748634625887493,0.0,0.0
37324,3,7324,[ 82 185  15 508  12],207,3,27458,3.748532423208191,20.0,0.0
37325,3,7325,[168 234 181 172 161],881,2,27460,3.748293748293748,0.0,0.0
37326,3,7326,[423 318 323 181 153],263,3,27463,3.748191620035485,20.0,0.0
37327,3,7327,[228 161  50 655 151],64,3,27466,3.748089519650655,0.0,20.0
37328,3,7328,[ 50 127 197 216  89],95,4,27470,3.748123891390367,0.0,40.0
37329,3,7329,[200  25   9 496  70],59,4,27474,3.7481582537517055,0.0,0.0
37330,3,7330,[151 117  25  15 235],374,2,27476,3.7479197926613015,0.0,0.0
37331,3,7331,[282 121 294 173 318],200,5,27481,3.7480905619203493,20.0,0.0
37332,3,7332,[385 742  95   8 125],92,3,27484,3.7479885449338606,0.0,0.0
37333,3,7333,[603 302 427 127  64],537,4,27488,3.748022907008454,20.0,20.0
37334,3,7334,[471  12 194  82 403],543,3,27491,3.7479209270620313,20.0,0.0
37335,3,7335,[183 187 333 294 215],537,1,27492,3.747546346782988,0.0,0.0
37336,3,7336,[ 12 597 268 161 132],7,2,27494,3.7473081640997683,20.0,0.0
37337,3,7337,[603 302 427 127  64],537,4,27498,3.7473426001635324,20.0,20.0
37338,3,7338,[302   9 471 153  97],543,2,27500,3.747104510151247,0.0,0.0
37339,3,7339,[322 385  15 276 194],537,1,27501,3.746730245231608,0.0,0.0
37340,3,7340,[471 127 181 435  69],313,5,27506,3.746900967170685,0.0,20.0
37341,3,7341,[ 69 191  70  71 183],6,3,27509,3.7467992372650505,0.0,0.0
37342,3,7342,[603 302 427 127  64],474,5,27514,3.746969903309274,20.0,20.0
37343,3,7343,[603 302 427 127  64],90,5,27519,3.747140522875817,20.0,20.0
37344,3,7344,[603 302 427 127  64],669,5,27524,3.747311095983662,20.0,20.0
37345,3,7345,[603 302 427 127  64],271,5,27529,3.747481622651783,20.0,20.0
37346,3,7346,[143 153  98 275  95],13,3,27532,3.74737988294542,0.0,20.0
37347,3,7347,[234 282   8 568 323],378,4,27536,3.7474142623843223,0.0,0.0
37348,3,7348,[204 215 322 318  98],263,4,27540,3.747448632467002,20.0,20.0
37349,3,7349,[403 546 186   4 423],653,1,27541,3.747074829931973,0.0,0.0
37350,3,7350,[118 273 294 403 174],479,2,27543,3.746837165011563,0.0,20.0
37351,3,7351,[276  22 180 211 237],452,2,27545,3.746599564744287,0.0,0.0
37352,3,7352,[603 302 427 127  64],474,5,27550,3.746770025839793,20.0,20.0
37353,3,7353,[603 302 427 127  64],537,4,27554,3.7468044601577373,20.0,20.0
37354,3,7354,[ 69 173  56 234  98],738,5,27559,3.746974847042828,0.0,20.0
37355,3,7355,[603 483 597  98 168],650,4,27563,3.7470092441544316,40.0,20.0
37356,3,7356,[ 28 515 194 288 143],474,4,27567,3.747043631915183,0.0,0.0
37357,3,7357,[ 22 427 357 200  12],380,5,27572,3.747213916825224,40.0,0.0
37358,3,7358,[168  95 357 235 318],406,4,27576,3.7472482674276395,40.0,0.0
37359,3,7359,[125  97  71  12  56],378,4,27580,3.7472826086956523,20.0,0.0
37360,3,7360,[ 69 228 185 173  12],13,3,27583,3.7471810895258795,20.0,0.0
37361,3,7361,[111 168 423 195 183],749,4,27587,3.7472154305895136,0.0,0.0
37362,3,7362,[655 179 742 328 216],334,2,27589,3.7469781339128074,0.0,0.0
37363,3,7363,[568 405 603 121 144],536,4,27593,3.747012493210212,20.0,0.0
37364,3,7364,[ 64 176 483 546 183],13,3,27596,3.746911065852003,20.0,0.0
37365,3,7365,[603 302 427 127  64],458,5,27601,3.74708118381754,20.0,20.0
37366,3,7366,[288   9 210 117 282],92,4,27605,3.7471155151350617,0.0,0.0
37367,3,7367,[181 228 357 403 153],290,2,27607,3.7468783930510314,20.0,0.0
37368,3,7368,[603 302 427 127  64],271,5,27612,3.747048446193513,20.0,20.0
37369,3,7369,[191 117 135  50  15],749,5,27617,3.7472184531886024,0.0,20.0
37370,3,7370,[  1 222 202 313 168],234,1,27618,3.746845746845747,0.0,0.0
37371,3,7371,[603 302 427 127  64],474,5,27623,3.7470157352143243,20.0,20.0
37372,3,7372,[  9 153  98 269 328],90,4,27627,3.7470500474705006,0.0,20.0
37373,3,7373,[603 302 427 127  64],664,5,27632,3.74721996202875,20.0,20.0
37374,3,7374,[603 302 427 127  64],666,5,27637,3.7473898305084745,20.0,20.0
37375,3,7375,[ 12 471 127  97 118],524,4,27641,3.747424078091106,20.0,20.0
37376,3,7376,[100 197 568 483   4],643,5,27646,3.747593872848041,20.0,20.0
37377,3,7377,[603 302 427 127  64],90,5,27651,3.7477636215776635,20.0,20.0
37378,3,7378,[238 237  28  50 204],271,5,27656,3.7479333242986854,0.0,20.0
37379,3,7379,[  8 385 174 168 210],311,5,27661,3.74810298102981,0.0,20.0
37380,3,7380,[ 96 288  25 258 172],378,4,27665,3.7481371087928466,0.0,0.0
37381,3,7381,[603 302 427 127  64],271,5,27670,3.7483066919534003,20.0,20.0
37382,3,7382,[603 302 427 127  64],271,5,27675,3.748476229175132,20.0,20.0
37383,3,7383,[179 135 132 215 191],90,4,27679,3.748510292524377,0.0,0.0
37384,3,7384,[588 216 302 186 313],537,3,27682,3.7484089370345295,0.0,0.0
37385,3,7385,[ 71   8  25 276 294],406,2,27684,3.7481722177091794,0.0,0.0
37386,3,7386,[172 151 423 435 197],387,1,27685,3.7478001895221333,0.0,0.0
37387,3,7387,[318  88 100 168 179],406,3,27688,3.7476989713048185,20.0,20.0
37388,3,7388,[603 302 427 127  64],90,5,27693,3.7478684531059683,20.0,20.0
37389,3,7389,[603 302 427 127  64],339,5,27698,3.7480378890392423,20.0,20.0
37390,3,7390,[496 182 257 117 403],339,3,27701,3.7479366797456364,0.0,0.0
37391,3,7391,[603 302 427 127  64],669,5,27706,3.7481060606060606,20.0,20.0
37392,3,7392,[603 302 427 127  64],664,5,27711,3.7482753956445287,20.0,20.0
37393,3,7393,[228  96 313 603 427],815,4,27715,3.748309440086557,20.0,0.0
37394,3,7394,[603 302 427 127  64],13,5,27720,3.7484787018255576,20.0,20.0
37395,3,7395,[127  56 286 275 235],406,3,27723,3.748377501352082,0.0,20.0
37396,3,7396,[238 135 191  95 483],892,5,27728,3.7485467081249153,20.0,0.0
37397,3,7397,[423 265 117   4 204],83,4,27732,3.748580697485807,0.0,0.0
37398,3,7398,[172 655 144  69 313],144,5,27737,3.748749831058251,0.0,0.0
37399,3,7399,[288 385 655 318   4],234,2,27739,3.7485135135135135,20.0,0.0
37400,3,7400,[118 357 435 275 191],533,4,27743,3.7485474935819485,20.0,0.0
37401,3,7401,[678 186 202 568 210],13,2,27745,3.7483112672250742,0.0,0.0
37402,3,7402,[ 97 215 234   9  98],60,4,27749,3.7483452654329326,0.0,20.0
37403,3,7403,[187 185 588 276  97],184,4,27753,3.7483792544570504,0.0,0.0
37404,3,7404,[603 302 427 127  64],537,4,27757,3.748413234301148,20.0,20.0
37405,3,7405,[300 313 515 228  64],455,5,27762,3.7485822306238186,0.0,0.0
37406,3,7406,[ 50 204 185 282  97],653,2,27764,3.7483461590387472,0.0,20.0
37407,3,7407,[603 302 427 127  64],537,4,27768,3.748380129589633,20.0,20.0
37408,3,7408,[603 302 427 127  64],271,5,27773,3.7485490619516804,20.0,20.0
37409,3,7409,[194 216 427 117 215],90,3,27776,3.7484480431848852,0.0,0.0
37410,3,7410,[603 302 427 127  64],271,5,27781,3.748616920793415,20.0,20.0
37411,3,7411,[195 144  28 125  56],7,5,27786,3.7487857528332436,0.0,0.0
37412,3,7412,[  7 655  79 258 210],64,3,27789,3.7486847430190204,0.0,0.0
37413,3,7413,[748   4 678  79 182],13,3,27792,3.748583760453197,0.0,0.0
37414,3,7414,[180 597 194 515 210],452,5,27797,3.7487525286581254,0.0,0.0
37415,3,7415,[275  56  82  70 508],533,4,27801,3.7487864077669903,0.0,0.0
37416,3,7416,[ 70 282 125  89 546],378,3,27804,3.748685452339221,0.0,0.0
37417,3,7417,[ 56 515 194 333 191],387,3,27807,3.7485845241304934,0.0,0.0
37418,3,7418,[603 302 427 127  64],339,5,27812,3.7487532012400595,20.0,20.0
37419,3,7419,[  7 117 294 222  56],13,1,27813,3.7483827493261455,0.0,0.0
37420,3,7420,[ 71 313  98 132 427],234,4,27817,3.7484166554372726,0.0,20.0
37421,3,7421,[153 323 182 144 655],488,0,27817,3.7479116141201834,0.0,0.0
37422,3,7422,[603 302 427 127  64],458,5,27822,3.7480802909874713,20.0,20.0
37423,3,7423,[  7 276 228 313 328],145,4,27826,3.748114224137931,0.0,0.0
37424,3,7424,[118 174 333 234 153],313,4,27830,3.748148148148148,0.0,20.0
37425,3,7425,[603 302 427 127  64],339,5,27835,3.7483167250201994,20.0,20.0
37426,3,7426,[175 211 678 435 268],537,3,27838,3.7482159687626226,0.0,0.0
37427,3,7427,[603 302 427 127  64],458,5,27843,3.748384491114701,20.0,20.0
37428,3,7428,[175 118 496 121 237],653,1,27844,3.7480145376228293,0.0,0.0
37429,3,7429,[496 546 435 180 204],290,2,27846,3.7477792732166892,0.0,0.0
37430,3,7430,[603 302 427 127  64],666,5,27851,3.7479477863006325,20.0,20.0
37431,3,7431,[196 100 222  28 546],92,3,27854,3.7478471474703983,0.0,20.0
37432,3,7432,[ 89 258 204 405 151],447,3,27857,3.7477465357190907,0.0,0.0
37433,3,7433,[603 302 427 127  64],537,4,27861,3.7477804681194513,20.0,20.0
37434,3,7434,[603 302 427 127  64],537,4,27865,3.7478143913920645,20.0,20.0
37435,3,7435,[603 302 427 127  64],474,5,27870,3.7479827864443247,20.0,20.0
37436,3,7436,[603 302 427 127  64],339,5,27875,3.7481511362108377,20.0,20.0
37437,3,7437,[403  64  12  97 202],892,4,27879,3.7481849959666578,20.0,0.0
37438,3,7438,[427  88  79  15 286],60,5,27884,3.7483532732894207,0.0,0.0
37439,3,7439,[ 88 276 237 423 427],343,5,27889,3.748521505376344,0.0,0.0
37440,3,7440,[ 79 435 135  22 265],881,4,27893,3.7485553017067597,0.0,0.0
37441,3,7441,[204   8 597 313  89],13,4,27897,3.7485890889545823,0.0,0.0
37442,3,7442,[216 328 179 234 294],234,1,27898,3.7482198038425367,0.0,0.0
37443,3,7443,[603 302 427 127  64],745,4,27902,3.7482536270822138,20.0,20.0
37444,3,7444,[427 195 742 588  70],42,4,27906,3.7482874412357288,0.0,0.0
37445,3,7445,[179 655 185 318 161],334,4,27910,3.748321246306742,20.0,0.0
37446,3,7446,[508 121 175 333 237],85,1,27911,3.7479521955149724,0.0,0.0
37447,3,7447,[603 302 427 127  64],271,5,27916,3.7481203007518795,20.0,20.0
37448,3,7448,[603 302 427 127  64],90,5,27921,3.748288360853806,20.0,20.0
37449,3,7449,[211  50 187 186   4],524,4,27925,3.748322147651007,0.0,20.0
37450,3,7450,[603 302 427 127  64],90,5,27930,3.748490135552275,20.0,20.0
37451,3,7451,[423 257  56 405 318],653,2,27932,3.7482555018786905,20.0,0.0
37452,3,7452,[603 302 427 127  64],745,4,27936,3.748289279484771,20.0,20.0
37453,3,7453,[603 302 427 127  64],13,5,27941,3.748457204185672,20.0,20.0
37454,3,7454,[603 302 427 127  64],474,5,27946,3.7486250838363513,20.0,20.0
37455,3,7455,[603 302 427 127  64],474,5,27951,3.7487929184549356,20.0,20.0
37456,3,7456,[603 302 427 127  64],271,5,27956,3.7489607080595415,20.0,20.0
37457,3,7457,[258 294 182 427 185],13,3,27959,3.748860284258514,0.0,0.0
37458,3,7458,[ 97 234 186 127 179],848,4,27963,3.7488939536130848,0.0,20.0
37459,3,7459,[202 186   4 385 302],13,4,27967,3.7489276139410186,0.0,0.0
37460,3,7460,[234 210 183  56 678],804,4,27971,3.7489612652459456,0.0,0.0
37461,3,7461,[603 302 427 127  64],90,5,27976,3.749128919860627,20.0,20.0
37462,3,7462,[603 302 427 127  64],664,5,27981,3.749296529545759,20.0,20.0
37463,3,7463,[568 185 191  89 655],7,5,27986,3.7494640943194,0.0,0.0
37464,3,7464,[603 302 427 127  64],339,5,27991,3.7496316141995982,20.0,20.0
37465,3,7465,[ 50 182 194 475 153],64,4,27995,3.749665148673989,0.0,20.0
37466,3,7466,[603 118 202 588 323],897,4,27999,3.749698674166332,20.0,0.0
37467,3,7467,[603 302 427 127  64],669,5,28004,3.749866095340118,20.0,20.0
37468,3,7468,[603 302 427 127  64],458,5,28009,3.7500334716829564,20.0,20.0
37469,3,7469,[ 97 183 161 603 117],387,2,28011,3.7497991967871487,20.0,0.0
37470,3,7470,[603 302 655 191 568],13,3,28014,3.7496988354972562,20.0,0.0
37471,3,7471,[121 588 357   8 234],13,4,28018,3.7497323340471094,20.0,0.0
37472,3,7472,[603 302 427 127  64],474,5,28023,3.7498996386993175,20.0,20.0
37473,3,7473,[546 202 222 144 748],804,4,28027,3.7499331014182498,0.0,0.0
37474,3,7474,[483 333 132 313 210],815,3,28030,3.7498327759197325,20.0,0.0
37475,3,7475,[603 302 427 127  64],90,5,28035,3.75,20.0,20.0
37476,3,7476,[300 357  69 187 151],666,2,28037,3.7497659489099906,20.0,0.0
37477,3,7477,[603 302 427 127  64],669,5,28042,3.7499331372024605,20.0,20.0
37478,3,7478,[603 302 427 127  64],664,5,28047,3.750100280786201,20.0,20.0
37479,3,7479,[182 275 234 121  97],406,4,28051,3.750133689839572,0.0,0.0
37480,3,7480,[603 302 427 127  64],474,5,28056,3.750300761930223,20.0,20.0
37481,3,7481,[603 302 427 127  64],669,5,28061,3.7504677893611333,20.0,20.0
37482,3,7482,[603 302 427 127  64],745,4,28065,3.7505011359080584,20.0,20.0
37483,3,7483,[508  64 197 271 483],13,3,28068,3.7504008551576695,20.0,0.0
37484,3,7484,[603 302 427 127  64],745,4,28072,3.750434201736807,20.0,20.0
37485,3,7485,[ 98 176 423 196 121],653,1,28073,3.750066791343842,0.0,20.0
37486,3,7486,[196 237  11 197 204],804,5,28078,3.750233738480032,0.0,0.0
37487,3,7487,[603 302 427 127  64],666,5,28083,3.750400641025641,20.0,20.0
37488,3,7488,[603 302 427 127  64],669,5,28088,3.750567498998531,20.0,20.0
37489,3,7489,[186 357 144 182 322],488,2,28090,3.7503337783711617,20.0,0.0
37490,3,7490,[200  56 185 222 286],488,3,28093,3.750233613669737,0.0,0.0
37491,3,7491,[216   8 357 423 187],207,4,28097,3.7502669514148423,20.0,0.0
37492,3,7492,[ 71 186  98 294 153],452,2,28099,3.7500333644735084,0.0,20.0
37493,3,7493,[135 215   9 168 187],749,3,28102,3.749933279957299,0.0,0.0
37494,3,7494,[ 79  69  88 125 182],378,3,28105,3.7498332221480988,0.0,0.0
37495,3,7495,[603 302 427 127  64],664,5,28110,3.75,20.0,20.0
37496,3,7496,[  4 100 385 323   1],788,1,28111,3.7496331866079764,0.0,20.0
37497,3,7497,[508 282  89 546  22],378,4,28115,3.7496665777540676,0.0,0.0
37498,3,7498,[ 71 195 204 588 483],313,5,28120,3.749833311108148,20.0,0.0
37499,3,7499,[603 302 427 127  64],13,5,28125,3.75,20.0,20.0
37500,3,7500,[235  71  69 117  95],650,1,28126,3.7496333822157046,0.0,0.0
37501,3,7501,[603 302 427 127  64],13,5,28131,3.749800053319115,20.0,20.0
37502,3,7502,[168 187 182   9 588],234,1,28132,3.7494335599093698,0.0,0.0
37503,3,7503,[603 302 427 127  64],458,5,28137,3.7496002132196162,20.0,20.0
37504,3,7504,[289 180  22 597 143],533,2,28139,3.749367088607595,0.0,0.0
37505,3,7505,[546 276  25 588 508],378,4,28143,3.7494004796163067,0.0,0.0
37506,3,7506,[603 302 427 127  64],664,5,28148,3.7495670707339817,20.0,20.0
37507,3,7507,[603 302 427 127  64],339,5,28153,3.7497336174746936,20.0,20.0
37508,3,7508,[603 302 427 127  64],669,5,28158,3.7499001198561728,20.0,20.0
37509,3,7509,[245 204 210  96 357],313,4,28162,3.7499334221038616,20.0,0.0
37510,3,7510,[200 257 194  56 182],213,5,28167,3.7500998535481296,0.0,0.0
37511,3,7511,[ 50 153  69 168 211],64,4,28171,3.750133120340788,0.0,20.0
37512,3,7512,[  7 180 748 197 496],474,4,28175,3.750166378277652,0.0,0.0
37513,3,7513,[588  70  69 196  64],59,3,28178,3.7500665424540855,0.0,0.0
37514,3,7514,[603 302 427 127  64],458,5,28183,3.750232867598137,20.0,20.0
37515,3,7515,[ 70 143 176 257 357],881,4,28187,3.7502660989888237,20.0,0.0
37516,3,7516,[282   1  97 302 174],378,5,28192,3.7504323533324464,0.0,20.0
37517,3,7517,[603 302 427 127  64],745,4,28196,3.750465549348231,20.0,20.0
37518,3,7518,[196 200 118 144   9],92,3,28199,3.750365740125017,0.0,0.0
37519,3,7519,[475 405 333 508 483],343,4,28203,3.7503989361702126,20.0,0.0
37520,3,7520,[135  15 176 282 742],42,4,28207,3.7504321233878475,0.0,0.0
37521,3,7521,[ 69  96 405 125 127],59,3,28210,3.750332358415315,0.0,20.0
37522,3,7522,[135  70 265 127 235],64,5,28215,3.7504984713545126,0.0,20.0
37523,3,7523,[173   7 405 237 185],60,5,28220,3.7506645401382244,0.0,0.0
37524,3,7524,[603 302 427 127  64],90,5,28225,3.750830564784053,20.0,20.0
37525,3,7525,[423 204 289 121 357],13,3,28228,3.750730799893702,20.0,0.0
37526,3,7526,[603 302 427 127  64],339,5,28233,3.7508967716221604,20.0,20.0
37527,3,7527,[333 186 403  28 423],313,2,28235,3.750664187035069,0.0,0.0
37528,3,7528,[ 96  89  56 238 423],774,1,28236,3.7502988444680567,0.0,0.0
37529,3,7529,[211 515  98 132 245],488,3,28239,3.750199203187251,0.0,20.0
37530,3,7530,[268 111 568  95 121],92,2,28241,3.749966803877307,0.0,0.0
37531,3,7531,[475 318 173   9 742],92,2,28243,3.7497344662772174,20.0,0.0
37532,3,7532,[25 64 89 98 95],387,2,28245,3.7495021903624055,0.0,20.0
37533,3,7533,[196 183 202 655 153],840,4,28249,3.7495354393416513,0.0,0.0
37534,3,7534,[301 127 237 286 222],13,2,28251,3.7493032514930325,0.0,20.0
37535,3,7535,[181 508 117  50 180],378,3,28254,3.749203821656051,0.0,20.0
37536,3,7536,[183 258 191 328 271],334,3,28257,3.749104418203529,0.0,0.0
37537,3,7537,[191 423 143 357 161],234,3,28260,3.749005041124967,20.0,0.0
37538,3,7538,[175 132 237 185 385],7,5,28265,3.749170977583234,0.0,0.0
37539,3,7539,[ 28 289 483 222 143],125,5,28270,3.749336870026525,20.0,0.0
37540,3,7540,[603 302 427 127  64],537,4,28274,3.7493701100649783,20.0,20.0
37541,3,7541,[265  11 176 180 121],897,3,28277,3.749270750464068,0.0,0.0
37542,3,7542,[273  88 143  89 385],13,2,28279,3.7490388439612885,0.0,0.0
37543,3,7543,[515 423 117 127 258],6,2,28281,3.7488069989395547,0.0,20.0
37544,3,7544,[183 144 235  71  11],788,2,28283,3.7485752153744203,0.0,0.0
37545,3,7545,[300 121 183  50  22],479,4,28287,3.74860853432282,0.0,20.0
37546,3,7546,[ 69 235  64 175 655],59,4,28291,3.7486418444415,0.0,0.0
37547,3,7547,[357 216 588 118 257],840,3,28294,3.748542660307366,20.0,0.0
37548,3,7548,[603 302 427 127  64],458,5,28299,3.7487084382037357,20.0,20.0
37549,3,7549,[ 79  96 176 289 271],328,4,28303,3.7487417218543047,0.0,0.0
37550,3,7550,[603 302 427 127  64],339,5,28308,3.748907429479539,20.0,20.0
37551,3,7551,[603 302 427 127  64],90,5,28313,3.749073093220339,20.0,20.0
37552,3,7552,[125 238 179  12   8],378,2,28315,3.748841519925857,20.0,0.0
37553,3,7553,[603 302 427 127  64],537,4,28319,3.748874768334657,20.0,20.0
37554,3,7554,[180  89 176 172  28],738,5,28324,3.7490403706154862,0.0,0.0
37555,3,7555,[603 302 427 127  64],458,5,28329,3.749205929062996,20.0,20.0
37556,3,7556,[427  71  97 235 202],194,2,28331,3.748974460764854,0.0,0.0
37557,3,7557,[603 302 427 127  64],664,5,28336,3.7491399841227837,20.0,20.0
37558,3,7558,[603 302 427 127  64],13,5,28341,3.7493054636856726,20.0,20.0
37559,3,7559,[603 302 427 127  64],339,5,28346,3.7494708994708996,20.0,20.0
37560,3,7560,[176   7 515 182   1],145,4,28350,3.7495040338579555,0.0,0.0
37561,3,7561,[603 302 427 127  64],474,5,28355,3.7496693996297275,20.0,20.0
37562,3,7562,[  7 568 168  28 286],95,5,28360,3.7498347216712946,0.0,0.0
37563,3,7563,[603 302 427 127  64],745,4,28364,3.7498677948175567,20.0,20.0
37564,3,7564,[111  98 568 183   1],488,3,28367,3.749768671513549,0.0,20.0
37565,3,7565,[ 82  22 328  50 483],533,5,28372,3.7499339148823685,20.0,20.0
37566,3,7566,[496 403   8 210 234],385,1,28373,3.7495705035020483,0.0,0.0
37567,3,7567,[289 268 143 313 328],234,2,28375,3.7493393234672303,0.0,0.0
37568,3,7568,[603 302 427 127  64],666,5,28380,3.749504558065795,20.0,20.0
37569,3,7569,[202 132 276 475   7],13,3,28383,3.749405548216645,0.0,0.0
37570,3,7570,[182 257 196 603 323],474,3,28386,3.74930656452252,20.0,0.0
37571,3,7571,[144 235 515   4 275],328,3,28389,3.7492076069730587,0.0,0.0
37572,3,7572,[603 302 427 127  64],271,5,28394,3.7493727716888947,20.0,20.0
37573,3,7573,[603 302 427 127  64],666,5,28399,3.7495378927911274,20.0,20.0
37574,3,7574,[603 302 427 127  64],13,5,28404,3.74970297029703,20.0,20.0
37575,3,7575,[ 95  15 132 385 125],892,4,28408,3.7497360084477296,0.0,0.0
37576,3,7576,[655 222 135 294 515],488,4,28412,3.749769037877788,0.0,0.0
37577,3,7577,[179  98  89 265  79],686,5,28417,3.749934019530219,0.0,20.0
37578,3,7578,[603 302 427 127  64],13,5,28422,3.7500989576461277,20.0,20.0
37579,3,7579,[228 197  98 127 357],25,3,28425,3.75,20.0,40.0
37580,3,7580,[603 302 427 127  64],666,5,28430,3.750164885898958,20.0,20.0
37581,3,7581,[ 15 202 237 257 176],533,3,28433,3.7500659456607757,0.0,0.0
37582,3,7582,[173 405 423  50   1],271,3,28436,3.749967031517869,0.0,20.0
37583,3,7583,[603 302 427 127  64],271,5,28441,3.7501318565400843,20.0,20.0
37584,3,7584,[603 302 427 127  64],669,5,28446,3.750296638101516,20.0,20.0
37585,3,7585,[273 258 403 151 118],7,3,28449,3.7501977326654363,0.0,0.0
37586,3,7586,[655 568 196 197 194],311,5,28454,3.750362462106234,0.0,0.0
37587,3,7587,[100 135 174  50  96],87,5,28459,3.750527148128624,0.0,60.0
37588,3,7588,[748 176 655 111 238],479,4,28463,3.7505600210831465,0.0,0.0
37589,3,7589,[403 496   8  71  89],194,2,28465,3.7503293807641636,0.0,0.0
37590,3,7590,[ 98 234 427 172 515],308,2,28467,3.7500988012119616,0.0,20.0
37591,3,7591,[127  70 423 655 265],328,5,28472,3.750263435194942,0.0,20.0
37592,3,7592,[235 180  95 153 174],279,2,28474,3.7500329250625577,0.0,20.0
37593,3,7593,[215 276 118 216 200],643,2,28476,3.749802475638662,0.0,0.0
37594,3,7594,[603 302 427 127  64],90,5,28481,3.7499670836076366,20.0,20.0
37595,3,7595,[197 132 182 286 276],90,4,28485,3.75,0.0,0.0
37596,3,7596,[111 215 237 258   1],271,3,28488,3.7499012768197972,0.0,0.0
37597,3,7597,[ 22 196  11 546 289],455,2,28490,3.7496709660436958,0.0,0.0
37598,3,7598,[ 1 69 22  4 28],343,5,28495,3.749835504671667,0.0,0.0
37599,3,7599,[186 216   1 176  25],59,4,28499,3.7498684210526316,0.0,0.0
37600,3,7600,[435 245 118 678 204],454,2,28501,3.7496382054992763,0.0,0.0
37601,3,7601,[ 64 175 194  98 515],343,5,28506,3.749802683504341,0.0,20.0
37602,3,7602,[603 302 427 127  64],13,5,28511,3.749967118242799,20.0,20.0
37603,3,7603,[603 302 427 127  64],666,5,28516,3.75013150973172,20.0,20.0
37604,3,7604,[202 183 161 258   7],102,3,28519,3.750032873109796,0.0,0.0
37605,3,7605,[748 117 483  79 322],311,5,28524,3.750197212726795,20.0,0.0
37606,3,7606,[323  79   1 357 655],788,2,28526,3.7499671355330615,20.0,0.0
37607,3,7607,[ 11 655 172 187  22],840,1,28527,3.7496056782334386,0.0,0.0
37608,3,7608,[603 302 427 127  64],474,5,28532,3.749770009199632,20.0,20.0
37609,3,7609,[273 235  50 186  98],328,3,28535,3.749671484888305,0.0,40.0
37610,3,7610,[748   1  96 403  89],13,3,28538,3.749572986466956,0.0,0.0
37611,3,7611,[ 12 427 302 172 423],380,3,28541,3.749474513925381,20.0,0.0
37612,3,7612,[181 180 546 508 265],92,4,28545,3.7495074215158284,0.0,0.0
37613,3,7613,[204 191 603 427  95],454,4,28549,3.749540320462306,20.0,0.0
37614,3,7614,[496 423 153   9 161],194,3,28552,3.7494418910045964,0.0,0.0
37615,3,7615,[117 182 265 186 423],653,3,28555,3.749343487394958,0.0,0.0
37616,3,7616,[603 302 427 127  64],474,5,28560,3.749507680189051,20.0,20.0
37617,3,7617,[603 302 427 127  64],90,5,28565,3.749671829876608,20.0,20.0
37618,3,7618,[ 11 168 191 202 197],881,3,28568,3.7495734348339678,0.0,0.0
37619,3,7619,[121 196 181 117 175],653,3,28571,3.749475065616798,0.0,0.0
37620,3,7620,[403 216 234 186 180],339,3,28574,3.7493767222149326,0.0,0.0
37621,3,7621,[603 302 427 127  64],339,5,28579,3.7495408029388613,20.0,20.0
37622,3,7622,[603 302 427 127  64],537,4,28583,3.7495736586645676,20.0,20.0
37623,3,7623,[435 175 423  98 202],90,3,28586,3.7494753410283317,0.0,20.0
37624,3,7624,[603 302 427 127  64],13,5,28591,3.7496393442622953,20.0,20.0
37625,3,7625,[ 50 143 175 435 238],339,5,28596,3.749803304484658,0.0,20.0
37626,3,7626,[603 302 427 127  64],474,5,28601,3.7499672217123377,20.0,20.0
37627,3,7627,[ 22 200 294 127 228],387,4,28605,3.75,0.0,20.0
37628,3,7628,[125 186   8 135 183],25,4,28609,3.7500327696945863,0.0,0.0
37629,3,7629,[195  79 181 228 333],653,5,28614,3.750196592398427,0.0,0.0
37630,3,7630,[603 302 427 127  64],458,5,28619,3.7503603721661642,20.0,20.0
37631,3,7631,[228 143 483  12 204],537,1,28620,3.75,40.0,0.0
37632,3,7632,[183 153  12  89 265],194,2,28622,3.7497707323463905,20.0,0.0
37633,3,7633,[603 302 427 127  64],669,5,28627,3.749934503536809,20.0,20.0
37634,3,7634,[  9 265 568 483 515],343,3,28630,3.7498362802881466,20.0,0.0
37635,3,7635,[176 228 135 174 181],290,5,28635,3.75,0.0,20.0
37636,3,7636,[ 50  64 182   8 265],892,5,28640,3.750163676836454,0.0,20.0
37637,3,7637,[603 302 427 127  64],271,5,28645,3.7503273108143493,20.0,20.0
37638,3,7638,[180  98 496 322 405],313,3,28648,3.750229087576908,0.0,20.0
37639,3,7639,[603 302 427 127  64],339,5,28653,3.7503926701570682,20.0,20.0
37640,3,7640,[194  70 121  25 222],87,5,28658,3.7505562099201675,0.0,0.0
37641,3,7641,[ 88 282 235  28  56],271,2,28660,3.7503271394922795,0.0,0.0
37642,3,7642,[603 302 427 127  64],458,5,28665,3.7504906450346724,20.0,20.0
37643,3,7643,[238 211  15 423  88],650,2,28667,3.750261643118786,0.0,0.0
37644,3,7644,[144 132  70   9 423],328,5,28672,3.7504251144538916,0.0,0.0
37645,3,7645,[ 15  89 288 603 276],537,3,28675,3.7503269683494636,20.0,0.0
37646,3,7646,[ 97   8 286  70 179],194,1,28676,3.7499673074408264,0.0,0.0
37647,3,7647,[603 302 427 127  64],474,5,28681,3.7501307531380754,20.0,20.0
37648,3,7648,[294   8 289 678 471],13,1,28682,3.749771211923127,0.0,0.0
37649,3,7649,[ 88 271 289 132 196],537,0,28682,3.749281045751634,0.0,0.0
37650,3,7650,[603 302 427 127  64],537,4,28686,3.7493138151875574,20.0,20.0
37651,3,7651,[  1 385 258 234 475],479,3,28689,3.7492158912702562,0.0,0.0
37652,3,7652,[300  56 216 238  97],85,1,28690,3.748856657519927,0.0,0.0
37653,3,7653,[603 302 427 127  64],745,4,28694,3.7488894695584007,20.0,20.0
37654,3,7654,[603 302 427 127  64],666,5,28699,3.7490529065969955,20.0,20.0
37655,3,7655,[300 173 204 742 211],666,2,28701,3.748824451410658,0.0,0.0
37656,3,7656,[ 15 117   4  56 546],533,2,28703,3.748596055896565,0.0,0.0
37657,3,7657,[204 275 194 181 215],648,4,28707,3.7486288848263256,0.0,0.0
37658,3,7658,[603 302 427 127  64],669,5,28712,3.748792270531401,20.0,20.0
37659,3,7659,[678  25 515 269   1],145,2,28714,3.748563968668407,0.0,0.0
37660,3,7660,[ 50 318  89 132 286],239,3,28717,3.7484662576687118,20.0,20.0
37661,3,7661,[603 302 427 127  64],474,5,28722,3.7486296006264683,20.0,20.0
37662,3,7662,[603 302 427 127  64],90,5,28727,3.7487929009526297,20.0,20.0
37663,3,7663,[ 56 423 175 200 186],343,4,28731,3.7488256784968685,0.0,0.0
37664,3,7664,[174  25 183 211 135],234,2,28733,3.748597521200261,0.0,20.0
37665,3,7665,[678 515 118 276 275],308,2,28735,3.7483694234281244,0.0,0.0
37666,3,7666,[403  97 173 185 655],339,4,28739,3.7484022433807227,0.0,0.0
37667,3,7667,[ 50 204  69 286 168],13,4,28743,3.748435054773083,0.0,20.0
37668,3,7668,[204 135  22 385 161],455,4,28747,3.7484678576085537,0.0,0.0
37669,3,7669,[269  25  11 173  89],271,3,28750,3.7483702737940026,0.0,0.0
37670,3,7670,[ 56 508  15 435  70],474,4,28754,3.748403076521966,0.0,0.0
37671,3,7671,[118 597 211 197  25],308,2,28756,3.7481751824817517,0.0,0.0
37672,3,7672,[204 271 174 357 268],13,3,28759,3.74807767496416,20.0,20.0
37673,3,7673,[100 173 118  15 276],378,5,28764,3.748240813135262,0.0,20.0
37674,3,7674,[ 11 302 258 515 294],102,1,28765,3.7478827361563516,0.0,0.0
37675,3,7675,[196 153 257 288 215],308,3,28768,3.747785304846274,0.0,0.0
37676,3,7676,[603 302 427 127  64],458,5,28773,3.7479484173505275,20.0,20.0
37677,3,7677,[603 302 427 127  64],90,5,28778,3.7481114873665016,20.0,20.0
37678,3,7678,[603 302 427 127  64],458,5,28783,3.7482745149107957,20.0,20.0
37679,3,7679,[ 98 173 258 174 294],144,5,28788,3.7484375,0.0,40.0
37680,3,7680,[588 357 323 222  11],804,5,28793,3.7486004426506967,20.0,0.0
37681,3,7681,[475 288 210   8 216],92,3,28796,3.748502994011976,0.0,0.0
37682,3,7682,[603 302 427 127  64],339,5,28801,3.7486658857217234,20.0,20.0
37683,3,7683,[323 269 127 216  50],883,4,28805,3.7486985944820406,0.0,40.0
37684,3,7684,[603 302 427 127  64],90,5,28810,3.7488614183474303,20.0,20.0
37685,3,7685,[322 423  88  11 127],474,5,28815,3.749024199843872,0.0,20.0
37686,3,7686,[276  96 179 568   4],308,5,28820,3.7491869389879016,0.0,0.0
37687,3,7687,[603 302 427 127  64],474,5,28825,3.7493496357960456,20.0,20.0
37688,3,7688,[111 238  82 269   7],666,3,28828,3.749252178436728,0.0,0.0
37689,3,7689,[ 12 289 568  25 435],455,2,28830,3.749024707412224,20.0,0.0
37690,3,7690,[603 302 427 127  64],271,5,28835,3.7491873618515146,20.0,20.0
37691,3,7691,[151 179  12 175 222],64,4,28839,3.749219968798752,20.0,0.0
37692,3,7692,[603 302 427 127  64],90,5,28844,3.7493825555699987,20.0,20.0
37693,3,7693,[269 132 180  98  11],378,3,28847,3.7492851572654016,0.0,20.0
37694,3,7694,[196  50 179 176  95],92,4,28851,3.749317738791423,0.0,20.0
37695,3,7695,[228 185 273 333  79],64,3,28854,3.749220374220374,0.0,0.0
37696,3,7696,[174 234 210 403 483],95,2,28856,3.7489931142003377,20.0,20.0
37697,3,7697,[127 245  56 211 228],804,3,28859,3.7488958170953492,0.0,20.0
37698,3,7698,[173 273 168  82 174],7,3,28862,3.7487985452656187,0.0,20.0
37699,3,7699,[588 132 265 323  11],897,3,28865,3.748701298701299,0.0,0.0
37700,3,7700,[333 180  22 228 216],653,4,28869,3.7487339306583563,0.0,0.0
37701,3,7701,[483  82 173 235 238],648,4,28873,3.748766554141781,20.0,0.0
37702,3,7702,[603 302 427 127  64],669,5,28878,3.748928988705699,20.0,20.0
37703,3,7703,[483 132 228 568 144],488,1,28879,3.7485721703011423,20.0,0.0
37704,3,7704,[  9 655 211 143 127],749,4,28883,3.748604802076574,0.0,20.0
37705,3,7705,[276 202  70 678 313],537,3,28886,3.7485076563716584,0.0,0.0
37706,3,7706,[12  4  8 71 64],328,3,28889,3.748410535876476,20.0,0.0
37707,3,7707,[  8 286 655 385   4],318,3,28892,3.748313440581214,0.0,0.0
37708,3,7708,[215 118  22 187   1],788,2,28894,3.7480866519652354,0.0,0.0
37709,3,7709,[175 216 121  88 100],479,3,28897,3.7479896238651103,0.0,20.0
37710,3,7710,[ 69 168 153 238 496],749,4,28901,3.7480223057969133,0.0,0.0
37711,3,7711,[  1 289 405  12  97],537,0,28901,3.747536307053942,20.0,0.0
37712,3,7712,[245 185 748 427 153],313,2,28903,3.7473097368079866,0.0,0.0
37713,3,7713,[322 678 496 196 143],474,4,28907,3.7473424941664506,0.0,0.0
37714,3,7714,[ 88 185 265 211  69],379,5,28912,3.7475048606610497,0.0,0.0
37715,3,7715,[228 238 323 216 210],13,1,28913,3.747148781752203,0.0,0.0
37716,3,7716,[ 71 568 245  50 423],533,4,28917,3.7471815472333807,0.0,20.0
37717,3,7717,[603 302 427 127  64],271,5,28922,3.7473438714692926,20.0,20.0
37718,3,7718,[603 302 427 127  64],271,5,28927,3.7475061536468455,20.0,20.0
37719,3,7719,[603 302 427 127  64],458,5,28932,3.7476683937823836,20.0,20.0
37720,3,7720,[603 302 427 127  64],745,4,28936,3.747701074990286,20.0,20.0
37721,3,7721,[603 302 427 127  64],664,5,28941,3.747863247863248,20.0,20.0
37722,3,7722,[302 597 294 471  98],328,2,28943,3.747636928654668,0.0,20.0
37723,3,7723,[  4 483 186  50 200],308,4,28947,3.747669601242879,20.0,20.0
37724,3,7724,[132 200 180 588 238],804,4,28951,3.747702265372168,0.0,0.0
37725,3,7725,[100 235 515 294 300],486,3,28954,3.747605487962723,0.0,20.0
37726,3,7726,[603 302 427 127  64],339,5,28959,3.747767568267115,20.0,20.0
37727,3,7727,[603 302 427 127  64],474,5,28964,3.747929606625259,20.0,20.0
37728,3,7728,[603 302 427 127  64],90,5,28969,3.7480916030534353,20.0,20.0
37729,3,7729,[  8 210 385  82 161],60,3,28972,3.747994825355757,0.0,0.0
37730,3,7730,[118 100 237 318 197],694,5,28977,3.7481567714396586,20.0,20.0
37731,3,7731,[333 483   4  70 125],334,2,28979,3.747930677703052,20.0,0.0
37732,3,7732,[118 211 294  15 197],194,4,28983,3.747963274279064,0.0,0.0
37733,3,7733,[496 185 357 182 187],90,4,28987,3.747995862425653,20.0,0.0
37734,3,7734,[603 302 427 127  64],339,5,28992,3.748157724628313,20.0,20.0
37735,3,7735,[121 323  64  98 237],378,4,28996,3.748190279214064,0.0,20.0
37736,3,7736,[597 496 423  64 258],378,3,28999,3.7480935763215717,0.0,0.0
37737,3,7737,[175 135  82 185 508],334,4,29003,3.748126130783148,0.0,0.0
37738,3,7738,[603 302 427 127  64],458,5,29008,3.74828789249257,20.0,20.0
37739,3,7739,[216 153  89 143 182],92,3,29011,3.748191214470284,0.0,0.0
37740,3,7740,[475   1 568 173 151],213,4,29015,3.748223743702364,0.0,0.0
37741,3,7741,[508 357 211  70 204],474,4,29019,3.748256264531129,20.0,0.0
37742,3,7742,[179 237 125  11 181],374,3,29022,3.748159628051143,0.0,0.0
37743,3,7743,[168  95 403 568 215],536,4,29026,3.7481921487603307,0.0,0.0
37744,3,7744,[118 211  71 742 313],328,4,29030,3.748224661071659,0.0,0.0
37745,3,7745,[603 302 427 127  64],339,5,29035,3.7483862638781305,20.0,20.0
37746,3,7746,[210 496  96 135   8],200,5,29040,3.7485478249645023,0.0,0.0
37747,3,7747,[603 302 427 127  64],666,5,29045,3.748709344346928,20.0,20.0
37748,3,7748,[294 174 228 216 403],92,3,29048,3.7486127242224803,0.0,20.0
37749,3,7749,[ 97 182 546 132 187],650,1,29049,3.748258064516129,0.0,0.0
37750,3,7750,[603 302 427 127  64],474,5,29054,3.748419558766611,20.0,20.0
37751,3,7751,[180 294 195 215 185],897,4,29058,3.748452012383901,0.0,0.0
37752,3,7752,[151   7 471 228 265],537,1,29059,3.7480975106410424,0.0,0.0
37753,3,7753,[357 322 196 234  88],13,3,29062,3.748001031725561,20.0,0.0
37754,3,7754,[603 302 427 127  64],745,4,29066,3.748033526756931,20.0,20.0
37755,3,7755,[194 568  22 435 135],804,3,29069,3.747937080969572,0.0,0.0
37756,3,7756,[  8 271 238 222 423],64,4,29073,3.747969575866959,0.0,0.0
37757,3,7757,[603 302 427 127  64],666,5,29078,3.7481309615880383,20.0,20.0
37758,3,7758,[603 302 427 127  64],537,4,29082,3.7481634231215364,20.0,20.0
37759,3,7759,[168  64 182  28 323],59,5,29087,3.748324742268041,0.0,0.0
37760,3,7760,[181 132 323 288 183],13,3,29090,3.748228321092643,0.0,0.0
37761,3,7761,[257   1 235 496 483],560,2,29092,3.748003091986601,20.0,0.0
37762,3,7762,[603 302 427 127  64],664,5,29097,3.7481643694448024,20.0,20.0
37763,3,7763,[ 97 403 273 385 265],479,2,29099,3.747939206594539,0.0,0.0
37764,3,7764,[ 15 403 435  89 179],378,4,29103,3.7479716677398582,0.0,0.0
37765,3,7765,[603 302 427 127  64],13,5,29108,3.748132886943085,20.0,20.0
37766,3,7766,[179 143 273 144 271],749,5,29113,3.7482940646324194,0.0,0.0
37767,3,7767,[471 385  82 143  22],479,3,29116,3.748197734294542,0.0,0.0
37768,3,7768,[174 173 265 210  69],650,3,29119,3.7481014287553096,0.0,20.0
37769,3,7769,[ 88 211 273 186 191],749,5,29124,3.7482625482625482,0.0,0.0
37770,3,7770,[603 302 427 127  64],339,5,29129,3.748423626302921,20.0,20.0
37771,3,7771,[195 385 269 153 357],7,4,29133,3.7484559958826558,20.0,0.0
37772,3,7772,[132 423 185 568 294],7,4,29137,3.748488357133668,0.0,0.0
37773,3,7773,[603 302 427 127  64],271,5,29142,3.74864934396707,20.0,20.0
37774,3,7774,[603 302 427 127  64],458,5,29147,3.7488102893890676,20.0,20.0
37775,3,7775,[603 302 427 127  64],537,4,29151,3.7488425925925926,20.0,20.0
37776,3,7776,[ 96 174 187 222  71],406,2,29153,3.7486177189147485,0.0,20.0
37777,3,7777,[ 28 204 180 175 471],666,3,29156,3.7485214708151195,0.0,0.0
37778,3,7778,[  9  70 197 546 187],648,1,29157,3.748168145005785,0.0,0.0
37779,3,7779,[403 211 210 174 191],64,4,29161,3.7482005141388175,0.0,20.0
37780,3,7780,[603 302 427 127  64],90,5,29166,3.7483613931371287,20.0,20.0
37781,3,7781,[174 228 403  69 588],254,3,29169,3.748265227447957,0.0,20.0
37782,3,7782,[204 515 322 144 385],883,4,29173,3.7482975716304767,0.0,0.0
37783,3,7783,[195 174 202 211 245],533,4,29177,3.7483299075025696,0.0,20.0
37784,3,7784,[515 143 286 111 357],6,2,29179,3.7481053307642904,20.0,0.0
37785,3,7785,[603 302 427 127  64],666,5,29184,3.748266118674544,20.0,20.0
37786,3,7786,[ 97 111 238 127  89],524,5,29189,3.748426865288301,0.0,20.0
37787,3,7787,[742  97  88 313 258],653,1,29190,3.748073959938367,0.0,0.0
37788,3,7788,[194 678 273 118 423],749,3,29193,3.747977917576069,0.0,0.0
37789,3,7789,[237  98 215 318 195],92,4,29197,3.74801026957638,20.0,20.0
37790,3,7790,[603 302 427 127  64],90,5,29202,3.7481709664998073,20.0,20.0
37791,3,7791,[118 294  64 143 275],7,2,29204,3.7479466119096507,0.0,0.0
37792,3,7792,[603 302 427 127  64],474,5,29209,3.748107275760298,20.0,20.0
37793,3,7793,[125 197 211 196 176],533,4,29213,3.748139594559918,0.0,0.0
37794,3,7794,[603 302 427 127  64],537,4,29217,3.748171905067351,20.0,20.0
37795,3,7795,[275  88 196 194 435],454,1,29218,3.7478193945613136,0.0,0.0
37796,3,7796,[ 79  64 385 216 185],328,3,29221,3.7477234833910478,0.0,0.0
37797,3,7797,[603 302 427 127  64],271,5,29226,3.7478840728391893,20.0,20.0
37798,3,7798,[196 405  28 496  79],897,4,29230,3.7479163995384024,0.0,0.0
37799,3,7799,[603 302 427 127  64],666,5,29235,3.748076923076923,20.0,20.0
37800,3,7800,[100 215 603 237 471],524,2,29237,3.7478528393795667,20.0,20.0
37801,3,7801,[289 568 180 471 117],533,3,29240,3.747756985388362,0.0,0.0
37802,3,7802,[ 50 568 183  89 195],892,5,29245,3.747917467640651,0.0,20.0
37803,3,7803,[ 96 185 302  56 151],537,3,29248,3.7478216299333673,0.0,0.0
37804,3,7804,[151 475 603 143   4],533,2,29250,3.7475976937860347,20.0,0.0
37805,3,7805,[275  79 271 183 294],158,3,29253,3.7475019215987704,0.0,0.0
37806,3,7806,[118 546 195 182 435],788,0,29253,3.747021903420008,0.0,0.0
37807,3,7807,[204 237 216 187 568],533,4,29257,3.7470543032786887,0.0,0.0
37808,3,7808,[471 235 546  22   1],194,2,29259,3.7468305800998847,0.0,0.0
37809,3,7809,[483 186 181  98 403],890,3,29262,3.7467349551856595,20.0,20.0
37810,3,7810,[483 132  50 185  56],311,4,29266,3.746767379336833,20.0,20.0
37811,3,7811,[603 302 427 127  64],474,5,29271,3.746927803379416,20.0,20.0
37812,3,7812,[322 333 427 144 117],328,2,29273,3.7467042109305004,0.0,0.0
37813,3,7813,[276 427  71 173 496],406,3,29276,3.746608651138981,0.0,0.0
37814,3,7814,[603 302 427 127  64],13,5,29281,3.7467690339091493,20.0,20.0
37815,3,7815,[151 100 210 168 427],474,3,29284,3.7466734902763563,0.0,20.0
37816,3,7816,[  7 187  22 289 268],387,3,29287,3.746577971088653,0.0,0.0
37817,3,7817,[302  82 135 179 183],934,3,29290,3.746482476336659,0.0,0.0
37818,3,7818,[276 168 151 748 265],346,4,29294,3.74651489960353,0.0,0.0
37819,3,7819,[588 121  79 294 427],194,3,29297,3.7464194373401534,0.0,0.0
37820,3,7820,[603 318 435 678 191],7,4,29301,3.746451860375911,40.0,0.0
37821,3,7821,[161 153 151 597 111],653,2,29303,3.746228586039376,0.0,0.0
37822,3,7822,[603 302 427 127  64],669,5,29308,3.7463888533810557,20.0,20.0
37823,3,7823,[127  71 182 282 508],85,3,29311,3.7462934560327197,0.0,20.0
37824,3,7824,[168 301  50 268   8],334,4,29315,3.746325878594249,0.0,20.0
37825,3,7825,[603 302 427 127  64],13,5,29320,3.7464860720674675,20.0,20.0
37826,3,7826,[300 216  96 748  97],346,4,29324,3.74651846173502,0.0,0.0
37827,3,7827,[111 435  98  15 328],378,3,29327,3.7464230965763923,0.0,20.0
37828,3,7828,[655 168 265 234 183],339,4,29331,3.7464554860135393,0.0,0.0
37829,3,7829,[603 302 427 127  64],271,5,29336,3.74661558109834,20.0,20.0
37830,3,7830,[117 161   9 286  96],648,1,29337,3.7462648448474014,0.0,0.0
37831,3,7831,[265 568 234  88 187],379,5,29342,3.7464249233912157,0.0,0.0
37832,3,7832,[405 172  56  25  89],92,3,29345,3.7463296310481295,0.0,0.0
37833,3,7833,[603 302 427 127  64],745,4,29349,3.7463620117436816,20.0,20.0
37834,3,7834,[603 302 427 127  64],13,5,29354,3.7465220165922144,20.0,20.0
37835,3,7835,[200  89 143 568 144],648,4,29358,3.746554364471669,0.0,0.0
37836,3,7836,[185  89 282 172 168],474,4,29362,3.746586704095955,0.0,0.0
37837,3,7837,[603 302 427 127  64],669,5,29367,3.746746619035468,20.0,20.0
37838,3,7838,[282 111 181 153 385],378,4,29371,3.7467789258834037,0.0,0.0
37839,3,7839,[ 50 475  64 427 117],343,4,29375,3.7468112244897958,0.0,20.0
37840,3,7840,[  7 210  28 313 211],474,5,29380,3.746971049611019,0.0,0.0
37841,3,7841,[603 302 427 127  64],339,5,29385,3.747130833970926,20.0,20.0
37842,3,7842,[204 276 194  89 132],881,3,29388,3.7470355731225298,0.0,0.0
37843,3,7843,[286  15 257 216 300],145,2,29390,3.7468128505864353,0.0,0.0
37844,3,7844,[202 183 546 568 403],7,4,29394,3.746845124282983,0.0,0.0
37845,3,7845,[  9 302 204 173 121],334,4,29398,3.7468773897527403,0.0,0.0
37846,3,7846,[118 483   9 597 182],788,2,29400,3.746654772524532,20.0,0.0
37847,3,7847,[603 302 427 127  64],745,4,29404,3.7466870540265034,20.0,20.0
37848,3,7848,[302 235  50 568 265],13,3,29407,3.746591922537903,0.0,20.0
37849,3,7849,[187 175 151 742 483],666,3,29410,3.746496815286624,20.0,0.0
37850,3,7850,[603 302 427 127  64],271,5,29415,3.7466564768819257,20.0,20.0
37851,3,7851,[742 323 515 237 117],26,1,29416,3.7463066734589914,0.0,0.0
37852,3,7852,[603 302 427 127  64],90,5,29421,3.746466318604355,20.0,20.0
37853,3,7853,[173 185 496 200  22],334,4,29425,3.746498599439776,0.0,0.0
37854,3,7854,[118 546  82  97 322],328,1,29426,3.7461489497135583,0.0,0.0
37855,3,7855,[ 88 181  69 176  56],379,5,29431,3.746308553971487,0.0,0.0
37856,3,7856,[603 302 427 127  64],339,5,29436,3.7464681176021384,20.0,20.0
37857,3,7857,[125 222 288 603 127],213,4,29440,3.7465003817765337,20.0,20.0
37858,3,7858,[176  56 323 603 483],648,4,29444,3.7465326377401706,40.0,0.0
37859,3,7859,[471 568 202 181  69],207,2,29446,3.7463104325699748,0.0,0.0
37860,3,7860,[268 496 289  22 423],334,3,29449,3.746215494211932,0.0,0.0
37861,3,7861,[603 302 427 127  64],90,5,29454,3.7463749682014753,20.0,20.0
37862,3,7862,[603 302 427 127  64],669,5,29459,3.746534401627877,20.0,20.0
37863,3,7863,[228 196  98 179 181],881,3,29462,3.746439471007121,0.0,20.0
37864,3,7864,[187 174 515 183  28],406,2,29464,3.7462174189446915,0.0,20.0
37865,3,7865,[603 302 427 127  64],13,5,29469,3.746376811594203,20.0,20.0
37866,3,7866,[603 302 427 127  64],474,5,29474,3.7465361637218764,20.0,20.0
37867,3,7867,[603 302 427 127  64],90,5,29479,3.746695475343162,20.0,20.0
37868,3,7868,[176 174   4 385 143],308,5,29484,3.746854746473504,0.0,20.0
37869,3,7869,[603 302 427 127  64],664,5,29489,3.7470139771283355,20.0,20.0
37870,3,7870,[202 195 568 276  71],311,5,29494,3.747173167323085,0.0,0.0
37871,3,7871,[603 302 427 127  64],474,5,29499,3.747332317073171,20.0,20.0
37872,3,7872,[294 357 176 197 313],234,3,29502,3.7472373936237773,20.0,0.0
37873,3,7873,[603 302 427 127  64],666,5,29507,3.7473964947929894,20.0,20.0
37874,3,7874,[210   9 265 197 161],7,4,29511,3.7474285714285713,0.0,0.0
37875,3,7875,[603 302 427 127  64],666,5,29516,3.7475876079228034,20.0,20.0
37876,3,7876,[ 71 151 496 271 182],479,2,29518,3.7473657483813634,0.0,0.0
37877,3,7877,[603 302 427 127  64],666,5,29523,3.7475247524752477,20.0,20.0
37878,3,7878,[603 302 427 127  64],537,4,29527,3.7475567965477854,20.0,20.0
37879,3,7879,[603 302 427 127  64],474,5,29532,3.7477157360406093,20.0,20.0
37880,3,7880,[ 25 127 187  95 483],406,3,29535,3.7476208602969168,20.0,20.0
37881,3,7881,[483 175 403 125   7],881,3,29538,3.747526008627252,20.0,0.0
37882,3,7882,[603 302 427 127  64],537,4,29542,3.747558036280604,20.0,20.0
37883,3,7883,[ 64 322 211 143 183],804,4,29546,3.747590055809234,0.0,0.0
37884,3,7884,[742 168 117 294 210],648,3,29549,3.7474952441344325,0.0,0.0
37885,3,7885,[228 597 282 322  79],788,3,29552,3.7474004565051993,0.0,0.0
37886,3,7886,[182 118  25 385 235],59,4,29556,3.7474324838341575,0.0,0.0
37887,3,7887,[515 597 216 168  12],308,2,29558,3.747210953346856,20.0,0.0
37888,3,7888,[603 302 427 127  64],13,5,29563,3.7473697553555585,20.0,20.0
37889,3,7889,[168 318 294 172   7],774,0,29563,3.746894803548796,20.0,0.0
37890,3,7890,[603 302 427 127  64],339,5,29568,3.74705360537321,20.0,20.0
37891,3,7891,[194 100  22 121 403],650,2,29570,3.7468322351748604,0.0,20.0
37892,3,7892,[ 89 144 111 191  64],92,4,29574,3.7468643101482324,0.0,0.0
37893,3,7893,[173  11   7  12  50],234,1,29575,3.746516341525209,20.0,20.0
37894,3,7894,[173 153  50 318 100],409,4,29579,3.7465484483850537,20.0,40.0
37895,3,7895,[195 222 204 211 471],882,5,29584,3.746707193515704,0.0,0.0
37896,3,7896,[603 302 427 127  64],90,5,29589,3.7468658984424463,20.0,20.0
37897,3,7897,[678 168 176 238 182],488,2,29591,3.7466447201823248,0.0,0.0
37898,3,7898,[603 302 427 127  64],90,5,29596,3.746803392834536,20.0,20.0
37899,3,7899,[603 302 427 127  64],669,5,29601,3.7469620253164555,20.0,20.0
37900,3,7900,[313 187 323 289  28],328,4,29605,3.7469940513859004,0.0,0.0
37901,3,7901,[195  89 181  79   1],881,5,29610,3.7471526195899774,0.0,0.0
37902,3,7902,[435  28 194  89 483],339,5,29615,3.7473111476654437,20.0,0.0
37903,3,7903,[483  64 288 200 234],374,4,29619,3.747343117408907,20.0,0.0
37904,3,7904,[603 302 427 127  64],669,5,29624,3.7475015812776724,20.0,20.0
37905,3,7905,[  8  11  22 282 132],474,5,29629,3.7476600050594486,0.0,0.0
37906,3,7906,[318 269 174 288 143],537,1,29630,3.7473125079043883,20.0,20.0
37907,3,7907,[276  11 322 318 186],474,5,29635,3.7474709155285786,20.0,0.0
37908,3,7908,[245 302  88   1 191],454,3,29638,3.7473764066253636,0.0,0.0
37909,3,7909,[313 271 323 269 405],294,4,29642,3.747408343868521,0.0,0.0
37910,3,7910,[603 302 427 127  64],669,5,29647,3.7475666793072935,20.0,20.0
37911,3,7911,[245  79  69 301 187],90,3,29650,3.7474721941354905,0.0,0.0
37912,3,7912,[111 222 161 318 483],454,2,29652,3.7472513585239478,40.0,0.0
37913,3,7913,[603 302 427 127  64],745,4,29656,3.7472832954258277,20.0,20.0
37914,3,7914,[333 211 168 496  82],387,3,29659,3.7471888818698673,0.0,0.0
37915,3,7915,[228 235 168 100 121],343,4,29663,3.7472208185952502,0.0,20.0
37916,3,7916,[603 302 427 127  64],666,5,29668,3.7473790577238852,20.0,20.0
37917,3,7917,[202  79 161  70 568],207,3,29671,3.7472846678454155,0.0,0.0
37918,3,7918,[603 302 427 127  64],666,5,29676,3.7474428589468367,20.0,20.0
37919,3,7919,[471  95  97 318  89],374,3,29679,3.747348484848485,20.0,0.0
37920,3,7920,[603 302 427 127  64],664,5,29684,3.747506627951016,20.0,20.0
37921,3,7921,[121 195  22   1 153],308,4,29688,3.7475385003786923,0.0,0.0
37922,3,7922,[215 228  11 273   4],7,3,29691,3.7474441499432034,0.0,0.0
37923,3,7923,[603 302 427 127  64],474,5,29696,3.7476022211004545,20.0,20.0
37924,3,7924,[196  89 568  70 515],64,4,29700,3.7476340694006307,0.0,0.0
37925,3,7925,[ 28 275 100 323 546],378,3,29703,3.747539742619228,0.0,20.0
37926,3,7926,[196 183 328  15 174],653,2,29705,3.747319288507632,0.0,20.0
37927,3,7927,[144 100 211 546 216],346,3,29708,3.7472250252270434,0.0,20.0
37928,3,7928,[289 273 135 302 173],524,3,29711,3.7471307857232943,0.0,0.0
37929,3,7929,[302 568 385 496 168],883,2,29713,3.7469104665825976,0.0,0.0
37930,3,7930,[186 185  22 179 322],881,4,29717,3.7469423780103392,0.0,0.0
37931,3,7931,[228 237  28 742 235],788,2,29719,3.746722138174483,0.0,0.0
37932,3,7932,[603 302 427 127  64],271,5,29724,3.746880121013488,20.0,20.0
37933,3,7933,[ 50  28 127   8 196],379,5,29729,3.747038064028233,0.0,40.0
37934,3,7934,[289 678 322 245   1],92,2,29731,3.746817895400126,0.0,0.0
37935,3,7935,[143 435 180 125 678],804,3,29734,3.7467237903225805,0.0,0.0
37936,3,7936,[173  98  15 234 405],95,3,29737,3.7466297089580447,0.0,20.0
37937,3,7937,[228 175  88 187  50],13,5,29742,3.746787603930461,0.0,20.0
37938,3,7938,[ 69  79 286 117 471],653,4,29746,3.7468194986774153,0.0,0.0
37939,3,7939,[427 234   9 200 118],380,2,29748,3.7465994962216627,0.0,0.0
37940,3,7940,[180 286  82 144 318],343,5,29753,3.746757335348193,20.0,0.0
37941,3,7941,[216 403  79  89 183],184,3,29756,3.7466633089901786,0.0,0.0
37942,3,7942,[403  50 215 204  71],59,4,29760,3.7466952033236813,0.0,20.0
37943,3,7943,[496 483  79 182 515],184,4,29764,3.7467270896273916,20.0,0.0
37944,3,7944,[179 181 161 172 185],59,4,29768,3.7467589679043423,0.0,0.0
37945,3,7945,[603 302 427 127  64],669,5,29773,3.7469166876415807,20.0,20.0
37946,3,7946,[ 89 286 144 403 235],328,3,29776,3.7468227003900845,0.0,0.0
37947,3,7947,[603 302 427 127  64],13,5,29781,3.746980372420735,20.0,20.0
37948,3,7948,[100 111 282  89 333],145,3,29784,3.7468864008051326,0.0,20.0
37949,3,7949,[ 22 187 483 181 385],207,2,29786,3.7466666666666666,20.0,0.0
37950,3,7950,[  8 132 180  95  82],897,3,29789,3.7465727581436297,0.0,0.0
37951,3,7951,[111 403 173 153 196],13,3,29792,3.7464788732394365,0.0,0.0
37952,3,7952,[603 302 427 127  64],474,5,29797,3.7466364893750788,20.0,20.0
37953,3,7953,[118 216 269   8 282],271,3,29800,3.7465426200653758,0.0,0.0
37954,3,7954,[603 302 427 127  64],745,4,29804,3.7465744814582025,20.0,20.0
37955,3,7955,[603 302 427 127  64],271,5,29809,3.746732026143791,20.0,20.0
37956,3,7956,[ 25 385 678 211 182],474,4,29813,3.7467638557245193,0.0,0.0
37957,3,7957,[181  69  64 318 197],804,5,29818,3.7469213370193515,20.0,0.0
37958,3,7958,[ 95 195 204 143 174],125,5,29823,3.7470787787410478,0.0,20.0
37959,3,7959,[288  25 118  96 405],447,4,29827,3.747110552763819,0.0,0.0
37960,3,7960,[144 300 153  64  50],749,5,29832,3.7472679311644264,0.0,20.0
37961,3,7961,[ 79  11 186 121  89],64,3,29835,3.747174076865109,0.0,0.0
37962,3,7962,[175  96 118 318  89],788,2,29837,3.746954665327138,20.0,0.0
37963,3,7963,[127 435 211   9 172],328,5,29842,3.7471120040180814,0.0,20.0
37964,3,7964,[237   4  98 328  70],207,3,29845,3.747018204645323,0.0,20.0
37965,3,7965,[597 174 238 200  70],378,2,29847,3.7467988953050466,0.0,20.0
37966,3,7966,[161 180  50  12 318],387,3,29850,3.7467051587799673,40.0,20.0
37967,3,7967,[603 302 427 127  64],537,4,29854,3.7467369477911645,20.0,20.0
37968,3,7968,[515 176 655  28  56],537,2,29856,3.7465177563056846,0.0,0.0
37969,3,7969,[127 161 176  28 173],271,3,29859,3.7464240903387704,0.0,20.0
37970,3,7970,[603 302 427 127  64],664,5,29864,3.74658135742065,20.0,20.0
37971,3,7971,[427 180 273 183 588],7,4,29868,3.746613146011039,0.0,0.0
37972,3,7972,[237 294 211  64  89],6,3,29871,3.7465195033237175,0.0,0.0
37973,3,7973,[603 302 427 127  64],666,5,29876,3.746676699272636,20.0,20.0
37974,3,7974,[603 302 427 127  64],537,4,29880,3.7467084639498434,20.0,20.0
37975,3,7975,[603 302 427 127  64],13,5,29885,3.746865596790371,20.0,20.0
37976,3,7976,[ 82 197 322 175 423],308,3,29888,3.74677196941206,0.0,0.0
37977,3,7977,[215 182  28  70 294],308,2,29890,3.74655302080722,0.0,0.0
37978,3,7978,[655 357 197 121 117],343,3,29893,3.7464594560721896,20.0,0.0
37979,3,7979,[ 50 273 195  70   1],374,2,29895,3.7462406015037595,0.0,20.0
37980,3,7980,[603 302 427 127  64],474,5,29900,3.7463976945244957,20.0,20.0
37981,3,7981,[172 125 111  95  22],554,4,29904,3.746429466299173,0.0,0.0
37982,3,7982,[  4 181 322 117  89],346,4,29908,3.7464612301139923,0.0,0.0
37983,3,7983,[603 302 427 127  64],669,5,29913,3.746618236472946,20.0,20.0
37984,3,7984,[385 196  71 161 202],42,5,29918,3.7467752035065747,0.0,0.0
37985,3,7985,[603 302 427 127  64],666,5,29923,3.7469321312296517,20.0,20.0
37986,3,7986,[121 204 300 385 423],666,0,29923,3.746463002378866,0.0,0.0
37987,3,7987,[151 245 117  71 187],334,2,29925,3.7462443665498246,0.0,0.0
37988,3,7988,[195   9 678 187 117],308,3,29928,3.746150957566654,0.0,0.0
37989,3,7989,[603 302 427 127  64],745,4,29932,3.7461827284105134,20.0,20.0
37990,3,7990,[603 302 427 127  64],271,5,29937,3.7463396320860967,20.0,20.0
37991,3,7991,[603 302 427 127  64],271,5,29942,3.7464964964964964,20.0,20.0
37992,3,7992,[100  25   4 742 215],59,4,29946,3.7465282121856625,0.0,20.0
37993,3,7993,[655 185 144   7 210],13,2,29948,3.7463097322992245,0.0,0.0
37994,3,7994,[603 302 427 127  64],666,5,29953,3.746466541588493,20.0,20.0
37995,3,7995,[ 69  97 151 288 318],378,2,29955,3.746248124062031,20.0,0.0
37996,3,7996,[  4 742  95 211 288],387,1,29956,3.7459047142678505,0.0,0.0
37997,3,7997,[257 200   1 151 121],308,4,29960,3.7459364841210303,0.0,0.0
37998,3,7998,[333 181 194 202 121],387,1,29961,3.745593199149894,0.0,0.0
37999,3,7999,[603 302 427 127  64],13,5,29966,3.74575,20.0,20.0
38000,3,8000,[603 302 427 127  64],664,5,29971,3.745906761654793,20.0,20.0
38001,3,8001,[603 302 427 127  64],271,5,29976,3.746063484128968,20.0,20.0
38002,3,8002,[603 302 427 127  64],339,5,29981,3.746220167437211,20.0,20.0
38003,3,8003,[196 435 678 197 265],474,4,29985,3.7462518740629687,0.0,0.0
38004,3,8004,[181 515 175 135 603],334,5,29990,3.7464084946908183,20.0,0.0
38005,3,8005,[655 204  97 132 197],194,3,29993,3.7463152635523356,0.0,0.0
38006,3,8006,[603 302 427 127  64],458,5,29998,3.7464718371425003,20.0,20.0
38007,3,8007,[603 302 427 127  64],664,5,30003,3.7466283716283715,20.0,20.0
38008,3,8008,[  7 153  89  12 357],194,2,30005,3.7464102884255213,40.0,0.0
38009,3,8009,[181 210 183 204 276],239,3,30008,3.7463171036204743,0.0,0.0
38010,3,8010,[423 182 195 180 496],313,5,30013,3.7464735988016478,0.0,0.0
38011,3,8011,[ 15 423 144 181   8],308,3,30016,3.746380429355966,0.0,0.0
38012,3,8012,[200 180 275   4  25],378,2,30018,3.7461624859603146,0.0,0.0
38013,3,8013,[194  95 143 546 187],524,3,30021,3.746069378587472,0.0,0.0
38014,3,8014,[ 96 483  97   7  64],452,4,30025,3.746101060511541,20.0,0.0
38015,3,8015,[  7   9 117 603 235],308,3,30028,3.746007984031936,20.0,0.0
38016,3,8016,[276 273 237 435 191],458,5,30033,3.7461644006486217,0.0,0.0
38017,3,8017,[435 475 121 471 202],537,1,30034,3.7458219007233726,0.0,0.0
38018,3,8018,[ 89 161 168  50 111],452,4,30038,3.7458535977054495,0.0,20.0
38019,3,8019,[483   7  22  98 144],10,5,30043,3.746009975062344,20.0,20.0
38020,3,8020,[603 302 427 127  64],666,5,30048,3.7461663134272536,20.0,20.0
38021,3,8021,[258 191 265 151 357],339,3,30051,3.7460732984293195,20.0,0.0
38022,3,8022,[ 22  69 204  56 196],308,3,30054,3.745980306618472,0.0,0.0
38023,3,8023,[191 173 182 269 179],207,3,30057,3.745887337986042,0.0,0.0
38024,3,8024,[175  88  70 183 258],13,4,30061,3.7459190031152647,0.0,0.0
38025,3,8025,[  4 294 742 238  15],554,1,30062,3.7455768751557437,0.0,0.0
38026,3,8026,[603 302 427 127  64],458,5,30067,3.745733150616669,20.0,20.0
38027,3,8027,[118 191 179 405 282],194,2,30069,3.745515695067265,0.0,0.0
38028,3,8028,[603 302 427 127  64],664,5,30074,3.745671939220326,20.0,20.0
38029,3,8029,[161   4 515 276 265],346,3,30077,3.745579078455791,0.0,0.0
38030,3,8030,[215 496 172 403 276],234,1,30078,3.7452372058274186,0.0,0.0
38031,3,8031,[603 302 427 127  64],339,5,30083,3.7453934262948207,20.0,20.0
38032,3,8032,[286 204 210 187 328],334,3,30086,3.7453006348811155,0.0,0.0
38033,3,8033,[100  89 427 603   9],383,4,30090,3.745332337565347,20.0,20.0
38034,3,8034,[257 265 238 174 121],145,4,30094,3.745364032358432,0.0,20.0
38035,3,8035,[603 302 427 127  64],458,5,30099,3.7455201592832257,20.0,20.0
38036,3,8036,[271 132 268 173 216],92,1,30100,3.7451785492099043,0.0,0.0
38037,3,8037,[ 89 678 118 202 179],749,3,30103,3.7450858422493156,0.0,0.0
38038,3,8038,[603 302 427 127  64],666,5,30108,3.745241945515611,20.0,20.0
38039,3,8039,[168 135 143 181   7],374,1,30109,3.744900497512438,0.0,0.0
38040,3,8040,[182 174  79 135 568],524,4,30113,3.744932222360403,0.0,20.0
38041,3,8041,[ 56 678 546 161   8],92,2,30115,3.744715244963939,0.0,0.0
38042,3,8042,[ 25  69 234 245 197],90,3,30118,3.7446226532388414,0.0,0.0
38043,3,8043,[603 302 427 127  64],537,4,30122,3.744654400795624,20.0,20.0
38044,3,8044,[603 302 427 127  64],90,5,30127,3.744810441267868,20.0,20.0
38045,3,8045,[603 302 427 127  64],664,5,30132,3.7449664429530203,20.0,20.0
38046,3,8046,[ 97  70 271  56 302],13,3,30135,3.7448738660370324,0.0,0.0
38047,3,8047,[403 294  12  64 238],774,1,30136,3.7445328031809146,20.0,0.0
38048,3,8048,[357 300 302 153 288],666,3,30139,3.744440303143248,20.0,0.0
38049,3,8049,[ 69 435 194 300 174],379,4,30143,3.744472049689441,0.0,20.0
38050,3,8050,[195 385  89 187  95],650,3,30146,3.7443795801763757,0.0,0.0
38051,3,8051,[  8  56 276 603 174],234,2,30148,3.7441629408842525,20.0,20.0
38052,3,8052,[117 182  28 405 313],653,3,30151,3.744070532720725,0.0,0.0
38053,3,8053,[603 302 427 127  64],745,4,30155,3.7441023094114727,20.0,20.0
38054,3,8054,[288 273 238 385 276],234,0,30155,3.743637492240844,0.0,0.0
38055,3,8055,[168 194 427 211 588],298,5,30160,3.743793445878848,0.0,0.0
38056,3,8056,[ 64 100  50 195 121],892,5,30165,3.7439493608042698,0.0,40.0
38057,3,8057,[222   7  25  11 357],804,5,30170,3.7441052370315213,20.0,0.0
38058,3,8058,[333  50 180  64 186],263,4,30174,3.7441369897009555,0.0,20.0
38059,3,8059,[603 302 427 127  64],339,5,30179,3.7442928039702235,20.0,20.0
38060,3,8060,[603 302 427 127  64],666,5,30184,3.744448579580697,20.0,20.0
38061,3,8061,[435 475 322 301  22],13,2,30186,3.744232200446539,0.0,0.0
38062,3,8062,[ 71 196 385 322 403],13,2,30188,3.744015874984497,0.0,0.0
38063,3,8063,[153 132 183 403 597],788,2,30190,3.7437996031746033,0.0,0.0
38064,3,8064,[294 655 748 191 265],311,5,30195,3.743955362678239,0.0,0.0
38065,3,8065,[483  28 211 176  79],648,5,30200,3.744111083560625,20.0,0.0
38066,3,8066,[603 302 427 127  64],745,4,30204,3.744142804016363,20.0,20.0
38067,3,8067,[144 197 182 186 151],374,4,30208,3.744174516608825,0.0,0.0
38068,3,8068,[603 302 427 127  64],458,5,30213,3.744330152435246,20.0,20.0
38069,3,8069,[302 173  12 235   8],378,5,30218,3.744485749690211,20.0,0.0
38070,3,8070,[603 302 427 127  64],458,5,30223,3.744641308388056,20.0,20.0
38071,3,8071,[603 302 427 127  64],537,4,30227,3.7446729435084243,20.0,20.0
38072,3,8072,[153 748 194  64   4],883,4,30231,3.7447045707915274,0.0,0.0
38073,3,8073,[603 302 427 127  64],745,4,30235,3.7447361902402774,20.0,20.0
38074,3,8074,[546  89 180 427 603],234,2,30237,3.7445201238390093,20.0,0.0
38075,3,8075,[483  50 318 121  98],804,5,30242,3.744675581971273,40.0,40.0
38076,3,8076,[603 302 427 127  64],537,4,30246,3.744707193264826,20.0,20.0
38077,3,8077,[603 302 427 127  64],745,4,30250,3.7447387967318644,20.0,20.0
38078,3,8078,[603 302 427 127  64],339,5,30255,3.744894170070553,20.0,20.0
38079,3,8079,[282 237 215 182 216],144,4,30259,3.7449257425742575,0.0,0.0
38080,3,8080,[185  79  70 175  50],881,2,30261,3.744709813141938,0.0,20.0
38081,3,8081,[603 302 427 127  64],474,5,30266,3.744865132392972,20.0,20.0
38082,3,8082,[187   1 127 172 235],479,4,30270,3.7448966967710007,0.0,20.0
38083,3,8083,[ 22 182 508 194 483],59,4,30274,3.7449282533399306,20.0,0.0
38084,3,8084,[258 121 117 111  88],454,3,30277,3.7448361162646875,0.0,0.0
38085,3,8085,[603 302 427 127  64],458,5,30282,3.7449913430620825,20.0,20.0
38086,3,8086,[173  89  50 187 588],7,5,30287,3.7451465314702608,0.0,20.0
38087,3,8087,[ 56  70 435 423 483],474,5,30292,3.745301681503462,20.0,0.0
38088,3,8088,[210 288  64 161 546],13,2,30294,3.7450859191494623,0.0,0.0
38089,3,8089,[603 302 427 127  64],537,4,30298,3.745117428924598,20.0,20.0
38090,3,8090,[603 302 427 127  64],271,5,30303,3.7452725250278087,20.0,20.0
38091,3,8091,[215 153 143 186 234],749,5,30308,3.745427582797825,0.0,0.0
38092,3,8092,[  4 597  82 357 161],653,4,30312,3.7454590386753983,20.0,0.0
38093,3,8093,[ 12 118 175 210 435],892,5,30317,3.745614035087719,20.0,0.0
38094,3,8094,[186  79  28 435 357],537,2,30319,3.745398394070414,20.0,0.0
38095,3,8095,[ 15  69 265  79  95],59,4,30323,3.7454298418972334,0.0,0.0
38096,3,8096,[603 302 427 127  64],745,4,30327,3.7454612819562803,20.0,20.0
38097,3,8097,[143 546 202 194 161],313,4,30331,3.745492714250432,0.0,0.0
38098,3,8098,[603 302 427 127  64],458,5,30336,3.74564761081615,20.0,20.0
38099,3,8099,[288 121 197 273 144],378,3,30339,3.7455555555555557,0.0,0.0
38100,3,8100,[603 302 427 127  64],339,5,30344,3.745710406122701,20.0,20.0
38101,3,8101,[405  12 273 144   4],883,4,30348,3.745741792150086,20.0,0.0
38102,3,8102,[268 597 294 288 405],699,1,30349,3.745402937183759,0.0,0.0
38103,3,8103,[603 302 427 127  64],339,5,30354,3.745557749259625,20.0,20.0
38104,3,8104,[144 515  11 118 204],892,4,30358,3.7455891425046266,0.0,0.0
38105,3,8105,[294 475 276 333 471],294,5,30363,3.7457438934122873,0.0,0.0
38106,3,8106,[427 151 191 180 210],664,4,30367,3.7457752559516466,0.0,0.0
38107,3,8107,[603 302 427 127  64],664,5,30372,3.74592994573261,20.0,20.0
38108,3,8108,[234 175 215   4 322],474,5,30377,3.746084597360957,0.0,0.0
38109,3,8109,[ 96 174 143 289  98],533,4,30381,3.7461159062885327,0.0,40.0
38110,3,8110,[483  95   4  97   1],406,4,30385,3.746147207495993,20.0,0.0
38111,3,8111,[ 50 275 181 151 179],554,4,30389,3.7461785009861934,0.0,20.0
38112,3,8112,[496 215   8  25 515],85,4,30393,3.746209786761987,0.0,0.0
38113,3,8113,[603 302 427 127  64],458,5,30398,3.7463643086024154,20.0,20.0
38114,3,8114,[603 302 427 127  64],669,5,30403,3.7465187923598275,20.0,20.0
38115,3,8115,[603 302 427 127  64],664,5,30408,3.7466732380482997,20.0,20.0
38116,3,8116,[183  71 176 238 288],378,3,30411,3.7465812492300112,0.0,0.0
38117,3,8117,[603 302 427 127  64],745,4,30415,3.7466124661246614,20.0,20.0
38118,3,8118,[603 302 427 127  64],745,4,30419,3.7466436753294743,20.0,20.0
38119,3,8119,[151 135  64  28 111],378,2,30421,3.7464285714285714,0.0,0.0
38120,3,8120,[427 172 197 175 588],843,1,30422,3.746090382957764,0.0,0.0
38121,3,8121,[271   7 258 235 328],548,3,30425,3.745998522531396,0.0,0.0
38122,3,8122,[197 173 238 153  28],648,3,30428,3.745906684722393,0.0,0.0
38123,3,8123,[257 111 496  12 211],533,5,30433,3.746061053668144,20.0,0.0
38124,3,8124,[603 302 427 127  64],666,5,30438,3.7462153846153847,20.0,20.0
38125,3,8125,[289  97 515 403 301],13,1,30439,3.745877430470096,0.0,0.0
38126,3,8126,[603 302 427 127  64],537,4,30443,3.7459086993970714,20.0,20.0
38127,3,8127,[273 228 127 179 180],537,3,30446,3.7458169291338583,0.0,20.0
38128,3,8128,[ 89 172 269 423 182],650,3,30449,3.745725181449133,0.0,0.0
38129,3,8129,[385 168 234 423 275],311,5,30454,3.745879458794588,0.0,0.0
38130,3,8130,[328 204 385 151 100],537,1,30455,3.7455417537818225,0.0,20.0
38131,3,8131,[144  82 216 132 427],7,4,30459,3.745573044761436,0.0,0.0
38132,3,8132,[  9 427  79 300 289],409,3,30462,3.7454813721873847,0.0,0.0
38133,3,8133,[174 135 357   1 168],254,2,30464,3.7452667814113596,20.0,20.0
38134,3,8134,[603 302 427 127  64],669,5,30469,3.745421020282729,20.0,20.0
38135,3,8135,[289  69  88 153 196],454,2,30471,3.745206489675516,0.0,0.0
38136,3,8136,[238 300  95 176  22],378,4,30475,3.745237802629962,0.0,0.0
38137,3,8137,[603 302 427 127  64],745,4,30479,3.745269107888916,20.0,20.0
38138,3,8138,[603 302 427 127  64],339,5,30484,3.745423270672073,20.0,20.0
38139,3,8139,[ 25  28 195 176 471],882,4,30488,3.7454545454545456,0.0,0.0
38140,3,8140,[483 195 748 151 294],533,3,30491,3.745362977521189,20.0,0.0
38141,3,8141,[181  56 180 186 135],339,5,30496,3.7455170719724884,0.0,0.0
38142,3,8142,[222 168 175 161 301],334,3,30499,3.7454255188505465,0.0,0.0
38143,3,8143,[603 302 427 127  64],90,5,30504,3.7455795677799606,20.0,20.0
38144,3,8144,[ 82  22 423  79  56],207,3,30507,3.74548802946593,0.0,0.0
38145,3,8145,[176 168 180  12  89],387,4,30511,3.745519273262951,20.0,0.0
38146,3,8146,[  8 135  15 197  11],543,3,30514,3.7454277648214065,0.0,0.0
38147,3,8147,[603 302 427 127  64],745,4,30518,3.7454590083456063,20.0,20.0
38148,3,8148,[515  89  97 742 175],543,2,30520,3.7452448153147624,0.0,0.0
38149,3,8149,[  7  96 288 216 151],804,3,30523,3.7451533742331287,0.0,0.0
38150,3,8150,[603 302 427 127  64],745,4,30527,3.745184639921482,20.0,20.0
38151,3,8151,[211 144  22 294 288],804,4,30531,3.745215897939156,0.0,0.0
38152,3,8152,[603 302 427 127  64],664,5,30536,3.7453698025266773,20.0,20.0
38153,3,8153,[121 742 168 427  89],334,3,30539,3.745278390973755,0.0,0.0
38154,3,8154,[282  15 435  95 183],881,3,30542,3.7451870018393625,0.0,0.0
38155,3,8155,[191 273 300 175 211],7,4,30546,3.745218244237371,0.0,0.0
38156,3,8156,[322 211 117 427 288],537,2,30548,3.745004290793184,0.0,0.0
38157,3,8157,[603 302 427 127  64],90,5,30553,3.74515812699191,20.0,20.0
38158,3,8158,[603 302 427 127  64],745,4,30557,3.745189361441353,20.0,20.0
38159,3,8159,[603 302 427 127  64],13,5,30562,3.7453431372549018,20.0,20.0
38160,3,8160,[603 302 427 127  64],458,5,30567,3.7454968753829188,20.0,20.0
38161,3,8161,[258  98 286 111 175],378,4,30571,3.7455280568488116,0.0,20.0
38162,3,8162,[194 121 204 180 143],406,4,30575,3.745559230674997,0.0,0.0
38163,3,8163,[125  11 328  64 238],207,2,30577,3.745345418912298,0.0,0.0
38164,3,8164,[172 322 275  69 179],334,2,30579,3.7451316595223516,0.0,0.0
38165,3,8165,[175 265   9 174 222],82,4,30583,3.7451628704384032,0.0,20.0
38166,3,8166,[191  50 228 496 180],650,4,30587,3.745194073711277,0.0,20.0
38167,3,8167,[176  22   7 301 269],279,3,30590,3.7451028403525957,0.0,0.0
38168,3,8168,[603 302 427 127  64],666,5,30595,3.7452564573387197,20.0,20.0
38169,3,8169,[191 183 144 234 603],379,5,30600,3.745410036719706,20.0,0.0
38170,3,8170,[603 302 427 127  64],666,5,30605,3.7455635785093624,20.0,20.0
38171,3,8171,[ 28  89  64 180 275],378,4,30609,3.745594713656388,0.0,0.0
38172,3,8172,[258 496   7 282 197],378,3,30612,3.7455034870916433,0.0,0.0
38173,3,8173,[ 88 234 204 333 196],13,4,30616,3.745534621972107,0.0,0.0
38174,3,8174,[143 515 215 265 282],194,2,30618,3.745321100917431,0.0,0.0
38175,3,8175,[603 302 427 127  64],90,5,30623,3.7454745596868886,20.0,20.0
38176,3,8176,[197 238 302  82 183],207,2,30625,3.7452610982022745,0.0,0.0
38177,3,8177,[187 143 265 174 300],313,4,30629,3.745292247493275,0.0,20.0
38178,3,8178,[302 405  15 180   4],537,2,30631,3.745078860496393,0.0,0.0
38179,3,8179,[603 302 427 127  64],271,5,30636,3.745232273838631,20.0,20.0
38180,3,8180,[603 302 427 127  64],474,5,30641,3.745385649676079,20.0,20.0
38181,3,8181,[603 302 427 127  64],339,5,30646,3.7455389880224885,20.0,20.0
38182,3,8182,[603 302 427 127  64],666,5,30651,3.7456922888916044,20.0,20.0
38183,3,8183,[603 302 427 127  64],271,5,30656,3.745845552297165,20.0,20.0
38184,3,8184,[180 125 546 265 237],378,2,30658,3.7456322541233966,0.0,0.0
38185,3,8185,[603 302 427 127  64],458,5,30663,3.745785487417542,20.0,20.0
38186,3,8186,[603 302 427 127  64],458,5,30668,3.7459386832783683,20.0,20.0
38187,3,8187,[132  12 187 176 202],643,4,30672,3.7459697117733266,20.0,0.0
38188,3,8188,[135 568 197 179 323],13,2,30674,3.7457565026254733,0.0,0.0
38189,3,8189,[121 568 202 742 172],804,5,30679,3.745909645909646,0.0,0.0
38190,3,8190,[603 302 427 127  64],537,4,30683,3.7459406665852764,20.0,20.0
38191,3,8191,[483 182 286 257 403],95,2,30685,3.7457275390625,20.0,0.0
38192,3,8192,[603 302 427 127  64],474,5,30690,3.745880629805932,20.0,20.0
38193,3,8193,[405 258  69  96   9],92,4,30694,3.745911642665365,0.0,0.0
38194,3,8194,[655 222 276 568  98],378,4,30698,3.745942647956071,0.0,20.0
38195,3,8195,[603 302 427 127  64],669,5,30703,3.746095656417765,20.0,20.0
38196,3,8196,[603 302 427 127  64],669,5,30708,3.7462486275466635,20.0,20.0
38197,3,8197,[237  89 568 211 151],883,3,30711,3.7461575994144916,0.0,0.0
38198,3,8198,[ 50 238 186  79 100],295,5,30716,3.7463105256738625,0.0,40.0
38199,3,8199,[151 483 546 508 286],339,5,30721,3.7464634146341464,20.0,0.0
38200,3,8200,[121  97 215 183 182],538,4,30725,3.746494329959761,0.0,0.0
38201,3,8201,[294 515 135 423   8],328,2,30727,3.7462813947817604,0.0,0.0
38202,3,8202,[483 185 121 175  79],59,5,30732,3.746434231378764,20.0,0.0
38203,3,8203,[ 82 135 121 132 427],87,5,30737,3.7465870307167237,0.0,0.0
38204,3,8204,[603 302 427 127  64],664,5,30742,3.7467397928092625,20.0,20.0
38205,3,8205,[603 302 427 127  64],669,5,30747,3.7468925176699974,20.0,20.0
38206,3,8206,[187 318 202 175  15],653,2,30749,3.746679663701718,20.0,0.0
38207,3,8207,[603 302 427 127  64],474,5,30754,3.746832358674464,20.0,20.0
38208,3,8208,[603 302 427 127  64],339,5,30759,3.7469850164453646,20.0,20.0
38209,3,8209,[144 197 403  89 258],653,1,30760,3.7466504263093787,0.0,0.0
38210,3,8210,[678  96 742 257  22],881,3,30763,3.7465594933625623,0.0,0.0
38211,3,8211,[186  88  95 200 496],506,5,30768,3.746712128592304,0.0,0.0
38212,3,8212,[471   4 245  79 111],378,1,30769,3.7463776938999147,0.0,0.0
38213,3,8213,[603 302 427 127  64],664,5,30774,3.746530314097882,20.0,20.0
38214,3,8214,[275  97  56   4 237],7,5,30779,3.746682897139379,0.0,0.0
38215,3,8215,[228  88  82 471  95],648,4,30783,3.746713729308666,0.0,0.0
38216,3,8216,[603 302 427 127  64],664,5,30788,3.7468662528903494,20.0,20.0
38217,3,8217,[185 168  70 191 234],148,2,30790,3.746653687028474,0.0,0.0
38218,3,8218,[603 302 427 127  64],271,5,30795,3.746806180800584,20.0,20.0
38219,3,8219,[ 11  50  70  71 216],308,4,30799,3.74683698296837,0.0,20.0
38220,3,8220,[ 70 197  69   7 100],537,4,30803,3.7468677776426227,0.0,20.0
38221,3,8221,[  1 427  69  97 403],379,4,30807,3.7468985648260764,0.0,0.0
38222,3,8222,[603 302 427 127  64],90,5,30812,3.747050954639426,20.0,20.0
38223,3,8223,[603 302 427 127  64],13,5,30817,3.7472033073929962,20.0,20.0
38224,3,8224,[ 96 187 197 179 471],479,4,30821,3.7472340425531914,0.0,0.0
38225,3,8225,[238  89 268 289 475],387,2,30823,3.7470216387065403,0.0,0.0
38226,3,8226,[603 302 427 127  64],664,5,30828,3.7471739394676065,20.0,20.0
38227,3,8227,[603 302 427 127  64],90,5,30833,3.7473262032085564,20.0,20.0
38228,3,8228,[172 300 121   1 238],653,3,30836,3.7472353870458135,0.0,0.0
38229,3,8229,[151 357  79 180 215],804,4,30840,3.74726609963548,20.0,0.0
38230,3,8230,[655 235 191 405 204],144,3,30843,3.747175312841696,0.0,0.0
38231,3,8231,[603 302 427 127  64],339,5,30848,3.747327502429543,20.0,20.0
38232,3,8232,[185 318 588 603 179],527,3,30851,3.747236730231993,40.0,0.0
38233,3,8233,[655  69 173 182 144],398,5,30856,3.7473888753947047,0.0,0.0
38234,3,8234,[273 153 135 202 151],378,2,30858,3.747176684881603,0.0,0.0
38235,3,8235,[168   1 435 211 172],380,2,30860,3.746964545896066,0.0,0.0
38236,3,8236,[  8 175 121 323  71],474,4,30864,3.7469952652664804,0.0,0.0
38237,3,8237,[210 135 191  64 268],537,3,30867,3.7469045884923524,0.0,0.0
38238,3,8238,[144   8 238 135 258],64,3,30870,3.7468139337298214,0.0,0.0
38239,3,8239,[300 187 273 211 183],7,4,30874,3.7468446601941747,0.0,0.0
38240,3,8240,[  4 271  95 222 275],537,1,30875,3.746511345710472,0.0,0.0
38241,3,8241,[127   9 294 168  82],648,2,30877,3.746299441883038,0.0,20.0
38242,3,8242,[603 302 427 127  64],90,5,30882,3.7464515346354483,20.0,20.0
38243,3,8243,[172 289 211  71 215],474,4,30886,3.7464822901504125,0.0,0.0
38244,3,8244,[175  98 289 204 135],194,2,30888,3.7462704669496665,0.0,20.0
38245,3,8245,[603 302 427 127  64],90,5,30893,3.7464225078826097,20.0,20.0
38246,3,8246,[603 302 427 127  64],669,5,30898,3.746574511943737,20.0,20.0
38247,3,8247,[603 302 427 127  64],339,5,30903,3.7467264791464596,20.0,20.0
38248,3,8248,[ 82 168 204 222 132],666,2,30905,3.7465147290580676,0.0,0.0
38249,3,8249,[179 197 117  96 216],899,4,30909,3.7465454545454544,0.0,0.0
38250,3,8250,[603 302 427 127  64],90,5,30914,3.7466973700157555,20.0,20.0
38251,3,8251,[ 22 172 742  64 423],59,4,30918,3.7467280659234126,0.0,0.0
38252,3,8252,[268 161  88 176 183],234,1,30919,3.746395250212044,0.0,0.0
38253,3,8253,[597 286   8 127 204],452,4,30923,3.7464259752847107,0.0,20.0
38254,3,8254,[603 302 427 127  64],664,5,30928,3.7465778316172016,20.0,20.0
38255,3,8255,[323 182 121  22 222],897,5,30933,3.7467296511627906,0.0,0.0
38256,3,8256,[ 89 191 210  98 174],524,3,30936,3.746639215211336,0.0,40.0
38257,3,8257,[603 302 427 127  64],474,5,30941,3.7467909905546137,20.0,20.0
38258,3,8258,[603 302 427 127  64],13,5,30946,3.746942729143964,20.0,20.0
38259,3,8259,[ 71  50  89 194 269],650,4,30950,3.7469733656174333,0.0,20.0
38260,3,8260,[117  56 258 333 282],533,4,30954,3.747003994673768,0.0,0.0
38261,3,8261,[ 12  70 322 302 215],524,3,30957,3.746913580246914,20.0,0.0
38262,3,8262,[135 210 237  70 423],537,2,30959,3.7467021662834323,0.0,0.0
38263,3,8263,[ 88 301 174   4 483],210,5,30964,3.7468538238141336,20.0,20.0
38264,3,8264,[ 96 195 301 403 322],13,1,30965,3.746521476104053,0.0,0.0
38265,3,8265,[186 286  88 515 216],650,3,30968,3.7464311638035324,0.0,0.0
38266,3,8266,[132 186 161 191   4],13,4,30972,3.7464618362162816,0.0,0.0
38267,3,8267,[471   9 238 294 111],92,3,30975,3.7463715529753268,0.0,0.0
38268,3,8268,[172   8 144  15 515],194,3,30978,3.7462812915709276,0.0,0.0
38269,3,8269,[100 237  97 174 191],378,5,30983,3.7464328899637245,0.0,40.0
38270,3,8270,[197 144 318 117 196],308,1,30984,3.746100834240116,20.0,0.0
38271,3,8271,[508 181 174 271 515],334,3,30987,3.7460106382978724,0.0,20.0
38272,3,8272,[603  69 234 265 268],7,4,30991,3.746041339296507,20.0,0.0
38273,3,8273,[603 302 427 127  64],664,5,30996,3.746192893401015,20.0,20.0
38274,3,8274,[175 300 588  56 183],840,4,31000,3.7462235649546827,0.0,0.0
38275,3,8275,[403  56 215 202 515],194,2,31002,3.746012566457226,0.0,0.0
38276,3,8276,[603 302 427 127  64],669,5,31007,3.7461640691071643,20.0,20.0
38277,3,8277,[135 269 151 211 197],934,3,31010,3.7460739309011837,0.0,0.0
38278,3,8278,[475  22 215 496 175],479,2,31012,3.7458630269356203,0.0,0.0
38279,3,8279,[603 302 427 127  64],537,4,31016,3.7458937198067632,20.0,20.0
38280,3,8280,[222 175 423 496  22],64,5,31021,3.7460451636275813,0.0,0.0
38281,3,8281,[118 603 748  50  56],13,5,31026,3.7461965708766,20.0,20.0
38282,3,8282,[176 588 144  82 175],843,2,31028,3.7459857539538812,0.0,0.0
38283,3,8283,[  4 182 183 117 175],339,4,31032,3.746016417189763,0.0,0.0
38284,3,8284,[385   9 191 179   4],881,3,31035,3.7459263729631864,0.0,0.0
38285,3,8285,[282 200 427  50 185],374,3,31038,3.7458363504706735,0.0,20.0
38286,3,8286,[603 302 427 127  64],90,5,31043,3.745987691565102,20.0,20.0
38287,3,8287,[603 302 427 127  64],271,5,31048,3.746138996138996,20.0,20.0
38288,3,8288,[ 12 237 185  28  89],666,3,31051,3.746048980576668,20.0,0.0
38289,3,8289,[168 288 194 678 216],804,4,31055,3.7460796139927623,0.0,0.0
38290,3,8290,[265 176 211 515 186],543,4,31059,3.746110240019298,0.0,0.0
38291,3,8291,[194 286 191  98 204],234,3,31062,3.7460202604920405,0.0,20.0
38292,3,8292,[423 385 127  22  97],897,4,31066,3.746050886289642,0.0,20.0
38293,3,8293,[603 302 427 127  64],745,4,31070,3.7460815047021945,20.0,20.0
38294,3,8294,[603 302 427 127  64],745,4,31074,3.7461121157323687,20.0,20.0
38295,3,8295,[197  69 742 172 300],533,5,31079,3.7462632594021215,0.0,0.0
38296,3,8296,[100 245 161 288 496],533,3,31082,3.7461733156562613,0.0,20.0
38297,3,8297,[121  71 515 187  28],474,5,31087,3.7463244155218125,0.0,0.0
38298,3,8298,[ 11 235 357 423  71],308,4,31091,3.7463549825280156,20.0,0.0
38299,3,8299,[ 97 318 197  12 210],533,4,31095,3.746385542168675,40.0,0.0
38300,3,8300,[191 678 333 183 143],881,4,31099,3.7464160944464524,0.0,0.0
38301,3,8301,[173 183 238  28 194],843,1,31100,3.746085280655264,0.0,0.0
38302,3,8302,[127 186 174 211   9],234,1,31101,3.74575454654944,0.0,40.0
38303,3,8303,[  1 228 132 144 427],650,3,31104,3.745664739884393,0.0,0.0
38304,3,8304,[ 15 275 313 196  56],533,4,31108,3.7456953642384105,0.0,0.0
38305,3,8305,[121 222 173  11 273],145,4,31112,3.7457259812183965,0.0,0.0
38306,3,8306,[405 423 228 197  70],455,3,31115,3.745636210424943,0.0,0.0
38307,3,8307,[603 302 427 127  64],474,5,31120,3.7457871930669233,20.0,20.0
38308,3,8308,[ 97 111   1  70 174],64,4,31124,3.745817787940787,0.0,20.0
38309,3,8309,[181 185 172  69   8],897,3,31127,3.745728038507822,0.0,0.0
38310,3,8310,[405 546  12 257 132],271,3,31130,3.7456383106726028,20.0,0.0
38311,3,8311,[603 302 427 127  64],271,5,31135,3.7457892204042347,20.0,20.0
38312,3,8312,[182 222 286 196 515],85,4,31139,3.745819800312763,0.0,0.0
38313,3,8313,[603 302 427 127  64],474,5,31144,3.7459706519124367,20.0,20.0
38314,3,8314,[357 202 180 153  98],840,4,31148,3.7460012026458207,20.0,20.0
38315,3,8315,[216 144 172 175 143],313,4,31152,3.746031746031746,0.0,0.0
38316,3,8316,[655 234 288 546 423],804,2,31154,3.745821810749068,0.0,0.0
38317,3,8317,[273 176 405 175 182],774,2,31156,3.7456119259437366,0.0,0.0
38318,3,8318,[ 22 172 286 176 405],474,5,31161,3.7457627118644066,0.0,0.0
38319,3,8319,[603 302 427 127  64],271,5,31166,3.7459134615384615,20.0,20.0
38320,3,8320,[ 95   9 237 111 195],59,3,31169,3.7458238192524935,0.0,0.0
38321,3,8321,[265 588   7  89  82],234,0,31169,3.7453737082432106,0.0,0.0
38322,3,8322,[603 302 427 127  64],745,4,31173,3.7454043013336538,20.0,20.0
38323,3,8323,[ 79 161 742 496  15],95,4,31177,3.745434887073522,0.0,0.0
38324,3,8324,[ 25 117 423 286 202],194,0,31177,3.7449849849849848,0.0,0.0
38325,3,8325,[238 483  88  11 258],215,1,31178,3.744655296661062,20.0,0.0
38326,3,8326,[118 200 435 257 403],804,2,31180,3.744445778791882,0.0,0.0
38327,3,8327,[196 179 234 423   7],378,4,31184,3.74447646493756,0.0,0.0
38328,3,8328,[ 79  50 235 117  69],339,3,31187,3.744387081282267,0.0,20.0
38329,3,8329,[  1 258 211 121 222],447,3,31190,3.744297719087635,0.0,0.0
38330,3,8330,[603 302 427 127  64],458,5,31195,3.744448445564758,20.0,20.0
38331,3,8331,[603 302 427 127  64],271,5,31200,3.744599135861738,20.0,20.0
38332,3,8332,[132 127 117 210   8],897,3,31203,3.7445097803912155,0.0,20.0
38333,3,8333,[603 302 427 127  64],666,5,31208,3.744660427165827,20.0,20.0
38334,3,8334,[603 302 427 127  64],90,5,31213,3.7448110377924415,20.0,20.0
38335,3,8335,[603 302 427 127  64],13,5,31218,3.744961612284069,20.0,20.0
38336,3,8336,[603 302 427 127  64],90,5,31223,3.7451121506537124,20.0,20.0
38337,3,8337,[603 302 427 127  64],474,5,31228,3.7452626529143678,20.0,20.0
38338,3,8338,[603 302 427 127  64],664,5,31233,3.7454131190790263,20.0,20.0
38339,3,8339,[385 265  88 257 357],881,4,31237,3.745443645083933,20.0,0.0
38340,3,8340,[174 294  82 127 180],387,4,31241,3.745474163769332,0.0,40.0
38341,3,8341,[172   8  22 180 271],536,4,31245,3.7455046751378567,0.0,0.0
38342,3,8342,[603 302 427 127  64],458,5,31250,3.745655040153422,20.0,20.0
38343,3,8343,[234  98 288 603 197],643,4,31254,3.74568552253116,20.0,20.0
38344,3,8344,[603 302 427 127  64],745,4,31258,3.745715997603355,20.0,20.0
38345,3,8345,[  4 323 423 125 328],378,1,31259,3.7453870117421517,0.0,0.0
38346,3,8346,[276  64 742   1 204],881,5,31264,3.7455373187971728,0.0,0.0
38347,3,8347,[603 302 427 127  64],537,4,31268,3.7455678006708193,20.0,20.0
38348,3,8348,[603 302 427 127  64],537,4,31272,3.745598275242544,20.0,20.0
38349,3,8349,[202 216 435 265 300],533,4,31276,3.74562874251497,0.0,0.0
38350,3,8350,[655 496 742 273 183],42,3,31279,3.7455394563525326,0.0,0.0
38351,3,8351,[175 196 435 168 678],881,0,31279,3.7450909961685825,0.0,0.0
38352,3,8352,[258 405 385 117   4],738,3,31282,3.745001795762002,0.0,0.0
38353,3,8353,[182 228 568 286 678],13,2,31284,3.7447929135743356,0.0,0.0
38354,3,8354,[ 28 210 515 200 655],474,4,31288,3.7448234590065828,0.0,0.0
38355,3,8355,[603 302 427 127  64],664,5,31293,3.744973671613212,20.0,20.0
38356,3,8356,[300 210 202 121 603],13,3,31296,3.7448845279406484,20.0,0.0
38357,3,8357,[435  97 385 427 100],343,4,31300,3.7449150514477147,0.0,20.0
38358,3,8358,[200 186 475  64 135],10,5,31305,3.7450651991865054,0.0,0.0
38359,3,8359,[125 286  96 195 175],378,3,31308,3.744976076555024,0.0,0.0
38360,3,8360,[515 403  79   1  82],815,5,31313,3.745126181078818,0.0,0.0
38361,3,8361,[603 302 427 127  64],339,5,31318,3.7452762497010283,20.0,20.0
38362,3,8362,[ 56 403 173 215 185],843,0,31318,3.7448284108573477,0.0,0.0
38363,3,8363,[216 135  25  82 483],7,3,31321,3.7447393591582974,20.0,0.0
38364,3,8364,[238 222  89 111 403],648,4,31325,3.7447698744769875,0.0,0.0
38365,3,8365,[603 302 427 127  64],669,5,31330,3.7449199139373657,20.0,20.0
38366,3,8366,[ 69   1 403  79 210],892,4,31334,3.744950400382455,0.0,0.0
38367,3,8367,[748 294 357 173   1],804,5,31339,3.745100382409178,20.0,0.0
38368,3,8368,[435 271 174 125 323],290,1,31340,3.74477237423826,0.0,20.0
38369,3,8369,[ 56 269   7 187 275],343,5,31345,3.7449223416965354,0.0,0.0
38370,3,8370,[216   8 202 423  70],378,4,31349,3.7449528132839567,0.0,0.0
38371,3,8371,[195 234  28 435 216],13,3,31352,3.7448638318203535,0.0,0.0
38372,3,8372,[603 302 427 127  64],458,5,31357,3.7450137346231935,20.0,20.0
38373,3,8373,[322 546 161 174 215],881,3,31360,3.7449247671363746,0.0,20.0
38374,3,8374,[603 302 427 127  64],458,5,31365,3.7450746268656716,20.0,20.0
38375,3,8375,[172  11 216   7 275],554,3,31368,3.7449856733524354,0.0,0.0
38376,3,8376,[603 302 427 127  64],90,5,31373,3.745135490032231,20.0,20.0
38377,3,8377,[175 187  88 144 181],308,4,31377,3.7451659107185487,0.0,0.0
38378,3,8378,[  4 144 508 195 191],653,2,31379,3.7449576321756775,0.0,0.0
38379,3,8379,[603 302 427 127  64],458,5,31384,3.745107398568019,20.0,20.0
38380,3,8380,[603 302 427 127  64],339,5,31389,3.7452571292208567,20.0,20.0
38381,3,8381,[318 496 215 333 125],263,4,31393,3.745287520878072,20.0,0.0
38382,3,8382,[603 302 427 127  64],669,5,31398,3.7454371943218416,20.0,20.0
38383,3,8383,[187 176 121  98   4],474,5,31403,3.745586832061069,0.0,20.0
38384,3,8384,[496 276 318  25 117],234,2,31405,3.7453786523553965,20.0,0.0
38385,3,8385,[ 97 238 176 385  98],543,2,31407,3.7451705222990697,0.0,20.0
38386,3,8386,[603 302 427 127  64],13,5,31412,3.745320138309288,20.0,20.0
38387,3,8387,[603 302 427 127  64],666,5,31417,3.7454697186456842,20.0,20.0
38388,3,8388,[125 215 435  70 286],648,1,31418,3.7451424484443914,0.0,0.0
38389,3,8389,[300  70 187  97 144],479,3,31421,3.745053635280095,0.0,0.0
38390,3,8390,[ 69 168 588  25 282],42,3,31424,3.7449648432844715,0.0,0.0
38391,3,8391,[175   7 515  64 216],883,5,31429,3.7451143946615826,0.0,0.0
38392,3,8392,[144 655 153 318 118],666,3,31432,3.7450256165852496,20.0,0.0
38393,3,8393,[603 302 427 127  64],90,5,31437,3.7451751250893497,20.0,20.0
38394,3,8394,[ 50 423 323 405 181],881,3,31440,3.7450863609291245,0.0,20.0
38395,3,8395,[603 302 427 127  64],669,5,31445,3.7452358265840875,20.0,20.0
38396,3,8396,[300 194 427 186 202],7,4,31449,3.7452661664880313,0.0,0.0
38397,3,8397,[603 302 427 127  64],537,4,31453,3.7452964991664683,20.0,20.0
38398,3,8398,[180 179  22 222 508],378,2,31455,3.745088701035838,0.0,0.0
38399,3,8399,[603 302 427 127  64],745,4,31459,3.7451190476190477,20.0,20.0
38400,3,8400,[603 302 427 127  64],90,5,31464,3.74526842042614,20.0,20.0
38401,3,8401,[603 302 427 127  64],271,5,31469,3.745417757676744,20.0,20.0
38402,3,8402,[ 79 173  97 237 172],664,3,31472,3.7453290491491136,0.0,0.0
38403,3,8403,[471 180 238 435  69],207,2,31474,3.745121370775821,0.0,0.0
38404,3,8404,[328 268  22 168 187],537,3,31477,3.745032718619869,0.0,0.0
38405,3,8405,[603 302 427 127  64],669,5,31482,3.7451820128479656,20.0,20.0
38406,3,8406,[187 546 161  70 100],643,2,31484,3.7449744260735103,0.0,20.0
38407,3,8407,[ 69 215 187 238 258],313,4,31488,3.7450047573739296,0.0,0.0
38408,3,8408,[603 302 427 127  64],474,5,31493,3.7451540016648828,20.0,20.0
38409,3,8409,[175 276 100 196 185],537,4,31497,3.7451843043995243,0.0,20.0
38410,3,8410,[603 302 427 127  64],458,5,31502,3.745333491855903,20.0,20.0
38411,3,8411,[186 265 603  69  97],60,4,31506,3.745363766048502,20.0,0.0
38412,3,8412,[ 50 135 180 176 174],290,4,31510,3.7453940330440982,0.0,40.0
38413,3,8413,[235 186  95 222  12],334,2,31512,3.745186593772284,20.0,0.0
38414,3,8414,[603 302 427 127  64],90,5,31517,3.7453357100415925,20.0,20.0
38415,3,8415,[603 302 427 127  64],474,5,31522,3.745484790874525,20.0,20.0
38416,3,8416,[603 302 427 127  64],90,5,31527,3.7456338362837114,20.0,20.0
38417,3,8417,[427 403 100 127 210],334,4,31531,3.745664053219292,0.0,40.0
38418,3,8418,[ 98  69 195 588 423],263,4,31535,3.7456942629766004,0.0,20.0
38419,3,8419,[603 302 427 127  64],669,5,31540,3.7458432304038003,20.0,20.0
38420,3,8420,[172 196 181 202  11],295,5,31545,3.7459921624510155,0.0,0.0
38421,3,8421,[215 183 323 191 234],59,5,31550,3.746141059130848,0.0,0.0
38422,3,8422,[603 302 427 127  64],13,5,31555,3.7462899204558946,20.0,20.0
38423,3,8423,[ 11 318 172  71 197],184,4,31559,3.7463200379867048,20.0,0.0
38424,3,8424,[603 302 427 127  64],669,5,31564,3.7464688427299704,20.0,20.0
38425,3,8425,[238 117 603 202 151],234,1,31565,3.746142891051507,20.0,0.0
38426,3,8426,[603 302 427 127  64],664,5,31570,3.7462916814999407,20.0,20.0
38427,3,8427,[603 302 427 127  64],458,5,31575,3.746440436639772,20.0,20.0
38428,3,8428,[603 302 427 127  64],271,5,31580,3.7465891564835685,20.0,20.0
38429,3,8429,[323 282 118 678 269],455,2,31582,3.74638196915777,0.0,0.0
38430,3,8430,[ 22 180 748 568 186],881,3,31585,3.746293440872969,0.0,0.0
38431,3,8431,[204 588  79 403 202],42,4,31589,3.7463235294117645,0.0,0.0
38432,3,8432,[742 276 289 288  50],486,3,31592,3.746235029052532,0.0,20.0
38433,3,8433,[234 132 200 588 143],7,4,31596,3.746265117382025,0.0,0.0
38434,3,8434,[603 302 427 127  64],271,5,31601,3.746413752222881,20.0,20.0
38435,3,8435,[144  88 403 568 265],13,3,31604,3.7463252726410623,0.0,0.0
38436,3,8436,[603 302 427 127  64],669,5,31609,3.746473865117933,20.0,20.0
38437,3,8437,[ 64 603 143 181 222],804,4,31613,3.746503910879355,20.0,0.0
38438,3,8438,[235 471 427 153 144],374,3,31616,3.7464154520677804,0.0,0.0
38439,3,8439,[186 301 121 132 276],13,4,31620,3.7464454976303316,0.0,0.0
38440,3,8440,[ 79 237  28   4 228],653,3,31623,3.7463570666982586,0.0,0.0
38441,3,8441,[603 302 427 127  64],669,5,31628,3.7465055674010896,20.0,20.0
38442,3,8442,[603 302 427 127  64],339,5,31633,3.746654032926685,20.0,20.0
38443,3,8443,[197 403  56 322 357],881,2,31635,3.7464471814306015,20.0,0.0
38444,3,8444,[603 302 427 127  64],13,5,31640,3.7465956187092955,20.0,20.0
38445,3,8445,[258 172 228 403  89],890,3,31643,3.746507222353777,0.0,0.0
38446,3,8446,[603 302 427 127  64],666,5,31648,3.746655617378951,20.0,20.0
38447,3,8447,[603 302 427 127  64],90,5,31653,3.746803977272727,20.0,20.0
38448,3,8448,[603 302 427 127  64],271,5,31658,3.7469523020475797,20.0,20.0
38449,3,8449,[603 302 427 127  64],474,5,31663,3.7471005917159763,20.0,20.0
38450,3,8450,[288 191  69 313 135],650,3,31666,3.7470121879067566,0.0,0.0
38451,3,8451,[ 22 181 427 161 333],328,3,31669,3.7469238050165643,0.0,0.0
38452,3,8452,[603 302 427 127  64],339,5,31674,3.7470720454276587,20.0,20.0
38453,3,8453,[202 357 211 200 655],804,4,31678,3.747101963567542,20.0,0.0
38454,3,8454,[294 121 183 403 286],881,2,31680,3.746895328208161,0.0,0.0
38455,3,8455,[168 151 234 191  96],537,2,31682,3.7466887417218544,0.0,0.0
38456,3,8456,[603 302 427 127  64],458,5,31687,3.7468369398131727,20.0,20.0
38457,3,8457,[603 302 427 127  64],664,5,31692,3.7469851028611965,20.0,20.0
38458,3,8458,[ 25 187 153 173 196],194,2,31694,3.7467785790282537,0.0,0.0
38459,3,8459,[173 135 328 143 228],479,4,31698,3.746808510638298,0.0,0.0
38460,3,8460,[568  71  89 174  56],901,3,31701,3.7467202458338256,0.0,20.0
38461,3,8461,[187 222 172 135  88],892,5,31706,3.746868352635311,0.0,0.0
38462,3,8462,[ 82  11  12 313  98],59,5,31711,3.7470164244357793,20.0,20.0
38463,3,8463,[197   7 182 118 403],374,3,31714,3.7469281663516067,0.0,0.0
38464,3,8464,[286 269 179  22 748],207,2,31716,3.746721795629061,0.0,0.0
38465,3,8465,[603 302 427 127  64],537,4,31720,3.746751712733286,20.0,20.0
38466,3,8466,[288  12 202 191 132],13,3,31723,3.7466635171843627,20.0,0.0
38467,3,8467,[603 302 427 127  64],474,5,31728,3.7468115257439774,20.0,20.0
38468,3,8468,[143  22 357  15  64],749,5,31733,3.746959499350573,20.0,0.0
38469,3,8469,[183 294 475 496 127],10,4,31737,3.7469893742621014,0.0,20.0
38470,3,8470,[318  56 475 483 211],125,2,31739,3.7467831424861293,40.0,0.0
38471,3,8471,[603 302 427 127  64],664,5,31744,3.7469310670443816,20.0,20.0
38472,3,8472,[144 435 275 180  15],901,3,31747,3.7468429127817773,0.0,0.0
38473,3,8473,[  1 238 176 313 211],380,2,31749,3.7466367713004485,0.0,0.0
38474,3,8474,[318 294  25 258 174],474,4,31753,3.7466666666666666,20.0,20.0
38475,3,8475,[603 302 427 127  64],669,5,31758,3.7468145351580935,20.0,20.0
38476,3,8476,[603 302 427 127  64],664,5,31763,3.7469623687625337,20.0,20.0
38477,3,8477,[603 302 427 127  64],745,4,31767,3.7469922151450814,20.0,20.0
38478,3,8478,[603 302 427 127  64],537,4,31771,3.7470220544875574,20.0,20.0
38479,3,8479,[333  25 471  89 127],343,2,31773,3.746816037735849,0.0,20.0
38480,3,8480,[176 515 204 100 121],311,4,31777,3.7468458908147624,0.0,20.0
38481,3,8481,[228 181 496 215 186],890,4,31781,3.7468757368545154,0.0,0.0
38482,3,8482,[ 22 471 568 174 179],95,4,31785,3.7469055758575975,0.0,20.0
38483,3,8483,[ 98 183 153   4 204],207,3,31788,3.746817538896747,0.0,20.0
38484,3,8484,[183 234  56 276  98],474,5,31793,3.7469652327637006,0.0,20.0
38485,3,8485,[603 302 427 127  64],666,5,31798,3.7471128918218244,20.0,20.0
38486,3,8486,[603 302 427 127  64],745,4,31802,3.7471426888181925,20.0,20.0
38487,3,8487,[200 286 185  82 276],13,1,31803,3.7468190386427898,0.0,0.0
38488,3,8488,[273   1 258 276 111],59,2,31805,3.7466132642242904,0.0,0.0
38489,3,8489,[275 118  56 515 168],882,5,31810,3.746760895170789,0.0,0.0
38490,3,8490,[172 204 273 276 282],554,2,31812,3.7465551760687785,0.0,0.0
38491,3,8491,[603 302 427 127  64],474,5,31817,3.7467027790861986,20.0,20.0
38492,3,8492,[194 143 197  96 174],653,2,31819,3.7464971152714,0.0,20.0
38493,3,8493,[144 294  88  82 234],95,2,31821,3.7462914998822696,0.0,0.0
38494,3,8494,[603 302 427 127  64],669,5,31826,3.7464390818128313,20.0,20.0
38495,3,8495,[135 515   4   7  15],537,3,31829,3.7463512241054615,0.0,0.0
38496,3,8496,[318 197 234 216  98],385,2,31831,3.746145698481817,20.0,20.0
38497,3,8497,[ 96 173  56  98 357],188,5,31836,3.746293245469522,20.0,20.0
38498,3,8498,[100 187 182  70 172],892,5,31841,3.746440757736204,0.0,20.0
38499,3,8499,[603 302 427 127  64],458,5,31846,3.7465882352941176,20.0,20.0
38500,3,8500,[603 302 427 127  64],271,5,31851,3.746735678155511,20.0,20.0
38501,3,8501,[603 302 427 127  64],666,5,31856,3.7468830863326277,20.0,20.0
38502,3,8502,[ 96 172 182 202 204],7,4,31860,3.7469128542867223,0.0,0.0
38503,3,8503,[ 64 197 228 323 200],488,2,31862,3.7467074317968017,0.0,0.0
38504,3,8504,[ 12 173 100 117 195],374,3,31865,3.7466196355085244,20.0,20.0
38505,3,8505,[132  15 210 181  95],378,5,31870,3.7467669880084644,0.0,0.0
38506,3,8506,[181 127 215  79 182],234,1,31871,3.7464441048548256,0.0,20.0
38507,3,8507,[294 333 196 186 313],537,2,31873,3.746238834038552,0.0,0.0
38508,3,8508,[179 271 195 603 200],379,3,31876,3.746151134093313,20.0,0.0
38509,3,8509,[211  15 180 117 194],650,3,31879,3.7460634547591067,0.0,0.0
38510,3,8510,[228 216  11 197 265],374,5,31884,3.746210786041593,0.0,0.0
38511,3,8511,[ 82 403 168  56 276],883,4,31888,3.7462406015037595,0.0,0.0
38512,3,8512,[135 276 258 200 313],455,5,31893,3.7463878773640316,0.0,0.0
38513,3,8513,[603 302 427 127  64],339,5,31898,3.7465351186281417,20.0,20.0
38514,3,8514,[194 427 405 588 174],13,4,31902,3.7465648854961833,0.0,20.0
38515,3,8515,[132 301 318 168 173],234,2,31904,3.746359793330202,20.0,0.0
38516,3,8516,[127  15 508 172 117],144,5,31909,3.7465069860279443,0.0,20.0
38517,3,8517,[546  50 515 186 385],343,3,31912,3.746419347264616,0.0,20.0
38518,3,8518,[603 302 427 127  64],458,5,31917,3.746566498415307,20.0,20.0
38519,3,8519,[603 302 427 127  64],664,5,31922,3.746713615023474,20.0,20.0
38520,3,8520,[603 302 427 127  64],90,5,31927,3.7468606971012792,20.0,20.0
38521,3,8521,[508 181 151 238 176],213,5,31932,3.747007744660878,0.0,0.0
38522,3,8522,[ 88 176 215 483 210],650,2,31934,3.746802768978059,20.0,0.0
38523,3,8523,[603 302 427 127  64],339,5,31939,3.7469497888315346,20.0,20.0
38524,3,8524,[603 302 427 127  64],666,5,31944,3.7470967741935484,20.0,20.0
38525,3,8525,[  9 294 174 204  95],406,4,31948,3.7471264367816093,0.0,20.0
38526,3,8526,[143 423 276   8  69],533,3,31951,3.7470388178726397,0.0,0.0
38527,3,8527,[100 588 603 153  71],454,2,31953,3.7468339587242028,20.0,20.0
38528,3,8528,[ 98   9 186 153  89],234,1,31954,3.7465119005745104,0.0,20.0
38529,3,8529,[603 302 427 127  64],339,5,31959,3.7466588511137164,20.0,20.0
38530,3,8530,[ 88 568   7 187 216],892,5,31964,3.7468057672019692,0.0,0.0
38531,3,8531,[135  56 568 385  70],883,2,31966,3.746601031411158,0.0,0.0
38532,3,8532,[435 143 483 235 508],643,5,31971,3.746747919840619,20.0,0.0
38533,3,8533,[117 603 475 132 275],537,3,31974,3.7466604171549096,20.0,0.0
38534,3,8534,[ 88 194 300 286 273],378,5,31979,3.74680726420621,0.0,0.0
38535,3,8535,[197 215 678 275  98],13,3,31982,3.7467197750702907,0.0,20.0
38536,3,8536,[235 127 273 269 322],102,0,31982,3.7462808949279607,0.0,20.0
38537,3,8537,[546  96 603   7 294],145,4,31986,3.7463106113843994,20.0,0.0
38538,3,8538,[ 69 222  88   1 151],883,2,31988,3.746106101417028,0.0,0.0
38539,3,8539,[ 50 161 403  89 151],379,4,31992,3.746135831381733,0.0,20.0
38540,3,8540,[ 89 403 245 328 322],197,3,31995,3.7460484720758696,0.0,0.0
38541,3,8541,[603 302 427 127  64],537,4,31999,3.74607820182627,20.0,20.0
38542,3,8542,[ 56 546 568 195  69],374,4,32003,3.7461079246166453,0.0,0.0
38543,3,8543,[294 211 121 179  88],311,3,32006,3.746020599250936,0.0,0.0
38544,3,8544,[182 742 125 423  97],374,4,32010,3.746050321825629,0.0,0.0
38545,3,8545,[ 70 258 237 288 405],144,4,32014,3.7460800374444183,0.0,0.0
38546,3,8546,[603 302 427 127  64],458,5,32019,3.7462267462267462,20.0,20.0
38547,3,8547,[655 181 200  97 483],881,3,32022,3.7461394478240524,20.0,0.0
38548,3,8548,[ 22 435  69 228 288],650,2,32024,3.745935197099076,0.0,0.0
38549,3,8549,[202 153 144 118 180],749,4,32028,3.745964912280702,0.0,0.0
38550,3,8550,[603 302 427 127  64],664,5,32033,3.746111565898725,20.0,20.0
38551,3,8551,[228 176 313 301 403],13,2,32035,3.745907390084191,0.0,0.0
38552,3,8552,[ 69 100 186 143 211],653,3,32038,3.7458201800537823,0.0,20.0
38553,3,8553,[215  25   4 143 275],648,2,32040,3.745616086041618,0.0,0.0
38554,3,8554,[603 302 427 127  64],271,5,32045,3.7457627118644066,20.0,20.0
38555,3,8555,[603 302 427 127  64],13,5,32050,3.7459093034128097,20.0,20.0
38556,3,8556,[475 294 286 204 144],213,3,32053,3.745822133925441,0.0,0.0
38557,3,8557,[385 125 204 179  82],648,4,32057,3.7458518345407805,0.0,0.0
38558,3,8558,[ 89   9 174 196 655],488,3,32060,3.745764692136932,0.0,20.0
38559,3,8559,[294 515 258 100 222],634,4,32064,3.7457943925233645,0.0,20.0
38560,3,8560,[603 302 427 127  64],664,5,32069,3.7459408947552855,20.0,20.0
38561,3,8561,[405 200 597 471  56],213,3,32072,3.7458537724830645,0.0,0.0
38562,3,8562,[423 215  98 194 357],774,1,32073,3.745533107555763,20.0,20.0
38563,3,8563,[603 302 427 127  64],666,5,32078,3.7456795889771133,20.0,20.0
38564,3,8564,[483 127 168  89 117],537,4,32082,3.7457092819614712,20.0,20.0
38565,3,8565,[ 50  96 181 282 211],474,5,32087,3.7458557086154562,0.0,20.0
38566,3,8566,[603 302 427 127  64],90,5,32092,3.746002101085561,20.0,20.0
38567,3,8567,[603 302 427 127  64],664,5,32097,3.7461484593837535,20.0,20.0
38568,3,8568,[603 302 427 127  64],474,5,32102,3.7462947835219977,20.0,20.0
38569,3,8569,[  8 210 127 172 174],95,5,32107,3.746441073512252,0.0,40.0
38570,3,8570,[273 196 100 318 245],92,4,32111,3.7464706568661765,20.0,20.0
38571,3,8571,[ 28 678 135 265 175],387,4,32115,3.7465002333177786,0.0,0.0
38572,3,8572,[ 56 597   4 235  82],804,3,32118,3.7464131575877757,0.0,0.0
38573,3,8573,[195 275 175 185 191],10,4,32122,3.7464427338465125,0.0,0.0
38574,3,8574,[258 471 111 313  25],26,1,32123,3.746122448979592,0.0,0.0
38575,3,8575,[204 238 228  70 195],59,4,32127,3.746152052238806,0.0,0.0
38576,3,8576,[496 176  12 483 191],533,4,32131,3.74618164859508,40.0,0.0
38577,3,8577,[471  88 423 328 276],271,2,32133,3.7459780834693404,0.0,0.0
38578,3,8578,[196 121 275  50 496],452,5,32138,3.7461242569063993,0.0,20.0
38579,3,8579,[143 100 186  79  22],295,5,32143,3.7462703962703965,0.0,20.0
38580,3,8580,[144 323 322 181 475],119,5,32148,3.7464165015732434,0.0,0.0
38581,3,8581,[ 50   7 423  28 258],774,1,32149,3.7460964810067585,0.0,20.0
38582,3,8582,[161 294 210 215 117],387,1,32150,3.7457765350110686,0.0,0.0
38583,3,8583,[603 302 427 127  64],474,5,32155,3.7459226467847158,20.0,20.0
38584,3,8584,[ 70 143 603 181 435],804,3,32158,3.745835760046593,20.0,0.0
38585,3,8585,[215   1 216 191 405],92,3,32161,3.7457488935476357,0.0,0.0
38586,3,8586,[235 508 180 435 127],537,3,32164,3.7456620472807733,0.0,20.0
38587,3,8587,[603 302 427 127  64],90,5,32169,3.7458081043316254,20.0,20.0
38588,3,8588,[234 216  22 496 258],474,5,32174,3.74595412737222,0.0,0.0
38589,3,8589,[ 98  88  96 568   8],543,4,32178,3.7459837019790454,0.0,20.0
38590,3,8590,[603 302 427 127  64],664,5,32183,3.7461296705854963,20.0,20.0
38591,3,8591,[100 181 121 176  96],653,4,32187,3.746159217877095,0.0,20.0
38592,3,8592,[ 15 185 151 323  25],648,2,32189,3.7459560107063887,0.0,0.0
38593,3,8593,[603 302 427 127  64],537,4,32193,3.745985571328834,20.0,20.0
38594,3,8594,[202 508 196 151 475],537,2,32195,3.745782431646306,0.0,0.0
38595,3,8595,[385 603 151  50 127],843,0,32195,3.745346672871103,20.0,40.0
38596,3,8596,[ 98 257 475 328 271],334,3,32198,3.7452599744096777,0.0,20.0
38597,3,8597,[258  98 568 215 222],378,4,32202,3.7452896022330773,0.0,20.0
38598,3,8598,[265  22   9   7  15],308,3,32205,3.7452029305733223,0.0,0.0
38599,3,8599,[603 302 427 127  64],537,4,32209,3.7452325581395347,20.0,20.0
38600,3,8600,[ 95  11 174  79 385],378,4,32213,3.7452621788164167,0.0,20.0
38601,3,8601,[234 301  96 328 215],234,1,32214,3.744943036503139,0.0,0.0
38602,3,8602,[603 302 427 127  64],537,4,32218,3.74497268394746,20.0,20.0
38603,3,8603,[603 302 427 127  64],669,5,32223,3.745118549511855,20.0,20.0
38604,3,8604,[173   1 496 328  15],537,2,32225,3.7449157466589194,0.0,0.0
38605,3,8605,[603 302 427 127  64],474,5,32230,3.745061584940739,20.0,20.0
38606,3,8606,[603 302 427 127  64],13,5,32235,3.745207389334263,20.0,20.0
38607,3,8607,[603 302 427 127  64],669,5,32240,3.7453531598513012,20.0,20.0
38608,3,8608,[238   9 655 222 143],378,3,32243,3.745266581484493,0.0,0.0
38609,3,8609,[282  28 196 385 275],533,5,32248,3.74541231126597,0.0,0.0
38610,3,8610,[172  89 496 318  22],334,3,32251,3.74532574613866,20.0,0.0
38611,3,8611,[265 204 655 132 194],843,0,32251,3.744890849976777,0.0,0.0
38612,3,8612,[183 127 117 181 202],313,5,32256,3.7450365726227797,0.0,20.0
38613,3,8613,[185 153 423   8 182],90,4,32260,3.7450661713489666,0.0,0.0
38614,3,8614,[275  98 603  88 168],883,4,32264,3.7450957632037145,20.0,20.0
38615,3,8615,[ 70   1 185  22 228],406,2,32266,3.7448932219127204,0.0,0.0
38616,3,8616,[603 302 427 127  64],537,4,32270,3.744922826969943,20.0,20.0
38617,3,8617,[475 289  69 153 135],90,2,32272,3.744720352750058,0.0,0.0
38618,3,8618,[132 135  82 265 196],537,1,32273,3.7444019027729434,0.0,0.0
38619,3,8619,[174 238  69 180 483],13,4,32277,3.744431554524362,20.0,20.0
38620,3,8620,[603 302 427 127  64],271,5,32282,3.744577195220972,20.0,20.0
38621,3,8621,[603 302 427 127  64],458,5,32287,3.7447228021340755,20.0,20.0
38622,3,8622,[257 161 475 180  88],479,3,32290,3.7446364374347674,0.0,0.0
38623,3,8623,[ 98 275 597  82 127],95,2,32292,3.74443413729128,0.0,40.0
38624,3,8624,[ 12 202  70  71 742],454,1,32293,3.7441159420289853,20.0,0.0
38625,3,8625,[153 168 179 210 597],13,2,32295,3.7439137491305354,0.0,0.0
38626,3,8626,[191 197 427 127 176],474,5,32300,3.7440593485568563,0.0,20.0
38627,3,8627,[182  79 276 161 228],881,2,32302,3.7438572090866944,0.0,0.0
38628,3,8628,[238 322   8 216 180],313,3,32305,3.7437710047514194,0.0,0.0
38629,3,8629,[603 302 427 127  64],666,5,32310,3.7439165701042874,20.0,20.0
38630,3,8630,[294 194 405 568 153],378,3,32313,3.743830378866875,0.0,0.0
38631,3,8631,[603 302 427 127  64],745,4,32317,3.7438600556070436,20.0,20.0
38632,3,8632,[603 302 427 127  64],339,5,32322,3.7440055600602338,20.0,20.0
38633,3,8633,[ 64   8 204 273 153],328,1,32323,3.7436877461199907,0.0,0.0
38634,3,8634,[  4 228 100 168  56],643,5,32328,3.7438332368268674,0.0,20.0
38635,3,8635,[168 174 121   4 100],308,4,32332,3.7438628994905048,0.0,40.0
38636,3,8636,[385 483  97 151 135],788,1,32333,3.7435452124580295,20.0,0.0
38637,3,8637,[427  95 111 210 265],42,3,32336,3.74345913405881,0.0,0.0
38638,3,8638,[237 294 174  98 132],194,3,32339,3.7433730755874524,0.0,40.0
38639,3,8639,[ 95 127 678 194 546],648,2,32341,3.743171296296296,0.0,20.0
38640,3,8640,[117 202 276 748  11],13,3,32344,3.743085291054276,0.0,0.0
38641,3,8641,[185 196 235 125 182],194,1,32345,3.7427678778060636,0.0,0.0
38642,3,8642,[508 265 180  98 135],60,5,32350,3.742913340275367,0.0,20.0
38643,3,8643,[172 175 275 161  50],378,5,32355,3.743058769088385,0.0,20.0
38644,3,8644,[603 302 427 127  64],537,4,32359,3.7430884904569117,20.0,20.0
38645,3,8645,[161 603 286 143  97],474,5,32364,3.74323386537127,20.0,0.0
38646,3,8646,[603 302 427 127  64],537,4,32368,3.743263559616052,20.0,20.0
38647,3,8647,[ 12 180 235 237 273],378,4,32372,3.7432932469935247,20.0,0.0
38648,3,8648,[603 302 427 127  64],664,5,32377,3.7434385478089953,20.0,20.0
38649,3,8649,[211 427  64  70 294],13,3,32380,3.743352601156069,0.0,0.0
38650,3,8650,[603 302 427 127  64],537,4,32384,3.7433822679459023,20.0,20.0
38651,3,8651,[603 302 427 127  64],664,5,32389,3.7435275080906147,20.0,20.0
38652,3,8652,[603 302 427 127  64],537,4,32393,3.7435571478100083,20.0,20.0
38653,3,8653,[135 222 161 176  50],881,3,32396,3.7434712271781834,0.0,20.0
38654,3,8654,[357  22 475 180  89],308,5,32401,3.743616406701329,20.0,0.0
38655,3,8655,[ 64  28 423  71 211],788,4,32405,3.7436460258780038,0.0,0.0
38656,3,8656,[603 302 427 127  64],666,5,32410,3.7437911516691695,20.0,20.0
38657,3,8657,[603 302 427 127  64],745,4,32414,3.743820743820744,20.0,20.0
38658,3,8658,[603 302 427 127  64],664,5,32419,3.743965815914078,20.0,20.0
38659,3,8659,[186 121  22 328  15],653,4,32423,3.743995381062356,0.0,0.0
38660,3,8660,[202  64 588 121 100],13,5,32428,3.7441403994919753,0.0,20.0
38661,3,8661,[603 302 427 127  64],271,5,32433,3.744285384437774,20.0,20.0
38662,3,8662,[  4 172 179  25   8],271,4,32437,3.7443149024587323,0.0,0.0
38663,3,8663,[603 302 427 127  64],90,5,32442,3.744459833795014,20.0,20.0
38664,3,8664,[603 302 427 127  64],669,5,32447,3.744604731679169,20.0,20.0
38665,3,8665,[ 64 182 186 318  69],271,4,32451,3.7446342026309716,20.0,0.0
38666,3,8666,[302 182 318 603 678],474,4,32455,3.744663666782047,40.0,0.0
38667,3,8667,[ 28 328 423 234 204],13,4,32459,3.7446931241347485,0.0,0.0
38668,3,8668,[204 135 546 234 237],804,3,32462,3.744607221132772,0.0,0.0
38669,3,8669,[603 302 427 127  64],666,5,32467,3.7447520184544407,20.0,20.0
38670,3,8670,[603 302 427 127  64],669,5,32472,3.7448967823780417,20.0,20.0
38671,3,8671,[603 302 427 127  64],90,5,32477,3.745041512915129,20.0,20.0
38672,3,8672,[ 50 257 237 100 125],6,2,32479,3.744840309004958,0.0,40.0
38673,3,8673,[265 313  98  71 187],59,4,32483,3.7448697256167858,0.0,20.0
38674,3,8674,[211 121 195 182 496],537,3,32486,3.7447838616714697,0.0,0.0
38675,3,8675,[194 179 174  97 318],774,1,32487,3.7444674965421854,20.0,20.0
38676,3,8676,[328 174 216 183 172],145,5,32492,3.744612193154316,0.0,20.0
38677,3,8677,[ 82 286 276 742  56],200,5,32497,3.7447568564185296,0.0,0.0
38678,3,8678,[471 289   9 269 385],378,4,32501,3.744786265698813,0.0,0.0
38679,3,8679,[132  82  70 483 174],488,2,32503,3.744585253456221,20.0,20.0
38680,3,8680,[222 183  70  64 435],378,4,32507,3.7446146757286027,0.0,0.0
38681,3,8681,[603 302 427 127 313],90,5,32512,3.74475927205713,20.0,20.0
38682,3,8682,[603 302 427 127 313],271,5,32517,3.7449038350800414,20.0,20.0
38683,3,8683,[174 269 245 496 181],334,2,32519,3.7447029018885307,0.0,20.0
38684,3,8684,[603 302 427 127 313],14,3,32522,3.74461715601612,20.0,20.0
38685,3,8685,[228 238 216 153 186],653,2,32524,3.744416302095326,0.0,0.0
38686,3,8686,[135 471 211 132 215],533,4,32528,3.7444457234948776,0.0,0.0
38687,3,8687,[257 196  89  71  98],233,4,32532,3.744475138121547,0.0,20.0
38688,3,8688,[210 385  28 183 423],64,4,32536,3.744504545977673,0.0,0.0
38689,3,8689,[ 56  69 597 273 271],13,2,32538,3.7443037974683544,0.0,0.0
38690,3,8690,[ 97 111 204 172 118],59,5,32543,3.744448279829709,0.0,0.0
38691,3,8691,[143 427 161 195  89],308,4,32547,3.744477680625863,0.0,0.0
38692,3,8692,[195 143 121 194 174],59,3,32550,3.7443920395720696,0.0,20.0
38693,3,8693,[168  88 496   4 405],474,4,32554,3.744421440073614,0.0,0.0
38694,3,8694,[435 168 127 100 202],161,2,32556,3.744220816561242,0.0,40.0
38695,3,8695,[ 15 357 143  22 161],59,3,32559,3.7441352345906163,20.0,0.0
38696,3,8696,[211 269 228 302 288],339,4,32563,3.744164654478556,0.0,0.0
38697,3,8697,[515 294 182 179 173],13,1,32564,3.743849160726604,0.0,0.0
38698,3,8698,[197 216 174 222 300],666,1,32565,3.7435337395102883,0.0,20.0
38699,3,8699,[  4 151  96 183 318],474,4,32569,3.7435632183908045,20.0,0.0
38700,3,8700,[195 282 135 187 153],144,5,32574,3.7437076198138146,0.0,0.0
38701,3,8701,[269 271 588  96   9],64,4,32578,3.7437370719374856,0.0,0.0
38702,3,8702,[216  25 318 174 276],537,2,32580,3.7435367114788005,20.0,20.0
38703,3,8703,[121 294 258 216  28],271,2,32582,3.7433363970588234,0.0,0.0
38704,3,8704,[235 182 216 588 186],59,3,32585,3.743251005169443,0.0,0.0
38705,3,8705,[186 471 172 181 222],524,1,32586,3.742935906271537,0.0,0.0
38706,3,8706,[289  89 238 173 302],378,4,32590,3.7429654301137014,0.0,0.0
38707,3,8707,[197 172 143 153 187],334,3,32593,3.7428801102434544,0.0,0.0
38708,3,8708,[294 111 182 385 276],92,3,32596,3.742794809966701,0.0,0.0
38709,3,8709,[186 121 215 200   8],474,4,32600,3.7428243398392653,0.0,0.0
38710,3,8710,[471  12  96  15 273],207,2,32602,3.742624268166686,20.0,0.0
38711,3,8711,[222 173 180 238  12],311,5,32607,3.7427685950413223,20.0,0.0
38712,3,8712,[182 216 435 222 127],328,2,32609,3.7425685756914953,0.0,20.0
38713,3,8713,[  9 546 471 276 475],699,1,32610,3.7422538443883404,0.0,0.0
38714,3,8714,[655  25  11 161 151],234,0,32610,3.7418244406196215,0.0,0.0
38715,3,8715,[269 222  97 186  69],312,3,32613,3.741739329967875,0.0,0.0
38716,3,8716,[603 302 427 127  64],666,5,32618,3.7418836755764597,20.0,20.0
38717,3,8717,[238 180 222 173 174],279,3,32621,3.7417985776554255,0.0,20.0
38718,3,8718,[121  79  56 117 173],897,2,32623,3.741598807202661,0.0,0.0
38719,3,8719,[  7  82 265  22 195],234,1,32624,3.7412844036697246,0.0,0.0
38720,3,8720,[603 302 427 127  64],474,5,32629,3.7414287352367848,20.0,20.0
38721,3,8721,[603 302 427 127  64],271,5,32634,3.741573033707865,20.0,20.0
38722,3,8722,[143 385 144 153 118],7,3,32637,3.741488020176545,0.0,0.0
38723,3,8723,[121 294 172   4 151],648,2,32639,3.741288399816598,0.0,0.0
38724,3,8724,[234  89 153 174 275],13,4,32643,3.7413180515759312,0.0,20.0
38725,3,8725,[204 258 135  89 197],13,5,32648,3.7414622965849187,0.0,0.0
38726,3,8726,[322  50 603 235 435],804,4,32652,3.7414919216225506,20.0,20.0
38727,3,8727,[603 302 427 127  64],664,5,32657,3.7416361136571954,20.0,20.0
38728,3,8728,[603 302 427 127  64],13,5,32662,3.7417802726543705,20.0,20.0
38729,3,8729,[603 302 427 127  64],339,5,32667,3.7419243986254296,20.0,20.0
38730,3,8730,[228  89 427 423 132],87,4,32671,3.741953957164128,0.0,0.0
38731,3,8731,[237 181 546 235 258],825,4,32675,3.7419835089326616,0.0,0.0
38732,3,8732,[180  98 546 328 568],788,3,32678,3.7418985457460208,0.0,20.0
38733,3,8733,[603 302 427 127  64],339,5,32683,3.742042592168537,20.0,20.0
38734,3,8734,[  7  79 245 174 121],378,4,32687,3.7420721236405265,0.0,20.0
38735,3,8735,[173  12 275 427 405],7,4,32691,3.7421016483516483,20.0,0.0
38736,3,8736,[302 222  11 117 742],145,5,32696,3.7422456220670712,0.0,0.0
38737,3,8737,[ 88 194  15   9  12],311,5,32701,3.7423895628290227,20.0,0.0
38738,3,8738,[ 98 748 183 568 179],881,4,32705,3.742419041080215,0.0,20.0
38739,3,8739,[603 302 427 127  64],537,4,32709,3.7424485125858125,20.0,20.0
38740,3,8740,[ 69 286 173  28 496],454,3,32712,3.7423635739617893,0.0,0.0
38741,3,8741,[286 483  28 678  64],7,4,32716,3.742393045069778,20.0,0.0
38742,3,8742,[603 302 427 127  64],13,5,32721,3.742536886652179,20.0,20.0
38743,3,8743,[174 423 182  11 175],666,3,32724,3.742451967063129,0.0,20.0
38744,3,8744,[143 271   9 273 385],92,3,32727,3.7423670668953686,0.0,0.0
38745,3,8745,[204 194  69 286 288],648,3,32730,3.7422821861422366,0.0,0.0
38746,3,8746,[603 168  97   4 568],339,4,32734,3.7423116497084714,20.0,0.0
38747,3,8747,[ 22 187  79 144 475],207,2,32736,3.7421124828532237,0.0,0.0
38748,3,8748,[118 568 183 197  56],7,4,32740,3.742141959081038,0.0,0.0
38749,3,8749,[ 95 151 288 546 202],234,0,32740,3.7417142857142855,0.0,0.0
38750,3,8750,[603 302 427 127  64],458,5,32745,3.741858073363044,20.0,20.0
38751,3,8751,[ 64 269 475 483 245],207,3,32748,3.7417733089579523,20.0,0.0
38752,3,8752,[153 515 111 265 313],64,4,32752,3.7418028104649834,0.0,0.0
38753,3,8753,[742 435 318   7 100],378,5,32757,3.7419465387251543,20.0,20.0
38754,3,8754,[  9 200 258 191 603],334,5,32762,3.742090234151913,20.0,0.0
38755,3,8755,[603 302 427 127  64],745,4,32766,3.7421196893558704,20.0,20.0
38756,3,8756,[603 302 427 127  64],745,4,32770,3.742149137832591,20.0,20.0
38757,3,8757,[546 174  96  69 168],95,4,32774,3.74217857958438,0.0,20.0
38758,3,8758,[257 655 196 234 151],479,5,32779,3.742322182897591,0.0,0.0
38759,3,8759,[323 173 235 186 180],897,3,32782,3.7422374429223746,0.0,0.0
38760,3,8760,[603 302 427 127  64],339,5,32787,3.7423810067343912,20.0,20.0
38761,3,8761,[180  82 161 186 135],10,5,32792,3.742524537776763,0.0,0.0
38762,3,8762,[ 69 173 515 269 405],455,4,32796,3.7425539198904483,0.0,0.0
38763,3,8763,[135 168 144  79 483],313,4,32800,3.7425832952989504,20.0,0.0
38764,3,8764,[333 100 678 275 323],894,3,32803,3.74249857387336,0.0,20.0
38765,3,8765,[222 121  95 117 118],901,4,32807,3.742527948893452,0.0,0.0
38766,3,8766,[742 235 222 204 118],378,4,32811,3.7425573172122735,0.0,0.0
38767,3,8767,[603 302 427 127  64],537,4,32815,3.742586678832117,20.0,20.0
38768,3,8768,[176 183 282 132 678],334,2,32817,3.742387957577831,0.0,0.0
38769,3,8769,[483 174  88 179  96],200,5,32822,3.7425313568985175,20.0,20.0
38770,3,8770,[ 69 180 121 282 135],85,3,32825,3.7424466993501313,0.0,0.0
38771,3,8771,[515  88 265 238 655],474,5,32830,3.7425900592795256,0.0,0.0
38772,3,8772,[603 302 427 127  64],664,5,32835,3.7427333865268437,20.0,20.0
38773,3,8773,[678 204 508 135 182],334,2,32837,3.742534761796216,0.0,0.0
38774,3,8774,[603 302 427 127  64],664,5,32842,3.7426780626780625,20.0,20.0
38775,3,8775,[196 132 515 216 172],804,5,32847,3.742821330902461,0.0,0.0
38776,3,8776,[125 322 182  95 222],804,4,32851,3.7428506323345108,0.0,0.0
38777,3,8777,[  9 194 385 435 235],788,2,32853,3.742652084757348,0.0,0.0
38778,3,8778,[603 302 427 127  64],666,5,32858,3.742795306982572,20.0,20.0
38779,3,8779,[234 210 276 204 187],311,5,32863,3.7429384965831436,0.0,0.0
38780,3,8780,[ 88 568  28 405 496],538,1,32864,3.742626124587177,0.0,0.0
38781,3,8781,[161 385 471 483 318],313,5,32869,3.7427693008426326,40.0,0.0
38782,3,8782,[603 302 427 127  64],13,5,32874,3.7429124444950475,20.0,20.0
38783,3,8783,[496 153  22 475 176],387,2,32876,3.7427140255009106,0.0,0.0
38784,3,8784,[168 271  64 132   9],64,4,32880,3.742743312464428,0.0,0.0
38785,3,8785,[546 195 143 216  25],207,3,32883,3.74265877532438,0.0,0.0
38786,3,8786,[405 276 216  69 215],554,3,32886,3.742574257425743,0.0,0.0
38787,3,8787,[127 210 271 197 234],215,5,32891,3.742717341829768,0.0,20.0
38788,3,8788,[603 302 427 127  64],339,5,32896,3.7428603936739107,20.0,20.0
38789,3,8789,[265  12   9 143 403],60,3,32899,3.7427758816837313,20.0,0.0
38790,3,8790,[322 483  12 202 210],308,3,32902,3.7426913889204867,40.0,0.0
38791,3,8791,[195 215 258  28 121],328,3,32905,3.742606915377616,0.0,0.0
38792,3,8792,[ 71  50  96  22 196],295,4,32909,3.74263618787672,0.0,20.0
38793,3,8793,[211   4 300 301 257],666,3,32912,3.7425517398226065,0.0,0.0
38794,3,8794,[204 323 186 187 175],804,5,32917,3.7426947129050596,0.0,0.0
38795,3,8795,[475 153  28 257  12],6,3,32920,3.7426102773988177,20.0,0.0
38796,3,8796,[603 302 427 127  64],90,5,32925,3.7427532113220416,20.0,20.0
38797,3,8797,[603 302 427 127  64],537,4,32929,3.7427824505569447,20.0,20.0
38798,3,8798,[ 64 174  56 121 153],833,1,32930,3.742470735310831,0.0,20.0
38799,3,8799,[603 302 427 127  64],666,5,32935,3.7426136363636364,20.0,20.0
38800,3,8800,[204 191 200 187 216],7,5,32940,3.74275650494262,0.0,0.0
38801,3,8801,[496 204 196 132 405],290,3,32943,3.7426721199727333,0.0,0.0
38802,3,8802,[183 204 111   4  96],666,2,32945,3.742474156537544,0.0,0.0
38803,3,8803,[ 89 568 195 215  95],749,4,32949,3.7425034075420265,0.0,0.0
38804,3,8804,[194 483  28 228 151],897,4,32953,3.7425326519023283,20.0,0.0
38805,3,8805,[603 302 427 127  64],474,5,32958,3.7426754485578013,20.0,20.0
38806,3,8806,[603 302 427 127  64],339,5,32963,3.7428182127852843,20.0,20.0
38807,3,8807,[603 302 427 127  64],271,5,32968,3.742960944595822,20.0,20.0
38808,3,8808,[678  89 100 200 483],804,4,32972,3.742990123737087,20.0,20.0
38809,3,8809,[603 302 427 127  64],13,5,32977,3.743132803632236,20.0,20.0
38810,3,8810,[215 210 191  50 187],184,5,32982,3.7432754511406197,0.0,20.0
38811,3,8811,[423 216 405 174  97],474,5,32987,3.743418066273264,0.0,20.0
38812,3,8812,[  1 117 273 318 269],537,1,32988,3.74310677408374,20.0,0.0
38813,3,8813,[ 88  56  12 125 496],398,3,32991,3.7430224642614025,20.0,0.0
38814,3,8814,[603 302 427 127  64],13,5,32996,3.7431650595575725,20.0,20.0
38815,3,8815,[508   1 234 125 182],378,4,33000,3.7431941923774956,0.0,0.0
38816,3,8816,[ 88 471 161 153 194],194,2,33002,3.7429964840648746,0.0,0.0
38817,3,8817,[117  96 471  11 483],207,1,33003,3.7426854161941483,20.0,0.0
38818,3,8818,[603 302 427 127  64],90,5,33008,3.7428279850323167,20.0,20.0
38819,3,8819,[603 302 427 127  64],90,5,33013,3.74297052154195,20.0,20.0
38820,3,8820,[202 200 294   9 323],881,1,33014,3.74265956240789,0.0,0.0
38821,3,8821,[515 286  82 191 228],455,5,33019,3.7428020856948536,0.0,0.0
38822,3,8822,[323  79  97 215 121],454,4,33023,3.742831236540859,0.0,0.0
38823,3,8823,[603 302 427 127  64],339,5,33028,3.742973708068903,20.0,20.0
38824,3,8824,[289 196 258  56 168],474,3,33031,3.7428895184135977,0.0,0.0
38825,3,8825,[603 302 427 127  64],474,5,33036,3.743031951053705,20.0,20.0
38826,3,8826,[603 302 427 127  64],339,5,33041,3.743174351421774,20.0,20.0
38827,3,8827,[603 302 427 127  64],271,5,33046,3.743316719528772,20.0,20.0
38828,3,8828,[135 182  98 318 603],313,5,33051,3.743459055385661,40.0,20.0
38829,3,8829,[117 403 143 187 168],346,2,33053,3.7432616081540204,0.0,0.0
38830,3,8830,[117  98 678 228 286],145,3,33056,3.743177443098177,0.0,20.0
38831,3,8831,[202 191 265 742 300],378,4,33060,3.7432065217391304,0.0,0.0
38832,3,8832,[603 302 427 127  64],669,5,33065,3.743348805615306,20.0,20.0
38833,3,8833,[ 95 268 235 196 294],92,2,33067,3.74315146026715,0.0,0.0
38834,3,8834,[568   7 427 181 183],940,2,33069,3.7429541595925295,0.0,0.0
38835,3,8835,[603 302 427 127  64],90,5,33074,3.743096423721141,20.0,20.0
38836,3,8836,[185 100 427 179 475],239,4,33078,3.743125495077515,0.0,20.0
38837,3,8837,[ 12 117 222 204 268],387,2,33080,3.742928264313193,20.0,0.0
38838,3,8838,[172   4 125 515 742],59,3,33083,3.7428442131462836,0.0,0.0
38839,3,8839,[603 302 427 127  64],669,5,33088,3.7429864253393665,20.0,20.0
38840,3,8840,[258 191 175 195 655],59,4,33092,3.743015495984617,0.0,0.0
38841,3,8841,[603 302 427 127  64],474,5,33097,3.7431576566387696,20.0,20.0
38842,3,8842,[ 69 216 100 200 405],653,3,33100,3.743073617550605,0.0,20.0
38843,3,8843,[ 11 269 200 313  98],334,4,33104,3.7431026684758026,0.0,20.0
38844,3,8844,[135  82   1  70  50],455,4,33108,3.7431317128321084,0.0,20.0
38845,3,8845,[603 302 427 127  64],458,5,33113,3.7432737960660187,20.0,20.0
38846,3,8846,[603 302 427 127  64],271,5,33118,3.743415847179835,20.0,20.0
38847,3,8847,[603 302 427 127  64],13,5,33123,3.7435578661844486,20.0,20.0
38848,3,8848,[603 302 427 127  64],669,5,33128,3.7436998530907446,20.0,20.0
38849,3,8849,[357 471 333 294  69],653,3,33131,3.7436158192090394,20.0,0.0
38850,3,8850,[215 222 235 186 405],92,3,33134,3.7435318043158965,0.0,0.0
38851,3,8851,[180  98  64 300 496],378,3,33137,3.74344780840488,0.0,20.0
38852,3,8852,[183 179 196 186 181],843,2,33139,3.7432508754094656,0.0,0.0
38853,3,8853,[603 302 427 127  64],745,4,33143,3.7432798735035013,20.0,20.0
38854,3,8854,[603 302 427 127  64],745,4,33147,3.7433088650479953,20.0,20.0
38855,3,8855,[228 483 185 273  15],537,2,33149,3.743112014453478,20.0,0.0
38856,3,8856,[546 168 153 235 127],833,3,33152,3.743028113356667,0.0,20.0
38857,3,8857,[234 172 187 678 144],804,5,33157,3.743170015804922,0.0,0.0
38858,3,8858,[216  88 288 111  50],13,3,33160,3.743086127102382,0.0,20.0
38859,3,8859,[211  71 322 385 144],13,3,33163,3.743002257336343,0.0,0.0
38860,3,8860,[655 135  22 483 211],207,3,33166,3.742918406500395,20.0,0.0
38861,3,8861,[258  69  97  25 172],213,4,33170,3.742947415933198,0.0,0.0
38862,3,8862,[187 228 132  12 423],643,5,33175,3.743089247433149,20.0,0.0
38863,3,8863,[200 222   7 294 237],474,3,33178,3.7430054151624548,0.0,0.0
38864,3,8864,[603 302 427 127  64],90,5,33183,3.7431472081218273,20.0,20.0
38865,3,8865,[187 200   1 568 100],59,4,33187,3.7431761786600495,0.0,20.0
38866,3,8866,[603 302 427 127  64],669,5,33192,3.7433179203789333,20.0,20.0
38867,3,8867,[180  25  22 515 194],452,4,33196,3.743346865133063,0.0,0.0
38868,3,8868,[ 22 215 546  95 202],804,3,33199,3.7432630510767844,0.0,0.0
38869,3,8869,[172 175   9 483  70],932,5,33204,3.7434047350620068,20.0,0.0
38870,3,8870,[603 302 427 127  64],271,5,33209,3.743546387104047,20.0,20.0
38871,3,8871,[748  88 313 276 475],533,2,33211,3.7433498647430117,0.0,0.0
38872,3,8872,[258 269 153 132 187],488,1,33212,3.7430406852248392,0.0,0.0
38873,3,8873,[588 273 182 258 228],102,3,33215,3.742956952896101,0.0,0.0
38874,3,8874,[603 302 427 127  64],474,5,33220,3.7430985915492956,20.0,20.0
38875,3,8875,[603 302 427 127  64],664,5,33225,3.7432401982875168,20.0,20.0
38876,3,8876,[153 258 385 471 187],207,3,33228,3.743156471781007,0.0,0.0
38877,3,8877,[603 302 427 127  64],537,4,33232,3.743185402117594,20.0,20.0
38878,3,8878,[228  79  95 100 265],387,4,33236,3.7432143259376054,0.0,20.0
38879,3,8879,[603 302 427 127  64],13,5,33241,3.7433558558558557,20.0,20.0
38880,3,8880,[173 742 186 238 655],488,3,33244,3.7432721540367075,0.0,0.0
38881,3,8881,[301 588 286 222  79],85,2,33246,3.743075883809953,0.0,0.0
38882,3,8882,[195 597  15  25 168],92,2,33248,3.742879657773275,0.0,0.0
38883,3,8883,[603 302 427 127  64],13,5,33253,3.7430211616389015,20.0,20.0
38884,3,8884,[603 302 427 127  64],745,4,33257,3.74305008441193,20.0,20.0
38885,3,8885,[ 88  89 273 153  96],13,4,33261,3.7430790006752193,0.0,0.0
38886,3,8886,[603 302 427 127  64],669,5,33266,3.7432204343422977,20.0,20.0
38887,3,8887,[196 328 234 357  96],144,4,33270,3.7432493249324934,20.0,0.0
38888,3,8888,[603 302 427 127  64],458,5,33275,3.7433907076161548,20.0,20.0
38889,3,8889,[ 70 161 475  15 100],308,3,33278,3.7433070866141733,0.0,20.0
38890,3,8890,[187  88 655 286  71],184,3,33281,3.7432234844224497,0.0,0.0
38891,3,8891,[603 302 427 127  64],666,5,33286,3.743364822312191,20.0,20.0
38892,3,8892,[117  79 125 385 143],194,0,33286,3.7429438884515913,0.0,0.0
38893,3,8893,[603 302 427 127  64],271,5,33291,3.7430852259950527,20.0,20.0
38894,3,8894,[215  79 187  25  11],308,4,33295,3.743114109050028,0.0,0.0
38895,3,8895,[515 143 100 568   7],92,3,33298,3.7430305755395685,0.0,20.0
38896,3,8896,[603 302 427 127  64],669,5,33303,3.7431718556816906,20.0,20.0
38897,3,8897,[172 235  50 265 655],738,3,33306,3.7430883344571813,0.0,20.0
38898,3,8898,[118 435   4 151  82],295,4,33310,3.743117204180245,0.0,0.0
38899,3,8899,[257 127 180 135  15],533,3,33313,3.7430337078651688,0.0,20.0
38900,3,8900,[603 302 427 127  64],666,5,33318,3.743174924165824,20.0,20.0
38901,3,8901,[318 174 216 194 275],899,5,33323,3.743316108739609,20.0,20.0
38902,3,8902,[245 210 678 318 496],605,2,33325,3.7431202965292596,20.0,0.0
38903,3,8903,[216  97  71 204 328],378,4,33329,3.7431491464510334,0.0,0.0
38904,3,8904,[603 302 427 127  64],458,5,33334,3.74329028635598,20.0,20.0
38905,3,8905,[323 187 603 125 483],804,5,33339,3.7434313945654614,40.0,0.0
38906,3,8906,[603 302 427 127  64],537,4,33343,3.7434601998428203,20.0,20.0
38907,3,8907,[168  50 496 483 294],263,4,33347,3.743488998652896,20.0,20.0
38908,3,8908,[ 70 235  69 216  98],378,4,33351,3.7435177909978674,0.0,20.0
38909,3,8909,[117 196  88 200 318],815,4,33355,3.7435465768799103,20.0,0.0
38910,3,8910,[222 204 153 471 196],378,3,33358,3.7434631354505665,0.0,0.0
38911,3,8911,[ 97 483   8 118 288],897,3,33361,3.743379712746858,20.0,0.0
38912,3,8912,[ 28 111 173   7 195],537,2,33363,3.7431841130932346,0.0,0.0
38913,3,8913,[603 302 427 127  64],458,5,33368,3.743325106573929,20.0,20.0
38914,3,8914,[196 222 187  50 194],897,4,33372,3.743353897924846,0.0,20.0
38915,3,8915,[603 302 427 127  64],664,5,33377,3.743494840735756,20.0,20.0
38916,3,8916,[ 64 237 211 423 471],234,2,33379,3.743299315913424,0.0,0.0
38917,3,8917,[ 12  97 265  69  22],380,3,33382,3.7432159677057637,20.0,0.0
38918,3,8918,[ 56 435   1 234 175],102,1,33383,3.742908397802444,0.0,0.0
38919,3,8919,[273 215  82 191 195],385,0,33383,3.7424887892376684,0.0,0.0
38920,3,8920,[289  79 597   9 237],458,3,33386,3.7424055599148076,0.0,0.0
38921,3,8921,[471  82 197 435 228],343,5,33391,3.7425465142344767,0.0,0.0
38922,3,8922,[216 597 301  12 318],378,3,33394,3.742463297097389,40.0,0.0
38923,3,8923,[265  15 237 125 153],313,1,33395,3.7421559838637384,0.0,0.0
38924,3,8924,[117 588 197 294 483],311,5,33400,3.742296918767507,20.0,0.0
38925,3,8925,[603 302 427 127  64],666,5,33405,3.7424378220927625,20.0,20.0
38926,3,8926,[603 568 187 475 222],13,2,33407,3.742242634703708,20.0,0.0
38927,3,8927,[294  71 235 182 257],92,2,33409,3.7420474910394264,0.0,0.0
38928,3,8928,[318 211 195  56  98],666,4,33413,3.742076380333744,20.0,20.0
38929,3,8929,[195 174 403 197  97],194,2,33415,3.741881298992161,0.0,20.0
38930,3,8930,[515 237 153 180 435],326,2,33417,3.741686261336916,0.0,0.0
38931,3,8931,[603 302 427 127  64],90,5,33422,3.7418271383788624,20.0,20.0
38932,3,8932,[ 69 174 322 546  89],13,3,33425,3.741744094928915,0.0,20.0
38933,3,8933,[  9  97  79 234 194],328,3,33428,3.741661070069398,0.0,0.0
38934,3,8934,[127 173 117  89 125],406,3,33431,3.7415780637940683,0.0,20.0
38935,3,8935,[  1 174 496 183 173],897,4,33435,3.7416069829901524,0.0,20.0
38936,3,8936,[202 435 235 742 182],897,1,33436,3.7413002125993065,0.0,0.0
38937,3,8937,[603 302 427 127  64],537,4,33440,3.74132915641083,20.0,20.0
38938,3,8938,[172 191 197  88 742],313,3,33443,3.741246224409889,0.0,0.0
38939,3,8939,[265 183 237  88 153],13,5,33448,3.741387024608501,0.0,0.0
38940,3,8940,[135 132  88 187 678],506,4,33452,3.7414159489989935,0.0,0.0
38941,3,8941,[603 302 427 127  64],474,5,33457,3.7415566987251174,20.0,20.0
38942,3,8942,[300 588 195 235  25],13,1,33458,3.741250139774125,0.0,0.0
38943,3,8943,[222 186 435 127 301],234,1,33459,3.740943649373882,0.0,20.0
38944,3,8944,[176 168  82 301 294],102,0,33459,3.7405254332029068,0.0,0.0
38945,3,8945,[  1 238 181 568 265],95,4,33463,3.7405544377375364,0.0,0.0
38946,3,8946,[211  98 117 228 427],533,5,33468,3.7406952050966806,0.0,20.0
38947,3,8947,[603 302 427 127  64],339,5,33473,3.7408359409924006,20.0,20.0
38948,3,8948,[197 191 318 288 265],452,3,33476,3.7407531567772936,20.0,0.0
38949,3,8949,[143 313 111 508 405],59,3,33479,3.7406703910614527,0.0,0.0
38950,3,8950,[603 302 427 127  64],458,5,33484,3.7408110825606076,20.0,20.0
38951,3,8951,[180 234   7 197 235],308,2,33486,3.7406166219839143,0.0,0.0
38952,3,8952,[ 82 196 300 655 515],234,1,33487,3.7403105104434267,0.0,0.0
38953,3,8953,[ 56 405  11 238 655],749,2,33489,3.7401161492070583,0.0,0.0
38954,3,8954,[435 179 427  98 132],343,5,33494,3.740256839754327,0.0,20.0
38955,3,8955,[186 328  96  56 234],749,4,33498,3.7402858418937024,0.0,0.0
38956,3,8956,[423  50  69 288 471],378,2,33500,3.7400915485095454,0.0,20.0
38957,3,8957,[603 302 427 127  64],669,5,33505,3.740232194686314,20.0,20.0
38958,3,8958,[235 210 175 194 186],313,3,33508,3.7401495702645384,0.0,0.0
38959,3,8959,[603 302 427 127  64],339,5,33513,3.7402901785714286,20.0,20.0
38960,3,8960,[748 135 385 173 100],92,3,33516,3.7402075661198526,0.0,20.0
38961,3,8961,[603 302 427 127  64],669,5,33521,3.740348136576657,20.0,20.0
38962,3,8962,[ 88 597 176  89 282],200,5,33526,3.7404886756666293,0.0,0.0
38963,3,8963,[202  97 546 118 121],295,4,33530,3.7405176260597948,0.0,0.0
38964,3,8964,[603 302 427 127  64],745,4,33534,3.740546569994423,20.0,20.0
38965,3,8965,[603 302 427 127  64],537,4,33538,3.7405755074726748,20.0,20.0
38966,3,8966,[603 302 427 127  64],458,5,33543,3.7407159585145533,20.0,20.0
38967,3,8967,[143 127 286 135 182],59,3,33546,3.7406333630686888,0.0,20.0
38968,3,8968,[  8 153 195  12 228],92,5,33551,3.7407737763407294,20.0,0.0
38969,3,8969,[603 302 427 127  64],669,5,33556,3.7409141583054626,20.0,20.0
38970,3,8970,[180 403 258  64 183],774,2,33558,3.740720098093858,0.0,0.0
38971,3,8971,[100 121 546 385   7],881,5,33563,3.740860454748105,0.0,20.0
38972,3,8972,[483 211  28 197 196],298,5,33568,3.741000780118132,20.0,0.0
38973,3,8973,[ 98  79 118 135 597],374,5,33573,3.741141074214397,0.0,20.0
38974,3,8974,[ 96 322 175 405 357],788,3,33576,3.741058495821727,20.0,0.0
38975,3,8975,[275 258 132 568 143],184,2,33578,3.7408645276292334,0.0,0.0
38976,3,8976,[271 179 127 135 322],749,5,33583,3.741004790018937,0.0,20.0
38977,3,8977,[ 56 111 202 286 191],59,4,33587,3.741033637781243,0.0,0.0
38978,3,8978,[ 50 100 174  56 269],271,4,33591,3.7410624791179417,0.0,60.0
38979,3,8979,[603 302 427 127  64],666,5,33596,3.7412026726057905,20.0,20.0
38980,3,8980,[168 181 475   1  50],479,4,33600,3.741231488698363,0.0,20.0
38981,3,8981,[603 302 427 127  64],458,5,33605,3.741371632153195,20.0,20.0
38982,3,8982,[655   1   4  70 294],144,5,33610,3.7415117444061003,0.0,0.0
38983,3,8983,[603 302 427 127  64],339,5,33615,3.741651825467498,20.0,20.0
38984,3,8984,[ 22 191  12 172 357],686,5,33620,3.741791875347802,40.0,0.0
38985,3,8985,[333 179 655 210 125],815,1,33621,3.741486757177832,0.0,0.0
38986,3,8986,[603 302 427 127  64],458,5,33626,3.7416267942583734,20.0,20.0
38987,3,8987,[603 302 427 127  64],339,5,33631,3.741766800178015,20.0,20.0
38988,3,8988,[603 302 427 127  64],474,5,33636,3.7419067749471577,20.0,20.0
38989,3,8989,[603 302 427 127  64],474,5,33641,3.7420467185761956,20.0,20.0
38990,3,8990,[603 302 427 127  64],664,5,33646,3.74218663107552,20.0,20.0
38991,3,8991,[603 302 427 127  64],664,5,33651,3.742326512455516,20.0,20.0
38992,3,8992,[603 302 427 127  64],339,5,33656,3.742466362726565,20.0,20.0
38993,3,8993,[ 50  96 322 143 180],234,1,33657,3.7421614409606403,0.0,20.0
38994,3,8994,[603 302 427 127  64],458,5,33662,3.742301278488049,20.0,20.0
38995,3,8995,[603 302 427 127  64],666,5,33667,3.742441084926634,20.0,20.0
38996,3,8996,[ 71 357 125  69 286],194,3,33670,3.7423585639657664,20.0,0.0
38997,3,8997,[603 302 427 127  64],458,5,33675,3.7424983329628807,20.0,20.0
38998,3,8998,[132 588  79  97 161],650,1,33676,3.742193577064118,0.0,0.0
38999,3,8999,[202 125 403 144 238],313,3,33679,3.742111111111111,0.0,0.0
39000,3,9000,[603 302 427 127  64],458,5,33684,3.742250861015443,20.0,20.0
39001,3,9001,[  8 100 301 288 286],458,3,33687,3.742168407020662,0.0,20.0
39002,3,9002,[603 302 427 127  64],339,5,33692,3.742308119515717,20.0,20.0
39003,3,9003,[191 275 228 135 385],524,1,33693,3.742003553976011,0.0,0.0
39004,3,9004,[100 143 197 195 258],234,2,33695,3.741810105496946,0.0,20.0
39005,3,9005,[603 302 427 127  64],474,5,33700,3.741949811236953,20.0,20.0
39006,3,9006,[603 302 427 127  64],458,5,33705,3.742089485955368,20.0,20.0
39007,3,9007,[ 22 742 182 515 273],346,5,33710,3.742229129662522,0.0,0.0
39008,3,9008,[603 302 427 127  64],474,5,33715,3.7423687423687424,20.0,20.0
39009,3,9009,[168 276 121 235 161],271,0,33715,3.741953385127636,0.0,0.0
39010,3,9010,[289 238 405 174 273],538,2,33717,3.7417600710243035,0.0,20.0
39011,3,9011,[ 98   7 100  12 183],59,5,33722,3.7418996893031515,20.0,40.0
39012,3,9012,[172 127 175 385 135],804,3,33725,3.741817374902918,0.0,20.0
39013,3,9013,[603 302 427 127  64],474,5,33730,3.741956955846461,20.0,20.0
39014,3,9014,[322 183 175 191 588],804,5,33735,3.742096505823627,0.0,0.0
39015,3,9015,[117 333 180 385 405],346,4,33739,3.7421251109139306,0.0,0.0
39016,3,9016,[ 79  22 132  89 172],537,1,33740,3.74182100476877,0.0,0.0
39017,3,9017,[655 222 508 211  50],339,5,33745,3.741960523397649,0.0,20.0
39018,3,9018,[179   7 235  79  22],524,2,33747,3.7417673799756073,0.0,0.0
39019,3,9019,[603 302 427 127  64],537,4,33751,3.7417960088691795,20.0,20.0
39020,3,9020,[143 427 117 176 403],13,1,33752,3.7414920740494404,0.0,0.0
39021,3,9021,[603 302 427 127  64],13,5,33757,3.7416315672799825,20.0,20.0
39022,3,9022,[603 302 427 127  64],669,5,33762,3.741771029591045,20.0,20.0
39023,3,9023,[423 204 176 435 271],13,3,33765,3.741688829787234,0.0,0.0
39024,3,9024,[603 302 427 127  64],745,4,33769,3.7417174515235456,20.0,20.0
39025,3,9025,[603 302 427 127  64],339,5,33774,3.7418568579658764,20.0,20.0
39026,3,9026,[568 151  69 172 237],901,3,33777,3.7417746759720836,0.0,0.0
39027,3,9027,[655  28   7 144  95],234,1,33778,3.7414709791758973,0.0,0.0
39028,3,9028,[ 79  50 546 294 423],200,4,33782,3.741499612360173,0.0,20.0
39029,3,9029,[294  56  22 121  97],774,0,33782,3.7410852713178295,0.0,0.0
39030,3,9030,[286 435 168 403 235],385,1,33783,3.740781751743993,0.0,0.0
39031,3,9031,[  9 435 127 222 117],881,3,33786,3.740699734278122,0.0,20.0
39032,3,9032,[603 302 427 127  64],745,4,33790,3.740728440163844,20.0,20.0
39033,3,9033,[435 508 357  98 234],833,2,33792,3.7405357538189064,20.0,20.0
39034,3,9034,[603 302 427 127  64],13,5,33797,3.7406751521859434,20.0,20.0
39035,3,9035,[ 89  22 121 210 144],64,1,33798,3.740371845949535,0.0,0.0
39036,3,9036,[603 302 427 127  64],666,5,33803,3.740511231603408,20.0,20.0
39037,3,9037,[121 153 234 168 742],804,5,33808,3.740650586412923,0.0,0.0
39038,3,9038,[597 294 323  71 222],788,0,33808,3.740236751853081,0.0,0.0
39039,3,9039,[111  64  11  97 174],378,3,33811,3.740154867256637,0.0,20.0
39040,3,9040,[603 302 427 127  64],90,5,33816,3.740294215241677,20.0,20.0
39041,3,9041,[191  56 196 423 204],738,5,33821,3.740433532404335,0.0,0.0
39042,3,9042,[121   7 222  82 210],804,5,33826,3.740572818754838,0.0,0.0
39043,3,9043,[603 302 427 127  64],339,5,33831,3.7407120743034055,20.0,20.0
39044,3,9044,[603 302 427 127  64],339,5,33836,3.7408512990602545,20.0,20.0
39045,3,9045,[603 302 427 127  64],664,5,33841,3.740990493035596,20.0,20.0
39046,3,9046,[496 200 435 237 282],804,3,33844,3.74090858848237,0.0,0.0
39047,3,9047,[603 302 427 127  64],669,5,33849,3.7410477453580904,20.0,20.0
39048,3,9048,[603 435  97  11 174],840,3,33852,3.7409658525803957,20.0,20.0
39049,3,9049,[603 302 427 127  64],745,4,33856,3.7409944751381214,20.0,20.0
39050,3,9050,[328 258 302   8 194],90,3,33859,3.7409126063418405,0.0,0.0
39051,3,9051,[180 403  50  79 111],648,4,33863,3.740941228457799,0.0,20.0
39052,3,9052,[181 222 143 135 144],13,3,33866,3.740859383629736,0.0,0.0
39053,3,9053,[180 135  22 265  89],13,5,33871,3.7409984537221117,0.0,0.0
39054,3,9054,[235 211 168 423 257],343,4,33875,3.741027056874655,0.0,0.0
39055,3,9055,[191 183  25 180 423],194,1,33876,3.7407243816254416,0.0,0.0
39056,3,9056,[288 174 181 275 300],7,4,33880,3.740753008722535,0.0,20.0
39057,3,9057,[603 302 427 127  64],666,5,33885,3.7408920291455066,20.0,20.0
39058,3,9058,[294  56 678 403 175],387,2,33887,3.740699856496302,0.0,0.0
39059,3,9059,[603 302 427 127  64],537,4,33891,3.740728476821192,20.0,20.0
39060,3,9060,[258 423 143 173 275],6,2,33893,3.7405363646396643,0.0,0.0
39061,3,9061,[748 245 172 228  96],749,4,33897,3.7405649966894727,0.0,0.0
39062,3,9062,[196 282 357  89 144],194,2,33899,3.740372944940969,20.0,0.0
39063,3,9063,[151 195 185 483 111],833,4,33903,3.7404015887025595,20.0,0.0
39064,3,9064,[603 302 427 127  64],666,5,33908,3.7405405405405405,20.0,20.0
39065,3,9065,[216 182 275 568 181],7,4,33912,3.7405691594970216,0.0,0.0
39066,3,9066,[ 98  70 238 143 186],207,3,33915,3.7404874820778646,0.0,20.0
39067,3,9067,[  8  95  89 435   1],234,1,33916,3.7401852668725186,0.0,0.0
39068,3,9068,[191 195 748 546  64],207,2,33918,3.739993384055574,0.0,0.0
39069,3,9069,[603 302 427 127  64],669,5,33923,3.7401323042998897,20.0,20.0
39070,3,9070,[603 302 427 127  64],90,5,33928,3.740271193914673,20.0,20.0
39071,3,9071,[168 204 183 185 508],643,4,33932,3.740299823633157,0.0,0.0
39072,3,9072,[174 237 282 323  56],804,4,33936,3.74032844704067,0.0,20.0
39073,3,9073,[ 25 269  64 258 597],119,3,33939,3.740246859158034,0.0,0.0
39074,3,9074,[200 176  69   1 423],311,5,33944,3.7403856749311295,0.0,0.0
39075,3,9075,[187 183 258 300 211],102,2,33946,3.740193918025562,0.0,0.0
39076,3,9076,[174 196 118  11 173],7,3,33949,3.7401123719290514,0.0,20.0
39077,3,9077,[181 403 132 117  56],184,2,33951,3.739920687376074,0.0,0.0
39078,3,9078,[603 302 427 127  64],90,5,33956,3.74005947791607,20.0,20.0
39079,3,9079,[603 302 427 127  64],90,5,33961,3.7401982378854624,20.0,20.0
39080,3,9080,[172 174 318 265   1],653,4,33965,3.7402268472635174,20.0,20.0
39081,3,9081,[127  12 143 176  88],339,5,33970,3.740365558247082,20.0,20.0
39082,3,9082,[288 483 273  28 175],7,4,33974,3.740394142904327,20.0,0.0
39083,3,9083,[211   4 172 144 238],738,4,33978,3.740422721268164,0.0,0.0
39084,3,9084,[603 302 427 127  64],13,5,33983,3.7405613648871765,20.0,20.0
39085,3,9085,[603 302 427 127  64],666,5,33988,3.7406999779881134,20.0,20.0
39086,3,9086,[603 302 427 127  64],474,5,33993,3.7408385605810497,20.0,20.0
39087,3,9087,[603 302 427 127  64],537,4,33997,3.7408670774647885,20.0,20.0
39088,3,9088,[237 196  89 176 269],666,3,34000,3.7407855649686432,0.0,0.0
39089,3,9089,[603 302 427 127  64],90,5,34005,3.740924092409241,20.0,20.0
39090,3,9090,[483  71 204 423 195],311,5,34010,3.7410625893741063,20.0,0.0
39091,3,9091,[  8 678  25 202 185],881,3,34013,3.7409810822701277,0.0,0.0
39092,3,9092,[603 302 427 127  64],13,5,34018,3.7411195425052237,20.0,20.0
39093,3,9093,[475 121   1  64 168],308,4,34022,3.74114800967671,0.0,0.0
39094,3,9094,[655 508 176  88 515],184,3,34025,3.7410665200659703,0.0,0.0
39095,3,9095,[289 183 222  64  95],92,3,34028,3.7409850483729112,0.0,0.0
39096,3,9096,[328  22 265 181 238],653,4,34032,3.7410135209409696,0.0,0.0
39097,3,9097,[ 79  71  25  12 176],92,4,34036,3.741041987249945,20.0,0.0
39098,3,9098,[153 228 286 173 210],194,1,34037,3.740740740740741,0.0,0.0
39099,3,9099,[ 96  25 127  28 100],398,4,34041,3.7407692307692306,0.0,40.0
39100,3,9100,[655 328 257 132 405],119,5,34046,3.7409075925722446,0.0,0.0
39101,3,9101,[603 302 427 127  64],664,5,34051,3.741045923972753,20.0,20.0
39102,3,9102,[603 302 427 127  64],13,5,34056,3.7411842249807754,20.0,20.0
39103,3,9103,[222 234 568  88 118],881,3,34059,3.7411028119507908,0.0,0.0
39104,3,9104,[603 302 427 127  64],474,5,34064,3.741241076331686,20.0,20.0
39105,3,9105,[258  15   1 568 202],59,3,34067,3.7411596749396003,0.0,0.0
39106,3,9106,[275  79 282 515 196],455,4,34071,3.7411880970681892,0.0,0.0
39107,3,9107,[179 196 265 174 216],537,1,34072,3.74088713219148,0.0,20.0
39108,3,9108,[471 318 181 183 258],537,2,34074,3.740696014930289,20.0,0.0
39109,3,9109,[286 294 234 196 182],666,2,34076,3.7405049396267835,0.0,0.0
39110,3,9110,[ 71 403  50 204 748],648,3,34079,3.7404236637032158,0.0,20.0
39111,3,9111,[357 294 265  50   7],13,2,34081,3.7402326602282705,20.0,20.0
39112,3,9112,[508 151 302 483 323],669,2,34083,3.7400416986722265,20.0,0.0
39113,3,9113,[603 302 427 127  64],669,5,34088,3.74017994294492,20.0,20.0
39114,3,9114,[603 302 427 127  64],339,5,34093,3.7403181568842565,20.0,20.0
39115,3,9115,[111   9 568 168 180],92,3,34096,3.74023694602896,0.0,0.0
39116,3,9116,[357 423  79 258 176],313,4,34100,3.7402654381923877,20.0,0.0
39117,3,9117,[ 22 211 132 323  98],254,3,34103,3.740184250932222,0.0,20.0
39118,3,9118,[181 228 257 234 187],339,5,34108,3.7403224037723435,0.0,0.0
39119,3,9119,[ 12  98   1 333 117],387,3,34111,3.7402412280701753,20.0,20.0
39120,3,9120,[603 302 427 127  64],745,4,34115,3.74026970726894,20.0,20.0
39121,3,9121,[211   1 357 257 483],95,3,34118,3.7401885551414162,40.0,0.0
39122,3,9122,[603 302 427 127  64],669,5,34123,3.740326646936315,20.0,20.0
39123,3,9123,[135 185 483 125  25],848,4,34127,3.740355107409031,20.0,0.0
39124,3,9124,[ 98 204  22 568 471],311,5,34132,3.7404931506849315,0.0,20.0
39125,3,9125,[ 70  71  50 496 237],892,4,34136,3.740521586675433,0.0,20.0
39126,3,9126,[603 302 427 127  64],13,5,34141,3.7406595814615975,20.0,20.0
39127,3,9127,[194  28 216 234 546],308,1,34142,3.740359333917616,0.0,0.0
39128,3,9128,[181 546 175 127 211],774,1,34143,3.7400591521524813,0.0,20.0
39129,3,9129,[603 302 427 127  64],458,5,34148,3.740197152245345,20.0,20.0
39130,3,9130,[603 302 427 127  64],664,5,34153,3.7403351221114884,20.0,20.0
39131,3,9131,[234 237 215  22 197],653,1,34154,3.740035041611914,0.0,0.0
39132,3,9132,[403 151  22 186  12],788,2,34156,3.739844519872988,20.0,0.0
39133,3,9133,[153 195 228 143 423],374,2,34158,3.739654039851106,0.0,0.0
39134,3,9134,[ 89 172  22 210 471],92,4,34162,3.7396825396825397,0.0,0.0
39135,3,9135,[185  88 195  64 546],374,3,34165,3.7396015761821366,0.0,0.0
39136,3,9136,[ 15 237 271 748 328],548,2,34167,3.7394111852905767,0.0,0.0
39137,3,9137,[385 302 125 546 275],158,2,34169,3.739220836069162,0.0,0.0
39138,3,9138,[238 204  28 194  12],7,5,34174,3.739358791990371,20.0,0.0
39139,3,9139,[357   7 258 228  69],59,4,34178,3.739387308533917,20.0,0.0
39140,3,9140,[173 183 127 222 357],194,3,34181,3.7393064216168908,20.0,20.0
39141,3,9141,[200 357 172   9 678],488,2,34183,3.7391161671406694,20.0,0.0
39142,3,9142,[ 56 100  79  64 471],474,4,34187,3.739144700864049,0.0,20.0
39143,3,9143,[603 302 427 127  64],339,5,34192,3.7392825896762907,20.0,20.0
39144,3,9144,[127 144 655 357  70],398,5,34197,3.7394204483324223,20.0,20.0
39145,3,9145,[313 302   8 423 568],13,4,34201,3.739448939427072,0.0,0.0
39146,3,9146,[257 603 174 385 286],385,1,34202,3.7391494479064176,20.0,20.0
39147,3,9147,[211 405   8 143  96],60,3,34205,3.7390686488850022,0.0,0.0
39148,3,9148,[187 269 427  28 496],6,4,34209,3.739097169089518,0.0,0.0
39149,3,9149,[323 271 191 185 275],537,3,34212,3.739016393442623,0.0,0.0
39150,3,9150,[143 508 183 168  50],385,0,34212,3.7386078024259644,0.0,20.0
39151,3,9151,[ 89 282 187 323  71],474,4,34216,3.7386363636363638,0.0,0.0
39152,3,9152,[603 302 427 127  64],537,4,34220,3.7386649186059215,20.0,20.0
39153,3,9153,[ 95 265 173 313 143],234,1,34221,3.7383657417522396,0.0,0.0
39154,3,9154,[603 302 427 127  64],13,5,34226,3.7385035499726924,20.0,20.0
39155,3,9155,[  8 405  50 403 568],328,2,34228,3.7383136740934906,0.0,20.0
39156,3,9156,[ 69 435  96 475 161],533,4,34232,3.7383422518292018,0.0,0.0
39157,3,9157,[179 515 180 588 202],650,1,34233,3.7380432408822886,0.0,0.0
39158,3,9158,[742 597 127 655 508],833,2,34235,3.7378534774538705,0.0,20.0
39159,3,9159,[186 135  22 202 200],833,3,34238,3.737772925764192,0.0,0.0
39160,3,9160,[508 204 268  25 748],92,3,34241,3.737692391660299,0.0,0.0
39161,3,9161,[153 100 300 204 211],653,3,34244,3.737611875136433,0.0,20.0
39162,3,9162,[603 302 427 127  64],339,5,34249,3.7377496453126704,20.0,20.0
39163,3,9163,[  8  28 168 276   4],474,4,34253,3.7377782627673506,0.0,0.0
39164,3,9164,[ 15  95 234 176 496],42,4,34257,3.7378068739770867,0.0,0.0
39165,3,9165,[179  79 655   9  69],308,4,34261,3.737835478943923,0.0,0.0
39166,3,9166,[603 302 427 127  64],458,5,34266,3.737973164612196,20.0,20.0
39167,3,9167,[603 302 427 127  64],669,5,34271,3.7381108202443283,20.0,20.0
39168,3,9168,[603 302 427 127  64],271,5,34276,3.738248445850147,20.0,20.0
39169,3,9169,[603 302 427 127  64],90,5,34281,3.7383860414394765,20.0,20.0
39170,3,9170,[  8 168 385 228 435],343,4,34285,3.738414567658925,0.0,0.0
39171,3,9171,[403 423   1 405 117],643,2,34287,3.7382250327082427,0.0,0.0
39172,3,9172,[603 182 143 403  96],59,4,34291,3.738253570260547,20.0,0.0
39173,3,9173,[655 210 423 228 179],749,5,34296,3.73839110529758,0.0,0.0
39174,3,9174,[603 302 427 127  64],13,5,34301,3.7385286103542232,20.0,20.0
39175,3,9175,[603 302 427 127  64],669,5,34306,3.738666085440279,20.0,20.0
39176,3,9176,[173  98   9 143 197],194,4,34310,3.7386945624931895,0.0,20.0
39177,3,9177,[174 211  98 435 191],6,5,34315,3.7388319895402047,0.0,40.0
39178,3,9178,[265 275 222  70  98],524,2,34317,3.7386425536550822,0.0,20.0
39179,3,9179,[228 100 258 357 603],339,4,34321,3.7386710239651415,40.0,20.0
39180,3,9180,[195  98 228 176   1],643,4,34325,3.7386994880731947,0.0,20.0
39181,3,9181,[603 302 427 127  64],664,5,34330,3.738836854715748,20.0,20.0
39182,3,9182,[151 265 275  50 183],334,4,34334,3.738865294566046,0.0,20.0
39183,3,9183,[181 403  71  89 161],60,3,34337,3.738784843205575,0.0,0.0
39184,3,9184,[181  11 483  22 216],339,4,34341,3.7388132825258573,20.0,0.0
39185,3,9185,[ 56 588 211 143 151],897,4,34345,3.7388417156542566,0.0,0.0
39186,3,9186,[603 302 427 127  64],537,4,34349,3.7388701425927944,20.0,20.0
39187,3,9187,[475  11 515  98 168],343,5,34354,3.739007400957771,0.0,20.0
39188,3,9188,[301 286 289 143  25],90,4,34358,3.739035803678311,0.0,0.0
39189,3,9189,[300 238 161 568 194],13,2,34360,3.738846572361262,0.0,0.0
39190,3,9190,[234 179 435 168  11],406,4,34364,3.738874986399739,0.0,0.0
39191,3,9191,[ 96 483 194 195 405],13,3,34367,3.7387946040034814,20.0,0.0
39192,3,9192,[195  89  12 238 174],13,3,34370,3.7387142390949637,20.0,20.0
39193,3,9193,[215 328  96 216  69],13,3,34373,3.7386338916684796,0.0,0.0
39194,3,9194,[ 56 179 196 234 323],311,3,34376,3.738553561718325,0.0,0.0
39195,3,9195,[603 302 427 127  64],537,4,34380,3.738581992170509,20.0,20.0
39196,3,9196,[328  56 143 187 191],533,4,34384,3.7386104164401437,0.0,0.0
39197,3,9197,[603 302 427 127  64],537,4,34388,3.7386388345292456,20.0,20.0
39198,3,9198,[603 302 427 127  64],664,5,34393,3.7387759539080334,20.0,20.0
39199,3,9199,[603 302 427 127  64],669,5,34398,3.7389130434782607,20.0,20.0
39200,3,9200,[603 302 427 127  64],339,5,34403,3.739050103249647,20.0,20.0
39201,3,9201,[161   1 204  69 180],378,3,34406,3.738969789176266,0.0,0.0
39202,3,9202,[588 483 313 215  97],184,4,34410,3.7389981527762686,20.0,0.0
39203,3,9203,[  8 121  79  88 322],313,2,34412,3.7388092133854847,0.0,0.0
39204,3,9204,[234 228 294 143 515],537,1,34413,3.738511678435633,0.0,0.0
39205,3,9205,[588 288 132 195   9],59,4,34417,3.7385400825548554,0.0,0.0
39206,3,9206,[301 211 179  89 403],13,2,34419,3.738351254480287,0.0,0.0
39207,3,9207,[603 302 427 127 313],14,3,34422,3.7382710686359686,20.0,20.0
39208,3,9208,[202  95 597 748 588],102,3,34425,3.73819090020632,0.0,0.0
39209,3,9209,[235 195 185 288 197],59,4,34429,3.738219326818675,0.0,0.0
39210,3,9210,[176  50 144 175 276],343,5,34434,3.7383563131038975,0.0,20.0
39211,3,9211,[603 302 427 127  64],339,5,34439,3.7384932696482847,20.0,20.0
39212,3,9212,[100 546  28 286 597],447,2,34441,3.7383045696298707,0.0,20.0
39213,3,9213,[603 302 427 127  64],666,5,34446,3.7384415020620794,20.0,20.0
39214,3,9214,[603 302 427 127  64],13,5,34451,3.738578404774824,20.0,20.0
39215,3,9215,[603 302 427 127  64],669,5,34456,3.7387152777777777,20.0,20.0
39216,3,9216,[176 235 127 515 302],102,0,34456,3.7383096452207876,0.0,20.0
39217,3,9217,[603 302 427 127  64],669,5,34461,3.7384465176827946,20.0,20.0
39218,3,9218,[ 79 275 175 181 127],184,3,34464,3.738366417181907,0.0,20.0
39219,3,9219,[183 181 135   7  28],843,3,34467,3.738286334056399,0.0,0.0
39220,3,9220,[172 216 258 168 275],533,5,34472,3.7384231645157793,0.0,0.0
39221,3,9221,[286   7 173  25 385],474,5,34477,3.7385599653003685,0.0,0.0
39222,3,9222,[235  11 271 276  96],119,4,34481,3.738588311829123,0.0,0.0
39223,3,9223,[168  56   9 237 435],883,4,34485,3.738616652211622,0.0,0.0
39224,3,9224,[603 302 427 127  64],669,5,34490,3.738753387533875,20.0,20.0
39225,3,9225,[234 121 286  97 328],664,1,34491,3.7384565358768698,0.0,0.0
39226,3,9226,[ 50   9 215  89 216],233,3,34494,3.7383765037390266,0.0,20.0
39227,3,9227,[180 100  97 323 508],537,3,34497,3.738296488946684,0.0,20.0
39228,3,9228,[515  11 210 117 202],892,4,34501,3.7383248455954057,0.0,0.0
39229,3,9229,[603 302 427 127  64],664,5,34506,3.7384615384615385,20.0,20.0
39230,3,9230,[ 22 127 216 196 238],59,5,34511,3.738598201711624,0.0,20.0
39231,3,9231,[  8  69 588 216 144],840,4,34515,3.738626516464471,0.0,0.0
39232,3,9232,[603 302 427 127  64],458,5,34520,3.7387631322430415,20.0,20.0
39233,3,9233,[181 568 655  79   7],378,5,34525,3.738899718431882,0.0,0.0
39234,3,9234,[202 173 135 183 204],378,3,34528,3.738819707634001,0.0,0.0
39235,3,9235,[603 302 427 127  64],90,5,34533,3.7389562581203983,20.0,20.0
39236,3,9236,[202  97 172 568 185],194,1,34534,3.7386597380101763,0.0,0.0
39237,3,9237,[603 302 427 127  64],458,5,34539,3.7387962762502704,20.0,20.0
39238,3,9238,[125 118 168 204 655],254,3,34542,3.7387163112891004,0.0,0.0
39239,3,9239,[ 82  97  28 135  69],85,3,34545,3.7386363636363638,0.0,0.0
39240,3,9240,[196 187 121 258  82],7,4,34549,3.7386646466832594,0.0,0.0
39241,3,9241,[603 302 427 127  64],13,5,34554,3.7388011252975546,20.0,20.0
39242,3,9242,[603 302 427 127  64],458,5,34559,3.7389375743806124,20.0,20.0
39243,3,9243,[603 302 427 127  64],90,5,34564,3.7390739939420166,20.0,20.0
39244,3,9244,[ 95 179 313 175 276],378,4,34568,3.739102217414819,0.0,0.0
39245,3,9245,[ 69 237 161 228 191],533,4,34572,3.739130434782609,0.0,0.0
39246,3,9246,[423 195 197  15 183],207,3,34575,3.739050502865794,0.0,0.0
39247,3,9247,[210 228 275 117  22],95,4,34579,3.7390787197231834,0.0,0.0
39248,3,9248,[ 25 197 588 435 174],13,4,34583,3.739106930478971,0.0,20.0
39249,3,9249,[403  71  98 118 546],788,1,34584,3.738810810810811,0.0,20.0
39250,3,9250,[603 302 427 127  64],669,5,34589,3.7389471408496378,20.0,20.0
39251,3,9251,[222 435 196  12 195],194,2,34591,3.738759187202767,20.0,0.0
39252,3,9252,[603 302 427 127  64],458,5,34596,3.738895493353507,20.0,20.0
39253,3,9253,[546 282 121  96 172],653,2,34598,3.7387075859087964,0.0,0.0
39254,3,9254,[603 302 427 127  64],745,4,34602,3.738735818476499,20.0,20.0
39255,3,9255,[603 302 427 127  64],339,5,34607,3.7388720829732067,20.0,20.0
39256,3,9256,[258 237 275 282 222],328,3,34610,3.7387922653127363,0.0,0.0
39257,3,9257,[183 328 210 202 195],207,0,34610,3.738388420825232,0.0,0.0
39258,3,9258,[603 302 427 127  64],458,5,34615,3.7385246786910034,20.0,20.0
39259,3,9259,[183   1 195   8 172],378,4,34619,3.7385529157667388,0.0,0.0
39260,3,9260,[603 302 427 127  64],271,5,34624,3.7386891264442284,20.0,20.0
39261,3,9261,[603 302 427 127  64],537,4,34628,3.7387173396674585,20.0,20.0
39262,3,9262,[603 302 427 127  64],474,5,34633,3.738853503184713,20.0,20.0
39263,3,9263,[195 215 153 197 313],378,3,34636,3.738773747841105,0.0,0.0
39264,3,9264,[ 11 204  96 125 174],406,4,34640,3.7388019427954666,0.0,20.0
39265,3,9265,[748  79 269   9 187],64,4,34644,3.7388301316641486,0.0,0.0
39266,3,9266,[603 302 427 127  64],458,5,34649,3.7389662242365382,20.0,20.0
39267,3,9267,[328 197 175  22 237],378,3,34652,3.738886491152352,0.0,0.0
39268,3,9268,[323 161 273 385 117],374,3,34655,3.7388067752724132,0.0,0.0
39269,3,9269,[ 96 215 322 195 143],749,5,34660,3.738942826321467,0.0,0.0
39270,3,9270,[185 238  56 153 515],488,3,34663,3.7388631215618595,0.0,0.0
39271,3,9271,[385   4 200 471 318],92,3,34666,3.738783433994823,20.0,0.0
39272,3,9272,[215 195  96 258 117],653,3,34669,3.7387037636147955,0.0,0.0
39273,3,9273,[603 302 427 127  64],90,5,34674,3.7388397670907914,20.0,20.0
39274,3,9274,[603 302 427 127  64],271,5,34679,3.738975741239892,20.0,20.0
39275,3,9275,[135 183 568 172 215],506,5,34684,3.7391116860715825,0.0,0.0
39276,3,9276,[173 568 215 475   8],506,4,34688,3.7391398081276273,0.0,0.0
39277,3,9277,[603 302 427 127  64],13,5,34693,3.7392757059711146,20.0,20.0
39278,3,9278,[ 98 238 200 100 655],387,4,34697,3.7393038042892552,0.0,40.0
39279,3,9279,[483 100  69 222 228],892,4,34701,3.739331896551724,20.0,20.0
39280,3,9280,[ 79 211 180 174 175],650,3,34704,3.739252235750458,0.0,20.0
39281,3,9281,[179 161 237 202 194],194,3,34707,3.7391725921137686,0.0,0.0
39282,3,9282,[151 546 286  89 161],479,2,34709,3.7389852418399223,0.0,0.0
39283,3,9283,[ 96 275 568 245 508],533,4,34713,3.7390133563119345,0.0,0.0
39284,3,9284,[603 302 427 127  64],745,4,34717,3.739041464728056,20.0,20.0
39285,3,9285,[161 197 276 475   8],207,2,34719,3.7388541891018736,0.0,0.0
39286,3,9286,[403 176  25 161 180],378,4,34723,3.738882308603424,0.0,0.0
39287,3,9287,[174  70 176 168 271],102,1,34724,3.7385874246339363,0.0,20.0
39288,3,9288,[  7  79 176 405 546],346,3,34727,3.7385079125847778,0.0,0.0
39289,3,9289,[318  96 405 135 294],92,2,34729,3.7383207750269105,20.0,0.0
39290,3,9290,[603 302 427 127  64],339,5,34734,3.7384565708750404,20.0,20.0
39291,3,9291,[655 318 187 183   8],326,4,34738,3.738484718037021,20.0,0.0
39292,3,9292,[603 302 427 127  64],666,5,34743,3.7386204670181855,20.0,20.0
39293,3,9293,[603 302 427 127  64],339,5,34748,3.7387561867871746,20.0,20.0
39294,3,9294,[121 197 117  96 322],749,4,34752,3.7387842926304464,0.0,0.0
39295,3,9295,[181 111 168  88 143],42,3,34755,3.7387048192771086,0.0,0.0
39296,3,9296,[ 22 496 127 237 655],184,3,34758,3.738625363020329,0.0,20.0
39297,3,9297,[153 151 237 515   9],7,4,34762,3.738653473865347,0.0,0.0
39298,3,9298,[603 302 427 127  64],13,5,34767,3.738789117109367,20.0,20.0
39299,3,9299,[265 191 302 508 168],339,4,34771,3.7388172043010752,0.0,0.0
39300,3,9300,[496 385 121  15 235],650,2,34773,3.7386302548113104,0.0,0.0
39301,3,9301,[132 168 405 182 183],653,0,34773,3.7382283379918295,0.0,0.0
39302,3,9302,[228 318 182 597 132],59,4,34777,3.7382564764054607,20.0,0.0
39303,3,9303,[194  97 475 238 118],343,4,34781,3.7382846087704213,0.0,0.0
39304,3,9304,[181 323 588 173  69],650,2,34783,3.738097796883396,0.0,0.0
39305,3,9305,[603 302 427 127  64],537,4,34787,3.7381259402536,20.0,20.0
39306,3,9306,[603 302 427 127  64],339,5,34792,3.738261523584399,20.0,20.0
39307,3,9307,[603 302 427 127  64],271,5,34797,3.738397077782553,20.0,20.0
39308,3,9308,[ 56 385   1 143 568],454,2,34799,3.7382103340852937,0.0,0.0
39309,3,9309,[294 100 174 175 234],279,3,34802,3.7381310418904405,0.0,40.0
39310,3,9310,[603 302 427 127  64],90,5,34807,3.738266566426807,20.0,20.0
39311,3,9311,[125 235   4 135  96],788,0,34807,3.7378651202749142,0.0,0.0
39312,3,9312,[194 143 118 100  98],308,3,34810,3.7377858906904327,0.0,40.0
39313,3,9313,[ 79 483 195 210 282],804,5,34815,3.737921408632167,20.0,0.0
39314,3,9314,[603 302 427 127  64],537,4,34819,3.737949543746645,20.0,20.0
39315,3,9315,[ 88  56  50 196 294],901,3,34822,3.7378703306139975,0.0,20.0
39316,3,9316,[588 183  98  96 603],64,4,34826,3.7378984651711926,20.0,20.0
39317,3,9317,[515  71  70 405 183],406,1,34827,3.7376046361880233,0.0,0.0
39318,3,9318,[603 302 427 127  64],537,4,34831,3.7376327932181566,20.0,20.0
39319,3,9319,[603 302 427 127  64],537,4,34835,3.7376609442060085,20.0,20.0
39320,3,9320,[603 302 427 127  64],271,5,34840,3.7377963737796374,20.0,20.0
39321,3,9321,[174 655 127 405 179],334,4,34844,3.7378245011800044,0.0,40.0
39322,3,9322,[210 174 245 313  98],334,3,34847,3.737745360935321,0.0,40.0
39323,3,9323,[333 403 144   4 435],387,0,34847,3.737344487344487,0.0,0.0
39324,3,9324,[748  28 176 222 195],804,5,34852,3.737479892761394,0.0,0.0
39325,3,9325,[ 79 210 234 132 222],664,3,34855,3.7374008149260134,0.0,0.0
39326,3,9326,[603 302 427 127  64],664,5,34860,3.737536185268575,20.0,20.0
39327,3,9327,[186 238 161  70  88],207,2,34862,3.737349914236707,0.0,0.0
39328,3,9328,[153 172 161 173 180],387,4,34866,3.7373780683888946,0.0,0.0
39329,3,9329,[175 176  11 333  64],10,4,34870,3.737406216505895,0.0,0.0
39330,3,9330,[603 302 427 127  64],669,5,34875,3.737541528239203,20.0,20.0
39331,3,9331,[195 276 132 357 588],298,4,34879,3.7375696528075437,20.0,0.0
39332,3,9332,[742 174  98 471 187],207,4,34883,3.7375977713489767,0.0,40.0
39333,3,9333,[ 95 135 174 173 211],897,2,34885,3.7374116134561817,0.0,20.0
39334,3,9334,[ 96  88 151 180 427],537,2,34887,3.7372254954472415,0.0,0.0
39335,3,9335,[210 194 121 403  50],194,1,34888,3.7369323050556984,0.0,20.0
39336,3,9336,[234  71 174 313 161],474,5,34893,3.7370675805933384,0.0,20.0
39337,3,9337,[ 71 257   7 265  56],378,5,34898,3.7372028271578497,0.0,0.0
39338,3,9338,[603 302 427 127  64],13,5,34903,3.7373380447585394,20.0,20.0
39339,3,9339,[ 71 187 282 300 427],533,5,34908,3.7374732334047107,0.0,0.0
39340,3,9340,[ 22 483 603 427  79],669,2,34910,3.7372872283481424,40.0,0.0
39341,3,9341,[603 302 427 127  64],537,4,34914,3.7373153500321132,20.0,20.0
39342,3,9342,[568  64 172 385 403],374,3,34917,3.7372364336936745,0.0,0.0
39343,3,9343,[100 197 211 121 483],452,4,34921,3.7372645547945207,20.0,20.0
39344,3,9344,[204  71  50 275  25],882,4,34925,3.7372926698769398,0.0,20.0
39345,3,9345,[403  64 197 172 235],374,2,34927,3.7371067836507597,0.0,0.0
39346,3,9346,[323 276 111 228   1],13,3,34930,3.7370279233978816,0.0,0.0
39347,3,9347,[176 405 568 222 127],883,2,34932,3.736842105263158,0.0,20.0
39348,3,9348,[265 111 215  70 204],42,2,34934,3.73665632687988,0.0,0.0
39349,3,9349,[ 95 597 176   1  98],308,3,34937,3.736577540106952,0.0,20.0
39350,3,9350,[  8  89 191  22 183],488,3,34940,3.736498770185007,0.0,0.0
39351,3,9351,[ 50 508 568 265  82],326,3,34943,3.7364200171086397,0.0,20.0
39352,3,9352,[603 302 427 127  64],474,5,34948,3.73655511600556,20.0,20.0
39353,3,9353,[ 15 100 197 405 496],533,4,34952,3.736583279880265,0.0,20.0
39354,3,9354,[  9 385   4 174 121],343,3,34955,3.7365045430251205,0.0,20.0
39355,3,9355,[ 64 161   1 435 186],387,1,34956,3.7362120564343737,0.0,0.0
39356,3,9356,[237 215 181  56 210],215,4,34960,3.7362402479427166,0.0,0.0
39357,3,9357,[588 286 385 210  89],13,2,34962,3.7360547125454158,0.0,0.0
39358,3,9358,[ 69 176 496 168 200],650,4,34966,3.736082914841329,0.0,0.0
39359,3,9359,[385 301 121  64  82],13,2,34968,3.735897435897436,0.0,0.0
39360,3,9360,[603 302 427 127  64],271,5,34973,3.73603247516291,20.0,20.0
39361,3,9361,[603 302 427 127  64],664,5,34978,3.736167485580004,20.0,20.0
39362,3,9362,[275 183 175 216 568],158,3,34981,3.736088860407989,0.0,0.0
39363,3,9363,[603 302 427 127  64],537,4,34985,3.7361170439982914,20.0,20.0
39364,3,9364,[179  89 135 216 191],881,5,34990,3.736252002135611,0.0,0.0
39365,3,9365,[175 202 282 216 210],666,2,34992,3.7360666239590006,0.0,0.0
39366,3,9366,[100  96 176 273 435],378,5,34997,3.7362015586633928,0.0,20.0
39367,3,9367,[ 96 211 237 172 483],406,4,35001,3.7362297181895814,20.0,0.0
39368,3,9368,[603 302 427 127  64],666,5,35006,3.7363646066816094,20.0,20.0
39369,3,9369,[322 273 328 678 100],113,3,35009,3.7362860192102456,0.0,20.0
39370,3,9370,[238 318  89 204 289],92,3,35012,3.7362074485113648,20.0,0.0
39371,3,9371,[546 204 238 568 181],313,5,35017,3.736342296201451,0.0,0.0
39372,3,9372,[475 546   8 121  95],455,4,35021,3.736370425690814,0.0,0.0
39373,3,9373,[186 174  79 275 143],298,4,35025,3.736398549178579,0.0,20.0
39374,3,9374,[202  12 235 204  82],194,2,35027,3.736213333333333,20.0,0.0
39375,3,9375,[196 237 200 100  79],92,4,35031,3.7362414675767917,0.0,20.0
39376,3,9376,[515 238  79 235 276],308,3,35034,3.736162951903594,0.0,0.0
39377,3,9377,[603 302 427 127  64],13,5,35039,3.736297718063553,20.0,20.0
39378,3,9378,[496 276 174 655 117],308,3,35042,3.736219213135729,0.0,20.0
39379,3,9379,[423 216 496  96  98],64,5,35047,3.7363539445628997,0.0,20.0
39380,3,9380,[228 143 496  15 237],42,5,35052,3.73648864726575,0.0,0.0
39381,3,9381,[151 181 143 118 173],378,4,35056,3.7365167341718184,0.0,0.0
39382,3,9382,[194 187 118 405 183],840,2,35058,3.736331663647021,0.0,0.0
39383,3,9383,[435  70 286 597 678],82,3,35061,3.7362531969309463,0.0,0.0
39384,3,9384,[603 302 427 127  64],664,5,35066,3.736387852956846,20.0,20.0
39385,3,9385,[423 235 151  89  12],339,3,35069,3.736309396974217,20.0,0.0
39386,3,9386,[ 50  64 180  71 333],13,4,35073,3.7363374880153404,0.0,20.0
39387,3,9387,[127 180 435 216 238],648,2,35075,3.736152535151257,0.0,20.0
39388,3,9388,[194  96  95 268 175],664,3,35078,3.736074129300245,0.0,0.0
39389,3,9389,[161 180 234 196  97],326,2,35080,3.735889243876464,0.0,0.0
39390,3,9390,[195 294 179 127 191],13,1,35081,3.7355979128953254,0.0,20.0
39391,3,9391,[655 135 357 195  15],537,2,35083,3.7354131175468486,20.0,0.0
39392,3,9392,[471 275 210  69 265],474,3,35086,3.735334823804961,0.0,0.0
39393,3,9393,[235  50  56 265 471],648,4,35090,3.7353629976580796,0.0,20.0
39394,3,9394,[151 294 197 678 172],308,2,35092,3.735178286322512,0.0,0.0
39395,3,9395,[603 302 427 127  64],537,4,35096,3.7352064708386545,20.0,20.0
39396,3,9396,[496  95 238 286 678],648,1,35097,3.734915398531446,0.0,0.0
39397,3,9397,[ 28 318   1 276 238],271,3,35100,3.7348371994041285,20.0,0.0
39398,3,9398,[195 515 435  89 210],85,3,35103,3.7347590169166933,0.0,0.0
39399,3,9399,[234 127 173  97  71],234,2,35105,3.7345744680851065,0.0,20.0
39400,3,9400,[603 302 427 127  64],537,4,35109,3.7346027018402297,20.0,20.0
39401,3,9401,[179 197 181  95 288],537,2,35111,3.734418208891725,0.0,0.0
39402,3,9402,[603 302 427 127  64],339,5,35116,3.7345528022971393,20.0,20.0
39403,3,9403,[179  50 168  70  79],479,4,35120,3.734581029349213,0.0,20.0
39404,3,9404,[435 197  89 210 265],452,3,35123,3.734502923976608,0.0,0.0
39405,3,9405,[ 50 286  96 196 271],379,4,35127,3.734531150329577,0.0,20.0
39406,3,9406,[603   9 403 173 313],13,2,35129,3.7343467630487934,20.0,0.0
39407,3,9407,[ 64 435  56 186 194],406,4,35133,3.734375,0.0,0.0
39408,3,9408,[174 405  28  22 238],59,4,35137,3.7344032309490913,0.0,20.0
39409,3,9409,[357 121 197 117  88],13,3,35140,3.7343251859723696,20.0,0.0
39410,3,9410,[187 276 183 286 515],59,4,35144,3.7343534162150673,0.0,0.0
39411,3,9411,[300   8 405 191 111],378,3,35147,3.734275393115172,0.0,0.0
39412,3,9412,[603 302 427 127  64],745,4,35151,3.734303622649527,20.0,20.0
39413,3,9413,[191   9  15 161  88],378,5,35156,3.7344380709581473,0.0,0.0
39414,3,9414,[135 258 238  98 276],207,2,35158,3.7342538502389804,0.0,20.0
39415,3,9415,[313 168 423 118 181],533,5,35163,3.734388275276126,0.0,0.0
39416,3,9416,[603 302 427 127  64],13,5,35168,3.7345226717638313,20.0,20.0
39417,3,9417,[ 70 183 318 186 204],207,2,35170,3.7343385007432577,20.0,0.0
39418,3,9418,[  1 175 568 180 125],749,4,35174,3.734366705595074,0.0,0.0
39419,3,9419,[118 257  89 483 237],308,2,35176,3.7341825902335457,20.0,0.0
39420,3,9420,[ 56 100  70 742 282],533,4,35180,3.734210805646959,0.0,20.0
39421,3,9421,[603 302 427 127  64],339,5,35185,3.734345149649756,20.0,20.0
39422,3,9422,[197  96 183 144  56],207,2,35187,3.7341610951926136,0.0,0.0
39423,3,9423,[603 302 427 127  64],458,5,35192,3.734295415959253,20.0,20.0
39424,3,9424,[435   9 161 143 211],234,0,35192,3.733899204244032,0.0,0.0
39425,3,9425,[ 79 111 118 211 185],454,2,35194,3.7337152556757904,0.0,0.0
39426,3,9426,[603 302 427 127  64],90,5,35199,3.7338495809907712,20.0,20.0
39427,3,9427,[125  22 182 300  56],313,2,35201,3.7336656767076795,0.0,0.0
39428,3,9428,[603 302 427 127  64],664,5,35206,3.7337999787888427,20.0,20.0
39429,3,9429,[276 405 125 471   1],6,1,35207,3.733510074231177,0.0,0.0
39430,3,9430,[357 172  69 135 197],899,4,35211,3.733538331035945,20.0,0.0
39431,3,9431,[603 302 427 127  64],669,5,35216,3.7336726039016117,20.0,20.0
39432,3,9432,[210 144 328 288  89],119,5,35221,3.7338068482985265,0.0,0.0
39433,3,9433,[597  28 196 186 385],83,4,35225,3.7338350646597416,0.0,0.0
39434,3,9434,[471 181  25 174  98],378,4,35229,3.7338632750397456,0.0,40.0
39435,3,9435,[173 222  71 186 144],488,3,35232,3.7337855023314965,0.0,0.0
39436,3,9436,[508 237 265 179 172],334,2,35234,3.733601780226767,0.0,0.0
39437,3,9437,[257 121 132 655   7],92,3,35237,3.73352405170587,0.0,0.0
39438,3,9438,[118 200 483 182 655],328,3,35240,3.7334463396546242,20.0,0.0
39439,3,9439,[  9 655 175 286 181],184,3,35243,3.7333686440677964,0.0,0.0
39440,3,9440,[ 71 237  64 180 181],95,3,35246,3.7332909649401547,0.0,0.0
39441,3,9441,[161 216 238 385  25],295,5,35251,3.7334251217962295,0.0,0.0
39442,3,9442,[197 403 235 121 294],194,2,35253,3.7332415545907023,0.0,0.0
39443,3,9443,[603 302 427 127  64],90,5,35258,3.7333756882676834,20.0,20.0
39444,3,9444,[237 100 235  64  28],378,5,35263,3.733509793541556,0.0,20.0
39445,3,9445,[603 302 427 127  64],664,5,35268,3.7336438704213424,20.0,20.0
39446,3,9446,[603 302 427 127  64],13,5,35273,3.733777918916058,20.0,20.0
39447,3,9447,[471 186  22 234 183],194,2,35275,3.7335944115156647,0.0,0.0
39448,3,9448,[603 302 427 127  64],90,5,35280,3.7337284368716266,20.0,20.0
39449,3,9449,[174 496 423  25 328],804,4,35284,3.7337566137566136,0.0,20.0
39450,3,9450,[508 215 546 318 322],524,4,35288,3.73378478467887,20.0,0.0
39451,3,9451,[202  89 257 173 100],738,3,35291,3.7337071519255183,0.0,20.0
39452,3,9452,[125  25 322 191 748],804,5,35296,3.7338411086427588,0.0,0.0
39453,3,9453,[ 11 182 238 276 328],145,4,35300,3.733869261688174,0.0,0.0
39454,3,9454,[603 302 427 127  64],666,5,35305,3.7340031729243788,20.0,20.0
39455,3,9455,[603 302 427 127  64],271,5,35310,3.7341370558375635,20.0,20.0
39456,3,9456,[289 302  79 427 515],334,4,35314,3.7341651686581367,0.0,0.0
39457,3,9457,[322 228 238   4 111],334,2,35316,3.7339818143370693,0.0,0.0
39458,3,9458,[ 70 125  25 435 323],804,4,35320,3.734009937625542,0.0,0.0
39459,3,9459,[603 302 427 127  64],13,5,35325,3.7341437632135306,20.0,20.0
39460,3,9460,[282  82  25 202 168],92,2,35327,3.7339604692950004,0.0,0.0
39461,3,9461,[ 71 132 161 211 216],290,3,35330,3.733882900021137,0.0,0.0
39462,3,9462,[603 302 427 127  64],666,5,35335,3.734016696607841,20.0,20.0
39463,3,9463,[200  22 216 211 475],10,5,35340,3.7341504649196957,0.0,0.0
39464,3,9464,[210 202 143  22 183],13,3,35343,3.7340729001584787,0.0,0.0
39465,3,9465,[603 302 427 127  64],90,5,35348,3.734206634270019,20.0,20.0
39466,3,9466,[174 328 117 508 215],533,5,35353,3.7343403401288686,0.0,20.0
39467,3,9467,[435 222  88  71  98],830,4,35357,3.734368398817068,0.0,20.0
39468,3,9468,[655 200 471 181 313],92,4,35361,3.7343964515788364,0.0,0.0
39469,3,9469,[180 153 210 179 286],207,2,35363,3.7342133051742343,0.0,0.0
39470,3,9470,[357 132  56 215 127],804,3,35366,3.7341357829162707,20.0,20.0
39471,3,9471,[ 88 117  12 269 195],279,3,35369,3.734058277027027,20.0,0.0
39472,3,9472,[ 70  28 318 276  89],311,5,35374,3.7341919138604456,20.0,0.0
39473,3,9473,[  9 603 496   7 180],474,5,35379,3.734325522482584,20.0,0.0
39474,3,9474,[ 28 202  50 215 181],506,5,35384,3.734459102902375,0.0,20.0
39475,3,9475,[195 546 176 435 427],650,4,35388,3.734487125369354,0.0,0.0
39476,3,9476,[568 333  64 161  79],91,3,35391,3.7344096232985122,0.0,0.0
39477,3,9477,[515 144  79 435 496],815,5,35396,3.734543152563832,0.0,0.0
39478,3,9478,[161 483 143 216  79],313,4,35400,3.7345711572950733,20.0,0.0
39479,3,9479,[603 302 427 127  64],474,5,35405,3.734704641350211,20.0,20.0
39480,3,9480,[603 302 427 127  64],669,5,35410,3.734838097247126,20.0,20.0
39481,3,9481,[496 318  50 183  98],200,5,35415,3.734971524994727,20.0,40.0
39482,3,9482,[181 121 328 215  12],533,5,35420,3.7351049246019192,20.0,0.0
39483,3,9483,[294  82 471 187  28],533,5,35425,3.7352382960776045,0.0,0.0
39484,3,9484,[403 175 357   4 181],7,4,35429,3.7352662098049554,20.0,0.0
39485,3,9485,[127 228 483 245 568],313,3,35432,3.735188699135568,20.0,20.0
39486,3,9486,[475 195   1 204  22],533,4,35436,3.7352166122061767,0.0,0.0
39487,3,9487,[275 194 300 435 180],537,2,35438,3.735033726812816,0.0,0.0
39488,3,9488,[603 302 427 127  64],458,5,35443,3.7351670355148068,20.0,20.0
39489,3,9489,[132  79 748 318 483],488,3,35446,3.73508956796628,40.0,0.0
39490,3,9490,[678  97   9 385  96],474,4,35450,3.735117479717627,0.0,0.0
39491,3,9491,[222 471 118 180 197],194,1,35451,3.734829329962073,0.0,0.0
39492,3,9492,[357 222 135 257 180],653,3,35454,3.734751922469188,20.0,0.0
39493,3,9493,[603 302 427 127  64],474,5,35459,3.7348851906467244,20.0,20.0
39494,3,9494,[197   4 471  56 603],308,3,35462,3.734807793575566,20.0,0.0
39495,3,9495,[357 161 200 300 405],271,2,35464,3.7346251053074977,20.0,0.0
39496,3,9496,[603 302 427 127  64],13,5,35469,3.7347583447404444,20.0,20.0
39497,3,9497,[111 265 143 234 286],653,2,35471,3.7345757001473996,0.0,0.0
39498,3,9498,[435 176 182  25  28],804,4,35475,3.734603642488683,0.0,0.0
39499,3,9499,[603 302 427 127  64],339,5,35480,3.734736842105263,20.0,20.0
39500,3,9500,[603 302 427 127  64],669,5,35485,3.7348700136827704,20.0,20.0
39501,3,9501,[603 302 427 127  64],669,5,35490,3.735003157230057,20.0,20.0
39502,3,9502,[ 64 210 427 211 204],379,5,35495,3.735136272755972,0.0,0.0
39503,3,9503,[603 302 427 127  64],458,5,35500,3.7352693602693603,20.0,20.0
39504,3,9504,[603 302 427 127  64],669,5,35505,3.7354024197790636,20.0,20.0
39505,3,9505,[121  98 204 197 483],298,5,35510,3.7355354512939196,20.0,20.0
39506,3,9506,[111 127 269 265  97],537,1,35511,3.7352477122120544,0.0,20.0
39507,3,9507,[603 302 427 127  64],271,5,35516,3.735380732015145,20.0,20.0
39508,3,9508,[603 302 427 127  64],13,5,35521,3.735513723840572,20.0,20.0
39509,3,9509,[603 302 427 127  64],458,5,35526,3.735646687697161,20.0,20.0
39510,3,9510,[127  88 405 143  79],479,4,35530,3.73567448217853,0.0,20.0
39511,3,9511,[328  82 197 403   1],804,4,35534,3.7357022708158114,0.0,0.0
39512,3,9512,[603 302 427 127  64],666,5,35539,3.7358351729212655,20.0,20.0
39513,3,9513,[257 265  98 127   7],815,3,35542,3.7357578305654826,0.0,40.0
39514,3,9514,[508 276 282 179 100],334,4,35546,3.7357856016815556,0.0,20.0
39515,3,9515,[ 71  97 483  70 127],95,4,35550,3.735813366960908,20.0,20.0
39516,3,9516,[603 302 427 127  64],339,5,35555,3.7359462015340967,20.0,20.0
39517,3,9517,[385  79 238  22  15],543,1,35556,3.7356587518386215,0.0,0.0
39518,3,9518,[ 79 196 385 181 238],207,2,35558,3.735476415589873,0.0,0.0
39519,3,9519,[603 302 427 127  64],669,5,35563,3.735609243697479,20.0,20.0
39520,3,9520,[ 96 153 603 197 258],666,4,35567,3.735637012918811,20.0,0.0
39521,3,9521,[603 302 427 127  64],458,5,35572,3.7357697962612897,20.0,20.0
39522,3,9522,[282 269  15 568 180],378,4,35576,3.735797542791137,0.0,0.0
39523,3,9523,[ 79 153  88 318  95],184,2,35578,3.7356152876942463,20.0,0.0
39524,3,9524,[ 69  97  70 196 275],271,5,35583,3.735748031496063,0.0,0.0
39525,3,9525,[603 302 427 127  64],669,5,35588,3.7358807474280917,20.0,20.0
39526,3,9526,[603 302 427 127  64],13,5,35593,3.7360134354991077,20.0,20.0
39527,3,9527,[ 69 186 245 237 258],207,4,35597,3.736041141897565,0.0,0.0
39528,3,9528,[132 265 194 294 181],194,3,35600,3.7359638996746773,0.0,0.0
39529,3,9529,[603 302 427 127  64],474,5,35605,3.736096537250787,20.0,20.0
39530,3,9530,[603 302 427 127  64],90,5,35610,3.7362291469940194,20.0,20.0
39531,3,9531,[ 69 186 742 211 483],533,4,35614,3.7362568191355434,20.0,0.0
39532,3,9532,[182 187 195 202 403],533,3,35617,3.7361795866988357,0.0,0.0
39533,3,9533,[125 121  28 423 196],207,4,35621,3.73620725823369,0.0,0.0
39534,3,9534,[385 403 222 275 121],279,2,35623,3.736025170424751,0.0,0.0
39535,3,9535,[175 182 111 216 202],207,1,35624,3.735738255033557,0.0,0.0
39536,3,9536,[ 64   7 234 265 200],881,3,35627,3.7356611093635315,0.0,0.0
39537,3,9537,[276 173   9  25  69],378,4,35631,3.7356888236527572,0.0,0.0
39538,3,9538,[ 25  22 286 194 222],378,4,35635,3.7357165321312507,0.0,0.0
39539,3,9539,[588 423 483 222  56],892,5,35640,3.7358490566037736,20.0,0.0
39540,3,9540,[200 515 568 588 204],59,4,35644,3.735876742479824,0.0,0.0
39541,3,9541,[294 211  97   8 173],311,4,35648,3.735904422552924,0.0,0.0
39542,3,9542,[215 357 196 117 194],882,4,35652,3.735932096824898,20.0,0.0
39543,3,9543,[ 50 200  64 111 678],145,3,35655,3.7358549874266553,0.0,20.0
39544,3,9544,[357 216  15 121 117],533,4,35659,3.735882661079099,20.0,0.0
39545,3,9545,[603 302 427 127  64],271,5,35664,3.736015084852294,20.0,20.0
39546,3,9546,[144 748 168  22 200],13,4,35668,3.736042735937991,0.0,0.0
39547,3,9547,[603 302 427 127  64],745,4,35672,3.7360703812316713,20.0,20.0
39548,3,9548,[200  50 234 174 423],648,4,35676,3.7360980207351555,0.0,40.0
39549,3,9549,[ 64 237 286 132 234],60,5,35681,3.736230366492147,0.0,0.0
39550,3,9550,[603 302 427 127  64],458,5,35686,3.7363626845356506,20.0,20.0
39551,3,9551,[603 302 427 127  64],474,5,35691,3.736494974874372,20.0,20.0
39552,3,9552,[603 302 427 127  64],537,4,35695,3.736522558358631,20.0,20.0
39553,3,9553,[508   1 132 196  88],326,2,35697,3.736340799665062,0.0,0.0
39554,3,9554,[ 56  50  64  88 185],398,5,35702,3.736473050758765,0.0,20.0
39555,3,9555,[ 70 483 237 269  79],90,5,35707,3.7366052741732942,20.0,0.0
39556,3,9556,[427  82 187 423  56],85,3,35710,3.7365281992256985,0.0,0.0
39557,3,9557,[603 302 427 127  64],90,5,35715,3.736660389202762,20.0,20.0
39558,3,9558,[603 302 427 127  64],458,5,35720,3.7367925515221256,20.0,20.0
39559,3,9559,[ 12 234 121 301 182],788,2,35722,3.7366108786610877,20.0,0.0
39560,3,9560,[ 11  79 121 678 144],455,2,35724,3.7364292438029496,0.0,0.0
39561,3,9561,[603 302 427 127  64],537,4,35728,3.7364568081991214,20.0,20.0
39562,3,9562,[ 89 144 143 185  97],194,2,35730,3.736275227439088,0.0,0.0
39563,3,9563,[173 568 302 132 322],454,2,35732,3.7360936846507737,0.0,0.0
39564,3,9564,[  8 483 286 121 405],881,4,35736,3.7361212754835336,20.0,0.0
39565,3,9565,[603 302 427 127  64],271,5,35741,3.7362533974492997,20.0,20.0
39566,3,9566,[180 275 323   9  28],13,2,35743,3.736071913870597,0.0,0.0
39567,3,9567,[603 302 427 127  64],458,5,35748,3.7362040133779266,20.0,20.0
39568,3,9568,[216 174   9 228  70],234,0,35748,3.7358135646358033,0.0,20.0
39569,3,9569,[748 135 655 289   9],328,3,35751,3.7357366771159874,0.0,0.0
39570,3,9570,[603 302 427 127  64],664,5,35756,3.7358687702434437,20.0,20.0
39571,3,9571,[603 302 427 127  64],458,5,35761,3.736000835770999,20.0,20.0
39572,3,9572,[235   7 132 172 135],87,4,35765,3.7360284132455868,0.0,0.0
39573,3,9573,[238 427 678 603 200],13,2,35767,3.735847085857531,20.0,0.0
39574,3,9574,[186 515 100 588 181],387,3,35770,3.735770234986945,0.0,20.0
39575,3,9575,[286 546 423 742 216],650,1,35771,3.735484544695071,0.0,0.0
39576,3,9576,[182 603 100 471 186],308,4,35775,3.735512164560927,20.0,20.0
39577,3,9577,[ 79 211  22  96  88],313,3,35778,3.735435372729171,0.0,0.0
39578,3,9578,[603 302 427 127  64],13,5,35783,3.735567386992379,20.0,20.0
39579,3,9579,[118 288 273 210 125],92,3,35786,3.735490605427975,0.0,0.0
39580,3,9580,[  8 174 179 183  70],312,5,35791,3.735622586368855,0.0,20.0
39581,3,9581,[174  89 181 204   9],694,5,35796,3.7357545397620537,0.0,20.0
39582,3,9582,[174  69 678 211 496],749,4,35800,3.7357821141604926,0.0,20.0
39583,3,9583,[127 597  25  96  69],59,4,35804,3.7358096828046743,0.0,20.0
39584,3,9584,[603 302 427 127  64],666,5,35809,3.7359415753781953,20.0,20.0
39585,3,9585,[603 302 427 127  64],271,5,35814,3.7360734404339664,20.0,20.0
39586,3,9586,[ 50 196 294 183 742],488,4,35818,3.7361009700636276,0.0,20.0
39587,3,9587,[ 11 423 237 222   1],804,4,35822,3.7361284939507717,0.0,0.0
39588,3,9588,[ 11 144   8 153  71],488,0,35822,3.735738867452289,0.0,0.0
39589,3,9589,[603 302 427 127  64],339,5,35827,3.7358706986444212,20.0,20.0
39590,3,9590,[603 302 427 127  64],458,5,35832,3.7360025023459493,20.0,20.0
39591,3,9591,[204 215 268  89 273],537,2,35834,3.7358215179316097,0.0,0.0
39592,3,9592,[603  71 235 175 322],524,1,35835,3.735536328572918,20.0,0.0
39593,3,9593,[194 195 258 118 228],882,3,35838,3.7354596622889304,0.0,0.0
39594,3,9594,[471 483 191 357 427],6,4,35842,3.73548723293382,40.0,0.0
39595,3,9595,[568 175  69 204  97],892,5,35847,3.7356190079199667,0.0,0.0
39596,3,9596,[276 191 286 135 118],881,4,35851,3.735646556215484,0.0,0.0
39597,3,9597,[302 603 427 127  64],13,5,35856,3.735778287143155,20.0,20.0
39598,3,9598,[302 603 427 127  64],745,4,35860,3.735805813105532,20.0,20.0
39599,3,9599,[302 603 427 127  64],458,5,35865,3.7359375,20.0,20.0
39600,3,9600,[302 603 427 127  64],745,4,35869,3.7359650036454535,20.0,20.0
39601,3,9601,[ 50 174 216   1 742],648,5,35874,3.7360966465319727,0.0,40.0
39602,3,9602,[302 603 427 127  64],666,5,35879,3.736228262001458,20.0,20.0
39603,3,9603,[127 318  28 176 197],686,4,35883,3.736255726780508,20.0,20.0
39604,3,9604,[302 603 427 127  64],271,5,35888,3.736387298282145,20.0,20.0
39605,3,9605,[302 603 427 127  64],474,5,35893,3.736518842390173,20.0,20.0
39606,3,9606,[197 496 135 185  79],659,4,35897,3.7365462683459976,0.0,0.0
39607,3,9607,[186  69 603 286 269],452,4,35901,3.736573688592839,20.0,0.0
39608,3,9608,[302 603 427 127  64],13,5,35906,3.736705172234364,20.0,20.0
39609,3,9609,[313  70 161  88 423],13,4,35910,3.736732570239334,0.0,0.0
39610,3,9610,[302 603 427 127  64],669,5,35915,3.7368640099885546,20.0,20.0
39611,3,9611,[302 603 427 127  64],474,5,35920,3.7369954223886808,20.0,20.0
39612,3,9612,[168 174 237  50 588],313,3,35923,3.736918755851451,0.0,40.0
39613,3,9613,[  9 742 655  50 294],92,3,35926,3.736842105263158,0.0,20.0
39614,3,9614,[302 603 427 127  64],745,4,35930,3.7368694747789912,20.0,20.0
39615,3,9615,[475  79 237  25 742],374,4,35934,3.7368968386023296,0.0,0.0
39616,3,9616,[302 603 427 127  64],666,5,35939,3.7370281792658835,20.0,20.0
39617,3,9617,[302 603 427 127  64],537,4,35943,3.737055520898316,20.0,20.0
39618,3,9618,[144 286 471 117 111],378,2,35945,3.736874935024431,0.0,0.0
39619,3,9619,[318 143 289 215 235],194,1,35946,3.7365904365904368,20.0,0.0
39620,3,9620,[ 56 286 161 216 100],379,4,35950,3.7366178151959257,0.0,20.0
39621,3,9621,[185 655 483  88 172],234,1,35951,3.7363334026189983,20.0,0.0
39622,3,9622,[302 603 427 127  64],90,5,35956,3.736464719941806,20.0,20.0
39623,3,9623,[302 603 427 127  64],474,5,35961,3.736596009975062,20.0,20.0
39624,3,9624,[200 121 483   9  71],815,4,35965,3.7366233766233767,20.0,0.0
39625,3,9625,[168  28 275  50 216],311,5,35970,3.7367546228963224,0.0,20.0
39626,3,9626,[186 125 132 655 143],749,5,35975,3.736885841902981,0.0,0.0
39627,3,9627,[302 603 427 127  64],13,5,35980,3.7370170336518487,20.0,20.0
39628,3,9628,[ 96 194 172 603  95],59,3,35983,3.7369404922629554,20.0,0.0
39629,3,9629,[405 237 210 144 132],7,4,35987,3.7369678089304257,0.0,0.0
39630,3,9630,[185 276 496 385 176],42,3,35990,3.736891288547399,0.0,0.0
39631,3,9631,[323 216   9 475 197],90,3,35993,3.736814784053156,0.0,0.0
39632,3,9632,[ 71  28 742 288 678],308,3,35996,3.736738295442749,0.0,0.0
39633,3,9633,[302 603 427 127  64],458,5,36001,3.7368694208013284,20.0,20.0
39634,3,9634,[  1 238 234 210 172],234,1,36002,3.7365853658536587,0.0,0.0
39635,3,9635,[210 237  50 603 183],42,5,36007,3.7367164798671646,20.0,20.0
39636,3,9636,[ 25 357 172 234 655],398,5,36012,3.7368475666701255,20.0,0.0
39637,3,9637,[  1 300 211 151 357],380,3,36015,3.7367711143390747,20.0,0.0
39638,3,9638,[302 603 427 127  64],669,5,36020,3.7369021682747174,20.0,20.0
39639,3,9639,[333 496 135 238 176],653,2,36022,3.736721991701245,0.0,0.0
39640,3,9640,[302 603 427 127  64],664,5,36027,3.7368530235452755,20.0,20.0
39641,3,9641,[302 603 427 127  64],664,5,36032,3.736984028209915,20.0,20.0
39642,3,9642,[288 546   1 117 195],308,3,36035,3.7369076013688685,0.0,0.0
39643,3,9643,[302 603 427 127  64],666,5,36040,3.7370385732061386,20.0,20.0
39644,3,9644,[228 475 174 135 568],13,3,36043,3.736962156557802,0.0,20.0
39645,3,9645,[302 603 427 127  64],339,5,36048,3.7370930955836617,20.0,20.0
39646,3,9646,[ 12 117 125 197 588],398,3,36051,3.737016689126153,20.0,0.0
39647,3,9647,[302 603 427 127  64],13,5,36056,3.7371475953565505,20.0,20.0
39648,3,9648,[302 603 427 127  64],669,5,36061,3.737278474453311,20.0,20.0
39649,3,9649,[748 322 135 186 328],313,2,36063,3.737098445595855,0.0,0.0
39650,3,9650,[302 603 427 127  64],339,5,36068,3.7372293026629366,20.0,20.0
39651,3,9651,[302 603 427 127  64],458,5,36073,3.737360132615002,20.0,20.0
39652,3,9652,[ 96 186 197 176 357],840,3,36076,3.737283745985704,20.0,0.0
39653,3,9653,[ 64 117 427  12 197],533,5,36081,3.737414543194531,20.0,0.0
39654,3,9654,[302 603 427 127  64],745,4,36085,3.737441740031072,20.0,20.0
39655,3,9655,[302 603 427 127  64],669,5,36090,3.7375724937862467,20.0,20.0
39656,3,9656,[286 427 301  70 111],234,1,36091,3.737289013151082,0.0,0.0
39657,3,9657,[216 508 515  69 204],207,4,36095,3.7373162145371714,0.0,0.0
39658,3,9658,[302 603 427 127  64],339,5,36100,3.737446940677089,20.0,20.0
39659,3,9659,[302 603 427 127  64],664,5,36105,3.737577639751553,20.0,20.0
39660,3,9660,[568 180 168  89  22],543,2,36107,3.7373977849083944,0.0,0.0
39661,3,9661,[302 603 427 127  64],271,5,36112,3.7375284620161455,20.0,20.0
39662,3,9662,[302 603 427 127  64],745,4,36116,3.737555624547242,20.0,20.0
39663,3,9663,[265 238  69 132 191],59,5,36121,3.7376862582781456,0.0,0.0
39664,3,9664,[302 603 427 127  64],669,5,36126,3.73781686497672,20.0,20.0
39665,3,9665,[302 603 427 127  64],745,4,36130,3.737843989240637,20.0,20.0
39666,3,9666,[302 603 427 127  64],669,5,36135,3.7379745526016346,20.0,20.0
39667,3,9667,[180 151  50 258 174],465,2,36137,3.7377947869259414,0.0,40.0
39668,3,9668,[265 568 153 100 403],650,3,36140,3.7377184817457856,0.0,20.0
39669,3,9669,[483 405 182  70 322],488,0,36140,3.737331954498449,20.0,0.0
39670,3,9670,[118  69  79 222 496],650,3,36143,3.737255712956261,0.0,0.0
39671,3,9671,[ 88 204   8 118 483],200,5,36148,3.7373862696443343,20.0,0.0
39672,3,9672,[302 603 427 127  64],664,5,36153,3.7375167993383647,20.0,20.0
39673,3,9673,[ 82 127 742  95 403],804,2,36155,3.7373371924746746,0.0,20.0
39674,3,9674,[471  98 191 202 195],815,4,36159,3.7373643410852715,0.0,20.0
39675,3,9675,[204 237 168 597 175],92,4,36163,3.7373914840843323,0.0,0.0
39676,3,9676,[ 88 151 234 168 187],406,1,36164,3.737108608039682,0.0,0.0
39677,3,9677,[258  95 228 179 515],843,3,36167,3.7370324447199836,0.0,0.0
39678,3,9678,[172 183 204 475 357],527,4,36171,3.737059613596446,20.0,0.0
39679,3,9679,[318  15  22 471 173],92,1,36172,3.736776859504132,20.0,0.0
39680,3,9680,[210 175 174 286 176],334,3,36175,3.736700754054333,0.0,20.0
39681,3,9681,[204 161  89 117 222],474,5,36180,3.7368312332162774,0.0,0.0
39682,3,9682,[302 603 427 127  64],537,4,36184,3.7368584116492825,20.0,20.0
39683,3,9683,[194 301  97 271  56],537,1,36185,3.736575795125981,0.0,0.0
39684,3,9684,[ 96 180 174 435  71],406,4,36189,3.736602994321115,0.0,20.0
39685,3,9685,[ 50 258 294 100 125],378,3,36192,3.7365269461077846,0.0,40.0
39686,3,9686,[196 195 265 742 318],92,3,36195,3.7364509135955406,20.0,0.0
39687,3,9687,[194 118 180 234 294],653,1,36196,3.736168455821635,0.0,0.0
39688,3,9688,[173 215 200  95 151],479,4,36200,3.736195685829291,0.0,0.0
39689,3,9689,[ 11 179 508 515 322],13,0,36200,3.7358101135190918,0.0,0.0
39690,3,9690,[655  22 234 318 191],144,5,36205,3.7359405634093488,20.0,0.0
39691,3,9691,[302 603 427 127  64],474,5,36210,3.73607098638052,20.0,20.0
39692,3,9692,[117  50 191 215  96],648,3,36213,3.735995047972764,0.0,20.0
39693,3,9693,[302 603 427 127  64],458,5,36218,3.736125438415515,20.0,20.0
39694,3,9694,[151 143  96 183 194],312,4,36222,3.736152656008252,0.0,0.0
39695,3,9695,[288 185 435 182 588],102,1,36223,3.7358704620462047,0.0,0.0
39696,3,9696,[111 655 175  70 742],334,2,36225,3.735691450964216,0.0,0.0
39697,3,9697,[111 172 475 258 197],537,3,36228,3.735615590843473,0.0,0.0
39698,3,9698,[302 603 427 127  64],745,4,36232,3.7356428497783276,20.0,20.0
39699,3,9699,[568 100  82 405 748],804,5,36237,3.7357731958762885,0.0,20.0
39700,3,9700,[ 95 257 237 597 181],308,3,36240,3.7356973507885787,0.0,0.0
39701,3,9701,[180 182 161 187 435],194,3,36243,3.735621521335807,0.0,0.0
39702,3,9702,[197 194 588 143 117],406,4,36247,3.7356487684221373,0.0,0.0
39703,3,9703,[302 603 427 127  64],664,5,36252,3.7357790601813683,20.0,20.0
39704,3,9704,[322 265 286 100  96],13,3,36255,3.7357032457496135,0.0,20.0
39705,3,9705,[288  50 211 322 678],13,2,36257,3.735524417885844,0.0,20.0
39706,3,9706,[238   7 181 603  97],474,5,36262,3.7356546821881116,20.0,0.0
39707,3,9707,[183  56   4 172 144],406,3,36265,3.7355789039967036,0.0,0.0
39708,3,9708,[302 603 427 127  64],745,4,36269,3.7356061386342567,20.0,20.0
39709,3,9709,[302 603 427 127  64],745,4,36273,3.7356333676622038,20.0,20.0
39710,3,9710,[ 11  98 135 191 273],10,5,36278,3.7357635670888683,0.0,20.0
39711,3,9711,[302 603 427 127  64],339,5,36283,3.7358937397034597,20.0,20.0
39712,3,9712,[318 210 403 174 187],184,3,36286,3.735817975908576,20.0,20.0
39713,3,9713,[175 403 135   9 237],308,4,36290,3.735845171916821,0.0,0.0
39714,3,9714,[ 89 228 215 568 168],804,5,36295,3.7359752959341224,0.0,0.0
39715,3,9715,[ 11 179 496   7 228],64,5,36300,3.736105393165912,0.0,0.0
39716,3,9716,[302 603 427 127  64],90,5,36305,3.736235463620459,20.0,20.0
39717,3,9717,[302 603 427 127  64],666,5,36310,3.7363655073060302,20.0,20.0
39718,3,9718,[435 471 286 313  64],232,2,36312,3.7361868504990223,0.0,0.0
39719,3,9719,[153 118  97 180 187],694,5,36317,3.7363168724279836,0.0,0.0
39720,3,9720,[202  69 385 135  28],897,2,36319,3.736138257380928,0.0,0.0
39721,3,9721,[508 173 195 328  15],144,4,36323,3.7361653980662415,0.0,0.0
39722,3,9722,[174 427 211 187 483],59,5,36328,3.736295382083719,20.0,20.0
39723,3,9723,[302 603 427 127  64],669,5,36333,3.736425339366516,20.0,20.0
39724,3,9724,[302 603 427 127  64],669,5,36338,3.7365552699228792,20.0,20.0
39725,3,9725,[204 202  28 597 515],833,1,36339,3.7362739049969154,0.0,0.0
39726,3,9726,[302 603 427 127  64],664,5,36344,3.736403824406292,20.0,20.0
39727,3,9727,[143  12 288   1 195],308,5,36349,3.7365337171052633,20.0,0.0
39728,3,9728,[515 195 423  69 427],91,5,36354,3.736663583102066,0.0,0.0
39729,3,9729,[258 288  70 265 175],479,4,36358,3.7366906474820145,0.0,0.0
39730,3,9730,[302 603 427 127  64],474,5,36363,3.736820470660775,20.0,20.0
39731,3,9731,[302 603 427 127  64],745,4,36367,3.7368475133579944,20.0,20.0
39732,3,9732,[302 603 427 127  64],664,5,36372,3.736977293742936,20.0,20.0
39733,3,9733,[127  79 483  22 191],452,5,36377,3.7371070474625028,20.0,20.0
39734,3,9734,[302 603 427 127  64],339,5,36382,3.73723677452491,20.0,20.0
39735,3,9735,[ 70 121 175 111 333],537,2,36384,3.737058340180772,0.0,0.0
39736,3,9736,[302 603 427 127  64],474,5,36389,3.7371880455992605,20.0,20.0
39737,3,9737,[597 475   1 234  56],458,4,36393,3.737215033887862,0.0,0.0
39738,3,9738,[302 603 427 127  64],537,4,36397,3.7372420166341516,20.0,20.0
39739,3,9739,[234 475 202 195 211],479,4,36401,3.7372689938398356,0.0,0.0
39740,3,9740,[475 234 127 678 275],13,2,36403,3.7370906477774355,0.0,20.0
39741,3,9741,[173 121 423   7  89],92,3,36406,3.7370149866557174,0.0,0.0
39742,3,9742,[302 603 427 127  64],474,5,36411,3.73714461664785,20.0,20.0
39743,3,9743,[ 28 228  50 211 597],13,4,36415,3.737171592775041,0.0,20.0
39744,3,9744,[568  97 546  95 235],13,2,36417,3.7369933299127758,0.0,0.0
39745,3,9745,[215 194 143   9 496],749,4,36421,3.737020316027088,0.0,0.0
39746,3,9746,[  1 135 357 200 322],313,3,36424,3.7369447009336207,20.0,0.0
39747,3,9747,[196 471   8 508 678],455,4,36428,3.736971686499795,0.0,0.0
39748,3,9748,[294 172 333 168  97],346,4,36432,3.7369986665299004,0.0,0.0
39749,3,9749,[ 64 328  12 385   1],378,4,36436,3.737025641025641,20.0,0.0
39750,3,9750,[187   7 183  96 144],144,4,36440,3.737052609988719,0.0,0.0
39751,3,9751,[ 70  79 161 210 180],60,5,36445,3.7371821164889254,0.0,0.0
39752,3,9752,[271 200 258 196 423],738,3,36448,3.737106531323695,0.0,0.0
39753,3,9753,[181 508  64 323  50],13,3,36451,3.7370309616567563,0.0,20.0
39754,3,9754,[357 265 211 191   4],804,5,36456,3.7371604305484367,20.0,0.0
39755,3,9755,[185 132 322 427 174],234,2,36458,3.736982369823698,0.0,20.0
39756,3,9756,[ 50 245  82 258 357],533,3,36461,3.736906836117659,20.0,20.0
39757,3,9757,[302 603 427 127  64],13,5,36466,3.7370362779258044,20.0,20.0
39758,3,9758,[302 603 427 127  64],458,5,36471,3.737165693206271,20.0,20.0
39759,3,9759,[302 603 427 127  64],90,5,36476,3.737295081967213,20.0,20.0
39760,3,9760,[204 183 195 100 222],932,5,36481,3.737424444216781,0.0,20.0
39761,3,9761,[546 135 185 515   4],7,4,36485,3.7374513419381272,0.0,0.0
39762,3,9762,[302 603 427 127  64],458,5,36490,3.73758066168186,20.0,20.0
39763,3,9763,[302 603 427 127  64],339,5,36495,3.7377099549365016,20.0,20.0
39764,3,9764,[235 678 185 655 183],13,2,36497,3.7375320020481313,0.0,0.0
39765,3,9765,[183  50  15 151 211],648,3,36500,3.737456481671104,0.0,20.0
39766,3,9766,[435 568 301 357 161],85,4,36504,3.7374833623425823,20.0,0.0
39767,3,9767,[302 603 427 127  64],666,5,36509,3.7376126126126126,20.0,20.0
39768,3,9768,[173 161  97 181  89],326,4,36513,3.7376394717985466,0.0,0.0
39769,3,9769,[515 258 197 742 496],313,3,36516,3.7375639713408395,0.0,0.0
39770,3,9770,[215 357   7   1 121],184,3,36519,3.73748848633712,20.0,0.0
39771,3,9771,[302 603 427 127  64],339,5,36524,3.7376176831764223,20.0,20.0
39772,3,9772,[ 82 197 195 191 276],378,3,36527,3.7375422081244243,0.0,0.0
39773,3,9773,[100  12 161 117 235],13,3,36530,3.7374667485164723,20.0,20.0
39774,3,9774,[268  22 333 273 423],13,3,36533,3.737391304347826,0.0,0.0
39775,3,9775,[ 97   1  79 508  22],125,3,36536,3.737315875613748,0.0,0.0
39776,3,9776,[302 603 427 127  64],474,5,36541,3.7374450240360026,20.0,20.0
39777,3,9777,[191 200 496  12  98],271,5,36546,3.7375741460421352,20.0,20.0
39778,3,9778,[181 191 228 180 195],406,4,36550,3.73760098169547,0.0,0.0
39779,3,9779,[ 98 194 471   9 508],207,4,36554,3.7376278118609405,0.0,20.0
39780,3,9780,[202  28 483 111 161],454,2,36556,3.737450158470504,20.0,0.0
39781,3,9781,[ 56  98 603 186 385],379,4,36560,3.7374769985687997,20.0,20.0
39782,3,9782,[302 603 427 127  64],13,5,36565,3.737606051313503,20.0,20.0
39783,3,9783,[187  70 183 515 302],102,1,36566,3.7373262469337694,0.0,0.0
39784,3,9784,[  1 403 118 125 204],92,4,36570,3.7373530914665305,0.0,0.0
39785,3,9785,[318 191 269 333 176],64,4,36574,3.7373799305129776,20.0,0.0
39786,3,9786,[603 302 427 127  64],458,5,36579,3.737508940431184,20.0,20.0
39787,3,9787,[603 302 427 127  64],474,5,36584,3.7376379239885575,20.0,20.0
39788,3,9788,[100 132  25 185 427],59,5,36589,3.737766881193176,0.0,20.0
39789,3,9789,[174 603 357 195 385],650,5,36594,3.7378958120531154,40.0,20.0
39790,3,9790,[ 11 118 235 161 597],374,4,36598,3.7379225819630273,0.0,0.0
39791,3,9791,[603 302 427 127  64],13,5,36603,3.7380514705882355,20.0,20.0
39792,3,9792,[179   9 275 276   8],334,5,36608,3.7381803328908405,0.0,0.0
39793,3,9793,[161 174 200 196  12],378,4,36612,3.7382070655503368,20.0,20.0
39794,3,9794,[228  15  98  95 423],95,4,36616,3.7382337927514038,0.0,20.0
39795,3,9795,[265 235 333 234 742],313,3,36619,3.7381584320130665,0.0,0.0
39796,3,9796,[603 302 427 127  64],13,5,36624,3.738287230784934,20.0,20.0
39797,3,9797,[603 302 427 127  64],669,5,36629,3.738416003265973,20.0,20.0
39798,3,9798,[ 22 211 181 257 161],738,2,36631,3.738238595775079,0.0,0.0
39799,3,9799,[135 125 238 176  82],749,4,36635,3.738265306122449,0.0,0.0
39800,3,9800,[603 302 427 127  64],458,5,36640,3.7383940414243444,20.0,20.0
39801,3,9801,[  8 195 121 515 318],387,3,36643,3.7383187104672517,20.0,0.0
39802,3,9802,[603 302 427 127  64],669,5,36648,3.7384474140569215,20.0,20.0
39803,3,9803,[678 234  50  82 195],339,3,36651,3.738372093023256,0.0,20.0
39804,3,9804,[ 70  69 202 180  89],308,4,36655,3.738398776134625,0.0,0.0
39805,3,9805,[ 82  28 175 153 174],194,2,36657,3.738221497042627,0.0,20.0
39806,3,9806,[603 302 427 127  64],474,5,36662,3.738350158050372,20.0,20.0
39807,3,9807,[603 302 427 127  64],666,5,36667,3.738478792822186,20.0,20.0
39808,3,9808,[ 28  97 216  95  22],406,2,36669,3.7383015597920277,0.0,0.0
39809,3,9809,[288 742 235 515 196],334,2,36671,3.738124362895005,0.0,0.0
39810,3,9810,[174 195  88 286  28],474,5,36676,3.738252981347467,0.0,20.0
39811,3,9811,[301 175 483 275 234],524,3,36679,3.7381777415409703,20.0,0.0
39812,3,9812,[ 98  50 127  22 603],308,4,36683,3.7382044227045754,20.0,60.0
39813,3,9813,[191 187 568 143   1],59,3,36686,3.738129203179132,0.0,0.0
39814,3,9814,[234 173 175 655 275],95,3,36689,3.7380539989811514,0.0,0.0
39815,3,9815,[211 187 195 185 143],653,2,36691,3.737876935615322,0.0,0.0
39816,3,9816,[603 302 427 127  64],474,5,36696,3.738005500662117,20.0,20.0
39817,3,9817,[603 302 427 127  64],474,5,36701,3.73813403951925,20.0,20.0
39818,3,9818,[603 302 427 127  64],90,5,36706,3.7382625521947244,20.0,20.0
39819,3,9819,[603 302 427 127  64],339,5,36711,3.7383910386965375,20.0,20.0
39820,3,9820,[603 302 427 127  64],271,5,36716,3.738519499032685,20.0,20.0
39821,3,9821,[ 15 275  69   1 323],454,1,36717,3.738240684178375,0.0,0.0
39822,3,9822,[  8  89 125   4 111],378,2,36719,3.7380637279853404,0.0,0.0
39823,3,9823,[187  82 181 151 204],666,1,36720,3.737785016286645,0.0,0.0
39824,3,9824,[  9  97 202 318 187],13,3,36723,3.7377099236641222,20.0,0.0
39825,3,9825,[603 302 427 127  64],339,5,36728,3.737838387950336,20.0,20.0
39826,3,9826,[282 323 176 234 183],788,3,36731,3.737763305179607,0.0,0.0
39827,3,9827,[496  56  98  70 125],295,5,36736,3.737891737891738,0.0,20.0
39828,3,9828,[603 302 427 127  64],271,5,36741,3.7380201444704446,20.0,20.0
39829,3,9829,[237 588 257 471 210],454,3,36744,3.73794506612411,0.0,0.0
39830,3,9830,[172 168 427  56 100],474,4,36748,3.7379717221035498,0.0,20.0
39831,3,9831,[132 204 265 216 179],881,4,36752,3.7379983726607,0.0,0.0
39832,3,9832,[603 302 427 127  64],339,5,36757,3.73812671615987,20.0,20.0
39833,3,9833,[496 195 216  98  71],59,4,36761,3.738153345535896,0.0,20.0
39834,3,9834,[471 181  88  22 318],479,5,36766,3.7382816471784444,20.0,0.0
39835,3,9835,[603 302 427 127  64],271,5,36771,3.738409922732818,20.0,20.0
39836,3,9836,[603 302 427 127  64],669,5,36776,3.7385381722069737,20.0,20.0
39837,3,9837,[ 88 271  71 515 211],650,2,36778,3.7383614555804026,0.0,0.0
39838,3,9838,[ 12 300 471  28   9],234,1,36779,3.7380831385303384,20.0,0.0
39839,3,9839,[186  56 276 515  98],92,5,36784,3.738211382113821,0.0,20.0
39840,3,9840,[ 96 275 200 496 234],311,5,36789,3.7383395996341835,0.0,0.0
39841,3,9841,[ 88 143 405  56 546],897,4,36793,3.738366185734607,0.0,0.0
39842,3,9842,[185  11 427 385 234],308,4,36797,3.738392766432998,0.0,0.0
39843,3,9843,[ 71 153 180 318 435],7,5,36802,3.7385209264526615,20.0,0.0
39844,3,9844,[276   1 405 125  79],194,1,36803,3.738242762823768,0.0,0.0
39845,3,9845,[275 132 568  50 405],524,3,36806,3.738167783871623,0.0,20.0
39846,3,9846,[  7 215  71 185 475],648,1,36807,3.737889712602823,0.0,0.0
39847,3,9847,[ 15 238 173 508 216],6,3,36810,3.7378147847278633,0.0,0.0
39848,3,9848,[289 405 655 187 568],881,4,36814,3.737841405218804,0.0,0.0
39849,3,9849,[173   9 181 111  15],145,2,36816,3.7376649746192894,0.0,0.0
39850,3,9850,[186 172  97  50 173],64,4,36820,3.737691604913207,0.0,20.0
39851,3,9851,[508 187 195 385 322],533,5,36825,3.737819732034105,0.0,0.0
39852,3,9852,[282 405 289 222 195],825,4,36829,3.7378463412158736,0.0,0.0
39853,3,9853,[603 302 427 127  64],90,5,36834,3.73797442662878,20.0,20.0
39854,3,9854,[508 196   1 161 301],83,3,36837,3.737899543378995,0.0,0.0
39855,3,9855,[153 288 215 237 182],13,4,36841,3.7379261363636362,0.0,0.0
39856,3,9856,[603 302 427 127  64],13,5,36846,3.738054174698184,20.0,20.0
39857,3,9857,[ 64 202 144   9  28],194,4,36850,3.738080746601745,0.0,0.0
39858,3,9858,[603 302 427 127  64],339,5,36855,3.7382087432802518,20.0,20.0
39859,3,9859,[ 96  82 197 182 294],749,3,36858,3.738133874239351,0.0,0.0
39860,3,9860,[318 179 153 496 117],536,4,36862,3.7381604299766757,20.0,0.0
39861,3,9861,[603 302 427 127  64],458,5,36867,3.7382883796390183,20.0,20.0
39862,3,9862,[268 174 197 742 132],288,3,36870,3.7382135252965627,0.0,20.0
39863,3,9863,[333 111 313  50 265],653,4,36874,3.7382400648824006,0.0,20.0
39864,3,9864,[ 56 318 235 204 403],144,2,36876,3.738063862138875,20.0,0.0
39865,3,9865,[185 197 168 568  96],379,5,36881,3.7381917697141698,0.0,0.0
39866,3,9866,[603 302 427 127  64],669,5,36886,3.73831965136313,20.0,20.0
39867,3,9867,[238  15 546  89 117],650,3,36889,3.738244831779489,0.0,0.0
39868,3,9868,[603 302 427 127  64],271,5,36894,3.7383726821359815,20.0,20.0
39869,3,9869,[237 265 483 204 216],374,4,36898,3.7383991894630193,20.0,0.0
39870,3,9870,[265 194  89  64 276],13,5,36903,3.7385269982777833,0.0,0.0
39871,3,9871,[ 70 127 216 118 186],158,3,36906,3.738452188006483,0.0,20.0
39872,3,9872,[588 258 135   8 210],387,4,36910,3.7384786792261724,0.0,0.0
39873,3,9873,[187  82 216 186 271],328,3,36913,3.7384038890014177,0.0,0.0
39874,3,9874,[313 508  12 748 265],543,3,36916,3.7383291139240504,20.0,0.0
39875,3,9875,[603 302 427 127  64],666,5,36921,3.738456865127582,20.0,20.0
39876,3,9876,[423 172  79 385 187],7,5,36926,3.738584590462691,0.0,0.0
39877,3,9877,[234  88 202 121  98],738,4,36930,3.738611054869407,0.0,20.0
39878,3,9878,[238 276 313  28 191],92,4,36934,3.738637513918413,0.0,0.0
39879,3,9879,[603 302 427 127  64],669,5,36939,3.738765182186235,20.0,20.0
39880,3,9880,[  7  97 194 357  88],379,4,36943,3.738791620281348,20.0,0.0
39881,3,9881,[ 79 191 597 546 202],279,2,36945,3.738615664845173,0.0,0.0
39882,3,9882,[597  79 655 234 357],774,0,36945,3.7382373773145807,20.0,0.0
39883,3,9883,[603 302 427 127  64],339,5,36950,3.738365034399029,20.0,20.0
39884,3,9884,[289  56 603  50 135],13,4,36954,3.7383915022761762,20.0,20.0
39885,3,9885,[185 111  88  64 276],145,3,36957,3.7383168116528425,0.0,0.0
39886,3,9886,[678  79 318  70 125],7,3,36960,3.7382421361383633,20.0,0.0
39887,3,9887,[117 483 174  28 175],207,3,36963,3.7381674757281553,20.0,20.0
39888,3,9888,[125 151 216  96 210],892,5,36968,3.7382950753362323,0.0,0.0
39889,3,9889,[603 302 427 127  64],339,5,36973,3.738422649140546,20.0,20.0
39890,3,9890,[603 302 427 127  64],669,5,36978,3.7385501971489234,20.0,20.0
39891,3,9891,[286  11 196 357 216],406,2,36980,3.7383744439951476,20.0,0.0
39892,3,9892,[238 405 294 275 282],145,3,36983,3.738299807945012,0.0,0.0
39893,3,9893,[127 328 187 117 194],749,4,36987,3.738326258338387,0.0,20.0
39894,3,9894,[385 127 313 216  79],64,5,36992,3.7384537645275393,0.0,20.0
39895,3,9895,[186 294 135 117  69],328,3,36995,3.7383791430881166,0.0,0.0
39896,3,9896,[258 423 515  69 121],207,4,36999,3.7384055774477116,0.0,0.0
39897,3,9897,[405 173 288 121 194],804,4,37003,3.7384320064659526,0.0,0.0
39898,3,9898,[153 135 185  88 132],452,2,37005,3.738256389534296,0.0,0.0
39899,3,9899,[197 153 151 174 234],374,4,37009,3.7382828282828284,0.0,20.0
39900,3,9900,[603 302 427 127  64],271,5,37014,3.7384102615897383,20.0,20.0
39901,3,9901,[ 89 135 403 235 211],339,3,37017,3.7383356897596447,0.0,0.0
39902,3,9902,[202 271  50 328 245],102,2,37019,3.738160153488842,0.0,20.0
39903,3,9903,[603 302 427 127  64],458,5,37024,3.738287560581583,20.0,20.0
39904,3,9904,[603 302 427 127  64],537,4,37028,3.738313982836951,20.0,20.0
39905,3,9905,[ 89 111  56  98  70],59,4,37032,3.7383403997577225,0.0,20.0
39906,3,9906,[508 301 294 235 100],378,3,37035,3.7382658726153224,0.0,20.0
39907,3,9907,[  1  82 173  12 435],454,1,37036,3.7379895034315704,20.0,0.0
39908,3,9908,[196  28 175 496 173],95,5,37041,3.738116863457463,0.0,0.0
39909,3,9909,[496  22  89 182   4],650,2,37043,3.737941473259334,0.0,0.0
39910,3,9910,[ 22 174 515  28  96],59,5,37048,3.7380688124306327,0.0,20.0
39911,3,9911,[ 12 196 197  64  22],537,1,37049,3.7377925746569813,20.0,0.0
39912,3,9912,[603 302 427 127  64],745,4,37053,3.737819025522042,20.0,20.0
39913,3,9913,[180  79 187  22  11],881,5,37058,3.7379463385111964,0.0,0.0
39914,3,9914,[603 302 427 127  64],669,5,37063,3.7380736258194656,20.0,20.0
39915,3,9915,[ 15 215 127 286 111],234,1,37064,3.737797498991529,0.0,20.0
39916,3,9916,[603 302 427 127  64],271,5,37069,3.7379247756377936,20.0,20.0
39917,3,9917,[153  12 357 210 597],7,4,37073,3.737951199838677,40.0,0.0
39918,3,9918,[475 228  96 385  95],92,4,37077,3.7379776187115636,0.0,0.0
39919,3,9919,[125  28  98 161 275],334,2,37079,3.7378024193548387,0.0,20.0
39920,3,9920,[603 302 427 127  64],666,5,37084,3.737929644189094,20.0,20.0
39921,3,9921,[  1 403 202 405 286],13,1,37085,3.7376536988510383,0.0,0.0
39922,3,9922,[151  11  71 125 423],892,3,37088,3.7375793610803183,0.0,0.0
39923,3,9923,[ 69 176 357 179 427],833,2,37090,3.737404272470778,20.0,0.0
39924,3,9924,[  8 175 385 313 515],92,5,37095,3.7375314861460955,0.0,0.0
39925,3,9925,[568 228 187 168 483],13,4,37099,3.737557928672174,20.0,0.0
39926,3,9926,[603 302 427 127  64],664,5,37104,3.737685101239045,20.0,20.0
39927,3,9927,[ 69 196 143 179 132],7,4,37108,3.7377115229653506,0.0,0.0
39928,3,9928,[ 79 405   1  71 204],648,4,37112,3.7377379393695236,0.0,0.0
39929,3,9929,[ 79 318  28  71   1],374,4,37116,3.737764350453172,20.0,0.0
39930,3,9930,[603 302 427 127  64],339,5,37121,3.7378914510119827,20.0,20.0
39931,3,9931,[ 50 118 282 176 172],42,4,37125,3.7379178413209826,0.0,20.0
39932,3,9932,[ 22  50 194 100 300],774,1,37126,3.7376422027584817,0.0,40.0
39933,3,9933,[125 515 195 185  12],311,4,37130,3.7376686128447756,20.0,0.0
39934,3,9934,[175 588 151  22 161],59,3,37133,3.7375943633618522,0.0,0.0
39935,3,9935,[  8 202 228  95  69],766,2,37135,3.7374194847020936,0.0,0.0
39936,3,9936,[ 28   1 187 588 289],537,1,37136,3.7371440072456474,0.0,0.0
39937,3,9937,[ 98  50   8 258 127],465,5,37141,3.737271080700342,0.0,60.0
39938,3,9938,[180 215 210 143  98],7,4,37145,3.7372975148405274,0.0,20.0
39939,3,9939,[  1 483 323 181 655],537,1,37146,3.7370221327967807,20.0,0.0
39940,3,9940,[302 435  97 286 289],615,4,37150,3.7370485866613015,0.0,0.0
39941,3,9941,[603 302 427 127  64],664,5,37155,3.737175618587809,20.0,20.0
39942,3,9942,[678 194 423 191 508],537,2,37157,3.7370009051594084,0.0,0.0
39943,3,9943,[ 71 143 210  98 678],648,3,37160,3.736926790024135,0.0,20.0
39944,3,9944,[186  11 200 655  98],7,4,37164,3.736953242835596,0.0,20.0
39945,3,9945,[185 405 238 546   1],82,1,37165,3.7366780615322743,0.0,0.0
39946,3,9946,[187 300 655 275  97],13,3,37168,3.736604001206394,0.0,0.0
39947,3,9947,[603 302 427 127  64],13,5,37173,3.7367310012062727,20.0,20.0
39948,3,9948,[ 28 742 195 100  69],458,3,37176,3.7366569504472813,0.0,20.0
39949,3,9949,[172 275 294 202 183],538,4,37180,3.7366834170854273,0.0,0.0
39950,3,9950,[121   7 168 185 496],7,5,37185,3.7368103708170035,0.0,0.0
39951,3,9951,[588 121 273 135 182],892,5,37190,3.73693729903537,0.0,0.0
39952,3,9952,[194 161 546 187 191],234,3,37193,3.736863257309354,0.0,0.0
39953,3,9953,[603 302 427 127  64],745,4,37197,3.736889692585895,20.0,20.0
39954,3,9954,[603 302 427 127  64],669,5,37202,3.737016574585635,20.0,20.0
39955,3,9955,[ 88  22 175 405 216],406,1,37203,3.7367416633186017,0.0,0.0
39956,3,9956,[603 302 427 127  64],458,5,37208,3.7368685346992065,20.0,20.0
39957,3,9957,[289  89 216 195 568],13,1,37209,3.7365936935127535,0.0,0.0
39958,3,9958,[603 302 427 127  64],90,5,37214,3.7367205542725173,20.0,20.0
39959,3,9959,[748  96 313 161 174],533,4,37218,3.736746987951807,0.0,20.0
39960,3,9960,[273 318 385 427 111],87,4,37222,3.736773416323662,20.0,0.0
39961,3,9961,[191 313 286 475 196],144,4,37226,3.736799839389681,0.0,0.0
39962,3,9962,[603 302 427 127  64],666,5,37231,3.7369266285255445,20.0,20.0
39963,3,9963,[143 405 135 265  98],334,2,37233,3.736752308309916,0.0,20.0
39964,3,9964,[183 234 483 318 258],474,5,37238,3.7368790767686906,40.0,0.0
39965,3,9965,[111 286 127 435 405],6,2,37240,3.7367047963074453,0.0,20.0
39966,3,9966,[144 265 742 195 151],298,3,37243,3.736630881910304,0.0,0.0
39967,3,9967,[603 302 427 127  64],664,5,37248,3.736757624398074,20.0,20.0
39968,3,9968,[265   8 121 195 186],25,5,37253,3.7368843414585213,0.0,0.0
39969,3,9969,[181  89  97 204 588],378,5,37258,3.737011033099298,0.0,0.0
39970,3,9970,[483 215   1  28 427],380,4,37262,3.737037408484605,20.0,0.0
39971,3,9971,[603 302 427 127  64],458,5,37267,3.7371640593662256,20.0,20.0
39972,3,9972,[197  69  88 405 216],537,1,37268,3.7368896019251983,0.0,0.0
39973,3,9973,[603 302 427 127  64],13,5,37273,3.7370162422297977,20.0,20.0
39974,3,9974,[603 302 427 127  64],669,5,37278,3.737142857142857,20.0,20.0
39975,3,9975,[ 56 588 185 234 427],406,5,37283,3.7372694466720127,0.0,0.0
39976,3,9976,[603 302 427 127  64],669,5,37288,3.7373960108248974,20.0,20.0
39977,3,9977,[194 234 257 385 357],95,4,37292,3.737422329124073,20.0,0.0
39978,3,9978,[435 234 153 546 496],666,4,37296,3.737448642148512,0.0,0.0
39979,3,9979,[180 168 194 678 300],749,4,37300,3.7374749498997994,0.0,0.0
39980,3,9980,[603 302 427 127  64],664,5,37305,3.7376014427412083,20.0,20.0
39981,3,9981,[ 15 318  82 132 186],313,2,37307,3.7374273692646764,20.0,0.0
39982,3,9982,[471  98 515  56  11],308,2,37309,3.7372533306621256,0.0,20.0
39983,3,9983,[655 286 273  96 111],666,2,37311,3.737079326923077,0.0,0.0
39984,3,9984,[ 11 357 211  22 471],271,4,37315,3.7371056584877316,20.0,0.0
39985,3,9985,[210 195 435 185 597],643,4,37319,3.7371319847786904,0.0,0.0
39986,3,9986,[603 302 427 127  64],339,5,37324,3.7372584359667567,20.0,20.0
39987,3,9987,[603 302 427 127  64],666,5,37329,3.737384861834201,20.0,20.0
39988,3,9988,[132 568 322 546 318],524,5,37334,3.7375112623886273,20.0,0.0
39989,3,9989,[282 301 234 200 294],378,2,37336,3.7373373373373373,0.0,0.0
39990,3,9990,[235 423 100  22 471],144,4,37340,3.7373636272645383,0.0,20.0
39991,3,9991,[ 97 168 294 301 603],650,2,37342,3.737189751801441,20.0,0.0
39992,3,9992,[125  82 143  22 202],378,3,37345,3.7371159811868306,0.0,0.0
39993,3,9993,[  1 294 111 143 121],374,2,37347,3.7369421652991797,0.0,0.0
39994,3,9994,[228 257 168 174 496],339,5,37352,3.7370685342671335,0.0,20.0
39995,3,9995,[603 302 427 127  64],669,5,37357,3.7371948779511803,20.0,20.0
39996,3,9996,[191 117  70  50 151],881,2,37359,3.7370211063318997,0.0,20.0
39997,3,9997,[121  28 265 471 173],95,4,37363,3.7370474094818964,0.0,0.0
39998,3,9998,[258 186  71 173  69],7,5,37368,3.737173717371737,0.0,0.0
39999,3,9999,[ 71 322  11 216 118],374,5,37373,3.7373,0.0,0.0
40000,4,0,[678 118  69  71 197],881,2,2,2.0,0.0,0.0
40001,4,1,[194 191 204  28  82],454,4,6,3.0,0.0,0.0
40002,4,2,[118 191  71  28  82],200,5,11,3.6666666666666665,0.0,0.0
40003,4,3,[118 191  71  28  82],738,3,14,3.5,0.0,0.0
40004,4,4,[191  28  82 204 118],804,5,19,3.8,0.0,0.0
40005,4,5,[191  28  82 204 118],290,4,23,3.8333333333333335,0.0,0.0
40006,4,6,[ 28  82 204 118 191],59,5,28,4.0,0.0,0.0
40007,4,7,[222 423  97 204 300],666,1,29,3.625,0.0,0.0
40008,4,8,[ 70 289 194 202  71],406,1,30,3.3333333333333335,0.0,0.0
40009,4,9,[483  22 143 176 182],313,3,33,3.3,20.0,0.0
40010,4,10,[483 176  28  82  97],398,5,38,3.4545454545454546,20.0,0.0
40011,4,11,[ 70 403  28 288 210],308,4,42,3.5,0.0,0.0
40012,4,12,[234 202 546  98 144],447,3,45,3.4615384615384617,0.0,20.0
40013,4,13,[ 98 210 288  97 182],533,2,47,3.357142857142857,0.0,20.0
40014,4,14,[  7 238 483  64 194],6,4,51,3.4,20.0,0.0
40015,4,15,[144 238 403  82 234],343,4,55,3.4375,0.0,0.0
40016,4,16,[144 238 403  82 176],543,4,59,3.4705882352941178,0.0,0.0
40017,4,17,[276 118 435 475 423],308,4,63,3.5,0.0,0.0
40018,4,18,[ 25  69 186 245  96],207,3,66,3.473684210526316,0.0,0.0
40019,4,19,[187 182 271 174 100],158,5,71,3.55,0.0,40.0
40020,4,20,[234 175 143 496 237],85,4,75,3.5714285714285716,0.0,0.0
40021,4,21,[210 234  56 655 742],804,4,79,3.590909090909091,0.0,0.0
40022,4,22,[197 135 144 172 322],454,2,81,3.5217391304347827,0.0,0.0
40023,4,23,[276 175 176 475  82],339,5,86,3.5833333333333335,0.0,0.0
40024,4,24,[276 175 176 475  82],10,4,90,3.6,0.0,0.0
40025,4,25,[216 195 186 175 471],308,3,93,3.576923076923077,0.0,0.0
40026,4,26,[276 100 475  82 742],308,5,98,3.6296296296296298,0.0,20.0
40027,4,27,[276 100 475  82 742],334,4,102,3.642857142857143,0.0,20.0
40028,4,28,[276 435 475  82 187],207,2,104,3.586206896551724,0.0,0.0
40029,4,29,[222 100  71 187 265],830,3,107,3.566666666666667,0.0,20.0
40030,4,30,[655 483  64 174 210],488,3,110,3.5483870967741935,20.0,20.0
40031,4,31,[182  82 202 186 275],95,2,112,3.5,0.0,0.0
40032,4,32,[195 144 186 435 265],326,4,116,3.515151515151515,0.0,0.0
40033,4,33,[ 70 258  11  28 222],334,3,119,3.5,0.0,0.0
40034,4,34,[216  69 655 483  56],13,4,123,3.5142857142857142,20.0,0.0
40035,4,35,[ 95 357 328 125 603],804,4,127,3.5277777777777777,40.0,0.0
40036,4,36,[ 28 273 186 181 328],833,0,127,3.4324324324324325,0.0,0.0
40037,4,37,[ 64  15 172 168 200],374,2,129,3.3947368421052633,0.0,0.0
40038,4,38,[151  11 276 275   9],82,3,132,3.3846153846153846,0.0,0.0
40039,4,39,[258 182 603 265 357],474,5,137,3.425,40.0,0.0
40040,4,40,[603 265 210  64 174],64,3,140,3.4146341463414633,20.0,20.0
40041,4,41,[ 96 153 143 100 427],527,4,144,3.4285714285714284,0.0,20.0
40042,4,42,[161 191 322 328  71],234,1,145,3.372093023255814,0.0,0.0
40043,4,43,[ 11 200 100 174  64],59,5,150,3.409090909090909,0.0,40.0
40044,4,44,[ 11 200 100 174  64],378,3,153,3.4,0.0,40.0
40045,4,45,[508 204 210  98 127],406,5,158,3.4347826086956523,0.0,40.0
40046,4,46,[191 268 405 180 153],6,3,161,3.425531914893617,0.0,0.0
40047,4,47,[423 191 276 286  50],537,3,164,3.4166666666666665,0.0,20.0
40048,4,48,[515  97 234  96  82],650,3,167,3.4081632653061225,0.0,0.0
40049,4,49,[568   1 174  98  15],200,5,172,3.44,0.0,40.0
40050,4,50,[180 127 100 357 176],325,4,176,3.450980392156863,20.0,40.0
40051,4,51,[ 50 187 151 132 183],6,4,180,3.4615384615384617,0.0,20.0
40052,4,52,[  9 100 508 265 180],343,4,184,3.4716981132075473,0.0,20.0
40053,4,53,[  9 100 127 180   1],881,4,188,3.4814814814814814,0.0,40.0
40054,4,54,[ 50 508 180   1 127],343,5,193,3.5090909090909093,0.0,40.0
40055,4,55,[ 50   7 294 385  95],95,3,196,3.5,0.0,20.0
40056,4,56,[  9 161  28 132 151],380,3,199,3.491228070175439,0.0,0.0
40057,4,57,[173 186  50  28 403],843,0,199,3.4310344827586206,0.0,20.0
40058,4,58,[  1  64 357 427 174],932,4,203,3.440677966101695,20.0,20.0
40059,4,59,[172 195 186 174 111],653,3,206,3.433333333333333,0.0,20.0
40060,4,60,[  1 183 357 427 174],398,5,211,3.459016393442623,20.0,20.0
40061,4,61,[  1 183 357 427 174],13,3,214,3.4516129032258065,20.0,20.0
40062,4,62,[222  56  25 405 294],804,4,218,3.4603174603174605,0.0,0.0
40063,4,63,[204  28 117 194 179],387,2,220,3.4375,0.0,0.0
40064,4,64,[168   8 202  22 179],7,4,224,3.4461538461538463,0.0,0.0
40065,4,65,[423  71 496 191 238],6,4,228,3.4545454545454546,0.0,0.0
40066,4,66,[237 597 282 235 135],328,1,229,3.417910447761194,0.0,0.0
40067,4,67,[ 97 161 222 144   4],378,3,232,3.411764705882353,0.0,0.0
40068,4,68,[276  22 175  95 100],334,4,236,3.420289855072464,0.0,20.0
40069,4,69,[508 195 174 132 271],13,2,238,3.4,0.0,20.0
40070,4,70,[174 515 180 125 127],59,4,242,3.408450704225352,0.0,40.0
40071,4,71,[427 515 180 100 496],6,5,247,3.4305555555555554,0.0,20.0
40072,4,72,[427 515 180 100 496],537,5,252,3.452054794520548,0.0,20.0
40073,4,73,[143 172 135 117 215],13,3,255,3.445945945945946,0.0,0.0
40074,4,74,[ 28 385  95 235   4],59,3,258,3.44,0.0,0.0
40075,4,75,[144  98 180 183 515],346,4,262,3.4473684210526314,0.0,20.0
40076,4,76,[216 405 195 202 300],749,4,266,3.4545454545454546,0.0,0.0
40077,4,77,[132 515 180 127 496],840,5,271,3.4743589743589745,0.0,20.0
40078,4,78,[132 515 180 127 496],474,5,276,3.4936708860759493,0.0,20.0
40079,4,79,[423 597 282 153   4],788,2,278,3.475,0.0,0.0
40080,4,80,[496 258 100 427 180],474,5,283,3.493827160493827,0.0,20.0
40081,4,81,[276 288 173 245 597],200,4,287,3.5,0.0,0.0
40082,4,82,[100 179 496 180 144],234,2,289,3.4819277108433737,0.0,20.0
40083,4,83,[568 496 174 427  25],42,4,293,3.488095238095238,0.0,20.0
40084,4,84,[200  15 300   1 135],311,5,298,3.5058823529411764,0.0,0.0
40085,4,85,[211 168  28 174 127],13,5,303,3.5232558139534884,0.0,40.0
40086,4,86,[216 100 151  71 210],234,1,304,3.4942528735632186,0.0,20.0
40087,4,87,[183 258 427 132 215],13,5,309,3.5113636363636362,0.0,0.0
40088,4,88,[  1 182 288  97  28],234,1,310,3.4831460674157304,0.0,0.0
40089,4,89,[ 15 258 423 508 313],533,5,315,3.5,0.0,0.0
40090,4,90,[  1 117 301 228 318],537,1,316,3.4725274725274726,20.0,0.0
40091,4,91,[568  96 100 322 204],263,4,320,3.4782608695652173,0.0,20.0
40092,4,92,[269  64 117 196 153],263,3,323,3.4731182795698925,0.0,0.0
40093,4,93,[183 515 100 132 318],380,5,328,3.4893617021276597,20.0,20.0
40094,4,94,[183 515 100 132 318],59,5,333,3.5052631578947366,20.0,20.0
40095,4,95,[183 515 100 132 318],13,3,336,3.5,20.0,20.0
40096,4,96,[313  50 496  97 127],64,4,340,3.5051546391752577,0.0,40.0
40097,4,97,[183 496 100 132 127],664,4,344,3.510204081632653,0.0,40.0
40098,4,98,[196 568 100 132 127],59,5,349,3.525252525252525,0.0,40.0
40099,4,99,[257  82  69  71 588],840,2,351,3.51,0.0,0.0
40100,4,100,[132 496 100 215 588],454,3,354,3.504950495049505,0.0,20.0
40101,4,101,[196 568 100 127 313],85,3,357,3.5,0.0,40.0
40102,4,102,[211 215 174 427 385],313,5,362,3.5145631067961167,0.0,20.0
40103,4,103,[ 56 333 204 187   1],13,3,365,3.5096153846153846,0.0,0.0
40104,4,104,[496 174 215 427 385],454,4,369,3.5142857142857142,0.0,20.0
40105,4,105,[515   7  96 405 161],643,3,372,3.509433962264151,0.0,0.0
40106,4,106,[ 64  15 132 275 143],308,3,375,3.5046728971962615,0.0,0.0
40107,4,107,[300 183  64 288 403],378,4,379,3.509259259259259,0.0,0.0
40108,4,108,[234 483 215 423 655],234,3,382,3.5045871559633026,20.0,0.0
40109,4,109,[496 427 174 127   8],87,5,387,3.518181818181818,0.0,40.0
40110,4,110,[197  64 174 427   8],899,5,392,3.5315315315315314,0.0,20.0
40111,4,111,[496 427 174 127   8],458,3,395,3.5267857142857144,0.0,40.0
40112,4,112,[427 127   8 211 269],6,5,400,3.5398230088495577,0.0,20.0
40113,4,113,[204 174 196 435 275],85,4,404,3.543859649122807,0.0,20.0
40114,4,114,[175 182 238  82 161],774,2,406,3.5304347826086957,0.0,0.0
40115,4,115,[172 603 204 127 210],848,4,410,3.5344827586206895,20.0,20.0
40116,4,116,[ 95 357 471 191 211],543,3,413,3.52991452991453,20.0,0.0
40117,4,117,[385 174 127 403 200],387,3,416,3.5254237288135593,0.0,40.0
40118,4,118,[172 228 151 222 185],524,1,417,3.504201680672269,0.0,0.0
40119,4,119,[427  11 194 245 603],454,2,419,3.4916666666666667,20.0,0.0
40120,4,120,[185 211 196   8 427],13,4,423,3.4958677685950414,0.0,0.0
40121,4,121,[  9 197 508 132 143],334,2,425,3.4836065573770494,0.0,0.0
40122,4,122,[ 82  96 286 357  22],650,2,427,3.4715447154471546,20.0,0.0
40123,4,123,[269 196 313 258   8],334,4,431,3.475806451612903,0.0,0.0
40124,4,124,[313 211 196   8 427],90,5,436,3.488,0.0,0.0
40125,4,125,[313 211 196   8 427],13,5,441,3.5,0.0,0.0
40126,4,126,[313 211 196   8 427],85,4,445,3.5039370078740157,0.0,0.0
40127,4,127,[228  69 173 182 515],892,4,449,3.5078125,0.0,0.0
40128,4,128,[211 196   8 313 258],13,5,454,3.5193798449612403,0.0,0.0
40129,4,129,[211 196   8 313 258],533,4,458,3.523076923076923,0.0,0.0
40130,4,130,[234 187  64 182   7],474,5,463,3.5343511450381677,0.0,0.0
40131,4,131,[ 82  50 174 655 117],738,3,466,3.5303030303030303,0.0,40.0
40132,4,132,[144 588  15 153  98],290,3,469,3.526315789473684,0.0,20.0
40133,4,133,[132 118 427 313 318],454,4,473,3.529850746268657,20.0,0.0
40134,4,134,[ 95 132 333  82 423],815,3,476,3.525925925925926,0.0,0.0
40135,4,135,[ 22 483 269 194 237],6,3,479,3.5220588235294117,20.0,0.0
40136,4,136,[258 211 313 196 100],64,4,483,3.5255474452554743,0.0,20.0
40137,4,137,[ 64  70 234 496 111],64,5,488,3.536231884057971,0.0,0.0
40138,4,138,[423 515 405 135 435],666,3,491,3.5323741007194243,0.0,0.0
40139,4,139,[313 211 196 100 174],934,4,495,3.5357142857142856,0.0,40.0
40140,4,140,[403 546 194 603 216],650,3,498,3.5319148936170213,20.0,0.0
40141,4,141,[288 294   4 222  15],554,2,500,3.5211267605633805,0.0,0.0
40142,4,142,[196 211 100 174 427],452,4,504,3.5244755244755246,0.0,40.0
40143,4,143,[121 161 180 196 181],59,4,508,3.5277777777777777,0.0,0.0
40144,4,144,[196 121 100 174 427],59,5,513,3.537931034482759,0.0,40.0
40145,4,145,[196 121 100 174 427],406,4,517,3.541095890410959,0.0,40.0
40146,4,146,[302  89   9 288 508],378,4,521,3.54421768707483,0.0,0.0
40147,4,147,[144 183 588  11  98],64,4,525,3.5472972972972974,0.0,20.0
40148,4,148,[175 185 195 186 153],833,3,528,3.5436241610738257,0.0,0.0
40149,4,149,[186  95  98 318 121],64,4,532,3.546666666666667,20.0,20.0
40150,4,150,[496 183 174  56 172],334,3,535,3.543046357615894,0.0,20.0
40151,4,151,[ 89 302 100 174 427],6,5,540,3.5526315789473686,0.0,40.0
40152,4,152,[185  64 196 471 269],13,2,542,3.542483660130719,0.0,0.0
40153,4,153,[161 183 204  56 179],194,4,546,3.5454545454545454,0.0,0.0
40154,4,154,[427 273  97  71 176],328,2,548,3.535483870967742,0.0,0.0
40155,4,155,[121  96 117  79 742],653,4,552,3.5384615384615383,0.0,0.0
40156,4,156,[273  89 546 183 211],102,2,554,3.5286624203821657,0.0,0.0
40157,4,157,[121 603  56  11 273],7,3,557,3.5253164556962027,20.0,0.0
40158,4,158,[ 79  89 302 100 174],271,4,561,3.5283018867924527,0.0,40.0
40159,4,159,[ 79 302 100 174 196],339,5,566,3.5375,0.0,40.0
40160,4,160,[294  95 235   9 678],648,1,567,3.5217391304347827,0.0,0.0
40161,4,161,[ 12 211 568 508 515],543,4,571,3.5246913580246915,20.0,0.0
40162,4,162,[ 79  12 302 100 174],207,3,574,3.521472392638037,20.0,40.0
40163,4,163,[ 79 302 174 196 127],669,2,576,3.5121951219512195,0.0,40.0
40164,4,164,[302 127 100 174 180],458,4,580,3.515151515151515,0.0,60.0
40165,4,165,[302 127 100 180 515],833,3,583,3.5120481927710845,0.0,40.0
40166,4,166,[127 100 180  64 427],537,4,587,3.5149700598802394,0.0,40.0
40167,4,167,[197 153 179 357 173],643,5,592,3.5238095238095237,20.0,0.0
40168,4,168,[176 385  22 132 168],311,5,597,3.532544378698225,0.0,0.0
40169,4,169,[181  70 318 125 176],374,3,600,3.5294117647058822,20.0,0.0
40170,4,170,[127 100 180 427 313],234,4,604,3.5321637426900585,0.0,40.0
40171,4,171,[127 100 427 313   8],334,5,609,3.5406976744186047,0.0,40.0
40172,4,172,[118 180  96 204  22],774,1,610,3.5260115606936417,0.0,0.0
40173,4,173,[323 215 187 228 568],897,5,615,3.5344827586206895,0.0,0.0
40174,4,174,[273  69 328 235 135],328,2,617,3.525714285714286,0.0,0.0
40175,4,175,[151 161 197   1 748],881,1,618,3.5113636363636362,0.0,0.0
40176,4,176,[286 182  96 282 385],328,2,620,3.5028248587570623,0.0,0.0
40177,4,177,[515  64 185  70 153],60,4,624,3.50561797752809,0.0,0.0
40178,4,178,[265 215 127   8 182],774,2,626,3.4972067039106145,0.0,20.0
40179,4,179,[175 271 174 286 302],883,3,629,3.4944444444444445,0.0,20.0
40180,4,180,[323 127 100 427 313],650,3,632,3.4917127071823204,0.0,40.0
40181,4,181,[  1  88 423 175 385],881,3,635,3.489010989010989,0.0,0.0
40182,4,182,[ 98 496 228 211  70],883,2,637,3.480874316939891,0.0,20.0
40183,4,183,[ 22 742 546 197   7],648,3,640,3.4782608695652173,0.0,0.0
40184,4,184,[  8 515 318 151  25],213,4,644,3.481081081081081,20.0,0.0
40185,4,185,[100 427 313 127 174],13,5,649,3.489247311827957,0.0,60.0
40186,4,186,[385 180  96 302 515],666,3,652,3.486631016042781,0.0,0.0
40187,4,187,[ 56 234  89 238 471],537,3,655,3.484042553191489,0.0,0.0
40188,4,188,[210 471 144  79 117],378,3,658,3.4814814814814814,0.0,0.0
40189,4,189,[ 98  22 282  88 302],207,3,661,3.4789473684210526,0.0,20.0
40190,4,190,[ 25 515 118  88  97],145,3,664,3.4764397905759163,0.0,0.0
40191,4,191,[100 313 427 127 174],85,3,667,3.4739583333333335,0.0,60.0
40192,4,192,[385 234 204 194  70],533,4,671,3.476683937823834,0.0,0.0
40193,4,193,[313 100 127 174 191],271,5,676,3.484536082474227,0.0,60.0
40194,4,194,[313 100 127 174 191],650,4,680,3.4871794871794872,0.0,60.0
40195,4,195,[117 568  82 185   1],643,3,683,3.4846938775510203,0.0,0.0
40196,4,196,[289 282 202 294 215],554,3,686,3.482233502538071,0.0,0.0
40197,4,197,[  8 187 118 174 228],774,1,687,3.4696969696969697,0.0,20.0
40198,4,198,[200 588  69 111  96],95,3,690,3.4673366834170856,0.0,0.0
40199,4,199,[313 100 191 302 427],13,4,694,3.47,0.0,20.0
40200,4,200,[215 257 191 655 182],454,3,697,3.4676616915422884,0.0,0.0
40201,4,201,[313 100 302 427 180],380,4,701,3.4702970297029703,0.0,20.0
40202,4,202,[  4 100 265 245 288],533,1,702,3.458128078817734,0.0,20.0
40203,4,203,[135 313  12 288 427],334,4,706,3.4607843137254903,20.0,0.0
40204,4,204,[174 194 196 222  69],85,4,710,3.4634146341463414,0.0,20.0
40205,4,205,[238 194 186  15 180],271,4,714,3.466019417475728,0.0,0.0
40206,4,206,[117 132  22 423 357],311,5,719,3.473429951690821,20.0,0.0
40207,4,207,[313 100 302 427 196],537,4,723,3.4759615384615383,0.0,20.0
40208,4,208,[ 88 323 153 216 286],13,2,725,3.4688995215311005,0.0,0.0
40209,4,209,[748 323 143 210 186],311,2,727,3.461904761904762,0.0,0.0
40210,4,210,[210 195 100 173 204],650,4,731,3.4644549763033177,0.0,20.0
40211,4,211,[313 100 302 427 174],90,5,736,3.4716981132075473,0.0,40.0
40212,4,212,[197  28 135 265 318],804,4,740,3.4741784037558685,20.0,0.0
40213,4,213,[313 100 302 427 174],454,5,745,3.4813084112149535,0.0,40.0
40214,4,214,[181 204  89 302  98],380,3,748,3.4790697674418603,0.0,20.0
40215,4,215,[  1 100  71   7 215],59,3,751,3.4768518518518516,0.0,20.0
40216,4,216,[ 70 185 210  96 118],882,4,755,3.47926267281106,0.0,0.0
40217,4,217,[172 121 423 135  95],843,1,756,3.467889908256881,0.0,0.0
40218,4,218,[313 100 302 427 174],14,4,760,3.470319634703196,0.0,40.0
40219,4,219,[302 100 427 313 174],13,5,765,3.477272727272727,0.0,40.0
40220,4,220,[228 200 191 294 257],95,3,768,3.475113122171946,0.0,0.0
40221,4,221,[302 100 313 427 174],14,4,772,3.4774774774774775,0.0,40.0
40222,4,222,[216  69 427 174  96],899,4,776,3.4798206278026904,0.0,20.0
40223,4,223,[302 100 427 174 276],334,5,781,3.486607142857143,0.0,40.0
40224,4,224,[196  12 168 174 194],537,1,782,3.4755555555555557,20.0,20.0
40225,4,225,[195  25  89  95 238],537,2,784,3.4690265486725664,0.0,0.0
40226,4,226,[302 100 427 276 357],339,5,789,3.4757709251101323,20.0,20.0
40227,4,227,[302 100 427 276 357],458,4,793,3.4780701754385963,20.0,20.0
40228,4,228,[302 100 427 276 127],537,5,798,3.48471615720524,0.0,40.0
40229,4,229,[302 100 427 276 127],537,5,803,3.491304347826087,0.0,40.0
40230,4,230,[216  56 172 496 118],308,2,805,3.484848484848485,0.0,0.0
40231,4,231,[288 127 211 269 183],537,2,807,3.478448275862069,0.0,20.0
40232,4,232,[168  64 245 405 257],749,3,810,3.476394849785408,0.0,0.0
40233,4,233,[302 100 427 276 127],90,5,815,3.482905982905983,0.0,40.0
40234,4,234,[222 211 678 483 174],749,3,818,3.480851063829787,20.0,20.0
40235,4,235,[183  79 597 471 117],13,1,819,3.4703389830508473,0.0,0.0
40236,4,236,[302 100 276 427 127],339,5,824,3.476793248945148,0.0,40.0
40237,4,237,[135 269 161 313 435],934,3,827,3.4747899159663866,0.0,0.0
40238,4,238,[483 168 222 300 200],380,3,830,3.4728033472803346,20.0,0.0
40239,4,239,[742 215 678 118 151],804,4,834,3.475,0.0,0.0
40240,4,240,[222 174 210 135 568],524,2,836,3.4688796680497926,0.0,20.0
40241,4,241,[302 100 276 427 127],334,5,841,3.475206611570248,0.0,40.0
40242,4,242,[302 100 276 427 127],13,5,846,3.4814814814814814,0.0,40.0
40243,4,243,[135 265   7 258 151],537,3,849,3.4795081967213113,0.0,0.0
40244,4,244,[204  12 235 210 121],271,3,852,3.477551020408163,20.0,0.0
40245,4,245,[180 588 144 204  95],387,1,853,3.467479674796748,0.0,0.0
40246,4,246,[179 234 191   1 153],934,2,855,3.4615384615384617,0.0,0.0
40247,4,247,[302 100 276 427 127],343,5,860,3.467741935483871,0.0,40.0
40248,4,248,[186 515 127 135 204],85,4,864,3.4698795180722892,0.0,20.0
40249,4,249,[ 56   1 172 191 302],537,3,867,3.468,0.0,0.0
40250,4,250,[ 56 357 257 286   8],474,4,871,3.4701195219123506,20.0,0.0
40251,4,251,[ 56  70  97 568 257],213,4,875,3.4722222222222223,0.0,0.0
40252,4,252,[172  79 222 153 333],313,3,878,3.4703557312252964,0.0,0.0
40253,4,253,[515  64 118 132 187],804,5,883,3.4763779527559056,0.0,0.0
40254,4,254,[ 69 182 496 181 215],892,5,888,3.4823529411764707,0.0,0.0
40255,4,255,[302 100 276 427 127],13,5,893,3.48828125,0.0,40.0
40256,4,256,[302 100 276 427 127],271,4,897,3.490272373540856,0.0,40.0
40257,4,257,[216 202 197 234   4],374,3,900,3.488372093023256,0.0,0.0
40258,4,258,[181 151 216 195 210],308,4,904,3.4903474903474905,0.0,0.0
40259,4,259,[  7  56 483 172 185],524,3,907,3.4884615384615385,20.0,0.0
40260,4,260,[302 100 427 127 276],474,5,912,3.4942528735632186,0.0,40.0
40261,4,261,[183 515 427 176 118],7,2,914,3.4885496183206106,0.0,0.0
40262,4,262,[ 98 127 235 258 197],650,2,916,3.482889733840304,0.0,40.0
40263,4,263,[194 405 179  79  28],458,3,919,3.481060606060606,0.0,0.0
40264,4,264,[125 357  95 204 265],200,5,924,3.486792452830189,20.0,0.0
40265,4,265,[176 191 111 302 742],334,2,926,3.481203007518797,0.0,0.0
40266,4,266,[186 496  50 271 173],749,5,931,3.48689138576779,0.0,20.0
40267,4,267,[194 195 234 328 185],102,1,932,3.4776119402985075,0.0,0.0
40268,4,268,[302 100 427 276 127],458,5,937,3.483271375464684,0.0,40.0
40269,4,269,[403 234 515 471 197],543,4,941,3.4851851851851854,0.0,0.0
40270,4,270,[302 100 427 276 127],13,5,946,3.4907749077490773,0.0,40.0
40271,4,271,[ 88 172 197   9 144],883,5,951,3.4963235294117645,0.0,0.0
40272,4,272,[  1 357 228 125  95],398,4,955,3.498168498168498,20.0,0.0
40273,4,273,[302 100 427 276 127],90,5,960,3.5036496350364965,0.0,40.0
40274,4,274,[ 97 151 185 385 182],95,3,963,3.501818181818182,0.0,0.0
40275,4,275,[194  22 182   8 197],144,4,967,3.503623188405797,0.0,0.0
40276,4,276,[471 117  89  69 269],90,3,970,3.5018050541516246,0.0,0.0
40277,4,277,[302 100 427 276 127],339,5,975,3.5071942446043165,0.0,40.0
40278,4,278,[ 28  69 385 289   8],378,4,979,3.5089605734767026,0.0,0.0
40279,4,279,[302 100 427 276 127],537,5,984,3.5142857142857142,0.0,40.0
40280,4,280,[181 211 313 273 111],537,2,986,3.508896797153025,0.0,0.0
40281,4,281,[597 289  95 202 282],374,3,989,3.50709219858156,0.0,0.0
40282,4,282,[302 100 427 276 127],474,5,994,3.512367491166078,0.0,40.0
40283,4,283,[179 222 273 257  11],92,4,998,3.5140845070422535,0.0,0.0
40284,4,284,[186 742 475   8  11],308,5,1003,3.519298245614035,0.0,0.0
40285,4,285,[302 100 427 276 127],13,5,1008,3.5244755244755246,0.0,40.0
40286,4,286,[180  98  22 471 222],378,2,1010,3.519163763066202,0.0,20.0
40287,4,287,[  1 173 228 265 197],64,4,1014,3.5208333333333335,0.0,0.0
40288,4,288,[161 181 200 121 403],334,3,1017,3.519031141868512,0.0,0.0
40289,4,289,[302 100 427 276 127],343,5,1022,3.524137931034483,0.0,40.0
40290,4,290,[265  96 357 180  50],666,2,1024,3.5189003436426116,20.0,20.0
40291,4,291,[302 100 427 276 127],474,5,1029,3.5239726027397262,0.0,40.0
40292,4,292,[174 235 204  79 168],13,3,1032,3.522184300341297,0.0,20.0
40293,4,293,[ 25 275 405 175 210],537,2,1034,3.5170068027210886,0.0,0.0
40294,4,294,[302 100 427 276 127],90,5,1039,3.522033898305085,0.0,40.0
40295,4,295,[405 118 211   7 144],194,2,1041,3.516891891891892,0.0,0.0
40296,4,296,[172 222   1 151 118],380,2,1043,3.5117845117845117,0.0,0.0
40297,4,297,[216 748  97 100 235],328,1,1044,3.5033557046979866,0.0,20.0
40298,4,298,[235 282   8  95   7],334,3,1047,3.5016722408026757,0.0,0.0
40299,4,299,[135   1 265 508 222],653,3,1050,3.5,0.0,0.0
40300,4,300,[302 100 427 276 127],664,5,1055,3.504983388704319,0.0,40.0
40301,4,301,[302 100 427 276 127],474,5,1060,3.5099337748344372,0.0,40.0
40302,4,302,[204  64 172 173   8],7,5,1065,3.514851485148515,0.0,0.0
40303,4,303,[ 97 144  89 234 568],543,3,1068,3.513157894736842,0.0,0.0
40304,4,304,[210  88 323 118 168],897,4,1072,3.5147540983606556,0.0,0.0
40305,4,305,[302 100 427 276 127],458,5,1077,3.519607843137255,0.0,40.0
40306,4,306,[100 132 301 228  71],13,4,1081,3.521172638436482,0.0,20.0
40307,4,307,[215 191  88 204  71],200,5,1086,3.5259740259740258,0.0,0.0
40308,4,308,[176 313 121 328  28],533,4,1090,3.527508090614887,0.0,0.0
40309,4,309,[302 100 427 276 127],745,3,1093,3.5258064516129033,0.0,40.0
40310,4,310,[597 603  28 568 135],59,4,1097,3.527331189710611,20.0,0.0
40311,4,311,[302 100 427 276 127],271,4,1101,3.5288461538461537,0.0,40.0
40312,4,312,[ 64 385  22 191 237],474,5,1106,3.533546325878594,0.0,0.0
40313,4,313,[302 100 427 127 191],339,5,1111,3.538216560509554,0.0,40.0
40314,4,314,[183 181 195 176 172],536,3,1114,3.5365079365079364,0.0,0.0
40315,4,315,[135  98 183 185 742],59,4,1118,3.537974683544304,0.0,20.0
40316,4,316,[302 100 427 127 191],334,5,1123,3.5425867507886437,0.0,40.0
40317,4,317,[435 216 222 135 286],474,5,1128,3.547169811320755,0.0,0.0
40318,4,318,[302 100 427 127 191],615,4,1132,3.54858934169279,0.0,40.0
40319,4,319,[483  11 235 678 100],804,5,1137,3.553125,20.0,20.0
40320,4,320,[302 427 100 191 127],615,4,1141,3.554517133956386,0.0,40.0
40321,4,321,[174  95 211 405 185],313,3,1144,3.5527950310559007,0.0,20.0
40322,4,322,[302 427 100 191 127],271,5,1149,3.557275541795666,0.0,40.0
40323,4,323,[174 197 568 196 475],90,4,1153,3.558641975308642,0.0,20.0
40324,4,324,[515 196  98 245 237],455,3,1156,3.556923076923077,0.0,20.0
40325,4,325,[302 427 100 191 127],458,5,1161,3.561349693251534,0.0,40.0
40326,4,326,[385 187 435 151 117],524,2,1163,3.5565749235474007,0.0,0.0
40327,4,327,[176  79 135  64 405],378,3,1166,3.5548780487804876,0.0,0.0
40328,4,328,[423 183 181 313 318],234,4,1170,3.556231003039514,20.0,0.0
40329,4,329,[302 427 100 191 127],90,5,1175,3.5606060606060606,0.0,40.0
40330,4,330,[302 427 100 191 127],666,5,1180,3.5649546827794563,0.0,40.0
40331,4,331,[302 427 100 191 127],14,4,1184,3.566265060240964,0.0,40.0
40332,4,332,[143 197 318  56 195],653,3,1187,3.5645645645645647,20.0,0.0
40333,4,333,[174 187 568 237  12],892,5,1192,3.568862275449102,20.0,20.0
40334,4,334,[ 82 237 603 181 200],334,5,1197,3.573134328358209,20.0,0.0
40335,4,335,[269 423 143 176 257],650,3,1200,3.5714285714285716,0.0,0.0
40336,4,336,[215 135 357 186 118],892,4,1204,3.572700296735905,20.0,0.0
40337,4,337,[269  11 235 475  96],119,4,1208,3.57396449704142,0.0,0.0
40338,4,338,[ 79 435  64 257   7],883,5,1213,3.578171091445428,0.0,0.0
40339,4,339,[302 427 100 191 483],343,5,1218,3.5823529411764707,20.0,20.0
40340,4,340,[  9 191  95  70 187],234,2,1220,3.5777126099706744,0.0,0.0
40341,4,341,[302 427 100 191 483],474,5,1225,3.58187134502924,20.0,20.0
40342,4,342,[194 588 483  89  69],892,5,1230,3.58600583090379,20.0,0.0
40343,4,343,[215 288 153  50  12],643,4,1234,3.5872093023255816,20.0,20.0
40344,4,344,[427  28 211 181 475],533,4,1238,3.588405797101449,0.0,0.0
40345,4,345,[185 323 183   8 238],883,5,1243,3.592485549132948,0.0,0.0
40346,4,346,[318  56 175 403 197],804,3,1246,3.590778097982709,20.0,0.0
40347,4,347,[  8  82 191 257 435],840,3,1249,3.589080459770115,0.0,0.0
40348,4,348,[302 427 100 191 483],537,5,1254,3.5931232091690544,20.0,20.0
40349,4,349,[265  71 181 195 385],279,3,1257,3.5914285714285716,0.0,0.0
40350,4,350,[302 427 100 191 483],454,4,1261,3.5925925925925926,20.0,20.0
40351,4,351,[302 427 100 191 127],339,5,1266,3.596590909090909,0.0,40.0
40352,4,352,[385 125 483  70 172],892,4,1270,3.5977337110481584,20.0,0.0
40353,4,353,[322 748  64 195  69],524,2,1272,3.593220338983051,0.0,0.0
40354,4,354,[302 427 100 191 127],343,5,1277,3.5971830985915494,0.0,40.0
40355,4,355,[286  50  28 144 183],648,4,1281,3.598314606741573,0.0,20.0
40356,4,356,[302 427 100 191 127],343,5,1286,3.6022408963585435,0.0,40.0
40357,4,357,[302 427 100 191 127],833,3,1289,3.600558659217877,0.0,40.0
40358,4,358,[202 191 323   8  98],311,4,1293,3.6016713091922004,0.0,20.0
40359,4,359,[302 427 191 100 127],537,5,1298,3.6055555555555556,0.0,40.0
40360,4,360,[302 427 191 100 127],271,5,1303,3.6094182825484764,0.0,40.0
40361,4,361,[289  56 257 237 211],474,3,1306,3.6077348066298343,0.0,0.0
40362,4,362,[302 427 191 100 127],458,5,1311,3.6115702479338845,0.0,40.0
40363,4,363,[183 195 357 132 174],91,4,1315,3.6126373626373627,20.0,20.0
40364,4,364,[357 427 483  56 276],234,3,1318,3.610958904109589,40.0,0.0
40365,4,365,[302 427 191 100 127],537,5,1323,3.6147540983606556,0.0,40.0
40366,4,366,[302 427 191 100 127],474,5,1328,3.6185286103542236,0.0,40.0
40367,4,367,[258  15 202 515 125],313,2,1330,3.614130434782609,0.0,0.0
40368,4,368,[180   8 173  64   1],95,4,1334,3.6151761517615175,0.0,0.0
40369,4,369,[ 50 186 181 180 196],666,1,1335,3.608108108108108,0.0,20.0
40370,4,370,[302 427 191 100 127],458,5,1340,3.6118598382749325,0.0,40.0
40371,4,371,[175 234  96  89 168],308,4,1344,3.6129032258064515,0.0,0.0
40372,4,372,[302 427 191 100 127],343,5,1349,3.616621983914209,0.0,40.0
40373,4,373,[302 427 191 100 127],14,4,1353,3.6176470588235294,0.0,40.0
40374,4,374,[176 118 100 172  96],650,5,1358,3.6213333333333333,0.0,20.0
40375,4,375,[302 427 191 100 211],666,5,1363,3.625,0.0,20.0
40376,4,376,[  4  11 202  50 222],653,1,1364,3.618037135278515,0.0,20.0
40377,4,377,[237  56 568 144 210],13,3,1367,3.6164021164021163,0.0,0.0
40378,4,378,[328 127 186 427 301],334,2,1369,3.612137203166227,0.0,20.0
40379,4,379,[302 427 191 100 211],474,5,1374,3.6157894736842104,0.0,20.0
40380,4,380,[ 25 515 423  69 191],200,5,1379,3.6194225721784776,0.0,0.0
40381,4,381,[180  15 515 151 172],59,5,1384,3.6230366492146597,0.0,0.0
40382,4,382,[597 135 275  96 143],7,3,1387,3.6214099216710185,0.0,0.0
40383,4,383,[302 191 427 100 211],339,5,1392,3.625,0.0,20.0
40384,4,384,[ 79  11 603 185 172],804,5,1397,3.6285714285714286,20.0,0.0
40385,4,385,[302 191 427 100 211],537,5,1402,3.6321243523316062,0.0,20.0
40386,4,386,[302 191 427 100 211],339,5,1407,3.635658914728682,0.0,20.0
40387,4,387,[ 98 211 546 180 435],804,3,1410,3.634020618556701,0.0,20.0
40388,4,388,[275 603  69 748 180],899,3,1413,3.632390745501285,20.0,0.0
40389,4,389,[143 427   9 475 603],527,3,1416,3.6307692307692307,20.0,0.0
40390,4,390,[258 546 135  50 176],7,4,1420,3.631713554987212,0.0,20.0
40391,4,391,[318 237 323 216 435],804,4,1424,3.63265306122449,20.0,0.0
40392,4,392,[385 176 191 475 175],92,5,1429,3.6361323155216283,0.0,0.0
40393,4,393,[  8  69 568 235 405],901,3,1432,3.6345177664974617,0.0,0.0
40394,4,394,[301 211 187 176 515],666,5,1437,3.6379746835443036,0.0,0.0
40395,4,395,[302 191 427 100 211],339,5,1442,3.6414141414141414,0.0,20.0
40396,4,396,[161   9 215 222 483],328,3,1445,3.6397984886649875,20.0,0.0
40397,4,397,[222  95   7  98  70],334,3,1448,3.6381909547738696,0.0,20.0
40398,4,398,[302 191 427 100 211],14,5,1453,3.6416040100250626,0.0,20.0
40399,4,399,[302 191 427 100 211],271,5,1458,3.645,0.0,20.0
40400,4,400,[196 210 235 546 211],87,3,1461,3.6433915211970076,0.0,0.0
40401,4,401,[211 483 322 222 269],524,4,1465,3.644278606965174,20.0,0.0
40402,4,402,[588  97 191 121 176],664,1,1466,3.6377171215880892,0.0,0.0
40403,4,403,[302 427 100 191 211],13,4,1470,3.6386138613861387,0.0,20.0
40404,4,404,[302 427 100 211 191],666,5,1475,3.6419753086419755,0.0,20.0
40405,4,405,[302 427 100 211 191],666,5,1480,3.645320197044335,0.0,20.0
40406,4,406,[143  28 403 294 182],194,2,1482,3.6412776412776413,0.0,0.0
40407,4,407,[  9 515  56  11 245],90,4,1486,3.642156862745098,0.0,0.0
40408,4,408,[302 427 100 211 191],90,5,1491,3.645476772616137,0.0,20.0
40409,4,409,[127 268 185 237  25],537,3,1494,3.6439024390243904,0.0,20.0
40410,4,410,[302 427 100 211 191],615,4,1498,3.6447688564476888,0.0,20.0
40411,4,411,[302 427 100 211 191],833,2,1500,3.6407766990291264,0.0,20.0
40412,4,412,[302 427 100 191 211],6,5,1505,3.6440677966101696,0.0,20.0
40413,4,413,[288 204  79  69 483],234,2,1507,3.640096618357488,20.0,0.0
40414,4,414,[200  79 121 186 210],537,1,1508,3.633734939759036,0.0,0.0
40415,4,415,[588  71   8 216 144],64,3,1511,3.6322115384615383,0.0,0.0
40416,4,416,[186  95 423 181 268],387,1,1512,3.6258992805755397,0.0,0.0
40417,4,417,[302 427 100 191 211],6,5,1517,3.6291866028708135,0.0,20.0
40418,4,418,[302 273 508 357  82],537,3,1520,3.627684964200477,20.0,0.0
40419,4,419,[678 176 194 427 496],339,4,1524,3.6285714285714286,0.0,0.0
40420,4,420,[302 427 100 191 211],6,5,1529,3.6318289786223277,0.0,20.0
40421,4,421,[302 427 100 191 211],454,4,1533,3.632701421800948,0.0,20.0
40422,4,422,[200 322 127 435 100],328,4,1537,3.6335697399527187,0.0,40.0
40423,4,423,[211 174 568   9 179],749,4,1541,3.634433962264151,0.0,20.0
40424,4,424,[546 197 151 143 435],881,2,1543,3.6305882352941174,0.0,0.0
40425,4,425,[302 427 100 191 603],271,5,1548,3.6338028169014085,20.0,20.0
40426,4,426,[ 79  12 385 100 294],474,4,1552,3.6346604215456675,20.0,20.0
40427,4,427,[153 269 357 121 257],666,3,1555,3.633177570093458,20.0,0.0
40428,4,428,[ 28 132 185 286 483],881,3,1558,3.6317016317016315,20.0,0.0
40429,4,429,[211 655 127 385 273],328,3,1561,3.630232558139535,0.0,20.0
40430,4,430,[268 121 173 423 333],387,1,1562,3.6241299303944317,0.0,0.0
40431,4,431,[185  89 597 273 234],59,3,1565,3.622685185185185,0.0,0.0
40432,4,432,[175  97 328 258 111],378,3,1568,3.6212471131639723,0.0,0.0
40433,4,433,[302 427 100 191 603],458,5,1573,3.6244239631336406,20.0,20.0
40434,4,434,[210 197 185 168   4],543,3,1576,3.6229885057471263,0.0,0.0
40435,4,435,[405 568 403 210 483],194,1,1577,3.61697247706422,20.0,0.0
40436,4,436,[173 508 403 175   9],334,4,1581,3.6178489702517163,0.0,0.0
40437,4,437,[302 427 100 191 603],454,5,1586,3.6210045662100456,20.0,20.0
40438,4,438,[302 427 100 191 603],13,4,1590,3.621867881548975,20.0,20.0
40439,4,439,[302 427 100 603 191],90,5,1595,3.625,20.0,20.0
40440,4,440,[228 125  79 191 202],881,4,1599,3.6258503401360542,0.0,0.0
40441,4,441,[121   8 357  64 187],194,3,1602,3.6244343891402715,20.0,0.0
40442,4,442,[289 546 313 471 435],455,3,1605,3.6230248306997743,0.0,0.0
40443,4,443,[302 427 100 603 191],666,5,1610,3.626126126126126,20.0,20.0
40444,4,444,[180 185  88 235  22],479,4,1614,3.6269662921348313,0.0,0.0
40445,4,445,[179 300 153 234 286],85,3,1617,3.625560538116592,0.0,0.0
40446,4,446,[597 135 333 286 471],653,4,1621,3.626398210290828,0.0,0.0
40447,4,447,[135 302 168 238 286],474,4,1625,3.627232142857143,0.0,0.0
40448,4,448,[238 215 216  70 180],271,5,1630,3.6302895322939865,0.0,0.0
40449,4,449,[288 483 121 175 427],339,3,1633,3.628888888888889,20.0,0.0
40450,4,450,[302 427 100 603 191],474,5,1638,3.631929046563193,20.0,20.0
40451,4,451,[302 427 100 603 191],14,5,1643,3.6349557522123894,20.0,20.0
40452,4,452,[168 228 496 289  98],524,1,1644,3.629139072847682,0.0,20.0
40453,4,453,[235 179  89 222  64],64,4,1648,3.6299559471365637,0.0,0.0
40454,4,454,[210 222 322  50  71],474,5,1653,3.632967032967033,0.0,20.0
40455,4,455,[302 427 100 603 191],537,5,1658,3.6359649122807016,20.0,20.0
40456,4,456,[ 71 603  69 195 172],42,5,1663,3.638949671772429,20.0,0.0
40457,4,457,[302 427 100 603 191],271,5,1668,3.6419213973799125,20.0,20.0
40458,4,458,[161 151 100 187 175],59,4,1672,3.6427015250544663,0.0,20.0
40459,4,459,[ 50 183 186 588 143],194,2,1674,3.639130434782609,0.0,20.0
40460,4,460,[515  98 174 228 403],890,4,1678,3.6399132321041217,0.0,40.0
40461,4,461,[235  25 508  79 405],82,0,1678,3.632034632034632,0.0,0.0
40462,4,462,[ 88   7  70 238 496],643,2,1680,3.6285097192224622,0.0,0.0
40463,4,463,[302 427 100 603 191],90,5,1685,3.6314655172413794,20.0,20.0
40464,4,464,[328 269  82  79  98],488,4,1689,3.632258064516129,0.0,20.0
40465,4,465,[496 191 173 168 202],295,5,1694,3.6351931330472103,0.0,0.0
40466,4,466,[197 289 195  12 176],10,5,1699,3.6381156316916488,20.0,0.0
40467,4,467,[173 121 181   1  70],194,2,1701,3.6346153846153846,0.0,0.0
40468,4,468,[302 427 603 100 191],537,5,1706,3.6375266524520256,20.0,20.0
40469,4,469,[302 427 603 100 191],271,5,1711,3.6404255319148935,20.0,20.0
40470,4,470,[302 427 603 100 191],13,4,1715,3.641188959660297,20.0,20.0
40471,4,471,[  8 175 286 181 161],479,3,1718,3.639830508474576,0.0,0.0
40472,4,472,[179 182 265  25 238],59,5,1723,3.6427061310782243,0.0,0.0
40473,4,473,[191 181  96 118 135],892,5,1728,3.6455696202531644,0.0,0.0
40474,4,474,[302 603 427 100 191],334,5,1733,3.648421052631579,20.0,20.0
40475,4,475,[111 603 216  70   4],666,3,1736,3.6470588235294117,20.0,0.0
40476,4,476,[289 258   7 181 100],234,2,1738,3.643605870020964,0.0,20.0
40477,4,477,[496 183 385 197  98],648,4,1742,3.6443514644351462,0.0,20.0
40478,4,478,[483 423 211 168 546],533,4,1746,3.6450939457202507,20.0,0.0
40479,4,479,[302 603 427 100 191],339,5,1751,3.6479166666666667,20.0,20.0
40480,4,480,[127 121 258 144 196],749,4,1755,3.6486486486486487,0.0,20.0
40481,4,481,[483 357  28 174 118],694,5,1760,3.6514522821576763,40.0,20.0
40482,4,482,[125  82 187 144 328],207,2,1762,3.648033126293996,0.0,0.0
40483,4,483,[234 174 196 181 403],92,5,1767,3.6508264462809916,0.0,20.0
40484,4,484,[ 15 222 202 210 275],14,4,1771,3.6515463917525772,0.0,0.0
40485,4,485,[ 25 144 181  28 435],843,0,1771,3.6440329218106995,0.0,0.0
40486,4,486,[302 603 427 100 191],664,4,1775,3.64476386036961,20.0,20.0
40487,4,487,[302 603 427 100 173],334,5,1780,3.6475409836065573,20.0,20.0
40488,4,488,[302 603 427 100 173],474,5,1785,3.6503067484662575,20.0,20.0
40489,4,489,[288  96 405 127 568],643,4,1789,3.6510204081632653,0.0,20.0
40490,4,490,[  8 597  15 269 161],207,3,1792,3.64969450101833,0.0,0.0
40491,4,491,[ 11 403 175   4 172],881,2,1794,3.6463414634146343,0.0,0.0
40492,4,492,[132 276 183 289 471],234,3,1797,3.6450304259634887,0.0,0.0
40493,4,493,[302 603 427 100 173],537,5,1802,3.6477732793522266,20.0,20.0
40494,4,494,[302 603 427 100 173],454,4,1806,3.6484848484848484,20.0,20.0
40495,4,495,[176 483  64 100  50],343,5,1811,3.651209677419355,20.0,40.0
40496,4,496,[302 603 427 100 483],458,5,1816,3.653923541247485,40.0,20.0
40497,4,497,[175   9 405 265 161],60,5,1821,3.6566265060240966,0.0,0.0
40498,4,498,[117 135 328  71 288],92,3,1824,3.655310621242485,0.0,0.0
40499,4,499,[302 603 427 100 483],454,4,1828,3.656,40.0,20.0
40500,4,500,[ 95 471 257 183 181],378,4,1832,3.656686626746507,0.0,0.0
40501,4,501,[322 202 427 423  97],374,2,1834,3.653386454183267,0.0,0.0
40502,4,502,[180 161 179 183 197],650,2,1836,3.650099403578529,0.0,0.0
40503,4,503,[117 172 268 234 235],537,1,1837,3.6448412698412698,0.0,0.0
40504,4,504,[302 603 100 427 191],339,5,1842,3.6475247524752477,20.0,20.0
40505,4,505,[302 603 100 427 191],474,5,1847,3.650197628458498,20.0,20.0
40506,4,506,[187 179 228 185 173],194,4,1851,3.6508875739644973,0.0,0.0
40507,4,507,[405 300 603 183 655],64,2,1853,3.6476377952755907,20.0,0.0
40508,4,508,[302 100 427 603 191],454,5,1858,3.650294695481336,20.0,20.0
40509,4,509,[181 222  95 211  88],13,4,1862,3.6509803921568627,0.0,0.0
40510,4,510,[302 100 427 603 191],339,5,1867,3.6536203522504893,20.0,20.0
40511,4,511,[121 258  71 161 603],533,5,1872,3.65625,20.0,0.0
40512,4,512,[302 100 427 603 191],474,5,1877,3.658869395711501,20.0,20.0
40513,4,513,[273 265 175 117 144],346,5,1882,3.6614785992217898,0.0,0.0
40514,4,514,[678 294 357 204 186],648,2,1884,3.658252427184466,20.0,0.0
40515,4,515,[153 216 174 196 183],479,4,1888,3.6589147286821704,0.0,20.0
40516,4,516,[748 265 118 275 153],648,4,1892,3.6595744680851063,0.0,0.0
40517,4,517,[ 95 151 211 385 187],650,2,1894,3.6563706563706564,0.0,0.0
40518,4,518,[302 100 427 603 191],339,5,1899,3.658959537572254,20.0,20.0
40519,4,519,[135 180 288 127  22],339,4,1903,3.6596153846153845,0.0,20.0
40520,4,520,[271 185 180 121 273],749,4,1907,3.6602687140115164,0.0,0.0
40521,4,521,[328 403 143 322 385],13,0,1907,3.653256704980843,0.0,0.0
40522,4,522,[ 89 186 235 322  97],804,5,1912,3.655831739961759,0.0,0.0
40523,4,523,[186   8 603 276  69],334,3,1915,3.654580152671756,20.0,0.0
40524,4,524,[121  69 172   9 318],92,4,1919,3.6552380952380954,20.0,0.0
40525,4,525,[508 237  71 273 175],378,5,1924,3.6577946768060836,0.0,0.0
40526,4,526,[302 100 427 603 191],454,5,1929,3.6603415559772294,20.0,20.0
40527,4,527,[161  11 196  96 182],387,2,1931,3.6571969696969697,0.0,0.0
40528,4,528,[302 100 427 603 191],454,5,1936,3.659735349716446,20.0,20.0
40529,4,529,[  1 182  22 286  97],13,3,1939,3.658490566037736,0.0,0.0
40530,4,530,[546 234 197   8 286],455,4,1943,3.659133709981168,0.0,0.0
40531,4,531,[302 100 427 603 191],13,4,1947,3.6597744360902253,20.0,20.0
40532,4,532,[183 100 748 200 132],804,4,1951,3.6604127579737336,0.0,20.0
40533,4,533,[302 100 427 603 211],90,5,1956,3.662921348314607,20.0,20.0
40534,4,534,[568 496 237   8 357],882,5,1961,3.6654205607476635,20.0,0.0
40535,4,535,[216  82 238 655  11],334,4,1965,3.666044776119403,0.0,0.0
40536,4,536,[269 333 237 322 289],894,2,1967,3.6629422718808193,0.0,0.0
40537,4,537,[515   7  89 603 179],643,4,1971,3.663568773234201,20.0,0.0
40538,4,538,[302 100 427 603 211],537,5,1976,3.666048237476809,20.0,20.0
40539,4,539,[ 28 176 215 100 294],406,2,1978,3.662962962962963,0.0,20.0
40540,4,540,[ 25   1 211 185  11],82,3,1981,3.6617375231053604,0.0,0.0
40541,4,541,[385 288 357 234 180],804,4,1985,3.662361623616236,20.0,0.0
40542,4,542,[215 182 475 300   1],533,3,1988,3.6611418047882136,0.0,0.0
40543,4,543,[228 186 111 235 202],537,1,1989,3.65625,0.0,0.0
40544,4,544,[234 655  69 742 496],308,2,1991,3.6532110091743117,0.0,0.0
40545,4,545,[228 258 179 238 202],343,5,1996,3.6556776556776556,0.0,0.0
40546,4,546,[423 181 117 286 183],378,4,2000,3.656307129798903,0.0,0.0
40547,4,547,[302 100 603 427 211],454,4,2004,3.656934306569343,20.0,20.0
40548,4,548,[302 100 603 427 191],339,5,2009,3.6593806921675776,20.0,20.0
40549,4,549,[302 100 603 427 191],334,5,2014,3.6618181818181816,20.0,20.0
40550,4,550,[179 202 196 313 228],92,4,2018,3.6624319419237747,0.0,0.0
40551,4,551,[222 300 655 174  82],234,0,2018,3.6557971014492754,0.0,20.0
40552,4,552,[127  71 257   7 235],804,4,2022,3.6564195298372515,0.0,20.0
40553,4,553,[185 265 423 202 210],543,3,2025,3.655234657039711,0.0,0.0
40554,4,554,[302 100 603 427 191],458,5,2030,3.6576576576576576,20.0,20.0
40555,4,555,[ 79 161 328  88 235],378,4,2034,3.658273381294964,0.0,0.0
40556,4,556,[  9 187 546  69   4],234,3,2037,3.657091561938959,0.0,0.0
40557,4,557,[302 100 603 427 191],271,5,2042,3.6594982078853047,20.0,20.0
40558,4,558,[302 100 603 427 191],14,5,2047,3.6618962432915922,20.0,20.0
40559,4,559,[222 185  12 196 546],194,2,2049,3.6589285714285715,20.0,0.0
40560,4,560,[302 100 603 427 191],334,5,2054,3.661319073083779,20.0,20.0
40561,4,561,[ 71 204 435  50 288],378,4,2058,3.6619217081850532,0.0,20.0
40562,4,562,[302 100 603 427 191],454,5,2063,3.664298401420959,20.0,20.0
40563,4,563,[175 257 183 200 385],804,4,2067,3.6648936170212765,0.0,0.0
40564,4,564,[235 237  71 132 427],308,2,2069,3.661946902654867,0.0,0.0
40565,4,565,[302 603 100 427 191],90,5,2074,3.664310954063604,20.0,20.0
40566,4,566,[ 50 179 197 117 385],899,3,2077,3.6631393298059964,0.0,20.0
40567,4,567,[302 423 515  70 271],328,4,2081,3.663732394366197,0.0,0.0
40568,4,568,[258 234 153 204  71],378,5,2086,3.6660808435852372,0.0,0.0
40569,4,569,[427   7  25 483 265],308,3,2089,3.6649122807017545,20.0,0.0
40570,4,570,[302 603 100 427 191],666,5,2094,3.6672504378283715,20.0,20.0
40571,4,571,[302 603 100 427 191],537,5,2099,3.6695804195804196,20.0,20.0
40572,4,572,[143 357 210 187 135],650,3,2102,3.668411867364747,20.0,0.0
40573,4,573,[204  22 234 215 427],536,5,2107,3.6707317073170733,0.0,0.0
40574,4,574,[546 168 286 568   7],650,2,2109,3.667826086956522,0.0,0.0
40575,4,575,[ 28 121 135 211 427],59,5,2114,3.670138888888889,0.0,0.0
40576,4,576,[258 127 197 173 333],85,3,2117,3.6689774696707107,0.0,20.0
40577,4,577,[210 496 655 180 195],7,5,2122,3.671280276816609,0.0,0.0
40578,4,578,[423 168 508 182 597],653,1,2123,3.6666666666666665,0.0,0.0
40579,4,579,[302 603 100 427 191],664,4,2127,3.6672413793103447,20.0,20.0
40580,4,580,[385  82 222 237 282],804,5,2132,3.6695352839931155,0.0,0.0
40581,4,581,[302 603 100 427 191],90,5,2137,3.6718213058419242,20.0,20.0
40582,4,582,[258 748 385 333 144],653,3,2140,3.6706689536878216,0.0,0.0
40583,4,583,[153 210 186  50 202],650,3,2143,3.6695205479452055,0.0,20.0
40584,4,584,[204 288  28 144 228],648,5,2148,3.6717948717948716,0.0,0.0
40585,4,585,[302 603 100 427 191],14,5,2153,3.674061433447099,20.0,20.0
40586,4,586,[125 118 111 288 183],92,2,2155,3.6712095400340714,0.0,0.0
40587,4,587,[ 50 143 187 258 195],653,3,2158,3.6700680272108843,0.0,20.0
40588,4,588,[127 168  70 271 313],334,3,2161,3.66893039049236,0.0,20.0
40589,4,589,[215  98 294  71  28],648,2,2163,3.666101694915254,0.0,20.0
40590,4,590,[302 603 100 427 191],474,5,2168,3.6683587140439933,20.0,20.0
40591,4,591,[302 603 100 427 191],666,5,2173,3.670608108108108,20.0,20.0
40592,4,592,[302 603 100 427 191],13,4,2177,3.6711635750421587,20.0,20.0
40593,4,593,[180  88 181  96 275],308,5,2182,3.6734006734006734,0.0,0.0
40594,4,594,[197  15 132 483  82],184,3,2185,3.672268907563025,20.0,0.0
40595,4,595,[197 182 385 183 435],474,5,2190,3.674496644295302,0.0,0.0
40596,4,596,[302 603 100 427 191],271,5,2195,3.676716917922948,20.0,20.0
40597,4,597,[ 71 204 187 237 183],313,4,2199,3.677257525083612,0.0,0.0
40598,4,598,[302 603 100 427 191],14,5,2204,3.679465776293823,20.0,20.0
40599,4,599,[ 96  64 180   8 187],892,5,2209,3.6816666666666666,0.0,0.0
40600,4,600,[302 603 100 427 191],537,5,2214,3.6838602329450914,20.0,20.0
40601,4,601,[515 238 200 269 182],537,3,2217,3.6827242524916945,0.0,0.0
40602,4,602,[302 603 100 427 191],537,5,2222,3.684908789386401,20.0,20.0
40603,4,603,[302 603 100 427 191],90,5,2227,3.687086092715232,20.0,20.0
40604,4,604,[ 98 118 100  97 427],194,3,2230,3.6859504132231407,0.0,40.0
40605,4,605,[168 403 748 216 202],543,3,2233,3.684818481848185,0.0,0.0
40606,4,606,[235 748 173  79 111],648,4,2237,3.685337726523888,0.0,0.0
40607,4,607,[302 603 100 427 191],666,5,2242,3.6875,20.0,20.0
40608,4,608,[496 405 273 172 271],537,1,2243,3.683087027914614,0.0,0.0
40609,4,609,[265  96  89 191 748],13,4,2247,3.683606557377049,0.0,0.0
40610,4,610,[117 186 168 196 121],537,2,2249,3.6808510638297873,0.0,0.0
40611,4,611,[ 71 179 117 238 182],406,3,2252,3.679738562091503,0.0,0.0
40612,4,612,[127 196 174 216 222],479,4,2256,3.6802610114192498,0.0,40.0
40613,4,613,[144 405 273   1   8],13,2,2258,3.6775244299674266,0.0,0.0
40614,4,614,[187 195  64 588 182],313,5,2263,3.6796747967479675,0.0,0.0
40615,4,615,[273  89 742 222  56],897,2,2265,3.676948051948052,0.0,0.0
40616,4,616,[302 603 100 427 127],271,5,2270,3.679092382495948,20.0,40.0
40617,4,617,[302 603 100 427 127],474,5,2275,3.6812297734627832,20.0,40.0
40618,4,618,[235 588 195 143 215],882,4,2279,3.6817447495961226,0.0,0.0
40619,4,619,[132 144 117 276 222],339,3,2282,3.6806451612903226,0.0,0.0
40620,4,620,[302 603 100 427 127],458,5,2287,3.682769726247987,20.0,40.0
40621,4,621,[ 89 211 286 197   7],653,2,2289,3.680064308681672,0.0,0.0
40622,4,622,[234  50 265 181   8],7,4,2293,3.680577849117175,0.0,20.0
40623,4,623,[302 603 100 427 127],745,4,2297,3.6810897435897436,20.0,40.0
40624,4,624,[302 603 100 427 191],474,5,2302,3.6832,20.0,20.0
40625,4,625,[ 12 204  79 275 186],308,5,2307,3.6853035143769968,20.0,0.0
40626,4,626,[357 286 483 121  64],380,3,2310,3.6842105263157894,40.0,0.0
40627,4,627,[194 228 238 185 151],380,3,2313,3.68312101910828,0.0,0.0
40628,4,628,[302 603 100 427 191],13,4,2317,3.68362480127186,20.0,20.0
40629,4,629,[423  50   1 427  79],6,3,2320,3.6825396825396823,0.0,20.0
40630,4,630,[423 427 153 238  50],343,5,2325,3.6846275752773376,0.0,20.0
40631,4,631,[597 515 655   1  22],308,3,2328,3.6835443037974684,0.0,0.0
40632,4,632,[435 127 288 161 275],533,4,2332,3.684044233807267,0.0,20.0
40633,4,633,[237 385  70 276  15],537,2,2334,3.6813880126182967,0.0,0.0
40634,4,634,[435 176 568 204  12],13,3,2337,3.6803149606299215,20.0,0.0
40635,4,635,[127 216 318 475 435],537,3,2340,3.6792452830188678,20.0,20.0
40636,4,636,[ 89 238 211 568 195],387,4,2344,3.6797488226059656,0.0,0.0
40637,4,637,[197 215  22 265 176],653,2,2346,3.677115987460815,0.0,0.0
40638,4,638,[257 125 313 173 271],144,4,2350,3.677621283255086,0.0,0.0
40639,4,639,[302 603 100 427 127],745,4,2354,3.678125,20.0,40.0
40640,4,640,[302 603 100 427 174],271,5,2359,3.6801872074882995,20.0,40.0
40641,4,641,[117 275 181   1 222],378,3,2362,3.6791277258566977,0.0,0.0
40642,4,642,[  7 117 294 176  11],308,3,2365,3.6780715396578536,0.0,0.0
40643,4,643,[  9 294  79 135   8],82,3,2368,3.6770186335403725,0.0,0.0
40644,4,644,[403   7 144 215   1],295,5,2373,3.6790697674418604,0.0,0.0
40645,4,645,[423 135 211  70 237],328,4,2377,3.679566563467492,0.0,0.0
40646,4,646,[302 603 100 427 174],537,4,2381,3.6800618238021636,20.0,40.0
40647,4,647,[176 127 204 175  96],833,3,2384,3.6790123456790123,0.0,20.0
40648,4,648,[302 603 100 427 191],666,5,2389,3.6810477657935285,20.0,20.0
40649,4,649,[588 546 118 265 237],882,4,2393,3.6815384615384614,0.0,0.0
40650,4,650,[268 257 508 125 328],637,1,2394,3.6774193548387095,0.0,0.0
40651,4,651,[132 161 204 265 215],313,5,2399,3.6794478527607364,0.0,0.0
40652,4,652,[322 117  98 289 235],374,3,2402,3.678407350689127,0.0,20.0
40653,4,653,[302 603 100 427 191],664,4,2406,3.6788990825688073,20.0,20.0
40654,4,654,[508 195 235 515 127],537,3,2409,3.6778625954198474,0.0,20.0
40655,4,655,[ 22 185 234 179 216],59,5,2414,3.6798780487804876,0.0,0.0
40656,4,656,[  8  96 204 183 132],7,5,2419,3.6818873668188736,0.0,0.0
40657,4,657,[302 603 100 427 127],339,5,2424,3.683890577507599,20.0,40.0
40658,4,658,[125 257 302 179 197],334,4,2428,3.684370257966616,0.0,0.0
40659,4,659,[302 603 100 427 127],339,5,2433,3.6863636363636365,20.0,40.0
40660,4,660,[276 161 496 423 603],643,4,2437,3.686838124054463,20.0,0.0
40661,4,661,[302 603 100 427 127],90,5,2442,3.688821752265861,20.0,40.0
40662,4,662,[302 603 100 427 127],664,5,2447,3.69079939668175,20.0,40.0
40663,4,663,[172 194 276 471 117],194,1,2448,3.6867469879518073,0.0,0.0
40664,4,664,[302 603 100 427 127],537,5,2453,3.688721804511278,20.0,40.0
40665,4,665,[302 603 100 427 127],458,5,2458,3.690690690690691,20.0,40.0
40666,4,666,[ 70  96 211 161 302],102,0,2458,3.685157421289355,0.0,0.0
40667,4,667,[216 234  25  97 121],308,1,2459,3.681137724550898,0.0,0.0
40668,4,668,[357 153 483 333 100],328,3,2462,3.680119581464873,40.0,20.0
40669,4,669,[603 302 100 427 127],745,4,2466,3.680597014925373,20.0,40.0
40670,4,670,[172   9  97 245  98],455,4,2470,3.6810730253353205,0.0,20.0
40671,4,671,[318   9 117 200 175],234,2,2472,3.6785714285714284,20.0,0.0
40672,4,672,[132 258 273 294 117],13,2,2474,3.676077265973254,0.0,0.0
40673,4,673,[211   7   9  89 202],7,4,2478,3.6765578635014835,0.0,0.0
40674,4,674,[117 423 121  96 318],346,5,2483,3.6785185185185183,20.0,0.0
40675,4,675,[194  28 222  89 180],897,5,2488,3.6804733727810652,0.0,0.0
40676,4,676,[603 302 100 427 191],339,5,2493,3.682422451994092,20.0,20.0
40677,4,677,[ 88 182 179 234 180],378,3,2496,3.6814159292035398,0.0,0.0
40678,4,678,[161 235 197  98 132],378,4,2500,3.681885125184094,0.0,20.0
40679,4,679,[603 302 100 427 191],334,5,2505,3.6838235294117645,20.0,20.0
40680,4,680,[603 302 100 427 191],537,5,2510,3.68575624082232,20.0,20.0
40681,4,681,[603 302 100 427 191],664,4,2514,3.686217008797654,20.0,20.0
40682,4,682,[197  71  89 603 111],474,5,2519,3.6881405563689604,20.0,0.0
40683,4,683,[194 742 182 318 143],59,2,2521,3.685672514619883,20.0,0.0
40684,4,684,[ 96 222 132 176 265],200,5,2526,3.6875912408759124,0.0,0.0
40685,4,685,[ 98 237 471 546 211],533,3,2529,3.686588921282799,0.0,20.0
40686,4,686,[194  56   8  69 237],313,2,2531,3.6841339155749635,0.0,0.0
40687,4,687,[121  89 194 176 135],339,4,2535,3.684593023255814,0.0,0.0
40688,4,688,[196 276  12 216 181],398,4,2539,3.6850507982583456,20.0,0.0
40689,4,689,[151  64 288 655 423],666,2,2541,3.6826086956521737,0.0,0.0
40690,4,690,[228 216 118 132 238],804,5,2546,3.6845151953690305,0.0,0.0
40691,4,691,[173 234 275 288 179],648,5,2551,3.6864161849710984,0.0,0.0
40692,4,692,[144 216 153 200  97],378,4,2555,3.686868686868687,0.0,0.0
40693,4,693,[ 50 222  25 100  79],313,3,2558,3.685878962536023,0.0,40.0
40694,4,694,[603 302 100 427 357],474,5,2563,3.6877697841726618,40.0,20.0
40695,4,695,[ 28 215 234 185 194],653,1,2564,3.6839080459770117,0.0,0.0
40696,4,696,[132 100 546 183 222],447,3,2567,3.682926829268293,0.0,20.0
40697,4,697,[603 302 100 427 357],537,5,2572,3.684813753581662,40.0,20.0
40698,4,698,[603 302 100 427 357],271,5,2577,3.686695278969957,40.0,20.0
40699,4,699,[603 302 100 427 357],458,4,2581,3.6871428571428573,40.0,20.0
40700,4,700,[603 302 100 427 127],339,5,2586,3.689015691868759,20.0,40.0
40701,4,701,[603 302 100 427 127],13,5,2591,3.690883190883191,20.0,40.0
40702,4,702,[ 97  71 172 187 191],64,3,2594,3.689900426742532,0.0,0.0
40703,4,703,[211  88  22 100 187],533,5,2599,3.6917613636363638,0.0,20.0
40704,4,704,[132 257 151 427  50],334,4,2603,3.692198581560284,0.0,20.0
40705,4,705,[603 302 100 427 127],13,5,2608,3.6940509915014164,20.0,40.0
40706,4,706,[603 302 100 427 127],334,5,2613,3.695898161244696,20.0,40.0
40707,4,707,[ 71   8 237  98 121],882,5,2618,3.6977401129943503,0.0,20.0
40708,4,708,[427 357 117 323 186],328,3,2621,3.696755994358251,20.0,0.0
40709,4,709,[427 210 215  22 323],537,1,2622,3.692957746478873,0.0,0.0
40710,4,710,[603 302 100 427 127],664,5,2627,3.6947960618846696,20.0,40.0
40711,4,711,[385 508 286 151 181],537,1,2628,3.691011235955056,0.0,0.0
40712,4,712,[603 302 100 427 127],339,5,2633,3.6928471248246844,20.0,40.0
40713,4,713,[603 302 100 427 127],745,4,2637,3.69327731092437,20.0,40.0
40714,4,714,[603 302 100 427  98],537,4,2641,3.6937062937062937,20.0,40.0
40715,4,715,[196  98 318  97 385],538,4,2645,3.6941340782122905,20.0,20.0
40716,4,716,[204 273   1 405 200],479,5,2650,3.695955369595537,0.0,0.0
40717,4,717,[ 22 678 151 179 191],7,4,2654,3.6963788300835656,0.0,0.0
40718,4,718,[276  15 655 117  50],406,4,2658,3.6968011126564675,0.0,20.0
40719,4,719,[234 294 588 211 222],406,3,2661,3.6958333333333333,0.0,0.0
40720,4,720,[318  22  28  64 117],271,4,2665,3.69625520110957,20.0,0.0
40721,4,721,[153 385  88 127 161],650,2,2667,3.693905817174515,0.0,20.0
40722,4,722,[197 204 235 300 258],378,4,2671,3.69432918395574,0.0,0.0
40723,4,723,[603 302 100 427 191],454,5,2676,3.696132596685083,20.0,20.0
40724,4,724,[603 302 100 427 191],271,5,2681,3.6979310344827585,20.0,20.0
40725,4,725,[238 515 118 161 427],308,2,2683,3.6955922865013773,0.0,0.0
40726,4,726,[603 302 100 427 191],537,5,2688,3.6973865199449794,20.0,20.0
40727,4,727,[603 302 100 427 191],334,5,2693,3.6991758241758244,20.0,20.0
40728,4,728,[ 89 195 423 588 161],85,3,2696,3.6982167352537725,0.0,0.0
40729,4,729,[300 742 603 655 238],666,3,2699,3.697260273972603,20.0,0.0
40730,4,730,[237 197 496 328  28],85,3,2702,3.6963064295485637,0.0,0.0
40731,4,731,[603 302 100 427 191],666,5,2707,3.698087431693989,20.0,20.0
40732,4,732,[603 302 100 427 191],90,5,2712,3.699863574351978,20.0,20.0
40733,4,733,[603 302 100 427 191],666,5,2717,3.7016348773841963,20.0,20.0
40734,4,734,[603 302 100 427 191],90,5,2722,3.7034013605442175,20.0,20.0
40735,4,735,[176 181 357 183 328],13,2,2724,3.7010869565217392,20.0,0.0
40736,4,736,[603 302 100 427 191],454,5,2729,3.7028493894165537,20.0,20.0
40737,4,737,[546  69  89 175 423],92,3,2732,3.7018970189701896,0.0,0.0
40738,4,738,[603 302 100 427 191],90,5,2737,3.7036535859269284,20.0,20.0
40739,4,739,[603 302 100 427 191],334,5,2742,3.7054054054054055,20.0,20.0
40740,4,740,[271 117 403 405 385],738,1,2743,3.7017543859649122,0.0,0.0
40741,4,741,[603 302 100 427 191],664,4,2747,3.702156334231806,20.0,20.0
40742,4,742,[121 168   4  56 196],881,1,2748,3.6985195154777926,0.0,0.0
40743,4,743,[132  22  70 202 174],234,2,2750,3.696236559139785,0.0,20.0
40744,4,744,[228  64 289  50 173],883,5,2755,3.697986577181208,0.0,20.0
40745,4,745,[603 302 100 427 191],666,5,2760,3.6997319034852545,20.0,20.0
40746,4,746,[143 111  12 100   4],474,5,2765,3.7014725568942435,20.0,20.0
40747,4,747,[603 302 100 427 191],339,5,2770,3.7032085561497325,20.0,20.0
40748,4,748,[588  79   1 121  28],13,3,2773,3.7022696929238985,0.0,0.0
40749,4,749,[275 318  70 197   7],64,4,2777,3.7026666666666666,20.0,0.0
40750,4,750,[195  79 121 132 144],95,4,2781,3.70306258322237,0.0,0.0
40751,4,751,[195 323 202  82 111],648,5,2786,3.7047872340425534,0.0,0.0
40752,4,752,[ 82 234  11 180 215],804,5,2791,3.7065073041168657,0.0,0.0
40753,4,753,[603 302 100 427 191],334,5,2796,3.7082228116710874,20.0,20.0
40754,4,754,[216 202  70 313  97],184,3,2799,3.7072847682119203,0.0,0.0
40755,4,755,[161 100 234 153  97],738,4,2803,3.7076719576719577,0.0,20.0
40756,4,756,[603 302 100 427 191],537,5,2808,3.7093791281373845,20.0,20.0
40757,4,757,[603 302 100 427 191],271,5,2813,3.7110817941952505,20.0,20.0
40758,4,758,[216 471  50 176 427],666,3,2816,3.710144927536232,0.0,20.0
40759,4,759,[ 50 258 275 288 405],7,4,2820,3.710526315789474,0.0,20.0
40760,4,760,[174 282  97  64 216],374,5,2825,3.712220762155059,0.0,20.0
40761,4,761,[228 172 191 186 173],804,5,2830,3.713910761154856,0.0,0.0
40762,4,762,[405 144 357 322 238],488,1,2831,3.710353866317169,20.0,0.0
40763,4,763,[603 302 100 427 191],664,4,2835,3.7107329842931938,20.0,20.0
40764,4,764,[427 322 271   9 301],788,2,2837,3.708496732026144,0.0,0.0
40765,4,765,[151 269 125 258 328],334,2,2839,3.706266318537859,0.0,0.0
40766,4,766,[603 302 100 427 191],537,5,2844,3.707953063885267,20.0,20.0
40767,4,767,[ 82 168 197 181  15],452,4,2848,3.7083333333333335,0.0,0.0
40768,4,768,[603 302 100 427 191],271,5,2853,3.7100130039011705,20.0,20.0
40769,4,769,[603 302 100 427 191],454,5,2858,3.7116883116883117,20.0,20.0
40770,4,770,[183 211 405 175  22],788,4,2862,3.7120622568093387,0.0,0.0
40771,4,771,[405 655 132 322 588],13,3,2865,3.711139896373057,0.0,0.0
40772,4,772,[603 302 100 427 191],537,5,2870,3.7128072445019407,20.0,20.0
40773,4,773,[748 471 200 215 135],313,3,2873,3.7118863049095605,0.0,0.0
40774,4,774,[603 302 100 427 191],13,4,2877,3.712258064516129,20.0,20.0
40775,4,775,[603 302 100 427 313],334,5,2882,3.713917525773196,20.0,20.0
40776,4,776,[603 302 100 427 313],334,5,2887,3.7155727155727156,20.0,20.0
40777,4,777,[603 302 100 427 313],271,5,2892,3.717223650385604,20.0,20.0
40778,4,778,[ 25   9 238 294 289],474,3,2895,3.7163029525032094,0.0,0.0
40779,4,779,[546   9  98 423  50],648,4,2899,3.716666666666667,0.0,40.0
40780,4,780,[603 302 100 427 313],454,5,2904,3.7183098591549295,20.0,20.0
40781,4,781,[603 302 100 427 313],383,4,2908,3.7186700767263425,20.0,20.0
40782,4,782,[603 302 100 427 191],14,5,2913,3.7203065134099615,20.0,20.0
40783,4,783,[ 70 273 286 186 187],13,2,2915,3.7181122448979593,0.0,0.0
40784,4,784,[318   1  70 357 403],804,4,2919,3.7184713375796177,40.0,0.0
40785,4,785,[  8 385  22 181 196],13,4,2923,3.71882951653944,0.0,0.0
40786,4,786,[202 175 568  50 228],738,4,2927,3.719186785260483,0.0,20.0
40787,4,787,[288   9 423 176 235],374,2,2929,3.717005076142132,0.0,0.0
40788,4,788,[216 235  22 483  88],194,2,2931,3.714828897338403,20.0,0.0
40789,4,789,[546 515 222 210  11],92,4,2935,3.7151898734177213,0.0,0.0
40790,4,790,[423   7 197 238  97],189,4,2939,3.7155499367888747,0.0,0.0
40791,4,791,[603 302 100 427 191],474,5,2944,3.717171717171717,20.0,20.0
40792,4,792,[215 216 135  95 568],42,5,2949,3.7187894073139973,0.0,0.0
40793,4,793,[603 302 100 427 191],666,5,2954,3.720403022670025,20.0,20.0
40794,4,794,[603 302 100 427 191],334,5,2959,3.722012578616352,20.0,20.0
40795,4,795,[187 211 174 183   1],537,2,2961,3.719849246231156,0.0,20.0
40796,4,796,[ 22 234   8 197 132],536,4,2965,3.7202007528230867,0.0,0.0
40797,4,797,[211  71 173 273 151],479,4,2969,3.7205513784461153,0.0,0.0
40798,4,798,[508 127 546 238 185],13,1,2970,3.7171464330413015,0.0,20.0
40799,4,799,[ 70 234 143 603 427],13,3,2973,3.71625,20.0,0.0
40800,4,800,[603 302 100 427 211],90,5,2978,3.717852684144819,20.0,20.0
40801,4,801,[286 222  79  50 179],380,3,2981,3.7169576059850375,0.0,20.0
40802,4,802,[ 89 301 275 597 238],145,4,2985,3.717310087173101,0.0,0.0
40803,4,803,[403 273 181 183 211],102,1,2986,3.7139303482587063,0.0,0.0
40804,4,804,[405 172   9 194 655],328,4,2990,3.7142857142857144,0.0,0.0
40805,4,805,[ 71 403 204 265 143],374,3,2993,3.7133995037220844,0.0,0.0
40806,4,806,[603 302 100 427 191],664,4,2997,3.7137546468401488,20.0,20.0
40807,4,807,[153 100 742 200 179],378,3,3000,3.712871287128713,0.0,20.0
40808,4,808,[173 180  64 194 289],387,2,3002,3.710754017305315,0.0,0.0
40809,4,809,[121 257 597   7  64],653,3,3005,3.7098765432098766,0.0,0.0
40810,4,810,[ 89 301 168 195 289],524,3,3008,3.7090012330456226,0.0,0.0
40811,4,811,[269 191 288  12  89],537,2,3010,3.706896551724138,20.0,0.0
40812,4,812,[423 144 153 742  22],543,1,3011,3.7035670356703565,0.0,0.0
40813,4,813,[603 302 100 427  89],454,4,3015,3.703931203931204,20.0,20.0
40814,4,814,[176 144 216 161 257],653,1,3016,3.7006134969325153,0.0,0.0
40815,4,815,[196 111  56 313 300],13,4,3020,3.700980392156863,0.0,0.0
40816,4,816,[546   8 282 135 234],328,1,3021,3.697674418604651,0.0,0.0
40817,4,817,[ 79 121 196 385 313],653,4,3025,3.698044009779951,0.0,0.0
40818,4,818,[135 161 603   9  69],379,4,3029,3.6984126984126986,20.0,0.0
40819,4,819,[603 302 100 427 191],13,4,3033,3.698780487804878,20.0,20.0
40820,4,820,[385 168 210 496 258],474,4,3037,3.6991473812423874,0.0,0.0
40821,4,821,[ 82 183 237 210 742],95,3,3040,3.6982968369829683,0.0,0.0
40822,4,822,[173  56  88 228 127],650,2,3042,3.696233292831106,0.0,20.0
40823,4,823,[100 546 181  15 176],145,3,3045,3.695388349514563,0.0,20.0
40824,4,824,[211 216 143  69 186],95,4,3049,3.695757575757576,0.0,0.0
40825,4,825,[603 302 100 427 173],339,5,3054,3.6973365617433416,20.0,20.0
40826,4,826,[ 50 202 302 151 168],537,3,3057,3.6964933494558645,0.0,20.0
40827,4,827,[  1 222 323 289 275],13,0,3057,3.6920289855072466,0.0,0.0
40828,4,828,[ 95 288  28 357 385],200,5,3062,3.6936067551266585,20.0,0.0
40829,4,829,[603 302 100 427 173],13,4,3066,3.693975903614458,20.0,20.0
40830,4,830,[237 427   7 748 318],474,4,3070,3.694344163658243,20.0,0.0
40831,4,831,[427 238 300 435 175],7,5,3075,3.6959134615384617,0.0,0.0
40832,4,832,[603 302 100 427 313],383,4,3079,3.6962785114045618,20.0,20.0
40833,4,833,[180 435 546   4 655],308,4,3083,3.696642685851319,0.0,0.0
40834,4,834,[238 187  28  89 211],804,5,3088,3.6982035928143713,0.0,0.0
40835,4,835,[603 302 100 427 191],13,4,3092,3.6985645933014353,20.0,20.0
40836,4,836,[288 194 568 258  11],119,4,3096,3.6989247311827955,0.0,0.0
40837,4,837,[ 98 185 328 100  89],328,5,3101,3.700477326968974,0.0,40.0
40838,4,838,[202  96  97 300 288],666,2,3103,3.698450536352801,0.0,0.0
40839,4,839,[302 318 183  69  89],537,3,3106,3.697619047619048,20.0,0.0
40840,4,840,[245 100 275 423  88],533,4,3110,3.697978596908442,0.0,20.0
40841,4,841,[427 183 176 216 196],650,5,3115,3.6995249406175774,0.0,0.0
40842,4,842,[181 318 228 100 238],387,4,3119,3.69988137603796,20.0,20.0
40843,4,843,[ 12 435  64 508 275],60,5,3124,3.7014218009478674,20.0,0.0
40844,4,844,[ 88 117 183 174 235],406,4,3128,3.701775147928994,0.0,20.0
40845,4,845,[216 135 161 211   8],533,3,3131,3.7009456264775413,0.0,0.0
40846,4,846,[  1 228  89 194 322],883,3,3134,3.7001180637544273,0.0,0.0
40847,4,847,[546 125 235 172 323],788,0,3134,3.6957547169811322,0.0,0.0
40848,4,848,[603 302 100 427 483],458,5,3139,3.6972909305064783,40.0,20.0
40849,4,849,[187 271 135 153 196],650,3,3142,3.696470588235294,0.0,0.0
40850,4,850,[176 173  79 179  69],666,3,3145,3.6956521739130435,0.0,0.0
40851,4,851,[603 302 100 427 483],454,4,3149,3.6960093896713615,40.0,20.0
40852,4,852,[328 127 333 143 403],533,4,3153,3.6963657678780772,0.0,20.0
40853,4,853,[174 143  12 222 135],524,1,3154,3.693208430913349,20.0,20.0
40854,4,854,[132 238 475 276 286],239,4,3158,3.6935672514619884,0.0,0.0
40855,4,855,[118 185 496 313 318],271,3,3161,3.692757009345794,20.0,0.0
40856,4,856,[323 181 655 135 111],59,5,3166,3.6942823803967326,0.0,0.0
40857,4,857,[  7  28 405  98  97],7,4,3170,3.6946386946386944,0.0,20.0
40858,4,858,[294 265  71  97 161],83,3,3173,3.6938300349243307,0.0,0.0
40859,4,859,[ 97 302 174 483 238],454,3,3176,3.6930232558139533,20.0,20.0
40860,4,860,[603 302 100 427  98],271,5,3181,3.694541231126597,20.0,40.0
40861,4,861,[125 385 172  25 237],7,4,3185,3.694895591647332,0.0,0.0
40862,4,862,[603 302 100 427  98],666,5,3190,3.6964078794901507,20.0,40.0
40863,4,863,[151 546  82 176  50],749,4,3194,3.696759259259259,0.0,20.0
40864,4,864,[603 302 100 427  98],90,5,3199,3.698265895953757,20.0,40.0
40865,4,865,[ 82  71 483 423  12],374,3,3202,3.697459584295612,40.0,0.0
40866,4,866,[ 98 135  25 748 197],881,2,3204,3.6955017301038064,0.0,20.0
40867,4,867,[427 273 228 161  70],87,4,3208,3.695852534562212,0.0,0.0
40868,4,868,[ 12 289  88 151   8],474,3,3211,3.6950517836593786,20.0,0.0
40869,4,869,[568 475 286 294 194],207,2,3213,3.693103448275862,0.0,0.0
40870,4,870,[ 64 215 238 186 435],804,4,3217,3.6934557979334097,0.0,0.0
40871,4,871,[153  96 405 435 515],313,3,3220,3.6926605504587156,0.0,0.0
40872,4,872,[385 588 323  88 483],454,1,3221,3.689576174112257,20.0,0.0
40873,4,873,[603 302 100 427  98],14,4,3225,3.6899313501144166,20.0,40.0
40874,4,874,[181  22 271 235 200],328,3,3228,3.689142857142857,0.0,0.0
40875,4,875,[135  82  89 300 276],892,4,3232,3.689497716894977,0.0,0.0
40876,4,876,[603 302 100 427  89],90,5,3237,3.6909920182440135,20.0,20.0
40877,4,877,[204  79 286 423 176],378,5,3242,3.69248291571754,0.0,0.0
40878,4,878,[ 95 588 180 174 196],664,4,3246,3.6928327645051193,0.0,20.0
40879,4,879,[286 210 216 234 271],479,2,3248,3.690909090909091,0.0,0.0
40880,4,880,[111 121 202 151 234],533,3,3251,3.6901248581157775,0.0,0.0
40881,4,881,[174 515 143 204 235],213,4,3255,3.6904761904761907,0.0,20.0
40882,4,882,[118  71  28 204 187],533,5,3260,3.6919592298980746,0.0,0.0
40883,4,883,[603 302 100 427  89],334,5,3265,3.6934389140271495,20.0,20.0
40884,4,884,[216 118 423 176 181],374,3,3268,3.6926553672316382,0.0,0.0
40885,4,885,[151 423 182 235 257],795,1,3269,3.6896162528216703,0.0,0.0
40886,4,886,[603 302 100 427  89],474,5,3274,3.6910935738444195,20.0,20.0
40887,4,887,[603 302 100 427  89],666,5,3279,3.6925675675675675,20.0,20.0
40888,4,888,[ 82  96 282 597 211],804,4,3283,3.6929133858267718,0.0,0.0
40889,4,889,[186   4 121 196 172],308,3,3286,3.6921348314606743,0.0,0.0
40890,4,890,[ 50 181 271 313   1],144,4,3290,3.6924803591470257,0.0,20.0
40891,4,891,[195 100 180 294 127],13,3,3293,3.6917040358744395,0.0,40.0
40892,4,892,[151 568 186 161  96],524,3,3296,3.690929451287794,0.0,0.0
40893,4,893,[197 182 172  98 588],95,3,3299,3.690156599552573,0.0,20.0
40894,4,894,[603 302 100 427  89],383,4,3303,3.690502793296089,20.0,20.0
40895,4,895,[603 302 100 427 127],13,5,3308,3.6919642857142856,20.0,40.0
40896,4,896,[483   7 181 117 186],328,5,3313,3.693422519509476,20.0,0.0
40897,4,897,[127 204 265 748 318],328,3,3316,3.692650334075724,20.0,20.0
40898,4,898,[168 435  97 313  88],533,4,3320,3.692992213570634,0.0,0.0
40899,4,899,[174 333 245 276 197],334,4,3324,3.6933333333333334,0.0,20.0
40900,4,900,[ 28  50 196 181 427],7,4,3328,3.6936736958934517,0.0,20.0
40901,4,901,[748  56 161 197 568],804,4,3332,3.694013303769401,0.0,0.0
40902,4,902,[237 181 655   1  82],308,4,3336,3.6943521594684388,0.0,0.0
40903,4,903,[ 96 127  11 202 265],64,5,3341,3.6957964601769913,0.0,20.0
40904,4,904,[603 302 100 427 127],537,5,3346,3.6972375690607735,20.0,40.0
40905,4,905,[603 302 100 427 127],14,4,3350,3.69757174392936,20.0,40.0
40906,4,906,[ 79 121 187 174 655],406,2,3352,3.695700110253583,0.0,20.0
40907,4,907,[  9 588 197 508 180],144,5,3357,3.697136563876652,0.0,0.0
40908,4,908,[144 294 318 301 194],788,3,3360,3.6963696369636962,20.0,0.0
40909,4,909,[ 69 153 118 168 678],7,3,3363,3.695604395604396,0.0,0.0
40910,4,910,[265 100 135 471 546],374,5,3368,3.6970362239297474,0.0,20.0
40911,4,911,[300 222 143   4 100],653,2,3370,3.6951754385964914,0.0,20.0
40912,4,912,[144 655 176 216  89],144,4,3374,3.695509309967141,0.0,0.0
40913,4,913,[603 302 100 427 174],454,5,3379,3.6969365426695844,20.0,40.0
40914,4,914,[603 302 100 427 174],339,5,3384,3.698360655737705,20.0,40.0
40915,4,915,[153 180 100 603 276],409,5,3389,3.699781659388646,20.0,20.0
40916,4,916,[508 191  22 288 471],537,2,3391,3.697928026172301,0.0,0.0
40917,4,917,[603 302 100 427 174],664,5,3396,3.6993464052287583,20.0,40.0
40918,4,918,[172 269 197 194 288],537,1,3397,3.6964091403699673,0.0,0.0
40919,4,919,[603 302 100 427 174],664,5,3402,3.6978260869565216,20.0,40.0
40920,4,920,[603 302 100 427 174],370,4,3406,3.6981541802388707,20.0,40.0
40921,4,921,[603 302 100 427 191],334,5,3411,3.6995661605206074,20.0,20.0
40922,4,922,[ 95 204 276 211 258],13,5,3416,3.700975081256771,0.0,0.0
40923,4,923,[603 302 100 427 191],664,4,3420,3.7012987012987013,20.0,20.0
40924,4,924,[603 302 100 427 127],13,5,3425,3.7027027027027026,20.0,40.0
40925,4,925,[508  70 111 271 313],13,2,3427,3.700863930885529,0.0,0.0
40926,4,926,[173  15 180  12  50],537,3,3430,3.7001078748651564,20.0,20.0
40927,4,927,[423 211 168  79  69],538,4,3434,3.7004310344827585,0.0,0.0
40928,4,928,[174  12  70 135  88],398,3,3437,3.6996770721205596,20.0,20.0
40929,4,929,[403 183 475  82  69],13,2,3439,3.6978494623655913,0.0,0.0
40930,4,930,[496 435 195 603 215],454,4,3443,3.6981740064446833,20.0,0.0
40931,4,931,[181 183 286   7 161],234,1,3444,3.6952789699570814,0.0,0.0
40932,4,932,[603 302 100 427 211],271,5,3449,3.6966773847802785,20.0,20.0
40933,4,933,[132 216 197 483 215],60,5,3454,3.6980728051391862,20.0,0.0
40934,4,934,[603 302 100 427 211],339,5,3459,3.6994652406417114,20.0,20.0
40935,4,935,[603 302 100 427 211],666,5,3464,3.700854700854701,20.0,20.0
40936,4,936,[ 97 475  11 271 191],64,3,3467,3.7001067235859124,0.0,0.0
40937,4,937,[194 318 153 405 125],194,2,3469,3.6982942430703623,20.0,0.0
40938,4,938,[275 282 117 742 313],328,4,3473,3.698615548455804,0.0,0.0
40939,4,939,[211 194 678 111 196],474,4,3477,3.698936170212766,0.0,0.0
40940,4,940,[603 302 100 427 211],14,5,3482,3.7003188097768334,20.0,20.0
40941,4,941,[603 302 100 427 211],14,5,3487,3.701698513800425,20.0,20.0
40942,4,942,[603 302 100 427 211],474,5,3492,3.7030752916224814,20.0,20.0
40943,4,943,[ 95  70 100 323  79],13,2,3494,3.7012711864406778,0.0,20.0
40944,4,944,[ 56 127 125   4  22],144,5,3499,3.7026455026455025,0.0,20.0
40945,4,945,[423  88 174 215 483],749,5,3504,3.704016913319239,20.0,20.0
40946,4,946,[176 202 271 191 333],506,5,3509,3.7053854276663145,0.0,0.0
40947,4,947,[181 176 182 175 273],892,5,3514,3.7067510548523206,0.0,0.0
40948,4,948,[ 56  28  70 286 742],59,2,3516,3.7049525816649105,0.0,0.0
40949,4,949,[603 302 100 427 211],90,5,3521,3.7063157894736842,20.0,20.0
40950,4,950,[301 187 186  15 318],234,2,3523,3.704521556256572,20.0,0.0
40951,4,951,[603 302 100 427 211],14,5,3528,3.7058823529411766,20.0,20.0
40952,4,952,[144 568 210  97 269],263,4,3532,3.7061909758656872,0.0,0.0
40953,4,953,[143 568 546  89 175],308,4,3536,3.706498951781971,0.0,0.0
40954,4,954,[742  82  69 245 385],488,4,3540,3.7068062827225132,0.0,0.0
40955,4,955,[211 282 313 245 546],207,3,3543,3.7060669456066946,0.0,0.0
40956,4,956,[603 302 100 427 211],13,5,3548,3.7074190177638453,20.0,20.0
40957,4,957,[603 302 100 427 211],537,5,3553,3.708768267223382,20.0,20.0
40958,4,958,[153 483 172 185 144],659,4,3557,3.7090719499478624,20.0,0.0
40959,4,959,[ 15 597  56 186 204],374,4,3561,3.709375,0.0,0.0
40960,4,960,[  1 546 265  56 100],650,2,3563,3.707596253902185,0.0,20.0
40961,4,961,[597 286 471  28 222],533,4,3567,3.7079002079002077,0.0,0.0
40962,4,962,[385 546  70  98 100],378,4,3571,3.7082035306334373,0.0,40.0
40963,4,963,[175 423  98 385  79],90,4,3575,3.70850622406639,0.0,20.0
40964,4,964,[ 69 125 238 275 546],378,1,3576,3.705699481865285,0.0,0.0
40965,4,965,[483 174 405 168 143],13,3,3579,3.7049689440993787,20.0,20.0
40966,4,966,[603 302 100 427 211],666,5,3584,3.706308169596691,20.0,20.0
40967,4,967,[603 302 100 427 211],454,4,3588,3.706611570247934,20.0,20.0
40968,4,968,[175  12 515 176 153],343,5,3593,3.7079463364293086,20.0,0.0
40969,4,969,[  4 210 175 238  79],194,2,3595,3.7061855670103094,0.0,0.0
40970,4,970,[238 275  89 185 483],311,4,3599,3.70648815653965,20.0,0.0
40971,4,971,[153 202 268  56 100],90,4,3603,3.70679012345679,0.0,20.0
40972,4,972,[144 180 588  11 275],13,3,3606,3.7060637204522098,0.0,0.0
40973,4,973,[742 328 125 289  15],92,1,3607,3.7032854209445585,0.0,0.0
40974,4,974,[603 302 100 427 211],13,5,3612,3.7046153846153844,20.0,20.0
40975,4,975,[ 11 237 515 196 423],92,4,3616,3.7049180327868854,0.0,0.0
40976,4,976,[265 300  70 302  88],13,3,3619,3.7041965199590585,0.0,0.0
40977,4,977,[603 302 100 427 211],339,5,3624,3.705521472392638,20.0,20.0
40978,4,978,[603 302 100 427 211],13,5,3629,3.706843718079673,20.0,20.0
40979,4,979,[  9 210 195  12 180],406,5,3634,3.7081632653061223,20.0,0.0
40980,4,980,[603 302 100 427 211],14,5,3639,3.709480122324159,20.0,20.0
40981,4,981,[603 302 100 427 211],13,5,3644,3.7107942973523422,20.0,20.0
40982,4,982,[475  64 194 100  96],537,2,3646,3.709053916581892,0.0,20.0
40983,4,983,[403 202 435 127 191],194,3,3649,3.7083333333333335,0.0,20.0
40984,4,984,[603 302 100 427 211],339,5,3654,3.7096446700507615,20.0,20.0
40985,4,985,[603 302 100 427 211],90,5,3659,3.710953346855984,20.0,20.0
40986,4,986,[603 302 100 427 211],474,5,3664,3.71225937183384,20.0,20.0
40987,4,987,[117 179 196 357 300],234,1,3665,3.7095141700404857,20.0,0.0
40988,4,988,[ 79 328 403  69 588],378,3,3668,3.7087967644084934,0.0,0.0
40989,4,989,[ 50 135 175 276 117],334,4,3672,3.709090909090909,0.0,20.0
40990,4,990,[603 302 100 427 211],666,5,3677,3.710393541876892,20.0,20.0
40991,4,991,[603 302 100 427 211],13,5,3682,3.711693548387097,20.0,20.0
40992,4,992,[568   1 483 195 546],650,2,3684,3.7099697885196377,20.0,0.0
40993,4,993,[222  28   1  64 269],125,4,3688,3.710261569416499,0.0,0.0
40994,4,994,[603 302 100 427 211],537,5,3693,3.7115577889447238,20.0,20.0
40995,4,995,[ 88  82 282   4  95],374,3,3696,3.710843373493976,0.0,0.0
40996,4,996,[ 25 176 568 204   1],42,3,3699,3.7101303911735206,0.0,0.0
40997,4,997,[603 302 100 427 211],339,5,3704,3.711422845691383,20.0,20.0
40998,4,998,[ 98 132 187 172 191],881,4,3708,3.7117117117117115,0.0,20.0
40999,4,999,[ 70 471 204   7   8],882,4,3712,3.712,0.0,0.0
41000,4,1000,[603 302 100 427 211],666,5,3717,3.7132867132867133,20.0,20.0
41001,4,1001,[603 302 100 427 211],271,5,3722,3.714570858283433,20.0,20.0
41002,4,1002,[210 173  88 175   9],13,2,3724,3.7128614157527418,0.0,0.0
41003,4,1003,[168 176  96 515 186],666,3,3727,3.712151394422311,0.0,0.0
41004,4,1004,[211 186 318 403 588],804,4,3731,3.7124378109452736,20.0,0.0
41005,4,1005,[ 64 265 286 172 132],194,2,3733,3.710735586481113,0.0,0.0
41006,4,1006,[ 71 183 204 215 216],311,5,3738,3.71201588877855,0.0,0.0
41007,4,1007,[ 56 273 185 508 173],537,4,3742,3.7123015873015874,0.0,0.0
41008,4,1008,[258   7 151  22 228],738,4,3746,3.7125867195242814,0.0,0.0
41009,4,1009,[ 95 151 288 210 403],378,3,3749,3.711881188118812,0.0,0.0
41010,4,1010,[588 568 211 323 202],311,3,3752,3.711177052423343,0.0,0.0
41011,4,1011,[186 185 403  28  95],374,4,3756,3.7114624505928853,0.0,0.0
41012,4,1012,[603 302 100 427 211],90,5,3761,3.7127344521224086,20.0,20.0
41013,4,1013,[603 302 100 427 211],13,5,3766,3.7140039447731756,20.0,20.0
41014,4,1014,[603 302 100 427 211],666,5,3771,3.715270935960591,20.0,20.0
41015,4,1015,[121 175 748  79 125],313,3,3774,3.7145669291338583,0.0,0.0
41016,4,1016,[603 302 100 427 211],666,5,3779,3.7158308751229105,20.0,20.0
41017,4,1017,[210 196 100 185   9],207,3,3782,3.7151277013752457,0.0,20.0
41018,4,1018,[603 302 100 427 211],14,5,3787,3.7163886162904807,20.0,20.0
41019,4,1019,[603 302 100 427 211],90,5,3792,3.7176470588235295,20.0,20.0
41020,4,1020,[289 275 268 435 300],537,2,3794,3.7159647404505387,0.0,0.0
41021,4,1021,[423 117 186 187 276],311,4,3798,3.716242661448141,0.0,0.0
41022,4,1022,[276 200 210 302 268],13,3,3801,3.7155425219941347,0.0,0.0
41023,4,1023,[603 302 100 427 211],339,5,3806,3.716796875,20.0,20.0
41024,4,1024,[603 302 100 427 211],13,5,3811,3.718048780487805,20.0,20.0
41025,4,1025,[121 180 191  71 403],308,4,3815,3.7183235867446394,0.0,0.0
41026,4,1026,[265 121 175 100 245],653,4,3819,3.7185978578383643,0.0,20.0
41027,4,1027,[603 302 100 427 211],14,5,3824,3.719844357976654,20.0,20.0
41028,4,1028,[603 153 185 186 323],13,3,3827,3.7191448007774537,20.0,0.0
41029,4,1029,[302 328 423  25 269],271,3,3830,3.7184466019417477,0.0,0.0
41030,4,1030,[ 22 135 144 117 271],144,4,3834,3.7187196896217265,0.0,0.0
41031,4,1031,[655 235   9   4  69],788,2,3836,3.7170542635658914,0.0,0.0
41032,4,1032,[ 96 197 132  15 195],406,5,3841,3.718296224588577,0.0,0.0
41033,4,1033,[234 268 546 471 403],13,2,3843,3.716634429400387,0.0,0.0
41034,4,1034,[603 302 100 427 211],90,5,3848,3.7178743961352656,20.0,20.0
41035,4,1035,[286  64  11 118 235],59,3,3851,3.7171814671814674,0.0,0.0
41036,4,1036,[234  11  89 546 125],64,2,3853,3.715525554484089,0.0,0.0
41037,4,1037,[173 655  11 197 183],406,3,3856,3.714836223506744,0.0,0.0
41038,4,1038,[603 302 100 427 211],271,5,3861,3.716073147256978,20.0,20.0
41039,4,1039,[603 302 100 427 211],537,5,3866,3.7173076923076924,20.0,20.0
41040,4,1040,[100   1 174 180 196],92,5,3871,3.718539865513929,0.0,40.0
41041,4,1041,[215   7 132 168   8],892,5,3876,3.719769673704415,0.0,0.0
41042,4,1042,[186  89 132 405 144],385,2,3878,3.7181208053691277,0.0,0.0
41043,4,1043,[603 302 100 427 211],90,5,3883,3.7193486590038316,20.0,20.0
41044,4,1044,[515 196 200  50 423],343,4,3887,3.7196172248803827,0.0,20.0
41045,4,1045,[603 302 100 427 211],14,5,3892,3.7208413001912044,20.0,20.0
41046,4,1046,[603 302 100 427 211],14,5,3897,3.7220630372492836,20.0,20.0
41047,4,1047,[603 302 100 427 211],271,5,3902,3.7232824427480917,20.0,20.0
41048,4,1048,[289  64  89 301 215],328,3,3905,3.722592945662536,0.0,0.0
41049,4,1049,[180 191 275 568 151],648,3,3908,3.721904761904762,0.0,0.0
41050,4,1050,[475  98 191 273 294],537,2,3910,3.720266412940057,0.0,20.0
41051,4,1051,[ 15 742 187  56  69],207,5,3915,3.7214828897338403,0.0,0.0
41052,4,1052,[ 64  15 222 211  82],290,4,3919,3.7217473884140553,0.0,0.0
41053,4,1053,[ 97 423  28 135 100],774,0,3919,3.718216318785579,0.0,20.0
41054,4,1054,[191 173 196 238 211],387,4,3923,3.718483412322275,0.0,0.0
41055,4,1055,[603 302 427 100 211],90,5,3928,3.7196969696969697,20.0,20.0
41056,4,1056,[483 294 182 196 655],234,1,3929,3.717123935666982,20.0,0.0
41057,4,1057,[603 302 427 100 211],474,5,3934,3.7183364839319473,20.0,20.0
41058,4,1058,[603 302 427 100 211],14,5,3939,3.7195467422096318,20.0,20.0
41059,4,1059,[603 302 427 100 211],13,5,3944,3.720754716981132,20.0,20.0
41060,4,1060,[603 302 427 100 211],474,5,3949,3.7219604147031102,20.0,20.0
41061,4,1061,[185 508 603 427 257],339,5,3954,3.7231638418079096,20.0,0.0
41062,4,1062,[117 357 275 475 194],648,2,3956,3.7215428033866416,20.0,0.0
41063,4,1063,[385   9 742 435 276],207,3,3959,3.720864661654135,0.0,0.0
41064,4,1064,[403 216 211  98 423],648,5,3964,3.7220657276995306,0.0,20.0
41065,4,1065,[ 89  25  88 118 181],749,4,3968,3.7223264540337713,0.0,0.0
41066,4,1066,[ 11 195 168 161 127],158,4,3972,3.7225866916588566,0.0,20.0
41067,4,1067,[427 100 181 168 183],745,2,3974,3.7209737827715355,0.0,20.0
41068,4,1068,[151 265 132 215 258],378,4,3978,3.7212347988774557,0.0,0.0
41069,4,1069,[237  12 144 496  71],64,3,3981,3.7205607476635514,20.0,0.0
41070,4,1070,[403  88  82 258  22],738,2,3983,3.718954248366013,0.0,0.0
41071,4,1071,[603 302 427 100 211],271,5,3988,3.720149253731343,20.0,20.0
41072,4,1072,[118 194  28  25 423],59,4,3992,3.7204100652376515,0.0,0.0
41073,4,1073,[603 302 427 100 211],90,5,3997,3.7216014897579144,20.0,20.0
41074,4,1074,[265 423 111 100 322],474,5,4002,3.7227906976744185,0.0,20.0
41075,4,1075,[ 25 235 588 210 174],897,3,4005,3.7221189591078065,0.0,20.0
41076,4,1076,[238   7 276 211  82],308,5,4010,3.72330547818013,0.0,0.0
41077,4,1077,[603 302 427 100 211],339,5,4015,3.7244897959183674,20.0,20.0
41078,4,1078,[127  98 423  88 173],452,4,4019,3.7247451343836886,0.0,40.0
41079,4,1079,[237 655 294   8 215],7,4,4023,3.725,0.0,0.0
41080,4,1080,[ 79 175 496 228 288],59,5,4028,3.7261794634597596,0.0,0.0
41081,4,1081,[603 302 427 100 211],666,5,4033,3.7273567467652495,20.0,20.0
41082,4,1082,[173 132 483 195  70],7,4,4037,3.7276084949215145,20.0,0.0
41083,4,1083,[ 28 435 385 546 125],378,3,4040,3.726937269372694,0.0,0.0
41084,4,1084,[423 257 186 655 144],666,1,4041,3.7244239631336407,0.0,0.0
41085,4,1085,[603 302 427 100 211],537,5,4046,3.7255985267034992,20.0,20.0
41086,4,1086,[603 302 427 100 211],14,5,4051,3.7267709291628335,20.0,20.0
41087,4,1087,[ 69 186 179 210 678],537,2,4053,3.7251838235294117,0.0,0.0
41088,4,1088,[603 302 427 100 211],339,5,4058,3.726354453627181,20.0,20.0
41089,4,1089,[603 302 427 100 211],666,5,4063,3.7275229357798163,20.0,20.0
41090,4,1090,[603 302 427 100 211],666,5,4068,3.7286892758936756,20.0,20.0
41091,4,1091,[427 196 202  98 144],194,3,4071,3.728021978021978,0.0,20.0
41092,4,1092,[603 302 427 100 211],666,5,4076,3.729185727355901,20.0,20.0
41093,4,1093,[300 179 471 234 186],271,3,4079,3.7285191956124315,0.0,0.0
41094,4,1094,[603 302 427 100 211],339,5,4084,3.7296803652968036,20.0,20.0
41095,4,1095,[603 302 427 100 211],14,5,4089,3.730839416058394,20.0,20.0
41096,4,1096,[ 96 196  88 172  50],474,5,4094,3.731996353691887,0.0,20.0
41097,4,1097,[132 135 300   8  82],892,4,4098,3.73224043715847,0.0,0.0
41098,4,1098,[118 237 588 496 135],308,2,4100,3.7306642402183803,0.0,0.0
41099,4,1099,[603 302 427 100 211],666,5,4105,3.731818181818182,20.0,20.0
41100,4,1100,[603 302 427 100 211],454,4,4109,3.732061762034514,20.0,20.0
41101,4,1101,[322  11  71 496 427],474,5,4114,3.733212341197822,0.0,0.0
41102,4,1102,[318 276 179 265 222],234,1,4115,3.730734360834089,20.0,0.0
41103,4,1103,[ 82 121 275 179 174],694,5,4120,3.7318840579710146,0.0,20.0
41104,4,1104,[ 96 181 496 182  89],454,2,4122,3.730316742081448,0.0,0.0
41105,4,1105,[215 269 423 435 191],650,3,4125,3.7296564195298374,0.0,0.0
41106,4,1106,[172 286 174  89 427],940,4,4129,3.729900632339657,0.0,20.0
41107,4,1107,[288   4 235 269 204],650,2,4131,3.7283393501805056,0.0,0.0
41108,4,1108,[153 181   7 748 435],13,4,4135,3.7285843101893597,0.0,0.0
41109,4,1109,[268  79 423 742 475],92,3,4138,3.727927927927928,0.0,0.0
41110,4,1110,[182 568 161 176 211],328,3,4141,3.727272727272727,0.0,0.0
41111,4,1111,[175 269 204 294 196],659,5,4146,3.7284172661870505,0.0,0.0
41112,4,1112,[603 302 427 100 211],13,5,4151,3.729559748427673,20.0,20.0
41113,4,1113,[132 183  15  50 179],694,5,4156,3.7307001795332138,0.0,20.0
41114,4,1114,[222 179  79 603 211],897,4,4160,3.7309417040358746,20.0,0.0
41115,4,1115,[603 302 427 100 211],454,4,4164,3.7311827956989245,20.0,20.0
41116,4,1116,[179 216 174 197  64],738,3,4167,3.730528200537153,0.0,20.0
41117,4,1117,[603 302 427 100 211],13,5,4172,3.731663685152057,20.0,20.0
41118,4,1118,[132  22 403 546 268],7,4,4176,3.7319034852546915,0.0,0.0
41119,4,1119,[143 568 300 237  79],749,4,4180,3.732142857142857,0.0,0.0
41120,4,1120,[318  50 173 238  98],295,5,4185,3.7332738626226583,20.0,40.0
41121,4,1121,[258 475 185 322  88],207,2,4187,3.731729055258467,0.0,0.0
41122,4,1122,[603 302 427 100 211],271,5,4192,3.732858414959929,20.0,20.0
41123,4,1123,[222 210 143  89 118],795,2,4194,3.7313167259786475,0.0,0.0
41124,4,1124,[603 302 427 100 211],454,4,4198,3.7315555555555555,20.0,20.0
41125,4,1125,[181 655   1 588 483],804,5,4203,3.7326820603907636,20.0,0.0
41126,4,1126,[ 89 179  64 143 121],60,4,4207,3.732919254658385,0.0,0.0
41127,4,1127,[143  89 423 144  97],538,4,4211,3.733156028368794,0.0,0.0
41128,4,1128,[175 258 186  79   4],64,3,4214,3.732506643046944,0.0,0.0
41129,4,1129,[603 302 427 100 211],14,5,4219,3.7336283185840706,20.0,20.0
41130,4,1130,[405 403 194  79 173],194,2,4221,3.7320954907161803,0.0,0.0
41131,4,1131,[127 655 286 273 181],479,4,4225,3.7323321554770317,0.0,20.0
41132,4,1132,[ 95   1   7 174 175],194,2,4227,3.7308031774051194,0.0,20.0
41133,4,1133,[174 111 405   4 135],87,5,4232,3.7319223985890653,0.0,20.0
41134,4,1134,[603 302 427 100 211],90,5,4237,3.7330396475770926,20.0,20.0
41135,4,1135,[435   8  79 228 168],64,5,4242,3.734154929577465,0.0,0.0
41136,4,1136,[423  95 196 187  71],897,3,4245,3.733509234828496,0.0,0.0
41137,4,1137,[603 302 427 100 211],666,5,4250,3.734622144112478,20.0,20.0
41138,4,1138,[568 127 153 228  96],650,3,4253,3.7339771729587357,0.0,20.0
41139,4,1139,[423 508 234 210 173],85,2,4255,3.732456140350877,0.0,0.0
41140,4,1140,[603 302 427 100 211],13,5,4260,3.733567046450482,20.0,20.0
41141,4,1141,[  4  97 125 588  95],804,4,4264,3.733800350262697,0.0,0.0
41142,4,1142,[405  89  98  79 234],346,2,4266,3.732283464566929,0.0,20.0
41143,4,1143,[603 302 427 100 211],537,5,4271,3.7333916083916083,20.0,20.0
41144,4,1144,[322 294 655 196 183],804,5,4276,3.7344978165938865,0.0,0.0
41145,4,1145,[603 302 427 100 211],14,5,4281,3.735602094240838,20.0,20.0
41146,4,1146,[  4 471  28 268 143],234,2,4283,3.734088927637315,0.0,0.0
41147,4,1147,[ 82 318 333 174 118],533,5,4288,3.735191637630662,20.0,20.0
41148,4,1148,[168 194  98 269 318],85,4,4292,3.7354221061792865,20.0,20.0
41149,4,1149,[405 357  71  11 144],892,3,4295,3.734782608695652,20.0,0.0
41150,4,1150,[423   4 318 471 179],271,4,4299,3.73501303214596,20.0,0.0
41151,4,1151,[ 82 182 385 172 196],7,4,4303,3.7352430555555554,0.0,0.0
41152,4,1152,[187 174 435  98 210],533,5,4308,3.7363399826539463,0.0,40.0
41153,4,1153,[ 50 210 127  22 183],311,5,4313,3.7374350086655115,0.0,40.0
41154,4,1154,[603 302 427 100 211],13,5,4318,3.7385281385281384,20.0,20.0
41155,4,1155,[603 302 427 100 211],14,5,4323,3.73961937716263,20.0,20.0
41156,4,1156,[202 168 204 228  82],804,5,4328,3.7407087294727743,0.0,0.0
41157,4,1157,[  4  64 318 286  95],378,4,4332,3.7409326424870466,20.0,0.0
41158,4,1158,[204 161 191   4 228],59,4,4336,3.741156169111303,0.0,0.0
41159,4,1159,[172 202 273  22  96],749,5,4341,3.742241379310345,0.0,0.0
41160,4,1160,[234 496  88  28 216],194,2,4343,3.740740740740741,0.0,0.0
41161,4,1161,[  4 302  56 196 210],378,4,4347,3.7409638554216866,0.0,0.0
41162,4,1162,[603 302 427 100 211],271,5,4352,3.7420464316423043,20.0,20.0
41163,4,1163,[135 237 588 215 202],882,5,4357,3.743127147766323,0.0,0.0
41164,4,1164,[143  69  98  11 195],213,4,4361,3.7433476394849787,0.0,20.0
41165,4,1165,[748 197 475  28  50],13,4,4365,3.7435677530017153,0.0,20.0
41166,4,1166,[603 302 427 100 211],14,5,4370,3.7446443873179094,20.0,20.0
41167,4,1167,[603 302 427 100 211],474,5,4375,3.745719178082192,20.0,20.0
41168,4,1168,[176  25  64 200  88],271,3,4378,3.74508126603935,0.0,0.0
41169,4,1169,[302 322 475  79 603],474,5,4383,3.746153846153846,20.0,0.0
41170,4,1170,[603 302 427 100 211],454,4,4387,3.7463706233988043,20.0,20.0
41171,4,1171,[  9 234 185 161 405],881,2,4389,3.7448805460750854,0.0,0.0
41172,4,1172,[100  56 357 328   8],328,4,4393,3.7450980392156863,20.0,20.0
41173,4,1173,[603 302 427 100 211],271,5,4398,3.746166950596252,20.0,20.0
41174,4,1174,[405 182 100 118 210],666,2,4400,3.74468085106383,0.0,20.0
41175,4,1175,[603 302 427 100 211],90,5,4405,3.745748299319728,20.0,20.0
41176,4,1176,[151 100 238 318  96],189,5,4410,3.7468139337298214,20.0,20.0
41177,4,1177,[ 56 403 181  98 172],328,4,4414,3.7470288624787775,0.0,20.0
41178,4,1178,[ 22  28 234 323  56],59,5,4419,3.7480916030534353,0.0,0.0
41179,4,1179,[222 215 435  96 471],378,3,4422,3.747457627118644,0.0,0.0
41180,4,1180,[237  89 175 546 118],343,2,4424,3.745977984758679,0.0,0.0
41181,4,1181,[143 196  64 174 286],234,1,4425,3.7436548223350252,0.0,20.0
41182,4,1182,[186 196 151 210 183],346,3,4428,3.743026204564666,0.0,0.0
41183,4,1183,[471 235 228  88 117],145,5,4433,3.7440878378378377,0.0,0.0
41184,4,1184,[ 97  50 173 186  89],848,5,4438,3.7451476793248943,0.0,20.0
41185,4,1185,[603 302 427 100 211],271,5,4443,3.746205733558179,20.0,20.0
41186,4,1186,[603 302 427 100 211],339,5,4448,3.74726200505476,20.0,20.0
41187,4,1187,[603 302 427 100 211],14,5,4453,3.7483164983164983,20.0,20.0
41188,4,1188,[423 204 301 655  69],328,3,4456,3.747687132043734,0.0,0.0
41189,4,1189,[603 302 427 100 211],666,5,4461,3.7487394957983193,20.0,20.0
41190,4,1190,[603 302 427 100 211],90,5,4466,3.749790092359362,20.0,20.0
41191,4,1191,[294 546 748 179  96],13,2,4468,3.748322147651007,0.0,0.0
41192,4,1192,[323 185  64 258 228],788,3,4471,3.7476948868398994,0.0,0.0
41193,4,1193,[172  96 185  12 180],666,3,4474,3.747068676716918,20.0,0.0
41194,4,1194,[151 194  95 318 197],804,3,4477,3.7464435146443513,20.0,0.0
41195,4,1195,[210 151 174 100  96],308,5,4482,3.7474916387959865,0.0,40.0
41196,4,1196,[302 204 186 301 202],537,2,4484,3.746031746031746,0.0,0.0
41197,4,1197,[168  25 603  69 222],537,2,4486,3.7445742904841404,20.0,0.0
41198,4,1198,[183 127 211 655  28],64,5,4491,3.7456213511259384,0.0,20.0
41199,4,1199,[603 302 427 100 211],339,5,4496,3.7466666666666666,20.0,20.0
41200,4,1200,[288 273  50 204  22],378,4,4500,3.7468776019983348,0.0,20.0
41201,4,1201,[222 135 175 258  69],650,3,4503,3.7462562396006653,0.0,0.0
41202,4,1202,[144 204 222 546 179],899,2,4505,3.744804655029094,0.0,0.0
41203,4,1203,[603 302 427 100 211],13,5,4510,3.7458471760797343,20.0,20.0
41204,4,1204,[603 302 427 100 211],666,5,4515,3.7468879668049793,20.0,20.0
41205,4,1205,[182 276 173 471 179],271,2,4517,3.7454394693200666,0.0,0.0
41206,4,1206,[603 302 427 100 211],537,5,4522,3.7464788732394365,20.0,20.0
41207,4,1207,[121 300 175 182  97],313,5,4527,3.747516556291391,0.0,0.0
41208,4,1208,[603 302 427 100 211],666,5,4532,3.748552522746071,20.0,20.0
41209,4,1209,[603 302 427 100 211],339,5,4537,3.749586776859504,20.0,20.0
41210,4,1210,[318 403 216 168   1],326,1,4538,3.7473162675474816,20.0,0.0
41211,4,1211,[228 294 172 483   8],13,4,4542,3.7475247524752477,20.0,0.0
41212,4,1212,[423 183 237  64  79],6,2,4544,3.7460840890354494,0.0,0.0
41213,4,1213,[257 204 135 144  82],650,2,4546,3.7446457990115323,0.0,0.0
41214,4,1214,[286 187 125 237   7],334,4,4550,3.7448559670781894,0.0,0.0
41215,4,1215,[603 302 427 100 211],90,5,4555,3.7458881578947367,20.0,20.0
41216,4,1216,[222 210  15 546 294],533,4,4559,3.7460969597370584,0.0,0.0
41217,4,1217,[ 96 211 135 187 197],666,4,4563,3.7463054187192117,0.0,0.0
41218,4,1218,[603 302 427 100 211],537,5,4568,3.7473338802296965,20.0,20.0
41219,4,1219,[ 79 475  70 161 195],13,1,4569,3.745081967213115,0.0,0.0
41220,4,1220,[294 318 289 187 546],234,3,4572,3.7444717444717446,20.0,0.0
41221,4,1221,[265 286 211  28 222],194,3,4575,3.743862520458265,0.0,0.0
41222,4,1222,[ 79 423 179 172  28],881,5,4580,3.7448896156991007,0.0,0.0
41223,4,1223,[ 12  69 423 173  71],334,3,4583,3.744281045751634,20.0,0.0
41224,4,1224,[ 15 245 405 289 269],378,3,4586,3.743673469387755,0.0,0.0
41225,4,1225,[313  15  70 143  79],234,1,4587,3.7414355628058726,0.0,0.0
41226,4,1226,[603 302 427 100 211],474,5,4592,3.7424612876935615,20.0,20.0
41227,4,1227,[405   4 132 568 427],13,3,4595,3.74185667752443,0.0,0.0
41228,4,1228,[ 96 132 300 135 176],788,3,4598,3.741253051261188,0.0,0.0
41229,4,1229,[603 302 427 100 211],271,5,4603,3.7422764227642276,20.0,20.0
41230,4,1230,[ 15  88  25 289 286],474,4,4607,3.742485783915516,0.0,0.0
41231,4,1231,[257  82 168  15 118],290,4,4611,3.7426948051948052,0.0,0.0
41232,4,1232,[ 88 127 196  98  70],653,1,4612,3.740470397404704,0.0,40.0
41233,4,1233,[313  28 318  64 265],59,5,4617,3.7414910858995136,20.0,0.0
41234,4,1234,[216 289  88 202 235],374,1,4618,3.7392712550607285,0.0,0.0
41235,4,1235,[ 95 118 183 210 323],290,4,4622,3.7394822006472492,0.0,0.0
41236,4,1236,[237 202 175  82 323],537,1,4623,3.7372675828617625,0.0,0.0
41237,4,1237,[ 70 183  96   4 210],934,4,4627,3.737479806138934,0.0,0.0
41238,4,1238,[222  79 423  98 204],339,3,4630,3.7368845843422114,0.0,20.0
41239,4,1239,[228 197 173 216  70],234,1,4631,3.734677419354839,0.0,0.0
41240,4,1240,[174 176  22  71 187],59,4,4635,3.7348912167606767,0.0,20.0
41241,4,1241,[603 302 427 100 211],271,5,4640,3.7359098228663448,20.0,20.0
41242,4,1242,[588   1 194 265 183],882,4,4644,3.736122284794851,0.0,0.0
41243,4,1243,[403 179 153 496 655],308,4,4648,3.7363344051446945,0.0,0.0
41244,4,1244,[210  98  69 111 228],42,4,4652,3.736546184738956,0.0,20.0
41245,4,1245,[216  88 275 161 143],95,3,4655,3.735955056179775,0.0,0.0
41246,4,1246,[603 302 427 100 211],271,5,4660,3.7369687249398558,20.0,20.0
41247,4,1247,[546  22 194 132  88],87,4,4664,3.7371794871794872,0.0,0.0
41248,4,1248,[200   1 204 385 405],881,4,4668,3.7373899119295437,0.0,0.0
41249,4,1249,[748 176 216  71 132],64,3,4671,3.7368,0.0,0.0
41250,4,1250,[322  88   9 168  98],13,3,4674,3.73621103117506,0.0,20.0
41251,4,1251,[ 69 121 483 202 111],13,5,4679,3.737220447284345,20.0,0.0
41252,4,1252,[195 168  69 515 191],7,4,4683,3.7374301675977653,0.0,0.0
41253,4,1253,[603 302 427 100 211],339,5,4688,3.7384370015948964,20.0,20.0
41254,4,1254,[204 200 515   9 132],474,4,4692,3.7386454183266933,0.0,0.0
41255,4,1255,[191  97 197 194  56],339,5,4697,3.7396496815286624,0.0,0.0
41256,4,1256,[186 181 161 210 144],13,4,4701,3.739856801909308,0.0,0.0
41257,4,1257,[603 302 427 100 211],339,5,4706,3.740858505564388,20.0,20.0
41258,4,1258,[603 302 427 100 211],454,4,4710,3.7410643367752185,20.0,20.0
41259,4,1259,[  4 202  98 471  82],343,5,4715,3.742063492063492,0.0,20.0
41260,4,1260,[276 204 125  12  82],334,4,4719,3.7422680412371134,20.0,0.0
41261,4,1261,[603 302 427 100 211],13,5,4724,3.7432646592709986,20.0,20.0
41262,4,1262,[183 268  89 282 235],145,5,4729,3.7442596991290578,0.0,0.0
41263,4,1263,[ 11 238 176 435 597],13,1,4730,3.742088607594937,0.0,0.0
41264,4,1264,[328 238 475  15 132],92,2,4732,3.740711462450593,0.0,0.0
41265,4,1265,[200 271 471  96 228],328,2,4734,3.7393364928909953,0.0,0.0
41266,4,1266,[603 302 427 100 211],271,5,4739,3.7403314917127073,20.0,20.0
41267,4,1267,[210 176 276 173   7],664,4,4743,3.7405362776025237,0.0,0.0
41268,4,1268,[153   4  89 173 180],406,2,4745,3.739164696611505,0.0,0.0
41269,4,1269,[603 302 427 100 211],537,5,4750,3.7401574803149606,20.0,20.0
41270,4,1270,[ 88 301 211  79 471],13,2,4752,3.7387883556254917,0.0,0.0
41271,4,1271,[175 588  96 151 435],59,4,4756,3.738993710691824,0.0,0.0
41272,4,1272,[179  79 215 403 197],343,5,4761,3.7399842890809114,0.0,0.0
41273,4,1273,[603 302 427 100 211],454,4,4765,3.740188383045526,20.0,20.0
41274,4,1274,[151  64 318 121 194],213,5,4770,3.7411764705882353,20.0,0.0
41275,4,1275,[100   4  11 175 200],334,4,4774,3.7413793103448274,0.0,20.0
41276,4,1276,[603 302 427 100 318],271,5,4779,3.7423649177760376,40.0,20.0
41277,4,1277,[ 71 515 597 357  28],200,5,4784,3.7433489827856024,20.0,0.0
41278,4,1278,[318 191 265 385 323],59,5,4789,3.7443315089913995,20.0,0.0
41279,4,1279,[678 196 186 300  28],488,3,4792,3.74375,0.0,0.0
41280,4,1280,[174 179 318 172 195],200,5,4797,3.7447306791569086,20.0,20.0
41281,4,1281,[276 197   8 180 196],13,5,4802,3.7457098283931356,0.0,0.0
41282,4,1282,[678 268 271 202 127],537,2,4804,3.744349181605612,0.0,20.0
41283,4,1283,[121  70 403 100 216],318,3,4807,3.7437694704049846,0.0,20.0
41284,4,1284,[357 235 475 300 258],669,2,4809,3.7424124513618677,20.0,0.0
41285,4,1285,[603 302 427 100 318],664,5,4814,3.7433903576982894,40.0,20.0
41286,4,1286,[269 423 191 273  98],666,3,4817,3.7428127428127427,0.0,20.0
41287,4,1287,[  9   1 174 175 187],326,1,4818,3.7406832298136647,0.0,20.0
41288,4,1288,[603 302 427 100 318],666,5,4823,3.7416602017067495,40.0,20.0
41289,4,1289,[313 100 118 742 235],141,4,4827,3.7418604651162792,0.0,20.0
41290,4,1290,[515 313   8 328 678],334,3,4830,3.7412858249419054,0.0,0.0
41291,4,1291,[183 195 333 286 197],537,1,4831,3.7391640866873064,0.0,0.0
41292,4,1292,[268 300 427 328 237],334,3,4834,3.7385924207269916,0.0,0.0
41293,4,1293,[161  70  96 183  95],308,4,4838,3.7387944358578054,0.0,0.0
41294,4,1294,[357  97 187 496  15],537,3,4841,3.738223938223938,20.0,0.0
41295,4,1295,[180   7 483 271 204],833,3,4844,3.7376543209876543,20.0,0.0
41296,4,1296,[603 302 427 100 318],90,5,4849,3.7386276021588283,40.0,20.0
41297,4,1297,[  9 385 275 176 322],13,0,4849,3.735747303543914,0.0,0.0
41298,4,1298,[603 302 427 100 318],334,5,4854,3.7367205542725173,40.0,20.0
41299,4,1299,[111  28 496 258 313],537,3,4857,3.736153846153846,0.0,0.0
41300,4,1300,[  1  79 235 202 515],13,1,4858,3.7340507302075325,0.0,0.0
41301,4,1301,[ 69 483 135 196 235],290,4,4862,3.7342549923195083,20.0,0.0
41302,4,1302,[  4   9 180 216 496],194,3,4865,3.733691481197237,0.0,0.0
41303,4,1303,[603 302 427 100 318],13,4,4869,3.7338957055214723,40.0,20.0
41304,4,1304,[185   9   4  82 475],10,5,4874,3.734865900383142,0.0,0.0
41305,4,1305,[603 302 427 100 211],271,5,4879,3.73583460949464,20.0,20.0
41306,4,1306,[161 117  64 187 515],234,3,4882,3.735271614384086,0.0,0.0
41307,4,1307,[427 294 237 202 143],13,3,4885,3.734709480122324,0.0,0.0
41308,4,1308,[603 302 427 100 211],339,5,4890,3.7356760886172653,20.0,20.0
41309,4,1309,[385 234 403  11 742],346,3,4893,3.735114503816794,0.0,0.0
41310,4,1310,[603 302 427 100 211],339,5,4898,3.7360793287566745,20.0,20.0
41311,4,1311,[300 127 471   7 313],548,5,4903,3.737042682926829,0.0,20.0
41312,4,1312,[238   4   1  82 318],537,2,4905,3.735719725818736,20.0,0.0
41313,4,1313,[603 302 427 100 211],454,4,4909,3.7359208523592087,20.0,20.0
41314,4,1314,[179 268 181 427 588],85,3,4912,3.735361216730038,0.0,0.0
41315,4,1315,[ 89 301  71 196 568],13,3,4915,3.7348024316109423,0.0,0.0
41316,4,1316,[ 69 204 318 271  50],290,4,4919,3.7350037965072134,20.0,20.0
41317,4,1317,[603 302 100 427 318],666,5,4924,3.7359635811836114,40.0,20.0
41318,4,1318,[ 82 603 403 427 200],848,4,4928,3.736163760424564,20.0,0.0
41319,4,1319,[ 64 748 179 427 237],899,4,4932,3.7363636363636363,0.0,0.0
41320,4,1320,[333 405 515   7 153],334,4,4936,3.736563209689629,0.0,0.0
41321,4,1321,[603 302 100 427 318],271,5,4941,3.737518910741301,40.0,20.0
41322,4,1322,[603 302 100 427 318],271,5,4946,3.7384731670445954,40.0,20.0
41323,4,1323,[294 475 301 496 168],537,3,4949,3.737915407854985,0.0,0.0
41324,4,1324,[222   9 175  97 515],13,2,4951,3.7366037735849056,0.0,0.0
41325,4,1325,[245 288 289 238 175],92,3,4954,3.73604826546003,0.0,0.0
41326,4,1326,[385 318  70 135 121],533,4,4958,3.736247174076865,20.0,0.0
41327,4,1327,[603 302 100 427 318],454,5,4963,3.737198795180723,40.0,20.0
41328,4,1328,[268  56 186 289 216],537,3,4966,3.7366440933032354,0.0,0.0
41329,4,1329,[161   4 132 357 179],474,5,4971,3.737593984962406,20.0,0.0
41330,4,1330,[603 302 100 427 318],664,5,4976,3.738542449286251,40.0,20.0
41331,4,1331,[385 222 405  15 200],92,2,4978,3.7372372372372373,0.0,0.0
41332,4,1332,[282 496 385 357 174],311,5,4983,3.738184546136534,20.0,20.0
41333,4,1333,[603 302 100 427 318],664,5,4988,3.739130434782609,40.0,20.0
41334,4,1334,[172 423 588 176 313],308,4,4992,3.7393258426966294,0.0,0.0
41335,4,1335,[423 588 194  70  89],882,3,4995,3.7387724550898205,0.0,0.0
41336,4,1336,[603 302 100 427 318],13,4,4999,3.738967838444278,40.0,20.0
41337,4,1337,[235 181 748 496 186],195,2,5001,3.7376681614349776,0.0,0.0
41338,4,1338,[181  98 195 405  11],804,5,5006,3.7386109036594473,0.0,20.0
41339,4,1339,[271 269 132 333   4],334,1,5007,3.7365671641791045,0.0,0.0
41340,4,1340,[181 265 483  98 180],666,3,5010,3.7360178970917226,20.0,20.0
41341,4,1341,[215 603 197 185 121],308,2,5012,3.7347242921013413,20.0,0.0
41342,4,1342,[  9  89  71 258  79],334,4,5016,3.734921816827997,0.0,0.0
41343,4,1343,[195 222 191 588 121],194,2,5018,3.7336309523809526,0.0,0.0
41344,4,1344,[603 302 100 427 211],13,5,5023,3.7345724907063196,20.0,20.0
41345,4,1345,[603 302 100 427 211],271,5,5028,3.735512630014859,20.0,20.0
41346,4,1346,[202  79  82 318 195],308,5,5033,3.7364513734224203,20.0,0.0
41347,4,1347,[357 173 286  97  89],271,4,5037,3.736646884272997,20.0,0.0
41348,4,1348,[546 597 185 678 357],308,2,5039,3.7353595255745,20.0,0.0
41349,4,1349,[603 302 100 427 211],474,5,5044,3.7362962962962962,20.0,20.0
41350,4,1350,[294 211 174 173 100],538,3,5047,3.7357512953367875,0.0,40.0
41351,4,1351,[318 143 181  96 151],188,3,5050,3.735207100591716,20.0,0.0
41352,4,1352,[328 238 228 135 294],95,3,5053,3.7346637102734666,0.0,0.0
41353,4,1353,[357 195 182   8 427],194,2,5055,3.7333825701624814,20.0,0.0
41354,4,1354,[603 302 100 427 211],14,5,5060,3.734317343173432,20.0,20.0
41355,4,1355,[405  11  12 132   1],560,4,5064,3.734513274336283,20.0,0.0
41356,4,1356,[603 302 100 427 211],454,4,5068,3.7347089167280765,20.0,20.0
41357,4,1357,[258 228 235 322 475],537,2,5070,3.7334315169366716,0.0,0.0
41358,4,1358,[ 69 118 186   8 568],311,3,5073,3.7328918322295808,0.0,0.0
41359,4,1359,[191  22 194  89 196],406,3,5076,3.7323529411764707,0.0,0.0
41360,4,1360,[603 302 100 427 318],334,5,5081,3.7332843497428363,40.0,20.0
41361,4,1361,[603 302 100 427 318],664,5,5086,3.7342143906020557,40.0,20.0
41362,4,1362,[603 302 100 427 318],664,5,5091,3.7351430667644903,40.0,20.0
41363,4,1363,[603 302 100 427 318],334,5,5096,3.7360703812316713,40.0,20.0
41364,4,1364,[168  88  95 234 191],506,5,5101,3.736996336996337,0.0,0.0
41365,4,1365,[210 127 235 173 568],537,2,5103,3.7357247437774523,0.0,20.0
41366,4,1366,[258  56 187 288 471],533,3,5106,3.735186539868325,0.0,0.0
41367,4,1367,[603 302 100 427 318],454,5,5111,3.736111111111111,40.0,20.0
41368,4,1368,[603 302 100 427 318],271,5,5116,3.737034331628926,40.0,20.0
41369,4,1369,[ 69 234 121 405 174],313,4,5120,3.7372262773722627,0.0,20.0
41370,4,1370,[ 98 288 289  95 405],334,1,5121,3.735229759299781,0.0,20.0
41371,4,1371,[294 405 181 237 245],533,2,5123,3.7339650145772594,0.0,0.0
41372,4,1372,[603 302 100 427 318],666,5,5128,3.7348871085214856,40.0,20.0
41373,4,1373,[603 302 100 427 318],271,5,5133,3.7358078602620086,40.0,20.0
41374,4,1374,[603 302 100 427 318],664,5,5138,3.736727272727273,40.0,20.0
41375,4,1375,[405 173 181 215 496],7,3,5141,3.7361918604651163,0.0,0.0
41376,4,1376,[117 597 282 269 245],455,1,5142,3.7342047930283226,0.0,0.0
41377,4,1377,[603 302 100 427 318],271,5,5147,3.735123367198839,40.0,20.0
41378,4,1378,[187  12 168 228 176],537,2,5149,3.7338651196519215,20.0,0.0
41379,4,1379,[135 117 151 655  71],387,1,5150,3.7318840579710146,0.0,0.0
41380,4,1380,[258 185  11 276 405],59,3,5153,3.731354091238233,0.0,0.0
41381,4,1381,[222  82 195 546 423],650,2,5155,3.7301013024602026,0.0,0.0
41382,4,1382,[125 275  12 179  82],378,3,5158,3.7295733911785973,20.0,0.0
41383,4,1383,[568 132 403 483 118],290,2,5160,3.7283236994219653,20.0,0.0
41384,4,1384,[603 302 100 427 318],666,5,5165,3.729241877256318,40.0,20.0
41385,4,1385,[405 153 385 143   9],379,3,5168,3.728715728715729,0.0,0.0
41386,4,1386,[603 302 100 427 318],664,5,5173,3.729632299927902,40.0,20.0
41387,4,1387,[603 302 100 427 318],13,4,5177,3.7298270893371757,40.0,20.0
41388,4,1388,[294 132  70  25 187],271,3,5180,3.7293016558675305,0.0,0.0
41389,4,1389,[ 95 269 258 174 175],13,4,5184,3.729496402877698,0.0,20.0
41390,4,1390,[202  96  11 216 195],871,3,5187,3.7289719626168223,0.0,0.0
41391,4,1391,[ 50  56 161 172 121],378,5,5192,3.7298850574712645,0.0,20.0
41392,4,1392,[175 546 202 265 588],42,2,5194,3.728643216080402,0.0,0.0
41393,4,1393,[603 302 100 427 318],537,5,5199,3.729555236728838,40.0,20.0
41394,4,1394,[603 302 100 427 318],537,5,5204,3.7304659498207884,40.0,20.0
41395,4,1395,[215  11   7  69 216],537,1,5205,3.7285100286532953,0.0,0.0
41396,4,1396,[603 302 100 427 318],454,5,5210,3.7294201861130993,40.0,20.0
41397,4,1397,[603 302 100 427 318],334,5,5215,3.7303290414878396,40.0,20.0
41398,4,1398,[121 135 204 211 186],95,3,5218,3.729807005003574,0.0,0.0
41399,4,1399,[238 181 322  89 127],537,3,5221,3.729285714285714,0.0,20.0
41400,4,1400,[ 25 211  89 200  50],13,3,5224,3.7287651677373304,0.0,20.0
41401,4,1401,[168  22 289 435 204],409,2,5226,3.72753209700428,0.0,0.0
41402,4,1402,[135 271  79 200  12],92,3,5229,3.7270135424091233,20.0,0.0
41403,4,1403,[180 294 258 182 135],788,2,5231,3.7257834757834756,0.0,0.0
41404,4,1404,[603 302 100 427 318],458,5,5236,3.7266903914590745,40.0,20.0
41405,4,1405,[603 302 100 427 318],474,5,5241,3.7275960170697013,40.0,20.0
41406,4,1406,[172 195  96 228  56],883,5,5246,3.728500355366027,0.0,0.0
41407,4,1407,[603 302 100 427 318],474,5,5251,3.729403409090909,40.0,20.0
41408,4,1408,[403 111 202  28 183],59,5,5256,3.730305180979418,0.0,0.0
41409,4,1409,[  7 191 143 238 117],378,3,5259,3.7297872340425533,0.0,0.0
41410,4,1410,[172 289  82  15 210],454,2,5261,3.728561304039688,0.0,0.0
41411,4,1411,[603 302 100 427 318],334,5,5266,3.729461756373938,40.0,20.0
41412,4,1412,[125 568 187 175  69],7,5,5271,3.73036093418259,0.0,0.0
41413,4,1413,[603 302 100 427 318],271,5,5276,3.731258840169731,40.0,20.0
41414,4,1414,[603 302 100 427 318],334,5,5281,3.732155477031802,40.0,20.0
41415,4,1415,[111 405 237 748 210],13,3,5284,3.731638418079096,0.0,0.0
41416,4,1416,[ 15 423 546 257 328],533,4,5288,3.731827805222301,0.0,0.0
41417,4,1417,[ 95 196 515 222 168],406,1,5289,3.729901269393512,0.0,0.0
41418,4,1418,[322 175 202 475 100],207,0,5289,3.727272727272727,0.0,20.0
41419,4,1419,[603 302 427 100 318],458,5,5294,3.728169014084507,40.0,20.0
41420,4,1420,[603 302 427 100 318],454,5,5299,3.729064039408867,40.0,20.0
41421,4,1421,[195 121 282 508   1],406,4,5303,3.729254571026723,0.0,0.0
41422,4,1422,[132 211 174  79 496],85,4,5307,3.729444834855938,0.0,20.0
41423,4,1423,[483 132 357 496  69],343,5,5312,3.730337078651685,40.0,0.0
41424,4,1424,[181   1 357  79   7],308,5,5317,3.7312280701754386,20.0,0.0
41425,4,1425,[603 302 427 100 318],666,5,5322,3.732117812061711,40.0,20.0
41426,4,1426,[132  69 483 289 322],474,4,5326,3.7323055360896986,20.0,0.0
41427,4,1427,[ 25 235 200 135 153],795,1,5327,3.730392156862745,0.0,0.0
41428,4,1428,[603 302 427 100 318],271,5,5332,3.7312806158152556,40.0,20.0
41429,4,1429,[597 180 175  15 471],653,2,5334,3.7300699300699303,0.0,0.0
41430,4,1430,[603 302 427 100 318],13,4,5338,3.73025856044724,40.0,20.0
41431,4,1431,[603 302 427 100 318],664,5,5343,3.731145251396648,40.0,20.0
41432,4,1432,[191 121 153 508 135],339,4,5347,3.7313328681088627,0.0,0.0
41433,4,1433,[216 173 143   4 276],538,1,5348,3.7294281729428174,0.0,0.0
41434,4,1434,[179 200  88  70 588],479,3,5351,3.728919860627178,0.0,0.0
41435,4,1435,[127 269 300 288 322],537,1,5352,3.7270194986072425,0.0,20.0
41436,4,1436,[ 97 228 197  95 182],234,1,5353,3.7251217814892135,0.0,0.0
41437,4,1437,[423 175 403  70 200],543,3,5356,3.72461752433936,0.0,0.0
41438,4,1438,[603 302 427 100 318],537,5,5361,3.7255038220986796,40.0,20.0
41439,4,1439,[603 302 427 100 318],334,5,5366,3.7263888888888888,40.0,20.0
41440,4,1440,[603 302 427 100 318],537,5,5371,3.727272727272727,40.0,20.0
41441,4,1441,[ 25 435 427 423  50],533,5,5376,3.7281553398058254,0.0,20.0
41442,4,1442,[ 95 179 127 180 435],387,3,5379,3.727650727650728,0.0,20.0
41443,4,1443,[182  82 222  69 111],749,2,5381,3.7264542936288088,0.0,0.0
41444,4,1444,[ 95 172 357 127  82],95,3,5384,3.7259515570934254,20.0,20.0
41445,4,1445,[194 197  71 238 313],454,2,5386,3.7247579529737207,0.0,0.0
41446,4,1446,[183  97 405 357 182],328,3,5389,3.7242570836212856,20.0,0.0
41447,4,1447,[234 194 423 135 222],533,3,5392,3.723756906077348,0.0,0.0
41448,4,1448,[183 202 191 318 132],848,4,5396,3.7239475500345067,20.0,0.0
41449,4,1449,[ 28 100 173 269 286],883,2,5398,3.722758620689655,0.0,20.0
41450,4,1450,[182   9 125 143 151],6,2,5400,3.7215713301171607,0.0,0.0
41451,4,1451,[318 222 118 655 197],13,3,5403,3.7210743801652892,20.0,0.0
41452,4,1452,[174 483  25 161 172],533,5,5408,3.721954576737784,20.0,20.0
41453,4,1453,[ 25  12 191 435 151],533,4,5412,3.722145804676754,20.0,0.0
41454,4,1454,[174  15 597  69 117],200,5,5417,3.723024054982818,0.0,20.0
41455,4,1455,[ 25 496 423  96   8],897,3,5420,3.7225274725274726,0.0,0.0
41456,4,1456,[179 546 322 302  11],207,2,5422,3.7213452299245025,0.0,0.0
41457,4,1457,[603 302 427 100 318],474,5,5427,3.7222222222222223,40.0,20.0
41458,4,1458,[ 70 173 200 182   8],795,3,5430,3.7217272104180945,0.0,0.0
41459,4,1459,[301 678 269 286 121],605,2,5432,3.7205479452054795,0.0,0.0
41460,4,1460,[  7 234  88 471 195],145,5,5437,3.7214236824093088,0.0,0.0
41461,4,1461,[603 302 427 100 318],537,5,5442,3.7222982216142273,40.0,20.0
41462,4,1462,[603 302 427 100 318],90,5,5447,3.7231715652768282,40.0,20.0
41463,4,1463,[403 483 179 385   9],194,3,5450,3.7226775956284155,20.0,0.0
41464,4,1464,[271  56 597  64 117],145,5,5455,3.7235494880546076,0.0,0.0
41465,4,1465,[186 180 196  96 151],7,5,5460,3.7244201909959074,0.0,0.0
41466,4,1466,[588 301 328 385 318],378,3,5463,3.723926380368098,20.0,0.0
41467,4,1467,[172 435 286  69 271],379,4,5467,3.724114441416894,0.0,0.0
41468,4,1468,[179 475  89 271   7],64,3,5470,3.723621511232131,0.0,0.0
41469,4,1469,[603 302 427 100 318],90,5,5475,3.7244897959183674,40.0,20.0
41470,4,1470,[603 302 427 100 318],271,5,5480,3.725356900067981,40.0,20.0
41471,4,1471,[161 313 235 100 245],328,4,5484,3.7255434782608696,0.0,20.0
41472,4,1472,[ 69 258 172  11  98],7,4,5488,3.7257298031228783,0.0,20.0
41473,4,1473,[100 181 483   7 276],458,4,5492,3.7259158751696067,20.0,20.0
41474,4,1474,[603 302 427 100 318],271,5,5497,3.7267796610169492,40.0,20.0
41475,4,1475,[603 302 427 100 318],664,5,5502,3.727642276422764,40.0,20.0
41476,4,1476,[603 302 427 100 318],664,5,5507,3.7285037237643874,40.0,20.0
41477,4,1477,[118 483 185 258 121],311,3,5510,3.7280108254397835,20.0,0.0
41478,4,1478,[228 117 275 173 322],311,5,5515,3.728870858688303,0.0,0.0
41479,4,1479,[151 748 186  96  88],533,2,5517,3.7277027027027025,0.0,0.0
41480,4,1480,[603 302 427 100 318],334,5,5522,3.7285617825793382,40.0,20.0
41481,4,1481,[187  28 282 216 182],533,4,5526,3.7287449392712553,0.0,0.0
41482,4,1482,[603 302 427 100 318],666,5,5531,3.729602157788267,40.0,20.0
41483,4,1483,[300 172 318 301 228],537,1,5532,3.7277628032345014,20.0,0.0
41484,4,1484,[435  79 187  71 117],387,2,5534,3.7265993265993265,0.0,0.0
41485,4,1485,[603 302 427 100 318],474,5,5539,3.727456258411844,40.0,20.0
41486,4,1486,[318 238 195 403  96],87,3,5542,3.726967047747142,20.0,0.0
41487,4,1487,[603 302 427 100 318],664,5,5547,3.7278225806451615,40.0,20.0
41488,4,1488,[603 302 427 100 318],666,5,5552,3.7286769644056412,40.0,20.0
41489,4,1489,[603 302 427 100 318],334,5,5557,3.729530201342282,40.0,20.0
41490,4,1490,[603 302 427 100 318],334,5,5562,3.7303822937625752,40.0,20.0
41491,4,1491,[204 121  64 269 127],271,4,5566,3.7305630026809653,0.0,20.0
41492,4,1492,[603 302 427 100 318],271,5,5571,3.7314132618888145,40.0,20.0
41493,4,1493,[603 302 427 100 318],537,5,5576,3.7322623828647923,40.0,20.0
41494,4,1494,[258 265   8 111  82],207,1,5577,3.7304347826086954,0.0,0.0
41495,4,1495,[144 597  64 288 403],308,3,5580,3.729946524064171,0.0,0.0
41496,4,1496,[ 12  82 318 603 186],524,2,5582,3.7287909151636605,60.0,0.0
41497,4,1497,[603 302 427 100 318],666,5,5587,3.7296395193591456,40.0,20.0
41498,4,1498,[546 125   7 183 194],881,4,5591,3.7298198799199467,0.0,0.0
41499,4,1499,[603 302 427 100 318],90,5,5596,3.7306666666666666,40.0,20.0
41500,4,1500,[603 302 427 100 318],334,5,5601,3.731512325116589,40.0,20.0
41501,4,1501,[603 302 427 100 318],13,4,5605,3.7316910785619175,40.0,20.0
41502,4,1502,[603 302 427 100 318],90,5,5610,3.7325349301397206,40.0,20.0
41503,4,1503,[191 333 515 258 655],116,4,5614,3.7327127659574466,0.0,0.0
41504,4,1504,[603 302 427 100 318],664,5,5619,3.7335548172757473,40.0,20.0
41505,4,1505,[143 135 117 174 286],90,4,5623,3.733731739707835,0.0,20.0
41506,4,1506,[ 89 515 191 546 228],92,4,5627,3.733908427339084,0.0,0.0
41507,4,1507,[ 64 202 143  25  12],194,2,5629,3.7327586206896552,20.0,0.0
41508,4,1508,[187 176 234 194 195],804,5,5634,3.7335984095427435,0.0,0.0
41509,4,1509,[196   8   9 546  56],87,4,5638,3.733774834437086,0.0,0.0
41510,4,1510,[496 111 385 168  96],899,4,5642,3.7339510258107214,0.0,0.0
41511,4,1511,[301 323 597  28 117],119,5,5647,3.73478835978836,0.0,0.0
41512,4,1512,[ 82  12 127 276 742],207,2,5649,3.7336417713152676,20.0,20.0
41513,4,1513,[603 302 427 100 318],334,5,5654,3.7344782034346102,40.0,20.0
41514,4,1514,[603 302 427 100 318],90,5,5659,3.7353135313531354,40.0,20.0
41515,4,1515,[603 302 427 100 318],537,5,5664,3.7361477572559365,40.0,20.0
41516,4,1516,[603 302 427 100 318],537,5,5669,3.736980883322347,40.0,20.0
41517,4,1517,[265 301 168  56   1],279,4,5673,3.7371541501976284,0.0,0.0
41518,4,1518,[ 82  79 265 238 276],334,4,5677,3.737327188940092,0.0,0.0
41519,4,1519,[597 144  50 323 294],804,4,5681,3.7375,0.0,20.0
41520,4,1520,[  4 357 187 258  70],207,4,5685,3.73767258382643,20.0,0.0
41521,4,1521,[ 25 265 185 211 143],194,3,5688,3.7371879106438897,0.0,0.0
41522,4,1522,[ 88 435 405 237 182],318,4,5692,3.737360472751149,0.0,0.0
41523,4,1523,[328 265 245 678 269],263,4,5696,3.7375328083989503,0.0,0.0
41524,4,1524,[195 161 118 403   1],749,3,5699,3.737049180327869,0.0,0.0
41525,4,1525,[ 56 216 333 125  22],144,4,5703,3.737221494102228,0.0,0.0
41526,4,1526,[603 302 427 100 318],454,5,5708,3.7380484610347087,40.0,20.0
41527,4,1527,[121 181 204 210 111],666,0,5708,3.735602094240838,0.0,0.0
41528,4,1528,[  1 186 182 385 197],533,3,5711,3.7351209941138,0.0,0.0
41529,4,1529,[ 69 132 161 655 194],328,4,5715,3.735294117647059,0.0,0.0
41530,4,1530,[237 196  56 435 328],85,3,5718,3.73481384715872,0.0,0.0
41531,4,1531,[302 655 111 211 168],833,1,5719,3.7330287206266317,0.0,0.0
41532,4,1532,[357  82  79 228 197],194,2,5721,3.731898238747554,20.0,0.0
41533,4,1533,[151 333  11 183 423],64,3,5724,3.7314211212516297,0.0,0.0
41534,4,1534,[289  95 333 318 357],85,3,5727,3.730944625407166,40.0,0.0
41535,4,1535,[183 135 286  69 288],200,5,5732,3.7317708333333335,0.0,0.0
41536,4,1536,[603 302 427 100 318],664,5,5737,3.7325959661678594,40.0,20.0
41537,4,1537,[161 210  95 294   9],271,3,5740,3.732119635890767,0.0,0.0
41538,4,1538,[275  98 268 211 471],13,3,5743,3.731643924626381,0.0,20.0
41539,4,1539,[403  88 282 185  71],42,4,5747,3.731818181818182,0.0,0.0
41540,4,1540,[ 79 181  64 176 588],64,5,5752,3.7326411421155092,0.0,0.0
41541,4,1541,[175 228   1 289 168],82,3,5755,3.732166018158236,0.0,0.0
41542,4,1542,[127  64  79 748 333],64,3,5758,3.731691510045366,0.0,20.0
41543,4,1543,[ 82 215 132  56 135],788,1,5759,3.729922279792746,0.0,0.0
41544,4,1544,[603 302 427 100 318],271,5,5764,3.7307443365695794,40.0,20.0
41545,4,1545,[195 275  97  71 222],13,2,5766,3.7296248382923674,0.0,0.0
41546,4,1546,[603 302 427 100 318],13,4,5770,3.7297996121525534,40.0,20.0
41547,4,1547,[603 302 427 100 318],90,5,5775,3.7306201550387597,40.0,20.0
41548,4,1548,[ 82  96  98 228 216],328,3,5778,3.7301484828921887,0.0,20.0
41549,4,1549,[603 302 427 100 318],334,5,5783,3.730967741935484,40.0,20.0
41550,4,1550,[195  25 268 678 172],537,1,5784,3.7292069632495166,0.0,0.0
41551,4,1551,[151  88 385 546 191],749,3,5787,3.7287371134020617,0.0,0.0
41552,4,1552,[ 89   4  64 257 176],804,5,5792,3.7295556986477787,0.0,0.0
41553,4,1553,[161   7 286 183 191],378,5,5797,3.7303732303732304,0.0,0.0
41554,4,1554,[603 302 427 100 318],666,5,5802,3.7311897106109324,40.0,20.0
41555,4,1555,[322 180 176  11 496],308,3,5805,3.730719794344473,0.0,0.0
41556,4,1556,[174 546 496   9 151],308,3,5808,3.7302504816955686,0.0,20.0
41557,4,1557,[603 302 427 100 318],666,5,5813,3.7310654685494224,40.0,20.0
41558,4,1558,[603 302 427 100 318],664,5,5818,3.731879409878127,40.0,20.0
41559,4,1559,[228 215 202 265 173],95,4,5822,3.732051282051282,0.0,0.0
41560,4,1560,[603 302 427 100 318],664,5,5827,3.732863549007047,40.0,20.0
41561,4,1561,[ 70 187 603 435 132],64,4,5831,3.73303457106274,20.0,0.0
41562,4,1562,[ 56 111  69 234 100],92,4,5835,3.7332053742802302,0.0,20.0
41563,4,1563,[143 127 276 423 269],233,5,5840,3.734015345268542,0.0,20.0
41564,4,1564,[475 195 204 210 322],207,0,5840,3.731629392971246,0.0,0.0
41565,4,1565,[603 302 427 100 318],334,5,5845,3.732439335887612,40.0,20.0
41566,4,1566,[603 302 427 100 318],458,5,5850,3.7332482450542437,40.0,20.0
41567,4,1567,[403 187 182 173 161],804,4,5854,3.733418367346939,0.0,0.0
41568,4,1568,[234 423 144 265   7],778,3,5857,3.732950924155513,0.0,0.0
41569,4,1569,[211 328 276  25 258],537,3,5860,3.732484076433121,0.0,0.0
41570,4,1570,[144 118 423  96   7],374,3,5863,3.732017823042648,0.0,0.0
41571,4,1571,[175 568 483 121 151],892,5,5868,3.732824427480916,20.0,0.0
41572,4,1572,[181 132 435  12  97],524,3,5871,3.732358550540369,20.0,0.0
41573,4,1573,[182 173 121 179 273],374,2,5873,3.7312579415501905,0.0,0.0
41574,4,1574,[265 471 118 197  79],479,4,5877,3.7314285714285713,0.0,0.0
41575,4,1575,[211 508 183 423   1],13,3,5880,3.730964467005076,0.0,0.0
41576,4,1576,[603 302 427 100 318],13,4,5884,3.731135066582118,40.0,20.0
41577,4,1577,[176 265 655 483 238],311,5,5889,3.7319391634980987,20.0,0.0
41578,4,1578,[405  69  88 100 176],379,4,5893,3.7321089297023433,0.0,20.0
41579,4,1579,[603 302 427 100 318],537,5,5898,3.732911392405063,40.0,20.0
41580,4,1580,[182 568 496  56 153],488,2,5900,3.7318153067678685,0.0,0.0
41581,4,1581,[  1  22 423 403 357],343,5,5905,3.732616940581542,20.0,0.0
41582,4,1582,[603 302 427 100 318],664,5,5910,3.733417561591914,40.0,20.0
41583,4,1583,[603 302 427 100 318],537,5,5915,3.7342171717171717,40.0,20.0
41584,4,1584,[179  64 294 483 202],311,4,5919,3.734384858044164,20.0,0.0
41585,4,1585,[210 222 204 196  96],650,4,5923,3.7345523329129886,0.0,0.0
41586,4,1586,[180 210 195 111  12],901,3,5926,3.73408947700063,20.0,0.0
41587,4,1587,[603 302 427 100 318],454,5,5931,3.7348866498740554,40.0,20.0
41588,4,1588,[175 222 483 153 546],343,4,5935,3.7350534927627437,20.0,0.0
41589,4,1589,[588 568 286  82 194],102,1,5936,3.7333333333333334,0.0,0.0
41590,4,1590,[  1 483 100 655  96],454,2,5938,3.7322438717787554,20.0,20.0
41591,4,1591,[222 187  64 238 678],474,4,5942,3.7324120603015074,0.0,0.0
41592,4,1592,[302  28   1  12 265],378,5,5947,3.733207784055242,20.0,0.0
41593,4,1593,[271 483   9 678 222],334,3,5950,3.7327478042659976,20.0,0.0
41594,4,1594,[405 294 210 276 265],533,2,5952,3.7316614420062697,0.0,0.0
41595,4,1595,[196 117 176  97 748],346,4,5956,3.7318295739348373,0.0,0.0
41596,4,1596,[ 98 435 144  28  97],13,5,5961,3.7326236693800876,0.0,20.0
41597,4,1597,[603 302 427 100 318],90,5,5966,3.7334167709637045,40.0,20.0
41598,4,1598,[187 238  79 357 100],881,4,5970,3.7335834896810507,20.0,20.0
41599,4,1599,[228 127 182 235 435],406,4,5974,3.73375,0.0,20.0
41600,4,1600,[210 127  71 597   4],308,4,5978,3.7339163023110555,0.0,20.0
41601,4,1601,[161 151 496  56  88],200,4,5982,3.7340823970037453,0.0,0.0
41602,4,1602,[275 597 237  98 222],554,4,5986,3.734248284466625,0.0,20.0
41603,4,1603,[302  50 197  96 127],210,5,5991,3.7350374064837903,0.0,40.0
41604,4,1604,[655 210  70 322 742],308,4,5995,3.735202492211838,0.0,0.0
41605,4,1605,[176  28 183  22 301],328,4,5999,3.7353673723536738,0.0,0.0
41606,4,1606,[ 64 238  28 183 174],774,2,6001,3.734287492221531,0.0,20.0
41607,4,1607,[742  82 228  22 483],749,5,6006,3.735074626865672,20.0,0.0
41608,4,1608,[161 174 200 173 323],648,3,6009,3.7346177750155376,0.0,20.0
41609,4,1609,[ 15 210 475 238  69],537,2,6011,3.7335403726708076,0.0,0.0
41610,4,1610,[435  12 121   9 161],194,4,6015,3.733705772811918,20.0,0.0
41611,4,1611,[294 265  11  25 211],474,4,6019,3.7338709677419355,0.0,0.0
41612,4,1612,[185 187   8  98 118],13,4,6023,3.7340359578425293,0.0,20.0
41613,4,1613,[603 302 427 100 318],537,5,6028,3.734820322180917,40.0,20.0
41614,4,1614,[ 50 161 121 357   4],833,1,6029,3.73312693498452,20.0,20.0
41615,4,1615,[603 302 427 100 318],537,5,6034,3.733910891089109,40.0,20.0
41616,4,1616,[603 302 427 100 318],666,5,6039,3.7346938775510203,40.0,20.0
41617,4,1617,[125  15   8  64 117],207,3,6042,3.734239802224969,0.0,0.0
41618,4,1618,[603 302 427 100 318],334,5,6047,3.735021618282891,40.0,20.0
41619,4,1619,[289 655 191 202 471],92,3,6050,3.734567901234568,0.0,0.0
41620,4,1620,[603 302 427 100 318],13,4,6054,3.7347316471314005,40.0,20.0
41621,4,1621,[742 300  95 176 151],749,4,6058,3.7348951911220714,0.0,0.0
41622,4,1622,[603 302 427 100 318],271,5,6063,3.7356746765249538,40.0,20.0
41623,4,1623,[269 313 234  25 183],378,5,6068,3.7364532019704435,0.0,0.0
41624,4,1624,[195   8 257 597 168],308,4,6072,3.7366153846153844,0.0,0.0
41625,4,1625,[117 237 111 405 144],374,4,6076,3.7367773677736777,0.0,0.0
41626,4,1626,[202 471 117 174 173],158,4,6080,3.736939151813153,0.0,20.0
41627,4,1627,[475  96 238 195 323],648,3,6083,3.7364864864864864,0.0,0.0
41628,4,1628,[211 435 186   4 215],271,5,6088,3.7372621240024553,0.0,0.0
41629,4,1629,[603 302 427 100 318],271,5,6093,3.738036809815951,40.0,20.0
41630,4,1630,[ 12 748 174 127 237],883,4,6097,3.7381974248927037,20.0,40.0
41631,4,1631,[603 302 427 100 318],664,5,6102,3.738970588235294,40.0,20.0
41632,4,1632,[603 302 427 100 318],13,4,6106,3.739130434782609,40.0,20.0
41633,4,1633,[257   9  88  11 276],308,5,6111,3.7399020807833536,0.0,0.0
41634,4,1634,[603 302 427 100 318],13,4,6115,3.7400611620795106,40.0,20.0
41635,4,1635,[197  56  98 187 179],643,4,6119,3.7402200488997557,0.0,20.0
41636,4,1636,[603 302 427 100 318],458,5,6124,3.740989615149664,40.0,20.0
41637,4,1637,[ 96 176 182 423 187],64,5,6129,3.741758241758242,0.0,0.0
41638,4,1638,[603  70 100 204  25],804,5,6134,3.7425259304453937,20.0,20.0
41639,4,1639,[603 302 427 100 318],664,5,6139,3.743292682926829,40.0,20.0
41640,4,1640,[ 28 597 222 100 742],554,3,6142,3.7428397318708106,0.0,20.0
41641,4,1641,[118 215 186 294  64],653,2,6144,3.7417783191230205,0.0,0.0
41642,4,1642,[258 173 483 496 603],749,5,6149,3.742544126597687,40.0,0.0
41643,4,1643,[603 302 427 100 318],664,5,6154,3.74330900243309,40.0,20.0
41644,4,1644,[ 15 151 121 403 216],479,2,6156,3.7422492401215806,0.0,0.0
41645,4,1645,[603 302 427 100 318],537,5,6161,3.7430133657351154,40.0,20.0
41646,4,1646,[475  89 216  70 176],308,4,6165,3.7431693989071038,0.0,0.0
41647,4,1647,[181 269 174  56 318],334,4,6169,3.7433252427184467,20.0,20.0
41648,4,1648,[ 28 328 678 179 195],537,1,6170,3.741661613098848,0.0,0.0
41649,4,1649,[216 204  70 222 265],653,2,6172,3.7406060606060607,0.0,0.0
41650,4,1650,[385  64 204   8  70],87,5,6177,3.741368867353119,0.0,0.0
41651,4,1651,[515 483 471 268 182],234,2,6179,3.740314769975787,20.0,0.0
41652,4,1652,[748 515 289  22 211],883,4,6183,3.7404718693284935,0.0,0.0
41653,4,1653,[ 69 265 228 210 194],650,3,6186,3.740024183796856,0.0,0.0
41654,4,1654,[181 282 125 179 423],194,1,6187,3.738368580060423,0.0,0.0
41655,4,1655,[603 302 427 100 318],454,5,6192,3.739130434782609,40.0,20.0
41656,4,1656,[603 302 427 100 318],474,5,6197,3.739891369945685,40.0,20.0
41657,4,1657,[603 302 427 100 318],271,5,6202,3.7406513872135103,40.0,20.0
41658,4,1658,[423 175 286 289   9],788,4,6206,3.74080771549126,0.0,0.0
41659,4,1659,[ 95 194 235 200 181],648,3,6209,3.7403614457831327,0.0,0.0
41660,4,1660,[195 742  98 200 186],328,4,6213,3.74051776038531,0.0,20.0
41661,4,1661,[603 302 427 100 318],537,5,6218,3.7412755716004815,40.0,20.0
41662,4,1662,[ 22 678 144  96  64],804,5,6223,3.742032471437162,0.0,0.0
41663,4,1663,[228 186 265  69  12],234,1,6224,3.7403846153846154,20.0,0.0
41664,4,1664,[191  97  12  22   7],64,4,6228,3.7405405405405405,20.0,0.0
41665,4,1665,[100 121 151 132 174],380,4,6232,3.7406962785114044,0.0,40.0
41666,4,1666,[603 302 427 100 318],537,5,6237,3.7414517096580684,40.0,20.0
41667,4,1667,[ 70 194 187  69 185],840,2,6239,3.7404076738609113,0.0,0.0
41668,4,1668,[181 588 288 475 197],13,3,6242,3.739964050329539,0.0,0.0
41669,4,1669,[603 302 427 100 318],13,4,6246,3.740119760479042,40.0,20.0
41670,4,1670,[238 405 423 194 181],385,1,6247,3.7384799521244765,0.0,0.0
41671,4,1671,[603 302 427 100 318],334,5,6252,3.7392344497607657,40.0,20.0
41672,4,1672,[228 181 153  89  25],77,2,6254,3.7381948595337717,0.0,0.0
41673,4,1673,[118 471 435 186   1],271,2,6256,3.7371565113500598,0.0,0.0
41674,4,1674,[237  50 496 185 515],882,5,6261,3.737910447761194,0.0,20.0
41675,4,1675,[603 302 427 100 318],271,5,6266,3.7386634844868736,40.0,20.0
41676,4,1676,[172 153 179 194 132],653,1,6267,3.737030411449016,0.0,0.0
41677,4,1677,[153 173 196 174  89],144,4,6271,3.7371871275327773,0.0,20.0
41678,4,1678,[603 302 427 100 318],664,5,6276,3.7379392495533055,40.0,20.0
41679,4,1679,[603 302 427 100 318],271,5,6281,3.738690476190476,40.0,20.0
41680,4,1680,[191  71 117  82  28],234,2,6283,3.7376561570493756,0.0,0.0
41681,4,1681,[603 302 427 100 318],13,4,6287,3.7378121284185495,40.0,20.0
41682,4,1682,[ 97 300 186 197 269],537,2,6289,3.736779560308972,0.0,0.0
41683,4,1683,[ 82  89 265 144  98],339,3,6292,3.736342042755344,0.0,20.0
41684,4,1684,[603 302 427 100 318],334,5,6297,3.737091988130564,40.0,20.0
41685,4,1685,[257 100  82 196 187],339,5,6302,3.737841043890866,0.0,20.0
41686,4,1686,[603 302 427 100 318],666,5,6307,3.7385892116182573,40.0,20.0
41687,4,1687,[100 161 273  89 210],92,4,6311,3.7387440758293837,0.0,20.0
41688,4,1688,[ 56 176 742 328 655],506,5,6316,3.739490822972173,0.0,0.0
41689,4,1689,[603 302 427 100 318],666,5,6321,3.7402366863905327,40.0,20.0
41690,4,1690,[176 423 258 195 742],387,2,6323,3.7392075694855116,0.0,0.0
41691,4,1691,[603 302 427 100 318],664,5,6328,3.739952718676123,40.0,20.0
41692,4,1692,[168 403 234   1 111],899,3,6331,3.739515652687537,0.0,0.0
41693,4,1693,[ 64 204 176 288 237],533,2,6333,3.7384887839433296,0.0,0.0
41694,4,1694,[603 302 427 100 318],90,5,6338,3.7392330383480825,40.0,20.0
41695,4,1695,[603 302 427 100 318],90,5,6343,3.7399764150943398,40.0,20.0
41696,4,1696,[603 302 427 100 318],13,4,6347,3.740129640542133,40.0,20.0
41697,4,1697,[ 88 172 210 200 174],234,1,6348,3.7385159010600706,0.0,20.0
41698,4,1698,[318 185 216 202 423],7,4,6352,3.7386698057680987,20.0,0.0
41699,4,1699,[257 181 182 172  25],881,3,6355,3.738235294117647,0.0,0.0
41700,4,1700,[ 11 294 191 271 496],749,4,6359,3.738389182833627,0.0,0.0
41701,4,1701,[ 96 328 322 180  88],234,0,6359,3.736192714453584,0.0,0.0
41702,4,1702,[603 302 427 100 318],537,5,6364,3.7369348209042865,40.0,20.0
41703,4,1703,[  8  25 269 275  89],13,2,6366,3.7359154929577465,0.0,0.0
41704,4,1704,[173  82 385 258 294],538,1,6367,3.7343108504398828,0.0,0.0
41705,4,1705,[ 15  96 175  79 181],881,2,6369,3.7332942555685813,0.0,0.0
41706,4,1706,[228  15 655  88   8],92,3,6372,3.73286467486819,0.0,0.0
41707,4,1707,[471  95 186 403 151],234,0,6372,3.730679156908665,0.0,0.0
41708,4,1708,[222   1 597 195  79],145,4,6376,3.7308367466354593,0.0,0.0
41709,4,1709,[228 204  64 153 282],406,2,6378,3.729824561403509,0.0,0.0
41710,4,1710,[603 302 427 100  64],370,5,6383,3.7305669199298657,20.0,20.0
41711,4,1711,[603 191 143 204 100],454,5,6388,3.7313084112149535,20.0,20.0
41712,4,1712,[603 302 427 100  64],454,5,6393,3.732049036777583,20.0,20.0
41713,4,1713,[294 191 742 132  88],271,3,6396,3.731621936989498,0.0,0.0
41714,4,1714,[323  56 173 153 403],378,4,6400,3.7317784256559765,0.0,0.0
41715,4,1715,[385 405 742 132  22],313,2,6402,3.730769230769231,0.0,0.0
41716,4,1716,[117  97 202 322 273],234,0,6402,3.72859638905067,0.0,0.0
41717,4,1717,[228  89 423 204 216],374,3,6405,3.728172293364377,0.0,0.0
41718,4,1718,[300 289 186 323 200],13,1,6406,3.726585223967423,0.0,0.0
41719,4,1719,[603 302 427 100  64],271,5,6411,3.7273255813953488,20.0,20.0
41720,4,1720,[603 302 427 100  64],454,5,6416,3.728065078442766,20.0,20.0
41721,4,1721,[301 245 258 168 286],119,4,6420,3.7282229965156795,0.0,0.0
41722,4,1722,[603 302 427 100  64],370,5,6425,3.7289611143354615,20.0,20.0
41723,4,1723,[ 95 496 161 143 323],648,3,6428,3.7285382830626452,0.0,0.0
41724,4,1724,[276  11 313 265  12],59,5,6433,3.7292753623188406,20.0,0.0
41725,4,1725,[210 202 183 127 173],207,1,6434,3.727694090382387,0.0,20.0
41726,4,1726,[ 22 117 496  89 121],378,3,6437,3.727272727272727,0.0,0.0
41727,4,1727,[191  70 357 403 168],13,1,6438,3.7256944444444446,20.0,0.0
41728,4,1728,[655  50 168 173 405],474,4,6442,3.725853094274147,0.0,20.0
41729,4,1729,[435 588  79 228  56],387,3,6445,3.7254335260115607,0.0,0.0
41730,4,1730,[603 302 427 100  64],458,5,6450,3.7261698440207973,20.0,20.0
41731,4,1731,[194 603  64  28 238],883,3,6453,3.7257505773672057,20.0,0.0
41732,4,1732,[603 302 427 100  64],458,5,6458,3.726485862665897,20.0,20.0
41733,4,1733,[603 302 427 100  64],339,5,6463,3.7272202998846597,20.0,20.0
41734,4,1734,[111 318 257 294  25],533,5,6468,3.7279538904899137,20.0,0.0
41735,4,1735,[191 185 215  71 204],804,5,6473,3.7286866359447006,0.0,0.0
41736,4,1736,[603 302 427 100  64],458,5,6478,3.729418537708693,20.0,20.0
41737,4,1737,[603 302 427 100  64],370,5,6483,3.730149597238205,20.0,20.0
41738,4,1738,[258 515  89 186  64],85,4,6487,3.730304772857964,0.0,0.0
41739,4,1739,[603 302 427 100  64],664,5,6492,3.731034482758621,20.0,20.0
41740,4,1740,[294  28  70 215 180],474,4,6496,3.7311889718552558,0.0,0.0
41741,4,1741,[603 302 427 100  64],745,5,6501,3.7319173363949485,20.0,20.0
41742,4,1742,[210 405 238 222 173],194,2,6503,3.7309236947791167,0.0,0.0
41743,4,1743,[ 11 132 405  56  25],666,3,6506,3.7305045871559632,0.0,0.0
41744,4,1744,[603 302 427 100  64],745,5,6511,3.7312320916905444,20.0,20.0
41745,4,1745,[603 302 427 100  64],271,5,6516,3.731958762886598,20.0,20.0
41746,4,1746,[357 172 216  22 328],479,4,6520,3.732112192329708,20.0,0.0
41747,4,1747,[301  96 496 186 328],234,1,6521,3.730549199084668,0.0,0.0
41748,4,1748,[275 238 282 300 161],378,4,6525,3.730703259005146,0.0,0.0
41749,4,1749,[603 302 427 100  64],664,5,6530,3.7314285714285713,20.0,20.0
41750,4,1750,[603 302 427 100  64],271,5,6535,3.732153055396916,20.0,20.0
41751,4,1751,[603 302 427 100  64],370,5,6540,3.732876712328767,20.0,20.0
41752,4,1752,[117 181 427 153  82],536,5,6545,3.733599543639475,0.0,0.0
41753,4,1753,[603 302 427 100  64],13,5,6550,3.734321550741163,20.0,20.0
41754,4,1754,[234 100 143 313 357],454,3,6553,3.733903133903134,20.0,20.0
41755,4,1755,[ 97   8 301 333 302],458,2,6555,3.7329157175398633,0.0,0.0
41756,4,1756,[100 121 282 234 117],479,3,6558,3.732498577120091,0.0,20.0
41757,4,1757,[ 15 202 483 125 181],749,5,6563,3.7332195676905573,20.0,0.0
41758,4,1758,[603 302 427 100  64],664,5,6568,3.733939738487777,20.0,20.0
41759,4,1759,[  4 289 161 176  64],234,3,6571,3.733522727272727,0.0,0.0
41760,4,1760,[603 302 427 100  64],370,5,6576,3.734241908006814,20.0,20.0
41761,4,1761,[234 186 245  50 125],653,3,6579,3.7338251986379114,0.0,20.0
41762,4,1762,[318 258 588   8 237],378,5,6584,3.7345433919455475,20.0,0.0
41763,4,1763,[546  50 194 185 127],194,3,6587,3.734126984126984,0.0,40.0
41764,4,1764,[483 385 215 117 121],313,5,6592,3.734844192634561,20.0,0.0
41765,4,1765,[603 302 427 100  64],90,5,6597,3.7355605889014725,20.0,20.0
41766,4,1766,[196 176  89 183 172],326,4,6601,3.735710243350311,0.0,0.0
41767,4,1767,[568  89 405  82 174],385,1,6602,3.734162895927602,0.0,20.0
41768,4,1768,[603 302 427 100  64],666,5,6607,3.7348784624081404,20.0,20.0
41769,4,1769,[603 302 427 100  64],666,5,6612,3.7355932203389832,20.0,20.0
41770,4,1770,[168 202  88 271 196],749,5,6617,3.7363071710897797,0.0,0.0
41771,4,1771,[271 357 322 289 180],537,2,6619,3.735327313769752,20.0,0.0
41772,4,1772,[603 302 427 100  64],271,5,6624,3.736040609137056,20.0,20.0
41773,4,1773,[328 127 117 515 202],102,1,6625,3.734498308906426,0.0,20.0
41774,4,1774,[ 70 483 237 111 179],234,1,6626,3.7329577464788732,20.0,0.0
41775,4,1775,[276 678 258  15 508],486,3,6629,3.732545045045045,0.0,0.0
41776,4,1776,[603 302 427 100  64],13,5,6634,3.7332583005064714,20.0,20.0
41777,4,1777,[ 88 210  97 191 588],840,3,6637,3.732845894263217,0.0,0.0
41778,4,1778,[265 237  79 403 176],7,4,6641,3.7329960652051715,0.0,0.0
41779,4,1779,[191   7  22 238 655],804,5,6646,3.7337078651685394,0.0,0.0
41780,4,1780,[603 302 427 100  64],666,5,6651,3.734418865805727,20.0,20.0
41781,4,1781,[185 655 268   1  89],643,4,6655,3.734567901234568,0.0,0.0
41782,4,1782,[603 302 427 100  64],271,5,6660,3.735277621985418,20.0,20.0
41783,4,1783,[603 302 427 100  64],458,5,6665,3.7359865470852016,20.0,20.0
41784,4,1784,[125  28 568 435  22],648,4,6669,3.7361344537815127,0.0,0.0
41785,4,1785,[603 302 427 100  64],745,5,6674,3.736842105263158,20.0,20.0
41786,4,1786,[222 588  98 172 237],454,1,6675,3.735310576385003,0.0,20.0
41787,4,1787,[603 302 427 100  64],745,5,6680,3.7360178970917226,20.0,20.0
41788,4,1788,[183  25  70 121 132],184,4,6684,3.7361654555617663,0.0,0.0
41789,4,1789,[  8 588  64 282 211],85,3,6687,3.735754189944134,0.0,0.0
41790,4,1790,[603 237   1 357 132],454,2,6689,3.734785036292574,40.0,0.0
41791,4,1791,[181 127 185 323 135],13,3,6692,3.734375,0.0,20.0
41792,4,1792,[603 302 427 100  64],474,5,6697,3.7350808700501954,20.0,20.0
41793,4,1793,[603 302 427 100  64],664,5,6702,3.7357859531772575,20.0,20.0
41794,4,1794,[318 357 135  79 288],234,3,6705,3.735376044568245,40.0,0.0
41795,4,1795,[ 89 385 100 151 357],234,2,6707,3.7344097995545655,20.0,20.0
41796,4,1796,[603 302 427 100  64],745,5,6712,3.73511407902059,20.0,20.0
41797,4,1797,[405  15 222 143 127],648,3,6715,3.734705228031146,0.0,20.0
41798,4,1798,[603 302 427 100  64],90,5,6720,3.735408560311284,20.0,20.0
41799,4,1799,[ 88  98 210 237 111],234,1,6721,3.733888888888889,0.0,20.0
41800,4,1800,[ 15 143 200 191 174],653,3,6724,3.733481399222654,0.0,20.0
41801,4,1801,[210 237 183 121 435],7,5,6729,3.7341842397336293,0.0,0.0
41802,4,1802,[603 302 427 100  64],745,5,6734,3.734886300610094,20.0,20.0
41803,4,1803,[603 302 427 100  64],271,5,6739,3.7355875831485585,20.0,20.0
41804,4,1804,[161 121  22 333  56],64,2,6741,3.7346260387811636,0.0,0.0
41805,4,1805,[603 302 427 100  64],339,5,6746,3.7353266888150607,20.0,20.0
41806,4,1806,[603 302 427 100  64],745,5,6751,3.736026563364693,20.0,20.0
41807,4,1807,[173 183  64 237  98],13,4,6755,3.7361725663716814,0.0,20.0
41808,4,1808,[603 302 427 100  64],13,5,6760,3.7368711995577666,20.0,20.0
41809,4,1809,[546   4 100 405 276],533,1,6761,3.7353591160220994,0.0,20.0
41810,4,1810,[179  28 175  50 144],13,4,6765,3.735505245720596,0.0,20.0
41811,4,1811,[603 302 427 100  64],339,5,6770,3.7362030905077264,20.0,20.0
41812,4,1812,[  1  88 597 196 121],308,2,6772,3.7352454495311638,0.0,0.0
41813,4,1813,[ 89 546 435  97 100],666,5,6777,3.7359426681367145,0.0,20.0
41814,4,1814,[ 15 323 100 313 269],26,4,6781,3.7360881542699724,0.0,20.0
41815,4,1815,[237 174 194  98 655],59,3,6784,3.73568281938326,0.0,40.0
41816,4,1816,[301  56 143 496 234],650,3,6787,3.7352779306549255,0.0,0.0
41817,4,1817,[197 118 748 322 117],454,3,6790,3.734873487348735,0.0,0.0
41818,4,1818,[216  50 597 222 405],533,3,6793,3.7344694887300713,0.0,20.0
41819,4,1819,[  9  88   8 195 475],92,4,6797,3.7346153846153847,0.0,0.0
41820,4,1820,[603 302 427 100  64],90,5,6802,3.7353102690829214,20.0,20.0
41821,4,1821,[483 181 172 265 176],897,2,6804,3.734357848518112,20.0,0.0
41822,4,1822,[603 302 427 100  64],458,5,6809,3.735052111903456,20.0,20.0
41823,4,1823,[475 655 302 127 282],334,5,6814,3.7357456140350878,0.0,20.0
41824,4,1824,[111 288 211  96 222],13,3,6817,3.735342465753425,0.0,0.0
41825,4,1825,[603 302 427 100  64],537,4,6821,3.735487404162103,20.0,20.0
41826,4,1826,[168 183 423 237  82],295,4,6825,3.735632183908046,0.0,0.0
41827,4,1827,[603 302 427 100  64],271,5,6830,3.736323851203501,20.0,20.0
41828,4,1828,[ 96  82  71 222  79],892,3,6833,3.7359212684527066,0.0,0.0
41829,4,1829,[568 273   9 258 174],90,3,6836,3.73551912568306,0.0,20.0
41830,4,1830,[144 237 286 182 132],194,1,6837,3.7340251228836703,0.0,0.0
41831,4,1831,[603 302 427 100  64],271,5,6842,3.73471615720524,20.0,20.0
41832,4,1832,[175 182 405 215  15],95,3,6845,3.734315330060011,0.0,0.0
41833,4,1833,[435 174 121 234 181],339,4,6849,3.7344601962922575,0.0,20.0
41834,4,1834,[ 71  70 300 143 173],7,3,6852,3.7340599455040873,0.0,0.0
41835,4,1835,[ 64   7 238 143 588],406,3,6855,3.7336601307189543,0.0,0.0
41836,4,1836,[117  69 151 210  82],290,3,6858,3.7332607512248233,0.0,0.0
41837,4,1837,[151 228 182 211 222],64,4,6862,3.733405875952122,0.0,0.0
41838,4,1838,[435 153 515  64 496],85,4,6866,3.7335508428493744,0.0,0.0
41839,4,1839,[173 235 196 405 742],378,4,6870,3.733695652173913,0.0,0.0
41840,4,1840,[603 302 427 100  64],339,5,6875,3.734383487235198,20.0,20.0
41841,4,1841,[174 276  98 286 194],458,2,6877,3.733441910966341,0.0,40.0
41842,4,1842,[603 302 427 100  64],454,5,6882,3.73412913727618,20.0,20.0
41843,4,1843,[655 271 161 172 216],64,3,6885,3.7337310195227764,0.0,0.0
41844,4,1844,[ 22  12  69 186 276],339,5,6890,3.734417344173442,20.0,0.0
41845,4,1845,[475 405 182 271 385],92,3,6893,3.7340195016251356,0.0,0.0
41846,4,1846,[568 273 288  25 655],13,1,6894,3.732539252842447,0.0,0.0
41847,4,1847,[603 302 427 100  64],458,5,6899,3.7332251082251084,20.0,20.0
41848,4,1848,[318  71  22 211  50],82,4,6903,3.7333693888588426,20.0,20.0
41849,4,1849,[568 588 197 546  97],308,2,6905,3.7324324324324323,0.0,0.0
41850,4,1850,[603 302 427 100  64],271,5,6910,3.7331172339276066,20.0,20.0
41851,4,1851,[276 228 176 655 357],406,3,6913,3.7327213822894167,20.0,0.0
41852,4,1852,[603 302 427 100  64],454,5,6918,3.733405288720993,20.0,20.0
41853,4,1853,[603 302 427 100  64],13,5,6923,3.7340884573894284,20.0,20.0
41854,4,1854,[215 127 275 427 210],85,2,6925,3.733153638814016,0.0,20.0
41855,4,1855,[153 508 143 385 273],378,5,6930,3.7338362068965516,0.0,0.0
41856,4,1856,[ 96 234 100 196 228],455,5,6935,3.734518039849219,0.0,20.0
41857,4,1857,[100  64  98 508 186],92,5,6940,3.735199138858988,0.0,40.0
41858,4,1858,[210 235 222 186  70],378,3,6943,3.734803657880581,0.0,0.0
41859,4,1859,[515  11 135  64 168],804,4,6947,3.7349462365591397,0.0,0.0
41860,4,1860,[603 302 427 100  64],664,5,6952,3.7356260075228374,20.0,20.0
41861,4,1861,[200  64  25 174 269],145,4,6956,3.7357679914070894,0.0,20.0
41862,4,1862,[ 88  50 135 423   9],308,5,6961,3.7364465915190554,0.0,20.0
41863,4,1863,[271 211 195 215 294],650,2,6963,3.7355150214592276,0.0,0.0
41864,4,1864,[ 82 100 118  95 172],308,4,6967,3.735656836461126,0.0,20.0
41865,4,1865,[ 28   9  98 515  11],7,3,6970,3.735262593783494,0.0,20.0
41866,4,1866,[603 302 427 100  64],745,5,6975,3.7359400107123726,20.0,20.0
41867,4,1867,[197 185 276  22 385],234,2,6977,3.7350107066381155,0.0,0.0
41868,4,1868,[742 176   9 483 182],533,3,6980,3.734617442482611,20.0,0.0
41869,4,1869,[200 194 678  89 302],13,3,6983,3.7342245989304814,0.0,0.0
41870,4,1870,[603 302 427 100  64],537,4,6987,3.734366648850882,20.0,20.0
41871,4,1871,[200 238 186 282 515],95,4,6991,3.734508547008547,0.0,0.0
41872,4,1872,[603 302 427 100  64],271,5,6996,3.7351841964762413,20.0,20.0
41873,4,1873,[ 89 175 515 265 191],650,5,7001,3.7358591248665953,0.0,0.0
41874,4,1874,[ 98 132 313  89  96],92,4,7005,3.736,0.0,20.0
41875,4,1875,[603 302 427 100  64],339,5,7010,3.736673773987207,20.0,20.0
41876,4,1876,[435 323 294 182 151],788,0,7010,3.7346830047948854,0.0,0.0
41877,4,1877,[603 302 427 100  64],271,5,7015,3.735356762513312,20.0,20.0
41878,4,1878,[603 302 427 100  64],664,5,7020,3.7360298030867485,20.0,20.0
41879,4,1879,[ 12 197  95 515  82],194,3,7023,3.7356382978723404,20.0,0.0
41880,4,1880,[597 265 403 153 195],7,4,7027,3.735778841041999,0.0,0.0
41881,4,1881,[127  88 238 200 135],774,2,7029,3.734856535600425,0.0,20.0
41882,4,1882,[603 302 427 100  64],339,5,7034,3.7355284121083376,20.0,20.0
41883,4,1883,[ 79 678 144 597 271],13,1,7035,3.734076433121019,0.0,0.0
41884,4,1884,[ 71 182  82   9 202],815,4,7039,3.7342175066312997,0.0,0.0
41885,4,1885,[202 257 748 182 655],479,4,7043,3.7343584305408273,0.0,0.0
41886,4,1886,[300 215  56  82  98],788,2,7045,3.733439321674616,0.0,20.0
41887,4,1887,[603 302 427 100  64],13,5,7050,3.7341101694915255,20.0,20.0
41888,4,1888,[210  12 318   9 282],271,4,7054,3.734250926416093,40.0,0.0
41889,4,1889,[235 302 222  50 271],13,2,7056,3.7333333333333334,0.0,20.0
41890,4,1890,[385 175 127 286 100],13,3,7059,3.7329455314648334,0.0,40.0
41891,4,1891,[196 300 161 127 357],774,1,7060,3.7315010570824523,20.0,20.0
41892,4,1892,[222 125  98 173  50],77,4,7064,3.731642894875858,0.0,40.0
41893,4,1893,[603 302 427 100  64],90,5,7069,3.732312565997888,20.0,20.0
41894,4,1894,[603 302 427 100  64],339,5,7074,3.732981530343008,20.0,20.0
41895,4,1895,[603 302 427 100  64],666,5,7079,3.7336497890295357,20.0,20.0
41896,4,1896,[ 69 294 496 186 183],6,3,7082,3.7332630469161834,0.0,0.0
41897,4,1897,[603 302 427 100  64],13,5,7087,3.733930453108535,20.0,20.0
41898,4,1898,[ 56 135 265  70  71],59,3,7090,3.7335439705107953,0.0,0.0
41899,4,1899,[678  82  89 153 195],13,2,7092,3.7326315789473683,0.0,0.0
41900,4,1900,[245 187 151 204 183],313,3,7095,3.7322461862177803,0.0,0.0
41901,4,1901,[183 211 180 546 257],804,4,7099,3.7323869610935856,0.0,0.0
41902,4,1902,[202 603 748   7 257],883,5,7104,3.7330530740935366,20.0,0.0
41903,4,1903,[ 97 222  95  71 496],897,4,7108,3.7331932773109244,0.0,0.0
41904,4,1904,[603 302 427 100  64],537,4,7112,3.7333333333333334,20.0,20.0
41905,4,1905,[ 12 176  96 216 237],42,4,7116,3.733473242392445,20.0,0.0
41906,4,1906,[301 174 135   4  69],378,1,7117,3.7320398531725223,0.0,20.0
41907,4,1907,[ 89 273 328 121 289],537,1,7118,3.730607966457023,0.0,0.0
41908,4,1908,[603 302 427 100  64],339,5,7123,3.7312729177579884,20.0,20.0
41909,4,1909,[ 56  82 265 187 117],207,2,7125,3.730366492146597,0.0,0.0
41910,4,1910,[222 588 195  50 173],13,2,7127,3.7294610151753007,0.0,20.0
41911,4,1911,[271 211  64  69  50],64,4,7131,3.7296025104602513,0.0,20.0
41912,4,1912,[515 496 194  28  88],537,2,7133,3.728698379508625,0.0,0.0
41913,4,1913,[211 204 748 288 180],479,3,7136,3.7283176593521423,0.0,0.0
41914,4,1914,[603 302 427 100  64],454,5,7141,3.728981723237598,20.0,20.0
41915,4,1915,[405 132 172 127   7],59,4,7145,3.729123173277662,0.0,20.0
41916,4,1916,[175 357  98 300 546],7,5,7150,3.729786124152321,20.0,20.0
41917,4,1917,[603 302 427 100  64],90,5,7155,3.730448383733055,20.0,20.0
41918,4,1918,[655 318 546 228   7],64,4,7159,3.73058884835852,20.0,0.0
41919,4,1919,[195  79  15  89 496],234,1,7160,3.7291666666666665,0.0,0.0
41920,4,1920,[273  95 210 118 191],749,3,7163,3.7287870900572617,0.0,0.0
41921,4,1921,[603 302 427 100  64],13,5,7168,3.729448491155047,20.0,20.0
41922,4,1922,[603 302 427 100  64],458,5,7173,3.730109204368175,20.0,20.0
41923,4,1923,[313 111  28 143 186],334,1,7174,3.728690228690229,0.0,0.0
41924,4,1924,[180 196 195   7 302],474,5,7179,3.7293506493506494,0.0,0.0
41925,4,1925,[427 275 328 323  88],537,2,7181,3.7284527518172377,0.0,0.0
41926,4,1926,[385 174 742 121 508],825,5,7186,3.7291126102750387,0.0,20.0
41927,4,1927,[603 302 427 100  64],271,5,7191,3.729771784232365,20.0,20.0
41928,4,1928,[603 302 427 100  64],458,5,7196,3.7304302747537585,20.0,20.0
41929,4,1929,[603 302 427 100  64],745,5,7201,3.7310880829015542,20.0,20.0
41930,4,1930,[222 195  56 132  98],64,5,7206,3.7317452097358883,0.0,20.0
41931,4,1931,[385 508 161 175 302],474,4,7210,3.7318840579710146,0.0,0.0
41932,4,1932,[258 174 333 405 176],488,4,7214,3.732022762545266,0.0,20.0
41933,4,1933,[258  28 286 275  69],334,3,7217,3.731644260599793,0.0,0.0
41934,4,1934,[603 302 427 100  64],370,5,7222,3.732299741602067,20.0,20.0
41935,4,1935,[603 302 427 100  64],339,5,7227,3.7329545454545454,20.0,20.0
41936,4,1936,[603 302 427 100  64],666,5,7232,3.7336086732059885,20.0,20.0
41937,4,1937,[ 56 181 194 603 258],213,5,7237,3.7342621259029927,20.0,0.0
41938,4,1938,[258 228 238   9 197],311,5,7242,3.7349149045899948,0.0,0.0
41939,4,1939,[  4 211 197 215 153],653,0,7242,3.7329896907216495,0.0,0.0
41940,4,1940,[357  11  25  96  97],881,2,7244,3.7320968572900566,20.0,0.0
41941,4,1941,[173  79 121 742 132],554,3,7247,3.731719876416066,0.0,0.0
41942,4,1942,[144 186 288  50 588],7,5,7252,3.7323726196603193,0.0,20.0
41943,4,1943,[603 302 427 100  64],664,5,7257,3.7330246913580245,20.0,20.0
41944,4,1944,[357   8 118   7 423],892,5,7262,3.7336760925449872,20.0,0.0
41945,4,1945,[161 546 215 234 186],328,3,7265,3.733299075025694,0.0,0.0
41946,4,1946,[435   1 127 173 200],387,4,7269,3.7334360554699537,0.0,20.0
41947,4,1947,[603 302 427 100  64],13,5,7274,3.7340862422997945,20.0,20.0
41948,4,1948,[294 216  28 175 508],6,2,7276,3.733196511031298,0.0,0.0
41949,4,1949,[597 286 435 403 191],59,3,7279,3.732820512820513,0.0,0.0
41950,4,1950,[181 282 245 257 117],486,1,7280,3.7314197847257815,0.0,0.0
41951,4,1951,[357  82 294 222 257],881,4,7284,3.7315573770491803,20.0,0.0
41952,4,1952,[197   1 187 127 117],387,3,7287,3.7311827956989245,0.0,20.0
41953,4,1953,[268 187 183 508   9],13,3,7290,3.730808597748209,0.0,0.0
41954,4,1954,[603 302 427 100  64],664,5,7295,3.731457800511509,20.0,20.0
41955,4,1955,[ 70 168 603 483  98],10,5,7300,3.7321063394683027,40.0,20.0
41956,4,1956,[234 257 269 211 655],339,5,7305,3.7327542156361777,0.0,0.0
41957,4,1957,[603 302 427 100  64],13,5,7310,3.7334014300306437,20.0,20.0
41958,4,1958,[  9   4  97 216  88],374,2,7312,3.732516590096988,0.0,0.0
41959,4,1959,[603 302 427 100  64],339,5,7317,3.7331632653061226,20.0,20.0
41960,4,1960,[127 275 176 194  97],311,5,7322,3.7338092809790924,0.0,20.0
41961,4,1961,[603 180 175  96   8],13,5,7327,3.734454638124363,20.0,0.0
41962,4,1962,[603 302 427 100  64],271,5,7332,3.7350993377483444,20.0,20.0
41963,4,1963,[135 181  64  50  98],533,4,7336,3.735234215885947,0.0,40.0
41964,4,1964,[603 302 427 100  64],458,5,7341,3.73587786259542,20.0,20.0
41965,4,1965,[ 11  25 265 180 215],271,4,7345,3.736012207527976,0.0,0.0
41966,4,1966,[603 302 427 100  64],666,5,7350,3.736654804270463,20.0,20.0
41967,4,1967,[  9 216 294 180  69],533,4,7354,3.736788617886179,0.0,0.0
41968,4,1968,[282  11 742  95  89],200,5,7359,3.7374301675977653,0.0,0.0
41969,4,1969,[655 496  12   8 546],343,4,7363,3.7375634517766496,20.0,0.0
41970,4,1970,[127  71 191 273 121],308,3,7366,3.737189244038559,0.0,20.0
41971,4,1971,[ 22  56   7 333 186],13,3,7369,3.7368154158215012,0.0,0.0
41972,4,1972,[603 302 427 100  64],474,5,7374,3.737455651292448,20.0,20.0
41973,4,1973,[234   1 273   4 742],92,4,7378,3.7375886524822697,0.0,0.0
41974,4,1974,[111 187 194 125 197],749,3,7381,3.737215189873418,0.0,0.0
41975,4,1975,[333 483  97 318 195],815,4,7385,3.7373481781376516,40.0,0.0
41976,4,1976,[288 508 405  25 423],59,4,7389,3.7374810318664644,0.0,0.0
41977,4,1977,[603 302 427 100  64],271,5,7394,3.738119312436805,20.0,20.0
41978,4,1978,[323 286 179 210 265],537,1,7395,3.736735725113694,0.0,0.0
41979,4,1979,[288 483 655 194 144],804,4,7399,3.7368686868686867,20.0,0.0
41980,4,1980,[245 210 276 282 200],92,4,7403,3.7370015143866735,0.0,0.0
41981,4,1981,[403  69 568 215 742],881,2,7405,3.736125126135217,0.0,0.0
41982,4,1982,[174  95 127 196 125],398,4,7409,3.736258194654564,0.0,40.0
41983,4,1983,[187 238   4 546 211],833,1,7410,3.7348790322580645,0.0,0.0
41984,4,1984,[603 302 427 100  64],370,5,7415,3.7355163727959697,20.0,20.0
41985,4,1985,[603 302 427 100  64],664,5,7420,3.7361530715005036,20.0,20.0
41986,4,1986,[603 302 427 100  64],13,5,7425,3.7367891293407145,20.0,20.0
41987,4,1987,[742 228  71 196 282],334,3,7428,3.7364185110663986,0.0,0.0
41988,4,1988,[603 508 173 475 182],13,2,7430,3.7355455002513827,20.0,0.0
41989,4,1989,[603 302 427 100  64],666,5,7435,3.736180904522613,20.0,20.0
41990,4,1990,[405 176 323 179  95],881,4,7439,3.7363134103465594,0.0,0.0
41991,4,1991,[603 302 427 100  64],454,5,7444,3.7369477911646585,20.0,20.0
41992,4,1992,[176 588 185 195 211],843,2,7446,3.73607626693427,0.0,0.0
41993,4,1993,[161 323 195 678   7],474,3,7449,3.735707121364092,0.0,0.0
41994,4,1994,[288 194 742 235 121],804,4,7453,3.7358395989974937,0.0,0.0
41995,4,1995,[200 173 143 202 403],650,3,7456,3.7354709418837677,0.0,0.0
41996,4,1996,[300 275   4 597  69],328,3,7459,3.7351026539809715,0.0,0.0
41997,4,1997,[603 302 427 100  64],339,5,7464,3.735735735735736,20.0,20.0
41998,4,1998,[176 182 183  50 172],479,5,7469,3.736368184092046,0.0,20.0
41999,4,1999,[603 302 427 100  64],370,5,7474,3.737,20.0,20.0
42000,4,2000,[196  89  96 117 471],537,1,7475,3.735632183908046,0.0,0.0
42001,4,2001,[603 302 427 100  64],90,5,7480,3.7362637362637363,20.0,20.0
42002,4,2002,[ 50 197 568 258 100],455,5,7485,3.7368946580129805,0.0,40.0
42003,4,2003,[153 318  71 235 234],374,3,7488,3.7365269461077846,20.0,0.0
42004,4,2004,[ 56 215 173 180 210],474,5,7493,3.73715710723192,0.0,0.0
42005,4,2005,[275 286 322 265 403],328,3,7496,3.73678963110668,0.0,0.0
42006,4,2006,[318 228  95 238 483],85,3,7499,3.7364225211758844,40.0,0.0
42007,4,2007,[603 302 427 100  64],271,5,7504,3.737051792828685,20.0,20.0
42008,4,2008,[435 405 181 471 183],313,4,7508,3.7371826779492285,0.0,0.0
42009,4,2009,[ 64  56   4 403 294],774,0,7508,3.735323383084577,0.0,0.0
42010,4,2010,[301   1 471 357   7],13,0,7508,3.733465937344605,20.0,0.0
42011,4,2011,[ 82 202 496 403 211],311,4,7512,3.7335984095427435,0.0,0.0
42012,4,2012,[603 302 427 100  64],458,5,7517,3.734227521112767,20.0,20.0
42013,4,2013,[603 302 427 100  64],13,5,7522,3.7348560079443893,20.0,20.0
42014,4,2014,[603 302 427 100  64],666,5,7527,3.735483870967742,20.0,20.0
42015,4,2015,[603 302 427 100  64],745,5,7532,3.736111111111111,20.0,20.0
42016,4,2016,[265 186   7  50 153],102,2,7534,3.7352503718393653,0.0,20.0
42017,4,2017,[271  12   4 245 655],334,2,7536,3.734390485629336,20.0,0.0
42018,4,2018,[603 302 427 100  64],13,5,7541,3.735017335314512,20.0,20.0
42019,4,2019,[603 302 427 100  64],745,5,7546,3.735643564356436,20.0,20.0
42020,4,2020,[215 313  69 135 168],13,5,7551,3.7362691736763978,0.0,0.0
42021,4,2021,[603 302 427 100  64],370,5,7556,3.7368941641938673,20.0,20.0
42022,4,2022,[603 302 427 100  64],458,5,7561,3.7375185368264954,20.0,20.0
42023,4,2023,[603 302 427 100  64],454,5,7566,3.7381422924901186,20.0,20.0
42024,4,2024,[ 88  89 265 423 127],650,2,7568,3.737283950617284,0.0,20.0
42025,4,2025,[ 95 275  50   9  89],334,4,7572,3.7374136229022703,0.0,20.0
42026,4,2026,[603 302 427 100  64],339,5,7577,3.7380365071534287,20.0,20.0
42027,4,2027,[125 180 151   7  96],804,4,7581,3.7381656804733727,0.0,0.0
42028,4,2028,[357 427  95 294 182],194,3,7584,3.7378018728437654,20.0,0.0
42029,4,2029,[191 515 180 172 175],13,3,7587,3.73743842364532,0.0,0.0
42030,4,2030,[546  69  96 286  79],881,2,7589,3.736582964057115,0.0,0.0
42031,4,2031,[ 89 318 161 742  70],378,5,7594,3.7372047244094486,20.0,0.0
42032,4,2032,[603 302 427 100  64],664,5,7599,3.73782587309395,20.0,20.0
42033,4,2033,[603 302 427 100  64],745,5,7604,3.7384464110127826,20.0,20.0
42034,4,2034,[603 302 427 100  64],458,5,7609,3.7390663390663392,20.0,20.0
42035,4,2035,[197 603  12 185  79],537,3,7612,3.7387033398821217,40.0,0.0
42036,4,2036,[ 70 118 200   7 655],13,2,7614,3.7378497790868925,0.0,0.0
42037,4,2037,[603 302 427 100  64],13,5,7619,3.7384690873405297,20.0,20.0
42038,4,2038,[127 234 186  64  88],452,2,7621,3.7376164786660127,0.0,20.0
42039,4,2039,[603 302 427 100  64],666,5,7626,3.738235294117647,20.0,20.0
42040,4,2040,[318 151 496 294 301],6,2,7628,3.7373836354728076,20.0,0.0
42041,4,2041,[173 196 496 237  89],406,2,7630,3.7365328109696376,0.0,0.0
42042,4,2042,[603 302 427 100  64],745,5,7635,3.737151248164464,20.0,20.0
42043,4,2043,[174 143 568 182  71],374,4,7639,3.737279843444227,0.0,20.0
42044,4,2044,[742 191 423 475 222],92,3,7642,3.736919315403423,0.0,0.0
42045,4,2045,[603 302 427 100  64],271,5,7647,3.7375366568914954,20.0,20.0
42046,4,2046,[603 302 427 100  64],13,5,7652,3.738153395212506,20.0,20.0
42047,4,2047,[288 322 111 132 168],474,3,7655,3.73779296875,0.0,0.0
42048,4,2048,[288 151 211 435 127],843,1,7656,3.7364568081991214,0.0,20.0
42049,4,2049,[294 258  28 187  12],537,2,7658,3.735609756097561,20.0,0.0
42050,4,2050,[ 15 385  22 322 176],474,5,7663,3.736226231106777,0.0,0.0
42051,4,2051,[ 70  64 546 300  11],788,3,7666,3.7358674463937622,0.0,0.0
42052,4,2052,[ 88 176 748 603 483],474,4,7670,3.735996103263517,40.0,0.0
42053,4,2053,[603 302 427 100  64],664,5,7675,3.7366114897760467,20.0,20.0
42054,4,2054,[603 302 427 100  64],370,5,7680,3.7372262773722627,20.0,20.0
42055,4,2055,[ 82 403 100 210  88],533,4,7684,3.737354085603113,0.0,20.0
42056,4,2056,[185  82 195 273 187],328,3,7687,3.7369956246961595,0.0,0.0
42057,4,2057,[603 302 427 100  64],271,5,7692,3.737609329446064,20.0,20.0
42058,4,2058,[405 265  97 204 118],892,5,7697,3.738222438076736,0.0,0.0
42059,4,2059,[111  95  79  96 234],899,5,7702,3.738834951456311,0.0,0.0
42060,4,2060,[143 216 286  82 403],650,2,7704,3.7379912663755457,0.0,0.0
42061,4,2061,[ 97 318 271 211 385],328,2,7706,3.737148399612027,20.0,0.0
42062,4,2062,[ 71  88 265 187 215],308,3,7709,3.7367910809500726,0.0,0.0
42063,4,2063,[117 151 258 597 322],533,3,7712,3.7364341085271318,0.0,0.0
42064,4,2064,[603 302 427 100  64],370,5,7717,3.737046004842615,20.0,20.0
42065,4,2065,[ 88  22 168 228 118],533,5,7722,3.7376573088092933,0.0,0.0
42066,4,2066,[ 79 385 288 515 211],102,0,7722,3.7358490566037736,0.0,0.0
42067,4,2067,[100 385  69 237 187],533,4,7726,3.7359767891682787,0.0,20.0
42068,4,2068,[603 302 427 100  64],458,5,7731,3.736587723537941,20.0,20.0
42069,4,2069,[603 302 427 100  64],13,5,7736,3.7371980676328502,20.0,20.0
42070,4,2070,[588 655 175 186  70],59,3,7739,3.736842105263158,0.0,0.0
42071,4,2071,[286 100 289 174 234],90,4,7743,3.736969111969112,0.0,40.0
42072,4,2072,[273 655 597 403 286],59,2,7745,3.736131210805596,0.0,0.0
42073,4,2073,[515 423 127  15 385],234,3,7748,3.7357762777242045,0.0,20.0
42074,4,2074,[328 257 588 258 275],499,3,7751,3.735421686746988,0.0,0.0
42075,4,2075,[603 302 427 100  64],370,5,7756,3.7360308285163777,20.0,20.0
42076,4,2076,[ 98 427 168 588 286],452,4,7760,3.736157920077034,0.0,20.0
42077,4,2077,[228  82  98 742 357],650,3,7763,3.735803657362849,20.0,20.0
42078,4,2078,[187  88 215 228 153],749,4,7767,3.735930735930736,0.0,0.0
42079,4,2079,[603 302 427 100  64],474,5,7772,3.7365384615384616,20.0,20.0
42080,4,2080,[603 302 427 100  64],271,5,7777,3.7371456030754446,20.0,20.0
42081,4,2081,[603 302 427 100  64],537,4,7781,3.7372718539865515,20.0,20.0
42082,4,2082,[603 302 427 100  64],339,5,7786,3.7378780604896784,20.0,20.0
42083,4,2083,[179  71 228 238 515],59,4,7790,3.738003838771593,0.0,0.0
42084,4,2084,[603 302 427 100  64],339,5,7795,3.738609112709832,20.0,20.0
42085,4,2085,[322 182 234 211 144],234,1,7796,3.7372962607861937,0.0,0.0
42086,4,2086,[125  11  96 179 269],378,2,7798,3.73646382367034,0.0,0.0
42087,4,2087,[168  97  28 127 121],77,2,7800,3.735632183908046,0.0,20.0
42088,4,2088,[603 302 427 100  64],474,5,7805,3.736237434179033,20.0,20.0
42089,4,2089,[144 435 328 403 194],833,1,7806,3.734928229665072,0.0,0.0
42090,4,2090,[  4   8 496  22 515],194,4,7810,3.7350549976087994,0.0,0.0
42091,4,2091,[603 302 427 100  64],13,5,7815,3.73565965583174,20.0,20.0
42092,4,2092,[603 302 427 100  64],474,5,7820,3.7362637362637363,20.0,20.0
42093,4,2093,[191 245 174 234 323],455,3,7823,3.735912129894938,0.0,20.0
42094,4,2094,[216 153 144 181 300],653,2,7825,3.7350835322195706,0.0,0.0
42095,4,2095,[200  56 175 405  89],343,3,7828,3.734732824427481,0.0,0.0
42096,4,2096,[588 275  97 269 182],13,3,7831,3.7343824511206485,0.0,0.0
42097,4,2097,[288 235   1 294 475],634,2,7833,3.7335557673975215,0.0,0.0
42098,4,2098,[603 302 427 100  64],13,5,7838,3.7341591233920917,20.0,20.0
42099,4,2099,[603 302 427 100  64],339,5,7843,3.7347619047619047,20.0,20.0
42100,4,2100,[603 302 427 100  64],271,5,7848,3.735364112327463,20.0,20.0
42101,4,2101,[197 132 289 180 186],13,4,7852,3.735490009514748,0.0,0.0
42102,4,2102,[258 172 238 471 269],145,5,7857,3.7360912981455066,0.0,0.0
42103,4,2103,[  7  12 151 742 132],795,2,7859,3.7352661596958177,20.0,0.0
42104,4,2104,[603 302 427 100  64],666,5,7864,3.7358669833729214,20.0,20.0
42105,4,2105,[496  22 202 186 234],653,2,7866,3.735042735042735,0.0,0.0
42106,4,2106,[603 302 427 100  64],13,5,7871,3.7356430944470813,20.0,20.0
42107,4,2107,[603  64 172 333 215],64,3,7874,3.735294117647059,20.0,0.0
42108,4,2108,[508  98 748  89 302],474,3,7877,3.734945471787577,0.0,20.0
42109,4,2109,[302 603 427 100  64],664,5,7882,3.7355450236966825,20.0,20.0
42110,4,2110,[ 71 121 200 204 197],881,3,7885,3.735196589294173,0.0,0.0
42111,4,2111,[302 603 427 100  64],664,5,7890,3.7357954545454546,20.0,20.0
42112,4,2112,[286 191 172 655  22],378,5,7895,3.7363937529578797,0.0,0.0
42113,4,2113,[161 302 174 195 289],454,4,7899,3.736518448438978,0.0,20.0
42114,4,2114,[210 508 194  50 228],524,3,7902,3.7361702127659573,0.0,20.0
42115,4,2115,[597 204 258 182 238],213,5,7907,3.7367674858223063,0.0,0.0
42116,4,2116,[302 603 427 100  64],537,4,7911,3.7368918280585737,20.0,20.0
42117,4,2117,[357  28 258 222 313],380,4,7915,3.7370160528800755,20.0,0.0
42118,4,2118,[435 186 215 195 427],194,3,7918,3.7366682397357245,0.0,0.0
42119,4,2119,[151 403 180 655 357],95,3,7921,3.736320754716981,20.0,0.0
42120,4,2120,[197  97  22 257  95],308,3,7924,3.735973597359736,0.0,0.0
42121,4,2121,[748 328 403 143 282],479,2,7926,3.7351555136663523,0.0,0.0
42122,4,2122,[302 603 427 100  64],454,5,7931,3.7357512953367875,20.0,20.0
42123,4,2123,[ 79 423 125 121 588],298,4,7935,3.7358757062146895,0.0,0.0
42124,4,2124,[302 603 427 100  64],339,5,7940,3.736470588235294,20.0,20.0
42125,4,2125,[302 603 427 100  64],13,5,7945,3.737064910630292,20.0,20.0
42126,4,2126,[174 294  82 175 271],537,1,7946,3.7357780912082745,0.0,20.0
42127,4,2127,[181  50  89 174 238],406,4,7950,3.7359022556390977,0.0,40.0
42128,4,2128,[302 603 427 100  64],90,5,7955,3.7364960075152656,20.0,20.0
42129,4,2129,[237 748 211 183 210],346,5,7960,3.7370892018779345,0.0,0.0
42130,4,2130,[204  89  88 258 385],234,0,7960,3.7353355232285312,0.0,0.0
42131,4,2131,[ 71 172 483 125  79],200,5,7965,3.7359287054409007,20.0,0.0
42132,4,2132,[302 603 427 100  64],474,5,7970,3.7365213314580403,20.0,20.0
42133,4,2133,[194 235 135 603 211],59,3,7973,3.7361761949390817,20.0,0.0
42134,4,2134,[176  95 265 143 471],882,5,7978,3.736768149882904,0.0,0.0
42135,4,2135,[273 265 168 257  50],374,1,7979,3.7354868913857677,0.0,20.0
42136,4,2136,[234 237 176 318 215],804,5,7984,3.736078614880674,20.0,0.0
42137,4,2137,[496 357 234 215 313],653,2,7986,3.735266604303087,20.0,0.0
42138,4,2138,[588 655 294 216  56],311,5,7991,3.7358578775128564,0.0,0.0
42139,4,2139,[471 135  98  88 117],311,5,7996,3.736448598130841,0.0,20.0
42140,4,2140,[302 603 427 100  64],454,5,8001,3.7370387669313403,20.0,20.0
42141,4,2141,[ 96 282 216  82 181],378,5,8006,3.7376283846872083,0.0,0.0
42142,4,2142,[ 50 216 257  89 289],883,5,8011,3.7382174521698555,0.0,20.0
42143,4,2143,[302 603 427 100  64],474,5,8016,3.7388059701492535,20.0,20.0
42144,4,2144,[117   1 143 403 179],749,5,8021,3.7393939393939393,0.0,0.0
42145,4,2145,[237 194 483 127 175],207,4,8025,3.739515377446412,20.0,20.0
42146,4,2146,[ 28 161 195 172 202],411,3,8028,3.7391709361900327,0.0,0.0
42147,4,2147,[271 228 153 603 385],13,3,8031,3.738826815642458,20.0,0.0
42148,4,2148,[302 603 427 100  64],370,5,8036,3.739413680781759,20.0,20.0
42149,4,2149,[302 603 427 100  64],271,5,8041,3.74,20.0,20.0
42150,4,2150,[ 50 195 194 174 269],48,4,8045,3.7401208740120873,0.0,40.0
42151,4,2151,[245 216 322 186  97],313,2,8047,3.7393122676579926,0.0,0.0
42152,4,2152,[302 603 427 100  64],271,5,8052,3.7398978169995356,20.0,20.0
42153,4,2153,[302 603 427 100  64],664,5,8057,3.7404828226555247,20.0,20.0
42154,4,2154,[175 313  25 271  96],13,3,8060,3.7401392111368907,0.0,0.0
42155,4,2155,[302 603 427 100  64],537,4,8064,3.74025974025974,20.0,20.0
42156,4,2156,[ 98 186 318 127 268],334,4,8068,3.740380157626333,20.0,40.0
42157,4,2157,[269 182 211  25 238],318,4,8072,3.7405004633920296,0.0,0.0
42158,4,2158,[183 121 202 333  12],387,2,8074,3.7396943029180174,20.0,0.0
42159,4,2159,[ 95 185 180 265  25],313,3,8077,3.739351851851852,0.0,0.0
42160,4,2160,[302 603 427 100  64],666,5,8082,3.7399352151781584,20.0,20.0
42161,4,2161,[333 211  28  64 475],343,4,8086,3.7400555041628123,0.0,0.0
42162,4,2162,[183 182 179 196 210],64,4,8090,3.7401756819232546,0.0,0.0
42163,4,2163,[187 172 234 195 144],659,4,8094,3.7402957486136783,0.0,0.0
42164,4,2164,[427 496 168 175  28],308,3,8097,3.7399538106235566,0.0,0.0
42165,4,2165,[ 25 204  71 210 197],7,4,8101,3.740073868882733,0.0,0.0
42166,4,2166,[182 200  82  12 286],328,4,8105,3.7401938163359483,20.0,0.0
42167,4,2167,[118 483  89 191 127],664,3,8108,3.7398523985239853,20.0,20.0
42168,4,2168,[302 603 427 100  64],13,5,8113,3.740433379437529,20.0,20.0
42169,4,2169,[302 603 427 100  64],537,4,8117,3.740552995391705,20.0,20.0
42170,4,2170,[405 385   4 168 183],102,1,8118,3.73929064947029,0.0,0.0
42171,4,2171,[302 603 427 100  64],458,5,8123,3.7398710865561693,20.0,20.0
42172,4,2172,[132 200 257  96 216],881,2,8125,3.73907040957202,0.0,0.0
42173,4,2173,[121 210  50  82 191],290,4,8129,3.7391904323827045,0.0,20.0
42174,4,2174,[ 96 403 183  50 117],374,3,8132,3.7388505747126435,0.0,20.0
42175,4,2175,[568 322 215  15 176],749,5,8137,3.7394301470588234,0.0,0.0
42176,4,2176,[173 318 603 211 176],387,3,8140,3.739090491502067,40.0,0.0
42177,4,2177,[ 89 173  64 100 435],892,5,8145,3.739669421487603,0.0,20.0
42178,4,2178,[ 96  89  64 318 294],92,3,8148,3.739329967875172,20.0,0.0
42179,4,2179,[181 161 748 127 196],346,3,8151,3.7389908256880733,0.0,20.0
42180,4,2180,[168 215 100 300 294],479,1,8152,3.7377349839523153,0.0,20.0
42181,4,2181,[234 294 546  89 603],145,4,8156,3.7378551787351055,20.0,0.0
42182,4,2182,[302 603 427 100  64],537,4,8160,3.737975263398992,20.0,20.0
42183,4,2183,[302 603 427 100  64],454,5,8165,3.7385531135531136,20.0,20.0
42184,4,2184,[100 588 176 318 235],144,4,8169,3.7386727688787187,20.0,20.0
42185,4,2185,[ 28 235 300 313 173],271,3,8172,3.738334858188472,0.0,0.0
42186,4,2186,[180 435  11 289 210],234,1,8173,3.73708276177412,0.0,0.0
42187,4,2187,[ 25  88 135 237  12],42,4,8177,3.737202925045704,20.0,0.0
42188,4,2188,[302 603 427 100  64],454,5,8182,3.7377798081315667,20.0,20.0
42189,4,2189,[195 183 471 313  89],92,5,8187,3.7383561643835614,0.0,0.0
42190,4,2190,[302 603 427 100  64],339,5,8192,3.738931994523049,20.0,20.0
42191,4,2191,[257 322 195  97 423],474,4,8196,3.739051094890511,0.0,0.0
42192,4,2192,[174 176 318 186 179],64,5,8201,3.739626082991336,20.0,20.0
42193,4,2193,[  1 168  79  96  89],881,3,8204,3.739288969917958,0.0,0.0
42194,4,2194,[423 294 200 257 289],271,4,8208,3.739407744874715,0.0,0.0
42195,4,2195,[403 216 405   9  89],87,4,8212,3.7395264116575593,0.0,0.0
42196,4,2196,[ 89 127 204 173 195],158,5,8217,3.7401001365498407,0.0,20.0
42197,4,2197,[187 172 195 117 174],311,5,8222,3.740673339399454,0.0,20.0
42198,4,2198,[385 215 286 423 403],95,4,8226,3.7407912687585267,0.0,0.0
42199,4,2199,[210 271 176 183 215],749,5,8231,3.7413636363636362,0.0,0.0
42200,4,2200,[302 603 427 100  64],271,5,8236,3.7419354838709675,20.0,20.0
42201,4,2201,[302 603 427 100  64],664,5,8241,3.742506811989101,20.0,20.0
42202,4,2202,[435 475 174 318 127],409,4,8245,3.7426236949614164,20.0,40.0
42203,4,2203,[302 603 427 100  64],13,5,8250,3.7431941923774956,20.0,20.0
42204,4,2204,[183 588 182 185 357],650,2,8252,3.742403628117914,20.0,0.0
42205,4,2205,[ 15 174 111 216 118],145,2,8254,3.7416137805983682,0.0,20.0
42206,4,2206,[302 603 427 100  64],90,5,8259,3.742183960126869,20.0,20.0
42207,4,2207,[302 603 427 100  64],13,5,8264,3.7427536231884058,20.0,20.0
42208,4,2208,[ 11 173 174 144 237],188,3,8267,3.742417383431417,0.0,20.0
42209,4,2209,[302 603 427 100  64],454,5,8272,3.7429864253393665,20.0,20.0
42210,4,2210,[302 603 427 100  64],454,5,8277,3.7435549525101766,20.0,20.0
42211,4,2211,[302 603 427 100  64],745,5,8282,3.744122965641953,20.0,20.0
42212,4,2212,[568 204  22  28  69],83,5,8287,3.7446904654315407,0.0,0.0
42213,4,2213,[496  97 238 143  71],479,1,8288,3.743450767841012,0.0,0.0
42214,4,2214,[271 323 742 588 176],290,2,8290,3.7426636568848757,0.0,0.0
42215,4,2215,[172  96  11 282  69],474,5,8295,3.743231046931408,0.0,0.0
42216,4,2216,[135 204  79 568 234],85,3,8298,3.742895805142084,0.0,0.0
42217,4,2217,[302 603 427 100  64],458,5,8303,3.74346257889991,20.0,20.0
42218,4,2218,[302 603 427 100  64],271,5,8308,3.74402884182064,20.0,20.0
42219,4,2219,[258 215  69 222 172],311,5,8313,3.7445945945945946,0.0,0.0
42220,4,2220,[302 603 427 100  64],271,5,8318,3.745159837910851,20.0,20.0
42221,4,2221,[ 96  98 100  79 202],666,3,8321,3.744824482448245,0.0,40.0
42222,4,2222,[302 603 427 100  64],458,5,8326,3.7453891138101665,20.0,20.0
42223,4,2223,[742 161 185 111 385],833,1,8327,3.744154676258993,0.0,0.0
42224,4,2224,[302 603 427 100  64],458,5,8332,3.7447191011235956,20.0,20.0
42225,4,2225,[175 176 191 211 282],804,5,8337,3.7452830188679247,0.0,0.0
42226,4,2226,[191 174 234 423 288],533,3,8340,3.744948361023799,0.0,20.0
42227,4,2227,[302 603 427 100  64],90,5,8345,3.745511669658887,20.0,20.0
42228,4,2228,[210 385 187 216 427],234,2,8347,3.7447285778375954,0.0,0.0
42229,4,2229,[302 603 427 100  64],271,5,8352,3.7452914798206276,20.0,20.0
42230,4,2230,[ 70 357 132 245 194],454,1,8353,3.744060959211116,20.0,0.0
42231,4,2231,[245 313 237 125 300],190,4,8357,3.744175627240143,0.0,0.0
42232,4,2232,[302 603 427 100  64],745,5,8362,3.7447380206000895,20.0,20.0
42233,4,2233,[ 82 597 294 143  22],92,0,8362,3.7430617726051927,0.0,0.0
42234,4,2234,[153 588 202 181 174],7,3,8365,3.742729306487696,0.0,20.0
42235,4,2235,[  9 121 180 195  12],474,5,8370,3.7432915921288012,20.0,0.0
42236,4,2236,[ 56 176  89 427 235],932,4,8374,3.743406347787215,0.0,0.0
42237,4,2237,[187 222 135 234  88],343,4,8378,3.7435210008936552,0.0,0.0
42238,4,2238,[302 603 427 100  64],745,5,8383,3.7440821795444394,20.0,20.0
42239,4,2239,[588 179  11  64 603],527,3,8386,3.74375,20.0,0.0
42240,4,2240,[211 121 235 385 183],643,4,8390,3.743864346273985,0.0,0.0
42241,4,2241,[  8 117 202 211 194],90,3,8393,3.7435325602140948,0.0,0.0
42242,4,2242,[238 194 181  12 195],892,5,8398,3.744092732946946,20.0,0.0
42243,4,2243,[269  82 678 210  95],334,1,8399,3.7428698752228162,0.0,0.0
42244,4,2244,[302 603 427 100  64],474,5,8404,3.7434298440979954,20.0,20.0
42245,4,2245,[ 71 186  97 187 173],892,3,8407,3.743098842386465,0.0,0.0
42246,4,2246,[302 603 427 100  64],271,5,8412,3.7436582109479306,20.0,20.0
42247,4,2247,[288 194 276  97 597],13,3,8415,3.743327402135231,0.0,0.0
42248,4,2248,[176  98 125 180 271],290,2,8417,3.7425522454424187,0.0,20.0
42249,4,2249,[302 603 427 100  64],13,5,8422,3.7431111111111113,20.0,20.0
42250,4,2250,[302 603 427 100  64],745,5,8427,3.7436694802310084,20.0,20.0
42251,4,2251,[302 603 427 100  64],458,5,8432,3.7442273534635877,20.0,20.0
42252,4,2252,[153   4 174 286 194],648,3,8435,3.7438970261873057,0.0,20.0
42253,4,2253,[302 603 427 100  64],537,4,8439,3.7440106477373556,20.0,20.0
42254,4,2254,[182  95 211 385 423],59,4,8443,3.7441241685144124,0.0,0.0
42255,4,2255,[ 56  69 318 289 403],318,2,8445,3.7433510638297873,20.0,0.0
42256,4,2256,[302 603 427 100  64],339,5,8450,3.743907842268498,20.0,20.0
42257,4,2257,[ 28 423  70  50 175],506,5,8455,3.744464127546501,0.0,20.0
42258,4,2258,[302 603 427 100  64],90,5,8460,3.745019920318725,20.0,20.0
42259,4,2259,[597 748 176 204 117],788,2,8462,3.7442477876106195,0.0,0.0
42260,4,2260,[172 471 180 318 216],271,4,8466,3.744360902255639,20.0,0.0
42261,4,2261,[121 117 202 276 300],892,5,8471,3.744916003536693,0.0,0.0
42262,4,2262,[ 28   1 202 127  96],263,4,8475,3.7450287229341583,0.0,20.0
42263,4,2263,[302 603 427 100  64],458,5,8480,3.745583038869258,20.0,20.0
42264,4,2264,[302 603 427 100  64],537,4,8484,3.7456953642384105,20.0,20.0
42265,4,2265,[174  97 748 185 475],64,3,8487,3.7453662842012356,0.0,20.0
42266,4,2266,[182 174 179 186 153],210,4,8491,3.74547860608734,0.0,20.0
42267,4,2267,[515 423 655   7 143],334,4,8495,3.745590828924162,0.0,0.0
42268,4,2268,[302 603 427 100  64],454,5,8500,3.74614367562803,20.0,20.0
42269,4,2269,[302 603 427 100  64],664,5,8505,3.746696035242291,20.0,20.0
42270,4,2270,[ 70   4 175 268  97],537,3,8508,3.7463672391017173,0.0,0.0
42271,4,2271,[655 132 183 357  96],749,5,8513,3.746919014084507,20.0,0.0
42272,4,2272,[302 603 427 100  64],271,5,8518,3.7474703035635724,20.0,20.0
42273,4,2273,[302 603 427 100  64],458,5,8523,3.7480211081794197,20.0,20.0
42274,4,2274,[302 603 427 100  64],370,5,8528,3.7485714285714287,20.0,20.0
42275,4,2275,[302 603 427 100  64],537,4,8532,3.748681898066784,20.0,20.0
42276,4,2276,[302 603 427 100  64],339,5,8537,3.749231444883619,20.0,20.0
42277,4,2277,[269 318 153 423 222],64,4,8541,3.7493415276558384,20.0,0.0
42278,4,2278,[168  22 235 655 173],194,4,8545,3.749451513821852,0.0,0.0
42279,4,2279,[588 258  79 228 175],64,4,8549,3.749561403508772,0.0,0.0
42280,4,2280,[302 603 427 100  64],666,5,8554,3.75010960105217,20.0,20.0
42281,4,2281,[257  97 186 234 185],95,3,8557,3.749780893952673,0.0,0.0
42282,4,2282,[ 15 175 302 210  56],360,3,8560,3.7494524748138414,0.0,0.0
42283,4,2283,[286 234 194 121 127],13,4,8564,3.7495621716287215,0.0,20.0
42284,4,2284,[568 127 183  28  96],59,5,8569,3.750109409190372,0.0,20.0
42285,4,2285,[289 222  97  25 215],387,1,8570,3.748906386701662,0.0,0.0
42286,4,2286,[302 603 427 100  64],537,4,8574,3.7490161783996503,20.0,20.0
42287,4,2287,[ 11 210 286  12 196],7,4,8578,3.749125874125874,20.0,0.0
42288,4,2288,[302 603 427 100  64],454,5,8583,3.749672346002621,20.0,20.0
42289,4,2289,[302 603 427 100  64],339,5,8588,3.7502183406113536,20.0,20.0
42290,4,2290,[385  56 185  28 234],643,4,8592,3.7503273679615887,0.0,0.0
42291,4,2291,[245 187 197 194 153],666,3,8595,3.75,0.0,0.0
42292,4,2292,[302 603 427 100  64],666,5,8600,3.7505451373746186,20.0,20.0
42293,4,2293,[204 161 211  89 403],843,1,8601,3.749346120313862,0.0,0.0
42294,4,2294,[ 56 173 216   7 276],234,0,8601,3.7477124183006536,0.0,0.0
42295,4,2295,[135 183 180  98  79],774,3,8604,3.7473867595818815,0.0,20.0
42296,4,2296,[185 403 111 175 174],59,5,8609,3.7479320853286895,0.0,20.0
42297,4,2297,[ 89  56 151 194 174],804,3,8612,3.7476066144473457,0.0,20.0
42298,4,2298,[515 238  79  50 143],804,4,8616,3.7477163984341018,0.0,20.0
42299,4,2299,[ 79  82 515 200   8],60,3,8619,3.747391304347826,0.0,0.0
42300,4,2300,[302 603 427 100  64],13,5,8624,3.74793568013907,20.0,20.0
42301,4,2301,[ 95 118  70 185 182],804,4,8628,3.7480451781059947,0.0,0.0
42302,4,2302,[427   8 322 186  28],13,4,8632,3.748154580981329,0.0,0.0
42303,4,2303,[288 181  98 265 100],64,5,8637,3.7486979166666665,0.0,40.0
42304,4,2304,[186 100 172 286 197],406,3,8640,3.7483731019522777,0.0,20.0
42305,4,2305,[204 228 200 144 271],749,5,8645,3.748915871639202,0.0,0.0
42306,4,2306,[174 423  69 435 301],378,3,8648,3.7485912440398788,0.0,20.0
42307,4,2307,[328 276   8 471  71],378,3,8651,3.748266897746967,0.0,0.0
42308,4,2308,[302 603 427 100  64],664,5,8656,3.7488090082286702,20.0,20.0
42309,4,2309,[302 603 427 100  64],745,5,8661,3.7493506493506494,20.0,20.0
42310,4,2310,[ 50 180 313  22  97],380,3,8664,3.749026395499784,0.0,20.0
42311,4,2311,[302 603 427 100  64],666,5,8669,3.749567474048443,20.0,20.0
42312,4,2312,[302 603 427 100  64],454,5,8674,3.750108084738435,20.0,20.0
42313,4,2313,[ 82 135  70 300   4],533,3,8677,3.7497839239412274,0.0,0.0
42314,4,2314,[ 11  89 403   1  82],234,0,8677,3.7481641468682505,0.0,0.0
42315,4,2315,[204 405  97 182 195],666,2,8679,3.7474093264248705,0.0,0.0
42316,4,2316,[ 88  11  28 195   8],454,4,8683,3.747518342684506,0.0,0.0
42317,4,2317,[302 603 427 100  64],474,5,8688,3.7480586712683346,20.0,20.0
42318,4,2318,[151 111 385 333 237],533,3,8691,3.7477360931435966,0.0,0.0
42319,4,2319,[302 603 427 100  64],666,5,8696,3.7482758620689656,20.0,20.0
42320,4,2320,[302 603 427 100  64],339,5,8701,3.748815165876777,20.0,20.0
42321,4,2321,[302 603 427 100  64],271,5,8706,3.749354005167959,20.0,20.0
42322,4,2322,[515 183 132 215 258],200,5,8711,3.749892380542402,0.0,0.0
42323,4,2323,[302 603 427 100  64],458,5,8716,3.7504302925989674,20.0,20.0
42324,4,2324,[183  88 588  25   7],537,1,8717,3.749247311827957,0.0,0.0
42325,4,2325,[ 88 435 271 323 496],290,2,8719,3.748495270851247,0.0,0.0
42326,4,2326,[655 222 196 186 322],881,3,8722,3.7481736140954016,0.0,0.0
42327,4,2327,[ 69 111 403   9  79],59,5,8727,3.7487113402061856,0.0,0.0
42328,4,2328,[202  89  98 204 216],690,2,8729,3.7479604980678403,0.0,20.0
42329,4,2329,[  7 234 175 173   1],648,3,8732,3.747639484978541,0.0,0.0
42330,4,2330,[153 187 143 237 176],694,5,8737,3.748176748176748,0.0,0.0
42331,4,2331,[302 603 427 100  64],474,5,8742,3.748713550600343,20.0,20.0
42332,4,2332,[302 603 427 100  64],454,5,8747,3.7492498928418345,20.0,20.0
42333,4,2333,[ 70 238  95  28  22],125,3,8750,3.748928877463582,0.0,0.0
42334,4,2334,[318 186 294 427 183],780,2,8752,3.7481798715203425,20.0,0.0
42335,4,2335,[302 603 427 100  64],90,5,8757,3.7487157534246576,20.0,20.0
42336,4,2336,[153  96  97 258   4],666,4,8761,3.748823277706461,0.0,0.0
42337,4,2337,[273  98 194 276 100],234,3,8764,3.748502994011976,0.0,40.0
42338,4,2338,[ 97  82 127  56 515],666,4,8768,3.748610517315092,0.0,20.0
42339,4,2339,[588 174 173 357 210],387,4,8772,3.7487179487179487,20.0,20.0
42340,4,2340,[153 216 197 211 175],406,3,8775,3.7483981204613412,0.0,0.0
42341,4,2341,[302 603 427 100  64],458,5,8780,3.748932536293766,20.0,20.0
42342,4,2342,[546 234 328 265 603],234,2,8782,3.7481860862142553,20.0,0.0
42343,4,2343,[258 111  12 403 186],13,4,8786,3.7482935153583616,20.0,0.0
42344,4,2344,[302 603 427 100  64],454,5,8791,3.748827292110874,20.0,20.0
42345,4,2345,[204 276 210 427 161],271,3,8794,3.7485080988917305,0.0,0.0
42346,4,2346,[  1 655 182 603 161],804,5,8799,3.7490413293566256,20.0,0.0
42347,4,2347,[318 118 195 228 238],13,2,8801,3.7482964224872233,20.0,0.0
42348,4,2348,[302 603 427 100  64],370,5,8806,3.748829289059174,20.0,20.0
42349,4,2349,[405 238 273  97  96],13,2,8808,3.7480851063829785,0.0,0.0
42350,4,2350,[235 121   7 191 546],699,0,8808,3.746490854955338,0.0,0.0
42351,4,2351,[302 603 427 100  64],370,5,8813,3.7470238095238093,20.0,20.0
42352,4,2352,[180 185 176 210 183],543,4,8817,3.747131321716957,0.0,0.0
42353,4,2353,[  1 742 127 235 118],634,3,8820,3.7468139337298214,0.0,20.0
42354,4,2354,[179 275  11 435 196],271,5,8825,3.7473460721868364,0.0,0.0
42355,4,2355,[228 357   8 144 185],7,5,8830,3.7478777589134125,20.0,0.0
42356,4,2356,[127 143 322 265 125],313,2,8832,3.7471361900721254,0.0,20.0
42357,4,2357,[ 71 237 300  12 127],13,4,8836,3.7472434266327395,20.0,20.0
42358,4,2358,[ 79 118 173 483   1],194,3,8839,3.7469266638406102,20.0,0.0
42359,4,2359,[234 186 238 168 174],795,3,8842,3.7466101694915253,0.0,20.0
42360,4,2360,[302 603 427 100  64],454,5,8847,3.747141041931385,20.0,20.0
42361,4,2361,[515 235 173  22 202],59,4,8851,3.7472480948348856,0.0,0.0
42362,4,2362,[302 603 427 100  64],664,5,8856,3.7477782479898436,20.0,20.0
42363,4,2363,[302 603 427 100  64],90,5,8861,3.7483079526226732,20.0,20.0
42364,4,2364,[ 50 228 546 423 196],95,4,8865,3.748414376321353,0.0,20.0
42365,4,2365,[168 121 118 210 435],666,2,8867,3.747675401521555,0.0,0.0
42366,4,2366,[111 194 385  70 405],474,5,8872,3.748204478242501,0.0,0.0
42367,4,2367,[496  71 215 742 655],42,4,8876,3.748310810810811,0.0,0.0
42368,4,2368,[385 153 313 144 172],659,4,8880,3.748417053609118,0.0,0.0
42369,4,2369,[302 603 427 100  64],90,5,8885,3.7489451476793247,20.0,20.0
42370,4,2370,[ 11 475 174 197 275],455,4,8889,3.7490510333192746,0.0,20.0
42371,4,2371,[282 222 174   8 132],200,5,8894,3.7495784148397977,0.0,20.0
42372,4,2372,[302 603 427 100  64],271,5,8899,3.750105351875263,20.0,20.0
42373,4,2373,[302 603 427 100  64],537,4,8903,3.7502106149957877,20.0,20.0
42374,4,2374,[187 235 483 121  79],328,4,8907,3.7503157894736843,20.0,0.0
42375,4,2375,[204 195   4 405 215],538,2,8909,3.7495791245791246,0.0,0.0
42376,4,2376,[302 603 427 100  64],90,5,8914,3.750105174589819,20.0,20.0
42377,4,2377,[125  11 204 328 294],234,0,8914,3.7485281749369217,0.0,0.0
42378,4,2378,[302 603 427 100  64],474,5,8919,3.7490542244640603,20.0,20.0
42379,4,2379,[302 603 427 100  64],537,4,8923,3.749159663865546,20.0,20.0
42380,4,2380,[302 603 427 100  64],666,5,8928,3.749685006299874,20.0,20.0
42381,4,2381,[302 603 427 100  64],745,5,8933,3.750209907640638,20.0,20.0
42382,4,2382,[302 603 427 100  64],370,5,8938,3.750734368443139,20.0,20.0
42383,4,2383,[405  11   8 258 195],213,3,8941,3.7504194630872485,0.0,0.0
42384,4,2384,[515   7  69 333 234],458,3,8944,3.750104821802935,0.0,0.0
42385,4,2385,[403  64 235 288  50],339,2,8946,3.749371332774518,0.0,20.0
42386,4,2386,[ 28 100 135 269 153],615,4,8950,3.7494763301214915,0.0,20.0
42387,4,2387,[210 435 195 135  28],263,3,8953,3.7491624790619764,0.0,0.0
42388,4,2388,[423 182 385  25  69],90,3,8956,3.7488488907492674,0.0,0.0
42389,4,2389,[302 603 427 100  64],666,5,8961,3.7493723849372387,20.0,20.0
42390,4,2390,[302 603 427 100  64],537,4,8965,3.7494772061898787,20.0,20.0
42391,4,2391,[161 121 172 197 111],454,3,8968,3.749163879598662,0.0,0.0
42392,4,2392,[588 385 228 269 185],7,4,8972,3.749268700376097,0.0,0.0
42393,4,2393,[423 211 257 228  22],290,4,8976,3.7493734335839597,0.0,0.0
42394,4,2394,[405 597 144 174 181],653,3,8979,3.7490605427974946,0.0,20.0
42395,4,2395,[172 182 202 655  69],815,3,8982,3.7487479131886476,0.0,0.0
42396,4,2396,[302 603 427 100  64],458,5,8987,3.749269920734251,20.0,20.0
42397,4,2397,[302 603 427 100  64],90,5,8992,3.749791492910759,20.0,20.0
42398,4,2398,[423   4 318 238 185],543,2,8994,3.7490621092121716,20.0,0.0
42399,4,2399,[195 286  82  69 471],666,2,8996,3.7483333333333335,0.0,0.0
42400,4,2400,[258 282 211 144  22],479,5,9001,3.7488546438983756,0.0,0.0
42401,4,2401,[144 597 132 174 215],643,3,9004,3.7485428809325563,0.0,20.0
42402,4,2402,[302 603 427 100  64],271,5,9009,3.749063670411985,20.0,20.0
42403,4,2403,[222 405 318 125 385],313,2,9011,3.7483361064891847,20.0,0.0
42404,4,2404,[357  97 216  70 286],474,5,9016,3.748856548856549,20.0,0.0
42405,4,2405,[302 603 427 100  64],458,5,9021,3.7493765586034913,20.0,20.0
42406,4,2406,[302 603 427 100  64],664,5,9026,3.7498961362692147,20.0,20.0
42407,4,2407,[180 302 276  70 132],13,4,9030,3.75,0.0,0.0
42408,4,2408,[269 235  12 210 173],13,1,9031,3.7488584474885847,20.0,0.0
42409,4,2409,[286  79 294  89 216],653,3,9034,3.7485477178423237,0.0,0.0
42410,4,2410,[302 603 427 100  64],664,5,9039,3.749066777270842,20.0,20.0
42411,4,2411,[ 69  95 181 174 176],125,5,9044,3.7495854063018244,0.0,20.0
42412,4,2412,[186   9 282 546 496],271,3,9047,3.7492747617074182,0.0,0.0
42413,4,2413,[  8 508 183 176 174],326,3,9050,3.7489643744821874,0.0,20.0
42414,4,2414,[302 603 427 100  64],339,5,9055,3.749482401656315,20.0,20.0
42415,4,2415,[  4 196 265 175 181],308,3,9058,3.7491721854304636,0.0,0.0
42416,4,2416,[302 603 427 100  64],370,5,9063,3.7496896979726935,20.0,20.0
42417,4,2417,[181 318 294 100 568],328,3,9066,3.7493796526054592,20.0,20.0
42418,4,2418,[385 176 357 202 273],7,2,9068,3.7486564696155438,20.0,0.0
42419,4,2419,[  7 237 588  28 483],59,3,9071,3.7483471074380166,20.0,0.0
42420,4,2420,[302 603 427 100  64],454,5,9076,3.748864105741429,20.0,20.0
42421,4,2421,[435 237 235  25 118],447,4,9080,3.7489677952105698,0.0,0.0
42422,4,2422,[302 603 427 100  64],271,5,9085,3.749484110606686,20.0,20.0
42423,4,2423,[ 25  64 471 496 127],313,4,9089,3.7495874587458746,0.0,20.0
42424,4,2424,[302 603 427 100  64],454,5,9094,3.750103092783505,20.0,20.0
42425,4,2425,[302 603 427 100  64],664,5,9099,3.7506183017312447,20.0,20.0
42426,4,2426,[302 603 427 100  64],745,5,9104,3.7511330861145447,20.0,20.0
42427,4,2427,[ 82  97 385 182 100],64,3,9107,3.750823723228995,0.0,20.0
42428,4,2428,[143 191 268 237  69],6,1,9108,3.7496912309592423,0.0,0.0
42429,4,2429,[301 289 179 603  88],537,2,9110,3.748971193415638,20.0,0.0
42430,4,2430,[182 202 568 132  71],533,4,9114,3.749074454956808,0.0,0.0
42431,4,2431,[302 603 427 100  64],537,4,9118,3.7491776315789473,20.0,20.0
42432,4,2432,[175  56 153 273 222],279,3,9121,3.748869708179203,0.0,0.0
42433,4,2433,[  1 204 435 197  89],804,4,9125,3.748972884141331,0.0,0.0
42434,4,2434,[ 71 151 100 216  89],279,3,9128,3.748665297741273,0.0,20.0
42435,4,2435,[302 603 427 100  64],745,5,9133,3.7491789819376025,20.0,20.0
42436,4,2436,[ 89 435  12 118 294],308,3,9136,3.74887156339762,20.0,0.0
42437,4,2437,[132  64 483 187 135],804,4,9140,3.748974569319114,20.0,0.0
42438,4,2438,[496 121 318 210   9],184,4,9144,3.7490774907749076,20.0,0.0
42439,4,2439,[153  95 195 183 234],804,4,9148,3.7491803278688525,0.0,0.0
42440,4,2440,[238 405  70  71 176],479,4,9152,3.7492830807046293,0.0,0.0
42441,4,2441,[302 603 427 100  64],458,5,9157,3.7497952497952496,20.0,20.0
42442,4,2442,[302 603 427 100  64],666,5,9162,3.7503069995906673,20.0,20.0
42443,4,2443,[117 144 172  89 216],194,1,9163,3.7491816693944355,0.0,0.0
42444,4,2444,[313 210 176  28 588],254,3,9166,3.7488752556237217,0.0,0.0
42445,4,2445,[269 111 194 180 117],6,3,9169,3.748569092395748,0.0,0.0
42446,4,2446,[271 257 187 197  89],144,3,9172,3.748263179403351,0.0,0.0
42447,4,2447,[302 603 427 100  64],458,5,9177,3.7487745098039214,20.0,20.0
42448,4,2448,[ 97 180 222 182  89],387,4,9181,3.7488770926908943,0.0,0.0
42449,4,2449,[302 603 427 100  64],537,4,9185,3.7489795918367346,20.0,20.0
42450,4,2450,[195 385   4 194 118],653,2,9187,3.748266013871889,0.0,0.0
42451,4,2451,[143 118 194 748 210],313,3,9190,3.7479608482871125,0.0,0.0
42452,4,2452,[603  96 357 204   1],59,4,9194,3.7480635955972277,40.0,0.0
42453,4,2453,[286 196 294 202 216],288,4,9198,3.748166259168704,0.0,0.0
42454,4,2454,[ 88 187 301 276 144],13,4,9202,3.7482688391038694,0.0,0.0
42455,4,2455,[161  28  70 172 288],533,4,9206,3.748371335504886,0.0,0.0
42456,4,2456,[179  56 282  50 405],406,3,9209,3.748066748066748,0.0,20.0
42457,4,2457,[302 603 427 100  64],537,4,9213,3.7481692432872253,20.0,20.0
42458,4,2458,[161 180  82   8 234],95,1,9214,3.7470516470109803,0.0,0.0
42459,4,2459,[742  70 483 182 174],308,4,9218,3.7471544715447154,20.0,20.0
42460,4,2460,[302 603 427 100  64],664,5,9223,3.7476635514018692,20.0,20.0
42461,4,2461,[385 196 235  11 183],897,1,9224,3.7465475223395615,0.0,0.0
42462,4,2462,[655 204  56 179 385],387,2,9226,3.745838408444986,0.0,0.0
42463,4,2463,[515  98 215  22 276],232,2,9228,3.7451298701298703,0.0,20.0
42464,4,2464,[ 56  28 742 222 228],881,3,9231,3.7448275862068967,0.0,0.0
42465,4,2465,[302 603 427 100  64],666,5,9236,3.7453365774533656,20.0,20.0
42466,4,2466,[234 588 185   1 271],13,2,9238,3.7446291041751114,0.0,0.0
42467,4,2467,[302 603 427 100  64],666,5,9243,3.745137763371151,20.0,20.0
42468,4,2468,[302 603 427 100  64],90,5,9248,3.7456460105305793,20.0,20.0
42469,4,2469,[302 603 427 100  64],458,5,9253,3.746153846153846,20.0,20.0
42470,4,2470,[302 603 427 100  64],271,5,9258,3.746661270740591,20.0,20.0
42471,4,2471,[271 603  69 196 187],749,4,9262,3.7467637540453076,20.0,0.0
42472,4,2472,[144  71 182   7 318],64,3,9265,3.746461787302871,20.0,0.0
42473,4,2473,[302 603 427 100  64],13,5,9270,3.7469684721099434,20.0,20.0
42474,4,2474,[302 603 427 100  64],664,5,9275,3.7474747474747474,20.0,20.0
42475,4,2475,[302 603 427 100  64],90,5,9280,3.7479806138933762,20.0,20.0
42476,4,2476,[ 64 568 294 194  11],387,0,9280,3.7464675010092856,0.0,0.0
42477,4,2477,[302 603 427 100  64],454,5,9285,3.7469733656174333,20.0,20.0
42478,4,2478,[302 603 427 100  64],370,5,9290,3.7474788221056876,20.0,20.0
42479,4,2479,[302 603 427 100  64],370,5,9295,3.747983870967742,20.0,20.0
42480,4,2480,[175 678 202 385 496],387,1,9296,3.746876259572753,0.0,0.0
42481,4,2481,[302 603 427 100  64],271,5,9301,3.7473811442385174,20.0,20.0
42482,4,2482,[302 603 427 100  64],666,5,9306,3.747885622231172,20.0,20.0
42483,4,2483,[ 98  50   1 174 118],454,3,9309,3.747584541062802,0.0,60.0
42484,4,2484,[ 12 496 127 237 204],524,1,9310,3.7464788732394365,20.0,20.0
42485,4,2485,[237 197 111 328 174],271,4,9314,3.746580852775543,0.0,20.0
42486,4,2486,[118 175 357 300 196],669,3,9317,3.746280659429031,20.0,0.0
42487,4,2487,[302 603 427 100  64],370,5,9322,3.7467845659163985,20.0,20.0
42488,4,2488,[294  82 234 182 228],650,2,9324,3.7460827641623142,0.0,0.0
42489,4,2489,[302 603 427 100  64],664,5,9329,3.7465863453815262,20.0,20.0
42490,4,2490,[135 403 125   1 180],653,3,9332,3.746286631874749,0.0,0.0
42491,4,2491,[  1 385 276 405 211],343,4,9336,3.7463884430176564,0.0,0.0
42492,4,2492,[302 603 427 100  64],537,4,9340,3.7464901724829525,20.0,20.0
42493,4,2493,[216 300 546 100 186],234,1,9341,3.745388933440257,0.0,20.0
42494,4,2494,[302 603 427 100  64],90,5,9346,3.745891783567134,20.0,20.0
42495,4,2495,[228 405  64  22 318],774,1,9347,3.7447916666666665,20.0,0.0
42496,4,2496,[172 117  71  95 234],378,4,9351,3.7448938726471765,0.0,0.0
42497,4,2497,[ 56 276   1  25 265],537,2,9353,3.744195356285028,0.0,0.0
42498,4,2498,[302 603 427 100  64],745,5,9358,3.7446978791516607,20.0,20.0
42499,4,2499,[180 194 286 135 403],343,5,9363,3.7452,0.0,0.0
42500,4,2500,[175 168  28 200 143],308,4,9367,3.745301879248301,0.0,0.0
42501,4,2501,[302 603 427 100  64],666,5,9372,3.7458033573141485,20.0,20.0
42502,4,2502,[405 197 265 182 269],666,3,9375,3.745505393527767,0.0,0.0
42503,4,2503,[168 222 135 186 427],380,2,9377,3.744808306709265,0.0,0.0
42504,4,2504,[423   4 210 385 655],378,4,9381,3.7449101796407187,0.0,0.0
42505,4,2505,[187 333  82 222 234],343,3,9384,3.744612928970471,0.0,0.0
42506,4,2506,[172  98 328 144 234],234,2,9386,3.7439170323095334,0.0,20.0
42507,4,2507,[194 182 168 568 496],537,3,9389,3.743620414673046,0.0,0.0
42508,4,2508,[302 603 427 100  64],454,5,9394,3.744121163810283,20.0,20.0
42509,4,2509,[  4  15 385  12 216],533,4,9398,3.744223107569721,20.0,0.0
42510,4,2510,[405  28  97  89 204],313,3,9401,3.743926722421346,0.0,0.0
42511,4,2511,[211 483 179 302 144],10,5,9406,3.7444267515923566,20.0,0.0
42512,4,2512,[ 82 655 118 222  79],343,4,9410,3.7445284520493436,0.0,0.0
42513,4,2513,[568 257 403 204 427],339,2,9412,3.7438345266507556,0.0,0.0
42514,4,2514,[405  11 180 235 228],788,2,9414,3.743141153081511,0.0,0.0
42515,4,2515,[496 132 289 121 172],406,4,9418,3.7432432432432434,0.0,0.0
42516,4,2516,[273 496 597 216  28],7,3,9421,3.7429479539133887,0.0,0.0
42517,4,2517,[302 603 427 100  64],90,5,9426,3.743447180301827,20.0,20.0
42518,4,2518,[302 603 427 100  64],458,5,9431,3.7439460103215563,20.0,20.0
42519,4,2519,[194 172 265  64 237],60,5,9436,3.7444444444444445,0.0,0.0
42520,4,2520,[216 423 183 144 257],650,2,9438,3.7437524791749306,0.0,0.0
42521,4,2521,[179 180  50 318 191],766,5,9443,3.7442505947660587,20.0,20.0
42522,4,2522,[302 603 427 100  64],745,5,9448,3.7447483154974237,20.0,20.0
42523,4,2523,[302 603 427 100  64],474,5,9453,3.745245641838352,20.0,20.0
42524,4,2524,[182  70 423 288 202],234,1,9454,3.7441584158415844,0.0,0.0
42525,4,2525,[302 603 427 100  64],745,5,9459,3.7446555819477436,20.0,20.0
42526,4,2526,[196  50 245 161 333],533,4,9463,3.744756628413138,0.0,20.0
42527,4,2527,[173  64 748 144 182],454,3,9466,3.7444620253164556,0.0,0.0
42528,4,2528,[515 185 195  79 269],235,5,9471,3.7449584816132857,0.0,0.0
42529,4,2529,[496 194  28 318 132],7,5,9476,3.7454545454545456,20.0,0.0
42530,4,2530,[302 603 427 100  64],664,5,9481,3.745950217305413,20.0,20.0
42531,4,2531,[ 98 568 144 191 286],207,3,9484,3.7456556082148498,0.0,20.0
42532,4,2532,[ 25 176 294 475 172],374,2,9486,3.7449664429530203,0.0,0.0
42533,4,2533,[  8 186 174 234 183],239,3,9489,3.744672454617206,0.0,20.0
42534,4,2534,[  7 144  64  50  88],194,2,9491,3.743984220907298,0.0,20.0
42535,4,2535,[121 194 204 211 235],102,1,9492,3.7429022082018926,0.0,0.0
42536,4,2536,[302 603 427 100  64],339,5,9497,3.7433977138352383,20.0,20.0
42537,4,2537,[ 69 216 568 300 174],533,5,9502,3.743892828999212,0.0,20.0
42538,4,2538,[289 174 403  82 173],524,5,9507,3.744387554155179,0.0,20.0
42539,4,2539,[302 603 427 100  64],537,4,9511,3.744488188976378,20.0,20.0
42540,4,2540,[302 603 427 100  64],666,5,9516,3.7449822904368357,20.0,20.0
42541,4,2541,[210  79  12 182 153],194,1,9517,3.7439024390243905,20.0,0.0
42542,4,2542,[111  56 153 172  89],643,4,9521,3.74400314589068,0.0,0.0
42543,4,2543,[273 186 117  22 322],328,3,9524,3.743710691823899,0.0,0.0
42544,4,2544,[ 96 588 144 187  15],650,1,9525,3.742632612966601,0.0,0.0
42545,4,2545,[211   7 197 172 111],59,5,9530,3.7431264728986644,0.0,0.0
42546,4,2546,[ 64 202 204  89 181],666,3,9533,3.7428347074990183,0.0,0.0
42547,4,2547,[302 603 427 100  64],537,4,9537,3.7429356357927785,20.0,20.0
42548,4,2548,[ 50 196   8 175 210],840,4,9541,3.7430364848960376,0.0,20.0
42549,4,2549,[125 174 185 121 143],311,3,9544,3.7427450980392156,0.0,20.0
42550,4,2550,[483 180 216 294  97],95,2,9546,3.742061936495492,20.0,0.0
42551,4,2551,[515 276  79 174 183],13,3,9549,3.741771159874608,0.0,20.0
42552,4,2552,[ 50   7 357 597 172],7,4,9553,3.7418723070896984,20.0,20.0
42553,4,2553,[302 603 427 100  64],271,5,9558,3.7423649177760376,20.0,20.0
42554,4,2554,[302 603 427 100  64],90,5,9563,3.742857142857143,20.0,20.0
42555,4,2555,[288 176 173   1 234],102,0,9563,3.741392801251956,0.0,0.0
42556,4,2556,[135 197 186 175 204],934,4,9567,3.7414939382088384,0.0,0.0
42557,4,2557,[515 197  98 196 135],194,3,9570,3.7412040656763095,0.0,20.0
42558,4,2558,[257 265 176  64 301],145,5,9575,3.7416959749902308,0.0,0.0
42559,4,2559,[302 603 427 100  64],339,5,9580,3.7421875,20.0,20.0
42560,4,2560,[194 181   1  11 100],82,5,9585,3.7426786411557984,0.0,20.0
42561,4,2561,[655 234 228 496 194],643,5,9590,3.7431693989071038,0.0,0.0
42562,4,2562,[301  96 215 273 546],524,3,9593,3.742879438158408,0.0,0.0
42563,4,2563,[245 300 176 546 435],749,4,9597,3.7429797191887677,0.0,0.0
42564,4,2564,[302 603 427 100  64],666,5,9602,3.7434697855750487,20.0,20.0
42565,4,2565,[742  98 257  15  70],454,2,9604,3.7427903351519873,0.0,20.0
42566,4,2566,[228 153 174 186 194],326,5,9609,3.7432800934943513,0.0,20.0
42567,4,2567,[568  28 294 405  82],538,1,9610,3.7422118380062304,0.0,0.0
42568,4,2568,[172 161  79 286 181],871,3,9613,3.7419229272090306,0.0,0.0
42569,4,2569,[588 175 153 194   7],102,2,9615,3.7412451361867705,0.0,0.0
42570,4,2570,[183 117 182  28  89],374,4,9619,3.7413457798521974,0.0,0.0
42571,4,2571,[ 11 265 273 222 234],378,3,9622,3.7410575427682735,0.0,0.0
42572,4,2572,[ 98 185 180 286  82],452,4,9626,3.741158181111543,0.0,20.0
42573,4,2573,[302 603 427 100  64],454,5,9631,3.7416472416472417,20.0,20.0
42574,4,2574,[302 603 427 100  64],370,5,9636,3.742135922330097,20.0,20.0
42575,4,2575,[174  69 273 215 127],144,5,9641,3.7426242236024843,0.0,40.0
42576,4,2576,[302 603 427 100  64],664,5,9646,3.7431121459060925,20.0,20.0
42577,4,2577,[483 132 546 215 265],13,4,9650,3.743211792086889,20.0,0.0
42578,4,2578,[302 603 427 100  64],474,5,9655,3.743699108181466,20.0,20.0
42579,4,2579,[234 127 174  22  79],488,5,9660,3.744186046511628,0.0,40.0
42580,4,2580,[ 22 294 135 216 118],653,2,9662,3.743510267338241,0.0,0.0
42581,4,2581,[515  71 273  79 172],387,4,9666,3.7436096049573973,0.0,0.0
42582,4,2582,[302 603 427 100  64],537,4,9670,3.743708865660085,20.0,20.0
42583,4,2583,[ 25 100 173 196 275],378,5,9675,3.7441950464396285,0.0,20.0
42584,4,2584,[302 603 427 100  64],474,5,9680,3.74468085106383,20.0,20.0
42585,4,2585,[405 435 194 235  96],897,3,9683,3.7443928847641144,0.0,0.0
42586,4,2586,[302 603 427 100  64],271,5,9688,3.744878237340549,20.0,20.0
42587,4,2587,[302 603 427 100  64],537,4,9692,3.7449768160741885,20.0,20.0
42588,4,2588,[  8 195 182 125 273],234,1,9693,3.7439165701042874,0.0,0.0
42589,4,2589,[302 603 427 100  64],537,4,9697,3.744015444015444,20.0,20.0
42590,4,2590,[228 333 357 175 179],653,4,9701,3.7441142416055575,20.0,0.0
42591,4,2591,[197 176 435  89 125],59,4,9705,3.744212962962963,0.0,0.0
42592,4,2592,[174 515 202 132  89],815,5,9710,3.7446972618588505,0.0,20.0
42593,4,2593,[288 143 403  88 172],374,1,9711,3.743639167309175,0.0,0.0
42594,4,2594,[ 88 216 202 204  97],13,4,9715,3.74373795761079,0.0,0.0
42595,4,2595,[302 603 427 100  64],339,5,9720,3.7442218798151004,20.0,20.0
42596,4,2596,[302 603 427 100  64],271,5,9725,3.744705429341548,20.0,20.0
42597,4,2597,[135 125 282  79 286],200,5,9730,3.745188606620477,0.0,0.0
42598,4,2598,[271 125 127 175 257],669,2,9732,3.7445171219699884,0.0,20.0
42599,4,2599,[ 50 237 228  95  82],537,1,9733,3.7434615384615384,0.0,20.0
42600,4,2600,[118 568 603 286 174],524,4,9737,3.7435601691657054,20.0,20.0
42601,4,2601,[302 603 427 100  64],458,5,9742,3.744043043812452,20.0,20.0
42602,4,2602,[ 97 186   9 197 161],60,4,9746,3.7441413753361505,0.0,0.0
42603,4,2603,[405 153 515 175  70],13,2,9748,3.7434715821812596,0.0,0.0
42604,4,2604,[302 603 427 100  64],537,4,9752,3.743570057581574,20.0,20.0
42605,4,2605,[385 333 300  50 245],533,4,9756,3.743668457405986,0.0,20.0
42606,4,2606,[302 603 427 100  64],454,5,9761,3.744150364403529,20.0,20.0
42607,4,2607,[197  79 237 176 151],234,1,9762,3.7430981595092025,0.0,0.0
42608,4,2608,[302 603 427 100  64],474,5,9767,3.7435799156765044,20.0,20.0
42609,4,2609,[318   4  98 328 135],537,2,9769,3.742911877394636,20.0,20.0
42610,4,2610,[222 546 234 265 269],64,4,9773,3.7430103408655686,0.0,0.0
42611,4,2611,[435  64 202 186  15],271,4,9777,3.7431087289433385,0.0,0.0
42612,4,2612,[655  82 238 357 435],254,2,9779,3.742441637964026,20.0,0.0
42613,4,2613,[ 11  89 275 568 276],90,5,9784,3.7429227237949503,0.0,0.0
42614,4,2614,[228 234 182 172 483],804,5,9789,3.7434034416826005,20.0,0.0
42615,4,2615,[216 471 202 403 125],533,4,9793,3.7435015290519877,0.0,0.0
42616,4,2616,[471  97 197 191 385],543,2,9795,3.742835307604127,0.0,0.0
42617,4,2617,[222 187  22 216 153],328,2,9797,3.7421695951107714,0.0,0.0
42618,4,2618,[216 153  79 186 302],328,3,9800,3.7418862161130204,0.0,0.0
42619,4,2619,[302 603 427 100  64],370,5,9805,3.7423664122137406,20.0,20.0
42620,4,2620,[302 603 427 100  64],271,5,9810,3.7428462418924076,20.0,20.0
42621,4,2621,[302 603 427 100  64],458,5,9815,3.7433257055682687,20.0,20.0
42622,4,2622,[282  56 357 132 135],533,2,9817,3.742661075104842,20.0,0.0
42623,4,2623,[ 71 143 202 173 423],897,3,9820,3.7423780487804876,0.0,0.0
42624,4,2624,[302 603 427 100  64],339,5,9825,3.742857142857143,20.0,20.0
42625,4,2625,[234 403 180 151 238],650,2,9827,3.742193450114242,0.0,0.0
42626,4,2626,[302 603 427 100  64],537,4,9831,3.74229158736201,20.0,20.0
42627,4,2627,[ 69  71 176 222 172],650,3,9834,3.7420091324200913,0.0,0.0
42628,4,2628,[302 603 427 100  64],90,5,9839,3.7424876378851275,20.0,20.0
42629,4,2629,[273 173  95  88 288],279,1,9840,3.741444866920152,0.0,0.0
42630,4,2630,[302 603 427 100  64],454,5,9845,3.741923223109084,20.0,20.0
42631,4,2631,[300 204 273 121 211],774,0,9845,3.740501519756839,0.0,0.0
42632,4,2632,[742 546  89 301 269],524,4,9849,3.7406000759589824,0.0,0.0
42633,4,2633,[181 508  82  98 135],334,4,9853,3.740698557327259,0.0,20.0
42634,4,2634,[276  12  79  88 161],308,4,9857,3.740796963946869,20.0,0.0
42635,4,2635,[302 603 427 100  64],537,4,9861,3.740895295902883,20.0,20.0
42636,4,2636,[302 603 427 100 313],13,5,9866,3.7413727720894956,20.0,20.0
42637,4,2637,[302 603 427 100 313],90,5,9871,3.741849886277483,20.0,20.0
42638,4,2638,[302 603 427 100 313],537,5,9876,3.742326638878363,20.0,20.0
42639,4,2639,[ 15 186 185 173   1],537,3,9879,3.7420454545454547,0.0,0.0
42640,4,2640,[ 89 175  70 153 135],543,3,9882,3.741764483150322,0.0,0.0
42641,4,2641,[655 182 678 302 515],339,4,9886,3.7418622255866767,0.0,0.0
42642,4,2642,[100 294 257 405 118],881,4,9890,3.7419598940597805,0.0,20.0
42643,4,2643,[302 603 427 100 313],13,5,9895,3.7424357034795763,20.0,20.0
42644,4,2644,[302 603 427 100 313],271,5,9900,3.742911153119093,20.0,20.0
42645,4,2645,[357 234 197 204 153],85,4,9904,3.743008314436886,20.0,0.0
42646,4,2646,[302 603 427 100 313],454,5,9909,3.7434831885153,20.0,20.0
42647,4,2647,[183 175 288 235  50],82,2,9911,3.742824773413897,0.0,20.0
42648,4,2648,[215 300  69 117  56],271,2,9913,3.7421668554171386,0.0,0.0
42649,4,2649,[195  22 172 385 168],346,5,9918,3.7426415094339625,0.0,0.0
42650,4,2650,[427 234 196  64  82],533,4,9922,3.7427385892116183,0.0,0.0
42651,4,2651,[302 603 427 100 313],14,4,9926,3.7428355957767723,20.0,20.0
42652,4,2652,[175 118   1  95 475],92,3,9929,3.742555597436864,0.0,0.0
42653,4,2653,[183 197 211 200 294],311,4,9933,3.742652599849284,0.0,0.0
42654,4,2654,[ 71 435 183 186 194],506,5,9938,3.743126177024482,0.0,0.0
42655,4,2655,[ 97 135 748 288  25],804,3,9941,3.7428463855421685,0.0,0.0
42656,4,2656,[ 98  89 603 268 302],664,4,9945,3.74294316898758,20.0,20.0
42657,4,2657,[195 174 132 175 496],474,5,9950,3.743416102332581,0.0,20.0
42658,4,2658,[210  79 185 161 294],234,0,9950,3.742008273787138,0.0,0.0
42659,4,2659,[202 181  79 196 496],194,1,9951,3.7409774436090224,0.0,0.0
42660,4,2660,[ 56 294 568  71 216],648,2,9953,3.7403231867718905,0.0,0.0
42661,4,2661,[  4 300 265  96 194],13,4,9957,3.7404207362885047,0.0,0.0
42662,4,2662,[111 435 357 318 135],533,3,9960,3.7401426962072852,40.0,0.0
42663,4,2663,[302 603 427 100  64],458,5,9965,3.7406156156156154,20.0,20.0
42664,4,2664,[302 603 427 100  64],90,5,9970,3.74108818011257,20.0,20.0
42665,4,2665,[302 603 427 100  64],745,5,9975,3.7415603900975243,20.0,20.0
42666,4,2666,[ 69  25 197 282 275],455,3,9978,3.7412823397075368,0.0,0.0
42667,4,2667,[302 603 427 100  64],666,5,9983,3.7417541229385307,20.0,20.0
42668,4,2668,[302 603 427 100  64],454,5,9988,3.7422255526414387,20.0,20.0
42669,4,2669,[234 196 125 333 182],144,3,9991,3.741947565543071,0.0,0.0
42670,4,2670,[174 289 508 176 132],537,1,9992,3.7409210033695244,0.0,20.0
42671,4,2671,[302 603 427 100  64],458,5,9997,3.741392215568862,20.0,20.0
42672,4,2672,[302 603 427 100  64],454,5,10002,3.7418630751964086,20.0,20.0
42673,4,2673,[210 235 173  98 204],804,5,10007,3.742333582647719,0.0,20.0
42674,4,2674,[ 15 403  69  88 117],313,2,10009,3.741682242990654,0.0,0.0
42675,4,2675,[215  15  71 655  28],311,5,10014,3.742152466367713,0.0,0.0
42676,4,2676,[185 180 143 182 289],95,1,10015,3.7411281285020546,0.0,0.0
42677,4,2677,[ 82 427 568 210  79],308,5,10020,3.741598207617625,0.0,0.0
42678,4,2678,[200 143 597 195 183],650,4,10024,3.7416946621873834,0.0,0.0
42679,4,2679,[302 603 427 100  64],13,5,10029,3.7421641791044777,20.0,20.0
42680,4,2680,[423 185 245   4 173],749,5,10034,3.742633345766505,0.0,0.0
42681,4,2681,[302 603 427 100  64],454,5,10039,3.7431021625652496,20.0,20.0
42682,4,2682,[ 89 405  70 153 181],479,5,10044,3.743570629891912,0.0,0.0
42683,4,2683,[302 603 427 100  64],664,5,10049,3.744038748137109,20.0,20.0
42684,4,2684,[  8 176  15 180  69],378,3,10052,3.7437616387337056,0.0,0.0
42685,4,2685,[302 603 427 100  64],537,4,10056,3.74385703648548,20.0,20.0
42686,4,2686,[357   4 265 385 318],318,4,10060,3.7439523632303686,40.0,0.0
42687,4,2687,[ 88 196 282 508 546],378,4,10064,3.744047619047619,0.0,0.0
42688,4,2688,[435 427 496 195   1],6,5,10069,3.7445146894756416,0.0,0.0
42689,4,2689,[302 603 427 100  64],458,5,10074,3.744981412639405,20.0,20.0
42690,4,2690,[302 603 427 100  64],454,5,10079,3.74544778892605,20.0,20.0
42691,4,2691,[588  88 153 197  50],454,3,10082,3.7451708766716196,0.0,20.0
42692,4,2692,[195 196 742 211 194],454,1,10083,3.744151503898997,0.0,0.0
42693,4,2693,[117 144  82 508 191],92,4,10087,3.7442464736451373,0.0,0.0
42694,4,2694,[483 427 127  64  96],474,5,10092,3.7447124304267163,20.0,20.0
42695,4,2695,[234  82 216 328 238],92,2,10094,3.74406528189911,0.0,0.0
42696,4,2696,[ 69 143 186 175 333],666,1,10095,3.743047830923248,0.0,0.0
42697,4,2697,[302 603 427 100  64],90,5,10100,3.74351371386212,20.0,20.0
42698,4,2698,[302 603 427 100  64],458,5,10105,3.7439792515746575,20.0,20.0
42699,4,2699,[182 175 194 238  96],207,1,10106,3.742962962962963,0.0,0.0
42700,4,2700,[302 603 427 100  64],271,5,10111,3.743428359866716,20.0,20.0
42701,4,2701,[196 300   4 181  25],378,4,10115,3.743523316062176,0.0,0.0
42702,4,2702,[302 603 427 100  64],666,5,10120,3.7439881613022568,20.0,20.0
42703,4,2703,[  8  89 168  22 143],13,4,10124,3.7440828402366866,0.0,0.0
42704,4,2704,[302 234  97 603  96],666,3,10127,3.743807763401109,20.0,0.0
42705,4,2705,[302 603 427 100  64],474,5,10132,3.744271988174427,20.0,20.0
42706,4,2706,[ 11 385 265 273 323],537,0,10132,3.7428888067971924,0.0,0.0
42707,4,2707,[302 603 427 100  64],454,5,10137,3.7433530280649925,20.0,20.0
42708,4,2708,[ 97 204 132 168 161],474,4,10141,3.743447766703581,0.0,0.0
42709,4,2709,[182 172 197  95 483],406,5,10146,3.7439114391143913,20.0,0.0
42710,4,2710,[ 95 173  97 286 228],664,4,10150,3.744005901881225,0.0,0.0
42711,4,2711,[175 161 182  79  71],7,4,10154,3.744100294985251,0.0,0.0
42712,4,2712,[125  28 111  79 181],334,2,10156,3.743457427202359,0.0,0.0
42713,4,2713,[176 144  79 222   1],738,4,10160,3.743551952837141,0.0,0.0
42714,4,2714,[328 180 294 216 322],207,1,10161,3.7425414364640885,0.0,0.0
42715,4,2715,[302 603 427 100  64],745,5,10166,3.7430044182621502,20.0,20.0
42716,4,2716,[302 603 427 100  64],339,5,10171,3.743467059256533,20.0,20.0
42717,4,2717,[  1 179  25 268 515],537,3,10174,3.7431935246504784,0.0,0.0
42718,4,2718,[176 300 405 161 265],313,4,10178,3.7432879735196765,0.0,0.0
42719,4,2719,[ 98 210  95  79  69],830,4,10182,3.7433823529411763,0.0,20.0
42720,4,2720,[742 186 172 748 403],899,4,10186,3.7434766629915472,0.0,0.0
42721,4,2721,[  9 191  15 168 603],82,4,10190,3.7435709037472447,20.0,0.0
42722,4,2722,[568 508 204   7 118],13,2,10192,3.7429305912596402,0.0,0.0
42723,4,2723,[182 483 271 191 186],833,4,10196,3.7430249632892805,20.0,0.0
42724,4,2724,[  4 237 176  22 234],343,4,10200,3.743119266055046,0.0,0.0
42725,4,2725,[568 173 742 318 153],648,4,10204,3.7432134996331623,20.0,0.0
42726,4,2726,[ 70 275 496  96 222],406,2,10206,3.742574257425743,0.0,0.0
42727,4,2727,[ 97 161 603 471 215],533,4,10210,3.7426686217008798,20.0,0.0
42728,4,2728,[  8 216 187 238 175],313,4,10214,3.742762916819348,0.0,0.0
42729,4,2729,[125  79 568 546 427],194,1,10215,3.741758241758242,0.0,0.0
42730,4,2730,[216 215 183 508 423],378,5,10220,3.7422189674112047,0.0,0.0
42731,4,2731,[302 603 427 100  64],537,4,10224,3.7423133235724744,20.0,20.0
42732,4,2732,[132  97 111 427  25],42,2,10226,3.7416758141236737,0.0,0.0
42733,4,2733,[655  71 333 196  50],334,4,10230,3.741770299926847,0.0,20.0
42734,4,2734,[483 174 144 180 288],188,4,10234,3.7418647166361976,20.0,20.0
42735,4,2735,[143 194  88  96  70],207,2,10236,3.741228070175439,0.0,0.0
42736,4,2736,[496 405   8 588 228],7,4,10240,3.7413226160029227,0.0,0.0
42737,4,2737,[180  88 143 273  79],892,4,10244,3.7414170927684443,0.0,0.0
42738,4,2738,[180 117 132  98  12],524,2,10246,3.740781307046367,20.0,20.0
42739,4,2739,[302 603 427 100  64],745,5,10251,3.7412408759124087,20.0,20.0
42740,4,2740,[302 603 427 100  64],537,4,10255,3.7413352790952206,20.0,20.0
42741,4,2741,[483 471 172 496   9],234,2,10257,3.7407002188183807,20.0,0.0
42742,4,2742,[302 603 427 100  64],454,5,10262,3.74115931461903,20.0,20.0
42743,4,2743,[174 258  70 117 222],474,5,10267,3.741618075801749,0.0,20.0
42744,4,2744,[742 200 515 202 427],308,4,10271,3.741712204007286,0.0,0.0
42745,4,2745,[161  95 286 546 405],524,3,10274,3.741442097596504,0.0,0.0
42746,4,2746,[275 161 597 271 289],13,1,10275,3.7404441208591193,0.0,0.0
42747,4,2747,[268 204 302 237 603],537,3,10278,3.7401746724890828,20.0,0.0
42748,4,2748,[  4 655 143 182 202],194,2,10280,3.73954165150964,0.0,0.0
42749,4,2749,[302 603 427 100  64],537,4,10284,3.7396363636363636,20.0,20.0
42750,4,2750,[302 603 427 100 313],14,4,10288,3.7397310069065792,20.0,20.0
42751,4,2751,[403 161 210 153 515],326,2,10290,3.739098837209302,0.0,0.0
42752,4,2752,[748 117 176  89 294],92,3,10293,3.7388303668725027,0.0,0.0
42753,4,2753,[302 603 427 100  64],458,5,10298,3.739288307915759,20.0,20.0
42754,4,2754,[200 202 216 742 237],95,3,10301,3.7390199637023596,0.0,0.0
42755,4,2755,[385 161 127 121 176],804,4,10305,3.73911465892598,0.0,20.0
42756,4,2756,[302 603 427 100  64],13,5,10310,3.7395719985491476,20.0,20.0
42757,4,2757,[294 194 238 289 197],234,3,10313,3.739303843364757,0.0,0.0
42758,4,2758,[302 603 427 100  64],370,5,10318,3.7397607828923523,20.0,20.0
42759,4,2759,[  1  71 204  50 655],194,4,10322,3.7398550724637682,0.0,20.0
42760,4,2760,[185 143 183 215 173],815,4,10326,3.739949293734154,0.0,0.0
42761,4,2761,[257 288 508 191 282],474,2,10328,3.7393193338160753,0.0,0.0
42762,4,2762,[302 603 427 100  64],458,5,10333,3.7397756062251175,20.0,20.0
42763,4,2763,[333  22 135 286 168],533,4,10337,3.7398697539797396,0.0,0.0
42764,4,2764,[328 238 174  88 187],479,5,10342,3.7403254972875226,0.0,20.0
42765,4,2765,[546  56 182 294 197],271,1,10343,3.739334779464931,0.0,0.0
42766,4,2766,[  8 100 186 237 288],334,3,10346,3.73906758221901,0.0,20.0
42767,4,2767,[568 179 181   8 121],881,5,10351,3.739523121387283,0.0,0.0
42768,4,2768,[185  64 471 258 748],454,3,10354,3.739256049115204,0.0,0.0
42769,4,2769,[153 194 174 173 151],378,4,10358,3.739350180505415,0.0,20.0
42770,4,2770,[333  95 483  79 588],815,3,10361,3.739083363406712,20.0,0.0
42771,4,2771,[742 234 228 173 215],95,4,10365,3.7391774891774894,0.0,0.0
42772,4,2772,[302 603 427 100  64],370,5,10370,3.739632167327804,20.0,20.0
42773,4,2773,[302 603 427 100  64],537,4,10374,3.73972602739726,20.0,20.0
42774,4,2774,[302 603 427 100  64],339,5,10379,3.74018018018018,20.0,20.0
42775,4,2775,[302 603 427 100  64],537,4,10383,3.740273775216138,20.0,20.0
42776,4,2776,[302 603 427 100  64],666,5,10388,3.7407274036730285,20.0,20.0
42777,4,2777,[132 153 265  89 435],553,5,10393,3.7411807055435564,0.0,0.0
42778,4,2778,[228 405 182  97  15],479,3,10396,3.74091399784095,0.0,0.0
42779,4,2779,[302 603 427 100  64],474,5,10401,3.7413669064748203,20.0,20.0
42780,4,2780,[302 603 427 100  64],474,5,10406,3.741819489392305,20.0,20.0
42781,4,2781,[302 603 427 100  64],537,4,10410,3.7419122933141624,20.0,20.0
42782,4,2782,[301 405 174  11   4],788,1,10411,3.7409270571325908,0.0,20.0
42783,4,2783,[  8 546 313 195  98],64,4,10415,3.7410201149425286,0.0,20.0
42784,4,2784,[302 238  22  79 235],145,5,10420,3.741472172351885,0.0,0.0
42785,4,2785,[471  70 197   8 269],7,3,10423,3.741206030150754,0.0,0.0
42786,4,2786,[302 603 427 100  64],537,4,10427,3.7412988876928597,20.0,20.0
42787,4,2787,[195  50 153 222 268],77,5,10432,3.7417503586800573,0.0,20.0
42788,4,2788,[302 603 427 100  64],537,4,10436,3.7418429544639658,20.0,20.0
42789,4,2789,[258 135 288   1  97],479,3,10439,3.7415770609318995,0.0,0.0
42790,4,2790,[496 117 588  95 153],184,3,10442,3.7413113579362234,0.0,0.0
42791,4,2791,[302 603 427 100 174],745,4,10446,3.741404011461318,20.0,40.0
42792,4,2792,[ 69 186 222 546  95],374,5,10451,3.7418546365914787,0.0,0.0
42793,4,2793,[483  28  69 135 515],815,4,10455,3.741947029348604,20.0,0.0
42794,4,2794,[111 118  12   9 286],825,3,10458,3.741681574239714,20.0,0.0
42795,4,2795,[302 603 427 100  64],664,5,10463,3.742131616595136,20.0,20.0
42796,4,2796,[568 194 294  22 385],7,4,10467,3.7422238112263138,0.0,0.0
42797,4,2797,[ 11 276 180 603 204],537,3,10470,3.7419585418155825,20.0,0.0
42798,4,2798,[302 603 427 100  64],13,5,10475,3.7424080028581637,20.0,20.0
42799,4,2799,[302 603 427 100  64],90,5,10480,3.742857142857143,20.0,20.0
42800,4,2800,[ 56 508 228   1   9],343,5,10485,3.7433059621563727,0.0,0.0
42801,4,2801,[182 597 143 245 210],207,1,10486,3.742326909350464,0.0,0.0
42802,4,2802,[194  95 172 271 597],650,2,10488,3.7417053157331432,0.0,0.0
42803,4,2803,[302 603 427 100  64],474,5,10493,3.742154065620542,20.0,20.0
42804,4,2804,[568  95 195  82 655],749,4,10497,3.742245989304813,0.0,0.0
42805,4,2805,[385 228 276 181 117],92,5,10502,3.742694226657163,0.0,0.0
42806,4,2806,[546 176 496   7  98],648,4,10506,3.7427858924118276,0.0,20.0
42807,4,2807,[302 603 427 100  64],474,5,10511,3.743233618233618,20.0,20.0
42808,4,2808,[  1 302 423  28 121],378,5,10516,3.7436810252758987,0.0,0.0
42809,4,2809,[ 95 276 204 655 100],92,4,10520,3.7437722419928825,0.0,20.0
42810,4,2810,[153 121  98 286  12],378,5,10525,3.744219139096407,20.0,20.0
42811,4,2811,[655 265 357 173 234],7,5,10530,3.744665718349929,20.0,0.0
42812,4,2812,[302 603 427 100  64],537,4,10534,3.7447564877355135,20.0,20.0
42813,4,2813,[ 15  69 111 427 275],474,4,10538,3.7448471926083866,0.0,0.0
42814,4,2814,[508 210 186 111 300],653,3,10541,3.744582593250444,0.0,0.0
42815,4,2815,[ 79  50   9  56 183],374,3,10544,3.7443181818181817,0.0,20.0
42816,4,2816,[385 200 435  56 508],13,2,10546,3.7436989705360313,0.0,0.0
42817,4,2817,[180 161 237 211 179],653,3,10549,3.7434350603264726,0.0,0.0
42818,4,2818,[179 186 196 202 496],452,3,10552,3.7431713373536715,0.0,0.0
42819,4,2819,[568 245 183   1  89],488,2,10554,3.7425531914893617,0.0,0.0
42820,4,2820,[288 302 269  95   7],334,2,10556,3.7419354838709675,0.0,0.0
42821,4,2821,[ 25 181 405 471 172],533,4,10560,3.7420269312544296,0.0,0.0
42822,4,2822,[181  98 183 132  79],406,4,10564,3.7421183138505136,0.0,20.0
42823,4,2823,[302 603 427 100  64],666,5,10569,3.7425637393767706,20.0,20.0
42824,4,2824,[302 603 427 100  64],13,5,10574,3.743008849557522,20.0,20.0
42825,4,2825,[302 603 427 100  64],13,5,10579,3.74345364472753,20.0,20.0
42826,4,2826,[183  82  11 204 176],234,1,10580,3.742483197736116,0.0,0.0
42827,4,2827,[228   4 144  82 235],650,1,10581,3.7415134370579914,0.0,0.0
42828,4,2828,[174 275  11 194 435],64,5,10586,3.741958289148109,0.0,20.0
42829,4,2829,[288 435  95 333 144],13,3,10589,3.741696113074205,0.0,0.0
42830,4,2830,[678 475  98 276  96],308,3,10592,3.7414341222182976,0.0,20.0
42831,4,2831,[508 191 204 328 333],537,2,10594,3.740819209039548,0.0,0.0
42832,4,2832,[238 508   4 265 234],343,3,10597,3.740557712672079,0.0,0.0
42833,4,2833,[302 603 427 100  64],13,5,10602,3.741002117148906,20.0,20.0
42834,4,2834,[210 265 181 197 286],533,4,10606,3.741093474426808,0.0,0.0
42835,4,2835,[273 435 111 403  64],833,0,10606,3.739774330042313,0.0,0.0
42836,4,2836,[234 186 202  96 294],308,3,10609,3.7395135706732465,0.0,0.0
42837,4,2837,[183 195 275 238  79],311,5,10614,3.7399577167019027,0.0,0.0
42838,4,2838,[118  69  25 174 357],13,3,10617,3.7396970764353648,20.0,20.0
42839,4,2839,[222 742 323 161  15],290,3,10620,3.73943661971831,0.0,0.0
42840,4,2840,[603   4 483 174 216],804,5,10625,3.7398803238296376,40.0,20.0
42841,4,2841,[181 228   1 245  22],455,4,10629,3.7399718508092894,0.0,0.0
42842,4,2842,[302 603 427 100 313],537,5,10634,3.7404150545198736,20.0,20.0
42843,4,2843,[275  25 125  22   9],406,1,10635,3.7394514767932487,0.0,0.0
42844,4,2844,[302 603 427 100 313],13,5,10640,3.739894551845343,20.0,20.0
42845,4,2845,[176 237   8 265 588],892,5,10645,3.740337315530569,0.0,0.0
42846,4,2846,[302 603 427 100 313],90,5,10650,3.7407797681770285,20.0,20.0
42847,4,2847,[172   4  79  69 111],524,4,10654,3.740870786516854,0.0,0.0
42848,4,2848,[302 603 427 100 313],454,5,10659,3.741312741312741,20.0,20.0
42849,4,2849,[302 603 427 100 313],271,5,10664,3.7417543859649123,20.0,20.0
42850,4,2850,[ 25 483 238  69 194],295,5,10669,3.742195720799719,20.0,0.0
42851,4,2851,[302 603 427 100 313],454,5,10674,3.7426367461430576,20.0,20.0
42852,4,2852,[ 50 257 127  88 168],653,2,10676,3.742025937609534,0.0,40.0
42853,4,2853,[597 276 200 508  11],92,3,10679,3.7417659425367904,0.0,0.0
42854,4,2854,[ 22 179 180 168   9],543,3,10682,3.741506129597198,0.0,0.0
42855,4,2855,[210 515 435  25 357],194,3,10685,3.74124649859944,20.0,0.0
42856,4,2856,[ 15 385  95 228 183],92,3,10688,3.7409870493524675,0.0,0.0
42857,4,2857,[  9 603  70 118 268],13,3,10691,3.7407277816655005,20.0,0.0
42858,4,2858,[175 286  82 301  69],524,4,10695,3.7408184679958025,0.0,0.0
42859,4,2859,[153 282 742 197 183],95,5,10700,3.7412587412587412,0.0,0.0
42860,4,2860,[302 603 427 100 313],334,5,10705,3.741698706745893,20.0,20.0
42861,4,2861,[496 121 269 117  82],650,3,10708,3.7414395527603075,0.0,0.0
42862,4,2862,[483  96 174 151 204],59,5,10713,3.7418791477471185,20.0,20.0
42863,4,2863,[357 301 288 135 195],13,1,10714,3.7409217877094973,20.0,0.0
42864,4,2864,[195 173 168  97 333],13,2,10716,3.7403141361256544,0.0,0.0
42865,4,2865,[200  71 186 176 144],60,4,10720,3.7404047452896023,0.0,0.0
42866,4,2866,[197  22 427 276 257],298,4,10724,3.740495291245204,0.0,0.0
42867,4,2867,[182 176 186   4 294],378,2,10726,3.7398884239888424,0.0,0.0
42868,4,2868,[435 678 302 289 173],454,1,10727,3.738933426280934,0.0,0.0
42869,4,2869,[300 423  22 289 475],533,3,10730,3.7386759581881535,0.0,0.0
42870,4,2870,[258 173 132  50 191],537,4,10734,3.7387669801462904,0.0,20.0
42871,4,2871,[302 603 427 100 313],14,4,10738,3.738857938718663,20.0,20.0
42872,4,2872,[302 603 427 100  64],90,5,10743,3.7392969021928297,20.0,20.0
42873,4,2873,[196 269 475 748 204],207,2,10745,3.7386917188587336,0.0,0.0
42874,4,2874,[258 294 197 174  25],387,2,10747,3.738086956521739,0.0,20.0
42875,4,2875,[182 286 100 435  12],318,4,10751,3.7381780250347707,20.0,20.0
42876,4,2876,[302 603 427 100  64],339,5,10756,3.738616614529023,20.0,20.0
42877,4,2877,[286 568 174 172  71],648,3,10759,3.7383599722029186,0.0,20.0
42878,4,2878,[135 175 202 300 276],90,2,10761,3.7377561653351856,0.0,0.0
42879,4,2879,[ 70 204 257   1 176],881,4,10765,3.7378472222222223,0.0,0.0
42880,4,2880,[111   4 603 234 323],59,5,10770,3.738285317598056,20.0,0.0
42881,4,2881,[195 238 181 385 176],308,5,10775,3.7387231089521165,0.0,0.0
42882,4,2882,[302 603 427 100  64],370,5,10780,3.739160596600763,20.0,20.0
42883,4,2883,[302 603 427 100  64],745,5,10785,3.7395977808599166,20.0,20.0
42884,4,2884,[ 71 195 265 515 483],312,4,10789,3.7396880415944542,20.0,0.0
42885,4,2885,[302 603 427 100  64],370,5,10794,3.74012474012474,20.0,20.0
42886,4,2886,[117 222   8 276 318],200,5,10799,3.740561136127468,20.0,0.0
42887,4,2887,[183 127 168 483 216],538,4,10803,3.740650969529086,20.0,20.0
42888,4,2888,[183 568 385  79 174],7,5,10808,3.741086881273797,0.0,20.0
42889,4,2889,[302 603 427 100  64],458,5,10813,3.741522491349481,20.0,20.0
42890,4,2890,[302 603 427 100  64],537,4,10817,3.741611898996887,20.0,20.0
42891,4,2891,[215 294 237   1 121],533,4,10821,3.741701244813278,0.0,0.0
42892,4,2892,[202 234 423 194  70],537,1,10822,3.740753543034912,0.0,0.0
42893,4,2893,[302 603 427 100 174],90,5,10827,3.7411886662059435,20.0,40.0
42894,4,2894,[196  12   9 204 195],308,4,10831,3.7412780656303974,20.0,0.0
42895,4,2895,[302 603 427 100 174],745,4,10835,3.741367403314917,20.0,40.0
42896,4,2896,[294  22 204  89 323],13,3,10838,3.7411114946496378,0.0,0.0
42897,4,2897,[ 64 151 176 276  89],537,2,10840,3.740510697032436,0.0,0.0
42898,4,2898,[603 168 176   9 183],339,5,10845,3.7409451535012073,20.0,0.0
42899,4,2899,[135 200 194 204  97],13,4,10849,3.7410344827586206,0.0,0.0
42900,4,2900,[153  70  89 143  22],378,5,10854,3.7414684591520166,0.0,0.0
42901,4,2901,[302 603 427 100 313],474,5,10859,3.7419021364576155,20.0,20.0
42902,4,2902,[121 210 515 182 237],194,1,10860,3.740957630037892,0.0,0.0
42903,4,2903,[196 423  89 211 357],749,5,10865,3.741391184573003,20.0,0.0
42904,4,2904,[302 603 427 100 313],90,5,10870,3.7418244406196215,20.0,20.0
42905,4,2905,[182 546 238 269 161],524,5,10875,3.7422573984858913,0.0,0.0
42906,4,2906,[187 515 183   9 235],64,5,10880,3.742690058479532,0.0,0.0
42907,4,2907,[ 96 132 318  56 328],90,4,10884,3.7427785419532325,20.0,0.0
42908,4,2908,[118 546  98 237 286],13,3,10887,3.74252320385012,0.0,20.0
42909,4,2909,[655  88 197 180 403],326,1,10888,3.7415807560137457,0.0,0.0
42910,4,2910,[ 25   8   1 174 748],200,4,10892,3.7416695293713502,0.0,20.0
42911,4,2911,[302 603 427 100 313],271,5,10897,3.7421016483516483,20.0,20.0
42912,4,2912,[265 228  56  22  50],653,5,10902,3.742533470648816,0.0,20.0
42913,4,2913,[568 210  97 294 238],537,1,10903,3.74159231297186,0.0,0.0
42914,4,2914,[748 211  89 234 385],474,4,10907,3.741680960548885,0.0,0.0
42915,4,2915,[302 603 427 100 313],537,5,10912,3.7421124828532237,20.0,20.0
42916,4,2916,[302 603 427 100 313],271,5,10917,3.742543709290367,20.0,20.0
42917,4,2917,[302 603 427 100 313],474,5,10922,3.7429746401644963,20.0,20.0
42918,4,2918,[211 174 117 471 187],653,3,10925,3.7427201096265845,0.0,20.0
42919,4,2919,[302 603 427 100 313],14,4,10929,3.742808219178082,20.0,20.0
42920,4,2920,[302 603 427 100 174],537,4,10933,3.7428962684012324,20.0,40.0
42921,4,2921,[423  64  22 238 194],474,5,10938,3.7433264887063653,0.0,0.0
42922,4,2922,[294 603   1  95 238],13,2,10940,3.742730071843996,20.0,0.0
42923,4,2923,[195 265  50 179 302],378,3,10943,3.7424760601915183,0.0,20.0
42924,4,2924,[228 265 179 435 483],899,2,10945,3.741880341880342,20.0,0.0
42925,4,2925,[302 603 427 100  64],666,5,10950,3.7423103212576896,20.0,20.0
42926,4,2926,[302 603 427 100  64],339,5,10955,3.7427400068329346,20.0,20.0
42927,4,2927,[176 515  11 216 127],840,3,10958,3.7424863387978142,0.0,20.0
42928,4,2928,[172 181  70 194 483],59,3,10961,3.7422328439740524,20.0,0.0
42929,4,2929,[127  71 603 228 273],13,4,10965,3.742320819112628,20.0,20.0
42930,4,2930,[302 194  22 257 185],6,3,10968,3.7420675537359265,0.0,0.0
42931,4,2931,[357 423 234 515 508],643,5,10973,3.7424965893587996,20.0,0.0
42932,4,2932,[121 132 508  64 300],85,2,10975,3.7419024889191954,0.0,0.0
42933,4,2933,[ 79 546  22  64 496],64,4,10979,3.741990456714383,0.0,0.0
42934,4,2934,[302 603 427 100  64],474,5,10984,3.742419080068143,20.0,20.0
42935,4,2935,[187  69  11 357 265],115,3,10987,3.74216621253406,20.0,0.0
42936,4,2936,[271 117 275   8 195],536,4,10991,3.742254000680967,0.0,0.0
42937,4,2937,[228 204 423 318  95],804,3,10994,3.742001361470388,20.0,0.0
42938,4,2938,[302 603 427 100  64],454,5,10999,3.7424293977543384,20.0,20.0
42939,4,2939,[302 603 427 100  64],271,5,11004,3.742857142857143,20.0,20.0
42940,4,2940,[202 194  88 318 195],406,3,11007,3.7426045562733763,20.0,0.0
42941,4,2941,[ 11   9  22 403 175],343,5,11012,3.743031951053705,0.0,0.0
42942,4,2942,[204 121 427 210 185],650,2,11014,3.7424396873938157,0.0,0.0
42943,4,2943,[302 603 427 100  64],370,5,11019,3.742866847826087,20.0,20.0
42944,4,2944,[302 603 427 100  64],537,4,11023,3.7429541595925295,20.0,20.0
42945,4,2945,[197 333 132   9 181],13,3,11026,3.742701968771215,0.0,0.0
42946,4,2946,[302 603 427 100  64],474,5,11031,3.7431286053613846,20.0,20.0
42947,4,2947,[168 179 238 174  97],406,3,11034,3.742876526458616,0.0,20.0
42948,4,2948,[237  50  15  88 748],454,4,11038,3.7429637165140726,0.0,20.0
42949,4,2949,[269 180 187  12  89],233,3,11041,3.74271186440678,20.0,0.0
42950,4,2950,[161 211 405 237  28],59,2,11043,3.7421213148085393,0.0,0.0
42951,4,2951,[302 603 427 100  64],666,5,11048,3.7425474254742546,20.0,20.0
42952,4,2952,[211  15 185   7 202],537,3,11051,3.742295970199797,0.0,0.0
42953,4,2953,[302 603 427 100  64],370,5,11056,3.7427217332430605,20.0,20.0
42954,4,2954,[ 56 174   9 435  88],207,4,11060,3.742808798646362,0.0,20.0
42955,4,2955,[183   4 222 216  71],378,3,11063,3.74255751014885,0.0,0.0
42956,4,2956,[168 204 318 483  79],406,3,11066,3.7423063916131216,40.0,0.0
42957,4,2957,[302 603 427 100  64],370,5,11071,3.742731575388776,20.0,20.0
42958,4,2958,[276 385 194  97  12],892,4,11075,3.7428185197701924,20.0,0.0
42959,4,2959,[302 603 427 100  64],90,5,11080,3.7432432432432434,20.0,20.0
42960,4,2960,[  1  89 597 196 179],200,5,11085,3.7436676798378925,0.0,0.0
42961,4,2961,[302 603 427 100  64],90,5,11090,3.7440918298446997,20.0,20.0
42962,4,2962,[302 603 427 100  64],664,5,11095,3.7445156935538306,20.0,20.0
42963,4,2963,[302 603 427 100  64],745,5,11100,3.7449392712550607,20.0,20.0
42964,4,2964,[471 483 282 318 748],788,3,11103,3.7446880269814504,40.0,0.0
42965,4,2965,[313 182 185 200 328],271,2,11105,3.74409979770735,0.0,0.0
42966,4,2966,[187 471   1 288 121],605,3,11108,3.743849005729693,0.0,0.0
42967,4,2967,[385 423  79 435 655],234,1,11109,3.7429245283018866,0.0,0.0
42968,4,2968,[ 25 181 282 385   8],194,0,11109,3.7416638598854832,0.0,0.0
42969,4,2969,[597 313 117 265 175],92,4,11113,3.7417508417508416,0.0,0.0
42970,4,2970,[111 210 151 597  25],83,1,11114,3.7408280040390443,0.0,0.0
42971,4,2971,[ 56 172  98 185 174],788,2,11116,3.740242261103634,0.0,40.0
42972,4,2972,[265  22 357 333  97],343,3,11119,3.7399932727884293,20.0,0.0
42973,4,2973,[328 423 187 234 194],506,5,11124,3.7404169468728985,0.0,0.0
42974,4,2974,[196 191 258 597  69],275,1,11125,3.7394957983193278,0.0,0.0
42975,4,2975,[302 603 427 100  64],90,5,11130,3.7399193548387095,20.0,20.0
42976,4,2976,[161 276 215 168   1],42,3,11133,3.7396708095398052,0.0,0.0
42977,4,2977,[302 603 427 100  64],454,5,11138,3.740094022834117,20.0,20.0
42978,4,2978,[ 11 176 100   4 144],328,3,11141,3.739845585767036,0.0,20.0
42979,4,2979,[197  79 318 111 234],13,3,11144,3.7395973154362414,20.0,0.0
42980,4,2980,[302 603 427 100  64],13,5,11149,3.740020127474002,20.0,20.0
42981,4,2981,[302 603 427 100  64],370,5,11154,3.7404426559356136,20.0,20.0
42982,4,2982,[  9 313  79  89 301],334,4,11158,3.740529668119343,0.0,0.0
42983,4,2983,[ 98 185  70 286 313],271,4,11162,3.7406166219839143,0.0,20.0
42984,4,2984,[302 603 427 100 313],454,5,11167,3.741038525963149,20.0,20.0
42985,4,2985,[302 603 427 100 313],334,5,11172,3.7414601473543203,20.0,20.0
42986,4,2986,[186 435 204 118  89],650,5,11177,3.7418814864412453,0.0,0.0
42987,4,2987,[275 197 318   4 151],189,5,11182,3.7423025435073627,20.0,0.0
42988,4,2988,[211 234 483 603   7],234,3,11185,3.7420541987286717,40.0,0.0
42989,4,2989,[496 211  71 187  56],7,5,11190,3.74247491638796,0.0,0.0
42990,4,2990,[ 89 204 181 282  64],271,3,11193,3.7422266800401203,0.0,0.0
42991,4,2991,[302 603 427 100 313],383,4,11197,3.742312834224599,20.0,20.0
42992,4,2992,[181  71 176 153 127],374,4,11201,3.7423989308386236,0.0,20.0
42993,4,2993,[186 234 323 185 194],648,5,11206,3.7428189712758853,0.0,0.0
42994,4,2994,[427  15 265 121  50],650,3,11209,3.7425709515859764,0.0,20.0
42995,4,2995,[ 28 318  25 121 294],271,2,11211,3.7419893190921227,20.0,0.0
42996,4,2996,[ 12 195 175   9 197],543,4,11215,3.7420754087420756,20.0,0.0
42997,4,2997,[196  11 300 313 323],378,3,11218,3.741827885256838,0.0,0.0
42998,4,2998,[179 742  50 182   1],271,2,11220,3.741247082360787,0.0,20.0
42999,4,2999,[302 603 427 100  64],664,5,11225,3.7416666666666667,20.0,20.0
43000,4,3000,[302 603 427 100  64],13,5,11230,3.7420859713428856,20.0,20.0
43001,4,3001,[655  25  64 187 515],537,2,11232,3.741505662891406,0.0,0.0
43002,4,3002,[302 603 427 100  64],474,5,11237,3.741924741924742,20.0,20.0
43003,4,3003,[175 173 588 288 318],64,5,11242,3.7423435419440745,20.0,0.0
43004,4,3004,[496 403 257 172   8],385,1,11243,3.741430948419301,0.0,0.0
43005,4,3005,[161 403 286 318 172],479,2,11245,3.740851630073187,20.0,0.0
43006,4,3006,[302 603 427 100  64],666,5,11250,3.7412703691386766,20.0,20.0
43007,4,3007,[ 89 187  56 427  64],13,5,11255,3.741688829787234,0.0,0.0
43008,4,3008,[471  22 228 237 748],313,1,11256,3.740777666999003,0.0,0.0
43009,4,3009,[655 328  25  15 286],537,0,11256,3.73953488372093,0.0,0.0
43010,4,3010,[302 603 427 100  64],13,5,11261,3.7399535038193292,20.0,20.0
43011,4,3011,[302 603 427 100  64],666,5,11266,3.740371845949535,20.0,20.0
43012,4,3012,[300 496 135 100 475],605,3,11269,3.740126120146034,0.0,20.0
43013,4,3013,[  8 181 289  71 121],378,5,11274,3.740544127405441,0.0,0.0
43014,4,3014,[ 97  56  50 568 175],339,4,11278,3.7406301824212274,0.0,20.0
43015,4,3015,[ 56 257  96 117 153],840,1,11279,3.7397214854111405,0.0,0.0
43016,4,3016,[302 603 427 100  64],370,5,11284,3.7401392111368907,20.0,20.0
43017,4,3017,[180 216 143 168 210],666,2,11286,3.7395626242544733,0.0,0.0
43018,4,3018,[302 603 427 100  64],745,5,11291,3.739980125869493,20.0,20.0
43019,4,3019,[603   9  89  95 471],271,3,11294,3.7397350993377483,20.0,0.0
43020,4,3020,[302 603 427 100  64],271,5,11299,3.7401522674611054,20.0,20.0
43021,4,3021,[173 403 269 172  98],738,3,11302,3.739907346128392,0.0,20.0
43022,4,3022,[302 603 427 100  64],90,5,11307,3.7403241812768773,20.0,20.0
43023,4,3023,[ 11 257 132 194 385],308,4,11311,3.740410052910053,0.0,0.0
43024,4,3024,[194 187   4 210 127],653,3,11314,3.7401652892561983,0.0,20.0
43025,4,3025,[302 603 427 100  64],537,4,11318,3.740251156642432,20.0,20.0
43026,4,3026,[127 475 235   8 174],308,4,11322,3.740336967294351,0.0,40.0
43027,4,3027,[403  79 186 118 210],194,1,11323,3.739431968295905,0.0,0.0
43028,4,3028,[  4 288 568  56 185],537,2,11325,3.7388577088147903,0.0,0.0
43029,4,3029,[117 194 496  69  22],90,3,11328,3.738613861386139,0.0,0.0
43030,4,3030,[496  97  64 435 191],454,4,11332,3.7387000989772354,0.0,0.0
43031,4,3031,[200 153 211 127 179],308,5,11337,3.7391160949868074,0.0,20.0
43032,4,3032,[ 50 215 173 204 238],840,5,11342,3.739531816683152,0.0,20.0
43033,4,3033,[302 603 427 100  64],664,5,11347,3.7399472643375082,20.0,20.0
43034,4,3034,[211 127  22 423  15],311,4,11351,3.74003294892916,0.0,20.0
43035,4,3035,[302 603 427 100  64],454,5,11356,3.740447957839262,20.0,20.0
43036,4,3036,[496 161 276 258 323],200,4,11360,3.740533421139282,0.0,0.0
43037,4,3037,[187 300  64  82 655],234,2,11362,3.739960500329164,0.0,0.0
43038,4,3038,[302 603 427 100  64],339,5,11367,3.7403751233958538,20.0,20.0
43039,4,3039,[ 25 183  50 111 405],87,5,11372,3.7407894736842104,0.0,20.0
43040,4,3040,[302 603 427 100  64],666,5,11377,3.7412035514633346,20.0,20.0
43041,4,3041,[333  98 269 271 172],392,4,11381,3.7412886259040103,0.0,20.0
43042,4,3042,[302 603 427 100  64],454,5,11386,3.7417022674991784,20.0,20.0
43043,4,3043,[ 96 301 222 211 237],234,0,11386,3.740473061760841,0.0,0.0
43044,4,3044,[ 50 143 237  56  95],13,4,11390,3.7405582922824303,0.0,20.0
43045,4,3045,[302 603 427 100  64],454,5,11395,3.7409717662508206,20.0,20.0
43046,4,3046,[302 603 427 100  64],745,5,11400,3.7413849688217917,20.0,20.0
43047,4,3047,[151 180 265 405 181],666,1,11401,3.740485564304462,0.0,0.0
43048,4,3048,[258 185 286 179 313],13,2,11403,3.739914726139718,0.0,0.0
43049,4,3049,[197 121 187 210 183],650,2,11405,3.739344262295082,0.0,0.0
43050,4,3050,[286 186  82 173  11],334,4,11409,3.7394296951819075,0.0,0.0
43051,4,3051,[302 603 427 100  64],745,5,11414,3.739842726081258,20.0,20.0
43052,4,3052,[194 179 546 180 475],648,3,11417,3.7396003930560107,0.0,0.0
43053,4,3053,[357 121 174   1 323],648,4,11421,3.739685658153242,20.0,20.0
43054,4,3054,[405  89  71 238 302],334,3,11424,3.739443535188216,0.0,0.0
43055,4,3055,[603 301 655  69 471],666,4,11428,3.7395287958115184,20.0,0.0
43056,4,3056,[258 144 196 328 125],378,3,11431,3.7392868825646057,0.0,0.0
43057,4,3057,[302 603 427 100  64],339,5,11436,3.7396991497710923,20.0,20.0
43058,4,3058,[ 89   1  70 258 127],271,2,11438,3.739130434782609,0.0,20.0
43059,4,3059,[202 496 323 678  69],506,3,11441,3.738888888888889,0.0,0.0
43060,4,3060,[313 318 588  64 210],378,5,11446,3.739300882064685,20.0,0.0
43061,4,3061,[153  88  12 144  71],92,4,11450,3.7393860222077073,20.0,0.0
43062,4,3062,[216 204   4 568 172],326,2,11452,3.7388181521384265,0.0,0.0
43063,4,3063,[ 12  22 328   7 204],833,1,11453,3.737924281984334,20.0,0.0
43064,4,3064,[265 271 204  50 111],92,3,11456,3.7376835236541597,0.0,20.0
43065,4,3065,[597 182 258 289   1],533,2,11458,3.737116764514025,0.0,0.0
43066,4,3066,[215  11 286 172 174],234,0,11458,3.7358982719269647,0.0,20.0
43067,4,3067,[302 603 427 100  64],474,5,11463,3.736310299869622,20.0,20.0
43068,4,3068,[237 294 200 546 211],447,3,11466,3.7360703812316713,0.0,0.0
43069,4,3069,[211 180 121  96   1],843,0,11466,3.7348534201954395,0.0,0.0
43070,4,3070,[403 496 168 176  11],643,4,11470,3.7349397590361444,0.0,0.0
43071,4,3071,[302 603 427 100  64],458,5,11475,3.7353515625,20.0,20.0
43072,4,3072,[191  95  50 435 173],455,5,11480,3.735763097949886,0.0,20.0
43073,4,3073,[302 603 427 100  64],271,5,11485,3.736174365647365,20.0,20.0
43074,4,3074,[302 603 427 100  64],339,5,11490,3.7365853658536587,20.0,20.0
43075,4,3075,[302 603 427 100  64],339,5,11495,3.736996098829649,20.0,20.0
43076,4,3076,[257  50 196 568  98],92,3,11498,3.736756581085473,0.0,40.0
43077,4,3077,[302 603 427 100  64],339,5,11503,3.7371669915529564,20.0,20.0
43078,4,3078,[588  96 435 202 288],452,0,11503,3.735953231568691,0.0,0.0
43079,4,3079,[ 64 182 179 405 237],59,3,11506,3.7357142857142858,0.0,0.0
43080,4,3080,[ 69  22  71  50 175],749,4,11510,3.735800064913989,0.0,20.0
43081,4,3081,[313 196   8 237 275],454,3,11513,3.735561323815704,0.0,0.0
43082,4,3082,[  7 191 265 603  88],815,4,11517,3.735647096983458,20.0,0.0
43083,4,3083,[302 603 427 100  64],370,5,11522,3.7360570687418937,20.0,20.0
43084,4,3084,[ 82 117 403 568 216],892,3,11525,3.7358184764991895,0.0,0.0
43085,4,3085,[302 603 427 100  64],370,5,11530,3.7362281270252753,20.0,20.0
43086,4,3086,[175 100  12 322 132],92,3,11533,3.7359896339488174,20.0,20.0
43087,4,3087,[302 603 427 100  64],13,5,11538,3.73639896373057,20.0,20.0
43088,4,3088,[ 15 568  70  22 100],59,4,11542,3.7364842991259306,0.0,20.0
43089,4,3089,[302 603 427 100  64],90,5,11547,3.736893203883495,20.0,20.0
43090,4,3090,[403 191 423 313 202],533,4,11551,3.736978324166936,0.0,0.0
43091,4,3091,[210 357 275 423 748],13,2,11553,3.736416558861578,20.0,0.0
43092,4,3092,[174 597 423 234   9],13,3,11556,3.7361784675072744,0.0,20.0
43093,4,3093,[ 22 435 234 194 302],271,5,11561,3.7365869424692955,0.0,0.0
43094,4,3094,[302 603 427 100  64],454,5,11566,3.736995153473344,20.0,20.0
43095,4,3095,[302 603 427 100  64],13,5,11571,3.737403100775194,20.0,20.0
43096,4,3096,[ 50  56 183  64 181],804,4,11575,3.737487891507911,0.0,20.0
43097,4,3097,[742 135 222 185 100],881,5,11580,3.737895416397676,0.0,20.0
43098,4,3098,[655  98 508 357 202],207,4,11584,3.7379799935463054,20.0,20.0
43099,4,3099,[168 678 191 294  98],92,3,11587,3.737741935483871,0.0,20.0
43100,4,3100,[235  96 603  25 173],145,4,11591,3.7378265075782005,20.0,0.0
43101,4,3101,[179  82 180 197  12],234,1,11592,3.736943907156673,20.0,0.0
43102,4,3102,[302 603 427 100  64],666,5,11597,3.737350950692878,20.0,20.0
43103,4,3103,[302 603 427 100  64],664,5,11602,3.7377577319587627,20.0,20.0
43104,4,3104,[271 275 323 289 405],883,3,11605,3.737520128824477,0.0,0.0
43105,4,3105,[302 603 427 100  64],339,5,11610,3.737926593689633,20.0,20.0
43106,4,3106,[302 603 427 100  64],474,5,11615,3.738332796910203,20.0,20.0
43107,4,3107,[302 603 427 100  64],745,5,11620,3.7387387387387387,20.0,20.0
43108,4,3108,[302 603 427 100  64],474,5,11625,3.739144419427469,20.0,20.0
43109,4,3109,[215  79 168 121 204],643,3,11628,3.7389067524115758,0.0,0.0
43110,4,3110,[197 471 161  15 301],234,1,11629,3.7380263580842175,0.0,0.0
43111,4,3111,[318 515 423 183  89],194,2,11631,3.7374678663239074,20.0,0.0
43112,4,3112,[275 179 180  97 237],90,5,11636,3.737873433986508,0.0,0.0
43113,4,3113,[ 64 265 185 313   4],883,3,11639,3.7376364804110467,0.0,0.0
43114,4,3114,[179 191 161 211 435],207,5,11644,3.7380417335473517,0.0,0.0
43115,4,3115,[187  50 168 322 515],308,3,11647,3.7378048780487805,0.0,20.0
43116,4,3116,[302 603 427 100  64],13,5,11652,3.7382098171318576,20.0,20.0
43117,4,3117,[302 603 427 100  64],13,5,11657,3.7386144964720973,20.0,20.0
43118,4,3118,[423 176 323 385 258],788,3,11660,3.7383776851554984,0.0,0.0
43119,4,3119,[475 471 273 143  89],374,1,11661,3.7375,0.0,0.0
43120,4,3120,[117 471 210 405 202],648,4,11665,3.737584107657802,0.0,0.0
43121,4,3121,[302 603 427 100  64],339,5,11670,3.737988468930173,20.0,20.0
43122,4,3122,[748 234   4 182 568],102,0,11670,3.7367915465898176,0.0,0.0
43123,4,3123,[215 181   1 655 328],144,4,11674,3.736875800256082,0.0,0.0
43124,4,3124,[  9 216 435   4 318],883,5,11679,3.73728,20.0,0.0
43125,4,3125,[515 180 385 302   9],207,3,11682,3.7370441458733206,0.0,0.0
43126,4,3126,[121 655 234 174 118],738,3,11685,3.7368084425967383,0.0,20.0
43127,4,3127,[276 288 100 423  89],892,5,11690,3.7372122762148337,0.0,20.0
43128,4,3128,[222 127 515 100  28],328,4,11694,3.7372962607861937,0.0,40.0
43129,4,3129,[211   8 496  28 151],215,4,11698,3.737380191693291,0.0,0.0
43130,4,3130,[238 127 179 235 216],194,3,11701,3.7371446822101566,0.0,20.0
43131,4,3131,[180 328 182 179 323],90,2,11703,3.7365900383141764,0.0,0.0
43132,4,3132,[288 175 174  70 238],234,0,11703,3.7353973827002873,0.0,20.0
43133,4,3133,[302 603 427 100  64],90,5,11708,3.7358008934269304,20.0,20.0
43134,4,3134,[151 183 603 237 258],537,2,11710,3.7352472089314195,20.0,0.0
43135,4,3135,[215 135  88  25 405],378,3,11713,3.7350127551020407,0.0,0.0
43136,4,3136,[302 603 427 100  64],666,5,11718,3.735416002550207,20.0,20.0
43137,4,3137,[301 313  96 183  89],234,2,11720,3.7348629700446145,0.0,0.0
43138,4,3138,[ 22 183  96 546 257],378,4,11724,3.7349474354890093,0.0,0.0
43139,4,3139,[ 82   9 322 215 195],328,2,11726,3.7343949044585987,0.0,0.0
43140,4,3140,[302 603 427 100  64],474,5,11731,3.7347978350843682,20.0,20.0
43141,4,3141,[742 153 313 435 197],308,3,11734,3.7345639719923613,0.0,0.0
43142,4,3142,[328 202  56 176 275],499,4,11738,3.7346484250715877,0.0,0.0
43143,4,3143,[302 603 427 100  64],90,5,11743,3.7350508905852418,20.0,20.0
43144,4,3144,[302 603 427 100  64],537,4,11747,3.735135135135135,20.0,20.0
43145,4,3145,[186   1 173 294 258],537,3,11750,3.7349014621741894,0.0,0.0
43146,4,3146,[ 56  82 194  89 234],788,2,11752,3.734350174769622,0.0,0.0
43147,4,3147,[234  98 603 215 197],308,1,11753,3.733481575603558,20.0,20.0
43148,4,3148,[302 603 427 100  64],454,5,11758,3.7338837726262306,20.0,20.0
43149,4,3149,[302 603 427 100  64],271,5,11763,3.7342857142857144,20.0,20.0
43150,4,3150,[204 496 197 135 238],666,4,11767,3.734370041256744,0.0,0.0
43151,4,3151,[191 234   7 588 216],194,2,11769,3.7338197969543145,0.0,0.0
43152,4,3152,[ 98 204 385 182 286],207,1,11770,3.732952743418966,0.0,20.0
43153,4,3153,[302 603 427 100  64],271,5,11775,3.7333544705136337,20.0,20.0
43154,4,3154,[289  15  11 173 222],537,1,11776,3.732488114104596,0.0,0.0
43155,4,3155,[403  89 175 318 427],13,3,11779,3.732256020278834,20.0,0.0
43156,4,3156,[302 603 427 100  64],13,5,11784,3.732657586316123,20.0,20.0
43157,4,3157,[ 88   7 187 180 322],881,4,11788,3.732742241925269,0.0,0.0
43158,4,3158,[215 385 597 181  28],643,1,11789,3.7318771763216207,0.0,0.0
43159,4,3159,[ 71 191 186 222 216],882,5,11794,3.732278481012658,0.0,0.0
43160,4,3160,[302 603 427 100  64],458,5,11799,3.7326795317937362,20.0,20.0
43161,4,3161,[302 603 427 100  64],90,5,11804,3.7330803289057557,20.0,20.0
43162,4,3162,[234  22 294 678 405],648,3,11807,3.732848561492254,0.0,0.0
43163,4,3163,[302 603 427 100  64],458,5,11812,3.7332490518331225,20.0,20.0
43164,4,3164,[210 196 215 300 135],488,4,11816,3.7333333333333334,0.0,0.0
43165,4,3165,[202 235 161 597   1],308,2,11818,3.7327858496525583,0.0,0.0
43166,4,3166,[ 56 508  96 204  71],92,5,11823,3.7331859804231136,0.0,0.0
43167,4,3167,[302 603 427 100  64],666,5,11828,3.7335858585858586,20.0,20.0
43168,4,3168,[135  69  98 173 357],7,5,11833,3.7339854843799305,20.0,20.0
43169,4,3169,[282 318 286 191  88],318,4,11837,3.734069400630915,20.0,0.0
43170,4,3170,[302 603 427 100  64],13,5,11842,3.7344686218858403,20.0,20.0
43171,4,3171,[546 183 318 568 200],313,4,11846,3.7345523329129886,20.0,0.0
43172,4,3172,[302 603 427 100  64],664,5,11851,3.734951150330917,20.0,20.0
43173,4,3173,[302 603 427 100  64],664,5,11856,3.735349716446125,20.0,20.0
43174,4,3174,[302 603 427 100  64],90,5,11861,3.735748031496063,20.0,20.0
43175,4,3175,[282 313 276 176 258],455,3,11864,3.7355163727959697,0.0,0.0
43176,4,3176,[  9  50 185 210 144],815,3,11867,3.7352848599307524,0.0,20.0
43177,4,3177,[318 405 125 179 435],59,3,11870,3.7350534927627437,20.0,0.0
43178,4,3178,[302 603 427 100  64],454,5,11875,3.7354513998112613,20.0,20.0
43179,4,3179,[187 471 135  79 118],308,3,11878,3.7352201257861637,0.0,0.0
43180,4,3180,[237 238  98 234 151],234,2,11880,3.734674630619302,0.0,20.0
43181,4,3181,[ 50 183 288 265  28],804,4,11884,3.7347580138277814,0.0,20.0
43182,4,3182,[176 603 186 161   4],7,3,11887,3.734527175620484,20.0,0.0
43183,4,3183,[196 143 151   7 275],334,4,11891,3.734610552763819,0.0,0.0
43184,4,3184,[496 180 187 357  28],892,5,11896,3.7350078492935634,20.0,0.0
43185,4,3185,[302 603 427 100  64],745,5,11901,3.7354048964218456,20.0,20.0
43186,4,3186,[385  98 234 427 118],374,4,11905,3.735487919673674,0.0,20.0
43187,4,3187,[423 211 237   8 151],95,3,11908,3.7352572145545797,0.0,0.0
43188,4,3188,[216 172 294 100 211],279,2,11910,3.7347130761994354,0.0,20.0
43189,4,3189,[302 603 427 100  64],666,5,11915,3.7351097178683386,20.0,20.0
43190,4,3190,[ 82 111 678 121 289],13,2,11917,3.7345659667815734,0.0,0.0
43191,4,3191,[302 603 427 100  64],13,5,11922,3.7349624060150375,20.0,20.0
43192,4,3192,[174 135 186  82  56],840,4,11926,3.7350454118383967,0.0,20.0
43193,4,3193,[302 603 427 100  64],664,5,11931,3.7354414527238573,20.0,20.0
43194,4,3194,[302 603 427 100  64],664,5,11936,3.7358372456964006,20.0,20.0
43195,4,3195,[180 427  89 235 153],385,5,11941,3.736232790988736,0.0,0.0
43196,4,3196,[175 204 258 238 187],474,5,11946,3.7366280888332812,0.0,0.0
43197,4,3197,[678 187 168 300 172],537,2,11948,3.7360850531582237,0.0,0.0
43198,4,3198,[174  79 357  64 117],263,4,11952,3.7361675523601123,20.0,20.0
43199,4,3199,[289   4 144 228 265],92,4,11956,3.73625,0.0,0.0
43200,4,3200,[483 405 496  12   4],537,2,11958,3.7357075913776945,40.0,0.0
43201,4,3201,[302 603 427 100  64],454,5,11963,3.736102435977514,20.0,20.0
43202,4,3202,[318 268 269 483 186],232,4,11967,3.7361848267249456,40.0,0.0
43203,4,3203,[180 172 238 197 496],474,5,11972,3.7365792759051186,0.0,0.0
43204,4,3204,[187  98 196 271  22],537,1,11973,3.735725429017161,0.0,20.0
43205,4,3205,[546 435  98 228 183],295,4,11977,3.7358078602620086,0.0,20.0
43206,4,3206,[302 603 427 100  64],13,5,11982,3.736202057998129,20.0,20.0
43207,4,3207,[302 603 427 100  64],745,5,11987,3.736596009975062,20.0,20.0
43208,4,3208,[144  79 742  97 318],458,4,11991,3.7366780928638206,20.0,0.0
43209,4,3209,[302 603 427 100  64],458,5,11996,3.737071651090343,20.0,20.0
43210,4,3210,[289 121 204 127  64],13,4,12000,3.737153534724385,0.0,20.0
43211,4,3211,[405 182 385  15 318],474,5,12005,3.737546699875467,20.0,0.0
43212,4,3212,[289 195  22 174   7],13,2,12007,3.737005913476502,0.0,20.0
43213,4,3213,[125   1 174 185 175],313,4,12011,3.737087741132545,0.0,20.0
43214,4,3214,[ 71  15 194 200 173],378,4,12015,3.7371695178849142,0.0,0.0
43215,4,3215,[  1 288  96 187  98],650,2,12017,3.736629353233831,0.0,20.0
43216,4,3216,[385 357  89   9 515],488,5,12022,3.7370220702517876,20.0,0.0
43217,4,3217,[176  12 191 603 181],527,4,12026,3.7371037911746425,40.0,0.0
43218,4,3218,[ 89 182   8 175 183],308,5,12031,3.7374961168064615,0.0,0.0
43219,4,3219,[195  82 174  22 435],263,5,12036,3.737888198757764,0.0,20.0
43220,4,3220,[302 603 427 100  64],458,5,12041,3.7382800372555107,20.0,20.0
43221,4,3221,[302 603 427 100  64],664,5,12046,3.738671632526381,20.0,20.0
43222,4,3222,[ 89 357 132 202  25],95,2,12048,3.738132174992243,20.0,0.0
43223,4,3223,[313 655 435 237 186],13,5,12053,3.7385235732009927,0.0,0.0
43224,4,3224,[191 187 265 111 168],648,4,12057,3.738604651162791,0.0,0.0
43225,4,3225,[181  95 151 172 197],848,5,12062,3.738995660260384,0.0,0.0
43226,4,3226,[276 271 515 174 742],334,3,12065,3.7387666563371553,0.0,20.0
43227,4,3227,[182 357 125 238  50],406,3,12068,3.738537794299876,20.0,20.0
43228,4,3228,[568 265 333 210   7],537,1,12069,3.7376896872096625,0.0,0.0
43229,4,3229,[302 603 427 100  64],370,5,12074,3.738080495356037,20.0,20.0
43230,4,3230,[405 496  89  96 111],479,4,12078,3.7381615598885793,0.0,0.0
43231,4,3231,[172 195 132  82 385],308,4,12082,3.7382425742574257,0.0,0.0
43232,4,3232,[258 496 117  71   1],275,1,12083,3.737395607794618,0.0,0.0
43233,4,3233,[222 210 301 172  28],279,2,12085,3.7368583797155224,0.0,0.0
43234,4,3234,[302 603 427 100  64],370,5,12090,3.7372488408037094,20.0,20.0
43235,4,3235,[483 302  25  64 515],458,4,12094,3.737330037082818,20.0,0.0
43236,4,3236,[202 200 234 405 181],804,4,12098,3.7374111831943155,0.0,0.0
43237,4,3237,[161 143  98 196 222],454,2,12100,3.736874613959234,0.0,20.0
43238,4,3238,[  8 100 204 200  22],774,0,12100,3.7357209015128126,0.0,20.0
43239,4,3239,[748 185  11 301 276],13,2,12102,3.7351851851851854,0.0,0.0
43240,4,3240,[ 28 216 333 200 153],666,2,12104,3.734649799444616,0.0,0.0
43241,4,3241,[ 11 237 427  95  97],406,4,12108,3.7347316471314005,0.0,0.0
43242,4,3242,[100 405 168 357 435],385,2,12110,3.734196731421523,20.0,20.0
43243,4,3243,[302 603 427 100  64],664,5,12115,3.7345869297163996,20.0,20.0
43244,4,3244,[153  88 181 161  82],454,3,12118,3.7343605546995375,0.0,0.0
43245,4,3245,[174 204 238 153 182],308,5,12123,3.734750462107209,0.0,20.0
43246,4,3246,[197 216 318   7  70],234,2,12125,3.7342161995688326,20.0,0.0
43247,4,3247,[273 301 176 197 258],537,2,12127,3.7336822660098523,0.0,0.0
43248,4,3248,[ 22 275 289  70  50],537,3,12130,3.7334564481378885,0.0,20.0
43249,4,3249,[216  12  88 483 153],234,1,12131,3.7326153846153844,40.0,0.0
43250,4,3250,[568 117  98  64 515],343,3,12134,3.7323900338357427,0.0,20.0
43251,4,3251,[302 603 427 100  64],458,5,12139,3.7327798277982778,20.0,20.0
43252,4,3252,[302 603 427 100  64],664,5,12144,3.7331693821088225,20.0,20.0
43253,4,3253,[ 22  64 269 183 471],378,4,12148,3.7332513829133376,0.0,0.0
43254,4,3254,[237 471  15  88 100],374,3,12151,3.733026113671275,0.0,20.0
43255,4,3255,[176 546 118  56 742],804,3,12154,3.732800982800983,0.0,0.0
43256,4,3256,[186 175 135 322 204],409,4,12158,3.7328830211851396,0.0,0.0
43257,4,3257,[211 179 172 403 238],833,1,12159,3.7320441988950277,0.0,0.0
43258,4,3258,[215 403  70 183   7],60,4,12163,3.7321264191469776,0.0,0.0
43259,4,3259,[302 603 427 100  64],370,5,12168,3.732515337423313,20.0,20.0
43260,4,3260,[269  12 276 475 603],14,4,12172,3.7325973627721556,40.0,0.0
43261,4,3261,[176 111 121 143  88],643,4,12176,3.7326793378295524,0.0,0.0
43262,4,3262,[302 603 427 100  64],458,5,12181,3.733067729083665,20.0,20.0
43263,4,3263,[181 195   7  69 273],458,3,12184,3.732843137254902,0.0,0.0
43264,4,3264,[222 235 168 423  12],374,2,12186,3.732312404287902,20.0,0.0
43265,4,3265,[ 98 153 173 151 194],378,4,12190,3.732394366197183,0.0,20.0
43266,4,3266,[302 603 427 100  64],370,5,12195,3.7327823691460056,20.0,20.0
43267,4,3267,[302 603 427 100  64],666,5,12200,3.733170134638923,20.0,20.0
43268,4,3268,[748 151 182 423 269],524,3,12203,3.7329458550015295,0.0,0.0
43269,4,3269,[196 180  82 403 186],774,1,12204,3.7321100917431194,0.0,0.0
43270,4,3270,[238 496 427 153  79],650,4,12208,3.732191990217059,0.0,0.0
43271,4,3271,[322  97  88 143 161],346,2,12210,3.7316625916870416,0.0,0.0
43272,4,3272,[302 603 427 100  64],664,5,12215,3.732050106935533,20.0,20.0
43273,4,3273,[216 748 132 117   9],328,3,12218,3.7318265119120344,0.0,0.0
43274,4,3274,[302 603 427 100  64],745,5,12223,3.732213740458015,20.0,20.0
43275,4,3275,[483 405 179 117  88],194,2,12225,3.7316849816849818,20.0,0.0
43276,4,3276,[302 603 427 100  64],458,5,12230,3.7320720170888007,20.0,20.0
43277,4,3277,[183 423 185 568 194],64,5,12235,3.732458816351434,0.0,0.0
43278,4,3278,[196 132 748  11 568],13,3,12238,3.732235437633425,0.0,0.0
43279,4,3279,[302 603 427 100  64],370,5,12243,3.732621951219512,20.0,20.0
43280,4,3280,[181  79   4 200 286],455,4,12247,3.7327034440719293,0.0,0.0
43281,4,3281,[185   7 151 172 161],804,4,12251,3.7327848872638634,0.0,0.0
43282,4,3282,[127 200  50 216 483],59,5,12256,3.7331708802924153,20.0,40.0
43283,4,3283,[288 234 143 276  50],339,4,12260,3.733252131546894,0.0,20.0
43284,4,3284,[258  95 210 235  50],125,4,12264,3.7333333333333334,0.0,20.0
43285,4,3285,[385 268  11  69  12],7,3,12267,3.733110164333536,20.0,0.0
43286,4,3286,[200 185 313 182   7],59,5,12272,3.7334955886826893,0.0,0.0
43287,4,3287,[302 603 427 100  64],271,5,12277,3.7338807785888077,20.0,20.0
43288,4,3288,[302 603 427 100  64],13,5,12282,3.734265734265734,20.0,20.0
43289,4,3289,[302 603 427 100  64],339,5,12287,3.7346504559270515,20.0,20.0
43290,4,3290,[ 56 215 588  12 234],144,5,12292,3.7350349437860833,20.0,0.0
43291,4,3291,[302 603 427 100  64],90,5,12297,3.7354191980558933,20.0,20.0
43292,4,3292,[302 603 427 100  64],370,5,12302,3.7358032189492865,20.0,20.0
43293,4,3293,[181 265  56  22 187],161,0,12302,3.734669095324833,0.0,0.0
43294,4,3294,[318 175 200 313 328],653,4,12306,3.7347496206373294,20.0,0.0
43295,4,3295,[302 603 427 100  64],537,4,12310,3.7348300970873787,20.0,20.0
43296,4,3296,[ 95  79 423 111 168],648,4,12314,3.734910524719442,0.0,0.0
43297,4,3297,[ 69  70 173 269 196],334,2,12316,3.7343844754396605,0.0,0.0
43298,4,3298,[302 603 427 100  64],474,5,12321,3.7347681115489544,20.0,20.0
43299,4,3299,[117  25 655 238 234],339,4,12325,3.734848484848485,0.0,0.0
43300,4,3300,[ 88  50  56 174 515],60,5,12330,3.735231747955165,0.0,40.0
43301,4,3301,[302 603 427 100  64],271,5,12335,3.7356147789218657,20.0,20.0
43302,4,3302,[302 603 427 100  64],664,5,12340,3.7359975779594308,20.0,20.0
43303,4,3303,[  4 153  95  97  98],64,2,12342,3.7354721549636802,0.0,20.0
43304,4,3304,[288 151 258 403 161],234,0,12342,3.734341906202723,0.0,0.0
43305,4,3305,[ 89 568 100  25 127],650,2,12344,3.733817301875378,0.0,40.0
43306,4,3306,[173 288 187  71 483],13,3,12347,3.733595403689144,20.0,0.0
43307,4,3307,[603 179  97 200 515],474,4,12351,3.733675937122128,20.0,0.0
43308,4,3308,[  8 100 173 172  79],455,5,12356,3.734058627984285,0.0,20.0
43309,4,3309,[588 515 183  64 234],326,3,12359,3.7338368580060424,0.0,0.0
43310,4,3310,[111 403 175 357 161],13,3,12362,3.733615221987315,20.0,0.0
43311,4,3311,[ 25 121 405 475 333],548,4,12366,3.733695652173913,0.0,0.0
43312,4,3312,[302 603 427 100  64],458,5,12371,3.7340778750377304,20.0,20.0
43313,4,3313,[603 403 185  15 196],59,5,12376,3.7344598672299334,20.0,0.0
43314,4,3314,[176 179 132  97 269],339,5,12381,3.734841628959276,0.0,0.0
43315,4,3315,[ 70 282 144 174 197],378,4,12385,3.7349215922798553,0.0,20.0
43316,4,3316,[ 79 174  69   1  25],213,3,12388,3.734700030147724,0.0,20.0
43317,4,3317,[202 496  56  22 161],311,5,12393,3.7350813743218807,0.0,0.0
43318,4,3318,[143 273 546 125 186],7,3,12396,3.734859897559506,0.0,0.0
43319,4,3319,[ 98 257  95 173 180],650,2,12398,3.7343373493975904,0.0,20.0
43320,4,3320,[153 237 515 144 202],326,4,12402,3.734417344173442,0.0,0.0
43321,4,3321,[210 143 172 191 211],308,5,12407,3.734798314268513,0.0,0.0
43322,4,3322,[234 176  12 515 273],548,5,12412,3.735179055070719,20.0,0.0
43323,4,3323,[302 603 427 100  64],664,5,12417,3.7355595667870034,20.0,20.0
43324,4,3324,[302 603 427 100  64],664,5,12422,3.73593984962406,20.0,20.0
43325,4,3325,[265 234   1 153 301],13,3,12425,3.7357185808779314,0.0,0.0
43326,4,3326,[302 603 427 100  64],664,5,12430,3.7360985873159,20.0,20.0
43327,4,3327,[174 173 435 300 185],102,1,12431,3.7352764423076925,0.0,20.0
43328,4,3328,[197 515  15 289 200],95,3,12434,3.735055572243917,0.0,0.0
43329,4,3329,[302 603 427 100  64],458,5,12439,3.7354354354354355,20.0,20.0
43330,4,3330,[186   1 117  64 234],406,4,12443,3.7355148604022816,0.0,0.0
43331,4,3331,[302 603 427 100  64],271,5,12448,3.7358943577430974,20.0,20.0
43332,4,3332,[302 603 427 100  64],474,5,12453,3.736273627362736,20.0,20.0
43333,4,3333,[ 71  97 176 173 496],664,4,12457,3.7363527294541092,0.0,0.0
43334,4,3334,[302 603 427 100  64],537,4,12461,3.736431784107946,20.0,20.0
43335,4,3335,[153 183 405 132 191],385,2,12463,3.7359112709832134,0.0,0.0
43336,4,3336,[135  22 153  64 118],738,3,12466,3.7356907401857957,0.0,0.0
43337,4,3337,[151   4 328 144  15],378,2,12468,3.7351707609346914,0.0,0.0
43338,4,3338,[302 603 427 100  64],745,5,12473,3.735549565738245,20.0,20.0
43339,4,3339,[195 168 215 271 202],13,3,12476,3.735329341317365,0.0,0.0
43340,4,3340,[121  82  70 211  97],308,3,12479,3.735109248727926,0.0,0.0
43341,4,3341,[153 132  70 427 191],7,4,12483,3.7351885098743267,0.0,0.0
43342,4,3342,[144 328 204 194 187],207,2,12485,3.7346694585701465,0.0,0.0
43343,4,3343,[228 179 127 333 403],343,4,12489,3.734748803827751,0.0,20.0
43344,4,3344,[276  50 202  28  89],538,3,12492,3.734529147982063,0.0,20.0
43345,4,3345,[194 222  50  98 546],653,1,12493,3.733711894799761,0.0,40.0
43346,4,3346,[302 603 427 100  64],474,5,12498,3.734090230056767,20.0,20.0
43347,4,3347,[ 96 175 403 385   4],774,0,12498,3.7329749103942653,0.0,0.0
43348,4,3348,[302 603 427 100  64],458,5,12503,3.7333532397730664,20.0,20.0
43349,4,3349,[357 153 118 318 179],543,2,12505,3.7328358208955223,40.0,0.0
43350,4,3350,[ 64 471 322 294 300],234,1,12506,3.7320202924500148,0.0,0.0
43351,4,3351,[302 603 427 100  64],13,5,12511,3.732398568019093,20.0,20.0
43352,4,3352,[191 234 204 257 301],279,2,12513,3.731881896808828,0.0,0.0
43353,4,3353,[302 603 427 100  64],13,5,12518,3.7322599880739418,20.0,20.0
43354,4,3354,[302 603 427 100  64],666,5,12523,3.7326378539493295,20.0,20.0
43355,4,3355,[ 88 603 161 427 222],474,5,12528,3.733015494636472,20.0,0.0
43356,4,3356,[427 135 174 183  64],194,3,12531,3.732797140303843,0.0,20.0
43357,4,3357,[195 286 111 200  70],653,3,12534,3.7325789160214415,0.0,0.0
43358,4,3358,[302 603 427 100  64],474,5,12539,3.73295623697529,20.0,20.0
43359,4,3359,[185 194  12  95 423],60,5,12544,3.7333333333333334,20.0,0.0
43360,4,3360,[176  15  98 211 118],694,5,12549,3.7337102052960427,0.0,20.0
43361,4,3361,[186 196 403 175  15],650,3,12552,3.733491969066032,0.0,0.0
43362,4,3362,[515 258 276 173 357],339,4,12556,3.7335712161760335,20.0,0.0
43363,4,3363,[302 603 427 100  64],474,5,12561,3.733947681331748,20.0,20.0
43364,4,3364,[435  98 515 496  50],339,5,12566,3.734323922734027,0.0,40.0
43365,4,3365,[121  64 742 202 318],653,3,12569,3.7341057635175283,20.0,0.0
43366,4,3366,[117 204 265 294 322],308,1,12570,3.7332937332937335,0.0,0.0
43367,4,3367,[302 603 427 100  64],454,5,12575,3.7336698337292162,20.0,20.0
43368,4,3368,[357 180 435 235 117],339,3,12578,3.7334520629266845,20.0,0.0
43369,4,3369,[302 603 427 100  64],339,5,12583,3.733827893175074,20.0,20.0
43370,4,3370,[302 603 427 100  64],271,5,12588,3.7342035004449716,20.0,20.0
43371,4,3371,[302 603 427 100  64],271,5,12593,3.734578884934757,20.0,20.0
43372,4,3372,[  7 302 127   4  11],537,3,12596,3.7343611028757784,0.0,20.0
43373,4,3373,[302 603 427 100  64],458,5,12601,3.734736218138708,20.0,20.0
43374,4,3374,[302 603 427 100  64],271,5,12606,3.7351111111111113,20.0,20.0
43375,4,3375,[222 235 597 204 546],92,2,12608,3.734597156398104,0.0,0.0
43376,4,3376,[197 216 357  64 181],537,2,12610,3.7340835060704767,20.0,0.0
43377,4,3377,[302 603 427 100  64],666,5,12615,3.7344582593250446,20.0,20.0
43378,4,3378,[211 204 196 210 286],934,5,12620,3.734832790766499,0.0,0.0
43379,4,3379,[151 265   9 117  12],334,3,12623,3.7346153846153847,20.0,0.0
43380,4,3380,[302 603 427 100  64],370,5,12628,3.7349896480331264,20.0,20.0
43381,4,3381,[302 603 427 100  64],339,5,12633,3.7353636901241867,20.0,20.0
43382,4,3382,[655 100 237 282 222],378,4,12637,3.735441915459651,0.0,20.0
43383,4,3383,[176 322 121 173 273],749,4,12641,3.7355200945626477,0.0,0.0
43384,4,3384,[302 603 427 100  64],666,5,12646,3.7358936484490397,20.0,20.0
43385,4,3385,[ 88 185 127 172 176],313,4,12650,3.7359716479621974,0.0,20.0
43386,4,3386,[302 603 427 100  64],458,5,12655,3.7363448479480366,20.0,20.0
43387,4,3387,[302 603 427 100  64],13,5,12660,3.7367178276269186,20.0,20.0
43388,4,3388,[222 121 161  95 678],454,2,12662,3.7362053703157274,0.0,0.0
43389,4,3389,[302 603 427 100  64],90,5,12667,3.7365781710914456,20.0,20.0
43390,4,3390,[302 603 427 100  64],13,5,12672,3.7369507519905634,20.0,20.0
43391,4,3391,[471  97 508  96 175],378,4,12676,3.7370283018867925,0.0,0.0
43392,4,3392,[  9  96 200 191  89],474,4,12680,3.737105806071323,0.0,0.0
43393,4,3393,[135  88 174 742  56],313,2,12682,3.7365939893930467,0.0,20.0
43394,4,3394,[ 50  11 132 423 173],892,4,12686,3.7366715758468336,0.0,20.0
43395,4,3395,[302 603 427 100  64],90,5,12691,3.7370435806831566,20.0,20.0
43396,4,3396,[211  11 185 471 294],308,3,12694,3.73682661171622,0.0,0.0
43397,4,3397,[ 71   4 216 496 403],738,2,12696,3.7363154796939377,0.0,0.0
43398,4,3398,[471   9 286 322 276],699,0,12696,3.735216240070609,0.0,0.0
43399,4,3399,[483 183  97 144 546],194,2,12698,3.7347058823529413,20.0,0.0
43400,4,3400,[405 210 234  69 168],85,3,12701,3.734489855924728,0.0,0.0
43401,4,3401,[186 568 151 496 748],64,3,12704,3.7342739564961787,0.0,0.0
43402,4,3402,[475 100 173  69 172],64,5,12709,3.7346459006758743,0.0,20.0
43403,4,3403,[302 603 427 100  64],745,5,12714,3.7350176263219743,20.0,20.0
43404,4,3404,[200 215  11 161 275],13,2,12716,3.7345080763582965,0.0,0.0
43405,4,3405,[271  89 183 258 238],650,3,12719,3.7342924251321197,0.0,0.0
43406,4,3406,[302 603 427 100  64],339,5,12724,3.734663927208688,20.0,20.0
43407,4,3407,[ 28  98 153 127  96],883,3,12727,3.7344483568075115,0.0,40.0
43408,4,3408,[302 603 427 100  64],13,5,12732,3.734819595189205,20.0,20.0
43409,4,3409,[302 603 427 100  64],339,5,12737,3.7351906158357773,20.0,20.0
43410,4,3410,[144  79 405 153 143],378,4,12741,3.7352682497801233,0.0,0.0
43411,4,3411,[302 603 427 100  64],339,5,12746,3.7356389214536927,20.0,20.0
43412,4,3412,[153  50 183  98 196],95,5,12751,3.7360093759156165,0.0,40.0
43413,4,3413,[196 238  96 568 194],379,5,12756,3.736379613356766,0.0,0.0
43414,4,3414,[302 603 427 100  64],664,5,12761,3.736749633967789,20.0,20.0
43415,4,3415,[172 187 403  11 204],7,4,12765,3.7368266978922717,0.0,0.0
43416,4,3416,[302 603 427 100  64],339,5,12770,3.737196371085748,20.0,20.0
43417,4,3417,[302 603 427 100  64],474,5,12775,3.737565827969573,20.0,20.0
43418,4,3418,[302 603 427 100  64],13,5,12780,3.737935068733548,20.0,20.0
43419,4,3419,[265  88 302  96 403],883,4,12784,3.7380116959064327,0.0,0.0
43420,4,3420,[257  64 222  56 515],883,4,12788,3.738088278281204,0.0,0.0
43421,4,3421,[ 69   8 182  50 405],213,2,12790,3.737580362361192,0.0,20.0
43422,4,3422,[ 28 405 180 176 300],447,4,12794,3.7376570260005844,0.0,0.0
43423,4,3423,[100 403  70  28 318],883,3,12797,3.7374415887850465,20.0,20.0
43424,4,3424,[ 64 111 273 216 275],537,1,12798,3.7366423357664234,0.0,0.0
43425,4,3425,[302 603 427 100  64],271,5,12803,3.7370110916520725,20.0,20.0
43426,4,3426,[ 50 194 423 187 234],749,4,12807,3.7370878319229646,0.0,20.0
43427,4,3427,[302 603 427 100  64],271,5,12812,3.737456242707118,20.0,20.0
43428,4,3428,[318 323 153   8  11],454,2,12814,3.73694954797317,20.0,0.0
43429,4,3429,[211 508 483 597 228],13,3,12817,3.736734693877551,20.0,0.0
43430,4,3430,[191  22 323 508 194],13,2,12819,3.7362285048090937,0.0,0.0
43431,4,3431,[302 603 427 100  64],13,5,12824,3.7365967365967365,20.0,20.0
43432,4,3432,[ 28 196 127 185 435],7,5,12829,3.736964753859598,0.0,20.0
43433,4,3433,[ 71 215  12 228 186],13,5,12834,3.7373325567850904,20.0,0.0
43434,4,3434,[302 603 427 100  64],474,5,12839,3.7377001455604075,20.0,20.0
43435,4,3435,[597 127  22 187 161],308,3,12842,3.737485448195576,0.0,20.0
43436,4,3436,[302 603 427 100  64],90,5,12847,3.7378527785859763,20.0,20.0
43437,4,3437,[127 195 496  97 121],406,5,12852,3.738219895287958,0.0,20.0
43438,4,3438,[135 508 179   7 185],60,5,12857,3.7385867984879324,0.0,0.0
43439,4,3439,[265  97 475 180 197],537,3,12860,3.738372093023256,0.0,0.0
43440,4,3440,[ 22 151 269  79 143],7,3,12863,3.738157512351061,0.0,0.0
43441,4,3441,[127 568  56 117 234],648,2,12865,3.7376525276002326,0.0,20.0
43442,4,3442,[ 79 300 515 172 202],7,3,12868,3.737438280569271,0.0,0.0
43443,4,3443,[302 603 427 100  64],458,5,12873,3.7378048780487805,20.0,20.0
43444,4,3444,[302 603 427 100  64],745,5,12878,3.7381712626995647,20.0,20.0
43445,4,3445,[568 546 143 265  11],308,3,12881,3.737957051654092,0.0,0.0
43446,4,3446,[302 603 427 100  64],666,5,12886,3.7383231795764433,20.0,20.0
43447,4,3447,[302 603 427 100  64],339,5,12891,3.73868909512761,20.0,20.0
43448,4,3448,[173   8 748 176 197],899,4,12895,3.7387648593795304,0.0,0.0
43449,4,3449,[127 191  56 174 471],207,4,12899,3.738840579710145,0.0,40.0
43450,4,3450,[302 603 427 100  64],537,4,12903,3.7389162561576357,20.0,20.0
43451,4,3451,[302 603 427 100  64],745,5,12908,3.7392815758980302,20.0,20.0
43452,4,3452,[100 282  97   8 181],458,2,12910,3.738777874312192,0.0,20.0
43453,4,3453,[127 183 294  96 182],479,4,12914,3.738853503184713,0.0,20.0
43454,4,3454,[475 238 211  69  70],6,3,12917,3.7386396526772794,0.0,0.0
43455,4,3455,[273 483 282 127 269],294,3,12920,3.738425925925926,20.0,20.0
43456,4,3456,[302 603 427 100  64],474,5,12925,3.7387908591264103,20.0,20.0
43457,4,3457,[245 215 117 182  15],533,3,12928,3.738577212261423,0.0,0.0
43458,4,3458,[328 215 385 748 357],533,3,12931,3.7383636889274356,20.0,0.0
43459,4,3459,[ 71 235  50  96 174],524,3,12934,3.7381502890173413,0.0,40.0
43460,4,3460,[288 202 117  56 183],650,2,12936,3.737648078590003,0.0,0.0
43461,4,3461,[202 211  98 328 195],653,2,12938,3.7371461582900056,0.0,20.0
43462,4,3462,[302 603 427 100  50],334,5,12943,3.73751082876119,20.0,40.0
43463,4,3463,[215 471 286   9 546],648,2,12945,3.737009237875289,0.0,0.0
43464,4,3464,[302 603 427 100  50],537,5,12950,3.7373737373737375,20.0,40.0
43465,4,3465,[179 245 300 427 121],334,2,12952,3.736872475476053,0.0,0.0
43466,4,3466,[302 603 427 100  50],745,4,12956,3.7369483703490047,20.0,40.0
43467,4,3467,[182 180  25 742 546],533,2,12958,3.7364475201845444,0.0,0.0
43468,4,3468,[300 151 235 210 216],378,4,12962,3.7365234938022485,0.0,0.0
43469,4,3469,[302 603 427 100  64],664,5,12967,3.736887608069164,20.0,20.0
43470,4,3470,[173  98  89 100 175],524,3,12970,3.7366753097090175,0.0,40.0
43471,4,3471,[172 127 302 300 100],144,3,12973,3.736463133640553,0.0,40.0
43472,4,3472,[121 200 322 186 111],13,3,12976,3.736251079758134,0.0,0.0
43473,4,3473,[187 132  11  69  12],90,4,12980,3.7363270005757054,20.0,0.0
43474,4,3474,[ 88  97 288 182   9],339,4,12984,3.7364028776978415,0.0,0.0
43475,4,3475,[ 28 185 289 678 405],82,0,12984,3.7353279631760645,0.0,0.0
43476,4,3476,[318 515 125 435   8],207,4,12988,3.735404083980443,20.0,0.0
43477,4,3477,[357 100 286 289  64],194,3,12991,3.7351926394479587,20.0,20.0
43478,4,3478,[302 603 427 100  64],370,5,12996,3.7355561943087094,20.0,20.0
43479,4,3479,[302 603 427 100  64],339,5,13001,3.7359195402298853,20.0,20.0
43480,4,3480,[302 603 427 100  64],13,5,13006,3.736282677391554,20.0,20.0
43481,4,3481,[196  56  82 471  25],83,2,13008,3.735784032165422,0.0,0.0
43482,4,3482,[302 603 427 100  64],474,5,13013,3.7361469997128913,20.0,20.0
43483,4,3483,[302 603 427 100  64],454,5,13018,3.7365097588978187,20.0,20.0
43484,4,3484,[302 603 427 100  64],90,5,13023,3.7368723098995695,20.0,20.0
43485,4,3485,[435 258 179  25 275],537,3,13026,3.7366609294320137,0.0,0.0
43486,4,3486,[172 475 135  97 597],455,4,13030,3.736736449670204,0.0,0.0
43487,4,3487,[475  97 546 210 100],13,2,13032,3.7362385321100917,0.0,20.0
43488,4,3488,[333 405 216 496 204],666,1,13033,3.7354542848953853,0.0,0.0
43489,4,3489,[111 403 286   8 200],95,3,13036,3.735243553008596,0.0,0.0
43490,4,3490,[ 22  82 181  97 323],83,5,13041,3.7356058435978228,0.0,0.0
43491,4,3491,[546 228 742 125  96],881,3,13044,3.7353951890034365,0.0,0.0
43492,4,3492,[302 603 427 100  64],271,5,13049,3.735757228743201,20.0,20.0
43493,4,3493,[186 127  56  11 748],102,1,13050,3.7349742415569547,0.0,20.0
43494,4,3494,[275 185 187 210 191],524,3,13053,3.734763948497854,0.0,0.0
43495,4,3495,[302 603 427 100  64],90,5,13058,3.73512585812357,20.0,20.0
43496,4,3496,[427 483 318  98  69],454,3,13061,3.734915641978839,40.0,20.0
43497,4,3497,[269 235   9 678 245],634,2,13063,3.7344196683819324,0.0,0.0
43498,4,3498,[405 655 186 216 238],194,3,13066,3.734209774221206,0.0,0.0
43499,4,3499,[235 286  56 403  97],524,4,13070,3.7342857142857144,0.0,0.0
43500,4,3500,[288 182 183 235  95],13,3,13073,3.7340759782919166,0.0,0.0
43501,4,3501,[302 603 427 100  64],537,4,13077,3.7341519131924614,20.0,20.0
43502,4,3502,[ 82 185 186 143 210],13,1,13078,3.7333713959463317,0.0,0.0
43503,4,3503,[194 191 333 237 127],64,4,13082,3.733447488584475,0.0,20.0
43504,4,3504,[302 603 427 100  64],745,5,13087,3.733808844507846,20.0,20.0
43505,4,3505,[435 318 200  28 176],313,3,13090,3.733599543639475,20.0,0.0
43506,4,3506,[183 191 427 483 234],13,4,13094,3.733675506130596,20.0,0.0
43507,4,3507,[302 603 427 100  64],666,5,13099,3.734036488027366,20.0,20.0
43508,4,3508,[222 288 237 603 302],666,2,13101,3.7335423197492164,20.0,0.0
43509,4,3509,[588 258 211  50 228],59,3,13104,3.7333333333333334,0.0,20.0
43510,4,3510,[182 180 234 215 135],328,2,13106,3.7328396468242664,0.0,0.0
43511,4,3511,[111 135 195 258 197],533,4,13110,3.7329157175398633,0.0,0.0
43512,4,3512,[302 603 427 100  64],537,4,13114,3.7329917449473387,20.0,20.0
43513,4,3513,[302 603 427 100  64],458,5,13119,3.7333523050654525,20.0,20.0
43514,4,3514,[515 200 403 258 187],328,4,13123,3.7334281650071124,0.0,0.0
43515,4,3515,[210 179 483 182 742],207,3,13126,3.7332195676905573,20.0,0.0
43516,4,3516,[235 175 195  64   7],932,3,13129,3.7330110889963035,0.0,0.0
43517,4,3517,[176 435 385 127 187],343,4,13133,3.7330869812393406,0.0,20.0
43518,4,3518,[302 603 427 100  64],664,5,13138,3.7334470019892017,20.0,20.0
43519,4,3519,[ 56 215 100 186 678],804,4,13142,3.733522727272727,0.0,20.0
43520,4,3520,[302 603 427 100  64],458,5,13147,3.7338824197671117,20.0,20.0
43521,4,3521,[302 603 427 100  64],537,4,13151,3.7339579784213517,20.0,20.0
43522,4,3522,[181 135 143 289  79],194,0,13151,3.7328980982117512,0.0,0.0
43523,4,3523,[ 69 176  22 508 603],13,3,13154,3.7326901248581157,20.0,0.0
43524,4,3524,[302 603 427 100  64],537,4,13158,3.7327659574468086,20.0,20.0
43525,4,3525,[  8 118 282  69 588],298,5,13163,3.733125354509359,0.0,0.0
43526,4,3526,[ 12  79 183   8 151],406,3,13166,3.732917493620641,20.0,0.0
43527,4,3527,[ 56 234 195  89 276],92,5,13171,3.7332766439909295,0.0,0.0
43528,4,3528,[302 603 427 100  50],537,5,13176,3.733635590818929,20.0,40.0
43529,4,3529,[302 603 427 100  50],458,4,13180,3.73371104815864,20.0,40.0
43530,4,3530,[268  70 143 135 405],85,4,13184,3.733786462758425,0.0,0.0
43531,4,3531,[678  56 182 200 204],7,4,13188,3.7338618346545864,0.0,0.0
43532,4,3532,[302 603 427 100  64],474,5,13193,3.734220209453722,20.0,20.0
43533,4,3533,[603 258 200 748 197],749,4,13197,3.734295415959253,20.0,0.0
43534,4,3534,[294 471 742 100 313],144,5,13202,3.734653465346535,0.0,20.0
43535,4,3535,[168 161 172 357  28],648,3,13205,3.734445701357466,20.0,0.0
43536,4,3536,[202 603 483 228 143],749,5,13210,3.734803505795872,40.0,0.0
43537,4,3537,[300 180 181   1 515],121,3,13213,3.7345958168456757,0.0,0.0
43538,4,3538,[ 64 546   9  88 211],343,4,13217,3.734670810963549,0.0,0.0
43539,4,3539,[302 603 427 100  64],537,4,13221,3.7347457627118645,20.0,20.0
43540,4,3540,[302 603 427 100  64],90,5,13226,3.73510307822649,20.0,20.0
43541,4,3541,[302 603 427 100  64],454,5,13231,3.735460191981931,20.0,20.0
43542,4,3542,[ 71 275 185 385 357],694,5,13236,3.7358171041490262,20.0,0.0
43543,4,3543,[144 174 215 204  50],840,4,13240,3.7358916478555306,0.0,40.0
43544,4,3544,[302 603 427 100  64],664,5,13245,3.7362482369534558,20.0,20.0
43545,4,3545,[174 151 210  69   1],290,4,13249,3.736322617033277,0.0,20.0
43546,4,3546,[215   7 121 127 182],328,3,13252,3.736115026783197,0.0,20.0
43547,4,3547,[117 143 228 288 276],643,4,13256,3.7361894024802704,0.0,0.0
43548,4,3548,[405 508 302 174 196],537,2,13258,3.7357001972386588,0.0,20.0
43549,4,3549,[302 603 427 100  64],454,5,13263,3.736056338028169,20.0,20.0
43550,4,3550,[151 161 135 125   7],200,4,13267,3.736130667417629,0.0,0.0
43551,4,3551,[515 475   7 546 186],833,0,13267,3.735078828828829,0.0,0.0
43552,4,3552,[302 603 427 100  64],13,5,13272,3.735434843793977,20.0,20.0
43553,4,3553,[302 603 427 100  64],13,5,13277,3.735790658413056,20.0,20.0
43554,4,3554,[151  11 186 742 228],653,2,13279,3.7353023909985934,0.0,0.0
43555,4,3555,[302 603 427 100  64],664,5,13284,3.735658042744657,20.0,20.0
43556,4,3556,[ 88  12   4 385 111],13,4,13288,3.7357323587292663,20.0,0.0
43557,4,3557,[258 216 185 183 182],749,4,13292,3.735806632939854,0.0,0.0
43558,4,3558,[ 97  82 187  28 234],194,2,13294,3.7353189098061255,0.0,0.0
43559,4,3559,[302 603 427 100  64],454,5,13299,3.7356741573033707,20.0,20.0
43560,4,3560,[197  82 276  69 111],452,2,13301,3.7351867452962653,0.0,0.0
43561,4,3561,[121  88 187  82  98],343,4,13305,3.7352610892756877,0.0,20.0
43562,4,3562,[323 196 483 508 405],59,4,13309,3.735335391523997,20.0,0.0
43563,4,3563,[302 603 427 100  64],474,5,13314,3.7356902356902357,20.0,20.0
43564,4,3564,[ 89 200  79 742 179],899,4,13318,3.735764375876578,0.0,0.0
43565,4,3565,[678 245 172 121 135],92,4,13322,3.7358384744812114,0.0,0.0
43566,4,3566,[185 508 175 194 183],774,1,13323,3.735071488645921,0.0,0.0
43567,4,3567,[302 603 427 100  64],745,5,13328,3.7354260089686098,20.0,20.0
43568,4,3568,[302 603 427 100  64],664,5,13333,3.735780330624825,20.0,20.0
43569,4,3569,[186 288 423  25 196],533,3,13336,3.735574229691877,0.0,0.0
43570,4,3570,[ 71 185 176  82 174],897,5,13341,3.735928311397368,0.0,20.0
43571,4,3571,[302 603 427 100  64],339,5,13346,3.7362821948488243,20.0,20.0
43572,4,3572,[302 603 427 100  64],458,5,13351,3.7366358802127064,20.0,20.0
43573,4,3573,[194 357  97 215 172],406,4,13355,3.7367095691102405,20.0,0.0
43574,4,3574,[302 603 427 100  64],90,5,13360,3.737062937062937,20.0,20.0
43575,4,3575,[302 603 427 100  64],13,5,13365,3.7374161073825505,20.0,20.0
43576,4,3576,[403 508  71 603 174],59,4,13369,3.737489516354487,20.0,20.0
43577,4,3577,[302 603 427 100  64],664,5,13374,3.737842370039128,20.0,20.0
43578,4,3578,[182 176  97 423 173],59,5,13379,3.7381950265437274,0.0,0.0
43579,4,3579,[302 603 427 100  64],339,5,13384,3.7385474860335197,20.0,20.0
43580,4,3580,[302 603 427 100  64],454,5,13389,3.7388997486735547,20.0,20.0
43581,4,3581,[423 195  22 191  50],533,5,13394,3.739251814628699,0.0,20.0
43582,4,3582,[144 216 210 294 117],378,3,13397,3.7390454926039633,0.0,0.0
43583,4,3583,[357 238  64 237 423],194,3,13400,3.7388392857142856,20.0,0.0
43584,4,3584,[302 603 427 100  64],454,5,13405,3.739191073919107,20.0,20.0
43585,4,3585,[265 427 200  50 196],308,3,13408,3.7389849414389293,0.0,20.0
43586,4,3586,[ 71 127 176 194 202],406,3,13411,3.7387789238918314,0.0,20.0
43587,4,3587,[302 603 427 100  64],537,4,13415,3.738851727982163,20.0,20.0
43588,4,3588,[301 111 100 179 655],537,2,13417,3.738367233212594,0.0,20.0
43589,4,3589,[483 273 183  88 655],537,1,13418,3.7376044568245126,20.0,0.0
43590,4,3590,[302 603 427 100  64],458,5,13423,3.7379560011138957,20.0,20.0
43591,4,3591,[174  69  97 173  64],398,5,13428,3.7383073496659245,0.0,20.0
43592,4,3592,[302 603 427 100  64],537,4,13432,3.7383801836905093,20.0,20.0
43593,4,3593,[237 185 202 265 204],882,5,13437,3.7387312186978297,0.0,0.0
43594,4,3594,[ 96  69  97 597 153],650,2,13439,3.738247566063978,0.0,0.0
43595,4,3595,[302 603 427 100  64],745,5,13444,3.738598442714127,20.0,20.0
43596,4,3596,[238 357 132 186 196],666,3,13447,3.7383931053655823,20.0,0.0
43597,4,3597,[265 289 135 211 245],533,1,13448,3.73763201778766,0.0,0.0
43598,4,3598,[ 50 127 125 117 483],815,3,13451,3.737427063073076,20.0,40.0
43599,4,3599,[118 202 568 286 180],59,4,13455,3.7375,0.0,0.0
43600,4,3600,[268 276  12  25 597],145,3,13458,3.7372951957789504,20.0,0.0
43601,4,3601,[302 603 427 100  64],90,5,13463,3.7376457523598,20.0,20.0
43602,4,3602,[ 25   1 153 172 603],648,4,13467,3.7377185678601164,20.0,0.0
43603,4,3603,[185 195 275   8 228],311,4,13471,3.737791342952275,0.0,0.0
43604,4,3604,[302 603 427 100  64],271,5,13476,3.738141470180305,20.0,20.0
43605,4,3605,[318 196   9 168 172],815,4,13480,3.7382140876317247,20.0,0.0
43606,4,3606,[302 603 427 100  64],454,5,13485,3.7385639035209315,20.0,20.0
43607,4,3607,[302 603 427 100  64],474,5,13490,3.738913525498891,20.0,20.0
43608,4,3608,[100  15  89  28 515],892,5,13495,3.739262953726794,0.0,20.0
43609,4,3609,[ 79 403 301 175 180],788,2,13497,3.738781163434903,0.0,0.0
43610,4,3610,[235   7 173 172 187],524,2,13499,3.738299639988923,0.0,0.0
43611,4,3611,[125  88  11 237  70],234,0,13499,3.7372646733111847,0.0,0.0
43612,4,3612,[186 515 403 313 176],650,4,13503,3.7373373927484086,0.0,0.0
43613,4,3613,[153 237   8 228  25],343,4,13507,3.737410071942446,0.0,0.0
43614,4,3614,[ 71 318 515  69 403],290,3,13510,3.7372060857538036,20.0,0.0
43615,4,3615,[302 603 427 100  64],474,5,13515,3.737555309734513,20.0,20.0
43616,4,3616,[289 132 174 245 294],92,2,13517,3.737074923970141,0.0,20.0
43617,4,3617,[289  56 546 117 222],881,3,13520,3.7368711995577666,0.0,0.0
43618,4,3618,[313 515 301 195  97],650,3,13523,3.7366675877314175,0.0,0.0
43619,4,3619,[ 98 180 100  88 275],474,4,13527,3.736740331491713,0.0,40.0
43620,4,3620,[302 603 427 100  64],339,5,13532,3.7370892018779345,20.0,20.0
43621,4,3621,[275 144  82 318 127],455,3,13535,3.736885698509111,20.0,20.0
43622,4,3622,[302 603 427 100  64],745,5,13540,3.7372343361854816,20.0,20.0
43623,4,3623,[302 603 427 100  64],13,5,13545,3.7375827814569536,20.0,20.0
43624,4,3624,[  4 276 318 235 603],271,3,13548,3.7373793103448274,40.0,0.0
43625,4,3625,[ 50 323  25 187 183],650,2,13550,3.736900165471594,0.0,20.0
43626,4,3626,[508 275  22 471 191],533,5,13555,3.7372484146677696,0.0,0.0
43627,4,3627,[294 282  82 196 265],378,4,13559,3.7373208379272325,0.0,0.0
43628,4,3628,[302 603 427 100  64],537,4,13563,3.737393221273078,20.0,20.0
43629,4,3629,[151 172 168 183 228],290,3,13566,3.737190082644628,0.0,0.0
43630,4,3630,[294 176  28 175 318],42,3,13569,3.7369870559074636,20.0,0.0
43631,4,3631,[269  56 187 153 328],334,3,13572,3.736784140969163,0.0,0.0
43632,4,3632,[302 603 427 100  64],664,5,13577,3.7371318469584365,20.0,20.0
43633,4,3633,[235 328   8  98 180],313,3,13580,3.736929003852504,0.0,20.0
43634,4,3634,[302 603 427 100  64],537,4,13584,3.7370013755158182,20.0,20.0
43635,4,3635,[289 216  15 135 175],406,3,13587,3.7367986798679866,0.0,0.0
43636,4,3636,[302 603 427 100  64],13,5,13592,3.7371459994500964,20.0,20.0
43637,4,3637,[302 603 427 100  64],454,5,13597,3.7374931280923582,20.0,20.0
43638,4,3638,[655 568 174 318 405],313,4,13601,3.7375652651827425,20.0,20.0
43639,4,3639,[194 322 222 191 423],13,2,13603,3.737087912087912,0.0,0.0
43640,4,3640,[182 546  89 194 210],666,3,13606,3.736885471024444,0.0,0.0
43641,4,3641,[197 265 286 111  82],648,3,13609,3.7366831411312464,0.0,0.0
43642,4,3642,[ 15 172 323 211 318],537,2,13611,3.7362064232775185,20.0,0.0
43643,4,3643,[135 183   4 568 168],749,5,13616,3.7365532381997806,0.0,0.0
43644,4,3644,[173  95 180 153 323],13,3,13619,3.7363511659807958,0.0,0.0
43645,4,3645,[238 117 176 135 144],95,3,13622,3.7361492046077895,0.0,0.0
43646,4,3646,[ 12 127 195 265 173],13,3,13625,3.7359473539895807,20.0,20.0
43647,4,3647,[423 180  95 174 496],387,2,13627,3.73547149122807,0.0,20.0
43648,4,3648,[238 186 181 265 228],653,4,13631,3.73554398465333,0.0,0.0
43649,4,3649,[515 132 204 588  79],308,3,13634,3.735342465753425,0.0,0.0
43650,4,3650,[204 176 168 194  98],379,5,13639,3.735688852369214,0.0,20.0
43651,4,3651,[195 181 118 323 173],374,1,13640,3.7349397590361444,0.0,0.0
43652,4,3652,[ 50 328 318 143   7],334,3,13643,3.7347385710375036,20.0,20.0
43653,4,3653,[182 603 161 153 172],650,3,13646,3.7345374931581827,20.0,0.0
43654,4,3654,[ 28 678 235 423 175],334,2,13648,3.73406292749658,0.0,0.0
43655,4,3655,[144 202 234  95 172],194,1,13649,3.7333150984682715,0.0,0.0
43656,4,3656,[265 179  25 127 423],374,3,13652,3.7331145747880776,0.0,20.0
43657,4,3657,[302 603 427 100  50],14,5,13657,3.733460907599781,20.0,40.0
43658,4,3658,[302 603 427 100  50],454,5,13662,3.7338070511068597,20.0,40.0
43659,4,3659,[238 153 302 185 357],543,3,13665,3.7336065573770494,20.0,0.0
43660,4,3660,[294  28 151 435 546],308,2,13667,3.733133023763999,0.0,0.0
43661,4,3661,[151 200  69  82 228],60,4,13671,3.7332058984161662,0.0,0.0
43662,4,3662,[ 12 275 245 258  56],328,5,13676,3.7335517335517334,20.0,0.0
43663,4,3663,[181 127  11 135 168],64,5,13681,3.733897379912664,0.0,20.0
43664,4,3664,[294  95  25 186 301],378,2,13683,3.733424283765348,0.0,0.0
43665,4,3665,[742  50 288 127 100],26,4,13687,3.7334969994544465,0.0,60.0
43666,4,3666,[151   9 196  82 515],334,5,13692,3.7338423779656393,0.0,0.0
43667,4,3667,[302 603 427 100  50],14,5,13697,3.734187568157034,20.0,40.0
43668,4,3668,[302 603 427 100  50],271,5,13702,3.734532570182611,20.0,40.0
43669,4,3669,[234  97 228 275 588],312,4,13706,3.7346049046321528,0.0,0.0
43670,4,3670,[100 144 323 435 318],263,4,13710,3.7346771996731136,20.0,20.0
43671,4,3671,[172 182 168 471 194],119,5,13715,3.735021786492375,0.0,0.0
43672,4,3672,[211   4 238 286 176],59,4,13719,3.7350939286686633,0.0,0.0
43673,4,3673,[143  70   4 288 237],13,2,13721,3.7346216657593905,0.0,0.0
43674,4,3674,[ 50 196  89 127 121],64,3,13724,3.734421768707483,0.0,40.0
43675,4,3675,[ 95 496 117  12  28],537,1,13725,3.733677910772579,20.0,0.0
43676,4,3676,[302 603 427 100  50],13,5,13730,3.7340223007886864,20.0,40.0
43677,4,3677,[302 603 427 100  50],271,5,13735,3.7343665035345297,20.0,40.0
43678,4,3678,[385 471 234 265 143],533,3,13738,3.734166893177494,0.0,0.0
43679,4,3679,[181 385 172 588 210],95,4,13742,3.7342391304347826,0.0,0.0
43680,4,3680,[385  11   1 186  28],59,4,13746,3.734311328443358,0.0,0.0
43681,4,3681,[144  12 211 125 423],7,5,13751,3.7346550787615427,20.0,0.0
43682,4,3682,[210 546  15  69 301],650,0,13751,3.7336410534890034,0.0,0.0
43683,4,3683,[508 186 215 202 216],653,1,13752,3.732899022801303,0.0,0.0
43684,4,3684,[302 603 427 100  50],339,5,13757,3.7332428765264587,20.0,40.0
43685,4,3685,[603 655 210  15 273],308,3,13760,3.733043950081389,20.0,0.0
43686,4,3686,[302 603 427 100  50],339,5,13765,3.733387577976675,20.0,40.0
43687,4,3687,[118  69 127 197  15],313,4,13769,3.733459869848156,0.0,20.0
43688,4,3688,[302 603 427 100  50],664,5,13774,3.7338031986988343,20.0,40.0
43689,4,3689,[302 603 427 100  50],14,5,13779,3.734146341463415,20.0,40.0
43690,4,3690,[135 423 179 173 191],934,2,13781,3.7336765104307776,0.0,0.0
43691,4,3691,[302 603 427 100  50],271,5,13786,3.7340195016251356,20.0,40.0
43692,4,3692,[175 271 222 568 117],650,3,13789,3.7338207419442186,0.0,0.0
43693,4,3693,[268 143 191  95  50],92,3,13792,3.7336220898754737,0.0,20.0
43694,4,3694,[483 210 176  25 273],308,3,13795,3.733423545331529,20.0,0.0
43695,4,3695,[132  25 496 181 144],194,2,13797,3.7329545454545454,0.0,0.0
43696,4,3696,[302 603 427 100  50],458,4,13801,3.733026778469029,20.0,40.0
43697,4,3697,[ 64 132 357 258 318],288,4,13805,3.733098972417523,40.0,0.0
43698,4,3698,[ 12 215 423   1 322],311,5,13810,3.733441470667748,20.0,0.0
43699,4,3699,[ 70 121   7 172 286],881,3,13813,3.733243243243243,0.0,0.0
43700,4,3700,[302 603 427 100  50],339,5,13818,3.733585517427722,20.0,40.0
43701,4,3701,[568  28 195 191 357],648,4,13822,3.7336574824419233,20.0,0.0
43702,4,3702,[302 603 427 100  50],664,5,13827,3.7339994598973805,20.0,40.0
43703,4,3703,[302 603 427 100  50],537,5,13832,3.734341252699784,20.0,40.0
43704,4,3704,[302 603 427 100  50],666,4,13836,3.734412955465587,20.0,40.0
43705,4,3705,[302 603 427 100  64],90,5,13841,3.7347544522396112,20.0,20.0
43706,4,3706,[181 161 268 515 265],7,1,13842,3.734016725114648,0.0,0.0
43707,4,3707,[302 603 427 100  64],666,5,13847,3.7343581445523193,20.0,20.0
43708,4,3708,[678   4 187 322 173],749,3,13850,3.734160150984093,0.0,0.0
43709,4,3709,[403   7 172  12 568],194,1,13851,3.733423180592992,20.0,0.0
43710,4,3710,[ 82 117 196 302 508],13,2,13853,3.7329560765292373,0.0,0.0
43711,4,3711,[302 603 427 100  64],537,4,13857,3.7330280172413794,20.0,20.0
43712,4,3712,[302 603 427 100  50],537,5,13862,3.733369243199569,20.0,40.0
43713,4,3713,[ 89  82 475 748 313],92,3,13865,3.7331717824448036,0.0,0.0
43714,4,3714,[515 471 181 174 313],13,3,13868,3.732974427994616,0.0,20.0
43715,4,3715,[302 603 427 100  50],271,5,13873,3.7333153928955864,20.0,40.0
43716,4,3716,[678  25  69 174 181],749,4,13877,3.7333871401668013,0.0,20.0
43717,4,3717,[215  70 265 132 258],537,2,13879,3.7329209252286177,0.0,0.0
43718,4,3718,[302 603 427 100  50],334,5,13884,3.7332616294702876,20.0,40.0
43719,4,3719,[121  98 143 385 197],653,2,13886,3.7327956989247313,0.0,20.0
43720,4,3720,[302 603 427 100  50],13,5,13891,3.733136253695243,20.0,40.0
43721,4,3721,[215 546 228  11  89],788,1,13892,3.7324019344438475,0.0,0.0
43722,4,3722,[211 300 294 174 144],488,4,13896,3.732473811442385,0.0,20.0
43723,4,3723,[191 121 181 215 483],648,4,13900,3.7325456498388827,20.0,0.0
43724,4,3724,[302 603 427 100  50],454,5,13905,3.7328859060402686,20.0,40.0
43725,4,3725,[655  11 357 211 187],207,4,13909,3.732957595276436,20.0,0.0
43726,4,3726,[204 257   7   9 194],339,4,13913,3.7330292460423933,0.0,0.0
43727,4,3727,[180 228 655 300 182],774,3,13916,3.732832618025751,0.0,0.0
43728,4,3728,[318 176 258 328 483],488,4,13920,3.7329042638777152,40.0,0.0
43729,4,3729,[100 282 186 191 597],653,4,13924,3.732975871313673,0.0,20.0
43730,4,3730,[742 210  56 222 385],387,3,13927,3.732779415706245,0.0,0.0
43731,4,3731,[302 603 427 100  50],339,5,13932,3.733118971061093,20.0,40.0
43732,4,3732,[471  95 132 215 176],815,3,13935,3.7329225823734262,0.0,0.0
43733,4,3733,[265 161 195 144  95],374,4,13939,3.732994108194965,0.0,0.0
43734,4,3734,[186 179 403 483 238],311,3,13942,3.732797858099063,20.0,0.0
43735,4,3735,[302 603 427 100  50],745,4,13946,3.732869379014989,20.0,40.0
43736,4,3736,[135 318 173 176 187],64,5,13951,3.733208455980733,20.0,0.0
43737,4,3737,[271  22   1 144 182],650,0,13951,3.7322097378277155,0.0,0.0
43738,4,3738,[172   4 174 211 265],102,1,13952,3.7314790050815727,0.0,20.0
43739,4,3739,[195 546 153  70  28],653,2,13954,3.7310160427807486,0.0,0.0
43740,4,3740,[273 202  56 181 515],308,3,13957,3.730820636193531,0.0,0.0
43741,4,3741,[174 183   1 403 322],804,4,13961,3.7308925708177445,0.0,20.0
43742,4,3742,[185 475  22  82 268],13,2,13963,3.7304301362543413,0.0,0.0
43743,4,3743,[200  11  70 289   9],271,5,13968,3.730769230769231,0.0,0.0
43744,4,3744,[302 603 427 100  64],339,5,13973,3.7311081441922562,20.0,20.0
43745,4,3745,[182 144 204 228 153],234,0,13973,3.7301121195942337,0.0,0.0
43746,4,3746,[302 603 427 100  64],664,5,13978,3.7304510274886575,20.0,20.0
43747,4,3747,[194 174 597 187   8],7,4,13982,3.730522945570971,0.0,20.0
43748,4,3748,[257   4 678 195 742],804,5,13987,3.730861563083489,0.0,0.0
43749,4,3749,[302 603 427 100  64],458,5,13992,3.7312,20.0,20.0
43750,4,3750,[176 245 748 125 216],313,2,13994,3.7307384697414023,0.0,0.0
43751,4,3751,[228  98 475 127 333],533,4,13998,3.7308102345415777,0.0,40.0
43752,4,3752,[172 144   1 168 471],158,5,14003,3.731148414601652,0.0,0.0
43753,4,3753,[300 313 200  70 237],328,5,14008,3.731486414491209,0.0,0.0
43754,4,3754,[302 603 427 100  64],474,5,14013,3.7318242343541943,20.0,20.0
43755,4,3755,[302 603 427 100  64],474,5,14018,3.7321618743343983,20.0,20.0
43756,4,3756,[435 132   9 125 405],881,2,14020,3.7317008251264308,0.0,0.0
43757,4,3757,[234 196 125  11  88],653,0,14020,3.7307078233102713,0.0,0.0
43758,4,3758,[ 11 127  82 237 172],538,5,14025,3.731045490822027,0.0,20.0
43759,4,3759,[187 289 174  89 328],234,2,14027,3.730585106382979,0.0,20.0
43760,4,3760,[182  50 568 143 742],533,4,14031,3.7306567402286626,0.0,20.0
43761,4,3761,[302 603 427 100  64],664,5,14036,3.7309941520467835,20.0,20.0
43762,4,3762,[ 98  89 100 222 111],374,3,14039,3.7307998937018336,0.0,40.0
43763,4,3763,[179 161 180 222   8],474,5,14044,3.731137088204038,0.0,0.0
43764,4,3764,[300 194 748 318 172],313,4,14048,3.7312084993359895,20.0,0.0
43765,4,3765,[174 176 151 258  11],537,1,14049,3.7304832713754648,0.0,20.0
43766,4,3766,[678 318  11 265 174],804,5,14054,3.7308202813910274,20.0,20.0
43767,4,3767,[302 603 427 100  64],474,5,14059,3.7311571125265393,20.0,20.0
43768,4,3768,[302 603 427 100  64],458,5,14064,3.7314937649243833,20.0,20.0
43769,4,3769,[ 79 423 471 405 483],788,4,14068,3.7315649867374003,20.0,0.0
43770,4,3770,[ 79 174 168 496 144],7,5,14073,3.731901352426412,0.0,20.0
43771,4,3771,[211 323 313 289 132],328,4,14077,3.7319724284199363,0.0,0.0
43772,4,3772,[302 603 427 100  64],458,5,14082,3.7323085078187117,20.0,20.0
43773,4,3773,[294 238   8 403 195],378,2,14084,3.731849496555379,0.0,0.0
43774,4,3774,[496 100 269  15 194],537,2,14086,3.7313907284768213,0.0,20.0
43775,4,3775,[655 405 282  11 471],119,5,14091,3.7317266949152543,0.0,0.0
43776,4,3776,[ 22 228 176  71   9],13,3,14094,3.7315329626687848,0.0,0.0
43777,4,3777,[117 168 118  50 202],738,2,14096,3.7310746426680783,0.0,20.0
43778,4,3778,[196 135 181  69  88],308,3,14099,3.7308811854988093,0.0,0.0
43779,4,3779,[144 273 288   9  15],234,0,14099,3.72989417989418,0.0,0.0
43780,4,3780,[180 183 435   8 333],328,3,14102,3.7297011372652737,0.0,0.0
43781,4,3781,[ 25 135 238 151 180],474,4,14106,3.729772607086198,0.0,0.0
43782,4,3782,[302 603 427 100  64],370,5,14111,3.7301083795929157,20.0,20.0
43783,4,3783,[483 168 286 282 215],85,4,14115,3.7301797040169133,20.0,0.0
43784,4,3784,[286 245 174 183 204],653,4,14119,3.7302509907529724,0.0,20.0
43785,4,3785,[597  96  95 121 273],308,2,14121,3.7297939778129954,0.0,0.0
43786,4,3786,[117 186 288 405 179],648,4,14125,3.7298653287562713,0.0,0.0
43787,4,3787,[143 132  69 118 318],454,4,14129,3.729936642027455,20.0,0.0
43788,4,3788,[211 176 181 125 127],804,4,14133,3.7300079176563736,0.0,20.0
43789,4,3789,[302 603 427 100  64],271,5,14138,3.7303430079155673,20.0,20.0
43790,4,3790,[302 603 427 100  64],537,4,14142,3.73041413874967,20.0,20.0
43791,4,3791,[273 216   7 168 100],7,4,14146,3.7304852320675104,0.0,20.0
43792,4,3792,[302 603 427 100  64],90,5,14151,3.7308199314526758,20.0,20.0
43793,4,3793,[ 82 423 275 603 175],537,3,14154,3.7306273062730626,20.0,0.0
43794,4,3794,[  7  12 748 294  11],447,4,14158,3.7306982872200263,20.0,0.0
43795,4,3795,[302 603 427 100  64],271,5,14163,3.7310326659641726,20.0,20.0
43796,4,3796,[  4 423  69 357 121],659,3,14166,3.7308401369502238,20.0,0.0
43797,4,3797,[302 603 427 100  64],13,5,14171,3.7311743022643498,20.0,20.0
43798,4,3798,[211 427 173 176 187],474,5,14176,3.731508291655699,0.0,0.0
43799,4,3799,[275 182 143 197 168],6,4,14180,3.731578947368421,0.0,0.0
43800,4,3800,[742 143 245 258 182],378,4,14184,3.7316495659037097,0.0,0.0
43801,4,3801,[302 603 427 100  64],745,5,14189,3.7319831667543397,20.0,20.0
43802,4,3802,[302 603 427 100  64],458,5,14194,3.732316592164081,20.0,20.0
43803,4,3803,[405 117 435 180 238],749,3,14197,3.732124079915878,0.0,0.0
43804,4,3804,[ 98 276 210 483  95],200,5,14202,3.7324572930354796,20.0,20.0
43805,4,3805,[151  97  79 475 195],537,1,14203,3.731739358906989,0.0,0.0
43806,4,3806,[ 25 435   7 742  98],666,3,14206,3.7315471499868664,0.0,20.0
43807,4,3807,[117  56  28 187 135],334,3,14209,3.7313550420168067,0.0,0.0
43808,4,3808,[435 111  28 471 508],533,5,14214,3.7316881071147283,0.0,0.0
43809,4,3809,[302 603 427 100  64],664,5,14219,3.732020997375328,20.0,20.0
43810,4,3810,[302 603 427 100  64],13,5,14224,3.7323537129362374,20.0,20.0
43811,4,3811,[144 403 197 405 204],95,3,14227,3.732161594963274,0.0,0.0
43812,4,3812,[ 79 273 435 238  82],666,2,14229,3.731707317073171,0.0,0.0
43813,4,3813,[216 195 197  64 322],537,1,14230,3.7309910854745674,0.0,0.0
43814,4,3814,[235  69  82  12 135],524,2,14232,3.730537352555701,20.0,0.0
43815,4,3815,[153 211 405 161 143],194,2,14234,3.730083857442348,0.0,0.0
43816,4,3816,[195 197 496 204  70],840,4,14238,3.730154571653131,0.0,0.0
43817,4,3817,[302 603 427 100  64],370,5,14243,3.7304871660555263,20.0,20.0
43818,4,3818,[210  69  97  82 172],830,4,14247,3.730557737627651,0.0,0.0
43819,4,3819,[471 151  69   7  70],658,4,14251,3.730628272251309,0.0,0.0
43820,4,3820,[302 603 427 100  64],13,5,14256,3.7309604815493325,20.0,20.0
43821,4,3821,[215 435 117 588 187],313,5,14261,3.7312925170068025,0.0,0.0
43822,4,3822,[423 161  70 234 322],524,5,14266,3.731624378760136,0.0,0.0
43823,4,3823,[302 603 427 100  64],370,5,14271,3.7319560669456067,20.0,20.0
43824,4,3824,[302 603 427 100  64],370,5,14276,3.7322875816993464,20.0,20.0
43825,4,3825,[172  22 275   7 385],95,4,14280,3.7323575535807634,0.0,0.0
43826,4,3826,[423 268 238  98 496],778,1,14281,3.731643585053567,0.0,20.0
43827,4,3827,[ 69 196 289   7 258],537,2,14283,3.731191222570533,0.0,0.0
43828,4,3828,[234 183 286 258 655],479,4,14287,3.7312614259597807,0.0,0.0
43829,4,3829,[215 235 197   4 222],343,5,14292,3.7315926892950393,0.0,0.0
43830,4,3830,[186  88 215  98  79],311,4,14296,3.731662751239885,0.0,20.0
43831,4,3831,[176 196 144 313 179],92,5,14301,3.731993736951983,0.0,0.0
43832,4,3832,[302 603 427 100  64],537,4,14305,3.732063657709366,20.0,20.0
43833,4,3833,[357 182 176 210 300],210,5,14310,3.732394366197183,20.0,0.0
43834,4,3834,[245 182 143 172 144],92,4,14314,3.732464146023468,0.0,0.0
43835,4,3835,[258 357 144  69  97],666,3,14317,3.7322732012513034,20.0,0.0
43836,4,3836,[302 603 427 100  50],745,4,14321,3.732342976283555,20.0,40.0
43837,4,3837,[302 603 427 100  64],339,5,14326,3.732673267326733,20.0,20.0
43838,4,3838,[302 603 427 100  64],537,4,14330,3.732742901797343,20.0,20.0
43839,4,3839,[ 98 135  28 742 603],308,3,14333,3.732552083333333,20.0,20.0
43840,4,3840,[302 603 427 100  64],537,4,14337,3.732621713095548,20.0,20.0
43841,4,3841,[748 183 302 289  70],474,3,14340,3.732431025507548,0.0,0.0
43842,4,3842,[269  11 471   9  71],7,3,14343,3.73224043715847,0.0,0.0
43843,4,3843,[302 603 427 100  64],339,5,14348,3.732570239334027,20.0,20.0
43844,4,3844,[302 603 427 100  64],90,5,14353,3.7328998699609883,20.0,20.0
43845,4,3845,[173 588 403  50 655],804,4,14357,3.732969318772751,0.0,20.0
43846,4,3846,[245 288 143 180 294],452,1,14358,3.732258903041331,0.0,0.0
43847,4,3847,[118 204 238   1 275],189,4,14362,3.7323284823284824,0.0,0.0
43848,4,3848,[302 603 427 100  64],370,5,14367,3.7326578332034295,20.0,20.0
43849,4,3849,[ 56  97 191 185 121],406,5,14372,3.732987012987013,0.0,0.0
43850,4,3850,[196 175  28 238  15],92,3,14375,3.732796676188003,0.0,0.0
43851,4,3851,[300 144 403 186 195],749,5,14380,3.7331256490134996,0.0,0.0
43852,4,3852,[ 12 197 118 655 204],690,4,14384,3.7331949130547626,20.0,0.0
43853,4,3853,[302 603 427 100  64],13,5,14389,3.733523611831863,20.0,20.0
43854,4,3854,[ 88  82  64 435 181],194,2,14391,3.7330739299610896,0.0,0.0
43855,4,3855,[302 603 427 100  64],474,5,14396,3.733402489626556,20.0,20.0
43856,4,3856,[172 144 322 117 546],901,5,14401,3.7337308789214414,0.0,0.0
43857,4,3857,[302 603 427 100  64],454,5,14406,3.734059097978227,20.0,20.0
43858,4,3858,[302 603 427 100  64],271,5,14411,3.734387146929256,20.0,20.0
43859,4,3859,[143 100 275 427 568],537,3,14414,3.73419689119171,0.0,20.0
43860,4,3860,[302 603 427 100  64],666,5,14419,3.7345247345247343,20.0,20.0
43861,4,3861,[302 603 427 100  64],13,5,14424,3.7348524080787158,20.0,20.0
43862,4,3862,[302 603 427 100  64],370,5,14429,3.7351799119855036,20.0,20.0
43863,4,3863,[211 275  70 435 568],64,5,14434,3.7355072463768115,0.0,0.0
43864,4,3864,[302 603 427 100  64],458,5,14439,3.7358344113842175,20.0,20.0
43865,4,3865,[302 603 427 100  64],339,5,14444,3.736161407139162,20.0,20.0
43866,4,3866,[427 173 204 546 211],339,4,14448,3.7362296353762607,0.0,0.0
43867,4,3867,[294  22  96 423 216],308,3,14451,3.736039296794209,0.0,0.0
43868,4,3868,[405  15 191 173 176],648,4,14455,3.7361075213233392,0.0,0.0
43869,4,3869,[ 28 508   7 215 603],474,4,14459,3.736175710594315,20.0,0.0
43870,4,3870,[ 79 546 403 118  96],749,3,14462,3.735985533453888,0.0,0.0
43871,4,3871,[ 28  64 568 191  70],543,4,14466,3.7360537190082646,0.0,0.0
43872,4,3872,[179 318 127 182 294],774,3,14469,3.7358636715724245,20.0,20.0
43873,4,3873,[302 603 427 100  64],458,5,14474,3.7361899845121322,20.0,20.0
43874,4,3874,[302 603 427 100  64],537,4,14478,3.736258064516129,20.0,20.0
43875,4,3875,[235 403  64 181 237],92,4,14482,3.736326109391125,0.0,0.0
43876,4,3876,[161 183 202   1 228],59,3,14485,3.736136187774052,0.0,0.0
43877,4,3877,[183   1 161 100 282],881,4,14489,3.7362042289840125,0.0,20.0
43878,4,3878,[ 50 111  98 187 423],749,3,14492,3.7360144367104926,0.0,40.0
43879,4,3879,[182 161 405 403   7],95,1,14493,3.7353092783505155,0.0,0.0
43880,4,3880,[483  98 111 245 196],207,3,14496,3.7351198144808038,20.0,20.0
43881,4,3881,[222 597 197 200 403],650,3,14499,3.7349304482225656,0.0,0.0
43882,4,3882,[302 603 427 100  64],458,5,14504,3.7352562451712594,20.0,20.0
43883,4,3883,[302 603 427 100  64],370,5,14509,3.735581874356334,20.0,20.0
43884,4,3884,[302 603 427 100  64],339,5,14514,3.735907335907336,20.0,20.0
43885,4,3885,[302 603 427 100  64],13,5,14519,3.7362326299536797,20.0,20.0
43886,4,3886,[403 385 187 181  88],648,4,14523,3.73630048880885,0.0,0.0
43887,4,3887,[234 301 238 172 276],210,4,14527,3.7363683127572016,0.0,0.0
43888,4,3888,[302 603 427 100  64],271,5,14532,3.736693237336076,20.0,20.0
43889,4,3889,[127 568 143 183 237],804,3,14535,3.736503856041131,0.0,20.0
43890,4,3890,[603 187  95 135  22],234,4,14539,3.7365715754304807,20.0,0.0
43891,4,3891,[302 603 427 100  64],13,5,14544,3.736896197327852,20.0,20.0
43892,4,3892,[ 64 515  96 127 100],311,4,14548,3.736963781145646,0.0,40.0
43893,4,3893,[237  79 483 268 234],90,5,14553,3.73728813559322,20.0,0.0
43894,4,3894,[ 15 483  71 235 151],406,3,14556,3.737098844672657,20.0,0.0
43895,4,3895,[288  88 121   7 181],188,4,14560,3.7371663244353184,0.0,0.0
43896,4,3896,[302 603 427 100  64],537,4,14564,3.737233769566333,20.0,20.0
43897,4,3897,[427  56 194  69 125],6,3,14567,3.737044638276039,0.0,0.0
43898,4,3898,[ 25  89  15 161 196],650,2,14569,3.736599127981534,0.0,0.0
43899,4,3899,[427 357 655  64 182],194,4,14573,3.736666666666667,20.0,0.0
43900,4,3900,[228 180 161 195 127],479,4,14577,3.736734170725455,0.0,20.0
43901,4,3901,[302 603 427 100  64],339,5,14582,3.7370579190158892,20.0,20.0
43902,4,3902,[302 603 427 100  64],745,5,14587,3.7373815014091725,20.0,20.0
43903,4,3903,[302 603 427 100  64],90,5,14592,3.737704918032787,20.0,20.0
43904,4,3904,[  9   8 423 678  69],13,3,14595,3.737516005121639,0.0,0.0
43905,4,3905,[168 180 228 234 603],738,4,14599,3.7375832053251408,20.0,0.0
43906,4,3906,[302 603 427 100  64],664,5,14604,3.737906321986179,20.0,20.0
43907,4,3907,[176 200 471 237 191],537,1,14605,3.737205731832139,0.0,0.0
43908,4,3908,[ 50 313 286 183 191],13,3,14608,3.737017139933487,0.0,20.0
43909,4,3909,[475 265 496 257  56],334,3,14611,3.7368286445012786,0.0,0.0
43910,4,3910,[172 204 143 210 423],234,1,14612,3.7361288672973663,0.0,0.0
43911,4,3911,[173 302 276 427 603],13,4,14616,3.736196319018405,20.0,0.0
43912,4,3912,[294 176 132 127 186],666,3,14619,3.736008177868643,0.0,20.0
43913,4,3913,[302 603 427 100  64],454,5,14624,3.7363311190597854,20.0,20.0
43914,4,3914,[742 183 174 173  96],749,5,14629,3.736653895274585,0.0,20.0
43915,4,3915,[302 603 427 100  64],454,5,14634,3.736976506639428,20.0,20.0
43916,4,3916,[117 322 515 182 215],313,4,14638,3.737043655859076,0.0,0.0
43917,4,3917,[302 603 427 100  64],458,5,14643,3.737366003062787,20.0,20.0
43918,4,3918,[302 603 427 100  64],13,5,14648,3.737688185761674,20.0,20.0
43919,4,3919,[748 508  50 333  70],894,2,14650,3.7372448979591835,0.0,20.0
43920,4,3920,[ 95  97 273 161 257],374,3,14653,3.7370568732466207,0.0,0.0
43921,4,3921,[302 603 427 100  64],664,5,14658,3.7373788883222847,20.0,20.0
43922,4,3922,[302 603 427 100  64],664,5,14663,3.737700739230181,20.0,20.0
43923,4,3923,[ 22 200 588 135 302],537,2,14665,3.7372579001019366,0.0,0.0
43924,4,3924,[302 603 427 100  64],90,5,14670,3.737579617834395,20.0,20.0
43925,4,3925,[302 603 427 100  64],666,5,14675,3.737901171676006,20.0,20.0
43926,4,3926,[143  88 471 211 655],42,4,14679,3.7379679144385025,0.0,0.0
43927,4,3927,[302 603 427 100  64],90,5,14684,3.7382892057026478,20.0,20.0
43928,4,3928,[302 603 427 100  64],458,5,14689,3.7386103334181726,20.0,20.0
43929,4,3929,[176 174 186   1  11],749,5,14694,3.738931297709924,0.0,20.0
43930,4,3930,[302 603 427 100  64],454,5,14699,3.7392520987026203,20.0,20.0
43931,4,3931,[302 603 427 100  64],458,5,14704,3.7395727365208544,20.0,20.0
43932,4,3932,[748 275  70  12 357],311,5,14709,3.7398932112890924,40.0,0.0
43933,4,3933,[265 187  96  50 222],234,2,14711,3.739450940518556,0.0,20.0
43934,4,3934,[121  22 153  88 603],454,4,14715,3.7395171537484115,20.0,0.0
43935,4,3935,[289 265 288  79 127],488,3,14718,3.739329268292683,0.0,20.0
43936,4,3936,[302 603 427 100  64],537,4,14722,3.7393954787909576,20.0,20.0
43937,4,3937,[ 96 183 245 202  82],313,3,14725,3.739207719654647,0.0,0.0
43938,4,3938,[357   4 568 118 471],7,4,14729,3.7392739273927393,20.0,0.0
43939,4,3939,[483 127 191 294 168],10,4,14733,3.7393401015228425,20.0,20.0
43940,4,3940,[302 603 427 100  64],271,5,14738,3.7396599847754377,20.0,20.0
43941,4,3941,[302 603 427 100  64],90,5,14743,3.7399797057331305,20.0,20.0
43942,4,3942,[302 603 427 100  64],90,5,14748,3.7402992645194013,20.0,20.0
43943,4,3943,[180  98 313 132 173],474,5,14753,3.7406186612576064,0.0,20.0
43944,4,3944,[204 181 174  50 385],833,0,14753,3.7396704689480353,0.0,40.0
43945,4,3945,[ 70  79 180 173  96],59,4,14757,3.7397364419665484,0.0,0.0
43946,4,3946,[ 97   8 655   7 282],406,3,14760,3.739549024575627,0.0,0.0
43947,4,3947,[302 603 427 100  64],339,5,14765,3.739868287740628,20.0,20.0
43948,4,3948,[302 603 427 100  64],454,5,14770,3.740187389212459,20.0,20.0
43949,4,3949,[194 271 423 603 175],506,5,14775,3.740506329113924,20.0,0.0
43950,4,3950,[313 748 176  28 132],328,4,14779,3.7405720070868136,0.0,0.0
43951,4,3951,[174 357 121 175 222],313,4,14783,3.7406376518218623,20.0,20.0
43952,4,3952,[202 597 197 195 471],374,3,14786,3.74045029091829,0.0,0.0
43953,4,3953,[302 603 427 100  64],474,5,14791,3.740768841679312,20.0,20.0
43954,4,3954,[294 423  12  50 496],474,4,14795,3.740834386852086,20.0,20.0
43955,4,3955,[  7 127 185  56 228],82,0,14795,3.7398887765419615,0.0,20.0
43956,4,3956,[ 89 302  88 181 258],474,5,14800,3.7402072276977507,0.0,0.0
43957,4,3957,[ 79 483 508 174 185],184,3,14803,3.7400202122283983,20.0,20.0
43958,4,3958,[302 603 427 100  64],370,5,14808,3.740338469310432,20.0,20.0
43959,4,3959,[288  70  69 186 197],308,3,14811,3.7401515151515152,0.0,0.0
43960,4,3960,[302 603 427 100  64],454,5,14816,3.7404695783892956,20.0,20.0
43961,4,3961,[ 25 322 748 121 197],13,3,14819,3.7402826855123674,0.0,0.0
43962,4,3962,[ 79 234 245 161 216],378,4,14823,3.740348221044663,0.0,0.0
43963,4,3963,[100  64 172  12   9],474,5,14828,3.74066599394551,20.0,20.0
43964,4,3964,[403 748  98   4   1],788,1,14829,3.7399747793190414,0.0,20.0
43965,4,3965,[302 603 427 100  64],474,5,14834,3.740292486132123,20.0,20.0
43966,4,3966,[302 603 427 100  64],666,5,14839,3.7406100327703555,20.0,20.0
43967,4,3967,[222 127 211 187 117],537,3,14842,3.740423387096774,0.0,20.0
43968,4,3968,[302 603 427 100  64],458,5,14847,3.740740740740741,20.0,20.0
43969,4,3969,[302 603 427 100  64],271,5,14852,3.741057934508816,20.0,20.0
43970,4,3970,[ 70 427   4 135 202],398,2,14854,3.740619491312012,0.0,0.0
43971,4,3971,[483 183 172 546 197],313,5,14859,3.740936555891239,20.0,0.0
43972,4,3972,[294 195 100 228 235],537,1,14860,3.7402466649886734,0.0,20.0
43973,4,3973,[515 271 200 318 204],328,3,14863,3.740060392551585,20.0,0.0
43974,4,3974,[302 603 427 100  64],370,5,14868,3.740377358490566,20.0,20.0
43975,4,3975,[196 132 271 423 172],506,5,14873,3.7406941649899395,0.0,0.0
43976,4,3976,[427 117 678 172 143],308,3,14876,3.740507920543123,0.0,0.0
43977,4,3977,[496 197  69 180 234],308,1,14877,3.739819004524887,0.0,0.0
43978,4,3978,[302 603 427 100  64],666,5,14882,3.7401357124905754,20.0,20.0
43979,4,3979,[286   8  56 515 144],328,4,14886,3.7402010050251255,0.0,0.0
43980,4,3980,[  8 318 179 168 216],194,3,14889,3.7400150715900526,20.0,0.0
43981,4,3981,[302 603 427 100  64],90,5,14894,3.7403314917127073,20.0,20.0
43982,4,3982,[302 603 427 100  64],745,5,14899,3.7406477529500375,20.0,20.0
43983,4,3983,[655 257 180 196 144],144,5,14904,3.7409638554216866,0.0,0.0
43984,4,3984,[174 286 196 168 403],254,2,14906,3.740526976160602,0.0,20.0
43985,4,3985,[268 135 273  82 483],13,3,14909,3.7403411941796287,20.0,0.0
43986,4,3986,[302 603 427 100  64],537,4,14913,3.740406320541761,20.0,20.0
43987,4,3987,[135 748   4 125 153],207,3,14916,3.740220661985958,0.0,0.0
43988,4,3988,[194 237  25 423 318],666,1,14917,3.73953371772374,20.0,0.0
43989,4,3989,[  9 300  96 180 168],13,3,14920,3.7393483709273183,0.0,0.0
43990,4,3990,[161 202 174 427  98],833,1,14921,3.738661989476322,0.0,40.0
43991,4,3991,[ 25 748 228 216 678],749,3,14924,3.7384769539078158,0.0,0.0
43992,4,3992,[302 603 427 100  64],13,5,14929,3.738792887553218,20.0,20.0
43993,4,3993,[302 603 427 100  64],458,5,14934,3.7391086629944916,20.0,20.0
43994,4,3994,[515  11 322  97 176],804,5,14939,3.739424280350438,0.0,0.0
43995,4,3995,[483 210  22 216 161],694,5,14944,3.73973973973974,20.0,0.0
43996,4,3996,[186 655   8  22 204],474,5,14949,3.740055041280961,0.0,0.0
43997,4,3997,[385 655 238 176 118],308,4,14953,3.740120060030015,0.0,0.0
43998,4,3998,[ 25 194 257  11  71],804,5,14958,3.740435108777194,0.0,0.0
43999,4,3999,[302 603 427 100  64],13,5,14963,3.74075,20.0,20.0
44000,4,4000,[471 328 172  12 546],533,4,14967,3.7408147963009246,20.0,0.0
44001,4,4001,[238 202 181 496 435],194,3,14970,3.7406296851574212,0.0,0.0
44002,4,4002,[ 95  88 111 215 423],42,4,14974,3.7406944791406445,0.0,0.0
44003,4,4003,[302 603 427 100  64],454,5,14979,3.741008991008991,20.0,20.0
44004,4,4004,[289   4  12 318 191],537,2,14981,3.740574282147316,40.0,0.0
44005,4,4005,[215 151 111 143 265],95,4,14985,3.740639041437843,0.0,0.0
44006,4,4006,[ 56 173   1 435 508],144,5,14990,3.740953331669578,0.0,0.0
44007,4,4007,[ 82 282 385 294 405],804,5,14995,3.74126746506986,0.0,0.0
44008,4,4008,[168 515 222 100  28],474,4,14999,3.741332002993265,0.0,20.0
44009,4,4009,[302 603 427 100  64],458,5,15004,3.741645885286783,20.0,20.0
44010,4,4010,[175 323 151  82  70],881,1,15005,3.7409623535277987,0.0,0.0
44011,4,4011,[195  98  96 143   1],653,3,15008,3.740777666999003,0.0,20.0
44012,4,4012,[216 435 234 508 161],326,0,15008,3.7398455021181163,0.0,0.0
44013,4,4013,[302 603 427 100  64],339,5,15013,3.740159441953164,20.0,20.0
44014,4,4014,[302 603 427 100  64],339,5,15018,3.7404732254047324,20.0,20.0
44015,4,4015,[168 172 181 588  89],882,5,15023,3.7407868525896415,0.0,0.0
44016,4,4016,[168 181 183 151 333],666,2,15025,3.740353497635051,0.0,0.0
44017,4,4017,[202 237 176 294 185],374,3,15028,3.740169238427078,0.0,0.0
44018,4,4018,[302 603 427 100  64],90,5,15033,3.74048270714108,20.0,20.0
44019,4,4019,[196 182 403 265 215],815,4,15037,3.740547263681592,0.0,0.0
44020,4,4020,[302 603 427 100  64],474,5,15042,3.740860482467048,20.0,20.0
44021,4,4021,[302 603 427 100  64],271,5,15047,3.7411735454997515,20.0,20.0
44022,4,4022,[182 273 286 127 403],385,2,15049,3.740740740740741,0.0,20.0
44023,4,4023,[302 603 427 100  64],474,5,15054,3.7410536779324057,20.0,20.0
44024,4,4024,[ 88 228 121 195 742],145,4,15058,3.74111801242236,0.0,0.0
44025,4,4025,[302 603 427 100  64],458,5,15063,3.741430700447094,20.0,20.0
44026,4,4026,[  4 175 173 313 176],474,5,15068,3.7417432331760616,0.0,0.0
44027,4,4027,[196  22 181 200 289],488,2,15070,3.7413108242303874,0.0,0.0
44028,4,4028,[302 603 427 100  64],271,5,15075,3.7416232315711095,20.0,20.0
44029,4,4029,[234 202 318 143 515],234,3,15078,3.741439205955335,20.0,0.0
44030,4,4030,[302 603 427 100  64],370,5,15083,3.7417514264450507,20.0,20.0
44031,4,4031,[181 183  98  56 204],659,4,15087,3.7418154761904763,0.0,20.0
44032,4,4032,[302 603 427 100  64],13,5,15092,3.742127448549467,20.0,20.0
44033,4,4033,[ 98 181  82  69   9],184,3,15095,3.74194348041646,0.0,20.0
44034,4,4034,[302 603 427 100  64],370,5,15100,3.742255266418835,20.0,20.0
44035,4,4035,[ 96 135  11 186 153],13,4,15104,3.7423191278493557,0.0,0.0
44036,4,4036,[282 288 265 289 257],334,2,15106,3.741887540252663,0.0,0.0
44037,4,4037,[515 357 257 265 427],474,4,15110,3.741951461119366,20.0,0.0
44038,4,4038,[222 143 286 186   9],378,3,15113,3.7417677642980935,0.0,0.0
44039,4,4039,[302 603 427 100  64],666,5,15118,3.742079207920792,20.0,20.0
44040,4,4040,[173 195 313   1   4],64,4,15122,3.7421430339024995,0.0,0.0
44041,4,4041,[322 132 176  71 195],804,5,15127,3.7424542305789212,0.0,0.0
44042,4,4042,[435 161 403 172 195],60,4,15131,3.742517932228543,0.0,0.0
44043,4,4043,[302 603 427 100  64],666,5,15136,3.7428288822947575,20.0,20.0
44044,4,4044,[302 603 427 100  64],537,4,15140,3.7428924598269466,20.0,20.0
44045,4,4045,[ 97 175 144 597  15],653,1,15141,3.7422145328719725,0.0,0.0
44046,4,4046,[471 313 333 118 282],533,5,15146,3.7425253274030146,0.0,0.0
44047,4,4047,[483  28 508 318   8],6,3,15149,3.7423418972332017,40.0,0.0
44048,4,4048,[200 405  11 216  88],13,1,15150,3.74166460854532,0.0,0.0
44049,4,4049,[300 151 235 405 678],294,3,15153,3.7414814814814816,0.0,0.0
44050,4,4050,[187 273  28 183 265],13,4,15157,3.7415452974574177,0.0,0.0
44051,4,4051,[ 88 186  50 187  15],648,3,15160,3.7413622902270482,0.0,20.0
44052,4,4052,[132 508 275 655 313],13,3,15163,3.7411793733037255,0.0,0.0
44053,4,4053,[597 121 183 100 228],804,4,15167,3.741243216576221,0.0,20.0
44054,4,4054,[302 603 427 100  64],90,5,15172,3.741553637484587,20.0,20.0
44055,4,4055,[ 71  64  70 182 238],378,4,15176,3.741617357001972,0.0,0.0
44056,4,4056,[496 333 385  89 173],64,3,15179,3.7414345575548436,0.0,0.0
44057,4,4057,[302 603 427 100  64],537,4,15183,3.7414982750123214,20.0,20.0
44058,4,4058,[508 245 235  11 151],334,2,15185,3.7410692288741068,0.0,0.0
44059,4,4059,[302 603 427 100  64],537,4,15189,3.7411330049261085,20.0,20.0
44060,4,4060,[111 121 603 423 385],666,1,15190,3.7404580152671754,20.0,0.0
44061,4,4061,[237 127 125  28 508],6,1,15191,3.739783357951748,0.0,20.0
44062,4,4062,[302 603 427 100  64],664,5,15196,3.7400935269505293,20.0,20.0
44063,4,4063,[302 603 427 100  64],666,5,15201,3.7404035433070866,20.0,20.0
44064,4,4064,[385 405 100 423 603],64,3,15204,3.740221402214022,20.0,20.0
44065,4,4065,[302 603 427 100  64],271,5,15209,3.7405312346286275,20.0,20.0
44066,4,4066,[742 179 191  11  15],59,4,15213,3.7405950331940003,0.0,0.0
44067,4,4067,[ 28 132 568   9  70],194,2,15215,3.740167158308751,0.0,0.0
44068,4,4068,[302 603 427 100  64],664,5,15220,3.7404767756205457,20.0,20.0
44069,4,4069,[238 176 222 603  70],666,4,15224,3.7405405405405405,20.0,0.0
44070,4,4070,[125 588  12 282 172],378,4,15228,3.7406042741341192,20.0,0.0
44071,4,4071,[302 603 427 100  64],13,5,15233,3.7409135559921416,20.0,20.0
44072,4,4072,[ 12   9 179 202 187],271,5,15238,3.7412226859808495,20.0,0.0
44073,4,4073,[ 69 237 546  25  50],194,1,15239,3.740549828178694,0.0,20.0
44074,4,4074,[302 603 427 100  64],370,5,15244,3.7408588957055215,20.0,20.0
44075,4,4075,[121 100 215 216 405],406,2,15246,3.740431795878312,0.0,20.0
44076,4,4076,[302 210 111 300 117],454,3,15249,3.740250183958793,0.0,0.0
44077,4,4077,[172 288 237 202 435],892,5,15254,3.740559097596861,0.0,0.0
44078,4,4078,[302 603 427 100  64],271,5,15259,3.7408678597695513,20.0,20.0
44079,4,4079,[180 237 427  12 228],13,5,15264,3.7411764705882353,20.0,0.0
44080,4,4080,[132 655 234 222 568],339,4,15268,3.7412398921832883,0.0,0.0
44081,4,4081,[ 12 127 144 237   1],883,3,15271,3.7410583047525723,20.0,20.0
44082,4,4082,[302 603 427 100  64],13,5,15276,3.7413666421748712,20.0,20.0
44083,4,4083,[302 603 427 100  64],666,5,15281,3.7416748285994124,20.0,20.0
44084,4,4084,[302 603 427 100  64],370,5,15286,3.741982864137087,20.0,20.0
44085,4,4085,[302 603 427 100  64],13,5,15291,3.7422907488986783,20.0,20.0
44086,4,4086,[568 182 300 176  88],210,5,15296,3.742598482994862,0.0,0.0
44087,4,4087,[186  96  98 204  22],892,4,15300,3.7426614481409004,0.0,20.0
44088,4,4088,[143 655 127 180 313],325,3,15303,3.7424798239178285,0.0,20.0
44089,4,4089,[302 603 427 100  64],474,5,15308,3.7427872860635696,20.0,20.0
44090,4,4090,[483 173 143  96 275],452,3,15311,3.7426057198728917,20.0,0.0
44091,4,4091,[302 603 427 100  64],664,5,15316,3.742913000977517,20.0,20.0
44092,4,4092,[302 603 427 100  64],271,5,15321,3.743220131932568,20.0,20.0
44093,4,4093,[ 28 135 143  11  95],406,3,15324,3.743038593063019,0.0,0.0
44094,4,4094,[172 435 245 117 588],378,3,15327,3.742857142857143,0.0,0.0
44095,4,4095,[ 22 546 655  95  28],95,3,15330,3.74267578125,0.0,0.0
44096,4,4096,[175 182  97 597 183],308,3,15333,3.7424945081767147,0.0,0.0
44097,4,4097,[302 603 427 100  64],339,5,15338,3.7428013665202537,20.0,20.0
44098,4,4098,[183 210  64 195  97],774,1,15339,3.74213222737253,0.0,0.0
44099,4,4099,[546 151 496 216 204],290,3,15342,3.7419512195121953,0.0,0.0
44100,4,4100,[302 603 427 100  64],339,5,15347,3.742257985857108,20.0,20.0
44101,4,4101,[302 603 427 100  64],271,5,15352,3.742564602632862,20.0,20.0
44102,4,4102,[286 121 185  96  97],95,4,15356,3.742627345844504,0.0,0.0
44103,4,4103,[588  12  70  89 182],144,3,15359,3.742446393762183,20.0,0.0
44104,4,4104,[195 597 405 483  25],95,1,15360,3.7417783191230205,20.0,0.0
44105,4,4105,[423 273 174 200 655],378,4,15364,3.7418412079883097,0.0,20.0
44106,4,4106,[302 603 427 100  64],666,5,15369,3.7421475529583637,20.0,20.0
44107,4,4107,[302 603 427 100  64],339,5,15374,3.7424537487828626,20.0,20.0
44108,4,4108,[ 56  89 180  25 186],339,5,15379,3.7427597955706986,0.0,0.0
44109,4,4109,[228 172  95 215 302],664,5,15384,3.743065693430657,0.0,0.0
44110,4,4110,[200 403 258 127 181],843,1,15385,3.7423984432011674,0.0,20.0
44111,4,4111,[405 403 471  56 194],194,2,15387,3.741974708171206,0.0,0.0
44112,4,4112,[196 121 273 288 174],479,4,15391,3.742037442256261,0.0,20.0
44113,4,4113,[238  69 234 187 655],339,5,15396,3.7423432182790473,0.0,0.0
44114,4,4114,[302 603 427 100  64],339,5,15401,3.742648845686513,20.0,20.0
44115,4,4115,[ 25 748 174 655 245],749,4,15405,3.742711370262391,0.0,20.0
44116,4,4116,[302 603 427 100  64],664,5,15410,3.7430167597765363,20.0,20.0
44117,4,4117,[187 423 568   1 168],326,1,15411,3.7423506556580866,0.0,0.0
44118,4,4118,[302 603 427 100  64],271,5,15416,3.7426559844622482,20.0,20.0
44119,4,4119,[153  97 222 182   7],795,2,15418,3.742233009708738,0.0,0.0
44120,4,4120,[202 117 196 258 172],537,1,15419,3.7415675806843,0.0,0.0
44121,4,4121,[288 257 483 269 200],339,4,15423,3.7416302765647744,20.0,0.0
44122,4,4122,[245 181  88 234 273],378,4,15427,3.7416929420325005,0.0,0.0
44123,4,4123,[302 603 427 100  64],271,5,15432,3.7419980601357903,20.0,20.0
44124,4,4124,[282 176 286 318 216],474,5,15437,3.7423030303030305,20.0,0.0
44125,4,4125,[302 603 427 100  64],370,5,15442,3.742607852641784,20.0,20.0
44126,4,4126,[258 313 187 273  50],59,3,15445,3.7424279137387932,0.0,20.0
44127,4,4127,[302 603 427 100  64],666,5,15450,3.7427325581395348,20.0,20.0
44128,4,4128,[ 89  50 403 194  71],648,4,15454,3.7427948655848873,0.0,20.0
44129,4,4129,[ 11  96 186 204  79],308,5,15459,3.743099273607748,0.0,0.0
44130,4,4130,[172  89   8 515 183],200,5,15464,3.7434035342532073,0.0,0.0
44131,4,4131,[302 603 427 100  64],745,5,15469,3.743707647628267,20.0,20.0
44132,4,4132,[302 603 427 100  64],458,5,15474,3.7440116138398256,20.0,20.0
44133,4,4133,[302 603 427 100  64],370,5,15479,3.744315432994678,20.0,20.0
44134,4,4134,[173 238 237  96 121],295,4,15483,3.744377267230955,0.0,0.0
44135,4,4135,[302 603 427 100  64],745,5,15488,3.74468085106383,20.0,20.0
44136,4,4136,[302 603 427 100  64],537,4,15492,3.7447425670775925,20.0,20.0
44137,4,4137,[302 603 427 100  64],666,5,15497,3.7450459159014016,20.0,20.0
44138,4,4138,[568 135 300 546  56],7,5,15502,3.745349118144479,0.0,0.0
44139,4,4139,[183 235 546  69 118],290,3,15505,3.745169082125604,0.0,0.0
44140,4,4140,[302 603 427 100  64],271,5,15510,3.7454721081864286,20.0,20.0
44141,4,4141,[ 71 742 238 237  95],749,2,15512,3.7450507001448576,0.0,0.0
44142,4,4142,[546  88 117 385 275],536,4,15516,3.7451122375090513,0.0,0.0
44143,4,4143,[187 215 435 265  22],308,3,15519,3.7449324324324325,0.0,0.0
44144,4,4144,[302 603 427 100  64],458,5,15524,3.7452352231604342,20.0,20.0
44145,4,4145,[ 88 174 181 204  89],650,4,15528,3.7452966714905935,0.0,20.0
44146,4,4146,[ 70 269 191 496 302],666,5,15533,3.745599228357849,0.0,0.0
44147,4,4147,[ 96 427 191  25 187],650,3,15536,3.7454194792671167,0.0,0.0
44148,4,4148,[191 200 118 195 471],653,3,15539,3.745239816823331,0.0,0.0
44149,4,4149,[222 313 597   7 742],294,4,15543,3.745301204819277,0.0,0.0
44150,4,4150,[302 603 427 100  64],458,5,15548,3.745603469043604,20.0,20.0
44151,4,4151,[302 603 427 100  64],90,5,15553,3.7459055876685934,20.0,20.0
44152,4,4152,[318 182 196 132 222],474,5,15558,3.746207560799422,20.0,0.0
44153,4,4153,[222 483 318 153 268],664,3,15561,3.7460279248916706,40.0,0.0
44154,4,4154,[471   4 186  22 403],788,1,15562,3.745367027677497,0.0,0.0
44155,4,4155,[185 211 257  50 228],804,5,15567,3.7456689124157845,0.0,20.0
44156,4,4156,[234 183 235 151 210],290,2,15569,3.7452489776280973,0.0,0.0
44157,4,4157,[ 11 302 222 294 172],788,1,15570,3.7445887445887447,0.0,0.0
44158,4,4158,[153   4 318  25 185],13,2,15572,3.7441692714594854,20.0,0.0
44159,4,4159,[222 196  71 118 127],311,4,15576,3.7442307692307693,0.0,20.0
44160,4,4160,[302 603 427 100  64],271,5,15581,3.744532564287431,20.0,20.0
44161,4,4161,[302 603 427 100  64],271,5,15586,3.7448342143200386,20.0,20.0
44162,4,4162,[183 357 496 132  12],474,5,15591,3.745135719433101,40.0,0.0
44163,4,4163,[302 603 427 100  64],474,5,15596,3.745437079731028,20.0,20.0
44164,4,4164,[300 302  28 204 183],666,2,15598,3.7450180072028814,0.0,0.0
44165,4,4165,[302 603 427 100  64],474,5,15603,3.745319251080173,20.0,20.0
44166,4,4166,[423 588 174 318 118],194,3,15606,3.7451403887688985,20.0,20.0
44167,4,4167,[322 273 153 435 168],749,5,15611,3.745441458733205,0.0,0.0
44168,4,4168,[117   7 151 174 655],738,3,15614,3.7452626529143678,0.0,20.0
44169,4,4169,[300 318  88   1   4],234,2,15616,3.74484412470024,20.0,0.0
44170,4,4170,[168  69 132 245 403],653,2,15618,3.7444257971709423,0.0,0.0
44171,4,4171,[302 603 427 100  64],537,4,15622,3.7444870565675936,20.0,20.0
44172,4,4172,[302 603 427 100  64],537,4,15626,3.7445482866043616,20.0,20.0
44173,4,4173,[144 174 132   4 100],234,3,15629,3.74436990896023,0.0,40.0
44174,4,4174,[174   8 742 282 153],95,5,15634,3.744670658682635,0.0,20.0
44175,4,4175,[202 172 210 508 273],13,2,15636,3.7442528735632186,0.0,0.0
44176,4,4176,[302 603 427 100  64],370,5,15641,3.7445535073018914,20.0,20.0
44177,4,4177,[176 275 196 151 678],334,3,15644,3.7443752991862134,0.0,0.0
44178,4,4178,[302 603 427 100  64],454,5,15649,3.7446757597511366,20.0,20.0
44179,4,4179,[302 603 427 100  64],664,5,15654,3.744976076555024,20.0,20.0
44180,4,4180,[515 294   9 186 173],406,1,15655,3.744319540779718,0.0,0.0
44181,4,4181,[ 88 175 127  11  69],308,4,15659,3.7443806791009084,0.0,20.0
44182,4,4182,[ 70  69 196 515 174],184,3,15662,3.7442027253167582,0.0,20.0
44183,4,4183,[302 603 427 100  64],454,5,15667,3.7445028680688335,20.0,20.0
44184,4,4184,[302 603 427 100  64],339,5,15672,3.7448028673835125,20.0,20.0
44185,4,4185,[302 603 427 100  64],454,5,15677,3.7451027233635927,20.0,20.0
44186,4,4186,[173   7 117  88 191],234,1,15678,3.7444470981609745,0.0,0.0
44187,4,4187,[210 161 288 176 179],308,4,15682,3.74450811843362,0.0,0.0
44188,4,4188,[318 222   7 423 144],387,2,15684,3.744091668656004,20.0,0.0
44189,4,4189,[ 88  95 144 273   1],234,0,15684,3.743198090692124,0.0,0.0
44190,4,4190,[222 273 289  98 151],374,2,15686,3.742782152230971,0.0,20.0
44191,4,4191,[197  88 423 496 588],311,5,15691,3.7430820610687023,0.0,0.0
44192,4,4192,[181 185 216  11  64],234,1,15692,3.7424278559503934,0.0,0.0
44193,4,4193,[302 603 427 100  64],339,5,15697,3.7427277062470194,20.0,20.0
44194,4,4194,[302 603 427 100  64],339,5,15702,3.7430274135876043,20.0,20.0
44195,4,4195,[125 181 228 265 202],892,4,15706,3.7430886558627265,0.0,0.0
44196,4,4196,[286  96 195  79  88],454,4,15710,3.743149868954015,0.0,0.0
44197,4,4197,[302 603 427 100  64],474,5,15715,3.7434492615531205,20.0,20.0
44198,4,4198,[288 182 318 173 194],804,4,15719,3.743510359609431,20.0,0.0
44199,4,4199,[ 98 204 300 215 180],694,4,15723,3.7435714285714288,0.0,20.0
44200,4,4200,[302 603 427 100  64],664,5,15728,3.7438705070221374,20.0,20.0
44201,4,4201,[197 135  69  97 228],881,1,15729,3.7432175154688245,0.0,0.0
44202,4,4202,[302 603 427 100  64],474,5,15734,3.7435165358077565,20.0,20.0
44203,4,4203,[195   4 204 405 186],833,1,15735,3.7428639391056135,0.0,0.0
44204,4,4204,[121 210  96 588 151],200,4,15739,3.7429250891795482,0.0,0.0
44205,4,4205,[132 176 234 182  88],313,4,15743,3.742986210175939,0.0,0.0
44206,4,4206,[546 187 168  69  64],666,4,15747,3.7430473021155217,0.0,0.0
44207,4,4207,[ 69 435 234 200 597],650,3,15750,3.74287072243346,0.0,0.0
44208,4,4208,[282 678   1   9  22],92,3,15753,3.742694226657163,0.0,0.0
44209,4,4209,[ 79  12 655 275 678],7,4,15757,3.742755344418052,20.0,0.0
44210,4,4210,[ 64 275 186 174 151],6,4,15761,3.7428164331512703,0.0,20.0
44211,4,4211,[181 269 187   8 183],334,4,15765,3.742877492877493,0.0,0.0
44212,4,4212,[186 172 200 210  89],92,4,15769,3.742938523617375,0.0,0.0
44213,4,4213,[ 98 186 174 183   8],298,4,15773,3.742999525391552,0.0,40.0
44214,4,4214,[194 211 403 135 228],398,4,15777,3.7430604982206406,0.0,0.0
44215,4,4215,[172 186 357  50 174],398,5,15782,3.743358633776091,20.0,40.0
44216,4,4216,[748 181  98 197 322],533,4,15786,3.7434194925302346,0.0,20.0
44217,4,4217,[302 603 427 100  64],537,4,15790,3.7434803224276907,20.0,20.0
44218,4,4218,[  4 186 185  70 153],194,3,15793,3.743304100497748,0.0,0.0
44219,4,4219,[  9  82 603 276 515],883,4,15797,3.7433649289099526,20.0,0.0
44220,4,4220,[742  95 235 111 300],271,2,15799,3.742951907131012,0.0,0.0
44221,4,4221,[302 603 427 100  64],454,5,15804,3.743249644718143,20.0,20.0
44222,4,4222,[153 132 210 173  69],643,4,15808,3.743310442813166,0.0,0.0
44223,4,4223,[  8 187 588  71 194],312,5,15813,3.7436079545454546,0.0,0.0
44224,4,4224,[237 135 603 423 187],271,5,15818,3.743905325443787,20.0,0.0
44225,4,4225,[238 117 228 135 202],749,4,15822,3.7439659252247988,0.0,0.0
44226,4,4226,[301 385   8  98 302],378,4,15826,3.7440264963330967,0.0,20.0
44227,4,4227,[187 195 405 172 427],474,5,15831,3.7443235572374647,0.0,0.0
44228,4,4228,[302 603 427 100  64],474,5,15836,3.744620477654292,20.0,20.0
44229,4,4229,[302 603 427 100  64],454,5,15841,3.7449172576832153,20.0,20.0
44230,4,4230,[302 603 427 100  64],13,5,15846,3.7452138974237767,20.0,20.0
44231,4,4231,[302 603 427 100  64],458,5,15851,3.7455103969754253,20.0,20.0
44232,4,4232,[ 98  88 186 117   4],102,2,15853,3.7450980392156863,0.0,20.0
44233,4,4233,[385  50 174  71 435],533,5,15858,3.745394426074634,0.0,40.0
44234,4,4234,[471   8 211 118 195],7,4,15862,3.7454545454545456,0.0,0.0
44235,4,4235,[ 82 117  50   1 121],669,3,15865,3.7452785646836637,0.0,20.0
44236,4,4236,[176 195 275   4 183],406,3,15868,3.7451026669813547,0.0,0.0
44237,4,4237,[302 603 427 100  64],666,5,15873,3.745398773006135,20.0,20.0
44238,4,4238,[144 216 323  50  69],650,2,15875,3.7449870252418025,0.0,20.0
44239,4,4239,[302 603 427 100  64],666,5,15880,3.7452830188679247,20.0,20.0
44240,4,4240,[302 603 427 100  64],90,5,15885,3.745578872907333,20.0,20.0
44241,4,4241,[302 603 427 100  64],339,5,15890,3.745874587458746,20.0,20.0
44242,4,4242,[204 187 427 313 185],890,5,15895,3.7461701626207873,0.0,0.0
44243,4,4243,[423 127  97 176  88],659,4,15899,3.7462299717247878,0.0,20.0
44244,4,4244,[302 603 427 100  64],454,5,15904,3.746525323910483,20.0,20.0
44245,4,4245,[121 322  15  88 100],207,1,15905,3.7458784738577484,0.0,20.0
44246,4,4246,[302 603 427 100  64],664,5,15910,3.7461737697198023,20.0,20.0
44247,4,4247,[302 603 427 100  64],537,4,15914,3.7462335216572504,20.0,20.0
44248,4,4248,[ 95 173  82 183   8],234,2,15916,3.745822546481525,0.0,0.0
44249,4,4249,[302 603 427 100  64],458,5,15921,3.7461176470588233,20.0,20.0
44250,4,4250,[302 603 427 100  64],745,5,15926,3.7464126087979297,20.0,20.0
44251,4,4251,[ 64 194  79 405 211],82,3,15929,3.7462370649106305,0.0,0.0
44252,4,4252,[143  25 288  11 161],13,1,15930,3.74559134728427,0.0,0.0
44253,4,4253,[302 603 427 100  64],537,4,15934,3.745651151857076,20.0,20.0
44254,4,4254,[179 197 508 228 144],13,3,15937,3.745475910693302,0.0,0.0
44255,4,4255,[228  79  56  15 496],82,1,15938,3.7448308270676693,0.0,0.0
44256,4,4256,[196  79   9 100 186],92,5,15943,3.7451256753582336,0.0,20.0
44257,4,4257,[568 403 257  71   1],378,5,15948,3.7454203851573507,0.0,0.0
44258,4,4258,[748 405 173 215 143],648,3,15951,3.7452453627612114,0.0,0.0
44259,4,4259,[302 603 427 100  64],90,5,15956,3.7455399061032866,20.0,20.0
44260,4,4260,[144 100  95   1 204],387,2,15958,3.745130251114762,0.0,20.0
44261,4,4261,[302 603 427 100  64],474,5,15963,3.7454246832473017,20.0,20.0
44262,4,4262,[294  15 235 215 237],378,4,15967,3.7454844006568146,0.0,0.0
44263,4,4263,[302 603 427 100  64],458,5,15972,3.74577861163227,20.0,20.0
44264,4,4264,[176  71 405 215 322],788,3,15975,3.745603751465416,0.0,0.0
44265,4,4265,[238  50 258 144 202],343,5,15980,3.745897796530708,0.0,20.0
44266,4,4266,[168 191 111  97 196],452,4,15984,3.745957347082259,0.0,0.0
44267,4,4267,[301 333 483 302   7],328,3,15987,3.7457825679475163,20.0,0.0
44268,4,4268,[302 603 427 100  64],664,5,15992,3.7460763644881707,20.0,20.0
44269,4,4269,[302 603 427 100  64],339,5,15997,3.7463700234192037,20.0,20.0
44270,4,4270,[302 603 427 100  64],745,5,16002,3.7466635448372747,20.0,20.0
44271,4,4271,[322 195 196 237 245],207,2,16004,3.7462546816479403,0.0,0.0
44272,4,4272,[186 245  96  64 185],488,3,16007,3.7460800374444183,0.0,0.0
44273,4,4273,[222 357 328 117 496],647,3,16010,3.745905474964904,20.0,0.0
44274,4,4274,[ 95 153 176 318 197],804,4,16014,3.745964912280702,20.0,0.0
44275,4,4275,[302 603 427 100  64],664,5,16019,3.7462581852198316,20.0,20.0
44276,4,4276,[302 603 427 100  64],370,5,16024,3.746551321019406,20.0,20.0
44277,4,4277,[144 234 183 181 173],666,2,16026,3.7461430575035064,0.0,0.0
44278,4,4278,[302 603 427 100  64],664,5,16031,3.7464360831970085,20.0,20.0
44279,4,4279,[302 603 427 100  64],666,5,16036,3.7467289719626167,20.0,20.0
44280,4,4280,[302 603 427 100  64],664,5,16041,3.7470217238962857,20.0,20.0
44281,4,4281,[302 603 427 100  64],339,5,16046,3.7473143390938812,20.0,20.0
44282,4,4282,[302 603 427 100  64],666,5,16051,3.747606817651179,20.0,20.0
44283,4,4283,[302 603 427 100  64],666,5,16056,3.7478991596638656,20.0,20.0
44284,4,4284,[302 603 427 100  64],474,5,16061,3.748191365227538,20.0,20.0
44285,4,4285,[302 603 427 100  64],666,5,16066,3.7484834344377043,20.0,20.0
44286,4,4286,[302 603 427 100  64],664,5,16071,3.7487753673897832,20.0,20.0
44287,4,4287,[100 117 180  25 215],537,2,16073,3.748367537313433,0.0,20.0
44288,4,4288,[176 655 196   7 174],881,4,16077,3.748426206574959,0.0,20.0
44289,4,4289,[ 82 111 132 135  11],59,5,16082,3.7487179487179487,0.0,0.0
44290,4,4290,[210 143 172  70  69],334,0,16082,3.7478443253320903,0.0,0.0
44291,4,4291,[121 313 238 237  56],653,3,16085,3.7476700838769803,0.0,0.0
44292,4,4292,[302 603 427 100  64],271,5,16090,3.747961798276264,20.0,20.0
44293,4,4293,[191  98 216  95  97],234,2,16092,3.7475547275267815,0.0,20.0
44294,4,4294,[ 22   1 471 475 328],13,1,16093,3.7469150174621655,0.0,0.0
44295,4,4295,[173 286 202 655 282],666,4,16097,3.746973929236499,0.0,0.0
44296,4,4296,[238  11 215 173  56],897,2,16099,3.746567372585525,0.0,0.0
44297,4,4297,[385  82 215 300 318],313,4,16103,3.7466263378315494,20.0,0.0
44298,4,4298,[302 603 427 100  64],13,5,16108,3.7469178878809024,20.0,20.0
44299,4,4299,[385 222 125 435 183],295,4,16112,3.7469767441860466,0.0,0.0
44300,4,4300,[302 603 427 100  64],458,5,16117,3.7472680771913507,20.0,20.0
44301,4,4301,[333 182 234  95 186],313,3,16120,3.7470943747094374,0.0,0.0
44302,4,4302,[302 603 427 100  64],666,5,16125,3.7473855449686266,20.0,20.0
44303,4,4303,[151 496   4 211 100],653,1,16126,3.7467472118959106,0.0,20.0
44304,4,4304,[302 603 427 100  64],454,5,16131,3.7470383275261323,20.0,20.0
44305,4,4305,[ 56 111 174 235 328],92,2,16133,3.746632605666512,0.0,20.0
44306,4,4306,[ 15  89 187   4 143],653,2,16135,3.7462270722080335,0.0,0.0
44307,4,4307,[182  79 172  69 228],506,5,16140,3.746518105849582,0.0,0.0
44308,4,4308,[200  97 496 121 194],298,4,16144,3.746576932002785,0.0,0.0
44309,4,4309,[276 546  64 215 235],13,3,16147,3.7464037122969835,0.0,0.0
44310,4,4310,[196  82 357 496 483],892,4,16151,3.7464625376942706,40.0,0.0
44311,4,4311,[302 603 427 100  64],664,5,16156,3.7467532467532467,20.0,20.0
44312,4,4312,[302 603 427 100  64],745,5,16161,3.74704382100626,20.0,20.0
44313,4,4313,[302 603 427 100  64],664,5,16166,3.7473342605470563,20.0,20.0
44314,4,4314,[125 405 323 294 546],374,3,16169,3.7471610660486676,0.0,0.0
44315,4,4315,[385  95 153 475  82],308,5,16174,3.747451343836886,0.0,0.0
44316,4,4316,[161 423 204 211   4],318,3,16177,3.747278202455409,0.0,0.0
44317,4,4317,[423  22 234 196 100],263,5,16182,3.747568318666049,0.0,20.0
44318,4,4318,[153  69  28 289   4],387,2,16184,3.7471636952998377,0.0,0.0
44319,4,4319,[302 603 427 100  64],745,5,16189,3.747453703703704,20.0,20.0
44320,4,4320,[302 603 427 100  64],13,5,16194,3.7477435778754917,20.0,20.0
44321,4,4321,[121 196 568 127  70],13,3,16197,3.747570569180935,0.0,20.0
44322,4,4322,[121 153 183 191 175],664,2,16199,3.7471663196854035,0.0,0.0
44323,4,4323,[302 603 427 100  64],454,5,16204,3.74745605920444,20.0,20.0
44324,4,4324,[302 603 427 100  64],339,5,16209,3.7477456647398846,20.0,20.0
44325,4,4325,[302 603 427 100  64],474,5,16214,3.748035136384651,20.0,20.0
44326,4,4326,[194 568 222 258 282],311,5,16219,3.7483244742315693,0.0,0.0
44327,4,4327,[125 228 173  89 195],897,4,16223,3.7483826247689462,0.0,0.0
44328,4,4328,[202 127 483 111 195],833,4,16227,3.7484407484407485,20.0,20.0
44329,4,4329,[ 71 176  25 204 257],95,3,16230,3.748267898383372,0.0,0.0
44330,4,4330,[323 258  64 294  12],788,3,16233,3.7480951281459247,20.0,0.0
44331,4,4331,[302 603 427 100  64],666,5,16238,3.7483841181902124,20.0,20.0
44332,4,4332,[302 603 427 100  64],664,5,16243,3.7486729748442187,20.0,20.0
44333,4,4333,[257 405 121 475 276],569,2,16245,3.7482694970004613,0.0,0.0
44334,4,4334,[423 204 282  50  64],804,4,16249,3.748327566320646,0.0,20.0
44335,4,4335,[302 603 427 100  64],454,5,16254,3.748616236162362,20.0,20.0
44336,4,4336,[200 204 238 111  96],899,4,16258,3.7486741987548995,0.0,0.0
44337,4,4337,[748  64 187 211 318],13,4,16262,3.748732134624251,20.0,0.0
44338,4,4338,[302 603 427 100  64],664,5,16267,3.7490205116386264,20.0,20.0
44339,4,4339,[268 655 496 403   8],387,1,16268,3.7483870967741937,0.0,0.0
44340,4,4340,[302 603 427 100  64],664,5,16273,3.7486754204100436,20.0,20.0
44341,4,4341,[185 144 405 423 546],13,2,16275,3.748272685398434,0.0,0.0
44342,4,4342,[385  25 237 286 423],533,4,16279,3.7483306470181903,0.0,0.0
44343,4,4343,[183   1 276 288 258],455,4,16283,3.748388581952118,0.0,0.0
44344,4,4344,[302 603 427 100  64],745,5,16288,3.7486766398158804,20.0,20.0
44345,4,4345,[ 64 588 222 423 405],892,5,16293,3.7489645651173493,0.0,0.0
44346,4,4346,[211 496 655 186 357],690,4,16297,3.7490223142397054,20.0,0.0
44347,4,4347,[ 97  82 127 174  22],83,5,16302,3.749310027598896,0.0,40.0
44348,4,4348,[234 185  70 151  15],406,3,16305,3.749137732812141,0.0,0.0
44349,4,4349,[ 22 265   8  79 195],234,2,16307,3.7487356321839083,0.0,0.0
44350,4,4350,[237 195 286 302 174],144,4,16311,3.7487933808319926,0.0,20.0
44351,4,4351,[302 603 427 100  64],666,5,16316,3.749080882352941,20.0,20.0
44352,4,4352,[168 127   9 289 174],85,4,16320,3.7491385251550655,0.0,40.0
44353,4,4353,[597 288 197 121 100],308,2,16322,3.748736793752871,0.0,20.0
44354,4,4354,[195 546 151  25 235],339,3,16325,3.748564867967853,0.0,0.0
44355,4,4355,[ 11 132 176  12   8],378,4,16329,3.7486225895316805,20.0,0.0
44356,4,4356,[269 313 185 405 174],145,4,16333,3.748680284599495,0.0,20.0
44357,4,4357,[196  12  98 276  88],538,3,16336,3.7485084901330885,20.0,20.0
44358,4,4358,[302 603 427 100  64],474,5,16341,3.7487955953200274,20.0,20.0
44359,4,4359,[ 98  97 176 237 423],263,4,16345,3.748853211009174,0.0,20.0
44360,4,4360,[275 289 100 121 132],13,3,16348,3.7486814950699383,0.0,20.0
44361,4,4361,[288   4 427 153 196],334,3,16351,3.7485098578633655,0.0,0.0
44362,4,4362,[302 603 427 100  64],745,5,16356,3.74879669951868,20.0,20.0
44363,4,4363,[174 515 179   9 228],380,2,16358,3.74839596700275,0.0,20.0
44364,4,4364,[323 300  28 273 313],537,1,16359,3.747766323024055,0.0,0.0
44365,4,4365,[ 89  50 238 132 748],804,5,16364,3.7480531378836464,0.0,20.0
44366,4,4366,[135 357 258 172 483],13,4,16368,3.748110831234257,40.0,0.0
44367,4,4367,[211 187 483 174  56],749,3,16371,3.7479395604395602,20.0,20.0
44368,4,4368,[125 100  15 195  98],406,4,16375,3.7479972533760586,0.0,40.0
44369,4,4369,[ 89  28 597 328  11],328,3,16378,3.747826086956522,0.0,0.0
44370,4,4370,[111 515 204  82 405],87,5,16383,3.7481125600549072,0.0,0.0
44371,4,4371,[153 175 127 742 182],346,4,16387,3.748170173833486,0.0,20.0
44372,4,4372,[300 508 191  11 121],13,1,16388,3.7475417333638235,0.0,0.0
44373,4,4373,[515 216  98  11 597],145,5,16393,3.747828074988569,0.0,20.0
44374,4,4374,[302 603 427 100  64],474,5,16398,3.7481142857142857,20.0,20.0
44375,4,4375,[302 603 427 100  64],664,5,16403,3.748400365630713,20.0,20.0
44376,4,4376,[183 168 237  12 385],92,5,16408,3.7486863148275074,20.0,0.0
44377,4,4377,[302 603 427 100  64],90,5,16413,3.748972133394244,20.0,20.0
44378,4,4378,[180 191 118  28 176],648,4,16417,3.7490294587805435,0.0,0.0
44379,4,4379,[302 603 427 100  64],271,5,16422,3.749315068493151,20.0,20.0
44380,4,4380,[300 204   1 175 180],788,2,16424,3.748915772654645,0.0,0.0
44381,4,4381,[100 237 302 294 318],328,4,16428,3.7489730716567777,20.0,20.0
44382,4,4382,[471 328 132  89 185],234,1,16429,3.7483458818161077,0.0,0.0
44383,4,4383,[515 211 742   1  64],308,4,16433,3.7484032846715327,0.0,0.0
44384,4,4384,[302 603 427 100  64],271,5,16438,3.7486887115165337,20.0,20.0
44385,4,4385,[302 603 427 100  64],339,5,16443,3.7489740082079344,20.0,20.0
44386,4,4386,[222 268 385 546 286],234,0,16443,3.7481194438112606,0.0,0.0
44387,4,4387,[385 196  28 191 174],7,5,16448,3.748404740200547,0.0,20.0
44388,4,4388,[294 194  89 211  79],406,3,16451,3.7482342219184326,0.0,0.0
44389,4,4389,[302 603 427 100  64],370,5,16456,3.748519362186788,20.0,20.0
44390,4,4390,[748 245 286 118  64],454,3,16459,3.748348895468003,0.0,0.0
44391,4,4391,[302 603 427 100  64],664,5,16464,3.748633879781421,20.0,20.0
44392,4,4392,[302 603 427 100  64],271,5,16469,3.7489187343501023,20.0,20.0
44393,4,4393,[302 603 427 100  64],458,5,16474,3.7492034592626307,20.0,20.0
44394,4,4394,[302 603 427 100  64],13,5,16479,3.7494880546075087,20.0,20.0
44395,4,4395,[202 135 269 121  15],537,1,16480,3.748862602365787,0.0,0.0
44396,4,4396,[174  98 427 117 273],234,2,16482,3.748464862406186,0.0,40.0
44397,4,4397,[268 179  89 204 187],334,5,16487,3.7487494315598,0.0,0.0
44398,4,4398,[568 234 588 237 742],378,5,16492,3.7490338713343943,0.0,0.0
44399,4,4399,[202   8 515  22 186],881,4,16496,3.749090909090909,0.0,0.0
44400,4,4400,[302 603 427 100  64],370,5,16501,3.7493751420131787,20.0,20.0
44401,4,4401,[302 603 427 100  64],666,5,16506,3.749659245797365,20.0,20.0
44402,4,4402,[508  89 294  71   9],406,3,16509,3.7494889847831026,0.0,0.0
44403,4,4403,[121 286 318 194 172],378,5,16514,3.749772933696639,20.0,0.0
44404,4,4404,[302 603 427 100  64],454,5,16519,3.7500567536889897,20.0,20.0
44405,4,4405,[302 603 427 100  64],370,5,16524,3.7503404448479345,20.0,20.0
44406,4,4406,[ 56   7  64 185 435],833,2,16526,3.7499432720671657,0.0,0.0
44407,4,4407,[216 196 237  69 238],234,1,16527,3.7493194192377497,0.0,0.0
44408,4,4408,[496   7 289 143  50],378,4,16531,3.749376275799501,0.0,20.0
44409,4,4409,[302 603 427 100  64],666,5,16536,3.749659863945578,20.0,20.0
44410,4,4410,[125  22 238  12 204],406,2,16538,3.749263205622308,20.0,0.0
44411,4,4411,[568 195 318 235 180],524,3,16541,3.74909338168631,20.0,0.0
44412,4,4412,[294 427 603  25 435],650,3,16544,3.748923634715613,20.0,0.0
44413,4,4413,[302 603 427 100  64],745,5,16549,3.749207068418668,20.0,20.0
44414,4,4414,[302 603 427 100  64],745,5,16554,3.7494903737259344,20.0,20.0
44415,4,4415,[403 176  12 435 191],506,5,16559,3.7497735507246377,20.0,0.0
44416,4,4416,[202 235   9 183 237],308,3,16562,3.7496038034865293,0.0,0.0
44417,4,4417,[182 183 276 153 185],398,5,16567,3.7498868266183796,0.0,0.0
44418,4,4418,[222 258 180  96 211],882,4,16571,3.7499434261145055,0.0,0.0
44419,4,4419,[183 202  25 286 216],537,0,16571,3.7490950226244344,0.0,0.0
44420,4,4420,[180 210 195 135 496],848,2,16573,3.748699389278444,0.0,0.0
44421,4,4421,[302 603 427 100  64],474,5,16578,3.7489823609226596,20.0,20.0
44422,4,4422,[302 603 427 100  64],13,5,16583,3.749265204612254,20.0,20.0
44423,4,4423,[302 603 427 100  64],666,5,16588,3.7495479204339963,20.0,20.0
44424,4,4424,[302 603 427 100  64],454,5,16593,3.7498305084745764,20.0,20.0
44425,4,4425,[597  79 202 515   1],308,3,16596,3.7496610935381836,0.0,0.0
44426,4,4426,[357 204 597 125  56],59,3,16599,3.74949175513892,20.0,0.0
44427,4,4427,[302 603 427 100  64],271,5,16604,3.749774164408311,20.0,20.0
44428,4,4428,[302 603 427 100  64],339,5,16609,3.7500564461503725,20.0,20.0
44429,4,4429,[302 603 427 100  64],90,5,16614,3.7503386004514674,20.0,20.0
44430,4,4430,[197 125 144 237   7],144,4,16618,3.750394944707741,0.0,0.0
44431,4,4431,[125 172 228 222 121],648,4,16622,3.750451263537906,0.0,0.0
44432,4,4432,[144 202 117 678 174],749,4,16626,3.7505075569591697,0.0,20.0
44433,4,4433,[294 100  97 288 194],82,4,16630,3.7505638249887236,0.0,20.0
44434,4,4434,[  8 216 111  25 265],234,1,16631,3.7499436302142053,0.0,0.0
44435,4,4435,[ 56 185  89   9 318],543,4,16635,3.75,20.0,0.0
44436,4,4436,[302 603 427 100  64],537,4,16639,3.7500563443768313,20.0,20.0
44437,4,4437,[181 132 234 143  79],378,5,16644,3.750337990085624,0.0,0.0
44438,4,4438,[118 215 496 176 216],7,3,16647,3.750168956972291,0.0,0.0
44439,4,4439,[ 56 515  15  11 588],892,4,16651,3.750225225225225,0.0,0.0
44440,4,4440,[515 118 385  89 405],638,3,16654,3.750056293627561,0.0,0.0
44441,4,4441,[179  64 238 185 748],653,3,16657,3.74988743809095,0.0,0.0
44442,4,4442,[ 50  79  97 328 195],537,1,16658,3.7492685122664864,0.0,20.0
44443,4,4443,[211 588 185 546 215],7,5,16663,3.7495499549954996,0.0,0.0
44444,4,4444,[258 117 269 403   1],339,2,16665,3.7491563554555682,0.0,0.0
44445,4,4445,[235 288  96 172 515],882,3,16668,3.748987854251012,0.0,0.0
44446,4,4446,[302 603 427 100  64],666,5,16673,3.7492691702271195,20.0,20.0
44447,4,4447,[118 742 168  88  22],308,4,16677,3.7493255395683454,0.0,0.0
44448,4,4448,[302 603 427 100  64],537,4,16681,3.7493818835693413,20.0,20.0
44449,4,4449,[302 603 427 100  64],537,4,16685,3.749438202247191,20.0,20.0
44450,4,4450,[181 183 176 202  88],13,4,16689,3.749494495618962,0.0,0.0
44451,4,4451,[258   8 603 197 202],90,3,16692,3.7493261455525606,20.0,0.0
44452,4,4452,[496 471 288 195   7],666,3,16695,3.749157871098136,0.0,0.0
44453,4,4453,[127 176 238 323 515],311,4,16699,3.7492141894925908,0.0,20.0
44454,4,4454,[302 603 427 100  64],537,4,16703,3.749270482603816,20.0,20.0
44455,4,4455,[194 289 100 180 176],406,4,16707,3.7493267504488332,0.0,20.0
44456,4,4456,[483 515 222 204 286],881,4,16711,3.749382993044649,20.0,0.0
44457,4,4457,[181 143  97   7  95],537,1,16712,3.7487662628981604,0.0,0.0
44458,4,4458,[742 100 194  64   1],378,5,16717,3.749046871495851,0.0,20.0
44459,4,4459,[269 275   1 235 597],145,3,16720,3.7488789237668163,0.0,0.0
44460,4,4460,[302 603 427 100  64],664,5,16725,3.7491593813046404,20.0,20.0
44461,4,4461,[176 191 471 405 117],13,0,16725,3.7483191393993724,0.0,0.0
44462,4,4462,[ 88 168  15 546 215],60,5,16730,3.748599596683845,0.0,0.0
44463,4,4463,[182 125 210  15   4],207,3,16733,3.748431899641577,0.0,0.0
44464,4,4464,[302 603 427 100  64],90,5,16738,3.7487122060470326,20.0,20.0
44465,4,4465,[302 603 427 100  64],339,5,16743,3.7489923869234216,20.0,20.0
44466,4,4466,[282   7  96 483 191],804,5,16748,3.749272442355048,20.0,0.0
44467,4,4467,[ 89  28  71 127 153],313,3,16751,3.749104744852283,0.0,20.0
44468,4,4468,[427 275 216 100 273],308,3,16754,3.748937122398747,0.0,20.0
44469,4,4469,[302 603 427 100  64],664,5,16759,3.7492170022371365,20.0,20.0
44470,4,4470,[302 603 427 100  64],271,5,16764,3.749496756877656,20.0,20.0
44471,4,4471,[302 603 427 100  64],664,5,16769,3.7497763864042932,20.0,20.0
44472,4,4472,[302 603 427 100  64],454,5,16774,3.750055890900961,20.0,20.0
44473,4,4473,[172 135 202 300 175],234,1,16775,3.7494412159141706,0.0,0.0
44474,4,4474,[302 603 427 100  64],664,5,16780,3.7497206703910613,20.0,20.0
44475,4,4475,[294 181 200 742 186],666,1,16781,3.749106344950849,0.0,0.0
44476,4,4476,[302 603 427 100  64],537,4,16785,3.749162385526022,20.0,20.0
44477,4,4477,[427 202 357 180 100],90,4,16789,3.749218401071907,20.0,20.0
44478,4,4478,[597   1  97 187 273],13,2,16791,3.7488278633623575,0.0,0.0
44479,4,4479,[603 153 318 405 210],64,1,16792,3.7482142857142855,40.0,0.0
44480,4,4480,[302 603 427 100  64],13,5,16797,3.748493639812542,20.0,20.0
44481,4,4481,[265 135 191 187 200],537,3,16800,3.748326639892905,0.0,0.0
44482,4,4482,[211 258 176 257 204],653,1,16801,3.747713584653134,0.0,0.0
44483,4,4483,[328 546  79 182 200],378,2,16803,3.7473238180196256,0.0,0.0
44484,4,4484,[427 153 135  56  96],313,3,16806,3.7471571906354515,0.0,0.0
44485,4,4485,[275 210 435 546 195],298,3,16809,3.7469906375390103,0.0,0.0
44486,4,4486,[496  12 197   9 294],533,5,16814,3.7472698907956317,20.0,0.0
44487,4,4487,[302 603 427 100  64],664,5,16819,3.747549019607843,20.0,20.0
44488,4,4488,[302 603 427 100  64],745,5,16824,3.74782802405881,20.0,20.0
44489,4,4489,[302 603 427 100  64],271,5,16829,3.748106904231626,20.0,20.0
44490,4,4490,[302 603 427 100  64],90,5,16834,3.7483856602093075,20.0,20.0
44491,4,4491,[ 50 215 515 276 508],59,5,16839,3.7486642920747997,0.0,20.0
44492,4,4492,[483 238  98 258 121],537,3,16842,3.748497663031382,20.0,20.0
44493,4,4493,[234  69 323  64 182],474,4,16846,3.7485536270582998,0.0,0.0
44494,4,4494,[181 191 276 125 228],92,5,16851,3.7488320355951057,0.0,0.0
44495,4,4495,[ 25 194   9   7 100],474,5,16856,3.7491103202846974,0.0,20.0
44496,4,4496,[174 678  88  15  25],537,0,16856,3.748276628863687,0.0,20.0
44497,4,4497,[302 603 427 100  64],454,5,16861,3.7485549132947975,20.0,20.0
44498,4,4498,[180 385 588 117 176],650,3,16864,3.7483885307846188,0.0,0.0
44499,4,4499,[302 603 427 100  64],664,5,16869,3.748666666666667,20.0,20.0
44500,4,4500,[302 603 427 100  64],339,5,16874,3.748944678960231,20.0,20.0
44501,4,4501,[  9  11 286 180 202],378,2,16876,3.7485561972456685,0.0,0.0
44502,4,4502,[  9 471  50 186 118],648,4,16880,3.7486120364201643,0.0,20.0
44503,4,4503,[127 175 100 161 289],13,4,16884,3.7486678507992894,0.0,40.0
44504,4,4504,[403  69  71 275 135],843,1,16885,3.7480577136514985,0.0,0.0
44505,4,4505,[216 496 143 276 211],474,5,16890,3.748335552596538,0.0,0.0
44506,4,4506,[183 151 273 288  50],64,3,16893,3.7481695140891946,0.0,20.0
44507,4,4507,[151 405 333 483  88],537,1,16894,3.7475598935226264,20.0,0.0
44508,4,4508,[186 427 187  28 302],833,1,16895,3.746950543357729,0.0,0.0
44509,4,4509,[318 187 435 175 197],387,2,16897,3.7465631929046563,20.0,0.0
44510,4,4510,[ 15 216 301 100 276],234,1,16898,3.7459543338505874,0.0,20.0
44511,4,4511,[ 79  82 151 427   7],788,2,16900,3.745567375886525,0.0,0.0
44512,4,4512,[302 603 427 100  64],90,5,16905,3.7458453356968757,20.0,20.0
44513,4,4513,[515 238  11 748  96],883,4,16909,3.7459016393442623,0.0,0.0
44514,4,4514,[302 603 427 100  64],537,4,16913,3.7459579180509412,20.0,20.0
44515,4,4515,[ 64 286 195 405 196],378,3,16916,3.745792736935341,0.0,0.0
44516,4,4516,[204 286 568 132 174],200,5,16921,3.746070400708435,0.0,20.0
44517,4,4517,[216 546 282 385  98],92,3,16924,3.7459052678176183,0.0,20.0
44518,4,4518,[302 603 427 100  64],454,5,16929,3.746182783801726,20.0,20.0
44519,4,4519,[183  28 191  12 197],308,3,16932,3.7460176991150442,20.0,0.0
44520,4,4520,[302 603 427 100  64],474,5,16937,3.7462950674629507,20.0,20.0
44521,4,4521,[181  89 289 286 313],328,5,16942,3.7465723131357804,0.0,0.0
44522,4,4522,[216 182 403 435 125],234,0,16942,3.745743975237674,0.0,0.0
44523,4,4523,[196 174  12 182 238],454,1,16943,3.745137046861185,20.0,20.0
44524,4,4524,[302 603 427 100  64],339,5,16948,3.745414364640884,20.0,20.0
44525,4,4525,[228 180 181 678 234],881,2,16950,3.7450287229341583,0.0,0.0
44526,4,4526,[302 603 427 100  64],666,5,16955,3.7453059421250274,20.0,20.0
44527,4,4527,[215 286 194 185  64],95,4,16959,3.745362190812721,0.0,0.0
44528,4,4528,[ 89 568 135 597  11],92,3,16962,3.7451976153676307,0.0,0.0
44529,4,4529,[322 176  89 288 202],804,4,16966,3.745253863134658,0.0,0.0
44530,4,4530,[ 64 118 210 258 234],738,4,16970,3.7453100860737143,0.0,0.0
44531,4,4531,[302 603 427 100  64],339,5,16975,3.7455869373345103,20.0,20.0
44532,4,4532,[121 313 597 125 258],168,4,16979,3.745643061989852,0.0,0.0
44533,4,4533,[186  79 111 318  50],13,3,16982,3.74547860608734,20.0,20.0
44534,4,4534,[  4 181 323 742  95],378,3,16985,3.745314222712238,0.0,0.0
44535,4,4535,[  9 471 135 237 276],13,3,16988,3.7451499118165783,0.0,0.0
44536,4,4536,[179  89 269 286 222],666,4,16992,3.7452060833149656,0.0,0.0
44537,4,4537,[ 15   8 125 179 234],271,3,16995,3.74504186866461,0.0,0.0
44538,4,4538,[302 603 427 100  64],745,5,17000,3.745318352059925,20.0,20.0
44539,4,4539,[  1 195 546 175  79],378,3,17003,3.7451541850220265,0.0,0.0
44540,4,4540,[ 79 286 211 748 182],474,4,17007,3.745210306099978,0.0,0.0
44541,4,4541,[ 70 258 405 181 271],119,3,17010,3.7450462351387053,0.0,0.0
44542,4,4542,[183 197 151 318 175],738,5,17015,3.7453224741360334,20.0,0.0
44543,4,4543,[187 245 597 603 238],804,4,17019,3.7453785211267605,20.0,0.0
44544,4,4544,[302 127 187 186  98],346,1,17020,3.744774477447745,0.0,40.0
44545,4,4545,[196  98 471 313 269],232,2,17022,3.744390673119226,0.0,20.0
44546,4,4546,[182 222 271 235  96],64,4,17026,3.7444468880580604,0.0,0.0
44547,4,4547,[127 121 238 275 100],13,3,17029,3.744283201407212,0.0,40.0
44548,4,4548,[ 28   8 175 174 211],7,5,17034,3.744559243789844,0.0,20.0
44549,4,4549,[302 603 427 100  64],271,5,17039,3.7448351648351648,20.0,20.0
44550,4,4550,[ 98 300 191 151  28],378,4,17043,3.744891232696111,0.0,20.0
44551,4,4551,[302 603 427 100  64],666,5,17048,3.7451669595782073,20.0,20.0
44552,4,4552,[100 435 194  71 288],378,4,17052,3.745222929936306,0.0,20.0
44553,4,4553,[302 603 427 100  64],271,5,17057,3.7454984628897674,20.0,20.0
44554,4,4554,[228 268 235 294 265],145,5,17062,3.7457738748627882,0.0,0.0
44555,4,4555,[ 96 185 323 286 300],90,3,17065,3.7456101843722562,0.0,0.0
44556,4,4556,[ 97 186 423  50   1],194,2,17067,3.7452271231073073,0.0,20.0
44557,4,4557,[328 210  28 117 196],13,2,17069,3.744844229925406,0.0,0.0
44558,4,4558,[ 70  15 288 194 238],215,1,17070,3.744242158368063,0.0,0.0
44559,4,4559,[286 237   9 515 200],271,5,17075,3.744517543859649,0.0,0.0
44560,4,4560,[302 603 427 100  64],271,5,17080,3.7447928085946063,20.0,20.0
44561,4,4561,[300 196   4 216 333],537,0,17080,3.7439719421306443,0.0,0.0
44562,4,4562,[289 210 234 135 143],374,3,17083,3.7438088976550516,0.0,0.0
44563,4,4563,[302 603 427 100  64],90,5,17088,3.7440841367221736,20.0,20.0
44564,4,4564,[546  88 405   7 144],653,0,17088,3.743263964950712,0.0,0.0
44565,4,4565,[ 25 237 423  12 301],234,1,17089,3.742663162505475,20.0,0.0
44566,4,4566,[546 286  22 258 471],7,5,17094,3.7429384716444054,0.0,0.0
44567,4,4567,[180 132 313 273 515],92,4,17098,3.7429947460595447,0.0,0.0
44568,4,4568,[385 161 235 215 427],328,1,17099,3.7423943970234186,0.0,0.0
44569,4,4569,[  8 237 168 405 179],13,3,17102,3.742231947483589,0.0,0.0
44570,4,4570,[302 603 427 100  64],666,5,17107,3.7425071100415663,20.0,20.0
44571,4,4571,[323 174 186 588 403],254,1,17108,3.741907261592301,0.0,20.0
44572,4,4572,[302 603 427 100  64],664,5,17113,3.7421823748086593,20.0,20.0
44573,4,4573,[515 323   1 228 197],883,4,17117,3.7422387407083515,0.0,0.0
44574,4,4574,[302 603 427 100  64],454,5,17122,3.7425136612021856,20.0,20.0
44575,4,4575,[288 195 588 357  25],537,1,17123,3.741914335664336,20.0,0.0
44576,4,4576,[302 603 427 100  64],370,5,17128,3.7421892069040856,20.0,20.0
44577,4,4577,[238 143 300 318   9],311,4,17132,3.742245522062036,20.0,0.0
44578,4,4578,[302 603 427 100  64],474,5,17137,3.7425202009172307,20.0,20.0
44579,4,4579,[302 603 427 100  64],90,5,17142,3.7427947598253275,20.0,20.0
44580,4,4580,[302 603 427 100  64],370,5,17147,3.7430691988648768,20.0,20.0
44581,4,4581,[ 15 515 423  98 182],271,3,17150,3.7429070274989087,0.0,20.0
44582,4,4582,[186 211 216  79 276],385,0,17150,3.7420903338424614,0.0,0.0
44583,4,4583,[111 204 385 197 328],533,5,17155,3.7423647469458987,0.0,0.0
44584,4,4584,[265 183 187  97 174],7,5,17160,3.742639040348964,0.0,20.0
44585,4,4585,[294 748 385 121 168],311,5,17165,3.7429132141299606,0.0,0.0
44586,4,4586,[475 211 271 328 100],699,2,17167,3.7425332461303684,0.0,20.0
44587,4,4587,[302 603 427 100  64],458,5,17172,3.742807323452485,20.0,20.0
44588,4,4588,[748 210 318 151  82],883,4,17176,3.742863368925692,20.0,0.0
44589,4,4589,[313  98 427 286 483],90,5,17181,3.743137254901961,20.0,20.0
44590,4,4590,[302 603 427 100  64],458,5,17186,3.7434110215639294,20.0,20.0
44591,4,4591,[ 69 181 286   1 144],234,1,17187,3.7428135888501743,0.0,0.0
44592,4,4592,[286 228 172  28 403],387,3,17190,3.742651861528413,0.0,0.0
44593,4,4593,[302 603 427 100  64],370,5,17195,3.742925555071833,20.0,20.0
44594,4,4594,[ 79 276 143 302 288],339,4,17199,3.742981501632209,0.0,0.0
44595,4,4595,[483  96 195 185 238],311,4,17203,3.743037423846823,20.0,0.0
44596,4,4596,[405 117  98 204 515],643,1,17204,3.7424407222101372,0.0,20.0
44597,4,4597,[302 603 427 100  64],454,5,17209,3.742714223575468,20.0,20.0
44598,4,4598,[302 603 427 100  64],339,5,17214,3.7429876060013045,20.0,20.0
44599,4,4599,[ 96  98 144 403 195],346,3,17217,3.7428260869565215,0.0,20.0
44600,4,4600,[168  97 195 471   8],308,3,17220,3.7426646381221476,0.0,0.0
44601,4,4601,[357 471 100  50  28],537,3,17223,3.742503259452412,20.0,40.0
44602,4,4602,[302 603 427 100  64],458,5,17228,3.7427764501412124,20.0,20.0
44603,4,4603,[302 603 427 100  64],271,5,17233,3.743049522154648,20.0,20.0
44604,4,4604,[265   4 179 216 194],650,3,17236,3.742888165038002,0.0,0.0
44605,4,4605,[  4  50  56 238 186],774,2,17238,3.742509769865393,0.0,20.0
44606,4,4606,[302 603 427 100  64],666,5,17243,3.7427827219448666,20.0,20.0
44607,4,4607,[302 603 427 100  64],666,5,17248,3.7430555555555554,20.0,20.0
44608,4,4608,[302 603 427 100  64],454,5,17253,3.7433282707745716,20.0,20.0
44609,4,4609,[302 603 427 100  64],454,5,17258,3.7436008676789587,20.0,20.0
44610,4,4610,[ 50  88  96 183 294],474,4,17262,3.7436564736499673,0.0,20.0
44611,4,4611,[176 200  70 597 180],213,4,17266,3.743712055507372,0.0,0.0
44612,4,4612,[ 12  96  50 174 179],60,5,17271,3.7439843919358333,20.0,40.0
44613,4,4613,[302 603 427 100  64],664,5,17276,3.744256610316428,20.0,20.0
44614,4,4614,[302 603 427 100  64],339,5,17281,3.744528710725894,20.0,20.0
44615,4,4615,[302 603 427 100  64],13,5,17286,3.7448006932409013,20.0,20.0
44616,4,4616,[180   9 121 234 423],881,3,17289,3.7446393762183234,0.0,0.0
44617,4,4617,[302 603 427 100  64],458,5,17294,3.744911216977046,20.0,20.0
44618,4,4618,[302 603 427 100  64],664,5,17299,3.7451829400303094,20.0,20.0
44619,4,4619,[100  96 258   7 182],234,1,17300,3.7445887445887447,0.0,20.0
44620,4,4620,[ 64 211 174 172 318],91,4,17304,3.7446440164466566,20.0,20.0
44621,4,4621,[204 265 405 187 269],537,1,17305,3.7440501947209,0.0,0.0
44622,4,4622,[302 603 427 100  64],339,5,17310,3.744321868916288,20.0,20.0
44623,4,4623,[173   1  22  88 403],749,5,17315,3.744593425605536,0.0,0.0
44624,4,4624,[302 603 427 100  64],13,5,17320,3.744864864864865,20.0,20.0
44625,4,4625,[302 603 427 100  64],339,5,17325,3.745136186770428,20.0,20.0
44626,4,4626,[427 234 597 191 302],833,1,17326,3.7445429003674087,0.0,0.0
44627,4,4627,[200 282 237 118  82],378,4,17330,3.7445980985306826,0.0,0.0
44628,4,4628,[180  96 182 176 153],328,3,17333,3.744437243465111,0.0,0.0
44629,4,4629,[ 69 187 117  98 175],13,4,17337,3.7444924406047515,0.0,20.0
44630,4,4630,[603 302 100 427  64],537,4,17341,3.744547613906284,20.0,20.0
44631,4,4631,[603 302 100 427  64],666,5,17346,3.744818652849741,20.0,20.0
44632,4,4632,[257 258 180 276 546],339,4,17350,3.74487373192316,0.0,0.0
44633,4,4633,[603 302 100 427  64],666,5,17355,3.7451445835131634,20.0,20.0
44634,4,4634,[ 70  98 289  79   7],328,5,17360,3.7454153182308523,0.0,20.0
44635,4,4635,[111 215 182 202   4],533,3,17363,3.7452545297670405,0.0,0.0
44636,4,4636,[300  22 597 127 200],455,4,17367,3.745309467328014,0.0,20.0
44637,4,4637,[216 182  82 357  56],85,3,17370,3.7451487710219924,20.0,0.0
44638,4,4638,[294 176 132  64 118],13,3,17373,3.744988143996551,0.0,0.0
44639,4,4639,[603 302 100 427  64],458,5,17378,3.745258620689655,20.0,20.0
44640,4,4640,[ 22 176 191 121 168],7,4,17382,3.7453135100193924,0.0,0.0
44641,4,4641,[ 15 135 403 172 117],650,3,17385,3.745152951314089,0.0,0.0
44642,4,4642,[603 302 100 427  64],454,5,17390,3.7454232177471463,20.0,20.0
44643,4,4643,[182 211 187  95 427],537,4,17394,3.7454780361757107,0.0,0.0
44644,4,4644,[  9  50 117 475 273],92,5,17399,3.7457481162540365,0.0,20.0
44645,4,4645,[182 202  50 153 328],833,2,17401,3.745372363323289,0.0,20.0
44646,4,4646,[300  28 333 127  15],537,1,17402,3.7447815795136647,0.0,20.0
44647,4,4647,[202   7  98 302  82],883,3,17405,3.7446213425129087,0.0,20.0
44648,4,4648,[175 211 222 143 183],339,5,17410,3.7448913744891374,0.0,0.0
44649,4,4649,[  1 216 258 204 333],533,5,17415,3.7451612903225806,0.0,0.0
44650,4,4650,[  1 172  82 265  50],234,1,17416,3.7445710599870994,0.0,20.0
44651,4,4651,[496  15 597 179 385],308,2,17418,3.744196044711952,0.0,0.0
44652,4,4652,[183  71 121 151  12],59,4,17422,3.7442510208467654,20.0,0.0
44653,4,4653,[403 385  89 238 176],234,0,17422,3.743446497636442,0.0,0.0
44654,4,4654,[289 204 318 286  64],85,4,17426,3.743501611170784,20.0,0.0
44655,4,4655,[568 222 288 132 234],92,2,17428,3.743127147766323,0.0,0.0
44656,4,4656,[ 71   1 301  97 204],234,0,17428,3.742323384152888,0.0,0.0
44657,4,4657,[357 127 471 286 174],648,2,17430,3.741949334478317,20.0,40.0
44658,4,4658,[100 435 121  56 181],313,4,17434,3.7420047220433568,0.0,20.0
44659,4,4659,[185 174 153 132 161],454,2,17436,3.7416309012875537,0.0,20.0
44660,4,4660,[603 302 100 427  64],90,5,17441,3.7419008796395623,20.0,20.0
44661,4,4661,[ 96 313 182 176 211],650,4,17445,3.7419562419562418,0.0,0.0
44662,4,4662,[258 111 151  71 357],533,3,17448,3.741797126313532,20.0,0.0
44663,4,4663,[117 288 742 238   7],387,2,17450,3.741423670668954,0.0,0.0
44664,4,4664,[603 302 100 427  64],666,5,17455,3.7416934619506965,20.0,20.0
44665,4,4665,[237  96 258 257 568],749,3,17458,3.7415345049292754,0.0,0.0
44666,4,4666,[  7  69 202 151 181],882,5,17463,3.7418041568459395,0.0,0.0
44667,4,4667,[ 15 125 508 143 423],207,5,17468,3.7420736932305054,0.0,0.0
44668,4,4668,[603 302 100 427  64],454,5,17473,3.742343114157207,20.0,20.0
44669,4,4669,[ 95 655 111 276 568],537,1,17474,3.7417558886509634,0.0,0.0
44670,4,4670,[238  96 228  89 153],892,4,17478,3.7418111753371868,0.0,0.0
44671,4,4671,[ 71 191 125 196 318],295,5,17483,3.7420804794520546,20.0,0.0
44672,4,4672,[385 318 181 234   1],374,3,17486,3.74192167772309,20.0,0.0
44673,4,4673,[202   1 288 135 143],892,4,17490,3.741976893453145,0.0,0.0
44674,4,4674,[603 302 100 427  64],474,5,17495,3.742245989304813,20.0,20.0
44675,4,4675,[603 302 100 427  64],664,5,17500,3.7425149700598803,20.0,20.0
44676,4,4676,[603 302 100 427  64],13,5,17505,3.7427838357921743,20.0,20.0
44677,4,4677,[603 302 100 427  64],458,5,17510,3.74305258657546,20.0,20.0
44678,4,4678,[603 302 100 427  64],458,5,17515,3.7433212224834365,20.0,20.0
44679,4,4679,[603 302 100 427  64],370,5,17520,3.7435897435897436,20.0,20.0
44680,4,4680,[603 302 100 427  64],370,5,17525,3.7438581499679557,20.0,20.0
44681,4,4681,[603 302 100 427  64],474,5,17530,3.7441264416915847,20.0,20.0
44682,4,4682,[603 302 100 427  64],13,5,17535,3.7443946188340806,20.0,20.0
44683,4,4683,[  7   1 161 215  95],380,2,17537,3.74402220324509,0.0,0.0
44684,4,4684,[603 302 100 427  64],271,5,17542,3.744290288153682,20.0,20.0
44685,4,4685,[202 151 161  69  95],59,3,17545,3.744131455399061,0.0,0.0
44686,4,4686,[603 302 100 427  64],90,5,17550,3.7443994026029443,20.0,20.0
44687,4,4687,[603 302 100 427  64],271,5,17555,3.7446672354948807,20.0,20.0
44688,4,4688,[175 357 742  96  95],804,4,17559,3.7447216890595008,20.0,0.0
44689,4,4689,[215   4 121 427 328],13,4,17563,3.744776119402985,0.0,0.0
44690,4,4690,[603 302 100 427  64],271,5,17568,3.7450437007034747,20.0,20.0
44691,4,4691,[151  95 603 423 153],648,3,17571,3.7448849104859336,20.0,0.0
44692,4,4692,[313 117 197 191  28],543,3,17574,3.7447261879394844,0.0,0.0
44693,4,4693,[182 204 215 286 179],85,5,17579,3.7449936088623774,0.0,0.0
44694,4,4694,[  1  70 182 183 405],788,3,17582,3.7448349307774227,0.0,0.0
44695,4,4695,[183  12  56 222 678],548,5,17587,3.7451022146507666,20.0,0.0
44696,4,4696,[144 515 405 257 175],213,4,17591,3.745156482861401,0.0,0.0
44697,4,4697,[603 302 100 427  64],370,5,17596,3.7454235845040444,20.0,20.0
44698,4,4698,[546 182  70 196  64],271,3,17599,3.7452649499893593,0.0,0.0
44699,4,4699,[174 127 196 568   9],343,4,17603,3.7453191489361704,0.0,40.0
44700,4,4700,[603 302 100 427  64],454,5,17608,3.7455860455222294,20.0,20.0
44701,4,4701,[603 302 100 427  64],745,5,17613,3.7458528285835815,20.0,20.0
44702,4,4702,[603 302 100 427  64],454,5,17618,3.746119498192643,20.0,20.0
44703,4,4703,[200 222 508 121   7],537,2,17620,3.745748299319728,0.0,0.0
44704,4,4704,[273  50 180 568 289],387,3,17623,3.7455897980871415,0.0,20.0
44705,4,4705,[475 222 238 161 176],479,3,17626,3.7454313642158947,0.0,0.0
44706,4,4706,[ 98 185 597 323 161],650,1,17627,3.744848098576588,0.0,20.0
44707,4,4707,[294 168 194 191 121],308,3,17630,3.7446898895497025,0.0,0.0
44708,4,4708,[318  69 655 289 175],232,4,17634,3.7447441070290934,20.0,0.0
44709,4,4709,[603 302 100 427  64],664,5,17639,3.745010615711253,20.0,20.0
44710,4,4710,[234 100 273  25 194],537,1,17640,3.7444279346210996,0.0,20.0
44711,4,4711,[211  96 222 202 179],406,3,17643,3.744269949066214,0.0,0.0
44712,4,4712,[603 496 135 234 301],90,5,17648,3.744536388712073,20.0,0.0
44713,4,4713,[ 69 125 180 237 603],533,3,17651,3.744378447178617,20.0,0.0
44714,4,4714,[603 302 100 427  64],90,5,17656,3.744644750795334,20.0,20.0
44715,4,4715,[333  70 210  97 475],64,2,17658,3.7442748091603053,0.0,0.0
44716,4,4716,[235 185 127 496   8],385,4,17662,3.7443290226839094,0.0,20.0
44717,4,4717,[475 678  82 496 200],339,4,17666,3.744383213225943,0.0,0.0
44718,4,4718,[603 302 100 427  64],454,5,17671,3.7446492901038355,20.0,20.0
44719,4,4719,[405 435  96 204 195],474,5,17676,3.7449152542372883,0.0,0.0
44720,4,4720,[603 302 100 427  64],537,4,17680,3.744969286168185,20.0,20.0
44721,4,4721,[ 79 323  89 173 603],13,2,17682,3.744599745870394,20.0,0.0
44722,4,4722,[603 302 100 427  64],271,5,17687,3.7448655515562144,20.0,20.0
44723,4,4723,[185  95 168 194  56],650,2,17689,3.7444961896697713,0.0,0.0
44724,4,4724,[294 204  50 216  70],374,3,17692,3.7443386243386243,0.0,20.0
44725,4,4725,[603 302 100 427  64],458,5,17697,3.7446043165467624,20.0,20.0
44726,4,4726,[603 302 100 427  64],745,5,17702,3.7448698963401736,20.0,20.0
44727,4,4727,[182 265 271 186 180],13,4,17706,3.74492385786802,0.0,0.0
44728,4,4728,[603 302 100 427  64],664,5,17711,3.745189257771199,20.0,20.0
44729,4,4729,[215 300 216 471  64],313,5,17716,3.7454545454545456,0.0,0.0
44730,4,4730,[238 121 228 210  50],158,5,17721,3.74571972098922,0.0,20.0
44731,4,4731,[234 288 173 423 385],378,4,17725,3.745773457311919,0.0,0.0
44732,4,4732,[211  11 276  95 121],537,2,17727,3.745404605958166,0.0,0.0
44733,4,4733,[144 234 273  79 182],7,4,17731,3.7454583861427966,0.0,0.0
44734,4,4734,[603 302 100 427  64],454,5,17736,3.745723336853221,20.0,20.0
44735,4,4735,[603 302 100 427  64],664,5,17741,3.745988175675676,20.0,20.0
44736,4,4736,[ 71 276 483 191  22],13,4,17745,3.746041798606713,20.0,0.0
44737,4,4737,[  4 588 228  69  82],7,4,17749,3.7460953989024905,0.0,0.0
44738,4,4738,[357 588 235  96 294],479,2,17751,3.7457269466132095,20.0,0.0
44739,4,4739,[181 245 176 211 153],488,3,17754,3.7455696202531645,0.0,0.0
44740,4,4740,[603 302 100 427  64],370,5,17759,3.7458342121915207,20.0,20.0
44741,4,4741,[294 546 234 181 568],7,3,17762,3.745676929565584,0.0,0.0
44742,4,4742,[234 268  69 357  79],7,4,17766,3.74573055028463,20.0,0.0
44743,4,4743,[ 98  70 185 302 118],328,4,17770,3.7457841483979766,0.0,20.0
44744,4,4744,[ 98  50  25 237 144],308,2,17772,3.7454162276080085,0.0,40.0
44745,4,4745,[185 265 183 655 151],379,5,17777,3.7456805731142016,0.0,0.0
44746,4,4746,[603 302 100 427  64],474,5,17782,3.745944807246682,20.0,20.0
44747,4,4747,[603 302 100 427  64],339,5,17787,3.7462089300758215,20.0,20.0
44748,4,4748,[286 300 603 127  69],13,3,17790,3.746051800379027,20.0,20.0
44749,4,4749,[313 238 181  25 435],474,5,17795,3.7463157894736843,0.0,0.0
44750,4,4750,[258  56 182 313 271],13,4,17799,3.7463691854346455,0.0,0.0
44751,4,4751,[603 302 100 427  64],339,5,17804,3.7466329966329965,20.0,20.0
44752,4,4752,[302 194  11 568 655],207,4,17808,3.7466863033873343,0.0,0.0
44753,4,4753,[405 603 176 195 151],666,2,17810,3.7463188893563317,20.0,0.0
44754,4,4754,[191 483 135  56  22],804,3,17813,3.746161934805468,20.0,0.0
44755,4,4755,[475   9 202 357 211],13,2,17815,3.7457947855340623,20.0,0.0
44756,4,4756,[174  70 313 135 191],334,4,17819,3.7458482236703805,0.0,20.0
44757,4,4757,[202  96  15 196 204],479,4,17823,3.7459016393442623,0.0,0.0
44758,4,4758,[ 50 403  98 204  22],536,4,17827,3.7459550325698676,0.0,40.0
44759,4,4759,[333 294 742 748   4],881,2,17829,3.7455882352941177,0.0,0.0
44760,4,4760,[ 70 222 153 173 186],210,5,17834,3.745851711825247,0.0,0.0
44761,4,4761,[215 423  69 182  50],774,3,17837,3.745695086098278,0.0,20.0
44762,4,4762,[435  82 568  70 168],506,5,17842,3.7459584295612007,0.0,0.0
44763,4,4763,[ 22   1  25 174 546],749,4,17846,3.7460117548278755,0.0,20.0
44764,4,4764,[603 302 100 427  64],370,5,17851,3.746274921301154,20.0,20.0
44765,4,4765,[603 302 100 427  64],666,5,17856,3.746537977339488,20.0,20.0
44766,4,4766,[183   9 603 174 118],145,3,17859,3.7463813719320327,20.0,20.0
44767,4,4767,[603 302 100 427  64],271,5,17864,3.7466442953020134,20.0,20.0
44768,4,4768,[121  28  56 135 175],843,2,17866,3.746278045711889,0.0,0.0
44769,4,4769,[603 302 100 427  64],90,5,17871,3.7465408805031446,20.0,20.0
44770,4,4770,[234 289 186   1 288],234,2,17873,3.7461748061203104,0.0,0.0
44771,4,4771,[ 56  15 288  97 237],378,4,17877,3.746227996647108,0.0,0.0
44772,4,4772,[204 427 357 118 185],59,5,17882,3.746490676723235,20.0,0.0
44773,4,4773,[405 423 181  97 196],804,4,17886,3.7465437788018434,0.0,0.0
44774,4,4774,[483 181 151 271 111],833,3,17889,3.7463874345549737,20.0,0.0
44775,4,4775,[288 568 313 180  64],308,4,17893,3.7464405360134005,0.0,0.0
44776,4,4776,[597 179 403   7  79],378,3,17896,3.7462842788360895,0.0,0.0
44777,4,4777,[546  70 174   4 318],271,4,17900,3.7463373796567603,20.0,20.0
44778,4,4778,[603 302 100 427  64],90,5,17905,3.7465997070516845,20.0,20.0
44779,4,4779,[234 515  89 405 475],474,5,17910,3.7468619246861925,0.0,0.0
44780,4,4780,[603 302 100 427  64],339,5,17915,3.747124032629157,20.0,20.0
44781,4,4781,[405  56 588  88  50],378,4,17919,3.747176913425345,0.0,20.0
44782,4,4782,[ 79  12 423  69 568],343,4,17923,3.747229772109555,20.0,0.0
44783,4,4783,[603 302 100 427  64],537,4,17927,3.7472826086956523,20.0,20.0
44784,4,4784,[603 302 100 427  64],370,5,17932,3.747544409613375,20.0,20.0
44785,4,4785,[ 64 435 300 471 100],378,4,17936,3.7475971583786043,0.0,20.0
44786,4,4786,[603 302 100 427  64],370,5,17941,3.747858784207228,20.0,20.0
44787,4,4787,[603 302 100 427  64],13,5,17946,3.7481203007518795,20.0,20.0
44788,4,4788,[181 269 300 215 275],64,4,17950,3.748172896220505,0.0,0.0
44789,4,4789,[ 79 195 194 288  71],387,2,17952,3.7478079331941543,0.0,0.0
44790,4,4790,[173 176 435 182 216],749,4,17956,3.7478605719056564,0.0,0.0
44791,4,4791,[603 302 100 427  64],474,5,17961,3.7481218697829717,20.0,20.0
44792,4,4792,[603 302 100 427  64],13,5,17966,3.7483830586271645,20.0,20.0
44793,4,4793,[ 22  56 151  95 655],378,4,17970,3.748435544430538,0.0,0.0
44794,4,4794,[603 302 100 427  64],474,5,17975,3.748696558915537,20.0,20.0
44795,4,4795,[282 173   7 183 185],95,4,17979,3.748748957464554,0.0,0.0
44796,4,4796,[196 435  70  50 234],840,4,17983,3.748801334167188,0.0,20.0
44797,4,4797,[275  56 603 568 135],308,5,17988,3.7490621092121716,20.0,0.0
44798,4,4798,[235 172 483  96 403],308,3,17991,3.748906022087935,20.0,0.0
44799,4,4799,[603 302 100 427  64],339,5,17996,3.7491666666666665,20.0,20.0
44800,4,4800,[603 302 100 427  64],454,5,18001,3.7494272026661113,20.0,20.0
44801,4,4801,[603 302 100 427  64],745,5,18006,3.7496876301541024,20.0,20.0
44802,4,4802,[ 95   1 117  69 135],454,1,18007,3.7491151363731,0.0,0.0
44803,4,4803,[603 302 100 427  64],537,4,18011,3.7491673605328892,20.0,20.0
44804,4,4804,[  1  25  70 300 357],13,0,18011,3.7483870967741937,20.0,0.0
44805,4,4805,[ 50  28 423 180 318],271,5,18016,3.748647523928423,20.0,20.0
44806,4,4806,[ 56 194  64 143 289],234,3,18019,3.7484917828167257,0.0,0.0
44807,4,4807,[603 302 100 427  64],664,5,18024,3.7487520798668883,20.0,20.0
44808,4,4808,[603 302 100 427  64],454,5,18029,3.7490122686629235,20.0,20.0
44809,4,4809,[176 204  88 318 238],648,3,18032,3.748856548856549,20.0,0.0
44810,4,4810,[179 269 168  50 235],325,3,18035,3.7487008937850756,0.0,20.0
44811,4,4811,[603 302 100 427  64],454,5,18040,3.748960931005819,20.0,20.0
44812,4,4812,[ 69 423 318 515  70],13,2,18042,3.7485975483066696,20.0,0.0
44813,4,4813,[603 302 100 427  64],454,5,18047,3.7488574989613626,20.0,20.0
44814,4,4814,[191 211 271 210 135],290,2,18049,3.7484942886812047,0.0,0.0
44815,4,4815,[603 302 100 427  64],474,5,18054,3.74875415282392,20.0,20.0
44816,4,4816,[265  22  95  15 197],830,4,18058,3.748806310981939,0.0,0.0
44817,4,4817,[603 302 100 427  64],271,5,18063,3.74906600249066,20.0,20.0
44818,4,4818,[ 95 151 185 318 235],537,2,18065,3.7487030504253993,20.0,0.0
44819,4,4819,[ 12   7 435  89 288],833,2,18067,3.7483402489626556,20.0,0.0
44820,4,4820,[182 318 508  50 357],184,5,18072,3.748599875544493,40.0,20.0
44821,4,4821,[183 144 172 276 268],13,5,18077,3.7488593944421402,0.0,0.0
44822,4,4822,[603 302 100 427  64],664,5,18082,3.7491188057225795,20.0,20.0
44823,4,4823,[678 238 603 144   1],13,2,18084,3.7487562189054726,20.0,0.0
44824,4,4824,[ 69 286  22 195 135],474,5,18089,3.749015544041451,0.0,0.0
44825,4,4825,[603 302 100 427  64],454,5,18094,3.7492747617074182,20.0,20.0
44826,4,4826,[132   9 174 144  22],308,3,18097,3.74911953594365,0.0,20.0
44827,4,4827,[300 357   4 515 435],7,4,18101,3.7491714995857497,20.0,0.0
44828,4,4828,[269 237 186 245 282],378,3,18104,3.7490163594947195,0.0,0.0
44829,4,4829,[357 174 318 185 211],454,2,18106,3.7486542443064184,40.0,20.0
44830,4,4830,[603 302 100 427  64],666,5,18111,3.748913268474436,20.0,20.0
44831,4,4831,[202 258 185 515 200],271,3,18114,3.7487582781456954,0.0,0.0
44832,4,4832,[182 215 176  25 603],59,5,18119,3.749017173598179,20.0,0.0
44833,4,4833,[603 302 100 427  64],664,5,18124,3.7492759619362848,20.0,20.0
44834,4,4834,[508  22 288 435 286],474,3,18127,3.749120992761117,0.0,0.0
44835,4,4835,[151 144  79  64   7],64,3,18130,3.748966087675765,0.0,0.0
44836,4,4836,[176 742 222 323 153],650,3,18133,3.7488112466404795,0.0,0.0
44837,4,4837,[742   1  50 174 546],899,3,18136,3.7486564696155438,0.0,40.0
44838,4,4838,[187 496  69 127 143],90,4,18140,3.7487084108286837,0.0,20.0
44839,4,4839,[603 302 100 427  64],537,4,18144,3.7487603305785124,20.0,20.0
44840,4,4840,[403 182 597 168 475],92,4,18148,3.748812228878331,0.0,0.0
44841,4,4841,[181  50 118 144 210],295,4,18152,3.748864105741429,0.0,20.0
44842,4,4842,[234 322 194 471 216],313,4,18156,3.748915961181086,0.0,0.0
44843,4,4843,[483 546 202 143   1],194,2,18158,3.7485549132947975,20.0,0.0
44844,4,4844,[603 302 100 427  64],370,5,18163,3.748813209494324,20.0,20.0
44845,4,4845,[ 82  11 748 286  69],207,1,18164,3.7482459760627322,0.0,0.0
44846,4,4846,[117 282   4 288  95],92,3,18167,3.7480916030534353,0.0,0.0
44847,4,4847,[357  50 143 168  64],881,3,18170,3.747937293729373,20.0,20.0
44848,4,4848,[216  97 183 191 132],406,4,18174,3.74798927613941,0.0,0.0
44849,4,4849,[603 302 100 427  64],745,5,18179,3.7482474226804126,20.0,20.0
44850,4,4850,[200 173 228 748  12],13,3,18182,3.748093176664605,20.0,0.0
44851,4,4851,[180 403 678 475 195],92,4,18186,3.7481450948062656,0.0,0.0
44852,4,4852,[496 276  12  89 282],406,4,18190,3.7481969915516173,20.0,0.0
44853,4,4853,[496 333  88 161  98],533,5,18195,3.7484548825710755,0.0,20.0
44854,4,4854,[655  89 181  69  50],144,4,18199,3.7485066941297633,0.0,20.0
44855,4,4855,[655 143 125 197 385],749,4,18203,3.7485584843492585,0.0,0.0
44856,4,4856,[603 302 100 427  64],458,5,18208,3.748816141651225,20.0,20.0
44857,4,4857,[185 195  25 357 135],537,3,18211,3.748662000823384,20.0,0.0
44858,4,4858,[  7 748 185 215  95],881,3,18214,3.7485079234410374,0.0,0.0
44859,4,4859,[125 195 222 265  50],897,4,18218,3.748559670781893,0.0,20.0
44860,4,4860,[ 98 153 161 300 475],13,3,18221,3.748405677844065,0.0,20.0
44861,4,4861,[568  79 187  64  82],194,2,18223,3.7480460715754833,0.0,0.0
44862,4,4862,[174 118 125 655  98],295,4,18227,3.748097881965865,0.0,40.0
44863,4,4863,[211 222 427 318 195],406,4,18231,3.7481496710526314,20.0,0.0
44864,4,4864,[603 302 100 427  64],271,5,18236,3.7484069886947586,20.0,20.0
44865,4,4865,[234 508   4 211  69],774,1,18237,3.747842170160296,0.0,0.0
44866,4,4866,[238  11 546 185 180],653,1,18238,3.747277583727142,0.0,0.0
44867,4,4867,[ 70  79  98 179  97],13,2,18240,3.7469186524239935,0.0,20.0
44868,4,4868,[238 282 183 276  79],92,5,18245,3.747176011501335,0.0,0.0
44869,4,4869,[435  69 475 187 100],533,4,18249,3.7472279260780286,0.0,20.0
44870,4,4870,[603 302 100 427  64],458,5,18254,3.7474851159926095,20.0,20.0
44871,4,4871,[603 302 100 427  64],666,5,18259,3.7477422003284073,20.0,20.0
44872,4,4872,[323 597 181 678 288],548,4,18263,3.747793966755592,0.0,0.0
44873,4,4873,[183 318 238 211 483],234,3,18266,3.7476405416495693,40.0,0.0
44874,4,4874,[ 25 172  95 471 294],882,4,18270,3.747692307692308,0.0,0.0
44875,4,4875,[603 302 100 427  64],745,5,18275,3.747949138638228,20.0,20.0
44876,4,4876,[603 302 100 427  64],664,5,18280,3.7482058642608163,20.0,20.0
44877,4,4877,[483 135 161 174 403],881,3,18283,3.748052480524805,20.0,20.0
44878,4,4878,[174 403 144 405  69],92,4,18287,3.7481041196966594,0.0,20.0
44879,4,4879,[ 96 168 568  22  28],64,5,18292,3.748360655737705,0.0,0.0
44880,4,4880,[237 195 282  28 323],378,3,18295,3.7482073345625895,0.0,0.0
44881,4,4881,[318 175 427 333  89],13,3,18298,3.7480540761982795,20.0,0.0
44882,4,4882,[257 234  64 235 318],213,4,18302,3.7481056727421667,20.0,0.0
44883,4,4883,[ 56   9 357 318 132],6,5,18307,3.7483619983619985,40.0,0.0
44884,4,4884,[276 286  28 228 216],406,1,18308,3.747799385875128,0.0,0.0
44885,4,4885,[603 302 100 427  64],13,5,18313,3.7480556692591076,20.0,20.0
44886,4,4886,[405 143 237   9 186],406,1,18314,3.7474933497032943,0.0,0.0
44887,4,4887,[603 302 100 427  64],271,5,18319,3.7477495908346974,20.0,20.0
44888,4,4888,[603 302 100 427  64],458,5,18324,3.748005727142565,20.0,20.0
44889,4,4889,[603 302 100 427  64],339,5,18329,3.7482617586912066,20.0,20.0
44890,4,4890,[294 186 282 121 204],533,4,18333,3.7483132283786547,0.0,0.0
44891,4,4891,[ 56 180 435 238 405],378,2,18335,3.7479558462796403,0.0,0.0
44892,4,4892,[ 25 655 174 678 195],92,3,18338,3.747802983854486,0.0,20.0
44893,4,4893,[603 302 100 427  64],664,5,18343,3.7480588475684513,20.0,20.0
44894,4,4894,[603 302 100 427  64],339,5,18348,3.748314606741573,20.0,20.0
44895,4,4895,[603 302 100 427  64],90,5,18353,3.7485702614379086,20.0,20.0
44896,4,4896,[603 302 100 427  64],664,5,18358,3.748825811721462,20.0,20.0
44897,4,4897,[603 302 100 427  64],745,5,18363,3.749081257656186,20.0,20.0
44898,4,4898,[245  82 161 185 204],313,3,18366,3.748928352725046,0.0,0.0
44899,4,4899,[  1  96 117 125 202],653,3,18369,3.748775510204082,0.0,0.0
44900,4,4900,[333 288 742 258 294],488,4,18373,3.748826770046929,0.0,0.0
44901,4,4901,[257 183 405 403 238],334,4,18377,3.7488780089759284,0.0,0.0
44902,4,4902,[  4  22 568 423 496],59,5,18382,3.749133183765042,0.0,0.0
44903,4,4903,[183 228 496  96 144],488,3,18385,3.7489804241435563,0.0,0.0
44904,4,4904,[185 153 183 588 181],406,4,18389,3.749031600407747,0.0,0.0
44905,4,4905,[603 302 100 427  64],271,5,18394,3.74928658785161,20.0,20.0
44906,4,4906,[603 302 100 427  64],13,5,18399,3.749541471367434,20.0,20.0
44907,4,4907,[603 302 100 427  64],745,5,18404,3.749796251018745,20.0,20.0
44908,4,4908,[237   8 313 471  69],308,1,18405,3.7492360969647587,0.0,0.0
44909,4,4909,[385 269 204 328 286],207,1,18406,3.74867617107943,0.0,0.0
44910,4,4910,[603 302 100 427  64],454,5,18411,3.748930971288943,20.0,20.0
44911,4,4911,[  4 423 121  98 302],537,1,18412,3.748371335504886,0.0,20.0
44912,4,4912,[597 186  22 273 176],328,3,18415,3.748219010787706,0.0,0.0
44913,4,4913,[357  22 100 195 273],10,5,18420,3.7484737484737485,20.0,20.0
44914,4,4914,[603 302 100 427  64],13,5,18425,3.7487283825025433,20.0,20.0
44915,4,4915,[313 289  79 258 245],328,5,18430,3.7489829129373473,0.0,0.0
44916,4,4916,[603 302 100 427  64],474,5,18435,3.7492373398413665,20.0,20.0
44917,4,4917,[235 546  98 403 200],774,1,18436,3.7486783245221633,0.0,20.0
44918,4,4918,[  4 496 210   8 215],7,5,18441,3.7489327099003864,0.0,0.0
44919,4,4919,[173 515 211 275  97],7,4,18445,3.7489837398373984,0.0,0.0
44920,4,4920,[603 302 100 427  64],454,5,18450,3.7492379597642755,20.0,20.0
44921,4,4921,[603 302 100 427  64],454,5,18455,3.749492076391711,20.0,20.0
44922,4,4922,[ 82 151 405 328 294],554,4,18459,3.749542961608775,0.0,0.0
44923,4,4923,[603 302 100 427  64],454,5,18464,3.749796913078798,20.0,20.0
44924,4,4924,[187 405 302 322 216],524,4,18468,3.7498477157360406,0.0,0.0
44925,4,4925,[603 302 100 427  64],90,5,18473,3.7501015022330493,20.0,20.0
44926,4,4926,[228 568  95 597  22],200,5,18478,3.750355185711386,0.0,0.0
44927,4,4927,[181 135 427 294 144],666,2,18480,3.75,0.0,0.0
44928,4,4928,[  1 173  12  97 357],271,4,18484,3.7500507202272266,40.0,0.0
44929,4,4929,[187   9  96 132 515],59,5,18489,3.7503042596348886,0.0,0.0
44930,4,4930,[117  98 318 568 385],328,3,18492,3.750152098965727,20.0,20.0
44931,4,4931,[603 302 100 427  64],664,5,18497,3.750405515004055,20.0,20.0
44932,4,4932,[176 173  98  89 121],538,3,18500,3.750253395499696,0.0,20.0
44933,4,4933,[202 196 191 403 144],738,4,18504,3.75030401297122,0.0,0.0
44934,4,4934,[655 204 268 180 125],7,4,18508,3.750354609929078,0.0,0.0
44935,4,4935,[258 204 222 245 427],328,2,18510,3.75,0.0,0.0
44936,4,4936,[111 268 196 135 197],13,5,18515,3.7502531901964757,0.0,0.0
44937,4,4937,[603 302 100 427  64],537,4,18519,3.750303766707169,20.0,20.0
44938,4,4938,[302 515 288 322 237],486,4,18523,3.750354322737396,0.0,0.0
44939,4,4939,[197 174 403 121 257],210,5,18528,3.7506072874493928,0.0,20.0
44940,4,4940,[435  71 471  97 286],533,4,18532,3.7506577615867234,0.0,0.0
44941,4,4941,[ 95 238 475 175 269],13,2,18534,3.7503035208417645,0.0,0.0
44942,4,4942,[211 202  50 435 496],59,5,18539,3.7505563423022457,0.0,20.0
44943,4,4943,[603 302 100 427  64],537,4,18543,3.750606796116505,20.0,20.0
44944,4,4944,[ 95 237 318 111 328],92,1,18544,3.7500505561172903,20.0,0.0
44945,4,4945,[603 302 100 427  64],458,5,18549,3.7503032753740397,20.0,20.0
44946,4,4946,[117 185 265 191 194],537,2,18551,3.749949464321811,0.0,0.0
44947,4,4947,[603 302 100 427  64],370,5,18556,3.7502021018593372,20.0,20.0
44948,4,4948,[603 302 100 427  64],474,5,18561,3.750454637300465,20.0,20.0
44949,4,4949,[269 655 588 175 276],14,5,18566,3.7507070707070707,0.0,0.0
44950,4,4950,[568 172 200  25 204],313,3,18569,3.750555443344779,0.0,0.0
44951,4,4951,[176 181 180 323 496],488,3,18572,3.750403877221325,0.0,0.0
44952,4,4952,[603 302 100 427  64],454,5,18577,3.7506561679790025,20.0,20.0
44953,4,4953,[172 111  22 200 357],479,5,18582,3.750908356883327,20.0,0.0
44954,4,4954,[603 302 100 427  64],13,5,18587,3.7511604439959636,20.0,20.0
44955,4,4955,[144 475 258  82 172],13,3,18590,3.7510088781275224,0.0,0.0
44956,4,4956,[603 302 100 427  64],90,5,18595,3.7512608432519667,20.0,20.0
44957,4,4957,[603 302 100 427  64],745,5,18600,3.7515127067365874,20.0,20.0
44958,4,4958,[603 302 100 427  64],458,5,18605,3.7517644686428717,20.0,20.0
44959,4,4959,[200 678 186  25   9],881,0,18605,3.751008064516129,0.0,0.0
44960,4,4960,[172 173  69  95 174],848,4,18609,3.751058254384197,0.0,20.0
44961,4,4961,[268 228 678  89 286],387,2,18611,3.7507053607416365,0.0,0.0
44962,4,4962,[603 302 100 427  64],454,5,18616,3.750957082409833,20.0,20.0
44963,4,4963,[603 302 100 427  64],537,4,18620,3.7510072522159548,20.0,20.0
44964,4,4964,[568 405 174 238 742],488,2,18622,3.750654582074522,0.0,20.0
44965,4,4965,[603 302 100 427  64],458,5,18627,3.7509061619009265,20.0,20.0
44966,4,4966,[603 302 100 427  64],474,5,18632,3.751157640426817,20.0,20.0
44967,4,4967,[603 302 100 427  64],537,4,18636,3.751207729468599,20.0,20.0
44968,4,4968,[385 228 301 216 235],537,0,18636,3.7504528074059165,0.0,0.0
44969,4,4969,[603 302 100 427  64],271,5,18641,3.750704225352113,20.0,20.0
44970,4,4970,[603 302 100 427  64],13,5,18646,3.7509555421444376,20.0,20.0
44971,4,4971,[ 95 211 183 210  96],234,1,18647,3.750402252614642,0.0,0.0
44972,4,4972,[603 302 100 427  64],664,5,18652,3.7506535290569074,20.0,20.0
44973,4,4973,[187 143 173 191 195],13,1,18653,3.7501005227181343,0.0,0.0
44974,4,4974,[603 302 100 427  64],474,5,18658,3.7503517587939696,20.0,20.0
44975,4,4975,[603 302 100 427  64],339,5,18663,3.750602893890675,20.0,20.0
44976,4,4976,[181  97  95 210 197],454,3,18666,3.7504520795660037,0.0,0.0
44977,4,4977,[603 302 100 427  64],458,5,18671,3.750703093611892,20.0,20.0
44978,4,4978,[276  50 546 294   4],194,2,18673,3.75035147620004,0.0,20.0
44979,4,4979,[175 196 210 111 235],378,4,18677,3.7504016064257026,0.0,0.0
44980,4,4980,[175 100  98 568 275],7,5,18682,3.750652479421803,0.0,40.0
44981,4,4981,[515 179  56  71 153],843,1,18683,3.7501003613006825,0.0,0.0
44982,4,4982,[ 12  25 238  22 216],194,3,18686,3.749949829420028,20.0,0.0
44983,4,4983,[603 302 100 427  64],90,5,18691,3.750200642054575,20.0,20.0
44984,4,4984,[603 302 100 427  64],13,5,18696,3.7504513540621867,20.0,20.0
44985,4,4985,[187 135 289 168  98],881,3,18699,3.750300842358604,0.0,20.0
44986,4,4986,[603 302 100 427  64],458,5,18704,3.750551433727692,20.0,20.0
44987,4,4987,[603 302 100 427  64],370,5,18709,3.750801924619086,20.0,20.0
44988,4,4988,[ 11  28  71 174 143],406,2,18711,3.750450992182802,0.0,20.0
44989,4,4989,[ 88 100 237 118  56],374,4,18715,3.750501002004008,0.0,20.0
44990,4,4990,[603 302 100 427  64],474,5,18720,3.750751352434382,20.0,20.0
44991,4,4991,[144   9 471 153  56],378,4,18724,3.750801282051282,0.0,0.0
44992,4,4992,[195  89 405 318 234],346,3,18727,3.750650911275786,20.0,0.0
44993,4,4993,[603 302 100 427  64],13,5,18732,3.750901081297557,20.0,20.0
44994,4,4994,[603 302 100 427  64],454,5,18737,3.7511511511511513,20.0,20.0
44995,4,4995,[603 302 100 427  64],13,5,18742,3.7514011208967175,20.0,20.0
44996,4,4996,[300 268 187  89 182],537,4,18746,3.7514508705223135,0.0,0.0
44997,4,4997,[385 117 235 202 121],343,2,18748,3.7511004401760704,0.0,0.0
44998,4,4998,[210 588 185 176 275],537,2,18750,3.750750150030006,0.0,0.0
44999,4,4999,[  8 282 385 127 135],194,1,18751,3.7502,0.0,20.0
45000,4,5000,[ 15 515 475  22 273],537,2,18753,3.7498500299940014,0.0,0.0
45001,4,5001,[234 173 172  79 168],650,4,18757,3.7499000399840066,0.0,0.0
45002,4,5002,[603 302 100 427  64],666,5,18762,3.7501499100539677,20.0,20.0
45003,4,5003,[603 302 100 427  64],454,5,18767,3.7503996802557955,20.0,20.0
45004,4,5004,[603 302 100 427  64],664,5,18772,3.7506493506493506,20.0,20.0
45005,4,5005,[603 302 100 427  64],339,5,18777,3.750898921294447,20.0,20.0
45006,4,5006,[ 64 117 333 176   1],144,4,18781,3.7509486718593967,0.0,0.0
45007,4,5007,[204 168 357 153  50],194,3,18784,3.7507987220447285,20.0,20.0
45008,4,5008,[ 28   4 313 222 678],474,4,18788,3.750848472749052,0.0,0.0
45009,4,5009,[603 302 100 427  64],537,4,18792,3.7508982035928145,20.0,20.0
45010,4,5010,[603 302 100 427  64],664,5,18797,3.7511474755537817,20.0,20.0
45011,4,5011,[ 56 117 742 597 265],533,2,18799,3.7507980845969673,0.0,0.0
45012,4,5012,[322 194 195  69 258],537,1,18800,3.7502493516856172,0.0,0.0
45013,4,5013,[197  28 180 211 187],694,5,18805,3.7504986039090547,0.0,0.0
45014,4,5014,[603 302 100 427  64],664,5,18810,3.7507477567298104,20.0,20.0
45015,4,5015,[423 183  50 483 187],311,5,18815,3.7509968102073366,20.0,20.0
45016,4,5016,[ 82 471   8  69 176],308,3,18818,3.750847119792705,0.0,0.0
45017,4,5017,[237 174 183 742 234],788,2,18820,3.7504982064567556,0.0,20.0
45018,4,5018,[603 302 100 427  64],339,5,18825,3.7507471607890017,20.0,20.0
45019,4,5019,[168  95 245  70 435],804,3,18828,3.750597609561753,0.0,0.0
45020,4,5020,[ 15   1 161 191 132],200,5,18833,3.7508464449312884,0.0,0.0
45021,4,5021,[603 302 100 427  64],666,5,18838,3.7510951812027082,20.0,20.0
45022,4,5022,[508  70 181 161   4],533,4,18842,3.751144734222576,0.0,0.0
45023,4,5023,[202 385 328 237 333],533,4,18846,3.7511942675159236,0.0,0.0
45024,4,5024,[515 186   8 423  50],60,4,18850,3.7512437810945274,0.0,20.0
45025,4,5025,[603 302 100 427  64],90,5,18855,3.751492240350179,20.0,20.0
45026,4,5026,[194 471 216 174 172],378,4,18859,3.7515416749552415,0.0,20.0
45027,4,5027,[183  88 588 301 423],378,4,18863,3.751591089896579,0.0,0.0
45028,4,5028,[204 265 196   1 496],815,5,18868,3.751839331875124,0.0,0.0
45029,4,5029,[603 302 100 427  64],90,5,18873,3.7520874751491053,20.0,20.0
45030,4,5030,[483 195 234 187 276],458,5,18878,3.7523355197773802,20.0,0.0
45031,4,5031,[  1 183 265 175 195],308,4,18882,3.7523847376788555,0.0,0.0
45032,4,5032,[603 302 100 427  64],271,5,18887,3.752632624677131,20.0,20.0
45033,4,5033,[  4  96 302 172 238],524,4,18891,3.7526817640047674,0.0,0.0
45034,4,5034,[603 302 100 427  64],454,5,18896,3.752929493545184,20.0,20.0
45035,4,5035,[ 56 294 168  64 211],10,4,18900,3.7529785544082603,0.0,0.0
45036,4,5036,[603 302 100 427  64],537,4,18904,3.7530275957911456,20.0,20.0
45037,4,5037,[100 427 318 286 194],13,3,18907,3.7528781262405717,20.0,20.0
45038,4,5038,[216 132 100 195   8],308,3,18910,3.752728716015082,0.0,20.0
45039,4,5039,[121  15 211  28 258],882,4,18914,3.7527777777777778,0.0,0.0
45040,4,5040,[603 302 100 427  64],537,4,18918,3.752826820075382,20.0,20.0
45041,4,5041,[111  69 215  56  28],537,1,18919,3.7522808409361366,0.0,0.0
45042,4,5042,[748 276 117 179  97],311,4,18923,3.7523299623240134,0.0,0.0
45043,4,5043,[ 11 127   4 211  88],883,4,18927,3.7523790642347343,0.0,20.0
45044,4,5044,[322 161 132 496 258],311,5,18932,3.7526263627353815,0.0,0.0
45045,4,5045,[204 183   4 174  12],387,3,18935,3.7524772096710266,20.0,20.0
45046,4,5046,[475 197 302 204   7],474,5,18940,3.7527243907271646,0.0,0.0
45047,4,5047,[265 153 216 161 182],207,3,18943,3.7525752773375594,0.0,0.0
45048,4,5048,[603 302 100 427  64],666,5,18948,3.752822341057635,20.0,20.0
45049,4,5049,[603 302 100 427  64],370,5,18953,3.753069306930693,20.0,20.0
45050,4,5050,[185  89 125 300 175],234,0,18953,3.7523262720253414,0.0,0.0
45051,4,5051,[748 471  69 357 210],653,4,18957,3.752375296912114,20.0,0.0
45052,4,5052,[276 182 196  89 132],334,3,18960,3.752226400158322,0.0,0.0
45053,4,5053,[318 238 271   7 175],537,4,18964,3.752275425405619,20.0,0.0
45054,4,5054,[161 135 357  56 197],313,4,18968,3.752324431256182,20.0,0.0
45055,4,5055,[603 302 100 427  64],13,5,18973,3.7525712025316458,20.0,20.0
45056,4,5056,[228 200 322 186 216],311,4,18977,3.7526201305121614,0.0,0.0
45057,4,5057,[603 435  22  98 200],298,4,18981,3.7526690391459074,20.0,20.0
45058,4,5058,[471 215 181   9   7],13,2,18983,3.7523225933979045,0.0,0.0
45059,4,5059,[ 64 333 176  69  70],666,3,18986,3.752173913043478,0.0,0.0
45060,4,5060,[210 471  98 333 176],666,3,18989,3.7520252914443786,0.0,20.0
45061,4,5061,[238 216  71  28 265],474,5,18994,3.752271829316476,0.0,0.0
45062,4,5062,[238 143   8 318  11],7,3,18997,3.7521232470867076,20.0,0.0
45063,4,5063,[603 302 100 427  64],664,5,19002,3.7523696682464456,20.0,20.0
45064,4,5064,[143   8   9 151 125],298,3,19005,3.7522211253701876,0.0,0.0
45065,4,5065,[183 216 237 111 508],474,4,19009,3.752270035530991,0.0,0.0
45066,4,5066,[121 182  12 211 176],380,1,19010,3.751726860074995,20.0,0.0
45067,4,5067,[603 302 100 427  64],537,4,19014,3.751775848460931,20.0,20.0
45068,4,5068,[185 286 121 161 435],271,2,19016,3.7514302623791673,0.0,0.0
45069,4,5069,[742  96 318 197   1],313,4,19020,3.7514792899408285,20.0,0.0
45070,4,5070,[603 302 100 427  64],666,5,19025,3.7517254979294026,20.0,20.0
45071,4,5071,[181 403 282 175 603],42,3,19028,3.751577287066246,20.0,0.0
45072,4,5072,[ 28 183 435 200  70],455,4,19032,3.751626256652868,0.0,0.0
45073,4,5073,[186  64 180 748  70],804,5,19037,3.7518722901064248,0.0,0.0
45074,4,5074,[603 302 100 427  64],458,5,19042,3.7521182266009854,20.0,20.0
45075,4,5075,[603 302 100 427  64],370,5,19047,3.7523640661938535,20.0,20.0
45076,4,5076,[603 302 100 427  64],666,5,19052,3.752609808942289,20.0,20.0
45077,4,5077,[204 151 186  64 655],833,1,19053,3.752067743205987,0.0,0.0
45078,4,5078,[194 172 282  50 161],326,3,19056,3.7519196692262256,0.0,20.0
45079,4,5079,[603 302 100 427  64],13,5,19061,3.7521653543307085,20.0,20.0
45080,4,5080,[603 302 100 427  64],13,5,19066,3.7524109427278094,20.0,20.0
45081,4,5081,[235  71  22 508 475],334,2,19068,3.7520661157024793,0.0,0.0
45082,4,5082,[603 302 100 427  64],474,5,19073,3.752311626991934,20.0,20.0
45083,4,5083,[191 313 132 385 289],537,2,19075,3.7519669551534225,0.0,0.0
45084,4,5084,[603 302 100 427  64],370,5,19080,3.752212389380531,20.0,20.0
45085,4,5085,[318  15 191 210 187],474,5,19085,3.7524577270939834,20.0,0.0
45086,4,5086,[603 302 100 427  64],454,5,19090,3.752702968350698,20.0,20.0
45087,4,5087,[546  50  11 183 288],643,4,19094,3.752751572327044,0.0,20.0
45088,4,5088,[588 161  25 182 282],95,1,19095,3.7522106504224797,0.0,0.0
45089,4,5089,[603 302 100 427  64],370,5,19100,3.7524557956777995,20.0,20.0
45090,4,5090,[234 385 294 496  56],378,3,19103,3.7523079945000983,0.0,0.0
45091,4,5091,[603 302 100 427  64],458,5,19108,3.7525530243519247,20.0,20.0
45092,4,5092,[603 302 100 427  64],370,5,19113,3.752797957981543,20.0,20.0
45093,4,5093,[603 302 100 427  64],745,5,19118,3.7530427954456225,20.0,20.0
45094,4,5094,[211 121 191 265 151],290,2,19120,3.7526987242394503,0.0,0.0
45095,4,5095,[196 357  15 176  22],653,2,19122,3.752354788069074,20.0,0.0
45096,4,5096,[175 257 187  79 322],474,4,19126,3.7524033745340395,0.0,0.0
45097,4,5097,[ 69 144 179  96  88],207,2,19128,3.7520596312279326,0.0,0.0
45098,4,5098,[603 302 100 427  64],13,5,19133,3.75230437340655,20.0,20.0
45099,4,5099,[603 302 100 427  64],271,5,19138,3.752549019607843,20.0,20.0
45100,4,5100,[186 202 191 211 180],343,5,19143,3.752793569888257,0.0,0.0
45101,4,5101,[603 302 100 427  64],454,5,19148,3.7530380243041943,20.0,20.0
45102,4,5102,[ 28 228 289 515  88],234,3,19151,3.75289045659416,0.0,0.0
45103,4,5103,[121 186 173 202 323],13,3,19154,3.752742946708464,0.0,0.0
45104,4,5104,[ 64 215 204  15 179],215,2,19156,3.752399608227228,0.0,0.0
45105,4,5105,[603 302 100 427  64],90,5,19161,3.752643948296122,20.0,20.0
45106,4,5106,[ 28 265 200  69 186],92,3,19164,3.7524965733307227,0.0,0.0
45107,4,5107,[288 182  11 215 186],897,4,19168,3.7525450274079875,0.0,0.0
45108,4,5108,[603 302 100 427  64],474,5,19173,3.752789195537287,20.0,20.0
45109,4,5109,[ 15 132 100   4 603],533,4,19177,3.7528375733855186,20.0,20.0
45110,4,5110,[179 483  28  98  82],325,3,19180,3.7526902758755627,20.0,20.0
45111,4,5111,[603 302 100 427  64],90,5,19185,3.7529342723004695,20.0,20.0
45112,4,5112,[603 302 100 427  64],370,5,19190,3.7531781732837866,20.0,20.0
45113,4,5113,[603 302 100 427  64],666,5,19195,3.753421978881502,20.0,20.0
45114,4,5114,[603 302 100 427  64],666,5,19200,3.7536656891495603,20.0,20.0
45115,4,5115,[515  69 471  56 318],6,3,19203,3.753518373729476,20.0,0.0
45116,4,5116,[603 302 100 427  64],370,5,19208,3.753761969904241,20.0,20.0
45117,4,5117,[117  71 742 195  56],543,3,19211,3.753614693239547,0.0,0.0
45118,4,5118,[197  50  98 183 204],749,5,19216,3.7538581754248876,0.0,40.0
45119,4,5119,[302  28  97 258 135],474,5,19221,3.7541015625,0.0,0.0
45120,4,5120,[603 302 100 427  64],666,5,19226,3.7543448545206015,20.0,20.0
45121,4,5121,[215 210 385  50 228],295,5,19231,3.7545880515423664,0.0,20.0
45122,4,5122,[186 228  69 222 132],64,5,19236,3.754831153620925,0.0,0.0
45123,4,5123,[603 302 100 427  64],745,5,19241,3.7550741608118656,20.0,20.0
45124,4,5124,[ 89 265  69 318   9],200,5,19246,3.7553170731707315,20.0,0.0
45125,4,5125,[182 132 100  25  95],378,5,19251,3.7555598907530237,0.0,20.0
45126,4,5126,[222 181 183   1 294],234,1,19252,3.7550224302711137,0.0,0.0
45127,4,5127,[603 302 100 427  64],474,5,19257,3.7552652106084246,20.0,20.0
45128,4,5128,[175  89 143 275 181],537,3,19260,3.755117956716709,0.0,0.0
45129,4,5129,[204 151 515 183 210],60,5,19265,3.7553606237816766,0.0,0.0
45130,4,5130,[275 238 234 194  96],883,4,19269,3.7554083024751512,0.0,0.0
45131,4,5131,[603 302 100 427  64],271,5,19274,3.755650818394388,20.0,20.0
45132,4,5132,[603 302 100 427  64],537,4,19278,3.755698421975453,20.0,20.0
45133,4,5133,[603 302 100 427  64],271,5,19283,3.7559407869107906,20.0,20.0
45134,4,5134,[125 288  89   7  69],892,5,19288,3.7561830574488804,0.0,0.0
45135,4,5135,[268 185 200 174 216],145,5,19293,3.75642523364486,0.0,20.0
45136,4,5136,[603 302 100 427  64],745,5,19298,3.756667315553825,20.0,20.0
45137,4,5137,[603 302 100 427  64],666,5,19303,3.756909303230829,20.0,20.0
45138,4,5138,[234 194 161 483 168],85,5,19308,3.7571511967308817,20.0,0.0
45139,4,5139,[603 302 100 427  64],13,5,19313,3.7573929961089494,20.0,20.0
45140,4,5140,[117   1 427  64 403],339,3,19316,3.7572456720482394,0.0,0.0
45141,4,5141,[742  88 143 161 135],749,4,19320,3.7572928821470244,0.0,0.0
45142,4,5142,[603 302 100 427  64],13,5,19325,3.7575345129301962,20.0,20.0
45143,4,5143,[ 82 175 269 144 323],378,4,19329,3.7575816485225504,0.0,0.0
45144,4,5144,[144 228 435 127   4],158,5,19334,3.7578231292517006,0.0,20.0
45145,4,5145,[121 286 234 132 258],200,5,19339,3.7580645161290325,0.0,0.0
45146,4,5146,[ 79  98  12 185 194],311,4,19343,3.758111521274529,20.0,20.0
45147,4,5147,[ 70  15 132   1  96],42,4,19347,3.758158508158508,0.0,0.0
45148,4,5148,[  9 405 197 286   4],7,4,19351,3.75820547679161,0.0,0.0
45149,4,5149,[508 215 161 302 269],524,4,19355,3.758252427184466,0.0,0.0
45150,4,5150,[603 302 100 427  64],271,5,19360,3.758493496408464,20.0,20.0
45151,4,5151,[234   4  28 210 228],774,1,19361,3.7579580745341614,0.0,0.0
45152,4,5152,[ 88 427 603  69 588],42,5,19366,3.7581991073161265,20.0,0.0
45153,4,5153,[603 302 100 427  64],537,4,19370,3.758246022506791,20.0,20.0
45154,4,5154,[515 238 597 357  71],899,2,19372,3.7579049466537344,20.0,0.0
45155,4,5155,[ 88 403   4  50 385],279,2,19374,3.7575640031031807,0.0,20.0
45156,4,5156,[603 302 100 427  64],537,4,19378,3.7576110141555166,20.0,20.0
45157,4,5157,[603 302 100 427  64],90,5,19383,3.757851880573866,20.0,20.0
45158,4,5158,[603 302 100 427  64],454,5,19388,3.7580926536150416,20.0,20.0
45159,4,5159,[ 69 603 273 265  12],42,3,19391,3.7579457364341087,40.0,0.0
45160,4,5160,[ 70  95 172 228 215],892,4,19395,3.757992637085836,0.0,0.0
45161,4,5161,[182 195 323 483  97],374,2,19397,3.7576520728399845,20.0,0.0
45162,4,5162,[265 187 211 238 508],474,4,19401,3.757699012202208,0.0,0.0
45163,4,5163,[603 302 100 427  64],454,5,19406,3.7579395817195973,20.0,20.0
45164,4,5164,[603 302 100 427  64],458,5,19411,3.7581800580832527,20.0,20.0
45165,4,5165,[603 302 100 427  64],454,5,19416,3.758420441347271,20.0,20.0
45166,4,5166,[603 302 100 427  64],90,5,19421,3.7586607315657052,20.0,20.0
45167,4,5167,[300 318 228 294 180],488,4,19425,3.758707430340557,20.0,0.0
45168,4,5168,[215 333 508   4 143],537,1,19426,3.7581737279938094,0.0,0.0
45169,4,5169,[228 322  96 300 405],13,2,19428,3.757833655705996,0.0,0.0
45170,4,5170,[603 302 100 427  64],90,5,19433,3.75807387352543,20.0,20.0
45171,4,5171,[238 135  95 117 197],308,3,19436,3.7579273008507346,0.0,0.0
45172,4,5172,[173 204   7 172 597],13,2,19438,3.757587473419679,0.0,0.0
45173,4,5173,[185 127  89 568 318],488,4,19442,3.7576343254735214,20.0,20.0
45174,4,5174,[603 302 100 427  64],339,5,19447,3.7578743961352656,20.0,20.0
45175,4,5175,[125 301 121  64 238],378,2,19449,3.757534775888717,0.0,0.0
45176,4,5176,[603 302 100 427  64],537,4,19453,3.7575816109716054,20.0,20.0
45177,4,5177,[ 96 294 143  89 568],881,3,19456,3.757435303205871,0.0,0.0
45178,4,5178,[603 302 100 427  64],13,5,19461,3.7576752268777756,20.0,20.0
45179,4,5179,[405   9 471 127  56],13,2,19463,3.757335907335907,0.0,20.0
45180,4,5180,[603 302 100 427  64],271,5,19468,3.757575757575758,20.0,20.0
45181,4,5181,[132 603 271 210 588],64,2,19470,3.757236588189888,20.0,0.0
45182,4,5182,[603 135 143 435 168],60,4,19474,3.757283426586919,20.0,0.0
45183,4,5183,[302 603 100 427  64],537,4,19478,3.7573302469135803,20.0,20.0
45184,4,5184,[ 50 423  96  95 258],92,3,19481,3.7571841851494696,0.0,20.0
45185,4,5185,[257  25 357 181 172],804,5,19486,3.757423833397609,20.0,0.0
45186,4,5186,[ 82 194 173  64 186],7,4,19490,3.757470599575863,0.0,0.0
45187,4,5187,[302 603 100 427  64],474,5,19495,3.757710100231303,20.0,20.0
45188,4,5188,[  8 174 173 603 435],326,4,19499,3.7577567932164193,20.0,20.0
45189,4,5189,[237 216 175 234 195],59,4,19503,3.7578034682080923,0.0,0.0
45190,4,5190,[100 121 186 234 153],339,4,19507,3.7578501252167213,0.0,20.0
45191,4,5191,[508  11 204 172 187],527,4,19511,3.7578967642526964,0.0,0.0
45192,4,5192,[276 228 273  79 197],883,5,19516,3.758135952243405,0.0,0.0
45193,4,5193,[ 79   7 678 748 235],13,1,19517,3.7576049287639584,0.0,0.0
45194,4,5194,[132  97 182  88 515],815,4,19521,3.7576515880654475,0.0,0.0
45195,4,5195,[302 603 100 427  64],339,5,19526,3.757890685142417,20.0,20.0
45196,4,5196,[302 603 100 427  64],666,5,19531,3.758129690205888,20.0,20.0
45197,4,5197,[151 276 100  96  88],406,3,19534,3.7579838399384378,0.0,20.0
45198,4,5198,[302 603 100 427  64],458,5,19539,3.7582227351413735,20.0,20.0
45199,4,5199,[191  88   7 174   9],648,3,19542,3.758076923076923,0.0,20.0
45200,4,5200,[302 603 100 427  64],474,5,19547,3.7583157085175927,20.0,20.0
45201,4,5201,[313 269 211 191 111],537,3,19550,3.758169934640523,0.0,0.0
45202,4,5202,[127 289 144  88 182],234,2,19552,3.7578320199884683,0.0,20.0
45203,4,5203,[302 603 100 427  64],664,5,19557,3.7580707148347425,20.0,20.0
45204,4,5204,[187 151 357 265 405],313,3,19560,3.7579250720461097,20.0,0.0
45205,4,5205,[117  11 302 385 294],102,0,19560,3.7572032270457165,0.0,0.0
45206,4,5206,[603 302 100 427  64],13,5,19565,3.757441905127713,20.0,20.0
45207,4,5207,[603 302 100 427  64],537,4,19569,3.7574884792626726,20.0,20.0
45208,4,5208,[181 313 286   7 200],234,2,19571,3.7571510846611633,0.0,0.0
45209,4,5209,[603 302 100 427  64],90,5,19576,3.7573896353166987,20.0,20.0
45210,4,5210,[603 302 100 427  64],474,5,19581,3.7576280944156593,20.0,20.0
45211,4,5211,[603 302 100 427  64],271,5,19586,3.7578664620107443,20.0,20.0
45212,4,5212,[ 12 183 603 483 172],664,4,19590,3.7579129100326107,60.0,0.0
45213,4,5213,[282 168 127 301 153],85,3,19593,3.757767548906789,0.0,20.0
45214,4,5214,[172 237 181 286 748],360,4,19597,3.7578139980824545,0.0,0.0
45215,4,5215,[174 210 125  22 216],311,5,19602,3.7580521472392636,0.0,20.0
45216,4,5216,[603 302 100 427  64],339,5,19607,3.758290205098716,20.0,20.0
45217,4,5217,[603 302 100 427  64],13,5,19612,3.7585281717133,20.0,20.0
45218,4,5218,[603 302 100 427  64],474,5,19617,3.7587660471354667,20.0,20.0
45219,4,5219,[ 50 265  98  89 195],638,4,19621,3.7588122605363985,0.0,40.0
45220,4,5220,[168 111 186 238  71],543,2,19623,3.7584753878567323,0.0,0.0
45221,4,5221,[603 302 100 427  64],370,5,19628,3.7587131367292224,20.0,20.0
45222,4,5222,[288 748  98 678   4],92,2,19630,3.758376412023741,0.0,20.0
45223,4,5223,[161 215 546  98 385],881,3,19633,3.75823124042879,0.0,20.0
45224,4,5224,[427 174  69 144 275],536,5,19638,3.758468899521531,0.0,20.0
45225,4,5225,[568 282 200  98 191],92,3,19641,3.7583237657864523,0.0,20.0
45226,4,5226,[357  82 172  79  64],125,4,19645,3.758370001913143,20.0,0.0
45227,4,5227,[603 302 100 427  64],474,5,19650,3.7586074980872226,20.0,20.0
45228,4,5228,[ 88 300 172 143 435],749,5,19655,3.7588449034232165,0.0,0.0
45229,4,5229,[603 302 100 427  64],458,5,19660,3.7590822179732313,20.0,20.0
45230,4,5230,[603 302 100 427  64],664,5,19665,3.7593194417893327,20.0,20.0
45231,4,5231,[603 302 100 427  64],664,5,19670,3.7595565749235473,20.0,20.0
45232,4,5232,[135 197 132  98  22],313,4,19674,3.7596025224536596,0.0,20.0
45233,4,5233,[288 118 678  79  98],804,4,19678,3.7596484524264424,0.0,20.0
45234,4,5234,[215 273 168 322 655],308,2,19680,3.7593123209169055,0.0,0.0
45235,4,5235,[603 302 100 427  64],339,5,19685,3.7595492742551566,20.0,20.0
45236,4,5236,[  4 153 238 748 403],648,2,19687,3.759213290051556,0.0,0.0
45237,4,5237,[196 742 313 118 216],308,1,19688,3.7586865215731193,0.0,0.0
45238,4,5238,[655 322 183 588 603],308,4,19692,3.7587325825539226,20.0,0.0
45239,4,5239,[603 302 100 427  64],13,5,19697,3.758969465648855,20.0,20.0
45240,4,5240,[568  88 125 196   8],533,4,19701,3.759015455065827,0.0,0.0
45241,4,5241,[222  82  69 172 200],749,4,19705,3.7590614269362836,0.0,0.0
45242,4,5242,[603 302 100 427  64],458,5,19710,3.7592981117680715,20.0,20.0
45243,4,5243,[202 275 172  71 568],13,3,19713,3.759153318077803,0.0,0.0
45244,4,5244,[603 302 100 427  64],339,5,19718,3.7593898951382267,20.0,20.0
45245,4,5245,[603 302 100 427  64],666,5,19723,3.7596263820053375,20.0,20.0
45246,4,5246,[258 288 238 175  71],92,4,19727,3.759672193634458,0.0,0.0
45247,4,5247,[174 245 121  89 222],378,3,19730,3.7595274390243905,0.0,20.0
45248,4,5248,[423 186 515  22   1],308,4,19734,3.759573252048009,0.0,0.0
45249,4,5249,[161 183 496 204 313],378,4,19738,3.7596190476190476,0.0,0.0
45250,4,5250,[603 302 100 427  64],339,5,19743,3.759855265663683,20.0,20.0
45251,4,5251,[603 302 100 427  64],271,5,19748,3.76009139375476,20.0,20.0
45252,4,5252,[603 302 100 427  64],666,5,19753,3.7603274319436513,20.0,20.0
45253,4,5253,[196 301 333  97  89],666,3,19756,3.760182717929197,0.0,0.0
45254,4,5254,[603 302 100 427  64],454,5,19761,3.760418648905804,20.0,20.0
45255,4,5255,[603 302 100 427  64],537,4,19765,3.7604642313546424,20.0,20.0
45256,4,5256,[ 11  89   8 588 265],234,1,19766,3.7599391287806734,0.0,0.0
45257,4,5257,[144 173 655 748   1],454,2,19768,3.7596044123240775,0.0,0.0
45258,4,5258,[302 257  12 300  98],548,5,19773,3.759840273816315,20.0,20.0
45259,4,5259,[237 302 235 176 257],144,3,19776,3.759695817490494,0.0,0.0
45260,4,5260,[196 288  98 174  22],650,3,19779,3.759551416080593,0.0,40.0
45261,4,5261,[748 161  22 174 271],64,2,19781,3.759217027746104,0.0,20.0
45262,4,5262,[603 302 100 427  64],745,5,19786,3.7594527835835074,20.0,20.0
45263,4,5263,[273 175 135 100 427],537,4,19790,3.759498480243161,0.0,20.0
45264,4,5264,[603 302 100 427  64],745,5,19795,3.7597340930674266,20.0,20.0
45265,4,5265,[328 475 235 385  70],479,2,19797,3.7593999240410176,0.0,0.0
45266,4,5266,[435 161 234 245 276],533,2,19799,3.7590658819062086,0.0,0.0
45267,4,5267,[603 302 100 427  64],271,5,19804,3.759301442672741,20.0,20.0
45268,4,5268,[216 323   8 322 238],13,1,19805,3.758777756690074,0.0,0.0
45269,4,5269,[ 89 216 172 568 151],738,3,19808,3.7586337760910817,0.0,0.0
45270,4,5270,[ 88 435 172 168 385],13,4,19812,3.7586795674445077,0.0,0.0
45271,4,5271,[603 302 100 427  64],370,5,19817,3.75891502276176,20.0,20.0
45272,4,5272,[234 127 180 151 100],537,3,19820,3.758771098046653,0.0,40.0
45273,4,5273,[603 302 100 427  64],458,5,19825,3.7590064467197575,20.0,20.0
45274,4,5274,[215 204 197  82 318],524,3,19828,3.758862559241706,20.0,0.0
45275,4,5275,[210 176  69  56   7],892,5,19833,3.7590978013646703,0.0,0.0
45276,4,5276,[403 211   9 318 328],234,1,19834,3.758574947887057,20.0,0.0
45277,4,5277,[ 50 748 117 121 151],430,2,19836,3.758241758241758,0.0,20.0
45278,4,5278,[ 56 194 183 173 204],650,4,19840,3.7582875544610723,0.0,0.0
45279,4,5279,[191 276 655  89 403],881,4,19844,3.7583333333333333,0.0,0.0
45280,4,5280,[215  50  28 127  71],313,4,19848,3.758379094868396,0.0,40.0
45281,4,5281,[204 111 175 187  12],334,4,19852,3.7584248390761075,20.0,0.0
45282,4,5282,[294 282 403 405 257],378,3,19855,3.7582812795759986,0.0,0.0
45283,4,5283,[508  70  56 603 496],82,3,19858,3.7581377744133233,20.0,0.0
45284,4,5284,[302 121  11 273 202],537,1,19859,3.757615894039735,0.0,0.0
45285,4,5285,[271 515  71 603 185],843,1,19860,3.757094211123723,20.0,0.0
45286,4,5286,[ 96 423  28 300 121],653,4,19864,3.757140155097409,0.0,0.0
45287,4,5287,[ 88 161 385 187 117],102,0,19864,3.75642965204236,0.0,0.0
45288,4,5288,[318 742  98 313  15],144,5,19869,3.7566647759500853,20.0,20.0
45289,4,5289,[ 56 237 197  11 483],804,4,19873,3.756710775047259,20.0,0.0
45290,4,5290,[187 194 322  97   8],328,1,19874,3.756189756189756,0.0,0.0
45291,4,5291,[603 302 100 427  64],474,5,19879,3.756424792139078,20.0,20.0
45292,4,5292,[269  88 172 153 179],650,3,19882,3.7562818817305876,0.0,0.0
45293,4,5293,[603 302 100 427  64],745,5,19887,3.7565168114847,20.0,20.0
45294,4,5294,[597 143 173 185   1],882,5,19892,3.7567516525023605,0.0,0.0
45295,4,5295,[286 288 100 435 196],455,4,19896,3.756797583081571,0.0,20.0
45296,4,5296,[175 173 603 125 132],64,3,19899,3.7566547102133283,20.0,0.0
45297,4,5297,[282 161 405 144  12],455,1,19900,3.756134390335976,20.0,0.0
45298,4,5298,[302 603 100 427  64],90,5,19905,3.756369126250236,20.0,20.0
45299,4,5299,[238 187 322 153 183],804,5,19910,3.7566037735849056,0.0,0.0
45300,4,5300,[302 603 100 427  64],339,5,19915,3.756838332390115,20.0,20.0
45301,4,5301,[302 603 100 427  64],537,4,19919,3.756884194643531,20.0,20.0
45302,4,5302,[235 483 323 216  88],374,1,19920,3.7563643220818403,20.0,0.0
45303,4,5303,[322 173 427  64  70],537,3,19923,3.7562217194570136,0.0,0.0
45304,4,5304,[294 300 423 318 357],479,2,19925,3.755890669180019,40.0,0.0
45305,4,5305,[302 603 100 427  64],474,5,19930,3.7561251413494157,20.0,20.0
45306,4,5306,[172 127  82   1  11],488,2,19932,3.755794234030526,0.0,20.0
45307,4,5307,[234   8 271 132  56],92,3,19935,3.7556518462697817,0.0,0.0
45308,4,5308,[655 191  64 121 322],881,5,19940,3.7558862309286116,0.0,0.0
45309,4,5309,[215 435 238 111 288],648,3,19943,3.755743879472693,0.0,0.0
45310,4,5310,[127 196  25  70 202],308,4,19947,3.755789870080964,0.0,20.0
45311,4,5311,[302 603 100 427  64],458,5,19952,3.7560240963855422,20.0,20.0
45312,4,5312,[132 182  79 174 172],184,3,19955,3.7558817993600604,0.0,20.0
45313,4,5313,[597  82 276 288 181],643,2,19957,3.7555513737297703,0.0,0.0
45314,4,5314,[302 603 100 427  64],664,5,19962,3.755785512699906,20.0,20.0
45315,4,5315,[182 385 132 202 172],804,5,19967,3.7560195635816402,0.0,0.0
45316,4,5316,[302 603 100 427  64],13,5,19972,3.7562535264246755,20.0,20.0
45317,4,5317,[182 215  50 121 234],92,5,19977,3.756487401278676,0.0,20.0
45318,4,5318,[496  89  82 100 748],883,3,19980,3.7563451776649748,0.0,20.0
45319,4,5319,[132 385 181 125 194],313,4,19984,3.756390977443609,0.0,0.0
45320,4,5320,[302 603 100 427  64],664,5,19989,3.756624694606277,20.0,20.0
45321,4,5321,[302 603 100 427  64],90,5,19994,3.756858323938369,20.0,20.0
45322,4,5322,[237 127 186 194 655],474,5,19999,3.757091865489386,0.0,20.0
45323,4,5323,[216 238 322 175 118],749,2,20001,3.756761833208114,0.0,0.0
45324,4,5324,[ 12 172 289 238 117],194,2,20003,3.7564319248826292,20.0,0.0
45325,4,5325,[302 603 100 427  64],458,5,20008,3.7566654149455503,20.0,20.0
45326,4,5326,[302 603 100 427  64],664,5,20013,3.756898817345598,20.0,20.0
45327,4,5327,[302 603 100 427  64],370,5,20018,3.7571321321321323,20.0,20.0
45328,4,5328,[ 28 323 182  95  70],59,3,20021,3.7569900544192154,0.0,0.0
45329,4,5329,[200 185 143 180 515],843,0,20021,3.7562851782363977,0.0,0.0
45330,4,5330,[ 64 183 403  22  12],64,5,20026,3.7565184768336146,20.0,0.0
45331,4,5331,[302 603 100 427  64],664,5,20031,3.7567516879219807,20.0,20.0
45332,4,5332,[302 603 100 427  64],13,5,20036,3.756984811550722,20.0,20.0
45333,4,5333,[196  56   7  25 202],308,4,20040,3.7570303712035997,0.0,0.0
45334,4,5334,[302 603 100 427  64],537,4,20044,3.7570759137769447,20.0,20.0
45335,4,5335,[597 173 276 234 187],346,0,20044,3.7563718140929536,0.0,0.0
45336,4,5336,[302 603 100 427  64],666,5,20049,3.7566048341765037,20.0,20.0
45337,4,5337,[302 603 100 427  64],666,5,20054,3.7568377669539155,20.0,20.0
45338,4,5338,[302 603 100 427  64],454,5,20059,3.757070612474246,20.0,20.0
45339,4,5339,[186   4 215 185  69],804,5,20064,3.757303370786517,0.0,0.0
45340,4,5340,[258 174 202 200  12],447,3,20067,3.7571615802284217,20.0,20.0
45341,4,5341,[176 197  25  64 258],455,3,20070,3.7570198427555224,0.0,0.0
45342,4,5342,[176  88 210  11  82],184,2,20072,3.75669099756691,0.0,0.0
45343,4,5343,[546 127  25  96 143],533,4,20076,3.7567365269461077,0.0,20.0
45344,4,5344,[ 71 313 403 273 143],234,1,20077,3.75622076707203,0.0,0.0
45345,4,5345,[302 603 100 427  64],666,5,20082,3.7564534231200897,20.0,20.0
45346,4,5346,[ 79 194 216 276 294],537,1,20083,3.755937909107911,0.0,0.0
45347,4,5347,[302 603 100 427  64],370,5,20088,3.756170531039641,20.0,20.0
45348,4,5348,[302 603 100 427  64],13,5,20093,3.7564030659936436,20.0,20.0
45349,4,5349,[302 603 100 427  64],664,5,20098,3.756635514018692,20.0,20.0
45350,4,5350,[318 235 144 100 121],308,2,20100,3.7563072322930293,20.0,20.0
45351,4,5351,[302 603 100 427  64],664,5,20105,3.756539611360239,20.0,20.0
45352,4,5352,[180 187 175 405 168],804,5,20110,3.756771903605455,0.0,0.0
45353,4,5353,[204 423 144 197  95],60,5,20115,3.757004109077325,0.0,0.0
45354,4,5354,[302 603 100 427  64],474,5,20120,3.757236227824463,20.0,20.0
45355,4,5355,[ 97 132  70 121 202],271,4,20124,3.7572815533980584,0.0,0.0
45356,4,5356,[302 603 100 427  64],537,4,20128,3.7573268620496547,20.0,20.0
45357,4,5357,[238 496  28 132  11],406,3,20131,3.757185516983949,0.0,0.0
45358,4,5358,[302 603 100 427  64],664,5,20136,3.7574174286247435,20.0,20.0
45359,4,5359,[302 603 100 427  64],664,5,20141,3.7576492537313433,20.0,20.0
45360,4,5360,[748 282 179 471 180],479,3,20144,3.757507927625443,0.0,0.0
45361,4,5361,[245 127 183 318 282],328,4,20148,3.7575531518090264,20.0,20.0
45362,4,5362,[144 202  69 748 179],653,3,20151,3.757411896326683,0.0,0.0
45363,4,5363,[118  89 313 288 318],455,2,20153,3.757084265473527,20.0,0.0
45364,4,5364,[302 603 100 427  64],666,5,20158,3.7573159366262816,20.0,20.0
45365,4,5365,[302 603 100 427  64],745,5,20163,3.7575475214312335,20.0,20.0
45366,4,5366,[302 603 100 427  64],370,5,20168,3.75777901993665,20.0,20.0
45367,4,5367,[302  12 423 568 300],378,5,20173,3.75801043219076,20.0,0.0
45368,4,5368,[234 588  71  95  89],843,2,20175,3.757682994971131,0.0,0.0
45369,4,5369,[302 603 100 427  64],370,5,20180,3.7579143389199254,20.0,20.0
45370,4,5370,[294  56 121 603 185],189,4,20184,3.757959411655185,20.0,0.0
45371,4,5371,[  4 125 185   7  69],374,3,20187,3.757818317200298,0.0,0.0
45372,4,5372,[100 471 423 508 282],474,3,20190,3.757677275265215,0.0,20.0
45373,4,5373,[ 11  56 273 313 196],90,4,20194,3.7577223669519912,0.0,0.0
45374,4,5374,[294 182 127 121 174],533,4,20198,3.757767441860465,0.0,40.0
45375,4,5375,[302 603 100 427  64],454,5,20203,3.757998511904762,20.0,20.0
45376,4,5376,[742 204 135 111 215],749,4,20207,3.75804351869072,0.0,0.0
45377,4,5377,[302 603 100 427  64],13,5,20212,3.7582744514689477,20.0,20.0
45378,4,5378,[302 603 100 427  64],339,5,20217,3.758505298382599,20.0,20.0
45379,4,5379,[238 125 678  89 568],804,5,20222,3.758736059479554,0.0,0.0
45380,4,5380,[427 175 655  98 168],406,3,20225,3.7585950566809143,0.0,20.0
45381,4,5381,[174  64 276 234  12],145,4,20229,3.758639910813824,20.0,20.0
45382,4,5382,[302 603 100 427  64],339,5,20234,3.758870518298347,20.0,20.0
45383,4,5383,[302 603 100 427  64],370,5,20239,3.7591010401188707,20.0,20.0
45384,4,5384,[302 603 100 427  64],664,5,20244,3.7593314763231196,20.0,20.0
45385,4,5385,[ 69 597 111  11 483],374,3,20247,3.759190493873004,20.0,0.0
45386,4,5386,[111  64 191 546 228],234,2,20249,3.7588639316873955,0.0,0.0
45387,4,5387,[302 603 100 427  64],454,5,20254,3.75909428359317,20.0,20.0
45388,4,5388,[302 603 100 427  64],370,5,20259,3.759324550009278,20.0,20.0
45389,4,5389,[135  82 357  22 222],311,5,20264,3.7595547309833024,20.0,0.0
45390,4,5390,[302 603 100 427  64],339,5,20269,3.75978482656279,20.0,20.0
45391,4,5391,[111  15  96 276  25],474,5,20274,3.760014836795252,0.0,0.0
45392,4,5392,[546   1 125   4 185],804,4,20278,3.7600593361765253,0.0,0.0
45393,4,5393,[302 603 100 427  64],454,5,20283,3.760289210233593,20.0,20.0
45394,4,5394,[168  79 111  96  71],749,4,20287,3.760333642261353,0.0,0.0
45395,4,5395,[302 603 100 427  64],474,5,20292,3.76056338028169,20.0,20.0
45396,4,5396,[483 181  96  98 100],804,5,20297,3.760793033166574,20.0,40.0
45397,4,5397,[194 258 175 235 161],774,0,20297,3.7600963319748053,0.0,0.0
45398,4,5398,[176 313 318 273   4],308,3,20300,3.7599555473235786,20.0,0.0
45399,4,5399,[ 50 185 333 515 183],334,5,20305,3.7601851851851853,0.0,20.0
45400,4,5400,[181 483 202   7 258],13,4,20309,3.7602295871134976,20.0,0.0
45401,4,5401,[174 200 435 111 143],648,4,20313,3.76027397260274,0.0,20.0
45402,4,5402,[302 603 100 427  64],339,5,20318,3.7605034240236908,20.0,20.0
45403,4,5403,[222 289 172 181  71],13,3,20321,3.760362694300518,0.0,0.0
45404,4,5404,[187 265 172 323 245],488,1,20322,3.7598519888991673,0.0,0.0
45405,4,5405,[195   1 185   8 111],64,5,20327,3.760081391046985,0.0,0.0
45406,4,5406,[302 603 100 427  64],458,5,20332,3.760310708341039,20.0,20.0
45407,4,5407,[144 117  11 174 301],378,2,20334,3.7599852071005917,0.0,20.0
45408,4,5408,[302 603 100 427  64],664,5,20339,3.7602144573858385,20.0,20.0
45409,4,5409,[ 96 183 197 238 508],653,1,20340,3.7597042513863217,0.0,0.0
45410,4,5410,[302 603 100 427  64],339,5,20345,3.7599334688597303,20.0,20.0
45411,4,5411,[302 603 100 427  64],370,5,20350,3.7601626016260163,20.0,20.0
45412,4,5412,[302 603 100 427  64],370,5,20355,3.7603916497321266,20.0,20.0
45413,4,5413,[204 237 185 496  97],60,4,20359,3.7604359069080164,0.0,0.0
45414,4,5414,[302 603 100 427  64],454,5,20364,3.7606648199445982,20.0,20.0
45415,4,5415,[471 385 132 111 100],13,3,20367,3.7605243722304285,0.0,20.0
45416,4,5416,[118 318 182 546  89],653,2,20369,3.760199372346317,20.0,0.0
45417,4,5417,[100 183 515 286  56],537,3,20372,3.7600590623846437,0.0,20.0
45418,4,5418,[183   1 568 118  11],59,4,20376,3.7601033400996493,0.0,0.0
45419,4,5419,[194 286 180 385 161],234,1,20377,3.7595940959409595,0.0,0.0
45420,4,5420,[228 471 100 235 183],447,4,20381,3.7596384430916805,0.0,20.0
45421,4,5421,[323 172 328 515 228],13,2,20383,3.7593139063076357,0.0,0.0
45422,4,5422,[313 195   1  79 234],102,1,20384,3.7588050894338925,0.0,0.0
45423,4,5423,[195 222 475 127 121],669,1,20385,3.7582964601769913,0.0,20.0
45424,4,5424,[ 95 655 403 180 172],479,4,20389,3.758341013824885,0.0,0.0
45425,4,5425,[216  56  12 194 423],378,5,20394,3.758569848875783,20.0,0.0
45426,4,5426,[235 211   8 222 168],125,3,20397,3.758430071862908,0.0,0.0
45427,4,5427,[269 117  69 235  88],271,3,20400,3.7582903463522475,0.0,0.0
45428,4,5428,[258 117 483 194 237],537,2,20402,3.757966476330816,20.0,0.0
45429,4,5429,[ 15  96 276 117 191],378,4,20406,3.758011049723757,0.0,0.0
45430,4,5430,[  8 234  56 132 172],840,4,20410,3.7580556067022646,0.0,0.0
45431,4,5431,[ 56   4  95 546 125],271,2,20412,3.7577319587628866,0.0,0.0
45432,4,5432,[211 204 228 202  11],7,3,20415,3.7575924903368305,0.0,0.0
45433,4,5433,[ 79 196 403 153 125],234,0,20415,3.756900993743099,0.0,0.0
45434,4,5434,[210 313 288  95 216],13,2,20417,3.756577736890524,0.0,0.0
45435,4,5435,[302 603 100 427  64],664,5,20422,3.7568064753495216,20.0,20.0
45436,4,5436,[302 603 100 427  64],745,5,20427,3.757035129667096,20.0,20.0
45437,4,5437,[302 603 100 427  64],13,5,20432,3.7572636998896654,20.0,20.0
45438,4,5438,[ 69 435 153   4 385],64,3,20435,3.7571244714101857,0.0,0.0
45439,4,5439,[302 603 100 427  64],745,5,20440,3.7573529411764706,20.0,20.0
45440,4,5440,[ 22  64 186  28 180],881,4,20444,3.757397537217423,0.0,0.0
45441,4,5441,[ 56  96 174 200 197],749,4,20448,3.7574421168687984,0.0,20.0
45442,4,5442,[151  97 216 182 427],234,1,20449,3.7569355135035827,0.0,0.0
45443,4,5443,[ 69 204 185 234  22],653,3,20452,3.7567964731814842,0.0,0.0
45444,4,5444,[302 603 100 427  64],664,5,20457,3.7570247933884295,20.0,20.0
45445,4,5445,[200 313 179 568 269],13,1,20458,3.7565185457216304,0.0,0.0
45446,4,5446,[ 12 161 118 151   1],380,3,20461,3.7563796585276297,20.0,0.0
45447,4,5447,[302 603 100 427  64],271,5,20466,3.7566079295154187,20.0,20.0
45448,4,5448,[302 603 100 427  64],271,5,20471,3.756836116718664,20.0,20.0
45449,4,5449,[176  98   4  97 385],328,2,20473,3.75651376146789,0.0,20.0
45450,4,5450,[ 25 111 235 301 313],119,5,20478,3.7567418822234453,0.0,0.0
45451,4,5451,[127 187 151 265 185],537,3,20481,3.7566030814380045,0.0,20.0
45452,4,5452,[180 546  71 132 185],749,4,20485,3.7566477168531085,0.0,0.0
45453,4,5453,[302 603 100 427  64],664,5,20490,3.756875687568757,20.0,20.0
45454,4,5454,[655 318 483   8  25],207,4,20494,3.7569202566452797,40.0,0.0
45455,4,5455,[496 211 333  50  56],64,4,20498,3.756964809384164,0.0,20.0
45456,4,5456,[302 603 100 427  64],454,5,20503,3.7571925966648343,20.0,20.0
45457,4,5457,[117  82   4  11 183],538,3,20506,3.7570538658849397,0.0,0.0
45458,4,5458,[328  95  70 405 194],95,3,20509,3.756915185931489,0.0,0.0
45459,4,5459,[ 70 204 179 678 161],7,2,20511,3.7565934065934066,0.0,0.0
45460,4,5460,[125  56 202 194   8],313,2,20513,3.7562717451016296,0.0,0.0
45461,4,5461,[275 172  22 313  82],64,4,20517,3.7563163676309044,0.0,0.0
45462,4,5462,[153 194 211 132  22],13,5,20522,3.7565440234303495,0.0,0.0
45463,4,5463,[191  95 282 403 195],92,4,20526,3.756588579795022,0.0,0.0
45464,4,5464,[127 176 222 132 117],213,4,20530,3.756633119853614,0.0,20.0
45465,4,5465,[204 144 173 318 276],92,3,20533,3.756494694474936,20.0,0.0
45466,4,5466,[302 603 100 427  64],666,5,20538,3.7567221510883484,20.0,20.0
45467,4,5467,[302 603 100 427  64],666,5,20543,3.756949524506218,20.0,20.0
45468,4,5468,[ 98 172  11 186 323],804,5,20548,3.7571768147741818,0.0,20.0
45469,4,5469,[191 748 197 185 186],311,3,20551,3.757038391224863,0.0,0.0
45470,4,5470,[  9 179 174 435 742],881,3,20554,3.756900018278194,0.0,20.0
45471,4,5471,[  8 197 174 276 294],271,3,20557,3.756761695906433,0.0,20.0
45472,4,5472,[302 603 100 427  64],90,5,20562,3.756988854376028,20.0,20.0
45473,4,5473,[302 603 100 427  64],271,5,20567,3.757215929850201,20.0,20.0
45474,4,5474,[235 597 100 216 265],308,1,20568,3.756712328767123,0.0,20.0
45475,4,5475,[196 187 568 435 151],64,4,20572,3.7567567567567566,0.0,0.0
45476,4,5476,[302 603 100 427  64],537,4,20576,3.756801168522914,20.0,20.0
45477,4,5477,[496  79 265 483  50],537,3,20579,3.7566630156991603,20.0,20.0
45478,4,5478,[302 603 100 427  64],745,5,20584,3.7568899434203322,20.0,20.0
45479,4,5479,[237  96 678  79 100],474,4,20588,3.756934306569343,0.0,20.0
45480,4,5480,[176 483 588 151 318],200,4,20592,3.7569786535303775,40.0,0.0
45481,4,5481,[195 258 235 271 132],13,2,20594,3.7566581539584094,0.0,0.0
45482,4,5482,[302 603 100 427  64],745,5,20599,3.756884917016232,20.0,20.0
45483,4,5483,[357 471 132 168  79],815,3,20602,3.7567469000729394,20.0,0.0
45484,4,5484,[603 216  79 435 197],326,2,20604,3.756426618049225,20.0,0.0
45485,4,5485,[181   9  50 215  89],7,4,20608,3.7564710171345244,0.0,20.0
45486,4,5486,[302 603 100 427  64],13,5,20613,3.7566976489885184,20.0,20.0
45487,4,5487,[187  15 125 258 121],749,3,20616,3.7565597667638486,0.0,0.0
45488,4,5488,[435 271 125  69 300],788,2,20618,3.7562397522317363,0.0,0.0
45489,4,5489,[268   1 237 200 300],13,2,20620,3.75591985428051,0.0,0.0
45490,4,5490,[135  82 180 222 265],892,4,20624,3.7559643052267346,0.0,0.0
45491,4,5491,[ 56 423 143 117 144],13,3,20627,3.7558266569555716,0.0,0.0
45492,4,5492,[ 70 483 235  28  56],537,3,20630,3.755689058802112,20.0,0.0
45493,4,5493,[  1 176 301 276 174],234,0,20630,3.755005460502366,0.0,20.0
45494,4,5494,[302 603 100 427  64],339,5,20635,3.7552320291173795,20.0,20.0
45495,4,5495,[302 603 100 427  64],271,5,20640,3.7554585152838427,20.0,20.0
45496,4,5496,[302 603 100 427  64],745,5,20645,3.755684919046753,20.0,20.0
45497,4,5497,[ 50 222 168 546  70],82,3,20648,3.75554747180793,0.0,20.0
45498,4,5498,[210 216 172 182  22],840,2,20650,3.75522822331333,0.0,0.0
45499,4,5499,[357 173 151 168 268],7,4,20654,3.755272727272727,20.0,0.0
45500,4,5500,[ 28 294 222  82  71],92,2,20656,3.754953644791856,0.0,0.0
45501,4,5501,[ 70 143 211  11 483],406,3,20659,3.7548164303889493,20.0,0.0
45502,4,5502,[302 603 100 427  64],666,5,20664,3.7550427039796475,20.0,20.0
45503,4,5503,[100 289  64 655 202],378,4,20668,3.7550872093023258,0.0,20.0
45504,4,5504,[186  95 228 210  82],92,3,20671,3.7549500454132607,0.0,0.0
45505,4,5505,[302 603 100 427  64],666,5,20676,3.755176171449328,20.0,20.0
45506,4,5506,[ 95 172 187 100  11],334,3,20679,3.755039041220265,0.0,20.0
45507,4,5507,[302 603 100 427  64],271,5,20684,3.755265068990559,20.0,20.0
45508,4,5508,[302 603 100 427  64],271,5,20689,3.755491014703213,20.0,20.0
45509,4,5509,[302 603 100 427  64],90,5,20694,3.755716878402904,20.0,20.0
45510,4,5510,[294 385 181 174 200],650,4,20698,3.7557612048630014,0.0,20.0
45511,4,5511,[515 179 282  12 508],334,4,20702,3.7558055152394774,20.0,0.0
45512,4,5512,[228 174  79 215  97],506,5,20707,3.756031198984219,0.0,20.0
45513,4,5513,[ 64 435 328 222 216],537,0,20707,3.7553500181356547,0.0,0.0
45514,4,5514,[234 546 210 235 135],378,3,20710,3.755213055303717,0.0,0.0
45515,4,5515,[302 603 100 427  64],370,5,20715,3.7554387237128353,20.0,20.0
45516,4,5516,[202 546 258 273 405],7,2,20717,3.755120536523473,0.0,0.0
45517,4,5517,[143  50   1 276  71],308,5,20722,3.755346139905763,0.0,20.0
45518,4,5518,[187 496  71 294 174],308,3,20725,3.7552092770429426,0.0,20.0
45519,4,5519,[302 603 100 427  64],666,5,20730,3.755434782608696,20.0,20.0
45520,4,5520,[100 471 286 111 211],234,1,20731,3.754935700054338,0.0,20.0
45521,4,5521,[210 180  71 588  56],378,4,20735,3.754980079681275,0.0,0.0
45522,4,5522,[302 603 100 427  64],370,5,20740,3.755205504254934,20.0,20.0
45523,4,5523,[302 603 100 427  64],664,5,20745,3.755430847212165,20.0,20.0
45524,4,5524,[302 603 100 427  64],271,5,20750,3.755656108597285,20.0,20.0
45525,4,5525,[357 269  69   9  89],13,2,20752,3.7553384002895402,20.0,0.0
45526,4,5526,[151 161 118 135 282],881,3,20755,3.755201736927809,0.0,0.0
45527,4,5527,[186 508 204 357  89],387,3,20758,3.75506512301013,20.0,0.0
45528,4,5528,[302 603 100 427  64],458,5,20763,3.755290287574607,20.0,20.0
45529,4,5529,[302 603 100 427  64],474,5,20768,3.755515370705244,20.0,20.0
45530,4,5530,[118   4 132 153 318],87,5,20773,3.7557403724462124,20.0,0.0
45531,4,5531,[ 22 222 271 328 235],479,3,20776,3.755603759942155,0.0,0.0
45532,4,5532,[173 211 222  89  98],60,5,20781,3.755828664377372,0.0,20.0
45533,4,5533,[508 423 385 125 210],59,4,20785,3.7558727864112758,0.0,0.0
45534,4,5534,[ 88 200 197 385 143],537,1,20786,3.7553748870822043,0.0,0.0
45535,4,5535,[302 603 100 427  64],745,5,20791,3.755599710982659,20.0,20.0
45536,4,5536,[302 603 100 427  64],370,5,20796,3.7558244536752756,20.0,20.0
45537,4,5537,[301 588 210 271  71],650,0,20796,3.7551462621885157,0.0,0.0
45538,4,5538,[258  82 228 333 121],653,4,20800,3.7551904675934282,0.0,0.0
45539,4,5539,[483  97 300 181 742],533,4,20804,3.7552346570397113,20.0,0.0
45540,4,5540,[302 603 100 427  64],370,5,20809,3.7554593033748422,20.0,20.0
45541,4,5541,[181 132 302 144 237],328,5,20814,3.7556838686394802,0.0,0.0
45542,4,5542,[143 300 222  50 168],666,1,20815,3.7551867219917012,0.0,20.0
45543,4,5543,[678 238 183  64 546],749,2,20817,3.7548701298701297,0.0,0.0
45544,4,5544,[302 603 100 427  64],745,5,20822,3.7550946798917946,20.0,20.0
45545,4,5545,[302 603 100 427  64],745,5,20827,3.75531914893617,20.0,20.0
45546,4,5546,[603 258  88 301 180],13,4,20831,3.755363259419506,20.0,0.0
45547,4,5547,[215 257  15 195 603],308,3,20834,3.7552271088680604,20.0,0.0
45548,4,5548,[302 603 100 427  64],474,5,20839,3.755451432690575,20.0,20.0
45549,4,5549,[302 603 100 427  64],370,5,20844,3.7556756756756755,20.0,20.0
45550,4,5550,[ 22 127 161 300 153],188,4,20848,3.7557196901459196,0.0,20.0
45551,4,5551,[302 603 100 427  64],745,5,20853,3.7559438040345823,20.0,20.0
45552,4,5552,[302 603 100 427  64],13,5,20858,3.756167837205114,20.0,20.0
45553,4,5553,[302 603 100 427  64],537,4,20862,3.7562117392870005,20.0,20.0
45554,4,5554,[111 228 211 405 195],643,4,20866,3.7562556255625563,0.0,0.0
45555,4,5555,[187  69 191 185 483],184,4,20870,3.7562994960403167,20.0,0.0
45556,4,5556,[ 82 174 176 210  50],650,3,20873,3.7561633975166457,0.0,40.0
45557,4,5557,[ 97 191 483 496 121],537,3,20876,3.7560273479668944,20.0,0.0
45558,4,5558,[302 603 100 427  64],370,5,20881,3.756251124302932,20.0,20.0
45559,4,5559,[194   1 135  22  96],234,3,20884,3.756115107913669,0.0,0.0
45560,4,5560,[302 603 100 427  64],745,5,20889,3.756338787987772,20.0,20.0
45561,4,5561,[302 603 100 427  64],474,5,20894,3.756562387630349,20.0,20.0
45562,4,5562,[195 748 435 143 483],648,4,20898,3.7566061477619987,20.0,0.0
45563,4,5563,[655 195 191 179  79],738,2,20900,3.756290438533429,0.0,0.0
45564,4,5564,[302 603 100 427  64],458,5,20905,3.756513926325247,20.0,20.0
45565,4,5565,[175 100 195 216 265],313,5,20910,3.7567373338124326,0.0,20.0
45566,4,5566,[302 603 100 427  64],339,5,20915,3.7569606610382613,20.0,20.0
45567,4,5567,[302 603 100 427  64],666,5,20920,3.757183908045977,20.0,20.0
45568,4,5568,[ 88 176 269   1   8],378,5,20925,3.757407074878793,0.0,0.0
45569,4,5569,[216 132  82 143  15],311,4,20929,3.757450628366248,0.0,0.0
45570,4,5570,[302 603 100 427  64],370,5,20934,3.75767366720517,20.0,20.0
45571,4,5571,[191 483 603 132 121],749,4,20938,3.757717157214645,40.0,0.0
45572,4,5572,[143 153  82 568  70],194,0,20938,3.757042885340032,0.0,0.0
45573,4,5573,[144 168 588   8 194],387,2,20940,3.7567276641550054,0.0,0.0
45574,4,5574,[ 96 200   4  89 282],788,3,20943,3.756591928251121,0.0,0.0
45575,4,5575,[302 603 100 427  64],13,5,20948,3.7568149210903874,20.0,20.0
45576,4,5576,[  7 143 385 182  22],524,1,20949,3.7563206024744487,0.0,0.0
45577,4,5577,[302 603 100 427  64],13,5,20954,3.756543564001434,20.0,20.0
45578,4,5578,[302 603 100 427  64],339,5,20959,3.75676644559957,20.0,20.0
45579,4,5579,[174 118 179 333 194],881,4,20963,3.756810035842294,0.0,20.0
45580,4,5580,[588 151 483 323 118],59,4,20967,3.7568536104640744,20.0,0.0
45581,4,5581,[ 79  98 300 318 182],334,3,20970,3.75671802221426,20.0,20.0
45582,4,5582,[ 79 568  71 215 183],506,5,20975,3.756940712878381,0.0,0.0
45583,4,5583,[ 28 132 211 483 265],7,5,20980,3.757163323782235,20.0,0.0
45584,4,5584,[475 301 385 265  71],13,2,20982,3.7568487018800356,0.0,0.0
45585,4,5585,[508  79 182 168 235],524,3,20985,3.7567132116004296,0.0,0.0
45586,4,5586,[187 597 196  56 175],774,0,20985,3.7560408090209414,0.0,0.0
45587,4,5587,[ 79 289 269  56 132],488,2,20987,3.755726556907659,0.0,0.0
45588,4,5588,[  4  56 168 288 273],218,2,20989,3.755412417248166,0.0,0.0
45589,4,5589,[302 603 100 427  64],537,4,20993,3.7554561717352417,20.0,20.0
45590,4,5590,[302 603 100 427  64],13,5,20998,3.755678769450903,20.0,20.0
45591,4,5591,[  1 132   9 185 194],788,4,21002,3.755722460658083,0.0,0.0
45592,4,5592,[179 210 294 174   7],537,2,21004,3.755408546397282,0.0,20.0
45593,4,5593,[357 204 144 678  15],308,2,21006,3.7550947443689666,20.0,0.0
45594,4,5594,[143 588  25   1 318],892,4,21010,3.7551385165326185,20.0,0.0
45595,4,5595,[182  98 194   1  12],387,4,21014,3.75518227305218,20.0,20.0
45596,4,5596,[302 603 100 427  64],90,5,21019,3.7554046810791495,20.0,20.0
45597,4,5597,[302 603 100 427  64],13,5,21024,3.7556270096463025,20.0,20.0
45598,4,5598,[435 195 286 132 153],298,4,21028,3.7556706554741917,0.0,0.0
45599,4,5599,[302 603 100 427  64],745,5,21033,3.755892857142857,20.0,20.0
45600,4,5600,[191 222 176 153  98],666,4,21037,3.7559364399214425,0.0,20.0
45601,4,5601,[302 603 100 427  64],370,5,21042,3.756158514816137,20.0,20.0
45602,4,5602,[302 603 100 427  64],339,5,21047,3.7563805104408354,20.0,20.0
45603,4,5603,[ 50 238 187 204 210],385,2,21049,3.7560670949321913,0.0,20.0
45604,4,5604,[302 603 100 427  64],339,5,21054,3.7562890276538803,20.0,20.0
45605,4,5605,[144 181 588 194 127],95,4,21058,3.7563325008919017,0.0,20.0
45606,4,5606,[302 603 100 427  64],90,5,21063,3.756554307116105,20.0,20.0
45607,4,5607,[143 215 289 111   8],234,2,21065,3.756241084165478,0.0,0.0
45608,4,5608,[508 210 132 173 603],474,4,21069,3.7562845426992335,20.0,0.0
45609,4,5609,[135 222  28 323  88],200,4,21073,3.7563279857397505,0.0,0.0
45610,4,5610,[302 603 100 427  64],454,5,21078,3.756549634646231,20.0,20.0
45611,4,5611,[568 202 180 265 143],194,1,21079,3.7560584461867426,0.0,0.0
45612,4,5612,[118 328   1 289 181],378,4,21083,3.756101906288972,0.0,0.0
45613,4,5613,[302 603 100 427  64],537,4,21087,3.7561453509084433,20.0,20.0
45614,4,5614,[302 603 100 427  64],458,5,21092,3.756366874443455,20.0,20.0
45615,4,5615,[191 132 195 210  15],650,3,21095,3.7562321937321936,0.0,0.0
45616,4,5616,[405 202 143 471 172],479,4,21099,3.756275591953,0.0,0.0
45617,4,5617,[175 302 405 269 286],13,2,21101,3.7559629761480955,0.0,0.0
45618,4,5618,[435 176 276 153 173],883,5,21106,3.7561843744438512,0.0,0.0
45619,4,5619,[603  89 655  97 187],59,5,21111,3.7564056939501778,20.0,0.0
45620,4,5620,[111 100  50 655  96],474,5,21116,3.7566269347091263,0.0,40.0
45621,4,5621,[ 56  69 271  22 515],13,3,21119,3.756492351476343,0.0,0.0
45622,4,5622,[ 56  70 161 197 143],234,1,21120,3.7560021340921215,0.0,0.0
45623,4,5623,[597 183  64   8 187],144,5,21125,3.7562233285917497,0.0,0.0
45624,4,5624,[258 475 121 300 275],486,4,21129,3.756266666666667,0.0,0.0
45625,4,5625,[245 300 435 222 301],102,0,21129,3.7555990046214007,0.0,0.0
45626,4,5626,[546 427 161 405 302],271,2,21131,3.7552870090634443,0.0,0.0
45627,4,5627,[302 603 100 427  64],454,5,21136,3.755508173418621,20.0,20.0
45628,4,5628,[302 603 100 427  64],90,5,21141,3.7557292591934623,20.0,20.0
45629,4,5629,[302 603 100 427  64],745,5,21146,3.7559502664298403,20.0,20.0
45630,4,5630,[302 603 100 427  64],745,5,21151,3.756171195169597,20.0,20.0
45631,4,5631,[185 288  69 175 471],666,3,21154,3.7560369318181817,0.0,0.0
45632,4,5632,[204  71 151  82 194],881,3,21157,3.7559027161370495,0.0,0.0
45633,4,5633,[143  95 228 197 302],334,3,21160,3.7557685481008165,0.0,0.0
45634,4,5634,[181   9 276 301 265],455,4,21164,3.755811889973381,0.0,0.0
45635,4,5635,[200 195 515 357  89],60,5,21169,3.7560326472675656,20.0,0.0
45636,4,5636,[118 168  88   8  11],897,2,21171,3.7557211282597125,0.0,0.0
45637,4,5637,[237  89 135  82  71],452,1,21172,3.755232351897836,0.0,0.0
45638,4,5638,[423 301  50 238 275],184,4,21176,3.755275758113141,0.0,20.0
45639,4,5639,[185  69 483 318 603],308,3,21179,3.7551418439716313,60.0,0.0
45640,4,5640,[234  95 286 265 568],648,3,21182,3.755007977308988,0.0,0.0
45641,4,5641,[ 22 313 276 204 195],474,5,21187,3.7552286423254166,0.0,0.0
45642,4,5642,[302 603 100 427  64],271,5,21192,3.75544922913344,20.0,20.0
45643,4,5643,[302 603 100 427  64],664,5,21197,3.7556697377746278,20.0,20.0
45644,4,5644,[385 191  98 180  96],207,2,21199,3.755358724534987,0.0,20.0
45645,4,5645,[328 357 197 117 483],263,4,21203,3.755402054551895,40.0,0.0
45646,4,5646,[  7  70 187  79  11],474,5,21208,3.7556224544005667,0.0,0.0
45647,4,5647,[132 180 161 197 228],311,5,21213,3.755842776203966,0.0,0.0
45648,4,5648,[ 71 300 282 179  12],334,3,21216,3.75570897503983,20.0,0.0
45649,4,5649,[121 210 183 196  50],934,3,21219,3.755575221238938,0.0,20.0
45650,4,5650,[121 176 215 294 173],7,3,21222,3.755441514776146,0.0,0.0
45651,4,5651,[ 89 475 483 100 546],343,3,21225,3.755307855626327,20.0,20.0
45652,4,5652,[302 603 100 427  64],454,5,21230,3.7555280382098,20.0,20.0
45653,4,5653,[  8 245 742  95 269],334,1,21231,3.7550406791651927,0.0,0.0
45654,4,5654,[302 603 100 427  64],474,5,21236,3.7552608311229,20.0,20.0
45655,4,5655,[ 95 182 237 161 179],749,1,21237,3.7547736916548797,0.0,0.0
45656,4,5656,[ 56  79 282 597 125],374,5,21242,3.754993812975075,0.0,0.0
45657,4,5657,[  4 118 191 496 117],378,2,21244,3.7546836337928595,0.0,0.0
45658,4,5658,[302 603 100 427  64],271,5,21249,3.75490369323202,20.0,20.0
45659,4,5659,[258  98 603 186  56],579,3,21252,3.7547703180212015,20.0,20.0
45660,4,5660,[181 238 427 234  89],833,1,21253,3.754283695460166,0.0,0.0
45661,4,5661,[182 471 742 143 385],207,2,21255,3.753973860826563,0.0,0.0
45662,4,5662,[ 12  79  97 143  82],64,3,21258,3.753840720466184,20.0,0.0
45663,4,5663,[302 603 100 427  64],90,5,21263,3.754060734463277,20.0,20.0
45664,4,5664,[118 204 216 258 196],653,1,21264,3.7535745807590466,0.0,0.0
45665,4,5665,[302 603 100 427  64],664,5,21269,3.753794564066361,20.0,20.0
45666,4,5666,[185 603 427 276 168],474,4,21273,3.753838009528851,20.0,0.0
45667,4,5667,[ 69   4  11 302  82],207,3,21276,3.7537050105857444,0.0,0.0
45668,4,5668,[302 603 100 427  64],13,5,21281,3.753924854471688,20.0,20.0
45669,4,5669,[286 181 185 435 204],7,4,21285,3.753968253968254,0.0,0.0
45670,4,5670,[483 127 286 300 427],85,3,21288,3.7538353024157995,20.0,20.0
45671,4,5671,[405 235 271 211 182],788,2,21290,3.7535260930888574,0.0,0.0
45672,4,5672,[302 603 100 427  64],90,5,21295,3.753745813502556,20.0,20.0
45673,4,5673,[179 172 237 181 483],13,4,21299,3.753789213958407,20.0,0.0
45674,4,5674,[302 603 100 427  64],664,5,21304,3.7540088105726874,20.0,20.0
45675,4,5675,[302 603 100 427  64],454,5,21309,3.754228329809725,20.0,20.0
45676,4,5676,[  8 185 200  96 237],543,5,21314,3.7544477717104106,0.0,0.0
45677,4,5677,[333   9 135 273  69],145,3,21317,3.7543148996125395,0.0,0.0
45678,4,5678,[100 546 276 174 257],825,4,21321,3.7543581616481774,0.0,40.0
45679,4,5679,[302 603 100 427  64],454,5,21326,3.754577464788732,20.0,20.0
45680,4,5680,[ 96 423  95   8 118],892,5,21331,3.754796690723464,0.0,0.0
45681,4,5681,[238 179 182 185 385],207,2,21333,3.7544878563885957,0.0,0.0
45682,4,5682,[483 168 496 194 135],313,4,21337,3.7545310575400315,20.0,0.0
45683,4,5683,[302 603 100 427  64],474,5,21342,3.754750175932442,20.0,20.0
45684,4,5684,[100 483  15 144 186],488,2,21344,3.7544415127528583,20.0,20.0
45685,4,5685,[302 603 100 427  64],666,5,21349,3.754660569820612,20.0,20.0
45686,4,5686,[357  88 194 183  12],13,4,21353,3.754703710216283,40.0,0.0
45687,4,5687,[202 135 216 197  56],90,4,21357,3.7547468354430378,0.0,0.0
45688,4,5688,[302 603 100 427  64],90,5,21362,3.754965723325716,20.0,20.0
45689,4,5689,[483  22 118 245 471],313,3,21365,3.7548330404217927,20.0,0.0
45690,4,5690,[222  98 197 318  97],653,1,21366,3.754348972061149,20.0,20.0
45691,4,5691,[265 483 435 161 151],313,4,21370,3.7543921293042866,20.0,0.0
45692,4,5692,[ 15 181 318  64 132],59,5,21375,3.754610925698226,20.0,0.0
45693,4,5693,[  7 258 111 323   1],378,3,21378,3.754478398314015,0.0,0.0
45694,4,5694,[302 603 100 427  64],666,5,21383,3.7546971027216856,20.0,20.0
45695,4,5695,[302 603 100 427  64],474,5,21388,3.754915730337079,20.0,20.0
45696,4,5696,[302 603 100 427  64],454,5,21393,3.755134281200632,20.0,20.0
45697,4,5697,[111 258 357 153 187],749,3,21396,3.755001755001755,20.0,0.0
45698,4,5698,[302 603 100 427  64],13,5,21401,3.7552202140726445,20.0,20.0
45699,4,5699,[302 603 100 427  64],458,5,21406,3.7554385964912282,20.0,20.0
45700,4,5700,[302 603 100 427  64],664,5,21411,3.7556569022978423,20.0,20.0
45701,4,5701,[302 603 100 427  64],745,5,21416,3.7558751315327954,20.0,20.0
45702,4,5702,[302 603 100 427  64],370,5,21421,3.756093284236367,20.0,20.0
45703,4,5703,[ 69 588 204  88 210],290,5,21426,3.756311360448808,0.0,0.0
45704,4,5704,[302 603 100 427  64],537,4,21430,3.7563540753724802,20.0,20.0
45705,4,5705,[ 22 153   1 257 174],738,3,21433,3.7562215212057484,0.0,20.0
45706,4,5706,[ 89 111  28 100 483],479,4,21437,3.7562642369020502,20.0,20.0
45707,4,5707,[302 603 100 427  64],13,5,21442,3.7564821303433775,20.0,20.0
45708,4,5708,[ 50 196 257 194 471],533,5,21447,3.7566999474513927,0.0,20.0
45709,4,5709,[302 603 100 427  64],745,5,21452,3.7569176882661997,20.0,20.0
45710,4,5710,[435  15 234 322  79],749,5,21457,3.757135352827876,0.0,0.0
45711,4,5711,[435 322 475 328 183],207,1,21458,3.7566526610644257,0.0,0.0
45712,4,5712,[111  22 185  96 183],488,4,21462,3.7566952564326974,0.0,0.0
45713,4,5713,[302 603 100 427  64],537,4,21466,3.7567378368918445,20.0,20.0
45714,4,5714,[302 603 100 427  64],339,5,21471,3.756955380577428,20.0,20.0
45715,4,5715,[282 222 216  70 176],533,4,21475,3.756997900629811,0.0,0.0
45716,4,5716,[742 183 588  22 186],378,4,21479,3.7570404058072415,0.0,0.0
45717,4,5717,[194 196 748 100 323],474,3,21482,3.756908009793634,0.0,20.0
45718,4,5718,[302 603 100 427  64],458,5,21487,3.757125371568456,20.0,20.0
45719,4,5719,[483 288 210 176 172],234,1,21488,3.7566433566433566,20.0,0.0
45720,4,5720,[302 603 100 427  64],90,5,21493,3.7568606886907885,20.0,20.0
45721,4,5721,[ 69 286 276 496 423],537,2,21495,3.756553652569032,0.0,0.0
45722,4,5722,[302 603 100 427  64],271,5,21500,3.756770924340381,20.0,20.0
45723,4,5723,[265 385   7   9 186],379,4,21504,3.756813417190776,0.0,0.0
45724,4,5724,[ 71 181 235 228   1],313,3,21507,3.7566812227074236,0.0,0.0
45725,4,5725,[427 597 175 143 195],13,2,21509,3.756374432413552,0.0,0.0
45726,4,5726,[ 70 175 182  11 273],90,2,21511,3.7560677492579013,0.0,0.0
45727,4,5727,[302 603 100 427  64],13,5,21516,3.756284916201117,20.0,20.0
45728,4,5728,[302 603 100 427  64],339,5,21521,3.756502007331122,20.0,20.0
45729,4,5729,[302 603 100 427  64],474,5,21526,3.756719022687609,20.0,20.0
45730,4,5730,[191 151 568  89 496],64,3,21529,3.756586983074507,0.0,0.0
45731,4,5731,[302 603 100 427  64],458,5,21534,3.756803907885555,20.0,20.0
45732,4,5732,[289 191 234 175  71],13,3,21537,3.7566718995290422,0.0,0.0
45733,4,5733,[172 588 151  97 211],804,4,21541,3.756714335542379,0.0,0.0
45734,4,5734,[ 71 100 161 357  50],313,5,21546,3.75693112467306,20.0,40.0
45735,4,5735,[127 282 483 182 161],326,1,21547,3.756450488145049,20.0,20.0
45736,4,5736,[302 603 100 427  64],370,5,21552,3.7566672476904306,20.0,20.0
45737,4,5737,[302 603 100 427  64],90,5,21557,3.756883931683513,20.0,20.0
45738,4,5738,[302 603 100 427  64],271,5,21562,3.757100540163792,20.0,20.0
45739,4,5739,[302 603 100 427  64],664,5,21567,3.7573170731707317,20.0,20.0
45740,4,5740,[655 603 238 151 678],804,4,21571,3.757359345061836,20.0,0.0
45741,4,5741,[302 603 100 427  64],339,5,21576,3.757575757575758,20.0,20.0
45742,4,5742,[302 603 100 427  64],664,5,21581,3.757792094724012,20.0,20.0
45743,4,5743,[302 603 100 427  64],13,5,21586,3.758008356545961,20.0,20.0
45744,4,5744,[235   8 568 194 183],87,4,21590,3.7580504786771107,0.0,0.0
45745,4,5745,[302 603 100 427  64],454,5,21595,3.7582666202575705,20.0,20.0
45746,4,5746,[117 183 195 202 238],774,3,21598,3.758134678962937,0.0,0.0
45747,4,5747,[748 143 125 211 132],653,1,21599,3.7576548364648574,0.0,0.0
45748,4,5748,[302 603 100 427  64],745,5,21604,3.757870934075491,20.0,20.0
45749,4,5749,[182 200 187 175 127],385,4,21608,3.757913043478261,0.0,20.0
45750,4,5750,[471 258  56   9 385],13,2,21610,3.7576073726308468,0.0,0.0
45751,4,5751,[302 603 100 427  64],90,5,21615,3.7578233657858138,20.0,20.0
45752,4,5752,[508 237 175 187 118],59,4,21619,3.7578654614983487,0.0,0.0
45753,4,5753,[603 234 173 185  71],398,5,21624,3.7580813347236703,20.0,0.0
45754,4,5754,[ 97 238 273 588 678],537,1,21625,3.7576020851433536,0.0,0.0
45755,4,5755,[322 127  50 269 132],13,3,21628,3.757470465601112,0.0,40.0
45756,4,5756,[302 603 100 427  64],370,5,21633,3.757686294945284,20.0,20.0
45757,4,5757,[300 204 275 678  28],334,2,21635,3.7573810350816257,0.0,0.0
45758,4,5758,[282 546 385  28  96],95,4,21639,3.7574231637437054,0.0,0.0
45759,4,5759,[161 172 357  97 197],311,5,21644,3.7576388888888888,20.0,0.0
45760,4,5760,[273 173 185 143 496],897,3,21647,3.7575073771914598,0.0,0.0
45761,4,5761,[ 88 183 186  22 135],311,4,21651,3.757549461992364,0.0,0.0
45762,4,5762,[183  50   7 121 427],890,3,21654,3.7574180114523688,0.0,20.0
45763,4,5763,[294 176 135  79 405],328,3,21657,3.7572866065232478,0.0,0.0
45764,4,5764,[302 603 100 427  64],745,5,21662,3.7575021682567216,20.0,20.0
45765,4,5765,[275 179  97 215  69],90,3,21665,3.757370794311481,0.0,0.0
45766,4,5766,[302 603 100 427  64],664,5,21670,3.7575862666897866,20.0,20.0
45767,4,5767,[302 603 100 427  64],370,5,21675,3.7578016643550622,20.0,20.0
45768,4,5768,[302 603 100 427  64],339,5,21680,3.7580169873461604,20.0,20.0
45769,4,5769,[302 603 100 427  64],664,5,21685,3.7582322357019065,20.0,20.0
45770,4,5770,[302 603 100 427  64],458,5,21690,3.7584474094610987,20.0,20.0
45771,4,5771,[273 286 597  69 742],59,1,21691,3.757969507969508,0.0,0.0
45772,4,5772,[180 265 111 235  25],537,1,21692,3.7574917720422656,0.0,0.0
45773,4,5773,[300 265 118 257 302],271,3,21695,3.757360581918947,0.0,0.0
45774,4,5774,[302 603 100 427  64],458,5,21700,3.757575757575758,20.0,20.0
45775,4,5775,[302 603 100 427  64],339,5,21705,3.7577908587257616,20.0,20.0
45776,4,5776,[302 603 100 427  64],666,5,21710,3.758005885407651,20.0,20.0
45777,4,5777,[302 603 100 427  64],339,5,21715,3.75822083766009,20.0,20.0
45778,4,5778,[302 603 100 427  64],745,5,21720,3.7584357155217165,20.0,20.0
45779,4,5779,[302 603 100 427  64],271,5,21725,3.758650519031142,20.0,20.0
45780,4,5780,[210   1 234 168 121],804,5,21730,3.7588652482269502,0.0,0.0
45781,4,5781,[302 603 100 427  64],474,5,21735,3.7590799031476996,20.0,20.0
45782,4,5782,[405 302 742  15 276],486,3,21738,3.758948642573059,0.0,0.0
45783,4,5783,[181 172  64 748 191],311,5,21743,3.7591632088520055,0.0,0.0
45784,4,5784,[235  95 196 276 357],398,4,21747,3.7592048401037164,20.0,0.0
45785,4,5785,[ 56  79 357 135   4],804,3,21750,3.759073625993778,20.0,0.0
45786,4,5786,[215 161 234 403 132],804,4,21754,3.7591152583376535,0.0,0.0
45787,4,5787,[302 603 100 427  64],474,5,21759,3.7593296475466484,20.0,20.0
45788,4,5788,[200 196 117 143 313],13,2,21761,3.759025738469511,0.0,0.0
45789,4,5789,[144 204 568   4 742],804,5,21766,3.759240069084629,0.0,0.0
45790,4,5790,[403 182  15 187 238],59,5,21771,3.7594543256777757,0.0,0.0
45791,4,5791,[ 56 318 215 117 234],537,2,21773,3.759150552486188,20.0,0.0
45792,4,5792,[ 97 678 655 238 191],804,5,21778,3.759364750561022,0.0,0.0
45793,4,5793,[302 603 100 427  64],664,5,21783,3.7595788746979633,20.0,20.0
45794,4,5794,[210 144 237 269 323],13,2,21785,3.7592752372735116,0.0,0.0
45795,4,5795,[302 603 100 427  64],454,5,21790,3.759489302967564,20.0,20.0
45796,4,5796,[302 603 100 427  64],666,5,21795,3.759703294807659,20.0,20.0
45797,4,5797,[302 603 100 427  64],537,4,21799,3.7597447395653676,20.0,20.0
45798,4,5798,[302 603 100 427  64],458,5,21804,3.759958613554061,20.0,20.0
45799,4,5799,[742 318  25   4 427],374,2,21806,3.759655172413793,20.0,0.0
45800,4,5800,[176 174 204 427 180],313,5,21811,3.759868988105499,0.0,20.0
45801,4,5801,[302 603 100 427  64],666,5,21816,3.7600827300930715,20.0,20.0
45802,4,5802,[211 215 202 423 294],311,4,21820,3.7601240737549544,0.0,0.0
45803,4,5803,[ 82 174 186 748 125],648,3,21823,3.7599931082012406,0.0,20.0
45804,4,5804,[144  98 603  69 294],650,2,21825,3.75968992248062,20.0,20.0
45805,4,5805,[175  12 546   8 172],13,4,21829,3.7597313124354117,20.0,0.0
45806,4,5806,[210   4 174 222 234],738,5,21834,3.7599448940933358,0.0,20.0
45807,4,5807,[302 603 100 427  64],745,5,21839,3.7601584022038566,20.0,20.0
45808,4,5808,[179 181 117 215 294],311,4,21843,3.760199690135996,0.0,0.0
45809,4,5809,[302 603 100 427  64],339,5,21848,3.7604130808950087,20.0,20.0
45810,4,5810,[215 427   7 182   4],328,1,21849,3.7599380485286527,0.0,0.0
45811,4,5811,[423 196 135 257 318],738,4,21853,3.759979353062629,20.0,0.0
45812,4,5812,[546 168  70   4 125],271,2,21855,3.7596765869602615,0.0,0.0
45813,4,5813,[302 603 100 427  64],474,5,21860,3.759889920880633,20.0,20.0
45814,4,5814,[302 603 100 427  64],745,5,21865,3.760103181427343,20.0,20.0
45815,4,5815,[302 603 100 427  64],271,5,21870,3.7603163686382395,20.0,20.0
45816,4,5816,[515 403 237 234  97],13,3,21873,3.7601856627127384,0.0,0.0
45817,4,5817,[  8 515 172  25 143],313,2,21875,3.759883121347542,0.0,0.0
45818,4,5818,[302 603 100 427  64],13,5,21880,3.760096236466747,20.0,20.0
45819,4,5819,[ 12 215 403 237 168],64,5,21885,3.7603092783505154,20.0,0.0
45820,4,5820,[496  96  69  82 210],643,3,21888,3.760178663459887,0.0,0.0
45821,4,5821,[302 603 100 427  64],745,5,21893,3.760391618000687,20.0,20.0
45822,4,5822,[302 603 100 427  64],90,5,21898,3.7606044993989354,20.0,20.0
45823,4,5823,[186 318 228  96  79],892,3,21901,3.760473901098901,20.0,0.0
45824,4,5824,[302 603 100 427  64],474,5,21906,3.76068669527897,20.0,20.0
45825,4,5825,[302 603 100 427  64],745,5,21911,3.7608994164092002,20.0,20.0
45826,4,5826,[174  64 318 153 204],899,5,21916,3.761112064527201,20.0,20.0
45827,4,5827,[405 161  70 127 196],374,4,21920,3.761153054221002,0.0,20.0
45828,4,5828,[475 191 197 215  82],537,3,21923,3.761022473837708,0.0,0.0
45829,4,5829,[483 191 195 235 286],13,1,21924,3.760548885077187,20.0,0.0
45830,4,5830,[496  71   7 216 111],524,2,21926,3.7602469559252274,0.0,0.0
45831,4,5831,[216 182 153 183 151],308,4,21930,3.7602880658436213,0.0,0.0
45832,4,5832,[302 603 100 427  64],454,5,21935,3.7605006000342875,20.0,20.0
45833,4,5833,[302 603 100 427  64],370,5,21940,3.7607130613644153,20.0,20.0
45834,4,5834,[ 96 210 258 202  56],13,4,21944,3.7607540702656386,0.0,0.0
45835,4,5835,[423 300 318 515 168],271,3,21947,3.760623714873201,20.0,0.0
45836,4,5836,[302 603 100 427  64],537,4,21951,3.760664725029981,20.0,20.0
45837,4,5837,[  1 269  22 235 238],279,2,21953,3.76036313806098,0.0,0.0
45838,4,5838,[ 71 182 237 191  69],6,3,21956,3.7602329165953075,0.0,0.0
45839,4,5839,[302 603 100 427  64],271,5,21961,3.760445205479452,20.0,20.0
45840,4,5840,[ 89 357 427 100 204],380,4,21965,3.760486218113337,20.0,20.0
45841,4,5841,[187   8  64 216 435],6,5,21970,3.7606983909619993,0.0,0.0
45842,4,5842,[302 174 185 742 197],454,3,21973,3.7605682012664725,0.0,20.0
45843,4,5843,[302 603 100 427  64],370,5,21978,3.760780287474333,20.0,20.0
45844,4,5844,[423 216 289  82 173],537,1,21979,3.7603079555175363,0.0,0.0
45845,4,5845,[  9 187 496 176 117],115,4,21983,3.7603489565514883,0.0,0.0
45846,4,5846,[111 385  96  22 132],488,3,21986,3.7602189156832564,0.0,0.0
45847,4,5847,[385 313  79  69 282],653,4,21990,3.760259917920657,0.0,0.0
45848,4,5848,[302 603 100 427  64],454,5,21995,3.760471875534279,20.0,20.0
45849,4,5849,[228  82  69 132  79],200,5,22000,3.7606837606837606,0.0,0.0
45850,4,5850,[302  79 508 435 323],13,2,22002,3.7603828405400788,0.0,0.0
45851,4,5851,[302 603 100 427  64],339,5,22007,3.7605946684894054,20.0,20.0
45852,4,5852,[196 515 135 318 117],815,3,22010,3.7604647189475484,20.0,0.0
45853,4,5853,[568 210 174  79 186],311,4,22014,3.760505637171165,0.0,20.0
45854,4,5854,[135  15  64 172 194],533,4,22018,3.760546541417592,0.0,0.0
45855,4,5855,[302 603 100 427  64],666,5,22023,3.7607581967213113,20.0,20.0
45856,4,5856,[153 204  89 176  96],328,3,22026,3.7606283080075125,0.0,0.0
45857,4,5857,[302 603 100 427  64],454,5,22031,3.7608398770911573,20.0,20.0
45858,4,5858,[302 603 100 427  64],537,4,22035,3.760880696364567,20.0,20.0
45859,4,5859,[302 603 100 427  64],458,5,22040,3.7610921501706485,20.0,20.0
45860,4,5860,[405 187 318 168 742],271,2,22042,3.760791673775806,20.0,0.0
45861,4,5861,[172 268 194 111   4],13,5,22047,3.7610030706243602,0.0,0.0
45862,4,5862,[  1 318 471 117 176],271,1,22048,3.7605321507760534,20.0,0.0
45863,4,5863,[127  28 175 234 546],804,3,22051,3.7604024556616644,0.0,20.0
45864,4,5864,[302 603 100 427  64],13,5,22056,3.7606138107416878,20.0,20.0
45865,4,5865,[302 603 100 427  64],666,5,22061,3.7608250937606544,20.0,20.0
45866,4,5866,[183 403 187   4  96],543,5,22066,3.761036304755412,0.0,0.0
45867,4,5867,[302 603 100 427  64],458,5,22071,3.761247443762781,20.0,20.0
45868,4,5868,[302 603 100 427  64],90,5,22076,3.7614585108195606,20.0,20.0
45869,4,5869,[182 258 405 200  96],537,2,22078,3.7611584327086884,0.0,0.0
45870,4,5870,[302 603 100 427  64],666,5,22083,3.761369443025038,20.0,20.0
45871,4,5871,[216  15  64 435 508],378,5,22088,3.7615803814713895,0.0,0.0
45872,4,5872,[153 300  98 174 173],488,4,22092,3.761620977353993,0.0,40.0
45873,4,5873,[302 603 100 427  64],13,5,22097,3.7618318011576437,20.0,20.0
45874,4,5874,[265  12 405 196 191],474,5,22102,3.762042553191489,20.0,0.0
45875,4,5875,[423 603 202 215 121],659,5,22107,3.7622532334921717,20.0,0.0
45876,4,5876,[655 333 168 328 194],313,4,22111,3.7622936872554025,0.0,0.0
45877,4,5877,[302 603 100 427  64],370,5,22116,3.762504253147329,20.0,20.0
45878,4,5878,[742 276 144 204  15],447,3,22119,3.7623745534954924,0.0,0.0
45879,4,5879,[435  11  12 385 273],833,2,22121,3.7620748299319726,20.0,0.0
45880,4,5880,[302 603 100 427  64],90,5,22126,3.7622853256248936,20.0,20.0
45881,4,5881,[  8 385 185 322 318],454,2,22128,3.7619857191431487,20.0,0.0
45882,4,5882,[546  70 748  79  56],83,3,22131,3.76185619581846,0.0,0.0
45883,4,5883,[515  11 210 194 258],13,2,22133,3.76155676410605,0.0,0.0
45884,4,5884,[ 82 742 403  28  50],648,5,22138,3.761767204757859,0.0,20.0
45885,4,5885,[ 15 238 210 179 132],215,3,22141,3.7616377845735642,0.0,0.0
45886,4,5886,[234 143 568 135  50],59,4,22145,3.761678274163411,0.0,20.0
45887,4,5887,[302 603 100 427  64],370,5,22150,3.761888586956522,20.0,20.0
45888,4,5888,[302 603 100 427  64],474,5,22155,3.762098828323994,20.0,20.0
45889,4,5889,[ 69  56  25 748 234],83,2,22157,3.7617996604414263,0.0,0.0
45890,4,5890,[302 603 100 427  64],454,5,22162,3.7620098455270754,20.0,20.0
45891,4,5891,[302 603 100 427  64],537,4,22166,3.762050237610319,20.0,20.0
45892,4,5892,[118 187 301 313 202],13,4,22170,3.762090615985067,0.0,0.0
45893,4,5893,[204 313 357 100 210],85,3,22173,3.7619613165931454,20.0,20.0
45894,4,5894,[  1 423  95 235 196],901,4,22177,3.7620016963528413,0.0,0.0
45895,4,5895,[302 603 100 427  64],271,5,22182,3.762211668928087,20.0,20.0
45896,4,5896,[173 588 135 216 300],892,5,22187,3.762421570289978,0.0,0.0
45897,4,5897,[183 179 471 288  82],92,3,22190,3.7622923024754154,0.0,0.0
45898,4,5898,[ 95  64 187 183 238],406,3,22193,3.7621630784878795,0.0,0.0
45899,4,5899,[ 69 265  97 100  56],881,2,22195,3.761864406779661,0.0,20.0
45900,4,5900,[302 603 100 427  64],474,5,22200,3.7620742247076766,20.0,20.0
45901,4,5901,[496 405 204  50 172],738,4,22204,3.762114537444934,0.0,20.0
45902,4,5902,[302 603 100 427  64],370,5,22209,3.7623242419108927,20.0,20.0
45903,4,5903,[127 282 483  70 515],406,2,22211,3.7620257452574526,20.0,20.0
45904,4,5904,[ 98 180 111 286  25],378,3,22214,3.761896697713802,0.0,20.0
45905,4,5905,[597 588 118 294 269],378,3,22217,3.76176769387064,0.0,0.0
45906,4,5906,[ 12 185 117 238 742],454,0,22217,3.7611308616895207,20.0,0.0
45907,4,5907,[222 180 245 183 286],666,3,22220,3.761002031144211,0.0,0.0
45908,4,5908,[151 222 228 174 234],648,4,22224,3.761042477576578,0.0,20.0
45909,4,5909,[216 286 195  96 276],145,3,22227,3.7609137055837563,0.0,0.0
45910,4,5910,[302 603 100 427  64],474,5,22232,3.7611233293858906,20.0,20.0
45911,4,5911,[435  82 180 215 117],524,3,22235,3.7609945872801083,0.0,0.0
45912,4,5912,[597 508  12  70 357],643,3,22238,3.76086588871977,40.0,0.0
45913,4,5913,[144 181 286 197 515],207,2,22240,3.7605681433885696,0.0,0.0
45914,4,5914,[302 603 100 427  64],90,5,22245,3.7607776838546068,20.0,20.0
45915,4,5915,[302 603 100 427  64],90,5,22250,3.7609871534820827,20.0,20.0
45916,4,5916,[ 22 405 228 603 238],524,1,22251,3.7605205340544194,20.0,0.0
45917,4,5917,[153 127 515 423 265],666,3,22254,3.760392024332545,0.0,20.0
45918,4,5918,[121 144 168 423 357],650,2,22256,3.7600946105761106,20.0,0.0
45919,4,5919,[153 197 483 176 423],385,3,22259,3.7599662162162164,20.0,0.0
45920,4,5920,[168 202 144 121  56],650,1,22260,3.759500084445195,0.0,0.0
45921,4,5921,[302 603 100 427  64],666,5,22265,3.759709557581898,20.0,20.0
45922,4,5922,[125  70  79  96 132],398,4,22269,3.759750126625021,0.0,0.0
45923,4,5923,[515 748 100 302  71],524,3,22272,3.7596218771100607,0.0,20.0
45924,4,5924,[423 125 121 143 257],804,3,22275,3.759493670886076,0.0,0.0
45925,4,5925,[748 121 161 678 257],804,5,22280,3.7597030037124535,0.0,0.0
45926,4,5926,[302 603 100 427  64],666,5,22285,3.7599122659018054,20.0,20.0
45927,4,5927,[302 603 100 427  64],370,5,22290,3.7601214574898787,20.0,20.0
45928,4,5928,[302 603 100 427  64],745,5,22295,3.760330578512397,20.0,20.0
45929,4,5929,[302 603 100 427  64],664,5,22300,3.7605396290050592,20.0,20.0
45930,4,5930,[215 288  96 322 276],474,4,22304,3.760580003372113,0.0,0.0
45931,4,5931,[ 71 191  88 211 742],454,2,22306,3.7602832097100474,0.0,0.0
45932,4,5932,[427 196  69 121 204],59,5,22311,3.760492162481038,0.0,0.0
45933,4,5933,[302 603 100 427  64],664,5,22316,3.760701044826424,20.0,20.0
45934,4,5934,[  8 385 322 185 204],328,1,22317,3.760235888795282,0.0,0.0
45935,4,5935,[196 194  22 179  89],664,4,22321,3.76027628032345,0.0,0.0
45936,4,5936,[302 603 100 427  64],458,5,22326,3.7604850934815564,20.0,20.0
45937,4,5937,[318  98 276  22 135],605,5,22331,3.7606938363085214,20.0,20.0
45938,4,5938,[302 603 100 427  64],13,5,22336,3.760902508839872,20.0,20.0
45939,4,5939,[276  97 143 118 385],378,5,22341,3.761111111111111,0.0,0.0
45940,4,5940,[302 603 100 427  64],271,5,22346,3.7613196431577176,20.0,20.0
45941,4,5941,[302 603 100 427  64],745,5,22351,3.7615281050151466,20.0,20.0
45942,4,5942,[175 215 288 187 257],804,4,22355,3.761568231532896,0.0,0.0
45943,4,5943,[ 22 245 235 742  25],313,0,22355,3.760935397039031,0.0,0.0
45944,4,5944,[475 182   8  69 197],90,2,22357,3.7606391925988225,0.0,0.0
45945,4,5945,[427 275 237 151 204],533,3,22360,3.760511268079381,0.0,0.0
45946,4,5946,[191 313 237 168  95],13,4,22364,3.760551538590886,0.0,0.0
45947,4,5947,[302 603 100 427  64],271,5,22369,3.760759919300605,20.0,20.0
45948,4,5948,[302 603 100 427  64],90,5,22374,3.760968229954614,20.0,20.0
45949,4,5949,[302 603 100 427  64],664,5,22379,3.7611764705882353,20.0,20.0
45950,4,5950,[302 603 100 427  64],13,5,22384,3.761384641236767,20.0,20.0
45951,4,5951,[204 191 234 143 385],537,1,22385,3.760920698924731,0.0,0.0
45952,4,5952,[237 215 515 168 161],13,4,22389,3.760960860070553,0.0,0.0
45953,4,5953,[257 127 161 222 202],653,2,22391,3.7606650990930466,0.0,20.0
45954,4,5954,[302 603 100 427  64],537,4,22395,3.760705289672544,20.0,20.0
45955,4,5955,[100  56 185 483 196],454,1,22396,3.7602417730020146,20.0,20.0
45956,4,5956,[  7   4 151 313 204],474,4,22400,3.7602820211515864,0.0,0.0
45957,4,5957,[568 183  95 742 508],184,3,22403,3.760154414232964,0.0,0.0
45958,4,5958,[423 275 222 258 471],455,4,22407,3.76019466353415,0.0,0.0
45959,4,5959,[185 289 237  98 168],13,3,22410,3.76006711409396,0.0,20.0
45960,4,5960,[302 603 100 427  64],537,4,22414,3.7601073645361516,20.0,20.0
45961,4,5961,[275 204   1 183 180],406,4,22418,3.7601476014760147,0.0,0.0
45962,4,5962,[275 234 151 289 143],90,3,22421,3.760020124098608,0.0,0.0
45963,4,5963,[196 195 173 257  64],92,3,22424,3.759892689470154,0.0,0.0
45964,4,5964,[135 300 180 202 471],666,4,22428,3.759932942162615,0.0,0.0
45965,4,5965,[302 603 100 427  64],537,4,22432,3.7599731813610457,20.0,20.0
45966,4,5966,[302 603 100 427  64],458,5,22437,3.760180995475113,20.0,20.0
45967,4,5967,[200 257 238  95  69],881,2,22439,3.759886058981233,0.0,0.0
45968,4,5968,[ 28 183 216  64  11],804,5,22444,3.7600938180599766,0.0,0.0
45969,4,5969,[302 603 100 427  64],664,5,22449,3.7603015075376884,20.0,20.0
45970,4,5970,[302 603 100 427  64],454,5,22454,3.7605091274493385,20.0,20.0
45971,4,5971,[127 238 405 323 176],804,4,22458,3.760549229738781,0.0,20.0
45972,4,5972,[258 265 357 185 546],7,5,22463,3.760756738657291,20.0,0.0
45973,4,5973,[196 496   1   8  96],533,4,22467,3.7607967860729827,0.0,0.0
45974,4,5974,[302 603 100 427  64],454,5,22472,3.7610041841004183,20.0,20.0
45975,4,5975,[302 603 100 427  64],745,5,22477,3.7612115127175367,20.0,20.0
45976,4,5976,[302 603 100 427  64],370,5,22482,3.761418771959177,20.0,20.0
45977,4,5977,[210 196   7  89 597],804,4,22486,3.761458681833389,0.0,0.0
45978,4,5978,[508 180 546 100   4],343,4,22490,3.761498578357585,0.0,20.0
45979,4,5979,[  4  11 186 515 237],474,5,22495,3.761705685618729,0.0,0.0
45980,4,5980,[300 121 173 211 235],13,2,22497,3.7614111352616617,0.0,0.0
45981,4,5981,[403 144 222 471  89],158,4,22501,3.761451019725844,0.0,0.0
45982,4,5982,[ 50 275 216  95 179],334,3,22504,3.761323750626776,0.0,20.0
45983,4,5983,[ 70  12 403 186 385],374,4,22508,3.7613636363636362,20.0,0.0
45984,4,5984,[302 603 100 427  64],474,5,22513,3.7615705931495405,20.0,20.0
45985,4,5985,[302 603 100 427  64],454,5,22518,3.7617774807885067,20.0,20.0
45986,4,5986,[  1 202 176 234 237],537,0,22518,3.7611491565057626,0.0,0.0
45987,4,5987,[ 89 216 144 385 186],843,1,22519,3.760688042752171,0.0,0.0
45988,4,5988,[678 238 100 153 121],334,3,22522,3.760561028552346,0.0,20.0
45989,4,5989,[ 96   8 144  11 333],328,2,22524,3.7602671118530884,0.0,0.0
45990,4,5990,[ 50 175 172 216 127],537,3,22527,3.7601402103154733,0.0,40.0
45991,4,5991,[323 181 121  15 423],474,4,22531,3.760180240320427,0.0,0.0
45992,4,5992,[173  56 118 238 655],454,1,22532,3.759719672951777,0.0,0.0
45993,4,5993,[427 187  98 237  71],7,5,22537,3.7599265932599266,0.0,20.0
45994,4,5994,[302 603 100 427  64],666,5,22542,3.7601334445371144,20.0,20.0
45995,4,5995,[174 179 302 238  25],207,4,22546,3.7601734489659773,0.0,20.0
45996,4,5996,[ 11 111  82 289 245],554,4,22550,3.7602134400533602,0.0,0.0
45997,4,5997,[286   1 222 197 202],479,4,22554,3.7602534178059352,0.0,0.0
45998,4,5998,[ 71  97 313  56 678],308,2,22556,3.759959993332222,0.0,0.0
45999,4,5999,[302 603 100 427  64],458,5,22561,3.7601666666666667,20.0,20.0
46000,4,6000,[515 181 196 187 282],311,5,22566,3.76037327112148,0.0,0.0
46001,4,6001,[258  12 288 132 182],533,3,22569,3.760246584471843,20.0,0.0
46002,4,6002,[ 11   9  22 118 204],554,5,22574,3.760453106779943,0.0,0.0
46003,4,6003,[302 603 100 427  64],339,5,22579,3.760659560293138,20.0,20.0
46004,4,6004,[302 603 100 427  64],454,5,22584,3.7608659450457953,20.0,20.0
46005,4,6005,[302 603 100 427  64],745,5,22589,3.761072261072261,20.0,20.0
46006,4,6006,[257 181   9 100 276],378,5,22594,3.7612785084068587,0.0,20.0
46007,4,6007,[302 603 100 427  64],370,5,22599,3.7614846870838883,20.0,20.0
46008,4,6008,[179 211 515  25   8],452,3,22602,3.761357963055417,0.0,0.0
46009,4,6009,[ 82 176 182 245 302],666,3,22605,3.7612312811980035,0.0,0.0
46010,4,6010,[483 508 180 655 357],343,5,22610,3.761437364831143,40.0,0.0
46011,4,6011,[302 603 100 427  64],537,4,22614,3.7614770459081837,20.0,20.0
46012,4,6012,[187 302 185 144 288],666,3,22617,3.7613504074505237,0.0,0.0
46013,4,6013,[191 117   1 237 175],308,3,22620,3.761223811107416,0.0,0.0
46014,4,6014,[265  82 471 273 151],308,2,22622,3.7609310058187866,0.0,0.0
46015,4,6015,[302 153 176 161 403],378,5,22627,3.7611369680851063,0.0,0.0
46016,4,6016,[385 195 151 742 234],899,3,22630,3.7610104703340537,0.0,0.0
46017,4,6017,[302 603 100 427  64],454,5,22635,3.7612163509471586,20.0,20.0
46018,4,6018,[118 286  64 423 111],454,3,22638,3.761089882040206,0.0,0.0
46019,4,6019,[180 546 300 294 186],13,2,22640,3.7607973421926912,0.0,0.0
46020,4,6020,[302 603 100 427  64],537,4,22644,3.7608370702541105,20.0,20.0
46021,4,6021,[302 603 100 427  64],339,5,22649,3.7610428429093323,20.0,20.0
46022,4,6022,[265 211 357 215 245],328,4,22653,3.7610825170180973,20.0,0.0
46023,4,6023,[588 174   9 153 385],378,5,22658,3.7612881806108898,0.0,20.0
46024,4,6024,[175  50  71 187  96],234,2,22660,3.7609958506224066,0.0,20.0
46025,4,6025,[302 603 100 427  64],664,5,22665,3.761201460338533,20.0,20.0
46026,4,6026,[  7 144 117 273 678],55,2,22667,3.7609092417454786,0.0,0.0
46027,4,6027,[302 603 100 427  64],370,5,22672,3.761114797611148,20.0,20.0
46028,4,6028,[195 271 603 235 143],537,1,22673,3.76065682534417,20.0,0.0
46029,4,6029,[302 603 100 427  64],664,5,22678,3.7608623548922058,20.0,20.0
46030,4,6030,[301 288 405 175 237],666,2,22680,3.7605703863372577,0.0,0.0
46031,4,6031,[ 64 176  25 294  15],881,2,22682,3.7602785145888595,0.0,0.0
46032,4,6032,[210 245 275 153 175],378,4,22686,3.7603182496270513,0.0,0.0
46033,4,6033,[132  69 546 568 742],200,4,22690,3.7603579714948623,0.0,0.0
46034,4,6034,[302 603 100 427  64],474,5,22695,3.76056338028169,20.0,20.0
46035,4,6035,[483 204 322 301 269],13,2,22697,3.7602717031146455,20.0,0.0
46036,4,6036,[427 655 405 191 161],85,2,22699,3.759980122577439,0.0,0.0
46037,4,6037,[302 603 100 427  64],474,5,22704,3.76018549188473,20.0,20.0
46038,4,6038,[302 603 100 427  64],537,4,22708,3.7602252028481535,20.0,20.0
46039,4,6039,[234 211 515 328 483],804,5,22713,3.7604304635761587,20.0,0.0
46040,4,6040,[357 435 265 186 276],339,4,22717,3.7604701208409206,20.0,0.0
46041,4,6041,[302 603 100 427  64],664,5,22722,3.7606752730883812,20.0,20.0
46042,4,6042,[ 89 186 202 210 282],666,2,22724,3.7603839152738705,0.0,0.0
46043,4,6043,[475 603 655  11 211],339,5,22729,3.760589013898081,20.0,0.0
46044,4,6044,[302 603 100 427  64],458,5,22734,3.7607940446650123,20.0,20.0
46045,4,6045,[161  70  88 385  56],454,3,22737,3.7606682103870326,0.0,0.0
46046,4,6046,[588 655 210 268 515],7,3,22740,3.760542417727799,0.0,0.0
46047,4,6047,[302 603 100 427  64],664,5,22745,3.7607473544973544,20.0,20.0
46048,4,6048,[322 132 276 121   4],13,4,22749,3.7607869069267648,0.0,0.0
46049,4,6049,[385 215  15 237   8],533,3,22752,3.7606611570247934,0.0,0.0
46050,4,6050,[127   9 204  89 288],144,2,22754,3.7603701867459924,0.0,20.0
46051,4,6051,[121  98  69 202   9],374,3,22757,3.760244547257105,0.0,20.0
46052,4,6052,[302 603 100 427  64],370,5,22762,3.7604493639517593,20.0,20.0
46053,4,6053,[302 603 100 427  64],537,4,22766,3.760488932936901,20.0,20.0
46054,4,6054,[135 323 176 603 289],91,4,22770,3.7605284888521884,20.0,0.0
46055,4,6055,[302 603 100 427  64],745,5,22775,3.7607331571994718,20.0,20.0
46056,4,6056,[176 313  89 237  98],184,5,22780,3.7609377579659897,0.0,20.0
46057,4,6057,[180 210 135 195 234],774,1,22781,3.760482007263123,0.0,0.0
46058,4,6058,[302 603 100 427  64],13,5,22786,3.7606865819442152,20.0,20.0
46059,4,6059,[173 238 228 200 742],334,4,22790,3.7607260726072607,0.0,0.0
46060,4,6060,[194 222 181 238  50],897,4,22794,3.7607655502392343,0.0,20.0
46061,4,6061,[161 294 181 357 182],271,2,22796,3.760475090729132,20.0,0.0
46062,4,6062,[144 173  15  28 238],892,5,22801,3.760679531585024,0.0,0.0
46063,4,6063,[215  15 179 204  69],92,4,22805,3.7607189973614776,0.0,0.0
46064,4,6064,[328 153 121 211  28],313,3,22808,3.760593569661995,0.0,0.0
46065,4,6065,[302 603 100 427  64],537,4,22812,3.760633036597428,20.0,20.0
46066,4,6066,[183 228 186  12 135],64,5,22817,3.7608373166309543,20.0,0.0
46067,4,6067,[234  56  88 181  79],538,2,22819,3.760547132498352,0.0,0.0
46068,4,6068,[176 222 405 173 168],102,0,22819,3.7599275004119295,0.0,0.0
46069,4,6069,[318 135 322 185  69],488,4,22823,3.75996705107084,20.0,0.0
46070,4,6070,[182  82   9  88 471],207,1,22824,3.759512436171965,0.0,0.0
46071,4,6071,[216 288 423 197 172],144,4,22828,3.759552042160738,0.0,0.0
46072,4,6072,[546 121  12 127 258],533,4,22832,3.759591635106208,20.0,20.0
46073,4,6073,[302 603 100 427  64],13,5,22837,3.7597958511689167,20.0,20.0
46074,4,6074,[302 603 100 427  64],454,5,22842,3.76,20.0,20.0
46075,4,6075,[289  69  56 125  50],334,2,22844,3.759710335747202,0.0,20.0
46076,4,6076,[403 194 200 655 235],102,0,22844,3.759091657067632,0.0,0.0
46077,4,6077,[204 235 194 125 483],398,3,22847,3.7589667653833496,20.0,0.0
46078,4,6078,[191   1 210 118   4],295,4,22851,3.75900641552887,0.0,0.0
46079,4,6079,[302 603 100 427  64],370,5,22856,3.7592105263157896,20.0,20.0
46080,4,6080,[191 282 357 403 228],311,5,22861,3.7594145699720443,20.0,0.0
46081,4,6081,[ 22  97 216 237 181],328,3,22864,3.759289707333114,0.0,0.0
46082,4,6082,[405 216 235 143 125],378,3,22867,3.7591648857471642,0.0,0.0
46083,4,6083,[202 210 168 117 175],234,0,22867,3.7585470085470085,0.0,0.0
46084,4,6084,[678  50 196 118 200],308,2,22869,3.7582580115036976,0.0,20.0
46085,4,6085,[176   8 172 181  79],387,4,22873,3.7582977325008216,0.0,0.0
46086,4,6086,[301 403   8 318 183],378,4,22877,3.758337440446854,20.0,0.0
46087,4,6087,[302 603 100 427  64],664,5,22882,3.7585413929040734,20.0,20.0
46088,4,6088,[302 603 100 427  64],745,5,22887,3.758745278370833,20.0,20.0
46089,4,6089,[302 603 100 427  64],370,5,22892,3.7589490968801313,20.0,20.0
46090,4,6090,[288 271 210 118 196],92,2,22894,3.758660318502709,0.0,0.0
46091,4,6091,[302 603 100 427  64],666,5,22899,3.7588640840446486,20.0,20.0
46092,4,6092,[210 143 216  22  15],311,4,22903,3.7589036599376335,0.0,0.0
46093,4,6093,[471 196 211 195 187],298,5,22908,3.7591073186741055,0.0,0.0
46094,4,6094,[173 117 328  69 322],537,1,22909,3.7586546349466774,0.0,0.0
46095,4,6095,[ 69  82 143 172 215],537,0,22909,3.758038057742782,0.0,0.0
46096,4,6096,[302 603 100 427  64],454,5,22914,3.758241758241758,20.0,20.0
46097,4,6097,[302 603 100 427  64],454,5,22919,3.758445391931781,20.0,20.0
46098,4,6098,[288  88 515 257 172],279,1,22920,3.7579931136251843,0.0,0.0
46099,4,6099,[ 69 191 176 237 204],13,3,22923,3.7578688524590165,0.0,0.0
46100,4,6100,[294 151 161   4 289],533,2,22925,3.7575807244713983,0.0,0.0
46101,4,6101,[118 179 195 483 183],897,3,22928,3.7574565716158634,20.0,0.0
46102,4,6102,[172  97 235 187 515],64,4,22932,3.757496313288547,0.0,0.0
46103,4,6103,[302 603 100 427  64],370,5,22937,3.757699868938401,20.0,20.0
46104,4,6104,[132 151 302 597 258],560,2,22939,3.7574119574119575,0.0,0.0
46105,4,6105,[245 185 237 435 222],666,2,22941,3.757124140189977,0.0,0.0
46106,4,6106,[181 237 200 508 678],13,2,22943,3.756836417226134,0.0,0.0
46107,4,6107,[  8 173 111 185 357],95,4,22947,3.756876227897839,20.0,0.0
46108,4,6108,[302 603 100 427  64],458,5,22952,3.757079718448191,20.0,20.0
46109,4,6109,[302 603 100 427  64],474,5,22957,3.757283142389525,20.0,20.0
46110,4,6110,[  4 194 483 183 471],194,3,22960,3.757159221076747,20.0,0.0
46111,4,6111,[238 403 197 271  69],64,3,22963,3.757035340314136,0.0,0.0
46112,4,6112,[302 603 100 427  64],537,4,22967,3.7570750858825455,20.0,20.0
46113,4,6113,[ 95 202 235   7   1],406,4,22971,3.7571148184494603,0.0,0.0
46114,4,6114,[357  89  70 265 318],653,4,22975,3.757154538021259,40.0,0.0
46115,4,6115,[546 187 127 405  56],533,2,22977,3.7568672334859383,0.0,20.0
46116,4,6116,[302 603 100 427  64],454,5,22982,3.7570704593755107,20.0,20.0
46117,4,6117,[323 515 210 265 385],59,5,22987,3.7572736188296827,0.0,0.0
46118,4,6118,[191  95 423 228 222],648,4,22991,3.75731328648472,0.0,0.0
46119,4,6119,[302 603 100 427  64],370,5,22996,3.757516339869281,20.0,20.0
46120,4,6120,[435 195 301 313 118],13,3,22999,3.757392582911289,0.0,0.0
46121,4,6121,[273 268 403 603 132],643,3,23002,3.757268866383535,20.0,0.0
46122,4,6122,[ 95 269  50 222 181],334,3,23005,3.7571451902662094,0.0,20.0
46123,4,6123,[273 238 202  82  88],92,2,23007,3.7568582625734814,0.0,0.0
46124,4,6124,[168 118 173 143 135],650,5,23012,3.757061224489796,0.0,0.0
46125,4,6125,[185 271  69 655 132],788,3,23015,3.7569376428338233,0.0,0.0
46126,4,6126,[ 69   4  97 195 153],538,4,23019,3.756977313530276,0.0,0.0
46127,4,6127,[385 191  64  50 211],537,3,23022,3.756853785900783,0.0,20.0
46128,4,6128,[258 435 210   1 179],234,0,23022,3.7562408223201174,0.0,0.0
46129,4,6129,[678 174 172 238 588],881,2,23024,3.7559543230016312,0.0,20.0
46130,4,6130,[302 603 100 427  64],90,5,23029,3.7561572337302236,20.0,20.0
46131,4,6131,[302 603 100 427  64],664,5,23034,3.7563600782778863,20.0,20.0
46132,4,6132,[302 603 100 427  64],90,5,23039,3.7565628566769935,20.0,20.0
46133,4,6133,[197 423 143 357  79],95,5,23044,3.7567655689598958,20.0,0.0
46134,4,6134,[204 195   7   1 173],144,3,23047,3.756642216788916,0.0,0.0
46135,4,6135,[202 234 179 238 275],13,2,23049,3.7563559322033897,0.0,0.0
46136,4,6136,[195 508 282 496  82],326,2,23051,3.756069740915757,0.0,0.0
46137,4,6137,[144  25 200 211 655],13,3,23054,3.7559465623981754,0.0,0.0
46138,4,6138,[276 176  12 275 294],271,2,23056,3.7556605310311126,20.0,0.0
46139,4,6139,[302 603 100 427  64],458,5,23061,3.7558631921824106,20.0,20.0
46140,4,6140,[302 603 100 427  64],666,5,23066,3.7560657873310537,20.0,20.0
46141,4,6141,[302 603 100 427  64],454,5,23071,3.7562683165092805,20.0,20.0
46142,4,6142,[173  88  64  70 151],60,5,23076,3.756470779749308,0.0,0.0
46143,4,6143,[302 603 100 427  64],339,5,23081,3.7566731770833335,20.0,20.0
46144,4,6144,[180  88 275 210 191],648,4,23085,3.756712774613507,0.0,0.0
46145,4,6145,[273 222 195  79 161],897,4,23089,3.756752359258054,0.0,0.0
46146,4,6146,[403 191 180 125  82],804,4,23093,3.7567919310232636,0.0,0.0
46147,4,6147,[302 603 100 427  64],454,5,23098,3.7569941444372152,20.0,20.0
46148,4,6148,[302 603 100 427  64],13,5,23103,3.757196292080013,20.0,20.0
46149,4,6149,[302 603 100 427  64],458,5,23108,3.7573983739837398,20.0,20.0
46150,4,6150,[302 603 100 427  64],13,5,23113,3.7576003901804587,20.0,20.0
46151,4,6151,[174 125 186 322 286],207,3,23116,3.7574772431729517,0.0,20.0
46152,4,6152,[ 71 265  22 121  82],328,5,23121,3.757679180887372,0.0,0.0
46153,4,6153,[302 603 100 427  64],664,5,23126,3.7578810529736755,20.0,20.0
46154,4,6154,[202 204 234 318 172],7,4,23130,3.757920389926889,20.0,0.0
46155,4,6155,[195 385 288 258 435],474,4,23134,3.757959714100065,0.0,0.0
46156,4,6156,[180 294 181 286 197],650,2,23136,3.757674191976612,0.0,0.0
46157,4,6157,[176 294 235 273  97],13,1,23137,3.7572263721987658,0.0,0.0
46158,4,6158,[302 603 100 427  64],664,5,23142,3.757428153921091,20.0,20.0
46159,4,6159,[302 603 100 427  64],664,5,23147,3.75762987012987,20.0,20.0
46160,4,6160,[302 603 100 427  64],90,5,23152,3.7578315208570037,20.0,20.0
46161,4,6161,[117 403 125 174 302],334,3,23155,3.757708536189549,0.0,20.0
46162,4,6162,[568 195 423 282 135],804,3,23158,3.757585591432744,0.0,0.0
46163,4,6163,[357 333 153 271 202],13,2,23160,3.757300454250487,20.0,0.0
46164,4,6164,[515 322 100 196 471],308,1,23161,3.7568532035685323,0.0,20.0
46165,4,6165,[423 191 496 151 121],59,5,23166,3.7570548167369444,0.0,0.0
46166,4,6166,[302 603 100 427  64],474,5,23171,3.7572563645208366,20.0,20.0
46167,4,6167,[173  96 125 234   7],804,5,23176,3.7574578469520103,0.0,0.0
46168,4,6168,[588 257   4  82 238],804,5,23181,3.7576592640622466,0.0,0.0
46169,4,6169,[204 603 258 289 202],387,2,23183,3.7573743922204215,20.0,0.0
46170,4,6170,[ 50 174 135   7  89],380,3,23186,3.7572516609949766,0.0,40.0
46171,4,6171,[302 603 100 427  64],271,5,23191,3.757453013609851,20.0,20.0
46172,4,6172,[194  50 288 282 423],144,4,23195,3.757492305200065,0.0,20.0
46173,4,6173,[302 603 100 427  64],454,5,23200,3.757693553611921,20.0,20.0
46174,4,6174,[183 237  50 153 405],374,4,23204,3.7577327935222673,0.0,20.0
46175,4,6175,[301 313 143 176 215],234,1,23205,3.7572862694300517,0.0,0.0
46176,4,6176,[ 82  79 257 173 121],454,4,23209,3.757325562570827,0.0,0.0
46177,4,6177,[ 71 294  95 385  96],308,4,23213,3.7573648429912594,0.0,0.0
46178,4,6178,[427 258 471 153  98],313,3,23216,3.757242272212332,0.0,20.0
46179,4,6179,[302 603 100 427  64],458,5,23221,3.757443365695793,20.0,20.0
46180,4,6180,[302 603 100 427  64],13,5,23226,3.757644394110985,20.0,20.0
46181,4,6181,[ 79 121 286 204 153],479,4,23230,3.7576835975412486,0.0,0.0
46182,4,6182,[ 97  96 235 135 496],537,2,23232,3.757399320718098,0.0,0.0
46183,4,6183,[302 603 100 427  64],454,5,23237,3.757600258732212,20.0,20.0
46184,4,6184,[302 603 100 427  64],664,5,23242,3.757801131770412,20.0,20.0
46185,4,6185,[200  98 294 228  71],804,4,23246,3.7578402845134176,0.0,20.0
46186,4,6186,[302 603 100 427  64],13,5,23251,3.7580410538225313,20.0,20.0
46187,4,6187,[302 603 100 427  64],666,5,23256,3.758241758241758,20.0,20.0
46188,4,6188,[204 603 318 483 117],13,3,23259,3.75811924381968,60.0,0.0
46189,4,6189,[ 96  88 180 179  79],234,0,23259,3.7575121163166396,0.0,0.0
46190,4,6190,[302 603 100 427  64],90,5,23264,3.7577128089161684,20.0,20.0
46191,4,6191,[302 603 100 427  64],13,5,23269,3.7579134366925064,20.0,20.0
46192,4,6192,[175 265 125 172 216],653,1,23270,3.7574681091554982,0.0,0.0
46193,4,6193,[202 302 748 322 100],883,5,23275,3.7576687116564416,0.0,20.0
46194,4,6194,[742 228 265   8 196],92,4,23279,3.7577078288942696,0.0,0.0
46195,4,6195,[ 56 135 655 179 258],666,5,23284,3.7579083279535186,0.0,0.0
46196,4,6196,[302 603 100 427  64],271,5,23289,3.758108762304341,20.0,20.0
46197,4,6197,[181 265 322  50 182],537,2,23291,3.7578251048725395,0.0,20.0
46198,4,6198,[182 144 273 237 483],374,3,23294,3.7577028552992418,20.0,0.0
46199,4,6199,[ 71 269 568 222 475],13,1,23295,3.757258064516129,0.0,0.0
46200,4,6200,[385 403 174 143 328],749,4,23299,3.757297210127399,0.0,20.0
46201,4,6201,[302 603 100 427  64],454,5,23304,3.757497581425347,20.0,20.0
46202,4,6202,[  1 237 385 161 403],92,4,23308,3.757536675802031,0.0,0.0
46203,4,6203,[183 186 181 187  88],506,5,23313,3.757736943907157,0.0,0.0
46204,4,6204,[179 100 483 197 328],833,3,23316,3.757614826752619,20.0,20.0
46205,4,6205,[175  69 655 328 603],749,4,23320,3.7576538833387043,20.0,0.0
46206,4,6206,[302 603 100 427  64],474,5,23325,3.7578540357660706,20.0,20.0
46207,4,6207,[185 496 742 183  22],897,4,23329,3.7578930412371134,0.0,0.0
46208,4,6208,[302 603 100 427  64],664,5,23334,3.758093090674827,20.0,20.0
46209,4,6209,[302 603 100 427  64],370,5,23339,3.75829307568438,20.0,20.0
46210,4,6210,[ 50 228 127 405 508],334,3,23342,3.7581709869586217,0.0,40.0
46211,4,6211,[302 603 100 427  64],745,5,23347,3.7583708950418546,20.0,20.0
46212,4,6212,[302 603 100 427  64],90,5,23352,3.7585707387735394,20.0,20.0
46213,4,6213,[182 132  88 237 183],749,3,23355,3.758448664306405,0.0,0.0
46214,4,6214,[323 216  12 427 180],59,5,23360,3.758648431214803,20.0,0.0
46215,4,6215,[191 237 173 496  25],85,2,23362,3.7583655083655083,0.0,0.0
46216,4,6216,[603 294   7 175 135],7,4,23366,3.7584043751005307,20.0,0.0
46217,4,6217,[211 228 235 258 121],537,2,23368,3.7581215825024126,0.0,0.0
46218,4,6218,[ 98 191 186 121 269],339,4,23372,3.758160475960765,0.0,20.0
46219,4,6219,[265 333 151  71 100],313,4,23376,3.7581993569131833,0.0,20.0
46220,4,6220,[ 56 273 268 195 258],234,0,23376,3.7575952419225205,0.0,0.0
46221,4,6221,[318 202  64 176 111],537,1,23377,3.7571520411443267,20.0,0.0
46222,4,6222,[ 64  89  79 204 238],840,5,23382,3.7573517596014785,0.0,0.0
46223,4,6223,[302 603 100 427  64],370,5,23387,3.7575514138817483,20.0,20.0
46224,4,6224,[258  11 237 132 202],234,1,23388,3.7571084337349396,0.0,0.0
46225,4,6225,[302 603 100 427  64],745,5,23393,3.757308062961773,20.0,20.0
46226,4,6226,[302 603 100 427  64],537,4,23397,3.757347037096515,20.0,20.0
46227,4,6227,[ 69   9 111 202 313],64,5,23402,3.7575465639049455,0.0,0.0
46228,4,6228,[300  69 405  15  98],488,4,23406,3.7575854872371166,0.0,20.0
46229,4,6229,[496 678 385  15 180],474,4,23410,3.7576243980738364,0.0,0.0
46230,4,6230,[  8 471 323 265   4],455,3,23413,3.7575028085379554,0.0,0.0
46231,4,6231,[655 234 603  11 357],537,2,23415,3.7572207958921693,40.0,0.0
46232,4,6232,[302 603 100 427  64],90,5,23420,3.7574201828974814,20.0,20.0
46233,4,6233,[200 318 265 258 302],13,3,23423,3.7572986846326595,20.0,0.0
46234,4,6234,[234  28 258  98 182],13,5,23428,3.7574979951884524,0.0,20.0
46235,4,6235,[269  70 257 125  12],6,2,23430,3.7572161642078257,20.0,0.0
46236,4,6236,[ 97  11 200 742 144],374,5,23435,3.7574154240820907,0.0,0.0
46237,4,6237,[475 200 196 204   9],339,4,23439,3.757454312279577,0.0,0.0
46238,4,6238,[ 15 222 194 173 385],830,4,23443,3.757493188010899,0.0,0.0
46239,4,6239,[185 385 238 121 508],59,5,23448,3.7576923076923077,0.0,0.0
46240,4,6240,[313 483 161 238  64],380,2,23450,3.757410671366768,20.0,0.0
46241,4,6241,[276 153 435 313 237],144,4,23454,3.757449535405319,0.0,0.0
46242,4,6242,[153  11   9 183 300],378,4,23458,3.757488386993433,0.0,0.0
46243,4,6243,[603  12 301 276  25],90,5,23463,3.7576873798846893,40.0,0.0
46244,4,6244,[302 603 100 427  64],474,5,23468,3.7578863090472376,20.0,20.0
46245,4,6245,[ 95 286 180 210 228],60,5,23473,3.7580851745116877,0.0,0.0
46246,4,6246,[302 603 100 427  64],745,5,23478,3.758283976308628,20.0,20.0
46247,4,6247,[302 603 100 427  64],664,5,23483,3.75848271446863,20.0,20.0
46248,4,6248,[176 405 181 121 197],64,2,23485,3.7582013122099536,0.0,0.0
46249,4,6249,[302 603 100 427  64],339,5,23490,3.7584,20.0,20.0
46250,4,6250,[302 603 100 427  64],474,5,23495,3.7585986242201246,20.0,20.0
46251,4,6251,[222 174 100 471  70],311,4,23499,3.758637236084453,0.0,40.0
46252,4,6252,[302 603 100 427  64],339,5,23504,3.758835758835759,20.0,20.0
46253,4,6253,[403  64 333 475 483],533,3,23507,3.7587144227694274,20.0,0.0
46254,4,6254,[302 603 100 427  64],370,5,23512,3.7589128697042367,20.0,20.0
46255,4,6255,[211 151 222 215 186],648,3,23515,3.758791560102302,0.0,0.0
46256,4,6256,[302 603 100 427  64],664,5,23520,3.75898993127697,20.0,20.0
46257,4,6257,[286 211  28 202 195],6,2,23522,3.758708852668584,0.0,0.0
46258,4,6258,[  7   1 111 143  28],13,2,23524,3.7584278638760185,0.0,0.0
46259,4,6259,[135 515 568  15 405],59,4,23528,3.7584664536741212,0.0,0.0
46260,4,6260,[  8 174 228 568  50],883,4,23532,3.7585050311451846,0.0,40.0
46261,4,6261,[121  98  25  64  12],84,4,23536,3.7585435962951133,20.0,20.0
46262,4,6262,[568 117 179 427 100],194,3,23539,3.758422481239023,0.0,20.0
46263,4,6263,[168 215 568  71 357],650,2,23541,3.7581417624521074,20.0,0.0
46264,4,6264,[508 288 135 435 546],447,3,23544,3.7580207501995213,0.0,0.0
46265,4,6265,[265  96  11 173 117],234,0,23544,3.75742100223428,0.0,0.0
46266,4,6266,[302 603 100 427  64],458,5,23549,3.7576192755704483,20.0,20.0
46267,4,6267,[275 405 742 132  95],271,3,23552,3.757498404594767,0.0,0.0
46268,4,6268,[210  89  28 385 195],374,3,23555,3.757377572180571,0.0,0.0
46269,4,6269,[132  22 237 127 275],537,2,23557,3.757097288676236,0.0,20.0
46270,4,6270,[302 603 100 427  64],458,5,23562,3.7572954871631317,20.0,20.0
46271,4,6271,[ 50  98 294 196 508],387,3,23565,3.7571747448979593,0.0,40.0
46272,4,6272,[121 423 515 202 143],643,4,23569,3.757213454487486,0.0,0.0
46273,4,6273,[ 97 403  56 144  25],843,0,23569,3.756614599936245,0.0,0.0
46274,4,6274,[302 603 100 427  64],474,5,23574,3.756812749003984,20.0,20.0
46275,4,6275,[423 211 268 471 300],7,4,23578,3.7568514977692797,0.0,0.0
46276,4,6276,[302 603 100 427  64],664,5,23583,3.7570495459614466,20.0,20.0
46277,4,6277,[328  64 268 258  11],537,2,23585,3.756769671870022,0.0,0.0
46278,4,6278,[597 427  71 215 186],13,4,23589,3.756808408982322,0.0,0.0
46279,4,6279,[302 603 100 427  64],745,5,23594,3.7570063694267515,20.0,20.0
46280,4,6280,[302 603 100 427  64],745,5,23599,3.757204266836491,20.0,20.0
46281,4,6281,[216 258  70  89 197],64,2,23601,3.756924546322827,0.0,0.0
46282,4,6282,[ 69   7  11 100 151],64,4,23605,3.7569632341238264,0.0,20.0
46283,4,6283,[210   8 176 483 385],200,5,23610,3.7571610439210694,20.0,0.0
46284,4,6284,[174  69 385 322 118],881,4,23614,3.7571996817820206,0.0,20.0
46285,4,6285,[302 603 100 427  64],537,4,23618,3.757238307349666,20.0,20.0
46286,4,6286,[ 15 200 117 318  22],653,4,23622,3.757276920629871,20.0,0.0
46287,4,6287,[483 268 333   7 258],537,4,23626,3.757315521628499,20.0,0.0
46288,4,6288,[144 191 143 216 174],308,3,23629,3.7571951025600256,0.0,20.0
46289,4,6289,[144 197 185 318  82],207,3,23632,3.757074721780604,20.0,0.0
46290,4,6290,[ 98  64 289 237 588],95,2,23634,3.7567954220314737,0.0,20.0
46291,4,6291,[238 275 435 322 258],13,2,23636,3.7565162110616654,0.0,0.0
46292,4,6292,[302 603 100 427  64],339,5,23641,3.7567138089941206,20.0,20.0
46293,4,6293,[405  97 210 234 180],897,5,23646,3.7569113441372735,0.0,0.0
46294,4,6294,[301  69 275  98   1],6,3,23649,3.756791104050834,0.0,20.0
46295,4,6295,[ 50 427  25 153 161],85,2,23651,3.7565120711562896,0.0,20.0
46296,4,6296,[210 276  15 385  97],533,3,23654,3.756391932666349,0.0,0.0
46297,4,6297,[197 435  82 143 748],454,4,23658,3.756430612892982,0.0,0.0
46298,4,6298,[ 98  56 202 238 215],643,1,23659,3.755993014764248,0.0,20.0
46299,4,6299,[302 603 100 427  64],370,5,23664,3.756190476190476,20.0,20.0
46300,4,6300,[216  64 546 234 405],666,2,23666,3.755911760038089,0.0,0.0
46301,4,6301,[302 603 100 427  64],454,5,23671,3.7561091716915267,20.0,20.0
46302,4,6302,[181 179 135 318 269],738,3,23674,3.7559892114865936,20.0,0.0
46303,4,6303,[ 28 143 265 117 200],313,2,23676,3.7557106598984773,0.0,0.0
46304,4,6304,[302 603 100 427  64],537,4,23680,3.7557494052339413,20.0,20.0
46305,4,6305,[172 405 237 176 181],184,4,23684,3.755788138281002,0.0,0.0
46306,4,6306,[328 118 200 173 742],271,2,23686,3.7555097510702393,0.0,0.0
46307,4,6307,[186 211 161 318  82],648,3,23689,3.755389980976538,20.0,0.0
46308,4,6308,[302 603 100 427  64],537,4,23693,3.7554287525756855,20.0,20.0
46309,4,6309,[546 197 121 603   8],313,4,23697,3.7554675118858953,20.0,0.0
46310,4,6310,[302 603 100 427  64],13,5,23702,3.7556647124069085,20.0,20.0
46311,4,6311,[483 197   1 435   9],406,5,23707,3.7558618504435994,20.0,0.0
46312,4,6312,[302 603 100 427  64],664,5,23712,3.7560589260256614,20.0,20.0
46313,4,6313,[ 64 143 100 173 194],188,4,23716,3.7560975609756095,0.0,20.0
46314,4,6314,[175 471  11 195 143],92,4,23720,3.7561361836896277,0.0,0.0
46315,4,6315,[568 273 318  82 181],7,2,23722,3.755858138062065,20.0,0.0
46316,4,6316,[302 603 100 427  64],537,4,23726,3.755896786449264,20.0,20.0
46317,4,6317,[197 174  11 176 100],7,3,23729,3.7557771446660335,0.0,40.0
46318,4,6318,[302 603 100 427  64],90,5,23734,3.755974046526349,20.0,20.0
46319,4,6319,[302 603 100 427  64],666,5,23739,3.7561708860759495,20.0,20.0
46320,4,6320,[302 603 100 427  64],454,5,23744,3.7563676633444074,20.0,20.0
46321,4,6321,[427 475 210 237  56],13,3,23747,3.756248022777602,0.0,0.0
46322,4,6322,[ 28 176 175 127 546],64,4,23751,3.756286572829353,0.0,20.0
46323,4,6323,[173 294   7 176 195],474,4,23755,3.756325110689437,0.0,0.0
46324,4,6324,[215 655 161  88 282],95,4,23759,3.7563636363636363,0.0,0.0
46325,4,6325,[302 603 100 427  64],458,5,23764,3.756560227631995,20.0,20.0
46326,4,6326,[  4  89 269 357  12],233,2,23766,3.7562825983878616,40.0,0.0
46327,4,6327,[302 603 100 427  64],666,5,23771,3.7564791403286977,20.0,20.0
46328,4,6328,[197 194 173 496 183],666,4,23775,3.7565176173171118,0.0,0.0
46329,4,6329,[144 181  15 135 172],194,2,23777,3.7562401263823064,0.0,0.0
46330,4,6330,[215 748 100 496 471],474,3,23780,3.7561206760385404,0.0,20.0
46331,4,6331,[302 603 100 427  64],454,5,23785,3.7563171193935565,20.0,20.0
46332,4,6332,[215 288 435 191  89],13,3,23788,3.7561976946155062,0.0,0.0
46333,4,6333,[322  25 483  96 294],207,2,23790,3.7559204294284814,20.0,0.0
46334,4,6334,[302 111 121 168 405],537,2,23792,3.7556432517758487,0.0,0.0
46335,4,6335,[ 89 168 175  56 265],843,2,23794,3.7553661616161618,0.0,0.0
46336,4,6336,[183 435 168 121 161],194,3,23797,3.755246962284993,0.0,0.0
46337,4,6337,[132 228 196  71 471],311,5,23802,3.7554433575260333,0.0,0.0
46338,4,6338,[195 186   9 182 357],13,2,23804,3.7551664300362835,20.0,0.0
46339,4,6339,[302 603 100 427  64],454,5,23809,3.7553627760252364,20.0,20.0
46340,4,6340,[ 64 385 313 597 202],653,4,23813,3.755401356252957,0.0,0.0
46341,4,6341,[302 603 100 427  64],370,5,23818,3.7555976032797225,20.0,20.0
46342,4,6342,[748  64 197  98 181],313,4,23822,3.755636134321299,0.0,20.0
46343,4,6343,[313   8 257 135 183],308,4,23826,3.7556746532156366,0.0,0.0
46344,4,6344,[172 265  12 483  98],328,5,23831,3.755870764381403,40.0,20.0
46345,4,6345,[302 603 100 427  64],90,5,23836,3.756066813740939,20.0,20.0
46346,4,6346,[ 82 435  56   7  28],308,4,23840,3.7561052465731843,0.0,0.0
46347,4,6347,[  1 111 423 185 265],653,2,23842,3.755828607435413,0.0,0.0
46348,4,6348,[302 603 100 427  64],745,5,23847,3.756024570798551,20.0,20.0
46349,4,6349,[294 135 275 286   1],271,3,23850,3.7559055118110236,0.0,0.0
46350,4,6350,[174 403 180 196 183],234,1,23851,3.7554715792788538,0.0,20.0
46351,4,6351,[ 50 111 742 161  89],374,2,23853,3.7551952141057936,0.0,20.0
46352,4,6352,[ 11 211 121 181  50],13,4,23857,3.755233747835668,0.0,20.0
46353,4,6353,[176  96 228  12 568],387,3,23860,3.755114888259364,20.0,0.0
46354,4,6354,[302 603 100 427  64],13,5,23865,3.755310778914241,20.0,20.0
46355,4,6355,[302 603 100 427  64],90,5,23870,3.7555066079295156,20.0,20.0
46356,4,6356,[302 603 100 427  64],271,5,23875,3.7557023753342773,20.0,20.0
46357,4,6357,[265 111  56 228   7],374,3,23878,3.7555835168291916,0.0,0.0
46358,4,6358,[135  96 172   7 196],374,2,23880,3.7553074382764584,0.0,0.0
46359,4,6359,[302 603 100 427  64],339,5,23885,3.755503144654088,20.0,20.0
46360,4,6360,[185 168  25 118 294],897,2,23887,3.7552271655400093,0.0,0.0
46361,4,6361,[302 603 100 427  64],90,5,23892,3.7554228230116316,20.0,20.0
46362,4,6362,[195 742 235 211 655],308,4,23896,3.7554612604117557,0.0,0.0
46363,4,6363,[405 111  50 181  11],145,3,23899,3.75534255185418,0.0,20.0
46364,4,6364,[302 603 100 427  64],537,4,23903,3.7553809897879025,20.0,20.0
46365,4,6365,[302 603 100 427  64],90,5,23908,3.7555765001570847,20.0,20.0
46366,4,6366,[302 603 100 427  64],339,5,23913,3.755771949112612,20.0,20.0
46367,4,6367,[125 318  25 197 215],533,5,23918,3.755967336683417,20.0,0.0
46368,4,6368,[ 64 195 435 475 258],339,3,23921,3.7558486418590045,0.0,0.0
46369,4,6369,[302 603 100 427  64],339,5,23926,3.756043956043956,20.0,20.0
46370,4,6370,[302 603 100 427  64],90,5,23931,3.7562392089153978,20.0,20.0
46371,4,6371,[475 427 286  79 172],474,5,23936,3.7564344005021972,0.0,0.0
46372,4,6372,[302 603 100 427  64],458,5,23941,3.7566295308332025,20.0,20.0
46373,4,6373,[222 125 187 181  82],804,5,23946,3.756824599937245,0.0,0.0
46374,4,6374,[302 603 100 427  64],666,5,23951,3.7570196078431373,20.0,20.0
46375,4,6375,[151 427 385 175  12],385,2,23953,3.7567440401505645,20.0,0.0
46376,4,6376,[302 603 100 427  64],537,4,23957,3.7567821859808688,20.0,20.0
46377,4,6377,[282  12 234 276 176],145,4,23961,3.7568203198494827,20.0,0.0
46378,4,6378,[302 603 100 427  64],271,5,23966,3.7570152061451636,20.0,20.0
46379,4,6379,[302 603 100 427  64],271,5,23971,3.757210031347962,20.0,20.0
46380,4,6380,[302 603 100 427  64],454,5,23976,3.757404795486601,20.0,20.0
46381,4,6381,[174 237 515  56 202],90,4,23980,3.757442807897211,0.0,20.0
46382,4,6382,[127 117  69   9  56],234,2,23982,3.757167476108413,0.0,20.0
46383,4,6383,[222 655   4  11 323],474,4,23986,3.757205513784461,0.0,0.0
46384,4,6384,[ 11   9  69 121 186],328,4,23990,3.7572435395458106,0.0,0.0
46385,4,6385,[ 15 286  69 172 195],59,4,23994,3.7572815533980584,0.0,0.0
46386,4,6386,[276 196 234 161 172],234,1,23995,3.7568498512603727,0.0,0.0
46387,4,6387,[273 175 318 385 742],387,2,23997,3.756574827802129,20.0,0.0
46388,4,6388,[  8 222  50 196 238],881,2,23999,3.756299890436688,0.0,20.0
46389,4,6389,[176   8 185 588  69],312,5,24004,3.756494522691706,0.0,0.0
46390,4,6390,[357  22 100   8 435],6,4,24008,3.7565326240025034,20.0,20.0
46391,4,6391,[ 98 655  25  28 132],308,2,24010,3.7562578222778473,0.0,20.0
46392,4,6392,[228 200 181 245 265],102,1,24011,3.755826685437197,0.0,0.0
46393,4,6393,[302 603 100 427  64],474,5,24016,3.756021269940569,20.0,20.0
46394,4,6394,[302 603 100 427  64],454,5,24021,3.756215793588741,20.0,20.0
46395,4,6395,[  9 181 403   8 161],334,4,24025,3.756253908692933,0.0,0.0
46396,4,6396,[323 294 427 161 210],650,1,24026,3.7558230420509613,0.0,0.0
46397,4,6397,[238 357 301   9 237],13,1,24027,3.755392310096905,20.0,0.0
46398,4,6398,[197 286 515 265  71],13,3,24030,3.7552742616033754,0.0,0.0
46399,4,6399,[302 603 100 427  64],454,5,24035,3.75546875,20.0,20.0
46400,4,6400,[302 603 100 427  64],537,4,24039,3.755506952038744,20.0,20.0
46401,4,6401,[302 603 100 427  64],90,5,24044,3.7557013433302093,20.0,20.0
46402,4,6402,[ 12 289 100  82 588],10,5,24049,3.755895673902858,20.0,20.0
46403,4,6403,[216 179 282 286 117],95,4,24053,3.755933791380387,0.0,0.0
46404,4,6404,[234 423 176 300 204],788,3,24056,3.755815768930523,0.0,0.0
46405,4,6405,[ 82  97 182 742 179],59,4,24060,3.7558538869809555,0.0,0.0
46406,4,6406,[180   9 132 196  98],881,2,24062,3.7555798345559546,0.0,20.0
46407,4,6407,[111  28  79  98 168],6,2,24064,3.755305867665418,0.0,20.0
46408,4,6408,[302 603 100 427  64],745,5,24069,3.755500078015291,20.0,20.0
46409,4,6409,[427 222 568 185 151],788,1,24070,3.7550702028081124,0.0,0.0
46410,4,6410,[196 202  71 435 603],848,4,24074,3.7551084074247387,20.0,0.0
46411,4,6411,[125 173 215 144  97],194,2,24076,3.7548346849656893,0.0,0.0
46412,4,6412,[302 603 100 427  64],666,5,24081,3.7550288476532043,20.0,20.0
46413,4,6413,[483 234 655 333 176],537,1,24082,3.7545993140006235,20.0,0.0
46414,4,6414,[302 603 100 427  64],271,5,24087,3.7547934528448947,20.0,20.0
46415,4,6415,[302 603 100 427  64],454,5,24092,3.7549875311720697,20.0,20.0
46416,4,6416,[483 121 215 288 273],537,1,24093,3.7545582047685833,20.0,0.0
46417,4,6417,[302 603 100 427  64],454,5,24098,3.7547522592708007,20.0,20.0
46418,4,6418,[197 333 322 271   8],334,3,24101,3.7546346782988005,0.0,0.0
46419,4,6419,[302 603 100 427  64],474,5,24106,3.754828660436137,20.0,20.0
46420,4,6420,[475 185 288  69 127],213,4,24110,3.754866843170846,0.0,20.0
46421,4,6421,[588 655  89 168 121],815,2,24112,3.7545935845530987,0.0,0.0
46422,4,6422,[ 25  50 588 357 187],184,5,24117,3.75478748248482,20.0,20.0
46423,4,6423,[ 98  69 172 471 237],145,5,24122,3.754981320049813,0.0,20.0
46424,4,6424,[ 88 234 168   8 403],95,3,24125,3.754863813229572,0.0,0.0
46425,4,6425,[174 135 200 180 175],13,4,24129,3.7549019607843137,0.0,20.0
46426,4,6426,[302 603 100 427  64],537,4,24133,3.7549400964680255,20.0,20.0
46427,4,6427,[471   1 215 132 111],378,3,24136,3.7548226509023026,0.0,0.0
46428,4,6428,[302 603 100 427  64],745,5,24141,3.755016332244517,20.0,20.0
46429,4,6429,[121 125   4 153 427],406,2,24143,3.754743390357698,0.0,0.0
46430,4,6430,[  4   9  64 194 202],690,2,24145,3.754470533354066,0.0,0.0
46431,4,6431,[194 161 357 423 100],380,3,24148,3.754353233830846,20.0,20.0
46432,4,6432,[289 196 245 181 300],334,2,24150,3.754080522306855,0.0,0.0
46433,4,6433,[100  25 483 237 210],13,3,24153,3.7539633198632267,20.0,20.0
46434,4,6434,[211  64 210 245 655],749,5,24158,3.754156954156954,0.0,0.0
46435,4,6435,[475 197 100 211 234],10,5,24163,3.754350528278434,0.0,20.0
46436,4,6436,[475 210  15  79 234],479,3,24166,3.754233338511729,0.0,0.0
46437,4,6437,[ 89   4 111 228 322],13,4,24170,3.7542715128922026,0.0,0.0
46438,4,6438,[ 50 117 191 471 328],234,2,24172,3.7539990681782887,0.0,20.0
46439,4,6439,[302 603 100 427  64],271,5,24177,3.754192546583851,20.0,20.0
46440,4,6440,[179 216 143   1 168],406,2,24179,3.753920198726906,0.0,0.0
46441,4,6441,[435   8 210  98 313],207,3,24182,3.7538031667184106,0.0,20.0
46442,4,6442,[318 222 135 403  64],804,3,24185,3.753686171038336,20.0,0.0
46443,4,6443,[216 228 603 196 153],13,4,24189,3.753724394785847,20.0,0.0
46444,4,6444,[168 228 143  69   8],64,5,24194,3.753917765709853,0.0,0.0
46445,4,6445,[318  89  96 210 211],59,5,24199,3.754111076636674,20.0,0.0
46446,4,6446,[181 182   9 191 200],527,4,24203,3.7541492166899335,0.0,0.0
46447,4,6447,[179 483   7 515  88],194,3,24206,3.754032258064516,20.0,0.0
46448,4,6448,[271 161 288 216  56],13,2,24208,3.7537602729105286,0.0,0.0
46449,4,6449,[302 603 100 427  64],537,4,24212,3.753798449612403,20.0,20.0
46450,4,6450,[515  79 200  64 286],6,2,24214,3.7535265850255772,0.0,0.0
46451,4,6451,[  4 286 678 179  56],7,4,24218,3.7535647861128334,0.0,0.0
46452,4,6452,[151 175 185  79  95],6,2,24220,3.753293041995971,0.0,0.0
46453,4,6453,[603 333 318 182 265],533,3,24223,3.753176324759839,40.0,0.0
46454,4,6454,[258 423  89 568 100],85,3,24226,3.7530596436870645,0.0,20.0
46455,4,6455,[302 603 100 427  64],90,5,24231,3.7532527881040894,20.0,20.0
46456,4,6456,[302 603 100 427  64],537,4,24235,3.7532910020133188,20.0,20.0
46457,4,6457,[515 153 180 121 183],13,4,24239,3.753329204087953,0.0,0.0
46458,4,6458,[238 182 194 300  64],653,2,24241,3.753057748877535,0.0,0.0
46459,4,6459,[182  22   7 318 195],59,5,24246,3.753250773993808,20.0,0.0
46460,4,6460,[405 568 228 597 174],7,3,24249,3.753134189753908,0.0,20.0
46461,4,6461,[269  89 125 182 168],334,2,24251,3.752862890745899,0.0,0.0
46462,4,6462,[196 275 257 435 515],455,5,24256,3.75305585641343,0.0,0.0
46463,4,6463,[302 603 100 427  64],664,5,24261,3.753248762376238,20.0,20.0
46464,4,6464,[ 97 195 204 423 385],328,1,24262,3.7528228924980667,0.0,0.0
46465,4,6465,[186 215 313 117  56],533,3,24265,3.752706464583978,0.0,0.0
46466,4,6466,[ 12  98 597 288 100],458,2,24267,3.752435441472089,20.0,40.0
46467,4,6467,[ 11 300 121  64 180],346,5,24272,3.7526283240568956,0.0,0.0
46468,4,6468,[302 603 100 427  64],271,5,24277,3.7528211470088113,20.0,20.0
46469,4,6469,[302 603 100 427  64],474,5,24282,3.7530139103554867,20.0,20.0
46470,4,6470,[168 176 257 153   1],815,3,24285,3.752897542883635,0.0,0.0
46471,4,6471,[ 25 483 180 172 222],648,3,24288,3.7527812113720644,20.0,0.0
46472,4,6472,[187 172 210 143 196],184,4,24292,3.752819403676811,0.0,0.0
46473,4,6473,[357 385 111 300 508],537,2,24294,3.752548656163114,20.0,0.0
46474,4,6474,[302 603 100 427  64],474,5,24299,3.7527413127413127,20.0,20.0
46475,4,6475,[323 597 210 211  95],59,3,24302,3.7526250772081533,0.0,0.0
46476,4,6476,[173 515 678  79 210],92,3,24305,3.7525088775667745,0.0,0.0
46477,4,6477,[ 71 132 118  12 294],311,4,24309,3.7525470824328497,20.0,0.0
46478,4,6478,[ 56 313 216 179 294],271,3,24312,3.752430930699182,0.0,0.0
46479,4,6479,[245 268 186  71 238],92,5,24317,3.7526234567901233,0.0,0.0
46480,4,6480,[302 603 100 427  64],745,5,24322,3.7528159234686007,20.0,20.0
46481,4,6481,[153  50 195 245 271],92,4,24326,3.7528540573896945,0.0,20.0
46482,4,6482,[302 603 100 427  64],537,4,24330,3.7528921795465062,20.0,20.0
46483,4,6483,[153 288 173 257 496],650,3,24333,3.7527760641579273,0.0,0.0
46484,4,6484,[322 282   1  15 403],374,3,24336,3.7526599845797994,0.0,0.0
46485,4,6485,[302 603 100 427  64],339,5,24341,3.7528522972556275,20.0,20.0
46486,4,6486,[234  11  69   4 182],474,5,24346,3.753044550639741,0.0,0.0
46487,4,6487,[191 322  11  70  64],308,4,24350,3.75308261405672,0.0,0.0
46488,4,6488,[435 187 568 678  82],537,1,24351,3.7526583448913544,0.0,0.0
46489,4,6489,[302 603 100 427  64],339,5,24356,3.752850539291217,20.0,20.0
46490,4,6490,[215  69 100 288   9],59,5,24361,3.753042674472346,0.0,20.0
46491,4,6491,[204 385 168 151 234],932,2,24363,3.752772643253235,0.0,0.0
46492,4,6492,[302 603 100 427  64],13,5,24368,3.7529647312490373,20.0,20.0
46493,4,6493,[302 603 100 427  64],537,4,24372,3.753002771789344,20.0,20.0
46494,4,6494,[  8 234 288 357 186],343,3,24375,3.7528868360277134,20.0,0.0
46495,4,6495,[302 603 100 427  64],271,5,24380,3.75307881773399,20.0,20.0
46496,4,6496,[385 597 475  98 294],308,2,24382,3.752808988764045,0.0,20.0
46497,4,6497,[302 603 100 427  64],271,5,24387,3.753000923361034,20.0,20.0
46498,4,6498,[302 603 100 427  64],537,4,24391,3.75303892906601,20.0,20.0
46499,4,6499,[265 597 546 328 403],378,2,24393,3.7527692307692306,0.0,0.0
46500,4,6500,[269 222 173 322 271],883,2,24395,3.752499615443778,0.0,0.0
46501,4,6501,[302 603 100 427  64],537,4,24399,3.7525376807136266,20.0,20.0
46502,4,6502,[302 603 100 427  64],458,5,24404,3.7527295094571738,20.0,20.0
46503,4,6503,[302 603 100 427  64],370,5,24409,3.752921279212792,20.0,20.0
46504,4,6504,[302 603 100 427  64],474,5,24414,3.7531129900076863,20.0,20.0
46505,4,6505,[302 603 100 427  64],458,5,24419,3.753304641869044,20.0,20.0
46506,4,6506,[302 603 100 427  64],666,5,24424,3.7534962348240355,20.0,20.0
46507,4,6507,[ 89   8 183 172 276],378,5,24429,3.7536877688998156,0.0,0.0
46508,4,6508,[302 603 100 427  64],13,5,24434,3.7538792441235214,20.0,20.0
46509,4,6509,[294 111 173 385 181],479,3,24437,3.753763440860215,0.0,0.0
46510,4,6510,[302 603 100 427  64],454,5,24442,3.75395484564583,20.0,20.0
46511,4,6511,[ 70  97  98 385  71],64,3,24445,3.7538390663390664,0.0,20.0
46512,4,6512,[302 603 100 427  64],537,4,24449,3.753876861661293,20.0,20.0
46513,4,6513,[118 435 183 405 286],254,2,24451,3.7536076143690513,0.0,0.0
46514,4,6514,[ 79 294 174  82 515],537,1,24452,3.753184957789716,0.0,20.0
46515,4,6515,[176 181 300  12  64],892,5,24457,3.753376304481277,20.0,0.0
46516,4,6516,[302 603 100 427  64],745,5,24462,3.753567592450514,20.0,20.0
46517,4,6517,[ 98 135 318 508 742],121,5,24467,3.7537588217244555,20.0,20.0
46518,4,6518,[176 202 196  88 197],379,5,24472,3.753949992330112,0.0,0.0
46519,4,6519,[ 70  79  82 111 286],452,3,24475,3.753834355828221,0.0,0.0
46520,4,6520,[127   9 234 215 144],749,4,24479,3.7538721055052906,0.0,20.0
46521,4,6521,[302 603 100 427  64],664,5,24484,3.754063170806501,20.0,20.0
46522,4,6522,[302 603 100 427  64],370,5,24489,3.7542541775256786,20.0,20.0
46523,4,6523,[435  82 176 234  98],13,3,24492,3.754138565297364,0.0,20.0
46524,4,6524,[302 603 100 427  64],370,5,24497,3.754329501915709,20.0,20.0
46525,4,6525,[228 282  15 211 748],653,2,24499,3.7540606803555012,0.0,0.0
46526,4,6526,[211 121 174 318 111],479,5,24504,3.7542515703998776,20.0,20.0
46527,4,6527,[302 603 100 427  64],13,5,24509,3.7544424019607843,20.0,20.0
46528,4,6528,[135 174  11 194  97],666,3,24512,3.7543268494409556,0.0,20.0
46529,4,6529,[182 168 186 216   7],804,5,24517,3.7545176110260337,0.0,0.0
46530,4,6530,[194 234  22 603 515],326,4,24521,3.754555198285102,20.0,0.0
46531,4,6531,[302 603 100 427  64],745,5,24526,3.754745866503368,20.0,20.0
46532,4,6532,[302 603 100 427  64],537,4,24530,3.7547834073166997,20.0,20.0
46533,4,6533,[302 603 100 427  64],339,5,24535,3.7549739822467094,20.0,20.0
46534,4,6534,[210  11  97 200  96],543,2,24537,3.7547054322876816,0.0,0.0
46535,4,6535,[302 603 100 427  64],454,5,24542,3.754895960832313,20.0,20.0
46536,4,6536,[ 22  98 172 111 313],64,5,24547,3.7550864310845955,0.0,20.0
46537,4,6537,[ 22 265 196 211 168],298,5,24552,3.7552768430712757,0.0,0.0
46538,4,6538,[475  71 196  97 127],374,3,24555,3.7551613396543813,0.0,20.0
46539,4,6539,[235 111  50  70  96],119,4,24559,3.7551987767584096,0.0,20.0
46540,4,6540,[302 603 100 427  64],745,5,24564,3.7553890842378843,20.0,20.0
46541,4,6541,[302 603 100 427  64],666,5,24569,3.7555793335371446,20.0,20.0
46542,4,6542,[135 132 216 215 168],533,4,24573,3.7556166895919305,0.0,0.0
46543,4,6543,[222 200 197 288   4],666,3,24576,3.7555012224938875,0.0,0.0
46544,4,6544,[302 185  25 237 191],207,5,24581,3.7556913674560732,0.0,0.0
46545,4,6545,[168 118 181 403 185],59,5,24586,3.755881454323251,0.0,0.0
46546,4,6546,[ 79 257 186 655 222],334,4,24590,3.7559187414082786,0.0,0.0
46547,4,6547,[302 603 100 427  64],271,5,24595,3.756108735491753,20.0,20.0
46548,4,6548,[ 70 603 294 245 200],804,4,24599,3.7561459764849596,20.0,0.0
46549,4,6549,[546 271  96 323  12],328,2,24601,3.75587786259542,20.0,0.0
46550,4,6550,[302 603 100 427  64],474,5,24606,3.7560677759120744,20.0,20.0
46551,4,6551,[186 385 258  28 194],64,4,24610,3.756105006105006,0.0,0.0
46552,4,6552,[234 127  22 333 435],343,3,24613,3.7559896230734013,0.0,20.0
46553,4,6553,[202 172 180 210 475],13,3,24616,3.7558742752517547,0.0,0.0
46554,4,6554,[302 603 100 427  64],745,5,24621,3.7560640732265447,20.0,20.0
46555,4,6555,[385  88 211 258 245],207,2,24623,3.755796217205613,0.0,0.0
46556,4,6556,[ 70 515 655 234 385],328,4,24627,3.7558334604239745,0.0,0.0
46557,4,6557,[302 603 100 427  64],666,5,24632,3.756023177798109,20.0,20.0
46558,4,6558,[302 603 100 427  64],664,5,24637,3.756212837322763,20.0,20.0
46559,4,6559,[186 121 202  79 144],308,3,24640,3.7560975609756095,0.0,0.0
46560,4,6560,[302 603 100 427  64],370,5,24645,3.7562871513488796,20.0,20.0
46561,4,6561,[302 603 100 427  64],474,5,24650,3.756476683937824,20.0,20.0
46562,4,6562,[143  12 210 186  96],374,4,24654,3.7565137894255676,20.0,0.0
46563,4,6563,[357 127 182 289 471],474,3,24657,3.756398537477148,20.0,20.0
46564,4,6564,[ 97 204 172 186 195],13,4,24661,3.756435643564356,0.0,0.0
46565,4,6565,[121 186 153 175  98],339,4,24665,3.756472738349071,0.0,20.0
46566,4,6566,[194 179 423 210 286],271,5,24670,3.756662098370641,0.0,0.0
46567,4,6567,[  7 121 508 275 318],343,4,24674,3.7566991473812426,20.0,0.0
46568,4,6568,[238 161 180  88  15],543,3,24677,3.756583954939869,0.0,0.0
46569,4,6569,[ 79 215 282 742 294],804,5,24682,3.756773211567732,0.0,0.0
46570,4,6570,[  1 151 176   7 234],664,3,24685,3.7566580429158423,0.0,0.0
46571,4,6571,[302 603 100 427  64],90,5,24690,3.7568472306755933,20.0,20.0
46572,4,6572,[ 70 173 742 185 269],488,3,24693,3.7567320858055684,0.0,0.0
46573,4,6573,[175 357  25 174 301],234,1,24694,3.7563127471858837,20.0,20.0
46574,4,6574,[588 197 117 318  64],454,3,24697,3.756197718631179,20.0,0.0
46575,4,6575,[496 588   1 210 202],650,1,24698,3.755778588807786,0.0,0.0
46576,4,6576,[302 603 100 427  64],474,5,24703,3.755967766458872,20.0,20.0
46577,4,6577,[302 603 100 427  64],13,5,24708,3.7561568865916692,20.0,20.0
46578,4,6578,[483  69   9 313 135],13,4,24712,3.7561939504483965,20.0,0.0
46579,4,6579,[302 603 100 427  64],271,5,24717,3.7563829787234044,20.0,20.0
46580,4,6580,[211 176 289 328  25],13,1,24718,3.755964139188573,0.0,0.0
46581,4,6581,[302 603 100 427  64],339,5,24723,3.7561531449407477,20.0,20.0
46582,4,6582,[302 603 100 427  64],474,5,24728,3.756342093270545,20.0,20.0
46583,4,6583,[168 357 127 187 228],339,5,24733,3.7565309842041312,20.0,20.0
46584,4,6584,[302 603 100 427  64],666,5,24738,3.756719817767654,20.0,20.0
46585,4,6585,[ 12  79 597  15 173],59,4,24742,3.7567567567567566,20.0,0.0
46586,4,6586,[228 127 302 180 655],537,3,24745,3.7566418703506907,0.0,20.0
46587,4,6587,[496 294 238 117 179],648,2,24747,3.756375227686703,0.0,0.0
46588,4,6588,[ 89  11 172 268 265],234,0,24747,3.755805129761724,0.0,0.0
46589,4,6589,[ 71 333 258 216 313],815,3,24750,3.755690440060698,0.0,0.0
46590,4,6590,[ 56 187  97 228  96],897,4,24754,3.7557275072067973,0.0,0.0
46591,4,6591,[168  50  64  98  97],7,5,24759,3.7559162621359223,0.0,40.0
46592,4,6592,[187 168 125 111  98],234,2,24761,3.755649931745791,0.0,20.0
46593,4,6593,[357 185 405 234 180],653,2,24763,3.7553836821352746,20.0,0.0
46594,4,6594,[153 204 173 333 742],334,4,24767,3.755420773313116,0.0,0.0
46595,4,6595,[302 603 100 427  64],339,5,24772,3.755609460278957,20.0,20.0
46596,4,6596,[117 172  22 385   9],788,3,24775,3.7554949219342126,0.0,0.0
46597,4,6597,[  8   4  56 257 237],318,3,24778,3.755380418308578,0.0,0.0
46598,4,6598,[302 603 100 427  64],339,5,24783,3.7555690256099408,20.0,20.0
46599,4,6599,[100 222 132 216 271],537,1,24784,3.7551515151515154,0.0,20.0
46600,4,6600,[318  88 187 357 121],311,5,24789,3.755340099984851,40.0,0.0
46601,4,6601,[286 273 300 185 100],537,2,24791,3.7550742199333533,0.0,20.0
46602,4,6602,[211 143 257 655 200],749,4,24795,3.7551113130395275,0.0,0.0
46603,4,6603,[302 603 100 427  64],454,5,24800,3.7552998182919444,20.0,20.0
46604,4,6604,[302 603 100 427  64],664,5,24805,3.7554882664647993,20.0,20.0
46605,4,6605,[161 211  98 357 194],643,3,24808,3.755373902512867,20.0,20.0
46606,4,6606,[275 300 211 118  11],7,3,24811,3.7552595731799605,0.0,0.0
46607,4,6607,[235 144 471   7  88],343,5,24816,3.7554479418886197,0.0,0.0
46608,4,6608,[200 197  88 153 496],343,4,24820,3.75548494477228,0.0,0.0
46609,4,6609,[302 603 100 427  64],664,5,24825,3.7556732223903175,20.0,20.0
46610,4,6610,[333  56  22 211  98],387,4,24829,3.7557101800030255,0.0,20.0
46611,4,6611,[ 95 258 183  56 187],184,3,24832,3.755595886267393,0.0,0.0
46612,4,6612,[301 282  50 245 222],294,3,24835,3.75548162709814,0.0,20.0
46613,4,6613,[143 257 121 435  22],749,3,24838,3.755367402479589,0.0,0.0
46614,4,6614,[121 483 216 135 678],537,2,24840,3.7551020408163267,20.0,0.0
46615,4,6615,[423 515 245  82 204],804,4,24844,3.7551390568319225,0.0,0.0
46616,4,6616,[183 202  82 210 216],738,4,24848,3.755176061659362,0.0,0.0
46617,4,6617,[ 79 228  56 132   8],85,3,24851,3.7550619522514355,0.0,0.0
46618,4,6618,[302 603 100 427  64],454,5,24856,3.7552500377700557,20.0,20.0
46619,4,6619,[435  79 216 333  97],506,5,24861,3.7554380664652567,0.0,0.0
46620,4,6620,[ 88 234 211 286 435],60,5,24866,3.755626038362785,0.0,0.0
46621,4,6621,[202 435 302 211 210],207,3,24869,3.7555119299305346,0.0,0.0
46622,4,6622,[302 603 100 427  64],474,5,24874,3.7556998339121246,20.0,20.0
46623,4,6623,[ 11 195 318 265 161],200,5,24879,3.7558876811594204,20.0,0.0
46624,4,6624,[302 603 100 427  64],339,5,24884,3.756075471698113,20.0,20.0
46625,4,6625,[302 603 100 427  64],339,5,24889,3.7562632055538785,20.0,20.0
46626,4,6626,[238 186 483 121 318],334,3,24892,3.7561490870680547,40.0,0.0
46627,4,6627,[ 98  25 195  96  69],533,5,24897,3.7563367531683767,0.0,20.0
46628,4,6628,[100 196 168 405 151],537,2,24899,3.7560718057022173,0.0,20.0
46629,4,6629,[302 603 100 427  64],13,5,24904,3.756259426847662,20.0,20.0
46630,4,6630,[210 276 111 286 328],537,1,24905,3.755843764138139,0.0,0.0
46631,4,6631,[175 515 423 435 222],85,4,24909,3.7558805790108565,0.0,0.0
46632,4,6632,[333  89 228 301  96],145,4,24913,3.7559173827830543,0.0,0.0
46633,4,6633,[302 603 100 427  64],454,5,24918,3.756104914078987,20.0,20.0
46634,4,6634,[475 175 185   7 294],82,2,24920,3.755840241145441,0.0,0.0
46635,4,6635,[302 603 100 427  64],664,5,24925,3.756027727546715,20.0,20.0
46636,4,6636,[302 603 100 427  64],745,5,24930,3.7562151574506553,20.0,20.0
46637,4,6637,[302 603 100 427  64],474,5,24935,3.756402530882796,20.0,20.0
46638,4,6638,[276 183 196 195 235],378,4,24939,3.7564392227745143,0.0,0.0
46639,4,6639,[302 603 100 427  64],664,5,24944,3.756626506024096,20.0,20.0
46640,4,6640,[ 22 100 161 286  28],387,3,24947,3.7565125734076195,0.0,20.0
46641,4,6641,[302 603 100 427  64],454,5,24952,3.7566997892201144,20.0,20.0
46642,4,6642,[302 603 100 427  64],370,5,24957,3.7568869486677707,20.0,20.0
46643,4,6643,[302 603 100 427  64],339,5,24962,3.7570740517760384,20.0,20.0
46644,4,6644,[175  15 210 132 176],308,3,24965,3.7569601203912715,0.0,0.0
46645,4,6645,[200   4 121 195  98],643,3,24968,3.756846223292206,0.0,20.0
46646,4,6646,[211 515 588 161  64],311,4,24972,3.756882804272604,0.0,0.0
46647,4,6647,[195 175 323  82 423],650,2,24974,3.75661853188929,0.0,0.0
46648,4,6648,[183 286  88 161 197],234,2,24976,3.756354338998346,0.0,0.0
46649,4,6649,[748 111 238 151 496],474,3,24979,3.7562406015037593,0.0,0.0
46650,4,6650,[135  22 204 318 172],533,4,24983,3.7562772515411216,20.0,0.0
46651,4,6651,[ 70   1 182   8  11],213,2,24985,3.756013229104029,0.0,0.0
46652,4,6652,[179 257 546 202 186],378,1,24986,3.7555989779047048,0.0,0.0
46653,4,6653,[423 237 222 168  98],343,5,24991,3.7557859933874362,0.0,20.0
46654,4,6654,[302 603 100 427  64],13,5,24996,3.7559729526671677,20.0,20.0
46655,4,6655,[  4 127  15  64 302],537,2,24998,3.7557091346153846,0.0,20.0
46656,4,6656,[405 211 385  22  56],738,2,25000,3.7554453958239447,0.0,0.0
46657,4,6657,[ 64  82 385 111  15],378,4,25004,3.7554821267647944,0.0,0.0
46658,4,6658,[172 403 475 742 228],506,4,25008,3.7555188466736746,0.0,0.0
46659,4,6659,[194 234 135 748 186],749,4,25012,3.7555555555555555,0.0,0.0
46660,4,6660,[238 176 191 161   7],379,4,25016,3.755592253415403,0.0,0.0
46661,4,6661,[118 515 258 195  82],669,2,25018,3.755328730111078,0.0,0.0
46662,4,6662,[ 28 179  82 288 245],378,2,25020,3.755065285907249,0.0,0.0
46663,4,6663,[282 275 195 742 117],825,4,25024,3.7551020408163267,0.0,0.0
46664,4,6664,[195 333 100  98 471],313,5,25029,3.7552888222055514,0.0,40.0
46665,4,6665,[385  69  89 568 323],650,2,25031,3.755025502550255,0.0,0.0
46666,4,6666,[302 603 100 427  64],458,5,25036,3.7552122393880305,20.0,20.0
46667,4,6667,[  7  70 357 143 172],659,3,25039,3.755098980203959,20.0,0.0
46668,4,6668,[471 182 186  50 328],533,3,25042,3.754985754985755,0.0,20.0
46669,4,6669,[302 603 100 427  64],370,5,25047,3.7551724137931033,20.0,20.0
46670,4,6670,[302 603 100 427  64],474,5,25052,3.7553590166391846,20.0,20.0
46671,4,6671,[ 95 228 100 117 546],279,3,25055,3.755245803357314,0.0,20.0
46672,4,6672,[302 603 100 427  64],13,5,25060,3.7554323392776863,20.0,20.0
46673,4,6673,[302 603 100 427  64],664,5,25065,3.755618819298771,20.0,20.0
46674,4,6674,[180 161 143 196  82],311,4,25069,3.7556554307116103,0.0,0.0
46675,4,6675,[127  69 435 180 300],694,5,25074,3.75584182144997,0.0,20.0
46676,4,6676,[302 603 100 427  64],474,5,25079,3.7560281563576456,20.0,20.0
46677,4,6677,[302 603 100 427  64],370,5,25084,3.7562144354597184,20.0,20.0
46678,4,6678,[215 237 475  12 748],92,4,25088,3.756250935768828,20.0,0.0
46679,4,6679,[322 117  70  12 546],374,5,25093,3.756437125748503,20.0,0.0
46680,4,6680,[187 276 423 127 181],537,3,25096,3.756323903607244,0.0,20.0
46681,4,6681,[302 603 100 427  64],13,5,25101,3.7565100269380425,20.0,20.0
46682,4,6682,[228  88 333 294 180],881,2,25103,3.7562471943737843,0.0,0.0
46683,4,6683,[678 210 435   4  64],474,4,25107,3.7562836624775584,0.0,0.0
46684,4,6684,[182   8 288 515 300],234,2,25109,3.756020942408377,0.0,0.0
46685,4,6685,[302 603 100 427  64],474,5,25114,3.7562069997008676,20.0,20.0
46686,4,6686,[603 202 294 204  22],648,4,25118,3.756243457454763,20.0,0.0
46687,4,6687,[475 405 222  69 179],343,5,25123,3.7564294258373208,0.0,0.0
46688,4,6688,[ 22 286 508 271 328],676,3,25126,3.7563163402601285,0.0,0.0
46689,4,6689,[302 603 100 427  64],745,5,25131,3.7565022421524663,20.0,20.0
46690,4,6690,[  8 748 288 385  82],92,2,25133,3.7562397250037365,0.0,0.0
46691,4,6691,[302 603 100 427  64],13,5,25138,3.7564255827854156,20.0,20.0
46692,4,6692,[ 28 179 678  11 318],308,3,25141,3.7563125653668012,20.0,0.0
46693,4,6693,[202 174 215 211 435],650,3,25144,3.7561995817149687,0.0,20.0
46694,4,6694,[302 603 100 427  64],458,5,25149,3.756385362210605,20.0,20.0
46695,4,6695,[588 127 403 288 196],387,1,25150,3.755973715651135,0.0,20.0
46696,4,6696,[302 603 100 427  64],458,5,25155,3.7561594743915188,20.0,20.0
46697,4,6697,[483 168  22  64   8],7,5,25160,3.7563451776649748,20.0,0.0
46698,4,6698,[302 603 100 427  64],664,5,25165,3.7565308254963425,20.0,20.0
46699,4,6699,[302 603 100 427  64],370,5,25170,3.756716417910448,20.0,20.0
46700,4,6700,[302 603 100 427  64],745,5,25175,3.7569019549320997,20.0,20.0
46701,4,6701,[185  50 175 187 301],6,4,25179,3.7569382273948073,0.0,20.0
46702,4,6702,[ 50 194 471 176 405],537,1,25180,3.7565269282410862,0.0,20.0
46703,4,6703,[ 69 275 678 515 265],537,2,25182,3.7562649164677806,0.0,0.0
46704,4,6704,[271 173 183 144  22],479,4,25186,3.7563012677106635,0.0,0.0
46705,4,6705,[546 181 100 182 237],13,4,25190,3.7563376081121382,0.0,20.0
46706,4,6706,[121  28 597 603  71],804,4,25194,3.7563739376770537,20.0,0.0
46707,4,6707,[302 603 100 427  64],339,5,25199,3.7565593321407276,20.0,20.0
46708,4,6708,[143 172 288   8 121],92,3,25202,3.75644656431659,0.0,0.0
46709,4,6709,[197 222  88 191 181],406,3,25205,3.756333830104322,0.0,0.0
46710,4,6710,[222  56 185 144 294],788,2,25207,3.7560721203993443,0.0,0.0
46711,4,6711,[302 603 100 427  64],454,5,25212,3.756257449344458,20.0,20.0
46712,4,6712,[183  28  70 245 187],804,5,25217,3.756442723074631,0.0,0.0
46713,4,6713,[302 603 100 427  64],370,5,25222,3.756627941614537,20.0,20.0
46714,4,6714,[302 603 100 427  64],666,5,25227,3.756813104988831,20.0,20.0
46715,4,6715,[302 603 100 427  64],90,5,25232,3.756998213222156,20.0,20.0
46716,4,6716,[302 603 100 427  64],370,5,25237,3.7571832663391396,20.0,20.0
46717,4,6717,[302 603 100 427  64],458,5,25242,3.757368264364394,20.0,20.0
46718,4,6718,[100  25 202 118 191],271,3,25245,3.757255543979759,0.0,20.0
46719,4,6719,[318 568 168 176 215],313,4,25249,3.7572916666666667,20.0,0.0
46720,4,6720,[515 143   4 568 176],537,1,25250,3.7568814164558844,0.0,0.0
46721,4,6721,[168  56 313  12 318],308,4,25254,3.756917584052365,40.0,0.0
46722,4,6722,[515 173  95 186   8],406,2,25256,3.7566562546482225,0.0,0.0
46723,4,6723,[143 204 742  79 318],454,4,25260,3.7566924449732304,20.0,0.0
46724,4,6724,[204 228 258 423 403],843,2,25262,3.756431226765799,0.0,0.0
46725,4,6725,[ 70  22 168 174  28],406,1,25263,3.756021409455843,0.0,20.0
46726,4,6726,[143 318 288 125 175],213,5,25268,3.756206332689163,20.0,0.0
46727,4,6727,[302 603 100 427  64],339,5,25273,3.7563912009512483,20.0,20.0
46728,4,6728,[597  82 175 121 471],378,3,25276,3.7562787932828057,0.0,0.0
46729,4,6729,[483 475 273 597 132],13,2,25278,3.7560178306092125,20.0,0.0
46730,4,6730,[ 70 200 185  96  97],7,4,25282,3.756054078145892,0.0,0.0
46731,4,6731,[302 603 100 427  64],13,5,25287,3.7562388591800357,20.0,20.0
46732,4,6732,[196 127 182 678 258],334,3,25290,3.756126540917867,0.0,20.0
46733,4,6733,[191 196 121 568 132],343,3,25293,3.756014256014256,0.0,0.0
46734,4,6734,[427  64 228 173 742],374,3,25296,3.755902004454343,0.0,0.0
46735,4,6735,[508 475 678 427 200],13,1,25297,3.7554928741092635,0.0,0.0
46736,4,6736,[216  22 235 185 238],82,1,25298,3.7550838652219087,0.0,0.0
46737,4,6737,[100 300 175 275 423],537,3,25301,3.754971801721579,0.0,20.0
46738,4,6738,[302 603 100 427  64],474,5,25306,3.7551565514171243,20.0,20.0
46739,4,6739,[302 603 100 427  64],474,5,25311,3.755341246290801,20.0,20.0
46740,4,6740,[ 56 568 175 294 153],804,4,25315,3.7553775404242695,0.0,0.0
46741,4,6741,[202   7  98 286 323],13,2,25317,3.755117175912192,0.0,20.0
46742,4,6742,[483 183  11 597   8],308,3,25320,3.7550051905679966,20.0,0.0
46743,4,6743,[302 603 100 427  64],666,5,25325,3.7551897983392646,20.0,20.0
46744,4,6744,[302 603 100 427  64],271,5,25330,3.7553743513713864,20.0,20.0
46745,4,6745,[289 204 168 483 288],374,2,25332,3.7551141417136082,20.0,0.0
46746,4,6746,[302 603 100 427  64],664,5,25337,3.7552986512524087,20.0,20.0
46747,4,6747,[ 88 258 318 182 237],474,5,25342,3.7554831061055127,20.0,0.0
46748,4,6748,[271 276 403 508  70],13,1,25343,3.755074825900133,0.0,0.0
46749,4,6749,[202 678  98  96 508],92,3,25346,3.754962962962963,0.0,20.0
46750,4,6750,[322 216 483  69 496],308,0,25346,3.7544067545548807,20.0,0.0
46751,4,6751,[301 435 357 181 100],328,4,25350,3.754443127962085,20.0,20.0
46752,4,6752,[100 333 144 175 385],346,4,25354,3.754479490596772,0.0,20.0
46753,4,6753,[168 222  97 328 496],85,2,25356,3.754219721646432,0.0,0.0
46754,4,6754,[135 174 161 302 210],524,3,25359,3.7541080680977053,0.0,20.0
46755,4,6755,[289 132  15 588   9],234,2,25361,3.7538484310242746,0.0,0.0
46756,4,6756,[302 603 100 427  64],458,5,25366,3.7540328548172264,20.0,20.0
46757,4,6757,[302 603 100 427  64],271,5,25371,3.7542172240307785,20.0,20.0
46758,4,6758,[302 603 100 427  64],458,5,25376,3.754401538689155,20.0,20.0
46759,4,6759,[302 603 100 427  64],745,5,25381,3.754585798816568,20.0,20.0
46760,4,6760,[300 210 508 179 100],378,4,25385,3.754622097322881,0.0,20.0
46761,4,6761,[546 423  56 174 197],339,4,25389,3.7546583850931676,0.0,20.0
46762,4,6762,[302 603 100 427  64],745,5,25394,3.754842525506432,20.0,20.0
46763,4,6763,[302 603 100 427  64],13,5,25399,3.7550266114725015,20.0,20.0
46764,4,6764,[185 603 173  50 181],659,3,25402,3.7549150036954915,20.0,20.0
46765,4,6765,[302 173 323 588 238],454,1,25403,3.7545078332840673,0.0,0.0
46766,4,6766,[ 71 127 245 265 483],452,2,25405,3.7542485591842767,20.0,20.0
46767,4,6767,[181 322 195 191 508],474,4,25409,3.754284869976359,0.0,0.0
46768,4,6768,[174 403 204 655 118],848,4,25413,3.7543211700398875,0.0,20.0
46769,4,6769,[678  69 405 195  56],749,2,25415,3.7540620384047267,0.0,0.0
46770,4,6770,[302 603 100 427  64],339,5,25420,3.7542460493280165,20.0,20.0
46771,4,6771,[ 50 174 475 546 357],13,2,25422,3.753987005316007,20.0,40.0
46772,4,6772,[403 181 496  70  79],892,4,25426,3.7540233279196813,0.0,0.0
46773,4,6773,[202 258 210 471  97],7,4,25430,3.7540596397992325,0.0,0.0
46774,4,6774,[302 603 100 427  64],271,5,25435,3.7542435424354244,20.0,20.0
46775,4,6775,[210 195 322 168 185],537,2,25437,3.7539846517119244,0.0,0.0
46776,4,6776,[302 603 100 427  64],474,5,25442,3.7541685111406227,20.0,20.0
46777,4,6777,[ 70  56 161 210 180],210,5,25447,3.754352316317498,0.0,0.0
46778,4,6778,[143 183 222 117 135],892,4,25451,3.7543885528839063,0.0,0.0
46779,4,6779,[300  12 269 471 135],90,4,25455,3.754424778761062,20.0,0.0
46780,4,6780,[117  95 197  98  97],881,3,25458,3.7543135230791918,0.0,20.0
46781,4,6781,[483 405 294 238 118],194,3,25461,3.754202300206429,20.0,0.0
46782,4,6782,[435  71 423 180 515],313,5,25466,3.754385964912281,0.0,0.0
46783,4,6783,[302 603 100 427  64],339,5,25471,3.754569575471698,20.0,20.0
46784,4,6784,[302 603 100 427  64],13,5,25476,3.754753131908622,20.0,20.0
46785,4,6785,[302 603 100 427  64],537,4,25480,3.7547892720306515,20.0,20.0
46786,4,6786,[ 89 172 200 603 127],848,3,25483,3.7546780609989687,20.0,20.0
46787,4,6787,[258   4 211 202 132],749,5,25488,3.754861520329994,0.0,0.0
46788,4,6788,[ 82 182 546   7 678],13,1,25489,3.754455737221977,0.0,0.0
46789,4,6789,[302 603 100 427  64],537,4,25493,3.7544918998527246,20.0,20.0
46790,4,6790,[302 603 100 427  64],666,5,25498,3.7546753055514652,20.0,20.0
46791,4,6791,[ 82 423 174 588 187],311,5,25503,3.7548586572438163,0.0,20.0
46792,4,6792,[269 546 475 180  89],343,3,25506,3.7547475342264094,0.0,0.0
46793,4,6793,[302 228 151   4  22],883,4,25510,3.754783632617015,0.0,0.0
46794,4,6794,[ 82 385 318 405  96],42,5,25515,3.7549668874172184,20.0,0.0
46795,4,6795,[302 603 100 427  64],745,5,25520,3.7551500882872277,20.0,20.0
46796,4,6796,[191 202 173  56 194],892,5,25525,3.755333235250846,0.0,0.0
46797,4,6797,[302 603 100 427  64],474,5,25530,3.755516328331862,20.0,20.0
46798,4,6798,[ 11 546 185 748 127],881,4,25534,3.755552287101044,0.0,20.0
46799,4,6799,[182 258 269  50 151],7,4,25538,3.7555882352941174,0.0,20.0
46800,4,6800,[655 323  11  28 471],788,1,25539,3.7551830613145127,0.0,0.0
46801,4,6801,[183  98 294 111 289],234,3,25542,3.7550720376359896,0.0,20.0
46802,4,6802,[237 182 546 603   1],804,4,25546,3.7551080405703368,20.0,0.0
46803,4,6803,[144  98  71 182 258],488,2,25548,3.7548500881834217,0.0,20.0
46804,4,6804,[302 603 100 427  64],454,5,25553,3.7550330639235856,20.0,20.0
46805,4,6805,[235 238 196 655 151],308,3,25556,3.7549221275345284,0.0,0.0
46806,4,6806,[302 603 100 427  64],474,5,25561,3.7551050389305125,20.0,20.0
46807,4,6807,[302 603 100 427  64],537,4,25565,3.755141010575793,20.0,20.0
46808,4,6808,[302 603 100 427  64],666,5,25570,3.75532383609928,20.0,20.0
46809,4,6809,[238 546 403  15 135],313,3,25573,3.7552129221732744,0.0,0.0
46810,4,6810,[215 153 182  69  70],95,4,25577,3.755248862134782,0.0,0.0
46811,4,6811,[301 181 204 172 153],328,2,25579,3.7549911920140926,0.0,0.0
46812,4,6812,[  1 588  79 186 405],406,2,25581,3.754733597534126,0.0,0.0
46813,4,6813,[302 603 100 427  64],271,5,25586,3.7549163486938655,20.0,20.0
46814,4,6814,[405 265 185 245 483],488,2,25588,3.7546588407923696,20.0,0.0
46815,4,6815,[100 269  22 302 182],10,5,25593,3.7548415492957745,0.0,20.0
46816,4,6816,[302 603 100 427  64],13,5,25598,3.755024204195394,20.0,20.0
46817,4,6817,[302 603 100 427  64],664,5,25603,3.755206805514814,20.0,20.0
46818,4,6818,[ 11 678 117 405  56],92,3,25606,3.75509605514005,0.0,0.0
46819,4,6819,[  4  70 173 515 282],643,3,25609,3.7549853372434017,0.0,0.0
46820,4,6820,[269 210 475 125 144],119,4,25613,3.755021257880076,0.0,0.0
46821,4,6821,[302 603 100 427  64],454,5,25618,3.75520375256523,20.0,20.0
46822,4,6822,[191 323 117 245 222],454,1,25619,3.754799941374762,0.0,0.0
46823,4,6823,[265 508  79 546 127],83,4,25623,3.7548358733880423,0.0,20.0
46824,4,6824,[  8 117 210 238  88],474,5,25628,3.755018315018315,0.0,0.0
46825,4,6825,[117 238 161 357 228],313,4,25632,3.7550542045121595,20.0,0.0
46826,4,6826,[302 603 100 427  64],454,5,25637,3.755236560714809,20.0,20.0
46827,4,6827,[302  50 655 121 282],378,5,25642,3.755418863503222,0.0,20.0
46828,4,6828,[ 25 271 172 288 121],843,2,25644,3.7551618099282473,0.0,0.0
46829,4,6829,[ 82   4 328 183 588],537,0,25644,3.7546120058565156,0.0,0.0
46830,4,6830,[302 603 100 427  64],90,5,25649,3.7547943200117113,20.0,20.0
46831,4,6831,[191 200 301 228  56],234,2,25651,3.7545374707259955,0.0,0.0
46832,4,6832,[302 603 100 427  64],666,5,25656,3.75471974242646,20.0,20.0
46833,4,6833,[302 603 100 427  64],537,4,25660,3.7547556335967225,20.0,20.0
46834,4,6834,[ 98 135 200 117  88],738,2,25662,3.754498902706657,0.0,20.0
46835,4,6835,[143 176 385 257 127],95,4,25666,3.7545348156816853,0.0,20.0
46836,4,6836,[202 603 204 496 181],42,5,25671,3.7547169811320753,20.0,0.0
46837,4,6837,[302 603 100 427  64],474,5,25676,3.7548990933021353,20.0,20.0
46838,4,6838,[257 195 181 222 174],378,3,25679,3.7547887117999705,0.0,20.0
46839,4,6839,[302 603 100 427  64],458,5,25684,3.754970760233918,20.0,20.0
46840,4,6840,[302 603 100 427  64],271,5,25689,3.7551527554451103,20.0,20.0
46841,4,6841,[302 603 100 427  64],537,4,25693,3.7551885413621746,20.0,20.0
46842,4,6842,[318   7 515  79  50],452,5,25698,3.755370451556335,20.0,20.0
46843,4,6843,[215 483 202  70 195],234,1,25699,3.754967855055523,20.0,0.0
46844,4,6844,[237 286  50 168  56],343,5,25704,3.7551497443389334,0.0,20.0
46845,4,6845,[173 179 180 483 405],524,4,25708,3.755185509786737,20.0,0.0
46846,4,6846,[200 181 194  64   8],328,3,25711,3.755075215422813,0.0,0.0
46847,4,6847,[302 603 100 427  64],458,5,25716,3.755257009345794,20.0,20.0
46848,4,6848,[202 191 121 194 144],343,4,25720,3.7552927434661996,0.0,0.0
46849,4,6849,[135 237  82  79 427],194,1,25721,3.754890510948905,0.0,0.0
46850,4,6850,[  4 180  22  71 200],328,4,25725,3.7549262881331193,0.0,0.0
46851,4,6851,[ 56 215 183  70 357],643,3,25728,3.754816112084063,20.0,0.0
46852,4,6852,[175 168 195  96 238],64,5,25733,3.7549978111775864,0.0,0.0
46853,4,6853,[475 678 357  50 191],387,3,25736,3.7548876568427194,20.0,20.0
46854,4,6854,[273  50 181 300 222],145,4,25740,3.7549234135667398,0.0,20.0
46855,4,6855,[187 196 210 185 273],59,4,25744,3.7549591598599767,0.0,0.0
46856,4,6856,[173 135 508 385 191],455,4,25748,3.7549948957269943,0.0,0.0
46857,4,6857,[302 603 100 427  64],90,5,25753,3.7551764362787985,20.0,20.0
46858,4,6858,[302 603 100 427  64],13,5,25758,3.7553579238956116,20.0,20.0
46859,4,6859,[135  22  28  11   1],406,3,25761,3.7552478134110787,0.0,0.0
46860,4,6860,[282 125   9 405 179],378,2,25763,3.754991983675849,0.0,0.0
46861,4,6861,[302 603 100 427  64],339,5,25768,3.75517341882833,20.0,20.0
46862,4,6862,[179  79 216 328 132],378,3,25771,3.7550633833600466,0.0,0.0
46863,4,6863,[187 483 245 117 181],749,4,25775,3.7550990675990676,20.0,0.0
46864,4,6864,[181 483 194 496 180],311,5,25780,3.7552804078659867,20.0,0.0
46865,4,6865,[200 471   7 435 176],447,4,25784,3.7553160501019516,0.0,0.0
46866,4,6866,[302 603 100 427  64],458,5,25789,3.7554973059560215,20.0,20.0
46867,4,6867,[294 196 121  11 323],200,4,25793,3.7555329062317995,0.0,0.0
46868,4,6868,[176 194 508 191 568],125,4,25797,3.7555684961420877,0.0,0.0
46869,4,6869,[173 200 176 216 172],648,4,25801,3.7556040756914117,0.0,0.0
46870,4,6870,[172  89 273 276  88],13,4,25805,3.755639644884296,0.0,0.0
46871,4,6871,[302 603 100 427  64],474,5,25810,3.755820721769499,20.0,20.0
46872,4,6872,[302 603 100 427  64],370,5,25815,3.756001745962462,20.0,20.0
46873,4,6873,[288  25 546 204 191],13,1,25816,3.7556008146639512,0.0,0.0
46874,4,6874,[174   4 143  28 197],374,3,25819,3.755490909090909,0.0,20.0
46875,4,6875,[302 603 100 427  64],664,5,25824,3.755671902268761,20.0,20.0
46876,4,6876,[ 79 222 127 265 144],455,3,25827,3.755562018321943,0.0,20.0
46877,4,6877,[302 603 100 427  64],13,5,25832,3.75574294853155,20.0,20.0
46878,4,6878,[187 228 191  96 496],664,3,25835,3.7556330862043903,0.0,0.0
46879,4,6879,[302 603 100 427  64],537,4,25839,3.755668604651163,20.0,20.0
46880,4,6880,[289 127 597 333 202],533,3,25842,3.755558785060311,0.0,20.0
46881,4,6881,[  4 655 423 111 172],234,2,25844,3.755303690787562,0.0,0.0
46882,4,6882,[235 288 181 100 678],537,1,25845,3.7549033851518234,0.0,20.0
46883,4,6883,[302 603 100 427  64],13,5,25850,3.7550842533410806,20.0,20.0
46884,4,6884,[237 173 191   9  11],749,3,25853,3.7549745824255627,0.0,0.0
46885,4,6885,[405  64 265   8 187],533,2,25855,3.7547197211733954,0.0,0.0
46886,4,6886,[ 11 117 235 181  96],882,4,25859,3.754755336140555,0.0,0.0
46887,4,6887,[302 603 100 427  64],745,5,25864,3.7549361207897793,20.0,20.0
46888,4,6888,[302 603 100 427  64],537,4,25868,3.7549716940049356,20.0,20.0
46889,4,6889,[186  79 174 282 180],311,4,25872,3.755007256894049,0.0,20.0
46890,4,6890,[302 603 100 427  64],90,5,25877,3.755187926280656,20.0,20.0
46891,4,6891,[302 603 100 427  64],271,5,25882,3.7553685432385375,20.0,20.0
46892,4,6892,[118 357 288 191 143],804,3,25885,3.7552589583635574,20.0,0.0
46893,4,6893,[180  79 143 265 194],648,4,25889,3.7552944589498116,0.0,0.0
46894,4,6894,[  4 196 186 143 176],346,2,25891,3.755039883973894,0.0,0.0
46895,4,6895,[143 181 235 313 180],308,3,25894,3.7549303944315544,0.0,0.0
46896,4,6896,[302 603 100 427  64],458,5,25899,3.7551109177903434,20.0,20.0
46897,4,6897,[135 197 172 180 245],378,1,25900,3.7547115105827777,0.0,0.0
46898,4,6898,[302 603 100 427  64],370,5,25905,3.754892013335266,20.0,20.0
46899,4,6899,[ 22 222 483 195 294],479,4,25909,3.754927536231884,20.0,0.0
46900,4,6900,[300 385 180 196 405],774,1,25910,3.7545283292276483,0.0,0.0
46901,4,6901,[302 603 100 427  64],90,5,25915,3.7547087800637495,20.0,20.0
46902,4,6902,[333 196  64 121 172],537,0,25915,3.7541648558597713,0.0,0.0
46903,4,6903,[568 435 197 423  28],648,4,25919,3.7542004634994206,0.0,0.0
46904,4,6904,[176 286  56  64 196],271,3,25922,3.754091238233164,0.0,0.0
46905,4,6905,[ 96 568 322  71 275],524,3,25925,3.7539820445988994,0.0,0.0
46906,4,6906,[302 603 100 427  64],537,4,25929,3.754017663240191,20.0,20.0
46907,4,6907,[302 603 100 427  64],13,5,25934,3.754198031268095,20.0,20.0
46908,4,6908,[ 97 435 228  15 515],455,4,25938,3.7542336083369516,0.0,0.0
46909,4,6909,[215 496 273  25  98],897,3,25941,3.754124457308249,0.0,20.0
46910,4,6910,[302 603 100 427  64],664,5,25946,3.7543047315873244,20.0,20.0
46911,4,6911,[302 603 100 427  64],90,5,25951,3.7544849537037037,20.0,20.0
46912,4,6912,[302 603 100 427  64],339,5,25956,3.7546651236800233,20.0,20.0
46913,4,6913,[180 211 144 318 197],7,5,25961,3.7548452415389066,20.0,0.0
46914,4,6914,[302 603 100 427  64],474,5,25966,3.7550253073029647,20.0,20.0
46915,4,6915,[183  70  97  79 288],455,3,25969,3.754916136495084,0.0,0.0
46916,4,6916,[302 603 100 427  64],271,5,25974,3.755096139945063,20.0,20.0
46917,4,6917,[302 603 100 427  64],13,5,25979,3.755276091355883,20.0,20.0
46918,4,6918,[302 603 100 427  64],339,5,25984,3.7554559907501086,20.0,20.0
46919,4,6919,[222 144  97 121  82],479,4,25988,3.755491329479769,0.0,0.0
46920,4,6920,[471 235  79 111 496],537,1,25989,3.7550931946250543,0.0,0.0
46921,4,6921,[302 603 100 427  64],13,5,25994,3.7552730424732736,20.0,20.0
46922,4,6922,[302 603 100 427  64],664,5,25999,3.755452838364871,20.0,20.0
46923,4,6923,[174   7 515 237 265],452,3,26002,3.7553437319468514,0.0,20.0
46924,4,6924,[302 603 100 427  64],339,5,26007,3.755523465703971,20.0,20.0
46925,4,6925,[318 117 111 191  56],454,2,26009,3.7552699971123302,20.0,0.0
46926,4,6926,[423 121 127 234 196],95,4,26013,3.7553053269813774,0.0,20.0
46927,4,6927,[187  69  28 174 265],881,4,26017,3.75534064665127,0.0,20.0
46928,4,6928,[ 25 191 405 111 357],537,2,26019,3.7550873141867513,20.0,0.0
46929,4,6929,[132 294  11  98 127],666,4,26023,3.7551226551226553,0.0,40.0
46930,4,6930,[111 186 237 405   9],533,2,26025,3.7548694272110805,0.0,0.0
46931,4,6931,[302 603 100 427  64],745,5,26030,3.755049047893826,20.0,20.0
46932,4,6932,[273  89 215 216 211],308,2,26032,3.754795903649214,0.0,0.0
46933,4,6933,[427 271  98 197 144],13,4,26036,3.7548312662244014,0.0,20.0
46934,4,6934,[302 603 100 427  64],13,5,26041,3.755010814708003,20.0,20.0
46935,4,6935,[302 603 100 427  64],458,5,26046,3.7551903114186853,20.0,20.0
46936,4,6936,[173 144 180 172 197],378,3,26049,3.755081447311518,0.0,0.0
46937,4,6937,[273 496  79   1 238],537,2,26051,3.7548284808302106,0.0,0.0
46938,4,6938,[ 15 323  97  70 228],455,2,26053,3.7545755872604123,0.0,0.0
46939,4,6939,[ 89 655 237 318   7],788,4,26057,3.7546109510086456,20.0,0.0
46940,4,6940,[174  28 211 483  25],398,5,26062,3.7547903760265093,20.0,20.0
46941,4,6941,[ 28 742 496 286 144],666,2,26064,3.7545375972342265,0.0,0.0
46942,4,6942,[302 603 100 427  64],271,5,26069,3.7547169811320753,20.0,20.0
46943,4,6943,[ 12   9 313 161 182],308,3,26072,3.7546082949308754,20.0,0.0
46944,4,6944,[302 603 100 427  64],370,5,26077,3.7547876169906407,20.0,20.0
46945,4,6945,[183  69 333  64 742],313,4,26081,3.754822919665995,0.0,0.0
46946,4,6946,[151  79  22 161 186],64,3,26084,3.7547142651504246,0.0,0.0
46947,4,6947,[268  69 276 175 111],13,5,26089,3.7548934945308003,0.0,0.0
46948,4,6948,[ 82 172 135 168 194],881,3,26092,3.754784861131098,0.0,0.0
46949,4,6949,[211  70 271 235 471],479,3,26095,3.7546762589928058,0.0,0.0
46950,4,6950,[ 82 313  96  11 197],308,3,26098,3.7545676881024312,0.0,0.0
46951,4,6951,[222  96  98   9  22],378,4,26102,3.754602991944764,0.0,20.0
46952,4,6952,[153 216 323  98 655],328,2,26104,3.7543506400115056,0.0,20.0
46953,4,6953,[603 111 357 427   1],271,4,26108,3.754385964912281,40.0,0.0
46954,4,6954,[181  28 222   9 403],328,3,26111,3.754277498202732,0.0,0.0
46955,4,6955,[168 143 180  56 234],234,1,26112,3.7538815411155837,0.0,0.0
46956,4,6956,[323 153 265 111 182],374,3,26115,3.753773178094006,0.0,0.0
46957,4,6957,[ 50  89 257   4 173],92,3,26118,3.753664846220178,0.0,20.0
46958,4,6958,[222   7  71 265 748],328,3,26121,3.7535565454806723,0.0,0.0
46959,4,6959,[302 603 100 427  64],90,5,26126,3.753735632183908,20.0,20.0
46960,4,6960,[197 328 275 211 322],533,5,26131,3.75391466743284,0.0,0.0
46961,4,6961,[302 603 100 427  64],13,5,26136,3.754093651249641,20.0,20.0
46962,4,6962,[678  50 405 245 258],894,3,26139,3.753985351141749,0.0,20.0
46963,4,6963,[302 603 100 427  64],13,5,26144,3.7541642734060883,20.0,20.0
46964,4,6964,[127 603  25 405 273],59,3,26147,3.754055994256999,20.0,20.0
46965,4,6965,[302 603 100 427  64],664,5,26152,3.754234855010049,20.0,20.0
46966,4,6966,[302 603 100 427  64],664,5,26157,3.7544136644179704,20.0,20.0
46967,4,6967,[ 69 322 143 483 202],881,4,26161,3.7544489092996556,20.0,0.0
46968,4,6968,[483 300 173 200 168],210,5,26166,3.754627636676711,20.0,0.0
46969,4,6969,[302 603 100 427  64],271,5,26171,3.75480631276901,20.0,20.0
46970,4,6970,[588 496 174 216 100],7,5,26176,3.754984937598623,0.0,40.0
46971,4,6971,[655 301 215 568 216],940,2,26178,3.7547332185886404,0.0,0.0
46972,4,6972,[300 385 357  22 210],774,0,26178,3.754194751183135,20.0,0.0
46973,4,6973,[302 603 100 427  64],339,5,26183,3.7543733868655003,20.0,20.0
46974,4,6974,[176 196 423 143 273],537,0,26183,3.753835125448029,0.0,0.0
46975,4,6975,[ 22  89   4 200  95],378,3,26186,3.7537270642201834,0.0,0.0
46976,4,6976,[302 603 100 427  64],458,5,26191,3.753905690124695,20.0,20.0
46977,4,6977,[475 180 135   8  50],474,5,26196,3.75408426483233,0.0,20.0
46978,4,6978,[405 183  98 496 258],6,3,26199,3.753976214357358,0.0,20.0
46979,4,6979,[546 265 186 172 181],95,3,26202,3.753868194842407,0.0,0.0
46980,4,6980,[546  28 135   7 191],339,5,26207,3.7540466981807765,0.0,0.0
46981,4,6981,[568  70 202 173   8],883,3,26210,3.7539386995130335,0.0,0.0
46982,4,6982,[302 603 100 427  64],666,5,26215,3.754117141629672,20.0,20.0
46983,4,6983,[302 603 100 427  64],271,5,26220,3.754295532646048,20.0,20.0
46984,4,6984,[302 603 100 427  64],458,5,26225,3.754473872584109,20.0,20.0
46985,4,6985,[302 603 100 427  64],13,5,26230,3.754652161465789,20.0,20.0
46986,4,6986,[181  12 333 237 258],334,5,26235,3.75483039931301,20.0,0.0
46987,4,6987,[302 603 100 427  64],664,5,26240,3.7550085861476816,20.0,20.0
46988,4,6988,[ 89 546 275 228 257],899,3,26243,3.754900558019745,0.0,0.0
46989,4,6989,[302 603 100 427  64],666,5,26248,3.7550786838340486,20.0,20.0
46990,4,6990,[195 215 186 194  88],95,5,26253,3.755256758689744,0.0,0.0
46991,4,6991,[515 186 196  15  79],452,4,26257,3.75529176201373,0.0,0.0
46992,4,6992,[302 603 100 427  64],370,5,26262,3.7554697554697554,20.0,20.0
46993,4,6993,[405  64 186  97   4],343,5,26267,3.75564769802688,0.0,0.0
46994,4,6994,[235   9 187 196 153],194,2,26269,3.755396711937098,0.0,0.0
46995,4,6995,[245 385 678 403 196],804,4,26273,3.755431675242996,0.0,0.0
46996,4,6996,[405 275  70 471 194],524,3,26276,3.755323710161498,0.0,0.0
46997,4,6997,[302 603 100 427  64],458,5,26281,3.755501571877679,20.0,20.0
46998,4,6998,[245 423 222 210  64],378,3,26284,3.7553936276610944,0.0,0.0
46999,4,6999,[ 69 427 161 515  22],13,4,26288,3.7554285714285713,0.0,0.0
47000,4,7000,[282 313 234  96 603],474,5,26293,3.75560634195115,20.0,0.0
47001,4,7001,[302 603 100 427  64],370,5,26298,3.7557840616966582,20.0,20.0
47002,4,7002,[  7 216  95 302 475],13,2,26300,3.755533342853063,0.0,0.0
47003,4,7003,[175 333 222 405 143],815,3,26303,3.7554254711593376,0.0,0.0
47004,4,7004,[302 603 100 427  64],454,5,26308,3.755603140613847,20.0,20.0
47005,4,7005,[302 603 100 427  64],664,5,26313,3.7557807593491295,20.0,20.0
47006,4,7006,[423 257 546  82 176],666,2,26315,3.755530184101613,0.0,0.0
47007,4,7007,[302 603 100 427  64],474,5,26320,3.7557077625570776,20.0,20.0
47008,4,7008,[153 161 202  71 588],308,4,26324,3.755742616635754,0.0,0.0
47009,4,7009,[234 294  22   1  56],897,3,26327,3.7556348074179744,0.0,0.0
47010,4,7010,[ 15 235 276 237 194],271,2,26329,3.7553843959492226,0.0,0.0
47011,4,7011,[237 135  95 257  79],378,4,26333,3.7554192812321734,0.0,0.0
47012,4,7012,[302 603 100 427  64],271,5,26338,3.7555967488949094,20.0,20.0
47013,4,7013,[471 144  97 435 121],13,4,26342,3.755631593954947,0.0,0.0
47014,4,7014,[302 603 100 427  64],474,5,26347,3.755808980755524,20.0,20.0
47015,4,7015,[121  28 144 357  98],188,3,26350,3.755701254275941,20.0,20.0
47016,4,7016,[385 289 546 234 286],524,4,26354,3.7557360695453896,0.0,0.0
47017,4,7017,[  1 357  98 179 318],537,3,26357,3.7556283841550298,40.0,20.0
47018,4,7018,[ 69 181 235 204  96],308,3,26360,3.7555207294486395,0.0,0.0
47019,4,7019,[ 70 202   4  82 121],533,4,26364,3.7555555555555555,0.0,0.0
47020,4,7020,[546 333  98  25 568],343,1,26365,3.755163082182025,0.0,20.0
47021,4,7021,[302 603 100 427  64],666,5,26370,3.7553403588721164,20.0,20.0
47022,4,7022,[322 286 111 678 257],825,4,26374,3.755375195785277,0.0,0.0
47023,4,7023,[151   9  11 210 144],378,3,26377,3.7552676537585423,0.0,0.0
47024,4,7024,[ 50 173 118 182 187],7,4,26381,3.755302491103203,0.0,20.0
47025,4,7025,[302 603 100 427  64],454,5,26386,3.7554796470253344,20.0,20.0
47026,4,7026,[  9 265 117  88   7],13,2,26388,3.75522982780703,0.0,0.0
47027,4,7027,[313  28 269 121 180],537,2,26390,3.754980079681275,0.0,0.0
47028,4,7028,[  9 678 111 427 238],13,2,26392,3.7547304026177266,0.0,0.0
47029,4,7029,[302 603 100 427  64],370,5,26397,3.7549075391180655,20.0,20.0
47030,4,7030,[302 603 100 427  64],90,5,26402,3.7550846252311194,20.0,20.0
47031,4,7031,[333  89 276 282 288],334,4,26406,3.7551194539249146,0.0,0.0
47032,4,7032,[302 603 100 427  64],666,5,26411,3.755296459547846,20.0,20.0
47033,4,7033,[121  28  70 143 568],643,4,26415,3.7553312482229173,0.0,0.0
47034,4,7034,[ 79 144 603 568 174],643,5,26420,3.755508173418621,20.0,20.0
47035,4,7035,[  9 132 385  82  12],10,5,26425,3.7556850483229107,20.0,0.0
47036,4,7036,[143 318 568 197 269],233,5,26430,3.755861872957226,20.0,0.0
47037,4,7037,[238   9 313 318 471],92,4,26434,3.75589656152316,20.0,0.0
47038,4,7038,[257 117 222 483 191],334,4,26438,3.7559312402329876,20.0,0.0
47039,4,7039,[302 603 100 427  64],13,5,26443,3.7561079545454548,20.0,20.0
47040,4,7040,[ 12  11  98 172 181],686,5,26448,3.756284618662122,20.0,20.0
47041,4,7041,[302 603 100 427  64],474,5,26453,3.756461232604374,20.0,20.0
47042,4,7042,[173   8 182 195  88],474,5,26458,3.756637796393582,0.0,0.0
47043,4,7043,[294 546 210  64 275],308,3,26461,3.7565303804656445,0.0,0.0
47044,4,7044,[301  28   4  98 237],455,2,26463,3.756281050390348,0.0,20.0
47045,4,7045,[288 289 515 204  25],474,3,26466,3.7561737155833095,0.0,0.0
47046,4,7046,[405 228 313 286 172],883,2,26468,3.7559245068823612,0.0,0.0
47047,4,7047,[  7 172 257 655 185],308,5,26473,3.7561010215664017,0.0,0.0
47048,4,7048,[435 127 196 135 238],406,3,26476,3.7559937579798555,0.0,20.0
47049,4,7049,[132 282 183 121 216],311,5,26481,3.7561702127659573,0.0,0.0
47050,4,7050,[302 603 100 427  64],90,5,26486,3.756346617501064,20.0,20.0
47051,4,7051,[302 603 100 427  64],90,5,26491,3.7565229722064664,20.0,20.0
47052,4,7052,[302 603 100 427  64],90,5,26496,3.7566992769034453,20.0,20.0
47053,4,7053,[302 603 100 427  64],454,5,26501,3.756875531613269,20.0,20.0
47054,4,7054,[  1  12  22 483  97],234,2,26503,3.756626506024096,40.0,0.0
47055,4,7055,[175 216  12  56 271],13,3,26506,3.756519274376417,20.0,0.0
47056,4,7056,[185 435 215 117  15],454,1,26507,3.756128666572198,0.0,0.0
47057,4,7057,[153 183 135 435 194],194,2,26509,3.7558798526494757,0.0,0.0
47058,4,7058,[357  50 194 151 183],537,2,26511,3.7556311092222696,20.0,20.0
47059,4,7059,[216  25 286 405   8],378,4,26515,3.7556657223796033,0.0,0.0
47060,4,7060,[302 603 100 427  64],666,5,26520,3.755841948732474,20.0,20.0
47061,4,7061,[302 603 100 427  64],474,5,26525,3.7560181251770035,20.0,20.0
47062,4,7062,[302 603 100 427  64],664,5,26530,3.7561942517343905,20.0,20.0
47063,4,7063,[144 238  28 180  96],312,3,26533,3.756087202718007,0.0,0.0
47064,4,7064,[302 603 100 427  64],745,5,26538,3.756263269639066,20.0,20.0
47065,4,7065,[191   9   1 385 194],64,5,26543,3.7564392867251626,0.0,0.0
47066,4,7066,[ 28 238 237 153 597],207,3,26546,3.7563322484788455,0.0,0.0
47067,4,7067,[748 328  79 197  11],488,3,26549,3.7562252405206564,0.0,0.0
47068,4,7068,[275 313 127 546 273],64,3,26552,3.756118262837742,0.0,20.0
47069,4,7069,[100 197 144 210 273],13,3,26555,3.756011315417256,0.0,20.0
47070,4,7070,[748 588 265   1 496],200,4,26559,3.756045820958846,0.0,0.0
47071,4,7071,[302 603 100 427  64],370,5,26564,3.7562217194570136,20.0,20.0
47072,4,7072,[200 234  69  56 588],537,1,26565,3.755832037325039,0.0,0.0
47073,4,7073,[302 603 100 427  64],454,5,26570,3.75600791631326,20.0,20.0
47074,4,7074,[117 176 168 204  88],474,4,26574,3.7560424028268553,0.0,0.0
47075,4,7075,[302 603 100 427  64],339,5,26579,3.7562182023742228,20.0,20.0
47076,4,7076,[211 357  98 174 168],488,5,26584,3.7563939522396494,20.0,40.0
47077,4,7077,[174 427  22  12 121],59,5,26589,3.756569652444193,20.0,20.0
47078,4,7078,[257 216 132  12  88],279,1,26590,3.7561802514479448,20.0,0.0
47079,4,7079,[187  28  56  95 118],313,2,26592,3.7559322033898304,0.0,0.0
47080,4,7080,[318 151 210 300 403],653,3,26595,3.7558254483829967,20.0,0.0
47081,4,7081,[302 603 100 427  64],339,5,26600,3.7560011296244,20.0,20.0
47082,4,7082,[ 79 603 228 318 546],64,3,26603,3.7558943950303543,40.0,0.0
47083,4,7083,[302 603 100 427  64],13,5,26608,3.756070016939582,20.0,20.0
47084,4,7084,[200 186 282 153 318],788,3,26611,3.7559633027522934,20.0,0.0
47085,4,7085,[117 294 273 257 655],378,3,26614,3.7558566186847306,0.0,0.0
47086,4,7086,[144 237 318 181 423],454,4,26618,3.7558910681529563,20.0,0.0
47087,4,7087,[202  25 238 186 265],387,2,26620,3.755643340857788,0.0,0.0
47088,4,7088,[748 143 194 132  82],311,4,26624,3.7556778106926223,0.0,0.0
47089,4,7089,[302 603 100 427  64],271,5,26629,3.7558533145275037,20.0,20.0
47090,4,7090,[302 603 100 427  64],458,5,26634,3.756028768861938,20.0,20.0
47091,4,7091,[194 471 182 313 202],653,1,26635,3.755640157924422,0.0,0.0
47092,4,7092,[302 603 100 427  64],370,5,26640,3.7558155928380095,20.0,20.0
47093,4,7093,[286   1 144  69  56],339,4,26644,3.7558500140964197,0.0,0.0
47094,4,7094,[257   8  69 168 180],881,3,26647,3.7557434813248767,0.0,0.0
47095,4,7095,[235 118 588 515  22],804,5,26652,3.7559188275084554,0.0,0.0
47096,4,7096,[302 603 100 427  64],370,5,26657,3.756094124277864,20.0,20.0
47097,4,7097,[186 748  98 168 121],64,3,26660,3.7559876021414484,0.0,20.0
47098,4,7098,[176  89 185 568 187],537,3,26663,3.755881110015495,0.0,0.0
47099,4,7099,[302 603 100 427  64],666,5,26668,3.756056338028169,20.0,20.0
47100,4,7100,[194 546 748 678  71],804,4,26672,3.756090691451908,0.0,0.0
47101,4,7101,[288 515 173 228 204],339,3,26675,3.755984229794424,0.0,0.0
47102,4,7102,[ 82 423 186 153 168],308,5,26680,3.7561593692805855,0.0,0.0
47103,4,7103,[182 273  11  25 597],897,2,26682,3.7559121621621623,0.0,0.0
47104,4,7104,[357 322 176 328  12],13,1,26683,3.755524278676988,40.0,0.0
47105,4,7105,[ 96 294  15  28 546],374,3,26686,3.7554179566563466,0.0,0.0
47106,4,7106,[ 64 117  97  50   7],669,3,26689,3.7553116645560713,0.0,20.0
47107,4,7107,[508  11 168 127 151],82,2,26691,3.7550647158131683,0.0,20.0
47108,4,7108,[ 88 181 328 132 175],653,2,26693,3.7548178365452243,0.0,0.0
47109,4,7109,[174 276 288  98 603],458,2,26695,3.7545710267229255,20.0,40.0
47110,4,7110,[183 403 300 357   4],234,3,26698,3.7544649135142736,20.0,0.0
47111,4,7111,[174 655 435 196  96],378,5,26703,3.7546400449943755,0.0,20.0
47112,4,7112,[200 183 268 273 161],7,2,26705,3.7543933642626177,0.0,0.0
47113,4,7113,[300 275 435  12 144],454,2,26707,3.754146752881642,20.0,0.0
47114,4,7114,[328  22 194 546 186],271,3,26710,3.7540407589599436,0.0,0.0
47115,4,7115,[111 655 121 742  98],42,3,26713,3.7539347948285555,0.0,20.0
47116,4,7116,[237   1 603  12 111],59,3,26716,3.7538288604749193,40.0,0.0
47117,4,7117,[302 603 100 427  64],666,5,26721,3.7540039336892383,20.0,20.0
47118,4,7118,[405 143 135 180 546],653,2,26723,3.753757550217727,0.0,0.0
47119,4,7119,[302 603 100 427  64],271,5,26728,3.753932584269663,20.0,20.0
47120,4,7120,[211 273  70 168 271],479,4,26732,3.753967139446707,0.0,0.0
47121,4,7121,[496  25  71 357 588],85,3,26735,3.7538612749227744,20.0,0.0
47122,4,7122,[302 603 100 427  64],666,5,26740,3.754036220693528,20.0,20.0
47123,4,7123,[435 100 294 143 194],666,2,26742,3.7537900056148232,0.0,20.0
47124,4,7124,[276 301 191 143 678],334,2,26744,3.7535438596491226,0.0,0.0
47125,4,7125,[257 405 172 144   8],883,4,26748,3.753578445130508,0.0,0.0
47126,4,7126,[597 143 357 405 300],7,2,26750,3.75333239792339,20.0,0.0
47127,4,7127,[302 603 100 427  64],339,5,26755,3.7535072951739616,20.0,20.0
47128,4,7128,[302 603 100 427  64],664,5,26760,3.7536821433581147,20.0,20.0
47129,4,7129,[302 603 100 427  64],537,4,26764,3.7537166900420758,20.0,20.0
47130,4,7130,[302 603 100 427  64],13,5,26769,3.753891459823307,20.0,20.0
47131,4,7131,[176 181 318 423  71],234,2,26771,3.7536455412226584,20.0,0.0
47132,4,7132,[302 603 100 427  64],13,5,26776,3.753820271975326,20.0,20.0
47133,4,7133,[515 186  71  15 125],59,3,26779,3.7537146061115783,0.0,0.0
47134,4,7134,[187 276 174 483  56],537,4,26783,3.7537491240364402,20.0,20.0
47135,4,7135,[302 603 100 427  64],90,5,26788,3.7539237668161434,20.0,20.0
47136,4,7136,[302 603 100 427  64],271,5,26793,3.7540983606557377,20.0,20.0
47137,4,7137,[143 357 258 151 121],843,1,26794,3.753712524516671,20.0,0.0
47138,4,7138,[204 275 176 238 174],189,5,26799,3.753887099033478,0.0,20.0
47139,4,7139,[302 603 100 427  64],458,5,26804,3.75406162464986,20.0,20.0
47140,4,7140,[318 200  97 385 181],374,3,26807,3.7539560285674276,20.0,0.0
47141,4,7141,[302 603 100 427  64],13,5,26812,3.754130495659479,20.0,20.0
47142,4,7142,[222  82 179 265  69],334,3,26815,3.7540249195016098,0.0,0.0
47143,4,7143,[194  64 405 273 132],213,4,26819,3.7540593505039195,0.0,0.0
47144,4,7144,[302 603 100 427  64],664,5,26824,3.7542337298810358,20.0,20.0
47145,4,7145,[237 301 215 357 194],537,1,26825,3.753848306745032,20.0,0.0
47146,4,7146,[302 603 100 427  64],537,4,26829,3.7538827480061565,20.0,20.0
47147,4,7147,[302 603 100 427  64],664,5,26834,3.7540570789031897,20.0,20.0
47148,4,7148,[302 603 100 427  64],13,5,26839,3.7542313610295146,20.0,20.0
47149,4,7149,[ 96 168 125 655 235],92,4,26843,3.754265734265734,0.0,0.0
47150,4,7150,[215 216  79 183 742],95,5,26848,3.754439938470144,0.0,0.0
47151,4,7151,[302 603 100 427  64],745,5,26853,3.7546140939597317,20.0,20.0
47152,4,7152,[ 15 132 238  12 174],234,1,26854,3.7542289948273453,20.0,20.0
47153,4,7153,[187 127 161  89 196],766,3,26857,3.7541235672351134,0.0,20.0
47154,4,7154,[427  97 173 197   9],474,5,26862,3.7542976939203356,0.0,0.0
47155,4,7155,[194 603 210 273 117],524,1,26863,3.753912800447177,20.0,0.0
47156,4,7156,[ 97 181 597   4  11],455,2,26865,3.7536677378789998,0.0,0.0
47157,4,7157,[ 97 603 222   7 265],650,4,26869,3.7537021514389495,20.0,0.0
47158,4,7158,[118   1   7 237 100],59,3,26872,3.7535968710713785,0.0,20.0
47159,4,7159,[ 95  96 322 100 132],308,3,26875,3.7534916201117317,0.0,20.0
47160,4,7160,[ 98 300 403  11  70],653,1,26876,3.7531071079458176,0.0,20.0
47161,4,7161,[ 82 179 183   7 132],10,5,26881,3.7532812063669367,0.0,0.0
47162,4,7162,[546 282 204  79 597],554,3,26884,3.753176043557169,0.0,0.0
47163,4,7163,[603 271 202  25  79],537,1,26885,3.752791736460078,20.0,0.0
47164,4,7164,[302 603 100 427  64],13,5,26890,3.7529658060013955,20.0,20.0
47165,4,7165,[302 603 100 427  64],664,5,26895,3.7531398269606475,20.0,20.0
47166,4,7166,[161  56 276 185 191],234,1,26896,3.7527556857820565,0.0,0.0
47167,4,7167,[302 603 100 427  64],664,5,26901,3.7529296875,20.0,20.0
47168,4,7168,[302 603 100 427  64],537,4,26905,3.752964151206584,20.0,20.0
47169,4,7169,[ 98 187 357  22  64],184,4,26909,3.7529986052998607,20.0,20.0
47170,4,7170,[302 603 100 427  64],339,5,26914,3.7531725003486263,20.0,20.0
47171,4,7171,[135   7  25 117  79],455,3,26917,3.753067484662577,0.0,0.0
47172,4,7172,[153 294 185 215  64],234,1,26918,3.752683674891956,0.0,0.0
47173,4,7173,[258 183 385  28 300],506,4,26922,3.752718148870923,0.0,0.0
47174,4,7174,[ 89 191 496 276 204],378,4,26926,3.752752613240418,0.0,0.0
47175,4,7175,[302 603 100 427  64],370,5,26931,3.7529264214046822,20.0,20.0
47176,4,7176,[216 276 143 194 471],308,3,26934,3.7528215131670613,0.0,0.0
47177,4,7177,[300 161 182  12 194],328,3,26937,3.752716634159933,20.0,0.0
47178,4,7178,[322 271 423 496 182],537,2,26939,3.7524724892046244,0.0,0.0
47179,4,7179,[302 603 100 427  64],370,5,26944,3.7526462395543176,20.0,20.0
47180,4,7180,[289  88 132 286 194],406,2,26946,3.7524021723993872,0.0,0.0
47181,4,7181,[191 357   9 168 186],379,5,26951,3.7525758841548313,20.0,0.0
47182,4,7182,[216 174 222  79 144],648,5,26956,3.7527495475428094,0.0,20.0
47183,4,7183,[210 111 234 187 238],749,2,26958,3.7525055679287305,0.0,0.0
47184,4,7184,[302 603 100 427  64],339,5,26963,3.7526791927627,20.0,20.0
47185,4,7185,[286 117   7 546 168],653,2,26965,3.7524352908433065,0.0,0.0
47186,4,7186,[ 12 118 568 121 132],795,1,26966,3.7520523166829,20.0,0.0
47187,4,7187,[302 603 100 427  64],271,5,26971,3.7522259321090705,20.0,20.0
47188,4,7188,[302 603 100 427  64],666,5,26976,3.7523994992349423,20.0,20.0
47189,4,7189,[302 603 100 427  64],664,5,26981,3.7525730180806676,20.0,20.0
47190,4,7190,[427 182   7 181 265],234,1,26982,3.7521902377972465,0.0,0.0
47191,4,7191,[302 603 100 427  64],666,5,26987,3.7523637374860956,20.0,20.0
47192,4,7192,[228 271  12 235 173],145,5,26992,3.7525371889336854,20.0,0.0
47193,4,7193,[302 603 100 427  64],454,5,26997,3.7527105921601334,20.0,20.0
47194,4,7194,[ 82 427 357 257 216],379,5,27002,3.7528839471855453,20.0,0.0
47195,4,7195,[318   1 742 508 180],387,3,27005,3.7527793218454697,20.0,0.0
47196,4,7196,[191 289 276 678 180],537,3,27008,3.752674725580103,0.0,0.0
47197,4,7197,[179 322 195 237 182],749,3,27011,3.752570158377327,0.0,0.0
47198,4,7198,[302 603 100 427  64],90,5,27016,3.752743436588415,20.0,20.0
47199,4,7199,[180 234  89 423 257],233,4,27020,3.7527777777777778,0.0,0.0
47200,4,7200,[302 603 100 427  64],339,5,27025,3.75295097903069,20.0,20.0
47201,4,7201,[302 603 100 427  64],666,5,27030,3.753124132185504,20.0,20.0
47202,4,7202,[172  64  79 204 435],454,3,27033,3.7530195751770097,0.0,0.0
47203,4,7203,[  8 228 234 257   1],92,4,27037,3.7530538589672404,0.0,0.0
47204,4,7204,[117 197 546 294  64],308,1,27038,3.7526717557251907,0.0,0.0
47205,4,7205,[196 173 222 168   7],234,0,27038,3.752150985290036,0.0,0.0
47206,4,7206,[328 275  69 180  71],378,2,27040,3.7519078673511865,0.0,0.0
47207,4,7207,[302 603 100 427  64],458,5,27045,3.7520810210876805,20.0,20.0
47208,4,7208,[302 603 100 427  64],474,5,27050,3.752254126785962,20.0,20.0
47209,4,7209,[186 121 200 300  89],271,2,27052,3.752011095700416,0.0,0.0
47210,4,7210,[302 603 100 427  64],454,5,27057,3.752184163084177,20.0,20.0
47211,4,7211,[ 69 405 318  89 423],64,3,27060,3.7520798668885194,20.0,0.0
47212,4,7212,[597 748  71  97 322],533,2,27062,3.751836961042562,0.0,0.0
47213,4,7213,[127 238 568  71 202],766,2,27064,3.7515941225395064,0.0,20.0
47214,4,7214,[405  12 186 276  79],374,5,27069,3.751767151767152,20.0,0.0
47215,4,7215,[282  98 195  28 181],207,3,27072,3.751662971175166,0.0,20.0
47216,4,7216,[144   7  50 435 357],7,5,27077,3.7518359429125674,20.0,20.0
47217,4,7217,[118 127 143  50 211],643,4,27081,3.751870324189526,0.0,40.0
47218,4,7218,[132 748 151 282 234],533,2,27083,3.7516276492589,0.0,0.0
47219,4,7219,[179 655 143  28   9],334,3,27086,3.7515235457063714,0.0,0.0
47220,4,7220,[289  97 168 127 196],881,1,27087,3.7511425010386374,0.0,20.0
47221,4,7221,[302 603 100 427  64],666,5,27092,3.7513154250900027,20.0,20.0
47222,4,7222,[300 200   8 172 515],328,4,27096,3.7513498546310395,0.0,0.0
47223,4,7223,[ 12 174 385  98   4],833,1,27097,3.750968992248062,20.0,40.0
47224,4,7224,[302 603 100 427  64],13,5,27102,3.7511418685121107,20.0,20.0
47225,4,7225,[ 64  98  97 100 328],145,5,27107,3.7513146969277607,0.0,40.0
47226,4,7226,[197 496 194 288  88],343,4,27111,3.7513491075134913,0.0,0.0
47227,4,7227,[222  22 323 748 405],488,3,27114,3.751245157719978,0.0,0.0
47228,4,7228,[302 603 100 427  64],339,5,27119,3.7514179001244985,20.0,20.0
47229,4,7229,[  7 385  96 403 144],60,4,27123,3.7514522821576763,0.0,0.0
47230,4,7230,[ 97 176 100 182 423],7,4,27127,3.7514866546812335,0.0,20.0
47231,4,7231,[302 603 100 427  64],370,5,27132,3.751659292035398,20.0,20.0
47232,4,7232,[302 603 100 427  64],454,5,27137,3.7518318816535325,20.0,20.0
47233,4,7233,[302 603 100 427  64],454,5,27142,3.752004423555433,20.0,20.0
47234,4,7234,[302 603 100 427  64],271,5,27147,3.7521769177608846,20.0,20.0
47235,4,7235,[ 69 183   7 194 181],499,4,27151,3.752211166390271,0.0,0.0
47236,4,7236,[197 202  50 655 153],313,4,27155,3.752245405554788,0.0,20.0
47237,4,7237,[238 210 234 127 271],883,4,27159,3.7522796352583585,0.0,20.0
47238,4,7238,[  9  89 153  95 187],184,4,27163,3.752313855504904,0.0,0.0
47239,4,7239,[ 11 333 151 385 301],537,0,27163,3.7517955801104974,0.0,0.0
47240,4,7240,[302 603 100 427  64],370,5,27168,3.751967960226488,20.0,20.0
47241,4,7241,[302 603 100 427  64],474,5,27173,3.752140292736813,20.0,20.0
47242,4,7242,[286 210 301  11 496],537,1,27174,3.751760320309264,0.0,0.0
47243,4,7243,[302 603 100 427  64],666,5,27179,3.7519326339039205,20.0,20.0
47244,4,7244,[181 258 135 211 121],882,4,27183,3.7519668737060043,0.0,0.0
47245,4,7245,[153 357 257 423 191],653,2,27185,3.7517250897046646,20.0,0.0
47246,4,7246,[132 172 197 161   8],60,4,27189,3.7517593486960124,0.0,0.0
47247,4,7247,[196 222 117 173 151],650,4,27193,3.7517935982339954,0.0,0.0
47248,4,7248,[405  50 182   9 197],474,5,27198,3.751965788384605,0.0,20.0
47249,4,7249,[  1 483 286 245 173],200,4,27202,3.752,20.0,0.0
47250,4,7250,[748  28 258 385 194],13,4,27206,3.7520342021790096,0.0,0.0
47251,4,7251,[403 385 168  88 202],95,4,27210,3.7520683949255376,0.0,0.0
47252,4,7252,[302 603 100 427  64],370,5,27215,3.752240452226665,20.0,20.0
47253,4,7253,[302 603 100 427  64],474,5,27220,3.7524124620898816,20.0,20.0
47254,4,7254,[257 655 196 175 195],479,5,27225,3.7525844245348035,0.0,0.0
47255,4,7255,[ 88 200 435 176 318],474,4,27229,3.7526185226019844,20.0,0.0
47256,4,7256,[302 603 100 427  64],537,4,27233,3.752652611271875,20.0,20.0
47257,4,7257,[ 96 275 268  79 496],7,4,27237,3.7526866905483605,0.0,0.0
47258,4,7258,[302 603 100 427  64],271,5,27242,3.7528585204573632,20.0,20.0
47259,4,7259,[302 603 100 427  64],666,5,27247,3.753030303030303,20.0,20.0
47260,4,7260,[302 603 100 427  64],664,5,27252,3.7532020382867373,20.0,20.0
47261,4,7261,[ 79  82 222 508 153],92,4,27256,3.753236023134123,0.0,0.0
47262,4,7262,[191 546  97   7   9],458,3,27259,3.7531323144706046,0.0,0.0
47263,4,7263,[ 22  98 483 127 179],194,5,27264,3.753303964757709,20.0,40.0
47264,4,7264,[ 89 289  50 427 195],234,3,27267,3.7532002752924982,0.0,20.0
47265,4,7265,[135 204  11 265   4],59,5,27272,3.7533718689788054,0.0,0.0
47266,4,7266,[ 12  89 144 187 655],833,4,27276,3.75340580707307,20.0,0.0
47267,4,7267,[196 117  82 194 183],398,5,27281,3.75357732526142,0.0,0.0
47268,4,7268,[302 603 100 427  64],454,5,27286,3.7537487962580824,20.0,20.0
47269,4,7269,[302 603 100 427  64],666,5,27291,3.753920220082531,20.0,20.0
47270,4,7270,[215 603 294 121  71],848,5,27296,3.754091596754229,20.0,0.0
47271,4,7271,[323 204 195 288 423],59,5,27301,3.7542629262926295,0.0,0.0
47272,4,7272,[302 603 100 427  64],454,5,27306,3.754434208717173,20.0,20.0
47273,4,7273,[302 603 100 427  64],90,5,27311,3.7546054440472916,20.0,20.0
47274,4,7274,[302 603 100 427  64],90,5,27316,3.7547766323024057,20.0,20.0
47275,4,7275,[302 603 100 427  64],664,5,27321,3.7549477735019243,20.0,20.0
47276,4,7276,[ 89 186 588 333 210],387,2,27323,3.7547066098667035,0.0,0.0
47277,4,7277,[117 222 655 258 151],738,3,27326,3.754602912888156,0.0,0.0
47278,4,7278,[423 132 288 195 286],666,2,27328,3.7543618628932545,0.0,0.0
47279,4,7279,[385 423 174 483   9],13,3,27331,3.754258241758242,20.0,20.0
47280,4,7280,[302 603 100 427  64],458,5,27336,3.754429336629584,20.0,20.0
47281,4,7281,[300 173  89 151 235],334,3,27339,3.7543257346882726,0.0,0.0
47282,4,7282,[144 385 187 275 196],64,4,27343,3.754359467252506,0.0,0.0
47283,4,7283,[302 603 100 427  64],458,5,27348,3.754530477759473,20.0,20.0
47284,4,7284,[655 215 118 385  71],881,4,27352,3.754564172958133,0.0,0.0
47285,4,7285,[194 182 313 127 216],215,4,27356,3.754597858907494,0.0,20.0
47286,4,7286,[176 168 181 403 423],254,2,27358,3.7543570742418004,0.0,0.0
47287,4,7287,[ 88 132 153 496   7],60,4,27362,3.754390779363337,0.0,0.0
47288,4,7288,[ 25  79  71 318 294],13,1,27363,3.754012896144876,20.0,0.0
47289,4,7289,[302 603 100 427  64],454,5,27368,3.7541838134430727,20.0,20.0
47290,4,7290,[181  25 197  98 276],406,4,27372,3.754217528459745,0.0,20.0
47291,4,7291,[302 603 100 427  64],90,5,27377,3.7543883708173342,20.0,20.0
47292,4,7292,[175 427 182 282 289],194,1,27378,3.7540106951871657,0.0,0.0
47293,4,7293,[302 603 100 427  64],454,5,27383,3.754181519056759,20.0,20.0
47294,4,7294,[234 127 603 100   4],339,5,27388,3.7543522960932147,20.0,40.0
47295,4,7295,[172 238   1   7 235],13,1,27389,3.7539747807017543,0.0,0.0
47296,4,7296,[118 168 289 385 357],13,2,27391,3.753734411401946,20.0,0.0
47297,4,7297,[172 423 185 197 151],298,3,27394,3.753631131816936,0.0,0.0
47298,4,7298,[ 88 403  22 405 275],901,3,27397,3.7535278805315797,0.0,0.0
47299,4,7299,[ 79 183 211 245 515],488,4,27401,3.7535616438356163,0.0,0.0
47300,4,7300,[286 515   4 238 655],7,4,27405,3.7535953978906997,0.0,0.0
47301,4,7301,[302 603 100 427  64],474,5,27410,3.753766091481786,20.0,20.0
47302,4,7302,[302 603 100 427  64],370,5,27415,3.7539367383267153,20.0,20.0
47303,4,7303,[  1 265 127 515 143],95,4,27419,3.7539704271631984,0.0,20.0
47304,4,7304,[  7 216  12 515 496],234,2,27421,3.7537303216974673,20.0,0.0
47305,4,7305,[302 603 100 427  64],474,5,27426,3.7539009033670956,20.0,20.0
47306,4,7306,[302 603 100 427  64],664,5,27431,3.7540714383467906,20.0,20.0
47307,4,7307,[302 603 100 427  64],664,5,27436,3.7542419266557197,20.0,20.0
47308,4,7308,[483 435 228  88   8],406,3,27439,3.754138733068819,20.0,0.0
47309,4,7309,[427 211 258 197  95],6,3,27442,3.754035567715458,0.0,0.0
47310,4,7310,[127 202  70  96  50],234,2,27444,3.7537956503898235,0.0,40.0
47311,4,7311,[125  12 300  97  69],788,3,27447,3.753692560175055,20.0,0.0
47312,4,7312,[302 603 100 427  64],370,5,27452,3.7538629837276085,20.0,20.0
47313,4,7313,[237 273  89 405 245],92,4,27456,3.7538966365873665,0.0,0.0
47314,4,7314,[302 603 100 427  64],13,5,27461,3.754066985645933,20.0,20.0
47315,4,7315,[117 151 185 405 271],334,2,27463,3.753827227993439,0.0,0.0
47316,4,7316,[153  79 168 185  88],234,0,27463,3.7533141998086648,0.0,0.0
47317,4,7317,[302 603 100 427  64],458,5,27468,3.7534845586225747,20.0,20.0
47318,4,7318,[302 603 100 427  64],90,5,27473,3.7536548708840005,20.0,20.0
47319,4,7319,[302 603 100 427  64],370,5,27478,3.7538251366120217,20.0,20.0
47320,4,7320,[302 603 100 427  64],664,5,27483,3.753995355825707,20.0,20.0
47321,4,7321,[180  69 655 289   1],387,2,27485,3.7537558044250203,0.0,0.0
47322,4,7322,[313 125 143 210 258],207,4,27489,3.7537894305612456,0.0,0.0
47323,4,7323,[300  50   8 313 173],13,3,27492,3.7536865101037686,0.0,20.0
47324,4,7324,[302 603 100 427  64],666,5,27497,3.7538566552901025,20.0,20.0
47325,4,7325,[322 121 194  98 174],537,0,27497,3.7533442533442534,0.0,40.0
47326,4,7326,[222 286  89 172  28],537,1,27498,3.7529684727719395,0.0,0.0
47327,4,7327,[ 97  95 228  70 183],42,3,27501,3.7528657205240177,0.0,0.0
47328,4,7328,[215 153  88 132 568],184,2,27503,3.7526265520534863,0.0,0.0
47329,4,7329,[302 603 100 427  64],537,4,27507,3.7526603001364256,20.0,20.0
47330,4,7330,[286 195 427 435 183],650,4,27511,3.752694039012413,0.0,0.0
47331,4,7331,[202  88  82 173 238],194,2,27513,3.752454991816694,0.0,0.0
47332,4,7332,[328 588 258 508 173],144,4,27517,3.752488749488613,0.0,0.0
47333,4,7333,[151 194  11 204  64],387,0,27517,3.751977092991546,0.0,0.0
47334,4,7334,[118 211 176 435 210],638,2,27519,3.7517382413087934,0.0,0.0
47335,4,7335,[302 603 100 427  64],745,5,27524,3.7519083969465647,20.0,20.0
47336,4,7336,[  9 268  97 176 603],7,3,27527,3.7518059152242063,20.0,0.0
47337,4,7337,[405 191 265  79 182],795,2,27529,3.7515671845189424,0.0,0.0
47338,4,7338,[302 603 100 427  64],90,5,27534,3.751737293909252,20.0,20.0
47339,4,7339,[603 357  88 496 210],454,4,27538,3.7517711171662125,40.0,0.0
47340,4,7340,[132 483 197   7 202],650,4,27542,3.7518049312082824,20.0,0.0
47341,4,7341,[302 603 100 427  64],339,5,27547,3.751974938708799,20.0,20.0
47342,4,7342,[302 603 100 427  64],271,5,27552,3.752144899904671,20.0,20.0
47343,4,7343,[200 483 210  69 121],804,4,27556,3.752178649237473,20.0,0.0
47344,4,7344,[318 228  50 118  56],455,4,27560,3.752212389380531,20.0,20.0
47345,4,7345,[302 603 100 427  64],474,5,27565,3.7523822488429075,20.0,20.0
47346,4,7346,[302 603 100 427  64],745,5,27570,3.7525520620661497,20.0,20.0
47347,4,7347,[ 89 276 301 174  56],145,4,27574,3.7525857376156777,0.0,20.0
47348,4,7348,[302 603 100 427  64],458,5,27579,3.7527554769356377,20.0,20.0
47349,4,7349,[118 238  28 245  82],92,2,27581,3.752517006802721,0.0,0.0
47350,4,7350,[161 546 182 187 294],533,3,27584,3.7524146374642906,0.0,0.0
47351,4,7351,[ 98   7 191 435 125],881,4,27588,3.752448313384113,0.0,20.0
47352,4,7352,[568  82 151 483 216],648,4,27592,3.7524819801441587,20.0,0.0
47353,4,7353,[302 603 100 427  64],537,4,27596,3.7525156377481643,20.0,20.0
47354,4,7354,[  9 275 235 197 276],343,5,27601,3.7526852481305233,0.0,0.0
47355,4,7355,[153  69 515 588   1],234,2,27603,3.752446982055465,0.0,0.0
47356,4,7356,[  7 588 121  12 118],13,4,27607,3.752480630691858,20.0,0.0
47357,4,7357,[423 435  12  25  97],194,2,27609,3.7522424571894537,20.0,0.0
47358,4,7358,[302 603 100 427  64],90,5,27614,3.7524120125016984,20.0,20.0
47359,4,7359,[302 603 100 427  64],745,5,27619,3.7525815217391303,20.0,20.0
47360,4,7360,[195 597 202 132 245],804,4,27623,3.7526151338133404,0.0,0.0
47361,4,7361,[302 603 100 427  64],745,5,27628,3.7527845694104864,20.0,20.0
47362,4,7362,[302 603 100 427  64],458,5,27633,3.7529539589841097,20.0,20.0
47363,4,7363,[265 748 228 168 357],533,2,27635,3.752715915263444,20.0,0.0
47364,4,7364,[234  82 173 215 180],659,5,27640,3.752885268160217,0.0,0.0
47365,4,7365,[302 603 100 427  64],13,5,27645,3.7530545750746676,20.0,20.0
47366,4,7366,[ 70 215 273 237 300],234,0,27645,3.7525451337043574,0.0,0.0
47367,4,7367,[204 195 471 185 300],13,1,27646,3.752171552660152,0.0,0.0
47368,4,7368,[175 385 294 127 435],102,1,27647,3.7517980730085494,0.0,20.0
47369,4,7369,[ 22 234 496 515  50],313,4,27651,3.751831750339213,0.0,20.0
47370,4,7370,[269 276 183 100 475],537,3,27654,3.751729751729752,0.0,20.0
47371,4,7371,[ 69  50 568 180 161],659,2,27656,3.751492132392838,0.0,20.0
47372,4,7372,[302 603 100 427  64],339,5,27661,3.7516614675166147,20.0,20.0
47373,4,7373,[245 200 195 234 173],749,5,27666,3.7518307567127747,0.0,0.0
47374,4,7374,[302 603 100 427  64],271,5,27671,3.752,20.0,20.0
47375,4,7375,[111 179 132  95 742],334,1,27672,3.7516268980477223,0.0,0.0
47376,4,7376,[302 603 100 427  64],458,5,27677,3.7517961230852652,20.0,20.0
47377,4,7377,[275 168  64 176 403],311,5,27682,3.7519653022499324,0.0,0.0
47378,4,7378,[ 96 204 200  89 568],881,3,27685,3.751863396124136,0.0,0.0
47379,4,7379,[302 603 100 427  64],454,5,27690,3.752032520325203,20.0,20.0
47380,4,7380,[ 25 168 435 172 475],648,3,27693,3.7519306327055952,0.0,0.0
47381,4,7381,[  9 276 289 238 271],334,3,27696,3.751828772690328,0.0,0.0
47382,4,7382,[132 191 265 483 237],452,2,27698,3.75159149397264,20.0,0.0
47383,4,7383,[ 69 168  56  50   4],940,2,27700,3.7513542795232935,0.0,20.0
47384,4,7384,[175 313 204 143   7],59,4,27704,3.7513879485443464,0.0,0.0
47385,4,7385,[302 603 100 427  64],745,5,27709,3.7515569997292175,20.0,20.0
47386,4,7386,[302 603 100 427  64],666,5,27714,3.7517260051441723,20.0,20.0
47387,4,7387,[302 603 100 427  64],474,5,27719,3.7518949648077964,20.0,20.0
47388,4,7388,[  1 135  89 271 603],13,3,27722,3.7517932061172012,20.0,0.0
47389,4,7389,[215 175  50 546 222],479,3,27725,3.7516914749661705,0.0,20.0
47390,4,7390,[161  71 127 191 172],334,2,27727,3.751454471654715,0.0,20.0
47391,4,7391,[302 603 100 427  64],339,5,27732,3.7516233766233764,20.0,20.0
47392,4,7392,[302 603 100 427  64],271,5,27737,3.751792235898823,20.0,20.0
47393,4,7393,[191 211 333  28 483],533,5,27742,3.7519610494995943,20.0,0.0
47394,4,7394,[180  69 423 100 515],234,4,27746,3.751994590939824,0.0,20.0
47395,4,7395,[186  98 181 288 100],7,4,27750,3.752028123309897,0.0,40.0
47396,4,7396,[302 603 100 427  64],271,5,27755,3.75219683655536,20.0,20.0
47397,4,7397,[ 25 423 176 435 234],648,4,27759,3.7522303325223034,0.0,0.0
47398,4,7398,[302 603 100 427  64],474,5,27764,3.752398972834167,20.0,20.0
47399,4,7399,[143 328 187 588  12],537,1,27765,3.752027027027027,20.0,0.0
47400,4,7400,[302 603 100 427  64],271,5,27770,3.7521956492365898,20.0,20.0
47401,4,7401,[265 435 172 318 257],666,2,27772,3.751958930018914,20.0,0.0
47402,4,7402,[200  95 258 546 323],455,3,27775,3.7518573551263,0.0,0.0
47403,4,7403,[174  69 328 194 151],749,5,27780,3.7520259319286873,0.0,20.0
47404,4,7404,[496 183 211 294 748],346,4,27784,3.752059419311276,0.0,0.0
47405,4,7405,[742 194 180 234 191],650,3,27787,3.751957871995679,0.0,0.0
47406,4,7406,[200 269 289 176 568],537,0,27787,3.7514513298231402,0.0,0.0
47407,4,7407,[302 603 100 427  64],458,5,27792,3.751619870410367,20.0,20.0
47408,4,7408,[302 603 100 427  64],745,5,27797,3.751788365501417,20.0,20.0
47409,4,7409,[435 127 300  22  50],263,4,27801,3.7518218623481783,0.0,40.0
47410,4,7410,[423 273 179  25  50],92,3,27804,3.751720415598435,0.0,20.0
47411,4,7411,[302 603 100 427  64],13,5,27809,3.7518888289260657,20.0,20.0
47412,4,7412,[ 96 191 435   9 100],7,5,27814,3.752057196816404,0.0,20.0
47413,4,7413,[180 111   8  89  96],13,5,27819,3.7522255192878338,0.0,0.0
47414,4,7414,[204 117  28 237 187],458,4,27823,3.752258934592043,0.0,0.0
47415,4,7415,[258  89 423 195 180],774,1,27824,3.7518878101402375,0.0,0.0
47416,4,7416,[ 97 300 204  56 216],666,2,27826,3.751651611163543,0.0,0.0
47417,4,7417,[ 71 180 125 318 127],311,5,27831,3.7518198975465085,20.0,20.0
47418,4,7418,[ 22  71  96   7 265],892,4,27835,3.75185334950802,0.0,0.0
47419,4,7419,[174 234 228  50 144],643,5,27840,3.752021563342318,0.0,40.0
47420,4,7420,[318 186 182 202  22],537,3,27843,3.751920226384584,20.0,0.0
47421,4,7421,[405  79 597 185  89],59,3,27846,3.751818916734034,0.0,0.0
47422,4,7422,[546 276 174 197  96],207,2,27848,3.751582917957699,0.0,20.0
47423,4,7423,[655 313 186 168   9],64,5,27853,3.751751077586207,0.0,0.0
47424,4,7424,[183 153 195 294 186],788,1,27854,3.7513804713804713,0.0,0.0
47425,4,7425,[197  96 546  69 181],524,4,27858,3.7514139509830327,0.0,0.0
47426,4,7426,[302 603 100 427  64],745,5,27863,3.7515820654369194,20.0,20.0
47427,4,7427,[216  95 195 210   8],85,2,27865,3.751346257404416,0.0,0.0
47428,4,7428,[302 603 100 427  64],458,5,27870,3.751514335711401,20.0,20.0
47429,4,7429,[ 28 742  69 202   4],653,2,27872,3.751278600269179,0.0,0.0
47430,4,7430,[153 196 568 238  56],339,4,27876,3.751312071053694,0.0,0.0
47431,4,7431,[294   7 269  15 216],650,3,27879,3.751210979547901,0.0,0.0
47432,4,7432,[ 89  69 204 483 197],85,5,27884,3.7513789856047355,20.0,0.0
47433,4,7433,[ 70 742 748 187 265],488,3,27887,3.7512779122948614,0.0,0.0
47434,4,7434,[597 197 111  98  70],533,4,27891,3.7513113651647614,0.0,20.0
47435,4,7435,[265 235 179 496 196],334,2,27893,3.7510758472296932,0.0,0.0
47436,4,7436,[471 265  89  50  25],313,4,27897,3.7511093182734974,0.0,20.0
47437,4,7437,[210 197  64 318  22],326,3,27900,3.751008335574079,20.0,0.0
47438,4,7438,[174 185 215 172  97],881,3,27903,3.7509073800241968,0.0,20.0
47439,4,7439,[288 286 121 168 742],648,4,27907,3.750940860215054,0.0,0.0
47440,4,7440,[135 195 237 168 143],7,4,27911,3.750974331407069,0.0,0.0
47441,4,7441,[ 79 168 204 143  12],795,2,27913,3.750739048642838,20.0,0.0
47442,4,7442,[182 135  12 302  97],145,5,27918,3.750906892382104,20.0,0.0
47443,4,7443,[597  70 202  71 546],533,3,27921,3.7508060182697474,0.0,0.0
47444,4,7444,[302 603 100 427  64],474,5,27926,3.750973807924782,20.0,20.0
47445,4,7445,[ 96 333 127 195  79],881,4,27930,3.7510072522159548,0.0,20.0
47446,4,7446,[302 603 100 427  64],271,5,27935,3.7511749697864913,20.0,20.0
47447,4,7447,[302 603 100 427  64],90,5,27940,3.7513426423200857,20.0,20.0
47448,4,7448,[282 496 202 276  82],311,5,27945,3.7515102698348772,0.0,0.0
47449,4,7449,[265 185 127  98 483],524,4,27949,3.751543624161074,20.0,40.0
47450,4,7450,[172  50 423 186 202],271,5,27954,3.7517111797074216,0.0,20.0
47451,4,7451,[302 603 100 427  64],664,5,27959,3.7518786902844874,20.0,20.0
47452,4,7452,[ 22 144 121 385 423],328,4,27963,3.7519119817523143,0.0,0.0
47453,4,7453,[302 603 100 427  64],664,5,27968,3.7520794204453987,20.0,20.0
47454,4,7454,[302 603 100 427  64],664,5,27973,3.7522468142186454,20.0,20.0
47455,4,7455,[302 603 100 427  64],454,5,27978,3.752414163090129,20.0,20.0
47456,4,7456,[302 603 100 427  64],90,5,27983,3.7525814670779134,20.0,20.0
47457,4,7457,[ 56   7  11 197 216],339,4,27987,3.752614641995173,0.0,0.0
47458,4,7458,[ 25 238 118 181 185],666,2,27989,3.7523796755597263,0.0,0.0
47459,4,7459,[275 235   8 202 228],64,5,27994,3.7525469168900805,0.0,0.0
47460,4,7460,[216 196 357 597  15],882,5,27999,3.7527141133896262,20.0,0.0
47461,4,7461,[127 117 238 187 191],387,4,28003,3.7527472527472527,0.0,20.0
47462,4,7462,[302 603 100 427  64],454,5,28008,3.752914377596141,20.0,20.0
47463,4,7463,[302 603 100 427  64],271,5,28013,3.753081457663451,20.0,20.0
47464,4,7464,[328 117 127 181 151],313,4,28017,3.7531145344943067,0.0,20.0
47465,4,7465,[405 742 276   1 132],271,1,28018,3.7527457808732922,0.0,0.0
47466,4,7466,[ 71 121 215 237 100],13,5,28023,3.7529128163921253,0.0,20.0
47467,4,7467,[144 183 435 204 181],295,4,28027,3.7529459025174075,0.0,0.0
47468,4,7468,[302 603 100 427  64],537,4,28031,3.7529789797831037,20.0,20.0
47469,4,7469,[302 603 100 427  64],537,4,28035,3.753012048192771,20.0,20.0
47470,4,7470,[ 79  88  28 215  96],653,3,28038,3.752911256859858,0.0,0.0
47471,4,7471,[181 245 405 215  64],313,3,28041,3.752810492505353,0.0,0.0
47472,4,7472,[302 603 100 427  64],370,5,28046,3.7529773852535797,20.0,20.0
47473,4,7473,[471 742 357 197 302],271,3,28049,3.752876639015253,20.0,0.0
47474,4,7474,[ 22 258  88   1 183],479,5,28054,3.7530434782608695,0.0,0.0
47475,4,7475,[742 186  82 483 100],59,4,28058,3.753076511503478,20.0,20.0
47476,4,7476,[302 603 100 427  64],664,5,28063,3.7532432793901296,20.0,20.0
47477,4,7477,[302 603 100 427  64],339,5,28068,3.753410002674512,20.0,20.0
47478,4,7478,[132 176  82  70 282],334,2,28070,3.7531755582297097,0.0,0.0
47479,4,7479,[302 603 100 427  64],537,4,28074,3.753208556149733,20.0,20.0
47480,4,7480,[302 603 100 427  64],370,5,28079,3.7533752172169494,20.0,20.0
47481,4,7481,[194 179 196  64 151],234,2,28081,3.753140871424753,0.0,0.0
47482,4,7482,[197 127 423  28 117],643,4,28085,3.7531738607510357,0.0,20.0
47483,4,7483,[302 603 100 427  64],90,5,28090,3.7533404596472475,20.0,20.0
47484,4,7484,[655   9 228 588 475],64,5,28095,3.753507014028056,0.0,0.0
47485,4,7485,[ 71 194 427  82   7],194,3,28098,3.753406358535934,0.0,0.0
47486,4,7486,[222  79 211  15  28],882,5,28103,3.7535728596233473,0.0,0.0
47487,4,7487,[176 273 173 132 568],378,5,28108,3.7537393162393164,0.0,0.0
47488,4,7488,[ 50 175 328 216 294],479,3,28111,3.7536386700494058,0.0,20.0
47489,4,7489,[ 56 508  98 222  97],85,2,28113,3.7534045393858477,0.0,20.0
47490,4,7490,[265 276 194 127 286],339,4,28117,3.7534374582832735,0.0,20.0
47491,4,7491,[100 237 197  22  82],64,3,28120,3.7533368926855313,0.0,20.0
47492,4,7492,[210 333  50 168 568],506,5,28125,3.753503269718404,0.0,20.0
47493,4,7493,[318 153 328 234 546],328,3,28128,3.7534027221777424,20.0,0.0
47494,4,7494,[151 385  89 222 289],374,2,28130,3.753168779186124,0.0,0.0
47495,4,7495,[385 323 186 265 185],488,4,28134,3.7532017075773747,0.0,0.0
47496,4,7496,[302 603 100 427  64],458,5,28139,3.7533680138722154,20.0,20.0
47497,4,7497,[ 96 121   4 182 153],666,3,28142,3.753267538010136,0.0,0.0
47498,4,7498,[ 71 234  88 191 183],840,4,28146,3.7533004400586747,0.0,0.0
47499,4,7499,[302 603 100 427  64],474,5,28151,3.7534666666666667,20.0,20.0
47500,4,7500,[195 202 111 153  82],378,2,28153,3.753232902279696,0.0,0.0
47501,4,7501,[302 603 100 427  64],537,4,28157,3.7532657957877897,20.0,20.0
47502,4,7502,[403 174 202   7 118],87,4,28161,3.753298680527789,0.0,20.0
47503,4,7503,[322 265 294 237  97],346,3,28164,3.75319829424307,0.0,0.0
47504,4,7504,[  4 257   9 172 288],374,1,28165,3.752831445702865,0.0,0.0
47505,4,7505,[302 603 100 427  64],666,5,28170,3.7529976019184654,20.0,20.0
47506,4,7506,[ 82 603 238   8 318],334,5,28175,3.7531637138670573,40.0,0.0
47507,4,7507,[197 183 423 318 210],374,3,28178,3.753063399041023,20.0,0.0
47508,4,7508,[125   9   4  82 183],7,4,28182,3.7530962844586497,0.0,0.0
47509,4,7509,[117 216 204 276  98],474,5,28187,3.7532623169107855,0.0,20.0
47510,4,7510,[597 210 385 173 175],102,1,28188,3.752895752895753,0.0,0.0
47511,4,7511,[125 135 228 172 323],254,3,28191,3.7527955271565494,0.0,0.0
47512,4,7512,[496 194 313 403 237],890,3,28194,3.7526953280979636,0.0,0.0
47513,4,7513,[302 603 100 427  64],370,5,28199,3.7528613255256853,20.0,20.0
47514,4,7514,[200  12 176 435 117],455,2,28201,3.7526280771789753,20.0,0.0
47515,4,7515,[173 597  88 132 655],92,1,28202,3.752261841405003,0.0,0.0
47516,4,7516,[ 28 132 175 204   1],918,2,28204,3.7520287348676336,0.0,0.0
47517,4,7517,[143  71 237 385 132],533,4,28208,3.7520617185421656,0.0,0.0
47518,4,7518,[403  89 435  82 195],901,3,28211,3.7519616970341803,0.0,0.0
47519,4,7519,[313 194 135 195 237],883,2,28213,3.751728723404255,0.0,0.0
47520,4,7520,[204 151 180  28 603],897,5,28218,3.751894694854408,20.0,0.0
47521,4,7521,[302 603 100 427  64],271,5,28223,3.7520606221749535,20.0,20.0
47522,4,7522,[118 172  25 273 568],749,4,28227,3.752093579688954,0.0,0.0
47523,4,7523,[333 385  11  28 132],666,2,28229,3.7518607123870282,0.0,0.0
47524,4,7524,[302 603 100 427  64],339,5,28234,3.7520265780730897,20.0,20.0
47525,4,7525,[ 89  97 228 222 121],454,2,28236,3.751793781557268,0.0,0.0
47526,4,7526,[ 22 210 546  98 234],313,4,28240,3.751826757008104,0.0,20.0
47527,4,7527,[216 405  98 210 197],666,2,28242,3.751594048884166,0.0,20.0
47528,4,7528,[302 603 100 427  64],339,5,28247,3.7517598618674457,20.0,20.0
47529,4,7529,[302 603 100 427  64],90,5,28252,3.751925630810093,20.0,20.0
47530,4,7530,[ 22 182   4 144  98],346,4,28256,3.7519585712388794,0.0,20.0
47531,4,7531,[655 427 475 197 603],334,5,28261,3.7521242697822625,20.0,0.0
47532,4,7532,[302 603 100 427  64],454,5,28266,3.7522899243329353,20.0,20.0
47533,4,7533,[271 603 515  89 185],890,4,28270,3.752322803291744,20.0,0.0
47534,4,7534,[302 603 100 427  64],458,5,28275,3.752488387524884,20.0,20.0
47535,4,7535,[211 125 200 173 385],234,1,28276,3.752123142250531,0.0,0.0
47536,4,7536,[202 385  88 200 183],326,2,28278,3.751890672681438,0.0,0.0
47537,4,7537,[176 200  70 294 222],447,2,28280,3.751658264791722,0.0,0.0
47538,4,7538,[302 603 100 427  64],664,5,28285,3.7518238493168856,20.0,20.0
47539,4,7539,[237  97 173 211  64],288,4,28289,3.7518567639257294,0.0,0.0
47540,4,7540,[ 96 300 187 144 135],788,3,28292,3.7517570613976927,0.0,0.0
47541,4,7541,[302 603 100 427  64],664,5,28297,3.7519225669583665,20.0,20.0
47542,4,7542,[174 153 234 175 176],234,1,28298,3.7515577356489462,0.0,20.0
47543,4,7543,[302 603 100 427  64],271,5,28303,3.751723223753977,20.0,20.0
47544,4,7544,[655 265 322 151 161],881,3,28306,3.7516235917826375,0.0,0.0
47545,4,7545,[302 132 121 200 235],378,4,28310,3.7516565067585477,0.0,0.0
47546,4,7546,[ 56 174 168 211 475],6,5,28315,3.75182191599311,0.0,20.0
47547,4,7547,[  9 194 483 301 151],6,3,28318,3.75172231054584,20.0,0.0
47548,4,7548,[268  79 135   8 258],387,4,28322,3.7517551993641542,0.0,0.0
47549,4,7549,[289   7  11 235 187],334,3,28325,3.751655629139073,0.0,0.0
47550,4,7550,[302 603 100 427  64],370,5,28330,3.751820950867435,20.0,20.0
47551,4,7551,[  1 496 127  70 121],533,5,28335,3.7519862288135593,0.0,20.0
47552,4,7552,[301 211 257  12 173],6,3,28338,3.7518866675493183,20.0,0.0
47553,4,7553,[ 22 300 318 237 216],188,4,28342,3.751919512840879,20.0,0.0
47554,4,7554,[302 603 100 427  64],339,5,28347,3.7520847121111847,20.0,20.0
47555,4,7555,[132 294 196 405 423],653,0,28347,3.7515881418740076,0.0,0.0
47556,4,7556,[302 603 100 427  64],454,5,28352,3.751753341272992,20.0,20.0
47557,4,7557,[302 603 100 427  64],13,5,28357,3.751918496956867,20.0,20.0
47558,4,7558,[302 603 100 427  64],745,5,28362,3.752083608942982,20.0,20.0
47559,4,7559,[282 172 180  96 197],533,4,28366,3.752116402116402,0.0,0.0
47560,4,7560,[ 89 118 175  71  12],378,5,28371,3.7522814442534056,20.0,0.0
47561,4,7561,[ 22 194 197 286  98],378,4,28375,3.752314202591907,0.0,20.0
47562,4,7562,[748  79   4 168 185],474,3,28378,3.7522147296046544,0.0,0.0
47563,4,7563,[118 215 265 179 275],524,3,28381,3.7521152829190902,0.0,0.0
47564,4,7564,[403 235  79 153  12],788,2,28383,3.751883674818242,20.0,0.0
47565,4,7565,[200 300 195 273 483],328,3,28386,3.7517842981760507,20.0,0.0
47566,4,7566,[144 111 195 508 191],543,5,28391,3.7519492533368575,0.0,0.0
47567,4,7567,[183 403 508 202   9],13,2,28393,3.7517177589852007,0.0,0.0
47568,4,7568,[ 50 196  12  69  97],506,5,28398,3.75188267934998,20.0,20.0
47569,4,7569,[302 603 100 427  64],745,5,28403,3.7520475561426685,20.0,20.0
47570,4,7570,[211 210  50 228 597],643,4,28407,3.7520803064324397,0.0,20.0
47571,4,7571,[117  56 234 435   8],232,2,28409,3.7518489170628633,0.0,0.0
47572,4,7572,[234  70   9   7 195],13,1,28410,3.7514855407368284,0.0,0.0
47573,4,7573,[302 603 100 427  64],474,5,28415,3.75165038288883,20.0,20.0
47574,4,7574,[161 515 118 234 194],271,3,28418,3.7515511551155116,0.0,0.0
47575,4,7575,[318  71  98 186 405],533,3,28421,3.7514519535374866,20.0,20.0
47576,4,7576,[302 603 100 427  64],666,5,28426,3.751616734855484,20.0,20.0
47577,4,7577,[ 79  82 121 202  70],452,3,28429,3.751517550804962,0.0,0.0
47578,4,7578,[121  69 118  15 237],145,2,28431,3.751286449399657,0.0,0.0
47579,4,7579,[302 603 100 427  64],666,5,28436,3.751451187335092,20.0,20.0
47580,4,7580,[194  79 435 183  96],328,4,28440,3.7514839730906213,0.0,0.0
47581,4,7581,[302 603 100 427  64],458,5,28445,3.751648641519388,20.0,20.0
47582,4,7582,[ 98 191  71 405  82],533,4,28449,3.751681392588685,0.0,20.0
47583,4,7583,[302 603 100 427  64],537,4,28453,3.751714135021097,20.0,20.0
47584,4,7584,[ 56 265 222  88 210],648,4,28457,3.7517468688200397,0.0,0.0
47585,4,7585,[302 603 100 427  64],454,5,28462,3.7519114157658846,20.0,20.0
47586,4,7586,[  7 172 286  64 515],7,4,28466,3.7519441149334387,0.0,0.0
47587,4,7587,[181  79 742 173 151],387,3,28469,3.7518450184501844,0.0,0.0
47588,4,7588,[ 95 180 204 403 197],848,4,28473,3.751877717749374,0.0,0.0
47589,4,7589,[655 176 210 234  71],59,4,28477,3.7519104084321477,0.0,0.0
47590,4,7590,[215 197  98 322 588],454,2,28479,3.7516796206033463,0.0,20.0
47591,4,7591,[183 271  95 181 603],13,4,28483,3.7517123287671232,20.0,0.0
47592,4,7592,[135  70 125 121  82],804,4,28487,3.751745028315554,0.0,0.0
47593,4,7593,[186  82 568  95 168],95,3,28490,3.7516460363444826,0.0,0.0
47594,4,7594,[302 603 100 427  64],458,5,28495,3.751810401579987,20.0,20.0
47595,4,7595,[195 235 179 204  98],374,2,28497,3.7515797788309637,0.0,20.0
47596,4,7596,[300 655  97 276 222],537,1,28498,3.751217585889167,0.0,0.0
47597,4,7597,[186 196 151  98 435],387,1,28499,3.7508554882863914,0.0,20.0
47598,4,7598,[302 603 100 427  64],339,5,28504,3.7510198710356626,20.0,20.0
47599,4,7599,[302 603 100 427  64],474,5,28509,3.751184210526316,20.0,20.0
47600,4,7600,[ 89 210 405 265  79],666,1,28510,3.7508222602289174,0.0,0.0
47601,4,7601,[288 265  95 475 179],308,4,28514,3.750855038147856,0.0,0.0
47602,4,7602,[302 603 100 427  64],474,5,28519,3.7510193344732343,20.0,20.0
47603,4,7603,[153 678 275 202 235],308,3,28522,3.750920568122041,0.0,0.0
47604,4,7604,[302 603 100 427  64],454,5,28527,3.751084812623274,20.0,20.0
47605,4,7605,[186 202 403  70 153],295,5,28532,3.751249013936366,0.0,0.0
47606,4,7606,[174 273 313   9 176],308,3,28535,3.751150256342842,0.0,20.0
47607,4,7607,[135  89   7 603  79],524,2,28537,3.7509200841219767,20.0,0.0
47608,4,7608,[265 427 185 200   1],298,3,28540,3.7508213957156,0.0,0.0
47609,4,7609,[302 603 100 427  64],666,5,28545,3.7509855453350855,20.0,20.0
47610,4,7610,[328 153 173 180  71],664,4,28549,3.7510182630403364,0.0,0.0
47611,4,7611,[302 603 100 427  64],745,5,28554,3.751182343667893,20.0,20.0
47612,4,7612,[153 235 200  28 111],13,3,28557,3.751083672665178,0.0,0.0
47613,4,7613,[403 194 588 515 265],311,5,28562,3.7512477016023116,0.0,0.0
47614,4,7614,[176  70 117 357 257],474,4,28566,3.751280367695338,20.0,0.0
47615,4,7615,[ 96 588 191 143 194],189,5,28571,3.7514443277310923,0.0,0.0
47616,4,7616,[237  98 127 515 181],346,4,28575,3.7514769594328476,0.0,40.0
47617,4,7617,[302 603 100 427  64],745,5,28580,3.7516408506169596,20.0,20.0
47618,4,7618,[302 603 100 427  64],370,5,28585,3.751804698779367,20.0,20.0
47619,4,7619,[271 211 197 228 215],749,5,28590,3.751968503937008,0.0,0.0
47620,4,7620,[135 471 385  22 194],524,2,28592,3.751738616979399,0.0,0.0
47621,4,7621,[161  70 286 546  11],102,0,28592,3.751246392023091,0.0,0.0
47622,4,7622,[302 603 100 427  64],90,5,28597,3.7514102059556604,20.0,20.0
47623,4,7623,[405 161  25 276 385],455,2,28599,3.751180482686254,0.0,0.0
47624,4,7624,[234 245 294  22 742],346,3,28602,3.7510819672131146,0.0,0.0
47625,4,7625,[405 186 204  95 282],194,2,28604,3.75085234723315,0.0,0.0
47626,4,7626,[302 603 100 427  64],454,5,28609,3.7510161269175297,20.0,20.0
47627,4,7627,[302 603 100 427  64],13,5,28614,3.7511798636601994,20.0,20.0
47628,4,7628,[238 196 322 258 202],537,2,28616,3.750950321143007,0.0,0.0
47629,4,7629,[385   8   7  82 271],379,3,28619,3.750851900393185,0.0,0.0
47630,4,7630,[275 235 603   9 471],548,2,28621,3.750622461014284,20.0,0.0
47631,4,7631,[302 603 100 427  64],537,4,28625,3.750655136268344,20.0,20.0
47632,4,7632,[302 603 100 427  64],666,5,28630,3.7508188130486046,20.0,20.0
47633,4,7633,[174 132 181 546 151],339,5,28635,3.750982446947865,0.0,20.0
47634,4,7634,[313 182 144 183 117],328,4,28639,3.7510150622134906,0.0,0.0
47635,4,7635,[302 603 100 427  64],745,5,28644,3.751178627553693,20.0,20.0
47636,4,7636,[302 603 100 427  64],745,5,28649,3.7513421500589237,20.0,20.0
47637,4,7637,[328  22 483 515 172],13,3,28652,3.7512437810945274,20.0,0.0
47638,4,7638,[204  82 174 435 121],454,4,28656,3.751276345071344,0.0,20.0
47639,4,7639,[302 603 100 427  64],666,5,28661,3.7514397905759163,20.0,20.0
47640,4,7640,[302 603 100 427  64],458,5,28666,3.7516031932993066,20.0,20.0
47641,4,7641,[302 603 100 427  64],664,5,28671,3.7517665532583093,20.0,20.0
47642,4,7642,[121 294 423 176   9],533,4,28675,3.7517990317937984,0.0,0.0
47643,4,7643,[183 186 173 176 185],848,3,28678,3.751700680272109,0.0,0.0
47644,4,7644,[181 153 187 427 180],85,3,28681,3.7516023544800525,0.0,0.0
47645,4,7645,[301 200 515 121  98],145,4,28685,3.7516348417473186,0.0,20.0
47646,4,7646,[302 603 100 427  64],13,5,28690,3.7517980907545443,20.0,20.0
47647,4,7647,[143 289 276 187  64],881,4,28694,3.7518305439330546,0.0,0.0
47648,4,7648,[ 12 195 435 328 211],533,5,28699,3.7519937246698913,20.0,0.0
47649,4,7649,[302 603 100 427  64],370,5,28704,3.752156862745098,20.0,20.0
47650,4,7650,[ 28 180 427  79  70],788,4,28708,3.752189256306365,0.0,0.0
47651,4,7651,[322 289 182 748 302],197,1,28709,3.751829587036069,0.0,0.0
47652,4,7652,[302 603 100 427  64],458,5,28714,3.7519926826081273,20.0,20.0
47653,4,7653,[302 603 100 427  64],664,5,28719,3.7521557355631043,20.0,20.0
47654,4,7654,[302 603 100 427  64],666,5,28724,3.7523187459177008,20.0,20.0
47655,4,7655,[302 603 100 427  64],474,5,28729,3.7524817136886104,20.0,20.0
47656,4,7656,[678  96 289 194 245],454,1,28730,3.7521222410865875,0.0,0.0
47657,4,7657,[313 273 483 185 265],328,4,28734,3.7521546095586316,20.0,0.0
47658,4,7658,[427 508 323  89 435],537,3,28737,3.7520564042303173,0.0,0.0
47659,4,7659,[  7   1   8 204 423],881,5,28742,3.752219321148825,0.0,0.0
47660,4,7660,[191 202 173 181   1],882,5,28747,3.752382195535831,0.0,0.0
47661,4,7661,[200 546  15  82 323],648,3,28750,3.7522839989558863,0.0,0.0
47662,4,7662,[302 603 100 427  64],339,5,28755,3.7524468223933187,20.0,20.0
47663,4,7663,[  9 197 357 210 144],379,5,28760,3.7526096033402925,20.0,0.0
47664,4,7664,[302 603 100 427  64],13,5,28765,3.7527723418134378,20.0,20.0
47665,4,7665,[ 98  97 234 265 211],290,2,28767,3.752543699452126,0.0,20.0
47666,4,7666,[302 603 100 427  64],745,5,28772,3.7527064040693885,20.0,20.0
47667,4,7667,[302 603 100 427  64],454,5,28777,3.752869066249348,20.0,20.0
47668,4,7668,[302 603 100 427  64],474,5,28782,3.753031686008606,20.0,20.0
47669,4,7669,[ 56  89  28  50 187],328,5,28787,3.753194263363755,0.0,20.0
47670,4,7670,[228 197 568 357 194],533,4,28791,3.75322643723113,20.0,0.0
47671,4,7671,[ 22 269 282 175 568],207,3,28794,3.753128258602711,0.0,0.0
47672,4,7672,[ 69 238 597  98  11],7,3,28797,3.753030105564968,0.0,20.0
47673,4,7673,[302 603 100 427  64],370,5,28802,3.753192598384154,20.0,20.0
47674,4,7674,[302 603 100 427  64],90,5,28807,3.7533550488599348,20.0,20.0
47675,4,7675,[288 181 603 237 191],7,4,28811,3.7533871808233457,20.0,0.0
47676,4,7676,[302 603 100 427  64],664,5,28816,3.7535495636316267,20.0,20.0
47677,4,7677,[211 269 111 200  15],6,2,28818,3.753321177389945,0.0,0.0
47678,4,7678,[111 132  28  97 302],378,4,28822,3.7533533012110953,0.0,0.0
47679,4,7679,[125  97 144 135 161],455,3,28825,3.7532552083333335,0.0,0.0
47680,4,7680,[ 71 175 423 235 655],308,4,28829,3.7532873323785965,0.0,0.0
47681,4,7681,[196 161 294  95 179],881,2,28831,3.7530590991929187,0.0,0.0
47682,4,7682,[302 603 100 427  64],664,5,28836,3.7532213978914486,20.0,20.0
47683,4,7683,[318 174 172  50 257],298,5,28841,3.7533836543466945,20.0,40.0
47684,4,7684,[302 603 100 427  64],458,5,28846,3.7535458685751464,20.0,20.0
47685,4,7685,[175 191 151  56 300],749,3,28849,3.753447827218319,0.0,0.0
47686,4,7686,[302 603 100 427  64],370,5,28854,3.753609990893717,20.0,20.0
47687,4,7687,[286 127 121 168  25],82,3,28857,3.753511966701353,0.0,20.0
47688,4,7688,[153 180  71 211  70],6,4,28861,3.75354402393029,0.0,0.0
47689,4,7689,[302 603 100 427  64],370,5,28866,3.75370611183355,20.0,20.0
47690,4,7690,[195 588 237 204 143],308,4,28870,3.753738135483032,0.0,0.0
47691,4,7691,[202  25 385 483 196],90,4,28874,3.7537701508060324,20.0,0.0
47692,4,7692,[318 423 210  97 546],533,3,28877,3.7536721695047444,20.0,0.0
47693,4,7693,[100 132 258 161 118],650,3,28880,3.753574213672992,0.0,20.0
47694,4,7694,[ 22 191 196 121 143],334,3,28883,3.7534762833008446,0.0,0.0
47695,4,7695,[228  98 143 168  79],374,3,28886,3.7533783783783785,0.0,20.0
47696,4,7696,[302 603 100 427  64],745,5,28891,3.7535403403923606,20.0,20.0
47697,4,7697,[222  11 271 135 215],749,4,28895,3.7535723564562224,0.0,0.0
47698,4,7698,[302 603 100 427  64],474,5,28900,3.753734251201455,20.0,20.0
47699,4,7699,[ 25  15 276 286 111],474,5,28905,3.753896103896104,0.0,0.0
47700,4,7700,[323 234 748 276 211],474,3,28908,3.7537982080249317,0.0,0.0
47701,4,7701,[427  64 200 403 568],788,2,28910,3.753570501168528,0.0,0.0
47702,4,7702,[176 235 215 275 313],537,2,28912,3.753342853433727,0.0,0.0
47703,4,7703,[195 144  11 515  22],339,3,28915,3.753245067497404,0.0,0.0
47704,4,7704,[302 603 100 427  64],454,5,28920,3.7534068786502273,20.0,20.0
47705,4,7705,[  4 200 546  50 211],271,4,28924,3.753438878795744,0.0,20.0
47706,4,7706,[ 56 568 423 202  96],538,4,28928,3.753470870637083,0.0,0.0
47707,4,7707,[ 56 100  50  70 302],13,4,28932,3.7535028541774778,0.0,40.0
47708,4,7708,[515 237 748 273 302],346,4,28936,3.753534829420158,0.0,0.0
47709,4,7709,[ 50 191 173 202  15],194,3,28939,3.753437094682231,0.0,20.0
47710,4,7710,[302 603 100 427  64],458,5,28944,3.7535987550252887,20.0,20.0
47711,4,7711,[546 588 216 173 179],64,4,28948,3.753630705394191,0.0,0.0
47712,4,7712,[273 194 181 185  82],749,5,28953,3.7537922987164527,0.0,0.0
47713,4,7713,[117  25 289 187 265],474,4,28957,3.7538242157116932,0.0,0.0
47714,4,7714,[234 172  89 289 143],406,3,28960,3.7537265068049255,0.0,0.0
47715,4,7715,[302 603 100 427  64],664,5,28965,3.7538880248833593,20.0,20.0
47716,4,7716,[168 435 210 288 222],666,2,28967,3.7536607489957237,0.0,0.0
47717,4,7717,[174 194 403 515 135],234,3,28970,3.75356309924851,0.0,20.0
47718,4,7718,[ 28  71 265  88 515],892,4,28974,3.7535950252623396,0.0,0.0
47719,4,7719,[302 603 100 427  64],454,5,28979,3.7537564766839377,20.0,20.0
47720,4,7720,[302 603 100 427  64],458,5,28984,3.7539178862841602,20.0,20.0
47721,4,7721,[153 174 168  95 271],749,4,28988,3.753949753949754,0.0,20.0
47722,4,7722,[204   7 286 194 168],60,5,28993,3.754111096724071,0.0,0.0
47723,4,7723,[  4 483 132   7  82],234,3,28996,3.7540134645261523,20.0,0.0
47724,4,7724,[ 70 471  64 403 118],311,4,29000,3.7540453074433655,0.0,0.0
47725,4,7725,[ 96   9   7 216 546],378,4,29004,3.7540771421175254,0.0,0.0
47726,4,7726,[427  98 228 405 210],13,3,29007,3.7539795522194903,0.0,20.0
47727,4,7727,[191 323 357 176 121],804,5,29012,3.7541407867494825,20.0,0.0
47728,4,7728,[302 603 100 427  64],339,5,29017,3.7543019795575105,20.0,20.0
47729,4,7729,[215 423 191 100  50],387,3,29020,3.7542043984476066,0.0,40.0
47730,4,7730,[302 603 100 427  64],745,5,29025,3.7543655413271244,20.0,20.0
47731,4,7731,[318 568 237 175  88],92,2,29027,3.7541386445938953,20.0,0.0
47732,4,7732,[302 603 100 427  64],666,5,29032,3.7542997542997543,20.0,20.0
47733,4,7733,[127 194 568 100 204],313,5,29037,3.7544608223429017,0.0,40.0
47734,4,7734,[318  50 237 427 588],326,3,29040,3.7543632837750485,20.0,20.0
47735,4,7735,[302 603 100 427  64],454,5,29045,3.7545243019648398,20.0,20.0
47736,4,7736,[302 603 100 427  64],370,5,29050,3.754685278531731,20.0,20.0
47737,4,7737,[  1   4 271 405 111],64,2,29052,3.7544585164125097,0.0,0.0
47738,4,7738,[302 603 100 427  64],454,5,29057,3.7546194598785374,20.0,20.0
47739,4,7739,[302 603 100 427  64],454,5,29062,3.754780361757106,20.0,20.0
47740,4,7740,[185 234 288 181 176],102,0,29062,3.754295310683374,0.0,0.0
47741,4,7741,[302 603 100 427  64],454,5,29067,3.7544562128648926,20.0,20.0
47742,4,7742,[ 71 318 176 174   8],479,4,29071,3.7544879245770373,20.0,20.0
47743,4,7743,[302 603 100 427  64],90,5,29076,3.7546487603305785,20.0,20.0
47744,4,7744,[302 603 100 427  64],271,5,29081,3.7548095545513234,20.0,20.0
47745,4,7745,[678 195 204 176 216],881,4,29085,3.754841208365608,0.0,0.0
47746,4,7746,[655 172  97  70 186],804,5,29090,3.7550019362333806,0.0,0.0
47747,4,7747,[302 603 100 427  64],454,5,29095,3.755162622612287,20.0,20.0
47748,4,7748,[603  98 117 271   7],548,4,29099,3.7551942186088527,20.0,20.0
47749,4,7749,[265 357 121 172 427],271,4,29103,3.755225806451613,20.0,0.0
47750,4,7750,[235   4 204 328  97],537,0,29103,3.7547413237001677,0.0,0.0
47751,4,7751,[496 187 202  12 294],6,3,29106,3.7546439628482973,20.0,0.0
47752,4,7752,[ 64 333 121 258 300],145,2,29108,3.7544176447826647,0.0,0.0
47753,4,7753,[216 471  70 288 121],374,5,29113,3.754578282176941,0.0,0.0
47754,4,7754,[ 79 186 143 210 181],85,2,29115,3.754352030947776,0.0,0.0
47755,4,7755,[  4 196  56  22 286],664,4,29119,3.7543837029396596,0.0,0.0
47756,4,7756,[ 28  88 100 191  64],881,4,29123,3.7544153667655022,0.0,20.0
47757,4,7757,[302 603 100 427  64],537,4,29127,3.7544470224284607,20.0,20.0
47758,4,7758,[204 175 568 180 181],339,3,29130,3.7543497873437297,0.0,0.0
47759,4,7759,[191 294 144  22 173],648,4,29134,3.754381443298969,0.0,0.0
47760,4,7760,[235 144   1 200  15],378,4,29138,3.754413091096508,0.0,0.0
47761,4,7761,[286  71  97 427 271],13,3,29141,3.754315897964442,0.0,0.0
47762,4,7762,[275 300 258   1  98],465,4,29145,3.754347546051784,0.0,20.0
47763,4,7763,[ 28  50 435 265   1],313,4,29149,3.754379185986605,0.0,20.0
47764,4,7764,[121 258 275  64  71],454,3,29152,3.75428203477141,0.0,0.0
47765,4,7765,[ 96  64 151 228 748],883,5,29157,3.75444244141128,0.0,0.0
47766,4,7766,[132 258 191 168 222],334,4,29161,3.754474056907429,0.0,0.0
47767,4,7767,[179 194 385 143 210],379,4,29165,3.754505664263646,0.0,0.0
47768,4,7768,[302 603 100 427  64],664,5,29170,3.754665980177629,20.0,20.0
47769,4,7769,[210 118 196   8 215],7,4,29174,3.7546975546975547,0.0,0.0
47770,4,7770,[597 496 276  71  96],378,3,29177,3.754600437524128,0.0,0.0
47771,4,7771,[135  28 235 603 197],64,3,29180,3.754503345342254,20.0,0.0
47772,4,7772,[302 603 100 427  64],454,5,29185,3.7546635790557055,20.0,20.0
47773,4,7773,[181 187 588 197  28],85,4,29189,3.7546951376382816,0.0,0.0
47774,4,7774,[237 175 313 289   8],85,3,29192,3.75459807073955,0.0,0.0
47775,4,7775,[ 97  28   9  96 515],64,4,29196,3.7546296296296298,0.0,0.0
47776,4,7776,[515 323 328  50 288],197,3,29199,3.7545325961167544,0.0,20.0
47777,4,7777,[200  22 318 655 234],313,3,29202,3.7544355875546414,20.0,0.0
47778,4,7778,[172 403 197  56 742],308,4,29206,3.754467155161332,0.0,0.0
47779,4,7779,[204 237 111 294 200],95,2,29208,3.7542416452442158,0.0,0.0
47780,4,7780,[496 186  69  71 238],85,3,29211,3.754144711476674,0.0,0.0
47781,4,7781,[357  89 135 174 222],387,5,29216,3.7543048059624775,20.0,20.0
47782,4,7782,[435   7  98 173 186],843,1,29217,3.7539509186688935,0.0,20.0
47783,4,7783,[  7 313 172 678 265],537,2,29219,3.7537255909558067,0.0,0.0
47784,4,7784,[200 257 268  88  11],92,2,29221,3.753500321130379,0.0,0.0
47785,4,7785,[302 603 100 427  64],370,5,29226,3.753660416131518,20.0,20.0
47786,4,7786,[294 216 132 100 288],488,1,29227,3.7533067933735715,0.0,20.0
47787,4,7787,[568 197 328  64 237],378,3,29230,3.753210066769389,0.0,0.0
47788,4,7788,[302 603 100 427  64],664,5,29235,3.7533701373732185,20.0,20.0
47789,4,7789,[302 603 100 427  64],370,5,29240,3.753530166880616,20.0,20.0
47790,4,7790,[302 603 100 427  64],537,4,29244,3.7535618020793224,20.0,20.0
47791,4,7791,[ 69  79 228 496 118],524,3,29247,3.753465092402464,0.0,0.0
47792,4,7792,[302 603 100 427  64],537,4,29251,3.7534967278326703,20.0,20.0
47793,4,7793,[ 95 228 127  70 121],102,2,29253,3.7532717474980752,0.0,20.0
47794,4,7794,[271 174 202  96  89],64,3,29256,3.7531751122514434,0.0,20.0
47795,4,7795,[168  89 357   9 153],7,5,29261,3.753335043612109,20.0,0.0
47796,4,7796,[269 546 173 211  98],64,4,29265,3.7533666794921126,0.0,20.0
47797,4,7797,[508 181  71 197 204],455,4,29269,3.7533983072582715,0.0,0.0
47798,4,7798,[302 603 100 427  64],745,5,29274,3.7535581484805745,20.0,20.0
47799,4,7799,[302 603 100 427  64],458,5,29279,3.7537179487179486,20.0,20.0
47800,4,7800,[294  50  88 313 273],308,2,29281,3.753493141904884,0.0,20.0
47801,4,7801,[153 200 288 182  12],234,1,29282,3.7531402204562934,20.0,0.0
47802,4,7802,[302 603 100 427  64],664,5,29287,3.7533000128155836,20.0,20.0
47803,4,7803,[302 603 100 427  64],370,5,29292,3.753459764223475,20.0,20.0
47804,4,7804,[144  98 181 202  82],125,5,29297,3.7536194746957077,0.0,20.0
47805,4,7805,[216 100  89 180  25],87,5,29302,3.753779144248014,0.0,20.0
47806,4,7806,[182 191 100 288 423],59,5,29307,3.753938772896119,0.0,20.0
47807,4,7807,[187 483 245 202 173],804,5,29312,3.7540983606557377,20.0,0.0
47808,4,7808,[508 191 100 568 117],378,4,29316,3.7541298501728773,0.0,20.0
47809,4,7809,[302 603 100 427  64],454,5,29321,3.754289372599232,20.0,20.0
47810,4,7810,[302 603 100 427  64],458,5,29326,3.7544488541800027,20.0,20.0
47811,4,7811,[ 79 268 483 196 172],85,4,29330,3.7544802867383513,20.0,0.0
47812,4,7812,[100 403  88 435 118],13,4,29334,3.7545117112504798,0.0,20.0
47813,4,7813,[194 234 323 135 273],90,3,29337,3.7544151522907603,0.0,0.0
47814,4,7814,[357  25 228 179 322],234,1,29338,3.7540626999360205,20.0,0.0
47815,4,7815,[302 603 100 427  64],474,5,29343,3.754222108495394,20.0,20.0
47816,4,7816,[ 12 181 235   8 127],406,5,29348,3.7543814762696686,20.0,20.0
47817,4,7817,[403 173 435 161 143],749,4,29352,3.7544128933231007,0.0,0.0
47818,4,7818,[175 257 202  98 100],6,3,29355,3.754316408747922,0.0,40.0
47819,4,7819,[100 435  88 273 127],308,4,29359,3.7543478260869567,0.0,40.0
47820,4,7820,[302 603 100 427  64],666,5,29364,3.7545070962792484,20.0,20.0
47821,4,7821,[ 82 186  88  97 153],650,2,29366,3.7542827921247763,0.0,0.0
47822,4,7822,[228 153   9 302 471],13,3,29369,3.7541863735139973,0.0,0.0
47823,4,7823,[ 97 144 323 471   9],378,3,29372,3.7540899795501024,0.0,0.0
47824,4,7824,[ 12 405 202 508 121],343,4,29376,3.754121405750799,20.0,0.0
47825,4,7825,[186  98 132 215 100],161,3,29379,3.7540250447227193,0.0,40.0
47826,4,7826,[286 318 258 385 655],788,3,29382,3.753928708317363,20.0,0.0
47827,4,7827,[568  88 423  70 603],543,3,29385,3.753832396525294,20.0,0.0
47828,4,7828,[204 176 135 211 182],479,5,29390,3.753991569804573,0.0,0.0
47829,4,7829,[174 286 238 176   1],339,5,29395,3.7541507024265646,0.0,20.0
47830,4,7830,[196 172   8 174 215],533,4,29399,3.75418209679479,0.0,20.0
47831,4,7831,[276 172 568 185 211],42,4,29403,3.7542134831460676,0.0,0.0
47832,4,7832,[302 603 100 427  64],271,5,29408,3.754372526490489,20.0,20.0
47833,4,7833,[ 96 168  56 187 135],650,3,29411,3.7542762318100587,0.0,0.0
47834,4,7834,[271  22   9 300 301],334,2,29413,3.75405232929164,0.0,0.0
47835,4,7835,[196 183 132 168 475],334,4,29417,3.7540837161817255,0.0,0.0
47836,4,7836,[302 603 100 427  64],458,5,29422,3.754242694908766,20.0,20.0
47837,4,7837,[ 82 127 357  56   8],398,4,29426,3.754274049502424,20.0,20.0
47838,4,7838,[302 603 100 427  64],13,5,29431,3.7544329633881874,20.0,20.0
47839,4,7839,[597  11 603 435 191],308,4,29435,3.7544642857142856,20.0,0.0
47840,4,7840,[ 98 186 568 655 245],313,3,29438,3.7543680652977938,0.0,20.0
47841,4,7841,[568  28 403 258 176],774,1,29439,3.754016832440704,0.0,0.0
47842,4,7842,[282 216 237  96 127],328,3,29442,3.7539206936121383,0.0,20.0
47843,4,7843,[ 28 118 258  89 180],774,1,29443,3.7535696073431923,0.0,0.0
47844,4,7844,[302 603 100 427  64],537,4,29447,3.7536010197578076,20.0,20.0
47845,4,7845,[603 204 100 228 211],533,5,29452,3.7537598776446597,20.0,20.0
47846,4,7846,[ 70 357 204 328 210],85,3,29455,3.75366382056837,20.0,0.0
47847,4,7847,[ 88 176 603  97  50],897,5,29460,3.753822629969419,20.0,20.0
47848,4,7848,[200 322 183   7 202],234,2,29462,3.7535991846095045,0.0,0.0
47849,4,7849,[135 323 273 210 286],883,4,29466,3.7536305732484077,0.0,0.0
47850,4,7850,[318 603  12  50 568],308,5,29471,3.7537893262004842,60.0,20.0
47851,4,7851,[302 603 100 427  64],13,5,29476,3.7539480387162505,20.0,20.0
47852,4,7852,[257 186 153 258 288],650,2,29478,3.753724691200815,0.0,0.0
47853,4,7853,[302 603 100 427  64],339,5,29483,3.7538833715304305,20.0,20.0
47854,4,7854,[333 234 173 269 216],488,3,29486,3.753787396562699,0.0,0.0
47855,4,7855,[655  11 153  50 294],10,4,29490,3.753818737270876,0.0,20.0
47856,4,7856,[300  22 403 182 508],533,3,29493,3.7537227949599083,0.0,0.0
47857,4,7857,[172 238  96 168 568],158,5,29498,3.7538813947569354,0.0,0.0
47858,4,7858,[294  95 237 127 173],537,2,29500,3.7536582262374347,0.0,20.0
47859,4,7859,[121 471 515 742   9],26,2,29502,3.7534351145038167,0.0,0.0
47860,4,7860,[ 50 121  97 175  98],843,1,29503,3.7530848492558198,0.0,40.0
47861,4,7861,[286 288  69 186 168],452,3,29506,3.7529890613075554,0.0,0.0
47862,4,7862,[175  11 273 195   8],378,3,29509,3.752893297723515,0.0,0.0
47863,4,7863,[ 11   8 216 180 202],13,3,29512,3.7527975584944047,0.0,0.0
47864,4,7864,[301 313 322 258 427],537,3,29515,3.7527018436109345,0.0,0.0
47865,4,7865,[269 286 211  79  98],343,5,29520,3.7528604118993134,0.0,20.0
47866,4,7866,[302 603 100 427  64],474,5,29525,3.753018939875429,20.0,20.0
47867,4,7867,[282 153 144 546 568],643,3,29528,3.7529232333502796,0.0,0.0
47868,4,7868,[302 603 100 427  64],537,4,29532,3.752954632100648,20.0,20.0
47869,4,7869,[176 197 603 403 405],313,3,29535,3.752858958068615,20.0,0.0
47870,4,7870,[238  12   4 546 196],234,1,29536,3.7525092110278235,20.0,0.0
47871,4,7871,[302 603 100 427  64],474,5,29541,3.752667682926829,20.0,20.0
47872,4,7872,[302 603 100 427  64],339,5,29546,3.7528261145687796,20.0,20.0
47873,4,7873,[302 603 100 427  64],370,5,29551,3.752984505969012,20.0,20.0
47874,4,7874,[234 403 435 118 172],308,3,29554,3.7528888888888887,0.0,0.0
47875,4,7875,[144 245  11 323  97],488,1,29555,3.7525393600812595,0.0,0.0
47876,4,7876,[197 174 100 132 234],398,4,29559,3.752570775676019,0.0,40.0
47877,4,7877,[258   1 515 100 257],343,4,29563,3.7526021832952527,0.0,20.0
47878,4,7878,[210   1 175 181 125],892,5,29568,3.752760502601853,0.0,0.0
47879,4,7879,[168  88 546 180 275],901,3,29571,3.7526649746192895,0.0,0.0
47880,4,7880,[216 427 202 176 294],308,3,29574,3.75256947087933,0.0,0.0
47881,4,7881,[ 22 385 179 546 180],653,4,29578,3.7526008627251968,0.0,0.0
47882,4,7882,[ 97  25 245 186 322],83,2,29580,3.752378536090321,0.0,0.0
47883,4,7883,[186  82 742 286 288],59,3,29583,3.752283105022831,0.0,0.0
47884,4,7884,[222 202 403 153  69],295,5,29588,3.752441344324667,0.0,0.0
47885,4,7885,[161 546 181  96  88],313,4,29592,3.7524727364950543,0.0,0.0
47886,4,7886,[215 181  28 127 197],13,5,29597,3.7526309116267274,0.0,20.0
47887,4,7887,[ 56  25  12 603 273],145,4,29601,3.752662271805274,40.0,0.0
47888,4,7888,[161  71  12  70  96],64,3,29604,3.752566865255419,20.0,0.0
47889,4,7889,[173 318  71 215 143],815,5,29609,3.752724968314322,20.0,0.0
47890,4,7890,[302 603 100 427  64],339,5,29614,3.7528830313014825,20.0,20.0
47891,4,7891,[238 111  70 202 153],95,5,29619,3.753041054232134,0.0,0.0
47892,4,7892,[678 357 405 288 228],648,3,29622,3.7529456480425694,20.0,0.0
47893,4,7893,[168 742  69   9   7],59,4,29626,3.7529769445148213,0.0,0.0
47894,4,7894,[302 603 100 427  64],474,5,29631,3.753134895503483,20.0,20.0
47895,4,7895,[302 603 100 427  64],745,5,29636,3.753292806484296,20.0,20.0
47896,4,7896,[182 174  82  98   1],95,3,29639,3.753197416740534,0.0,40.0
47897,4,7897,[179  98 302  25  22],343,4,29643,3.753228665484933,0.0,20.0
47898,4,7898,[302 603 100 427  64],745,5,29648,3.753386504620838,20.0,20.0
47899,4,7899,[302 603 100 427  64],339,5,29653,3.7535443037974683,20.0,20.0
47900,4,7900,[403 265  96 275 588],378,5,29658,3.753702063029996,0.0,0.0
47901,4,7901,[515 471  95  98 322],537,1,29659,3.7533535813718046,0.0,20.0
47902,4,7902,[ 11 515 313 273 322],308,1,29660,3.753005187903328,0.0,0.0
47903,4,7903,[405 357  79  56 183],194,2,29662,3.7527834008097165,20.0,0.0
47904,4,7904,[273 151 132 168 153],666,3,29665,3.752688172043011,0.0,0.0
47905,4,7905,[153  79 204 222 180],648,4,29669,3.75271945357956,0.0,0.0
47906,4,7906,[ 69   7  56 245  70],804,4,29673,3.7527507272037437,0.0,0.0
47907,4,7907,[302 603 100 427  64],90,5,29678,3.7529084471421346,20.0,20.0
47908,4,7908,[302 603 100 427  64],745,5,29683,3.753066127196864,20.0,20.0
47909,4,7909,[ 79  11 196 175 282],666,2,29685,3.7528445006321114,0.0,0.0
47910,4,7910,[  1 194 183 508 471],13,2,29687,3.7526229300973326,0.0,0.0
47911,4,7911,[ 28  89 135 210 194],882,4,29691,3.752654196157735,0.0,0.0
47912,4,7912,[302 603 100 427  64],454,5,29696,3.752811828636421,20.0,20.0
47913,4,7913,[282   9 182 275 181],334,4,29700,3.7528430629264595,0.0,0.0
47914,4,7914,[265 286 175  89 100],653,4,29704,3.752874289324068,0.0,20.0
47915,4,7915,[302 603 100 427  64],339,5,29709,3.753031834259727,20.0,20.0
47916,4,7916,[100   8 318 435 175],385,3,29712,3.75293671845396,20.0,20.0
47917,4,7917,[302 603 100 427  64],666,5,29717,3.7530942157110383,20.0,20.0
47918,4,7918,[191 173 210 385 127],892,4,29721,3.753125394620533,0.0,20.0
47919,4,7919,[276 289  56 151   7],406,3,29724,3.753030303030303,0.0,0.0
47920,4,7920,[302 603 100 427  64],474,5,29729,3.7531877288221183,20.0,20.0
47921,4,7921,[215  96   9 515 265],200,5,29734,3.7533451148699823,0.0,0.0
47922,4,7922,[302 603 100 427  64],271,5,29739,3.7535024611889436,20.0,20.0
47923,4,7923,[197 258 483 100 475],479,3,29742,3.753407370015144,20.0,20.0
47924,4,7924,[302 603 100 427  64],13,5,29747,3.753564668769716,20.0,20.0
47925,4,7925,[302 603 100 427  64],454,5,29752,3.75372192783245,20.0,20.0
47926,4,7926,[179  70 153  56  88],659,3,29755,3.7536268449602623,0.0,0.0
47927,4,7927,[118 151  98 186  25],374,4,29759,3.753657921291625,0.0,20.0
47928,4,7928,[302 603 100 427  64],458,5,29764,3.7538151090932024,20.0,20.0
47929,4,7929,[302 603 100 427  64],271,5,29769,3.753972257250946,20.0,20.0
47930,4,7930,[275 265 289 427  28],271,5,29774,3.754129365779851,0.0,0.0
47931,4,7931,[302 603 100 427  64],339,5,29779,3.7542864346949067,20.0,20.0
47932,4,7932,[323 742 196  25 301],650,1,29780,3.753939241144586,0.0,0.0
47933,4,7933,[135 318  22  79 172],378,4,29784,3.753970254600454,20.0,0.0
47934,4,7934,[302 603 100 427  64],339,5,29789,3.754127284183995,20.0,20.0
47935,4,7935,[ 70 313 185 132  98],184,5,29794,3.7542842741935485,0.0,20.0
47936,4,7936,[302 603 100 427  64],666,5,29799,3.754441224644072,20.0,20.0
47937,4,7937,[302 603 100 427  64],664,5,29804,3.7545981355505167,20.0,20.0
47938,4,7938,[435 423 275 121 132],85,3,29807,3.7545030860309865,0.0,0.0
47939,4,7939,[200  64 302 144  79],833,2,29809,3.754282115869018,0.0,0.0
47940,4,7940,[  9 118 276 215 111],533,4,29813,3.754313058808714,0.0,0.0
47941,4,7941,[183 179  96  70  89],653,3,29816,3.7542180810878873,0.0,0.0
47942,4,7942,[  7 191 204 603  89],840,5,29821,3.7543749213143647,20.0,0.0
47943,4,7943,[288 215 118 546 323],650,1,29822,3.754028197381672,0.0,0.0
47944,4,7944,[210  50 180 603 100],738,4,29826,3.7540591567023287,20.0,40.0
47945,4,7945,[483   1  15 245 294],200,4,29830,3.754090108230556,20.0,0.0
47946,4,7946,[186 302   4 508 603],543,4,29834,3.7541210519692965,20.0,0.0
47947,4,7947,[471 282 405  97 276],374,5,29839,3.7542778057372925,0.0,0.0
47948,4,7948,[100 655 179  70  88],537,3,29842,3.754182916090074,0.0,20.0
47949,4,7949,[197 132 168 117  69],778,2,29844,3.7539622641509434,0.0,0.0
47950,4,7950,[179 185 678 286 322],881,3,29847,3.753867438058106,0.0,0.0
47951,4,7951,[143 197  69 748 423],804,3,29850,3.7537726358148893,0.0,0.0
47952,4,7952,[275 215 286  28  79],537,1,29851,3.7534263799823964,0.0,0.0
47953,4,7953,[183  56  71 127 301],6,4,29855,3.7534573799346242,0.0,20.0
47954,4,7954,[302 603 100 427  64],474,5,29860,3.7536140791954744,20.0,20.0
47955,4,7955,[302 603 100 427  64],664,5,29865,3.7537707390648567,20.0,20.0
47956,4,7956,[302 603 100 427  64],458,5,29870,3.7539273595576224,20.0,20.0
47957,4,7957,[ 82 228 117 286 210],387,3,29873,3.7538326212616235,0.0,0.0
47958,4,7958,[202 568  28 187 168],648,4,29877,3.7538635506973237,0.0,0.0
47959,4,7959,[168 234 135 300 496],506,4,29881,3.753894472361809,0.0,0.0
47960,4,7960,[194 215 235  89 210],804,5,29886,3.754050998618264,0.0,0.0
47961,4,7961,[ 71 175  12 301 173],279,3,29889,3.753956292388847,20.0,0.0
47962,4,7962,[237 143 273  25 180],59,2,29891,3.7537360291347484,0.0,0.0
47963,4,7963,[302 603 100 427  64],339,5,29896,3.7538925163234556,20.0,20.0
47964,4,7964,[234 204 385 215 237],60,5,29901,3.754048964218456,0.0,0.0
47965,4,7965,[ 50 655  70 286 211],59,3,29904,3.7539543057996485,0.0,20.0
47966,4,7966,[151 603 202 423 181],42,5,29909,3.754110706664993,20.0,0.0
47967,4,7967,[302 603 100 427  64],13,5,29914,3.7542670682730925,20.0,20.0
47968,4,7968,[302 603 100 427  64],13,5,29919,3.754423390638725,20.0,20.0
47969,4,7969,[175 588 275  64 742],184,3,29922,3.7543287327478043,0.0,0.0
47970,4,7970,[ 64 180 742 181 151],346,5,29927,3.7544850081545604,0.0,0.0
47971,4,7971,[175 282 427  89  11],334,5,29932,3.7546412443552435,0.0,0.0
47972,4,7972,[ 69 144   7 173 357],406,3,29935,3.754546594757306,20.0,0.0
47973,4,7973,[215  82 144 180 597],13,3,29938,3.7544519688989215,0.0,0.0
47974,4,7974,[302 603 100 427  64],13,5,29943,3.7546081504702196,20.0,20.0
47975,4,7975,[423   8   7 597 301],455,3,29946,3.7545135406218657,0.0,0.0
47976,4,7976,[302 603 100 427  64],666,5,29951,3.754669675316535,20.0,20.0
47977,4,7977,[483 197  82 294 588],452,2,29953,3.7544497367761345,20.0,0.0
47978,4,7978,[302 603 100 427  64],664,5,29958,3.7546058403308686,20.0,20.0
47979,4,7979,[302 603 100 427  64],745,5,29963,3.7547619047619047,20.0,20.0
47980,4,7980,[182 515 197 405 100],213,4,29967,3.7547926325021925,0.0,20.0
47981,4,7981,[  9 153 302 496 118],343,4,29971,3.754823352543222,0.0,0.0
47982,4,7982,[302 603 100 427  64],90,5,29976,3.754979331078542,20.0,20.0
47983,4,7983,[302 603 100 427  64],666,5,29981,3.755135270541082,20.0,20.0
47984,4,7984,[496 228 125 121  97],290,3,29984,3.7550407013149654,0.0,0.0
47985,4,7985,[ 82 302 100 181 143],537,2,29986,3.7548209366391183,0.0,20.0
47986,4,7986,[302 603 100 427  64],339,5,29991,3.754976837360711,20.0,20.0
47987,4,7987,[258 323 173 313  69],455,4,29995,3.7550075112669004,0.0,0.0
47988,4,7988,[ 88 483 273 357 423],643,3,29998,3.754913005382401,40.0,0.0
47989,4,7989,[153 196 603 172 568],7,5,30003,3.7550688360450564,20.0,0.0
47990,4,7990,[300  79 271 111   1],537,0,30003,3.754598923789263,0.0,0.0
47991,4,7991,[ 56 194  28 168 288],343,4,30007,3.7546296296296298,0.0,0.0
47992,4,7992,[302 603 100 427  64],271,5,30012,3.7547854372576004,20.0,20.0
47993,4,7993,[302 603 100 427  64],666,5,30017,3.7549412059044283,20.0,20.0
47994,4,7994,[191 265 328 153 111],95,4,30021,3.7549718574108817,0.0,0.0
47995,4,7995,[132 215 471 275 176],537,1,30022,3.7546273136568282,0.0,0.0
47996,4,7996,[ 22 313 215 100 294],533,5,30027,3.7547830436413654,0.0,20.0
47997,4,7997,[121 508  89 235  50],339,3,30030,3.754688672168042,0.0,20.0
47998,4,7998,[ 15 313 748 174  12],474,4,30034,3.75471933991749,20.0,20.0
47999,4,7999,[168  82 143 197 435],325,1,30035,3.754375,0.0,0.0
48000,4,8000,[215 174 222 271 151],479,3,30038,3.754280714910636,0.0,20.0
48001,4,8001,[ 22 515 215 216 172],804,5,30043,3.754436390902274,0.0,0.0
48002,4,8002,[180 385  95  79  69],92,4,30047,3.754467074846932,0.0,0.0
48003,4,8003,[ 11 655 168  64 435],749,5,30052,3.754622688655672,0.0,0.0
48004,4,8004,[117 333 258  95  12],537,1,30053,3.7542785758900687,20.0,0.0
48005,4,8005,[153 423   1 655 100],795,2,30055,3.7540594554084437,0.0,20.0
48006,4,8006,[235 269 300 181 276],669,2,30057,3.7538403896590484,0.0,0.0
48007,4,8007,[302 603 100 427  64],537,4,30061,3.753871128871129,20.0,20.0
48008,4,8008,[ 79  98 187 185  70],194,3,30064,3.753777000874017,0.0,20.0
48009,4,8009,[302 603 100 427  64],537,4,30068,3.753807740324594,20.0,20.0
48010,4,8010,[144 271 187 172 234],13,4,30072,3.7538384721008615,0.0,0.0
48011,4,8011,[302 603 100 427  64],458,5,30077,3.75399400898652,20.0,20.0
48012,4,8012,[302 603 100 427  64],271,5,30082,3.754149507051042,20.0,20.0
48013,4,8013,[603 135 200 546 568],749,4,30086,3.7541801846768155,20.0,0.0
48014,4,8014,[302 603 100 427  64],745,5,30091,3.7543356207111667,20.0,20.0
48015,4,8015,[483 471  79 196  12],207,3,30094,3.7542415169660677,40.0,0.0
48016,4,8016,[194 405 257  82 322],749,3,30097,3.7541474366970187,0.0,0.0
48017,4,8017,[265 173 318 546  25],271,3,30100,3.7540533798952356,20.0,0.0
48018,4,8018,[ 64  28  89 435 655],13,5,30105,3.7542087542087543,0.0,0.0
48019,4,8019,[423   1 132 127 186],804,3,30108,3.7541147132169574,0.0,20.0
48020,4,8020,[  4  50 748 245 405],653,3,30111,3.754020695673856,0.0,20.0
48021,4,8021,[ 50  70 191 153 282],804,5,30116,3.7541760159561206,0.0,20.0
48022,4,8022,[197 117 121 471 118],378,2,30118,3.7539573725539075,0.0,0.0
48023,4,8023,[ 71 238 286 143 161],648,1,30119,3.7536141575274176,0.0,0.0
48024,4,8024,[508 423  98  71 181],92,4,30123,3.7536448598130843,0.0,20.0
48025,4,8025,[ 88 286 194 191  12],533,5,30128,3.7538001495140794,20.0,0.0
48026,4,8026,[275 265 185  28 204],474,4,30132,3.753830820979195,0.0,0.0
48027,4,8027,[318  69 313   7   8],234,4,30136,3.753861484803189,20.0,0.0
48028,4,8028,[302 603 100 427  64],537,4,30140,3.753892140988915,20.0,20.0
48029,4,8029,[302 508 235 258 222],334,3,30143,3.7537982565379826,0.0,0.0
48030,4,8030,[ 95   4 333 182 194],881,2,30145,3.753579877972855,0.0,0.0
48031,4,8031,[302 603 100 427  64],454,5,30150,3.753735059760956,20.0,20.0
48032,4,8032,[194 127 100  71 603],313,5,30155,3.753890202912984,20.0,40.0
48033,4,8033,[318  15 153  89 258],234,1,30156,3.753547423450336,20.0,0.0
48034,4,8034,[302 603 100 427  64],664,5,30161,3.7537025513378968,20.0,20.0
48035,4,8035,[742 127  64 286 475],387,1,30162,3.7533598805375807,0.0,20.0
48036,4,8036,[ 15 176 135 300 151],749,5,30167,3.7535149931566503,0.0,0.0
48037,4,8037,[215  96  82  71 174],60,3,30170,3.753421249066932,0.0,20.0
48038,4,8038,[222  88 742  50 273],145,5,30175,3.753576315462122,0.0,20.0
48039,4,8039,[135 111 174 288 235],13,3,30178,3.7534825870646764,0.0,20.0
48040,4,8040,[125   7 117 403 179],378,2,30180,3.7532645193383907,0.0,0.0
48041,4,8041,[ 82 238  64 323 318],13,1,30181,3.752922158666998,20.0,0.0
48042,4,8042,[ 82 181 228 515 748],804,5,30186,3.75307720999627,0.0,0.0
48043,4,8043,[588 191  96 318 234],313,5,30191,3.753232222774739,20.0,0.0
48044,4,8044,[161  11  28  22   8],92,2,30193,3.753014294592915,0.0,0.0
48045,4,8045,[127  11 302 257 180],392,5,30198,3.7531692766592095,0.0,20.0
48046,4,8046,[174  56 187 496 127],64,5,30203,3.753324220206288,0.0,40.0
48047,4,8047,[181   8 471  70 238],271,4,30207,3.753354870775348,0.0,0.0
48048,4,8048,[ 64  15 173 294 100],207,2,30209,3.753137035656603,0.0,20.0
48049,4,8049,[ 12 265   1 257 191],279,2,30211,3.752919254658385,20.0,0.0
48050,4,8050,[161 228  15  69 508],92,3,30214,3.7528257359334245,0.0,0.0
48051,4,8051,[  7 186 187 195  98],339,4,30218,3.752856433184302,0.0,20.0
48052,4,8052,[258  97 678 174 176],145,4,30222,3.7528871228113747,0.0,20.0
48053,4,8053,[302 603 100 427  64],339,5,30227,3.753041966724609,20.0,20.0
48054,4,8054,[186 234  96 182 427],398,5,30232,3.7531967721911856,0.0,0.0
48055,4,8055,[204 186 211 318 238],804,5,30237,3.753351539225422,20.0,0.0
48056,4,8056,[204  70  69 403  11],804,4,30241,3.7533821521658184,0.0,0.0
48057,4,8057,[302 603 100 427  64],666,5,30246,3.753536857781087,20.0,20.0
48058,4,8058,[302 603 100 427  64],458,5,30251,3.753691525003102,20.0,20.0
48059,4,8059,[175 117 238  25 423],92,3,30254,3.7535980148883374,0.0,0.0
48060,4,8060,[302 603 100 427  64],90,5,30259,3.753752636149361,20.0,20.0
48061,4,8061,[302 603 100 427  64],271,5,30264,3.753907219052344,20.0,20.0
48062,4,8062,[302 603 100 427  64],537,4,30268,3.7539377402951755,20.0,20.0
48063,4,8063,[135 121 202 289 603],82,3,30271,3.753844246031746,20.0,0.0
48064,4,8064,[302 603 100 427  64],474,5,30276,3.7539987600743956,20.0,20.0
48065,4,8065,[302 603 100 427  64],454,5,30281,3.754153235804612,20.0,20.0
48066,4,8066,[302 603 100 427  64],339,5,30286,3.754307673236643,20.0,20.0
48067,4,8067,[269 357 273 121 210],537,1,30287,3.753966286564204,20.0,0.0
48068,4,8068,[318 245 121 186 197],313,3,30290,3.753872846697236,20.0,0.0
48069,4,8069,[302 603 100 427  64],339,5,30295,3.754027261462206,20.0,20.0
48070,4,8070,[210 286  88 183 318],406,3,30298,3.753933837194895,20.0,0.0
48071,4,8071,[318 423  56 483  98],313,4,30302,3.75396432111001,40.0,20.0
48072,4,8072,[302 603 100 427  64],90,5,30307,3.7541186671621456,20.0,20.0
48073,4,8073,[568 288 204  25 245],200,4,30311,3.754149120634134,0.0,0.0
48074,4,8074,[ 70  56 313 300 173],144,4,30315,3.7541795665634674,0.0,0.0
48075,4,8075,[302 603 100 427  64],745,5,30320,3.7543338286280337,20.0,20.0
48076,4,8076,[  4 195 117 302  82],537,1,30321,3.7539928191160086,0.0,0.0
48077,4,8077,[302 603 100 427  64],745,5,30326,3.7541470661054714,20.0,20.0
48078,4,8078,[211  56 258 176 153],653,1,30327,3.753806164129224,0.0,0.0
48079,4,8079,[176 265  89  56 288],346,4,30331,3.7538366336633664,0.0,0.0
48080,4,8080,[302 603 100 427  64],339,5,30336,3.7539908427174855,20.0,20.0
48081,4,8081,[ 11 195 546 515 121],13,1,30337,3.753650086612225,0.0,0.0
48082,4,8082,[302 603 100 427  64],458,5,30342,3.7538042805888905,20.0,20.0
48083,4,8083,[300 195 313 257 435],378,4,30346,3.7538347352795647,0.0,0.0
48084,4,8084,[302 603 100 427  64],474,5,30351,3.7539888682745826,20.0,20.0
48085,4,8085,[302 603 100 427  64],454,5,30356,3.7541429631461787,20.0,20.0
48086,4,8086,[ 71 161  22 588 143],311,4,30360,3.7541733646593296,0.0,0.0
48087,4,8087,[118 176 100 318 187],59,5,30365,3.7543273986152323,20.0,20.0
48088,4,8088,[588 195 289 288 742],387,1,30366,3.7539868957843985,0.0,0.0
48089,4,8089,[173  50  97   1  89],455,4,30370,3.754017305315204,0.0,20.0
48090,4,8090,[135 678 273 183 153],749,4,30374,3.754047707329131,0.0,0.0
48091,4,8091,[302 603 100 427  64],474,5,30379,3.754201680672269,20.0,20.0
48092,4,8092,[302 603 100 427  64],537,4,30383,3.754232052390955,20.0,20.0
48093,4,8093,[302 603 100 427  64],745,5,30388,3.754385964912281,20.0,20.0
48094,4,8094,[228 333 121 496 403],64,3,30391,3.754292773316862,0.0,0.0
48095,4,8095,[302 603 100 427  64],745,5,30396,3.7544466403162056,20.0,20.0
48096,4,8096,[427 508 182  64  25],537,3,30399,3.7543534642460172,0.0,0.0
48097,4,8097,[302 603 100 427  64],474,5,30404,3.754507285749568,20.0,20.0
48098,4,8098,[302 603 100 427  64],339,5,30409,3.7546610692678106,20.0,20.0
48099,4,8099,[216 132 211 168 195],85,3,30412,3.754567901234568,0.0,0.0
48100,4,8100,[ 98 216 197 237  96],64,4,30416,3.7545981977533636,0.0,20.0
48101,4,8101,[302 603 100 427  64],664,5,30421,3.754751913107875,20.0,20.0
48102,4,8102,[302 603 100 427  64],458,5,30426,3.754905590522029,20.0,20.0
48103,4,8103,[200 196 385 333 202],343,2,30428,3.754689042448174,0.0,0.0
48104,4,8104,[302 603 100 427  64],474,5,30433,3.7548426896977176,20.0,20.0
48105,4,8105,[302 603 100 427  64],339,5,30438,3.75499629903775,20.0,20.0
48106,4,8106,[748 318 185 132  11],488,3,30441,3.754903170099914,20.0,0.0
48107,4,8107,[ 95  88 194 471 300],378,4,30445,3.754933399111988,0.0,0.0
48108,4,8108,[302 603 100 427  64],458,5,30450,3.755086940436552,20.0,20.0
48109,4,8109,[302 603 100 427  64],664,5,30455,3.755240443896424,20.0,20.0
48110,4,8110,[257 185   9 195  25],308,5,30460,3.7553939095056097,0.0,0.0
48111,4,8111,[ 22  11 655 238 597],13,2,30462,3.7551775147928996,0.0,0.0
48112,4,8112,[302 603 100 427  64],271,5,30467,3.7553309503266363,20.0,20.0
48113,4,8113,[  4 174 144 496 197],339,4,30471,3.7553611042642348,0.0,20.0
48114,4,8114,[187 135  69 403  82],194,2,30473,3.7551447935921134,0.0,0.0
48115,4,8115,[302 603 100 427  64],666,5,30478,3.7552981764415967,20.0,20.0
48116,4,8116,[268 271   8  70 475],13,2,30480,3.755081926820254,0.0,0.0
48117,4,8117,[597 153  70 195 118],328,1,30481,3.754742547425474,0.0,0.0
48118,4,8118,[117 597 202   8 153],899,4,30485,3.7547727552654266,0.0,0.0
48119,4,8119,[302 603 100 427  64],370,5,30490,3.7549261083743843,20.0,20.0
48120,4,8120,[ 96 211  15 237 191],207,4,30494,3.754956286171654,0.0,0.0
48121,4,8121,[603  25 483 200 194],13,3,30497,3.754863334154149,40.0,0.0
48122,4,8122,[187 200 302 238 183],833,3,30500,3.754770405022775,0.0,0.0
48123,4,8123,[318 135 183 127 286],406,4,30504,3.75480059084195,20.0,20.0
48124,4,8124,[ 22 196 471 135   7],194,1,30505,3.7544615384615385,0.0,0.0
48125,4,8125,[211 483 143 603   1],339,5,30510,3.754614816637952,40.0,0.0
48126,4,8126,[294 127 181  22 228],311,5,30515,3.7547680570936386,0.0,20.0
48127,4,8127,[275  98  79 289 186],95,3,30518,3.7546751968503935,0.0,20.0
48128,4,8128,[100  79  97 121 496],840,3,30521,3.7545823594538072,0.0,20.0
48129,4,8129,[153  89 257 186 172],379,5,30526,3.7547355473554735,0.0,0.0
48130,4,8130,[ 98 515 135 357 405],95,3,30529,3.754642725372033,20.0,20.0
48131,4,8131,[216 172 191 153 182],385,2,30531,3.754426955238564,0.0,0.0
48132,4,8132,[322 127 328 748 118],102,0,30531,3.7539653264478052,0.0,20.0
48133,4,8133,[302 603 100 427  64],537,4,30535,3.753995574133268,20.0,20.0
48134,4,8134,[121 435 475 179 235],64,4,30539,3.754025814382299,0.0,0.0
48135,4,8135,[210 191 172 173  56],488,3,30542,3.7539331366764994,0.0,0.0
48136,4,8136,[302 603 100 427  64],13,5,30547,3.7540862725820325,20.0,20.0
48137,4,8137,[ 98 187 168 125  71],804,5,30552,3.7542393708527895,0.0,20.0
48138,4,8138,[143 496 313 174 195],200,5,30557,3.754392431502642,0.0,20.0
48139,4,8139,[  4  56 185 748  11],474,4,30561,3.7544226044226043,0.0,0.0
48140,4,8140,[302 603 100 427  64],458,5,30566,3.754575604962535,20.0,20.0
48141,4,8141,[197 174 135 183 245],452,3,30569,3.7544829280275116,0.0,20.0
48142,4,8142,[ 89 179 228  56 322],311,4,30573,3.7545130787179173,0.0,0.0
48143,4,8143,[125 238 237  50 187],271,4,30577,3.7545432220039294,0.0,20.0
48144,4,8144,[302 603 100 427  64],370,5,30582,3.754696132596685,20.0,20.0
48145,4,8145,[ 50 328 127 546 275],95,3,30585,3.7546034863736804,0.0,40.0
48146,4,8146,[318 143 216 276   1],184,4,30589,3.75463360746287,20.0,0.0
48147,4,8147,[ 71 508 273 195 132],59,3,30592,3.7545409916543937,0.0,0.0
48148,4,8148,[181 496 204 423  88],339,3,30595,3.7544483985765122,0.0,0.0
48149,4,8149,[302 603 100 427  64],339,5,30600,3.754601226993865,20.0,20.0
48150,4,8150,[204 435  22 127 183],749,5,30605,3.7547540179119125,0.0,20.0
48151,4,8151,[202  11 323   9 174],378,2,30607,3.7545387634936214,0.0,20.0
48152,4,8152,[135 202  64 195 183],92,4,30611,3.7545688703544706,0.0,0.0
48153,4,8153,[  4 173 181 265 172],59,5,30616,3.754721609026245,0.0,0.0
48154,4,8154,[ 70 144 258 121 385],328,4,30620,3.7547516860821584,0.0,0.0
48155,4,8155,[655 294 318 238 186],804,5,30625,3.7549043648847475,20.0,0.0
48156,4,8156,[ 50 333  96  64 182],458,3,30628,3.754811818070369,0.0,20.0
48157,4,8157,[302 603 100 427  64],745,5,30633,3.754964452071586,20.0,20.0
48158,4,8158,[357 603   7 132 143],815,4,30637,3.754994484618213,40.0,0.0
48159,4,8159,[302 603 100 427  64],745,5,30642,3.7551470588235296,20.0,20.0
48160,4,8160,[  7 204 276  97 182],339,4,30646,3.7551770616346034,0.0,0.0
48161,4,8161,[ 50 132 100 194 603],643,5,30651,3.755329576084293,20.0,40.0
48162,4,8162,[302 603 100 427  64],666,5,30656,3.755482053166728,20.0,20.0
48163,4,8163,[302 603 100 427  64],339,5,30661,3.7556344928956396,20.0,20.0
48164,4,8164,[302 603 100 427  64],271,5,30666,3.755786895284752,20.0,20.0
48165,4,8165,[ 69  22 117 186  96],232,2,30668,3.7555718834190546,0.0,0.0
48166,4,8166,[302 603 100 427  64],90,5,30673,3.75572425615281,20.0,20.0
48167,4,8167,[302 603 100 427  64],13,5,30678,3.7558765915768855,20.0,20.0
48168,4,8168,[302 603 100 427  64],458,5,30683,3.7560288897049823,20.0,20.0
48169,4,8169,[302 603 100 427  64],666,5,30688,3.7561811505507956,20.0,20.0
48170,4,8170,[302 603 100 427  64],666,5,30693,3.7563333741280136,20.0,20.0
48171,4,8171,[  7 174 121 182 183],339,4,30697,3.756363191385218,0.0,20.0
48172,4,8172,[302 603 100 427  64],458,5,30702,3.7565153554386392,20.0,20.0
48173,4,8173,[357   1 100  98 151],313,4,30706,3.7565451431367753,20.0,40.0
48174,4,8174,[302 603 100 427  64],745,5,30711,3.756697247706422,20.0,20.0
48175,4,8175,[179 302 185  97  22],543,3,30714,3.7566046966731896,0.0,0.0
48176,4,8176,[187  22  89 588 655],840,3,30717,3.756512168276874,0.0,0.0
48177,4,8177,[135 143 132 183   1],536,4,30721,3.75654194179506,0.0,0.0
48178,4,8178,[ 97 179 180  11 286],378,2,30723,3.7563271793617803,0.0,0.0
48179,4,8179,[302 603 100 427  64],745,5,30728,3.756479217603912,20.0,20.0
48180,4,8180,[302 603 100 427  64],745,5,30733,3.7566312186774233,20.0,20.0
48181,4,8181,[385 403  95  70 276],398,4,30737,3.756660963089709,0.0,0.0
48182,4,8182,[403 195  88 546 427],42,3,30740,3.7565684956617376,0.0,0.0
48183,4,8183,[302 603 100 427  64],454,5,30745,3.756720430107527,20.0,20.0
48184,4,8184,[216  56 183 385 182],804,4,30749,3.756750152718387,0.0,0.0
48185,4,8185,[405 186 181 175 176],385,1,30750,3.756413388712436,0.0,0.0
48186,4,8186,[222  97 301 323 202],13,2,30752,3.7561988518382803,0.0,0.0
48187,4,8187,[161 174 143 385 588],42,5,30757,3.756350757205667,0.0,20.0
48188,4,8188,[302 603 100 427  64],537,4,30761,3.7563805104408354,20.0,20.0
48189,4,8189,[302 603 100 427  64],13,5,30766,3.7565323565323565,20.0,20.0
48190,4,8190,[ 82 294 435   4 603],650,2,30768,3.756317909901111,20.0,0.0
48191,4,8191,[405 313  98 318 173],334,4,30772,3.75634765625,20.0,20.0
48192,4,8192,[143 181  71 294  22],406,1,30773,3.7560112290980103,0.0,0.0
48193,4,8193,[313 111  82 588 121],64,3,30776,3.755918965096412,0.0,0.0
48194,4,8194,[302 603 100 427  64],537,4,30780,3.75594874923734,20.0,20.0
48195,4,8195,[168 238 187  82 185],64,4,30784,3.755978526110298,0.0,0.0
48196,4,8196,[186 215 568  71  69],13,4,30788,3.7560082957179457,0.0,0.0
48197,4,8197,[302 603 100 427  64],339,5,30793,3.7561600390339107,20.0,20.0
48198,4,8198,[289 185  70 603 183],537,3,30796,3.756067813147945,20.0,0.0
48199,4,8199,[405 275 435 195 475],13,1,30797,3.7557317073170733,0.0,0.0
48200,4,8200,[235 237 117  12 187],328,4,30801,3.7557614925009144,20.0,0.0
48201,4,8201,[288 222 475 187 273],479,3,30804,3.755669348939283,0.0,0.0
48202,4,8202,[202 111 265  12 168],666,3,30807,3.755577227843472,20.0,0.0
48203,4,8203,[302 603 100 427  64],271,5,30812,3.7557289127254996,20.0,20.0
48204,4,8204,[168  88 172 496 483],892,5,30817,3.7558805606337597,20.0,0.0
48205,4,8205,[179 211  56  11 132],64,5,30822,3.7560321715817695,0.0,0.0
48206,4,8206,[302 603 100 427  64],90,5,30827,3.756183745583039,20.0,20.0
48207,4,8207,[257 195 603 176 100],385,2,30829,3.755969785575049,20.0,20.0
48208,4,8208,[228 195 276 151 118],59,5,30834,3.75612133024729,0.0,0.0
48209,4,8209,[238 318 181 215 179],653,3,30837,3.756029232643118,20.0,0.0
48210,4,8210,[282 186 568 427 144],328,2,30839,3.755815369626111,0.0,0.0
48211,4,8211,[  4  64 603 655 302],13,5,30844,3.7559668777398927,20.0,0.0
48212,4,8212,[ 97 403  71 191 357],387,2,30846,3.755753074394253,20.0,0.0
48213,4,8213,[405 143  28 183 568],536,3,30849,3.7556610664718773,0.0,0.0
48214,4,8214,[135 111 174 125 144],749,4,30853,3.7556908094948267,0.0,20.0
48215,4,8215,[546 403 294 471  15],42,3,30856,3.7555988315481987,0.0,0.0
48216,4,8216,[ 71 215 282  15 245],533,4,30860,3.7556285749056832,0.0,0.0
48217,4,8217,[135  97 588 174   4],326,2,30862,3.755414942808469,0.0,20.0
48218,4,8218,[117  69 143 655 427],313,4,30866,3.7554447013018617,0.0,0.0
48219,4,8219,[ 50  82 273 289 168],374,1,30867,3.7551094890510948,0.0,20.0
48220,4,8220,[  8 568 161  28 655],308,3,30870,3.7550176377569637,0.0,0.0
48221,4,8221,[181 172 276  50 423],533,4,30874,3.7550474337144246,0.0,20.0
48222,4,8222,[302 603 100 427  64],271,5,30879,3.7551988325428676,20.0,20.0
48223,4,8223,[ 79  71 144 185 183],815,4,30883,3.7552285992217898,0.0,0.0
48224,4,8224,[302 603 100 427  64],271,5,30888,3.7553799392097265,20.0,20.0
48225,4,8225,[403 200 496 276  97],234,2,30890,3.7551665451008995,0.0,0.0
48226,4,8226,[302 603 100 427  64],454,5,30895,3.755317855840525,20.0,20.0
48227,4,8227,[302 603 100 427  64],745,5,30900,3.7554691298006806,20.0,20.0
48228,4,8228,[181 144 286  69  95],455,4,30904,3.755498845546239,0.0,0.0
48229,4,8229,[546 117 194 211 183],882,3,30907,3.7554070473876062,0.0,0.0
48230,4,8230,[302 603 100 427  64],339,5,30912,3.7555582553760174,20.0,20.0
48231,4,8231,[ 82 427 151 186 161],60,4,30916,3.7555879494655007,0.0,0.0
48232,4,8232,[234  79  22 655 121],774,0,30916,3.7551317867120124,0.0,0.0
48233,4,8233,[ 12 172 195 301  56],234,0,30916,3.7546757347583193,20.0,0.0
48234,4,8234,[180 135 191 546 655],749,4,30920,3.7547055251973287,0.0,0.0
48235,4,8235,[302 603 100 427  64],339,5,30925,3.7548567265662944,20.0,20.0
48236,4,8236,[496 180 222 183 200],387,4,30929,3.754886487798956,0.0,0.0
48237,4,8237,[302 603 100 427  64],666,5,30934,3.755037630492838,20.0,20.0
48238,4,8238,[302 603 100 427  64],13,5,30939,3.7551887364971477,20.0,20.0
48239,4,8239,[222 127 211 161 100],387,4,30943,3.755218446601942,0.0,40.0
48240,4,8240,[302 603 100 427  64],454,5,30948,3.7553694939934474,20.0,20.0
48241,4,8241,[197 603 655 161 210],326,2,30950,3.7551565154088813,20.0,0.0
48242,4,8242,[302 603 100 427  64],271,5,30955,3.755307533664928,20.0,20.0
48243,4,8243,[302 603 100 427  64],666,5,30960,3.7554585152838427,20.0,20.0
48244,4,8244,[288 132 181 238 265],650,4,30964,3.755488174651304,0.0,0.0
48245,4,8245,[300  15 742 328 302],145,3,30967,3.755396555905894,0.0,0.0
48246,4,8246,[302 603 100 427  64],13,5,30972,3.75554747180793,20.0,20.0
48247,4,8247,[302 603 100 427  64],339,5,30977,3.755698351115422,20.0,20.0
48248,4,8248,[202 385 181 257  82],650,2,30979,3.755485513395563,0.0,0.0
48249,4,8249,[172  89 228 202   7],279,4,30983,3.7555151515151515,0.0,0.0
48250,4,8250,[568 200 143 125 294],648,2,30985,3.755302387589383,0.0,0.0
48251,4,8251,[302 603 100 427  64],370,5,30990,3.755453223460979,20.0,20.0
48252,4,8252,[ 71 289  89 168 143],406,1,30991,3.7551193505391978,0.0,0.0
48253,4,8253,[265  82  28  69 215],308,1,30992,3.754785558517083,0.0,0.0
48254,4,8254,[ 97 194 202  56 210],537,1,30993,3.754451847365233,0.0,0.0
48255,4,8255,[151 300 127 210 288],537,1,30994,3.7541182170542635,0.0,20.0
48256,4,8256,[286 195 238   4  12],339,4,30998,3.754147995640063,20.0,0.0
48257,4,8257,[423 132 179 289 273],234,3,31001,3.7540566723177524,0.0,0.0
48258,4,8258,[204 173   7 185 289],374,2,31003,3.7538442910764016,0.0,0.0
48259,4,8259,[ 96 546   4 117 211],13,3,31006,3.7537530266343824,0.0,0.0
48260,4,8260,[302 603 100 427  64],474,5,31011,3.75390388572812,20.0,20.0
48261,4,8261,[  4 357  70 172 168],59,4,31015,3.753933672234326,20.0,0.0
48262,4,8262,[ 25  95 196  64 322],804,4,31019,3.753963451530921,0.0,0.0
48263,4,8263,[125 265 202 678 191],82,3,31022,3.7538722168441434,0.0,0.0
48264,4,8264,[181 294 357 179 742],666,2,31024,3.7536600120992136,20.0,0.0
48265,4,8265,[187 153 483  82 237],184,3,31027,3.7535688361964676,20.0,0.0
48266,4,8266,[515 202  71  22 100],308,4,31031,3.7535986452159187,0.0,20.0
48267,4,8267,[222 318 168  82 276],194,2,31033,3.7533865505563617,20.0,0.0
48268,4,8268,[197 100 143 237  98],666,3,31036,3.753295440802999,0.0,40.0
48269,4,8269,[215 117 176 179 222],815,3,31039,3.7532043530834343,0.0,0.0
48270,4,8270,[302 603 100 427  64],474,5,31044,3.75335509611897,20.0,20.0
48271,4,8271,[ 50  15 183 204 186],406,4,31048,3.753384912959381,0.0,20.0
48272,4,8272,[302 603 100 427  64],474,5,31053,3.7535355977275473,20.0,20.0
48273,4,8273,[197 143 196 204  98],666,2,31055,3.753323664491177,0.0,20.0
48274,4,8274,[302 603 100 427  64],90,5,31060,3.753474320241692,20.0,20.0
48275,4,8275,[423 588 211 603 546],804,3,31063,3.7533832769453843,20.0,0.0
48276,4,8276,[302 603 100 427  64],474,5,31068,3.75353388909025,20.0,20.0
48277,4,8277,[302 603 100 427  64],666,5,31073,3.7536844648465815,20.0,20.0
48278,4,8278,[302 603 100 427  64],458,5,31078,3.7538350042275637,20.0,20.0
48279,4,8279,[174 168 403   9 135],194,3,31081,3.753743961352657,0.0,20.0
48280,4,8280,[302 603 100 427  64],13,5,31086,3.7538944571911603,20.0,20.0
48281,4,8281,[202  64 333 234  22],13,4,31090,3.753924172905095,0.0,0.0
48282,4,8282,[  9  98 121 405 135],474,5,31095,3.754074610648316,0.0,20.0
48283,4,8283,[135  69 175 174 132],239,4,31099,3.7541042974408496,0.0,20.0
48284,4,8284,[186 168 222 187   1],804,5,31104,3.7542546771273386,0.0,0.0
48285,4,8285,[100  69  89 423 276],374,3,31107,3.7541636495293265,0.0,20.0
48286,4,8286,[100  82 403 405 183],334,4,31111,3.754193314830457,0.0,20.0
48287,4,8287,[182   8 258 211 195],387,5,31116,3.754343629343629,0.0,0.0
48288,4,8288,[269  98 153   4  95],334,2,31118,3.7541319821450116,0.0,20.0
48289,4,8289,[302 603 100 427  64],474,5,31123,3.754282267792521,20.0,20.0
48290,4,8290,[294 245 180 282   4],92,4,31127,3.7543119044747315,0.0,0.0
48291,4,8291,[302 603 100 427  64],474,5,31132,3.754462132175591,20.0,20.0
48292,4,8292,[ 50 546 127 471  95],524,4,31136,3.754491740021705,0.0,40.0
48293,4,8293,[302 603 100 427  64],13,5,31141,3.7546419098143238,20.0,20.0
48294,4,8294,[100 603 228 200 211],59,5,31146,3.7547920433996382,20.0,20.0
48295,4,8295,[ 79 294 234 546 100],92,3,31149,3.75470106075217,0.0,20.0
48296,4,8296,[302 603 100 427  64],339,5,31154,3.7548511510184404,20.0,20.0
48297,4,8297,[302 603 100 427  64],474,5,31159,3.755001205109665,20.0,20.0
48298,4,8298,[ 98 121 496  96 357],815,4,31163,3.7550307265935654,20.0,20.0
48299,4,8299,[181 168 275 100   7],560,4,31167,3.7550602409638554,0.0,20.0
48300,4,8300,[302 603 100 427  64],90,5,31172,3.7552102156366702,20.0,20.0
48301,4,8301,[302 603 100 427  64],666,5,31177,3.7553601541797157,20.0,20.0
48302,4,8302,[179 678 323 211 180],537,3,31180,3.755269179814525,0.0,0.0
48303,4,8303,[302 603 100 427  64],745,5,31185,3.7554190751445087,20.0,20.0
48304,4,8304,[302 603 100 427  64],370,5,31190,3.7555689343768814,20.0,20.0
48305,4,8305,[222 271 161 234 300],102,0,31190,3.7551167830483987,0.0,0.0
48306,4,8306,[153  28 183 168 271],92,3,31193,3.755025881786445,0.0,0.0
48307,4,8307,[127 182 179 181 174],474,5,31198,3.7551757342320653,0.0,40.0
48308,4,8308,[144 187  82 385 276],13,3,31201,3.755084847755446,0.0,0.0
48309,4,8309,[302 603 100 427  64],13,5,31206,3.7552346570397113,20.0,20.0
48310,4,8310,[302 603 100 427  64],745,5,31211,3.755384430273132,20.0,20.0
48311,4,8311,[200  28   4 176 194],308,4,31215,3.7554138594802695,0.0,0.0
48312,4,8312,[210 234 294 245  98],102,1,31216,3.755082401058583,0.0,20.0
48313,4,8313,[237 191 216 508 385],318,5,31221,3.7552321385614627,0.0,0.0
48314,4,8314,[568 268  88 357 117],537,2,31223,3.7550210463018643,20.0,0.0
48315,4,8315,[ 96 117 273 427 185],234,1,31224,3.7546897546897546,0.0,0.0
48316,4,8316,[496 403 196  28  98],95,4,31228,3.7547192497294697,0.0,20.0
48317,4,8317,[ 79  97  95 174 289],881,3,31231,3.7546285164703055,0.0,20.0
48318,4,8318,[302 603 100 427  64],90,5,31236,3.754778218535882,20.0,20.0
48319,4,8319,[211 180 118 168 100],59,5,31241,3.7549278846153844,0.0,20.0
48320,4,8320,[302 603 100 427  64],339,5,31246,3.7550775147217883,20.0,20.0
48321,4,8321,[515 403 132 286 385],890,4,31250,3.755106945445806,0.0,0.0
48322,4,8322,[196 313 245 197  64],455,4,31254,3.755136369097681,0.0,0.0
48323,4,8323,[302 603 100 427  64],370,5,31259,3.7552859202306585,20.0,20.0
48324,4,8324,[286 144 276 328 125],234,0,31259,3.754834834834835,0.0,0.0
48325,4,8325,[405 135 196 210 180],92,4,31263,3.754864280566899,0.0,0.0
48326,4,8326,[302 603 100 427  64],370,5,31268,3.755013810495977,20.0,20.0
48327,4,8327,[186   7 318  28  97],537,3,31271,3.7549231508165226,20.0,0.0
48328,4,8328,[ 79   9 322 180 475],13,1,31272,3.7545923880417815,0.0,0.0
48329,4,8329,[282 161   7  15  95],374,3,31275,3.754501800720288,0.0,0.0
48330,4,8330,[302 268 211 496  56],6,4,31279,3.7545312687552514,0.0,0.0
48331,4,8331,[301 423 127  56 187],6,3,31282,3.7544407105136823,0.0,20.0
48332,4,8332,[302 603 100 427  64],13,5,31287,3.7545901836073443,20.0,20.0
48333,4,8333,[302 603 100 427  64],271,5,31292,3.7547396208303336,20.0,20.0
48334,4,8334,[302 603 100 427  64],370,5,31297,3.754889022195561,20.0,20.0
48335,4,8335,[475 181 228 127 286],537,2,31299,3.7546785028790786,0.0,20.0
48336,4,8336,[435 132 176 175 111],537,1,31300,3.7543480868417896,0.0,0.0
48337,4,8337,[357 186  22 333 215],298,5,31305,3.75449748141041,20.0,0.0
48338,4,8338,[302 603 100 427  64],271,5,31310,3.7546468401486988,20.0,20.0
48339,4,8339,[181 186  12  98  15],59,5,31315,3.7547961630695443,20.0,20.0
48340,4,8340,[568 258 153 144 603],13,4,31319,3.7548255604843543,20.0,0.0
48341,4,8341,[ 25 238 603 235 216],537,2,31321,3.7546152001918007,20.0,0.0
48342,4,8342,[258  79 286   7 174],650,2,31323,3.7544048903272205,0.0,20.0
48343,4,8343,[ 15  70 117 483 238],194,3,31326,3.75431447746884,20.0,0.0
48344,4,8344,[302 603 100 427  64],454,5,31331,3.7544637507489513,20.0,20.0
48345,4,8345,[  7  69 211 318  71],6,3,31334,3.7543733525041936,20.0,0.0
48346,4,8346,[302 603 100 427  64],745,5,31339,3.754522582963939,20.0,20.0
48347,4,8347,[302 603 100 427  64],339,5,31344,3.7546717776712986,20.0,20.0
48348,4,8348,[568 322 153 294 742],92,1,31345,3.7543418373457897,0.0,0.0
48349,4,8349,[187 405 742  70 222],328,4,31349,3.75437125748503,0.0,0.0
48350,4,8350,[ 50 197 211 282 172],95,4,31353,3.7544006705783737,0.0,20.0
48351,4,8351,[302 603 100 427  64],271,5,31358,3.7545498084291187,20.0,20.0
48352,4,8352,[302 603 100 427  64],370,5,31363,3.754698910571052,20.0,20.0
48353,4,8353,[302 603 100 427  64],370,5,31368,3.754847977016998,20.0,20.0
48354,4,8354,[181 435 204 153 222],210,5,31373,3.7549970077797727,0.0,0.0
48355,4,8355,[302 603 100 427  64],13,5,31378,3.7551460028721877,20.0,20.0
48356,4,8356,[302 603 100 427  64],537,4,31382,3.7551753021419167,20.0,20.0
48357,4,8357,[435  12 204 245 301],328,3,31385,3.7550849485522853,20.0,0.0
48358,4,8358,[ 95   4 168  64 194],543,2,31387,3.754874985046058,0.0,0.0
48359,4,8359,[302 603 100 427  64],90,5,31392,3.755023923444976,20.0,20.0
48360,4,8360,[302 603 100 427  64],537,4,31396,3.7550532232986487,20.0,20.0
48361,4,8361,[ 98 228 294  11  28],653,2,31398,3.7548433389141356,0.0,20.0
48362,4,8362,[302 603 100 427  64],458,5,31403,3.7549922276694967,20.0,20.0
48363,4,8363,[196 175 179 173  69],766,3,31406,3.7549019607843137,0.0,0.0
48364,4,8364,[182 302 211 483 176],833,2,31408,3.7546921697549314,20.0,0.0
48365,4,8365,[302 603 100 427  64],454,5,31413,3.7548410231890985,20.0,20.0
48366,4,8366,[215 173  15 127 100],194,4,31417,3.7548703238914785,0.0,40.0
48367,4,8367,[302 603 100 427  64],13,5,31422,3.755019120458891,20.0,20.0
48368,4,8368,[135 265  12 202 194],378,3,31425,3.7549289042896405,20.0,0.0
48369,4,8369,[302 603 100 427  64],474,5,31430,3.7550776583034646,20.0,20.0
48370,4,8370,[302 603 100 427  64],666,5,31435,3.7552263767769682,20.0,20.0
48371,4,8371,[515 175 234  69 483],326,2,31437,3.7550167224080266,20.0,0.0
48372,4,8372,[483 568 153 288  95],13,3,31440,3.7549265496237907,20.0,0.0
48373,4,8373,[302 603 100 427  64],90,5,31445,3.7550752328636254,20.0,20.0
48374,4,8374,[302 603 100 427  64],537,4,31449,3.7551044776119404,20.0,20.0
48375,4,8375,[202 180 111 200 471],666,4,31453,3.7551337153772684,0.0,0.0
48376,4,8376,[318 483 176 118 273],59,4,31457,3.7551629461621103,40.0,0.0
48377,4,8377,[187  50 357 172 216],234,3,31460,3.7550728097397945,20.0,20.0
48378,4,8378,[100 175 268 127 546],13,4,31464,3.7551020408163267,0.0,40.0
48379,4,8379,[ 11 196   9 202 173],59,5,31469,3.755250596658711,0.0,0.0
48380,4,8380,[161 202 294 475 678],92,1,31470,3.75492184703496,0.0,0.0
48381,4,8381,[195 273   9 238  22],207,2,31472,3.754712479121928,0.0,0.0
48382,4,8382,[179 405 300 196  95],13,2,31474,3.7545031611594895,0.0,0.0
48383,4,8383,[289 182 210 435 144],234,1,31475,3.7541746183206106,0.0,0.0
48384,4,8384,[288 183  56 323 121],474,3,31478,3.7540846750149077,0.0,0.0
48385,4,8385,[202  25 496 172  56],387,2,31480,3.753875506797043,0.0,0.0
48386,4,8386,[118 144 161 215  98],308,0,31480,3.753427924168356,0.0,20.0
48387,4,8387,[302 603 100 427  64],13,5,31485,3.753576537911302,20.0,20.0
48388,4,8388,[302 603 100 427  64],745,5,31490,3.753725116223626,20.0,20.0
48389,4,8389,[185 234 568 186 265],881,3,31493,3.7536352800953514,0.0,0.0
48390,4,8390,[216 179 427  69 515],334,3,31496,3.7535454653795735,0.0,0.0
48391,4,8391,[183  71 271 194 151],843,2,31498,3.753336510962822,0.0,0.0
48392,4,8392,[175 405   7 153 222],406,2,31500,3.7531276063386154,0.0,0.0
48393,4,8393,[302 603 100 427  64],271,5,31505,3.753276149630689,20.0,20.0
48394,4,8394,[302 603 100 427  64],745,5,31510,3.7534246575342465,20.0,20.0
48395,4,8395,[471  98 111 186  56],374,4,31514,3.7534540257265365,0.0,20.0
48396,4,8396,[515 132  70 268 187],234,3,31517,3.753364296772657,0.0,0.0
48397,4,8397,[ 82 471 300 385 235],83,2,31519,3.7531555132174326,0.0,0.0
48398,4,8398,[222 655 117  89 121],311,5,31524,3.753303964757709,0.0,0.0
48399,4,8399,[302 603 100 427  64],666,5,31529,3.753452380952381,20.0,20.0
48400,4,8400,[742 275 176 235 216],334,1,31530,3.753124628020474,0.0,0.0
48401,4,8401,[302 603 100 427  64],666,5,31535,3.7532730302308974,20.0,20.0
48402,4,8402,[ 12 282  11 210 597],643,3,31538,3.753183386885636,20.0,0.0
48403,4,8403,[173 228  28 195  11],374,3,31541,3.7530937648738694,0.0,0.0
48404,4,8404,[ 97 588 289 385 435],387,0,31541,3.752647233789411,0.0,0.0
48405,4,8405,[ 69 318 403 423 435],533,4,31545,3.752676659528908,20.0,0.0
48406,4,8406,[302 603 100 427  64],370,5,31550,3.7528250267634116,20.0,20.0
48407,4,8407,[ 22 483 194 289 118],533,4,31554,3.7528544243577544,20.0,0.0
48408,4,8408,[153 125 405 215 603],313,2,31556,3.752645974551076,20.0,0.0
48409,4,8409,[245 117 161  28  56],533,3,31559,3.7525564803804996,0.0,0.0
48410,4,8410,[275 276 234 742 144],308,3,31562,3.7524670074901914,0.0,0.0
48411,4,8411,[ 28 403  79 238 265],479,4,31566,3.7524964336661912,0.0,0.0
48412,4,8412,[161 127  70 135 195],881,3,31569,3.7524069891834064,0.0,20.0
48413,4,8413,[ 22  95 597  50 286],455,4,31573,3.7524364154979795,0.0,20.0
48414,4,8414,[180 182 200 127 176],749,4,31577,3.752465834818776,0.0,20.0
48415,4,8415,[135  71 403 174  70],479,3,31580,3.7523764258555135,0.0,20.0
48416,4,8416,[265 603 200 181 180],648,3,31583,3.7522870381371036,20.0,0.0
48417,4,8417,[302 603 100 427  64],745,5,31588,3.7524352577809457,20.0,20.0
48418,4,8418,[302 603 100 427  64],745,5,31593,3.7525834422140396,20.0,20.0
48419,4,8419,[302 603 100 427  64],458,5,31598,3.752731591448931,20.0,20.0
48420,4,8420,[258 568 100  79 427],788,3,31601,3.752642204013775,0.0,20.0
48421,4,8421,[ 56 357 294 546 176],648,2,31603,3.7524341011636193,20.0,0.0
48422,4,8422,[ 82  69  56 151 153],788,1,31604,3.752107325181052,0.0,0.0
48423,4,8423,[302 603 100 427  64],537,4,31608,3.752136752136752,20.0,20.0
48424,4,8424,[483 118 127 245 603],313,4,31612,3.752166172106825,40.0,20.0
48425,4,8425,[294  98 423  71 483],452,3,31615,3.752076904818419,20.0,20.0
48426,4,8426,[257 186 202 405 496],653,1,31616,3.751750326332028,0.0,0.0
48427,4,8427,[ 95 181 118 185 216],194,1,31617,3.7514238253440912,0.0,0.0
48428,4,8428,[ 95 180 678 197 132],804,4,31621,3.7514533159330883,0.0,0.0
48429,4,8429,[ 64  11 181 301 588],378,3,31624,3.751364175563464,0.0,0.0
48430,4,8430,[302 603 100 427  64],474,5,31629,3.7515122761238286,20.0,20.0
48431,4,8431,[302 603 100 427  64],666,5,31634,3.751660341555977,20.0,20.0
48432,4,8432,[302 603 100 427  64],745,5,31639,3.7518083718724062,20.0,20.0
48433,4,8433,[172  79 568 748 275],328,3,31642,3.75171923168129,0.0,0.0
48434,4,8434,[215  11  82 216 385],295,5,31647,3.7518672199170124,0.0,0.0
48435,4,8435,[302 603 100 427  64],370,5,31652,3.7520151730678046,20.0,20.0
48436,4,8436,[302 603 100 427  64],745,5,31657,3.752163091146142,20.0,20.0
48437,4,8437,[475  71  95 294  50],648,1,31658,3.751836928182034,0.0,20.0
48438,4,8438,[302 603 100 427  64],271,5,31663,3.751984832326105,20.0,20.0
48439,4,8439,[276 186  96 181 144],346,3,31666,3.751895734597156,0.0,0.0
48440,4,8440,[302 603 100 427  64],458,5,31671,3.7520435967302452,20.0,20.0
48441,4,8441,[302 603 100 427  64],271,5,31676,3.752191423833215,20.0,20.0
48442,4,8442,[257  98  11 238 174],474,4,31680,3.7522207746061826,0.0,40.0
48443,4,8443,[237 228 234  50 655],13,5,31685,3.7523685457129323,0.0,20.0
48444,4,8444,[258 313   7  64 121],738,5,31690,3.7525162818235644,0.0,0.0
48445,4,8445,[286  28 294  98 678],554,3,31693,3.7524271844660193,0.0,20.0
48446,4,8446,[302 603 100 427  64],474,5,31698,3.752574878655144,20.0,20.0
48447,4,8447,[268 300 168 100 174],7,4,31702,3.7526041666666665,0.0,40.0
48448,4,8448,[300 322 215 191 187],13,2,31704,3.752396733341224,0.0,0.0
48449,4,8449,[ 25 273 286  11 318],13,0,31704,3.7519526627218935,20.0,0.0
48450,4,8450,[216 357 234 238  50],843,1,31705,3.7516270263874096,20.0,20.0
48451,4,8451,[179 357 187 144   1],339,4,31709,3.7516564126833885,20.0,0.0
48452,4,8452,[153  79 322 111 318],234,1,31710,3.751330888441973,20.0,0.0
48453,4,8453,[318 204  98 125 300],892,5,31715,3.75147859001656,20.0,20.0
48454,4,8454,[187 161 235 286 153],194,2,31717,3.7512714370195153,0.0,0.0
48455,4,8455,[ 82 322  79 204 175],749,4,31721,3.7513008514664143,0.0,0.0
48456,4,8456,[238 748 200 313 328],13,2,31723,3.751093768475819,0.0,0.0
48457,4,8457,[302 603 100 427  64],537,4,31727,3.7511231969732797,20.0,20.0
48458,4,8458,[302 603 100 427  64],474,5,31732,3.7512708357961935,20.0,20.0
48459,4,8459,[496 276  69 588  70],59,3,31735,3.7511820330969265,0.0,0.0
48460,4,8460,[  1 197 423 235 176],313,4,31739,3.751211440728046,0.0,0.0
48461,4,8461,[234  98 289  56 196],378,5,31744,3.7513590167809028,0.0,20.0
48462,4,8462,[302 603 100 427  64],271,5,31749,3.751506557958171,20.0,20.0
48463,4,8463,[288 228 168 423 322],374,3,31752,3.7514177693761814,0.0,0.0
48464,4,8464,[194  22  89 179  12],524,3,31755,3.7513290017720022,20.0,0.0
48465,4,8465,[194 483 180 173   9],339,5,31760,3.7514764942121426,20.0,0.0
48466,4,8466,[273  28 144  79   9],64,3,31763,3.751387740640132,0.0,0.0
48467,4,8467,[403 597  98  89  96],804,3,31766,3.7512990080302315,0.0,20.0
48468,4,8468,[185 186   1  88 151],650,1,31767,3.750974140984768,0.0,0.0
48469,4,8469,[216 200 121 257  89],666,2,31769,3.750767414403778,0.0,0.0
48470,4,8470,[302 603 100 427  64],13,5,31774,3.7509148860819264,20.0,20.0
48471,4,8471,[265  79  82   9 132],194,2,31776,3.7507082152974505,0.0,0.0
48472,4,8472,[180  28 179 118 228],648,4,31780,3.7507376372005194,0.0,0.0
48473,4,8473,[471 204 194 210 196],666,1,31781,3.75041302808591,0.0,0.0
48474,4,8474,[302 603 100 427  64],339,5,31786,3.750560471976401,20.0,20.0
48475,4,8475,[ 98 181 294 268 191],234,2,31788,3.7503539405379898,0.0,20.0
48476,4,8476,[ 22  89 300 405  79],447,3,31791,3.7502654240887106,0.0,0.0
48477,4,8477,[302 603 100 427  64],339,5,31796,3.750412833215381,20.0,20.0
48478,4,8478,[ 71  70 187 127 322],234,2,31798,3.7502063922632387,0.0,20.0
48479,4,8479,[302 603 100 427  64],664,5,31803,3.7503537735849055,20.0,20.0
48480,4,8480,[302 603 100 427  64],370,5,31808,3.7505011201509255,20.0,20.0
48481,4,8481,[302 603 100 427  64],13,5,31813,3.750648431973591,20.0,20.0
48482,4,8482,[276 176 603  88 275],308,5,31818,3.7507957090651893,20.0,0.0
48483,4,8483,[ 15  69  98  89 173],537,2,31820,3.7505893446487506,0.0,20.0
48484,4,8484,[313 282 238 121 318],334,4,31824,3.7506187389510903,20.0,0.0
48485,4,8485,[100 276 175 135 678],474,4,31828,3.750648126325713,0.0,20.0
48486,4,8486,[588 294 195 238 286],881,1,31829,3.7503240249793803,0.0,0.0
48487,4,8487,[302 603 100 427  64],458,5,31834,3.7504712535344016,20.0,20.0
48488,4,8488,[302 603 100 427  64],90,5,31839,3.750618447402521,20.0,20.0
48489,4,8489,[175 268 245 471 322],92,4,31843,3.7506478209658423,0.0,0.0
48490,4,8490,[302 603 100 427  64],370,5,31848,3.7507949593687435,20.0,20.0
48491,4,8491,[211 187 313 100 568],537,4,31852,3.7508243052284502,0.0,20.0
48492,4,8492,[322  89 265  15 333],313,3,31855,3.7507359001530673,0.0,0.0
48493,4,8493,[302 603 100 427  64],13,5,31860,3.750882976218507,20.0,20.0
48494,4,8494,[181 197  97 187 179],409,3,31863,3.7507945850500293,0.0,0.0
48495,4,8495,[215 678 173  69 471],92,3,31866,3.7507062146892656,0.0,0.0
48496,4,8496,[216 288 202 191 423],882,4,31870,3.750735553724844,0.0,0.0
48497,4,8497,[ 25 197 234 180   7],234,2,31872,3.7505295363614968,0.0,0.0
48498,4,8498,[168 273 257 286 210],883,4,31876,3.7505588892810917,0.0,0.0
48499,4,8499,[117  25 172  79 288],200,5,31881,3.7507058823529413,0.0,0.0
48500,4,8500,[302 603 100 427  64],458,5,31886,3.7508528408422537,20.0,20.0
48501,4,8501,[153 515  15  89  28],95,4,31890,3.7508821453775583,0.0,0.0
48502,4,8502,[ 95 181 183 222 678],749,2,31892,3.7506762319181464,0.0,0.0
48503,4,8503,[302 603 100 427  64],339,5,31897,3.7508231420507996,20.0,20.0
48504,4,8504,[276 202 318 286 603],82,5,31902,3.7509700176366843,40.0,0.0
48505,4,8505,[300 546  15 238 185],653,1,31903,3.750646602398307,0.0,0.0
48506,4,8506,[302 603 100 427  64],13,5,31908,3.750793464205948,20.0,20.0
48507,4,8507,[197 357   7 211 118],13,3,31911,3.7507052186177714,20.0,0.0
48508,4,8508,[202 257 403 185 435],804,3,31914,3.7506169937713008,0.0,0.0
48509,4,8509,[322 435 748 200 265],881,2,31916,3.7504112808460635,0.0,0.0
48510,4,8510,[301   9 185 176   7],234,0,31916,3.7499706262483845,0.0,0.0
48511,4,8511,[302 603 100 427  64],339,5,31921,3.7501174812030076,20.0,20.0
48512,4,8512,[302 603 100 427  64],664,5,31926,3.75026430165629,20.0,20.0
48513,4,8513,[257  69 182 211 496],666,3,31929,3.7501761804087383,0.0,0.0
48514,4,8514,[257 121 273 237 322],749,2,31931,3.749970640046976,0.0,0.0
48515,4,8515,[286 174 181 265 300],537,0,31931,3.7495302959135746,0.0,20.0
48516,4,8516,[302 603 100 427  64],745,5,31936,3.749677116355524,20.0,20.0
48517,4,8517,[403 172 435 318 357],648,3,31939,3.749589105423808,40.0,0.0
48518,4,8518,[  8 289  71 202 265],92,3,31942,3.7495011151543607,0.0,0.0
48519,4,8519,[302 603 100 427  64],454,5,31947,3.7496478873239436,20.0,20.0
48520,4,8520,[405  69 318 175 191],474,5,31952,3.749794625044009,20.0,0.0
48521,4,8521,[ 71 191 132 121 144],650,2,31954,3.749589298286787,0.0,0.0
48522,4,8522,[ 71 435 194 183 286],648,3,31957,3.749501349290156,0.0,0.0
48523,4,8523,[275   1   7 282  15],637,2,31959,3.7492961051149694,0.0,0.0
48524,4,8524,[ 82 168 176 118 153],102,0,31959,3.7488563049853374,0.0,0.0
48525,4,8525,[ 50 228 257  64  96],533,5,31964,3.7490030494956605,0.0,20.0
48526,4,8526,[471  71 144 194  79],95,5,31969,3.7491497595871937,0.0,0.0
48527,4,8527,[302 603 100 427  64],745,5,31974,3.749296435272045,20.0,20.0
48528,4,8528,[ 56 151 405 187 215],7,4,31978,3.7493258295228045,0.0,0.0
48529,4,8529,[ 98 483   8 322  79],334,4,31982,3.7493552168815945,20.0,20.0
48530,4,8530,[215  88 121 302 204],454,5,31987,3.7495018169030594,0.0,0.0
48531,4,8531,[302 603 100 427  64],664,5,31992,3.749648382559775,20.0,20.0
48532,4,8532,[302 603 100 427  64],370,5,31997,3.749794913863823,20.0,20.0
48533,4,8533,[302 603 100 427  64],13,5,32002,3.749941410827279,20.0,20.0
48534,4,8534,[496  79 196  15 181],308,2,32004,3.7497363796133567,0.0,0.0
48535,4,8535,[678 191  15  89 276],474,4,32008,3.7497656982193064,0.0,0.0
48536,4,8536,[323  12 144 121 183],378,4,32012,3.7497950099566593,20.0,0.0
48537,4,8537,[302 603 100 427  64],271,5,32017,3.749941438275943,20.0,20.0
48538,4,8538,[228 328   8 313 195],234,2,32019,3.749736503103408,0.0,0.0
48539,4,8539,[405  28 318 237 111],474,5,32024,3.7498829039812644,20.0,0.0
48540,4,8540,[271  89 286  11 175],102,2,32026,3.749678023650626,0.0,0.0
48541,4,8541,[ 70 211 153  79 172],452,4,32030,3.7497073284944977,0.0,0.0
48542,4,8542,[ 95  97  28 423  64],290,4,32034,3.749736626477818,0.0,0.0
48543,4,8543,[302 603 100 427  64],13,5,32039,3.749882958801498,20.0,20.0
48544,4,8544,[ 98 228  28 234 176],899,4,32043,3.7499122293739027,0.0,20.0
48545,4,8545,[ 22 655  15 216 174],184,1,32044,3.7495904516732974,0.0,20.0
48546,4,8546,[302 603 100 427  64],454,5,32049,3.7497367497367495,20.0,20.0
48547,4,8547,[173 117 187  28 423],892,5,32054,3.7498830135704257,0.0,0.0
48548,4,8548,[  4  71 153  88 125],406,0,32054,3.749444379459586,0.0,0.0
48549,4,8549,[ 11 496 294 151 403],346,3,32057,3.7493567251461988,0.0,0.0
48550,4,8550,[515 294 405 435 143],194,3,32060,3.7492690913343467,0.0,0.0
48551,4,8551,[ 70 175 186 405 238],95,4,32064,3.7492984097287185,0.0,0.0
48552,4,8552,[294 323  98 173 300],13,1,32065,3.7489769671460307,0.0,20.0
48553,4,8553,[265 294 196 403 210],848,5,32070,3.7491232172083238,0.0,0.0
48554,4,8554,[302 603 100 427  64],339,5,32075,3.74926943308007,20.0,20.0
48555,4,8555,[496 294 100  79  12],271,4,32079,3.7492987377279103,20.0,20.0
48556,4,8556,[172 186 655 121 423],840,3,32082,3.7492111721397685,0.0,0.0
48557,4,8557,[153 216  95  25 275],125,2,32084,3.7490067772844125,0.0,0.0
48558,4,8558,[302 603 100 427  64],664,5,32089,3.7491529384273865,20.0,20.0
48559,4,8559,[125 183 117 144  69],398,4,32093,3.749182242990654,0.0,0.0
48560,4,8560,[ 82 174 168  64 483],524,3,32096,3.7490947319238406,20.0,20.0
48561,4,8561,[ 97 222 210 235   9],406,4,32100,3.749124036440084,0.0,0.0
48562,4,8562,[385 294 172 403  11],7,3,32103,3.7490365526100664,0.0,0.0
48563,4,8563,[496 742  95 597  56],200,5,32108,3.749182624941616,0.0,0.0
48564,4,8564,[302 603 100 427  64],458,5,32113,3.74932866316404,20.0,20.0
48565,4,8565,[161  98 181  28 196],64,4,32117,3.7493579266869017,0.0,20.0
48566,4,8566,[181 172 121 427 153],899,4,32121,3.7493871833780785,0.0,0.0
48567,4,8567,[ 11 180 742  56 135],59,4,32125,3.7494164332399627,0.0,0.0
48568,4,8568,[288 216 174 265 143],188,5,32130,3.7495623760065353,0.0,20.0
48569,4,8569,[423 202 135 175 172],97,5,32135,3.749708284714119,0.0,0.0
48570,4,8570,[117 288 210 132 286],119,5,32140,3.7498541593746353,0.0,0.0
48571,4,8571,[ 88 546  64 210  56],92,3,32143,3.749766682221185,0.0,0.0
48572,4,8572,[258 181 475 742 196],119,4,32147,3.749795870757028,0.0,0.0
48573,4,8573,[210 161 181 204  70],95,4,32151,3.7498250524842547,0.0,0.0
48574,4,8574,[302 603 100 427  64],271,5,32156,3.7499708454810494,20.0,20.0
48575,4,8575,[175 182 202  25  11],92,3,32159,3.7498833955223883,0.0,0.0
48576,4,8576,[302 603 100 427  64],664,5,32164,3.750029147720648,20.0,20.0
48577,4,8577,[ 25 435 289 357 276],82,3,32167,3.7499417113546283,20.0,0.0
48578,4,8578,[132 117 185 265 508],524,4,32171,3.7499708590744842,0.0,0.0
48579,4,8579,[ 22 427 180  56 269],7,4,32175,3.75,0.0,0.0
48580,4,8580,[194 179 191 318  88],234,3,32178,3.7499125975993475,20.0,0.0
48581,4,8581,[  9 385   1 265  82],92,4,32182,3.749941738522489,0.0,0.0
48582,4,8582,[302 603 100 427  64],339,5,32187,3.7500873820342537,20.0,20.0
48583,4,8583,[ 22 294 508 111 117],13,2,32189,3.749883504193849,0.0,0.0
48584,4,8584,[302 603 100 427  64],537,4,32193,3.7499126383226558,20.0,20.0
48585,4,8585,[ 82 403 127  70 216],184,3,32196,3.7498252969951085,0.0,20.0
48586,4,8586,[182 125 258 286 423],6,1,32197,3.7495050657971354,0.0,0.0
48587,4,8587,[ 97 265 174 200   1],815,5,32202,3.749650675360969,0.0,20.0
48588,4,8588,[385 742 405 269   4],666,2,32204,3.749446967050879,0.0,0.0
48589,4,8589,[313 238 172 275  56],883,4,32208,3.749476135040745,0.0,0.0
48590,4,8590,[228 508 186  15  88],653,2,32210,3.749272494470958,0.0,0.0
48591,4,8591,[515  50 423 127 286],524,5,32215,3.749418063314711,0.0,40.0
48592,4,8592,[483  70  71 100  69],398,4,32219,3.749447224485046,20.0,20.0
48593,4,8593,[172 322 603 125 204],334,2,32221,3.7492436583663022,20.0,0.0
48594,4,8594,[302 603 100 427  64],664,5,32226,3.749389179755672,20.0,20.0
48595,4,8595,[302 603 100 427  64],458,5,32231,3.74953466728711,20.0,20.0
48596,4,8596,[302 603 100 427  64],90,5,32236,3.749680120972432,20.0,20.0
48597,4,8597,[302 603 100 427  64],271,5,32241,3.7498255408234473,20.0,20.0
48598,4,8598,[302 603 100 427  64],13,5,32246,3.7499709268519594,20.0,20.0
48599,4,8599,[237 265 127  89 405],7,4,32250,3.75,0.0,20.0
48600,4,8600,[302 603 100 427  64],339,5,32255,3.7501453319381466,20.0,20.0
48601,4,8601,[328 300  11   4 258],378,2,32257,3.7499418739827948,0.0,0.0
48602,4,8602,[302 603 100 427  64],271,5,32262,3.7500871788910843,20.0,20.0
48603,4,8603,[496   7 196 318 678],804,5,32267,3.750232450023245,20.0,0.0
48604,4,8604,[357  97   7 185 234],537,3,32270,3.7501452643811737,20.0,0.0
48605,4,8605,[302 603 100 427  64],537,4,32274,3.7501742970020917,20.0,20.0
48606,4,8606,[471  98 118 196 357],343,4,32278,3.7502033228767284,20.0,20.0
48607,4,8607,[568 483 172 182  97],892,5,32283,3.7503485130111525,20.0,0.0
48608,4,8608,[302 603 100 427  64],537,4,32287,3.750377511906145,20.0,20.0
48609,4,8609,[655 127 222 151  88],815,3,32290,3.7502903600464577,0.0,20.0
48610,4,8610,[121 222 100 117 151],339,3,32293,3.750203228428754,0.0,20.0
48611,4,8611,[235 435 135 121  88],897,2,32295,3.75,0.0,0.0
48612,4,8612,[294 195 588 222  69],200,5,32300,3.750145129455474,0.0,0.0
48613,4,8613,[191 235 175 151 258],378,4,32304,3.75017413512886,0.0,0.0
48614,4,8614,[302 603 100 427  64],271,5,32309,3.750319210679048,20.0,20.0
48615,4,8615,[302 603 100 427  64],537,4,32313,3.7503481894150417,20.0,20.0
48616,4,8616,[302 603 100 427  64],664,5,32318,3.7504932110943483,20.0,20.0
48617,4,8617,[748  95  56 403 127],804,1,32319,3.750174054304943,0.0,20.0
48618,4,8618,[197 186 588 471 597],899,3,32322,3.7500870170553426,0.0,0.0
48619,4,8619,[ 69 328 168 238  28],833,1,32323,3.749767981438515,0.0,0.0
48620,4,8620,[143 357  69 174 172],843,1,32324,3.749449019835286,20.0,20.0
48621,4,8621,[185 182 204 173 186],7,5,32329,3.7495940617026213,0.0,0.0
48622,4,8622,[ 11  98 216  64   1],804,5,32334,3.7497390699292588,0.0,20.0
48623,4,8623,[405  69 194  11 237],378,2,32336,3.749536178107607,0.0,0.0
48624,4,8624,[ 28 132  56 216 301],210,5,32341,3.7496811594202897,0.0,0.0
48625,4,8625,[302 603 100 427  64],458,5,32346,3.7498261071180155,20.0,20.0
48626,4,8626,[302 603 100 427  64],666,5,32351,3.7499710212124726,20.0,20.0
48627,4,8627,[183   4 143 181  22],194,2,32353,3.7497681965693093,0.0,0.0
48628,4,8628,[302 603 100 427  64],271,5,32358,3.749913083787229,20.0,20.0
48629,4,8629,[ 88 176 210 385 265],13,2,32360,3.749710312862109,0.0,0.0
48630,4,8630,[302 603 100 427  64],90,5,32365,3.7498551732128376,20.0,20.0
48631,4,8631,[405 121 276  15 151],892,5,32370,3.75,0.0,0.0
48632,4,8632,[275  12 187 182  22],334,4,32374,3.750028958647052,20.0,0.0
48633,4,8633,[302 603 100 427  64],13,5,32379,3.7501737317581654,20.0,20.0
48634,4,8634,[204 294 175 135  98],379,4,32383,3.7502026635784595,0.0,20.0
48635,4,8635,[ 69 197 204 269  28],312,5,32388,3.7503473830477074,0.0,0.0
48636,4,8636,[ 70 234 275 603  98],233,5,32393,3.7504920690054417,20.0,20.0
48637,4,8637,[195 151  69 176  11],387,1,32394,3.7501736513081734,0.0,0.0
48638,4,8638,[117   7  82 288 161],200,5,32399,3.750318323880079,0.0,0.0
48639,4,8639,[215 100 200 333 183],653,3,32402,3.7502314814814817,0.0,20.0
48640,4,8640,[194 216  64 265 289],95,3,32405,3.750144659182965,0.0,0.0
48641,4,8641,[302 603 100 427  64],90,5,32410,3.7502892848877574,20.0,20.0
48642,4,8642,[238 179  70 257 403],479,3,32413,3.750202475992132,0.0,0.0
48643,4,8643,[173 127 234 197 151],189,5,32418,3.7503470615455807,0.0,20.0
48644,4,8644,[302 603 100 427  64],664,5,32423,3.7504916136495083,20.0,20.0
48645,4,8645,[496   8 211 191  71],194,4,32427,3.7505204718945175,0.0,0.0
48646,4,8646,[258 313 211 132 117],454,2,32429,3.7503180293743497,0.0,0.0
48647,4,8647,[258  79 179 144 742],666,2,32431,3.7501156336725257,0.0,0.0
48648,4,8648,[111 117 483 496  98],648,4,32435,3.7501445253786563,20.0,20.0
48649,4,8649,[435 546 143 515 483],666,4,32439,3.7501734104046243,20.0,0.0
48650,4,8650,[603  79 273 546  89],7,4,32443,3.7502022887527455,20.0,0.0
48651,4,8651,[161  12  70 144  22],543,4,32447,3.750231160425335,20.0,0.0
48652,4,8652,[546 181 216 588 196],378,4,32451,3.750260025424708,0.0,0.0
48653,4,8653,[302 603 100 427  64],664,5,32456,3.7504044372544487,20.0,20.0
48654,4,8654,[ 89 288 180 153 197],378,2,32458,3.7502021952628537,0.0,0.0
48655,4,8655,[173 179 238 496 127],666,5,32463,3.7503465804066543,0.0,20.0
48656,4,8656,[111 603 328 191 268],13,3,32466,3.750259905278965,20.0,0.0
48657,4,8657,[302 603 100 427  64],458,5,32471,3.7504042504042503,20.0,20.0
48658,4,8658,[597  22 117 385 328],378,2,32473,3.7502021018593372,0.0,0.0
48659,4,8659,[294 143 603 197  50],298,4,32477,3.7502309468822173,20.0,20.0
48660,4,8660,[  4  64   1   8 144],13,4,32481,3.7502597852441983,0.0,0.0
48661,4,8661,[302 603 100 427  64],90,5,32486,3.750404063726622,20.0,20.0
48662,4,8662,[302 603 100 427  64],90,5,32491,3.750548308899919,20.0,20.0
48663,4,8663,[302 603 100 427  64],745,5,32496,3.7506925207756234,20.0,20.0
48664,4,8664,[302 603 100 427  64],90,5,32501,3.7508366993652626,20.0,20.0
48665,4,8665,[271  71 423 174 143],13,3,32504,3.750750057696746,0.0,20.0
48666,4,8666,[302 603 100 427  64],370,5,32509,3.7508941963770623,20.0,20.0
48667,4,8667,[302 603 100 427  64],339,5,32514,3.7510383017997233,20.0,20.0
48668,4,8668,[405 258   7 318 196],653,1,32515,3.7507209597416082,20.0,0.0
48669,4,8669,[323 385  28 265  69],200,4,32519,3.7507497116493655,0.0,0.0
48670,4,8670,[111 191  70 194 318],653,2,32521,3.750547803021566,20.0,0.0
48671,4,8671,[302 603 100 427  64],13,5,32526,3.750691881918819,20.0,20.0
48672,4,8672,[302 603 100 427  64],271,5,32531,3.7508359275913756,20.0,20.0
48673,4,8673,[405   4  82 117  12],455,1,32532,3.750518791791561,20.0,0.0
48674,4,8674,[222 143 300 655 186],749,4,32536,3.7505475504322767,0.0,0.0
48675,4,8675,[187 269 191 385 603],659,5,32541,3.750691562932227,20.0,0.0
48676,4,8676,[301   9  71 405 125],6,2,32543,3.750489800622335,0.0,0.0
48677,4,8677,[191 318 175 603 678],664,3,32546,3.7504033187370363,40.0,0.0
48678,4,8678,[302 603 100 427  64],474,5,32551,3.750547298075815,20.0,20.0
48679,4,8679,[318  64 181  95 588],308,5,32556,3.7506912442396314,20.0,0.0
48680,4,8680,[515 180  12 144 132],892,5,32561,3.7508351572399494,20.0,0.0
48681,4,8681,[302 603 100 427  64],90,5,32566,3.7509790370882286,20.0,20.0
48682,4,8682,[175  70 202 333 237],537,2,32568,3.750777381089485,0.0,0.0
48683,4,8683,[ 56 175 273 222  22],387,5,32573,3.7509212344541685,0.0,0.0
48684,4,8684,[ 79 176   1  50 185],398,5,32578,3.7510650546919977,0.0,20.0
48685,4,8685,[215 289  95 117 181],406,3,32581,3.750978586230716,0.0,0.0
48686,4,8686,[286 197 515 288 268],7,3,32584,3.750892137676989,0.0,0.0
48687,4,8687,[ 82 300 257 423  22],454,5,32589,3.75103591160221,0.0,0.0
48688,4,8688,[183 135  22 405  25],749,4,32593,3.7510645643917595,0.0,0.0
48689,4,8689,[302 603 100 427  64],13,5,32598,3.7512082853855007,20.0,20.0
48690,4,8690,[204 183 211 257 435],339,4,32602,3.7512369117477853,0.0,0.0
48691,4,8691,[302 603 100 427  64],458,5,32607,3.7513805798435342,20.0,20.0
48692,4,8692,[300 568  28 197 127],210,5,32612,3.75152421488554,0.0,20.0
48693,4,8693,[175 238  56  95  50],308,5,32617,3.7516678168852082,0.0,20.0
48694,4,8694,[204 238 318 195 405],406,3,32620,3.751581368602645,20.0,0.0
48695,4,8695,[302 603 100 427  64],454,5,32625,3.75172493100276,20.0,20.0
48696,4,8696,[235  12 210  50 197],378,4,32629,3.7517534782108775,20.0,20.0
48697,4,8697,[318 182 172 597 187],144,4,32633,3.751782018854909,20.0,0.0
48698,4,8698,[302 603 100 427  64],537,4,32637,3.751810552937119,20.0,20.0
48699,4,8699,[302 603 100 427  64],370,5,32642,3.7519540229885058,20.0,20.0
48700,4,8700,[ 71 127 238 275 181],85,3,32645,3.7518676014251238,0.0,20.0
48701,4,8701,[238 135  56  89 435],897,2,32647,3.7516662836129626,0.0,0.0
48702,4,8702,[215 496 127 185 172],848,2,32649,3.751465012064805,0.0,20.0
48703,4,8703,[655  70  11 215 117],328,3,32652,3.7513786764705883,0.0,0.0
48704,4,8704,[302 603 100 427  64],13,5,32657,3.751522113727743,20.0,20.0
48705,4,8705,[302 603 100 427  64],458,5,32662,3.75166551803354,20.0,20.0
48706,4,8706,[302 603 100 427  64],458,5,32667,3.7518088893993338,20.0,20.0
48707,4,8707,[121 427  64  89 237],454,4,32671,3.751837390904915,0.0,0.0
48708,4,8708,[135 403 202 603 294],379,4,32675,3.7518658858651968,20.0,0.0
48709,4,8709,[211 180 357 121  88],749,4,32679,3.751894374282434,20.0,0.0
48710,4,8710,[ 88 385 135 322 204],313,3,32682,3.75180805877626,0.0,0.0
48711,4,8711,[302 603 100 427  64],745,5,32687,3.751951331496786,20.0,20.0
48712,4,8712,[ 88 423 288 273  82],892,4,32691,3.751979800298405,0.0,0.0
48713,4,8713,[153 211 357 435 318],313,4,32695,3.752008262565986,40.0,0.0
48714,4,8714,[185 179 186 403 100],374,3,32698,3.7519219736087206,0.0,20.0
48715,4,8715,[496   1 125  70 258],6,2,32700,3.7517209729233594,0.0,0.0
48716,4,8716,[302 603 100 427  64],474,5,32705,3.75186417345417,20.0,20.0
48717,4,8717,[302 603 100 427  64],537,4,32709,3.751892635925671,20.0,20.0
48718,4,8718,[302 603 100 427  64],370,5,32714,3.7520357839201743,20.0,20.0
48719,4,8719,[179 186 427 302 475],339,5,32719,3.7521788990825686,0.0,0.0
48720,4,8720,[118 271 289  50 234],13,3,32722,3.7520926499254674,0.0,20.0
48721,4,8721,[302 603 100 427  64],454,5,32727,3.7522357257509746,20.0,20.0
48722,4,8722,[302 603 100 427  64],474,5,32732,3.7523787687722114,20.0,20.0
48723,4,8723,[302 603 100 427  64],339,5,32737,3.7525217790004586,20.0,20.0
48724,4,8724,[678 174 180 195 187],474,4,32741,3.752550143266476,0.0,20.0
48725,4,8725,[471  89 216 265 515],543,4,32745,3.7525785010314006,0.0,0.0
48726,4,8726,[603 269 127 678  97],537,2,32747,3.7523776784691187,20.0,20.0
48727,4,8727,[313 357 174 182 121],533,3,32750,3.7522914757103574,20.0,20.0
48728,4,8728,[ 98 191  79 475 143],343,5,32755,3.7524344140222246,0.0,20.0
48729,4,8729,[ 82 174 185 568 182],897,5,32760,3.752577319587629,0.0,20.0
48730,4,8730,[235 357  96 234 323],650,3,32763,3.7524911235826366,20.0,0.0
48731,4,8731,[302 603 100 427  64],537,4,32767,3.7525194686211636,20.0,20.0
48732,4,8732,[132  79 153 475 111],64,4,32771,3.7525478071682126,0.0,0.0
48733,4,8733,[302 603 100 427  64],339,5,32776,3.752690634302725,20.0,20.0
48734,4,8734,[385 176 403 228  11],643,3,32779,3.7526044647967947,0.0,0.0
48735,4,8735,[194 423 183 182 318],207,3,32782,3.7525183150183152,20.0,0.0
48736,4,8736,[132 546 161 435  82],290,2,32784,3.752317729197665,0.0,0.0
48737,4,8737,[302 603 100 427  64],458,5,32789,3.7524605172808423,20.0,20.0
48738,4,8738,[135 185  22  82 385],788,2,32791,3.7522599839798603,0.0,0.0
48739,4,8739,[196 357 143  98 118],653,1,32792,3.751945080091533,20.0,20.0
48740,4,8740,[742  69  64 211 496],271,4,32796,3.751973458414369,0.0,0.0
48741,4,8741,[302 603 100 427  64],339,5,32801,3.752116220544498,20.0,20.0
48742,4,8742,[238 471 211 202  28],207,2,32803,3.751915818368981,0.0,0.0
48743,4,8743,[302 603 100 427  64],458,5,32808,3.7520585544373284,20.0,20.0
48744,4,8744,[333 143 322 197 748],533,4,32812,3.752086906803888,0.0,0.0
48745,4,8745,[294 234  11 257 276],474,3,32815,3.7520009147038644,0.0,0.0
48746,4,8746,[132  95 496 173 117],749,4,32819,3.752029267177318,0.0,0.0
48747,4,8747,[121 269 588 181  82],254,2,32821,3.7518289894833106,0.0,0.0
48748,4,8748,[204 508 318 196 258],455,4,32825,3.7518573551263,20.0,0.0
48749,4,8749,[ 98  97  11 182 508],474,4,32829,3.7518857142857143,0.0,20.0
48750,4,8750,[ 97 161 288 211 182],13,4,32833,3.7519140669637756,0.0,0.0
48751,4,8751,[302 603 100 427  64],13,5,32838,3.752056672760512,20.0,20.0
48752,4,8752,[135 211 546 180 294],194,2,32840,3.7518565063406832,0.0,0.0
48753,4,8753,[294   8 508 179  28],92,3,32843,3.7517706191455336,0.0,0.0
48754,4,8754,[302 603 100 427  64],370,5,32848,3.7519131924614504,20.0,20.0
48755,4,8755,[127 269 273  70 191],524,4,32852,3.7519415258108726,0.0,20.0
48756,4,8756,[234  28 172 483  82],897,4,32856,3.7519698526892773,20.0,0.0
48757,4,8757,[173 496 288 202  95],648,4,32860,3.751998173098881,0.0,0.0
48758,4,8758,[ 64  88  12 183 568],339,4,32864,3.7520264870418996,20.0,0.0
48759,4,8759,[ 71   8 176 191 202],311,5,32869,3.7521689497716895,0.0,0.0
48760,4,8760,[168  50 483  71 405],295,5,32874,3.7523113799794543,20.0,20.0
48761,4,8761,[318   8 423 180 228],87,4,32878,3.752339648482082,20.0,0.0
48762,4,8762,[678 100 117 427  28],13,3,32881,3.752253794362661,0.0,20.0
48763,4,8763,[132 603 186   1   7],13,3,32884,3.7521679598356914,20.0,0.0
48764,4,8764,[302 603 100 427  64],537,4,32888,3.75219623502567,20.0,20.0
48765,4,8765,[318  88 173 121  22],92,1,32889,3.7518822724161534,20.0,0.0
48766,4,8766,[302 603 100 427  64],664,5,32894,3.75202463784647,20.0,20.0
48767,4,8767,[302 603 100 427  64],537,4,32898,3.7520529197080292,20.0,20.0
48768,4,8768,[183  88 121 403 215],194,0,32898,3.7516250427642834,0.0,0.0
48769,4,8769,[597  15 258  25 276],168,3,32901,3.751539338654504,0.0,0.0
48770,4,8770,[234   1  50 153 238],13,3,32904,3.7514536540873333,0.0,20.0
48771,4,8771,[168 323 275 211 191],648,5,32909,3.7515959872321023,0.0,0.0
48772,4,8772,[318 216 121 742 195],804,5,32914,3.7517382879288728,20.0,0.0
48773,4,8773,[302 603 100 427  64],271,5,32919,3.7518805561887394,20.0,20.0
48774,4,8774,[ 50 174 121 185  96],189,4,32923,3.751908831908832,0.0,40.0
48775,4,8775,[302 603 100 427  64],537,4,32927,3.75193710118505,20.0,20.0
48776,4,8776,[302 603 100 427  64],537,4,32931,3.7519653640195965,20.0,20.0
48777,4,8777,[302 603 100 427  64],664,5,32936,3.7521075415812257,20.0,20.0
48778,4,8778,[ 69 174 118 183 186],648,4,32940,3.7521357785624785,0.0,20.0
48779,4,8779,[302 603 100 427  64],454,5,32945,3.752277904328018,20.0,20.0
48780,4,8780,[275   7 195 471  89],95,3,32948,3.7521922332308395,0.0,0.0
48781,4,8781,[302 603 100 427  64],13,5,32953,3.75233432020041,20.0,20.0
48782,4,8782,[603 265 135 237 271],890,2,32955,3.7521348058749857,20.0,0.0
48783,4,8783,[222 288 275 301 111],13,1,32956,3.7518214936247722,0.0,0.0
48784,4,8784,[302 603 100 427  64],664,5,32961,3.751963574274331,20.0,20.0
48785,4,8785,[202  79 294   9 496],308,3,32964,3.751877987707717,0.0,0.0
48786,4,8786,[286 100 181 301 294],743,2,32966,3.7516786161374758,0.0,20.0
48787,4,8787,[111 328 100 258  25],92,2,32968,3.7514792899408285,0.0,20.0
48788,4,8788,[121 333 180  22 271],537,1,32969,3.751166230515417,0.0,0.0
48789,4,8789,[118 300 153   8 143],13,3,32972,3.751080773606371,0.0,0.0
48790,4,8790,[197 322  71 161 179],13,3,32975,3.7509953361392334,0.0,0.0
48791,4,8791,[237 196 322 269 161],207,4,32979,3.7510236578707916,0.0,0.0
48792,4,8792,[135  28  71 257 265],474,4,32983,3.7510519731604686,0.0,0.0
48793,4,8793,[302 603 100 427  64],745,5,32988,3.7511939959063,20.0,20.0
48794,4,8794,[748 183  82 180 515],882,5,32993,3.751335986355884,0.0,0.0
48795,4,8795,[ 82 286 323  12  71],455,2,32995,3.751136880400182,20.0,0.0
48796,4,8796,[  7 423 210 403 195],524,2,32997,3.750937819711265,0.0,0.0
48797,4,8797,[197  89 258  50  28],774,1,32998,3.750625142077745,0.0,20.0
48798,4,8798,[  8 475 111  89  22],474,5,33003,3.7507671326287078,0.0,0.0
48799,4,8799,[127  89 161 269  71],452,4,33007,3.7507954545454547,0.0,20.0
48800,4,8800,[ 70 322 265 273  56],328,3,33010,3.750710146574253,0.0,0.0
48801,4,8801,[121  50 405 289 678],852,2,33012,3.7505112474437627,0.0,20.0
48802,4,8802,[172 328  64 180 435],788,3,33015,3.7504259911393842,0.0,0.0
48803,4,8803,[302 603 100 427  64],745,5,33020,3.7505679236710585,20.0,20.0
48804,4,8804,[435 161  98  69 172],643,2,33022,3.7503691084611015,0.0,20.0
48805,4,8805,[302 603 100 427  64],458,5,33027,3.7505110152168974,20.0,20.0
48806,4,8806,[200 100  95 143 483],334,3,33030,3.7504257976609514,20.0,20.0
48807,4,8807,[302 603 100 427  64],666,5,33035,3.7505676657584015,20.0,20.0
48808,4,8808,[234 175 275 215  56],60,5,33040,3.750709501646044,0.0,0.0
48809,4,8809,[300 294 288 194 655],102,0,33040,3.750283768444949,0.0,0.0
48810,4,8810,[302 603 100 427  64],90,5,33045,3.7504256043581887,20.0,20.0
48811,4,8811,[179 168 288 211 185],308,5,33050,3.750567408079891,0.0,0.0
48812,4,8812,[423  97 168 276  22],59,5,33055,3.7507091796210146,0.0,0.0
48813,4,8813,[302 603 100 427  64],664,5,33060,3.750850918992512,20.0,20.0
48814,4,8814,[655 748 258 100  97],64,2,33062,3.7506522972206464,0.0,20.0
48815,4,8815,[286 323 597 405 215],200,3,33065,3.7505671506352085,0.0,0.0
48816,4,8816,[302 603 100 427  64],339,5,33070,3.7507088578881707,20.0,20.0
48817,4,8817,[427 151 385 597 204],650,3,33073,3.750623724200499,0.0,0.0
48818,4,8818,[302 603 100 427  64],90,5,33078,3.7507653929016898,20.0,20.0
48819,4,8819,[271 235 655   4 222],92,3,33081,3.7506802721088435,0.0,0.0
48820,4,8820,[ 82  71 191 228 588],454,2,33083,3.7504818047840383,0.0,0.0
48821,4,8821,[302 603 100 427  64],90,5,33088,3.7506234413965087,20.0,20.0
48822,4,8822,[302 603 100 427  64],474,5,33093,3.750765045902754,20.0,20.0
48823,4,8823,[127  82 328 173 180],537,3,33096,3.7506799637352675,0.0,20.0
48824,4,8824,[ 98 258 175 282 172],788,3,33099,3.7505949008498582,0.0,20.0
48825,4,8825,[216 222 276 333 423],537,1,33100,3.7502832540222073,0.0,0.0
48826,4,8826,[302 603 100 427  64],474,5,33105,3.7504248328990597,20.0,20.0
48827,4,8827,[302 603 100 427  64],339,5,33110,3.7505663797009516,20.0,20.0
48828,4,8828,[302 603 100 427  64],339,5,33115,3.7507078944387815,20.0,20.0
48829,4,8829,[302 603 100 427  64],370,5,33120,3.750849377123443,20.0,20.0
48830,4,8830,[210 318 475  95 405],537,2,33122,3.750651115388971,20.0,0.0
48831,4,8831,[197 258 568 153 333],387,2,33124,3.7504528985507246,0.0,0.0
48832,4,8832,[568 275 234 125 222],311,5,33129,3.750594362051398,0.0,0.0
48833,4,8833,[302 603 100 427  64],271,5,33134,3.750735793525017,20.0,20.0
48834,4,8834,[118 294  96  88 423],897,4,33138,3.7507640067911714,0.0,0.0
48835,4,8835,[403  70 357 286  69],234,2,33140,3.750565866908103,20.0,0.0
48836,4,8836,[118 678 204  98 748],13,4,33144,3.7505940930179924,0.0,20.0
48837,4,8837,[333 385 258 195 588],64,3,33147,3.75050916496945,0.0,0.0
48838,4,8838,[302 603 100 427  64],666,5,33152,3.7506505260776106,20.0,20.0
48839,4,8839,[186 143 168  28 194],194,4,33156,3.750678733031674,0.0,0.0
48840,4,8840,[302 603 100 427  64],13,5,33161,3.7508200429815632,20.0,20.0
48841,4,8841,[515 357 174 175 100],184,3,33164,3.7507351277991403,20.0,40.0
48842,4,8842,[ 82 161  98  89 603],13,4,33168,3.7507633156168723,20.0,20.0
48843,4,8843,[ 50 496 121 234 161],454,4,33172,3.750791497060154,0.0,20.0
48844,4,8844,[302 603 100 427  64],454,5,33177,3.7509327303561335,20.0,20.0
48845,4,8845,[  7 172  70 385 275],158,4,33181,3.750960886276283,0.0,0.0
48846,4,8846,[302 603 100 427  64],745,5,33186,3.751102068497796,20.0,20.0
48847,4,8847,[423 515  95 100 234],804,3,33189,3.751017179023508,0.0,20.0
48848,4,8848,[121 496 222 423 235],64,4,33193,3.7510453158548986,0.0,0.0
48849,4,8849,[405  50 215 216 180],144,5,33198,3.7511864406779662,0.0,20.0
48850,4,8850,[313 173  50  22 211],14,3,33201,3.7511015704440176,0.0,20.0
48851,4,8851,[135 655  82 435 238],848,4,33205,3.751129688206055,0.0,0.0
48852,4,8852,[153 313 546  70 475],64,3,33208,3.751044843555857,0.0,0.0
48853,4,8853,[302 603 100 427  64],454,5,33213,3.751185904675853,20.0,20.0
48854,4,8854,[172 235 161 173 273],479,3,33216,3.7511010728402034,0.0,0.0
48855,4,8855,[405 121 191 132 313],92,3,33219,3.7510162601626016,0.0,0.0
48856,4,8856,[385  50 271 151  69],650,2,33221,3.750818561589703,0.0,20.0
48857,4,8857,[  1 135 234 508 655],537,2,33223,3.750620907654098,0.0,0.0
48858,4,8858,[302 603 100 427  64],666,5,33228,3.750761937013207,20.0,20.0
48859,4,8859,[234 405 655 222 245],328,4,33232,3.7507900677200903,0.0,0.0
48860,4,8860,[302 603 100 427  64],537,4,33236,3.7508181920776438,20.0,20.0
48861,4,8861,[302 603 100 427  64],370,5,33241,3.750959151433085,20.0,20.0
48862,4,8862,[  8 100 195 204 357],311,4,33245,3.750987250366693,20.0,20.0
48863,4,8863,[302 603 100 427  64],370,5,33250,3.7511281588447654,20.0,20.0
48864,4,8864,[302 603 100 427  64],339,5,33255,3.751269035532995,20.0,20.0
48865,4,8865,[200  98 245 655 288],92,3,33258,3.7511842995713964,0.0,20.0
48866,4,8866,[435 228   9 125  64],234,1,33259,3.750874027292207,0.0,0.0
48867,4,8867,[173  56 423 323   4],59,5,33264,3.7510148849797025,0.0,0.0
48868,4,8868,[427 265   1 151 135],650,3,33267,3.7509302063366783,0.0,0.0
48869,4,8869,[546 748 323 597 153],788,0,33267,3.7505073280721533,0.0,0.0
48870,4,8870,[496 258   7 196  89],650,4,33271,3.750535452598354,0.0,0.0
48871,4,8871,[302 603 100 427  64],90,5,33276,3.7506762849413886,20.0,20.0
48872,4,8872,[174  56  71 186 127],738,4,33280,3.750704384086555,0.0,40.0
48873,4,8873,[302 603 100 427  64],370,5,33285,3.7508451656524677,20.0,20.0
48874,4,8874,[302 603 100 427  64],537,4,33289,3.7508732394366198,20.0,20.0
48875,4,8875,[216 197  70 655 275],64,4,33293,3.7509013068949977,0.0,0.0
48876,4,8876,[215 271 435 385 423],749,4,33297,3.7509293680297398,0.0,0.0
48877,4,8877,[179 423  50  89  56],311,4,33301,3.7509574228429825,0.0,20.0
48878,4,8878,[302 603 100 427  64],458,5,33306,3.7510980966325036,20.0,20.0
48879,4,8879,[286 275 118 245  50],533,4,33310,3.751126126126126,0.0,20.0
48880,4,8880,[238 100 322 191  98],454,2,33312,3.7509289494426303,0.0,40.0
48881,4,8881,[ 69 405 483 655 181],848,4,33316,3.7509569916685432,20.0,0.0
48882,4,8882,[302 603 100 427  64],474,5,33321,3.751097602161432,20.0,20.0
48883,4,8883,[302 603 100 427  64],13,5,33326,3.75123818099955,20.0,20.0
48884,4,8884,[269 127 258 228 568],85,2,33328,3.751041080472707,0.0,20.0
48885,4,8885,[ 79 322 216 271 132],328,2,33330,3.7508440243079,0.0,0.0
48886,4,8886,[172  98 286 197  50],85,5,33335,3.7509845842241476,0.0,40.0
48887,4,8887,[ 69  22 191 322 546],881,4,33339,3.751012601260126,0.0,0.0
48888,4,8888,[176 289 161  79  82],378,5,33344,3.7511531105861176,0.0,0.0
48889,4,8889,[475  89 197  71  69],13,4,33348,3.751181102362205,0.0,0.0
48890,4,8890,[302 603 100 427  64],537,4,33352,3.7512090878416378,20.0,20.0
48891,4,8891,[271 258 235 238 323],537,2,33354,3.751012145748988,0.0,0.0
48892,4,8892,[118 144   1   9 180],194,3,33357,3.7509276959406272,0.0,0.0
48893,4,8893,[302 603 100 427  64],90,5,33362,3.7510681358219022,20.0,20.0
48894,4,8894,[328 210 180  88 100],271,4,33366,3.751096121416526,0.0,20.0
48895,4,8895,[302 603 100 427  64],458,5,33371,3.751236510791367,20.0,20.0
48896,4,8896,[ 15 121 568   4 357],648,2,33373,3.7510396762953806,20.0,0.0
48897,4,8897,[265 588  79  98 172],295,5,33378,3.75118004045853,0.0,20.0
48898,4,8898,[197 328 435 204 483],537,2,33380,3.750983256545679,20.0,0.0
48899,4,8899,[143 196 127 186 405],804,3,33383,3.7508988764044946,0.0,20.0
48900,4,8900,[302 603 100 427  64],454,5,33388,3.7510392090776317,20.0,20.0
48901,4,8901,[302 603 100 427  64],370,5,33393,3.751179510222422,20.0,20.0
48902,4,8902,[ 98  82 191  95 546],295,5,33398,3.751319779849489,0.0,20.0
48903,4,8903,[176 568 546   7 257],455,3,33401,3.7512353998203056,0.0,0.0
48904,4,8904,[125 282 118 183 286],455,3,33404,3.7511510387422797,0.0,0.0
48905,4,8905,[204  25 118 216  71],194,2,33406,3.750954412755446,0.0,0.0
48906,4,8906,[202 132 135 197 515],64,4,33410,3.7509823734141685,0.0,0.0
48907,4,8907,[195 235 135  50  64],339,3,33413,3.7508980691513245,0.0,20.0
48908,4,8908,[275 127 183 300 176],13,2,33415,3.7507015377707935,0.0,20.0
48909,4,8909,[200  96  71 176 385],479,3,33418,3.7506172839506173,0.0,0.0
48910,4,8910,[289 175 302 180 181],378,4,33422,3.750645269891146,0.0,0.0
48911,4,8911,[ 71  95  98 405 496],524,0,33422,3.7502244165170557,0.0,20.0
48912,4,8912,[179 211  88  11  79],749,5,33427,3.7503646359250533,0.0,0.0
48913,4,8913,[302 603 100 427  64],454,5,33432,3.7505048238725602,20.0,20.0
48914,4,8914,[ 79  70 118  11 471],666,3,33435,3.7504206393718453,0.0,0.0
48915,4,8915,[182 121  89 597 200],897,5,33440,3.750560789591745,0.0,0.0
48916,4,8916,[197 121 172  96 161],7,4,33444,3.750588763036896,0.0,0.0
48917,4,8917,[302 603 100 427  64],666,5,33449,3.750728862973761,20.0,20.0
48918,4,8918,[202 118 210 483 435],59,5,33454,3.750868931494562,20.0,0.0
48919,4,8919,[294   1  97 471 238],378,2,33456,3.75067264573991,0.0,0.0
48920,4,8920,[185 245  22 216 118],804,5,33461,3.750812689160408,0.0,0.0
48921,4,8921,[302 603 100 427  64],474,5,33466,3.7509527011880746,20.0,20.0
48922,4,8922,[302 603 100 427  64],474,5,33471,3.7510926818334642,20.0,20.0
48923,4,8923,[118 282 471 289 176],374,4,33475,3.751120573733752,0.0,0.0
48924,4,8924,[202 435 215 282  79],406,1,33476,3.750812324929972,0.0,0.0
48925,4,8925,[238 121 257 151 427],650,2,33478,3.7506161774591082,0.0,0.0
48926,4,8926,[678  70   7 423 121],554,3,33481,3.750532093648482,0.0,0.0
48927,4,8927,[302 603 100 427  64],370,5,33486,3.7506720430107525,20.0,20.0
48928,4,8928,[ 82 515 196 235 228],537,1,33487,3.7503639825288384,0.0,0.0
48929,4,8929,[127 405 237 210 174],537,1,33488,3.7500559910414335,0.0,40.0
48930,4,8930,[403 318 435 405 144],7,4,33492,3.750083977158213,20.0,0.0
48931,4,8931,[196 210 423  11 200],13,2,33494,3.749888042991491,0.0,0.0
48932,4,8932,[ 88  64 202 161 333],881,3,33497,3.7498040971678046,0.0,0.0
48933,4,8933,[302 603 100 427  64],666,5,33502,3.7499440340273114,20.0,20.0
48934,4,8934,[174 132 151 153  69],890,4,33506,3.749972020145495,0.0,20.0
48935,4,8935,[ 98 228 195 385 151],234,1,33507,3.749664279319606,0.0,20.0
48936,4,8936,[302 603 100 427  64],474,5,33512,3.749804184849502,20.0,20.0
48937,4,8937,[678 117  64 435 234],455,3,33515,3.7497202953680913,0.0,0.0
48938,4,8938,[302 603 100 427  64],664,5,33520,3.7498601633292314,20.0,20.0
48939,4,8939,[ 69  97 191 194 195],458,2,33522,3.7496644295302013,0.0,0.0
48940,4,8940,[405  12  69 238 215],343,5,33527,3.749804272452746,20.0,0.0
48941,4,8941,[186  50 118  28 483],194,3,33530,3.7497204204875865,20.0,20.0
48942,4,8942,[302 603 100 427  64],271,5,33535,3.7498602258749862,20.0,20.0
48943,4,8943,[173  97 174   9  28],271,5,33540,3.75,0.0,20.0
48944,4,8944,[302 603 100 427  64],666,5,33545,3.7501397428731136,20.0,20.0
48945,4,8945,[597 172   9   8 483],200,5,33550,3.7502794545048066,20.0,0.0
48946,4,8946,[286 181 143 185 333],653,3,33553,3.750195596289259,0.0,0.0
48947,4,8947,[ 89 174 286 191 211],234,1,33554,3.749888243182834,0.0,20.0
48948,4,8948,[302 603 100 427  64],458,5,33559,3.750027936082244,20.0,20.0
48949,4,8949,[181 286 127  89 185],385,3,33562,3.7499441340782123,0.0,20.0
48950,4,8950,[302 603 100 427  64],370,5,33567,3.750083789520724,20.0,20.0
48951,4,8951,[302 603 100 427  64],13,5,33572,3.7502234137622876,20.0,20.0
48952,4,8952,[228 235 161 245 294],328,2,33574,3.7500279236010274,0.0,0.0
48953,4,8953,[302 603 100 427  64],13,5,33579,3.7501675228947957,20.0,20.0
48954,4,8954,[302 603 100 427  64],454,5,33584,3.7503070910106087,20.0,20.0
48955,4,8955,[ 98 121  28 268 187],537,2,33586,3.7501116569897275,0.0,20.0
48956,4,8956,[294 172 153 300 568],378,4,33590,3.750139555654795,0.0,0.0
48957,4,8957,[282 318 194 508 273],207,5,33595,3.7502790801518198,20.0,0.0
48958,4,8958,[237  50  97 288 197],378,3,33598,3.7501953343007033,0.0,20.0
48959,4,8959,[302 603 100 427  64],370,5,33603,3.7503348214285714,20.0,20.0
48960,4,8960,[174 222 173 405  50],213,3,33606,3.7502510880482087,0.0,40.0
48961,4,8961,[302 603 100 427  64],13,5,33611,3.750390537826378,20.0,20.0
48962,4,8962,[174 257 282 179 210],666,1,33612,3.7500836773401764,0.0,20.0
48963,4,8963,[176 237 271 268  22],13,3,33615,3.75,0.0,0.0
48964,4,8964,[302 603 100 427  64],664,5,33620,3.7501394311210263,20.0,20.0
48965,4,8965,[496  79 125 655 385],64,4,33624,3.750167298683917,0.0,0.0
48966,4,8966,[ 69  71 202  64 238],387,1,33625,3.749860599977696,0.0,0.0
48967,4,8967,[302 603 100 427  64],745,5,33630,3.75,20.0,20.0
48968,4,8968,[181 195 385 210 143],313,4,33634,3.75002787378749,0.0,0.0
48969,4,8969,[ 71 117 228 121 748],200,4,33638,3.750055741360089,0.0,0.0
48970,4,8970,[385   7  95  71 121],738,4,33642,3.750083602719875,0.0,0.0
48971,4,8971,[179 385  97  12 228],60,4,33646,3.7501114578689254,20.0,0.0
48972,4,8972,[302 603 100 427  64],90,5,33651,3.7502507522567705,20.0,20.0
48973,4,8973,[238 182 423 132 211],749,3,33654,3.750167149543125,0.0,0.0
48974,4,8974,[269  82 204 483  95],334,3,33657,3.75008356545961,20.0,0.0
48975,4,8975,[302 603 100 427  64],370,5,33662,3.750222816399287,20.0,20.0
48976,4,8976,[302 603 100 427  64],339,5,33667,3.7503620363150274,20.0,20.0
48977,4,8977,[357  97 515   1  70],213,3,33670,3.7502784584539985,20.0,0.0
48978,4,8978,[313  56  11 508  64],653,3,33673,3.750194899209266,0.0,0.0
48979,4,8979,[357   7 234 173 385],60,5,33678,3.750334075723831,20.0,0.0
48980,4,8980,[302 603 100 427  64],666,5,33683,3.7504732212448504,20.0,20.0
48981,4,8981,[405 179 294 748 187],653,3,33686,3.7503896682253397,0.0,0.0
48982,4,8982,[302 603 100 427  64],271,5,33691,3.7505287765779807,20.0,20.0
48983,4,8983,[ 12 210  89 135 588],795,4,33695,3.7505565449688336,20.0,0.0
48984,4,8984,[515 289 276 357  25],90,4,33699,3.750584307178631,20.0,0.0
48985,4,8985,[127 216 175  96 185],406,4,33703,3.750612063209437,0.0,20.0
48986,4,8986,[483  22 168 294 235],650,2,33705,3.750417269389118,20.0,0.0
48987,4,8987,[302 603 100 427  64],745,5,33710,3.7505562972852693,20.0,20.0
48988,4,8988,[151 234 655 603 294],804,4,33714,3.7505840471687617,20.0,0.0
48989,4,8989,[  7 182 235  12 143],537,2,33716,3.750389321468298,20.0,0.0
48990,4,8990,[302 603 100 427  64],339,5,33721,3.7505283060838615,20.0,20.0
48991,4,8991,[302 603 100 427  64],90,5,33726,3.7506672597864767,20.0,20.0
48992,4,8992,[174  97 176 197 179],664,4,33730,3.7506949849883244,0.0,20.0
48993,4,8993,[181 210  79  96  71],840,1,33731,3.750389148321103,0.0,0.0
48994,4,8994,[302 603 100 427  64],666,5,33736,3.7505280711506392,20.0,20.0
48995,4,8995,[135 405 176 318   1],213,3,33739,3.750444642063139,20.0,0.0
48996,4,8996,[302 186 245  64 515],346,3,33742,3.750361231521618,0.0,0.0
48997,4,8997,[427 215 117   1 423],234,2,33744,3.750166703711936,0.0,0.0
48998,4,8998,[603 302 100 427  64],745,5,33749,3.7503055895099457,20.0,20.0
48999,4,8999,[603 302 100 427  64],666,5,33754,3.7504444444444442,20.0,20.0
49000,4,9000,[186 435  64 180  89],339,5,33759,3.750583268525719,0.0,0.0
49001,4,9001,[655 294 427 172 403],788,0,33759,3.7501666296378584,0.0,0.0
49002,4,9002,[603 302 100 427  64],454,5,33764,3.750305453737643,20.0,20.0
49003,4,9003,[603 302 100 427  64],339,5,33769,3.7504442470013326,20.0,20.0
49004,4,9004,[210 222 173 258 202],454,2,33771,3.750249861188229,0.0,0.0
49005,4,9005,[161  69 234 173 181],379,4,33775,3.750277592715967,0.0,0.0
49006,4,9006,[603 302 100 427  64],458,5,33780,3.750416342844454,20.0,20.0
49007,4,9007,[ 97 135 117  71  25],455,2,33782,3.750222024866785,0.0,0.0
49008,4,9008,[173 286 275 276 265],537,3,33785,3.75013875013875,0.0,0.0
49009,4,9009,[ 56 200 216 423 588],378,4,33789,3.7501664816870144,0.0,0.0
49010,4,9010,[182 174 475 546  71],92,4,33793,3.750194207080235,0.0,20.0
49011,4,9011,[423 286 200 234 258],380,3,33796,3.750110963160231,0.0,0.0
49012,4,9012,[168 678   1 172 135],92,4,33800,3.7501386885609675,0.0,0.0
49013,4,9013,[ 89   4 228  50  98],738,5,33805,3.750277346350122,0.0,40.0
49014,4,9014,[179 161 228 135  25],897,2,33807,3.7500831946755406,0.0,0.0
49015,4,9015,[435 187 289 235 237],406,2,33809,3.7498890860692105,0.0,0.0
49016,4,9016,[174 258 286 183  11],378,4,33813,3.7499168237773097,0.0,20.0
49017,4,9017,[603 302 100 427  64],13,5,33818,3.750055444666223,20.0,20.0
49018,4,9018,[603 302 100 427  64],664,5,33823,3.7501940348153897,20.0,20.0
49019,4,9019,[210 191 202 143 186],13,2,33825,3.75,0.0,0.0
49020,4,9020,[603 302 100 427  64],666,5,33830,3.750138565569227,20.0,20.0
49021,4,9021,[603 302 100 427  64],13,5,33835,3.7502771004211928,20.0,20.0
49022,4,9022,[191 496 357 117 172],474,5,33840,3.750415604566109,20.0,0.0
49023,4,9023,[603 302 100 427  64],745,5,33845,3.7505540780141846,20.0,20.0
49024,4,9024,[216 423 357 568 127],90,5,33850,3.7506925207756234,20.0,20.0
49025,4,9025,[603 302 100 427  64],537,4,33854,3.7507201418125415,20.0,20.0
49026,4,9026,[182  96 196 294 151],881,0,33854,3.7503046416306636,0.0,0.0
49027,4,9027,[603 302 100 427  64],666,5,33859,3.7504430660168366,20.0,20.0
49028,4,9028,[603 302 100 427  64],271,5,33864,3.750581459740835,20.0,20.0
49029,4,9029,[195 197 117 215 153],406,3,33867,3.750498338870432,0.0,0.0
49030,4,9030,[143 603 258   7  12],13,3,33870,3.750415236407928,40.0,0.0
49031,4,9031,[603 302 100 427  64],13,5,33875,3.7505535872453497,20.0,20.0
49032,4,9032,[127 515 238 186 258],339,4,33879,3.750581202258386,0.0,20.0
49033,4,9033,[318 174 121  88 237],694,5,33884,3.7507195040956387,20.0,20.0
49034,4,9034,[234  79 435 204 211],60,5,33889,3.750857775318207,0.0,0.0
49035,4,9035,[271 117 742  89 313],145,5,33894,3.750996015936255,0.0,0.0
49036,4,9036,[ 97 742 181 132 603],308,3,33897,3.7509129135775146,20.0,0.0
49037,4,9037,[168  25 181  95  11],537,1,33898,3.750608541712768,0.0,0.0
49038,4,9038,[496   8 588   9 195],7,5,33903,3.7507467640225687,0.0,0.0
49039,4,9039,[603 302 100 427  64],745,5,33908,3.7508849557522126,20.0,20.0
49040,4,9040,[385 181  11  95 276],455,3,33911,3.7508019024444197,0.0,0.0
49041,4,9041,[385  96 182 742 357],308,5,33916,3.7509400575094007,20.0,0.0
49042,4,9042,[603 302 100 427  64],474,5,33921,3.7510781820192416,20.0,20.0
49043,4,9043,[423 187 237 328 210],313,4,33925,3.7511057054400707,0.0,0.0
49044,4,9044,[ 28 132 151 603 222],312,3,33928,3.7510226644555003,20.0,0.0
49045,4,9045,[121  95  69  64 211],537,1,33929,3.750718549635198,0.0,0.0
49046,4,9046,[603 302 100 427  64],13,5,33934,3.750856637559412,20.0,20.0
49047,4,9047,[ 95 328 127  11 196],234,1,33935,3.750552608311229,0.0,20.0
49048,4,9048,[427 135 234 125 357],406,4,33939,3.7505801746049285,20.0,0.0
49049,4,9049,[168 175 125 423 742],92,3,33942,3.7504972375690606,0.0,0.0
49050,4,9050,[603 302 100 427  64],454,5,33947,3.7506352889183514,20.0,20.0
49051,4,9051,[234 265 174 191 204],194,4,33951,3.750662836942112,0.0,20.0
49052,4,9052,[127 182 200 258 143],537,3,33954,3.750579918259141,0.0,20.0
49053,4,9053,[603 302 100 427  64],13,5,33959,3.750717914733819,20.0,20.0
49054,4,9054,[405 546 245  97  70],666,3,33962,3.7506350082827167,0.0,0.0
49055,4,9055,[603 302 100 427  64],271,5,33967,3.7507729681978796,20.0,20.0
49056,4,9056,[234   1 144  96 471],899,3,33970,3.7506900739759303,0.0,0.0
49057,4,9057,[286 196 322 237 210],13,2,33972,3.750496798410245,0.0,0.0
49058,4,9058,[216 176   4  64 196],474,5,33977,3.7506347278949113,0.0,0.0
49059,4,9059,[603 302 100 427  64],90,5,33982,3.7507726269315675,20.0,20.0
49060,4,9060,[603 302 100 427  64],745,5,33987,3.7509104955302948,20.0,20.0
49061,4,9061,[182 118  50 195 215],313,5,33992,3.7510483337011697,0.0,20.0
49062,4,9062,[173 328 185 135  22],804,4,33996,3.751075802714333,0.0,0.0
49063,4,9063,[471  69  56 597 300],653,4,34000,3.7511032656663725,0.0,0.0
49064,4,9064,[603 302 100 427  64],454,5,34005,3.7512410369553226,20.0,20.0
49065,4,9065,[288 238 435   4 153],7,5,34010,3.7513787778513126,0.0,0.0
49066,4,9066,[180 276 245  12 202],378,2,34012,3.7511856181758025,20.0,0.0
49067,4,9067,[603 302 100 427  64],458,5,34017,3.7513233348037054,20.0,20.0
49068,4,9068,[483  98 127 216 161],234,3,34020,3.7512404895798874,20.0,40.0
49069,4,9069,[ 89 153  96 202  12],883,5,34025,3.7513781697905184,20.0,0.0
49070,4,9070,[328   8   1  28 257],533,4,34029,3.7514055782162936,0.0,0.0
49071,4,9071,[204   8 427 194  64],87,5,34034,3.751543209876543,0.0,0.0
49072,4,9072,[ 25 265 176 546   9],881,3,34037,3.751460376942577,0.0,0.0
49073,4,9073,[183 180 471 186  12],6,4,34041,3.7514877672470797,20.0,0.0
49074,4,9074,[603 302 100 427  64],666,5,34046,3.7516253443526173,20.0,20.0
49075,4,9075,[603 302 100 427  64],537,4,34050,3.75165271044513,20.0,20.0
49076,4,9076,[195  70 168 471 496],537,3,34053,3.7515699019499835,0.0,0.0
49077,4,9077,[173 588 496  70  79],378,4,34057,3.7515972681207312,0.0,0.0
49078,4,9078,[288 197  69 204 427],474,4,34061,3.7516246282630243,0.0,0.0
49079,4,9079,[135  22  15 168  25],82,1,34062,3.7513215859030837,0.0,0.0
49080,4,9080,[245 228 257 496 403],653,2,34064,3.7511287303160445,0.0,0.0
49081,4,9081,[294 204  98 195 175],13,3,34067,3.7510460251046025,0.0,20.0
49082,4,9082,[  8 183 143 210 191],536,4,34071,3.7510734338874823,0.0,0.0
49083,4,9083,[568 181  82 655 265],64,4,34075,3.7511008366358434,0.0,0.0
49084,4,9084,[603 302 100 427  64],666,5,34080,3.751238304898184,20.0,20.0
49085,4,9085,[385 202 265 435 276],881,4,34084,3.7512656834690734,0.0,0.0
49086,4,9086,[ 28 286 181 121  50],271,4,34088,3.7512930560140862,0.0,20.0
49087,4,9087,[742  97 143 323 385],454,2,34090,3.751100352112676,0.0,0.0
49088,4,9088,[603 302 100 427  64],454,5,34095,3.751237759929585,20.0,20.0
49089,4,9089,[161 286 234 181 191],7,3,34098,3.7511551155115512,0.0,0.0
49090,4,9090,[603 302 100 427  64],271,5,34103,3.7512924870751294,20.0,20.0
49091,4,9091,[ 89 202 111 333 195],653,3,34106,3.751209854817422,0.0,0.0
49092,4,9092,[603 302 100 427  64],664,5,34111,3.7513471901462663,20.0,20.0
49093,4,9093,[742 234  50 276  98],881,3,34114,3.7512645700461844,0.0,40.0
49094,4,9094,[655 121 235 176 161],13,3,34117,3.7511819681143486,0.0,0.0
49095,4,9095,[176 289 143  79   1],92,3,34120,3.751099384344767,0.0,0.0
49096,4,9096,[333 323   4 385 176],328,1,34121,3.750796966032758,0.0,0.0
49097,4,9097,[179  69 197 180  89],648,2,34123,3.750604528467795,0.0,0.0
49098,4,9098,[ 69 228  89 423 318],374,2,34125,3.7504121332014506,20.0,0.0
49099,4,9099,[603 302 100 427  64],13,5,34130,3.7505494505494505,20.0,20.0
49100,4,9100,[204 181 475 323 172],474,4,34134,3.750576859685749,0.0,0.0
49101,4,9101,[603 302 100 427  64],474,5,34139,3.750714128762909,20.0,20.0
49102,4,9102,[603 302 100 427  64],458,5,34144,3.7508513676809843,20.0,20.0
49103,4,9103,[603 210 235 322   9],13,1,34145,3.75054920913884,20.0,0.0
49104,4,9104,[603 302 100 427  64],370,5,34150,3.7506864360241625,20.0,20.0
49105,4,9105,[ 64 234 117 496 173],537,2,34152,3.7504941796617617,0.0,0.0
49106,4,9106,[603 302 100 427  64],474,5,34157,3.750631382453058,20.0,20.0
49107,4,9107,[603 302 100 427  64],90,5,34162,3.750768555116381,20.0,20.0
49108,4,9108,[385 655 135 202   1],738,4,34166,3.7507959161269073,0.0,0.0
49109,4,9109,[603   1 238 210 265],883,3,34169,3.7507135016465423,20.0,0.0
49110,4,9110,[ 70  11 143 222 568],537,1,34170,3.7504115903852484,0.0,0.0
49111,4,9111,[196 588   1 265  28],263,3,34173,3.750329236172081,0.0,0.0
49112,4,9112,[742 100  28 179 275],308,4,34177,3.7503566333808847,0.0,20.0
49113,4,9113,[269  56 161 222   1],339,4,34181,3.750384024577573,0.0,0.0
49114,4,9114,[603 302 100 427  64],664,5,34186,3.750521119034558,20.0,20.0
49115,4,9115,[228 294 271 234 313],13,3,34189,3.750438788942519,0.0,0.0
49116,4,9116,[204 546 257  22  69],290,4,34193,3.750466162114731,0.0,0.0
49117,4,9117,[603 302 100 427  64],90,5,34198,3.750603202456679,20.0,20.0
49118,4,9118,[603 302 100 427  64],339,5,34203,3.7507402127426253,20.0,20.0
49119,4,9119,[318 275 121 197  64],537,3,34206,3.7506578947368423,20.0,0.0
49120,4,9120,[182  69  70 125 318],194,2,34208,3.750465957680079,20.0,0.0
49121,4,9121,[222 302 427 288 655],14,5,34213,3.7506029379522037,0.0,0.0
49122,4,9122,[655 423 435 204 161],749,4,34217,3.7506302751287954,0.0,0.0
49123,4,9123,[204 238 176 215 161],648,2,34219,3.7504384042086802,0.0,0.0
49124,4,9124,[357 176 135  97  70],840,2,34221,3.750246575342466,20.0,0.0
49125,4,9125,[603 302 100 427  64],474,5,34226,3.7503835196142887,20.0,20.0
49126,4,9126,[603 302 100 427  64],537,4,34230,3.750410868850663,20.0,20.0
49127,4,9127,[  8 127 215   7 210],95,5,34235,3.7505477651183172,0.0,20.0
49128,4,9128,[603 302 100 427  64],664,5,34240,3.7506846313944573,20.0,20.0
49129,4,9129,[234 197 121 273  98],537,1,34241,3.750383351588171,0.0,20.0
49130,4,9130,[ 95 238 289 323 127],881,2,34243,3.7501916548023218,0.0,20.0
49131,4,9131,[603 302 100 427  64],271,5,34248,3.750328515111695,20.0,20.0
49132,4,9132,[186 182 276 172 318],308,5,34253,3.750465345450564,20.0,0.0
49133,4,9133,[403 200 183 202   7],387,3,34256,3.7503831837092183,0.0,0.0
49134,4,9134,[603 302 100 427  64],339,5,34261,3.750519978106185,20.0,20.0
49135,4,9135,[200  15 294 111  71],488,3,34264,3.7504378283712785,0.0,0.0
49136,4,9136,[483 515 204  25 186],308,3,34267,3.750355696618146,20.0,0.0
49137,4,9137,[215 385 603 174 273],59,4,34271,3.750383015977238,20.0,20.0
49138,4,9138,[ 56  25 211 127  69],207,5,34276,3.7505197505197505,0.0,20.0
49139,4,9139,[603 302 100 427  64],745,5,34281,3.750656455142232,20.0,20.0
49140,4,9140,[515  15 180 183 427],882,5,34286,3.7507931298545016,0.0,0.0
49141,4,9141,[603 302 100 427  64],90,5,34291,3.750929774666375,20.0,20.0
49142,4,9142,[603 302 100 427  64],13,5,34296,3.751066389587663,20.0,20.0
49143,4,9143,[496  70 161 172 322],804,5,34301,3.7512029746281716,0.0,0.0
49144,4,9144,[ 88 288 302 423 135],537,2,34303,3.7510114816839804,0.0,0.0
49145,4,9145,[603 302 100 427  64],458,5,34308,3.7511480428602666,20.0,20.0
49146,4,9146,[234 180  15  28 508],533,3,34311,3.7510659232535257,0.0,0.0
49147,4,9147,[176 181 195 121  82],815,4,34315,3.7510931351114998,0.0,0.0
49148,4,9148,[182 132 496 172 515],346,5,34320,3.751229642583889,0.0,0.0
49149,4,9149,[282 127  98 215 161],533,5,34325,3.751366120218579,0.0,40.0
49150,4,9150,[100 271 222 235 194],650,3,34328,3.7512840126762104,0.0,20.0
49151,4,9151,[483 237 211 235   9],308,2,34330,3.7510926573426575,20.0,0.0
49152,4,9152,[234 176 161  69 300],455,4,34334,3.7511198514148365,0.0,0.0
49153,4,9153,[603 302 100 427  64],474,5,34339,3.751256281407035,20.0,20.0
49154,4,9154,[100 318   8 235 405],92,2,34341,3.7510649918077554,20.0,20.0
49155,4,9155,[204   8  28  97   1],194,3,34344,3.750982961992136,0.0,0.0
49156,4,9156,[161 143  97 210 423],184,2,34346,3.7507917440209675,0.0,0.0
49157,4,9157,[655 328 234 286  96],13,3,34349,3.750709761956759,0.0,0.0
49158,4,9158,[228 202 257   7 302],343,4,34353,3.750736980019653,0.0,0.0
49159,4,9159,[603 302 100 427  64],454,5,34358,3.750873362445415,20.0,20.0
49160,4,9160,[  8 194 168 151 117],313,2,34360,3.7506822399301387,0.0,0.0
49161,4,9161,[742 187  50 172 111],59,4,34364,3.7507094520846977,0.0,20.0
49162,4,9162,[603 302 100 427  64],339,5,34369,3.7508457928625996,20.0,20.0
49163,4,9163,[186 174 173 228 235],537,2,34371,3.7506547359231774,0.0,20.0
49164,4,9164,[423 143 385 742 403],95,4,34375,3.750681942171304,0.0,0.0
49165,4,9165,[678   8  88 179 597],308,3,34378,3.7506000436395373,0.0,0.0
49166,4,9166,[603 302 100 427  64],271,5,34383,3.7507363368604776,20.0,20.0
49167,4,9167,[483 475 173 276  56],474,5,34388,3.75087260034904,20.0,0.0
49168,4,9168,[603 302 100 427  64],666,5,34393,3.7510088341149523,20.0,20.0
49169,4,9169,[603 302 100 427  64],458,5,34398,3.7511450381679388,20.0,20.0
49170,4,9170,[  4 175 185  11 508],207,3,34401,3.7510631337912987,0.0,0.0
49171,4,9171,[ 64 228 100 273  69],234,3,34404,3.750981247274313,0.0,20.0
49172,4,9172,[603 302 100 427  64],90,5,34409,3.7511174097896,20.0,20.0
49173,4,9173,[603 302 100 427  64],454,5,34414,3.751253542620449,20.0,20.0
49174,4,9174,[655 385 173 211 318],85,2,34416,3.7510626702997274,20.0,0.0
49175,4,9175,[168 357 210 228 135],815,2,34418,3.750871839581517,20.0,0.0
49176,4,9176,[603 302 100 427  64],13,5,34423,3.751007954669282,20.0,20.0
49177,4,9177,[496  79 125 118 185],7,4,34427,3.751035083896274,0.0,0.0
49178,4,9178,[603 302 100 427  64],474,5,34432,3.751171151541562,20.0,20.0
49179,4,9179,[603 302 100 427  64],454,5,34437,3.7513071895424837,20.0,20.0
49180,4,9180,[603 302 100 427  64],454,5,34442,3.7514431979087246,20.0,20.0
49181,4,9181,[603 302 100 427  64],339,5,34447,3.7515791766499675,20.0,20.0
49182,4,9182,[186 322 215 118 427],308,2,34449,3.7513884351519113,0.0,0.0
49183,4,9183,[603 302 100 427  64],90,5,34454,3.7515243902439024,20.0,20.0
49184,4,9184,[603 302 100 427  64],666,5,34459,3.751660315732172,20.0,20.0
49185,4,9185,[211 161 234 121 200],308,2,34461,3.7514696276943176,0.0,0.0
49186,4,9186,[603 302 100 427  64],370,5,34466,3.7516055295526285,20.0,20.0
49187,4,9187,[  1  69 288  50 181],13,3,34469,3.751523726599913,0.0,20.0
49188,4,9188,[222 228  69 403 179],194,2,34471,3.7513331156817933,0.0,0.0
49189,4,9189,[121  64 588 204 286],406,4,34475,3.751360174102285,0.0,0.0
49190,4,9190,[508 194 333 168 172],387,3,34478,3.751278424545751,0.0,0.0
49191,4,9191,[603 302 100 427  64],339,5,34483,3.751414273281114,20.0,20.0
49192,4,9192,[234 423 176  22  64],254,4,34487,3.751441314043294,0.0,0.0
49193,4,9193,[603 302 100 427  64],745,5,34492,3.7515771155101154,20.0,20.0
49194,4,9194,[603 302 100 427  64],370,5,34497,3.7517128874388255,20.0,20.0
49195,4,9195,[237 144  56   7  28],92,4,34501,3.751739886907351,0.0,0.0
49196,4,9196,[603 302 100 427  64],537,4,34505,3.7517668805045123,20.0,20.0
49197,4,9197,[603 302 100 427  64],271,5,34510,3.7519025875190257,20.0,20.0
49198,4,9198,[ 96 318 385 204 483],533,5,34515,3.7520382650288076,40.0,0.0
49199,4,9199,[603 302 100 427  64],458,5,34520,3.752173913043478,20.0,20.0
49200,4,9200,[302 216 271  96 603],145,5,34525,3.752309531572655,20.0,0.0
49201,4,9201,[333 289 135 118 180],328,2,34527,3.7521191045424906,0.0,0.0
49202,4,9202,[603 302 100 427  64],537,4,34531,3.7521460393349995,20.0,20.0
49203,4,9203,[603 302 100 427  64],370,5,34536,3.7522816166883963,20.0,20.0
49204,4,9204,[228 597  82 185  69],897,5,34541,3.752417164584465,0.0,0.0
49205,4,9205,[153 182 121 328   9],378,4,34545,3.752444058222898,0.0,0.0
49206,4,9206,[237  71 271  96 200],92,3,34548,3.752362333007494,0.0,0.0
49207,4,9207,[603 302 100 427  64],339,5,34553,3.7524978279756733,20.0,20.0
49208,4,9208,[196  12  22 185 172],7,5,34558,3.7526332935172113,20.0,0.0
49209,4,9209,[282   9 132  22 211],406,3,34561,3.7525515743756785,0.0,0.0
49210,4,9210,[603 302 100 427  64],454,5,34566,3.7526870046683314,20.0,20.0
49211,4,9211,[185 322   4 181 748],749,4,34570,3.752713851498046,0.0,0.0
49212,4,9212,[ 96  50 216 496 475],537,3,34573,3.7526321502225115,0.0,20.0
49213,4,9213,[216 276 245  22   8],207,1,34574,3.752333405686998,0.0,0.0
49214,4,9214,[603 302 100 427  64],458,5,34579,3.75246880086815,20.0,20.0
49215,4,9215,[742 195 144 180 269],378,3,34582,3.7523871527777777,0.0,0.0
49216,4,9216,[ 98  11   8  70 228],406,3,34585,3.752305522404253,0.0,20.0
49217,4,9217,[211 176   1 597  56],308,4,34589,3.752332393143849,0.0,0.0
49218,4,9218,[204 200  56 125 258],653,3,34592,3.7522507864193515,0.0,0.0
49219,4,9219,[603 302 100 427  64],90,5,34597,3.7523861171366595,20.0,20.0
49220,4,9220,[  4 121 196 265 273],374,2,34599,3.7521960741785056,0.0,0.0
49221,4,9221,[271 176 172 117  56],13,2,34601,3.7520060724354805,0.0,0.0
49222,4,9222,[175   8  50 273 237],308,3,34604,3.7519245364848746,0.0,20.0
49223,4,9223,[257  88 427 228 234],934,4,34608,3.751951431049436,0.0,0.0
49224,4,9224,[ 88 265  15 196 135],378,4,34612,3.751978319783198,0.0,0.0
49225,4,9225,[  1  56 322 238  98],92,4,34616,3.7520052026880557,0.0,20.0
49226,4,9226,[357  56 748  71 655],313,3,34619,3.7519237021783893,20.0,0.0
49227,4,9227,[215 294 301 508 153],13,2,34621,3.7517338534893803,0.0,0.0
49228,4,9228,[194 202  89 228 118],102,3,34624,3.7516524000433416,0.0,0.0
49229,4,9229,[ 71 216  15 183  25],194,2,34626,3.7514626218851572,0.0,0.0
49230,4,9230,[515  50 271  12 678],13,2,34628,3.7512728848445454,20.0,20.0
49231,4,9231,[202 237 228 273 185],234,0,34628,3.7508665511265167,0.0,0.0
49232,4,9232,[ 79 655 238 258 168],387,4,34632,3.7508935340626017,0.0,0.0
49233,4,9233,[210 328 172 423 748],91,4,34636,3.7509205111544293,0.0,0.0
49234,4,9234,[ 96 211 181 210 748],64,3,34639,3.7508391987005956,0.0,0.0
49235,4,9235,[603 302 100 427  64],13,5,34644,3.750974447812906,20.0,20.0
49236,4,9236,[603 302 100 427  64],339,5,34649,3.751109667641009,20.0,20.0
49237,4,9237,[471 161 100 496 179],474,4,34653,3.7511366096557697,0.0,20.0
49238,4,9238,[603 302 100 427  64],458,5,34658,3.751271782660461,20.0,20.0
49239,4,9239,[269 475 333  96 117],13,1,34659,3.750974025974026,0.0,0.0
49240,4,9240,[182 151 568  56 183],892,5,34664,3.75110918731739,0.0,0.0
49241,4,9241,[143 174 515 496 258],537,3,34667,3.7510279160354902,0.0,20.0
49242,4,9242,[215 176  28   9 111],488,5,34672,3.7511630423022826,0.0,0.0
49243,4,9243,[603 302 100 427  64],537,4,34676,3.75118996105582,20.0,20.0
49244,4,9244,[144  15 216 258 174],92,3,34679,3.7511087074094105,0.0,20.0
49245,4,9245,[  7 423 216 222  15],881,4,34683,3.7511356262167426,0.0,0.0
49246,4,9246,[603 302 100 427  64],13,5,34688,3.751270682383476,20.0,20.0
49247,4,9247,[  9 216 179 200 435],308,4,34692,3.7512975778546713,0.0,0.0
49248,4,9248,[ 82 475 655  50 172],119,4,34696,3.7513244675100013,0.0,20.0
49249,4,9249,[603 302 100 427  64],474,5,34701,3.7514594594594595,20.0,20.0
49250,4,9250,[ 56 210 597 655 191],308,4,34705,3.751486325802616,0.0,0.0
49251,4,9251,[179 222  97 265 216],524,4,34709,3.751513186338089,0.0,0.0
49252,4,9252,[238 186 403 328 194],653,2,34711,3.7513238949529883,0.0,0.0
49253,4,9253,[603 302 100 427  64],454,5,34716,3.7514588286146533,20.0,20.0
49254,4,9254,[568  79  97  70   4],64,3,34719,3.7513776337115075,0.0,0.0
49255,4,9255,[ 50 143 179 172 127],379,5,34724,3.7515125324114087,0.0,40.0
49256,4,9256,[179  56 111 118 483],749,2,34726,3.7513233228907854,20.0,0.0
49257,4,9257,[603 302 100 427  64],370,5,34731,3.7514581983149706,20.0,20.0
49258,4,9258,[603 302 100 427  64],370,5,34736,3.751593044605249,20.0,20.0
49259,4,9259,[603 302 100 427  64],271,5,34741,3.7517278617710583,20.0,20.0
49260,4,9260,[313  11 423 655  50],474,5,34746,3.7518626498218337,0.0,20.0
49261,4,9261,[603 302 100 427  64],339,5,34751,3.751997408767005,20.0,20.0
49262,4,9262,[181 197 200  50 204],7,4,34755,3.752024182230379,0.0,20.0
49263,4,9263,[181 176 273 288 286],548,3,34758,3.751943005181347,0.0,0.0
49264,4,9264,[603 302 100 427  64],537,4,34762,3.751969778737183,20.0,20.0
49265,4,9265,[ 70 132 234 318 483],664,3,34765,3.751888625080941,40.0,0.0
49266,4,9266,[237 172 235 191 195],882,4,34769,3.7519153987266645,0.0,0.0
49267,4,9267,[ 15 176 403 185 144],398,5,34774,3.7520500647388864,0.0,0.0
49268,4,9268,[210 100 196 194 515],7,4,34778,3.75207681519042,0.0,20.0
49269,4,9269,[ 28 182 245 265 286],207,1,34779,3.751779935275081,0.0,0.0
49270,4,9270,[603 302 100 427  64],474,5,34784,3.7519145723222955,20.0,20.0
49271,4,9271,[603 302 100 427  64],474,5,34789,3.752049180327869,20.0,20.0
49272,4,9272,[135 186 597  70  97],533,1,34790,3.751752399439232,0.0,0.0
49273,4,9273,[603 302 100 427  64],458,5,34795,3.7518869959025234,20.0,20.0
49274,4,9274,[597  56  97 151  25],378,3,34798,3.7518059299191373,0.0,0.0
49275,4,9275,[125  50 228 132  97],533,4,34802,3.751832686502803,0.0,20.0
49276,4,9276,[  7 121  22 144  25],339,3,34805,3.751751643850383,0.0,0.0
49277,4,9277,[197 174  97 423 655],64,3,34808,3.7516706186678164,0.0,20.0
49278,4,9278,[603 302 100 427  64],458,5,34813,3.7518051514171784,20.0,20.0
49279,4,9279,[186 185  71 405 328],95,3,34816,3.7517241379310344,0.0,0.0
49280,4,9280,[302 385  97 132 111],474,5,34821,3.751858635922853,0.0,0.0
49281,4,9281,[603 302 100 427  64],339,5,34826,3.7519931049342814,20.0,20.0
49282,4,9282,[ 70 196  96 180 186],7,4,34830,3.7520198211784983,0.0,0.0
49283,4,9283,[405 483  71 183  82],648,4,34834,3.7520465316673848,20.0,0.0
49284,4,9284,[546 748 194  70 423],524,4,34838,3.7520732364028,0.0,0.0
49285,4,9285,[127 132 483  11 405],13,3,34841,3.751992246392419,20.0,20.0
49286,4,9286,[ 11 121  12 302  82],666,3,34844,3.7519112738236244,20.0,0.0
49287,4,9287,[748 258   8 302  25],474,4,34848,3.751937984496124,0.0,0.0
49288,4,9288,[180 179 197 118  69],653,3,34851,3.7518570352029283,0.0,0.0
49289,4,9289,[603 302 100 427  64],745,5,34856,3.7519913885898815,20.0,20.0
49290,4,9290,[174  56 273 211 121],774,0,34856,3.7515875578516846,0.0,20.0
49291,4,9291,[ 96 603 515 748 186],64,3,34859,3.751506672406371,20.0,0.0
49292,4,9292,[183  71 300 508 234],13,3,34862,3.7514258043688797,0.0,0.0
49293,4,9293,[475   4 546 202 117],374,2,34864,3.751237357434904,0.0,0.0
49294,4,9294,[258 127  82 276 200],234,2,34866,3.751048951048951,0.0,20.0
49295,4,9295,[302 603 100 427  64],664,5,34871,3.75118330464716,20.0,20.0
49296,4,9296,[265   1 204 546  82],804,4,34875,3.751210067763795,0.0,0.0
49297,4,9297,[333 289   1  25 111],894,2,34877,3.7510217251021727,0.0,0.0
49298,4,9298,[ 89 127 483 403 111],524,5,34882,3.7511560382836864,20.0,20.0
49299,4,9299,[143 197 603 257 568],385,2,34884,3.750967741935484,20.0,0.0
49300,4,9300,[118 655   7  11 286],7,3,34887,3.7508870013976994,0.0,0.0
49301,4,9301,[135 423 174  12 211],339,4,34891,3.7509137819823692,20.0,20.0
49302,4,9302,[405 210 237 118 258],7,3,34894,3.7508330646028165,0.0,0.0
49303,4,9303,[179  88  89 471 191],95,3,34897,3.7507523645743768,0.0,0.0
49304,4,9304,[ 98 187 182   9   1],184,5,34902,3.7508866200967224,0.0,20.0
49305,4,9305,[302 603 100 427  64],13,5,34907,3.7510208467655275,20.0,20.0
49306,4,9306,[143 405 655  50 181],666,1,34908,3.75072526055657,0.0,20.0
49307,4,9307,[265 100 245 483 228],488,2,34910,3.750537172324882,20.0,20.0
49308,4,9308,[302 603 100 427  64],745,5,34915,3.750671393275325,20.0,20.0
49309,4,9309,[194  25 179 202  82],59,4,34919,3.7506981740064447,0.0,0.0
49310,4,9310,[302 603 100 427  64],458,5,34924,3.7508323488347117,20.0,20.0
49311,4,9311,[ 28 235 265 204 238],795,1,34925,3.750536941580756,0.0,0.0
49312,4,9312,[ 28 234 269  11 202],537,0,34925,3.750134220981424,0.0,0.0
49313,4,9313,[ 22  88 405 125 546],271,2,34927,3.7499463173716987,0.0,0.0
49314,4,9314,[118 265 111  56  97],13,5,34932,3.7500805152979066,0.0,0.0
49315,4,9315,[ 11 357 195 515 276],200,5,34937,3.7502146844139115,20.0,0.0
49316,4,9316,[ 12 268   8 174 515],90,5,34942,3.7503488247289902,20.0,20.0
49317,4,9317,[405 546 435 471 210],666,3,34945,3.750268297918008,0.0,0.0
49318,4,9318,[210  15 238 185  96],749,4,34949,3.7502950960403476,0.0,0.0
49319,4,9319,[302 603 100 427  64],458,5,34954,3.7504291845493563,20.0,20.0
49320,4,9320,[568 172 210 275 471],95,4,34958,3.7504559596609806,0.0,0.0
49321,4,9321,[258 318 186 234 568],488,4,34962,3.7504827290281058,20.0,0.0
49322,4,9322,[302 603 100 427  64],474,5,34967,3.750616754263649,20.0,20.0
49323,4,9323,[294  56 357 496 197],311,5,34972,3.750750750750751,20.0,0.0
49324,4,9324,[302 603 100 427  64],745,5,34977,3.7508847184986593,20.0,20.0
49325,4,9325,[258 175  70 257  28],666,3,34980,3.750804203302595,0.0,0.0
49326,4,9326,[ 96  50 195 257 568],881,3,34983,3.750723705371502,0.0,20.0
49327,4,9327,[483 172 515 194  79],669,1,34984,3.7504288164665525,20.0,0.0
49328,4,9328,[  8  22  28 125 237],243,2,34986,3.7502411834065814,0.0,0.0
49329,4,9329,[143 200 172 323 313],13,2,34988,3.75005359056806,0.0,0.0
49330,4,9330,[302 603 100 427  64],454,5,34993,3.7501875468867216,20.0,20.0
49331,4,9331,[121 183 333 172  79],387,3,34996,3.750107158165452,0.0,0.0
49332,4,9332,[168 603 265 185 204],666,3,34999,3.7500267866709525,20.0,0.0
49333,4,9333,[172 357 100 403 471],311,4,35003,3.7500535676023143,20.0,20.0
49334,4,9334,[302 603 100 427  64],664,5,35008,3.750187466523835,20.0,20.0
49335,4,9335,[143 195 197 174 186],6,4,35012,3.7502142245072836,0.0,20.0
49336,4,9336,[ 95 289 172 546 301],524,3,35015,3.7501338759772946,0.0,0.0
49337,4,9337,[222 161 268  69 121],387,1,35016,3.74983936603127,0.0,0.0
49338,4,9338,[302 603 100 427  64],666,5,35021,3.7499732305386018,20.0,20.0
49339,4,9339,[185  15 187 258 176],59,4,35025,3.75,0.0,0.0
49340,4,9340,[302 603 100 427  64],370,5,35030,3.7501338186489668,20.0,20.0
49341,4,9341,[ 71 357  70  64   7],406,3,35033,3.7500535217298223,20.0,0.0
49342,4,9342,[300  22 748  82 483],488,4,35037,3.7500802740019266,20.0,0.0
49343,4,9343,[302 603 100 427  64],339,5,35042,3.7502140410958904,20.0,20.0
49344,4,9344,[423 100  71 195 211],234,2,35044,3.750026752273943,0.0,20.0
49345,4,9345,[ 28 202 228 235  22],194,2,35046,3.7498395035309224,0.0,0.0
49346,4,9346,[302 603 100 427  64],454,5,35051,3.749973253450305,20.0,20.0
49347,4,9347,[302 603 100 427  64],537,4,35055,3.75,20.0,20.0
49348,4,9348,[302 603 100 427  64],664,5,35060,3.75013370413948,20.0,20.0
49349,4,9349,[302 603 100 427  64],454,5,35065,3.7502673796791446,20.0,20.0
49350,4,9350,[302 603 100 427  64],537,4,35069,3.75029408619399,20.0,20.0
49351,4,9351,[302 603 100 427  64],666,5,35074,3.750427715996578,20.0,20.0
49352,4,9352,[302 603 100 427  64],370,5,35079,3.75056131722442,20.0,20.0
49353,4,9353,[144  50 194 176 257],213,5,35084,3.7506948898866797,0.0,20.0
49354,4,9354,[322 173  95  96 211],524,4,35088,3.7507215392838056,0.0,0.0
49355,4,9355,[ 97 235 276 257 245],378,4,35092,3.7507481829841813,0.0,0.0
49356,4,9356,[127  56 185 313 237],271,3,35095,3.7506679491289945,0.0,20.0
49357,4,9357,[228 144 211 121 186],102,2,35097,3.7504808719811926,0.0,0.0
49358,4,9358,[302 603 100 427  64],454,5,35102,3.750614381878406,20.0,20.0
49359,4,9359,[302 603 100 427  64],537,4,35106,3.7506410256410256,20.0,20.0
49360,4,9360,[172 168 275 289 179],406,2,35108,3.7504540113235767,0.0,0.0
49361,4,9361,[302 603 100 427  64],454,5,35113,3.750587481307413,20.0,20.0
49362,4,9362,[403 238 742 181 508],378,4,35117,3.750614119406173,0.0,0.0
49363,4,9363,[742 333 151 265   9],533,3,35120,3.7505339598462197,0.0,0.0
49364,4,9364,[333 194 742 515 302],458,3,35123,3.750453817405232,0.0,0.0
49365,4,9365,[655 197 210 435 211],234,1,35124,3.7501601537475975,0.0,0.0
49366,4,9366,[ 89 323   1 181 100],881,4,35128,3.750186826091598,0.0,20.0
49367,4,9367,[302 603 100 427  64],13,5,35133,3.75032023911187,20.0,20.0
49368,4,9368,[265 153 186 195 228],650,5,35138,3.750453623652471,0.0,0.0
49369,4,9369,[302 603 100 427  64],458,5,35143,3.750586979722519,20.0,20.0
49370,4,9370,[195 121 265 175 172],308,3,35146,3.75050688293672,0.0,0.0
49371,4,9371,[151 228 194   4 286],59,3,35149,3.7504268032437045,0.0,0.0
49372,4,9372,[302 603 100 427  64],474,5,35154,3.7505601194921585,20.0,20.0
49373,4,9373,[  9 161 187 271 179],379,3,35157,3.750480051205462,0.0,0.0
49374,4,9374,[748 286 313 204 174],207,2,35159,3.7502933333333335,0.0,20.0
49375,4,9375,[302 603 100 427  64],666,5,35164,3.7504266211604094,20.0,20.0
49376,4,9376,[175  11 135  25 405],13,2,35166,3.75023994881092,0.0,0.0
49377,4,9377,[328 322 546 588 742],313,3,35169,3.750159948816379,0.0,0.0
49378,4,9378,[ 82  25 204   8 568],387,2,35171,3.749973344706259,0.0,0.0
49379,4,9379,[302 603 100 427  64],90,5,35176,3.7501066098081024,20.0,20.0
49380,4,9380,[318 127   9 276 245],90,4,35180,3.7501332480545786,20.0,20.0
49381,4,9381,[427 385  56  64 197],379,4,35184,3.7501598806224687,0.0,0.0
49382,4,9382,[302 603 100 427  64],458,5,35189,3.750293083235639,20.0,20.0
49383,4,9383,[357  82  98 282 196],207,4,35193,3.750319693094629,20.0,20.0
49384,4,9384,[ 98 204 183  96   4],144,4,35197,3.7503462972828983,0.0,20.0
49385,4,9385,[302 603 300 185  56],116,1,35198,3.7500532708288943,20.0,0.0
49386,4,9386,[125  79 191 265 161],92,4,35202,3.750079897730904,0.0,0.0
49387,4,9387,[161  82 181   7 100],295,5,35207,3.75021303792075,0.0,20.0
49388,4,9388,[302 603 100 427  64],13,5,35212,3.7503461497497073,20.0,20.0
49389,4,9389,[ 82 216  70 405 471],648,4,35216,3.7503727369542066,0.0,0.0
49390,4,9390,[245 258 181 186 322],102,2,35218,3.7501863486316687,0.0,0.0
49391,4,9391,[185 655 100 194 322],329,2,35220,3.75,0.0,20.0
49392,4,9392,[222  70 191 403 174],881,3,35223,3.749920153305653,0.0,20.0
49393,4,9393,[202  97  98 132   8],499,5,35228,3.7500532254630614,0.0,20.0
49394,4,9394,[172  50 269   1  12],883,3,35231,3.7499733901011174,20.0,20.0
49395,4,9395,[ 71  50 546 515  64],13,3,35234,3.749893571732652,0.0,20.0
49396,4,9396,[153 211 127 405 483],406,3,35237,3.7498137703522403,20.0,20.0
49397,4,9397,[286 275 191 423 180],537,3,35240,3.7497339859544585,0.0,0.0
49398,4,9398,[194 546 117 195 515],524,3,35243,3.7496542185338866,0.0,0.0
49399,4,9399,[302 603 100 427  64],13,5,35248,3.7497872340425533,20.0,20.0
49400,4,9400,[187 405  11 216 275],474,4,35252,3.749813849590469,0.0,0.0
49401,4,9401,[197 238 179  71 235],648,2,35254,3.749627738778983,0.0,0.0
49402,4,9402,[302 603 100 427  64],745,5,35259,3.7497607146655323,20.0,20.0
49403,4,9403,[302 603 100 427  64],458,5,35264,3.749893662271374,20.0,20.0
49404,4,9404,[127 300 318 357  97],13,2,35266,3.749707602339181,40.0,20.0
49405,4,9405,[318 153 273  50   4],92,4,35270,3.7497342122049755,20.0,20.0
49406,4,9406,[ 25 183 111 271 117],749,4,35274,3.749760816413309,0.0,0.0
49407,4,9407,[302 603 100 427  64],666,5,35279,3.749893707482993,20.0,20.0
49408,4,9408,[471 183 200 238 742],666,4,35283,3.7499202890849186,0.0,0.0
49409,4,9409,[ 56 286 195 385  96],328,3,35286,3.7498405951115834,0.0,0.0
49410,4,9410,[302 603 100 427  64],537,4,35290,3.7498671767081073,20.0,20.0
49411,4,9411,[ 28 187 235 471 234],648,4,35294,3.7498937526561837,0.0,0.0
49412,4,9412,[302 603 100 427  64],90,5,35299,3.7500265590141293,20.0,20.0
49413,4,9413,[302 603 100 427  64],666,5,35304,3.750159337157425,20.0,20.0
49414,4,9414,[ 98 179 276 191 174],207,4,35308,3.750185873605948,0.0,40.0
49415,4,9415,[302 603 100 427  64],271,5,35313,3.750318606627018,20.0,20.0
49416,4,9416,[288 216 135 127  70],374,5,35318,3.7504513114580016,0.0,20.0
49417,4,9417,[  7 215 176 357 748],13,2,35320,3.750265449139945,20.0,0.0
49418,4,9418,[111 322 588 313  15],537,1,35321,3.749973457904236,0.0,0.0
49419,4,9419,[ 70  97 175 185 173],406,3,35324,3.7498938428874733,0.0,0.0
49420,4,9420,[302 603 100 427  64],537,4,35328,3.7499203906167073,20.0,20.0
49421,4,9421,[302 603 100 427  64],458,5,35333,3.750053067289323,20.0,20.0
49422,4,9422,[318 182 187 191 269],537,4,35337,3.750079592486469,20.0,0.0
49423,4,9423,[186 191 174 196 483],334,4,35341,3.7501061120543295,20.0,20.0
49424,4,9424,[302 603 100 427  64],664,5,35346,3.750238726790451,20.0,20.0
49425,4,9425,[302 603 100 427  64],454,5,35351,3.7503713133885,20.0,20.0
49426,4,9426,[302 603 100 427  64],339,5,35356,3.750503871857431,20.0,20.0
49427,4,9427,[302 603 100 427  64],13,5,35361,3.750636402206194,20.0,20.0
49428,4,9428,[568 118 273 200 588],378,4,35365,3.7506628486583944,0.0,0.0
49429,4,9429,[318 200 328 151 161],334,3,35368,3.7505832449628844,20.0,0.0
49430,4,9430,[302 603 100 427  64],745,5,35373,3.7507157247375678,20.0,20.0
49431,4,9431,[143 403 215   8 197],343,5,35378,3.7508481764206953,0.0,0.0
49432,4,9432,[302 603 100 427  64],664,5,35383,3.7509806000212023,20.0,20.0
49433,4,9433,[ 71 168 357 174 210],815,3,35386,3.7509009963960143,20.0,20.0
49434,4,9434,[258 222 183 215 435],263,4,35390,3.7509273979862217,0.0,0.0
49435,4,9435,[302 603 100 427  64],474,5,35395,3.751059771089445,20.0,20.0
49436,4,9436,[258 186 288 289 333],13,2,35397,3.7508742185016426,0.0,0.0
49437,4,9437,[ 88 168 435 195 176],536,3,35400,3.750794659885569,0.0,0.0
49438,4,9438,[302 603 100 427  64],458,5,35405,3.750927004979341,20.0,20.0
49439,4,9439,[257 405 385 483 151],749,2,35407,3.7507415254237286,20.0,0.0
49440,4,9440,[302 603 100 427  64],474,5,35412,3.7508738481093102,20.0,20.0
49441,4,9441,[300 182   1 202 328],749,4,35416,3.7509002330014827,0.0,0.0
49442,4,9442,[323 471 151 195 294],378,0,35416,3.750503018108652,0.0,0.0
49443,4,9443,[ 69 182 191 153   8],398,4,35420,3.7505294366793733,0.0,0.0
49444,4,9444,[153  69 300 678 357],749,4,35424,3.7505558496559024,20.0,0.0
49445,4,9445,[ 98 183 238 423 174],64,5,35429,3.7506881219563835,0.0,40.0
49446,4,9446,[323 318 173   7  11],200,4,35433,3.7507145125436647,20.0,0.0
49447,4,9447,[186 215 204 202 118],840,4,35437,3.750740897544454,0.0,0.0
49448,4,9448,[100 288 118 121 333],396,3,35440,3.750661445655625,0.0,20.0
49449,4,9449,[ 56 655   9 265 318],207,4,35444,3.7506878306878306,20.0,0.0
49450,4,9450,[403 265 151 197 143],339,3,35447,3.7506084012273835,0.0,0.0
49451,4,9451,[302 603 100 427  64],13,5,35452,3.7507405840033856,20.0,20.0
49452,4,9452,[151 153 204 121 111],749,3,35455,3.750661165767481,0.0,0.0
49453,4,9453,[302 603 100 427  64],370,5,35460,3.7507933149989423,20.0,20.0
49454,4,9454,[  8  12 234   1 100],398,2,35462,3.7506081438392385,20.0,20.0
49455,4,9455,[288 117  82 322  12],92,2,35464,3.750423011844332,20.0,0.0
49456,4,9456,[603 515 183 423 173],59,5,35469,3.7505551443375276,20.0,0.0
49457,4,9457,[  4 191 161   1 172],59,3,35472,3.750475787692958,0.0,0.0
49458,4,9458,[302 603 427 100  64],454,5,35477,3.750607886668781,20.0,20.0
49459,4,9459,[302 603 427 100  64],454,5,35482,3.7507399577167018,20.0,20.0
49460,4,9460,[ 56 313 286 168 269],119,4,35486,3.7507663037733856,0.0,0.0
49461,4,9461,[302 603 427 100  64],454,5,35491,3.750898330162756,20.0,20.0
49462,4,9462,[180  96 202 215 603],648,3,35494,3.7508189791820774,20.0,0.0
49463,4,9463,[175 195 196  98 143],59,4,35498,3.7508453085376163,0.0,20.0
49464,4,9464,[302 603 427 100  64],664,5,35503,3.750977284733228,20.0,20.0
49465,4,9465,[216 265 197 235 215],524,3,35506,3.7508979505598985,0.0,0.0
49466,4,9466,[302 603 427 100  64],745,5,35511,3.751029893313616,20.0,20.0
49467,4,9467,[  1   9 603 185 211],379,5,35516,3.7511618081960285,20.0,0.0
49468,4,9468,[  7  69 294  88  98],452,3,35519,3.7510824796705036,0.0,20.0
49469,4,9469,[ 88 234 187 174 210],533,4,35523,3.7511087645195356,0.0,20.0
49470,4,9470,[ 64 211 197 174  22],288,5,35528,3.7512406292894096,0.0,20.0
49471,4,9471,[302 603 427 100  64],454,5,35533,3.7513724662162162,20.0,20.0
49472,4,9472,[181 302 385 172 194],454,1,35534,3.7510820225905204,0.0,0.0
49473,4,9473,[515 117 211 135 186],13,3,35537,3.751002744352966,0.0,0.0
49474,4,9474,[215 175  89   4  71],59,4,35541,3.751029023746702,0.0,0.0
49475,4,9475,[302 603 427 100  64],664,5,35546,3.7511608273533135,20.0,20.0
49476,4,9476,[174 222 211 210 496],215,5,35551,3.751292603144455,0.0,20.0
49477,4,9477,[  1  71 132 125 323],254,1,35552,3.751002321164803,0.0,0.0
49478,4,9478,[318 471  89 175 204],653,3,35555,3.750923093153286,20.0,0.0
49479,4,9479,[135 318 323  98 215],474,4,35559,3.7509493670886074,20.0,20.0
49480,4,9480,[144 655 151  25 435],899,1,35560,3.7506592131631686,0.0,0.0
49481,4,9481,[238 475 211 144 235],339,3,35563,3.7505800464037122,0.0,0.0
49482,4,9482,[132 228 185 186 161],194,3,35566,3.7505008963408204,0.0,0.0
49483,4,9483,[182 405 135  98 318],328,3,35569,3.750421762969211,20.0,20.0
49484,4,9484,[302 603 427 100  64],745,5,35574,3.750553505535055,20.0,20.0
49485,4,9485,[194 176 121  11 185],474,5,35579,3.750685220324689,0.0,0.0
49486,4,9486,[302 603 427 100  64],454,5,35584,3.7508169073468958,20.0,20.0
49487,4,9487,[216  12 405 222 273],92,3,35587,3.750737774030354,20.0,0.0
49488,4,9488,[210  64  88 258 197],311,5,35592,3.7508694277584573,0.0,0.0
49489,4,9489,[302 603 427 100  64],537,4,35596,3.750895679662803,20.0,20.0
49490,4,9490,[302 603 427 100  64],664,5,35601,3.7510272890106418,20.0,20.0
49491,4,9491,[211 186 173 179  64],311,2,35603,3.750842815002107,0.0,0.0
49492,4,9492,[302 603 427 100  64],745,5,35608,3.7509744021910882,20.0,20.0
49493,4,9493,[302 603 427 100  64],370,5,35613,3.751105961659996,20.0,20.0
49494,4,9494,[302 603 427 100  64],13,5,35618,3.7512374934175883,20.0,20.0
49495,4,9495,[302 603 427 100  64],90,5,35623,3.75136899747262,20.0,20.0
49496,4,9496,[186 176 151 471 742],308,4,35627,3.75139517742445,0.0,0.0
49497,4,9497,[197 176 568 153 385],536,3,35630,3.7513160665403245,0.0,0.0
49498,4,9498,[302 603 427 100  64],537,4,35634,3.7513422465522686,20.0,20.0
49499,4,9499,[302 603 427 100  64],339,5,35639,3.7514736842105263,20.0,20.0
49500,4,9500,[302 603 427 100  64],271,5,35644,3.7516050942006105,20.0,20.0
49501,4,9501,[357  95 173  98  56],749,3,35647,3.751525994527468,20.0,20.0
49502,4,9502,[496 742 427 275  79],298,3,35650,3.751446911501631,0.0,0.0
49503,4,9503,[174  11  79 191  88],538,4,35654,3.751473063973064,0.0,20.0
49504,4,9504,[302 603 427 100  64],666,5,35659,3.751604418726986,20.0,20.0
49505,4,9505,[655 168 238 357 100],940,3,35662,3.7515253524090046,20.0,20.0
49506,4,9506,[302 603 427 100  64],745,5,35667,3.7516566740296624,20.0,20.0
49507,4,9507,[302 603 427 100  64],474,5,35672,3.7517879680269246,20.0,20.0
49508,4,9508,[302 603 427 100  64],458,5,35677,3.751919234409507,20.0,20.0
49509,4,9509,[180   9 151  88 238],749,3,35680,3.751840168243954,0.0,0.0
49510,4,9510,[385 282 135 180 125],788,2,35682,3.751655977289454,0.0,0.0
49511,4,9511,[471 228 427  22  15],234,2,35684,3.7514718250630783,0.0,0.0
49512,4,9512,[  8  71 235 269 546],64,3,35687,3.7513928308630295,0.0,0.0
49513,4,9513,[748 228  82 161 211],524,3,35690,3.751313853268867,0.0,0.0
49514,4,9514,[273  56 143 196 100],378,5,35695,3.7514450867052025,0.0,20.0
49515,4,9515,[289  50 302 185 181],271,4,35699,3.751471206389239,0.0,20.0
49516,4,9516,[144  79 238 742 121],648,4,35703,3.751497320584218,0.0,0.0
49517,4,9517,[302 603 427 100  64],271,5,35708,3.7516284933809625,20.0,20.0
49518,4,9518,[174  98  64  82 194],452,4,35712,3.751654585565711,0.0,40.0
49519,4,9519,[678 333 603 222 323],294,3,35715,3.751575630252101,20.0,0.0
49520,4,9520,[ 22 173   7 483 179],334,5,35720,3.75170675349228,20.0,0.0
49521,4,9521,[197 216 655 546 194],339,4,35724,3.751732829237555,0.0,0.0
49522,4,9522,[302 603 427 100  64],13,5,35729,3.7518639084322167,20.0,20.0
49523,4,9523,[302 603 427 100  64],370,5,35734,3.751994960100798,20.0,20.0
49524,4,9524,[302 603 427 100  64],454,5,35739,3.7521259842519683,20.0,20.0
49525,4,9525,[302 603 427 100  64],90,5,35744,3.752256980894394,20.0,20.0
49526,4,9526,[302 603 427 100  64],458,5,35749,3.752387950036738,20.0,20.0
49527,4,9527,[302 603 427 100  64],537,4,35753,3.7524139378673382,20.0,20.0
49528,4,9528,[302 603 427 100  64],90,5,35758,3.752544863049638,20.0,20.0
49529,4,9529,[176  95  96 195 173],506,5,35763,3.752675760755509,0.0,0.0
49530,4,9530,[ 22 181  88 100 191],92,3,35766,3.752596789423985,0.0,20.0
49531,4,9531,[245 257 204 111 235],378,3,35769,3.7525178346621906,0.0,0.0
49532,4,9532,[ 96  50 151 172 202],234,1,35770,3.7522290989195426,0.0,20.0
49533,4,9533,[186  89 132 742  69],666,2,35772,3.752045311516677,0.0,0.0
49534,4,9534,[ 98 135 183 655 269],325,4,35776,3.752071316203461,0.0,20.0
49535,4,9535,[302 603 427 100  64],458,5,35781,3.7522021812080535,20.0,20.0
49536,4,9536,[333 202 211 546  98],533,4,35785,3.75222816399287,0.0,20.0
49537,4,9537,[302 603 427 100  64],13,5,35790,3.752358985112183,20.0,20.0
49538,4,9538,[135 176  11   8 269],271,4,35794,3.7523849460111123,0.0,0.0
49539,4,9539,[ 70 655 475  98 483],207,3,35797,3.7523060796645704,20.0,20.0
49540,4,9540,[196 245 127 143 100],346,2,35799,3.752122419033644,0.0,40.0
49541,4,9541,[302 603 427 100  64],13,5,35804,3.7522531963948857,20.0,20.0
49542,4,9542,[302 603 427 100  64],474,5,35809,3.7523839463481083,20.0,20.0
49543,4,9543,[143  25 289  64 678],537,0,35809,3.7519907795473597,0.0,0.0
49544,4,9544,[288  89 328 275 175],13,2,35811,3.7518072289156628,0.0,0.0
49545,4,9545,[174 187   7 117 202],653,3,35814,3.751728472658705,0.0,20.0
49546,4,9546,[ 50  89 237 144 508],653,2,35816,3.7515449879543312,0.0,20.0
49547,4,9547,[302 172 127 176  98],271,4,35820,3.751571009635526,0.0,40.0
49548,4,9548,[135 216 176  95 153],738,4,35824,3.751597025866583,0.0,0.0
49549,4,9549,[204 403  50 117 423],643,2,35826,3.751413612565445,0.0,20.0
49550,4,9550,[100 182 111 172 271],833,3,35829,3.7513349387498693,0.0,20.0
49551,4,9551,[302 603 427 100  64],537,4,35833,3.751360971524288,20.0,20.0
49552,4,9552,[271 135 173 597 121],13,2,35835,3.75117764053177,0.0,0.0
49553,4,9553,[302 603 427 100  64],271,5,35840,3.7513083525225035,20.0,20.0
49554,4,9554,[302 603 427 100  64],666,5,35845,3.751439037153323,20.0,20.0
49555,4,9555,[302 603 427 100  64],664,5,35850,3.751569694432817,20.0,20.0
49556,4,9556,[237 423  95 323  64],59,3,35853,3.7514910536779325,0.0,0.0
49557,4,9557,[100 403 385 179 174],479,1,35854,3.7512031805817116,0.0,40.0
49558,4,9558,[742 191  11 111 318],378,3,35857,3.7511245946228686,20.0,0.0
49559,4,9559,[302 603 427 100  64],454,5,35862,3.751255230125523,20.0,20.0
49560,4,9560,[195 118 228  28 405],788,2,35864,3.7510720635916743,0.0,0.0
49561,4,9561,[302 603 427 100  64],745,5,35869,3.7512026772641707,20.0,20.0
49562,4,9562,[182 100 222 161 294],158,2,35871,3.751019554533096,0.0,20.0
49563,4,9563,[228  50 196  28 168],537,2,35873,3.750836470096194,0.0,20.0
49564,4,9564,[ 56  15 195 172  28],374,2,35875,3.7506534239414533,0.0,0.0
49565,4,9565,[176 202 211  96 179],537,2,35877,3.750470416056868,0.0,0.0
49566,4,9566,[302 603 427 100  64],454,5,35882,3.7506010243545522,20.0,20.0
49567,4,9567,[302 603 427 100  64],370,5,35887,3.7507316053511706,20.0,20.0
49568,4,9568,[302 603 427 100  64],745,5,35892,3.750862159055283,20.0,20.0
49569,4,9569,[302 603 427 100  64],13,5,35897,3.750992685475444,20.0,20.0
49570,4,9570,[302 603 427 100  64],745,5,35902,3.751123184620207,20.0,20.0
49571,4,9571,[302 603 427 100  64],666,5,35907,3.7512536564981196,20.0,20.0
49572,4,9572,[282 195 427 288 597],374,3,35910,3.7511751801942963,0.0,0.0
49573,4,9573,[302 603 427 100  64],664,5,35915,3.7513056193858367,20.0,20.0
49574,4,9574,[ 28 603 427 176 742],42,4,35919,3.751331592689295,20.0,0.0
49575,4,9575,[302 603 427 100  64],458,5,35924,3.7514619883040936,20.0,20.0
49576,4,9576,[235  28 118 245  64],313,2,35926,3.751279106191918,0.0,0.0
49577,4,9577,[302 603 427 100  64],271,5,35931,3.7514094800584674,20.0,20.0
49578,4,9578,[187 191 132  15 234],311,5,35936,3.751539826704249,0.0,0.0
49579,4,9579,[302 603 427 100  64],13,5,35941,3.751670146137787,20.0,20.0
49580,4,9580,[ 56   9 357  79 144],543,5,35946,3.7518004383676025,20.0,0.0
49581,4,9581,[302 603 427 100  64],370,5,35951,3.7519307034022127,20.0,20.0
49582,4,9582,[179  12  15 153 172],92,4,35955,3.751956589794428,20.0,0.0
49583,4,9583,[508  82   9 322  25],207,3,35958,3.7518781302170283,0.0,0.0
49584,4,9584,[508   9 546 323 181],825,4,35962,3.751904016692749,0.0,0.0
49585,4,9585,[300 471 265 180 273],378,3,35965,3.7518255789693304,0.0,0.0
49586,4,9586,[211 187  15  25  50],59,5,35970,3.7519557734432043,0.0,20.0
49587,4,9587,[175  82 172 111 132],653,1,35971,3.751668752607426,0.0,0.0
49588,4,9588,[302 603 427 100  64],745,5,35976,3.7517989362811557,20.0,20.0
49589,4,9589,[483 313 475 322 161],308,1,35977,3.751511991657977,20.0,0.0
49590,4,9590,[ 25 234 191 257 161],804,5,35982,3.751642164529246,0.0,0.0
49591,4,9591,[302 603 427 100  64],537,4,35986,3.7516680567139282,20.0,20.0
49592,4,9592,[302 603 427 100  64],271,5,35991,3.751798186177421,20.0,20.0
49593,4,9593,[ 69 187  96 234 216],188,4,35995,3.7518240567021053,0.0,0.0
49594,4,9594,[237  88 143  79 187],538,3,35998,3.751745700885878,0.0,0.0
49595,4,9595,[568 286 245   7 143],378,4,36002,3.75177157148812,0.0,0.0
49596,4,9596,[258 172 546 127  25],271,2,36004,3.751589038241117,0.0,20.0
49597,4,9597,[204 234 195 186   7],308,4,36008,3.751614919774953,0.0,0.0
49598,4,9598,[265 423 222 678 196],804,4,36012,3.7516407959162414,0.0,0.0
49599,4,9599,[302 603 427 100  64],13,5,36017,3.7517708333333335,20.0,20.0
49600,4,9600,[302 603 427 100  64],370,5,36022,3.7519008436621184,20.0,20.0
49601,4,9601,[ 50 678 195 238  12],387,4,36026,3.751926681941262,20.0,20.0
49602,4,9602,[180  89  22  56 135],892,5,36031,3.7520566489638654,0.0,0.0
49603,4,9603,[302 603 427 100  64],13,5,36036,3.752186588921283,20.0,20.0
49604,4,9604,[302 603 427 100  64],13,5,36041,3.7523165018219675,20.0,20.0
49605,4,9605,[187 265 168 179 121],897,2,36043,3.752134082864876,0.0,0.0
49606,4,9606,[588  69 183 273 515],308,2,36045,3.751951701884043,0.0,0.0
49607,4,9607,[302 603 427 100  64],90,5,36050,3.7520815986677767,20.0,20.0
49608,4,9608,[228 180 423 333 181],653,4,36054,3.752107399313144,0.0,0.0
49609,4,9609,[ 22 228 186 172 127],892,3,36057,3.752029136316337,0.0,20.0
49610,4,9610,[183  79 265 546  64],328,4,36061,3.7520549370512954,0.0,0.0
49611,4,9611,[187  28 176   4 269],343,5,36066,3.752184769038702,0.0,0.0
49612,4,9612,[289 197 181 265 168],13,4,36070,3.7522105482159573,0.0,0.0
49613,4,9613,[742   1 117   8 153],144,5,36075,3.7523403370085293,0.0,0.0
49614,4,9614,[ 95 475  82  64 161],92,2,36077,3.752158086323453,0.0,0.0
49615,4,9615,[ 98 282 180 179 423],653,2,36079,3.7519758735440933,0.0,20.0
49616,4,9616,[302 603 427 100  64],339,5,36084,3.75210564625143,20.0,20.0
49617,4,9617,[183 197 204  96 215],804,5,36089,3.7522353919733833,0.0,0.0
49618,4,9618,[  7 318  95  50 176],59,4,36093,3.7522611498076723,20.0,20.0
49619,4,9619,[302 603 427 100  64],271,5,36098,3.7523908523908522,20.0,20.0
49620,4,9620,[197  56 121 196 385],843,0,36098,3.752000831514396,0.0,0.0
49621,4,9621,[302 603 427 100  64],454,5,36103,3.7521305341924758,20.0,20.0
49622,4,9622,[302 603 427 100  64],474,5,36108,3.7522602099137483,20.0,20.0
49623,4,9623,[  9 403  12 174  69],533,4,36112,3.7522859517871985,20.0,20.0
49624,4,9624,[173 568  88 210 603],42,5,36117,3.7524155844155844,20.0,0.0
49625,4,9625,[302 603 427 100  64],666,5,36122,3.7525451901101183,20.0,20.0
49626,4,9626,[302 603 427 100  64],537,4,36126,3.7525708943596134,20.0,20.0
49627,4,9627,[742 265 200  95 603],308,4,36130,3.7525965932696304,20.0,0.0
49628,4,9628,[234 194 175  88 333],313,4,36134,3.7526222868418317,0.0,0.0
49629,4,9629,[234 132 215 257 143],95,3,36137,3.7525441329179645,0.0,0.0
49630,4,9630,[496 257 318 328  69],653,3,36140,3.7524659952237567,20.0,0.0
49631,4,9631,[117 271 597  79 195],788,2,36142,3.752284053156146,0.0,0.0
49632,4,9632,[222 269 179 181 186],378,2,36144,3.7521021488632824,0.0,0.0
49633,4,9633,[173  82 183 180 135],13,3,36147,3.752024081378451,0.0,0.0
49634,4,9634,[302 603 427 100  64],664,5,36152,3.7521536066424495,20.0,20.0
49635,4,9635,[385  28 275  64 265],328,4,36156,3.752179327521793,0.0,0.0
49636,4,9636,[ 69 174 222 403 186],653,3,36159,3.752101276330808,0.0,20.0
49637,4,9637,[  7  82 175 228 187],7,4,36163,3.752126997302345,0.0,0.0
49638,4,9638,[210 180 294 200  82],13,1,36164,3.7518414773316735,0.0,0.0
49639,4,9639,[302 603 427 100  64],90,5,36169,3.7519709543568465,20.0,20.0
49640,4,9640,[302 603 427 100  64],339,5,36174,3.7521004045223525,20.0,20.0
49641,4,9641,[ 79 204 245  89 588],313,4,36178,3.7521261149139185,0.0,0.0
49642,4,9642,[127 211  71  28  69],328,5,36183,3.7522555221404126,0.0,20.0
49643,4,9643,[194 100 435 385  89],666,3,36186,3.7521775197013687,0.0,20.0
49644,4,9644,[111 151  89 435 117],6,2,36188,3.7519958527734576,0.0,0.0
49645,4,9645,[302 603 427 100  64],271,5,36193,3.7521252332573085,20.0,20.0
49646,4,9646,[302 603 427 100  64],90,5,36198,3.752254586918213,20.0,20.0
49647,4,9647,[200 127 183 276 216],308,4,36202,3.7522802653399667,0.0,20.0
49648,4,9648,[328 323 202 475 496],90,1,36203,3.751995025391232,0.0,0.0
49649,4,9649,[191 385 215 117 135],533,4,36207,3.752020725388601,0.0,0.0
49650,4,9650,[ 95 161 318 265 191],59,3,36210,3.751942803854523,20.0,0.0
49651,4,9651,[328 202 175 182 161],804,5,36215,3.7520721094073766,0.0,0.0
49652,4,9652,[302 603 427 100  64],454,5,36220,3.752201388169481,20.0,20.0
49653,4,9653,[265 742 222 235 471],378,3,36223,3.752123472135902,0.0,0.0
49654,4,9654,[135  69 483 125 228],788,2,36225,3.7519419989642673,20.0,0.0
49655,4,9655,[111 276 265 423 186],334,2,36227,3.7517605633802815,0.0,0.0
49656,4,9656,[302 603 427 100  64],537,4,36231,3.7517862690276482,20.0,20.0
49657,4,9657,[302 603 427 100  64],537,4,36235,3.7518119693518326,20.0,20.0
49658,4,9658,[568  98 222 294 318],788,2,36237,3.7516306035821514,20.0,20.0
49659,4,9659,[100 194  50 196 183],380,5,36242,3.75175983436853,0.0,40.0
49660,4,9660,[302 603 427 100  64],458,5,36247,3.751889038401822,20.0,20.0
49661,4,9661,[302 603 427 100  64],664,5,36252,3.7520182156903332,20.0,20.0
49662,4,9662,[100  89 275 211 179],474,4,36256,3.752043878712615,0.0,20.0
49663,4,9663,[265 186 423 121 182],308,3,36259,3.751966059602649,0.0,0.0
49664,4,9664,[302 603 427 100  64],666,5,36264,3.7520951888256597,20.0,20.0
49665,4,9665,[258 181 403 423 100],749,4,36268,3.7521208359197185,0.0,20.0
49666,4,9666,[234 265   4  22 597],92,3,36271,3.7520430329988623,0.0,0.0
49667,4,9667,[265 222 235   7 202],64,5,36276,3.752172114191146,0.0,0.0
49668,4,9668,[302 603 427 100  64],745,5,36281,3.752301168683421,20.0,20.0
49669,4,9669,[135 197 282 185  95],194,2,36283,3.7521199586349536,0.0,0.0
49670,4,9670,[313 100 258   4 546],92,4,36287,3.7521455899079723,0.0,20.0
49671,4,9671,[302 603 427 100  64],13,5,36292,3.752274607113317,20.0,20.0
49672,4,9672,[ 28 118  12 276 234],343,3,36295,3.75219683655536,20.0,0.0
49673,4,9673,[313 515 333   7 300],537,3,36298,3.7521190820756667,0.0,0.0
49674,4,9674,[302 603 427 100  64],339,5,36303,3.752248062015504,20.0,20.0
49675,4,9675,[ 95 385 357  64 204],95,4,36307,3.7522736668044647,20.0,0.0
49676,4,9676,[483 111 181   7 289],82,3,36310,3.7521959284902344,20.0,0.0
49677,4,9677,[403  95 238 435 186],766,1,36311,3.7519115519735484,0.0,0.0
49678,4,9678,[302 603 427 100  64],666,5,36316,3.7520405000516583,20.0,20.0
49679,4,9679,[302 603 427 100  64],370,5,36321,3.7521694214876034,20.0,20.0
49680,4,9680,[ 82 172 357 234 161],650,3,36324,3.7520917260613573,20.0,0.0
49681,4,9681,[302 603 427 100  64],13,5,36329,3.752220615575294,20.0,20.0
49682,4,9682,[ 79 294 202 195 176],279,2,36331,3.7520396571310544,0.0,0.0
49683,4,9683,[742 483 546  71 111],749,3,36334,3.7519619991738953,20.0,0.0
49684,4,9684,[483 172 127 318 257],385,2,36336,3.751781104801239,40.0,20.0
49685,4,9685,[288   7 172   4 301],378,2,36338,3.7516002477803014,0.0,0.0
49686,4,9686,[655 186 210 176  96],7,4,36342,3.751625890368535,0.0,0.0
49687,4,9687,[210 187  11  64 265],188,4,36346,3.751651527663088,0.0,0.0
49688,4,9688,[748 153  15 172 186],313,1,36347,3.751367530188874,0.0,0.0
49689,4,9689,[302 603 427 100  64],13,5,36352,3.7514963880288956,20.0,20.0
49690,4,9690,[302 603 427 100  64],664,5,36357,3.7516252192756165,20.0,20.0
49691,4,9691,[ 95 238 483 210 185],650,2,36359,3.7514444903012794,20.0,0.0
49692,4,9692,[174 423 185 202  98],215,5,36364,3.7515733003198184,0.0,40.0
49693,4,9693,[427 183 222  50 179],843,2,36366,3.751392613988034,0.0,20.0
49694,4,9694,[ 25  88 286 185 423],537,1,36367,3.7511088189788553,0.0,0.0
49695,4,9695,[286 475  70 258  79],334,4,36371,3.751134488448845,0.0,0.0
49696,4,9696,[238  88 423 132 748],749,3,36374,3.751057027946788,0.0,0.0
49697,4,9697,[568 435 161 200  89],455,4,36378,3.7510826974633944,0.0,0.0
49698,4,9698,[ 15 144 403 318 175],892,4,36382,3.751108361686772,20.0,0.0
49699,4,9699,[289 168 328 597 174],833,1,36383,3.7508247422680414,0.0,20.0
49700,4,9700,[ 50 153 151 405 191],279,2,36385,3.750644263477992,0.0,20.0
49701,4,9701,[508 211  71 237  95],6,2,36387,3.750463821892393,0.0,0.0
49702,4,9702,[275 328 405 508  64],85,1,36388,3.7501803565907452,0.0,0.0
49703,4,9703,[302 603 427 100  64],745,5,36393,3.7503091508656223,20.0,20.0
49704,4,9704,[302 603 427 100  64],745,5,36398,3.7504379185986605,20.0,20.0
49705,4,9705,[  4 151 228 172 161],64,2,36400,3.7502575726354834,0.0,0.0
49706,4,9706,[302 603 427 100  64],458,5,36405,3.750386319151128,20.0,20.0
49707,4,9707,[ 28 135 238 435 173],59,5,36410,3.7505150391429747,0.0,0.0
49708,4,9708,[ 28 322 265 215 333],881,4,36414,3.7505407354001443,0.0,0.0
49709,4,9709,[313 483 568 181 655],59,5,36419,3.750669412976313,20.0,0.0
49710,4,9710,[211 183  95 117 271],749,4,36423,3.750695088044486,0.0,0.0
49711,4,9711,[333 275  28 234  50],458,2,36425,3.750514827018122,0.0,20.0
49712,4,9712,[ 11 173  82 288  69],554,3,36428,3.750437557912077,0.0,0.0
49713,4,9713,[ 22 294  96 176 258],488,4,36432,3.7504632489190857,0.0,0.0
49714,4,9714,[302 603 427 100  64],745,5,36437,3.750591868244982,20.0,20.0
49715,4,9715,[153 483  82 318 144],815,5,36442,3.750720461095101,40.0,0.0
49716,4,9716,[302 603 427 100  64],474,5,36447,3.7508490274776167,20.0,20.0
49717,4,9717,[  4 172 289 182 435],387,2,36449,3.750668861905742,0.0,0.0
49718,4,9718,[302 603 427 100  64],458,5,36454,3.7507974071406522,20.0,20.0
49719,4,9719,[302 603 427 100  64],474,5,36459,3.7509259259259258,20.0,20.0
49720,4,9720,[302 603 427 100  64],745,5,36464,3.7510544182697254,20.0,20.0
49721,4,9721,[117 191  97 175 132],881,2,36466,3.750874305698416,0.0,0.0
49722,4,9722,[202  11 222 282 515],406,1,36467,3.7505913812609277,0.0,0.0
49723,4,9723,[678  12 174 191  98],92,4,36471,3.7506170300287947,20.0,40.0
49724,4,9724,[151 100 405  70 257],213,3,36474,3.7505398457583548,0.0,20.0
49725,4,9725,[215 385 194 183 322],537,0,36474,3.7501542257865514,0.0,0.0
49726,4,9726,[302 603 427 100  64],537,4,36478,3.750179911586306,20.0,20.0
49727,4,9727,[ 64 288 186  69   1],537,1,36479,3.7498972039473686,0.0,0.0
49728,4,9728,[288 318   7 234 427],474,4,36483,3.749922910884983,20.0,0.0
49729,4,9729,[302 603 427 100  64],90,5,36488,3.7500513874614594,20.0,20.0
49730,4,9730,[ 15 111 180  28   1],653,3,36491,3.74997430890967,0.0,0.0
49731,4,9731,[100  15 257 180 323],650,1,36492,3.749691738594328,0.0,20.0
49732,4,9732,[176 678  22 118 121],308,2,36494,3.7495119695879997,0.0,0.0
49733,4,9733,[180 144 176 200 175],7,4,36498,3.749537702897062,0.0,0.0
49734,4,9734,[  1 200  70  50 265],234,2,36500,3.7493579866461224,0.0,20.0
49735,4,9735,[258 546 423  98  95],650,1,36501,3.749075595727198,0.0,20.0
49736,4,9736,[302 603 427 100  64],664,5,36506,3.7492040669610764,20.0,20.0
49737,4,9737,[100 118 176 515 276],343,4,36510,3.7492298213185458,0.0,20.0
49738,4,9738,[ 12 200 210 125 234],378,3,36513,3.749152890440497,20.0,0.0
49739,4,9739,[435  79  82  11 175],343,5,36518,3.749281314168378,0.0,0.0
49740,4,9740,[238 423 117  88 175],653,1,36519,3.7489990760702185,0.0,0.0
49741,4,9741,[273  50 265 385 181],42,3,36522,3.748922192568261,0.0,20.0
49742,4,9742,[ 56 235 172 194 200],648,3,36525,3.748845324848609,0.0,0.0
49743,4,9743,[ 15 258   8   4 151],234,2,36527,3.7486658456486044,0.0,0.0
49744,4,9744,[ 89 276 195 228  22],311,5,36532,3.7487942534633145,0.0,0.0
49745,4,9745,[161 282 202  69 200],95,3,36535,3.7487174225323208,0.0,0.0
49746,4,9746,[204   1 153 655 496],479,4,36539,3.748743203036832,0.0,0.0
49747,4,9747,[748  71  25 496   8],313,2,36541,3.748563807960607,0.0,0.0
49748,4,9748,[302 603 427 100  64],454,5,36546,3.7486921735562624,20.0,20.0
49749,4,9749,[302 603 427 100  64],271,5,36551,3.748820512820513,20.0,20.0
49750,4,9750,[271  64 182 173   9],145,4,36555,3.7488462721772127,0.0,0.0
49751,4,9751,[228  89 151  50 300],7,5,36560,3.748974569319114,0.0,20.0
49752,4,9752,[294 435 144  89   1],648,4,36564,3.749000307597662,0.0,0.0
49753,4,9753,[302 603 427 100  64],271,5,36569,3.749128562640968,20.0,20.0
49754,4,9754,[302 603 427 100  64],458,5,36574,3.749256791389031,20.0,20.0
49755,4,9755,[182 742 197 655 117],454,1,36575,3.7489749897498976,0.0,0.0
49756,4,9756,[276 173 237 185  69],13,3,36578,3.7488982269140103,0.0,0.0
49757,4,9757,[ 69 423 300 197 176],144,4,36582,3.7489239598278337,0.0,0.0
49758,4,9758,[228 403 121  56 143],92,4,36586,3.748949687467978,0.0,0.0
49759,4,9759,[333 405   4 215 483],881,3,36589,3.7488729508196723,20.0,0.0
49760,4,9760,[210 211 286  98 173],95,4,36593,3.748898678414097,0.0,20.0
49761,4,9761,[302 603 427 100  64],458,5,36598,3.7490268387625485,20.0,20.0
49762,4,9762,[318 181  96 301  95],455,3,36601,3.7489501177916624,20.0,0.0
49763,4,9763,[151 294 125 228 135],42,5,36606,3.7490782466202375,0.0,0.0
49764,4,9764,[357 215  50 161 127],774,2,36608,3.748899129544291,20.0,40.0
49765,4,9765,[117 151 238 508 180],339,4,36612,3.7489248412860947,0.0,0.0
49766,4,9766,[ 79 294 289 195 282],881,3,36615,3.7488481621787653,0.0,0.0
49767,4,9767,[181 176 202 191 483],215,5,36620,3.748976248976249,20.0,0.0
49768,4,9768,[  4   1 289 385  64],374,3,36623,3.7488995803050464,0.0,0.0
49769,4,9769,[302 603 427 100  64],13,5,36628,3.7490276356192425,20.0,20.0
49770,4,9770,[302 603 427 100  64],458,5,36633,3.749155664722137,20.0,20.0
49771,4,9771,[174 121 168 323 100],311,3,36636,3.749079001227998,0.0,40.0
49772,4,9772,[302 603 427 100  64],537,4,36640,3.7491046761485727,20.0,20.0
49773,4,9773,[  8  88 117 475 515],308,3,36643,3.7490280335584205,0.0,0.0
49774,4,9774,[294 435 742 323 181],328,3,36646,3.7489514066496166,0.0,0.0
49775,4,9775,[302 603 427 100  64],537,4,36650,3.7489770867430443,20.0,20.0
49776,4,9776,[204  50 211   7 423],387,3,36653,3.7489004807200574,0.0,20.0
49777,4,9777,[ 12 196 403 276 197],144,3,36656,3.748823890366128,20.0,0.0
49778,4,9778,[ 79 168 143 194 603],537,2,36658,3.7486450557316697,20.0,0.0
49779,4,9779,[216 385  56 194 153],378,5,36663,3.7487730061349693,0.0,0.0
49780,4,9780,[302 603 427 100  64],271,5,36668,3.748900930375217,20.0,20.0
49781,4,9781,[186 132 265 423 237],334,2,36670,3.748722142711102,0.0,0.0
49782,4,9782,[135  50 515 427 471],474,4,36674,3.7487478278646633,0.0,20.0
49783,4,9783,[302 603 427 100  64],537,4,36678,3.748773507767784,20.0,20.0
49784,4,9784,[ 11  25 117 546 210],234,0,36678,3.7483903934593767,0.0,0.0
49785,4,9785,[195 357 655 135 132],313,5,36683,3.7485182914367465,20.0,0.0
49786,4,9786,[  7 151 742 176 483],59,4,36687,3.7485439869214265,20.0,0.0
49787,4,9787,[302 603 427 100  64],474,5,36692,3.7486718430731507,20.0,20.0
49788,4,9788,[121  95 228 275 176],882,5,36697,3.7487996731024618,0.0,0.0
49789,4,9789,[222  82 175 269 265],339,4,36701,3.7488253319713993,0.0,0.0
49790,4,9790,[ 96  98 257 588  28],275,2,36703,3.7486467163721784,0.0,20.0
49791,4,9791,[111 318 196 174  11],653,2,36705,3.748468137254902,20.0,20.0
49792,4,9792,[168 273 144 258 176],13,3,36708,3.7483917083631164,0.0,0.0
49793,4,9793,[211 318 276 328  64],90,4,36712,3.748417398407188,20.0,0.0
49794,4,9794,[ 69 132 186 204 238],406,3,36715,3.748340990301174,0.0,0.0
49795,4,9795,[174 475  69 111 496],533,4,36719,3.7483666802776643,0.0,20.0
49796,4,9796,[ 64 313 603  95 175],543,2,36721,3.748188220883944,20.0,0.0
49797,4,9797,[302 603 427 100  64],271,5,36726,3.7483159828536436,20.0,20.0
49798,4,9798,[118 273 181 588  50],892,5,36731,3.748443718746811,0.0,20.0
49799,4,9799,[194 125 204 179 318],7,5,36736,3.7485714285714287,20.0,0.0
49800,4,9800,[187 191 423  28 172],474,5,36741,3.748699112335476,0.0,0.0
49801,4,9801,[187 515 678 427 183],308,3,36744,3.7486227300550907,0.0,0.0
49802,4,9802,[276 176 268 515 748],13,3,36747,3.7485463633581557,0.0,0.0
49803,4,9803,[ 88 135 173   9 151],339,5,36752,3.7486740106079153,0.0,0.0
49804,4,9804,[302 603 427 100  64],664,5,36757,3.7488016318204997,20.0,20.0
49805,4,9805,[181 515 215 121 182],184,4,36761,3.7488272486232916,0.0,0.0
49806,4,9806,[302 603 427 100  64],664,5,36766,3.74895482818395,20.0,20.0
49807,4,9807,[ 89 546 111 151   9],378,2,36768,3.7487765089722673,0.0,0.0
49808,4,9808,[302 603 427 100  64],458,5,36773,3.7489040676929353,20.0,20.0
49809,4,9809,[271  95 234 286 143],325,1,36774,3.748623853211009,0.0,0.0
49810,4,9810,[ 79  50 181  82 403],648,5,36779,3.7487514014881254,0.0,20.0
49811,4,9811,[302 603 427 100  64],745,5,36784,3.7488789237668163,20.0,20.0
49812,4,9812,[194 118 483 204  97],890,4,36788,3.7489045144196473,20.0,0.0
49813,4,9813,[496 210 187 181 588],387,3,36791,3.7488282046056653,0.0,0.0
49814,4,9814,[118 322  79  89 515],804,5,36796,3.748955680081508,0.0,0.0
49815,4,9815,[  7 174 191 215 238],59,5,36801,3.749083129584352,0.0,20.0
49816,4,9816,[302 568 111  56 245],454,2,36803,3.7489049607823164,0.0,0.0
49817,4,9817,[ 11 288 286 182 515],339,4,36807,3.748930535750662,0.0,0.0
49818,4,9818,[302  56   7 179 181],334,5,36812,3.749057948874631,0.0,0.0
49819,4,9819,[302 603 427 100  64],370,5,36817,3.74918533604888,20.0,20.0
49820,4,9820,[216 182 276 135 257],334,3,36820,3.7491090520313612,0.0,0.0
49821,4,9821,[ 11  70 678 302 748],474,3,36823,3.749032783547139,0.0,0.0
49822,4,9822,[ 71 211 546 200 294],7,4,36827,3.749058332484984,0.0,0.0
49823,4,9823,[273 385 175  11 210],13,1,36828,3.7487785016286646,0.0,0.0
49824,4,9824,[302 603 427 100  64],537,4,36832,3.7488040712468194,20.0,20.0
49825,4,9825,[210 197   4  89  88],537,2,36834,3.7486260940362306,0.0,0.0
49826,4,9826,[  1 471 235 385  89],194,1,36835,3.7483463925918388,0.0,0.0
49827,4,9827,[ 70 200 179 238 161],7,3,36838,3.748270248270248,0.0,0.0
49828,4,9828,[ 28 405 175  88 185],13,3,36841,3.7481941194424664,0.0,0.0
49829,4,9829,[ 97 183 127  82 181],881,4,36845,3.7482197355035605,0.0,20.0
49830,4,9830,[121  96 313 271  64],669,2,36847,3.748041908249415,0.0,0.0
49831,4,9831,[ 50 403 143  64 197],95,4,36851,3.74806753458096,0.0,20.0
49832,4,9832,[196 161  22  12 328],92,2,36853,3.7478897589748805,20.0,0.0
49833,4,9833,[222 168 235 191 153],64,4,36857,3.747915395566402,0.0,0.0
49834,4,9834,[302 603 427 100  64],90,5,36862,3.7480427046263345,20.0,20.0
49835,4,9835,[302 603 427 100  64],474,5,36867,3.7481699877999186,20.0,20.0
49836,4,9836,[269 322 187 568 216],13,1,36868,3.747890617058046,0.0,0.0
49837,4,9837,[302 603 427 100  64],458,5,36873,3.748017889815003,20.0,20.0
49838,4,9838,[302 603 427 100  64],745,5,36878,3.7481451367008844,20.0,20.0
49839,4,9839,[302 603 427 100  64],271,5,36883,3.748272357723577,20.0,20.0
49840,4,9840,[302 603 427 100  64],339,5,36888,3.7483995528909664,20.0,20.0
49841,4,9841,[174 471 173 153 238],234,0,36888,3.7480186953871164,0.0,20.0
49842,4,9842,[202 265 302 655 288],378,3,36891,3.7479427003962207,0.0,0.0
49843,4,9843,[ 56 132 655 185   1],488,2,36893,3.747765136123527,0.0,0.0
49844,4,9844,[302 603 427 100  64],458,5,36898,3.7478923311325545,20.0,20.0
49845,4,9845,[174 742 143 200 405],92,1,36899,3.7476132439569367,0.0,20.0
49846,4,9846,[ 79 132 179 173 515],843,1,36900,3.74733421346603,0.0,0.0
49847,4,9847,[655 194 174 588 143],42,4,36904,3.74735987002437,0.0,20.0
49848,4,9848,[302 603 427 100  64],537,4,36908,3.747385521372728,20.0,20.0
49849,4,9849,[ 97  50 265  22  11],686,4,36912,3.7474111675126904,0.0,20.0
49850,4,9850,[603 153   1 496 471],308,3,36915,3.747335295909045,20.0,0.0
49851,4,9851,[302 603 427 100  64],745,5,36920,3.7474624441737716,20.0,20.0
49852,4,9852,[222 187   7   9 515],13,1,36921,3.747183598903887,0.0,0.0
49853,4,9853,[100 216 174 182 234],288,5,36926,3.747310736756647,0.0,40.0
49854,4,9854,[302 603 427 100  64],271,5,36931,3.747437848807712,20.0,20.0
49855,4,9855,[302 603 427 100  64],745,5,36936,3.747564935064935,20.0,20.0
49856,4,9856,[100 435 423 172 323],474,4,36940,3.747590544790504,0.0,20.0
49857,4,9857,[302 603 427 100  64],13,5,36945,3.747717589774802,20.0,20.0
49858,4,9858,[328   8 127 333 273],144,3,36948,3.7476417486560503,0.0,20.0
49859,4,9859,[302 603 427 100  64],339,5,36953,3.747768762677485,20.0,20.0
49860,4,9860,[302 603 427 100  64],666,5,36958,3.7478957509380386,20.0,20.0
49861,4,9861,[302 603 427 100  64],474,5,36963,3.7480227134455486,20.0,20.0
49862,4,9862,[302 603 427 100  64],666,5,36968,3.7481496502078473,20.0,20.0
49863,4,9863,[235 195 237  95 238],13,2,36970,3.747972424979724,0.0,0.0
49864,4,9864,[144  69 180 196 186],343,5,36975,3.748099341104916,0.0,0.0
49865,4,9865,[302 603 427 100  64],474,5,36980,3.7482262315021284,20.0,20.0
49866,4,9866,[302 603 427 100  64],745,5,36985,3.748353096179183,20.0,20.0
49867,4,9867,[ 64 117  79 546 180],234,1,36986,3.748074584515606,0.0,0.0
49868,4,9868,[ 96 597 194 234 273],774,0,36986,3.747694801904955,0.0,0.0
49869,4,9869,[302 603 427 100  64],13,5,36991,3.747821681864235,20.0,20.0
49870,4,9870,[568 186 174  89 172],85,3,36994,3.747745922398946,0.0,20.0
49871,4,9871,[302 603 427 100  64],745,5,36999,3.7478727714748783,20.0,20.0
49872,4,9872,[302 603 427 100  64],370,5,37004,3.747999594854654,20.0,20.0
49873,4,9873,[ 25 294 168 127 323],650,1,37005,3.7477212882317197,0.0,20.0
49874,4,9874,[318  79 195 323 181],13,1,37006,3.7474430379746835,20.0,0.0
49875,4,9875,[302 603 427 100  64],13,5,37011,3.7475698663426487,20.0,20.0
49876,4,9876,[302 603 427 100  64],90,5,37016,3.7476966690290574,20.0,20.0
49877,4,9877,[302 603 427 100  64],537,4,37020,3.7477222109738815,20.0,20.0
49878,4,9878,[117 258 182 257 597],119,4,37024,3.7477477477477477,0.0,0.0
49879,4,9879,[302 603 427 100  64],370,5,37029,3.7478744939271254,20.0,20.0
49880,4,9880,[204  95 234 215  71],233,5,37034,3.7480012144519788,0.0,0.0
49881,4,9881,[168  96 245 132 471],313,3,37037,3.747925521149565,0.0,0.0
49882,4,9882,[405 143 181 288 168],666,1,37038,3.7476474754629163,0.0,0.0
49883,4,9883,[181 333  50 117 515],548,5,37043,3.7477741804937272,0.0,20.0
49884,4,9884,[302 603 427 100  64],90,5,37048,3.7479008598887202,20.0,20.0
49885,4,9885,[302 603 427 100  64],454,5,37053,3.748027513655675,20.0,20.0
49886,4,9886,[318  89 144 195 276],374,2,37055,3.7478507130575505,20.0,0.0
49887,4,9887,[187   8 195 181 282],311,5,37060,3.7479773462783172,0.0,0.0
49888,4,9888,[403 427 471  15 204],313,3,37063,3.7479017089695623,0.0,0.0
49889,4,9889,[ 95 194 403 191 294],804,3,37066,3.747826086956522,0.0,0.0
49890,4,9890,[200 546 234 597 194],650,3,37069,3.7477504802345565,0.0,0.0
49891,4,9891,[127 237 333 117 194],537,1,37070,3.7474727052163366,0.0,20.0
49892,4,9892,[302 603 427 100  64],339,5,37075,3.747599312645305,20.0,20.0
49893,4,9893,[200 748 117 275 237],328,4,37079,3.7476248231251263,0.0,0.0
49894,4,9894,[302 603 427 100  64],458,5,37084,3.7477513895907024,20.0,20.0
49895,4,9895,[302 603 427 100  64],90,5,37089,3.7478779304769603,20.0,20.0
49896,4,9896,[302 603 427 100  64],666,5,37094,3.748004445791654,20.0,20.0
49897,4,9897,[302 603 427 100  64],271,5,37099,3.748130935542534,20.0,20.0
49898,4,9898,[302 603 427 100  64],454,5,37104,3.7482573997373474,20.0,20.0
49899,4,9899,[427  56 300 508 483],533,4,37108,3.748282828282828,20.0,0.0
49900,4,9900,[  4 405 121 435 748],64,1,37109,3.748005251994748,0.0,0.0
49901,4,9901,[302 603 427 100  64],458,5,37114,3.748131690567562,20.0,20.0
49902,4,9902,[302 603 427 100  64],90,5,37119,3.748258103604968,20.0,20.0
49903,4,9903,[197 234 300 168 196],85,4,37123,3.7482835218093697,0.0,0.0
49904,4,9904,[302 603 427 100  64],13,5,37128,3.7484098939929327,20.0,20.0
49905,4,9905,[405 191 515 181 175],815,4,37132,3.7484352917423784,0.0,0.0
49906,4,9906,[ 12  88   4 176 282],474,5,37137,3.7485616230947816,20.0,0.0
49907,4,9907,[ 82 288 202  88 275],648,5,37142,3.748687928946306,0.0,0.0
49908,4,9908,[191 385  25 182 135],378,4,37146,3.7487132909476233,0.0,0.0
49909,4,9909,[ 82 257 191 151  56],385,1,37147,3.748435923309788,0.0,0.0
49910,4,9910,[496 185 200  95  28],815,3,37150,3.7483604076278882,0.0,0.0
49911,4,9911,[385 322 195 191 302],454,3,37153,3.748284907183212,0.0,0.0
49912,4,9912,[357 185 313 194 603],543,3,37156,3.748209421971149,40.0,0.0
49913,4,9913,[172 121  70  64  56],311,5,37161,3.748335686907404,0.0,0.0
49914,4,9914,[302 603 427 100  64],745,5,37166,3.7484619263741807,20.0,20.0
49915,4,9915,[496 288 742   1 257],650,1,37167,3.7481847519160953,0.0,0.0
49916,4,9916,[ 28  82 186 286 185],7,4,37171,3.748210144196834,0.0,0.0
49917,4,9917,[117 333 196 132  28],537,0,37171,3.7478322242387576,0.0,0.0
49918,4,9918,[181 144 568  71 588],378,5,37176,3.747958463554794,0.0,0.0
49919,4,9919,[195 222 100 238 294],749,1,37177,3.747681451612903,0.0,20.0
49920,4,9920,[235 191  22 153  15],650,2,37179,3.7475052918052616,0.0,0.0
49921,4,9921,[ 88 515 286 210 132],60,5,37184,3.747631525902036,0.0,0.0
49922,4,9922,[100 215  98 276 204],311,4,37188,3.747656958581074,0.0,40.0
49923,4,9923,[302 603 427 100  64],13,5,37193,3.747783151954857,20.0,20.0
49924,4,9924,[176   4 181 603   9],7,3,37196,3.7477078085642317,20.0,0.0
49925,4,9925,[302 603 427 100  64],474,5,37201,3.7478339713882733,20.0,20.0
49926,4,9926,[302 603 427 100  64],666,5,37206,3.7479601087941976,20.0,20.0
49927,4,9927,[302 603 427 100  64],537,4,37210,3.7479854955680905,20.0,20.0
49928,4,9928,[302 603 427 100  64],537,4,37214,3.748010877228321,20.0,20.0
49929,4,9929,[302 603 427 100  64],90,5,37219,3.748136958710977,20.0,20.0
49930,4,9930,[ 69 204 275 186 191],533,4,37223,3.7481623200080554,0.0,0.0
49931,4,9931,[302 603 427 100  64],664,5,37228,3.748288360853806,20.0,20.0
49932,4,9932,[546  97  71 144 210],194,2,37230,3.7481123527635156,0.0,0.0
49933,4,9933,[302 603 427 100  64],537,4,37234,3.7481377088785988,20.0,20.0
49934,4,9934,[318   4   9 603 427],527,3,37237,3.748062405636638,40.0,0.0
49935,4,9935,[216  70  89 496 174],85,4,37241,3.7480877616747184,0.0,20.0
49936,4,9936,[100  89 176 655 403],738,2,37243,3.747911844621113,0.0,20.0
49937,4,9937,[ 22 168 286 427 197],615,5,37248,3.7480378345743612,0.0,0.0
49938,4,9938,[496 182 204 180 423],840,5,37253,3.7481637991749674,0.0,0.0
49939,4,9939,[302 603 427 100  64],664,5,37258,3.7482897384305836,20.0,20.0
49940,4,9940,[202 182 211  79 180],653,2,37260,3.748113871843879,0.0,0.0
49941,4,9941,[197 423  11 195 179],234,2,37262,3.747938040635687,0.0,0.0
49942,4,9942,[423 427 135  98 183],328,3,37265,3.7478628180629587,0.0,20.0
49943,4,9943,[302 603 427 100  64],745,5,37270,3.74798873692679,20.0,20.0
49944,4,9944,[ 89  50 294  69 210],92,4,37274,3.748014077425842,0.0,20.0
49945,4,9945,[435  64  98 237 258],90,4,37278,3.748039412829278,0.0,20.0
49946,4,9946,[ 70 153 357 181 215],184,4,37282,3.748064743138635,20.0,0.0
49947,4,9947,[ 12 180   7 471  22],343,5,37287,3.7481905910735827,20.0,0.0
49948,4,9948,[302 603 427 100  64],271,5,37292,3.7483164137099205,20.0,20.0
49949,4,9949,[302 603 427 100  64],474,5,37297,3.748442211055276,20.0,20.0
49950,4,9950,[ 11 179  25 191 215],92,4,37301,3.748467490704452,0.0,0.0
49951,4,9951,[742  50 181 125  15],374,2,37303,3.748291800643087,0.0,20.0
49952,4,9952,[302 603 427 100  64],666,5,37308,3.7484175625439566,20.0,20.0
49953,4,9953,[161 286   9 385   8],7,4,37312,3.748442837050432,0.0,0.0
49954,4,9954,[302 603 427 100  64],537,4,37316,3.748468106479156,20.0,20.0
49955,4,9955,[ 15 121 515  70 568],882,4,37320,3.7484933708316595,0.0,0.0
49956,4,9956,[228 183  56 185 588],82,1,37321,3.7482173345385155,0.0,0.0
49957,4,9957,[265 202 172 597 318],92,2,37323,3.748041775456919,20.0,0.0
49958,4,9958,[194 265 588 269 195],650,4,37327,3.7480670750075307,0.0,0.0
49959,4,9959,[ 89 286 204 168  12],940,3,37330,3.747991967871486,20.0,0.0
49960,4,9960,[ 97 568 132 216 302],339,3,37333,3.7479168758156813,0.0,0.0
49961,4,9961,[302 603 427 100  64],458,5,37338,3.7480425617345916,20.0,20.0
49962,4,9962,[302 603 427 100  64],474,5,37343,3.748168222422965,20.0,20.0
49963,4,9963,[222 180 546 153 275],279,1,37344,3.7478924126856685,0.0,0.0
49964,4,9964,[  9 117  97 100 195],339,3,37347,3.7478173607626695,0.0,20.0
49965,4,9965,[187 117  22 100 496],313,4,37351,3.7478426650612082,0.0,20.0
49966,4,9966,[200 183 405  11 258],666,4,37355,3.747867964282131,0.0,0.0
49967,4,9967,[175 328 168  96 173],537,3,37358,3.747792937399679,0.0,0.0
49968,4,9968,[333 238 180 302 121],605,3,37361,3.7477179255692645,0.0,0.0
49969,4,9969,[302 603 427 100  64],745,5,37366,3.7478435305917754,20.0,20.0
49970,4,9970,[210 132 268 175 179],77,3,37369,3.7477685287333267,0.0,0.0
49971,4,9971,[  1 197 328 294 144],653,2,37371,3.747593261131167,0.0,0.0
49972,4,9972,[202 100 173 183 144],158,4,37375,3.7476185701393763,0.0,20.0
49973,4,9973,[118 228 210 483 183],13,4,37379,3.7476438740725886,20.0,0.0
49974,4,9974,[257  28 235   7  71],279,2,37381,3.747468671679198,0.0,0.0
49975,4,9975,[196  71  50 568 515],892,4,37385,3.747493985565357,0.0,20.0
49976,4,9976,[496   4 471 143 127],666,4,37389,3.747519294377067,0.0,20.0
49977,4,9977,[385 197 175  88 216],474,5,37394,3.747644818600922,0.0,0.0
49978,4,9978,[ 28  12 385 275 191],533,5,37399,3.747770317667101,20.0,0.0
49979,4,9979,[302 603 427 100  64],537,4,37403,3.747795591182365,20.0,20.0
49980,4,9980,[302 603 427 100  64],271,5,37408,3.7479210499949906,20.0,20.0
49981,4,9981,[135 405  25 276 234],447,4,37412,3.7479463033460227,0.0,0.0
49982,4,9982,[483 117  71 182 151],650,2,37414,3.7477712110588,20.0,0.0
49983,4,9983,[132 202 195 127  64],892,5,37419,3.7478966346153846,0.0,20.0
49984,4,9984,[204 222   4 186   7],882,5,37424,3.7480220330495744,0.0,0.0
49985,4,9985,[294  79   4 275 546],13,1,37425,3.7477468455838174,0.0,0.0
49986,4,9986,[ 89  98 135 357 191],85,5,37430,3.7478722339040753,20.0,20.0
49987,4,9987,[302 603 427 100  64],458,5,37435,3.74799759711654,20.0,20.0
49988,4,9988,[302 603 427 100  64],339,5,37440,3.7481229352287517,20.0,20.0
49989,4,9989,[271 118   7 257  71],738,1,37441,3.7478478478478476,0.0,0.0
49990,4,9990,[302 603 427 100  64],474,5,37446,3.7479731758582724,20.0,20.0
49991,4,9991,[ 69 423 269 483  64],6,3,37449,3.747898318654924,20.0,0.0
49992,4,9992,[302 603 427 100  64],664,5,37454,3.748023616531572,20.0,20.0
49993,4,9993,[302 603 427 100  64],458,5,37459,3.7481488893336,20.0,20.0
49994,4,9994,[235 237 228 195 435],313,2,37461,3.7479739869934967,0.0,0.0
49995,4,9995,[302 603 427 100  64],474,5,37466,3.7480992396958785,20.0,20.0
49996,4,9996,[200 182 183 161  79],380,3,37469,3.7480244073221964,0.0,0.0
49997,4,9997,[269 174 471 204 175],537,1,37470,3.747749549909982,0.0,20.0
49998,4,9998,[302 603 427 100  64],90,5,37475,3.747874787478748,20.0,20.0
49999,4,9999,[302 603 427 100  64],537,4,37479,3.7479,20.0,20.0
