,iteration,visit,item_id_list,visitor_id,reward,total_reward,fraction_relevant,percentage_overlap_rating,percentage_overlap_like
0,0,0,[280 206 420 485 209],293,2,2,2.0,0.0,0.0
1,0,1,[268 295 243 508 259],936,1,3,1.5,0.0,20.0
2,0,2,[290 344 350 222 211],758,4,7,2.3333333333333335,0.0,20.0
3,0,3,[212 275 230 221 222],201,2,9,2.25,0.0,20.0
4,0,4,[250 213 227 378 216],790,2,11,2.2,0.0,20.0
5,0,5,[232 392 247 231 240],222,2,13,2.1666666666666665,0.0,0.0
6,0,6,[275 321 243 283 220],181,1,14,2.0,0.0,0.0
7,0,7,[216 212 232 220 250],1,3,17,2.125,0.0,20.0
8,0,8,[216 206 250 290 268],435,3,20,2.2222222222222223,0.0,40.0
9,0,9,[321 291 508 202 293],303,3,23,2.3,0.0,0.0
10,0,10,[216 202 230 293 315],758,4,27,2.4545454545454546,20.0,20.0
11,0,11,[290 429 223 301 291],276,4,31,2.5833333333333335,20.0,0.0
12,0,12,[508 293 222 268 365],276,4,35,2.6923076923076925,0.0,40.0
13,0,13,[227 283 208 293 246],303,3,38,2.7142857142857144,0.0,0.0
14,0,14,[211 202 420 246 268],94,4,42,2.8,0.0,20.0
15,0,15,[250 259 367 384 246],682,2,44,2.75,0.0,0.0
16,0,16,[227 384 429 367 293],276,3,47,2.764705882352941,0.0,0.0
17,0,17,[211 420 250 212 301],758,3,50,2.7777777777777777,0.0,0.0
18,0,18,[221 218 240 303 324],758,3,53,2.789473684210526,0.0,0.0
19,0,19,[264 301 254 583 298],276,2,55,2.75,0.0,20.0
20,0,20,[315 218 350 223 298],363,2,57,2.7142857142857144,40.0,20.0
21,0,21,[365 275 264 211 378],429,2,59,2.6818181818181817,0.0,0.0
22,0,22,[223 250 298 392 208],222,3,62,2.6956521739130435,20.0,20.0
23,0,23,[246 452 384 283 216],303,2,64,2.6666666666666665,0.0,20.0
24,0,24,[217 298 223 291 250],758,4,68,2.72,20.0,20.0
25,0,25,[284 452 367 226 431],222,1,69,2.6538461538461537,0.0,0.0
26,0,26,[226 216 378 209 284],682,2,71,2.6296296296296298,0.0,20.0
27,0,27,[272 231 201 240 213],1,0,71,2.5357142857142856,20.0,0.0
28,0,28,[226 215 429 212 217],846,4,75,2.586206896551724,0.0,0.0
29,0,29,[392 301 230 231 202],880,2,77,2.566666666666667,0.0,0.0
30,0,30,[324 215 223 298 303],592,5,82,2.6451612903225805,20.0,20.0
31,0,31,[324 215 223 298 303],276,5,87,2.71875,20.0,20.0
32,0,32,[324 215 223 298 303],592,5,92,2.787878787878788,20.0,20.0
33,0,33,[324 215 223 298 303],592,5,97,2.8529411764705883,20.0,20.0
34,0,34,[324 215 223 298 303],592,5,102,2.914285714285714,20.0,20.0
35,0,35,[324 215 223 298 303],276,5,107,2.9722222222222223,20.0,20.0
36,0,36,[324 215 223 298 303],276,5,112,3.027027027027027,20.0,20.0
37,0,37,[324 215 223 298 303],276,5,117,3.0789473684210527,20.0,20.0
38,0,38,[324 215 223 298 303],592,5,122,3.128205128205128,20.0,20.0
39,0,39,[431 241 232 283 298],429,3,125,3.125,0.0,20.0
40,0,40,[268 212 303 215 211],201,2,127,3.097560975609756,0.0,20.0
41,0,41,[268 206 246 431 212],916,3,130,3.0952380952380953,0.0,20.0
42,0,42,[268 298 246 212 223],889,4,134,3.116279069767442,20.0,40.0
43,0,43,[268 298 246 223 324],592,5,139,3.159090909090909,20.0,40.0
44,0,44,[268 298 246 223 324],347,4,143,3.1777777777777776,20.0,40.0
45,0,45,[268 298 246 223 324],276,5,148,3.217391304347826,20.0,40.0
46,0,46,[268 298 246 223 324],303,4,152,3.234042553191489,20.0,40.0
47,0,47,[452 390 219 231 284],303,3,155,3.2291666666666665,0.0,0.0
48,0,48,[223 298 268 246 219],276,5,160,3.2653061224489797,20.0,40.0
49,0,49,[365 211 241 230 268],790,5,165,3.3,0.0,20.0
50,0,50,[223 246 298 219 268],222,5,170,3.3333333333333335,20.0,40.0
51,0,51,[223 246 298 219 268],889,4,174,3.3461538461538463,20.0,40.0
52,0,52,[223 246 298 268 215],453,4,178,3.358490566037736,20.0,40.0
53,0,53,[300 246 202 209 255],682,2,180,3.3333333333333335,0.0,20.0
54,0,54,[223 246 298 268 303],567,4,184,3.3454545454545452,20.0,40.0
55,0,55,[255 367 431 246 201],682,3,187,3.3392857142857144,0.0,0.0
56,0,56,[227 218 264 241 508],429,1,188,3.2982456140350878,0.0,0.0
57,0,57,[268 223 298 246 212],916,4,192,3.310344827586207,20.0,40.0
58,0,58,[246 206 367 254 218],435,2,194,3.288135593220339,0.0,0.0
59,0,59,[268 223 246 298 212],916,4,198,3.3,20.0,40.0
60,0,60,[268 223 246 298 212],916,4,202,3.3114754098360657,20.0,40.0
61,0,61,[201 218 244 221 240],919,3,205,3.306451612903226,0.0,0.0
62,0,62,[276 315 231 254 298],276,3,208,3.3015873015873014,20.0,20.0
63,0,63,[246 223 268 276 212],889,4,212,3.3125,20.0,20.0
64,0,64,[246 223 268 276 298],916,4,216,3.3230769230769233,20.0,40.0
65,0,65,[246 223 268 276 298],222,5,221,3.3484848484848486,20.0,40.0
66,0,66,[246 223 268 276 298],453,5,226,3.373134328358209,20.0,40.0
67,0,67,[246 223 268 276 298],916,4,230,3.3823529411764706,20.0,40.0
68,0,68,[246 223 268 276 250],592,5,235,3.4057971014492754,20.0,20.0
69,0,69,[316 268 222 300 583],276,4,239,3.414285714285714,20.0,60.0
70,0,70,[316 223 276 268 246],500,4,243,3.4225352112676055,40.0,20.0
71,0,71,[246 268 276 223 250],222,4,247,3.4305555555555554,20.0,20.0
72,0,72,[246 268 276 223 324],276,5,252,3.452054794520548,20.0,20.0
73,0,73,[367 326 259 298 223],178,3,255,3.445945945945946,20.0,20.0
74,0,74,[246 268 276 326 223],222,5,260,3.466666666666667,20.0,20.0
75,0,75,[246 268 276 326 223],178,4,264,3.473684210526316,20.0,20.0
76,0,76,[246 268 326 223 276],222,5,269,3.4935064935064934,20.0,20.0
77,0,77,[230 301 315 293 583],276,4,273,3.5,20.0,0.0
78,0,78,[246 268 326 223 276],303,4,277,3.5063291139240507,20.0,20.0
79,0,79,[223 268 246 276 324],347,3,280,3.5,20.0,20.0
80,0,80,[268 246 223 276 293],303,5,285,3.5185185185185186,20.0,20.0
81,0,81,[384 223 300 276 367],276,3,288,3.5121951219512195,20.0,20.0
82,0,82,[246 223 268 276 293],276,5,293,3.5301204819277108,20.0,20.0
83,0,83,[246 223 268 276 293],178,4,297,3.5357142857142856,20.0,20.0
84,0,84,[246 223 268 293 276],682,3,300,3.5294117647058822,20.0,20.0
85,0,85,[452 276 255 508 367],222,1,301,3.5,0.0,0.0
86,0,86,[268 246 223 293 216],222,4,305,3.5057471264367814,20.0,40.0
87,0,87,[268 246 223 216 211],916,5,310,3.522727272727273,20.0,40.0
88,0,88,[250 209 230 219 212],1,4,314,3.5280898876404496,0.0,0.0
89,0,89,[268 246 223 216 211],870,2,316,3.511111111111111,20.0,40.0
90,0,90,[290 303 509 209 208],747,3,319,3.5054945054945055,0.0,0.0
91,0,91,[509 223 246 268 216],682,3,322,3.5,20.0,40.0
92,0,92,[246 268 223 216 303],592,5,327,3.5161290322580645,20.0,40.0
93,0,93,[255 283 206 298 275],293,2,329,3.5,0.0,20.0
94,0,94,[268 246 223 216 303],889,4,333,3.5052631578947366,20.0,40.0
95,0,95,[268 246 223 216 212],1,5,338,3.5208333333333335,20.0,40.0
96,0,96,[268 246 223 216 212],305,2,340,3.5051546391752577,20.0,40.0
97,0,97,[223 268 246 216 215],94,4,344,3.510204081632653,20.0,40.0
98,0,98,[223 268 246 216 215],94,4,348,3.515151515151515,20.0,40.0
99,0,99,[223 268 246 215 298],323,5,353,3.53,20.0,40.0
100,0,100,[223 268 246 215 298],178,4,357,3.5346534653465347,20.0,40.0
101,0,101,[223 268 246 215 293],222,4,361,3.5392156862745097,20.0,20.0
102,0,102,[223 268 246 215 324],347,4,365,3.5436893203883497,20.0,20.0
103,0,103,[223 268 246 215 216],592,5,370,3.5576923076923075,20.0,40.0
104,0,104,[223 268 246 215 216],1,4,374,3.5619047619047617,20.0,40.0
105,0,105,[223 268 246 215 216],305,2,376,3.547169811320755,20.0,40.0
106,0,106,[223 268 246 216 276],222,5,381,3.560747663551402,20.0,40.0
107,0,107,[223 268 246 216 276],592,5,386,3.574074074074074,20.0,40.0
108,0,108,[223 268 246 216 276],178,4,390,3.5779816513761467,20.0,40.0
109,0,109,[223 268 246 216 215],178,5,395,3.590909090909091,20.0,40.0
110,0,110,[208 221 290 216 301],758,3,398,3.5855855855855854,0.0,20.0
111,0,111,[223 246 268 216 215],303,5,403,3.5982142857142856,20.0,40.0
112,0,112,[223 246 268 216 215],1,4,407,3.601769911504425,20.0,40.0
113,0,113,[223 246 268 216 298],500,5,412,3.6140350877192984,20.0,60.0
114,0,114,[241 276 321 272 215],201,1,413,3.591304347826087,20.0,0.0
115,0,115,[223 268 246 216 298],347,4,417,3.5948275862068964,20.0,60.0
116,0,116,[223 268 246 216 298],347,4,421,3.5982905982905984,20.0,60.0
117,0,117,[223 268 246 216 298],916,4,425,3.6016949152542375,20.0,60.0
118,0,118,[420 275 272 264 209],293,2,427,3.588235294117647,20.0,0.0
119,0,119,[223 246 268 216 250],916,5,432,3.6,20.0,40.0
120,0,120,[223 246 268 216 250],682,4,436,3.603305785123967,20.0,40.0
121,0,121,[223 246 268 216 250],222,4,440,3.6065573770491803,20.0,40.0
122,0,122,[223 246 268 216 326],303,4,444,3.6097560975609757,20.0,40.0
123,0,123,[223 246 268 216 206],94,4,448,3.6129032258064515,20.0,40.0
124,0,124,[223 246 268 206 216],1,5,453,3.624,20.0,40.0
125,0,125,[240 283 208 324 239],303,1,454,3.6031746031746033,0.0,0.0
126,0,126,[223 246 268 206 216],916,4,458,3.606299212598425,20.0,40.0
127,0,127,[223 246 268 216 208],222,4,462,3.609375,20.0,40.0
128,0,128,[223 246 268 216 202],347,4,466,3.612403100775194,20.0,40.0
129,0,129,[223 246 268 202 216],916,4,470,3.6153846153846154,20.0,40.0
130,0,130,[223 246 268 216 298],500,5,475,3.6259541984732824,20.0,60.0
131,0,131,[223 246 268 216 298],592,5,480,3.6363636363636362,20.0,60.0
132,0,132,[223 246 268 216 298],303,5,485,3.6466165413533833,20.0,60.0
133,0,133,[223 246 268 216 298],178,4,489,3.6492537313432836,20.0,60.0
134,0,134,[223 246 268 216 303],889,4,493,3.651851851851852,20.0,40.0
135,0,135,[223 246 268 216 276],870,3,496,3.6470588235294117,20.0,40.0
136,0,136,[223 246 268 216 276],870,3,499,3.6423357664233578,20.0,40.0
137,0,137,[223 246 268 216 276],682,3,502,3.63768115942029,20.0,40.0
138,0,138,[223 246 268 216 298],303,5,507,3.647482014388489,20.0,60.0
139,0,139,[223 246 268 216 298],889,5,512,3.657142857142857,20.0,60.0
140,0,140,[239 202 392 324 227],347,3,515,3.652482269503546,0.0,0.0
141,0,141,[223 246 268 216 298],305,3,518,3.647887323943662,20.0,60.0
142,0,142,[223 246 268 216 298],682,4,522,3.6503496503496504,20.0,60.0
143,0,143,[223 246 268 216 298],500,5,527,3.6597222222222223,20.0,60.0
144,0,144,[223 246 268 216 298],178,4,531,3.6620689655172414,20.0,60.0
145,0,145,[223 246 268 216 298],916,4,535,3.664383561643836,20.0,60.0
146,0,146,[223 246 268 216 276],347,3,538,3.6598639455782314,20.0,40.0
147,0,147,[223 246 268 216 212],916,5,543,3.668918918918919,20.0,40.0
148,0,148,[230 259 218 267 206],268,0,543,3.6442953020134228,0.0,0.0
149,0,149,[223 246 268 216 212],305,2,545,3.6333333333333333,20.0,40.0
150,0,150,[223 246 268 216 298],592,5,550,3.642384105960265,20.0,60.0
151,0,151,[223 246 268 216 298],592,5,555,3.651315789473684,20.0,60.0
152,0,152,[223 246 268 216 298],889,5,560,3.6601307189542482,20.0,60.0
153,0,153,[223 246 268 216 298],222,5,565,3.668831168831169,20.0,60.0
154,0,154,[223 246 268 216 298],500,5,570,3.6774193548387095,20.0,60.0
155,0,155,[223 246 268 216 298],303,5,575,3.6858974358974357,20.0,60.0
156,0,156,[223 246 268 216 298],916,4,579,3.6878980891719744,20.0,60.0
157,0,157,[223 246 268 216 298],347,4,583,3.689873417721519,20.0,60.0
158,0,158,[223 246 268 216 298],222,5,588,3.69811320754717,20.0,60.0
159,0,159,[223 246 268 216 298],303,5,593,3.70625,20.0,60.0
160,0,160,[223 246 268 216 298],305,3,596,3.701863354037267,20.0,60.0
161,0,161,[223 246 268 216 298],347,4,600,3.7037037037037037,20.0,60.0
162,0,162,[223 246 268 216 298],592,5,605,3.7116564417177913,20.0,60.0
163,0,163,[223 246 268 216 298],347,4,609,3.7134146341463414,20.0,60.0
164,0,164,[223 246 268 216 298],500,5,614,3.721212121212121,20.0,60.0
165,0,165,[223 246 268 216 298],682,4,618,3.7228915662650603,20.0,60.0
166,0,166,[223 246 268 216 298],305,3,621,3.718562874251497,20.0,60.0
167,0,167,[223 246 268 216 298],303,5,626,3.7261904761904763,20.0,60.0
168,0,168,[223 246 268 216 298],500,5,631,3.7337278106508878,20.0,60.0
169,0,169,[223 246 268 216 298],178,4,635,3.735294117647059,20.0,60.0
170,0,170,[223 246 268 216 298],500,5,640,3.742690058479532,20.0,60.0
171,0,171,[223 246 268 216 298],222,5,645,3.75,20.0,60.0
172,0,172,[223 246 268 216 298],222,5,650,3.7572254335260116,20.0,60.0
173,0,173,[223 246 268 216 298],222,5,655,3.764367816091954,20.0,60.0
174,0,174,[223 246 268 216 298],500,5,660,3.7714285714285714,20.0,60.0
175,0,175,[223 246 268 216 298],500,5,665,3.778409090909091,20.0,60.0
176,0,176,[223 246 268 216 298],682,4,669,3.7796610169491527,20.0,60.0
177,0,177,[223 246 268 216 298],592,5,674,3.7865168539325844,20.0,60.0
178,0,178,[223 246 268 216 298],303,5,679,3.793296089385475,20.0,60.0
179,0,179,[223 246 268 216 298],682,4,683,3.7944444444444443,20.0,60.0
180,0,180,[384 240 241 276 251],303,3,686,3.7900552486187844,0.0,0.0
181,0,181,[251 223 246 268 216],303,5,691,3.7967032967032965,20.0,40.0
182,0,182,[239 276 297 275 212],299,3,694,3.7923497267759565,0.0,0.0
183,0,183,[232 216 275 217 392],429,3,697,3.7880434782608696,0.0,20.0
184,0,184,[251 223 268 246 216],592,5,702,3.7945945945945945,20.0,40.0
185,0,185,[251 223 268 246 216],303,5,707,3.8010752688172045,20.0,40.0
186,0,186,[251 223 268 246 216],303,5,712,3.807486631016043,20.0,40.0
187,0,187,[212 350 301 208 206],363,1,713,3.7925531914893615,0.0,0.0
188,0,188,[303 272 240 316 206],276,5,718,3.798941798941799,40.0,0.0
189,0,189,[290 222 507 344 394],393,2,720,3.789473684210526,0.0,20.0
190,0,190,[267 223 264 255 240],1,2,722,3.7801047120418847,20.0,0.0
191,0,191,[241 508 227 246 295],399,2,724,3.7708333333333335,0.0,0.0
192,0,192,[303 221 222 264 326],181,1,725,3.756476683937824,0.0,20.0
193,0,193,[211 290 378 431 367],429,2,727,3.747422680412371,0.0,0.0
194,0,194,[239 223 413 215 268],399,0,727,3.7282051282051283,20.0,20.0
195,0,195,[367 297 283 251 216],293,3,730,3.7244897959183674,0.0,20.0
196,0,196,[326 297 276 315 283],592,5,735,3.730964467005076,20.0,0.0
197,0,197,[316 208 485 227 230],293,0,735,3.712121212121212,20.0,0.0
198,0,198,[509 226 219 431 331],551,5,740,3.7185929648241207,0.0,0.0
199,0,199,[223 255 431 365 280],682,1,741,3.705,20.0,0.0
200,0,200,[293 216 202 267 350],130,5,746,3.711442786069652,0.0,20.0
201,0,201,[284 218 583 226 297],293,1,747,3.698019801980198,0.0,0.0
202,0,202,[217 206 222 226 202],201,0,747,3.6798029556650245,0.0,20.0
203,0,203,[276 291 226 452 227],130,4,751,3.6813725490196076,0.0,0.0
204,0,204,[298 241 326 255 240],222,2,753,3.6731707317073172,0.0,20.0
205,0,205,[290 240 250 264 222],268,2,755,3.6650485436893203,0.0,20.0
206,0,206,[201 215 254 365 226],276,3,758,3.6618357487922704,0.0,0.0
207,0,207,[316 215 232 583 268],276,3,761,3.6586538461538463,20.0,20.0
208,0,208,[485 378 268 367 202],846,5,766,3.665071770334928,0.0,20.0
209,0,209,[218 206 303 326 209],201,1,767,3.6523809523809523,0.0,0.0
210,0,210,[231 298 208 509 213],758,4,771,3.654028436018957,0.0,20.0
211,0,211,[222 384 315 226 208],880,4,775,3.6556603773584904,20.0,20.0
212,0,212,[209 218 215 231 232],864,3,778,3.652582159624413,0.0,0.0
213,0,213,[201 243 219 378 299],682,2,780,3.6448598130841123,0.0,0.0
214,0,214,[452 290 264 268 209],303,3,783,3.641860465116279,0.0,20.0
215,0,215,[303 218 344 276 217],758,2,785,3.634259259259259,0.0,0.0
216,0,216,[331 276 431 315 201],201,3,788,3.6313364055299537,20.0,0.0
217,0,217,[202 384 218 365 226],291,4,792,3.63302752293578,0.0,0.0
218,0,218,[227 201 250 208 216],407,4,796,3.634703196347032,0.0,20.0
219,0,219,[226 227 216 280 509],916,2,798,3.6272727272727274,0.0,20.0
220,0,220,[254 303 230 218 227],276,4,802,3.6289592760180995,0.0,0.0
221,0,221,[216 384 241 211 201],22,2,804,3.6216216216216215,0.0,20.0
222,0,222,[226 221 230 283 239],303,2,806,3.6143497757847536,0.0,0.0
223,0,223,[420 223 283 321 316],393,2,808,3.607142857142857,40.0,0.0
224,0,224,[293 231 300 507 202],429,3,811,3.6044444444444443,0.0,20.0
225,0,225,[206 284 246 211 392],435,3,814,3.601769911504425,0.0,0.0
226,0,226,[240 219 223 507 222],561,2,816,3.594713656387665,20.0,20.0
227,0,227,[367 431 215 291 240],276,2,818,3.587719298245614,0.0,0.0
228,0,228,[283 300 201 239 232],303,2,820,3.5807860262008733,0.0,20.0
229,0,229,[321 215 268 202 583],327,3,823,3.5782608695652174,0.0,20.0
230,0,230,[241 243 218 255 239],682,1,824,3.567099567099567,0.0,0.0
231,0,231,[209 213 268 236 284],916,3,827,3.564655172413793,0.0,20.0
232,0,232,[298 217 350 216 239],130,4,831,3.5665236051502145,0.0,40.0
233,0,233,[284 384 219 211 290],435,2,833,3.5598290598290596,0.0,0.0
234,0,234,[301 272 298 211 431],660,3,836,3.557446808510638,20.0,20.0
235,0,235,[202 223 508 209 240],551,4,840,3.559322033898305,20.0,0.0
236,0,236,[232 384 507 239 259],727,2,842,3.5527426160337554,0.0,0.0
237,0,237,[218 208 300 283 222],293,0,842,3.53781512605042,0.0,40.0
238,0,238,[218 298 250 315 215],293,2,844,3.5313807531380754,20.0,20.0
239,0,239,[215 231 301 202 478],747,3,847,3.529166666666667,20.0,0.0
240,0,240,[208 218 255 202 226],222,2,849,3.5228215767634854,0.0,0.0
241,0,241,[215 583 255 246 276],303,4,853,3.524793388429752,0.0,0.0
242,0,242,[227 212 239 216 276],916,3,856,3.522633744855967,0.0,20.0
243,0,243,[508 268 293 316 202],178,4,860,3.5245901639344264,20.0,20.0
244,0,244,[202 243 336 367 222],514,3,863,3.522448979591837,0.0,20.0
245,0,245,[583 268 331 217 231],201,2,865,3.516260162601626,0.0,20.0
246,0,246,[298 293 315 239 508],276,5,870,3.522267206477733,20.0,20.0
247,0,247,[222 216 223 226 232],916,2,872,3.5161290322580645,20.0,40.0
248,0,248,[236 218 226 299 321],130,4,876,3.5180722891566263,0.0,0.0
249,0,249,[264 276 384 298 303],299,2,878,3.512,0.0,20.0
250,0,250,[246 384 215 431 367],790,2,880,3.50597609561753,0.0,0.0
251,0,251,[268 222 326 231 280],222,3,883,3.503968253968254,0.0,40.0
252,0,252,[250 231 276 208 326],222,2,885,3.4980237154150196,0.0,0.0
253,0,253,[250 272 300 218 259],425,2,887,3.4921259842519685,20.0,20.0
254,0,254,[246 431 321 301 324],327,1,888,3.4823529411764707,0.0,0.0
255,0,255,[303 206 429 297 507],293,5,893,3.48828125,0.0,0.0
256,0,256,[226 331 300 293 276],276,5,898,3.4941634241245136,0.0,20.0
257,0,257,[230 231 239 481 226],896,3,901,3.492248062015504,0.0,0.0
258,0,258,[201 232 293 392 208],429,3,904,3.4903474903474905,0.0,0.0
259,0,259,[250 251 420 298 267],532,3,907,3.4884615384615385,0.0,20.0
260,0,260,[298 420 367 583 276],303,4,911,3.4904214559386975,0.0,20.0
261,0,261,[583 259 321 227 202],303,1,912,3.480916030534351,0.0,0.0
262,0,262,[222 321 583 508 420],303,2,914,3.4752851711026618,0.0,20.0
263,0,263,[215 232 246 365 583],94,2,916,3.4696969696969697,0.0,0.0
264,0,264,[236 283 291 298 250],303,3,919,3.4679245283018867,0.0,20.0
265,0,265,[478 485 303 211 255],299,3,922,3.4661654135338344,20.0,0.0
266,0,266,[452 240 219 246 259],303,2,924,3.460674157303371,0.0,0.0
267,0,267,[227 216 231 392 222],521,1,925,3.451492537313433,0.0,40.0
268,0,268,[316 293 250 217 507],293,2,927,3.446096654275093,20.0,0.0
269,0,269,[420 240 390 298 231],303,3,930,3.4444444444444446,0.0,20.0
270,0,270,[208 300 431 315 272],758,3,933,3.4428044280442807,40.0,20.0
271,0,271,[215 216 384 239 232],301,4,937,3.4448529411764706,0.0,20.0
272,0,272,[291 420 293 232 367],276,2,939,3.4395604395604398,0.0,0.0
273,0,273,[231 232 211 268 209],682,2,941,3.434306569343066,0.0,20.0
274,0,274,[215 246 267 232 221],1,3,944,3.4327272727272726,0.0,0.0
275,0,275,[251 431 231 216 301],286,4,948,3.4347826086956523,0.0,20.0
276,0,276,[202 218 293 215 268],327,3,951,3.4332129963898916,0.0,20.0
277,0,277,[268 216 236 221 291],303,4,955,3.435251798561151,0.0,40.0
278,0,278,[394 384 240 218 254],435,1,956,3.4265232974910393,0.0,0.0
279,0,279,[264 227 367 217 218],472,4,960,3.4285714285714284,0.0,0.0
280,0,280,[384 240 217 268 209],790,2,962,3.4234875444839856,0.0,20.0
281,0,281,[284 293 232 261 431],222,2,964,3.4184397163120566,0.0,0.0
282,0,282,[250 291 272 246 215],592,4,968,3.420494699646643,20.0,0.0
283,0,283,[316 261 254 218 217],130,3,971,3.4190140845070425,20.0,0.0
284,0,284,[230 250 209 367 431],896,2,973,3.414035087719298,0.0,0.0
285,0,285,[239 241 290 303 331],758,3,976,3.4125874125874125,0.0,0.0
286,0,286,[222 216 256 220 254],1,3,979,3.4111498257839723,0.0,40.0
287,0,287,[218 431 321 217 280],429,1,980,3.4027777777777777,0.0,0.0
288,0,288,[251 452 223 215 246],303,4,984,3.4048442906574397,20.0,0.0
289,0,289,[301 217 324 268 316],276,5,989,3.410344827586207,20.0,20.0
290,0,290,[507 367 316 509 481],747,3,992,3.40893470790378,20.0,0.0
291,0,291,[209 232 259 223 298],268,1,993,3.4006849315068495,20.0,20.0
292,0,292,[227 300 232 508 394],880,2,995,3.3959044368600684,0.0,20.0
293,0,293,[254 211 256 209 259],1,2,997,3.391156462585034,0.0,0.0
294,0,294,[485 218 284 280 255],293,0,997,3.3796610169491523,0.0,0.0
295,0,295,[324 222 264 226 218],303,2,999,3.375,0.0,20.0
296,0,296,[344 240 394 485 202],393,1,1000,3.367003367003367,0.0,0.0
297,0,297,[201 227 298 324 254],276,4,1004,3.3691275167785233,0.0,20.0
298,0,298,[367 226 216 227 250],303,4,1008,3.37123745819398,0.0,20.0
299,0,299,[211 246 236 290 583],916,4,1012,3.3733333333333335,0.0,0.0
300,0,300,[300 324 452 230 316],425,2,1014,3.3687707641196014,20.0,20.0
301,0,301,[218 431 264 336 219],327,1,1015,3.3609271523178808,0.0,0.0
302,0,302,[201 231 452 413 255],303,3,1018,3.3597359735973598,0.0,0.0
303,0,303,[254 240 276 222 250],130,3,1021,3.3585526315789473,0.0,20.0
304,0,304,[208 452 201 240 293],303,3,1024,3.357377049180328,0.0,0.0
305,0,305,[261 247 227 268 209],1,3,1027,3.3562091503267975,0.0,20.0
306,0,306,[223 315 246 202 392],276,4,1031,3.3583061889250816,40.0,0.0
307,0,307,[303 264 230 272 290],293,2,1033,3.353896103896104,20.0,0.0
308,0,308,[221 239 293 283 202],303,3,1036,3.352750809061489,0.0,0.0
309,0,309,[378 226 250 219 240],222,1,1037,3.3451612903225807,0.0,0.0
310,0,310,[420 217 268 250 241],276,5,1042,3.35048231511254,0.0,20.0
311,0,311,[255 232 218 244 268],178,3,1045,3.3493589743589745,0.0,20.0
312,0,312,[211 216 231 336 298],286,4,1049,3.351437699680511,0.0,40.0
313,0,313,[261 331 298 300 243],130,3,1052,3.3503184713375798,0.0,40.0
314,0,314,[293 291 378 367 231],429,2,1054,3.346031746031746,0.0,0.0
315,0,315,[216 331 211 239 218],758,4,1058,3.348101265822785,0.0,20.0
316,0,316,[298 216 509 217 218],916,3,1061,3.3470031545741326,0.0,40.0
317,0,317,[508 201 429 264 298],276,4,1065,3.349056603773585,0.0,20.0
318,0,318,[251 208 201 231 367],303,5,1070,3.35423197492163,0.0,0.0
319,0,319,[239 365 429 250 254],276,3,1073,3.353125,0.0,0.0
320,0,320,[218 431 241 300 239],222,4,1077,3.3551401869158877,0.0,20.0
321,0,321,[390 239 276 507 291],303,2,1079,3.3509316770186337,0.0,0.0
322,0,322,[243 223 336 261 303],592,2,1081,3.346749226006192,20.0,0.0
323,0,323,[315 290 217 230 213],293,0,1081,3.3364197530864197,20.0,0.0
324,0,324,[206 215 239 431 259],393,3,1084,3.335384615384615,0.0,0.0
325,0,325,[324 256 303 299 275],181,0,1084,3.3251533742331287,0.0,0.0
326,0,326,[299 239 241 215 226],896,3,1087,3.324159021406728,0.0,0.0
327,0,327,[219 420 230 267 231],130,3,1090,3.323170731707317,0.0,0.0
328,0,328,[206 216 244 211 218],916,3,1093,3.3221884498480243,0.0,20.0
329,0,329,[485 251 218 284 331],532,5,1098,3.327272727272727,0.0,0.0
330,0,330,[226 509 268 219 221],201,2,1100,3.323262839879154,0.0,20.0
331,0,331,[240 223 226 215 250],222,2,1102,3.319277108433735,20.0,0.0
332,0,332,[217 420 218 221 509],758,2,1104,3.315315315315315,0.0,0.0
333,0,333,[478 222 276 481 211],747,4,1108,3.317365269461078,20.0,20.0
334,0,334,[231 216 232 217 218],682,2,1110,3.3134328358208953,0.0,20.0
335,0,335,[321 378 284 208 223],429,2,1112,3.3095238095238093,20.0,0.0
336,0,336,[298 217 290 315 293],758,3,1115,3.308605341246291,20.0,20.0
337,0,337,[219 216 232 226 431],846,4,1119,3.3106508875739644,0.0,20.0
338,0,338,[221 344 202 316 324],758,3,1122,3.309734513274336,20.0,0.0
339,0,339,[284 230 211 216 241],551,5,1127,3.3147058823529414,0.0,20.0
340,0,340,[232 211 231 290 284],268,2,1129,3.310850439882698,0.0,0.0
341,0,341,[508 326 246 218 299],130,4,1133,3.3128654970760234,0.0,0.0
342,0,342,[232 202 392 283 226],727,2,1135,3.309037900874636,0.0,0.0
343,0,343,[300 290 216 272 508],758,4,1139,3.311046511627907,20.0,40.0
344,0,344,[316 254 226 315 255],130,4,1143,3.3130434782608695,40.0,0.0
345,0,345,[293 429 218 583 209],276,4,1147,3.315028901734104,0.0,0.0
346,0,346,[202 378 246 431 227],222,3,1150,3.314121037463977,0.0,0.0
347,0,347,[218 217 365 202 231],429,1,1151,3.307471264367816,0.0,0.0
348,0,348,[236 201 276 367 508],919,5,1156,3.312320916905444,0.0,0.0
349,0,349,[298 261 243 216 215],130,4,1160,3.3142857142857145,0.0,40.0
350,0,350,[275 324 215 221 216],201,3,1163,3.3133903133903133,0.0,20.0
351,0,351,[365 507 316 420 239],393,2,1165,3.309659090909091,20.0,0.0
352,0,352,[208 226 485 215 211],790,1,1166,3.303116147308782,0.0,0.0
353,0,353,[227 275 222 367 202],393,3,1169,3.3022598870056497,0.0,20.0
354,0,354,[300 239 284 367 222],276,4,1173,3.304225352112676,0.0,40.0
355,0,355,[367 413 239 290 507],303,3,1176,3.303370786516854,0.0,0.0
356,0,356,[326 239 216 267 240],130,5,1181,3.3081232492997197,0.0,20.0
357,0,357,[284 431 268 246 367],870,1,1182,3.3016759776536313,0.0,20.0
358,0,358,[231 295 223 298 250],851,5,1187,3.3064066852367686,20.0,20.0
359,0,359,[276 223 239 284 508],222,3,1190,3.3055555555555554,20.0,0.0
360,0,360,[583 206 231 201 227],268,3,1193,3.3047091412742384,0.0,0.0
361,0,361,[431 222 583 509 241],201,0,1193,3.2955801104972378,0.0,20.0
362,0,362,[239 218 300 223 250],276,5,1198,3.3002754820936637,20.0,20.0
363,0,363,[295 202 215 508 367],178,3,1201,3.2994505494505493,0.0,0.0
364,0,364,[219 218 300 452 244],21,4,1205,3.3013698630136985,0.0,20.0
365,0,365,[303 223 230 208 239],293,2,1207,3.297814207650273,20.0,0.0
366,0,366,[201 223 206 227 232],94,3,1210,3.2970027247956404,20.0,0.0
367,0,367,[254 326 378 222 230],545,3,1213,3.296195652173913,0.0,20.0
368,0,368,[394 276 365 240 230],880,2,1215,3.292682926829268,0.0,0.0
369,0,369,[222 331 300 280 284],178,5,1220,3.2972972972972974,0.0,40.0
370,0,370,[232 223 299 378 284],682,2,1222,3.293800539083558,20.0,0.0
371,0,371,[215 316 276 326 230],178,4,1226,3.295698924731183,20.0,0.0
372,0,372,[221 272 230 222 212],758,4,1230,3.297587131367292,20.0,20.0
373,0,373,[206 216 240 298 290],435,2,1232,3.2941176470588234,0.0,40.0
374,0,374,[232 202 298 300 227],303,3,1235,3.2933333333333334,0.0,40.0
375,0,375,[211 212 300 481 350],758,4,1239,3.2952127659574466,0.0,20.0
376,0,376,[227 222 509 481 290],758,5,1244,3.2997347480106103,0.0,20.0
377,0,377,[326 264 236 223 507],303,3,1247,3.298941798941799,20.0,0.0
378,0,378,[508 413 202 240 209],201,1,1248,3.29287598944591,0.0,0.0
379,0,379,[268 216 256 223 250],1,5,1253,3.2973684210526315,20.0,40.0
380,0,380,[390 431 251 367 212],286,3,1256,3.2965879265091864,0.0,0.0
381,0,381,[254 509 299 272 222],682,3,1259,3.2958115183246073,20.0,20.0
382,0,382,[420 268 413 290 261],130,3,1262,3.2950391644908614,0.0,20.0
383,0,383,[300 452 251 227 301],532,5,1267,3.2994791666666665,0.0,20.0
384,0,384,[300 291 272 276 236],130,5,1272,3.303896103896104,20.0,20.0
385,0,385,[216 321 219 583 293],327,1,1273,3.2979274611398965,0.0,20.0
386,0,386,[390 268 232 239 326],303,2,1275,3.294573643410853,0.0,20.0
387,0,387,[216 485 212 241 378],299,3,1278,3.2938144329896906,0.0,20.0
388,0,388,[206 264 230 507 231],70,3,1281,3.2930591259640103,0.0,0.0
389,0,389,[284 227 509 240 226],293,0,1281,3.2846153846153845,0.0,0.0
390,0,390,[254 202 299 392 215],435,2,1283,3.2813299232736575,0.0,0.0
391,0,391,[259 240 216 507 291],303,2,1285,3.2780612244897958,0.0,20.0
392,0,392,[280 215 284 300 384],682,2,1287,3.2748091603053435,0.0,20.0
393,0,393,[300 218 231 264 211],429,1,1288,3.269035532994924,0.0,20.0
394,0,394,[291 211 367 300 240],293,1,1289,3.2632911392405064,0.0,20.0
395,0,395,[384 431 293 259 246],682,3,1292,3.2626262626262625,0.0,0.0
396,0,396,[216 508 201 236 211],606,4,1296,3.2644836272040303,0.0,20.0
397,0,397,[367 280 223 226 217],293,1,1297,3.258793969849246,20.0,0.0
398,0,398,[219 217 231 244 264],1,0,1297,3.2506265664160403,0.0,0.0
399,0,399,[230 215 222 508 316],178,4,1301,3.2525,20.0,20.0
400,0,400,[583 202 216 324 255],327,1,1302,3.2468827930174564,0.0,20.0
401,0,401,[226 507 219 276 384],303,4,1306,3.2487562189054726,0.0,0.0
402,0,402,[509 215 222 367 241],916,2,1308,3.2456575682382134,0.0,20.0
403,0,403,[284 208 227 280 293],222,0,1308,3.237623762376238,0.0,0.0
404,0,404,[267 350 240 222 295],130,4,1312,3.2395061728395063,0.0,20.0
405,0,405,[217 202 218 431 239],758,2,1314,3.2364532019704435,0.0,0.0
406,0,406,[222 268 202 201 208],435,4,1318,3.2383292383292384,0.0,40.0
407,0,407,[241 250 301 227 298],429,1,1319,3.232843137254902,0.0,20.0
408,0,408,[507 216 268 290 230],303,4,1323,3.234718826405868,0.0,40.0
409,0,409,[240 222 213 218 236],758,4,1327,3.2365853658536587,0.0,20.0
410,0,410,[218 394 300 283 280],880,1,1328,3.2311435523114356,0.0,20.0
411,0,411,[226 241 239 227 268],303,3,1331,3.2305825242718447,0.0,20.0
412,0,412,[215 392 261 452 250],130,4,1335,3.232445520581114,0.0,0.0
413,0,413,[298 276 222 293 367],222,3,1338,3.2318840579710146,0.0,40.0
414,0,414,[227 201 246 367 206],435,4,1342,3.233734939759036,0.0,0.0
415,0,415,[300 223 218 507 227],293,2,1344,3.230769230769231,20.0,20.0
416,0,416,[216 276 239 297 509],889,3,1347,3.2302158273381294,0.0,20.0
417,0,417,[420 331 291 324 232],276,3,1350,3.229665071770335,0.0,0.0
418,0,418,[299 452 284 367 223],896,3,1353,3.2291169451073984,20.0,0.0
419,0,419,[392 216 293 275 239],514,4,1357,3.230952380952381,0.0,20.0
420,0,420,[431 583 367 211 209],870,2,1359,3.2280285035629452,0.0,0.0
421,0,421,[231 246 299 243 250],130,1,1360,3.2227488151658767,0.0,0.0
422,0,422,[231 283 583 215 223],303,3,1363,3.2222222222222223,20.0,0.0
423,0,423,[298 315 218 267 367],532,3,1366,3.2216981132075473,20.0,20.0
424,0,424,[276 420 392 300 303],276,4,1370,3.223529411764706,0.0,20.0
425,0,425,[259 236 255 211 213],1,1,1371,3.2183098591549295,0.0,0.0
426,0,426,[392 222 316 331 246],130,4,1375,3.2201405152224822,20.0,20.0
427,0,427,[316 211 272 222 227],660,3,1378,3.2196261682242993,40.0,20.0
428,0,428,[272 291 208 250 223],758,5,1383,3.2237762237762237,40.0,0.0
429,0,429,[268 246 303 223 297],889,3,1386,3.2232558139534886,20.0,20.0
430,0,430,[231 283 365 208 217],880,2,1388,3.2204176334106727,0.0,0.0
431,0,431,[202 212 232 431 230],916,1,1389,3.2152777777777777,0.0,0.0
432,0,432,[284 254 452 232 331],276,2,1391,3.212471131639723,0.0,0.0
433,0,433,[208 429 264 272 209],293,2,1393,3.2096774193548385,20.0,0.0
434,0,434,[268 452 324 283 290],303,2,1395,3.206896551724138,0.0,20.0
435,0,435,[213 216 201 231 220],1,1,1396,3.2018348623853212,0.0,20.0
436,0,436,[392 316 291 218 508],130,5,1401,3.205949656750572,20.0,0.0
437,0,437,[250 221 208 324 390],303,3,1404,3.2054794520547945,0.0,0.0
438,0,438,[508 367 293 300 226],222,1,1405,3.2004555808656034,0.0,20.0
439,0,439,[303 293 508 298 295],592,5,1410,3.2045454545454546,0.0,20.0
440,0,440,[212 201 508 384 284],896,1,1411,3.199546485260771,0.0,0.0
441,0,441,[231 293 452 223 291],758,2,1413,3.1968325791855206,20.0,0.0
442,0,442,[392 331 254 290 316],276,3,1416,3.1963882618510158,20.0,0.0
443,0,443,[326 209 293 244 220],178,3,1419,3.195945945945946,0.0,0.0
444,0,444,[222 316 239 413 290],276,4,1423,3.197752808988764,20.0,20.0
445,0,445,[250 284 201 218 217],301,4,1427,3.1995515695067263,0.0,0.0
446,0,446,[365 218 276 284 208],880,4,1431,3.2013422818791946,0.0,0.0
447,0,447,[226 231 201 298 219],671,1,1432,3.1964285714285716,0.0,20.0
448,0,448,[250 326 272 255 222],130,4,1436,3.198218262806236,20.0,20.0
449,0,449,[293 276 280 272 367],682,2,1438,3.1955555555555555,20.0,0.0
450,0,450,[301 246 315 231 250],880,3,1441,3.1951219512195124,20.0,0.0
451,0,451,[293 241 392 250 232],429,2,1443,3.1924778761061945,0.0,0.0
452,0,452,[240 246 315 299 298],130,4,1447,3.1942604856512142,20.0,20.0
453,0,453,[246 259 202 241 293],682,4,1451,3.196035242290749,0.0,0.0
454,0,454,[239 250 211 223 206],268,2,1453,3.1934065934065936,20.0,0.0
455,0,455,[250 222 202 290 283],249,4,1457,3.1951754385964914,0.0,20.0
456,0,456,[295 283 367 301 240],919,2,1459,3.192560175054705,0.0,0.0
457,0,457,[300 218 232 209 324],303,3,1462,3.1921397379912664,0.0,20.0
458,0,458,[226 211 231 392 275],429,2,1464,3.189542483660131,0.0,0.0
459,0,459,[298 378 250 481 202],429,2,1466,3.1869565217391305,0.0,20.0
460,0,460,[251 478 268 246 223],305,2,1468,3.1843817787418653,40.0,20.0
461,0,461,[251 268 223 246 236],1,5,1473,3.188311688311688,20.0,20.0
462,0,462,[251 268 223 246 236],303,5,1478,3.1922246220302375,20.0,20.0
463,0,463,[251 268 236 223 246],303,5,1483,3.1961206896551726,20.0,20.0
464,0,464,[246 299 508 298 268],130,4,1487,3.1978494623655913,0.0,40.0
465,0,465,[251 236 268 246 223],592,4,1491,3.199570815450644,20.0,20.0
466,0,466,[300 315 431 316 209],758,3,1494,3.1991434689507496,40.0,20.0
467,0,467,[251 268 246 223 272],305,2,1496,3.1965811965811968,40.0,20.0
468,0,468,[251 223 268 246 216],303,5,1501,3.2004264392324093,20.0,40.0
469,0,469,[251 223 268 246 216],303,5,1506,3.204255319148936,20.0,40.0
470,0,470,[251 223 268 246 216],592,5,1511,3.208067940552017,20.0,40.0
471,0,471,[251 223 268 246 216],305,3,1514,3.207627118644068,20.0,40.0
472,0,472,[251 223 268 246 216],1,5,1519,3.211416490486258,20.0,40.0
473,0,473,[209 300 367 326 291],303,2,1521,3.2088607594936707,0.0,20.0
474,0,474,[251 223 268 246 216],1,5,1526,3.2126315789473683,20.0,40.0
475,0,475,[251 223 268 246 216],592,5,1531,3.216386554621849,20.0,40.0
476,0,476,[251 223 268 246 216],303,5,1536,3.220125786163522,20.0,40.0
477,0,477,[251 223 268 246 216],303,5,1541,3.223849372384937,20.0,40.0
478,0,478,[251 223 268 246 216],1,5,1546,3.2275574112734864,20.0,40.0
479,0,479,[251 223 268 246 216],305,3,1549,3.2270833333333333,20.0,40.0
480,0,480,[251 223 268 246 216],305,3,1552,3.226611226611227,20.0,40.0
481,0,481,[206 315 261 267 350],130,4,1556,3.228215767634855,20.0,0.0
482,0,482,[251 223 268 246 216],305,3,1559,3.227743271221532,20.0,40.0
483,0,483,[251 223 268 246 216],1,5,1564,3.231404958677686,20.0,40.0
484,0,484,[251 223 268 246 216],305,3,1567,3.2309278350515465,20.0,40.0
485,0,485,[251 223 268 246 216],303,5,1572,3.234567901234568,20.0,40.0
486,0,486,[251 223 268 246 216],592,5,1577,3.238193018480493,20.0,40.0
487,0,487,[230 290 226 261 216],130,3,1580,3.237704918032787,0.0,20.0
488,0,488,[251 223 268 216 246],1,5,1585,3.2413087934560325,20.0,40.0
489,0,489,[251 223 268 216 246],1,5,1590,3.2448979591836733,20.0,40.0
490,0,490,[251 223 268 216 246],592,5,1595,3.24847250509165,20.0,40.0
491,0,491,[251 223 268 216 246],305,3,1598,3.247967479674797,20.0,40.0
492,0,492,[255 208 219 222 384],435,2,1600,3.2454361054766734,0.0,20.0
493,0,493,[255 275 367 216 331],178,5,1605,3.248987854251012,0.0,20.0
494,0,494,[251 223 216 268 246],592,5,1610,3.2525252525252526,20.0,40.0
495,0,495,[251 223 216 268 246],303,5,1615,3.256048387096774,20.0,40.0
496,0,496,[251 223 216 268 246],303,5,1620,3.2595573440643864,20.0,40.0
497,0,497,[251 223 216 268 246],303,5,1625,3.2630522088353415,20.0,40.0
498,0,498,[251 223 216 268 246],592,5,1630,3.2665330661322645,20.0,40.0
499,0,499,[251 223 216 268 246],303,5,1635,3.27,20.0,40.0
500,0,500,[251 223 216 268 246],303,5,1640,3.273453093812375,20.0,40.0
501,0,501,[251 223 216 268 246],1,5,1645,3.2768924302788847,20.0,40.0
502,0,502,[251 223 216 268 246],303,5,1650,3.280318091451292,20.0,40.0
503,0,503,[251 223 216 268 246],305,3,1653,3.2797619047619047,20.0,40.0
504,0,504,[367 452 240 202 222],303,2,1655,3.277227722772277,0.0,20.0
505,0,505,[226 264 222 256 298],363,2,1657,3.274703557312253,0.0,40.0
506,0,506,[251 223 216 268 246],303,5,1662,3.2781065088757395,20.0,40.0
507,0,507,[583 420 452 209 236],303,3,1665,3.27755905511811,0.0,0.0
508,0,508,[251 223 216 268 246],303,5,1670,3.280943025540275,20.0,40.0
509,0,509,[227 217 431 293 206],267,4,1674,3.2823529411764705,0.0,0.0
510,0,510,[251 223 216 268 246],1,5,1679,3.2857142857142856,20.0,40.0
511,0,511,[251 223 216 268 246],1,5,1684,3.2890625,20.0,40.0
512,0,512,[251 223 216 268 246],305,3,1687,3.288499025341131,20.0,40.0
513,0,513,[201 420 216 284 241],682,4,1691,3.28988326848249,0.0,20.0
514,0,514,[251 223 216 268 246],1,5,1696,3.2932038834951456,20.0,40.0
515,0,515,[251 223 216 268 246],1,5,1701,3.296511627906977,20.0,40.0
516,0,516,[324 209 231 201 230],276,4,1705,3.297872340425532,0.0,0.0
517,0,517,[217 215 222 216 321],435,1,1706,3.2934362934362933,0.0,40.0
518,0,518,[251 223 216 268 246],303,5,1711,3.296724470134875,20.0,40.0
519,0,519,[251 223 216 268 246],1,5,1716,3.3,20.0,40.0
520,0,520,[231 431 232 211 250],246,2,1718,3.2975047984644914,0.0,0.0
521,0,521,[251 223 216 268 246],303,5,1723,3.3007662835249043,20.0,40.0
522,0,522,[251 223 216 268 246],303,5,1728,3.3040152963671128,20.0,40.0
523,0,523,[315 290 240 280 283],393,2,1730,3.301526717557252,20.0,0.0
524,0,524,[251 223 216 268 246],1,5,1735,3.3047619047619046,20.0,40.0
525,0,525,[251 223 216 268 246],303,5,1740,3.307984790874525,20.0,40.0
526,0,526,[251 223 216 268 246],303,5,1745,3.3111954459203035,20.0,40.0
527,0,527,[251 223 216 268 246],1,5,1750,3.3143939393939394,20.0,40.0
528,0,528,[251 223 216 268 246],1,5,1755,3.31758034026465,20.0,40.0
529,0,529,[251 223 216 268 246],592,5,1760,3.3207547169811322,20.0,40.0
530,0,530,[251 223 216 268 246],592,5,1765,3.3239171374764593,20.0,40.0
531,0,531,[251 223 216 268 246],303,5,1770,3.327067669172932,20.0,40.0
532,0,532,[222 275 232 290 507],293,1,1771,3.3227016885553473,0.0,20.0
533,0,533,[251 223 216 268 246],305,3,1774,3.3220973782771535,20.0,40.0
534,0,534,[367 219 227 217 201],868,0,1774,3.3158878504672895,0.0,0.0
535,0,535,[251 223 216 268 246],303,5,1779,3.3190298507462686,20.0,40.0
536,0,536,[251 223 216 268 246],1,5,1784,3.3221601489757915,20.0,40.0
537,0,537,[251 223 216 268 246],592,5,1789,3.325278810408922,20.0,40.0
538,0,538,[251 223 216 268 246],592,5,1794,3.3283858998144713,20.0,40.0
539,0,539,[251 223 216 268 246],305,3,1797,3.327777777777778,20.0,40.0
540,0,540,[251 223 216 268 246],1,5,1802,3.33086876155268,20.0,40.0
541,0,541,[251 223 216 268 246],303,5,1807,3.3339483394833946,20.0,40.0
542,0,542,[251 223 216 268 246],305,3,1810,3.3333333333333335,20.0,40.0
543,0,543,[251 223 216 268 246],592,5,1815,3.3363970588235294,20.0,40.0
544,0,544,[251 223 216 268 246],592,5,1820,3.3394495412844036,20.0,40.0
545,0,545,[251 223 216 268 246],303,5,1825,3.3424908424908426,20.0,40.0
546,0,546,[251 223 216 268 246],303,5,1830,3.3455210237659965,20.0,40.0
547,0,547,[202 209 208 246 230],1,5,1835,3.3485401459854014,0.0,0.0
548,0,548,[251 223 216 268 246],1,5,1840,3.3515482695810563,20.0,40.0
549,0,549,[250 420 413 264 222],276,3,1843,3.350909090909091,0.0,20.0
550,0,550,[251 223 216 268 246],303,5,1848,3.353901996370236,20.0,40.0
551,0,551,[241 219 226 251 268],1,3,1851,3.3532608695652173,0.0,20.0
552,0,552,[251 223 216 268 246],1,5,1856,3.35623869801085,20.0,40.0
553,0,553,[251 223 216 268 246],1,5,1861,3.3592057761732854,20.0,40.0
554,0,554,[212 217 231 241 209],846,4,1865,3.3603603603603602,0.0,0.0
555,0,555,[251 223 216 268 246],1,5,1870,3.3633093525179856,20.0,40.0
556,0,556,[251 223 216 268 246],303,5,1875,3.3662477558348294,20.0,40.0
557,0,557,[251 223 216 268 246],305,3,1878,3.3655913978494625,20.0,40.0
558,0,558,[251 223 216 268 246],303,5,1883,3.368515205724508,20.0,40.0
559,0,559,[251 223 216 268 246],1,5,1888,3.3714285714285714,20.0,40.0
560,0,560,[485 255 378 392 259],393,4,1892,3.372549019607843,0.0,0.0
561,0,561,[251 223 216 268 246],305,3,1895,3.3718861209964412,20.0,40.0
562,0,562,[251 223 216 268 246],592,5,1900,3.374777975133215,20.0,40.0
563,0,563,[251 223 216 268 246],305,3,1903,3.374113475177305,20.0,40.0
564,0,564,[251 223 216 268 246],303,5,1908,3.376991150442478,20.0,40.0
565,0,565,[251 223 216 268 246],1,5,1913,3.3798586572438163,20.0,40.0
566,0,566,[251 223 216 268 246],305,3,1916,3.379188712522046,20.0,40.0
567,0,567,[251 223 216 268 246],1,5,1921,3.382042253521127,20.0,40.0
568,0,568,[251 223 216 268 246],1,5,1926,3.3848857644991215,20.0,40.0
569,0,569,[251 223 216 268 246],1,5,1931,3.387719298245614,20.0,40.0
570,0,570,[251 223 216 268 246],305,3,1934,3.3870402802101576,20.0,40.0
571,0,571,[251 223 216 268 246],592,5,1939,3.38986013986014,20.0,40.0
572,0,572,[251 223 216 268 246],1,5,1944,3.392670157068063,20.0,40.0
573,0,573,[251 223 216 268 246],1,5,1949,3.3954703832752613,20.0,40.0
574,0,574,[251 223 216 268 246],1,5,1954,3.3982608695652172,20.0,40.0
575,0,575,[241 331 227 431 206],201,2,1956,3.3958333333333335,0.0,0.0
576,0,576,[251 223 216 268 246],1,5,1961,3.398613518197574,20.0,40.0
577,0,577,[251 223 216 268 246],1,5,1966,3.4013840830449826,20.0,40.0
578,0,578,[251 223 216 268 246],305,3,1969,3.400690846286701,20.0,40.0
579,0,579,[251 223 216 268 246],1,5,1974,3.4034482758620688,20.0,40.0
580,0,580,[251 223 216 268 246],592,5,1979,3.406196213425129,20.0,40.0
581,0,581,[251 223 216 268 246],305,3,1982,3.4054982817869415,20.0,40.0
582,0,582,[251 223 216 268 246],303,5,1987,3.4082332761578042,20.0,40.0
583,0,583,[293 420 509 231 583],682,1,1988,3.404109589041096,0.0,0.0
584,0,584,[251 223 216 268 246],592,5,1993,3.4068376068376067,20.0,40.0
585,0,585,[251 223 216 268 246],1,5,1998,3.409556313993174,20.0,40.0
586,0,586,[218 239 230 223 222],222,5,2003,3.4122657580919933,20.0,20.0
587,0,587,[251 223 216 268 246],305,3,2006,3.4115646258503403,20.0,40.0
588,0,588,[244 298 268 223 230],268,2,2008,3.409168081494058,20.0,40.0
589,0,589,[295 239 272 283 392],880,3,2011,3.4084745762711863,20.0,0.0
590,0,590,[218 316 431 202 284],276,4,2015,3.4094754653130286,20.0,0.0
591,0,591,[390 583 223 431 509],94,4,2019,3.410472972972973,20.0,0.0
592,0,592,[215 298 222 420 290],682,3,2022,3.409780775716695,0.0,40.0
593,0,593,[218 420 268 259 227],532,4,2026,3.410774410774411,0.0,20.0
594,0,594,[230 216 508 392 321],429,2,2028,3.4084033613445377,0.0,20.0
595,0,595,[209 303 324 293 367],276,4,2032,3.4093959731543624,0.0,0.0
596,0,596,[239 222 211 202 384],758,4,2036,3.4103852596314908,0.0,20.0
597,0,597,[420 215 219 392 431],94,4,2040,3.411371237458194,0.0,0.0
598,0,598,[255 431 275 219 283],178,5,2045,3.4140233722871454,0.0,0.0
599,0,599,[275 215 223 344 291],393,4,2049,3.415,20.0,0.0
600,0,600,[420 478 299 241 392],896,3,2052,3.4143094841930117,20.0,0.0
601,0,601,[246 303 223 243 295],592,4,2056,3.4152823920265782,20.0,0.0
602,0,602,[251 223 216 268 246],1,5,2061,3.417910447761194,20.0,40.0
603,0,603,[251 223 216 268 246],305,3,2064,3.4172185430463577,20.0,40.0
604,0,604,[254 268 201 240 211],682,4,2068,3.418181818181818,0.0,20.0
605,0,605,[276 221 244 367 215],916,3,2071,3.4174917491749173,0.0,0.0
606,0,606,[226 239 452 217 293],130,4,2075,3.4184514003294892,0.0,0.0
607,0,607,[300 452 202 299 267],130,4,2079,3.419407894736842,0.0,20.0
608,0,608,[202 293 452 231 218],222,2,2081,3.4170771756978655,0.0,0.0
609,0,609,[316 231 208 250 219],660,3,2084,3.416393442622951,20.0,0.0
610,0,610,[202 250 429 218 201],276,5,2089,3.4189852700490997,0.0,0.0
611,0,611,[251 223 216 429 316],293,4,2093,3.4199346405228757,40.0,20.0
612,0,612,[227 246 293 219 392],130,4,2097,3.4208809135399676,0.0,0.0
613,0,613,[217 508 367 218 321],919,4,2101,3.4218241042345277,0.0,0.0
614,0,614,[209 217 367 507 216],429,3,2104,3.4211382113821136,0.0,20.0
615,0,615,[255 211 331 222 413],435,2,2106,3.418831168831169,0.0,20.0
616,0,616,[316 283 300 215 298],293,2,2108,3.4165316045380876,20.0,40.0
617,0,617,[344 583 222 232 507],327,3,2111,3.4158576051779934,0.0,20.0
618,0,618,[259 291 392 507 250],727,4,2115,3.4168012924071083,0.0,0.0
619,0,619,[206 429 215 384 367],896,3,2118,3.4161290322580644,0.0,0.0
620,0,620,[212 413 508 202 213],201,3,2121,3.4154589371980677,0.0,0.0
621,0,621,[452 202 301 291 218],758,3,2124,3.414790996784566,0.0,0.0
622,0,622,[392 303 222 250 452],276,3,2127,3.4141252006420544,0.0,20.0
623,0,623,[293 280 365 231 218],429,1,2128,3.41025641025641,0.0,0.0
624,0,624,[298 321 250 259 508],919,2,2130,3.408,0.0,20.0
625,0,625,[365 230 232 283 367],429,1,2131,3.4041533546325877,0.0,0.0
626,0,626,[226 230 202 217 291],727,2,2133,3.401913875598086,0.0,0.0
627,0,627,[202 247 255 413 250],222,1,2134,3.3980891719745223,0.0,0.0
628,0,628,[201 367 241 218 481],301,4,2138,3.3990461049284577,0.0,0.0
629,0,629,[221 452 232 211 413],201,0,2138,3.3936507936507936,0.0,0.0
630,0,630,[367 390 217 280 212],286,2,2140,3.3914421553090333,0.0,0.0
631,0,631,[226 216 202 331 284],435,3,2143,3.3908227848101267,0.0,20.0
632,0,632,[254 300 246 201 240],276,4,2147,3.391785150078989,0.0,20.0
633,0,633,[507 420 324 239 250],303,3,2150,3.391167192429022,0.0,0.0
634,0,634,[218 206 272 300 291],130,4,2154,3.3921259842519684,20.0,20.0
635,0,635,[291 201 508 251 384],303,3,2157,3.391509433962264,0.0,0.0
636,0,636,[303 315 392 222 298],393,5,2162,3.3940345368916796,20.0,40.0
637,0,637,[284 259 367 321 293],303,3,2165,3.3934169278996866,0.0,0.0
638,0,638,[509 215 222 299 226],682,3,2168,3.3928012519561817,0.0,20.0
639,0,639,[230 284 268 216 215],790,4,2172,3.39375,0.0,40.0
640,0,640,[202 232 246 208 291],727,4,2176,3.3946957878315134,0.0,0.0
641,0,641,[344 212 481 452 316],758,3,2179,3.3940809968847354,20.0,0.0
642,0,642,[509 299 201 232 431],682,3,2182,3.3934681181959565,0.0,0.0
643,0,643,[367 230 240 255 390],303,2,2184,3.391304347826087,0.0,0.0
644,0,644,[219 211 223 507 284],429,4,2188,3.3922480620155038,20.0,0.0
645,0,645,[276 222 250 223 226],682,2,2190,3.390092879256966,20.0,20.0
646,0,646,[284 420 365 300 240],682,2,2192,3.3879443585780527,0.0,20.0
647,0,647,[295 452 222 508 230],399,1,2193,3.384259259259259,0.0,20.0
648,0,648,[291 293 255 331 230],130,3,2196,3.38366718027735,0.0,0.0
649,0,649,[272 254 239 268 246],682,3,2199,3.383076923076923,20.0,20.0
650,0,650,[227 240 392 367 223],222,2,2201,3.380952380952381,20.0,0.0
651,0,651,[255 243 219 241 290],682,1,2202,3.3773006134969323,0.0,0.0
652,0,652,[509 223 216 232 215],682,2,2204,3.3751914241960184,20.0,20.0
653,0,653,[290 206 223 212 315],363,1,2205,3.371559633027523,40.0,0.0
654,0,654,[300 331 201 431 413],276,3,2208,3.3709923664122137,0.0,20.0
655,0,655,[239 216 272 251 201],305,2,2210,3.3689024390243905,20.0,20.0
656,0,656,[413 230 216 217 218],130,2,2212,3.3668188736681888,0.0,20.0
657,0,657,[275 299 413 508 259],181,0,2212,3.3617021276595747,0.0,0.0
658,0,658,[209 413 268 298 291],303,3,2215,3.361153262518968,0.0,40.0
659,0,659,[298 452 211 272 230],758,4,2219,3.3621212121212123,20.0,20.0
660,0,660,[223 218 216 268 240],551,4,2223,3.363086232980333,20.0,40.0
661,0,661,[240 331 264 268 284],435,2,2225,3.3610271903323263,0.0,20.0
662,0,662,[390 240 507 202 420],303,3,2228,3.3604826546003017,0.0,0.0
663,0,663,[508 298 246 291 222],595,3,2231,3.3599397590361444,0.0,40.0
664,0,664,[217 215 293 255 392],222,2,2233,3.357894736842105,0.0,0.0
665,0,665,[227 230 303 202 222],293,1,2234,3.354354354354354,0.0,20.0
666,0,666,[216 222 218 236 215],130,5,2239,3.3568215892053974,0.0,40.0
667,0,667,[244 219 226 218 209],916,1,2240,3.3532934131736525,0.0,0.0
668,0,668,[244 221 209 367 213],916,3,2243,3.3527653213751867,0.0,0.0
669,0,669,[221 218 209 509 583],201,1,2244,3.3492537313432837,0.0,0.0
670,0,670,[217 367 301 365 219],429,1,2245,3.34575260804769,0.0,0.0
671,0,671,[201 206 303 240 508],201,2,2247,3.34375,0.0,0.0
672,0,672,[250 216 268 367 300],497,2,2249,3.3417533432392275,0.0,60.0
673,0,673,[202 201 420 209 230],276,5,2254,3.344213649851632,0.0,0.0
674,0,674,[208 201 227 217 231],886,0,2254,3.339259259259259,0.0,0.0
675,0,675,[217 230 215 256 293],363,1,2255,3.3357988165680474,0.0,0.0
676,0,676,[367 413 241 219 206],276,3,2258,3.3353028064992616,0.0,0.0
677,0,677,[219 478 212 250 275],896,2,2260,3.3333333333333335,20.0,0.0
678,0,678,[452 293 250 298 583],425,3,2263,3.3328424153166423,0.0,20.0
679,0,679,[481 275 226 222 217],896,3,2266,3.3323529411764707,0.0,20.0
680,0,680,[240 209 246 208 300],880,3,2269,3.331864904552129,0.0,20.0
681,0,681,[420 254 246 298 431],682,3,2272,3.3313782991202348,0.0,20.0
682,0,682,[509 420 507 280 227],293,2,2274,3.329428989751098,0.0,0.0
683,0,683,[216 259 209 298 583],790,2,2276,3.327485380116959,0.0,40.0
684,0,684,[284 300 508 223 227],896,3,2279,3.3270072992700728,20.0,20.0
685,0,685,[291 301 241 384 239],758,2,2281,3.325072886297376,0.0,0.0
686,0,686,[215 217 326 241 321],201,0,2281,3.3202328966521106,0.0,0.0
687,0,687,[316 301 324 264 315],820,0,2281,3.315406976744186,40.0,0.0
688,0,688,[231 509 508 268 212],201,3,2284,3.3149492017416544,0.0,20.0
689,0,689,[324 420 209 315 208],758,4,2288,3.315942028985507,20.0,0.0
690,0,690,[431 284 218 215 201],276,4,2292,3.316931982633864,0.0,0.0
691,0,691,[276 298 231 331 239],276,4,2296,3.3179190751445087,0.0,20.0
692,0,692,[272 280 222 431 291],487,3,2299,3.3174603174603177,20.0,20.0
693,0,693,[201 298 216 212 226],363,1,2300,3.314121037463977,0.0,40.0
694,0,694,[280 326 217 241 219],222,2,2302,3.3122302158273382,0.0,0.0
695,0,695,[239 244 211 452 218],268,2,2304,3.310344827586207,0.0,0.0
696,0,696,[431 275 232 201 255],327,3,2307,3.3098995695839313,0.0,0.0
697,0,697,[303 202 232 226 508],201,1,2308,3.306590257879656,0.0,0.0
698,0,698,[331 293 300 218 508],276,5,2313,3.3090128755364807,0.0,20.0
699,0,699,[239 219 300 202 508],303,3,2316,3.3085714285714287,0.0,20.0
700,0,700,[316 261 240 350 291],130,5,2321,3.310984308131241,20.0,0.0
701,0,701,[264 331 268 244 255],919,2,2323,3.309116809116809,0.0,20.0
702,0,702,[392 367 211 208 230],94,3,2326,3.3086770981507825,0.0,0.0
703,0,703,[431 243 316 202 216],660,2,2328,3.3068181818181817,20.0,20.0
704,0,704,[272 297 250 283 243],919,3,2331,3.3063829787234043,20.0,0.0
705,0,705,[218 344 231 212 303],758,3,2334,3.3059490084985836,0.0,0.0
706,0,706,[226 431 508 268 324],327,1,2335,3.3026874115983027,0.0,20.0
707,0,707,[217 227 218 209 230],293,0,2335,3.2980225988700567,0.0,0.0
708,0,708,[231 392 240 250 268],130,3,2338,3.297602256699577,0.0,20.0
709,0,709,[384 232 420 218 223],399,1,2339,3.2943661971830984,20.0,0.0
710,0,710,[431 218 300 222 268],435,1,2340,3.2911392405063293,0.0,60.0
711,0,711,[321 275 583 276 226],429,2,2342,3.289325842696629,0.0,0.0
712,0,712,[259 384 209 222 283],514,3,2345,3.2889200561009817,0.0,20.0
713,0,713,[321 272 246 268 218],130,5,2350,3.291316526610644,20.0,20.0
714,0,714,[583 221 290 509 367],916,3,2353,3.290909090909091,0.0,0.0
715,0,715,[367 384 222 209 250],303,3,2356,3.2905027932960893,0.0,20.0
716,0,716,[384 420 222 264 300],303,1,2357,3.287308228730823,0.0,40.0
717,0,717,[272 236 284 297 221],919,4,2361,3.288300835654596,20.0,0.0
718,0,718,[299 231 236 240 202],130,3,2364,3.2878998609179417,0.0,0.0
719,0,719,[241 413 284 298 507],303,4,2368,3.2888888888888888,0.0,20.0
720,0,720,[202 217 384 230 264],276,3,2371,3.2884882108183078,0.0,0.0
721,0,721,[222 507 291 378 283],393,3,2374,3.2880886426592797,0.0,20.0
722,0,722,[231 211 280 227 250],429,1,2375,3.284923928077455,0.0,0.0
723,0,723,[293 420 251 315 275],293,3,2378,3.2845303867403315,20.0,0.0
724,0,724,[298 392 272 254 246],130,4,2382,3.2855172413793103,20.0,20.0
725,0,725,[211 452 209 231 239],201,0,2382,3.28099173553719,0.0,0.0
726,0,726,[431 367 283 241 220],178,4,2386,3.281980742778542,0.0,0.0
727,0,727,[240 230 420 331 431],532,4,2390,3.282967032967033,0.0,0.0
728,0,728,[452 223 420 429 290],276,4,2394,3.2839506172839505,20.0,0.0
729,0,729,[226 420 223 272 206],276,5,2399,3.286301369863014,40.0,0.0
730,0,730,[239 298 452 223 268],303,3,2402,3.2859097127222983,20.0,40.0
731,0,731,[275 272 297 301 221],919,4,2406,3.2868852459016393,20.0,0.0
732,0,732,[291 365 509 201 299],682,2,2408,3.2851296043656206,0.0,0.0
733,0,733,[202 508 331 431 316],758,4,2412,3.2861035422343323,20.0,0.0
734,0,734,[300 431 211 276 223],889,4,2416,3.287074829931973,20.0,20.0
735,0,735,[232 283 431 240 230],790,2,2418,3.285326086956522,0.0,0.0
736,0,736,[259 217 300 384 420],682,1,2419,3.282225237449118,0.0,20.0
737,0,737,[350 431 221 331 420],758,2,2421,3.2804878048780486,0.0,0.0
738,0,738,[255 298 293 217 452],222,1,2422,3.277401894451962,0.0,20.0
739,0,739,[291 384 507 208 284],727,2,2424,3.2756756756756755,0.0,0.0
740,0,740,[431 452 392 215 301],276,2,2426,3.2739541160593792,0.0,0.0
741,0,741,[239 216 221 268 298],303,4,2430,3.274932614555256,0.0,60.0
742,0,742,[216 384 367 241 230],301,4,2434,3.2759084791386273,0.0,20.0
743,0,743,[202 324 583 241 291],303,2,2436,3.274193548387097,0.0,0.0
744,0,744,[276 231 227 212 211],201,3,2439,3.2738255033557047,0.0,0.0
745,0,745,[251 303 299 201 268],592,4,2443,3.274798927613941,0.0,20.0
746,0,746,[202 239 298 230 293],487,5,2448,3.2771084337349397,0.0,20.0
747,0,747,[241 384 367 299 217],682,3,2451,3.2767379679144386,0.0,0.0
748,0,748,[275 431 201 255 209],327,3,2454,3.2763684913217626,0.0,0.0
749,0,749,[429 211 507 297 509],293,4,2458,3.2773333333333334,0.0,0.0
750,0,750,[223 230 315 231 211],201,1,2459,3.274300932090546,40.0,0.0
751,0,751,[290 209 420 223 365],682,0,2459,3.2699468085106385,20.0,0.0
752,0,752,[316 384 300 227 239],276,4,2463,3.270916334661355,20.0,20.0
753,0,753,[280 275 326 508 222],178,4,2467,3.2718832891246685,0.0,20.0
754,0,754,[295 431 291 222 202],109,3,2470,3.271523178807947,0.0,20.0
755,0,755,[316 223 227 280 507],293,2,2472,3.2698412698412698,40.0,0.0
756,0,756,[413 268 583 326 216],201,2,2474,3.2681638044914134,0.0,40.0
757,0,757,[227 300 240 291 365],551,4,2478,3.2691292875989446,0.0,20.0
758,0,758,[331 223 240 272 481],758,4,2482,3.270092226613966,40.0,0.0
759,0,759,[222 254 219 246 240],682,3,2485,3.2697368421052633,0.0,20.0
760,0,760,[250 420 202 264 254],276,3,2488,3.269382391590013,0.0,0.0
761,0,761,[223 420 431 284 227],276,4,2492,3.270341207349081,20.0,0.0
762,0,762,[429 206 298 218 227],276,5,2497,3.272608125819135,0.0,20.0
763,0,763,[298 291 297 344 509],758,4,2501,3.2735602094240837,0.0,20.0
764,0,764,[206 243 208 216 232],1,3,2504,3.273202614379085,0.0,20.0
765,0,765,[485 231 268 239 216],846,4,2508,3.2741514360313317,0.0,40.0
766,0,766,[227 255 202 239 264],472,4,2512,3.27509778357236,0.0,0.0
767,0,767,[276 232 222 290 241],244,3,2515,3.2747395833333335,0.0,20.0
768,0,768,[276 392 420 250 227],130,3,2518,3.2743823146944084,0.0,0.0
769,0,769,[226 206 413 218 219],201,2,2520,3.272727272727273,0.0,0.0
770,0,770,[267 256 222 213 236],1,4,2524,3.2736705577172502,0.0,20.0
771,0,771,[222 226 256 241 220],1,3,2527,3.273316062176166,0.0,20.0
772,0,772,[316 300 216 509 264],293,1,2528,3.2703751617076326,20.0,40.0
773,0,773,[583 240 219 384 217],682,2,2530,3.268733850129199,0.0,0.0
774,0,774,[290 298 250 331 219],130,2,2532,3.2670967741935484,0.0,20.0
775,0,775,[240 324 583 215 264],276,3,2535,3.2667525773195876,0.0,0.0
776,0,776,[267 216 413 316 508],130,4,2539,3.2676962676962678,20.0,20.0
777,0,777,[202 316 206 219 231],130,3,2542,3.2673521850899743,20.0,0.0
778,0,778,[413 206 324 301 240],276,4,2546,3.268292682926829,0.0,0.0
779,0,779,[217 246 295 300 508],130,3,2549,3.267948717948718,0.0,20.0
780,0,780,[268 413 283 251 508],303,3,2552,3.267605633802817,0.0,20.0
781,0,781,[295 219 259 232 255],178,3,2555,3.2672634271099743,0.0,0.0
782,0,782,[209 507 208 219 202],303,5,2560,3.269476372924649,0.0,0.0
783,0,783,[420 239 208 209 268],303,4,2564,3.270408163265306,0.0,20.0
784,0,784,[268 243 201 250 244],1,2,2566,3.2687898089171976,0.0,20.0
785,0,785,[227 217 231 212 213],1,2,2568,3.267175572519084,0.0,0.0
786,0,786,[222 301 336 508 264],327,0,2568,3.263024142312579,0.0,20.0
787,0,787,[478 217 508 284 299],896,2,2570,3.261421319796954,20.0,0.0
788,0,788,[241 226 223 219 202],303,5,2575,3.26362484157161,20.0,0.0
789,0,789,[303 202 316 222 209],293,1,2576,3.260759493670886,20.0,20.0
790,0,790,[231 272 298 316 246],880,4,2580,3.261694058154235,40.0,20.0
791,0,791,[250 284 227 212 208],363,2,2582,3.26010101010101,0.0,0.0
792,0,792,[215 507 316 217 206],293,3,2585,3.2597730138713747,20.0,0.0
793,0,793,[384 508 268 316 202],880,4,2589,3.260705289672544,20.0,20.0
794,0,794,[508 268 264 243 244],919,1,2590,3.257861635220126,0.0,20.0
795,0,795,[208 230 485 227 275],293,0,2590,3.2537688442211055,0.0,0.0
796,0,796,[452 241 215 239 324],201,1,2591,3.250941028858218,0.0,0.0
797,0,797,[215 284 221 202 268],303,5,2596,3.2531328320802007,0.0,20.0
798,0,798,[250 326 201 236 276],592,4,2600,3.254067584480601,0.0,0.0
799,0,799,[213 211 202 251 208],1,3,2603,3.25375,0.0,0.0
800,0,800,[216 236 231 315 298],130,4,2607,3.254681647940075,20.0,40.0
801,0,801,[211 267 240 218 243],1,1,2608,3.251870324189526,0.0,0.0
802,0,802,[223 232 246 201 243],682,2,2610,3.2503113325031134,20.0,0.0
803,0,803,[243 272 300 202 240],130,4,2614,3.2512437810945274,20.0,20.0
804,0,804,[202 365 217 250 367],472,5,2619,3.253416149068323,0.0,0.0
805,0,805,[507 250 236 251 283],303,4,2623,3.2543424317617866,0.0,0.0
806,0,806,[222 478 215 508 211],896,4,2627,3.255266418835192,20.0,20.0
807,0,807,[276 481 297 223 250],758,4,2631,3.256188118811881,20.0,0.0
808,0,808,[209 211 250 293 218],327,1,2632,3.253399258343634,0.0,0.0
809,0,809,[350 261 230 231 272],130,3,2635,3.253086419753086,20.0,0.0
810,0,810,[255 232 226 478 216],407,3,2638,3.252774352651048,20.0,20.0
811,0,811,[394 280 367 255 378],393,4,2642,3.2536945812807883,0.0,0.0
812,0,812,[227 264 291 301 226],276,3,2645,3.2533825338253384,0.0,0.0
813,0,813,[227 246 420 231 226],303,4,2649,3.2542997542997543,0.0,0.0
814,0,814,[246 202 272 344 508],592,5,2654,3.256441717791411,20.0,0.0
815,0,815,[209 293 284 300 452],303,3,2657,3.2561274509803924,0.0,20.0
816,0,816,[246 300 240 243 272],919,2,2659,3.254589963280294,20.0,20.0
817,0,817,[247 326 232 219 268],222,4,2663,3.2555012224938875,0.0,20.0
818,0,818,[222 209 230 255 431],327,2,2665,3.253968253968254,0.0,20.0
819,0,819,[202 232 220 209 255],178,4,2669,3.254878048780488,0.0,0.0
820,0,820,[250 276 223 272 315],919,3,2672,3.254567600487211,60.0,0.0
821,0,821,[251 227 293 291 202],293,2,2674,3.2530413625304138,0.0,0.0
822,0,822,[219 227 298 293 232],222,3,2677,3.25273390036452,0.0,20.0
823,0,823,[420 222 216 211 431],435,2,2679,3.2512135922330097,0.0,40.0
824,0,824,[315 221 236 215 298],592,4,2683,3.252121212121212,20.0,20.0
825,0,825,[226 221 324 583 230],303,2,2685,3.250605326876513,0.0,0.0
826,0,826,[221 209 241 276 215],303,5,2690,3.252720677146312,0.0,0.0
827,0,827,[508 232 218 236 293],303,5,2695,3.254830917874396,0.0,0.0
828,0,828,[283 212 255 275 202],249,4,2699,3.255729794933655,0.0,0.0
829,0,829,[268 220 215 259 232],178,3,2702,3.255421686746988,0.0,20.0
830,0,830,[215 222 336 212 256],363,2,2704,3.253910950661853,0.0,20.0
831,0,831,[508 365 231 223 232],222,3,2707,3.253605769230769,20.0,0.0
832,0,832,[241 331 583 221 222],201,1,2708,3.250900360144058,0.0,20.0
833,0,833,[283 315 301 280 293],880,3,2711,3.2505995203836933,20.0,0.0
834,0,834,[390 240 230 264 231],303,1,2712,3.2479041916167666,0.0,0.0
835,0,835,[298 378 293 321 208],429,3,2715,3.2476076555023923,0.0,20.0
836,0,836,[208 284 230 413 202],303,3,2718,3.247311827956989,0.0,0.0
837,0,837,[201 272 300 303 240],276,5,2723,3.2494033412887826,20.0,20.0
838,0,838,[202 211 508 367 507],327,3,2726,3.2491060786650774,0.0,0.0
839,0,839,[367 215 276 226 227],276,4,2730,3.25,0.0,0.0
840,0,840,[244 223 230 508 226],407,3,2733,3.249702734839477,20.0,0.0
841,0,841,[240 222 315 291 250],276,4,2737,3.2505938242280283,20.0,20.0
842,0,842,[255 583 201 293 215],303,4,2741,3.2514827995255042,0.0,0.0
843,0,843,[250 239 283 413 264],303,1,2742,3.248815165876777,0.0,0.0
844,0,844,[230 232 291 508 276],276,3,2745,3.2485207100591715,0.0,0.0
845,0,845,[227 243 413 290 298],130,1,2746,3.2458628841607564,0.0,20.0
846,0,846,[284 315 301 239 240],276,5,2751,3.2479338842975207,20.0,0.0
847,0,847,[218 239 201 247 255],1,1,2752,3.2452830188679247,0.0,0.0
848,0,848,[276 300 202 367 392],478,3,2755,3.2449941107184923,0.0,20.0
849,0,849,[215 367 291 226 220],244,1,2756,3.2423529411764704,0.0,0.0
850,0,850,[222 431 272 226 202],201,0,2756,3.2385428907168037,20.0,20.0
851,0,851,[259 261 300 272 246],919,3,2759,3.238262910798122,20.0,20.0
852,0,852,[284 230 217 264 206],268,0,2759,3.234466588511137,0.0,0.0
853,0,853,[218 239 267 247 222],1,3,2762,3.234192037470726,0.0,20.0
854,0,854,[202 431 216 300 365],222,5,2767,3.2362573099415206,0.0,40.0
855,0,855,[413 236 350 239 231],130,3,2770,3.235981308411215,0.0,0.0
856,0,856,[367 230 293 276 240],880,4,2774,3.236872812135356,0.0,0.0
857,0,857,[478 301 268 324 344],327,3,2777,3.2365967365967365,20.0,20.0
858,0,858,[344 218 230 211 431],758,3,2780,3.2363213038416765,0.0,0.0
859,0,859,[264 507 219 201 293],327,3,2783,3.236046511627907,0.0,0.0
860,0,860,[239 231 250 293 268],303,4,2787,3.2369337979094075,0.0,20.0
861,0,861,[219 303 206 215 216],201,2,2789,3.2354988399071924,0.0,20.0
862,0,862,[276 216 239 208 219],222,4,2793,3.236384704519119,0.0,20.0
863,0,863,[217 208 413 291 268],727,3,2796,3.236111111111111,0.0,20.0
864,0,864,[222 413 290 300 390],303,1,2797,3.2335260115606936,0.0,40.0
865,0,865,[298 215 216 202 431],660,1,2798,3.23094688221709,0.0,40.0
866,0,866,[212 236 367 298 218],916,2,2800,3.229527104959631,0.0,20.0
867,0,867,[583 378 209 216 227],429,2,2802,3.228110599078341,0.0,20.0
868,0,868,[275 222 255 290 223],393,4,2806,3.228998849252014,20.0,20.0
869,0,869,[321 276 272 213 324],201,3,2809,3.2287356321839082,20.0,0.0
870,0,870,[429 290 230 209 231],660,3,2812,3.2284730195177955,0.0,0.0
871,0,871,[583 218 236 230 413],303,2,2814,3.227064220183486,0.0,0.0
872,0,872,[413 583 367 231 324],276,1,2815,3.2245131729667813,0.0,0.0
873,0,873,[420 507 315 241 303],393,3,2818,3.2242562929061784,20.0,0.0
874,0,874,[478 223 268 295 226],178,4,2822,3.225142857142857,40.0,20.0
875,0,875,[250 300 239 485 217],293,0,2822,3.221461187214612,0.0,20.0
876,0,876,[212 583 272 321 268],201,2,2824,3.2200684150513115,20.0,20.0
877,0,877,[219 583 239 295 236],916,2,2826,3.218678815489749,0.0,0.0
878,0,878,[243 259 344 367 301],592,2,2828,3.217292377701934,0.0,0.0
879,0,879,[219 232 209 250 290],429,3,2831,3.2170454545454548,0.0,0.0
880,0,880,[246 326 259 223 295],919,2,2833,3.2156640181611804,20.0,0.0
881,0,881,[218 222 243 284 367],880,4,2837,3.2165532879818595,0.0,20.0
882,0,882,[218 216 284 275 259],178,3,2840,3.216308040770102,0.0,20.0
883,0,883,[222 300 226 394 268],497,1,2841,3.2138009049773757,0.0,60.0
884,0,884,[230 215 241 331 420],532,5,2846,3.215819209039548,0.0,0.0
885,0,885,[394 241 321 431 507],393,2,2848,3.214446952595937,0.0,0.0
886,0,886,[246 272 230 206 420],276,5,2853,3.216459977452086,20.0,0.0
887,0,887,[240 301 230 293 221],758,1,2854,3.213963963963964,0.0,0.0
888,0,888,[216 291 350 331 243],592,2,2856,3.2125984251968505,0.0,20.0
889,0,889,[215 298 291 255 508],592,4,2860,3.2134831460674156,0.0,20.0
890,0,890,[316 280 219 324 384],551,2,2862,3.212121212121212,20.0,0.0
891,0,891,[316 272 350 300 215],130,5,2867,3.2141255605381165,40.0,20.0
892,0,892,[298 261 268 275 255],919,2,2869,3.2127659574468086,0.0,40.0
893,0,893,[508 250 315 240 331],276,5,2874,3.214765100671141,20.0,0.0
894,0,894,[227 208 240 365 232],880,3,2877,3.2145251396648047,0.0,0.0
895,0,895,[268 251 291 344 216],592,4,2881,3.2154017857142856,0.0,40.0
896,0,896,[284 293 331 326 267],130,3,2884,3.2151616499442586,0.0,0.0
897,0,897,[431 208 218 240 202],435,2,2886,3.2138084632516706,0.0,0.0
898,0,898,[216 250 222 367 209],682,3,2889,3.21357063403782,0.0,40.0
899,0,899,[431 280 298 239 275],393,4,2893,3.2144444444444447,0.0,20.0
900,0,900,[222 264 223 298 209],276,4,2897,3.2153163152053272,20.0,40.0
901,0,901,[300 378 232 293 507],429,3,2900,3.2150776053215075,0.0,20.0
902,0,902,[201 392 291 250 508],429,2,2902,3.2137320044296787,0.0,0.0
903,0,903,[208 239 216 315 431],660,3,2905,3.213495575221239,20.0,20.0
904,0,904,[212 231 209 216 268],889,2,2907,3.212154696132597,0.0,40.0
905,0,905,[316 293 331 226 267],130,4,2911,3.2130242825607063,20.0,0.0
906,0,906,[298 215 315 254 300],276,4,2915,3.2138919514884234,20.0,40.0
907,0,907,[219 227 365 215 324],551,4,2919,3.2147577092511015,0.0,0.0
908,0,908,[240 298 392 431 217],276,3,2922,3.2145214521452146,0.0,20.0
909,0,909,[215 326 209 508 255],178,4,2926,3.2153846153846155,0.0,0.0
910,0,910,[240 298 254 243 413],130,2,2928,3.214050493962678,0.0,20.0
911,0,911,[217 331 206 254 303],276,4,2932,3.2149122807017543,0.0,0.0
912,0,912,[239 254 509 293 240],682,2,2934,3.213581599123768,0.0,0.0
913,0,913,[236 244 268 367 230],916,3,2937,3.213347921225383,0.0,20.0
914,0,914,[324 246 239 276 226],303,3,2940,3.2131147540983607,0.0,0.0
915,0,915,[276 392 324 227 367],276,3,2943,3.212882096069869,0.0,0.0
916,0,916,[255 268 211 300 298],327,1,2944,3.2104689203925845,0.0,60.0
917,0,917,[230 231 284 420 232],301,3,2947,3.210239651416122,0.0,0.0
918,0,918,[290 390 239 293 215],303,3,2950,3.2100108813928183,0.0,0.0
919,0,919,[300 239 254 290 365],682,0,2950,3.2065217391304346,0.0,20.0
920,0,920,[211 254 219 250 291],682,2,2952,3.205211726384365,0.0,0.0
921,0,921,[240 206 324 268 212],201,3,2955,3.204989154013015,0.0,20.0
922,0,922,[219 268 367 250 261],222,2,2957,3.2036836403033586,0.0,20.0
923,0,923,[431 211 201 420 481],896,3,2960,3.2034632034632033,0.0,0.0
924,0,924,[236 350 240 250 299],130,3,2963,3.2032432432432434,0.0,0.0
925,0,925,[208 231 217 276 227],864,4,2967,3.2041036717062634,0.0,0.0
926,0,926,[378 219 209 264 217],429,2,2969,3.202804746494067,0.0,0.0
927,0,927,[384 324 365 264 431],276,1,2970,3.2004310344827585,0.0,0.0
928,0,928,[240 231 232 431 367],472,5,2975,3.2023681377825617,0.0,0.0
929,0,929,[298 201 243 215 219],660,0,2975,3.1989247311827955,0.0,20.0
930,0,930,[284 239 413 315 240],130,3,2978,3.1987110633727176,20.0,0.0
931,0,931,[367 220 216 209 301],244,2,2980,3.1974248927038627,0.0,20.0
932,0,932,[298 344 211 293 250],327,1,2981,3.195069667738478,0.0,20.0
933,0,933,[321 236 231 324 226],303,3,2984,3.194860813704497,0.0,0.0
934,0,934,[284 241 293 290 485],429,1,2985,3.192513368983957,0.0,0.0
935,0,935,[431 240 276 392 202],276,3,2988,3.1923076923076925,0.0,0.0
936,0,936,[272 215 316 509 227],551,5,2993,3.1942369263607255,40.0,0.0
937,0,937,[431 275 293 276 284],178,4,2997,3.195095948827292,0.0,0.0
938,0,938,[218 251 298 216 208],303,5,3002,3.197018104366347,0.0,40.0
939,0,939,[280 218 219 284 291],429,2,3004,3.195744680851064,0.0,0.0
940,0,940,[222 255 324 300 298],303,2,3006,3.194473963868225,0.0,60.0
941,0,941,[264 293 321 326 208],303,2,3008,3.1932059447983017,0.0,0.0
942,0,942,[367 256 290 244 209],916,1,3009,3.190880169671262,0.0,0.0
943,0,943,[216 222 227 240 218],301,4,3013,3.1917372881355934,0.0,40.0
944,0,944,[202 293 326 216 209],222,4,3017,3.1925925925925926,0.0,20.0
945,0,945,[227 293 291 429 232],293,2,3019,3.1913319238900635,0.0,0.0
946,0,946,[284 367 208 202 378],429,2,3021,3.1900739176346358,0.0,0.0
947,0,947,[291 485 202 222 300],429,3,3024,3.189873417721519,0.0,40.0
948,0,948,[272 290 215 208 390],286,2,3026,3.188619599578504,20.0,0.0
949,0,949,[201 507 378 283 240],727,1,3027,3.186315789473684,0.0,0.0
950,0,950,[268 331 429 413 240],276,4,3031,3.1871713985278656,0.0,20.0
951,0,951,[283 202 250 217 367],880,3,3034,3.186974789915966,0.0,0.0
952,0,952,[264 232 508 227 331],551,4,3038,3.1878279118572928,0.0,0.0
953,0,953,[215 230 211 431 326],545,1,3039,3.1855345911949686,0.0,0.0
954,0,954,[324 264 244 206 222],268,3,3042,3.1853403141361256,0.0,20.0
955,0,955,[209 315 392 202 431],660,3,3045,3.185146443514644,20.0,0.0
956,0,956,[223 290 324 508 392],347,1,3046,3.1828631138975965,20.0,0.0
957,0,957,[420 321 315 227 246],130,4,3050,3.183716075156576,20.0,0.0
958,0,958,[250 295 230 211 239],916,2,3052,3.1824817518248176,0.0,0.0
959,0,959,[324 217 227 272 315],276,5,3057,3.184375,40.0,0.0
960,0,960,[208 227 431 250 215],222,2,3059,3.183142559833507,0.0,0.0
961,0,961,[231 218 236 300 350],758,3,3062,3.182952182952183,0.0,20.0
962,0,962,[298 226 246 267 230],130,4,3066,3.1838006230529596,0.0,20.0
963,0,963,[217 452 508 202 350],130,4,3070,3.184647302904564,0.0,0.0
964,0,964,[216 254 226 231 215],130,3,3073,3.184455958549223,0.0,20.0
965,0,965,[255 298 231 276 392],487,2,3075,3.1832298136645965,0.0,20.0
966,0,966,[217 215 222 241 367],94,4,3079,3.184074457083764,0.0,20.0
967,0,967,[250 227 239 284 232],586,0,3079,3.1807851239669422,0.0,0.0
968,0,968,[216 208 206 239 452],868,1,3080,3.1785345717234263,0.0,20.0
969,0,969,[259 384 251 202 276],303,3,3083,3.1783505154639173,0.0,0.0
970,0,970,[431 295 250 236 290],916,2,3085,3.177136972193615,0.0,0.0
971,0,971,[303 216 255 202 485],299,3,3088,3.1769547325102883,0.0,20.0
972,0,972,[201 331 219 431 284],435,3,3091,3.1767728674203495,0.0,0.0
973,0,973,[227 226 295 485 218],532,5,3096,3.1786447638603694,0.0,0.0
974,0,974,[246 217 255 236 223],919,4,3100,3.1794871794871793,20.0,0.0
975,0,975,[222 202 219 392 217],94,2,3102,3.17827868852459,0.0,20.0
976,0,976,[219 315 367 276 222],130,5,3107,3.18014329580348,20.0,20.0
977,0,977,[231 276 222 384 365],682,1,3108,3.1779141104294477,0.0,20.0
978,0,978,[331 301 392 226 231],276,3,3111,3.177732379979571,0.0,0.0
979,0,979,[300 239 275 255 301],327,1,3112,3.1755102040816325,0.0,20.0
980,0,980,[222 431 230 208 250],727,3,3115,3.1753312945973495,0.0,20.0
981,0,981,[331 227 293 219 326],130,3,3118,3.175152749490835,0.0,0.0
982,0,982,[206 243 255 223 230],1,3,3121,3.1749745676500507,20.0,0.0
983,0,983,[239 231 290 264 431],363,0,3121,3.171747967479675,0.0,0.0
984,0,984,[226 218 452 431 485],456,3,3124,3.1715736040609137,0.0,0.0
985,0,985,[217 365 321 431 226],429,1,3125,3.1693711967545637,0.0,0.0
986,0,986,[276 284 300 268 331],178,4,3129,3.1702127659574466,0.0,40.0
987,0,987,[452 219 241 223 244],268,1,3130,3.168016194331984,20.0,0.0
988,0,988,[218 276 219 201 268],682,2,3132,3.166835187057634,0.0,20.0
989,0,989,[298 301 268 326 508],770,5,3137,3.1686868686868688,0.0,40.0
990,0,990,[239 202 431 223 316],276,4,3141,3.169525731584258,40.0,0.0
991,0,991,[321 222 485 378 223],429,2,3143,3.1683467741935485,20.0,20.0
992,0,992,[217 230 209 413 367],222,2,3145,3.1671701913393755,0.0,0.0
993,0,993,[216 218 217 250 246],130,3,3148,3.1670020120724347,0.0,20.0
994,0,994,[301 315 222 223 272],758,4,3152,3.1678391959798997,60.0,20.0
995,0,995,[291 298 452 231 223],758,3,3155,3.1676706827309236,20.0,20.0
996,0,996,[276 240 239 209 316],276,5,3160,3.16950852557673,20.0,0.0
997,0,997,[216 284 429 213 209],293,2,3162,3.1683366733466936,0.0,20.0
998,0,998,[232 215 392 223 246],276,3,3165,3.1681681681681684,20.0,0.0
999,0,999,[297 293 240 321 264],919,2,3167,3.167,0.0,0.0
1000,0,1000,[256 268 508 246 222],69,4,3171,3.167832167832168,0.0,40.0
1001,0,1001,[259 293 300 254 384],682,1,3172,3.165668662674651,0.0,20.0
1002,0,1002,[208 284 583 222 209],293,0,3172,3.1625124626121637,0.0,20.0
1003,0,1003,[298 276 272 508 217],919,4,3176,3.1633466135458166,20.0,20.0
1004,0,1004,[276 481 231 316 218],758,3,3179,3.16318407960199,20.0,0.0
1005,0,1005,[508 218 297 275 272],919,5,3184,3.165009940357853,20.0,0.0
1006,0,1006,[231 384 431 201 206],363,0,3184,3.1618669314796426,0.0,0.0
1007,0,1007,[246 213 202 250 209],790,2,3186,3.1607142857142856,0.0,0.0
1008,0,1008,[259 321 284 300 283],303,1,3187,3.1585728444003967,0.0,20.0
1009,0,1009,[219 208 211 240 251],1,2,3189,3.1574257425742576,0.0,0.0
1010,0,1010,[280 218 219 331 215],551,4,3193,3.158259149357072,0.0,0.0
1011,0,1011,[315 283 251 276 303],592,5,3198,3.1600790513833994,20.0,0.0
1012,0,1012,[222 255 230 485 226],293,0,3198,3.156959526159921,0.0,20.0
1013,0,1013,[208 336 232 201 206],363,2,3200,3.155818540433925,0.0,0.0
1014,0,1014,[413 236 300 268 420],130,4,3204,3.1566502463054187,0.0,40.0
1015,0,1015,[250 202 231 226 246],222,2,3206,3.155511811023622,0.0,0.0
1016,0,1016,[226 291 250 246 300],130,4,3210,3.1563421828908553,0.0,20.0
1017,0,1017,[301 478 300 367 293],327,2,3212,3.1552062868369353,20.0,20.0
1018,0,1018,[239 284 299 206 227],896,3,3215,3.155053974484789,0.0,0.0
1019,0,1019,[276 231 583 246 227],303,3,3218,3.1549019607843136,0.0,0.0
1020,0,1020,[209 365 290 298 264],429,2,3220,3.1537708129285016,0.0,20.0
1021,0,1021,[290 293 264 583 429],293,2,3222,3.152641878669276,0.0,0.0
1022,0,1022,[316 230 508 303 331],276,5,3227,3.1544477028347995,20.0,0.0
1023,0,1023,[485 217 298 208 222],429,3,3230,3.154296875,0.0,40.0
1024,0,1024,[293 201 280 481 232],429,2,3232,3.153170731707317,0.0,0.0
1025,0,1025,[367 331 218 431 255],435,1,3233,3.151072124756335,0.0,0.0
1026,0,1026,[326 202 392 331 299],130,3,3236,3.150925024342746,0.0,0.0
1027,0,1027,[300 240 218 508 272],532,4,3240,3.151750972762646,20.0,20.0
1028,0,1028,[246 223 298 219 244],268,2,3242,3.1506316812439263,20.0,20.0
1029,0,1029,[367 293 255 221 259],919,5,3247,3.152427184466019,0.0,0.0
1030,0,1030,[392 216 226 240 255],435,1,3248,3.150339476236663,0.0,20.0
1031,0,1031,[295 241 431 259 255],178,3,3251,3.1501937984496124,0.0,0.0
1032,0,1032,[254 276 365 331 324],276,3,3254,3.150048402710552,0.0,0.0
1033,0,1033,[209 420 583 300 216],293,2,3256,3.148936170212766,0.0,40.0
1034,0,1034,[219 392 212 300 239],896,1,3257,3.1468599033816425,0.0,20.0
1035,0,1035,[201 230 208 221 206],1,4,3261,3.1476833976833976,0.0,0.0
1036,0,1036,[227 223 250 420 367],393,3,3264,3.1475409836065573,20.0,0.0
1037,0,1037,[365 241 367 378 219],682,1,3265,3.1454720616570326,0.0,0.0
1038,0,1038,[316 452 300 222 293],758,2,3267,3.14436958614052,20.0,40.0
1039,0,1039,[244 216 209 239 303],299,1,3268,3.1423076923076922,0.0,20.0
1040,0,1040,[261 276 350 299 324],592,3,3271,3.1421709894332372,0.0,0.0
1041,0,1041,[272 420 250 276 218],758,3,3274,3.1420345489443378,20.0,0.0
1042,0,1042,[431 216 206 336 298],363,2,3276,3.140939597315436,0.0,40.0
1043,0,1043,[206 232 291 284 384],896,1,3277,3.138888888888889,0.0,0.0
1044,0,1044,[216 231 227 213 420],758,3,3280,3.138755980861244,0.0,20.0
1045,0,1045,[367 221 284 216 236],303,5,3285,3.1405353728489485,0.0,20.0
1046,0,1046,[222 290 291 255 272],393,4,3289,3.1413562559694364,20.0,20.0
1047,0,1047,[219 324 254 240 300],276,4,3293,3.142175572519084,0.0,20.0
1048,0,1048,[250 236 241 293 201],606,3,3296,3.142040038131554,0.0,0.0
1049,0,1049,[298 300 326 219 218],303,3,3299,3.1419047619047618,0.0,40.0
1050,0,1050,[293 206 413 384 217],276,3,3302,3.1417697431018077,0.0,0.0
1051,0,1051,[255 219 420 222 284],682,2,3304,3.140684410646388,0.0,20.0
1052,0,1052,[290 326 284 508 331],181,0,3304,3.1377018043684712,0.0,0.0
1053,0,1053,[209 226 227 216 290],22,5,3309,3.1394686907020875,0.0,20.0
1054,0,1054,[230 350 209 331 291],758,5,3314,3.1412322274881515,0.0,0.0
1055,0,1055,[231 232 202 254 300],880,2,3316,3.140151515151515,0.0,20.0
1056,0,1056,[298 240 331 291 239],276,4,3320,3.140964995269631,0.0,20.0
1057,0,1057,[268 232 209 315 290],286,4,3324,3.1417769376181472,20.0,20.0
1058,0,1058,[208 321 231 264 284],303,3,3327,3.141643059490085,0.0,0.0
1059,0,1059,[223 227 241 254 298],276,4,3331,3.142452830188679,20.0,20.0
1060,0,1060,[226 209 284 240 208],222,1,3332,3.140433553251649,0.0,0.0
1061,0,1061,[420 350 216 236 267],130,5,3337,3.1421845574387945,0.0,20.0
1062,0,1062,[217 216 261 508 276],130,4,3341,3.142991533396049,0.0,20.0
1063,0,1063,[384 390 290 240 221],303,2,3343,3.1419172932330826,0.0,0.0
1064,0,1064,[226 290 299 206 268],130,2,3345,3.140845070422535,0.0,20.0
1065,0,1065,[365 241 300 211 431],429,2,3347,3.1397748592870545,0.0,20.0
1066,0,1066,[367 507 232 291 283],293,1,3348,3.1377694470477975,0.0,0.0
1067,0,1067,[478 209 485 239 481],299,2,3350,3.136704119850187,20.0,0.0
1068,0,1068,[295 250 392 227 240],130,2,3352,3.1356407857811037,0.0,0.0
1069,0,1069,[227 291 206 202 250],276,4,3356,3.136448598130841,0.0,0.0
1070,0,1070,[413 300 452 219 231],276,2,3358,3.1353874883286648,0.0,20.0
1071,0,1071,[583 206 324 219 227],268,3,3361,3.1352611940298507,0.0,0.0
1072,0,1072,[202 367 246 226 280],916,1,3362,3.1332712022367195,0.0,0.0
1073,0,1073,[206 321 290 367 202],130,3,3365,3.133147113594041,0.0,0.0
1074,0,1074,[291 251 236 231 508],303,4,3369,3.133953488372093,0.0,0.0
1075,0,1075,[209 324 202 509 218],201,2,3371,3.132899628252788,0.0,0.0
1076,0,1076,[267 240 223 259 256],1,3,3374,3.1327762302692665,20.0,0.0
1077,0,1077,[202 250 222 284 300],880,3,3377,3.13265306122449,0.0,40.0
1078,0,1078,[209 295 202 219 508],178,3,3380,3.1325301204819276,0.0,0.0
1079,0,1079,[202 230 239 223 255],222,4,3384,3.1333333333333333,20.0,0.0
1080,0,1080,[259 324 232 326 583],303,1,3385,3.131359851988899,0.0,0.0
1081,0,1081,[583 239 276 232 298],682,1,3386,3.129390018484288,0.0,20.0
1082,0,1082,[254 231 241 293 201],682,3,3389,3.1292705447830103,0.0,0.0
1083,0,1083,[272 283 300 316 295],880,3,3392,3.129151291512915,40.0,20.0
1084,0,1084,[223 208 202 222 241],303,4,3396,3.1299539170506914,20.0,20.0
1085,0,1085,[300 201 276 303 508],276,5,3401,3.1316758747697975,0.0,20.0
1086,0,1086,[259 250 246 240 261],919,1,3402,3.1297148114075437,0.0,0.0
1087,0,1087,[293 216 259 367 223],592,4,3406,3.130514705882353,20.0,20.0
1088,0,1088,[283 367 261 222 295],919,2,3408,3.1294765840220387,0.0,20.0
1089,0,1089,[255 295 268 243 321],936,2,3410,3.128440366972477,0.0,20.0
1090,0,1090,[413 431 315 326 215],201,0,3410,3.1255728689275895,20.0,0.0
1091,0,1091,[231 284 367 246 283],790,4,3414,3.1263736263736264,0.0,0.0
1092,0,1092,[413 452 217 291 227],130,2,3416,3.1253430924062213,0.0,0.0
1093,0,1093,[209 231 508 217 240],442,1,3417,3.123400365630713,0.0,0.0
1094,0,1094,[219 284 218 223 259],303,4,3421,3.124200913242009,20.0,0.0
1095,0,1095,[290 298 297 208 255],293,2,3423,3.1231751824817517,0.0,20.0
1096,0,1096,[478 218 239 244 290],407,3,3426,3.12306289881495,20.0,0.0
1097,0,1097,[276 583 509 384 218],682,0,3426,3.120218579234973,0.0,0.0
1098,0,1098,[315 300 231 218 208],880,3,3429,3.1201091901728844,20.0,20.0
1099,0,1099,[431 384 222 231 298],276,2,3431,3.119090909090909,0.0,40.0
1100,0,1100,[378 392 230 208 365],846,2,3433,3.1180744777475025,0.0,0.0
1101,0,1101,[218 290 508 231 202],276,4,3437,3.118874773139746,0.0,0.0
1102,0,1102,[431 344 236 291 303],758,3,3440,3.1187669990933817,0.0,0.0
1103,0,1103,[246 219 202 227 431],916,1,3441,3.1168478260869565,0.0,0.0
1104,0,1104,[241 209 276 201 232],429,3,3444,3.116742081447964,0.0,0.0
1105,0,1105,[232 300 508 283 284],880,3,3447,3.116636528028933,0.0,20.0
1106,0,1106,[218 315 283 300 226],880,3,3450,3.116531165311653,20.0,20.0
1107,0,1107,[324 301 283 298 326],592,4,3454,3.1173285198555956,0.0,20.0
1108,0,1108,[213 241 378 365 231],790,3,3457,3.117222723174031,0.0,0.0
1109,0,1109,[295 485 315 240 301],532,3,3460,3.1171171171171173,20.0,0.0
1110,0,1110,[298 295 261 315 222],592,3,3463,3.117011701170117,20.0,40.0
1111,0,1111,[209 365 208 254 239],880,2,3465,3.116007194244604,0.0,0.0
1112,0,1112,[209 240 250 230 222],622,3,3468,3.115902964959569,0.0,20.0
1113,0,1113,[239 315 209 316 216],293,1,3469,3.114003590664273,40.0,20.0
1114,0,1114,[293 315 241 276 212],758,2,3471,3.1130044843049327,20.0,0.0
1115,0,1115,[276 261 283 336 221],592,3,3474,3.1129032258064515,0.0,0.0
1116,0,1116,[232 413 272 303 509],201,0,3474,3.110116383169203,20.0,0.0
1117,0,1117,[215 431 232 227 241],790,2,3476,3.10912343470483,0.0,0.0
1118,0,1118,[250 316 227 209 246],880,2,3478,3.1081322609472744,20.0,0.0
1119,0,1119,[583 206 239 264 507],293,2,3480,3.107142857142857,0.0,0.0
1120,0,1120,[259 321 507 264 202],303,2,3482,3.1061552185548615,0.0,0.0
1121,0,1121,[324 420 222 326 452],303,1,3483,3.1042780748663104,0.0,20.0
1122,0,1122,[221 326 303 223 331],919,4,3487,3.1050756901157612,20.0,0.0
1123,0,1123,[298 259 221 508 261],919,3,3490,3.104982206405694,0.0,20.0
1124,0,1124,[236 283 268 264 315],592,3,3493,3.104888888888889,20.0,20.0
1125,0,1125,[221 316 298 216 213],758,4,3497,3.105683836589698,20.0,40.0
1126,0,1126,[240 321 217 315 213],201,1,3498,3.103815439219166,20.0,0.0
1127,0,1127,[217 223 227 206 213],293,2,3500,3.102836879432624,20.0,0.0
1128,0,1128,[420 216 367 413 507],303,4,3504,3.103631532329495,0.0,20.0
1129,0,1129,[344 276 303 250 301],592,4,3508,3.104424778761062,0.0,0.0
1130,0,1130,[384 215 222 226 316],363,1,3509,3.1025641025641026,20.0,20.0
1131,0,1131,[236 217 291 392 508],130,4,3513,3.103356890459364,0.0,0.0
1132,0,1132,[250 268 215 272 227],532,4,3517,3.1041482789055603,20.0,20.0
1133,0,1133,[284 272 232 213 201],201,2,3519,3.1031746031746033,20.0,0.0
1134,0,1134,[291 226 206 250 300],435,4,3523,3.1039647577092513,0.0,20.0
1135,0,1135,[232 219 365 230 264],276,2,3525,3.102992957746479,0.0,0.0
1136,0,1136,[250 216 291 420 227],130,3,3528,3.1029023746701845,0.0,20.0
1137,0,1137,[250 217 206 227 215],435,4,3532,3.1036906854130053,0.0,0.0
1138,0,1138,[217 239 507 284 392],727,2,3534,3.1027216856892013,0.0,0.0
1139,0,1139,[267 413 367 261 243],130,3,3537,3.1026315789473684,0.0,0.0
1140,0,1140,[367 378 227 211 478],846,4,3541,3.1034180543382996,20.0,0.0
1141,0,1141,[290 218 392 219 241],276,4,3545,3.1042031523642732,0.0,0.0
1142,0,1142,[275 485 365 291 222],393,3,3548,3.1041119860017496,0.0,20.0
1143,0,1143,[226 291 392 429 230],896,2,3550,3.1031468531468533,0.0,0.0
1144,0,1144,[259 243 246 231 583],682,1,3551,3.1013100436681222,0.0,0.0
1145,0,1145,[219 201 272 250 326],425,2,3553,3.100349040139616,20.0,0.0
1146,0,1146,[215 209 508 206 284],201,1,3554,3.098517872711421,0.0,0.0
1147,0,1147,[250 209 316 280 239],293,0,3554,3.0958188153310107,20.0,0.0
1148,0,1148,[211 223 384 230 218],268,1,3555,3.093994778067885,20.0,0.0
1149,0,1149,[316 216 202 268 326],130,5,3560,3.0956521739130434,20.0,40.0
1150,0,1150,[508 350 230 384 236],758,5,3565,3.097306689834926,0.0,0.0
1151,0,1151,[254 394 246 208 250],435,4,3569,3.0980902777777777,0.0,0.0
1152,0,1152,[236 209 219 280 230],916,1,3570,3.096270598438855,0.0,0.0
1153,0,1153,[246 365 240 284 264],276,3,3573,3.0961871750433274,0.0,0.0
1154,0,1154,[218 215 222 384 202],551,4,3577,3.096969696969697,0.0,20.0
1155,0,1155,[246 215 241 227 268],94,4,3581,3.097750865051903,0.0,20.0
1156,0,1156,[508 276 303 220 261],181,1,3582,3.0959377700950736,0.0,0.0
1157,0,1157,[254 239 217 413 508],130,2,3584,3.0949913644214164,0.0,0.0
1158,0,1158,[216 220 232 244 508],178,2,3586,3.09404659188956,0.0,20.0
1159,0,1159,[218 268 226 298 216],532,5,3591,3.095689655172414,0.0,60.0
1160,0,1160,[420 268 215 283 507],303,4,3595,3.0964685615848406,0.0,20.0
1161,0,1161,[241 298 284 275 283],429,2,3597,3.09552495697074,0.0,20.0
1162,0,1162,[247 431 216 268 413],222,3,3600,3.095442820292347,0.0,40.0
1163,0,1163,[231 201 239 216 227],201,3,3603,3.095360824742268,0.0,20.0
1164,0,1164,[261 276 284 326 367],130,4,3607,3.096137339055794,0.0,0.0
1165,0,1165,[300 293 230 201 315],276,5,3612,3.097770154373928,20.0,20.0
1166,0,1166,[219 232 284 226 268],201,2,3614,3.0968294772922023,0.0,20.0
1167,0,1167,[226 298 232 293 378],682,2,3616,3.095890410958904,0.0,20.0
1168,0,1168,[202 365 392 431 217],429,2,3618,3.0949529512403764,0.0,0.0
1169,0,1169,[222 481 583 216 367],429,2,3620,3.094017094017094,0.0,40.0
1170,0,1170,[227 201 259 298 208],660,2,3622,3.093082835183604,0.0,20.0
1171,0,1171,[293 255 239 218 431],682,2,3624,3.092150170648464,0.0,0.0
1172,0,1172,[276 222 202 218 284],178,3,3627,3.0920716112531967,0.0,20.0
1173,0,1173,[392 231 240 508 324],276,3,3630,3.0919931856899487,0.0,0.0
1174,0,1174,[222 226 202 261 326],130,5,3635,3.0936170212765957,0.0,20.0
1175,0,1175,[291 202 295 231 276],130,3,3638,3.0935374149659864,0.0,0.0
1176,0,1176,[201 219 206 239 212],1,3,3641,3.0934579439252334,0.0,0.0
1177,0,1177,[336 326 221 240 300],181,0,3641,3.090831918505942,0.0,20.0
1178,0,1178,[276 299 272 243 240],880,4,3645,3.0916030534351147,20.0,0.0
1179,0,1179,[284 217 218 272 202],551,4,3649,3.0923728813559324,20.0,0.0
1180,0,1180,[240 223 232 227 261],222,2,3651,3.0914479254868756,20.0,0.0
1181,0,1181,[212 420 211 290 227],758,4,3655,3.0922165820642977,0.0,0.0
1182,0,1182,[230 291 284 299 206],896,2,3657,3.091293322062553,0.0,0.0
1183,0,1183,[485 297 230 283 250],293,1,3658,3.089527027027027,0.0,0.0
1184,0,1184,[276 429 206 300 230],276,5,3663,3.091139240506329,0.0,20.0
1185,0,1185,[300 293 316 206 290],293,2,3665,3.090219224283305,20.0,20.0
1186,0,1186,[239 367 215 507 246],327,4,3669,3.0909856781802865,0.0,0.0
1187,0,1187,[218 230 413 331 201],435,2,3671,3.09006734006734,0.0,0.0
1188,0,1188,[221 293 303 384 509],758,3,3674,3.0899915895710683,0.0,0.0
1189,0,1189,[209 226 295 240 202],880,4,3678,3.0907563025210085,0.0,0.0
1190,0,1190,[219 226 303 268 508],276,5,3683,3.0923593618807725,0.0,20.0
1191,0,1191,[392 365 223 413 222],109,3,3686,3.0922818791946307,20.0,20.0
1192,0,1192,[227 223 367 219 231],222,2,3688,3.0913663034367143,20.0,0.0
1193,0,1193,[280 239 241 300 209],222,3,3691,3.091289782244556,0.0,20.0
1194,0,1194,[284 276 211 431 283],429,3,3694,3.091213389121339,0.0,0.0
1195,0,1195,[222 250 259 223 291],682,2,3696,3.0903010033444818,20.0,20.0
1196,0,1196,[350 221 236 509 239],758,3,3699,3.0902255639097747,0.0,0.0
1197,0,1197,[367 223 222 303 215],276,4,3703,3.0909849749582636,20.0,20.0
1198,0,1198,[275 321 217 481 209],429,2,3705,3.0900750625521267,0.0,0.0
1199,0,1199,[300 215 239 216 206],521,2,3707,3.089166666666667,0.0,40.0
1200,0,1200,[250 367 275 324 583],327,2,3709,3.0882597835137386,0.0,0.0
1201,0,1201,[300 222 583 508 298],276,4,3713,3.089018302828619,0.0,60.0
1202,0,1202,[420 300 223 303 315],293,3,3716,3.088944305901912,40.0,20.0
1203,0,1203,[227 206 218 239 202],868,1,3717,3.0872093023255816,0.0,0.0
1204,0,1204,[250 452 216 508 231],222,1,3718,3.0854771784232367,0.0,20.0
1205,0,1205,[217 215 240 272 298],286,2,3720,3.084577114427861,20.0,20.0
1206,0,1206,[240 298 227 236 583],303,2,3722,3.0836785418392707,0.0,20.0
1207,0,1207,[280 272 215 316 300],551,4,3726,3.084437086092715,40.0,20.0
1208,0,1208,[222 300 239 219 232],896,2,3728,3.08354011579818,0.0,40.0
1209,0,1209,[284 431 216 413 384],435,0,3728,3.0809917355371903,0.0,20.0
1210,0,1210,[250 384 202 583 431],276,2,3730,3.0800990916597852,0.0,0.0
1211,0,1211,[390 291 240 284 215],303,2,3732,3.0792079207920793,0.0,0.0
1212,0,1212,[222 220 244 316 293],178,3,3735,3.0791426215993405,20.0,20.0
1213,0,1213,[272 217 246 201 298],276,5,3740,3.080724876441516,20.0,20.0
1214,0,1214,[232 431 508 300 255],327,1,3741,3.079012345679012,0.0,20.0
1215,0,1215,[201 239 202 223 290],303,4,3745,3.0797697368421053,20.0,0.0
1216,0,1216,[259 315 246 303 508],592,4,3749,3.0805258833196385,20.0,0.0
1217,0,1217,[268 280 223 226 222],347,5,3754,3.0821018062397374,20.0,40.0
1218,0,1218,[259 268 227 378 431],790,1,3755,3.0803937653814604,0.0,20.0
1219,0,1219,[509 255 243 293 276],682,1,3756,3.078688524590164,0.0,0.0
1220,0,1220,[280 227 272 259 206],393,4,3760,3.0794430794430796,20.0,0.0
1221,0,1221,[254 509 250 211 239],682,2,3762,3.078559738134206,0.0,0.0
1222,0,1222,[223 251 367 283 429],293,3,3765,3.078495502861815,20.0,0.0
1223,0,1223,[324 284 223 326 283],303,2,3767,3.0776143790849675,20.0,0.0
1224,0,1224,[315 367 267 217 272],130,4,3771,3.0783673469387756,40.0,0.0
1225,0,1225,[331 217 240 431 303],758,2,3773,3.0774877650897228,0.0,0.0
1226,0,1226,[300 291 227 431 226],429,2,3775,3.0766096169519153,0.0,20.0
1227,0,1227,[206 268 213 250 290],916,3,3778,3.076547231270358,0.0,20.0
1228,0,1228,[299 300 230 215 231],896,2,3780,3.0756712774613506,0.0,20.0
1229,0,1229,[240 246 264 420 239],435,3,3783,3.075609756097561,0.0,0.0
1230,0,1230,[255 261 246 350 206],130,4,3787,3.076360682372055,0.0,0.0
1231,0,1231,[326 221 268 321 508],201,2,3789,3.075487012987013,0.0,20.0
1232,0,1232,[254 208 392 211 206],435,3,3792,3.0754257907542577,0.0,0.0
1233,0,1233,[239 217 218 276 209],222,4,3796,3.0761750405186388,0.0,0.0
1234,0,1234,[413 226 231 326 218],303,3,3799,3.0761133603238866,0.0,0.0
1235,0,1235,[283 239 202 297 280],293,1,3800,3.074433656957929,0.0,0.0
1236,0,1236,[226 508 284 201 259],303,4,3804,3.0751818916734033,0.0,0.0
1237,0,1237,[298 240 221 324 251],303,3,3807,3.0751211631663975,0.0,20.0
1238,0,1238,[223 280 276 208 227],347,3,3810,3.0750605326876514,20.0,0.0
1239,0,1239,[218 316 284 300 299],880,4,3814,3.075806451612903,20.0,20.0
1240,0,1240,[290 293 223 217 291],276,4,3818,3.0765511684125704,20.0,0.0
1241,0,1241,[367 222 251 413 241],303,3,3821,3.076489533011272,0.0,20.0
1242,0,1242,[365 247 217 222 367],222,2,3823,3.075623491552695,0.0,20.0
1243,0,1243,[295 221 202 344 251],592,5,3828,3.077170418006431,0.0,0.0
1244,0,1244,[293 298 218 202 206],487,4,3832,3.077911646586345,0.0,20.0
1245,0,1245,[222 272 243 300 241],682,3,3835,3.07784911717496,20.0,40.0
1246,0,1246,[209 291 315 227 218],551,5,3840,3.0793905372894947,20.0,0.0
1247,0,1247,[316 250 297 300 301],758,3,3843,3.079326923076923,20.0,20.0
1248,0,1248,[255 254 240 219 226],435,2,3845,3.078462770216173,0.0,0.0
1249,0,1249,[211 201 216 222 268],682,5,3850,3.08,0.0,60.0
1250,0,1250,[290 300 452 226 251],303,3,3853,3.0799360511590725,0.0,20.0
1251,0,1251,[303 217 230 223 240],276,5,3858,3.0814696485623,20.0,0.0
1252,0,1252,[232 290 236 326 209],303,4,3862,3.0822027134876295,0.0,0.0
1253,0,1253,[239 298 226 413 201],276,4,3866,3.082934609250399,0.0,20.0
1254,0,1254,[295 301 240 230 367],880,4,3870,3.0836653386454183,0.0,0.0
1255,0,1255,[241 290 413 239 206],276,4,3874,3.0843949044585988,0.0,0.0
1256,0,1256,[246 298 276 272 301],276,5,3879,3.0859188544152745,20.0,20.0
1257,0,1257,[206 452 384 268 420],276,3,3882,3.0858505564387917,0.0,20.0
1258,0,1258,[291 303 324 284 240],181,0,3882,3.0833995234312948,0.0,0.0
1259,0,1259,[280 315 223 219 264],551,3,3885,3.0833333333333335,40.0,0.0
1260,0,1260,[222 206 209 420 246],94,4,3889,3.08406026962728,0.0,20.0
1261,0,1261,[250 209 208 202 241],758,4,3893,3.0847860538827256,0.0,0.0
1262,0,1262,[316 226 222 254 508],276,4,3897,3.0855106888361044,20.0,20.0
1263,0,1263,[301 290 215 240 365],244,1,3898,3.0838607594936707,0.0,0.0
1264,0,1264,[280 293 378 241 255],222,0,3898,3.0814229249011857,0.0,0.0
1265,0,1265,[268 236 452 420 240],303,3,3901,3.081358609794629,0.0,20.0
1266,0,1266,[283 272 264 255 208],293,1,3902,3.0797158642462508,20.0,0.0
1267,0,1267,[509 284 218 268 431],551,5,3907,3.081230283911672,0.0,20.0
1268,0,1268,[202 239 246 255 244],1,3,3910,3.081166272655634,0.0,0.0
1269,0,1269,[350 239 293 298 331],130,4,3914,3.0818897637795275,0.0,20.0
1270,0,1270,[452 367 254 276 295],130,3,3917,3.0818253343823763,0.0,0.0
1271,0,1271,[331 230 272 268 222],551,5,3922,3.0833333333333335,20.0,40.0
1272,0,1272,[216 226 280 431 212],916,2,3924,3.082482325216025,0.0,20.0
1273,0,1273,[316 217 276 268 315],276,5,3929,3.083987441130298,40.0,20.0
1274,0,1274,[202 221 222 300 239],303,2,3931,3.0831372549019607,0.0,40.0
1275,0,1275,[280 509 202 299 232],682,2,3933,3.0822884012539187,0.0,0.0
1276,0,1276,[216 420 508 390 218],94,3,3936,3.082223962411903,0.0,20.0
1277,0,1277,[324 280 298 284 268],697,4,3940,3.082942097026604,0.0,40.0
1278,0,1278,[227 392 420 215 378],393,4,3944,3.0836591086786553,0.0,0.0
1279,0,1279,[251 202 259 243 293],592,3,3947,3.08359375,0.0,0.0
1280,0,1280,[331 298 232 254 303],276,3,3950,3.083528493364559,0.0,20.0
1281,0,1281,[241 509 291 324 222],244,3,3953,3.0834633385335413,0.0,20.0
1282,0,1282,[218 413 583 301 222],276,3,3956,3.083398285268901,0.0,20.0
1283,0,1283,[241 321 583 259 222],303,1,3957,3.0817757009345796,0.0,20.0
1284,0,1284,[230 250 284 227 236],246,3,3960,3.0817120622568095,0.0,0.0
1285,0,1285,[324 231 213 326 452],201,2,3962,3.0808709175738724,0.0,0.0
1286,0,1286,[223 246 255 276 431],178,4,3966,3.0815850815850814,20.0,0.0
1287,0,1287,[264 244 212 254 208],1,2,3968,3.080745341614907,0.0,0.0
1288,0,1288,[259 326 413 219 216],303,2,3970,3.0799069045771916,0.0,20.0
1289,0,1289,[583 392 508 215 201],94,3,3973,3.07984496124031,0.0,0.0
1290,0,1290,[226 255 290 217 299],435,3,3976,3.0797831138652207,0.0,0.0
1291,0,1291,[201 231 259 284 219],727,2,3978,3.0789473684210527,0.0,0.0
1292,0,1292,[202 240 221 212 208],1,4,3982,3.079659706109822,0.0,0.0
1293,0,1293,[223 250 284 244 226],916,3,3985,3.079598145285935,20.0,0.0
1294,0,1294,[272 452 431 508 213],201,2,3987,3.078764478764479,20.0,0.0
1295,0,1295,[300 452 324 227 230],276,4,3991,3.0794753086419755,0.0,20.0
1296,0,1296,[344 246 202 230 268],327,5,3996,3.0809560524286814,0.0,20.0
1297,0,1297,[243 298 321 300 272],130,4,4000,3.0816640986132513,20.0,40.0
1298,0,1298,[250 231 326 218 241],303,4,4004,3.082371054657429,0.0,0.0
1299,0,1299,[215 216 202 290 217],916,2,4006,3.0815384615384613,0.0,20.0
1300,0,1300,[452 413 206 315 508],130,3,4009,3.0814757878554957,20.0,0.0
1301,0,1301,[290 324 202 246 300],521,1,4010,3.0798771121351765,0.0,20.0
1302,0,1302,[202 209 241 211 208],790,2,4012,3.079048349961627,0.0,0.0
1303,0,1303,[222 259 293 384 209],303,2,4014,3.0782208588957056,0.0,20.0
1304,0,1304,[215 384 226 272 324],276,4,4018,3.0789272030651342,20.0,0.0
1305,0,1305,[275 201 209 303 315],201,2,4020,3.0781010719754978,20.0,0.0
1306,0,1306,[301 295 316 230 216],532,5,4025,3.0795715378729915,20.0,20.0
1307,0,1307,[429 217 583 291 413],276,2,4027,3.0787461773700304,0.0,0.0
1308,0,1308,[255 583 300 390 384],303,1,4028,3.0771581359816653,0.0,20.0
1309,0,1309,[222 250 321 420 268],130,4,4032,3.0778625954198473,0.0,40.0
1310,0,1310,[240 378 259 275 217],790,2,4034,3.0770404271548437,0.0,0.0
1311,0,1311,[219 223 217 315 241],551,4,4038,3.0777439024390243,40.0,0.0
1312,0,1312,[230 227 429 231 431],896,3,4041,3.077684691546078,0.0,0.0
1313,0,1313,[232 268 509 201 206],201,2,4043,3.0768645357686455,0.0,20.0
1314,0,1314,[211 241 220 201 256],1,2,4045,3.076045627376426,0.0,0.0
1315,0,1315,[431 240 216 291 268],889,3,4048,3.0759878419452886,0.0,40.0
1316,0,1316,[297 221 216 202 303],758,4,4052,3.0766894457099467,0.0,20.0
1317,0,1317,[431 244 226 236 206],916,2,4054,3.0758725341426403,0.0,0.0
1318,0,1318,[240 256 254 222 261],1,2,4056,3.0750568612585294,0.0,20.0
1319,0,1319,[331 255 226 291 267],130,4,4060,3.0757575757575757,0.0,0.0
1320,0,1320,[384 201 298 226 316],363,1,4061,3.0741862225586676,20.0,20.0
1321,0,1321,[239 291 324 230 221],303,1,4062,3.0726172465960664,0.0,0.0
1322,0,1322,[268 284 231 240 583],790,3,4065,3.072562358276644,0.0,20.0
1323,0,1323,[384 243 283 215 298],393,3,4068,3.0725075528700905,0.0,20.0
1324,0,1324,[275 324 240 221 284],201,2,4070,3.0716981132075474,0.0,0.0
1325,0,1325,[206 243 284 331 291],130,1,4071,3.070135746606335,0.0,0.0
1326,0,1326,[508 392 219 227 222],933,0,4071,3.0678221552373777,0.0,20.0
1327,0,1327,[298 420 268 240 367],532,4,4075,3.0685240963855422,0.0,40.0
1328,0,1328,[211 231 239 367 378],682,1,4076,3.066967644845749,0.0,0.0
1329,0,1329,[240 208 251 268 384],303,3,4079,3.066917293233083,0.0,20.0
1330,0,1330,[208 291 508 509 316],758,5,4084,3.0683696468820436,20.0,0.0
1331,0,1331,[299 240 276 508 291],130,4,4088,3.069069069069069,0.0,0.0
1332,0,1332,[300 232 215 268 272],682,3,4091,3.0690172543135783,20.0,40.0
1333,0,1333,[413 300 284 293 250],303,3,4094,3.0689655172413794,0.0,20.0
1334,0,1334,[223 239 236 211 268],916,4,4098,3.0696629213483146,20.0,20.0
1335,0,1335,[217 301 232 324 259],425,1,4099,3.06811377245509,0.0,0.0
1336,0,1336,[485 303 298 206 316],393,3,4102,3.068062827225131,20.0,20.0
1337,0,1337,[216 316 293 227 507],293,3,4105,3.0680119581464873,20.0,20.0
1338,0,1338,[384 298 230 293 250],880,2,4107,3.0672143390589994,0.0,20.0
1339,0,1339,[367 420 226 208 291],303,4,4111,3.067910447761194,0.0,0.0
1340,0,1340,[481 264 244 283 300],299,1,4112,3.0663683818046232,0.0,20.0
1341,0,1341,[246 216 239 250 219],222,4,4116,3.067064083457526,0.0,20.0
1342,0,1342,[231 284 290 301 212],363,0,4116,3.0647803425167535,0.0,0.0
1343,0,1343,[227 239 209 231 202],880,2,4118,3.0639880952380953,0.0,0.0
1344,0,1344,[280 316 240 217 276],551,2,4120,3.063197026022305,20.0,0.0
1345,0,1345,[222 485 208 481 508],299,3,4123,3.0631500742942053,0.0,20.0
1346,0,1346,[209 227 452 324 272],758,4,4127,3.0638455827765405,20.0,0.0
1347,0,1347,[431 280 217 507 283],429,2,4129,3.0630563798219583,0.0,0.0
1348,0,1348,[293 232 240 209 246],682,3,4132,3.063009636767976,0.0,0.0
1349,0,1349,[208 231 367 232 216],846,3,4135,3.062962962962963,0.0,20.0
1350,0,1350,[284 230 218 331 508],551,5,4140,3.0643967431532197,0.0,0.0
1351,0,1351,[326 246 240 222 367],130,5,4145,3.065828402366864,0.0,20.0
1352,0,1352,[223 452 216 209 429],896,3,4148,3.065779748706578,20.0,20.0
1353,0,1353,[324 326 223 221 231],303,3,4151,3.0657311669128506,20.0,0.0
1354,0,1354,[284 365 211 326 230],551,5,4156,3.067158671586716,0.0,0.0
1355,0,1355,[283 316 301 290 232],363,0,4156,3.0648967551622417,20.0,0.0
1356,0,1356,[365 290 209 202 211],682,2,4158,3.064112011790715,0.0,0.0
1357,0,1357,[232 583 226 420 367],94,2,4160,3.0633284241531666,0.0,0.0
1358,0,1358,[268 508 331 303 298],919,3,4163,3.063281824871229,0.0,40.0
1359,0,1359,[254 300 259 218 219],682,0,4163,3.061029411764706,0.0,20.0
1360,0,1360,[301 259 324 336 316],863,3,4166,3.0609845701689933,20.0,0.0
1361,0,1361,[230 211 367 280 283],429,1,4167,3.0594713656387666,0.0,0.0
1362,0,1362,[208 264 223 268 209],303,4,4171,3.0601614086573736,20.0,20.0
1363,0,1363,[209 507 264 239 276],303,3,4174,3.060117302052786,0.0,0.0
1364,0,1364,[268 222 301 264 250],592,2,4176,3.059340659340659,0.0,40.0
1365,0,1365,[303 583 232 201 231],276,2,4178,3.0585651537335283,0.0,0.0
1366,0,1366,[367 331 222 226 209],276,4,4182,3.0592538405267007,0.0,20.0
1367,0,1367,[384 230 226 300 239],276,4,4186,3.059941520467836,0.0,20.0
1368,0,1368,[300 240 206 250 420],276,5,4191,3.0613586559532506,0.0,20.0
1369,0,1369,[326 223 275 298 268],919,2,4193,3.0605839416058394,20.0,40.0
1370,0,1370,[284 240 201 384 227],246,2,4195,3.059810357403355,0.0,0.0
1371,0,1371,[217 251 300 230 367],293,1,4196,3.058309037900875,0.0,20.0
1372,0,1372,[268 232 431 507 344],327,4,4200,3.058994901675164,0.0,20.0
1373,0,1373,[378 284 392 202 367],429,1,4201,3.057496360989811,0.0,0.0
1374,0,1374,[392 227 413 215 216],222,3,4204,3.0574545454545454,0.0,20.0
1375,0,1375,[202 254 250 583 241],682,3,4207,3.0574127906976742,0.0,0.0
1376,0,1376,[259 236 301 293 201],592,2,4209,3.056644880174292,0.0,0.0
1377,0,1377,[284 508 219 209 431],178,4,4213,3.0573294629898404,0.0,0.0
1378,0,1378,[298 344 243 295 201],592,4,4217,3.0580130529369107,0.0,20.0
1379,0,1379,[298 264 206 218 284],435,2,4219,3.057246376811594,0.0,20.0
1380,0,1380,[216 413 478 232 208],495,5,4224,3.058653149891383,20.0,20.0
1381,0,1381,[293 452 217 216 508],222,1,4225,3.0571635311143273,0.0,20.0
1382,0,1382,[316 202 365 367 291],276,2,4227,3.056399132321041,20.0,0.0
1383,0,1383,[392 208 508 291 222],347,2,4229,3.055635838150289,0.0,20.0
1384,0,1384,[283 223 264 303 431],592,3,4232,3.055595667870036,20.0,0.0
1385,0,1385,[227 219 209 239 284],276,5,4237,3.056998556998557,0.0,0.0
1386,0,1386,[241 236 217 227 244],1,3,4240,3.056957462148522,0.0,0.0
1387,0,1387,[243 420 299 232 254],682,1,4241,3.0554755043227666,0.0,0.0
1388,0,1388,[276 254 272 508 583],276,3,4244,3.0554355651547875,20.0,0.0
1389,0,1389,[264 295 261 250 259],592,2,4246,3.0546762589928056,0.0,0.0
1390,0,1390,[508 316 276 272 240],276,5,4251,3.05607476635514,40.0,0.0
1391,0,1391,[583 211 222 378 300],682,2,4253,3.055316091954023,0.0,40.0
1392,0,1392,[508 290 365 209 222],429,3,4256,3.0552763819095476,0.0,20.0
1393,0,1393,[209 293 250 219 255],222,2,4258,3.054519368723099,0.0,0.0
1394,0,1394,[256 250 208 218 216],1,4,4262,3.0551971326164873,0.0,20.0
1395,0,1395,[431 268 240 509 298],889,3,4265,3.055157593123209,0.0,40.0
1396,0,1396,[384 227 218 268 324],551,3,4268,3.0551181102362204,0.0,20.0
1397,0,1397,[316 394 254 268 300],880,2,4270,3.0543633762517883,20.0,40.0
1398,0,1398,[219 240 206 250 222],435,3,4273,3.054324517512509,0.0,20.0
1399,0,1399,[223 215 384 216 226],303,4,4277,3.055,20.0,20.0
1400,0,1400,[300 226 251 316 216],532,5,4282,3.0563882940756604,20.0,40.0
1401,0,1401,[218 295 276 232 293],880,5,4287,3.0577746077032812,0.0,0.0
1402,0,1402,[290 293 206 268 431],276,4,4291,3.058446186742694,0.0,20.0
1403,0,1403,[276 223 216 284 202],916,3,4294,3.0584045584045585,20.0,20.0
1404,0,1404,[216 384 367 240 250],301,5,4299,3.0597864768683274,0.0,20.0
1405,0,1405,[316 230 250 220 367],178,4,4303,3.0604551920341394,20.0,0.0
1406,0,1406,[202 231 217 211 215],823,3,4306,3.060412224591329,0.0,0.0
1407,0,1407,[206 508 226 367 326],130,4,4310,3.0610795454545454,0.0,0.0
1408,0,1408,[264 268 420 367 290],435,2,4312,3.0603264726756563,0.0,20.0
1409,0,1409,[209 509 232 215 367],94,4,4316,3.0609929078014186,0.0,0.0
1410,0,1410,[429 226 217 420 508],896,2,4318,3.0602409638554215,0.0,0.0
1411,0,1411,[226 509 222 324 264],551,3,4321,3.060198300283286,0.0,20.0
1412,0,1412,[218 283 326 241 264],303,2,4323,3.059447983014862,0.0,0.0
1413,0,1413,[268 301 250 216 219],327,2,4325,3.0586987270155586,0.0,40.0
1414,0,1414,[267 272 247 264 215],1,1,4326,3.057243816254417,20.0,0.0
1415,0,1415,[231 201 219 413 246],303,4,4330,3.0579096045197742,0.0,0.0
1416,0,1416,[211 219 202 284 216],435,3,4333,3.0578687367678192,0.0,20.0
1417,0,1417,[222 384 239 431 264],399,0,4333,3.0557122708039492,0.0,20.0
1418,0,1418,[226 231 413 392 365],276,1,4334,3.054263565891473,0.0,0.0
1419,0,1419,[331 326 261 230 222],130,3,4337,3.054225352112676,0.0,20.0
1420,0,1420,[392 280 291 219 365],429,2,4339,3.0534834623504574,0.0,0.0
1421,0,1421,[221 241 230 272 239],201,0,4339,3.051336146272855,20.0,0.0
1422,0,1422,[231 217 202 268 232],846,3,4342,3.0513000702740687,0.0,20.0
1423,0,1423,[255 236 211 251 227],1,3,4345,3.0512640449438204,0.0,0.0
1424,0,1424,[236 583 298 239 241],303,3,4348,3.0512280701754384,0.0,20.0
1425,0,1425,[236 300 251 291 230],303,2,4350,3.050490883590463,0.0,20.0
1426,0,1426,[298 293 264 303 275],293,3,4353,3.0504555010511565,0.0,20.0
1427,0,1427,[303 276 239 241 240],276,5,4358,3.0518207282913163,0.0,0.0
1428,0,1428,[350 227 209 211 202],758,5,4363,3.053184044786564,0.0,0.0
1429,0,1429,[291 219 413 231 251],303,3,4366,3.053146853146853,0.0,0.0
1430,0,1430,[300 431 420 206 218],276,4,4370,3.0538085255066387,0.0,20.0
1431,0,1431,[213 211 232 251 254],1,1,4371,3.0523743016759775,0.0,0.0
1432,0,1432,[227 230 218 241 219],222,3,4374,3.052337752965806,0.0,0.0
1433,0,1433,[212 378 202 509 219],846,5,4379,3.0536959553695957,0.0,0.0
1434,0,1434,[272 226 208 209 218],293,1,4380,3.052264808362369,20.0,0.0
1435,0,1435,[255 367 420 240 299],682,2,4382,3.051532033426184,0.0,0.0
1436,0,1436,[336 250 272 215 331],592,3,4385,3.0514961725817678,20.0,0.0
1437,0,1437,[240 226 236 284 222],303,3,4388,3.0514603616133518,0.0,20.0
1438,0,1438,[223 215 583 508 276],551,4,4392,3.052119527449618,20.0,0.0
1439,0,1439,[240 206 226 244 209],1,2,4394,3.051388888888889,0.0,0.0
1440,0,1440,[222 230 215 507 276],561,2,4396,3.0506592643997226,0.0,20.0
1441,0,1441,[231 209 429 509 301],747,2,4398,3.0499306518723994,0.0,0.0
1442,0,1442,[250 583 290 223 268],682,2,4400,3.049203049203049,20.0,20.0
1443,0,1443,[303 246 201 367 452],276,3,4403,3.049168975069252,0.0,0.0
1444,0,1444,[226 300 222 452 215],303,2,4405,3.0484429065743943,0.0,40.0
1445,0,1445,[303 300 259 213 298],299,3,4408,3.048409405255878,0.0,40.0
1446,0,1446,[206 254 255 326 413],130,2,4410,3.0476848652384243,0.0,0.0
1447,0,1447,[255 241 243 485 240],393,3,4413,3.0476519337016574,0.0,0.0
1448,0,1448,[227 246 290 259 384],268,2,4415,3.0469289164941338,0.0,0.0
1449,0,1449,[201 365 316 246 268],880,4,4419,3.047586206896552,20.0,20.0
1450,0,1450,[301 298 583 202 219],276,4,4423,3.0482425913163333,0.0,20.0
1451,0,1451,[485 507 250 316 217],293,1,4424,3.046831955922865,20.0,0.0
1452,0,1452,[208 232 291 276 284],429,4,4428,3.0474879559532004,0.0,0.0
1453,0,1453,[211 275 201 303 206],201,2,4430,3.046767537826685,0.0,0.0
1454,0,1454,[344 259 261 297 215],592,3,4433,3.0467353951890033,0.0,0.0
1455,0,1455,[218 301 223 227 350],363,2,4435,3.0460164835164836,20.0,0.0
1456,0,1456,[239 240 208 201 206],727,3,4438,3.0459849004804394,0.0,0.0
1457,0,1457,[250 239 209 255 216],682,2,4440,3.045267489711934,0.0,20.0
1458,0,1458,[261 299 301 236 336],592,0,4440,3.0431802604523646,0.0,0.0
1459,0,1459,[291 316 272 290 202],276,4,4444,3.043835616438356,40.0,0.0
1460,0,1460,[219 209 508 392 384],933,0,4444,3.0417522245037647,0.0,0.0
1461,0,1461,[254 208 420 291 215],435,3,4447,3.0417236662106704,0.0,0.0
1462,0,1462,[481 222 276 344 223],758,3,4450,3.041695146958305,20.0,20.0
1463,0,1463,[232 300 247 268 298],222,4,4454,3.0423497267759565,0.0,60.0
1464,0,1464,[217 226 431 298 209],327,1,4455,3.0409556313993176,0.0,20.0
1465,0,1465,[243 267 246 255 226],130,4,4459,3.0416098226466577,0.0,0.0
1466,0,1466,[239 284 211 213 230],293,1,4460,3.0402181322426722,0.0,0.0
1467,0,1467,[226 420 291 413 293],303,3,4463,3.040190735694823,0.0,0.0
1468,0,1468,[509 206 230 227 219],201,2,4465,3.039482641252553,0.0,0.0
1469,0,1469,[365 250 226 283 378],790,2,4467,3.0387755102040814,0.0,0.0
1470,0,1470,[208 324 223 209 236],758,5,4472,3.0401087695445277,20.0,0.0
1471,0,1471,[394 298 485 241 223],393,4,4476,3.0407608695652173,20.0,20.0
1472,0,1472,[508 222 250 202 231],407,4,4480,3.0414120841819416,0.0,20.0
1473,0,1473,[291 367 264 240 321],303,1,4481,3.0400271370420624,0.0,0.0
1474,0,1474,[226 583 239 254 219],276,3,4484,3.04,0.0,0.0
1475,0,1475,[509 221 298 240 452],758,2,4486,3.0392953929539295,0.0,20.0
1476,0,1476,[261 206 209 219 222],1,3,4489,3.039268788083954,0.0,20.0
1477,0,1477,[276 303 509 272 202],201,1,4490,3.037889039242219,20.0,0.0
1478,0,1478,[223 452 240 431 509],758,2,4492,3.0371872887085867,20.0,0.0
1479,0,1479,[300 297 303 259 272],919,5,4497,3.0385135135135135,20.0,20.0
1480,0,1480,[223 283 275 222 485],429,3,4500,3.038487508440243,20.0,20.0
1481,0,1481,[246 268 367 217 321],919,2,4502,3.03778677462888,0.0,20.0
1482,0,1482,[217 367 268 250 202],286,4,4506,3.038435603506406,0.0,20.0
1483,0,1483,[243 344 221 261 251],592,3,4509,3.038409703504043,0.0,0.0
1484,0,1484,[240 324 226 218 507],303,3,4512,3.0383838383838384,0.0,0.0
1485,0,1485,[250 300 413 264 254],435,1,4513,3.0370121130551815,0.0,20.0
1486,0,1486,[509 250 206 209 295],916,2,4515,3.036314727639543,0.0,0.0
1487,0,1487,[413 226 284 331 298],435,3,4518,3.036290322580645,0.0,20.0
1488,0,1488,[508 429 246 240 227],276,5,4523,3.037609133646743,0.0,0.0
1489,0,1489,[485 216 284 250 300],293,1,4524,3.036241610738255,0.0,40.0
1490,0,1490,[507 216 321 413 293],303,3,4527,3.0362173038229376,0.0,20.0
1491,0,1491,[268 254 261 231 267],1,2,4529,3.035522788203753,0.0,20.0
1492,0,1492,[241 280 209 300 365],551,4,4533,3.0361687876758205,0.0,20.0
1493,0,1493,[230 209 331 211 508],758,5,4538,3.037483266398929,0.0,0.0
1494,0,1494,[230 215 201 261 206],1,2,4540,3.036789297658863,0.0,0.0
1495,0,1495,[213 255 215 226 209],1,1,4541,3.035427807486631,0.0,0.0
1496,0,1496,[230 509 295 227 232],916,1,4542,3.0340681362725452,0.0,0.0
1497,0,1497,[350 284 431 283 226],363,0,4542,3.0320427236315086,0.0,0.0
1498,0,1498,[508 221 201 321 276],919,4,4546,3.0326884589726486,0.0,0.0
1499,0,1499,[321 324 508 259 413],303,1,4547,3.0313333333333334,0.0,0.0
1500,0,1500,[227 231 243 247 213],1,1,4548,3.0299800133244505,0.0,0.0
1501,0,1501,[384 218 243 280 420],682,0,4548,3.0279627163781626,0.0,0.0
1502,0,1502,[280 384 223 316 202],393,3,4551,3.027944111776447,40.0,0.0
1503,0,1503,[240 268 232 222 215],790,2,4553,3.0272606382978724,0.0,40.0
1504,0,1504,[215 276 250 275 202],500,3,4556,3.0272425249169435,0.0,0.0
1505,0,1505,[202 298 276 303 268],919,2,4558,3.0265604249667994,0.0,40.0
1506,0,1506,[300 255 246 202 280],682,2,4560,3.0258792302587922,0.0,20.0
1507,0,1507,[230 215 268 240 222],130,4,4564,3.026525198938992,0.0,40.0
1508,0,1508,[202 316 226 227 268],880,4,4568,3.027170311464546,20.0,20.0
1509,0,1509,[452 218 202 208 390],303,3,4571,3.0271523178807946,0.0,0.0
1510,0,1510,[215 211 230 509 226],201,0,4571,3.025148908007942,0.0,0.0
1511,0,1511,[315 241 240 268 215],201,1,4572,3.0238095238095237,20.0,20.0
1512,0,1512,[284 206 254 216 321],435,1,4573,3.0224719101123596,0.0,20.0
1513,0,1513,[219 284 298 301 217],276,5,4578,3.023778071334214,0.0,20.0
1514,0,1514,[315 431 429 231 230],276,3,4581,3.023762376237624,20.0,0.0
1515,0,1515,[452 509 206 213 219],201,2,4583,3.0230870712401057,0.0,0.0
1516,0,1516,[429 222 217 280 507],293,2,4585,3.022412656558998,0.0,20.0
1517,0,1517,[232 365 420 367 215],94,3,4588,3.0223978919631094,0.0,0.0
1518,0,1518,[272 316 291 243 261],130,4,4592,3.0230414746543777,40.0,0.0
1519,0,1519,[275 291 298 420 293],293,3,4595,3.023026315789474,0.0,20.0
1520,0,1520,[344 295 303 367 350],592,5,4600,3.0243261012491782,0.0,0.0
1521,0,1521,[217 268 218 239 272],1,2,4602,3.02365308804205,20.0,20.0
1522,0,1522,[509 232 268 213 284],201,2,4604,3.0229809586342746,0.0,20.0
1523,0,1523,[231 226 384 390 583],303,2,4606,3.022309711286089,0.0,0.0
1524,0,1524,[217 316 240 293 268],880,5,4611,3.023606557377049,20.0,20.0
1525,0,1525,[583 255 216 507 226],303,4,4615,3.024246395806029,0.0,20.0
1526,0,1526,[413 284 240 293 321],303,2,4617,3.0235756385068764,0.0,0.0
1527,0,1527,[211 392 208 222 240],727,3,4620,3.0235602094240837,0.0,20.0
1528,0,1528,[202 226 280 215 201],216,2,4622,3.022890778286462,0.0,0.0
1529,0,1529,[217 239 413 254 295],130,1,4623,3.0215686274509803,0.0,0.0
1530,0,1530,[231 291 293 268 250],303,4,4627,3.022207707380797,0.0,20.0
1531,0,1531,[216 218 384 241 232],303,4,4631,3.022845953002611,0.0,20.0
1532,0,1532,[268 251 413 240 250],303,3,4634,3.0228310502283104,0.0,20.0
1533,0,1533,[227 231 222 431 201],22,4,4638,3.0234680573663626,0.0,20.0
1534,0,1534,[213 202 211 236 218],916,3,4641,3.0234527687296415,0.0,0.0
1535,0,1535,[276 452 227 272 331],201,3,4644,3.0234375,20.0,0.0
1536,0,1536,[217 264 223 290 251],293,2,4646,3.022771633051399,20.0,0.0
1537,0,1537,[280 250 256 227 209],916,1,4647,3.0214564369310795,0.0,0.0
1538,0,1538,[227 290 350 226 256],363,1,4648,3.020142949967511,0.0,0.0
1539,0,1539,[452 236 331 217 246],130,3,4651,3.02012987012987,0.0,0.0
1540,0,1540,[336 276 222 284 283],181,1,4652,3.018818948734588,0.0,20.0
1541,0,1541,[293 508 230 298 226],303,4,4656,3.019455252918288,0.0,20.0
1542,0,1542,[291 316 365 202 315],551,5,4661,3.0207388204795853,40.0,0.0
1543,0,1543,[254 485 202 208 230],660,1,4662,3.0194300518134716,0.0,0.0
1544,0,1544,[290 217 272 280 336],286,3,4665,3.0194174757281553,20.0,0.0
1545,0,1545,[222 275 220 284 215],178,4,4669,3.020051746442432,0.0,20.0
1546,0,1546,[290 367 429 298 365],276,3,4672,3.020038784744667,0.0,20.0
1547,0,1547,[221 239 220 256 264],1,3,4675,3.0200258397932815,0.0,0.0
1548,0,1548,[276 303 290 365 217],276,4,4679,3.020658489347966,0.0,0.0
1549,0,1549,[255 283 284 431 230],178,5,4684,3.0219354838709678,0.0,0.0
1550,0,1550,[216 276 315 293 331],130,4,4688,3.0225660863958734,20.0,20.0
1551,0,1551,[208 420 255 251 452],303,4,4692,3.0231958762886597,0.0,0.0
1552,0,1552,[244 212 222 202 236],916,3,4695,3.0231809401159047,0.0,20.0
1553,0,1553,[219 276 254 291 293],276,3,4698,3.023166023166023,0.0,0.0
1554,0,1554,[299 219 413 202 350],130,3,4701,3.023151125401929,0.0,0.0
1555,0,1555,[413 291 272 367 315],130,4,4705,3.0237789203084833,40.0,0.0
1556,0,1556,[218 232 201 246 226],94,2,4707,3.023121387283237,0.0,0.0
1557,0,1557,[507 303 283 284 239],293,2,4709,3.022464698331194,0.0,0.0
1558,0,1558,[508 268 219 217 206],94,5,4714,3.023733162283515,0.0,20.0
1559,0,1559,[394 219 367 206 268],435,4,4718,3.0243589743589743,0.0,20.0
1560,0,1560,[222 240 324 227 298],303,1,4719,3.023062139654068,0.0,40.0
1561,0,1561,[303 272 231 481 297],758,4,4723,3.0236875800256082,20.0,0.0
1562,0,1562,[255 420 254 219 431],435,2,4725,3.0230326295585415,0.0,0.0
1563,0,1563,[291 268 284 261 315],130,4,4729,3.0236572890025575,20.0,20.0
1564,0,1564,[202 246 226 268 232],94,2,4731,3.023003194888179,0.0,20.0
1565,0,1565,[246 300 227 222 299],130,3,4734,3.0229885057471266,0.0,40.0
1566,0,1566,[293 268 231 211 284],682,4,4738,3.0236119974473517,0.0,20.0
1567,0,1567,[215 211 216 255 219],435,2,4740,3.0229591836734695,0.0,20.0
1568,0,1568,[290 291 221 209 230],758,4,4744,3.0235818992989163,0.0,0.0
1569,0,1569,[239 284 226 392 216],347,2,4746,3.0229299363057325,0.0,20.0
1570,0,1570,[284 508 268 250 272],532,4,4750,3.0235518777848505,20.0,20.0
1571,0,1571,[230 239 206 250 219],435,4,4754,3.024173027989822,0.0,0.0
1572,0,1572,[247 251 206 221 216],1,4,4758,3.024793388429752,0.0,20.0
1573,0,1573,[223 367 230 239 246],222,4,4762,3.025412960609911,20.0,0.0
1574,0,1574,[215 222 213 268 326],201,2,4764,3.0247619047619048,0.0,40.0
1575,0,1575,[420 206 222 217 215],293,3,4767,3.024746192893401,0.0,20.0
1576,0,1576,[239 284 217 295 300],130,2,4769,3.0240963855421685,0.0,20.0
1577,0,1577,[291 208 507 367 321],303,3,4772,3.024081115335868,0.0,0.0
1578,0,1578,[508 218 413 291 223],303,3,4775,3.024065864471184,20.0,0.0
1579,0,1579,[227 268 326 259 291],303,1,4776,3.0227848101265824,0.0,20.0
1580,0,1580,[303 227 231 211 202],758,4,4780,3.023402909550917,0.0,0.0
1581,0,1581,[300 211 284 431 384],896,2,4782,3.02275600505689,0.0,20.0
1582,0,1582,[213 250 218 298 481],758,5,4787,3.024005053695515,0.0,20.0
1583,0,1583,[420 429 583 301 508],276,4,4791,3.024621212121212,0.0,0.0
1584,0,1584,[326 284 232 217 268],222,3,4794,3.0246056782334385,0.0,20.0
1585,0,1585,[239 208 431 202 240],222,3,4797,3.0245901639344264,0.0,0.0
1586,0,1586,[365 231 378 219 392],222,3,4800,3.0245746691871456,0.0,0.0
1587,0,1587,[231 452 202 230 241],276,3,4803,3.02455919395466,0.0,0.0
1588,0,1588,[507 231 227 255 291],303,3,4806,3.024543738200126,0.0,0.0
1589,0,1589,[331 241 246 283 215],178,5,4811,3.0257861635220125,0.0,0.0
1590,0,1590,[221 244 216 209 241],916,4,4815,3.0263984915147706,0.0,20.0
1591,0,1591,[264 290 301 254 232],276,2,4817,3.025753768844221,0.0,0.0
1592,0,1592,[215 231 227 259 226],1,1,4818,3.024482109227872,0.0,0.0
1593,0,1593,[255 392 367 218 299],435,1,4819,3.023212045169385,0.0,0.0
1594,0,1594,[420 215 211 226 201],94,4,4823,3.0238244514106585,0.0,0.0
1595,0,1595,[246 420 219 222 267],130,5,4828,3.025062656641604,0.0,20.0
1596,0,1596,[284 244 246 216 219],870,1,4829,3.023794614902943,0.0,20.0
1597,0,1597,[291 303 420 223 202],293,3,4832,3.0237797246558196,20.0,0.0
1598,0,1598,[221 215 350 268 326],592,5,4837,3.0250156347717323,0.0,20.0
1599,0,1599,[240 284 272 215 219],276,5,4842,3.02625,20.0,0.0
1600,0,1600,[232 239 208 507 275],293,1,4843,3.0249843847595255,0.0,0.0
1601,0,1601,[272 218 221 240 230],1,2,4845,3.0243445692883895,20.0,0.0
1602,0,1602,[365 230 276 303 298],276,4,4849,3.0249532127261385,0.0,20.0
1603,0,1603,[261 240 321 331 222],130,4,4853,3.025561097256858,0.0,20.0
1604,0,1604,[452 293 239 218 268],303,3,4856,3.025545171339564,0.0,20.0
1605,0,1605,[255 241 219 202 226],303,5,4861,3.026774595267746,0.0,0.0
1606,0,1606,[283 303 367 275 507],393,2,4863,3.0261356565028,0.0,0.0
1607,0,1607,[300 222 232 244 255],178,4,4867,3.0267412935323383,0.0,40.0
1608,0,1608,[324 481 420 227 431],758,3,4870,3.0267246737103792,0.0,0.0
1609,0,1609,[295 344 202 255 268],592,5,4875,3.027950310559006,0.0,20.0
1610,0,1610,[219 420 255 230 392],130,4,4879,3.0285536933581625,0.0,0.0
1611,0,1611,[367 230 290 315 239],276,4,4883,3.0291563275434243,20.0,0.0
1612,0,1612,[284 268 431 209 240],201,1,4884,3.027898326100434,0.0,20.0
1613,0,1613,[290 300 272 240 293],758,2,4886,3.0272614622057,20.0,20.0
1614,0,1614,[219 206 331 326 392],130,3,4889,3.027244582043344,0.0,0.0
1615,0,1615,[216 221 290 236 250],916,4,4893,3.0278465346534653,0.0,20.0
1616,0,1616,[284 208 291 431 259],727,4,4897,3.028447742733457,0.0,0.0
1617,0,1617,[298 272 254 250 222],682,4,4901,3.0290482076637826,20.0,40.0
1618,0,1618,[239 350 315 283 218],363,0,4901,3.0271772699197035,20.0,0.0
1619,0,1619,[315 208 275 290 250],293,0,4901,3.025308641975309,20.0,0.0
1620,0,1620,[392 250 276 226 261],130,4,4905,3.025909932140654,0.0,0.0
1621,0,1621,[217 218 303 293 206],293,3,4908,3.025893958076449,0.0,0.0
1622,0,1622,[226 298 367 232 293],178,4,4912,3.0264941466420208,0.0,20.0
1623,0,1623,[431 478 392 239 300],896,2,4914,3.0258620689655173,20.0,20.0
1624,0,1624,[222 316 219 275 259],178,4,4918,3.0264615384615383,20.0,20.0
1625,0,1625,[227 231 215 284 508],222,1,4919,3.0252152521525217,0.0,0.0
1626,0,1626,[240 231 261 208 264],1,1,4920,3.0239704978488016,0.0,0.0
1627,0,1627,[293 241 231 326 247],222,1,4921,3.022727272727273,0.0,0.0
1628,0,1628,[222 303 259 283 481],299,0,4921,3.0208717004297116,0.0,20.0
1629,0,1629,[300 222 276 390 259],303,1,4922,3.0196319018404907,0.0,40.0
1630,0,1630,[243 344 431 215 507],393,2,4924,3.0190067443286326,0.0,0.0
1631,0,1631,[509 216 315 240 201],201,2,4926,3.0183823529411766,20.0,20.0
1632,0,1632,[509 303 298 300 222],758,4,4930,3.0189834660134722,0.0,60.0
1633,0,1633,[298 226 284 508 223],429,3,4933,3.018971848225214,20.0,20.0
1634,0,1634,[230 240 231 239 222],823,1,4934,3.017737003058104,0.0,20.0
1635,0,1635,[231 367 222 255 216],682,2,4936,3.0171149144254277,0.0,40.0
1636,0,1636,[218 227 223 236 201],303,4,4940,3.0177153329260844,20.0,0.0
1637,0,1637,[293 300 241 246 202],303,4,4944,3.0183150183150182,0.0,20.0
1638,0,1638,[293 316 202 223 208],293,2,4946,3.0176937156802928,40.0,0.0
1639,0,1639,[222 227 201 583 301],425,3,4949,3.017682926829268,0.0,20.0
1640,0,1640,[344 202 478 324 219],327,4,4953,3.0182815356489945,20.0,0.0
1641,0,1641,[300 230 226 217 452],896,1,4954,3.0170523751522533,0.0,20.0
1642,0,1642,[255 218 298 300 431],222,4,4958,3.017650639074863,0.0,40.0
1643,0,1643,[255 246 298 384 291],682,2,4960,3.017031630170316,0.0,20.0
1644,0,1644,[283 367 290 485 276],429,1,4961,3.01580547112462,0.0,0.0
1645,0,1645,[507 315 429 298 227],293,3,4964,3.0157958687727824,20.0,20.0
1646,0,1646,[284 215 290 299 509],682,3,4967,3.01578627808136,0.0,0.0
1647,0,1647,[246 284 291 254 365],682,2,4969,3.0151699029126213,0.0,0.0
1648,0,1648,[315 344 431 241 290],393,2,4971,3.0145542753183747,20.0,0.0
1649,0,1649,[255 316 250 222 293],104,1,4972,3.013333333333333,20.0,20.0
1650,0,1650,[219 215 230 240 272],201,1,4973,3.012113870381587,20.0,0.0
1651,0,1651,[230 429 231 202 413],276,3,4976,3.0121065375302662,0.0,0.0
1652,0,1652,[384 255 209 236 293],303,4,4980,3.0127041742286753,0.0,0.0
1653,0,1653,[298 218 239 264 209],268,1,4981,3.0114873035066507,0.0,20.0
1654,0,1654,[250 284 213 283 215],790,2,4983,3.010876132930514,0.0,0.0
1655,0,1655,[246 300 390 216 208],303,3,4986,3.010869565217391,0.0,40.0
1656,0,1656,[272 300 246 315 239],130,5,4991,3.012070006035003,40.0,20.0
1657,0,1657,[276 221 509 239 246],916,4,4995,3.0126658624849214,0.0,0.0
1658,0,1658,[508 209 367 290 240],276,4,4999,3.013261000602773,0.0,0.0
1659,0,1659,[240 219 300 246 276],130,5,5004,3.014457831325301,0.0,20.0
1660,0,1660,[209 431 300 227 326],551,5,5009,3.015653220951234,0.0,20.0
1661,0,1661,[222 268 227 316 284],276,5,5014,3.016847172081829,20.0,40.0
1662,0,1662,[431 324 241 226 215],276,4,5018,3.017438364401684,0.0,0.0
1663,0,1663,[215 236 413 226 390],303,3,5021,3.0174278846153846,0.0,0.0
1664,0,1664,[452 316 299 219 202],130,4,5025,3.018018018018018,20.0,0.0
1665,0,1665,[231 246 216 227 201],303,4,5029,3.0186074429771907,0.0,20.0
1666,0,1666,[392 227 231 232 378],495,4,5033,3.0191961607678466,0.0,0.0
1667,0,1667,[218 209 230 250 478],407,5,5038,3.0203836930455634,20.0,0.0
1668,0,1668,[299 201 209 280 254],682,2,5040,3.019772318753745,0.0,0.0
1669,0,1669,[303 367 293 223 215],276,4,5044,3.0203592814371256,20.0,0.0
1670,0,1670,[420 236 239 331 226],130,4,5048,3.0209455415918613,0.0,0.0
1671,0,1671,[507 298 215 232 420],293,4,5052,3.021531100478469,0.0,20.0
1672,0,1672,[222 290 202 244 298],916,1,5053,3.020322773460849,0.0,40.0
1673,0,1673,[209 215 291 452 315],276,3,5056,3.020310633213859,20.0,0.0
1674,0,1674,[508 226 217 431 227],94,3,5059,3.0202985074626865,0.0,0.0
1675,0,1675,[420 390 227 324 219],303,2,5061,3.0196897374701672,0.0,0.0
1676,0,1676,[261 215 202 264 268],592,3,5064,3.0196779964221823,0.0,20.0
1677,0,1677,[239 231 268 219 227],130,3,5067,3.0196662693682956,0.0,20.0
1678,0,1678,[298 222 297 232 583],293,2,5069,3.0190589636688503,0.0,40.0
1679,0,1679,[226 390 240 218 246],303,3,5072,3.019047619047619,0.0,0.0
1680,0,1680,[293 202 201 291 221],303,4,5076,3.0196311719214752,0.0,0.0
1681,0,1681,[315 268 244 508 275],919,2,5078,3.019024970273484,20.0,20.0
1682,0,1682,[218 508 295 246 250],919,2,5080,3.0184194890077243,0.0,0.0
1683,0,1683,[316 429 300 241 222],276,5,5085,3.0195961995249405,20.0,40.0
1684,0,1684,[226 240 583 208 259],303,2,5087,3.0189910979228487,0.0,0.0
1685,0,1685,[283 268 230 208 384],727,2,5089,3.0183867141162515,0.0,20.0
1686,0,1686,[251 212 215 280 217],286,2,5091,3.01778304682869,0.0,0.0
1687,0,1687,[316 232 239 218 226],363,0,5091,3.015995260663507,20.0,0.0
1688,0,1688,[218 290 202 384 331],758,5,5096,3.0171699230313793,0.0,0.0
1689,0,1689,[293 226 222 268 241],682,4,5100,3.0177514792899407,0.0,40.0
1690,0,1690,[509 583 222 324 206],201,1,5101,3.0165582495564753,0.0,20.0
1691,0,1691,[272 429 222 392 206],276,4,5105,3.0171394799054374,20.0,20.0
1692,0,1692,[218 223 272 420 206],276,5,5110,3.0183106910809214,40.0,0.0
1693,0,1693,[202 431 217 216 215],660,1,5111,3.0171192443919717,0.0,20.0
1694,0,1694,[239 291 431 268 394],497,3,5114,3.017109144542773,0.0,20.0
1695,0,1695,[264 215 239 216 230],435,1,5115,3.015919811320755,0.0,20.0
1696,0,1696,[254 272 217 413 206],276,3,5118,3.01591043017089,20.0,0.0
1697,0,1697,[272 230 251 246 215],1,3,5121,3.0159010600706715,20.0,0.0
1698,0,1698,[222 241 508 300 290],347,2,5123,3.015303119482048,0.0,40.0
1699,0,1699,[231 452 227 216 222],303,2,5125,3.014705882352941,0.0,40.0
1700,0,1700,[429 217 239 331 272],276,5,5130,3.015873015873016,20.0,0.0
1701,0,1701,[255 254 218 239 209],682,0,5130,3.0141010575793183,0.0,0.0
1702,0,1702,[303 413 431 221 276],201,1,5131,3.012918379330593,0.0,0.0
1703,0,1703,[243 222 303 300 326],919,2,5133,3.012323943661972,0.0,40.0
1704,0,1704,[232 298 384 290 293],276,3,5136,3.012316715542522,0.0,20.0
1705,0,1705,[298 215 290 384 222],303,3,5139,3.012309495896835,0.0,40.0
1706,0,1706,[216 219 222 230 236],303,3,5142,3.0123022847100174,0.0,40.0
1707,0,1707,[255 254 217 261 250],130,2,5144,3.011709601873536,0.0,0.0
1708,0,1708,[301 239 201 241 284],276,5,5149,3.012873025160913,0.0,0.0
1709,0,1709,[259 261 326 202 236],919,2,5151,3.012280701754386,0.0,0.0
1710,0,1710,[213 217 509 209 284],916,3,5154,3.0122735242548218,0.0,0.0
1711,0,1711,[255 413 298 208 367],435,2,5156,3.0116822429906542,0.0,20.0
1712,0,1712,[283 206 208 303 280],293,2,5158,3.0110916520723876,0.0,0.0
1713,0,1713,[222 218 299 326 215],130,4,5162,3.011668611435239,0.0,20.0
1714,0,1714,[246 300 583 215 230],303,2,5164,3.0110787172011664,0.0,20.0
1715,0,1715,[275 284 324 280 283],181,1,5165,3.0099067599067597,0.0,0.0
1716,0,1716,[223 231 202 264 367],276,2,5167,3.0093185789167154,20.0,0.0
1717,0,1717,[290 215 298 211 222],682,4,5171,3.009895227008149,0.0,40.0
1718,0,1718,[213 227 291 429 226],293,1,5172,3.0087260034904015,0.0,0.0
1719,0,1719,[276 244 259 283 202],178,2,5174,3.0081395348837208,0.0,0.0
1720,0,1720,[326 301 315 216 201],592,4,5178,3.008715862870424,20.0,20.0
1721,0,1721,[583 264 255 222 211],327,0,5178,3.0069686411149825,0.0,20.0
1722,0,1722,[240 201 216 299 218],301,4,5182,3.007544979686593,0.0,20.0
1723,0,1723,[413 206 209 275 241],201,1,5183,3.0063805104408354,0.0,0.0
1724,0,1724,[202 255 300 264 485],299,3,5186,3.006376811594203,0.0,20.0
1725,0,1725,[232 299 241 219 481],301,3,5189,3.0063731170336037,0.0,0.0
1726,0,1726,[239 367 219 264 392],435,2,5191,3.005790387955993,0.0,0.0
1727,0,1727,[420 241 507 206 298],393,2,5193,3.0052083333333335,0.0,20.0
1728,0,1728,[301 232 246 344 321],327,3,5196,3.005205320994795,0.0,0.0
1729,0,1729,[250 284 251 485 209],293,1,5197,3.0040462427745664,0.0,0.0
1730,0,1730,[243 291 216 236 230],130,3,5200,3.0040439052570767,0.0,20.0
1731,0,1731,[452 507 241 231 293],303,4,5204,3.004618937644342,0.0,0.0
1732,0,1732,[331 413 226 299 250],435,4,5208,3.005193306405078,0.0,0.0
1733,0,1733,[219 206 284 431 246],916,1,5209,3.0040369088811993,0.0,0.0
1734,0,1734,[413 219 246 227 315],130,3,5212,3.0040345821325647,20.0,0.0
1735,0,1735,[231 392 230 367 272],276,2,5214,3.0034562211981566,20.0,0.0
1736,0,1736,[315 216 267 350 218],130,5,5219,3.0046056419113416,20.0,20.0
1737,0,1737,[201 272 280 202 226],682,3,5222,3.004602991944764,20.0,0.0
1738,0,1738,[232 223 216 420 221],303,5,5227,3.005750431282346,20.0,20.0
1739,0,1739,[216 508 222 218 202],327,1,5228,3.004597701149425,0.0,40.0
1740,0,1740,[217 201 244 239 213],1,1,5229,3.003446295232625,0.0,0.0
1741,0,1741,[452 223 290 316 226],276,4,5233,3.0040183696900113,40.0,0.0
1742,0,1742,[326 331 316 303 259],863,3,5236,3.004016064257028,20.0,0.0
1743,0,1743,[206 275 508 221 276],201,3,5239,3.00401376146789,0.0,0.0
1744,0,1744,[284 232 230 429 583],276,3,5242,3.0040114613180515,0.0,0.0
1745,0,1745,[284 227 232 218 231],222,2,5244,3.0034364261168385,0.0,0.0
1746,0,1746,[218 223 240 583 211],201,2,5246,3.0028620492272466,20.0,0.0
1747,0,1747,[431 303 211 217 321],201,0,5246,3.0011441647597255,0.0,0.0
1748,0,1748,[246 293 215 276 241],178,4,5250,3.0017152658662094,0.0,0.0
1749,0,1749,[250 239 291 365 240],393,3,5253,3.001714285714286,0.0,0.0
1750,0,1750,[222 293 226 255 291],332,5,5258,3.0028555111364934,0.0,20.0
1751,0,1751,[219 231 367 222 298],303,4,5262,3.0034246575342465,0.0,40.0
1752,0,1752,[315 223 303 202 236],758,5,5267,3.004563605248146,40.0,0.0
1753,0,1753,[239 420 202 300 384],682,1,5268,3.0034207525655643,0.0,20.0
1754,0,1754,[211 241 239 276 202],916,3,5271,3.0034188034188034,0.0,0.0
1755,0,1755,[231 420 240 326 215],303,3,5274,3.003416856492027,0.0,0.0
1756,0,1756,[268 315 275 303 301],919,2,5276,3.0028457598178715,20.0,20.0
1757,0,1757,[216 272 284 431 367],532,5,5281,3.003981797497156,20.0,20.0
1758,0,1758,[246 231 367 485 226],790,3,5284,3.0039795338260373,0.0,0.0
1759,0,1759,[236 295 291 227 367],130,3,5287,3.0039772727272727,0.0,0.0
1760,0,1760,[291 508 300 259 219],303,2,5289,3.0034071550255534,0.0,20.0
1761,0,1761,[250 290 300 254 219],276,4,5293,3.003972758229285,0.0,20.0
1762,0,1762,[226 211 222 223 216],109,4,5297,3.0045377197958025,20.0,40.0
1763,0,1763,[239 230 384 227 231],758,3,5300,3.00453514739229,0.0,0.0
1764,0,1764,[290 298 297 284 275],293,2,5302,3.0039660056657222,0.0,20.0
1765,0,1765,[211 256 206 276 509],916,3,5305,3.0039637599093996,0.0,0.0
1766,0,1766,[223 283 213 218 251],293,2,5307,3.0033955857385397,20.0,0.0
1767,0,1767,[268 293 284 218 431],682,4,5311,3.0039592760180995,0.0,20.0
1768,0,1768,[208 299 284 250 298],435,4,5315,3.0045223289994345,0.0,20.0
1769,0,1769,[202 201 236 268 267],1,4,5319,3.0050847457627117,0.0,20.0
1770,0,1770,[212 478 250 367 209],896,2,5321,3.004517221908526,20.0,0.0
1771,0,1771,[202 431 303 243 507],393,2,5323,3.0039503386004514,0.0,0.0
1772,0,1772,[350 227 431 331 481],758,4,5327,3.0045121263395376,0.0,0.0
1773,0,1773,[384 290 276 250 231],276,3,5330,3.004509582863585,0.0,0.0
1774,0,1774,[384 243 218 232 508],880,3,5333,3.004507042253521,0.0,0.0
1775,0,1775,[316 226 276 350 246],130,5,5338,3.005630630630631,20.0,0.0
1776,0,1776,[485 481 367 227 232],429,1,5339,3.004501969611705,0.0,0.0
1777,0,1777,[268 227 232 211 216],201,3,5342,3.0044994375703036,0.0,40.0
1778,0,1778,[276 431 478 211 232],561,3,5345,3.0044969083754918,20.0,0.0
1779,0,1779,[209 232 219 324 321],201,2,5347,3.003932584269663,0.0,0.0
1780,0,1780,[254 295 413 293 250],130,1,5348,3.0028074115665357,0.0,0.0
1781,0,1781,[384 259 240 326 209],303,1,5349,3.0016835016835017,0.0,0.0
1782,0,1782,[250 211 420 216 232],293,3,5352,3.001682557487381,0.0,20.0
1783,0,1783,[232 219 227 231 291],429,3,5355,3.001681614349776,0.0,0.0
1784,0,1784,[365 226 272 283 301],880,3,5358,3.0016806722689076,20.0,0.0
1785,0,1785,[293 251 291 326 223],592,4,5362,3.0022396416573347,20.0,0.0
1786,0,1786,[213 255 429 303 208],293,2,5364,3.0016787912702854,0.0,0.0
1787,0,1787,[291 255 239 283 215],393,4,5368,3.0022371364653244,0.0,0.0
1788,0,1788,[209 216 280 272 300],661,3,5371,3.0022358859698155,20.0,40.0
1789,0,1789,[429 213 452 478 378],846,2,5373,3.0016759776536315,20.0,0.0
1790,0,1790,[508 300 241 251 301],532,5,5378,3.002791736460078,0.0,20.0
1791,0,1791,[259 240 420 227 275],393,3,5381,3.0027901785714284,0.0,0.0
1792,0,1792,[394 208 301 268 336],286,5,5386,3.003904071388734,0.0,20.0
1793,0,1793,[508 367 230 209 227],933,1,5387,3.0027870680044595,0.0,0.0
1794,0,1794,[284 230 223 276 227],276,5,5392,3.003899721448468,20.0,0.0
1795,0,1795,[230 226 315 209 215],201,0,5392,3.002227171492205,20.0,0.0
1796,0,1796,[284 276 367 259 246],303,4,5396,3.0027824151363385,0.0,0.0
1797,0,1797,[267 244 209 220 230],1,3,5399,3.0027808676307006,0.0,0.0
1798,0,1798,[230 232 218 431 211],201,1,5400,3.001667593107282,0.0,0.0
1799,0,1799,[431 223 246 295 316],178,4,5404,3.002222222222222,40.0,0.0
1800,0,1800,[232 276 478 367 295],178,3,5407,3.002220988339811,20.0,0.0
1801,0,1801,[208 378 413 384 211],727,2,5409,3.0016648168701443,0.0,0.0
1802,0,1802,[298 239 316 261 315],130,5,5414,3.002773155851359,40.0,20.0
1803,0,1803,[221 259 384 226 508],303,3,5417,3.0027716186252773,0.0,0.0
1804,0,1804,[247 219 452 284 218],222,2,5419,3.0022160664819943,0.0,0.0
1805,0,1805,[331 246 291 298 301],697,4,5423,3.002768549280177,0.0,20.0
1806,0,1806,[254 284 209 392 232],276,2,5425,3.002213613724405,0.0,0.0
1807,0,1807,[223 326 202 255 222],919,2,5427,3.001659292035398,20.0,20.0
1808,0,1808,[298 230 420 507 211],293,4,5431,3.002211166390271,0.0,20.0
1809,0,1809,[215 452 275 226 231],896,2,5433,3.001657458563536,0.0,0.0
1810,0,1810,[275 507 509 272 291],293,2,5435,3.001104362230812,20.0,0.0
1811,0,1811,[420 485 206 431 255],393,1,5436,3.0,0.0,0.0
1812,0,1812,[208 290 215 431 298],363,2,5438,2.9994484280198566,0.0,20.0
1813,0,1813,[226 239 429 290 300],276,5,5443,3.000551267916207,0.0,20.0
1814,0,1814,[259 303 324 236 336],592,2,5445,3.0,0.0,0.0
1815,0,1815,[293 275 392 300 276],429,3,5448,3.0,0.0,20.0
1816,0,1816,[206 222 254 350 239],130,3,5451,3.0,0.0,20.0
1817,0,1817,[216 240 251 202 315],293,2,5453,2.9994499449944994,20.0,20.0
1818,0,1818,[276 272 291 431 216],682,3,5456,2.9994502473886753,20.0,20.0
1819,0,1819,[212 213 300 303 384],299,3,5459,2.9994505494505495,0.0,20.0
1820,0,1820,[223 239 231 232 251],1,3,5462,2.99945085118067,20.0,0.0
1821,0,1821,[272 316 240 367 290],276,4,5466,3.0,40.0,0.0
1822,0,1822,[280 315 217 264 208],293,0,5466,2.9983543609435,20.0,0.0
1823,0,1823,[226 215 250 227 280],222,1,5467,2.9972587719298245,0.0,0.0
1824,0,1824,[217 268 259 293 240],919,3,5470,2.9972602739726026,0.0,20.0
1825,0,1825,[215 223 246 267 221],1,4,5474,2.9978094194961664,20.0,0.0
1826,0,1826,[291 298 508 230 280],347,4,5478,2.9983579638752054,0.0,20.0
1827,0,1827,[227 413 208 239 222],497,1,5479,2.9972647702407,0.0,20.0
1828,0,1828,[226 264 216 291 219],303,3,5482,2.997266265718972,0.0,20.0
1829,0,1829,[298 230 232 201 384],268,0,5482,2.9956284153005464,0.0,20.0
1830,0,1830,[420 241 231 227 303],758,2,5484,2.9950846531949753,0.0,0.0
1831,0,1831,[264 321 241 227 507],303,2,5486,2.9945414847161573,0.0,0.0
1832,0,1832,[300 244 283 250 272],919,3,5489,2.994544462629569,20.0,20.0
1833,0,1833,[222 209 223 298 509],293,2,5491,2.9940021810250816,20.0,40.0
1834,0,1834,[240 236 299 261 321],130,4,5495,2.994550408719346,0.0,0.0
1835,0,1835,[298 299 201 290 219],682,3,5498,2.994553376906318,0.0,20.0
1836,0,1836,[244 255 326 508 301],919,2,5500,2.9940119760479043,0.0,0.0
1837,0,1837,[481 259 384 241 303],299,0,5500,2.9923830250272037,0.0,0.0
1838,0,1838,[290 222 240 218 255],682,2,5502,2.99184339314845,0.0,20.0
1839,0,1839,[300 297 275 293 255],919,5,5507,2.9929347826086956,0.0,20.0
1840,0,1840,[331 230 240 254 219],130,2,5509,2.9923954372623576,0.0,0.0
1841,0,1841,[267 215 367 321 254],130,4,5513,2.992942453854506,0.0,0.0
1842,0,1842,[216 290 231 219 300],303,4,5517,2.9934888768312535,0.0,40.0
1843,0,1843,[230 291 429 303 217],293,2,5519,2.99295010845987,0.0,0.0
1844,0,1844,[219 272 291 295 350],130,4,5523,2.9934959349593497,20.0,0.0
1845,0,1845,[226 239 283 507 211],727,2,5525,2.992957746478873,0.0,0.0
1846,0,1846,[283 217 230 276 223],864,4,5529,2.9935029778018407,20.0,0.0
1847,0,1847,[298 202 216 232 259],790,3,5532,2.9935064935064934,0.0,40.0
1848,0,1848,[298 259 583 239 246],682,2,5534,2.9929691725256897,0.0,20.0
1849,0,1849,[290 344 230 324 209],758,4,5538,2.9935135135135136,0.0,0.0
1850,0,1850,[241 232 211 284 202],201,0,5538,2.9918962722852513,0.0,0.0
1851,0,1851,[241 219 268 231 452],399,1,5539,2.9908207343412525,0.0,20.0
1852,0,1852,[384 303 250 321 215],393,3,5542,2.9908256880733943,0.0,0.0
1853,0,1853,[221 206 217 261 220],1,2,5544,2.9902912621359223,0.0,0.0
1854,0,1854,[250 301 283 303 246],919,2,5546,2.9897574123989217,0.0,0.0
1855,0,1855,[365 217 276 202 227],429,2,5548,2.9892241379310347,0.0,0.0
1856,0,1856,[223 429 208 291 290],293,2,5550,2.988691437802908,20.0,0.0
1857,0,1857,[246 232 209 201 243],1,2,5552,2.9881593110871907,0.0,0.0
1858,0,1858,[241 275 239 298 283],393,4,5556,2.9887036040882196,0.0,20.0
1859,0,1859,[223 324 284 508 232],291,4,5560,2.989247311827957,20.0,0.0
1860,0,1860,[250 583 291 301 232],276,2,5562,2.9887157442235357,0.0,0.0
1861,0,1861,[478 211 324 298 201],327,2,5564,2.9881847475832437,20.0,20.0
1862,0,1862,[507 508 222 201 264],303,3,5567,2.988191089640365,0.0,20.0
1863,0,1863,[384 240 243 272 284],682,3,5570,2.9881974248927037,20.0,0.0
1864,0,1864,[246 217 321 218 222],327,1,5571,2.9871313672922253,0.0,20.0
1865,0,1865,[227 222 215 384 218],363,2,5573,2.9866023579849945,0.0,20.0
1866,0,1866,[283 208 221 420 223],303,4,5577,2.9871451526513124,20.0,0.0
1867,0,1867,[208 206 268 218 298],268,2,5579,2.98661670235546,0.0,40.0
1868,0,1868,[420 240 293 303 367],293,3,5582,2.9866238630283575,0.0,0.0
1869,0,1869,[452 241 223 239 303],758,2,5584,2.986096256684492,20.0,0.0
1870,0,1870,[365 227 367 223 290],393,2,5586,2.985569214323891,20.0,0.0
1871,0,1871,[239 420 240 201 223],276,5,5591,2.986645299145299,20.0,0.0
1872,0,1872,[297 481 272 236 344],758,4,5595,2.98718633208756,20.0,0.0
1873,0,1873,[227 209 431 264 226],429,2,5597,2.986659551760939,0.0,0.0
1874,0,1874,[298 219 261 226 247],222,2,5599,2.9861333333333335,0.0,20.0
1875,0,1875,[284 208 232 236 209],303,5,5604,2.9872068230277184,0.0,0.0
1876,0,1876,[250 246 367 291 215],303,4,5608,2.9877464038359083,0.0,0.0
1877,0,1877,[209 227 284 291 222],293,0,5608,2.9861554845580405,0.0,20.0
1878,0,1878,[227 222 216 202 301],487,4,5612,2.986695050558808,0.0,40.0
1879,0,1879,[241 250 316 206 232],276,4,5616,2.9872340425531916,20.0,0.0
1880,0,1880,[212 240 301 231 202],286,2,5618,2.986709197235513,0.0,0.0
1881,0,1881,[226 384 239 378 250],682,1,5619,2.985653560042508,0.0,0.0
1882,0,1882,[420 507 283 324 239],303,2,5621,2.9851301115241635,0.0,0.0
1883,0,1883,[217 452 241 508 321],201,1,5622,2.984076433121019,0.0,0.0
1884,0,1884,[365 243 255 215 378],682,1,5623,2.9830238726790452,0.0,0.0
1885,0,1885,[367 243 272 315 217],919,3,5626,2.983032873806999,40.0,0.0
1886,0,1886,[232 250 219 276 201],301,4,5630,2.9835718071012187,0.0,0.0
1887,0,1887,[413 215 331 268 431],276,3,5633,2.983580508474576,0.0,20.0
1888,0,1888,[223 240 508 218 268],919,3,5636,2.9835892006352567,20.0,20.0
1889,0,1889,[316 240 241 250 222],393,4,5640,2.984126984126984,20.0,20.0
1890,0,1890,[201 232 221 298 384],303,4,5644,2.9846641988365943,0.0,20.0
1891,0,1891,[431 215 583 206 300],276,3,5647,2.9846723044397465,0.0,20.0
1892,0,1892,[268 226 246 367 431],790,3,5650,2.9846804014791335,0.0,20.0
1893,0,1893,[217 230 226 431 392],435,2,5652,2.9841605068637804,0.0,0.0
1894,0,1894,[324 227 420 481 217],758,3,5655,2.984168865435356,0.0,0.0
1895,0,1895,[365 284 283 485 384],790,2,5657,2.9836497890295357,0.0,0.0
1896,0,1896,[239 241 236 230 431],758,2,5659,2.9831312598840274,0.0,0.0
1897,0,1897,[284 223 209 222 240],682,3,5662,2.9831401475237094,20.0,20.0
1898,0,1898,[240 211 230 219 231],823,1,5663,2.982095839915745,0.0,0.0
1899,0,1899,[300 222 226 250 221],303,3,5666,2.982105263157895,0.0,40.0
1900,0,1900,[509 384 350 276 202],758,4,5670,2.9826407154129404,0.0,0.0
1901,0,1901,[209 452 290 508 239],276,4,5674,2.983175604626709,0.0,0.0
1902,0,1902,[215 202 283 209 326],303,3,5677,2.983184445612191,0.0,0.0
1903,0,1903,[218 315 303 239 583],293,1,5678,2.982142857142857,20.0,0.0
1904,0,1904,[429 284 299 201 231],896,2,5680,2.9816272965879267,0.0,0.0
1905,0,1905,[275 250 227 222 583],429,2,5682,2.981112277019937,0.0,20.0
1906,0,1906,[246 268 267 223 284],268,2,5684,2.9805977975878344,20.0,20.0
1907,0,1907,[384 268 218 231 283],880,2,5686,2.980083857442348,0.0,20.0
1908,0,1908,[384 298 275 222 508],299,3,5689,2.9800942902042955,0.0,40.0
1909,0,1909,[223 201 222 509 250],864,4,5693,2.980628272251309,20.0,20.0
1910,0,1910,[219 324 264 223 293],303,3,5696,2.980638409209838,20.0,0.0
1911,0,1911,[254 429 239 246 209],276,4,5700,2.981171548117155,0.0,0.0
1912,0,1912,[324 508 275 303 231],201,3,5703,2.9811813904861473,0.0,0.0
1913,0,1913,[217 275 280 241 208],429,2,5705,2.9806687565308256,0.0,0.0
1914,0,1914,[276 316 240 201 298],880,5,5710,2.9817232375979112,20.0,20.0
1915,0,1915,[222 485 275 284 240],293,0,5710,2.980167014613779,0.0,20.0
1916,0,1916,[222 264 290 230 231],268,2,5712,2.979655712050078,0.0,20.0
1917,0,1917,[231 226 208 315 250],407,3,5715,2.9796663190823773,20.0,0.0
1918,0,1918,[226 431 239 232 508],399,0,5715,2.9781136008337676,0.0,0.0
1919,0,1919,[300 232 268 264 290],276,3,5718,2.978125,0.0,40.0
1920,0,1920,[216 283 300 276 202],478,4,5722,2.978656949505466,0.0,40.0
1921,0,1921,[241 431 206 295 583],916,2,5724,2.978147762747138,0.0,0.0
1922,0,1922,[218 431 217 507 275],429,3,5727,2.9781591263650546,0.0,0.0
1923,0,1923,[239 303 218 264 293],293,2,5729,2.977650727650728,0.0,0.0
1924,0,1924,[293 223 230 324 232],276,4,5733,2.978181818181818,20.0,0.0
1925,0,1925,[420 315 509 211 384],758,4,5737,2.97871235721703,20.0,0.0
1926,0,1926,[413 217 223 240 365],276,3,5740,2.978723404255319,20.0,0.0
1927,0,1927,[212 211 478 452 202],846,3,5743,2.978734439834025,20.0,0.0
1928,0,1928,[268 231 254 283 243],880,1,5744,2.977708657335407,0.0,20.0
1929,0,1929,[431 215 420 232 315],276,3,5747,2.977720207253886,20.0,0.0
1930,0,1930,[507 276 231 324 250],303,4,5751,2.9782496116002073,0.0,0.0
1931,0,1931,[220 295 367 268 508],178,2,5753,2.977743271221532,0.0,20.0
1932,0,1932,[316 241 326 201 231],425,1,5754,2.9767201241593377,20.0,0.0
1933,0,1933,[206 218 326 272 223],201,2,5756,2.9762150982419855,40.0,0.0
1934,0,1934,[298 321 413 255 452],303,2,5758,2.9757105943152453,0.0,20.0
1935,0,1935,[316 231 208 431 280],286,4,5762,2.9762396694214877,20.0,0.0
1936,0,1936,[315 384 293 227 241],276,4,5766,2.9767681982447085,20.0,0.0
1937,0,1937,[230 384 227 331 250],758,5,5771,2.97781217750258,0.0,0.0
1938,0,1938,[217 367 209 481 211],896,3,5774,2.9778236204228983,0.0,0.0
1939,0,1939,[583 293 209 227 324],276,4,5778,2.9783505154639176,0.0,0.0
1940,0,1940,[211 384 246 378 272],682,3,5781,2.978361669242658,20.0,0.0
1941,0,1941,[202 227 239 298 217],276,5,5786,2.979402677651905,0.0,20.0
1942,0,1942,[236 209 227 230 268],303,3,5789,2.979413278435409,0.0,20.0
1943,0,1943,[254 452 508 202 223],453,3,5792,2.9794238683127574,20.0,0.0
1944,0,1944,[206 202 367 259 222],727,2,5794,2.9789203084832905,0.0,20.0
1945,0,1945,[231 240 291 222 261],130,4,5798,2.9794450154162386,0.0,20.0
1946,0,1946,[240 209 211 284 232],201,0,5798,2.977914740626605,0.0,0.0
1947,0,1947,[232 206 212 331 431],201,2,5800,2.97741273100616,0.0,0.0
1948,0,1948,[367 485 264 218 230],429,0,5800,2.9758850692662904,0.0,0.0
1949,0,1949,[201 239 230 219 300],303,2,5802,2.9753846153846153,0.0,20.0
1950,0,1950,[223 236 208 213 215],1,3,5805,2.9753972321886213,20.0,0.0
1951,0,1951,[290 326 218 390 268],303,3,5808,2.9754098360655736,0.0,20.0
1952,0,1952,[367 219 394 222 202],435,3,5811,2.97542242703533,0.0,20.0
1953,0,1953,[211 232 231 384 243],682,1,5812,2.9744114636642784,0.0,0.0
1954,0,1954,[246 231 384 217 209],790,3,5815,2.9744245524296673,0.0,0.0
1955,0,1955,[213 300 272 240 431],758,2,5817,2.973926380368098,20.0,20.0
1956,0,1956,[261 280 239 226 230],222,2,5819,2.9734287174246297,0.0,0.0
1957,0,1957,[222 206 217 232 431],757,3,5822,2.9734422880490294,0.0,20.0
1958,0,1958,[230 508 241 246 215],222,3,5825,2.973455844818785,0.0,0.0
1959,0,1959,[326 324 300 384 316],551,3,5828,2.973469387755102,20.0,20.0
1960,0,1960,[251 215 246 222 413],303,3,5831,2.9734829168791435,0.0,20.0
1961,0,1961,[209 208 240 250 201],268,3,5834,2.9734964322120288,0.0,0.0
1962,0,1962,[264 202 298 239 583],303,2,5836,2.9730005094243506,0.0,20.0
1963,0,1963,[240 223 246 264 236],1,3,5839,2.9730142566191446,20.0,0.0
1964,0,1964,[218 201 216 251 250],303,5,5844,2.9740458015267177,0.0,20.0
1965,0,1965,[295 215 201 264 291],592,3,5847,2.974059003051882,0.0,0.0
1966,0,1966,[206 218 217 230 209],293,1,5848,2.973055414336553,0.0,0.0
1967,0,1967,[239 231 431 298 211],660,2,5850,2.972560975609756,0.0,20.0
1968,0,1968,[241 293 429 508 303],276,5,5855,2.973590655154901,0.0,0.0
1969,0,1969,[215 206 367 280 227],293,2,5857,2.9730964467005077,0.0,0.0
1970,0,1970,[219 583 201 246 420],276,4,5861,2.9736174530695076,0.0,0.0
1971,0,1971,[222 583 298 283 202],303,2,5863,2.9731237322515214,0.0,40.0
1972,0,1972,[240 209 331 230 290],758,4,5867,2.97364419665484,0.0,0.0
1973,0,1973,[452 290 240 223 239],276,4,5871,2.974164133738602,20.0,0.0
1974,0,1974,[254 452 201 300 222],276,3,5874,2.9741772151898735,0.0,40.0
1975,0,1975,[216 247 226 255 219],222,2,5876,2.973684210526316,0.0,20.0
1976,0,1976,[223 215 508 222 250],896,3,5879,2.973697521497218,20.0,20.0
1977,0,1977,[315 254 267 239 227],130,3,5882,2.9737108190091,20.0,0.0
1978,0,1978,[230 231 254 226 452],130,2,5884,2.9732187973724105,0.0,0.0
1979,0,1979,[290 324 206 429 226],276,5,5889,2.974242424242424,0.0,0.0
1980,0,1980,[284 384 315 232 226],363,0,5889,2.972741039878849,20.0,0.0
1981,0,1981,[293 276 240 201 223],303,4,5893,2.9732593340060545,20.0,0.0
1982,0,1982,[231 481 350 212 509],758,4,5897,2.973777105395865,0.0,0.0
1983,0,1983,[218 231 298 251 290],303,5,5902,2.974798387096774,0.0,20.0
1984,0,1984,[259 275 230 209 240],790,2,5904,2.9743073047858943,0.0,0.0
1985,0,1985,[259 298 431 268 365],790,3,5907,2.974320241691843,0.0,40.0
1986,0,1986,[209 222 217 384 508],551,3,5910,2.9743331655762457,0.0,20.0
1987,0,1987,[298 384 276 583 240],276,3,5913,2.9743460764587524,0.0,20.0
1988,0,1988,[226 284 216 241 202],429,2,5915,2.973856209150327,0.0,20.0
1989,0,1989,[276 206 218 291 324],276,4,5919,2.9743718592964825,0.0,0.0
1990,0,1990,[508 583 239 241 300],303,2,5921,2.97388247112004,0.0,20.0
1991,0,1991,[275 206 223 239 217],896,3,5924,2.9738955823293174,20.0,0.0
1992,0,1992,[218 250 209 290 316],407,4,5928,2.9744104365278474,20.0,0.0
1993,0,1993,[429 272 264 583 215],293,3,5931,2.9744232698094284,20.0,0.0
1994,0,1994,[485 208 243 201 227],660,1,5932,2.9734335839598995,0.0,0.0
1995,0,1995,[508 231 217 316 208],407,4,5936,2.973947895791583,20.0,0.0
1996,0,1996,[209 241 508 222 303],276,5,5941,2.9749624436654982,0.0,20.0
1997,0,1997,[298 326 240 300 226],332,5,5946,2.975975975975976,0.0,40.0
1998,0,1998,[222 202 392 230 267],130,4,5950,2.976488244122061,0.0,20.0
1999,0,1999,[250 215 276 226 326],130,4,5954,2.977,0.0,0.0
2000,0,2000,[256 250 230 264 431],363,0,5954,2.975512243878061,0.0,0.0
2001,0,2001,[216 350 326 508 301],592,4,5958,2.976023976023976,0.0,20.0
2002,0,2002,[268 219 227 250 367],435,4,5962,2.9765351972041936,0.0,20.0
2003,0,2003,[324 300 264 276 223],303,2,5964,2.9760479041916166,20.0,20.0
2004,0,2004,[298 367 222 250 284],293,1,5965,2.975062344139651,0.0,40.0
2005,0,2005,[300 378 202 259 268],682,2,5967,2.9745762711864407,0.0,40.0
2006,0,2006,[413 367 452 365 284],276,1,5968,2.9735924265072247,0.0,0.0
2007,0,2007,[241 201 202 230 239],606,3,5971,2.973605577689243,0.0,0.0
2008,0,2008,[420 384 321 222 250],393,2,5973,2.9731209556993528,0.0,20.0
2009,0,2009,[291 226 300 420 231],896,1,5974,2.972139303482587,0.0,20.0
2010,0,2010,[226 216 222 431 217],435,2,5976,2.971655892590751,0.0,40.0
2011,0,2011,[367 223 508 232 202],222,3,5979,2.9716699801192843,20.0,0.0
2012,0,2012,[217 218 215 231 431],682,3,5982,2.9716840536512668,0.0,0.0
2013,0,2013,[508 227 301 367 240],880,4,5986,2.9721946375372394,0.0,0.0
2014,0,2014,[232 222 239 223 290],268,1,5987,2.9712158808933005,20.0,20.0
2015,0,2015,[298 202 283 243 384],880,2,5989,2.970734126984127,0.0,20.0
2016,0,2016,[394 321 219 300 284],435,2,5991,2.970252850768468,0.0,20.0
2017,0,2017,[201 290 222 218 240],435,1,5992,2.9692765113974233,0.0,20.0
2018,0,2018,[420 202 223 201 226],276,5,5997,2.9702823179791977,20.0,0.0
2019,0,2019,[239 268 478 298 293],327,2,5999,2.96980198019802,20.0,40.0
2020,0,2020,[413 365 231 276 431],222,3,6002,2.9698169223156854,0.0,0.0
2021,0,2021,[508 272 231 254 509],453,3,6005,2.9698318496538083,20.0,0.0
2022,0,2022,[264 291 583 250 218],429,1,6006,2.9688581314878895,0.0,0.0
2023,0,2023,[209 241 264 300 365],276,3,6009,2.968873517786561,0.0,20.0
2024,0,2024,[209 315 452 268 212],201,2,6011,2.968395061728395,20.0,20.0
2025,0,2025,[276 261 293 315 223],592,4,6015,2.968904244817374,40.0,0.0
2026,0,2026,[215 241 293 243 209],682,3,6018,2.9689195855944748,0.0,0.0
2027,0,2027,[217 365 230 241 201],94,3,6021,2.9689349112426036,0.0,0.0
2028,0,2028,[583 206 324 218 264],268,2,6023,2.968457368161656,0.0,0.0
2029,0,2029,[208 209 429 259 230],660,4,6027,2.9689655172413794,0.0,0.0
2030,0,2030,[223 481 241 301 300],758,2,6029,2.9684884293451503,20.0,20.0
2031,0,2031,[300 507 583 290 291],429,2,6031,2.968011811023622,0.0,20.0
2032,0,2032,[583 232 241 246 202],916,3,6034,2.968027545499262,0.0,0.0
2033,0,2033,[315 222 367 272 246],919,2,6036,2.967551622418879,40.0,20.0
2034,0,2034,[324 429 230 209 384],276,4,6040,2.968058968058968,0.0,0.0
2035,0,2035,[231 367 226 211 284],896,3,6043,2.968074656188605,0.0,0.0
2036,0,2036,[301 264 250 215 413],276,3,6046,2.9680903289150713,0.0,0.0
2037,0,2037,[431 298 202 215 255],435,2,6048,2.967615309126595,0.0,20.0
2038,0,2038,[276 298 206 250 223],276,5,6053,2.9686120647376164,20.0,20.0
2039,0,2039,[227 217 230 509 303],293,1,6054,2.9676470588235295,0.0,0.0
2040,0,2040,[226 219 509 211 268],846,4,6058,2.968152866242038,0.0,20.0
2041,0,2041,[276 239 297 219 211],889,3,6061,2.968168462291871,0.0,0.0
2042,0,2042,[246 272 240 420 367],276,4,6065,2.9686735193343123,20.0,0.0
2043,0,2043,[326 336 255 250 223],592,4,6069,2.969178082191781,20.0,0.0
2044,0,2044,[508 221 209 217 275],201,2,6071,2.968704156479218,0.0,0.0
2045,0,2045,[231 219 367 583 222],682,1,6072,2.967741935483871,0.0,20.0
2046,0,2046,[223 324 251 250 299],592,4,6076,2.968246213971666,20.0,0.0
2047,0,2047,[221 209 241 202 256],1,5,6081,2.96923828125,0.0,0.0
2048,0,2048,[215 239 218 298 216],435,2,6083,2.968765251342118,0.0,40.0
2049,0,2049,[299 291 295 206 267],130,2,6085,2.9682926829268292,0.0,0.0
2050,0,2050,[230 583 216 215 509],201,1,6086,2.9673330082886396,0.0,20.0
2051,0,2051,[298 216 211 255 384],435,2,6088,2.9668615984405458,0.0,40.0
2052,0,2052,[250 284 231 275 367],727,1,6089,2.965903555772041,0.0,0.0
2053,0,2053,[452 303 239 272 232],201,0,6089,2.9644595910418694,20.0,0.0
2054,0,2054,[485 226 298 222 431],790,1,6090,2.9635036496350367,0.0,40.0
2055,0,2055,[420 321 226 298 251],303,4,6094,2.9640077821011674,0.0,20.0
2056,0,2056,[215 509 213 452 268],846,3,6097,2.964025279533301,0.0,20.0
2057,0,2057,[227 239 217 350 452],442,0,6097,2.9625850340136055,0.0,0.0
2058,0,2058,[222 226 231 431 208],363,2,6099,2.962117532782904,0.0,20.0
2059,0,2059,[250 324 284 300 221],303,3,6102,2.962135922330097,0.0,20.0
2060,0,2060,[344 291 420 508 250],758,3,6105,2.962154294032023,0.0,0.0
2061,0,2061,[216 241 367 431 326],222,3,6108,2.962172647914646,0.0,20.0
2062,0,2062,[217 264 201 508 429],276,4,6112,2.9626757149781873,0.0,0.0
2063,0,2063,[217 367 254 216 290],130,2,6114,2.9622093023255816,0.0,20.0
2064,0,2064,[507 392 429 212 241],846,2,6116,2.9617433414043584,0.0,0.0
2065,0,2065,[268 293 275 226 298],178,4,6120,2.9622458857696032,0.0,40.0
2066,0,2066,[231 221 293 315 208],758,2,6122,2.961780358006773,20.0,0.0
2067,0,2067,[298 431 321 420 392],393,2,6124,2.9613152804642167,0.0,20.0
2068,0,2068,[297 420 230 315 217],293,2,6126,2.960850652489125,20.0,0.0
2069,0,2069,[303 507 272 394 222],393,4,6130,2.9613526570048307,20.0,20.0
2070,0,2070,[230 255 264 583 507],303,2,6132,2.960888459681313,0.0,0.0
2071,0,2071,[324 315 211 413 227],201,2,6134,2.9604247104247103,20.0,0.0
2072,0,2072,[429 222 254 259 201],660,2,6136,2.9599614085865893,0.0,20.0
2073,0,2073,[259 508 367 297 268],919,4,6140,2.96046287367406,0.0,20.0
2074,0,2074,[218 452 241 219 276],222,3,6143,2.9604819277108434,0.0,0.0
2075,0,2075,[507 367 213 208 303],293,2,6145,2.960019267822736,0.0,0.0
2076,0,2076,[211 290 431 230 244],916,2,6147,2.959557053442465,0.0,0.0
2077,0,2077,[240 259 223 211 251],1,2,6149,2.9590952839268527,20.0,0.0
2078,0,2078,[390 202 275 301 394],286,4,6153,2.95959595959596,0.0,0.0
2079,0,2079,[201 367 315 227 250],880,3,6156,2.9596153846153848,20.0,0.0
2080,0,2080,[232 231 390 246 508],303,4,6160,2.960115329168669,0.0,0.0
2081,0,2081,[268 276 255 259 239],682,1,6161,2.959173871277618,0.0,20.0
2082,0,2082,[300 240 202 239 367],222,3,6164,2.959193470955353,0.0,20.0
2083,0,2083,[250 227 259 378 217],727,3,6167,2.9592130518234163,0.0,0.0
2084,0,2084,[300 250 216 452 230],303,2,6169,2.9587529976019185,0.0,40.0
2085,0,2085,[431 230 227 250 268],727,4,6173,2.9592521572387342,0.0,20.0
2086,0,2086,[219 232 227 223 240],268,1,6174,2.95831336847149,20.0,0.0
2087,0,2087,[219 202 255 293 300],327,2,6176,2.9578544061302683,0.0,20.0
2088,0,2088,[272 268 298 301 367],880,5,6181,2.958831977022499,20.0,40.0
2089,0,2089,[297 240 295 300 275],770,4,6185,2.95933014354067,0.0,20.0
2090,0,2090,[236 250 243 247 215],1,2,6187,2.9588713534194166,0.0,0.0
2091,0,2091,[300 201 264 324 315],276,4,6191,2.9593690248565965,20.0,20.0
2092,0,2092,[209 290 222 239 272],293,1,6192,2.95843287147635,20.0,20.0
2093,0,2093,[331 217 326 232 284],551,4,6196,2.958930276981853,0.0,0.0
2094,0,2094,[297 485 298 293 213],293,3,6199,2.958949880668258,0.0,20.0
2095,0,2095,[217 300 201 508 293],327,1,6200,2.9580152671755724,0.0,20.0
2096,0,2096,[206 230 420 300 201],276,5,6205,2.9589890319504053,0.0,20.0
2097,0,2097,[209 246 215 227 264],303,3,6208,2.959008579599619,0.0,0.0
2098,0,2098,[452 218 384 420 202],303,3,6211,2.959028108623154,0.0,0.0
2099,0,2099,[202 219 226 507 367],727,1,6212,2.958095238095238,0.0,0.0
2100,0,2100,[508 226 291 231 227],399,0,6212,2.956687291765826,0.0,0.0
2101,0,2101,[507 201 290 231 246],303,5,6217,2.957659372026641,0.0,0.0
2102,0,2102,[413 299 280 508 220],181,2,6219,2.9572039942938657,0.0,0.0
2103,0,2103,[218 583 211 259 240],682,2,6221,2.956749049429658,0.0,0.0
2104,0,2104,[239 255 384 251 211],299,2,6223,2.956294536817102,0.0,0.0
2105,0,2105,[264 276 254 209 291],276,2,6225,2.955840455840456,0.0,0.0
2106,0,2106,[367 295 222 243 236],592,2,6227,2.9553868058851447,0.0,20.0
2107,0,2107,[298 216 227 275 300],429,3,6230,2.955407969639469,0.0,60.0
2108,0,2108,[208 227 226 206 215],94,3,6233,2.9554291133238504,0.0,0.0
2109,0,2109,[268 222 230 208 216],868,1,6234,2.9545023696682464,0.0,60.0
2110,0,2110,[209 215 251 206 290],293,3,6237,2.954523922311701,0.0,0.0
2111,0,2111,[241 223 316 206 293],276,5,6242,2.9554924242424243,40.0,0.0
2112,0,2112,[507 201 232 413 239],727,2,6244,2.955040227165168,0.0,0.0
2113,0,2113,[226 431 255 509 218],682,1,6245,2.954115421002838,0.0,0.0
2114,0,2114,[331 246 293 315 255],592,4,6249,2.954609929078014,20.0,0.0
2115,0,2115,[413 378 275 392 239],727,2,6251,2.9541587901701325,0.0,0.0
2116,0,2116,[268 227 219 264 291],435,4,6255,2.954652810581011,0.0,20.0
2117,0,2117,[508 301 336 264 293],327,0,6255,2.953257790368272,0.0,0.0
2118,0,2118,[255 283 336 431 324],592,3,6258,2.9532798489853707,0.0,0.0
2119,0,2119,[268 251 336 299 236],181,0,6258,2.95188679245283,0.0,20.0
2120,0,2120,[297 211 303 485 226],293,3,6261,2.951909476661952,0.0,0.0
2121,0,2121,[299 241 219 202 365],682,3,6264,2.951932139491046,0.0,0.0
2122,0,2122,[280 202 384 215 217],551,2,6266,2.9514837494112105,0.0,0.0
2123,0,2123,[316 231 420 350 509],758,3,6269,2.9515065913371,20.0,0.0
2124,0,2124,[201 301 293 209 316],425,3,6272,2.9515294117647057,20.0,0.0
2125,0,2125,[222 215 392 261 268],222,4,6276,2.952022577610536,0.0,40.0
2126,0,2126,[251 485 206 250 272],293,3,6279,2.9520451339915375,20.0,0.0
2127,0,2127,[280 202 290 392 431],393,2,6281,2.9515977443609023,0.0,0.0
2128,0,2128,[218 280 208 230 394],880,2,6283,2.9511507750117425,0.0,0.0
2129,0,2129,[221 230 231 326 413],303,2,6285,2.9507042253521125,0.0,0.0
2130,0,2130,[321 276 275 507 227],429,3,6288,2.950727358047865,0.0,0.0
2131,0,2131,[284 216 222 217 221],201,1,6289,2.949812382739212,0.0,40.0
2132,0,2132,[336 326 221 201 223],592,4,6293,2.950304735114862,20.0,0.0
2133,0,2133,[392 215 365 201 290],276,3,6296,2.950328022492971,0.0,0.0
2134,0,2134,[232 218 429 223 272],276,4,6300,2.9508196721311477,40.0,0.0
2135,0,2135,[222 431 201 413 246],276,3,6303,2.9508426966292136,0.0,20.0
2136,0,2136,[300 250 324 230 201],327,2,6305,2.9503977538605524,0.0,20.0
2137,0,2137,[365 216 485 226 222],429,2,6307,2.949953227315248,0.0,40.0
2138,0,2138,[272 231 256 261 211],1,1,6308,2.949041608228144,20.0,0.0
2139,0,2139,[365 211 280 209 290],682,1,6309,2.9481308411214955,0.0,0.0
2140,0,2140,[219 217 301 392 222],429,2,6311,2.9476879962634284,0.0,20.0
2141,0,2141,[290 232 255 276 420],682,0,6311,2.946311858076564,0.0,0.0
2142,0,2142,[202 420 316 507 239],393,2,6313,2.945870275314979,20.0,0.0
2143,0,2143,[326 227 413 255 240],303,1,6314,2.9449626865671643,0.0,0.0
2144,0,2144,[300 227 222 290 213],293,0,6314,2.943589743589744,0.0,40.0
2145,0,2145,[218 583 230 268 215],303,3,6317,2.9436160298229264,0.0,20.0
2146,0,2146,[201 254 241 365 301],276,3,6320,2.943642291569632,0.0,0.0
2147,0,2147,[272 202 367 508 221],592,5,6325,2.9445996275605215,20.0,0.0
2148,0,2148,[583 268 218 303 275],201,3,6328,2.9446254071661238,0.0,20.0
2149,0,2149,[217 267 250 226 201],1,2,6330,2.944186046511628,0.0,0.0
2150,0,2150,[217 392 420 267 239],130,4,6334,2.9446768944676895,0.0,0.0
2151,0,2151,[226 250 217 276 241],916,4,6338,2.9451672862453533,0.0,0.0
2152,0,2152,[216 201 209 219 230],1,3,6341,2.9451927542963308,0.0,20.0
2153,0,2153,[209 298 290 291 232],429,4,6345,2.945682451253482,0.0,20.0
2154,0,2154,[300 367 240 315 250],880,3,6348,2.945707656612529,20.0,20.0
2155,0,2155,[324 240 209 230 431],276,4,6352,2.9461966604823746,0.0,0.0
2156,0,2156,[284 217 201 232 241],429,1,6353,2.9452943903569775,0.0,0.0
2157,0,2157,[241 331 232 293 202],178,5,6358,2.9462465245597778,0.0,0.0
2158,0,2158,[201 230 254 243 220],1,1,6359,2.9453450671607224,0.0,0.0
2159,0,2159,[208 202 420 378 384],472,3,6362,2.9453703703703704,0.0,0.0
2160,0,2160,[202 280 215 509 429],293,2,6364,2.944932901434521,0.0,0.0
2161,0,2161,[216 268 452 365 211],846,2,6366,2.944495837187789,0.0,40.0
2162,0,2162,[392 231 230 478 509],846,2,6368,2.944059177068886,20.0,0.0
2163,0,2163,[208 209 316 508 481],747,4,6372,2.944547134935305,20.0,0.0
2164,0,2164,[301 394 217 231 392],880,2,6374,2.944110854503464,0.0,0.0
2165,0,2165,[222 202 244 246 293],919,1,6375,2.943213296398892,0.0,20.0
2166,0,2166,[218 378 365 429 217],846,3,6378,2.9432395016151363,0.0,0.0
2167,0,2167,[298 236 276 244 301],936,4,6382,2.9437269372693726,0.0,20.0
2168,0,2168,[250 413 240 232 208],222,1,6383,2.942830797602582,0.0,0.0
2169,0,2169,[583 298 218 232 431],429,3,6386,2.942857142857143,0.0,20.0
2170,0,2170,[218 206 232 259 298],268,0,6386,2.9415016121602946,0.0,20.0
2171,0,2171,[300 315 226 250 291],293,0,6386,2.940147329650092,20.0,20.0
2172,0,2172,[321 324 239 255 290],303,2,6388,2.9397146801656695,0.0,0.0
2173,0,2173,[420 316 300 301 212],758,2,6390,2.939282428702852,20.0,20.0
2174,0,2174,[217 293 219 508 231],276,4,6394,2.9397701149425286,0.0,0.0
2175,0,2175,[508 316 280 246 241],178,4,6398,2.9402573529411766,20.0,0.0
2176,0,2176,[275 315 218 507 211],293,2,6400,2.939825447864033,20.0,0.0
2177,0,2177,[218 216 272 241 452],758,3,6403,2.9398530762167128,20.0,20.0
2178,0,2178,[300 201 202 431 227],301,4,6407,2.940339605323543,0.0,20.0
2179,0,2179,[293 218 219 326 209],425,1,6408,2.9394495412844037,0.0,0.0
2180,0,2180,[272 384 420 230 217],276,4,6412,2.9399358092618066,20.0,0.0
2181,0,2181,[211 384 221 236 508],758,4,6416,2.9404216315307057,0.0,0.0
2182,0,2182,[246 215 413 236 268],303,4,6420,2.940907008703619,0.0,20.0
2183,0,2183,[201 226 284 321 209],303,4,6424,2.9413919413919416,0.0,0.0
2184,0,2184,[299 394 201 246 208],880,4,6428,2.9418764302059497,0.0,0.0
2185,0,2185,[321 301 218 209 217],429,1,6429,2.9409881061299177,0.0,0.0
2186,0,2186,[331 413 272 201 217],201,2,6431,2.9405578417924096,20.0,0.0
2187,0,2187,[301 431 223 255 326],592,3,6434,2.9405850091407677,20.0,0.0
2188,0,2188,[303 250 420 213 315],758,4,6438,2.941068981269986,20.0,0.0
2189,0,2189,[240 452 223 431 420],758,1,6439,2.9401826484018265,20.0,0.0
2190,0,2190,[298 230 244 232 367],178,3,6442,2.9402099497946144,0.0,20.0
2191,0,2191,[272 255 256 261 231],1,1,6443,2.9393248175182483,20.0,0.0
2192,0,2192,[227 222 230 290 280],347,4,6447,2.9398084815321477,0.0,20.0
2193,0,2193,[284 226 268 230 217],727,1,6448,2.9389243391066544,0.0,20.0
2194,0,2194,[384 209 316 215 264],276,3,6451,2.9389521640091116,20.0,0.0
2195,0,2195,[241 276 219 392 280],429,2,6453,2.9385245901639343,0.0,0.0
2196,0,2196,[201 321 246 218 226],327,2,6455,2.9380974055530267,0.0,0.0
2197,0,2197,[215 211 276 222 212],201,2,6457,2.937670609645132,0.0,20.0
2198,0,2198,[211 272 217 315 239],293,2,6459,2.937244201909959,40.0,0.0
2199,0,2199,[240 231 239 226 246],1,2,6461,2.936818181818182,0.0,0.0
2200,0,2200,[301 239 230 300 208],880,3,6464,2.9368468877782825,0.0,20.0
2201,0,2201,[218 251 280 255 507],293,2,6466,2.9364214350590374,0.0,0.0
2202,0,2202,[240 452 291 431 301],276,2,6468,2.9359963685882886,0.0,0.0
2203,0,2203,[431 215 209 239 284],201,0,6468,2.9346642468239565,0.0,0.0
2204,0,2204,[215 216 315 336 293],592,4,6472,2.9351473922902493,20.0,20.0
2205,0,2205,[208 507 298 264 293],303,4,6476,2.9356300997280145,0.0,20.0
2206,0,2206,[217 280 298 378 250],682,3,6479,2.9356592659719074,0.0,20.0
2207,0,2207,[298 508 202 420 250],303,5,6484,2.9365942028985508,0.0,20.0
2208,0,2208,[209 223 216 261 239],1,4,6488,2.9370755998189226,20.0,20.0
2209,0,2209,[384 293 239 303 431],276,3,6491,2.93710407239819,0.0,0.0
2210,0,2210,[240 209 211 303 239],293,2,6493,2.9366802351876977,0.0,0.0
2211,0,2211,[223 221 315 202 217],758,3,6496,2.9367088607594938,40.0,0.0
2212,0,2212,[276 431 240 209 268],561,2,6498,2.936285585178491,0.0,20.0
2213,0,2213,[583 219 216 209 268],327,3,6501,2.9363143631436315,0.0,40.0
2214,0,2214,[431 227 215 231 211],660,2,6503,2.9358916478555304,0.0,0.0
2215,0,2215,[202 211 227 244 431],916,2,6505,2.9354693140794224,0.0,0.0
2216,0,2216,[201 230 378 219 217],429,1,6506,2.934596301308074,0.0,0.0
2217,0,2217,[583 226 219 290 239],276,4,6510,2.935076645626691,0.0,0.0
2218,0,2218,[420 231 268 259 232],682,1,6511,2.9342045966651646,0.0,20.0
2219,0,2219,[508 276 315 259 236],592,3,6514,2.9342342342342342,20.0,0.0
2220,0,2220,[209 250 303 280 300],293,1,6515,2.933363349842413,0.0,20.0
2221,0,2221,[218 331 324 241 452],276,4,6519,2.933843384338434,0.0,0.0
2222,0,2222,[301 284 290 227 321],429,0,6519,2.932523616734143,0.0,0.0
2223,0,2223,[209 384 241 232 244],268,2,6521,2.9321043165467624,0.0,0.0
2224,0,2224,[241 246 293 202 232],222,3,6524,2.932134831460674,0.0,0.0
2225,0,2225,[208 392 291 275 226],727,3,6527,2.9321653189577717,0.0,0.0
2226,0,2226,[508 268 300 284 254],276,4,6531,2.932644813650651,0.0,40.0
2227,0,2227,[315 429 280 291 272],293,2,6533,2.932226211849192,40.0,0.0
2228,0,2228,[268 367 291 243 246],592,3,6536,2.9322566173171825,0.0,20.0
2229,0,2229,[226 508 217 321 324],201,2,6538,2.9318385650224217,0.0,0.0
2230,0,2230,[431 268 201 299 202],592,3,6541,2.931869116987898,0.0,20.0
2231,0,2231,[251 384 290 222 293],303,3,6544,2.931899641577061,0.0,20.0
2232,0,2232,[223 226 331 284 326],551,5,6549,2.9328257948947605,20.0,0.0
2233,0,2233,[293 508 222 255 420],303,4,6553,2.933303491495076,0.0,20.0
2234,0,2234,[384 420 452 236 223],303,3,6556,2.933333333333333,20.0,0.0
2235,0,2235,[209 217 232 331 291],551,4,6560,2.933810375670841,0.0,0.0
2236,0,2236,[298 331 211 208 206],435,5,6565,2.934734018775145,0.0,20.0
2237,0,2237,[240 208 259 300 384],299,2,6567,2.9343163538873993,0.0,20.0
2238,0,2238,[246 290 280 241 420],682,2,6569,2.933899062081286,0.0,0.0
2239,0,2239,[222 298 508 413 367],276,3,6572,2.9339285714285714,0.0,40.0
2240,0,2240,[298 213 216 290 344],758,4,6576,2.9344042838018742,0.0,40.0
2241,0,2241,[264 298 390 384 221],303,2,6578,2.9339875111507583,0.0,20.0
2242,0,2242,[241 280 243 219 293],682,2,6580,2.9335711101203743,0.0,0.0
2243,0,2243,[367 326 227 284 226],222,1,6581,2.9327094474153297,0.0,0.0
2244,0,2244,[217 583 267 384 290],268,1,6582,2.93184855233853,0.0,0.0
2245,0,2245,[217 243 230 254 259],660,1,6583,2.9309884238646484,0.0,0.0
2246,0,2246,[293 268 290 230 240],130,3,6586,2.931019136626613,0.0,20.0
2247,0,2247,[276 384 219 201 226],303,4,6590,2.9314946619217084,0.0,0.0
2248,0,2248,[209 201 240 264 390],303,2,6592,2.9310804802134283,0.0,0.0
2249,0,2249,[290 293 276 392 300],347,2,6594,2.9306666666666668,0.0,20.0
2250,0,2250,[209 367 246 213 275],58,5,6599,2.9315859617947577,0.0,0.0
2251,0,2251,[298 326 241 230 209],606,3,6602,2.931616341030195,0.0,20.0
2252,0,2252,[367 246 219 268 272],682,3,6605,2.931646693297825,20.0,20.0
2253,0,2253,[324 365 290 226 264],276,3,6608,2.9316770186335406,0.0,0.0
2254,0,2254,[321 216 231 202 507],429,3,6611,2.9317073170731707,0.0,20.0
2255,0,2255,[283 392 367 291 507],393,2,6613,2.931294326241135,0.0,0.0
2256,0,2256,[284 213 216 251 316],293,2,6615,2.9308817013735045,20.0,20.0
2257,0,2257,[508 217 365 583 300],551,3,6618,2.9309123117803364,0.0,20.0
2258,0,2258,[219 239 240 275 206],201,2,6620,2.930500221336875,0.0,0.0
2259,0,2259,[226 216 367 264 508],429,2,6622,2.9300884955752213,0.0,20.0
2260,0,2260,[507 227 315 321 392],393,3,6625,2.9301194161875275,20.0,0.0
2261,0,2261,[211 217 202 431 230],94,3,6628,2.9301503094606542,0.0,0.0
2262,0,2262,[222 299 254 431 384],682,3,6631,2.930181175430844,0.0,20.0
2263,0,2263,[246 297 326 295 508],592,5,6636,2.931095406360424,0.0,0.0
2264,0,2264,[303 268 326 290 264],181,0,6636,2.929801324503311,0.0,20.0
2265,0,2265,[240 219 202 227 222],130,4,6640,2.93027360988526,0.0,20.0
2266,0,2266,[246 431 299 251 255],592,3,6643,2.9303043670048523,0.0,0.0
2267,0,2267,[236 240 367 420 255],130,5,6648,2.931216931216931,0.0,0.0
2268,0,2268,[429 218 367 276 217],301,3,6651,2.9312472454825915,0.0,0.0
2269,0,2269,[268 218 478 219 209],327,4,6655,2.9317180616740086,20.0,20.0
2270,0,2270,[241 246 223 300 478],178,5,6660,2.9326287978863936,40.0,20.0
2271,0,2271,[301 223 206 413 315],276,4,6664,2.933098591549296,40.0,0.0
2272,0,2272,[223 268 272 315 211],201,2,6666,2.9326880774307083,60.0,20.0
2273,0,2273,[219 284 216 221 276],303,5,6671,2.9335971855760774,0.0,20.0
2274,0,2274,[384 239 284 268 583],268,2,6673,2.933186813186813,0.0,20.0
2275,0,2275,[508 293 481 344 208],758,3,6676,2.9332161687170473,0.0,0.0
2276,0,2276,[239 201 218 241 209],268,1,6677,2.9323671497584543,0.0,0.0
2277,0,2277,[226 212 268 367 478],846,5,6682,2.9332748024582966,20.0,20.0
2278,0,2278,[211 316 272 367 250],293,2,6684,2.9328652917946467,40.0,0.0
2279,0,2279,[213 239 280 485 255],293,0,6684,2.931578947368421,0.0,0.0
2280,0,2280,[227 324 254 284 230],276,4,6688,2.9320473476545375,0.0,0.0
2281,0,2281,[301 223 508 222 297],758,4,6692,2.932515337423313,20.0,20.0
2282,0,2282,[232 283 316 303 509],293,1,6693,2.9316688567674114,20.0,0.0
2283,0,2283,[413 216 431 213 206],201,2,6695,2.931260945709282,0.0,20.0
2284,0,2284,[241 290 239 291 316],393,4,6699,2.9317286652078773,20.0,0.0
2285,0,2285,[384 268 201 431 202],682,4,6703,2.932195975503062,0.0,20.0
2286,0,2286,[222 216 239 240 231],267,5,6708,2.9331001311762135,0.0,40.0
2287,0,2287,[216 221 303 336 350],592,4,6712,2.9335664335664338,0.0,20.0
2288,0,2288,[241 243 209 420 246],682,2,6714,2.9331585845347314,0.0,0.0
2289,0,2289,[217 219 216 230 413],222,3,6717,2.933187772925764,0.0,20.0
2290,0,2290,[255 213 244 232 259],1,0,6717,2.9319074639895244,0.0,0.0
2291,0,2291,[293 301 431 223 226],276,4,6721,2.932373472949389,20.0,0.0
2292,0,2292,[336 315 215 264 212],363,1,6722,2.9315307457479283,20.0,0.0
2293,0,2293,[509 276 264 213 239],299,3,6725,2.9315605928509156,0.0,0.0
2294,0,2294,[250 452 227 297 241],758,3,6728,2.931590413943355,0.0,0.0
2295,0,2295,[431 264 508 222 326],592,2,6730,2.931184668989547,0.0,20.0
2296,0,2296,[230 208 222 283 431],790,1,6731,2.930343926861123,0.0,20.0
2297,0,2297,[227 231 291 431 290],429,2,6733,2.9299390774586596,0.0,0.0
2298,0,2298,[280 367 216 290 244],916,2,6735,2.9295345802522834,0.0,20.0
2299,0,2299,[276 230 217 378 261],222,2,6737,2.929130434782609,0.0,0.0
2300,0,2300,[268 478 283 367 220],178,4,6741,2.9295958279009127,20.0,20.0
2301,0,2301,[202 226 284 240 213],293,0,6741,2.9283231972198087,0.0,0.0
2302,0,2302,[239 223 420 255 431],393,3,6744,2.928354320451585,20.0,0.0
2303,0,2303,[202 583 217 219 215],551,3,6747,2.9283854166666665,0.0,0.0
2304,0,2304,[298 255 508 246 250],432,3,6750,2.928416485900217,0.0,20.0
2305,0,2305,[290 390 216 301 231],286,2,6752,2.928013876843018,0.0,20.0
2306,0,2306,[239 280 392 226 231],880,2,6754,2.927611616818379,0.0,0.0
2307,0,2307,[244 211 222 298 240],299,2,6756,2.927209705372617,0.0,40.0
2308,0,2308,[284 222 202 290 283],303,3,6759,2.9272412299696837,0.0,20.0
2309,0,2309,[298 291 365 222 367],429,3,6762,2.9272727272727272,0.0,40.0
2310,0,2310,[284 431 231 230 219],943,2,6764,2.9268714842059715,0.0,0.0
2311,0,2311,[241 481 509 231 384],758,3,6767,2.9269031141868513,0.0,0.0
2312,0,2312,[232 276 264 211 431],429,4,6771,2.927367055771725,0.0,0.0
2313,0,2313,[367 365 378 275 290],429,1,6772,2.926534140017286,0.0,0.0
2314,0,2314,[420 226 240 251 227],293,2,6774,2.926133909287257,0.0,0.0
2315,0,2315,[413 222 583 239 509],201,0,6774,2.9248704663212437,0.0,20.0
2316,0,2316,[384 291 413 321 208],303,1,6775,2.924039706517048,0.0,0.0
2317,0,2317,[226 583 250 209 367],293,0,6775,2.9227782571182055,0.0,0.0
2318,0,2318,[384 431 331 315 303],758,4,6779,2.923242777059077,20.0,0.0
2319,0,2319,[230 384 256 429 201],363,1,6780,2.9224137931034484,0.0,0.0
2320,0,2320,[206 218 213 239 240],293,1,6781,2.921585523481258,0.0,0.0
2321,0,2321,[431 452 230 508 250],896,1,6782,2.920757967269595,0.0,0.0
2322,0,2322,[291 272 326 276 231],130,4,6786,2.9212225570383126,20.0,0.0
2323,0,2323,[232 276 259 244 268],178,2,6788,2.9208261617900173,0.0,20.0
2324,0,2324,[226 254 293 202 219],130,4,6792,2.9212903225806452,0.0,0.0
2325,0,2325,[485 208 227 291 232],293,0,6792,2.9200343938091144,0.0,0.0
2326,0,2326,[384 232 219 420 223],291,5,6797,2.9209282337773956,20.0,0.0
2327,0,2327,[583 413 251 239 218],303,2,6799,2.92053264604811,0.0,0.0
2328,0,2328,[240 276 217 315 272],276,5,6804,2.9214255045083726,40.0,0.0
2329,0,2329,[217 298 367 222 583],276,3,6807,2.9214592274678113,0.0,40.0
2330,0,2330,[202 222 232 206 226],94,1,6808,2.9206349206349205,0.0,20.0
2331,0,2331,[226 481 293 583 508],429,2,6810,2.920240137221269,0.0,0.0
2332,0,2332,[255 216 392 259 226],487,2,6812,2.919845692241749,0.0,20.0
2333,0,2333,[208 240 283 280 420],293,1,6813,2.9190231362467864,0.0,0.0
2334,0,2334,[431 230 236 290 215],916,1,6814,2.9182012847965737,0.0,0.0
2335,0,2335,[298 232 272 429 241],425,3,6817,2.918236301369863,20.0,20.0
2336,0,2336,[290 316 227 201 208],363,2,6819,2.9178433889602053,20.0,0.0
2337,0,2337,[259 250 243 236 431],592,1,6820,2.917023096663815,0.0,0.0
2338,0,2338,[215 384 509 250 378],682,2,6822,2.916631038905515,0.0,0.0
2339,0,2339,[212 244 251 478 367],299,4,6826,2.917094017094017,20.0,0.0
2340,0,2340,[208 283 212 256 429],363,2,6828,2.916702263989748,0.0,0.0
2341,0,2341,[240 215 250 268 384],435,2,6830,2.9163108454312554,0.0,20.0
2342,0,2342,[384 219 420 211 231],682,1,6831,2.915492957746479,0.0,0.0
2343,0,2343,[208 284 255 367 315],293,0,6831,2.914249146757679,20.0,0.0
2344,0,2344,[331 509 230 201 276],201,3,6834,2.914285714285714,0.0,0.0
2345,0,2345,[208 267 254 218 216],1,3,6837,2.914322250639386,0.0,20.0
2346,0,2346,[202 452 240 301 420],758,1,6838,2.9135066041755433,0.0,0.0
2347,0,2347,[413 392 240 507 218],495,5,6843,2.914395229982964,0.0,0.0
2348,0,2348,[219 268 218 452 239],442,1,6844,2.9135802469135803,0.0,20.0
2349,0,2349,[202 508 211 232 209],407,4,6848,2.9140425531914893,0.0,0.0
2350,0,2350,[222 226 218 230 211],551,5,6853,2.914929817099107,0.0,20.0
2351,0,2351,[232 452 217 378 230],868,0,6853,2.9136904761904763,0.0,0.0
2352,0,2352,[250 223 232 231 508],303,5,6858,2.914577135571611,20.0,0.0
2353,0,2353,[452 300 297 350 227],758,3,6861,2.9146134239592185,0.0,20.0
2354,0,2354,[290 316 202 300 420],758,3,6864,2.914649681528662,20.0,20.0
2355,0,2355,[209 392 583 219 215],94,3,6867,2.914685908319185,0.0,0.0
2356,0,2356,[219 215 324 367 336],327,3,6870,2.914722104369962,0.0,0.0
2357,0,2357,[384 583 222 507 223],303,2,6872,2.914334181509754,20.0,20.0
2358,0,2358,[241 507 212 284 431],561,1,6873,2.9135226791013142,0.0,0.0
2359,0,2359,[226 315 303 209 268],201,1,6874,2.9127118644067798,20.0,20.0
2360,0,2360,[206 299 420 268 255],435,4,6878,2.9131723845828037,0.0,20.0
2361,0,2361,[206 202 298 246 431],276,4,6882,2.9136325148179507,0.0,20.0
2362,0,2362,[255 236 321 284 420],303,4,6886,2.914092255607279,0.0,0.0
2363,0,2363,[301 300 293 583 280],429,1,6887,2.9132825719120135,0.0,20.0
2364,0,2364,[261 259 216 218 240],1,1,6888,2.9124735729386892,0.0,20.0
2365,0,2365,[583 226 315 429 298],276,4,6892,2.9129332206255283,20.0,20.0
2366,0,2366,[280 201 243 202 284],682,3,6895,2.912970004224757,0.0,0.0
2367,0,2367,[298 350 246 300 284],130,4,6899,2.913429054054054,0.0,40.0
2368,0,2368,[219 236 290 201 221],303,5,6904,2.9143098353735755,0.0,0.0
2369,0,2369,[223 284 221 321 236],303,4,6908,2.9147679324894513,20.0,0.0
2370,0,2370,[259 367 508 478 216],178,3,6911,2.9148038802193166,20.0,20.0
2371,0,2371,[291 219 420 392 208],435,4,6915,2.9152613827993257,0.0,0.0
2372,0,2372,[508 316 324 583 211],551,3,6918,2.9152970922882426,20.0,0.0
2373,0,2373,[509 321 241 222 331],201,1,6919,2.914490311710194,0.0,20.0
2374,0,2374,[208 261 231 392 218],222,2,6921,2.9141052631578948,0.0,0.0
2375,0,2375,[336 291 280 326 324],181,1,6922,2.9132996632996635,0.0,0.0
2376,0,2376,[230 222 217 420 452],276,4,6926,2.9137568363483384,0.0,20.0
2377,0,2377,[344 315 301 236 250],758,3,6929,2.913793103448276,20.0,0.0
2378,0,2378,[201 240 259 219 321],21,3,6932,2.9138293400588484,0.0,0.0
2379,0,2379,[324 259 244 218 321],21,3,6935,2.9138655462184873,0.0,0.0
2380,0,2380,[254 211 259 209 216],660,3,6938,2.9139017219655607,0.0,20.0
2381,0,2381,[420 202 300 392 331],435,3,6941,2.913937867338371,0.0,20.0
2382,0,2382,[268 261 431 202 218],222,4,6945,2.9143936214855226,0.0,20.0
2383,0,2383,[384 290 272 301 239],758,3,6948,2.914429530201342,20.0,0.0
2384,0,2384,[213 215 243 256 220],1,1,6949,2.9136268343815512,0.0,0.0
2385,0,2385,[280 217 250 218 219],916,2,6951,2.913243922883487,0.0,0.0
2386,0,2386,[219 508 365 324 315],276,4,6955,2.9136992040217846,20.0,0.0
2387,0,2387,[226 209 222 201 223],561,2,6957,2.913316582914573,20.0,20.0
2388,0,2388,[215 240 315 413 216],130,4,6961,2.913771452490582,20.0,20.0
2389,0,2389,[202 241 303 219 221],201,1,6962,2.912970711297071,0.0,0.0
2390,0,2390,[254 230 232 291 331],276,2,6964,2.9125888749477205,0.0,0.0
2391,0,2391,[268 201 367 216 239],561,0,6964,2.911371237458194,0.0,40.0
2392,0,2392,[298 478 297 429 507],567,4,6968,2.9118261596322608,20.0,20.0
2393,0,2393,[261 326 508 264 246],592,3,6971,2.9118629908103593,0.0,0.0
2394,0,2394,[226 384 485 222 215],472,3,6974,2.9118997912317326,0.0,20.0
2395,0,2395,[431 218 215 268 231],222,4,6978,2.9123539232053424,0.0,20.0
2396,0,2396,[202 211 226 255 216],682,3,6981,2.9123904881101375,0.0,20.0
2397,0,2397,[227 392 321 239 222],435,2,6983,2.9120100083402836,0.0,20.0
2398,0,2398,[367 283 241 324 239],303,2,6985,2.9116298457690704,0.0,0.0
2399,0,2399,[300 231 243 215 293],682,2,6987,2.91125,0.0,20.0
2400,0,2400,[300 202 250 230 507],293,1,6988,2.910453977509371,0.0,20.0
2401,0,2401,[206 324 219 223 431],276,4,6992,2.9109075770191506,20.0,0.0
2402,0,2402,[208 250 316 429 227],660,4,6996,2.9113607990012484,20.0,0.0
2403,0,2403,[293 208 284 218 250],363,2,6998,2.910981697171381,0.0,0.0
2404,0,2404,[230 331 392 420 272],130,3,7001,2.911018711018711,20.0,0.0
2405,0,2405,[280 223 232 213 250],293,1,7002,2.910224438902743,20.0,0.0
2406,0,2406,[250 324 300 478 301],327,1,7003,2.909430826755297,20.0,20.0
2407,0,2407,[216 215 226 485 240],532,4,7007,2.9098837209302326,0.0,20.0
2408,0,2408,[303 350 431 298 293],758,3,7010,2.909921129099211,0.0,20.0
2409,0,2409,[280 219 246 212 583],916,3,7013,2.9099585062240663,0.0,0.0
2410,0,2410,[300 275 384 478 251],299,4,7017,2.9104106180008293,20.0,20.0
2411,0,2411,[239 293 240 276 291],130,5,7022,2.9112769485903813,0.0,0.0
2412,0,2412,[226 217 276 216 215],916,3,7025,2.9113137173642767,0.0,20.0
2413,0,2413,[324 344 431 297 295],592,4,7029,2.911764705882353,0.0,0.0
2414,0,2414,[250 255 239 202 264],293,0,7029,2.91055900621118,0.0,0.0
2415,0,2415,[452 507 264 239 250],303,2,7031,2.910182119205298,0.0,0.0
2416,0,2416,[413 222 239 212 284],201,1,7032,2.909391808026479,0.0,20.0
2417,0,2417,[236 508 231 240 316],758,3,7035,2.9094292803970223,20.0,0.0
2418,0,2418,[250 211 218 301 222],429,2,7037,2.9090533278214137,0.0,20.0
2419,0,2419,[272 239 315 211 215],201,0,7037,2.9078512396694216,40.0,0.0
2420,0,2420,[201 250 206 246 232],1,3,7040,2.9078893019413465,0.0,0.0
2421,0,2421,[239 216 222 250 431],249,4,7044,2.908340214698596,0.0,40.0
2422,0,2422,[213 291 481 236 331],758,5,7049,2.9092034667767233,0.0,0.0
2423,0,2423,[321 217 226 299 255],435,3,7052,2.9092409240924093,0.0,0.0
2424,0,2424,[250 218 209 215 280],178,4,7056,2.9096907216494845,0.0,0.0
2425,0,2425,[243 298 367 230 202],880,3,7059,2.9097279472382525,0.0,20.0
2426,0,2426,[236 213 315 303 241],758,4,7063,2.9101771734651836,20.0,0.0
2427,0,2427,[284 264 202 431 293],429,3,7066,2.9102141680395386,0.0,0.0
2428,0,2428,[223 206 255 275 211],293,3,7069,2.9102511321531495,20.0,0.0
2429,0,2429,[392 219 217 298 321],435,3,7072,2.910288065843621,0.0,20.0
2430,0,2430,[222 202 431 284 217],916,1,7073,2.909502262443439,0.0,20.0
2431,0,2431,[240 268 290 298 241],303,4,7077,2.9099506578947367,0.0,40.0
2432,0,2432,[218 431 315 276 219],551,5,7082,2.9108096999588984,20.0,0.0
2433,0,2433,[254 222 280 202 367],880,3,7085,2.910846343467543,0.0,20.0
2434,0,2434,[290 217 264 227 250],276,4,7089,2.91129363449692,0.0,0.0
2435,0,2435,[315 208 378 431 239],870,1,7090,2.9105090311986865,20.0,0.0
2436,0,2436,[298 336 295 221 236],592,3,7093,2.9105457529749694,0.0,20.0
2437,0,2437,[241 212 223 232 392],896,2,7095,2.910172272354389,20.0,0.0
2438,0,2438,[300 222 231 243 226],880,2,7097,2.90979909799098,0.0,40.0
2439,0,2439,[216 431 240 222 209],682,4,7101,2.9102459016393443,0.0,40.0
2440,0,2440,[315 431 219 276 272],870,2,7103,2.9098730028676774,40.0,0.0
2441,0,2441,[315 276 246 300 236],919,3,7106,2.90990990990991,20.0,20.0
2442,0,2442,[206 316 202 230 267],130,3,7109,2.909946786737618,20.0,0.0
2443,0,2443,[208 232 452 239 240],497,2,7111,2.9095744680851063,0.0,0.0
2444,0,2444,[222 202 303 291 298],592,3,7114,2.90961145194274,0.0,40.0
2445,0,2445,[392 384 202 208 291],435,3,7117,2.909648405560098,0.0,0.0
2446,0,2446,[246 230 384 276 241],303,3,7120,2.909685328974254,0.0,0.0
2447,0,2447,[431 297 290 211 250],758,4,7124,2.9101307189542482,0.0,0.0
2448,0,2448,[392 222 208 232 202],222,4,7128,2.9105757452021233,0.0,20.0
2449,0,2449,[299 209 452 202 481],896,1,7129,2.909795918367347,0.0,0.0
2450,0,2450,[243 350 202 227 299],130,2,7131,2.909424724602203,0.0,0.0
2451,0,2451,[276 227 244 206 509],916,3,7134,2.909461663947798,0.0,0.0
2452,0,2452,[301 202 230 217 300],429,1,7135,2.908683245006115,0.0,20.0
2453,0,2453,[219 259 452 298 324],303,2,7137,2.9083129584352077,0.0,20.0
2454,0,2454,[217 509 275 232 208],293,0,7137,2.9071283095723013,0.0,0.0
2455,0,2455,[202 223 236 283 303],592,4,7141,2.90757328990228,20.0,0.0
2456,0,2456,[299 218 324 452 291],21,3,7144,2.907610907610908,0.0,0.0
2457,0,2457,[246 365 284 394 367],880,3,7147,2.907648494711147,0.0,0.0
2458,0,2458,[213 275 452 326 240],201,2,7149,2.9072793818625455,0.0,0.0
2459,0,2459,[223 272 300 216 208],293,3,7152,2.9073170731707316,40.0,40.0
2460,0,2460,[255 213 216 236 230],1,3,7155,2.9073547338480292,0.0,20.0
2461,0,2461,[219 209 230 247 206],1,3,7158,2.9073923639317627,0.0,0.0
2462,0,2462,[392 250 201 232 316],880,3,7161,2.907429963459196,20.0,0.0
2463,0,2463,[350 227 217 431 256],363,1,7162,2.906655844155844,0.0,0.0
2464,0,2464,[384 219 250 215 211],435,3,7165,2.9066937119675456,0.0,0.0
2465,0,2465,[413 202 583 431 303],276,2,7167,2.90632603406326,0.0,0.0
2466,0,2466,[259 478 239 211 481],299,2,7169,2.905958654235914,20.0,0.0
2467,0,2467,[291 227 301 293 481],758,3,7172,2.905996758508914,0.0,0.0
2468,0,2468,[232 227 321 241 231],201,1,7173,2.905224787363305,0.0,0.0
2469,0,2469,[232 420 365 250 508],276,3,7176,2.905263157894737,0.0,0.0
2470,0,2470,[284 222 583 231 213],790,2,7178,2.9048968029138003,0.0,20.0
2471,0,2471,[293 243 392 321 250],130,3,7181,2.904935275080906,0.0,0.0
2472,0,2472,[303 336 301 315 299],863,2,7183,2.9045693489688635,20.0,0.0
2473,0,2473,[254 276 392 420 201],276,3,7186,2.904607922392886,0.0,0.0
2474,0,2474,[298 206 324 272 227],276,5,7191,2.9054545454545453,20.0,20.0
2475,0,2475,[250 239 209 413 219],276,4,7195,2.905896607431341,0.0,0.0
2476,0,2476,[259 283 221 315 331],592,3,7198,2.9059345983044005,20.0,0.0
2477,0,2477,[508 215 300 217 324],327,1,7199,2.9051654560129134,0.0,20.0
2478,0,2478,[243 259 230 211 272],660,3,7202,2.9052037111738604,20.0,0.0
2479,0,2479,[208 272 315 300 226],293,1,7203,2.9044354838709676,40.0,20.0
2480,0,2480,[202 509 211 431 392],94,3,7206,2.9044740024183797,0.0,0.0
2481,0,2481,[232 276 255 219 251],303,5,7211,2.9053182917002416,0.0,0.0
2482,0,2482,[206 284 275 303 429],293,3,7214,2.905356423681031,0.0,0.0
2483,0,2483,[384 209 217 259 211],682,2,7216,2.9049919484702094,0.0,0.0
2484,0,2484,[215 226 231 413 326],222,2,7218,2.9046277665995976,0.0,0.0
2485,0,2485,[367 420 246 239 218],303,4,7222,2.905068382944489,0.0,0.0
2486,0,2486,[303 324 452 240 202],276,4,7226,2.9055086449537595,0.0,0.0
2487,0,2487,[276 218 300 301 268],608,2,7228,2.905144694533762,0.0,40.0
2488,0,2488,[413 209 452 231 223],109,1,7229,2.9043792687826437,20.0,0.0
2489,0,2489,[221 244 251 226 230],1,3,7232,2.9044176706827307,0.0,0.0
2490,0,2490,[384 222 420 246 290],435,2,7234,2.9040545965475713,0.0,20.0
2491,0,2491,[264 300 276 275 485],429,2,7236,2.903691813804173,0.0,20.0
2492,0,2492,[227 261 239 315 293],130,4,7240,2.904131568391496,20.0,0.0
2493,0,2493,[236 261 331 240 299],181,0,7240,2.9029671210906174,0.0,0.0
2494,0,2494,[303 485 231 223 276],747,4,7244,2.9034068136272544,20.0,0.0
2495,0,2495,[384 230 290 284 246],268,1,7245,2.902644230769231,0.0,0.0
2496,0,2496,[250 324 272 413 508],276,4,7249,2.9030837004405288,20.0,0.0
2497,0,2497,[324 222 272 227 384],551,3,7252,2.9031224979983987,20.0,20.0
2498,0,2498,[268 250 241 222 208],222,2,7254,2.902761104441777,0.0,40.0
2499,0,2499,[290 507 293 420 300],293,3,7257,2.9028,0.0,20.0
2500,0,2500,[208 431 365 232 259],790,2,7259,2.902439024390244,0.0,0.0
2501,0,2501,[254 246 239 201 276],880,4,7263,2.902877697841727,0.0,0.0
2502,0,2502,[241 583 227 300 226],551,4,7267,2.90331602077507,0.0,20.0
2503,0,2503,[227 217 219 215 478],896,3,7270,2.9033546325878596,20.0,0.0
2504,0,2504,[230 254 250 215 219],435,2,7272,2.902994011976048,0.0,0.0
2505,0,2505,[583 211 219 276 231],682,1,7273,2.9022346368715084,0.0,0.0
2506,0,2506,[230 201 413 240 221],201,1,7274,2.901475867570802,0.0,0.0
2507,0,2507,[202 231 232 212 206],561,0,7274,2.9003189792663475,0.0,0.0
2508,0,2508,[324 264 413 222 301],276,3,7277,2.9003587086488642,0.0,20.0
2509,0,2509,[218 239 431 216 240],301,4,7281,2.900796812749004,0.0,20.0
2510,0,2510,[250 230 261 240 431],222,2,7283,2.900438072481083,0.0,0.0
2511,0,2511,[251 240 202 276 321],303,3,7286,2.9004777070063694,0.0,0.0
2512,0,2512,[431 201 264 222 303],592,2,7288,2.9001193792280144,0.0,20.0
2513,0,2513,[209 240 226 254 324],806,0,7288,2.8989657915672233,0.0,0.0
2514,0,2514,[246 215 272 284 291],276,4,7292,2.899403578528827,20.0,0.0
2515,0,2515,[293 227 232 222 420],303,3,7295,2.899443561208267,0.0,20.0
2516,0,2516,[413 293 230 239 267],130,3,7298,2.8994835121176004,0.0,0.0
2517,0,2517,[216 230 390 413 298],303,2,7300,2.8991262907069104,0.0,40.0
2518,0,2518,[324 331 209 218 219],276,5,7305,2.8999603017070266,0.0,0.0
2519,0,2519,[227 236 331 300 202],130,3,7308,2.9,0.0,20.0
2520,0,2520,[211 215 250 227 216],660,2,7310,2.899642998809996,0.0,20.0
2521,0,2521,[246 291 284 222 384],276,3,7313,2.8996827914353687,0.0,20.0
2522,0,2522,[293 219 246 276 255],222,3,7316,2.899722552516845,0.0,0.0
2523,0,2523,[264 231 251 216 367],303,4,7320,2.9001584786053884,0.0,20.0
2524,0,2524,[284 259 509 255 378],682,1,7321,2.8994059405940593,0.0,0.0
2525,0,2525,[326 232 507 255 250],303,4,7325,2.8998416468725257,0.0,0.0
2526,0,2526,[218 222 232 223 268],1,3,7328,2.89988128215275,20.0,40.0
2527,0,2527,[429 272 300 232 201],425,2,7330,2.899525316455696,20.0,20.0
2528,0,2528,[276 303 246 217 315],276,5,7335,2.900355871886121,20.0,0.0
2529,0,2529,[246 431 300 280 272],682,3,7338,2.900395256916996,20.0,20.0
2530,0,2530,[240 256 241 221 215],1,3,7341,2.9004346108257604,0.0,0.0
2531,0,2531,[295 298 272 300 301],624,3,7344,2.9004739336492893,20.0,40.0
2532,0,2532,[452 231 209 236 481],758,3,7347,2.900513225424398,0.0,0.0
2533,0,2533,[315 218 324 293 227],758,4,7351,2.9009471191791634,20.0,0.0
2534,0,2534,[226 208 508 293 218],303,5,7356,2.901775147928994,0.0,0.0
2535,0,2535,[202 291 321 216 300],303,2,7358,2.9014195583596214,0.0,40.0
2536,0,2536,[331 583 384 284 202],551,3,7361,2.9014584154513203,0.0,0.0
2537,0,2537,[227 236 243 250 230],130,1,7362,2.900709219858156,0.0,0.0
2538,0,2538,[293 231 246 367 230],130,3,7365,2.9007483261126428,0.0,0.0
2539,0,2539,[218 508 276 255 239],303,4,7369,2.9011811023622047,0.0,0.0
2540,0,2540,[291 217 239 231 299],130,2,7371,2.9008264462809916,0.0,0.0
2541,0,2541,[216 218 222 365 201],94,1,7372,2.9000786782061367,0.0,40.0
2542,0,2542,[239 222 298 303 316],393,5,7377,2.9009044435705857,20.0,40.0
2543,0,2543,[215 272 331 219 367],276,4,7381,2.9013364779874213,20.0,0.0
2544,0,2544,[508 230 264 226 241],429,1,7382,2.900589390962672,0.0,0.0
2545,0,2545,[300 241 276 431 583],276,3,7385,2.900628436763551,0.0,20.0
2546,0,2546,[231 222 293 481 230],429,2,7387,2.900274833137024,0.0,20.0
2547,0,2547,[261 212 227 267 208],1,4,7391,2.9007064364207222,0.0,0.0
2548,0,2548,[241 264 275 298 240],299,2,7393,2.900353079639074,0.0,20.0
2549,0,2549,[365 250 290 298 232],276,3,7396,2.900392156862745,0.0,20.0
2550,0,2550,[295 316 291 272 350],130,4,7400,2.9008232065856525,40.0,0.0
2551,0,2551,[324 301 240 226 227],276,5,7405,2.9016457680250785,0.0,0.0
2552,0,2552,[246 219 206 268 267],1,4,7409,2.902075989032511,0.0,20.0
2553,0,2553,[211 478 206 299 217],896,2,7411,2.9017227877838683,20.0,0.0
2554,0,2554,[300 384 298 209 243],880,1,7412,2.900978473581213,0.0,40.0
2555,0,2555,[222 431 223 508 215],551,5,7417,2.901799687010955,20.0,20.0
2556,0,2556,[226 267 208 230 231],1,3,7420,2.9018380915134925,0.0,0.0
2557,0,2557,[230 276 208 250 209],880,2,7422,2.901485535574668,0.0,0.0
2558,0,2558,[239 219 211 217 230],268,1,7423,2.9007424775302852,0.0,0.0
2559,0,2559,[250 230 344 208 231],758,3,7426,2.90078125,0.0,0.0
2560,0,2560,[226 429 367 431 217],846,4,7430,2.9012104646622414,0.0,0.0
2561,0,2561,[255 583 208 509 303],293,1,7431,2.9004683840749412,0.0,0.0
2562,0,2562,[300 222 413 326 324],303,0,7431,2.8993367147873585,0.0,40.0
2563,0,2563,[212 321 241 284 211],201,1,7432,2.8985959438377535,0.0,0.0
2564,0,2564,[212 213 223 240 300],758,3,7435,2.898635477582846,20.0,20.0
2565,0,2565,[508 261 250 240 226],130,4,7439,2.8990646921278254,0.0,0.0
2566,0,2566,[367 291 221 293 284],303,4,7443,2.8994935722633426,0.0,0.0
2567,0,2567,[303 222 209 240 297],293,2,7445,2.8991433021806854,0.0,20.0
2568,0,2568,[216 326 583 230 300],551,4,7449,2.899571817827949,0.0,40.0
2569,0,2569,[226 293 420 202 217],276,5,7454,2.9003891050583657,0.0,0.0
2570,0,2570,[223 250 241 350 227],758,4,7458,2.900816802800467,20.0,0.0
2571,0,2571,[250 246 452 316 300],276,4,7462,2.901244167962675,20.0,20.0
2572,0,2572,[217 316 284 301 295],500,2,7464,2.9008938981733383,20.0,0.0
2573,0,2573,[227 293 452 240 215],303,2,7466,2.9005439005439007,0.0,0.0
2574,0,2574,[508 272 303 240 315],758,4,7470,2.9009708737864077,40.0,0.0
2575,0,2575,[365 291 222 298 299],682,3,7473,2.9010093167701863,0.0,40.0
2576,0,2576,[275 240 413 226 232],201,1,7474,2.9002716336825767,0.0,0.0
2577,0,2577,[261 291 336 315 251],592,2,7476,2.899922420480993,20.0,0.0
2578,0,2578,[240 284 478 209 243],561,2,7478,2.8995734780922837,20.0,0.0
2579,0,2579,[303 301 300 293 226],276,5,7483,2.900387596899225,0.0,20.0
2580,0,2580,[303 365 227 222 298],276,4,7487,2.900813638124758,0.0,40.0
2581,0,2581,[222 223 231 241 431],561,1,7488,2.9000774593338496,20.0,20.0
2582,0,2582,[239 241 230 247 208],1,4,7492,2.900503290747193,0.0,0.0
2583,0,2583,[216 420 213 283 297],293,3,7495,2.9005417956656347,0.0,20.0
2584,0,2584,[315 452 367 293 240],276,3,7498,2.9005802707930366,20.0,0.0
2585,0,2585,[392 202 367 223 231],109,2,7500,2.9002320185614847,20.0,0.0
2586,0,2586,[300 303 222 384 290],758,4,7504,2.9006571318129106,0.0,40.0
2587,0,2587,[367 208 264 291 300],303,2,7506,2.900309119010819,0.0,20.0
2588,0,2588,[218 367 223 268 452],222,3,7509,2.900347624565469,20.0,20.0
2589,0,2589,[291 290 231 324 223],758,4,7513,2.900772200772201,20.0,0.0
2590,0,2590,[344 290 384 303 236],758,4,7517,2.901196449247395,0.0,0.0
2591,0,2591,[211 208 384 259 367],790,2,7519,2.900848765432099,0.0,0.0
2592,0,2592,[244 284 256 367 250],916,2,7521,2.9005013497878904,0.0,0.0
2593,0,2593,[259 291 201 283 241],303,2,7523,2.900154202004626,0.0,0.0
2594,0,2594,[259 239 246 291 217],727,4,7527,2.900578034682081,0.0,0.0
2595,0,2595,[215 256 261 209 221],1,3,7530,2.9006163328197228,0.0,0.0
2596,0,2596,[452 326 272 246 261],130,5,7535,2.901424720831729,20.0,0.0
2597,0,2597,[264 384 232 217 223],268,0,7535,2.9003079291762894,20.0,0.0
2598,0,2598,[298 429 316 392 331],276,4,7539,2.9007310504040014,20.0,20.0
2599,0,2599,[202 284 222 324 246],276,5,7544,2.9015384615384616,0.0,20.0
2600,0,2600,[283 481 216 202 378],299,2,7546,2.901191849288735,0.0,20.0
2601,0,2601,[507 217 280 485 283],293,1,7547,2.9004611837048424,0.0,0.0
2602,0,2602,[264 267 452 232 250],268,1,7548,2.8997310795236264,0.0,0.0
2603,0,2603,[212 290 250 236 316],758,5,7553,2.900537634408602,20.0,0.0
2604,0,2604,[219 394 202 222 215],435,3,7556,2.9005758157389634,0.0,20.0
2605,0,2605,[431 246 452 268 367],276,2,7558,2.90023023791251,0.0,20.0
2606,0,2606,[583 201 420 299 216],682,3,7561,2.9002685078634447,0.0,20.0
2607,0,2607,[508 324 331 268 275],201,5,7566,2.901073619631902,0.0,20.0
2608,0,2608,[394 215 223 509 276],864,4,7570,2.9014948256036797,20.0,0.0
2609,0,2609,[300 246 275 251 268],936,4,7574,2.9019157088122607,0.0,40.0
2610,0,2610,[367 213 315 202 206],293,1,7575,2.901187284565301,20.0,0.0
2611,0,2611,[209 239 284 230 268],880,3,7578,2.9012251148545176,0.0,20.0
2612,0,2612,[331 232 315 219 431],201,2,7580,2.9008802143130503,20.0,0.0
2613,0,2613,[247 202 239 293 218],222,3,7583,2.900918133129304,0.0,0.0
2614,0,2614,[211 226 215 230 431],435,2,7585,2.9005736137667304,0.0,0.0
2615,0,2615,[236 344 283 367 259],592,3,7588,2.900611620795107,0.0,0.0
2616,0,2616,[226 326 299 255 268],130,4,7592,2.9010317157050056,0.0,20.0
2617,0,2617,[219 239 223 246 232],399,0,7592,2.8999236058059585,20.0,0.0
2618,0,2618,[236 276 384 297 231],758,3,7595,2.8999618174875907,0.0,0.0
2619,0,2619,[206 291 284 420 392],130,3,7598,2.9,0.0,0.0
2620,0,2620,[230 283 239 222 232],363,1,7599,2.899275085845097,0.0,20.0
2621,0,2621,[367 316 232 255 326],178,5,7604,2.9000762776506486,20.0,0.0
2622,0,2622,[284 221 222 259 298],919,2,7606,2.8997331300038125,0.0,40.0
2623,0,2623,[508 324 507 478 246],327,3,7609,2.8997713414634148,20.0,0.0
2624,0,2624,[206 241 429 291 413],276,3,7612,2.8998095238095236,0.0,0.0
2625,0,2625,[293 243 280 295 316],880,3,7615,2.8998476770754,20.0,0.0
2626,0,2626,[240 211 217 452 216],495,4,7619,2.9002664636467452,0.0,20.0
2627,0,2627,[231 240 226 223 254],1,1,7620,2.8995433789954337,20.0,0.0
2628,0,2628,[219 420 326 246 250],130,4,7624,2.899961962723469,0.0,0.0
2629,0,2629,[272 350 299 413 420],130,3,7627,2.9,20.0,0.0
2630,0,2630,[232 216 202 291 275],293,1,7628,2.8992778411250475,0.0,20.0
2631,0,2631,[239 250 243 298 222],682,3,7631,2.899316109422492,0.0,40.0
2632,0,2632,[293 300 209 232 240],880,3,7634,2.899354348651728,0.0,20.0
2633,0,2633,[208 217 246 213 211],1,2,7636,2.8990129081245253,0.0,0.0
2634,0,2634,[231 216 208 223 230],303,4,7640,2.8994307400379506,20.0,20.0
2635,0,2635,[264 222 247 246 206],1,3,7643,2.8994688922610017,0.0,20.0
2636,0,2636,[201 219 209 211 240],727,2,7645,2.899127796738718,0.0,0.0
2637,0,2637,[508 392 276 485 316],747,4,7649,2.8995451099317666,20.0,0.0
2638,0,2638,[211 230 246 215 280],916,2,7651,2.8992042440318304,0.0,0.0
2639,0,2639,[211 215 268 326 241],201,1,7652,2.8984848484848484,0.0,20.0
2640,0,2640,[508 316 215 264 315],551,4,7656,2.8989019310867095,40.0,0.0
2641,0,2641,[240 365 217 431 284],682,4,7660,2.899318697956094,0.0,0.0
2642,0,2642,[211 239 231 365 222],109,4,7664,2.899735149451381,0.0,20.0
2643,0,2643,[367 202 246 272 254],682,3,7667,2.8997730711043874,20.0,0.0
2644,0,2644,[261 365 431 508 231],222,2,7669,2.8994328922495276,0.0,0.0
2645,0,2645,[283 221 297 321 275],919,4,7673,2.899848828420257,0.0,0.0
2646,0,2646,[216 219 303 331 272],201,3,7676,2.899886664148092,20.0,20.0
2647,0,2647,[485 259 315 303 240],393,3,7679,2.8999244712990935,20.0,0.0
2648,0,2648,[321 202 344 316 378],393,2,7681,2.8995847489618725,20.0,0.0
2649,0,2649,[420 219 230 254 392],276,3,7684,2.899622641509434,0.0,0.0
2650,0,2650,[227 485 272 293 217],293,2,7686,2.8992832893247833,20.0,0.0
2651,0,2651,[390 326 276 324 259],303,1,7687,2.8985671191553544,0.0,0.0
2652,0,2652,[324 431 231 509 230],201,1,7688,2.8978514888805127,0.0,0.0
2653,0,2653,[431 218 268 222 223],916,2,7690,2.8975131876412963,20.0,40.0
2654,0,2654,[250 215 202 222 216],94,2,7692,2.897175141242938,0.0,40.0
2655,0,2655,[392 231 264 232 384],472,3,7695,2.8972138554216866,0.0,0.0
2656,0,2656,[264 209 280 231 378],429,1,7696,2.8964998118178396,0.0,0.0
2657,0,2657,[321 268 344 264 326],3,2,7698,2.8961625282167045,0.0,20.0
2658,0,2658,[240 231 261 315 321],130,4,7702,2.8965776607747276,20.0,0.0
2659,0,2659,[507 326 413 232 508],303,3,7705,2.8966165413533833,0.0,0.0
2660,0,2660,[315 208 215 301 222],747,3,7708,2.8966553927095076,20.0,20.0
2661,0,2661,[420 236 350 452 215],130,5,7713,2.8974455296769346,0.0,0.0
2662,0,2662,[215 236 298 324 221],303,4,7717,2.8978595568907246,0.0,20.0
2663,0,2663,[303 209 275 201 217],201,2,7719,2.8975225225225225,0.0,0.0
2664,0,2664,[413 303 336 276 326],181,0,7719,2.896435272045028,0.0,0.0
2665,0,2665,[276 293 227 254 268],880,3,7722,2.8964741185296323,0.0,20.0
2666,0,2666,[201 390 219 367 250],303,4,7726,2.896887889013873,0.0,0.0
2667,0,2667,[217 255 509 272 268],682,3,7729,2.8969265367316344,20.0,20.0
2668,0,2668,[216 315 420 226 293],130,5,7734,2.897714499812664,20.0,20.0
2669,0,2669,[251 276 239 223 236],303,4,7738,2.89812734082397,20.0,0.0
2670,0,2670,[219 254 216 239 255],130,4,7742,2.898539872706851,0.0,20.0
2671,0,2671,[272 284 246 378 215],682,4,7746,2.8989520958083834,20.0,0.0
2672,0,2672,[213 208 216 331 222],758,5,7751,2.899738121960344,0.0,40.0
2673,0,2673,[230 283 202 280 384],880,1,7752,2.899027673896784,0.0,0.0
2674,0,2674,[276 232 226 301 367],880,5,7757,2.8998130841121497,0.0,0.0
2675,0,2675,[276 221 223 315 301],919,3,7760,2.899850523168909,40.0,0.0
2676,0,2676,[300 272 291 583 222],551,4,7764,2.900261486738887,20.0,40.0
2677,0,2677,[236 251 283 284 280],181,1,7765,2.899551904406273,0.0,0.0
2678,0,2678,[215 241 209 300 255],178,5,7770,2.9003359462486,0.0,20.0
2679,0,2679,[293 420 326 259 284],303,3,7773,2.9003731343283583,0.0,0.0
2680,0,2680,[300 219 246 240 315],276,5,7778,2.9011562849682955,20.0,20.0
2681,0,2681,[226 485 508 218 324],456,4,7782,2.901565995525727,0.0,0.0
2682,0,2682,[272 256 255 241 216],1,3,7785,2.9016026835631754,20.0,20.0
2683,0,2683,[365 367 226 413 268],222,2,7787,2.901266766020864,0.0,20.0
2684,0,2684,[217 201 284 212 508],896,1,7788,2.900558659217877,0.0,0.0
2685,0,2685,[291 336 243 413 280],181,1,7789,2.8998510796723753,0.0,0.0
2686,0,2686,[336 291 243 268 272],592,2,7791,2.8995161890584296,20.0,20.0
2687,0,2687,[215 223 218 583 201],94,3,7794,2.8995535714285716,20.0,0.0
2688,0,2688,[222 217 284 241 209],551,4,7798,2.8999628114540723,0.0,20.0
2689,0,2689,[212 222 211 240 236],758,4,7802,2.9003717472118957,0.0,20.0
2690,0,2690,[478 239 222 202 216],561,1,7803,2.899665551839465,20.0,40.0
2691,0,2691,[206 218 420 241 413],276,4,7807,2.900074294205052,0.0,0.0
2692,0,2692,[367 268 267 215 290],130,4,7811,2.9004827330115113,0.0,20.0
2693,0,2693,[264 420 331 303 268],276,4,7815,2.900890868596882,0.0,20.0
2694,0,2694,[259 201 326 221 239],303,2,7817,2.900556586270872,0.0,0.0
2695,0,2695,[367 508 299 216 217],896,2,7819,2.9002225519287834,0.0,20.0
2696,0,2696,[216 250 290 230 392],429,1,7820,2.899517982944012,0.0,20.0
2697,0,2697,[298 223 221 227 283],303,3,7823,2.8995552260934025,20.0,20.0
2698,0,2698,[221 261 246 219 212],1,3,7826,2.8995924416450536,0.0,0.0
2699,0,2699,[367 299 293 291 216],130,4,7830,2.9,0.0,20.0
2700,0,2700,[201 232 209 268 240],880,4,7834,2.9004072565716403,0.0,20.0
2701,0,2701,[239 223 218 509 303],293,2,7836,2.900074019245004,20.0,0.0
2702,0,2702,[264 202 300 290 209],429,2,7838,2.8997410284868663,0.0,20.0
2703,0,2703,[291 298 231 300 485],429,2,7840,2.899408284023669,0.0,40.0
2704,0,2704,[298 231 240 217 290],130,2,7842,2.899075785582255,0.0,20.0
2705,0,2705,[326 413 452 247 231],222,1,7843,2.8983739837398375,0.0,0.0
2706,0,2706,[344 216 316 239 508],758,3,7846,2.8984115256741783,20.0,20.0
2707,0,2707,[316 219 227 315 240],276,5,7851,2.8991875923190547,40.0,0.0
2708,0,2708,[212 485 384 509 378],299,3,7854,2.89922480620155,0.0,0.0
2709,0,2709,[367 215 226 208 202],303,5,7859,2.9,0.0,0.0
2710,0,2710,[202 211 227 431 201],429,3,7862,2.900036886757654,0.0,0.0
2711,0,2711,[239 215 226 232 240],472,5,7867,2.900811209439528,0.0,0.0
2712,0,2712,[216 212 326 275 218],201,4,7871,2.9012163656468855,0.0,20.0
2713,0,2713,[215 240 276 299 209],682,3,7874,2.901252763448784,0.0,0.0
2714,0,2714,[246 231 217 268 508],880,4,7878,2.9016574585635357,0.0,20.0
2715,0,2715,[431 268 241 331 583],551,4,7882,2.902061855670103,0.0,20.0
2716,0,2716,[384 264 420 365 250],472,2,7884,2.9017298490982704,0.0,0.0
2717,0,2717,[219 201 420 509 223],682,1,7885,2.9010301692420897,20.0,0.0
2718,0,2718,[268 247 232 413 218],222,3,7888,2.901066568591394,0.0,20.0
2719,0,2719,[507 431 485 275 301],429,3,7891,2.9011029411764704,0.0,0.0
2720,0,2720,[218 209 291 202 509],682,1,7892,2.900404263138552,0.0,0.0
2721,0,2721,[431 223 478 290 583],249,4,7896,2.9008082292432036,40.0,0.0
2722,0,2722,[216 420 298 230 290],758,4,7900,2.9012118986412045,0.0,40.0
2723,0,2723,[219 215 390 583 291],303,2,7902,2.9008810572687223,0.0,0.0
2724,0,2724,[283 209 250 201 275],864,3,7905,2.9009174311926604,0.0,0.0
2725,0,2725,[227 284 209 250 507],293,1,7906,2.9002201027146,0.0,0.0
2726,0,2726,[227 255 226 236 367],303,4,7910,2.9006233956729006,0.0,0.0
2727,0,2727,[275 217 272 293 508],919,5,7915,2.901392961876833,20.0,0.0
2728,0,2728,[211 218 378 240 384],682,2,7917,2.9010626603151337,0.0,0.0
2729,0,2729,[217 220 213 211 236],1,1,7918,2.9003663003663003,0.0,0.0
2730,0,2730,[264 303 350 215 259],592,3,7921,2.90040278286342,0.0,0.0
2731,0,2731,[316 315 300 206 217],276,5,7926,2.9011713030746704,40.0,20.0
2732,0,2732,[298 272 255 239 226],293,2,7928,2.9008415660446394,20.0,20.0
2733,0,2733,[219 478 217 232 284],561,1,7929,2.9001463057790784,20.0,0.0
2734,0,2734,[202 216 326 508 223],303,4,7933,2.90054844606947,20.0,20.0
2735,0,2735,[452 315 583 300 293],276,3,7936,2.9005847953216373,20.0,20.0
2736,0,2736,[367 219 275 206 216],896,3,7939,2.900621118012422,0.0,20.0
2737,0,2737,[290 223 202 485 431],429,3,7942,2.9006574141709276,20.0,0.0
2738,0,2738,[221 240 241 215 452],303,3,7945,2.900693683826214,0.0,0.0
2739,0,2739,[250 215 367 239 291],896,3,7948,2.9007299270072995,0.0,0.0
2740,0,2740,[250 485 283 230 275],790,3,7951,2.9007661437431596,0.0,0.0
2741,0,2741,[218 293 420 239 452],758,1,7952,2.900072939460248,0.0,0.0
2742,0,2742,[222 254 367 413 331],435,1,7953,2.899380240612468,0.0,20.0
2743,0,2743,[201 261 295 324 291],21,2,7955,2.8990524781341107,0.0,0.0
2744,0,2744,[452 223 284 226 264],276,3,7958,2.899089253187614,20.0,0.0
2745,0,2745,[272 293 206 392 291],276,3,7961,2.8991260014566644,20.0,0.0
2746,0,2746,[215 298 284 431 251],532,5,7966,2.899890789952676,0.0,20.0
2747,0,2747,[508 316 303 390 478],747,5,7971,2.900655021834061,40.0,0.0
2748,0,2748,[336 350 284 301 264],363,1,7972,2.899963623135686,0.0,0.0
2749,0,2749,[291 290 236 208 300],303,3,7975,2.9,0.0,20.0
2750,0,2750,[241 280 290 246 300],347,3,7978,2.9000363504180298,0.0,20.0
2751,0,2751,[219 508 316 211 231],407,4,7982,2.900436046511628,20.0,0.0
2752,0,2752,[367 227 215 365 218],222,3,7985,2.9004722121322195,0.0,0.0
2753,0,2753,[344 222 202 208 231],758,3,7988,2.9005083514887438,0.0,20.0
2754,0,2754,[275 211 583 431 223],201,2,7990,2.9001814882032666,20.0,0.0
2755,0,2755,[227 268 230 211 209],94,3,7993,2.9002177068214805,0.0,20.0
2756,0,2756,[220 300 367 244 284],178,3,7996,2.90025389916576,0.0,20.0
2757,0,2757,[232 326 384 215 246],303,3,7999,2.9002900652646844,0.0,0.0
2758,0,2758,[211 222 239 220 246],1,3,8002,2.900326205146792,0.0,20.0
2759,0,2759,[392 298 275 378 283],393,4,8006,2.9007246376811593,0.0,20.0
2760,0,2760,[219 280 216 230 291],429,3,8009,2.9007605939876857,0.0,20.0
2761,0,2761,[218 298 241 478 202],249,4,8013,2.901158580738595,20.0,20.0
2762,0,2762,[384 283 218 202 264],303,2,8015,2.900832428519725,0.0,0.0
2763,0,2763,[201 509 583 331 206],201,2,8017,2.900506512301013,0.0,0.0
2764,0,2764,[276 264 293 215 223],592,4,8021,2.9009041591320073,20.0,0.0
2765,0,2765,[209 255 222 452 378],222,2,8023,2.90057845263919,0.0,20.0
2766,0,2766,[291 201 293 365 217],682,3,8026,2.9006143838091796,0.0,0.0
2767,0,2767,[243 218 255 268 509],682,1,8027,2.89992774566474,0.0,20.0
2768,0,2768,[219 315 272 218 275],201,3,8030,2.899963885879379,40.0,0.0
2769,0,2769,[206 431 217 264 336],363,1,8031,2.89927797833935,0.0,0.0
2770,0,2770,[209 280 215 276 218],682,1,8032,2.8985925658607,0.0,0.0
2771,0,2771,[452 216 230 211 208],758,4,8036,2.898989898989899,0.0,20.0
2772,0,2772,[264 239 246 208 236],1,4,8040,2.8993869455463397,0.0,0.0
2773,0,2773,[583 367 276 219 230],303,3,8043,2.8994232155731794,0.0,0.0
2774,0,2774,[243 222 301 201 232],880,4,8047,2.89981981981982,0.0,20.0
2775,0,2775,[298 321 211 222 241],429,3,8050,2.89985590778098,0.0,40.0
2776,0,2776,[298 264 420 222 226],276,4,8054,2.9002520705797625,0.0,40.0
2777,0,2777,[216 201 344 508 315],592,5,8059,2.901007919366451,20.0,20.0
2778,0,2778,[331 216 246 420 222],435,3,8062,2.9010435408420294,0.0,40.0
2779,0,2779,[297 384 213 236 208],758,5,8067,2.9017985611510793,0.0,0.0
2780,0,2780,[315 222 221 297 255],919,3,8070,2.901833872707659,20.0,20.0
2781,0,2781,[206 276 293 420 272],276,5,8075,2.902588066139468,20.0,0.0
2782,0,2782,[211 315 331 291 241],551,5,8080,2.9033417175709664,20.0,0.0
2783,0,2783,[219 217 429 420 275],896,3,8083,2.9033764367816093,0.0,0.0
2784,0,2784,[232 216 240 367 241],561,0,8083,2.902333931777379,0.0,20.0
2785,0,2785,[230 202 268 365 227],846,3,8086,2.9023689877961236,0.0,20.0
2786,0,2786,[240 209 227 217 507],727,1,8087,2.901686401148188,0.0,0.0
2787,0,2787,[211 431 291 226 321],429,3,8090,2.9017216642754664,0.0,0.0
2788,0,2788,[208 218 239 209 202],886,1,8091,2.901039799211187,0.0,0.0
2789,0,2789,[255 231 299 298 223],682,2,8093,2.900716845878136,20.0,20.0
2790,0,2790,[230 293 301 280 232],429,2,8095,2.900394123969903,0.0,0.0
2791,0,2791,[202 226 509 239 246],916,2,8097,2.9000716332378222,0.0,0.0
2792,0,2792,[232 219 246 431 275],327,4,8101,2.90046544933763,0.0,0.0
2793,0,2793,[206 300 201 226 231],896,0,8101,2.899427344309234,0.0,20.0
2794,0,2794,[226 250 509 365 222],94,2,8103,2.8991055456171737,0.0,20.0
2795,0,2795,[216 230 215 227 291],896,4,8107,2.8994992846924177,0.0,20.0
2796,0,2796,[232 217 223 293 303],276,4,8111,2.899892742223811,20.0,0.0
2797,0,2797,[206 222 221 276 227],916,2,8113,2.8995711222301646,0.0,20.0
2798,0,2798,[208 429 509 303 223],747,5,8118,2.90032154340836,20.0,0.0
2799,0,2799,[276 431 508 209 223],201,3,8121,2.900357142857143,20.0,0.0
2800,0,2800,[230 201 267 240 246],1,3,8124,2.900392716886826,0.0,0.0
2801,0,2801,[239 315 227 211 250],293,1,8125,2.89971448965025,20.0,0.0
2802,0,2802,[300 264 420 218 206],276,4,8129,2.9001070281840886,0.0,20.0
2803,0,2803,[232 300 246 301 254],276,3,8132,2.9001426533523538,0.0,20.0
2804,0,2804,[218 222 431 268 583],551,4,8136,2.9005347593582886,0.0,40.0
2805,0,2805,[301 293 222 212 218],758,3,8139,2.900570206699929,0.0,20.0
2806,0,2806,[222 206 223 221 508],201,2,8141,2.9002493765586035,20.0,20.0
2807,0,2807,[300 241 280 275 218],429,1,8142,2.8995726495726495,0.0,20.0
2808,0,2808,[226 215 239 284 431],896,3,8145,2.8996084015663937,0.0,0.0
2809,0,2809,[331 367 272 315 231],130,3,8148,2.899644128113879,40.0,0.0
2810,0,2810,[508 206 241 365 300],276,4,8152,2.9000355745286375,0.0,20.0
2811,0,2811,[236 231 267 290 216],130,3,8155,2.9000711237553345,0.0,20.0
2812,0,2812,[226 264 251 509 213],293,1,8156,2.899395662993246,0.0,0.0
2813,0,2813,[283 280 215 367 226],293,1,8157,2.898720682302772,0.0,0.0
2814,0,2814,[239 208 250 246 230],435,4,8161,2.89911190053286,0.0,0.0
2815,0,2815,[290 223 236 283 202],303,4,8165,2.899502840909091,20.0,0.0
2816,0,2816,[215 390 227 221 250],303,3,8168,2.8995385161519347,0.0,0.0
2817,0,2817,[243 246 300 508 222],919,2,8170,2.899219304471256,0.0,40.0
2818,0,2818,[202 272 217 284 227],276,5,8175,2.8999645264278113,20.0,0.0
2819,0,2819,[413 236 316 202 254],130,3,8178,2.9,20.0,0.0
2820,0,2820,[431 250 201 222 301],327,1,8179,2.8993264799716414,0.0,20.0
2821,0,2821,[452 508 202 246 250],222,2,8181,2.8990077958894402,0.0,0.0
2822,0,2822,[326 295 218 272 255],919,3,8184,2.8990435706695004,20.0,0.0
2823,0,2823,[384 452 300 303 324],276,3,8187,2.8990793201133145,0.0,20.0
2824,0,2824,[240 275 227 264 202],293,0,8187,2.898053097345133,0.0,0.0
2825,0,2825,[230 280 367 299 276],880,3,8190,2.8980891719745223,0.0,0.0
2826,0,2826,[272 268 239 324 209],201,2,8192,2.897771489211178,20.0,20.0
2827,0,2827,[232 223 384 420 583],682,0,8192,2.896746817538897,20.0,0.0
2828,0,2828,[226 227 378 452 280],222,0,8192,2.895722870272181,0.0,0.0
2829,0,2829,[276 321 230 226 222],429,2,8194,2.8954063604240283,0.0,20.0
2830,0,2830,[280 291 275 222 272],393,5,8199,2.8961497703991523,20.0,20.0
2831,0,2831,[276 583 201 209 216],303,4,8203,2.896539548022599,0.0,20.0
2832,0,2832,[240 284 223 246 431],222,3,8206,2.896576067772679,20.0,0.0
2833,0,2833,[583 255 507 390 202],303,3,8209,2.8966125617501763,0.0,0.0
2834,0,2834,[239 230 392 315 331],276,4,8213,2.89700176366843,20.0,0.0
2835,0,2835,[276 211 384 272 315],870,2,8215,2.896685472496474,40.0,0.0
2836,0,2836,[202 452 284 240 226],276,4,8219,2.8970743743390908,0.0,0.0
2837,0,2837,[250 365 232 209 240],880,2,8221,2.8967582804792107,0.0,0.0
2838,0,2838,[384 316 222 326 276],551,4,8225,2.897146882705178,20.0,20.0
2839,0,2839,[255 301 232 509 365],244,2,8227,2.896830985915493,0.0,0.0
2840,0,2840,[241 293 222 284 227],222,1,8228,2.8961633227736714,0.0,20.0
2841,0,2841,[246 226 218 241 284],682,3,8231,2.8961998592540463,0.0,0.0
2842,0,2842,[255 291 264 293 241],303,3,8234,2.896236370031657,0.0,0.0
2843,0,2843,[367 259 222 365 218],682,1,8235,2.8955696202531644,0.0,20.0
2844,0,2844,[378 241 239 413 226],222,1,8236,2.894903339191564,0.0,0.0
2845,0,2845,[206 268 298 239 216],916,2,8238,2.894588896697119,0.0,60.0
2846,0,2846,[324 202 209 268 222],456,2,8240,2.894274675096593,0.0,40.0
2847,0,2847,[222 365 290 219 299],682,2,8242,2.893960674157303,0.0,20.0
2848,0,2848,[231 298 264 226 316],276,3,8245,2.893997893997894,20.0,20.0
2849,0,2849,[254 231 230 218 208],472,5,8250,2.8947368421052633,0.0,0.0
2850,0,2850,[481 316 218 431 384],758,4,8254,2.895124517713083,20.0,0.0
2851,0,2851,[236 227 276 223 222],303,3,8257,2.8951612903225805,20.0,20.0
2852,0,2852,[378 392 293 230 211],429,2,8259,2.8948475289169298,0.0,0.0
2853,0,2853,[264 298 232 276 508],303,4,8263,2.8952347582340576,0.0,20.0
2854,0,2854,[218 239 201 250 300],276,5,8268,2.895971978984238,0.0,20.0
2855,0,2855,[283 315 298 350 324],592,5,8273,2.8967086834733893,20.0,20.0
2856,0,2856,[215 202 218 219 250],130,4,8277,2.897094854742737,0.0,0.0
2857,0,2857,[367 250 222 268 276],916,3,8280,2.8971308607417776,0.0,40.0
2858,0,2858,[227 240 223 275 315],393,4,8284,2.8975166142007693,40.0,0.0
2859,0,2859,[246 299 243 227 239],130,2,8286,2.897202797202797,0.0,0.0
2860,0,2860,[291 215 240 326 420],303,2,8288,2.896889199580566,0.0,0.0
2861,0,2861,[413 206 223 219 303],201,2,8290,2.896575821104123,20.0,0.0
2862,0,2862,[221 264 331 246 344],592,3,8293,2.896611945511701,0.0,0.0
2863,0,2863,[290 300 429 219 250],276,5,8298,2.897346368715084,0.0,20.0
2864,0,2864,[226 280 255 367 293],222,0,8298,2.8963350785340314,0.0,0.0
2865,0,2865,[239 315 250 264 216],293,1,8299,2.8956734124214933,20.0,20.0
2866,0,2866,[290 201 264 240 223],303,3,8302,2.895709801185909,20.0,0.0
2867,0,2867,[261 201 264 246 326],919,1,8303,2.8950488145048814,0.0,0.0
2868,0,2868,[202 241 420 223 239],758,2,8305,2.8947368421052633,20.0,0.0
2869,0,2869,[485 384 394 240 243],393,2,8307,2.8944250871080137,0.0,0.0
2870,0,2870,[300 216 222 331 420],435,2,8309,2.894113549285963,0.0,60.0
2871,0,2871,[280 216 215 244 509],916,3,8312,2.894150417827298,0.0,20.0
2872,0,2872,[232 247 226 276 218],222,3,8315,2.894187260703098,0.0,0.0
2873,0,2873,[431 290 392 283 367],393,1,8316,2.893528183716075,0.0,0.0
2874,0,2874,[283 300 211 284 264],429,1,8317,2.8928695652173912,0.0,20.0
2875,0,2875,[231 218 223 326 298],303,4,8321,2.8932545201668987,20.0,20.0
2876,0,2876,[215 241 583 324 250],276,4,8325,2.8936392075078206,0.0,0.0
2877,0,2877,[272 222 267 420 293],130,5,8330,2.8943710910354414,20.0,20.0
2878,0,2878,[246 283 241 220 216],178,4,8334,2.894755123306704,0.0,20.0
2879,0,2879,[215 507 384 231 276],303,4,8338,2.895138888888889,0.0,0.0
2880,0,2880,[223 264 290 298 254],276,3,8341,2.8951752863589033,20.0,20.0
2881,0,2881,[217 208 276 326 298],222,3,8344,2.895211658570437,0.0,20.0
2882,0,2882,[223 230 226 227 215],551,5,8349,2.8959417273673256,20.0,0.0
2883,0,2883,[208 284 230 481 226],429,1,8350,2.895284327323162,0.0,0.0
2884,0,2884,[226 222 336 300 508],327,0,8350,2.8942807625649913,0.0,40.0
2885,0,2885,[324 218 227 244 267],268,3,8353,2.8943173943173943,0.0,0.0
2886,0,2886,[283 507 240 202 211],293,2,8355,2.894007620367163,0.0,0.0
2887,0,2887,[413 241 298 216 392],222,3,8358,2.89404432132964,0.0,40.0
2888,0,2888,[299 239 217 315 227],130,2,8360,2.8937348563516787,20.0,0.0
2889,0,2889,[218 232 226 230 223],222,4,8364,2.8941176470588235,20.0,0.0
2890,0,2890,[202 246 209 239 222],222,5,8369,2.8948460740228295,0.0,20.0
2891,0,2891,[298 230 452 392 218],222,4,8373,2.895228215767635,0.0,20.0
2892,0,2892,[227 420 254 246 209],276,4,8377,2.8956100933287243,0.0,0.0
2893,0,2893,[378 231 255 392 268],222,2,8379,2.895300621976503,0.0,20.0
2894,0,2894,[301 243 259 276 216],592,2,8381,2.8949913644214162,0.0,20.0
2895,0,2895,[241 219 367 216 384],896,3,8384,2.8950276243093924,0.0,20.0
2896,0,2896,[213 244 509 303 276],299,3,8387,2.895063859164653,0.0,0.0
2897,0,2897,[241 219 583 208 321],303,3,8390,2.8951000690131123,0.0,0.0
2898,0,2898,[429 227 509 216 291],293,2,8392,2.894791307347361,0.0,20.0
2899,0,2899,[261 259 213 272 227],1,1,8393,2.8941379310344826,20.0,0.0
2900,0,2900,[215 508 478 230 241],178,4,8397,2.8945191313340226,20.0,0.0
2901,0,2901,[216 201 240 219 384],301,5,8402,2.8952446588559613,0.0,20.0
2902,0,2902,[216 239 276 206 392],487,4,8406,2.895625215294523,0.0,20.0
2903,0,2903,[283 240 290 211 227],293,1,8407,2.8949724517906334,0.0,0.0
2904,0,2904,[295 211 431 230 206],916,1,8408,2.8943201376936316,0.0,0.0
2905,0,2905,[583 276 256 226 290],916,2,8410,2.8940123881624227,0.0,0.0
2906,0,2906,[507 231 301 280 275],429,2,8412,2.893704850361197,0.0,0.0
2907,0,2907,[316 227 239 272 299],130,3,8415,2.8937414030261346,40.0,0.0
2908,0,2908,[250 431 226 324 239],327,0,8415,2.89274664833276,0.0,0.0
2909,0,2909,[583 420 201 507 321],303,3,8418,2.892783505154639,0.0,0.0
2910,0,2910,[218 215 209 211 241],94,4,8422,2.893163861216077,0.0,0.0
2911,0,2911,[240 230 293 290 298],130,3,8425,2.8932005494505493,0.0,20.0
2912,0,2912,[293 316 231 384 315],276,3,8428,2.893237212495709,40.0,0.0
2913,0,2913,[241 239 365 429 290],276,4,8432,2.893617021276596,0.0,0.0
2914,0,2914,[255 301 236 350 283],592,3,8435,2.893653516295026,0.0,0.0
2915,0,2915,[232 209 227 429 240],276,4,8439,2.8940329218106995,0.0,0.0
2916,0,2916,[280 211 219 223 326],551,4,8443,2.894412067192321,20.0,0.0
2917,0,2917,[350 232 284 293 283],363,1,8444,2.893762851267992,0.0,0.0
2918,0,2918,[211 227 232 583 384],933,1,8445,2.8931140801644397,0.0,0.0
2919,0,2919,[297 211 209 303 291],889,1,8446,2.8924657534246574,0.0,0.0
2920,0,2920,[246 227 290 276 324],276,5,8451,2.8931872646353987,0.0,0.0
2921,0,2921,[240 216 300 316 350],130,5,8456,2.8939082819986313,20.0,40.0
2922,0,2922,[293 250 219 211 420],94,5,8461,2.894628806021211,0.0,0.0
2923,0,2923,[241 240 365 280 217],682,3,8464,2.8946648426812587,0.0,0.0
2924,0,2924,[255 326 250 221 216],303,4,8468,2.8950427350427352,0.0,20.0
2925,0,2925,[284 259 209 227 431],790,1,8469,2.894395078605605,0.0,0.0
2926,0,2926,[268 211 276 431 365],551,5,8474,2.895114451656987,0.0,20.0
2927,0,2927,[230 300 293 240 222],303,1,8475,2.894467213114754,0.0,40.0
2928,0,2928,[298 316 226 280 213],293,1,8476,2.8938204165244112,20.0,20.0
2929,0,2929,[392 240 276 284 226],276,4,8480,2.89419795221843,0.0,0.0
2930,0,2930,[378 583 284 239 508],870,0,8480,2.893210508358922,0.0,0.0
2931,0,2931,[218 211 215 232 583],551,4,8484,2.893587994542974,0.0,0.0
2932,0,2932,[232 254 284 394 243],880,2,8486,2.8932833276508694,0.0,0.0
2933,0,2933,[276 272 284 206 230],276,5,8491,2.8940013633265167,20.0,0.0
2934,0,2934,[219 509 291 315 264],551,4,8495,2.8943781942078366,20.0,0.0
2935,0,2935,[223 246 293 324 291],276,4,8499,2.8947547683923704,20.0,0.0
2936,0,2936,[232 231 202 219 222],303,4,8503,2.8951310861423223,0.0,20.0
2937,0,2937,[215 331 299 276 221],592,3,8506,2.8951667801225325,0.0,0.0
2938,0,2938,[230 583 226 321 365],429,0,8506,2.894181694453896,0.0,0.0
2939,0,2939,[222 331 218 298 246],919,2,8508,2.8938775510204082,0.0,40.0
2940,0,2940,[298 239 231 201 232],268,1,8509,2.893233594015641,0.0,20.0
2941,0,2941,[268 331 216 365 508],551,5,8514,2.893949694085656,0.0,40.0
2942,0,2942,[217 272 316 223 215],293,3,8517,2.893985728848114,60.0,0.0
2943,0,2943,[222 367 211 280 223],682,2,8519,2.893682065217391,20.0,20.0
2944,0,2944,[301 324 316 239 290],758,3,8522,2.8937181663837013,20.0,0.0
2945,0,2945,[321 295 250 420 216],130,3,8525,2.8937542430414123,0.0,20.0
2946,0,2946,[216 272 243 217 315],130,3,8528,2.8937902952154735,40.0,20.0
2947,0,2947,[239 222 508 429 231],896,3,8531,2.8938263229308006,0.0,20.0
2948,0,2948,[222 201 301 202 272],660,1,8532,2.8931841302136316,20.0,20.0
2949,0,2949,[239 202 218 213 206],1,3,8535,2.893220338983051,0.0,0.0
2950,0,2950,[221 202 251 219 250],1,4,8539,2.8935953913927484,0.0,0.0
2951,0,2951,[219 254 299 226 321],435,3,8542,2.893631436314363,0.0,0.0
2952,0,2952,[202 331 303 240 231],758,3,8545,2.8936674568235694,0.0,0.0
2953,0,2953,[202 223 232 261 254],1,2,8547,2.8933649289099526,20.0,0.0
2954,0,2954,[303 315 223 284 452],201,1,8548,2.892724196277496,40.0,0.0
2955,0,2955,[384 213 478 209 508],299,3,8551,2.8927604871447903,20.0,0.0
2956,0,2956,[218 216 316 290 331],758,5,8556,2.8934731146432195,20.0,20.0
2957,0,2957,[211 212 509 431 222],916,3,8559,2.893509127789047,0.0,20.0
2958,0,2958,[384 223 290 315 429],276,4,8563,2.893883068604258,40.0,0.0
2959,0,2959,[324 303 299 268 344],592,4,8567,2.8942567567567568,0.0,20.0
2960,0,2960,[226 219 222 230 299],896,2,8569,2.8939547450185747,0.0,20.0
2961,0,2961,[508 236 264 221 297],592,3,8572,2.8939905469277516,0.0,0.0
2962,0,2962,[316 202 350 254 299],130,3,8575,2.8940263246709415,20.0,0.0
2963,0,2963,[300 206 232 227 272],276,4,8579,2.894399460188934,20.0,20.0
2964,0,2964,[298 299 326 231 227],130,2,8581,2.894097807757167,0.0,20.0
2965,0,2965,[241 284 290 365 209],276,4,8585,2.894470667565745,0.0,0.0
2966,0,2966,[255 240 256 216 241],1,3,8588,2.894506235254466,0.0,20.0
2967,0,2967,[255 211 392 240 226],435,2,8590,2.8942048517520216,0.0,0.0
2968,0,2968,[336 324 298 367 300],327,1,8591,2.8935668575277873,0.0,40.0
2969,0,2969,[211 232 223 201 222],896,3,8594,2.8936026936026935,20.0,20.0
2970,0,2970,[226 301 291 246 431],399,1,8595,2.8929653315382025,0.0,0.0
2971,0,2971,[267 226 298 583 240],268,2,8597,2.892664872139973,0.0,20.0
2972,0,2972,[295 331 367 243 297],592,3,8600,2.8927009754456776,0.0,0.0
2973,0,2973,[452 208 276 367 507],303,4,8604,2.8930733019502353,0.0,0.0
2974,0,2974,[239 219 217 201 413],727,2,8606,2.8927731092436977,0.0,0.0
2975,0,2975,[431 250 392 255 275],484,3,8609,2.892809139784946,0.0,0.0
2976,0,2976,[202 222 583 255 268],682,3,8612,2.8928451461202553,0.0,40.0
2977,0,2977,[367 284 222 299 226],682,3,8615,2.8928811282740092,0.0,20.0
2978,0,2978,[241 392 508 301 481],429,1,8616,2.892245720040282,0.0,0.0
2979,0,2979,[280 202 293 583 301],429,2,8618,2.8919463087248323,0.0,0.0
2980,0,2980,[231 220 216 208 201],1,2,8620,2.8916470982891647,0.0,20.0
2981,0,2981,[221 223 298 215 413],303,4,8624,2.892018779342723,20.0,20.0
2982,0,2982,[431 216 239 211 420],246,1,8625,2.8913845122360042,0.0,20.0
2983,0,2983,[221 324 344 291 300],758,2,8627,2.8910857908847185,0.0,20.0
2984,0,2984,[284 226 367 213 202],622,4,8631,2.8914572864321606,0.0,0.0
2985,0,2985,[218 350 452 222 239],442,0,8631,2.890488948425988,0.0,20.0
2986,0,2986,[429 215 367 284 223],293,3,8634,2.890525610980917,20.0,0.0
2987,0,2987,[226 392 246 315 219],276,4,8638,2.890896921017403,20.0,0.0
2988,0,2988,[227 215 431 240 367],435,1,8639,2.8902643024422883,0.0,0.0
2989,0,2989,[223 201 232 431 239],246,2,8641,2.8899665551839466,20.0,0.0
2990,0,2990,[232 206 240 217 321],201,0,8641,2.8890003343363424,0.0,0.0
2991,0,2991,[431 291 300 365 202],429,3,8644,2.8890374331550803,0.0,20.0
2992,0,2992,[231 217 420 350 250],130,2,8646,2.8887403942532575,0.0,0.0
2993,0,2993,[250 231 219 230 291],429,2,8648,2.888443553774215,0.0,0.0
2994,0,2994,[508 276 216 244 259],299,3,8651,2.888480801335559,0.0,20.0
2995,0,2995,[218 326 250 276 221],303,4,8655,2.888851802403204,0.0,0.0
2996,0,2996,[295 485 216 230 420],532,5,8660,2.8895562228895564,0.0,20.0
2997,0,2997,[201 276 250 241 298],429,2,8662,2.8892595063375586,0.0,20.0
2998,0,2998,[222 264 230 223 201],276,4,8666,2.8896298766255417,20.0,20.0
2999,0,2999,[254 240 367 206 219],276,3,8669,2.889666666666667,0.0,0.0
3000,0,3000,[208 290 268 209 316],747,3,8672,2.88970343218927,20.0,20.0
3001,0,3001,[367 284 255 231 241],682,2,8674,2.889407061958694,0.0,0.0
3002,0,3002,[284 431 226 384 290],363,0,8674,2.8884448884448886,0.0,0.0
3003,0,3003,[208 367 217 321 201],435,3,8677,2.8884820239680424,0.0,0.0
3004,0,3004,[217 298 392 227 236],130,3,8680,2.8885191347753745,0.0,20.0
3005,0,3005,[315 254 300 276 431],276,3,8683,2.8885562208915503,20.0,20.0
3006,0,3006,[297 290 236 315 211],758,5,8688,2.8892583970734953,20.0,0.0
3007,0,3007,[227 221 290 420 300],303,3,8691,2.8892952127659575,0.0,20.0
3008,0,3008,[452 284 276 208 226],222,1,8692,2.8886673313393154,0.0,0.0
3009,0,3009,[222 429 231 315 291],276,3,8695,2.888704318936877,20.0,20.0
3010,0,3010,[241 230 202 215 232],178,5,8700,2.8894055131185654,0.0,0.0
3011,0,3011,[301 272 218 230 283],880,3,8703,2.889442231075697,20.0,0.0
3012,0,3012,[507 321 315 215 240],393,2,8705,2.8891470295386656,20.0,0.0
3013,0,3013,[268 236 213 264 217],1,2,8707,2.88885202388852,0.0,20.0
3014,0,3014,[367 394 280 275 272],393,4,8711,2.8892205638474295,20.0,0.0
3015,0,3015,[219 226 240 509 413],201,1,8712,2.8885941644562334,0.0,0.0
3016,0,3016,[216 315 218 268 226],201,3,8715,2.8886310904872388,20.0,40.0
3017,0,3017,[226 223 481 291 275],896,3,8718,2.8886679920477136,20.0,0.0
3018,0,3018,[297 268 293 508 261],919,3,8721,2.888704869161974,0.0,20.0
3019,0,3019,[220 254 240 261 272],1,0,8721,2.887748344370861,20.0,0.0
3020,0,3020,[420 218 298 223 283],303,4,8725,2.888116517709368,20.0,20.0
3021,0,3021,[508 230 291 241 223],758,4,8729,2.8884844473858373,20.0,0.0
3022,0,3022,[315 202 212 293 240],758,3,8732,2.8885213364207742,20.0,0.0
3023,0,3023,[284 367 209 384 246],880,3,8735,2.888558201058201,0.0,0.0
3024,0,3024,[301 280 413 336 256],181,1,8736,2.887933884297521,0.0,0.0
3025,0,3025,[231 240 255 243 290],130,2,8738,2.8876404494382024,0.0,0.0
3026,0,3026,[206 485 240 293 218],293,2,8740,2.8873472084572183,0.0,0.0
3027,0,3027,[241 254 509 240 378],682,2,8742,2.8870541611624834,0.0,0.0
3028,0,3028,[231 283 315 293 316],363,1,8743,2.8864311654011225,40.0,0.0
3029,0,3029,[232 272 299 293 208],880,5,8748,2.887128712871287,20.0,0.0
3030,0,3030,[392 300 272 350 240],130,5,8753,2.887825800065985,20.0,20.0
3031,0,3031,[429 284 507 213 315],293,2,8755,2.887532981530343,20.0,0.0
3032,0,3032,[507 240 215 290 293],293,3,8758,2.8875700626442464,0.0,0.0
3033,0,3033,[291 290 280 216 240],293,1,8759,2.8869479235332896,0.0,20.0
3034,0,3034,[367 222 216 208 394],435,2,8761,2.88665568369028,0.0,40.0
3035,0,3035,[431 226 216 509 209],916,2,8763,2.8863636363636362,0.0,20.0
3036,0,3036,[206 232 209 231 223],896,1,8764,2.8857425090549884,20.0,0.0
3037,0,3037,[217 326 293 267 201],422,2,8766,2.8854509545753784,0.0,0.0
3038,0,3038,[508 223 298 216 219],178,3,8769,2.8854886475814414,20.0,40.0
3039,0,3039,[452 239 217 367 324],276,3,8772,2.8855263157894737,0.0,0.0
3040,0,3040,[452 239 219 240 227],303,1,8773,2.884906280828675,0.0,0.0
3041,0,3041,[208 202 239 300 222],435,3,8776,2.8849441157133464,0.0,40.0
3042,0,3042,[300 232 301 209 324],327,2,8778,2.884653302661847,0.0,20.0
3043,0,3043,[241 212 267 236 213],1,4,8782,2.8850197109067017,0.0,0.0
3044,0,3044,[250 216 206 239 300],896,2,8784,2.884729064039409,0.0,40.0
3045,0,3045,[223 216 293 298 255],303,5,8789,2.885423506237689,20.0,40.0
3046,0,3046,[217 316 284 420 275],293,1,8790,2.8848047259599605,20.0,0.0
3047,0,3047,[239 222 583 209 384],276,3,8793,2.8848425196850394,0.0,20.0
3048,0,3048,[384 392 201 246 301],276,3,8796,2.8848802886192195,0.0,0.0
3049,0,3049,[239 240 217 227 208],880,4,8800,2.8852459016393444,0.0,0.0
3050,0,3050,[227 508 222 232 452],303,2,8802,2.8849557522123894,0.0,20.0
3051,0,3051,[250 259 243 231 217],1,1,8803,2.884338138925295,0.0,0.0
3052,0,3052,[293 326 215 300 227],303,2,8805,2.8840484769079593,0.0,20.0
3053,0,3053,[276 429 216 215 290],747,3,8808,2.8840864440078584,0.0,20.0
3054,0,3054,[232 298 583 241 284],303,4,8812,2.8844517184942715,0.0,20.0
3055,0,3055,[221 290 420 390 326],303,3,8815,2.8844895287958114,0.0,0.0
3056,0,3056,[264 227 324 291 202],551,3,8818,2.884527314360484,0.0,0.0
3057,0,3057,[392 276 291 227 230],429,2,8820,2.884238064094179,0.0,0.0
3058,0,3058,[508 201 293 276 429],276,5,8825,2.8849297155933313,0.0,0.0
3059,0,3059,[232 215 227 250 298],916,1,8826,2.884313725490196,0.0,20.0
3060,0,3060,[315 264 268 243 293],919,1,8827,2.883698137863443,20.0,20.0
3061,0,3061,[299 223 217 367 293],682,3,8830,2.883736120182887,20.0,0.0
3062,0,3062,[420 316 226 268 291],276,4,8834,2.8841005550114267,20.0,20.0
3063,0,3063,[301 202 275 583 300],429,2,8836,2.8838120104438643,0.0,20.0
3064,0,3064,[215 272 223 236 212],1,3,8839,2.8838499184339317,40.0,0.0
3065,0,3065,[413 255 202 240 261],130,4,8843,2.8842139595564253,0.0,0.0
3066,0,3066,[283 508 431 202 255],178,4,8847,2.8845777632865994,0.0,0.0
3067,0,3067,[283 202 431 250 303],592,4,8851,2.8849413298565842,0.0,0.0
3068,0,3068,[413 202 239 240 250],276,4,8855,2.8853046594982077,0.0,0.0
3069,0,3069,[223 209 350 216 291],758,5,8860,2.8859934853420195,20.0,20.0
3070,0,3070,[268 227 392 316 230],880,2,8862,2.885704982090524,20.0,20.0
3071,0,3071,[250 246 344 324 295],592,5,8867,2.8863932291666665,0.0,0.0
3072,0,3072,[251 230 213 256 218],1,3,8870,2.8864301985030916,0.0,0.0
3073,0,3073,[452 236 231 413 215],303,3,8873,2.8864671437865974,0.0,0.0
3074,0,3074,[209 300 284 583 264],303,2,8875,2.886178861788618,0.0,20.0
3075,0,3075,[481 344 212 223 350],758,4,8879,2.8865409622886866,20.0,0.0
3076,0,3076,[316 272 315 239 227],393,5,8884,2.8872278193045173,60.0,0.0
3077,0,3077,[213 420 275 298 507],293,3,8887,2.8872644574398962,0.0,20.0
3078,0,3078,[255 239 429 507 202],293,2,8889,2.8869762910035726,0.0,0.0
3079,0,3079,[221 508 367 272 259],919,5,8894,2.887662337662338,20.0,0.0
3080,0,3080,[481 283 250 208 232],429,2,8896,2.887374229146381,0.0,0.0
3081,0,3081,[367 280 217 295 299],880,4,8900,2.887735236859182,0.0,0.0
3082,0,3082,[241 276 218 221 452],758,1,8901,2.8871229322088876,0.0,0.0
3083,0,3083,[215 213 452 378 209],846,3,8904,2.88715953307393,0.0,0.0
3084,0,3084,[222 218 300 290 298],293,1,8905,2.886547811993517,0.0,60.0
3085,0,3085,[272 261 297 350 367],592,4,8909,2.886908619572262,20.0,0.0
3086,0,3086,[209 202 239 212 223],889,2,8911,2.886621315192744,20.0,0.0
3087,0,3087,[216 420 284 232 367],303,5,8916,2.8873056994818653,0.0,20.0
3088,0,3088,[452 272 230 295 367],130,3,8919,2.8873421819359018,20.0,0.0
3089,0,3089,[293 201 218 268 413],276,4,8923,2.8877022653721682,0.0,20.0
3090,0,3090,[202 226 223 275 218],293,1,8924,2.8870915561307022,20.0,0.0
3091,0,3091,[509 315 209 216 392],747,2,8926,2.8868046571798187,20.0,20.0
3092,0,3092,[243 300 301 275 280],181,1,8927,2.886194633042354,0.0,20.0
3093,0,3093,[201 301 246 272 326],919,2,8929,2.885908209437621,20.0,0.0
3094,0,3094,[211 202 254 420 216],246,1,8930,2.88529886914378,0.0,20.0
3095,0,3095,[300 246 240 413 231],222,2,8932,2.8850129198966408,0.0,20.0
3096,0,3096,[295 202 298 316 267],130,4,8936,2.8853729415563447,20.0,20.0
3097,0,3097,[227 226 208 236 300],303,3,8939,2.885409941897999,0.0,20.0
3098,0,3098,[261 227 241 431 413],222,1,8940,2.884801548886738,0.0,0.0
3099,0,3099,[324 241 222 202 272],276,5,8945,2.8854838709677417,20.0,20.0
3100,0,3100,[231 384 324 239 212],758,3,8948,2.885520799742019,0.0,0.0
3101,0,3101,[217 201 431 208 392],727,4,8952,2.885880077369439,0.0,0.0
3102,0,3102,[261 219 213 217 215],1,0,8952,2.8849500483403157,0.0,0.0
3103,0,3103,[236 331 316 508 217],130,3,8955,2.8849871134020617,20.0,0.0
3104,0,3104,[300 509 478 255 378],299,3,8958,2.885024154589372,20.0,20.0
3105,0,3105,[211 209 222 226 365],109,4,8962,2.8853831294269154,0.0,20.0
3106,0,3106,[226 208 298 284 583],268,3,8965,2.8854200193112325,0.0,20.0
3107,0,3107,[298 264 384 291 300],303,1,8966,2.884813384813385,0.0,40.0
3108,0,3108,[295 298 227 244 216],916,2,8968,2.884528787391444,0.0,40.0
3109,0,3109,[272 344 293 255 236],592,4,8972,2.884887459807074,20.0,0.0
3110,0,3110,[300 246 431 240 429],276,4,8976,2.8852459016393444,0.0,20.0
3111,0,3111,[298 226 218 280 206],622,2,8978,2.884961439588689,0.0,20.0
3112,0,3112,[255 291 420 222 219],303,3,8981,2.884998393832316,0.0,20.0
3113,0,3113,[231 212 316 429 315],363,1,8982,2.884393063583815,40.0,0.0
3114,0,3114,[241 223 231 250 268],268,3,8985,2.884430176565008,20.0,20.0
3115,0,3115,[297 232 217 298 272],293,3,8988,2.8844672657252888,20.0,20.0
3116,0,3116,[293 264 232 300 226],429,2,8990,2.88418350978505,0.0,20.0
3117,0,3117,[223 350 293 431 429],363,3,8993,2.8842206542655546,20.0,0.0
3118,0,3118,[255 217 508 283 243],919,4,8997,2.8845783905097786,0.0,0.0
3119,0,3119,[290 221 280 268 250],916,3,9000,2.8846153846153846,0.0,20.0
3120,0,3120,[246 209 231 226 255],222,2,9002,2.8843319448894587,0.0,0.0
3121,0,3121,[293 201 259 230 326],303,2,9004,2.88404868673927,0.0,0.0
3122,0,3122,[300 255 284 264 217],293,0,9004,2.883125200128082,0.0,20.0
3123,0,3123,[201 218 226 206 239],561,0,9004,2.882202304737516,0.0,0.0
3124,0,3124,[221 283 264 223 268],303,3,9007,2.88224,20.0,20.0
3125,0,3125,[243 215 431 232 223],682,2,9009,2.881957773512476,20.0,0.0
3126,0,3126,[290 232 222 365 219],429,3,9012,2.881995522865366,0.0,20.0
3127,0,3127,[583 481 211 321 300],429,1,9013,2.881393861892583,0.0,20.0
3128,0,3128,[209 300 291 232 255],682,0,9013,2.8804729945669543,0.0,20.0
3129,0,3129,[231 240 384 250 239],727,2,9015,2.880191693290735,0.0,0.0
3130,0,3130,[232 226 384 236 367],303,4,9019,2.8805493452571063,0.0,0.0
3131,0,3131,[246 239 230 218 452],303,2,9021,2.8802681992337167,0.0,0.0
3132,0,3132,[201 219 246 215 255],303,5,9026,2.880944781359719,0.0,0.0
3133,0,3133,[216 298 367 259 324],303,3,9029,2.8809827696234844,0.0,40.0
3134,0,3134,[226 268 230 219 267],268,2,9031,2.880701754385965,0.0,20.0
3135,0,3135,[384 264 413 324 272],276,2,9033,2.880420918367347,20.0,0.0
3136,0,3136,[384 215 583 284 290],682,2,9035,2.8801402613962384,0.0,0.0
3137,0,3137,[275 255 507 218 478],327,3,9038,2.8801784576163163,20.0,0.0
3138,0,3138,[241 246 261 431 452],222,2,9040,2.879898056705957,0.0,0.0
3139,0,3139,[215 303 206 218 232],276,4,9044,2.8802547770700637,0.0,0.0
3140,0,3140,[221 246 301 264 331],919,2,9046,2.87997453040433,0.0,0.0
3141,0,3141,[284 241 326 280 226],178,5,9051,2.880649267982177,0.0,0.0
3142,0,3142,[241 431 324 276 290],276,4,9055,2.8810054088450525,0.0,0.0
3143,0,3143,[384 239 291 481 212],896,2,9057,2.8807251908396947,0.0,0.0
3144,0,3144,[213 276 420 509 331],758,3,9060,2.8807631160572336,0.0,0.0
3145,0,3145,[583 227 275 222 208],293,0,9060,2.879847425301971,0.0,20.0
3146,0,3146,[300 216 230 251 264],303,2,9062,2.8795678423895774,0.0,40.0
3147,0,3147,[300 365 226 291 216],429,2,9064,2.8792884371029226,0.0,40.0
3148,0,3148,[431 212 331 217 272],201,2,9066,2.879009209272785,20.0,0.0
3149,0,3149,[326 216 268 202 226],201,2,9068,2.878730158730159,0.0,40.0
3150,0,3150,[213 509 222 384 209],299,2,9070,2.878451285306252,0.0,20.0
3151,0,3151,[223 240 452 276 222],758,2,9072,2.8781725888324874,20.0,20.0
3152,0,3152,[275 240 394 272 344],393,3,9075,2.878211227402474,20.0,0.0
3153,0,3153,[230 293 208 507 226],429,3,9078,2.8782498414711477,0.0,0.0
3154,0,3154,[583 223 264 215 384],551,2,9080,2.87797147385103,20.0,0.0
3155,0,3155,[365 264 232 300 431],276,1,9081,2.8773764258555135,0.0,20.0
3156,0,3156,[209 216 202 215 298],286,4,9085,2.8777320240734876,0.0,40.0
3157,0,3157,[300 226 222 201 211],896,2,9087,2.877454084863838,0.0,40.0
3158,0,3158,[211 276 215 291 209],682,2,9089,2.877176321620766,0.0,0.0
3159,0,3159,[201 255 367 230 268],327,4,9093,2.8775316455696203,0.0,20.0
3160,0,3160,[291 284 213 485 367],293,0,9093,2.87662132236634,0.0,0.0
3161,0,3161,[239 211 392 291 217],727,4,9097,2.876976597090449,0.0,0.0
3162,0,3162,[293 243 215 222 583],682,3,9100,2.877015491621878,0.0,20.0
3163,0,3163,[232 315 295 299 298],880,5,9105,2.877686472819216,20.0,20.0
3164,0,3164,[290 268 300 201 250],435,3,9108,2.8777251184834123,0.0,40.0
3165,0,3165,[209 240 230 276 331],276,5,9113,2.8783954516740367,0.0,0.0
3166,0,3166,[315 222 230 254 367],276,3,9116,2.8784338490685193,20.0,20.0
3167,0,3167,[321 290 390 300 255],303,2,9118,2.8781565656565657,0.0,20.0
3168,0,3168,[209 509 239 365 299],682,1,9119,2.8775639002840014,0.0,0.0
3169,0,3169,[324 213 241 431 240],201,2,9121,2.8772870662460566,0.0,0.0
3170,0,3170,[202 212 431 230 216],758,4,9125,2.8776411226742353,0.0,20.0
3171,0,3171,[241 227 268 218 206],94,3,9128,2.8776796973518284,0.0,20.0
3172,0,3172,[326 217 218 230 215],545,3,9131,2.877718247715096,0.0,0.0
3173,0,3173,[276 295 297 246 291],592,4,9135,2.8780718336483933,0.0,0.0
3174,0,3174,[324 264 246 236 291],592,2,9137,2.877795275590551,0.0,0.0
3175,0,3175,[216 209 300 239 255],249,3,9140,2.8778337531486144,0.0,40.0
3176,0,3176,[222 202 218 216 212],249,4,9144,2.878186968838527,0.0,40.0
3177,0,3177,[255 284 250 222 221],303,4,9148,2.878539962240403,0.0,20.0
3178,0,3178,[452 231 392 227 254],130,2,9150,2.8782636049072035,0.0,0.0
3179,0,3179,[217 254 206 431 276],276,3,9153,2.878301886792453,0.0,0.0
3180,0,3180,[316 254 384 301 315],276,3,9156,2.8783401446086136,40.0,0.0
3181,0,3181,[226 293 276 392 208],222,2,9158,2.87806411062225,0.0,0.0
3182,0,3182,[284 392 211 201 394],435,3,9161,2.878102419101477,0.0,0.0
3183,0,3183,[259 365 255 243 485],393,3,9164,2.878140703517588,0.0,0.0
3184,0,3184,[583 216 367 241 211],94,3,9167,2.87817896389325,0.0,20.0
3185,0,3185,[243 300 244 301 326],21,3,9170,2.8782172002510986,0.0,20.0
3186,0,3186,[291 275 230 206 240],293,1,9171,2.8776278631942267,0.0,0.0
3187,0,3187,[231 290 300 232 215],303,4,9175,2.877979924717691,0.0,20.0
3188,0,3188,[231 392 241 291 215],521,1,9176,2.8773910316713702,0.0,0.0
3189,0,3189,[367 215 452 331 206],130,3,9179,2.8774294670846396,0.0,0.0
3190,0,3190,[215 315 509 223 226],551,5,9184,2.878094641178314,40.0,0.0
3191,0,3191,[583 344 222 367 275],327,3,9187,2.8781328320802007,0.0,20.0
3192,0,3192,[212 223 231 202 201],896,1,9188,2.8775446288756656,20.0,0.0
3193,0,3193,[268 413 201 215 291],435,3,9191,2.877582968065122,0.0,20.0
3194,0,3194,[211 250 240 222 209],293,1,9192,2.876995305164319,0.0,20.0
3195,0,3195,[264 259 209 211 324],268,3,9195,2.8770337922403004,0.0,0.0
3196,0,3196,[208 211 384 212 209],758,5,9200,2.8776978417266186,0.0,0.0
3197,0,3197,[276 295 222 259 217],919,3,9203,2.8777360850531584,0.0,20.0
3198,0,3198,[201 324 291 508 231],303,3,9206,2.877774304470147,0.0,0.0
3199,0,3199,[452 509 218 275 227],201,3,9209,2.8778125,0.0,0.0
3200,0,3200,[250 226 268 216 255],178,5,9214,2.878475476413621,0.0,40.0
3201,0,3201,[209 283 231 298 241],429,2,9216,2.878201124297314,0.0,20.0
3202,0,3202,[508 222 301 232 240],880,5,9221,2.8788635654074306,0.0,20.0
3203,0,3203,[350 254 231 326 230],757,1,9222,2.8782771535580522,0.0,0.0
3204,0,3204,[218 201 336 384 223],363,2,9224,2.878003120124805,20.0,0.0
3205,0,3205,[209 215 284 217 367],222,2,9226,2.8777292576419216,0.0,0.0
3206,0,3206,[212 216 217 240 209],1,3,9229,2.877767383847833,0.0,20.0
3207,0,3207,[219 240 298 250 218],682,3,9232,2.8778054862842892,0.0,20.0
3208,0,3208,[236 259 267 241 239],1,4,9236,2.878155188532253,0.0,0.0
3209,0,3209,[390 218 300 216 290],303,3,9239,2.8781931464174453,0.0,40.0
3210,0,3210,[583 284 280 209 291],682,1,9240,2.8776082217377765,0.0,0.0
3211,0,3211,[300 272 298 218 297],919,4,9244,2.8779576587795765,20.0,40.0
3212,0,3212,[284 222 272 276 202],880,5,9249,2.8786181139122315,20.0,20.0
3213,0,3213,[215 227 216 219 201],864,5,9254,2.879278158058494,0.0,20.0
3214,0,3214,[255 275 384 344 223],393,3,9257,2.879315707620529,20.0,0.0
3215,0,3215,[250 239 290 226 223],276,5,9262,2.8799751243781095,20.0,0.0
3216,0,3216,[326 321 315 227 413],130,3,9265,2.880012433944669,20.0,0.0
3217,0,3217,[206 209 216 508 284],201,2,9267,2.879738968303294,0.0,20.0
3218,0,3218,[230 413 324 212 431],201,2,9269,2.879465672569121,0.0,0.0
3219,0,3219,[298 230 367 384 213],790,3,9272,2.879503105590062,0.0,20.0
3220,0,3220,[367 264 508 232 250],303,4,9276,2.879850977957156,0.0,0.0
3221,0,3221,[272 293 216 250 231],682,4,9280,2.8801986343885786,20.0,20.0
3222,0,3222,[298 230 232 217 509],916,2,9282,2.8799255352156377,0.0,20.0
3223,0,3223,[227 215 420 321 255],130,4,9286,2.880272952853598,0.0,0.0
3224,0,3224,[481 217 485 222 231],429,1,9287,2.8796899224806203,0.0,20.0
3225,0,3225,[293 420 413 255 227],303,3,9290,2.879727216367018,0.0,0.0
3226,0,3226,[222 331 202 272 315],130,4,9294,2.8800743724821816,40.0,20.0
3227,0,3227,[384 230 268 291 259],303,1,9295,2.8794919454770755,0.0,20.0
3228,0,3228,[272 241 295 268 215],532,5,9300,2.880148652833695,20.0,20.0
3229,0,3229,[226 365 211 246 390],94,3,9303,2.880185758513932,0.0,0.0
3230,0,3230,[221 219 218 390 321],303,3,9306,2.8802228412256268,0.0,0.0
3231,0,3231,[209 583 215 431 291],682,2,9308,2.879950495049505,0.0,0.0
3232,0,3232,[298 226 227 316 300],532,5,9313,2.880606248066811,20.0,40.0
3233,0,3233,[344 222 291 303 208],758,4,9317,2.880952380952381,0.0,20.0
3234,0,3234,[215 241 226 222 216],790,2,9319,2.880680061823802,0.0,40.0
3235,0,3235,[291 452 420 239 431],896,2,9321,2.880407911001236,0.0,0.0
3236,0,3236,[217 365 272 255 211],682,3,9324,2.880444856348471,20.0,0.0
3237,0,3237,[275 268 255 326 244],919,2,9326,2.8801729462631256,0.0,20.0
3238,0,3238,[268 367 293 336 222],514,3,9329,2.8802099413399196,0.0,40.0
3239,0,3239,[509 231 508 202 208],758,4,9333,2.8805555555555555,0.0,0.0
3240,0,3240,[240 298 232 209 301],880,4,9337,2.880900956494909,0.0,20.0
3241,0,3241,[298 326 240 300 413],303,1,9338,2.880320789636027,0.0,40.0
3242,0,3242,[264 365 209 481 367],429,1,9339,2.879740980573543,0.0,0.0
3243,0,3243,[239 431 222 218 226],472,5,9344,2.88039457459926,0.0,20.0
3244,0,3244,[280 392 283 508 231],880,1,9345,2.879815100154083,0.0,0.0
3245,0,3245,[384 509 508 452 241],758,3,9348,2.879852125693161,0.0,0.0
3246,0,3246,[223 202 394 485 298],393,3,9351,2.87988912842624,20.0,20.0
3247,0,3247,[431 268 420 230 316],532,5,9356,2.8805418719211824,20.0,20.0
3248,0,3248,[241 298 240 315 222],758,3,9359,2.8805786395814095,20.0,40.0
3249,0,3249,[276 227 293 231 392],222,2,9361,2.8803076923076922,0.0,0.0
3250,0,3250,[259 213 220 201 227],1,1,9362,2.8797293140572133,0.0,0.0
3251,0,3251,[223 216 217 316 509],551,4,9366,2.8800738007380073,40.0,20.0
3252,0,3252,[481 216 227 219 226],301,4,9370,2.880418075622502,0.0,20.0
3253,0,3253,[206 326 291 392 508],130,4,9374,2.880762138905962,0.0,0.0
3254,0,3254,[431 250 316 222 230],363,1,9375,2.880184331797235,20.0,20.0
3255,0,3255,[268 293 298 267 331],130,4,9379,2.8805282555282554,0.0,40.0
3256,0,3256,[209 216 259 208 201],303,4,9383,2.880871968068775,0.0,20.0
3257,0,3257,[283 275 264 331 243],919,3,9386,2.8809085328422346,0.0,0.0
3258,0,3258,[283 226 392 301 201],429,0,9386,2.88002454740718,0.0,0.0
3259,0,3259,[246 315 331 300 201],99,2,9388,2.8797546012269937,20.0,20.0
3260,0,3260,[261 344 243 264 250],592,2,9390,2.8794848206071757,0.0,0.0
3261,0,3261,[216 217 431 367 218],429,2,9392,2.8792152053954627,0.0,20.0
3262,0,3262,[298 201 232 275 431],327,3,9395,2.879252221881704,0.0,20.0
3263,0,3263,[254 431 298 316 331],276,3,9398,2.8792892156862746,20.0,20.0
3264,0,3264,[216 276 226 509 259],682,1,9399,2.8787136294027564,0.0,20.0
3265,0,3265,[481 367 290 284 202],429,1,9400,2.8781383955909368,0.0,0.0
3266,0,3266,[243 276 384 222 316],880,3,9403,2.8781756963575145,20.0,20.0
3267,0,3267,[201 230 509 223 227],94,3,9406,2.8782129742962055,20.0,0.0
3268,0,3268,[481 255 264 212 276],299,2,9408,2.8779443254817987,0.0,0.0
3269,0,3269,[212 283 290 232 298],363,1,9409,2.87737003058104,0.0,20.0
3270,0,3270,[216 230 250 208 202],758,5,9414,2.878018954448181,0.0,20.0
3271,0,3271,[239 367 298 509 268],453,3,9417,2.8780562347188265,0.0,40.0
3272,0,3272,[201 293 261 216 276],592,4,9421,2.878399022303697,0.0,20.0
3273,0,3273,[216 250 211 280 509],916,4,9425,2.878741600488699,0.0,20.0
3274,0,3274,[259 268 209 206 202],1,4,9429,2.8790839694656487,0.0,20.0
3275,0,3275,[219 508 201 509 211],94,5,9434,2.8797313797313797,0.0,0.0
3276,0,3276,[223 216 509 231 240],889,2,9436,2.879462923405554,20.0,20.0
3277,0,3277,[217 222 508 367 216],222,2,9438,2.879194630872483,0.0,40.0
3278,0,3278,[316 276 452 250 241],276,4,9442,2.8795364440378166,20.0,0.0
3279,0,3279,[284 508 231 298 300],880,3,9445,2.879573170731707,0.0,40.0
3280,0,3280,[227 365 241 218 211],429,1,9446,2.8790003047851265,0.0,0.0
3281,0,3281,[230 216 201 217 232],495,4,9450,2.8793418647166362,0.0,20.0
3282,0,3282,[267 216 230 227 255],130,3,9453,2.879378617118489,0.0,20.0
3283,0,3283,[241 209 268 201 331],201,3,9456,2.879415347137637,0.0,20.0
3284,0,3284,[202 240 321 259 507],393,1,9457,2.8788432267884323,0.0,0.0
3285,0,3285,[232 246 284 290 206],268,1,9458,2.878271454656117,0.0,0.0
3286,0,3286,[429 219 212 268 241],846,4,9462,2.878612716763006,0.0,20.0
3287,0,3287,[217 299 218 219 420],130,3,9465,2.8786496350364965,0.0,0.0
3288,0,3288,[290 241 255 223 232],682,1,9466,2.8780784432958346,20.0,0.0
3289,0,3289,[216 261 212 272 219],1,2,9468,2.877811550151976,20.0,20.0
3290,0,3290,[222 392 231 209 227],660,1,9469,2.8772409601944697,0.0,20.0
3291,0,3291,[212 218 215 240 247],1,1,9470,2.876670716889429,0.0,0.0
3292,0,3292,[202 264 218 215 293],303,4,9474,2.877011843303978,0.0,0.0
3293,0,3293,[315 215 331 239 384],276,4,9478,2.8773527625986643,20.0,0.0
3294,0,3294,[365 239 232 218 378],846,3,9481,2.877389984825493,0.0,0.0
3295,0,3295,[284 206 211 215 219],896,3,9484,2.8774271844660193,0.0,0.0
3296,0,3296,[255 284 293 218 367],178,4,9488,2.8777676675765846,0.0,0.0
3297,0,3297,[276 299 240 324 280],181,1,9489,2.877198302001213,0.0,0.0
3298,0,3298,[284 420 217 298 429],293,3,9492,2.8772355259169444,0.0,20.0
3299,0,3299,[222 232 208 212 206],363,2,9494,2.876969696969697,0.0,20.0
3300,0,3300,[236 239 255 223 290],303,4,9498,2.877309906089064,20.0,0.0
3301,0,3301,[583 272 290 255 507],293,2,9500,2.877044215626893,20.0,0.0
3302,0,3302,[413 219 300 216 218],222,4,9504,2.877384196185286,0.0,40.0
3303,0,3303,[217 295 202 392 316],880,4,9508,2.87772397094431,20.0,0.0
3304,0,3304,[241 227 236 367 239],303,3,9511,2.8777609682299548,0.0,0.0
3305,0,3305,[255 230 298 219 240],222,3,9514,2.877797943133696,0.0,20.0
3306,0,3306,[508 291 240 507 209],303,3,9517,2.8778348956758393,0.0,0.0
3307,0,3307,[295 300 413 246 276],130,3,9520,2.8778718258766625,0.0,20.0
3308,0,3308,[291 300 276 331 241],551,5,9525,2.8785131459655484,0.0,20.0
3309,0,3309,[222 209 324 508 217],276,5,9530,2.879154078549849,0.0,20.0
3310,0,3310,[261 365 378 215 284],222,2,9532,2.8788885533071578,0.0,0.0
3311,0,3311,[452 217 583 206 284],276,3,9535,2.878925120772947,0.0,0.0
3312,0,3312,[290 272 365 298 215],276,4,9539,2.8792635073951103,20.0,20.0
3313,0,3313,[509 291 206 255 367],293,1,9540,2.8786964393482197,0.0,0.0
3314,0,3314,[223 284 250 240 452],276,4,9544,2.8790346907993967,20.0,0.0
3315,0,3315,[201 218 324 431 275],201,4,9548,2.879372738238842,0.0,0.0
3316,0,3316,[367 217 413 452 226],276,2,9550,2.8791076273741334,0.0,0.0
3317,0,3317,[344 272 255 326 315],592,5,9555,2.8797468354430378,40.0,0.0
3318,0,3318,[321 431 384 420 227],435,2,9557,2.8794817716179573,0.0,0.0
3319,0,3319,[230 413 284 298 231],276,3,9560,2.8795180722891565,0.0,20.0
3320,0,3320,[209 283 300 230 236],303,2,9562,2.879253236976814,0.0,20.0
3321,0,3321,[221 290 209 219 284],916,1,9563,2.878687537627935,0.0,0.0
3322,0,3322,[219 226 429 290 315],276,5,9568,2.8793259103219984,20.0,0.0
3323,0,3323,[298 367 236 299 261],592,2,9570,2.8790613718411553,0.0,20.0
3324,0,3324,[226 583 272 202 255],682,2,9572,2.878796992481203,20.0,0.0
3325,0,3325,[365 283 378 384 315],393,2,9574,2.878532772098617,20.0,0.0
3326,0,3326,[219 217 291 243 232],682,1,9575,2.8779681394649836,0.0,0.0
3327,0,3327,[259 240 202 222 241],393,3,9578,2.8780048076923075,0.0,20.0
3328,0,3328,[209 231 206 217 429],276,4,9582,2.878341844397717,0.0,0.0
3329,0,3329,[303 291 212 298 217],758,4,9586,2.878678678678679,0.0,20.0
3330,0,3330,[239 284 429 276 301],276,5,9591,2.8793155208646053,0.0,0.0
3331,0,3331,[239 507 255 583 219],327,2,9593,2.8790516206482595,0.0,0.0
3332,0,3332,[211 272 293 230 315],293,3,9596,2.879087908790879,40.0,0.0
3333,0,3333,[232 217 331 219 216],551,4,9600,2.8794241151769646,0.0,20.0
3334,0,3334,[215 209 251 316 431],286,4,9604,2.87976011994003,20.0,0.0
3335,0,3335,[264 216 211 226 239],435,3,9607,2.8797961630695443,0.0,20.0
3336,0,3336,[583 217 276 272 429],276,4,9611,2.8801318549595445,20.0,0.0
3337,0,3337,[211 232 583 508 331],551,4,9615,2.8804673457159975,0.0,0.0
3338,0,3338,[272 315 227 223 367],293,2,9617,2.8802036537885596,60.0,0.0
3339,0,3339,[367 283 251 222 298],299,3,9620,2.8802395209580838,0.0,40.0
3340,0,3340,[218 231 240 276 217],622,3,9623,2.8802753666566896,0.0,0.0
3341,0,3341,[236 239 367 209 218],916,1,9624,2.8797127468581687,0.0,0.0
3342,0,3342,[365 231 331 218 268],276,3,9627,2.8797487286868084,0.0,20.0
3343,0,3343,[295 254 367 215 255],130,3,9630,2.8797846889952154,0.0,0.0
3344,0,3344,[216 217 452 367 392],130,4,9634,2.880119581464873,0.0,20.0
3345,0,3345,[201 246 236 507 324],303,4,9638,2.880454273759713,0.0,0.0
3346,0,3346,[209 232 241 202 240],561,1,9639,2.879892440991933,0.0,0.0
3347,0,3347,[240 239 208 219 212],1,3,9642,2.879928315412186,0.0,0.0
3348,0,3348,[300 384 272 226 201],880,3,9645,2.8799641684084802,20.0,20.0
3349,0,3349,[392 336 211 208 222],514,3,9648,2.88,0.0,20.0
3350,0,3350,[255 243 295 272 239],130,3,9651,2.8800358102059085,20.0,0.0
3351,0,3351,[216 300 231 293 392],487,4,9655,2.8803699284009547,0.0,40.0
3352,0,3352,[255 241 283 384 239],393,3,9658,2.880405606919177,0.0,0.0
3353,0,3353,[246 268 223 280 250],916,4,9662,2.8807394156231365,20.0,20.0
3354,0,3354,[378 240 219 223 300],682,1,9663,2.8801788375558868,20.0,20.0
3355,0,3355,[209 367 215 378 217],222,2,9665,2.879916567342074,0.0,0.0
3356,0,3356,[331 298 250 367 255],178,4,9669,2.8802502234137624,0.0,20.0
3357,0,3357,[208 250 217 268 226],435,5,9674,2.8808814770696842,0.0,20.0
3358,0,3358,[240 378 219 254 215],682,2,9676,2.88061923191426,0.0,0.0
3359,0,3359,[243 508 324 276 240],181,0,9676,2.8797619047619047,0.0,0.0
3360,0,3360,[239 227 303 384 300],758,3,9679,2.8797976792621243,0.0,20.0
3361,0,3361,[275 217 315 230 284],201,1,9680,2.8792385484830456,20.0,0.0
3362,0,3362,[222 365 255 201 246],682,3,9683,2.8792744573297653,0.0,20.0
3363,0,3363,[268 215 261 227 202],130,4,9687,2.8796076099881094,0.0,20.0
3364,0,3364,[239 226 215 250 290],682,2,9689,2.8793462109955423,0.0,0.0
3365,0,3365,[250 299 331 243 267],130,1,9690,2.878787878787879,0.0,0.0
3366,0,3366,[222 301 232 227 217],880,4,9694,2.879120879120879,0.0,20.0
3367,0,3367,[290 298 420 243 384],682,1,9695,2.878562945368171,0.0,20.0
3368,0,3368,[452 508 212 217 213],758,3,9698,2.8785989907984564,0.0,0.0
3369,0,3369,[202 213 509 239 365],846,3,9701,2.8786350148367954,0.0,0.0
3370,0,3370,[259 276 202 255 300],487,2,9703,2.8783743696232573,0.0,20.0
3371,0,3371,[221 202 384 324 350],758,4,9707,2.8787069988137604,0.0,0.0
3372,0,3372,[268 226 284 241 227],347,3,9710,2.878742958790394,0.0,20.0
3373,0,3373,[209 202 431 508 240],201,1,9711,2.8781861292234736,0.0,0.0
3374,0,3374,[226 231 452 221 232],201,0,9711,2.8773333333333335,0.0,0.0
3375,0,3375,[202 255 299 284 272],130,3,9714,2.8773696682464456,20.0,0.0
3376,0,3376,[301 221 508 295 300],919,3,9717,2.8774059816405093,0.0,20.0
3377,0,3377,[301 420 350 208 303],758,3,9720,2.8774422735346357,0.0,0.0
3378,0,3378,[219 250 247 261 267],1,2,9722,2.877182598401894,0.0,0.0
3379,0,3379,[246 218 275 255 202],178,4,9726,2.8775147928994085,0.0,0.0
3380,0,3380,[413 244 291 293 367],291,4,9730,2.877846790890269,0.0,0.0
3381,0,3381,[392 215 291 316 255],393,5,9735,2.8784742755765818,20.0,0.0
3382,0,3382,[280 284 232 378 219],682,1,9736,2.8779190067986993,0.0,0.0
3383,0,3383,[367 246 236 250 303],919,3,9739,2.8779550827423166,0.0,0.0
3384,0,3384,[206 226 315 452 230],130,3,9742,2.877991137370753,20.0,0.0
3385,0,3385,[508 255 280 276 431],178,3,9745,2.8780271707028944,0.0,0.0
3386,0,3386,[272 231 583 291 209],682,1,9746,2.877472689695896,20.0,0.0
3387,0,3387,[280 222 268 223 218],682,2,9748,2.8772136953955134,20.0,40.0
3388,0,3388,[240 344 315 202 231],758,2,9750,2.876954853939215,20.0,0.0
3389,0,3389,[218 280 219 315 291],551,4,9754,2.877286135693215,20.0,0.0
3390,0,3390,[202 217 284 216 583],682,4,9758,2.8776172220583898,0.0,20.0
3391,0,3391,[202 223 293 321 301],919,2,9760,2.8773584905660377,20.0,0.0
3392,0,3392,[218 250 321 240 232],303,3,9763,2.8773946360153255,0.0,0.0
3393,0,3393,[384 243 392 291 227],393,4,9767,2.8777253977607544,0.0,0.0
3394,0,3394,[315 206 218 331 316],130,3,9770,2.877761413843888,40.0,0.0
3395,0,3395,[295 206 255 250 254],130,1,9771,2.877208480565371,0.0,0.0
3396,0,3396,[246 431 239 272 284],276,4,9775,2.8775390050044156,20.0,0.0
3397,0,3397,[240 227 239 321 201],201,2,9777,2.8772807533843436,0.0,0.0
3398,0,3398,[250 431 283 215 508],592,4,9781,2.8776110620770816,0.0,0.0
3399,0,3399,[300 223 222 298 264],919,2,9783,2.8773529411764707,20.0,60.0
3400,0,3400,[218 240 255 303 206],293,2,9785,2.877094972067039,0.0,0.0
3401,0,3401,[232 264 239 331 431],276,2,9787,2.8768371546149325,0.0,0.0
3402,0,3402,[293 246 331 284 241],178,5,9792,2.877461063767264,0.0,0.0
3403,0,3403,[336 413 216 251 394],286,4,9796,2.8777908343125733,0.0,20.0
3404,0,3404,[247 241 365 223 508],222,2,9798,2.877533039647577,20.0,0.0
3405,0,3405,[272 226 300 301 215],110,1,9799,2.876981796829125,20.0,20.0
3406,0,3406,[232 216 420 367 509],94,3,9802,2.877017904314646,0.0,20.0
3407,0,3407,[261 250 297 272 222],592,3,9805,2.8770539906103285,20.0,20.0
3408,0,3408,[300 216 209 223 219],889,2,9807,2.8767967145790556,20.0,40.0
3409,0,3409,[390 507 246 236 583],303,3,9810,2.87683284457478,0.0,0.0
3410,0,3410,[293 268 280 295 300],178,4,9814,2.8771621225447084,0.0,40.0
3411,0,3411,[293 485 239 213 251],293,2,9816,2.876905041031653,0.0,0.0
3412,0,3412,[206 508 367 202 208],542,2,9818,2.8766481101670083,0.0,0.0
3413,0,3413,[250 367 239 240 231],267,5,9823,2.877270064440539,0.0,0.0
3414,0,3414,[211 508 217 216 298],758,4,9827,2.877598828696925,0.0,40.0
3415,0,3415,[201 420 223 301 240],276,5,9832,2.8782201405152223,20.0,0.0
3416,0,3416,[508 215 392 240 222],347,3,9835,2.8782557799239097,0.0,20.0
3417,0,3417,[240 246 290 298 206],130,3,9838,2.8782913984786425,0.0,20.0
3418,0,3418,[272 324 316 429 284],276,5,9843,2.8789119625621526,40.0,0.0
3419,0,3419,[301 230 231 227 222],425,4,9847,2.8792397660818714,0.0,20.0
3420,0,3420,[508 230 226 202 217],222,2,9849,2.878982753580824,0.0,0.0
3421,0,3421,[321 211 420 206 392],435,3,9852,2.8790181180596144,0.0,0.0
3422,0,3422,[509 290 226 240 246],682,2,9854,2.878761320479112,0.0,0.0
3423,0,3423,[216 241 280 246 284],682,4,9858,2.879088785046729,0.0,20.0
3424,0,3424,[583 223 272 431 218],682,2,9860,2.8788321167883213,40.0,0.0
3425,0,3425,[508 272 344 211 222],758,4,9864,2.8791593695271454,20.0,20.0
3426,0,3426,[583 215 509 420 254],682,1,9865,2.878611030055442,0.0,0.0
3427,0,3427,[222 284 232 290 283],293,0,9865,2.877771295215869,0.0,20.0
3428,0,3428,[326 246 267 276 261],130,5,9870,2.878390201224847,0.0,0.0
3429,0,3429,[261 367 452 246 508],130,5,9875,2.879008746355685,0.0,0.0
3430,0,3430,[301 254 299 365 218],880,3,9878,2.8790440104925676,0.0,0.0
3431,0,3431,[227 250 508 208 240],880,3,9881,2.879079254079254,0.0,0.0
3432,0,3432,[295 243 272 291 261],130,3,9884,2.8791144771337023,20.0,0.0
3433,0,3433,[301 239 250 272 316],880,4,9888,2.879440885264997,40.0,0.0
3434,0,3434,[250 215 583 216 230],916,3,9891,2.879475982532751,0.0,20.0
3435,0,3435,[236 218 201 220 267],1,2,9893,2.8792200232828873,0.0,0.0
3436,0,3436,[276 250 236 420 227],130,3,9896,2.8792551643875473,0.0,0.0
3437,0,3437,[209 244 222 283 367],178,4,9900,2.8795811518324608,0.0,20.0
3438,0,3438,[276 392 226 230 367],222,3,9903,2.8796161674905494,0.0,0.0
3439,0,3439,[420 303 250 298 243],393,4,9907,2.879941860465116,0.0,20.0
3440,0,3440,[283 236 275 268 240],919,3,9910,2.879976750944493,0.0,20.0
3441,0,3441,[211 259 290 243 276],682,1,9911,2.879430563625799,0.0,0.0
3442,0,3442,[244 250 246 216 212],916,5,9916,2.8800464711007843,0.0,20.0
3443,0,3443,[241 232 250 222 300],301,4,9920,2.8803716608594656,0.0,40.0
3444,0,3444,[250 217 226 284 201],880,4,9924,2.8806966618287375,0.0,0.0
3445,0,3445,[264 507 250 226 239],293,1,9925,2.880150899593732,0.0,0.0
3446,0,3446,[201 216 222 226 321],201,2,9927,2.8798955613577024,0.0,40.0
3447,0,3447,[230 326 240 392 218],222,4,9931,2.8802204176334105,0.0,0.0
3448,0,3448,[509 290 232 254 431],682,1,9932,2.8796752681936795,0.0,0.0
3449,0,3449,[222 219 201 226 413],727,1,9933,2.8791304347826085,0.0,20.0
3450,0,3450,[431 223 226 227 201],94,3,9936,2.879165459287163,20.0,0.0
3451,0,3451,[218 241 392 232 223],94,2,9938,2.8789107763615296,20.0,0.0
3452,0,3452,[365 583 246 209 241],276,3,9941,2.878945844193455,0.0,0.0
3453,0,3453,[211 230 384 206 232],727,1,9942,2.8784018529241457,0.0,0.0
3454,0,3454,[276 236 272 315 243],592,3,9945,2.878437047756874,40.0,0.0
3455,0,3455,[583 321 300 215 241],303,2,9947,2.8781828703703702,0.0,20.0
3456,0,3456,[250 301 303 331 202],919,2,9949,2.8779288400347123,0.0,0.0
3457,0,3457,[232 507 227 275 231],727,1,9950,2.877385772122614,0.0,0.0
3458,0,3458,[276 223 583 213 256],916,4,9954,2.8777103209019947,20.0,0.0
3459,0,3459,[293 226 231 230 300],429,1,9955,2.8771676300578033,0.0,20.0
3460,0,3460,[300 384 272 283 365],880,1,9956,2.876625252817105,20.0,20.0
3461,0,3461,[226 222 508 291 452],130,5,9961,2.8772385904101676,0.0,20.0
3462,0,3462,[211 218 222 230 209],201,1,9962,2.876696505919723,0.0,20.0
3463,0,3463,[321 239 230 227 226],130,3,9965,2.876732101616628,0.0,0.0
3464,0,3464,[201 240 236 290 291],303,3,9968,2.8767676767676766,0.0,0.0
3465,0,3465,[275 222 326 283 244],178,4,9972,2.8770917484131564,0.0,20.0
3466,0,3466,[211 295 509 250 215],500,3,9975,2.877127199307759,0.0,0.0
3467,0,3467,[246 240 452 223 219],222,3,9978,2.8771626297577853,20.0,0.0
3468,0,3468,[232 227 392 230 264],276,2,9980,2.8769097722686654,0.0,0.0
3469,0,3469,[378 211 226 300 275],429,2,9982,2.876657060518732,0.0,20.0
3470,0,3470,[300 255 215 291 299],435,2,9984,2.8764044943820224,0.0,20.0
3471,0,3471,[367 276 431 240 365],222,3,9987,2.8764400921658986,0.0,0.0
3472,0,3472,[243 202 365 222 250],682,3,9990,2.876475669450043,0.0,20.0
3473,0,3473,[420 241 239 211 284],896,5,9995,2.8770869314910765,0.0,0.0
3474,0,3474,[284 272 509 251 275],293,2,9997,2.876834532374101,20.0,0.0
3475,0,3475,[255 251 272 250 217],1,2,9999,2.8765822784810124,20.0,0.0
3476,0,3476,[280 291 231 218 283],429,1,10000,2.876042565429968,0.0,0.0
3477,0,3477,[241 384 298 508 212],299,3,10003,2.87607820586544,0.0,20.0
3478,0,3478,[227 231 218 222 384],472,4,10007,2.8764012647312445,0.0,20.0
3479,0,3479,[212 481 344 290 452],758,3,10010,2.8764367816091956,0.0,0.0
3480,0,3480,[231 201 222 298 420],276,4,10014,2.8767595518529157,0.0,40.0
3481,0,3481,[452 239 222 324 300],758,2,10016,2.8765077541642734,0.0,40.0
3482,0,3482,[232 250 509 230 390],94,3,10019,2.876543209876543,0.0,0.0
3483,0,3483,[215 272 392 295 222],130,4,10023,2.876865671641791,20.0,20.0
3484,0,3484,[297 211 209 259 240],299,1,10024,2.8763271162123387,0.0,0.0
3485,0,3485,[231 507 250 211 226],727,2,10026,2.8760757314974184,0.0,0.0
3486,0,3486,[367 231 215 219 202],291,4,10030,2.876398049899627,0.0,0.0
3487,0,3487,[240 211 226 223 227],246,3,10033,2.876433486238532,20.0,0.0
3488,0,3488,[293 300 264 209 321],327,1,10034,2.875895672112353,0.0,20.0
3489,0,3489,[209 215 268 255 219],303,5,10039,2.8765042979942694,0.0,20.0
3490,0,3490,[291 300 290 239 276],889,2,10041,2.8762532225723287,0.0,20.0
3491,0,3491,[202 240 264 367 272],276,3,10044,2.8762886597938144,20.0,0.0
3492,0,3492,[218 222 215 231 239],222,4,10048,2.8766103635843114,0.0,20.0
3493,0,3493,[208 298 236 293 215],303,5,10053,2.8772180881511162,0.0,20.0
3494,0,3494,[275 284 236 283 221],919,4,10057,2.8775393419170245,0.0,0.0
3495,0,3495,[211 209 324 350 218],758,5,10062,2.878146453089245,0.0,0.0
3496,0,3496,[293 301 211 222 509],758,3,10065,2.878181298255648,0.0,20.0
3497,0,3497,[241 321 201 365 378],429,0,10065,2.8773584905660377,0.0,0.0
3498,0,3498,[217 392 264 284 394],435,2,10067,2.87710774507002,0.0,0.0
3499,0,3499,[216 239 231 275 215],201,2,10069,2.876857142857143,0.0,20.0
3500,0,3500,[212 219 221 268 232],916,3,10072,2.8768923164810056,0.0,20.0
3501,0,3501,[232 209 231 211 208],429,4,10076,2.8772130211307823,0.0,0.0
3502,0,3502,[216 231 384 255 226],682,1,10077,2.876677133885241,0.0,20.0
3503,0,3503,[298 202 291 219 240],435,4,10081,2.876997716894977,0.0,20.0
3504,0,3504,[227 276 208 241 316],758,3,10084,2.877032810271041,20.0,0.0
3505,0,3505,[481 212 241 232 367],896,3,10087,2.877067883628066,0.0,0.0
3506,0,3506,[268 230 222 290 231],130,2,10089,2.8768177929854577,0.0,40.0
3507,0,3507,[259 291 202 211 299],682,3,10092,2.8768529076396807,0.0,0.0
3508,0,3508,[232 226 201 202 209],94,2,10094,2.876603020803648,0.0,0.0
3509,0,3509,[217 583 255 250 291],682,2,10096,2.876353276353276,0.0,0.0
3510,0,3510,[367 276 267 316 227],130,4,10100,2.8766733124465964,20.0,0.0
3511,0,3511,[508 316 236 509 211],758,5,10105,2.877277904328018,20.0,0.0
3512,0,3512,[452 226 232 264 413],276,1,10106,2.8767435240535155,0.0,0.0
3513,0,3513,[222 298 291 283 275],429,4,10110,2.877063175867957,0.0,40.0
3514,0,3514,[240 241 208 222 300],621,4,10114,2.8773826458036984,0.0,40.0
3515,0,3515,[201 222 226 232 220],1,1,10115,2.876848691695108,0.0,20.0
3516,0,3516,[298 268 239 413 251],303,3,10118,2.8768837077054306,0.0,40.0
3517,0,3517,[212 478 272 215 275],305,0,10118,2.8760659465605456,40.0,0.0
3518,0,3518,[284 244 239 227 217],268,2,10120,2.8758169934640523,0.0,0.0
3519,0,3519,[226 293 217 276 255],130,4,10124,2.8761363636363635,0.0,0.0
3520,0,3520,[291 218 264 219 244],21,3,10127,2.8761715421755185,0.0,0.0
3521,0,3521,[227 384 264 290 211],435,2,10129,2.875922771152754,0.0,0.0
3522,0,3522,[295 326 508 298 201],919,2,10131,2.8756741413567983,0.0,20.0
3523,0,3523,[246 202 291 240 232],521,1,10132,2.8751418842224745,0.0,0.0
3524,0,3524,[217 208 226 316 264],293,0,10132,2.8743262411347517,20.0,0.0
3525,0,3525,[244 231 212 365 367],291,2,10134,2.8740782756664776,0.0,0.0
3526,0,3526,[241 367 272 250 209],682,3,10137,2.874113977884888,20.0,0.0
3527,0,3527,[392 321 295 316 206],130,3,10140,2.8741496598639458,20.0,0.0
3528,0,3528,[239 316 300 215 201],276,5,10145,2.8747520544063474,20.0,20.0
3529,0,3529,[264 259 261 209 239],1,2,10147,2.8745042492917845,0.0,0.0
3530,0,3530,[326 300 236 268 221],181,0,10147,2.8736901727555932,0.0,40.0
3531,0,3531,[344 275 211 209 259],514,2,10149,2.8734428086070216,0.0,0.0
3532,0,3532,[291 219 240 321 201],21,3,10152,2.8734786300594397,0.0,0.0
3533,0,3533,[583 209 420 264 508],276,3,10155,2.8735144312393888,0.0,0.0
3534,0,3534,[226 284 431 232 216],551,5,10160,2.8741159830268743,0.0,20.0
3535,0,3535,[209 298 478 201 211],327,3,10163,2.874151583710407,20.0,20.0
3536,0,3536,[219 268 255 208 230],303,4,10167,2.8744698897370653,0.0,20.0
3537,0,3537,[284 478 244 275 268],178,4,10171,2.8747880158281514,20.0,20.0
3538,0,3538,[231 226 213 227 485],846,3,10174,2.8748233964396723,0.0,0.0
3539,0,3539,[211 316 291 280 232],551,4,10178,2.875141242937853,20.0,0.0
3540,0,3540,[272 431 222 255 211],682,4,10182,2.875458909912454,20.0,20.0
3541,0,3541,[232 215 250 272 230],1,2,10184,2.875211744776962,20.0,0.0
3542,0,3542,[583 293 246 290 284],303,4,10188,2.875529212531753,0.0,0.0
3543,0,3543,[255 300 201 431 222],435,1,10189,2.875,0.0,40.0
3544,0,3544,[392 241 452 384 232],896,1,10190,2.8744710860366713,0.0,0.0
3545,0,3545,[216 344 316 509 293],758,3,10193,2.874506486181613,20.0,20.0
3546,0,3546,[218 215 240 223 241],561,1,10194,2.8739780095855654,20.0,0.0
3547,0,3547,[240 221 223 250 239],303,3,10197,2.874013528748591,20.0,0.0
3548,0,3548,[321 264 230 239 202],303,1,10198,2.8734854888701045,0.0,0.0
3549,0,3549,[326 367 452 222 290],303,2,10200,2.8732394366197185,0.0,20.0
3550,0,3550,[275 217 276 331 303],919,5,10205,2.8738383553928473,0.0,0.0
3551,0,3551,[298 202 284 290 206],130,2,10207,2.8735923423423424,0.0,20.0
3552,0,3552,[222 221 211 255 217],1,2,10209,2.8733464677737124,0.0,20.0
3553,0,3553,[365 367 232 507 481],429,2,10211,2.873100731570062,0.0,0.0
3554,0,3554,[284 216 208 300 209],429,3,10214,2.8731364275668074,0.0,40.0
3555,0,3555,[202 217 583 250 206],276,4,10218,2.873453318335208,0.0,0.0
3556,0,3556,[217 331 240 420 508],758,2,10220,2.873207759347765,0.0,0.0
3557,0,3557,[268 255 321 227 283],303,2,10222,2.8729623383923553,0.0,20.0
3558,0,3558,[583 231 226 227 219],933,0,10222,2.87215509974712,0.0,0.0
3559,0,3559,[378 223 219 250 247],222,2,10224,2.8719101123595507,20.0,0.0
3560,0,3560,[212 208 344 231 223],758,3,10227,2.8719460825610783,20.0,0.0
3561,0,3561,[290 250 243 217 431],682,3,10230,2.871982032565974,0.0,0.0
3562,0,3562,[209 231 232 250 284],222,2,10232,2.8717373000280664,0.0,0.0
3563,0,3563,[215 276 384 230 227],303,2,10234,2.8714927048260384,0.0,0.0
3564,0,3564,[336 202 350 268 297],592,4,10238,2.8718092566619915,0.0,20.0
3565,0,3565,[344 367 259 272 239],393,3,10241,2.871845204711161,20.0,0.0
3566,0,3566,[232 226 280 365 284],880,3,10244,2.8718811326044293,0.0,0.0
3567,0,3567,[509 211 217 215 583],682,3,10247,2.871917040358744,0.0,0.0
3568,0,3568,[509 201 240 276 241],682,3,10250,2.871952927991034,0.0,0.0
3569,0,3569,[268 246 431 275 216],305,2,10252,2.8717086834733894,0.0,40.0
3570,0,3570,[259 216 268 226 209],178,4,10256,2.8720246429571548,0.0,40.0
3571,0,3571,[583 452 223 246 227],303,2,10258,2.8717805151175813,20.0,0.0
3572,0,3572,[202 297 331 250 298],592,4,10262,2.8720962776378394,0.0,20.0
3573,0,3573,[202 251 256 246 255],1,4,10266,2.8724118634583102,0.0,0.0
3574,0,3574,[284 392 216 290 420],435,1,10267,2.871888111888112,0.0,20.0
3575,0,3575,[240 283 326 264 321],181,0,10267,2.8710850111856825,0.0,0.0
3576,0,3576,[215 290 326 507 293],303,4,10271,2.8714006150405367,0.0,0.0
3577,0,3577,[222 431 230 254 219],276,3,10274,2.8714365567356066,0.0,20.0
3578,0,3578,[219 284 226 215 208],435,3,10277,2.8714724783459067,0.0,0.0
3579,0,3579,[208 206 226 217 384],268,2,10279,2.8712290502793296,0.0,0.0
3580,0,3580,[316 215 291 240 297],293,2,10281,2.8709857581681093,20.0,0.0
3581,0,3581,[219 250 264 284 268],303,4,10285,2.8713009491903962,0.0,20.0
3582,0,3582,[239 392 293 206 259],487,4,10289,2.8716159642757466,0.0,0.0
3583,0,3583,[264 202 231 250 392],429,1,10290,2.87109375,0.0,0.0
3584,0,3584,[215 283 384 413 293],303,2,10292,2.8708507670850767,0.0,0.0
3585,0,3585,[255 231 298 218 290],682,1,10293,2.870329057445622,0.0,20.0
3586,0,3586,[217 367 227 583 284],790,3,10296,2.8703652076944524,0.0,0.0
3587,0,3587,[206 244 232 212 259],1,2,10298,2.870122630992196,0.0,0.0
3588,0,3588,[478 365 211 429 226],846,2,10300,2.8698801894678185,20.0,0.0
3589,0,3589,[222 231 217 218 215],363,1,10301,2.869359331476323,0.0,20.0
3590,0,3590,[300 315 326 268 485],305,1,10302,2.8688387635756056,20.0,40.0
3591,0,3591,[264 367 223 300 284],293,1,10303,2.8683184855233854,20.0,20.0
3592,0,3592,[236 222 300 216 221],758,3,10306,2.8683551349846925,0.0,60.0
3593,0,3593,[283 431 250 284 202],622,4,10310,2.86867000556483,0.0,0.0
3594,0,3594,[431 365 211 507 276],429,4,10314,2.8689847009735745,0.0,0.0
3595,0,3595,[303 331 452 215 316],276,4,10318,2.8692992213570636,20.0,0.0
3596,0,3596,[211 250 291 206 230],293,2,10320,2.8690575479566305,0.0,0.0
3597,0,3597,[231 290 384 367 218],682,0,10320,2.868260144524736,0.0,0.0
3598,0,3598,[256 240 219 216 215],1,2,10322,2.8680188941372604,0.0,20.0
3599,0,3599,[254 276 284 226 295],880,4,10326,2.868333333333333,0.0,0.0
3600,0,3600,[212 226 217 222 246],1,3,10329,2.868369897250764,0.0,20.0
3601,0,3601,[239 280 297 420 208],293,2,10331,2.868128817323709,0.0,0.0
3602,0,3602,[215 384 218 284 298],682,3,10334,2.868165417707466,0.0,20.0
3603,0,3603,[507 276 321 223 246],303,4,10338,2.8684794672586014,20.0,0.0
3604,0,3604,[246 280 202 254 211],682,3,10341,2.868515950069348,0.0,0.0
3605,0,3605,[420 268 202 331 232],276,4,10345,2.8688297282307267,0.0,20.0
3606,0,3606,[392 250 211 232 215],94,3,10348,2.8688660937066817,0.0,0.0
3607,0,3607,[509 208 583 255 283],293,0,10348,2.868070953436807,0.0,0.0
3608,0,3608,[255 272 222 280 232],487,4,10352,2.86838459407038,20.0,20.0
3609,0,3609,[298 315 331 365 293],276,4,10356,2.868698060941828,20.0,20.0
3610,0,3610,[507 209 283 221 250],303,4,10360,2.869011354195514,0.0,0.0
3611,0,3611,[509 216 211 226 219],682,2,10362,2.8687707641196014,0.0,20.0
3612,0,3612,[268 275 208 239 283],514,5,10367,2.8693606421256574,0.0,20.0
3613,0,3613,[485 232 215 208 259],790,1,10368,2.868843386828998,0.0,0.0
3614,0,3614,[221 384 293 583 413],303,2,10370,2.868603042876902,0.0,0.0
3615,0,3615,[272 298 280 316 293],880,4,10374,2.8689159292035398,40.0,20.0
3616,0,3616,[219 324 316 217 201],425,1,10375,2.8683992258777993,20.0,0.0
3617,0,3617,[223 211 231 300 508],429,3,10378,2.8684355997788833,20.0,20.0
3618,0,3618,[297 324 223 221 201],592,5,10383,2.8690245924288478,20.0,0.0
3619,0,3619,[246 431 240 202 290],276,4,10387,2.8693370165745855,0.0,0.0
3620,0,3620,[297 291 275 290 255],293,1,10388,2.8688207677437174,0.0,0.0
3621,0,3621,[241 316 367 250 291],276,3,10391,2.86885698509111,20.0,0.0
3622,0,3622,[250 508 223 259 298],303,4,10395,2.8691691967982336,20.0,20.0
3623,0,3623,[284 216 250 301 256],363,0,10395,2.868377483443709,0.0,20.0
3624,0,3624,[211 300 264 321 217],429,1,10396,2.8678620689655174,0.0,20.0
3625,0,3625,[226 219 507 293 223],303,5,10401,2.868450082735797,20.0,0.0
3626,0,3626,[213 239 221 222 219],201,2,10403,2.8682106424041907,0.0,20.0
3627,0,3627,[216 202 215 211 208],514,4,10407,2.8685226019845644,0.0,20.0
3628,0,3628,[209 268 202 239 230],846,4,10411,2.868834389639019,0.0,20.0
3629,0,3629,[508 216 246 232 202],94,2,10413,2.868595041322314,0.0,20.0
3630,0,3630,[420 209 232 293 219],682,1,10414,2.8680804186174607,0.0,0.0
3631,0,3631,[392 217 485 222 219],429,2,10416,2.86784140969163,0.0,20.0
3632,0,3632,[507 452 227 215 226],303,3,10419,2.8678777869529313,0.0,0.0
3633,0,3633,[209 276 230 326 217],222,4,10423,2.868189323059989,0.0,0.0
3634,0,3634,[202 226 300 246 365],276,4,10427,2.8685006877579093,0.0,20.0
3635,0,3635,[208 240 227 290 284],268,2,10429,2.8682618261826183,0.0,0.0
3636,0,3636,[276 267 227 290 243],130,2,10431,2.868023095958207,0.0,0.0
3637,0,3637,[215 202 211 583 316],551,4,10435,2.8683342495876856,20.0,0.0
3638,0,3638,[300 241 223 298 231],303,4,10439,2.8686452322066502,20.0,40.0
3639,0,3639,[201 291 216 392 219],429,3,10442,2.8686813186813187,0.0,20.0
3640,0,3640,[216 259 280 583 240],682,2,10444,2.8684427355122217,0.0,20.0
3641,0,3641,[297 232 290 223 583],293,2,10446,2.868204283360791,20.0,0.0
3642,0,3642,[315 222 206 201 212],363,1,10447,2.867691463079879,20.0,20.0
3643,0,3643,[508 384 280 276 217],551,2,10449,2.8674533479692648,0.0,0.0
3644,0,3644,[264 241 232 290 230],429,1,10450,2.8669410150891634,0.0,0.0
3645,0,3645,[291 243 295 255 300],130,3,10453,2.866977509599561,0.0,20.0
3646,0,3646,[255 246 218 344 239],327,2,10455,2.866739786125583,0.0,0.0
3647,0,3647,[230 231 392 215 202],56,4,10459,2.8670504385964914,0.0,0.0
3648,0,3648,[299 290 250 301 508],104,1,10460,2.866538777747328,0.0,0.0
3649,0,3649,[208 394 239 206 250],435,5,10465,2.867123287671233,0.0,0.0
3650,0,3650,[300 384 254 290 284],435,0,10465,2.8663379895918926,0.0,20.0
3651,0,3651,[230 301 293 331 211],758,3,10468,2.8663745892661554,0.0,0.0
3652,0,3652,[481 231 239 276 227],758,2,10470,2.8661374212975637,0.0,0.0
3653,0,3653,[316 254 264 218 291],276,2,10472,2.8659003831417627,20.0,0.0
3654,0,3654,[231 232 298 316 384],880,3,10475,2.86593707250342,20.0,20.0
3655,0,3655,[215 429 485 231 226],846,3,10478,2.8659737417943107,0.0,0.0
3656,0,3656,[431 216 250 392 298],222,4,10482,2.8662838392124694,0.0,40.0
3657,0,3657,[293 275 222 223 508],429,5,10487,2.866867140513942,20.0,20.0
3658,0,3658,[299 284 264 431 290],435,1,10488,2.8663569281224377,0.0,0.0
3659,0,3659,[284 246 201 508 413],276,4,10492,2.8666666666666667,0.0,0.0
3660,0,3660,[280 212 394 316 217],286,3,10495,2.866703086588364,20.0,0.0
3661,0,3661,[217 201 206 384 232],268,0,10495,2.8659202621518296,0.0,0.0
3662,0,3662,[250 300 291 202 201],276,4,10499,2.866229866229866,0.0,20.0
3663,0,3663,[431 206 226 291 378],727,2,10501,2.8659934497816595,0.0,0.0
3664,0,3664,[218 295 255 250 276],130,3,10504,2.8660300136425647,0.0,0.0
3665,0,3665,[222 223 215 230 250],916,2,10506,2.865793780687398,20.0,20.0
3666,0,3666,[231 226 230 222 208],880,3,10509,2.865830379056449,0.0,20.0
3667,0,3667,[326 283 300 298 232],178,4,10513,2.8661395856052345,0.0,40.0
3668,0,3668,[431 219 300 217 299],896,0,10513,2.8653584082856365,0.0,20.0
3669,0,3669,[240 324 256 220 264],181,1,10514,2.864850136239782,0.0,0.0
3670,0,3670,[230 232 272 246 241],276,4,10518,2.8651593571233995,20.0,0.0
3671,0,3671,[222 227 209 236 223],1,5,10523,2.865740740740741,20.0,20.0
3672,0,3672,[264 230 208 259 321],303,1,10524,2.8652327797440784,0.0,0.0
3673,0,3673,[392 255 283 241 259],393,4,10528,2.865541643984758,0.0,0.0
3674,0,3674,[276 209 264 420 268],276,4,10532,2.8658503401360544,0.0,20.0
3675,0,3675,[268 259 218 583 208],303,3,10535,2.86588683351469,0.0,20.0
3676,0,3676,[300 276 316 243 226],130,4,10539,2.866195267881425,20.0,20.0
3677,0,3677,[259 222 300 261 275],919,3,10542,2.866231647634584,0.0,40.0
3678,0,3678,[300 211 227 231 384],896,2,10544,2.865996194618103,0.0,20.0
3679,0,3679,[222 276 236 290 202],130,4,10548,2.866304347826087,0.0,20.0
3680,0,3680,[241 246 201 509 230],94,4,10552,2.8666123336049987,0.0,0.0
3681,0,3681,[209 223 206 211 303],293,4,10556,2.8669201520912546,20.0,0.0
3682,0,3682,[244 226 232 216 295],178,3,10559,2.866956285636709,0.0,20.0
3683,0,3683,[413 240 299 268 508],130,3,10562,2.8669923995656896,0.0,20.0
3684,0,3684,[431 420 251 295 298],532,5,10567,2.8675712347354136,0.0,20.0
3685,0,3685,[223 261 222 209 293],222,3,10570,2.8676071622354855,20.0,20.0
3686,0,3686,[240 384 231 255 290],303,3,10573,2.867643070246813,0.0,0.0
3687,0,3687,[291 300 331 272 227],130,3,10576,2.8676789587852496,20.0,20.0
3688,0,3688,[303 264 315 232 507],293,2,10578,2.867443751694226,20.0,0.0
3689,0,3689,[218 231 226 215 202],846,4,10582,2.867750677506775,0.0,0.0
3690,0,3690,[508 298 241 227 284],347,2,10584,2.8675155784340287,0.0,20.0
3691,0,3691,[507 216 219 222 384],303,3,10587,2.867551462621885,0.0,40.0
3692,0,3692,[232 326 202 241 255],222,3,10590,2.8675873273761168,0.0,0.0
3693,0,3693,[231 208 429 509 508],747,4,10594,2.8678938819707636,0.0,0.0
3694,0,3694,[227 291 202 250 295],130,2,10596,2.86765899864682,0.0,0.0
3695,0,3695,[275 231 211 201 206],201,2,10598,2.867424242424242,0.0,0.0
3696,0,3696,[215 509 485 227 507],846,4,10602,2.867730592372194,0.0,0.0
3697,0,3697,[420 218 206 290 209],276,5,10607,2.868307193077339,0.0,0.0
3698,0,3698,[276 217 420 222 243],682,2,10609,2.868072452014058,0.0,20.0
3699,0,3699,[367 267 254 290 239],130,3,10612,2.868108108108108,0.0,0.0
3700,0,3700,[284 222 217 255 303],919,3,10615,2.8681437449338016,0.0,20.0
3701,0,3701,[206 231 246 452 392],130,3,10618,2.868179362506753,0.0,0.0
3702,0,3702,[251 255 215 284 420],293,3,10621,2.8682149608425602,0.0,0.0
3703,0,3703,[217 246 290 218 222],268,2,10623,2.8679805615550755,0.0,20.0
3704,0,3704,[509 251 216 221 384],773,2,10625,2.8677462887989202,0.0,20.0
3705,0,3705,[301 230 350 508 316],758,4,10629,2.868051807879115,20.0,0.0
3706,0,3706,[303 226 232 231 268],889,1,10630,2.867547882384678,0.0,20.0
3707,0,3707,[241 212 206 223 264],1,4,10634,2.8678532901833873,20.0,0.0
3708,0,3708,[246 243 291 336 508],592,2,10636,2.8676193043947156,0.0,0.0
3709,0,3709,[324 232 298 508 478],327,2,10638,2.8673854447439355,20.0,20.0
3710,0,3710,[300 227 316 276 284],130,3,10641,2.8674211802748584,20.0,20.0
3711,0,3711,[481 276 212 222 223],758,4,10645,2.8677262931034484,20.0,20.0
3712,0,3712,[420 218 290 216 232],682,1,10646,2.8672232695933206,0.0,20.0
3713,0,3713,[268 413 508 226 232],201,2,10648,2.8669897684437267,0.0,20.0
3714,0,3714,[508 232 291 218 212],291,5,10653,2.8675639300134588,0.0,0.0
3715,0,3715,[485 222 211 284 321],429,2,10655,2.867330462863294,0.0,20.0
3716,0,3716,[331 299 324 201 291],592,2,10657,2.8670971213344094,0.0,0.0
3717,0,3717,[251 232 268 291 221],303,4,10661,2.8674018289402903,0.0,20.0
3718,0,3718,[324 231 315 232 226],466,3,10664,2.867437483194407,20.0,0.0
3719,0,3719,[429 254 420 431 209],276,3,10667,2.86747311827957,0.0,0.0
3720,0,3720,[293 291 280 378 202],682,2,10669,2.8672399892502014,0.0,0.0
3721,0,3721,[507 251 217 230 291],293,2,10671,2.8670069854916713,0.0,0.0
3722,0,3722,[209 264 232 251 215],303,4,10675,2.867311308084878,0.0,0.0
3723,0,3723,[251 232 413 208 223],303,4,10679,2.8676154672395273,20.0,0.0
3724,0,3724,[226 321 290 268 326],130,4,10683,2.867919463087248,0.0,20.0
3725,0,3725,[365 300 202 291 217],551,4,10687,2.8682232957595275,0.0,20.0
3726,0,3726,[226 241 583 209 259],303,3,10690,2.868258653072176,0.0,0.0
3727,0,3727,[255 367 303 284 290],293,1,10691,2.867757510729614,0.0,0.0
3728,0,3728,[232 226 231 230 219],495,4,10695,2.8680611423974254,0.0,0.0
3729,0,3729,[226 316 324 241 217],276,5,10700,2.868632707774799,20.0,0.0
3730,0,3730,[321 222 211 227 284],435,2,10702,2.8683998927901366,0.0,20.0
3731,0,3731,[392 223 413 239 316],276,3,10705,2.8684351554126475,40.0,0.0
3732,0,3732,[301 392 232 241 230],429,1,10706,2.8679346370211625,0.0,0.0
3733,0,3733,[259 209 293 291 420],303,3,10709,2.8679700053561863,0.0,0.0
3734,0,3734,[298 420 240 215 208],303,4,10713,2.8682730923694777,0.0,20.0
3735,0,3735,[365 220 291 217 241],244,2,10715,2.8680406852248392,0.0,0.0
3736,0,3736,[350 301 221 291 246],592,3,10718,2.868075996788868,0.0,0.0
3737,0,3737,[226 231 239 211 429],896,3,10721,2.868111289459604,0.0,0.0
3738,0,3738,[218 384 222 264 298],268,1,10722,2.8676116608718907,0.0,40.0
3739,0,3739,[223 230 209 290 231],303,4,10726,2.8679144385026736,20.0,0.0
3740,0,3740,[211 226 583 365 222],551,4,10730,2.868217054263566,0.0,20.0
3741,0,3741,[315 227 344 481 301],758,3,10733,2.86825227151256,20.0,0.0
3742,0,3742,[290 222 316 283 420],393,2,10735,2.8680203045685277,20.0,20.0
3743,0,3743,[298 227 219 226 202],130,4,10739,2.8683226495726495,0.0,20.0
3744,0,3744,[452 223 303 509 231],758,3,10742,2.8683578104138854,20.0,0.0
3745,0,3745,[216 232 300 420 284],301,4,10746,2.8686599038974907,0.0,40.0
3746,0,3746,[284 300 219 202 201],435,3,10749,2.868694955964772,0.0,20.0
3747,0,3747,[221 255 295 243 291],592,3,10752,2.8687299893276412,0.0,0.0
3748,0,3748,[452 276 206 250 226],276,4,10756,2.8690317417978126,0.0,0.0
3749,0,3749,[303 413 300 259 275],181,0,10756,2.8682666666666665,0.0,20.0
3750,0,3750,[232 280 316 284 226],551,4,10760,2.8685683817648626,20.0,0.0
3751,0,3751,[221 222 431 303 324],592,3,10763,2.8686034115138592,0.0,20.0
3752,0,3752,[223 231 232 507 251],303,5,10768,2.869171329602984,20.0,0.0
3753,0,3753,[243 384 420 367 255],682,0,10768,2.868407032498668,0.0,0.0
3754,0,3754,[316 202 485 290 259],660,3,10771,2.8684420772303594,20.0,0.0
3755,0,3755,[268 236 215 507 367],303,5,10776,2.869009584664537,0.0,20.0
3756,0,3756,[226 452 209 230 384],268,2,10778,2.8687782805429864,0.0,0.0
3757,0,3757,[226 239 232 219 298],276,4,10782,2.8690792974986694,0.0,20.0
3758,0,3758,[303 326 246 350 215],592,5,10787,2.8696461824953445,0.0,0.0
3759,0,3759,[230 315 316 268 293],880,4,10791,2.869946808510638,40.0,20.0
3760,0,3760,[230 250 431 217 280],222,2,10793,2.8697155011964903,0.0,0.0
3761,0,3761,[291 239 324 290 283],303,1,10794,2.869218500797448,0.0,0.0
3762,0,3762,[293 291 331 215 452],276,3,10797,2.8692532553813446,0.0,0.0
3763,0,3763,[268 239 218 256 259],1,3,10800,2.869287991498406,0.0,20.0
3764,0,3764,[283 230 367 284 208],880,3,10803,2.8693227091633466,0.0,0.0
3765,0,3765,[315 215 232 226 231],110,1,10804,2.8688263409453,20.0,0.0
3766,0,3766,[283 222 239 211 250],727,3,10807,2.868861162728962,0.0,20.0
3767,0,3767,[209 255 239 508 217],327,1,10808,2.8683651804670913,0.0,0.0
3768,0,3768,[508 223 211 367 420],94,5,10813,2.868930750862298,20.0,0.0
3769,0,3769,[231 478 222 508 223],896,3,10816,2.8689655172413793,40.0,20.0
3770,0,3770,[324 315 236 344 268],592,4,10820,2.869265446831079,20.0,20.0
3771,0,3771,[276 236 350 221 202],758,3,10823,2.869300106044539,0.0,0.0
3772,0,3772,[251 226 275 227 209],293,1,10824,2.868804664723032,0.0,0.0
3773,0,3773,[211 268 392 321 284],435,2,10826,2.868574456809751,0.0,20.0
3774,0,3774,[227 240 206 251 231],1,3,10829,2.868609271523179,0.0,0.0
3775,0,3775,[223 202 272 241 276],276,5,10834,2.8691737288135593,40.0,0.0
3776,0,3776,[219 222 227 209 231],864,3,10837,2.8692083664283823,0.0,20.0
3777,0,3777,[583 232 508 290 246],303,4,10841,2.8695076760190577,0.0,0.0
3778,0,3778,[276 243 508 267 300],130,4,10845,2.8698068272029635,0.0,20.0
3779,0,3779,[508 243 284 254 250],130,1,10846,2.8693121693121695,0.0,0.0
3780,0,3780,[218 367 283 268 201],880,4,10850,2.8696112139645598,0.0,20.0
3781,0,3781,[280 392 264 216 298],429,2,10852,2.869381279746166,0.0,40.0
3782,0,3782,[231 291 299 268 216],682,3,10855,2.8694158075601375,0.0,40.0
3783,0,3783,[284 315 299 222 255],130,3,10858,2.869450317124736,20.0,20.0
3784,0,3784,[240 209 217 202 211],561,2,10860,2.869220607661823,0.0,0.0
3785,0,3785,[240 420 226 390 230],303,2,10862,2.8689910195456947,0.0,0.0
3786,0,3786,[215 212 255 221 241],1,3,10865,2.869025613942435,0.0,0.0
3787,0,3787,[232 485 367 222 227],429,2,10867,2.8687961985216472,0.0,20.0
3788,0,3788,[255 268 202 331 297],919,3,10870,2.868830826075482,0.0,20.0
3789,0,3789,[206 321 264 255 420],435,2,10872,2.8686015831134566,0.0,0.0
3790,0,3790,[217 276 268 384 508],551,3,10875,2.8686362437351622,0.0,20.0
3791,0,3791,[209 215 222 202 291],293,1,10876,2.8681434599156117,0.0,20.0
3792,0,3792,[254 217 216 208 232],472,5,10881,2.868705510150277,0.0,20.0
3793,0,3793,[209 298 231 232 301],429,3,10884,2.8687401159725883,0.0,20.0
3794,0,3794,[276 485 226 209 291],429,3,10887,2.868774703557312,0.0,0.0
3795,0,3795,[239 246 219 583 291],303,2,10889,2.86854583772392,0.0,0.0
3796,0,3796,[232 507 216 227 275],429,4,10893,2.8688438240716354,0.0,20.0
3797,0,3797,[246 291 324 272 209],276,4,10897,2.8691416535018432,20.0,0.0
3798,0,3798,[222 226 246 298 223],178,4,10901,2.8694393261384574,20.0,40.0
3799,0,3799,[384 367 331 250 268],435,3,10904,2.869473684210526,0.0,20.0
3800,0,3800,[202 250 219 217 293],327,2,10906,2.869244935543278,0.0,0.0
3801,0,3801,[239 201 236 326 211],606,4,10910,2.869542346133614,0.0,0.0
3802,0,3802,[350 239 226 298 216],130,5,10915,2.870102550617933,0.0,40.0
3803,0,3803,[255 250 231 219 268],1,2,10917,2.8698738170347005,0.0,20.0
3804,0,3804,[222 264 324 201 275],327,2,10919,2.869645203679369,0.0,20.0
3805,0,3805,[226 246 293 231 298],222,2,10921,2.869416710457173,0.0,20.0
3806,0,3806,[300 240 350 331 230],758,3,10924,2.869451011294983,0.0,20.0
3807,0,3807,[508 223 208 583 230],94,3,10927,2.869485294117647,20.0,0.0
3808,0,3808,[290 216 255 316 250],407,4,10931,2.869782095038068,20.0,20.0
3809,0,3809,[250 239 300 240 384],303,1,10932,2.869291338582677,0.0,20.0
3810,0,3810,[583 209 231 384 236],303,3,10935,2.8693256363159274,0.0,0.0
3811,0,3811,[250 222 420 255 316],130,4,10939,2.869622245540399,20.0,20.0
3812,0,3812,[350 219 331 300 239],130,4,10943,2.869918699186992,0.0,20.0
3813,0,3813,[231 481 272 290 222],758,4,10947,2.870214997378081,20.0,20.0
3814,0,3814,[275 367 429 216 202],896,4,10951,2.870511140235911,0.0,20.0
3815,0,3815,[276 217 268 283 298],919,3,10954,2.870545073375262,0.0,40.0
3816,0,3816,[297 264 508 236 255],919,4,10958,2.8708409745873724,0.0,0.0
3817,0,3817,[246 284 367 223 283],303,4,10962,2.8711367207962284,20.0,0.0
3818,0,3818,[226 326 239 221 315],201,0,10962,2.8703849175176748,20.0,0.0
3819,0,3819,[291 236 283 208 290],303,3,10965,2.8704188481675392,0.0,0.0
3820,0,3820,[259 255 250 331 315],592,3,10968,2.8704527610573147,20.0,0.0
3821,0,3821,[280 293 255 241 215],222,1,10969,2.86996336996337,0.0,0.0
3822,0,3822,[259 206 272 276 215],487,3,10972,2.8699973842532045,20.0,0.0
3823,0,3823,[215 300 303 392 272],276,4,10976,2.8702928870292888,20.0,20.0
3824,0,3824,[268 246 298 272 261],130,5,10981,2.8708496732026143,20.0,40.0
3825,0,3825,[250 216 259 215 218],682,3,10984,2.8708834291688445,0.0,20.0
3826,0,3826,[300 226 324 431 365],551,4,10988,2.871178468774497,0.0,20.0
3827,0,3827,[209 241 331 246 202],276,5,10993,2.8717345872518285,0.0,0.0
3828,0,3828,[226 232 243 240 300],880,3,10996,2.871768085662053,0.0,20.0
3829,0,3829,[268 223 276 246 284],399,0,10996,2.871018276762402,20.0,20.0
3830,0,3830,[350 295 276 230 226],130,3,10999,2.8710519446619682,0.0,0.0
3831,0,3831,[226 244 291 202 223],407,3,11002,2.8710855949895615,20.0,0.0
3832,0,3832,[276 218 326 268 216],303,4,11006,2.8713801200104356,0.0,40.0
3833,0,3833,[367 232 206 481 241],896,3,11009,2.8714136671883153,0.0,0.0
3834,0,3834,[250 222 272 509 254],682,3,11012,2.8714471968709256,20.0,20.0
3835,0,3835,[367 254 298 202 284],880,4,11016,2.8717413972888424,0.0,20.0
3836,0,3836,[216 367 250 243 202],682,3,11019,2.8717748240813137,0.0,20.0
3837,0,3837,[275 367 478 255 297],299,3,11022,2.8718082334549244,20.0,0.0
3838,0,3838,[226 284 209 272 206],293,2,11024,2.8715811409221152,20.0,0.0
3839,0,3839,[217 247 241 276 365],222,2,11026,2.871354166666667,0.0,0.0
3840,0,3840,[216 213 256 202 290],916,2,11028,2.871127310596199,0.0,20.0
3841,0,3841,[298 219 268 316 331],130,4,11032,2.871421134825612,20.0,40.0
3842,0,3842,[218 384 241 259 246],303,3,11035,2.871454592766068,0.0,0.0
3843,0,3843,[218 226 298 202 485],429,2,11037,2.8712278876170654,0.0,20.0
3844,0,3844,[226 215 208 240 508],244,3,11040,2.871261378413524,0.0,0.0
3845,0,3845,[293 507 303 280 222],293,3,11043,2.871294851794072,0.0,20.0
3846,0,3846,[275 303 240 222 259],181,1,11044,2.8708084221471277,0.0,20.0
3847,0,3847,[212 215 232 231 481],896,2,11046,2.8705821205821205,0.0,0.0
3848,0,3848,[246 226 212 272 268],1,3,11049,2.8706157443491818,20.0,20.0
3849,0,3849,[226 509 217 300 223],682,1,11050,2.8701298701298703,20.0,20.0
3850,0,3850,[298 216 209 226 367],916,1,11051,2.8696442482472087,0.0,40.0
3851,0,3851,[429 290 291 209 297],293,2,11053,2.8694184839044654,0.0,0.0
3852,0,3852,[226 321 221 452 227],201,1,11054,2.8689332987282636,0.0,0.0
3853,0,3853,[250 227 321 295 222],130,2,11056,2.86870783601453,0.0,20.0
3854,0,3854,[303 384 202 331 583],276,3,11059,2.8687418936446174,0.0,0.0
3855,0,3855,[219 246 231 367 259],727,2,11061,2.8685165975103732,0.0,0.0
3856,0,3856,[240 236 301 283 255],919,3,11064,2.8685506870624837,0.0,0.0
3857,0,3857,[284 206 429 583 227],293,2,11066,2.8683255572835664,0.0,0.0
3858,0,3858,[303 268 431 275 215],201,2,11068,2.8681005441824308,0.0,20.0
3859,0,3859,[250 202 431 280 384],682,3,11071,2.868134715025907,0.0,0.0
3860,0,3860,[303 202 239 298 283],393,3,11074,2.868168868168868,0.0,20.0
3861,0,3861,[240 227 268 232 290],276,4,11078,2.8684619368203004,0.0,20.0
3862,0,3862,[420 293 217 413 331],276,4,11082,2.868754853740616,0.0,0.0
3863,0,3863,[222 231 321 239 261],130,4,11086,2.869047619047619,0.0,20.0
3864,0,3864,[218 227 367 507 324],303,3,11089,2.8690815006468307,0.0,0.0
3865,0,3865,[452 218 324 485 226],456,3,11092,2.8691153647180547,0.0,0.0
3866,0,3866,[241 429 392 481 250],896,3,11095,2.86914921127489,0.0,0.0
3867,0,3867,[230 222 583 217 264],429,1,11096,2.8686659772492242,0.0,20.0
3868,0,3868,[259 365 215 272 232],682,2,11098,2.868441457741018,20.0,0.0
3869,0,3869,[280 255 227 284 315],293,0,11098,2.867700258397933,20.0,0.0
3870,0,3870,[283 240 208 392 272],880,3,11101,2.8677344355463705,20.0,0.0
3871,0,3871,[284 431 211 298 365],429,3,11104,2.8677685950413223,0.0,20.0
3872,0,3872,[452 291 301 202 211],758,3,11107,2.8678027368964627,0.0,0.0
3873,0,3873,[384 219 250 275 392],896,1,11108,2.867320598864223,0.0,0.0
3874,0,3874,[243 299 315 326 250],130,2,11110,2.8670967741935485,20.0,0.0
3875,0,3875,[508 216 276 583 226],551,4,11114,2.867389060887513,0.0,20.0
3876,0,3876,[243 223 240 261 259],919,2,11116,2.8671653340211503,20.0,0.0
3877,0,3877,[220 301 324 240 336],181,1,11117,2.866683857658587,0.0,0.0
3878,0,3878,[295 240 202 321 315],919,0,11117,2.865944831142047,20.0,0.0
3879,0,3879,[202 268 219 583 218],870,1,11118,2.8654639175257732,0.0,20.0
3880,0,3880,[350 336 236 202 295],592,3,11121,2.8654985828394746,0.0,0.0
3881,0,3881,[300 208 420 219 321],435,3,11124,2.865533230293663,0.0,20.0
3882,0,3882,[326 316 331 293 227],130,3,11127,2.8655678599021375,20.0,0.0
3883,0,3883,[284 267 246 227 276],130,3,11130,2.865602471678682,0.0,0.0
3884,0,3884,[280 209 211 227 240],293,1,11131,2.865122265122265,0.0,0.0
3885,0,3885,[216 208 231 227 226],864,3,11134,2.86515697375193,0.0,20.0
3886,0,3886,[344 315 239 384 303],393,3,11137,2.865191664522768,20.0,0.0
3887,0,3887,[583 218 209 284 227],933,0,11137,2.8644547325102883,0.0,0.0
3888,0,3888,[508 208 290 283 251],303,4,11141,2.864746721522242,0.0,0.0
3889,0,3889,[326 301 367 223 243],919,2,11143,2.8645244215938304,20.0,0.0
3890,0,3890,[452 217 300 272 298],758,2,11145,2.8643022359290673,20.0,40.0
3891,0,3891,[217 280 246 583 227],916,3,11148,2.8643371017471737,0.0,0.0
3892,0,3892,[241 303 331 206 218],276,5,11153,2.8648856922681736,0.0,0.0
3893,0,3893,[239 215 202 250 230],472,5,11158,2.8654340010272215,0.0,0.0
3894,0,3894,[291 344 213 316 508],758,4,11162,2.8657252888318356,20.0,0.0
3895,0,3895,[394 230 239 215 268],435,3,11165,2.865759753593429,0.0,20.0
3896,0,3896,[250 216 212 246 215],916,4,11169,2.8660508083140877,0.0,20.0
3897,0,3897,[215 217 255 226 331],435,3,11172,2.866085171883017,0.0,0.0
3898,0,3898,[326 452 222 261 508],222,2,11174,2.865863041805591,0.0,20.0
3899,0,3899,[217 227 209 236 268],1,4,11178,2.8661538461538463,0.0,20.0
3900,0,3900,[218 264 583 268 367],303,3,11181,2.8661881568828504,0.0,20.0
3901,0,3901,[290 232 259 300 239],303,2,11183,2.8659661711942594,0.0,20.0
3902,0,3902,[241 298 485 216 367],299,4,11187,2.8662567255956954,0.0,40.0
3903,0,3903,[272 222 261 255 293],592,3,11190,2.8662909836065573,20.0,20.0
3904,0,3904,[254 209 392 226 272],880,2,11192,2.8660691421254803,20.0,0.0
3905,0,3905,[259 290 250 240 276],303,3,11195,2.86610343061956,0.0,0.0
3906,0,3906,[241 232 222 217 321],429,2,11197,2.8658817507038647,0.0,20.0
3907,0,3907,[283 290 452 507 284],303,3,11200,2.865916069600819,0.0,0.0
3908,0,3908,[507 431 298 215 283],393,2,11202,2.8656945510360705,0.0,20.0
3909,0,3909,[254 230 413 226 284],435,1,11203,2.865217391304348,0.0,0.0
3910,0,3910,[295 254 392 280 227],880,1,11204,2.8647404755816925,0.0,0.0
3911,0,3911,[297 209 315 223 300],758,4,11208,2.8650306748466257,40.0,20.0
3912,0,3912,[272 206 208 226 293],293,3,11211,2.865065167390749,20.0,0.0
3913,0,3913,[508 509 232 219 452],201,2,11213,2.8648441492079715,0.0,0.0
3914,0,3914,[298 299 250 254 284],682,4,11217,2.865134099616858,0.0,20.0
3915,0,3915,[331 452 218 231 276],130,3,11220,2.865168539325843,0.0,0.0
3916,0,3916,[316 293 272 324 209],276,5,11225,2.8657135562930813,40.0,0.0
3917,0,3917,[232 206 268 246 209],268,3,11228,2.8657478305257786,0.0,20.0
3918,0,3918,[394 219 217 239 211],435,5,11233,2.866292421536106,0.0,0.0
3919,0,3919,[264 241 212 216 276],299,3,11236,2.8663265306122447,0.0,20.0
3920,0,3920,[232 367 206 280 297],293,2,11238,2.86610558530987,0.0,0.0
3921,0,3921,[231 509 239 240 350],758,2,11240,2.8658847526772053,0.0,0.0
3922,0,3922,[429 276 226 300 324],276,5,11245,2.866428753504971,0.0,20.0
3923,0,3923,[367 217 291 215 275],896,3,11248,2.8664627930682975,0.0,0.0
3924,0,3924,[291 202 452 331 240],276,3,11251,2.866496815286624,0.0,0.0
3925,0,3925,[206 429 218 222 293],276,5,11256,2.867040244523688,0.0,20.0
3926,0,3926,[452 276 290 508 217],130,3,11259,2.86707410236822,0.0,0.0
3927,0,3927,[300 481 303 264 378],299,1,11260,2.8665987780040734,0.0,20.0
3928,0,3928,[230 227 367 213 365],846,2,11262,2.8663782132858233,0.0,0.0
3929,0,3929,[298 452 291 230 240],497,1,11263,2.8659033078880407,0.0,20.0
3930,0,3930,[290 231 218 264 331],276,3,11266,2.8659374205036885,0.0,0.0
3931,0,3931,[236 221 219 218 244],1,2,11268,2.8657171922685656,0.0,0.0
3932,0,3932,[291 223 365 485 202],429,3,11271,2.8657513348588863,20.0,0.0
3933,0,3933,[239 420 431 202 300],758,1,11272,2.865277071682766,0.0,20.0
3934,0,3934,[208 264 232 222 213],293,0,11272,2.8645489199491743,0.0,20.0
3935,0,3935,[431 276 392 215 216],222,5,11277,2.8650914634146343,0.0,20.0
3936,0,3936,[316 221 223 217 315],758,3,11280,2.8651257302514606,60.0,0.0
3937,0,3937,[244 247 251 256 231],1,2,11282,2.8649060436769935,0.0,0.0
3938,0,3938,[324 236 367 232 291],303,3,11285,2.864940340187865,0.0,0.0
3939,0,3939,[507 223 230 239 275],293,2,11287,2.864720812182741,20.0,0.0
3940,0,3940,[326 220 301 299 276],181,1,11288,2.8642476528799796,0.0,0.0
3941,0,3941,[392 384 431 290 293],276,2,11290,2.8640284119736172,0.0,0.0
3942,0,3942,[221 223 276 222 583],916,4,11294,2.864316510271367,20.0,20.0
3943,0,3943,[507 485 264 208 300],293,1,11295,2.8638438133874238,0.0,20.0
3944,0,3944,[268 392 300 298 324],521,1,11296,2.8633713561470215,0.0,60.0
3945,0,3945,[297 215 293 218 227],293,3,11299,2.86340598073999,0.0,0.0
3946,0,3946,[293 509 241 365 298],682,3,11302,2.8634405877881934,0.0,20.0
3947,0,3947,[264 251 336 220 222],181,2,11304,2.86322188449848,0.0,20.0
3948,0,3948,[452 509 216 478 378],846,4,11308,2.863509749303621,20.0,20.0
3949,0,3949,[315 231 264 226 216],363,0,11308,2.8627848101265823,20.0,20.0
3950,0,3950,[223 272 250 264 239],276,4,11312,2.8630726398380157,40.0,0.0
3951,0,3951,[211 240 384 583 246],790,2,11314,2.8628542510121457,0.0,0.0
3952,0,3952,[509 481 218 217 298],758,4,11318,2.863141917530989,0.0,20.0
3953,0,3953,[240 290 315 219 293],130,4,11322,2.8634294385432475,20.0,0.0
3954,0,3954,[293 295 202 218 259],178,2,11324,2.8632111251580277,0.0,0.0
3955,0,3955,[583 331 254 300 508],276,3,11327,2.86324570273003,0.0,20.0
3956,0,3956,[316 298 215 250 301],500,2,11329,2.8630275461207986,20.0,20.0
3957,0,3957,[219 298 208 206 222],435,4,11333,2.8633148054573017,0.0,40.0
3958,0,3958,[365 316 384 272 300],880,2,11335,2.8630967416014146,40.0,20.0
3959,0,3959,[259 336 268 243 301],451,4,11339,2.8633838383838386,0.0,20.0
3960,0,3960,[246 231 239 413 206],130,2,11341,2.863165867205251,0.0,0.0
3961,0,3961,[367 255 215 219 236],130,5,11346,2.8637051993942455,0.0,0.0
3962,0,3962,[215 218 367 209 365],222,4,11350,2.8639919253091093,0.0,0.0
3963,0,3963,[219 202 215 240 378],566,2,11352,2.863773965691221,0.0,0.0
3964,0,3964,[222 246 231 284 420],303,4,11356,2.8640605296343002,0.0,20.0
3965,0,3965,[268 315 215 291 367],592,4,11360,2.86434694906707,20.0,20.0
3966,0,3966,[326 244 209 268 220],178,3,11363,2.8643811444416434,0.0,20.0
3967,0,3967,[284 241 240 230 452],268,0,11363,2.8636592741935485,0.0,0.0
3968,0,3968,[236 227 384 297 211],758,5,11368,2.8641975308641974,0.0,0.0
3969,0,3969,[268 452 303 206 218],201,2,11370,2.863979848866499,0.0,20.0
3970,0,3970,[219 420 268 243 452],130,4,11374,2.8642659279778395,0.0,20.0
3971,0,3971,[299 344 324 255 336],592,3,11377,2.8643001007049347,0.0,0.0
3972,0,3972,[301 452 276 303 392],276,3,11380,2.8643342562295495,0.0,0.0
3973,0,3973,[218 315 216 222 226],201,2,11382,2.864116758933065,20.0,40.0
3974,0,3974,[344 223 291 295 303],592,4,11386,2.8644025157232704,20.0,0.0
3975,0,3975,[215 321 211 367 226],435,2,11388,2.8641851106639837,0.0,0.0
3976,0,3976,[217 290 222 227 365],276,4,11392,2.8644707065627357,0.0,20.0
3977,0,3977,[231 293 303 201 254],276,3,11395,2.864504776269482,0.0,0.0
3978,0,3978,[208 293 413 390 239],303,2,11397,2.8642875094244786,0.0,0.0
3979,0,3979,[246 384 243 223 240],682,2,11399,2.864070351758794,20.0,0.0
3980,0,3980,[239 215 208 218 365],222,4,11403,2.864355689525245,0.0,0.0
3981,0,3981,[324 290 316 241 315],758,4,11407,2.8646408839779007,40.0,0.0
3982,0,3982,[218 202 209 367 230],622,3,11410,2.8646748681898067,0.0,0.0
3983,0,3983,[303 222 217 227 280],293,1,11411,2.864206827309237,0.0,20.0
3984,0,3984,[243 272 331 276 221],592,3,11414,2.864240903387704,20.0,0.0
3985,0,3985,[227 239 255 299 284],435,3,11417,2.864274962368289,0.0,0.0
3986,0,3986,[290 264 298 259 239],303,2,11419,2.8640581891146226,0.0,20.0
3987,0,3987,[300 201 429 215 217],896,2,11421,2.863841524573721,0.0,20.0
3988,0,3988,[217 219 259 251 202],1,2,11423,2.8636249686638253,0.0,0.0
3989,0,3989,[299 321 216 290 230],435,1,11424,2.863157894736842,0.0,20.0
3990,0,3990,[222 212 221 209 284],916,2,11426,2.8629416186419445,0.0,20.0
3991,0,3991,[303 243 202 218 240],919,2,11428,2.8627254509018036,0.0,0.0
3992,0,3992,[452 420 284 239 241],303,3,11431,2.8627598297019783,0.0,0.0
3993,0,3993,[420 431 232 226 219],682,1,11432,2.8622934401602405,0.0,0.0
3994,0,3994,[324 219 291 217 246],276,4,11436,2.862578222778473,0.0,0.0
3995,0,3995,[231 284 280 276 241],682,2,11438,2.8623623623623624,0.0,0.0
3996,0,3996,[283 226 583 507 209],303,3,11441,2.8623967975981985,0.0,0.0
3997,0,3997,[298 291 223 326 232],303,3,11444,2.862431215607804,20.0,20.0
3998,0,3998,[268 429 231 303 291],276,3,11447,2.862465616404101,0.0,20.0
3999,0,3999,[290 232 241 268 215],244,4,11451,2.86275,0.0,20.0
4000,1,0,[485 378 222 298 230],790,2,2,2.0,0.0,40.0
4001,1,1,[218 227 583 250 452],276,3,5,2.5,0.0,0.0
4002,1,2,[227 230 250 298 218],221,3,8,2.6666666666666665,0.0,20.0
4003,1,3,[250 298 218 227 230],429,1,9,2.25,0.0,20.0
4004,1,4,[298 250 218 227 230],276,5,14,2.8,0.0,20.0
4005,1,5,[452 227 293 216 413],303,2,16,2.6666666666666665,0.0,20.0
4006,1,6,[216 298 293 218 250],178,3,19,2.7142857142857144,0.0,40.0
4007,1,7,[216 293 298 250 218],303,5,24,3.0,0.0,40.0
4008,1,8,[216 293 298 250 218],130,4,28,3.111111111111111,0.0,40.0
4009,1,9,[216 293 298 218 250],222,3,31,3.1,0.0,40.0
4010,1,10,[216 298 293 218 250],429,3,34,3.090909090909091,0.0,40.0
4011,1,11,[216 298 293 218 250],303,5,39,3.25,0.0,40.0
4012,1,12,[240 255 316 222 298],293,1,40,3.076923076923077,20.0,40.0
4013,1,13,[216 298 293 218 250],758,4,44,3.142857142857143,0.0,40.0
4014,1,14,[216 298 293 218 250],178,3,47,3.1333333333333333,0.0,40.0
4015,1,15,[216 298 293 218 250],303,5,52,3.25,0.0,40.0
4016,1,16,[216 298 293 218 250],178,3,55,3.235294117647059,0.0,40.0
4017,1,17,[216 293 298 250 218],758,4,59,3.2777777777777777,0.0,40.0
4018,1,18,[216 298 293 250 218],222,3,62,3.263157894736842,0.0,40.0
4019,1,19,[216 298 293 218 250],682,4,66,3.3,0.0,40.0
4020,1,20,[216 298 293 250 218],303,5,71,3.380952380952381,0.0,40.0
4021,1,21,[216 298 293 250 218],327,0,71,3.227272727272727,0.0,40.0
4022,1,22,[413 223 230 365 268],222,4,75,3.260869565217391,20.0,20.0
4023,1,23,[301 321 259 218 331],919,3,78,3.25,0.0,0.0
4024,1,24,[250 226 208 217 218],363,1,79,3.16,0.0,0.0
4025,1,25,[212 219 217 215 218],1,1,80,3.076923076923077,0.0,0.0
4026,1,26,[215 209 216 509 218],916,2,82,3.037037037037037,0.0,20.0
4027,1,27,[209 509 250 276 219],889,2,84,3.0,0.0,0.0
4028,1,28,[264 280 222 283 365],429,1,85,2.9310344827586206,0.0,20.0
4029,1,29,[246 367 231 284 222],276,3,88,2.933333333333333,0.0,20.0
4030,1,30,[284 331 246 268 276],276,5,93,3.0,0.0,20.0
4031,1,31,[284 331 246 268 276],919,2,95,2.96875,0.0,20.0
4032,1,32,[221 413 241 251 202],303,4,99,3.0,0.0,0.0
4033,1,33,[261 255 219 217 222],130,4,103,3.0294117647058822,0.0,20.0
4034,1,34,[420 259 232 384 324],303,2,105,3.0,0.0,0.0
4035,1,35,[241 202 315 219 201],276,5,110,3.0555555555555554,20.0,0.0
4036,1,36,[255 283 250 213 429],293,1,111,3.0,0.0,0.0
4037,1,37,[226 250 209 283 268],790,2,113,2.973684210526316,0.0,20.0
4038,1,38,[218 254 208 295 232],880,4,117,3.0,0.0,0.0
4039,1,39,[222 241 267 213 226],1,3,120,3.0,0.0,20.0
4040,1,40,[215 211 507 290 216],293,4,124,3.024390243902439,0.0,20.0
4041,1,41,[222 223 240 217 384],268,1,125,2.9761904761904763,20.0,20.0
4042,1,42,[240 239 208 223 216],293,2,127,2.953488372093023,20.0,20.0
4043,1,43,[216 291 222 223 227],303,2,129,2.9318181818181817,20.0,40.0
4044,1,44,[326 413 231 232 241],201,0,129,2.8666666666666667,0.0,0.0
4045,1,45,[297 331 236 293 221],592,3,132,2.869565217391304,0.0,0.0
4046,1,46,[261 201 297 202 221],919,3,135,2.872340425531915,0.0,0.0
4047,1,47,[230 378 365 219 232],846,2,137,2.8541666666666665,0.0,0.0
4048,1,48,[276 284 231 232 202],276,3,140,2.857142857142857,0.0,0.0
4049,1,49,[223 231 226 206 201],363,1,141,2.82,20.0,0.0
4050,1,50,[215 226 507 583 232],293,2,143,2.803921568627451,0.0,0.0
4051,1,51,[478 211 222 219 201],327,3,146,2.8076923076923075,20.0,20.0
4052,1,52,[413 298 321 390 222],303,1,147,2.7735849056603774,0.0,40.0
4053,1,53,[316 301 268 390 217],286,3,150,2.7777777777777777,20.0,20.0
4054,1,54,[231 259 241 291 215],682,2,152,2.7636363636363637,0.0,0.0
4055,1,55,[261 251 240 213 227],1,2,154,2.75,0.0,0.0
4056,1,56,[261 295 244 276 202],919,1,155,2.719298245614035,0.0,0.0
4057,1,57,[268 227 215 365 254],276,3,158,2.7241379310344827,0.0,20.0
4058,1,58,[226 215 232 367 209],244,3,161,2.7288135593220337,0.0,0.0
4059,1,59,[344 303 367 246 291],592,4,165,2.75,0.0,0.0
4060,1,60,[392 216 275 300 231],484,3,168,2.7540983606557377,0.0,40.0
4061,1,61,[291 254 232 303 293],276,2,170,2.7419354838709675,0.0,0.0
4062,1,62,[222 384 291 324 250],276,3,173,2.746031746031746,0.0,20.0
4063,1,63,[290 222 202 223 218],916,1,174,2.71875,20.0,20.0
4064,1,64,[452 215 431 413 275],201,1,175,2.6923076923076925,0.0,0.0
4065,1,65,[202 272 413 268 230],276,4,179,2.712121212121212,20.0,20.0
4066,1,66,[326 209 413 230 231],201,0,179,2.671641791044776,0.0,0.0
4067,1,67,[240 420 230 213 231],758,2,181,2.661764705882353,0.0,0.0
4068,1,68,[206 223 365 230 201],276,4,185,2.681159420289855,20.0,0.0
4069,1,69,[201 230 367 215 226],943,4,189,2.7,0.0,0.0
4070,1,70,[211 378 231 208 240],790,2,191,2.6901408450704225,0.0,0.0
4071,1,71,[431 231 216 215 226],521,2,193,2.6805555555555554,0.0,20.0
4072,1,72,[336 272 217 250 316],286,4,197,2.6986301369863015,40.0,0.0
4073,1,73,[231 216 254 384 250],682,2,199,2.689189189189189,0.0,20.0
4074,1,74,[301 303 331 259 350],592,2,201,2.68,0.0,0.0
4075,1,75,[206 261 255 420 300],130,4,205,2.6973684210526314,0.0,20.0
4076,1,76,[250 217 209 226 300],276,5,210,2.727272727272727,0.0,20.0
4077,1,77,[420 297 290 293 230],758,3,213,2.730769230769231,0.0,0.0
4078,1,78,[321 316 243 299 508],663,3,216,2.7341772151898733,20.0,0.0
4079,1,79,[508 291 315 216 227],758,5,221,2.7625,20.0,20.0
4080,1,80,[215 508 209 230 219],222,4,225,2.7777777777777777,0.0,0.0
4081,1,81,[261 256 202 244 232],1,2,227,2.768292682926829,0.0,0.0
4082,1,82,[394 293 202 250 299],880,3,230,2.7710843373493974,0.0,0.0
4083,1,83,[321 508 280 243 261],181,1,231,2.75,0.0,0.0
4084,1,84,[284 291 202 246 384],682,3,234,2.7529411764705882,0.0,0.0
4085,1,85,[284 259 280 231 215],682,2,236,2.744186046511628,0.0,0.0
4086,1,86,[276 209 223 227 268],201,4,240,2.7586206896551726,20.0,20.0
4087,1,87,[246 243 291 227 219],130,3,243,2.7613636363636362,0.0,0.0
4088,1,88,[202 291 331 365 272],276,3,246,2.764044943820225,20.0,0.0
4089,1,89,[267 259 219 211 202],1,2,248,2.7555555555555555,0.0,0.0
4090,1,90,[508 284 227 215 223],201,3,251,2.758241758241758,20.0,0.0
4091,1,91,[231 284 216 431 219],222,3,254,2.760869565217391,0.0,20.0
4092,1,92,[230 378 300 392 284],429,0,254,2.7311827956989245,0.0,20.0
4093,1,93,[201 283 239 218 232],864,5,259,2.75531914893617,0.0,0.0
4094,1,94,[218 230 299 239 222],301,3,262,2.7578947368421054,0.0,20.0
4095,1,95,[284 326 240 276 209],551,4,266,2.7708333333333335,0.0,0.0
4096,1,96,[217 250 300 583 208],293,0,266,2.7422680412371134,0.0,20.0
4097,1,97,[420 365 219 201 226],276,4,270,2.7551020408163267,0.0,0.0
4098,1,98,[583 250 324 331 293],276,4,274,2.7676767676767677,0.0,0.0
4099,1,99,[209 215 211 284 241],896,4,278,2.78,0.0,0.0
4100,1,100,[215 254 300 206 394],435,2,280,2.772277227722772,0.0,20.0
4101,1,101,[243 211 299 420 367],682,2,282,2.764705882352941,0.0,0.0
4102,1,102,[240 221 295 243 272],919,2,284,2.7572815533980584,20.0,0.0
4103,1,103,[206 321 276 219 239],130,4,288,2.769230769230769,0.0,0.0
4104,1,104,[367 250 217 213 293],293,1,289,2.7523809523809524,0.0,0.0
4105,1,105,[259 240 230 201 276],303,2,291,2.7452830188679247,0.0,0.0
4106,1,106,[583 223 384 201 230],268,1,292,2.7289719626168223,20.0,0.0
4107,1,107,[240 276 283 217 367],919,4,296,2.740740740740741,0.0,0.0
4108,1,108,[219 209 216 201 583],682,2,298,2.7339449541284404,0.0,20.0
4109,1,109,[212 250 256 315 350],363,0,298,2.709090909090909,20.0,0.0
4110,1,110,[326 295 227 232 276],332,3,301,2.7117117117117115,0.0,0.0
4111,1,111,[216 250 300 231 212],889,2,303,2.705357142857143,0.0,40.0
4112,1,112,[280 206 420 241 316],393,3,306,2.7079646017699117,20.0,0.0
4113,1,113,[392 290 291 217 331],276,3,309,2.710526315789474,0.0,0.0
4114,1,114,[264 206 301 284 201],276,4,313,2.7217391304347824,0.0,0.0
4115,1,115,[216 232 241 275 291],429,4,317,2.7327586206896552,0.0,20.0
4116,1,116,[298 202 209 217 230],790,3,320,2.735042735042735,0.0,20.0
4117,1,117,[583 272 331 301 232],276,3,323,2.73728813559322,20.0,0.0
4118,1,118,[344 221 303 297 336],592,4,327,2.7478991596638656,0.0,0.0
4119,1,119,[227 202 223 291 284],303,3,330,2.75,20.0,0.0
4120,1,120,[230 239 206 297 227],293,2,332,2.743801652892562,0.0,0.0
4121,1,121,[390 215 272 208 250],286,3,335,2.7459016393442623,20.0,0.0
4122,1,122,[236 384 216 413 291],303,2,337,2.7398373983739837,0.0,20.0
4123,1,123,[315 293 241 303 583],276,4,341,2.75,20.0,0.0
4124,1,124,[211 212 216 201 227],201,4,345,2.76,0.0,20.0
4125,1,125,[202 246 216 230 272],1,4,349,2.7698412698412698,20.0,20.0
4126,1,126,[231 246 259 202 384],727,3,352,2.7716535433070866,0.0,0.0
4127,1,127,[211 209 301 331 384],758,4,356,2.78125,0.0,0.0
4128,1,128,[290 215 392 485 255],393,3,359,2.7829457364341086,0.0,0.0
4129,1,129,[284 295 232 226 431],178,4,363,2.792307692307692,0.0,0.0
4130,1,130,[251 215 227 291 219],303,3,366,2.7938931297709924,0.0,0.0
4131,1,131,[243 284 272 367 316],130,3,369,2.7954545454545454,40.0,0.0
4132,1,132,[209 202 291 300 367],682,1,370,2.781954887218045,0.0,20.0
4133,1,133,[293 240 284 280 201],682,4,374,2.791044776119403,0.0,0.0
4134,1,134,[299 218 230 316 227],880,3,377,2.7925925925925927,20.0,0.0
4135,1,135,[326 223 259 215 222],592,3,380,2.7941176470588234,20.0,20.0
4136,1,136,[261 272 284 226 350],130,4,384,2.802919708029197,20.0,0.0
4137,1,137,[216 219 221 254 272],1,2,386,2.7971014492753623,20.0,20.0
4138,1,138,[431 293 239 275 215],327,2,388,2.79136690647482,0.0,0.0
4139,1,139,[284 276 268 216 367],916,3,391,2.7928571428571427,0.0,40.0
4140,1,140,[223 208 316 315 240],293,1,392,2.780141843971631,60.0,0.0
4141,1,141,[331 316 241 295 244],178,3,395,2.7816901408450705,20.0,0.0
4142,1,142,[431 344 272 221 213],758,2,397,2.7762237762237763,20.0,0.0
4143,1,143,[241 485 276 223 298],429,3,400,2.7777777777777777,20.0,20.0
4144,1,144,[378 243 268 218 509],682,1,401,2.7655172413793103,0.0,20.0
4145,1,145,[316 217 276 213 300],758,2,403,2.76027397260274,20.0,20.0
4146,1,146,[240 261 378 226 230],222,1,404,2.748299319727891,0.0,0.0
4147,1,147,[284 219 209 215 243],561,1,405,2.7364864864864864,0.0,0.0
4148,1,148,[291 201 431 231 284],276,2,407,2.7315436241610738,0.0,0.0
4149,1,149,[239 316 216 429 272],660,3,410,2.7333333333333334,40.0,20.0
4150,1,150,[315 209 219 284 331],551,5,415,2.748344370860927,20.0,0.0
4151,1,151,[241 276 226 283 284],303,4,419,2.7565789473684212,0.0,0.0
4152,1,152,[241 298 413 264 384],276,2,421,2.7516339869281046,0.0,20.0
4153,1,153,[429 413 276 218 254],276,3,424,2.7532467532467533,0.0,0.0
4154,1,154,[206 208 264 217 230],268,1,425,2.7419354838709675,0.0,0.0
4155,1,155,[215 240 284 246 231],276,4,429,2.75,0.0,0.0
4156,1,156,[209 227 315 208 218],880,3,432,2.751592356687898,20.0,0.0
4157,1,157,[508 232 216 268 202],303,5,437,2.7658227848101267,0.0,40.0
4158,1,158,[243 208 301 316 250],660,3,440,2.7672955974842766,20.0,0.0
4159,1,159,[431 276 293 478 275],178,4,444,2.775,20.0,0.0
4160,1,160,[272 222 243 291 378],393,5,449,2.7888198757763973,20.0,20.0
4161,1,161,[217 227 247 378 216],222,1,450,2.7777777777777777,0.0,20.0
4162,1,162,[291 267 243 227 293],130,3,453,2.7791411042944785,0.0,0.0
4163,1,163,[291 219 209 365 202],276,3,456,2.7804878048780486,0.0,0.0
4164,1,164,[298 344 301 316 230],758,3,459,2.7818181818181817,20.0,20.0
4165,1,165,[250 268 215 230 219],1,3,462,2.783132530120482,0.0,20.0
4166,1,166,[293 226 209 202 367],327,3,465,2.784431137724551,0.0,0.0
4167,1,167,[226 583 291 280 300],682,0,465,2.767857142857143,0.0,20.0
4168,1,168,[231 384 420 201 215],246,1,466,2.757396449704142,0.0,0.0
4169,1,169,[202 290 276 240 298],130,4,470,2.764705882352941,0.0,20.0
4170,1,170,[239 209 275 303 509],293,1,471,2.754385964912281,0.0,0.0
4171,1,171,[256 230 212 221 223],1,5,476,2.7674418604651163,20.0,0.0
4172,1,172,[291 276 367 268 509],244,3,479,2.76878612716763,0.0,20.0
4173,1,173,[255 202 221 239 256],1,4,483,2.7758620689655173,0.0,0.0
4174,1,174,[217 226 284 206 276],276,5,488,2.7885714285714287,0.0,0.0
4175,1,175,[429 201 232 216 217],868,0,488,2.772727272727273,0.0,20.0
4176,1,176,[283 208 239 209 272],514,4,492,2.7796610169491527,20.0,0.0
4177,1,177,[201 219 211 452 324],201,3,495,2.7808988764044944,0.0,0.0
4178,1,178,[299 508 255 226 452],130,4,499,2.787709497206704,0.0,0.0
4179,1,179,[301 324 268 291 217],276,4,503,2.7944444444444443,0.0,20.0
4180,1,180,[378 202 507 232 217],429,3,506,2.7955801104972378,0.0,0.0
4181,1,181,[222 227 331 268 231],130,2,508,2.791208791208791,0.0,40.0
4182,1,182,[211 239 392 284 429],896,4,512,2.797814207650273,0.0,0.0
4183,1,183,[216 241 268 251 208],1,5,517,2.8097826086956523,0.0,40.0
4184,1,184,[236 250 226 290 276],303,5,522,2.8216216216216217,0.0,0.0
4185,1,185,[291 316 201 331 276],276,4,526,2.827956989247312,20.0,0.0
4186,1,186,[250 211 209 384 367],22,2,528,2.823529411764706,0.0,0.0
4187,1,187,[211 293 208 230 241],94,4,532,2.8297872340425534,0.0,0.0
4188,1,188,[209 240 221 293 208],303,4,536,2.835978835978836,0.0,0.0
4189,1,189,[272 206 217 240 230],276,5,541,2.8473684210526318,20.0,0.0
4190,1,190,[215 324 226 583 326],201,1,542,2.837696335078534,0.0,0.0
4191,1,191,[583 264 246 259 250],268,3,545,2.8385416666666665,0.0,0.0
4192,1,192,[413 509 268 303 321],201,1,546,2.8290155440414506,0.0,20.0
4193,1,193,[221 300 326 246 231],303,3,549,2.829896907216495,0.0,20.0
4194,1,194,[211 215 219 251 246],1,2,551,2.825641025641026,0.0,0.0
4195,1,195,[481 226 206 201 241],896,2,553,2.8214285714285716,0.0,0.0
4196,1,196,[213 507 283 239 232],293,1,554,2.8121827411167515,0.0,0.0
4197,1,197,[243 211 254 267 219],1,1,555,2.803030303030303,0.0,0.0
4198,1,198,[232 215 202 209 230],790,2,557,2.798994974874372,0.0,0.0
4199,1,199,[212 226 367 215 275],896,3,560,2.8,0.0,0.0
4200,1,200,[336 507 218 344 255],327,2,562,2.7960199004975124,0.0,0.0
4201,1,201,[218 276 215 331 290],130,3,565,2.797029702970297,0.0,0.0
4202,1,202,[240 272 201 221 232],201,1,566,2.7881773399014778,20.0,0.0
4203,1,203,[291 481 222 223 478],896,4,570,2.7941176470588234,40.0,20.0
4204,1,204,[331 297 344 259 367],592,3,573,2.795121951219512,0.0,0.0
4205,1,205,[213 290 350 239 276],758,3,576,2.796116504854369,0.0,0.0
4206,1,206,[275 223 255 268 301],500,2,578,2.792270531400966,20.0,20.0
4207,1,207,[219 223 246 420 301],276,5,583,2.8028846153846154,20.0,0.0
4208,1,208,[300 219 367 384 583],303,2,585,2.799043062200957,0.0,20.0
4209,1,209,[227 240 219 217 413],495,5,590,2.8095238095238093,0.0,0.0
4210,1,210,[321 350 326 272 284],130,4,594,2.815165876777251,20.0,0.0
4211,1,211,[230 321 239 241 326],201,0,594,2.80188679245283,0.0,0.0
4212,1,212,[583 268 326 303 201],201,2,596,2.7981220657276995,0.0,20.0
4213,1,213,[324 297 350 272 300],758,4,600,2.803738317757009,20.0,20.0
4214,1,214,[283 255 303 478 259],299,1,601,2.7953488372093025,20.0,0.0
4215,1,215,[326 243 321 291 280],181,1,602,2.787037037037037,0.0,0.0
4216,1,216,[240 267 295 261 508],130,4,606,2.792626728110599,0.0,0.0
4217,1,217,[509 221 244 211 298],916,4,610,2.7981651376146788,0.0,20.0
4218,1,218,[290 297 216 300 212],758,4,614,2.8036529680365296,0.0,40.0
4219,1,219,[222 201 481 293 223],429,3,617,2.8045454545454547,20.0,20.0
4220,1,220,[208 241 232 244 255],1,2,619,2.8009049773755654,0.0,0.0
4221,1,221,[201 284 240 420 227],276,5,624,2.810810810810811,0.0,0.0
4222,1,222,[280 290 264 230 211],293,1,625,2.802690582959641,0.0,0.0
4223,1,223,[212 256 272 213 232],1,2,627,2.799107142857143,20.0,0.0
4224,1,224,[452 268 216 291 290],130,4,631,2.8044444444444445,0.0,40.0
4225,1,225,[509 230 365 280 232],551,4,635,2.809734513274336,0.0,0.0
4226,1,226,[259 293 244 316 478],178,3,638,2.8105726872246697,40.0,0.0
4227,1,227,[219 275 216 213 240],201,4,642,2.8157894736842106,0.0,20.0
4228,1,228,[247 326 250 218 413],222,2,644,2.8122270742358078,0.0,0.0
4229,1,229,[209 239 241 452 217],846,4,648,2.8173913043478263,0.0,0.0
4230,1,230,[223 272 298 431 420],393,3,651,2.8181818181818183,40.0,20.0
4231,1,231,[206 431 223 452 268],201,2,653,2.814655172413793,20.0,20.0
4232,1,232,[219 216 241 290 367],303,5,658,2.8240343347639487,0.0,20.0
4233,1,233,[583 240 283 230 232],293,0,658,2.8119658119658117,0.0,0.0
4234,1,234,[452 276 226 240 268],303,3,661,2.8127659574468087,0.0,20.0
4235,1,235,[261 202 508 222 201],592,3,664,2.8135593220338984,0.0,20.0
4236,1,236,[201 239 367 226 231],896,2,666,2.810126582278481,0.0,0.0
4237,1,237,[218 232 431 231 367],429,2,668,2.80672268907563,0.0,0.0
4238,1,238,[392 299 250 255 240],130,3,671,2.807531380753138,0.0,0.0
4239,1,239,[315 290 485 208 219],660,3,674,2.808333333333333,20.0,0.0
4240,1,240,[216 230 384 202 218],933,0,674,2.796680497925311,0.0,20.0
4241,1,241,[367 261 247 232 431],222,2,676,2.793388429752066,0.0,0.0
4242,1,242,[315 206 293 297 216],293,4,680,2.7983539094650207,20.0,20.0
4243,1,243,[431 384 230 420 215],399,0,680,2.7868852459016393,0.0,0.0
4244,1,244,[431 321 275 315 509],201,1,681,2.779591836734694,20.0,0.0
4245,1,245,[367 280 209 300 202],880,2,683,2.7764227642276422,0.0,20.0
4246,1,246,[239 216 315 298 202],293,2,685,2.7732793522267207,20.0,40.0
4247,1,247,[222 217 298 297 300],758,3,688,2.774193548387097,0.0,60.0
4248,1,248,[326 300 202 211 280],551,4,692,2.7791164658634537,0.0,20.0
4249,1,249,[321 217 216 222 215],201,1,693,2.772,0.0,40.0
4250,1,250,[324 209 509 300 250],758,4,697,2.7768924302788847,0.0,20.0
4251,1,251,[326 508 331 284 219],201,3,700,2.7777777777777777,0.0,0.0
4252,1,252,[431 212 226 241 209],896,1,701,2.7707509881422925,0.0,0.0
4253,1,253,[232 284 291 283 202],293,0,701,2.7598425196850394,0.0,0.0
4254,1,254,[226 280 232 378 218],487,3,704,2.76078431372549,0.0,0.0
4255,1,255,[222 241 209 365 208],222,3,707,2.76171875,0.0,20.0
4256,1,256,[508 243 293 283 276],919,4,711,2.7665369649805447,0.0,0.0
4257,1,257,[226 300 209 232 241],222,3,714,2.7674418604651163,0.0,20.0
4258,1,258,[217 240 223 507 431],561,2,716,2.7644787644787643,20.0,0.0
4259,1,259,[284 280 290 268 300],347,3,719,2.7653846153846153,0.0,40.0
4260,1,260,[508 240 218 284 420],303,4,723,2.7701149425287355,0.0,0.0
4261,1,261,[392 481 290 232 378],429,1,724,2.763358778625954,0.0,0.0
4262,1,262,[268 254 284 236 350],130,3,727,2.76425855513308,0.0,20.0
4263,1,263,[264 202 299 272 315],592,3,730,2.765151515151515,40.0,0.0
4264,1,264,[211 223 324 413 230],201,2,732,2.762264150943396,20.0,0.0
4265,1,265,[284 218 216 290 213],293,1,733,2.755639097744361,0.0,20.0
4266,1,266,[290 211 216 230 217],429,2,735,2.752808988764045,0.0,20.0
4267,1,267,[247 256 226 268 215],1,2,737,2.75,0.0,20.0
4268,1,268,[208 227 264 231 232],429,2,739,2.7472118959107807,0.0,0.0
4269,1,269,[209 367 211 216 246],94,4,743,2.751851851851852,0.0,20.0
4270,1,270,[230 202 226 222 275],178,5,748,2.7601476014760147,0.0,20.0
4271,1,271,[247 431 227 413 202],222,2,750,2.7573529411764706,0.0,0.0
4272,1,272,[216 261 240 202 293],222,2,752,2.7545787545787546,0.0,20.0
4273,1,273,[392 216 295 272 300],130,4,756,2.759124087591241,20.0,40.0
4274,1,274,[217 230 420 232 508],896,2,758,2.7563636363636363,0.0,0.0
4275,1,275,[264 268 222 367 295],592,3,761,2.7572463768115942,0.0,40.0
4276,1,276,[218 246 243 298 226],880,4,765,2.7617328519855597,0.0,20.0
4277,1,277,[300 365 202 254 215],682,2,767,2.758992805755396,0.0,20.0
4278,1,278,[284 209 216 206 255],293,2,769,2.7562724014336917,0.0,20.0
4279,1,279,[202 255 244 284 264],919,1,770,2.75,0.0,0.0
4280,1,280,[254 392 316 239 243],660,1,771,2.7437722419928825,20.0,0.0
4281,1,281,[324 222 321 217 201],21,2,773,2.7411347517730498,0.0,20.0
4282,1,282,[216 201 246 315 326],305,2,775,2.7385159010600706,20.0,20.0
4283,1,283,[206 244 236 295 276],916,3,778,2.73943661971831,0.0,0.0
4284,1,284,[201 293 208 276 298],429,4,782,2.743859649122807,0.0,20.0
4285,1,285,[230 420 331 239 290],276,5,787,2.7517482517482517,0.0,0.0
4286,1,286,[246 276 452 255 284],130,4,791,2.7560975609756095,0.0,0.0
4287,1,287,[215 246 324 226 227],521,2,793,2.7534722222222223,0.0,0.0
4288,1,288,[243 268 232 365 231],682,1,794,2.7474048442906573,0.0,20.0
4289,1,289,[254 276 378 209 365],682,0,794,2.7379310344827585,0.0,0.0
4290,1,290,[209 241 264 247 201],1,2,796,2.7353951890034365,0.0,0.0
4291,1,291,[202 240 206 227 283],393,1,797,2.7294520547945207,0.0,0.0
4292,1,292,[344 276 298 227 297],758,3,800,2.7303754266211606,0.0,20.0
4293,1,293,[272 241 220 259 254],1,1,801,2.7244897959183674,20.0,0.0
4294,1,294,[222 230 283 367 202],429,2,803,2.7220338983050847,0.0,20.0
4295,1,295,[218 226 367 222 202],561,0,803,2.7128378378378377,0.0,20.0
4296,1,296,[202 218 264 254 384],472,3,806,2.7138047138047137,0.0,0.0
4297,1,297,[211 272 324 231 222],201,1,807,2.708053691275168,20.0,20.0
4298,1,298,[394 201 299 284 217],880,4,811,2.7123745819397995,0.0,0.0
4299,1,299,[219 280 291 202 231],682,1,812,2.7066666666666666,0.0,0.0
4300,1,300,[223 241 431 239 227],758,2,814,2.7043189368770766,20.0,0.0
4301,1,301,[367 331 206 350 321],130,3,817,2.705298013245033,0.0,0.0
4302,1,302,[508 264 217 280 583],551,1,818,2.6996699669966997,0.0,0.0
4303,1,303,[236 291 231 272 331],130,3,821,2.700657894736842,20.0,0.0
4304,1,304,[291 290 201 239 331],276,4,825,2.7049180327868854,0.0,0.0
4305,1,305,[239 250 583 255 300],303,2,827,2.7026143790849675,0.0,20.0
4306,1,306,[256 246 217 219 222],916,2,829,2.7003257328990227,0.0,20.0
4307,1,307,[232 264 316 298 215],363,1,830,2.6948051948051948,20.0,20.0
4308,1,308,[226 209 218 301 290],429,1,831,2.6893203883495147,0.0,0.0
4309,1,309,[212 261 256 218 223],1,3,834,2.6903225806451614,20.0,0.0
4310,1,310,[221 250 367 219 215],303,5,839,2.697749196141479,0.0,0.0
4311,1,311,[431 508 452 276 211],201,2,841,2.6955128205128207,0.0,0.0
4312,1,312,[244 241 218 230 206],916,2,843,2.693290734824281,0.0,0.0
4313,1,313,[267 201 272 231 221],1,2,845,2.6910828025477707,20.0,0.0
4314,1,314,[324 208 283 452 232],303,2,847,2.688888888888889,0.0,0.0
4315,1,315,[276 481 216 283 300],299,3,850,2.689873417721519,0.0,40.0
4316,1,316,[315 378 394 431 507],393,3,853,2.690851735015773,20.0,0.0
4317,1,317,[250 255 202 293 367],303,5,858,2.69811320754717,0.0,0.0
4318,1,318,[213 250 232 230 236],1,3,861,2.699059561128527,0.0,0.0
4319,1,319,[239 206 290 284 213],916,1,862,2.69375,0.0,0.0
4320,1,320,[283 315 300 246 239],880,3,865,2.694704049844237,20.0,20.0
4321,1,321,[283 251 241 291 209],303,3,868,2.6956521739130435,0.0,0.0
4322,1,322,[420 201 264 321 223],303,3,871,2.696594427244582,20.0,0.0
4323,1,323,[216 264 218 255 208],293,1,872,2.691358024691358,0.0,20.0
4324,1,324,[223 284 217 300 232],429,2,874,2.689230769230769,20.0,20.0
4325,1,325,[201 208 250 367 283],429,1,875,2.684049079754601,0.0,0.0
4326,1,326,[413 222 223 226 452],399,0,875,2.675840978593272,20.0,20.0
4327,1,327,[452 209 431 284 316],276,3,878,2.676829268292683,20.0,0.0
4328,1,328,[222 283 241 240 255],249,4,882,2.6808510638297873,0.0,20.0
4329,1,329,[508 241 431 239 268],276,4,886,2.684848484848485,0.0,20.0
4330,1,330,[246 223 227 452 217],276,4,890,2.688821752265861,20.0,0.0
4331,1,331,[218 227 300 255 452],130,4,894,2.6927710843373496,0.0,20.0
4332,1,332,[295 293 222 284 226],130,3,897,2.6936936936936937,0.0,20.0
4333,1,333,[250 392 243 293 298],880,2,899,2.691616766467066,0.0,20.0
4334,1,334,[226 298 420 283 509],293,2,901,2.68955223880597,0.0,20.0
4335,1,335,[202 276 216 326 268],592,5,906,2.6964285714285716,0.0,40.0
4336,1,336,[216 300 232 583 431],327,1,907,2.691394658753709,0.0,40.0
4337,1,337,[202 420 219 384 299],682,2,909,2.6893491124260356,0.0,0.0
4338,1,338,[293 283 367 272 350],592,5,914,2.696165191740413,20.0,0.0
4339,1,339,[315 264 301 321 316],587,3,917,2.697058823529412,40.0,0.0
4340,1,340,[420 321 367 413 259],303,2,919,2.695014662756598,0.0,0.0
4341,1,341,[297 211 230 213 429],293,3,922,2.695906432748538,0.0,0.0
4342,1,342,[275 326 264 300 218],919,3,925,2.696793002915452,0.0,20.0
4343,1,343,[268 241 247 216 264],1,3,928,2.697674418604651,0.0,40.0
4344,1,344,[284 209 208 250 367],880,3,931,2.698550724637681,0.0,0.0
4345,1,345,[431 212 276 344 303],758,2,933,2.6965317919075145,0.0,0.0
4346,1,346,[218 276 208 230 324],758,4,937,2.7002881844380404,0.0,0.0
4347,1,347,[316 202 208 392 290],747,3,940,2.7011494252873565,20.0,0.0
4348,1,348,[202 239 222 384 431],514,4,944,2.7048710601719197,0.0,20.0
4349,1,349,[250 324 367 392 218],276,3,947,2.7057142857142855,0.0,0.0
4350,1,350,[230 250 326 298 284],222,3,950,2.7065527065527064,0.0,20.0
4351,1,351,[202 218 222 212 231],758,4,954,2.710227272727273,0.0,20.0
4352,1,352,[367 508 236 227 254],130,3,957,2.7110481586402266,0.0,0.0
4353,1,353,[211 241 216 223 300],429,3,960,2.711864406779661,20.0,40.0
4354,1,354,[201 284 250 365 222],682,4,964,2.715492957746479,0.0,20.0
4355,1,355,[291 239 202 201 293],303,3,967,2.716292134831461,0.0,0.0
4356,1,356,[232 431 208 316 315],286,5,972,2.722689075630252,40.0,0.0
4357,1,357,[217 268 413 232 452],497,2,974,2.7206703910614527,0.0,20.0
4358,1,358,[259 429 431 336 272],514,4,978,2.7242339832869082,20.0,0.0
4359,1,359,[209 316 326 202 367],178,5,983,2.7305555555555556,20.0,0.0
4360,1,360,[246 208 392 298 508],880,4,987,2.7340720221606647,0.0,20.0
4361,1,361,[431 206 583 223 331],201,2,989,2.7320441988950277,20.0,0.0
4362,1,362,[211 202 268 231 276],561,2,991,2.7300275482093666,0.0,20.0
4363,1,363,[321 261 284 315 331],919,1,992,2.7252747252747254,20.0,0.0
4364,1,364,[261 254 367 255 299],130,3,995,2.7260273972602738,0.0,0.0
4365,1,365,[227 583 264 315 217],293,0,995,2.7185792349726774,20.0,0.0
4366,1,366,[226 219 280 241 300],178,5,1000,2.7247956403269753,0.0,20.0
4367,1,367,[231 259 250 241 226],1,2,1002,2.722826086956522,0.0,0.0
4368,1,368,[321 276 507 293 291],429,4,1006,2.7262872628726287,0.0,0.0
4369,1,369,[291 211 241 365 201],429,2,1008,2.7243243243243245,0.0,0.0
4370,1,370,[268 223 208 218 508],303,5,1013,2.730458221024259,20.0,20.0
4371,1,371,[384 256 217 264 212],363,0,1013,2.7231182795698925,0.0,0.0
4372,1,372,[219 413 284 365 303],276,3,1016,2.7238605898123325,0.0,0.0
4373,1,373,[246 268 250 217 272],130,3,1019,2.7245989304812834,20.0,20.0
4374,1,374,[293 295 299 255 246],592,4,1023,2.728,0.0,0.0
4375,1,375,[276 283 316 250 246],880,3,1026,2.728723404255319,20.0,0.0
4376,1,376,[243 201 431 219 284],682,3,1029,2.7294429708222814,0.0,0.0
4377,1,377,[239 227 244 236 206],1,4,1033,2.732804232804233,0.0,0.0
4378,1,378,[232 250 215 583 223],303,4,1037,2.7361477572559365,20.0,0.0
4379,1,379,[452 275 212 324 272],201,3,1040,2.736842105263158,20.0,0.0
4380,1,380,[226 259 240 230 246],303,2,1042,2.7349081364829395,0.0,0.0
4381,1,381,[276 316 420 303 232],276,4,1046,2.738219895287958,20.0,0.0
4382,1,382,[268 290 206 209 222],916,1,1047,2.733681462140992,0.0,40.0
4383,1,383,[241 223 240 276 431],276,4,1051,2.7369791666666665,20.0,0.0
4384,1,384,[452 298 217 272 316],758,3,1054,2.7376623376623375,40.0,20.0
4385,1,385,[212 243 215 244 218],1,1,1055,2.733160621761658,0.0,0.0
4386,1,386,[239 209 236 230 231],1,4,1059,2.7364341085271318,0.0,0.0
4387,1,387,[259 220 246 215 212],1,2,1061,2.734536082474227,0.0,0.0
4388,1,388,[315 303 261 250 272],592,4,1065,2.7377892030848328,40.0,0.0
4389,1,389,[583 291 216 250 201],429,2,1067,2.735897435897436,0.0,20.0
4390,1,390,[216 219 583 202 209],303,4,1071,2.739130434782609,0.0,20.0
4391,1,391,[365 250 222 219 232],276,3,1074,2.739795918367347,0.0,20.0
4392,1,392,[315 365 280 367 420],393,2,1076,2.737913486005089,20.0,0.0
4393,1,393,[240 201 452 221 219],303,3,1079,2.738578680203046,0.0,0.0
4394,1,394,[246 256 244 230 236],1,4,1083,2.741772151898734,0.0,0.0
4395,1,395,[384 300 275 378 212],299,3,1086,2.742424242424242,0.0,20.0
4396,1,396,[219 384 208 246 321],303,3,1089,2.743073047858942,0.0,0.0
4397,1,397,[485 268 509 507 218],846,4,1093,2.7462311557788945,0.0,20.0
4398,1,398,[230 223 508 272 331],276,5,1098,2.7518796992481205,40.0,0.0
4399,1,399,[215 216 239 259 384],514,4,1102,2.755,0.0,20.0
4400,1,400,[268 276 219 246 216],222,5,1107,2.760598503740648,0.0,40.0
4401,1,401,[284 230 255 290 206],130,1,1108,2.756218905472637,0.0,0.0
4402,1,402,[298 280 239 217 230],880,3,1111,2.7568238213399505,0.0,20.0
4403,1,403,[230 264 394 222 219],435,2,1113,2.754950495049505,0.0,20.0
4404,1,404,[201 420 230 250 300],896,2,1115,2.753086419753086,0.0,20.0
4405,1,405,[284 280 583 326 300],551,3,1118,2.7536945812807883,0.0,20.0
4406,1,406,[331 583 201 223 276],201,4,1122,2.7567567567567566,20.0,0.0
4407,1,407,[240 284 299 316 226],880,5,1127,2.7622549019607843,20.0,0.0
4408,1,408,[230 246 254 202 293],276,4,1131,2.765281173594132,0.0,0.0
4409,1,409,[508 326 300 208 231],303,3,1134,2.765853658536585,0.0,20.0
4410,1,410,[206 420 202 236 231],130,3,1137,2.7664233576642334,0.0,0.0
4411,1,411,[255 291 384 280 218],682,0,1137,2.7597087378640777,0.0,0.0
4412,1,412,[508 217 298 246 209],276,5,1142,2.765133171912833,0.0,20.0
4413,1,413,[293 255 251 331 303],592,4,1146,2.7681159420289854,0.0,0.0
4414,1,414,[276 284 211 298 509],916,3,1149,2.7686746987951807,0.0,20.0
4415,1,415,[254 420 215 300 431],276,3,1152,2.769230769230769,0.0,20.0
4416,1,416,[276 384 226 272 250],682,2,1154,2.7673860911270984,20.0,0.0
4417,1,417,[284 583 209 232 201],303,4,1158,2.770334928229665,0.0,0.0
4418,1,418,[255 583 284 429 290],293,1,1159,2.7661097852028638,0.0,0.0
4419,1,419,[321 365 201 485 211],429,1,1160,2.761904761904762,0.0,0.0
4420,1,420,[202 276 508 227 241],303,4,1164,2.7648456057007125,0.0,0.0
4421,1,421,[209 280 241 230 223],916,2,1166,2.7630331753554502,20.0,0.0
4422,1,422,[251 429 239 218 485],293,2,1168,2.7612293144208038,0.0,0.0
4423,1,423,[431 293 429 290 284],363,2,1170,2.759433962264151,0.0,0.0
4424,1,424,[413 227 254 226 231],130,1,1171,2.755294117647059,0.0,0.0
4425,1,425,[202 315 230 301 283],880,3,1174,2.755868544600939,20.0,0.0
4426,1,426,[241 298 508 209 230],429,3,1177,2.756440281030445,0.0,20.0
4427,1,427,[268 222 226 241 291],521,4,1181,2.7593457943925235,0.0,40.0
4428,1,428,[232 420 321 326 293],303,3,1184,2.7599067599067597,0.0,0.0
4429,1,429,[208 206 259 256 239],1,4,1188,2.7627906976744185,0.0,0.0
4430,1,430,[208 232 211 240 223],889,3,1191,2.7633410672853826,20.0,0.0
4431,1,431,[222 485 301 293 392],429,2,1193,2.761574074074074,0.0,20.0
4432,1,432,[244 272 259 331 300],919,4,1197,2.764434180138568,20.0,20.0
4433,1,433,[431 283 507 206 291],727,2,1199,2.762672811059908,0.0,0.0
4434,1,434,[321 246 298 283 507],303,3,1202,2.7632183908045977,0.0,20.0
4435,1,435,[250 241 259 365 227],790,3,1205,2.7637614678899083,0.0,0.0
4436,1,436,[222 316 297 509 239],758,4,1209,2.7665903890160184,20.0,20.0
4437,1,437,[509 301 246 367 217],244,3,1212,2.767123287671233,0.0,0.0
4438,1,438,[284 261 244 300 295],919,1,1213,2.7630979498861046,0.0,20.0
4439,1,439,[230 413 222 508 326],130,3,1216,2.7636363636363637,0.0,20.0
4440,1,440,[221 215 213 239 212],201,2,1218,2.761904761904762,0.0,0.0
4441,1,441,[223 283 275 216 211],293,3,1221,2.762443438914027,20.0,20.0
4442,1,442,[241 250 213 222 221],1,4,1225,2.765237020316027,0.0,20.0
4443,1,443,[508 293 222 215 284],303,4,1229,2.768018018018018,0.0,20.0
4444,1,444,[239 246 384 583 217],276,3,1232,2.7685393258426965,0.0,0.0
4445,1,445,[246 209 367 226 268],727,2,1234,2.766816143497758,0.0,20.0
4446,1,446,[291 232 272 485 255],293,1,1235,2.762863534675615,20.0,0.0
4447,1,447,[202 209 240 244 367],299,2,1237,2.7611607142857144,0.0,0.0
4448,1,448,[331 297 298 268 326],919,2,1239,2.7594654788418707,0.0,40.0
4449,1,449,[219 300 232 280 216],222,4,1243,2.7622222222222224,0.0,40.0
4450,1,450,[321 293 254 508 250],130,3,1246,2.762749445676275,0.0,0.0
4451,1,451,[290 367 276 272 315],130,4,1250,2.765486725663717,40.0,0.0
4452,1,452,[206 244 208 241 201],1,3,1253,2.7660044150110377,0.0,0.0
4453,1,453,[431 227 420 231 230],276,3,1256,2.7665198237885464,0.0,0.0
4454,1,454,[230 508 215 268 324],201,3,1259,2.767032967032967,0.0,20.0
4455,1,455,[300 384 268 246 298],880,3,1262,2.767543859649123,0.0,60.0
4456,1,456,[293 250 316 232 220],178,4,1266,2.7702407002188183,20.0,0.0
4457,1,457,[243 508 240 268 261],919,1,1267,2.7663755458515285,0.0,20.0
4458,1,458,[303 230 217 331 508],758,4,1271,2.7690631808278865,0.0,0.0
4459,1,459,[219 226 202 384 241],301,4,1275,2.7717391304347827,0.0,0.0
4460,1,460,[272 297 331 244 275],919,4,1279,2.774403470715835,20.0,0.0
4461,1,461,[208 300 246 223 226],303,4,1283,2.777056277056277,20.0,20.0
4462,1,462,[284 291 254 367 299],130,2,1285,2.775377969762419,0.0,0.0
4463,1,463,[230 216 221 413 303],201,1,1286,2.771551724137931,0.0,20.0
4464,1,464,[218 209 226 254 272],276,4,1290,2.774193548387097,20.0,0.0
4465,1,465,[239 217 413 215 298],276,4,1294,2.776824034334764,0.0,20.0
4466,1,466,[211 218 243 365 255],682,1,1295,2.773019271948608,0.0,0.0
4467,1,467,[300 420 212 384 392],896,1,1296,2.769230769230769,0.0,20.0
4468,1,468,[283 227 316 315 254],880,2,1298,2.767590618336887,40.0,0.0
4469,1,469,[250 239 481 221 290],758,3,1301,2.7680851063829786,0.0,0.0
4470,1,470,[298 264 367 227 218],435,2,1303,2.7664543524416136,0.0,20.0
4471,1,471,[218 284 293 365 394],880,3,1306,2.766949152542373,0.0,0.0
4472,1,472,[219 331 431 206 291],435,4,1310,2.7695560253699787,0.0,0.0
4473,1,473,[232 508 231 250 390],303,4,1314,2.7721518987341773,0.0,0.0
4474,1,474,[365 223 218 324 216],551,4,1318,2.774736842105263,20.0,20.0
4475,1,475,[321 259 272 239 344],393,3,1321,2.7752100840336134,20.0,0.0
4476,1,476,[202 291 324 298 272],592,4,1325,2.7777777777777777,20.0,20.0
4477,1,477,[331 315 250 215 367],276,4,1329,2.780334728033473,20.0,0.0
4478,1,478,[326 232 324 239 216],303,2,1331,2.778705636743215,0.0,20.0
4479,1,479,[367 420 293 392 254],130,4,1335,2.78125,0.0,0.0
4480,1,480,[244 201 259 240 209],268,2,1337,2.7796257796257797,0.0,0.0
4481,1,481,[201 276 236 222 255],919,4,1341,2.7821576763485476,0.0,20.0
4482,1,482,[264 290 324 583 431],276,2,1343,2.780538302277433,0.0,0.0
4483,1,483,[216 226 209 208 300],293,1,1344,2.7768595041322315,0.0,40.0
4484,1,484,[384 431 254 231 202],276,1,1345,2.7731958762886597,0.0,0.0
4485,1,485,[243 272 290 216 384],682,2,1347,2.771604938271605,20.0,20.0
4486,1,486,[243 223 241 259 290],393,4,1351,2.7741273100616017,20.0,0.0
4487,1,487,[218 239 255 250 231],682,1,1352,2.7704918032786887,0.0,0.0
4488,1,488,[250 217 291 300 246],889,3,1355,2.770961145194274,0.0,20.0
4489,1,489,[223 211 367 429 216],747,3,1358,2.7714285714285714,20.0,20.0
4490,1,490,[321 431 213 284 209],201,1,1359,2.7678207739307537,0.0,0.0
4491,1,491,[239 485 208 264 297],293,1,1360,2.7642276422764227,0.0,0.0
4492,1,492,[241 215 240 272 209],551,4,1364,2.766734279918864,20.0,0.0
4493,1,493,[299 298 254 230 202],880,3,1367,2.7672064777327936,0.0,20.0
4494,1,494,[413 206 219 331 291],435,4,1371,2.7696969696969695,0.0,0.0
4495,1,495,[452 219 221 202 222],201,1,1372,2.7661290322580645,0.0,20.0
4496,1,496,[230 227 223 231 254],1,3,1375,2.766599597585513,20.0,0.0
4497,1,497,[244 316 215 250 298],500,2,1377,2.7650602409638556,20.0,20.0
4498,1,498,[246 295 326 300 291],130,4,1381,2.7675350701402808,0.0,20.0
4499,1,499,[429 293 217 227 226],276,5,1386,2.772,0.0,0.0
4500,1,500,[217 209 231 232 392],896,0,1386,2.7664670658682633,0.0,0.0
4501,1,501,[452 230 209 226 212],846,3,1389,2.766932270916335,0.0,0.0
4502,1,502,[211 231 431 508 324],758,3,1392,2.7673956262425445,0.0,0.0
4503,1,503,[413 268 324 452 315],276,3,1395,2.767857142857143,20.0,20.0
4504,1,504,[508 507 378 211 226],429,3,1398,2.768316831683168,0.0,0.0
4505,1,505,[218 217 429 215 268],276,5,1403,2.772727272727273,0.0,20.0
4506,1,506,[250 217 230 298 508],130,2,1405,2.7712031558185406,0.0,20.0
4507,1,507,[378 219 226 250 209],682,1,1406,2.767716535433071,0.0,0.0
4508,1,508,[209 367 365 232 392],276,1,1407,2.764243614931238,0.0,0.0
4509,1,509,[244 226 202 259 326],178,3,1410,2.764705882352941,0.0,0.0
4510,1,510,[413 300 232 227 298],303,2,1412,2.7632093933463797,0.0,40.0
4511,1,511,[206 202 509 240 508],542,1,1413,2.759765625,0.0,0.0
4512,1,512,[246 230 243 202 247],1,3,1416,2.760233918128655,0.0,0.0
4513,1,513,[384 301 216 316 213],758,4,1420,2.762645914396887,20.0,20.0
4514,1,514,[209 231 280 202 299],682,2,1422,2.761165048543689,0.0,0.0
4515,1,515,[259 211 215 268 221],1,2,1424,2.75968992248062,0.0,20.0
4516,1,516,[508 300 240 232 219],222,3,1427,2.760154738878143,0.0,20.0
4517,1,517,[315 251 293 213 226],293,2,1429,2.758687258687259,20.0,0.0
4518,1,518,[206 298 226 227 230],757,4,1433,2.7610789980732178,0.0,20.0
4519,1,519,[413 216 261 326 350],130,4,1437,2.7634615384615384,0.0,20.0
4520,1,520,[231 300 291 290 208],521,0,1437,2.7581573896353166,0.0,20.0
4521,1,521,[420 222 226 485 583],293,1,1438,2.7547892720306515,0.0,20.0
4522,1,522,[202 264 583 298 321],327,1,1439,2.751434034416826,0.0,20.0
4523,1,523,[331 384 508 211 209],551,4,1443,2.75381679389313,0.0,0.0
4524,1,524,[331 413 290 300 222],276,4,1447,2.756190476190476,0.0,40.0
4525,1,525,[251 259 216 206 223],1,4,1451,2.758555133079848,20.0,20.0
4526,1,526,[226 206 217 231 324],276,4,1455,2.760910815939279,0.0,0.0
4527,1,527,[232 300 431 255 298],222,4,1459,2.7632575757575757,0.0,40.0
4528,1,528,[280 223 219 222 291],682,1,1460,2.7599243856332705,20.0,20.0
4529,1,529,[250 367 301 299 226],880,4,1464,2.762264150943396,0.0,0.0
4530,1,530,[384 232 222 478 367],896,3,1467,2.76271186440678,20.0,20.0
4531,1,531,[290 239 218 232 509],864,4,1471,2.7650375939849625,0.0,0.0
4532,1,532,[202 378 392 206 218],487,4,1475,2.7673545966228894,0.0,0.0
4533,1,533,[246 241 583 264 218],303,3,1478,2.7677902621722845,0.0,0.0
4534,1,534,[283 230 298 217 226],880,3,1481,2.7682242990654204,0.0,20.0
4535,1,535,[208 378 241 211 303],299,2,1483,2.7667910447761193,0.0,0.0
4536,1,536,[231 218 222 290 315],407,3,1486,2.7672253258845436,20.0,20.0
4537,1,537,[315 254 261 239 350],130,4,1490,2.7695167286245352,20.0,0.0
4538,1,538,[216 365 384 239 231],472,4,1494,2.771799628942486,0.0,20.0
4539,1,539,[508 268 452 284 264],303,3,1497,2.772222222222222,0.0,20.0
4540,1,540,[276 367 303 239 481],299,2,1499,2.770794824399261,0.0,0.0
4541,1,541,[378 223 293 485 264],429,2,1501,2.7693726937269374,20.0,0.0
4542,1,542,[216 301 227 250 283],363,1,1502,2.766114180478821,0.0,20.0
4543,1,543,[202 367 222 215 216],178,5,1507,2.770220588235294,0.0,40.0
4544,1,544,[293 226 331 431 264],276,3,1510,2.770642201834862,0.0,0.0
4545,1,545,[232 240 201 315 301],880,5,1515,2.7747252747252746,20.0,0.0
4546,1,546,[219 420 218 230 452],276,4,1519,2.776965265082267,0.0,0.0
4547,1,547,[275 219 240 272 324],201,3,1522,2.7773722627737225,20.0,0.0
4548,1,548,[241 324 227 508 293],303,3,1525,2.7777777777777777,0.0,0.0
4549,1,549,[264 365 223 226 583],551,3,1528,2.7781818181818183,20.0,0.0
4550,1,550,[230 251 420 223 429],293,4,1532,2.780399274047187,20.0,0.0
4551,1,551,[201 275 219 222 283],727,1,1533,2.777173913043478,0.0,20.0
4552,1,552,[220 268 215 206 272],1,2,1535,2.7757685352622063,20.0,20.0
4553,1,553,[324 268 284 255 250],303,4,1539,2.7779783393501805,0.0,20.0
4554,1,554,[583 227 300 316 272],551,4,1543,2.78018018018018,40.0,20.0
4555,1,555,[232 507 291 215 276],303,4,1547,2.7823741007194243,0.0,0.0
4556,1,556,[272 315 344 301 299],592,3,1550,2.7827648114901256,40.0,0.0
4557,1,557,[315 231 299 272 216],130,3,1553,2.783154121863799,40.0,20.0
4558,1,558,[420 367 222 293 239],303,3,1556,2.783542039355993,0.0,20.0
4559,1,559,[303 508 201 243 218],919,4,1560,2.7857142857142856,0.0,0.0
4560,1,560,[239 232 216 241 230],916,2,1562,2.784313725490196,0.0,20.0
4561,1,561,[243 280 326 284 299],181,1,1563,2.781138790035587,0.0,0.0
4562,1,562,[226 221 254 251 230],1,3,1566,2.7815275310834813,0.0,0.0
4563,1,563,[291 254 316 240 290],130,3,1569,2.7819148936170213,20.0,0.0
4564,1,564,[452 298 250 202 420],303,4,1573,2.784070796460177,0.0,20.0
4565,1,565,[250 216 202 264 239],435,3,1576,2.784452296819788,0.0,20.0
4566,1,566,[331 226 254 298 452],276,3,1579,2.7848324514991183,0.0,20.0
4567,1,567,[208 202 246 259 284],727,4,1583,2.7869718309859155,0.0,0.0
4568,1,568,[215 508 452 219 384],896,1,1584,2.7838312829525482,0.0,0.0
4569,1,569,[226 206 217 208 202],435,5,1589,2.787719298245614,0.0,0.0
4570,1,570,[250 212 223 267 215],1,4,1593,2.7898423817863396,20.0,0.0
4571,1,571,[230 231 226 284 239],586,1,1594,2.7867132867132867,0.0,0.0
4572,1,572,[255 326 276 268 223],303,4,1598,2.7888307155322862,20.0,20.0
4573,1,573,[280 250 272 222 232],293,1,1599,2.7857142857142856,20.0,20.0
4574,1,574,[284 291 293 227 429],293,2,1601,2.7843478260869565,0.0,0.0
4575,1,575,[232 212 326 301 215],110,1,1602,2.78125,0.0,0.0
4576,1,576,[250 216 336 290 212],363,1,1603,2.778162911611785,0.0,20.0
4577,1,577,[239 202 223 367 232],222,4,1607,2.7802768166089966,20.0,0.0
4578,1,578,[208 246 231 284 223],303,5,1612,2.784110535405872,20.0,0.0
4579,1,579,[227 303 507 202 429],293,3,1615,2.7844827586206895,0.0,0.0
4580,1,580,[268 217 583 331 431],276,3,1618,2.784853700516351,0.0,20.0
4581,1,581,[227 298 452 291 241],276,3,1621,2.7852233676975944,0.0,20.0
4582,1,582,[219 283 250 452 240],303,2,1623,2.783876500857633,0.0,0.0
4583,1,583,[219 223 268 222 291],399,0,1623,2.779109589041096,20.0,40.0
4584,1,584,[321 246 299 295 276],130,3,1626,2.7794871794871794,0.0,0.0
4585,1,585,[250 246 219 222 259],268,3,1629,2.779863481228669,0.0,20.0
4586,1,586,[291 268 209 299 211],682,3,1632,2.7802385008517887,0.0,20.0
4587,1,587,[223 226 244 326 293],178,4,1636,2.7823129251700682,20.0,0.0
4588,1,588,[223 244 241 250 230],268,2,1638,2.7809847198641764,20.0,0.0
4589,1,589,[299 215 240 420 217],682,4,1642,2.783050847457627,0.0,0.0
4590,1,590,[301 243 259 255 264],919,2,1644,2.781725888324873,0.0,0.0
4591,1,591,[321 392 243 215 413],130,3,1647,2.7820945945945947,0.0,0.0
4592,1,592,[284 298 316 303 239],293,2,1649,2.780775716694772,20.0,20.0
4593,1,593,[392 507 241 431 250],393,3,1652,2.781144781144781,0.0,0.0
4594,1,594,[508 227 293 216 202],429,4,1656,2.7831932773109243,0.0,20.0
4595,1,595,[232 264 208 222 209],1,3,1659,2.783557046979866,0.0,20.0
4596,1,596,[478 300 284 291 392],896,2,1661,2.782244556113903,20.0,20.0
4597,1,597,[392 431 485 202 219],429,3,1664,2.782608695652174,0.0,0.0
4598,1,598,[209 255 213 239 206],1,3,1667,2.7829716193656093,0.0,0.0
4599,1,599,[261 231 268 272 246],1,2,1669,2.7816666666666667,20.0,20.0
4600,1,600,[315 316 392 299 295],880,4,1673,2.78369384359401,40.0,0.0
4601,1,601,[202 295 326 478 246],178,4,1677,2.7857142857142856,20.0,0.0
4602,1,602,[283 223 261 326 255],592,4,1681,2.7877280265339968,20.0,0.0
4603,1,603,[272 275 259 284 283],919,4,1685,2.7897350993377485,20.0,0.0
4604,1,604,[209 291 509 227 583],293,0,1685,2.7851239669421486,0.0,0.0
4605,1,605,[217 215 218 202 275],327,3,1688,2.7854785478547854,0.0,0.0
4606,1,606,[218 365 206 367 284],276,3,1691,2.785831960461285,0.0,0.0
4607,1,607,[227 365 429 217 392],276,3,1694,2.786184210526316,0.0,0.0
4608,1,608,[367 431 217 232 230],429,2,1696,2.7848932676518885,0.0,0.0
4609,1,609,[420 367 254 392 272],130,4,1700,2.7868852459016393,20.0,0.0
4610,1,610,[378 298 259 392 222],393,5,1705,2.79050736497545,0.0,40.0
4611,1,611,[201 239 384 231 326],303,2,1707,2.7892156862745097,0.0,0.0
4612,1,612,[264 284 206 231 232],363,0,1707,2.7846655791190864,0.0,0.0
4613,1,613,[291 431 217 392 254],276,1,1708,2.781758957654723,0.0,0.0
4614,1,614,[231 284 290 420 272],276,4,1712,2.783739837398374,20.0,0.0
4615,1,615,[326 331 298 255 268],178,4,1716,2.7857142857142856,0.0,40.0
4616,1,616,[431 384 509 315 284],551,4,1720,2.787682333873582,20.0,0.0
4617,1,617,[264 215 291 413 226],303,2,1722,2.7864077669902914,0.0,0.0
4618,1,618,[384 509 481 301 218],758,4,1726,2.788368336025848,0.0,0.0
4619,1,619,[218 219 259 268 209],682,1,1727,2.785483870967742,0.0,20.0
4620,1,620,[240 255 280 227 367],222,0,1727,2.780998389694042,0.0,0.0
4621,1,621,[222 219 223 583 239],268,2,1729,2.779742765273312,20.0,20.0
4622,1,622,[295 261 223 298 301],851,3,1732,2.780096308186196,20.0,20.0
4623,1,623,[290 276 226 394 208],864,2,1734,2.7788461538461537,0.0,0.0
4624,1,624,[223 293 367 215 431],178,5,1739,2.7824,20.0,0.0
4625,1,625,[232 250 272 230 384],276,3,1742,2.7827476038338657,20.0,0.0
4626,1,626,[297 251 284 583 420],293,3,1745,2.7830940988835726,0.0,0.0
4627,1,627,[365 232 239 250 231],222,3,1748,2.78343949044586,0.0,0.0
4628,1,628,[218 264 206 301 429],363,1,1749,2.78060413354531,0.0,0.0
4629,1,629,[227 217 268 232 208],880,4,1753,2.7825396825396824,0.0,20.0
4630,1,630,[208 222 324 300 290],758,4,1757,2.784469096671949,0.0,40.0
4631,1,631,[201 231 246 413 211],727,3,1760,2.7848101265822787,0.0,0.0
4632,1,632,[213 276 223 367 241],916,4,1764,2.786729857819905,20.0,0.0
4633,1,633,[293 452 321 227 216],303,2,1766,2.7854889589905363,0.0,20.0
4634,1,634,[367 209 413 222 227],109,2,1768,2.784251968503937,0.0,20.0
4635,1,635,[290 250 293 280 230],293,1,1769,2.7814465408805034,0.0,0.0
4636,1,636,[239 298 223 583 227],276,4,1773,2.783359497645212,20.0,20.0
4637,1,637,[431 226 429 222 232],363,2,1775,2.782131661442006,0.0,20.0
4638,1,638,[420 208 255 290 202],435,3,1778,2.782472613458529,0.0,0.0
4639,1,639,[272 321 231 284 230],201,0,1778,2.778125,20.0,0.0
4640,1,640,[215 211 241 231 243],561,1,1779,2.7753510140405617,0.0,0.0
4641,1,641,[284 218 216 247 250],222,2,1781,2.7741433021806854,0.0,20.0
4642,1,642,[219 241 290 367 324],303,4,1785,2.776049766718507,0.0,0.0
4643,1,643,[202 221 315 255 259],919,3,1788,2.7763975155279503,20.0,0.0
4644,1,644,[284 217 246 367 378],682,3,1791,2.7767441860465114,0.0,0.0
4645,1,645,[420 217 254 384 268],682,2,1793,2.7755417956656347,0.0,20.0
4646,1,646,[283 284 315 202 507],293,1,1794,2.7727975270479135,20.0,0.0
4647,1,647,[255 299 321 206 268],130,3,1797,2.7731481481481484,0.0,20.0
4648,1,648,[218 384 246 222 255],435,1,1798,2.7704160246533127,0.0,20.0
4649,1,649,[211 291 232 290 280],293,1,1799,2.767692307692308,0.0,0.0
4650,1,650,[298 299 216 201 272],682,5,1804,2.771121351766513,20.0,40.0
4651,1,651,[208 420 264 367 250],303,4,1808,2.773006134969325,0.0,0.0
4652,1,652,[321 276 202 241 268],201,2,1810,2.771822358346095,0.0,20.0
4653,1,653,[290 365 583 219 202],429,2,1812,2.770642201834862,0.0,0.0
4654,1,654,[413 276 324 290 264],181,0,1812,2.766412213740458,0.0,0.0
4655,1,655,[452 240 392 247 280],222,1,1813,2.763719512195122,0.0,0.0
4656,1,656,[272 230 331 284 303],201,1,1814,2.7610350076103503,20.0,0.0
4657,1,657,[230 213 226 431 217],201,1,1815,2.7583586626139818,0.0,0.0
4658,1,658,[452 394 230 420 268],497,1,1816,2.755690440060698,0.0,20.0
4659,1,659,[384 202 367 206 227],276,3,1819,2.756060606060606,0.0,0.0
4660,1,660,[420 267 251 508 240],532,3,1822,2.75642965204236,0.0,0.0
4661,1,661,[255 280 206 431 321],393,2,1824,2.7552870090634443,0.0,0.0
4662,1,662,[350 301 293 218 264],363,1,1825,2.7526395173453997,0.0,0.0
4663,1,663,[231 284 452 246 276],276,3,1828,2.753012048192771,0.0,0.0
4664,1,664,[209 218 208 264 291],429,3,1831,2.7533834586466166,0.0,0.0
4665,1,665,[261 295 326 272 218],130,4,1835,2.755255255255255,20.0,0.0
4666,1,666,[226 452 392 431 211],896,1,1836,2.752623688155922,0.0,0.0
4667,1,667,[202 315 384 284 331],551,4,1840,2.754491017964072,20.0,0.0
4668,1,668,[250 301 272 264 284],851,2,1842,2.7533632286995515,20.0,0.0
4669,1,669,[508 315 202 583 284],551,4,1846,2.755223880597015,20.0,0.0
4670,1,670,[300 217 215 367 276],276,4,1850,2.7570789865871834,0.0,20.0
4671,1,671,[209 231 232 367 261],222,2,1852,2.755952380952381,0.0,0.0
4672,1,672,[211 315 284 283 202],293,1,1853,2.7533432392273403,20.0,0.0
4673,1,673,[215 509 367 290 293],293,2,1855,2.7522255192878338,0.0,0.0
4674,1,674,[232 202 240 384 367],727,1,1856,2.7496296296296294,0.0,0.0
4675,1,675,[216 276 452 259 201],303,3,1859,2.75,0.0,20.0
4676,1,676,[259 297 243 217 301],919,3,1862,2.7503692762186116,0.0,0.0
4677,1,677,[390 583 250 236 239],303,2,1864,2.7492625368731565,0.0,0.0
4678,1,678,[276 215 250 315 429],276,5,1869,2.752577319587629,20.0,0.0
4679,1,679,[219 275 212 331 216],201,5,1874,2.7558823529411764,0.0,20.0
4680,1,680,[291 508 316 246 331],276,4,1878,2.7577092511013217,20.0,0.0
4681,1,681,[209 212 243 226 206],1,3,1881,2.7580645161290325,0.0,0.0
4682,1,682,[431 239 211 331 275],201,2,1883,2.7569546120058566,0.0,0.0
4683,1,683,[215 201 222 232 239],1,2,1885,2.7558479532163744,0.0,20.0
4684,1,684,[251 215 219 211 213],1,1,1886,2.7532846715328465,0.0,0.0
4685,1,685,[221 223 218 222 212],916,3,1889,2.753644314868805,20.0,20.0
4686,1,686,[259 250 230 268 508],178,3,1892,2.7540029112081514,0.0,20.0
4687,1,687,[290 236 293 298 222],130,4,1896,2.755813953488372,0.0,40.0
4688,1,688,[217 250 239 255 268],327,1,1897,2.753265602322206,0.0,20.0
4689,1,689,[316 509 324 209 272],551,4,1901,2.755072463768116,40.0,0.0
4690,1,690,[230 250 297 216 212],758,5,1906,2.7583212735166427,0.0,20.0
4691,1,691,[251 222 255 212 276],299,3,1909,2.758670520231214,0.0,20.0
4692,1,692,[452 365 240 298 255],222,2,1911,2.757575757575758,0.0,20.0
4693,1,693,[218 240 290 293 298],682,3,1914,2.7579250720461097,0.0,20.0
4694,1,694,[300 221 272 201 284],919,4,1918,2.7597122302158272,20.0,20.0
4695,1,695,[394 241 227 290 250],393,4,1922,2.7614942528735633,0.0,0.0
4696,1,696,[222 230 216 227 367],22,4,1926,2.763271162123386,0.0,40.0
4697,1,697,[219 283 290 231 250],303,4,1930,2.7650429799426934,0.0,0.0
4698,1,698,[221 268 250 336 297],592,4,1934,2.7668097281831185,0.0,20.0
4699,1,699,[291 290 300 297 507],293,2,1936,2.7657142857142856,0.0,20.0
4700,1,700,[326 218 331 217 316],551,4,1940,2.767475035663338,20.0,0.0
4701,1,701,[223 211 208 202 300],500,4,1944,2.769230769230769,20.0,20.0
4702,1,702,[509 223 283 316 215],293,2,1946,2.7681365576102417,40.0,0.0
4703,1,703,[232 240 208 226 246],222,2,1948,2.7670454545454546,0.0,0.0
4704,1,704,[431 299 251 301 202],592,2,1950,2.765957446808511,0.0,0.0
4705,1,705,[293 283 365 227 223],429,2,1952,2.764872521246459,20.0,0.0
4706,1,706,[384 216 321 201 394],435,2,1954,2.763790664780764,0.0,20.0
4707,1,707,[230 298 365 247 508],222,3,1957,2.7641242937853105,0.0,20.0
4708,1,708,[276 431 209 316 324],551,4,1961,2.765867418899859,20.0,0.0
4709,1,709,[217 216 226 222 255],130,4,1965,2.767605633802817,0.0,40.0
4710,1,710,[202 215 213 226 232],916,1,1966,2.7651195499296763,0.0,0.0
4711,1,711,[303 201 231 239 326],201,1,1967,2.7626404494382024,0.0,0.0
4712,1,712,[232 507 230 209 264],429,3,1970,2.7629733520336606,0.0,0.0
4713,1,713,[223 268 201 216 431],94,4,1974,2.764705882352941,20.0,40.0
4714,1,714,[232 508 240 301 227],276,4,1978,2.7664335664335664,0.0,0.0
4715,1,715,[272 336 268 367 201],592,4,1982,2.7681564245810057,20.0,20.0
4716,1,716,[394 276 508 232 202],880,4,1986,2.7698744769874475,0.0,0.0
4717,1,717,[295 236 251 264 243],592,2,1988,2.768802228412256,0.0,0.0
4718,1,718,[232 275 239 230 208],864,4,1992,2.7705146036161334,0.0,0.0
4719,1,719,[344 239 367 420 227],393,2,1994,2.7694444444444444,0.0,0.0
4720,1,720,[227 300 452 485 215],532,5,1999,2.7725381414701804,0.0,20.0
4721,1,721,[218 316 267 272 291],130,5,2004,2.775623268698061,40.0,0.0
4722,1,722,[413 291 206 209 284],727,1,2005,2.773167358229599,0.0,0.0
4723,1,723,[390 251 284 241 218],303,4,2009,2.7748618784530388,0.0,0.0
4724,1,724,[218 230 268 509 331],201,3,2012,2.7751724137931033,0.0,20.0
4725,1,725,[508 264 316 429 240],276,4,2016,2.7768595041322315,20.0,0.0
4726,1,726,[218 211 301 298 202],758,4,2020,2.778541953232462,0.0,20.0
4727,1,727,[213 222 206 201 431],201,2,2022,2.7774725274725274,0.0,20.0
4728,1,728,[236 280 276 212 230],916,3,2025,2.7777777777777777,0.0,0.0
4729,1,729,[315 239 298 316 208],880,5,2030,2.780821917808219,40.0,20.0
4730,1,730,[250 413 284 227 223],303,3,2033,2.781121751025992,20.0,0.0
4731,1,731,[303 217 583 226 290],276,4,2037,2.7827868852459017,0.0,0.0
4732,1,732,[236 315 240 297 350],758,4,2041,2.7844474761255116,20.0,0.0
4733,1,733,[208 209 231 222 230],268,4,2045,2.7861035422343323,0.0,20.0
4734,1,734,[485 268 367 232 227],846,4,2049,2.7877551020408164,0.0,20.0
4735,1,735,[384 223 299 219 452],896,1,2050,2.785326086956522,20.0,0.0
4736,1,736,[384 272 232 298 280],880,3,2053,2.78561736770692,20.0,20.0
4737,1,737,[276 213 324 218 316],758,4,2057,2.7872628726287263,20.0,0.0
4738,1,738,[298 216 255 211 507],293,4,2061,2.7889039242219216,0.0,40.0
4739,1,739,[226 284 431 219 232],682,2,2063,2.787837837837838,0.0,0.0
4740,1,740,[295 212 284 202 217],916,2,2065,2.786774628879892,0.0,0.0
4741,1,741,[206 298 583 303 507],293,4,2069,2.788409703504043,0.0,20.0
4742,1,742,[201 290 219 583 268],276,4,2073,2.7900403768506057,0.0,20.0
4743,1,743,[211 303 284 316 291],293,2,2075,2.788978494623656,20.0,0.0
4744,1,744,[284 218 239 507 241],303,4,2079,2.790604026845638,0.0,0.0
4745,1,745,[226 290 264 250 241],429,0,2079,2.78686327077748,0.0,0.0
4746,1,746,[226 326 315 221 201],201,1,2080,2.784471218206158,20.0,0.0
4747,1,747,[298 239 219 508 452],222,3,2083,2.78475935828877,0.0,20.0
4748,1,748,[290 227 243 240 284],130,1,2084,2.7823765020026703,0.0,0.0
4749,1,749,[291 420 290 217 230],276,4,2088,2.784,0.0,0.0
4750,1,750,[261 268 243 300 295],130,3,2091,2.7842876165113184,0.0,40.0
4751,1,751,[226 283 413 300 208],303,2,2093,2.783244680851064,0.0,20.0
4752,1,752,[246 218 276 264 583],303,3,2096,2.7835325365205845,0.0,0.0
4753,1,753,[216 276 241 232 431],429,4,2100,2.7851458885941645,0.0,20.0
4754,1,754,[298 201 227 230 219],268,1,2101,2.7827814569536424,0.0,20.0
4755,1,755,[344 508 216 232 246],327,3,2104,2.7830687830687832,0.0,20.0
4756,1,756,[227 222 268 209 226],268,5,2109,2.785997357992074,0.0,40.0
4757,1,757,[299 321 326 420 222],130,4,2113,2.787598944591029,0.0,20.0
4758,1,758,[255 236 219 298 226],303,5,2118,2.7905138339920947,0.0,20.0
4759,1,759,[230 301 226 216 508],327,1,2119,2.788157894736842,0.0,20.0
4760,1,760,[243 298 231 254 216],130,2,2121,2.7871222076215507,0.0,40.0
4761,1,761,[324 300 268 321 507],327,2,2123,2.786089238845144,0.0,40.0
4762,1,762,[227 280 206 212 367],622,1,2124,2.783748361730013,0.0,0.0
4763,1,763,[508 240 243 232 217],880,4,2128,2.7853403141361257,0.0,0.0
4764,1,764,[226 283 290 275 251],293,1,2129,2.7830065359477123,0.0,0.0
4765,1,765,[259 268 220 367 478],178,3,2132,2.783289817232376,20.0,20.0
4766,1,766,[331 301 365 298 218],276,4,2136,2.7848761408083442,0.0,20.0
4767,1,767,[250 213 206 241 232],1,3,2139,2.78515625,0.0,0.0
4768,1,768,[508 392 219 293 243],130,4,2143,2.786736020806242,0.0,0.0
4769,1,769,[218 232 384 240 226],551,3,2146,2.787012987012987,0.0,0.0
4770,1,770,[202 509 316 208 239],758,4,2150,2.788586251621271,20.0,0.0
4771,1,771,[209 226 223 240 218],551,4,2154,2.790155440414508,20.0,0.0
4772,1,772,[293 264 431 246 231],276,2,2156,2.7891332470892625,0.0,0.0
4773,1,773,[226 201 208 431 284],727,3,2159,2.789405684754522,0.0,0.0
4774,1,774,[316 303 231 298 452],276,3,2162,2.7896774193548386,20.0,20.0
4775,1,775,[264 276 222 367 250],592,3,2165,2.7899484536082473,0.0,20.0
4776,1,776,[268 272 264 246 267],1,3,2168,2.7902187902187903,20.0,20.0
4777,1,777,[394 508 222 299 250],880,3,2171,2.790488431876607,0.0,20.0
4778,1,778,[215 315 209 291 583],293,1,2172,2.7881899871630296,20.0,0.0
4779,1,779,[290 254 315 293 413],130,2,2174,2.787179487179487,20.0,0.0
4780,1,780,[209 290 298 255 293],293,2,2176,2.7861715749039693,0.0,20.0
4781,1,781,[246 297 221 315 264],919,2,2178,2.785166240409207,20.0,0.0
4782,1,782,[202 255 297 284 239],293,1,2179,2.7828863346104726,0.0,0.0
4783,1,783,[284 218 202 367 283],293,0,2179,2.7793367346938775,0.0,0.0
4784,1,784,[219 211 208 298 250],889,4,2183,2.780891719745223,0.0,20.0
4785,1,785,[261 212 227 206 202],1,4,2187,2.782442748091603,0.0,0.0
4786,1,786,[226 218 202 365 240],472,5,2192,2.7852604828462515,0.0,0.0
4787,1,787,[241 211 344 230 452],758,2,2194,2.784263959390863,0.0,0.0
4788,1,788,[297 315 208 222 508],758,5,2199,2.7870722433460076,20.0,20.0
4789,1,789,[583 429 217 324 250],276,4,2203,2.788607594936709,0.0,0.0
4790,1,790,[202 231 420 583 222],276,3,2206,2.788874841972187,0.0,20.0
4791,1,791,[264 259 212 298 222],299,2,2208,2.787878787878788,0.0,40.0
4792,1,792,[219 367 508 241 284],303,5,2213,2.790668348045397,0.0,0.0
4793,1,793,[321 217 250 268 239],327,1,2214,2.788413098236776,0.0,20.0
4794,1,794,[211 241 250 478 452],896,3,2217,2.788679245283019,20.0,0.0
4795,1,795,[481 485 508 211 300],429,2,2219,2.7876884422110555,0.0,20.0
4796,1,796,[209 452 226 232 280],222,2,2221,2.7867001254705146,0.0,0.0
4797,1,797,[276 250 209 301 350],758,3,2224,2.7869674185463658,0.0,0.0
4798,1,798,[284 255 213 206 429],293,2,2226,2.785982478097622,0.0,0.0
4799,1,799,[250 244 300 298 315],919,1,2227,2.78375,20.0,40.0
4800,1,800,[227 211 219 223 216],896,4,2231,2.7852684144818975,20.0,20.0
4801,1,801,[202 485 298 290 250],293,1,2232,2.7830423940149625,0.0,20.0
4802,1,802,[217 246 250 384 324],268,3,2235,2.783312577833126,0.0,0.0
4803,1,803,[284 324 227 326 226],551,4,2239,2.7848258706467663,0.0,0.0
4804,1,804,[241 216 264 211 223],1,3,2242,2.7850931677018633,20.0,20.0
4805,1,805,[226 367 201 216 300],896,2,2244,2.7841191066997517,0.0,40.0
4806,1,806,[201 246 365 202 211],94,3,2247,2.7843866171003717,0.0,0.0
4807,1,807,[241 215 239 268 230],521,3,2250,2.7846534653465347,0.0,20.0
4808,1,808,[392 478 507 268 216],846,3,2253,2.784919653893696,20.0,40.0
4809,1,809,[222 583 508 298 324],276,4,2257,2.78641975308642,0.0,40.0
4810,1,810,[239 215 244 272 222],1,2,2259,2.785450061652281,20.0,20.0
4811,1,811,[384 316 250 280 301],880,2,2261,2.7844827586206895,20.0,0.0
4812,1,812,[226 202 239 223 240],276,5,2266,2.787207872078721,20.0,0.0
4813,1,813,[246 583 218 230 227],94,1,2267,2.785012285012285,0.0,0.0
4814,1,814,[227 246 222 241 268],1,5,2272,2.787730061349693,0.0,40.0
4815,1,815,[384 232 231 431 202],545,2,2274,2.786764705882353,0.0,0.0
4816,1,816,[303 316 420 239 275],393,4,2278,2.788249694002448,20.0,0.0
4817,1,817,[217 250 268 230 223],916,4,2282,2.7897310513447433,20.0,20.0
4818,1,818,[202 206 284 452 215],276,4,2286,2.791208791208791,0.0,0.0
4819,1,819,[209 241 284 223 293],429,3,2289,2.7914634146341464,20.0,0.0
4820,1,820,[246 331 583 324 201],276,4,2293,2.792935444579781,0.0,0.0
4821,1,821,[201 231 324 230 241],268,2,2295,2.791970802919708,0.0,0.0
4822,1,822,[219 431 215 231 250],682,3,2298,2.7922235722964763,0.0,0.0
4823,1,823,[241 452 508 272 218],201,2,2300,2.79126213592233,20.0,0.0
4824,1,824,[223 208 315 508 217],758,4,2304,2.792727272727273,40.0,0.0
4825,1,825,[300 255 478 222 336],327,1,2305,2.790556900726392,20.0,40.0
4826,1,826,[212 208 240 217 209],889,2,2307,2.7896009673518742,0.0,0.0
4827,1,827,[211 431 217 275 392],727,3,2310,2.789855072463768,0.0,0.0
4828,1,828,[272 291 283 315 431],592,3,2313,2.790108564535585,40.0,0.0
4829,1,829,[290 230 222 208 206],268,2,2315,2.789156626506024,0.0,20.0
4830,1,830,[264 276 222 227 240],332,3,2318,2.789410348977136,0.0,20.0
4831,1,831,[315 217 429 240 218],276,5,2323,2.7920673076923075,20.0,0.0
4832,1,832,[344 227 280 365 215],393,3,2326,2.792316926770708,0.0,0.0
4833,1,833,[219 244 226 509 250],916,3,2329,2.792565947242206,0.0,0.0
4834,1,834,[293 300 201 226 284],429,1,2330,2.7904191616766467,0.0,20.0
4835,1,835,[295 250 324 244 275],936,4,2334,2.791866028708134,0.0,0.0
4836,1,836,[291 508 219 239 206],896,1,2335,2.7897252090800477,0.0,0.0
4837,1,837,[326 291 201 261 315],592,3,2338,2.7899761336515514,20.0,0.0
4838,1,838,[367 243 255 299 222],592,2,2340,2.7890345649582837,0.0,20.0
4839,1,839,[219 211 226 280 213],916,2,2342,2.788095238095238,0.0,0.0
4840,1,840,[321 297 222 236 293],919,3,2345,2.788347205707491,0.0,20.0
4841,1,841,[211 254 239 244 215],1,1,2346,2.786223277909739,0.0,0.0
4842,1,842,[429 217 226 367 240],301,4,2350,2.7876631079478056,0.0,0.0
4843,1,843,[208 259 244 297 378],299,1,2351,2.7855450236966823,0.0,0.0
4844,1,844,[251 291 420 315 222],293,2,2353,2.7846153846153845,20.0,20.0
4845,1,845,[293 276 431 583 216],682,3,2356,2.784869976359338,0.0,20.0
4846,1,846,[226 222 276 280 331],178,4,2360,2.7863046044864226,0.0,20.0
4847,1,847,[201 206 240 259 284],268,0,2360,2.7830188679245285,0.0,0.0
4848,1,848,[255 365 239 367 392],222,3,2363,2.7832744405182566,0.0,0.0
4849,1,849,[299 202 231 378 240],682,3,2366,2.783529411764706,0.0,0.0
4850,1,850,[246 298 222 239 300],276,5,2371,2.7861339600470036,0.0,60.0
4851,1,851,[326 222 218 478 223],178,4,2375,2.7875586854460095,40.0,20.0
4852,1,852,[208 231 384 201 216],22,3,2378,2.787807737397421,0.0,20.0
4853,1,853,[226 218 215 276 295],586,2,2380,2.7868852459016393,0.0,0.0
4854,1,854,[367 315 280 209 272],293,1,2381,2.784795321637427,40.0,0.0
4855,1,855,[227 209 208 429 241],846,4,2385,2.786214953271028,0.0,0.0
4856,1,856,[222 384 240 217 250],790,2,2387,2.785297549591599,0.0,20.0
4857,1,857,[222 217 508 215 291],130,4,2391,2.7867132867132867,0.0,20.0
4858,1,858,[485 250 246 384 367],790,3,2394,2.7869615832363213,0.0,0.0
4859,1,859,[268 222 276 223 367],222,4,2398,2.7883720930232556,20.0,40.0
4860,1,860,[219 206 264 291 290],435,3,2401,2.7886178861788617,0.0,0.0
4861,1,861,[365 284 240 275 215],790,3,2404,2.788863109048724,0.0,0.0
4862,1,862,[241 201 223 284 206],896,3,2407,2.7891077636152954,20.0,0.0
4863,1,863,[202 219 236 232 201],1,2,2409,2.7881944444444446,0.0,0.0
4864,1,864,[227 231 367 246 431],276,2,2411,2.7872832369942198,0.0,0.0
4865,1,865,[231 230 222 452 295],586,0,2411,2.784064665127021,0.0,20.0
4866,1,866,[300 209 202 215 240],276,5,2416,2.7866205305651675,0.0,20.0
4867,1,867,[218 413 206 429 293],276,4,2420,2.7880184331797233,0.0,0.0
4868,1,868,[222 485 431 232 384],472,3,2423,2.7882623705408514,0.0,20.0
4869,1,869,[213 241 217 239 202],916,3,2426,2.788505747126437,0.0,0.0
4870,1,870,[344 303 315 324 264],863,3,2429,2.788748564867968,20.0,0.0
4871,1,871,[232 219 246 227 268],222,4,2433,2.790137614678899,0.0,20.0
4872,1,872,[300 413 508 365 241],276,3,2436,2.790378006872852,0.0,20.0
4873,1,873,[230 226 394 208 315],880,3,2439,2.7906178489702516,20.0,0.0
4874,1,874,[226 206 431 231 227],727,2,2441,2.7897142857142856,0.0,0.0
4875,1,875,[324 209 420 251 239],303,3,2444,2.7899543378995433,0.0,0.0
4876,1,876,[276 217 221 239 324],758,1,2445,2.7879133409350056,0.0,0.0
4877,1,877,[216 201 392 250 231],429,1,2446,2.785876993166287,0.0,20.0
4878,1,878,[431 209 226 202 232],790,1,2447,2.783845278725825,0.0,0.0
4879,1,879,[215 250 316 298 202],500,3,2450,2.784090909090909,20.0,20.0
4880,1,880,[420 583 241 219 509],94,4,2454,2.7854710556186153,0.0,0.0
4881,1,881,[206 227 212 215 367],896,3,2457,2.7857142857142856,0.0,0.0
4882,1,882,[509 223 231 276 222],864,4,2461,2.7870894677236695,20.0,20.0
4883,1,883,[243 261 293 295 508],761,2,2463,2.7861990950226243,0.0,0.0
4884,1,884,[336 264 216 293 283],363,2,2465,2.785310734463277,0.0,20.0
4885,1,885,[226 301 291 429 222],276,4,2469,2.7866817155756207,0.0,20.0
4886,1,886,[452 241 215 222 276],303,3,2472,2.7869222096956032,0.0,20.0
4887,1,887,[290 221 227 297 293],758,3,2475,2.7871621621621623,0.0,0.0
4888,1,888,[367 223 250 209 231],429,2,2477,2.786276715410574,20.0,0.0
4889,1,889,[223 226 211 264 247],1,1,2478,2.784269662921348,20.0,0.0
4890,1,890,[231 431 217 481 452],758,1,2479,2.782267115600449,0.0,0.0
4891,1,891,[222 240 268 202 429],868,2,2481,2.781390134529148,0.0,40.0
4892,1,892,[208 232 216 452 219],495,4,2485,2.782754759238522,0.0,20.0
4893,1,893,[259 216 392 255 239],487,3,2488,2.7829977628635345,0.0,20.0
4894,1,894,[291 429 223 316 222],276,4,2492,2.7843575418994413,40.0,20.0
4895,1,895,[218 293 202 255 291],293,1,2493,2.7823660714285716,0.0,0.0
4896,1,896,[219 284 300 276 290],682,1,2494,2.7803790412486067,0.0,20.0
4897,1,897,[241 509 300 452 218],758,2,2496,2.779510022271715,0.0,20.0
4898,1,898,[243 452 284 240 316],130,3,2499,2.779755283648498,20.0,0.0
4899,1,899,[215 232 250 478 316],178,5,2504,2.7822222222222224,40.0,0.0
4900,1,900,[420 241 283 251 264],303,3,2507,2.7824639289678137,0.0,0.0
4901,1,901,[216 227 215 299 321],130,3,2510,2.7827050997782705,0.0,20.0
4902,1,902,[226 209 227 239 394],864,2,2512,2.7818383167220375,0.0,0.0
4903,1,903,[236 508 384 231 284],303,4,2516,2.7831858407079646,0.0,0.0
4904,1,904,[219 326 291 283 236],303,2,2518,2.7823204419889502,0.0,0.0
4905,1,905,[201 259 246 365 222],682,3,2521,2.782560706401766,0.0,20.0
4906,1,906,[218 255 227 283 583],303,2,2523,2.7816979051819186,0.0,0.0
4907,1,907,[300 384 481 240 276],301,4,2527,2.7830396475770924,0.0,20.0
4908,1,908,[316 367 303 283 297],293,2,2529,2.782178217821782,20.0,0.0
4909,1,909,[291 240 231 230 232],727,1,2530,2.78021978021978,0.0,0.0
4910,1,910,[298 378 264 202 240],299,2,2532,2.7793633369923163,0.0,20.0
4911,1,911,[298 392 219 254 206],276,3,2535,2.7796052631578947,0.0,20.0
4912,1,912,[291 246 283 431 215],592,3,2538,2.7798466593647317,0.0,0.0
4913,1,913,[201 431 508 216 218],201,4,2542,2.7811816192560177,0.0,20.0
4914,1,914,[268 201 211 431 367],561,1,2543,2.7792349726775956,0.0,20.0
4915,1,915,[392 239 216 431 301],660,1,2544,2.777292576419214,0.0,20.0
4916,1,916,[227 452 300 367 209],896,2,2546,2.776444929116685,0.0,20.0
4917,1,917,[452 254 239 219 365],276,2,2548,2.775599128540305,0.0,0.0
4918,1,918,[507 293 232 583 231],429,3,2551,2.7758433079434166,0.0,0.0
4919,1,919,[300 219 243 280 202],682,1,2552,2.773913043478261,0.0,20.0
4920,1,920,[230 232 326 583 268],303,2,2554,2.773072747014115,0.0,20.0
4921,1,921,[241 259 254 384 290],682,1,2555,2.7711496746203905,0.0,0.0
4922,1,922,[250 218 394 227 215],864,3,2558,2.771397616468039,0.0,0.0
4923,1,923,[481 264 301 321 232],429,1,2559,2.7694805194805197,0.0,0.0
4924,1,924,[290 250 231 215 201],303,5,2564,2.771891891891892,0.0,0.0
4925,1,925,[303 212 298 230 202],758,5,2569,2.7742980561555077,0.0,20.0
4926,1,926,[255 243 300 298 272],936,3,2572,2.7745415318230853,20.0,40.0
4927,1,927,[509 216 212 231 226],846,4,2576,2.7758620689655173,0.0,20.0
4928,1,928,[208 250 509 293 227],758,4,2580,2.7771797631862216,0.0,0.0
4929,1,929,[250 280 298 300 218],682,2,2582,2.7763440860215054,0.0,40.0
4930,1,930,[290 276 331 303 384],758,4,2586,2.7776584317937703,0.0,0.0
4931,1,931,[239 507 272 215 222],393,4,2590,2.778969957081545,20.0,20.0
4932,1,932,[208 583 202 392 211],94,2,2592,2.7781350482315115,0.0,0.0
4933,1,933,[367 215 583 365 211],682,2,2594,2.777301927194861,0.0,0.0
4934,1,934,[215 293 298 219 230],222,4,2598,2.7786096256684494,0.0,20.0
4935,1,935,[268 219 298 215 230],222,5,2603,2.780982905982906,0.0,40.0
4936,1,936,[246 251 264 215 216],592,4,2607,2.7822838847385274,0.0,20.0
4937,1,937,[201 291 217 298 218],682,3,2610,2.7825159914712154,0.0,20.0
4938,1,938,[264 202 222 241 485],429,2,2612,2.7816826411075612,0.0,20.0
4939,1,939,[413 230 223 392 202],276,3,2615,2.7819148936170213,20.0,0.0
4940,1,940,[240 227 268 291 275],727,3,2618,2.7821466524973433,0.0,20.0
4941,1,941,[276 239 232 219 241],561,1,2619,2.7802547770700636,0.0,0.0
4942,1,942,[299 280 272 240 202],880,4,2623,2.781548250265111,20.0,0.0
4943,1,943,[240 268 231 223 508],222,2,2625,2.780720338983051,20.0,20.0
4944,1,944,[264 218 209 254 331],276,3,2628,2.780952380952381,0.0,0.0
4945,1,945,[315 215 218 240 300],276,5,2633,2.7832980972515857,20.0,20.0
4946,1,946,[201 231 219 230 300],303,3,2636,2.7835269271383316,0.0,20.0
4947,1,947,[300 241 232 219 420],682,1,2637,2.7816455696202533,0.0,20.0
4948,1,948,[268 254 384 290 272],682,2,2639,2.780821917808219,20.0,20.0
4949,1,949,[324 216 507 367 298],327,2,2641,2.78,0.0,40.0
4950,1,950,[367 240 384 507 201],727,1,2642,2.7781282860147214,0.0,0.0
4951,1,951,[201 230 215 508 218],94,3,2645,2.778361344537815,0.0,0.0
4952,1,952,[431 507 212 367 217],561,1,2646,2.776495278069255,0.0,0.0
4953,1,953,[201 202 227 413 230],435,3,2649,2.7767295597484276,0.0,0.0
4954,1,954,[251 298 264 209 230],293,2,2651,2.775916230366492,0.0,20.0
4955,1,955,[239 298 222 206 246],521,4,2655,2.7771966527196654,0.0,40.0
4956,1,956,[251 230 509 298 429],293,3,2658,2.7774294670846396,0.0,20.0
4957,1,957,[299 290 295 300 202],130,2,2660,2.776617954070981,0.0,20.0
4958,1,958,[508 276 284 291 283],470,4,2664,2.777893639207508,0.0,0.0
4959,1,959,[220 230 217 268 261],1,2,2666,2.777083333333333,0.0,20.0
4960,1,960,[299 293 231 217 250],130,1,2667,2.7752341311134234,0.0,0.0
4961,1,961,[239 326 226 250 291],303,2,2669,2.774428274428274,0.0,0.0
4962,1,962,[222 420 276 509 236],758,3,2672,2.77466251298027,0.0,20.0
4963,1,963,[431 298 331 384 293],276,3,2675,2.774896265560166,0.0,20.0
4964,1,964,[295 331 276 222 255],592,3,2678,2.7751295336787565,0.0,20.0
4965,1,965,[276 202 509 239 226],682,1,2679,2.7732919254658386,0.0,0.0
4966,1,966,[259 331 221 336 222],592,1,2680,2.7714581178903828,0.0,20.0
4967,1,967,[268 365 201 420 241],276,4,2684,2.772727272727273,0.0,20.0
4968,1,968,[300 243 344 259 315],428,4,2688,2.7739938080495357,20.0,20.0
4969,1,969,[239 217 240 218 211],293,1,2689,2.772164948453608,0.0,0.0
4970,1,970,[246 293 303 223 276],592,5,2694,2.7744593202883627,20.0,0.0
4971,1,971,[293 240 232 202 243],682,3,2697,2.7746913580246915,0.0,0.0
4972,1,972,[244 232 223 276 239],916,3,2700,2.774922918807811,20.0,0.0
4973,1,973,[508 275 367 209 378],299,3,2703,2.7751540041067764,0.0,0.0
4974,1,974,[226 250 429 481 431],301,5,2708,2.7774358974358972,0.0,0.0
4975,1,975,[367 222 290 272 201],682,3,2711,2.7776639344262297,20.0,20.0
4976,1,976,[218 222 221 293 240],303,3,2714,2.7778915046059365,0.0,20.0
4977,1,977,[392 230 240 202 232],495,5,2719,2.780163599182004,0.0,0.0
4978,1,978,[227 315 202 213 206],201,2,2721,2.7793667007150153,20.0,0.0
4979,1,979,[217 267 268 298 216],130,4,2725,2.7806122448979593,0.0,60.0
4980,1,980,[209 264 231 583 298],303,3,2728,2.7808358817533128,0.0,20.0
4981,1,981,[239 298 202 223 215],393,4,2732,2.7820773930753564,20.0,20.0
4982,1,982,[231 583 413 240 365],276,1,2733,2.780264496439471,0.0,0.0
4983,1,983,[255 206 220 247 201],1,1,2734,2.7784552845528454,0.0,0.0
4984,1,984,[384 241 246 232 226],399,1,2735,2.7766497461928936,0.0,0.0
4985,1,985,[216 232 485 240 384],472,3,2738,2.7768762677484786,0.0,20.0
4986,1,986,[212 429 290 284 206],363,1,2739,2.7750759878419453,0.0,0.0
4987,1,987,[215 261 216 236 272],130,5,2744,2.777327935222672,20.0,20.0
4988,1,988,[216 280 392 365 300],222,4,2748,2.7785642062689586,0.0,40.0
4989,1,989,[201 324 429 508 217],276,5,2753,2.7808080808080806,0.0,0.0
4990,1,990,[268 201 251 420 291],303,4,2757,2.7820383451059536,0.0,20.0
4991,1,991,[272 240 215 211 583],551,3,2760,2.782258064516129,20.0,0.0
4992,1,992,[508 223 209 326 226],201,2,2762,2.78147029204431,20.0,0.0
4993,1,993,[272 508 324 431 212],201,3,2765,2.7816901408450705,20.0,0.0
4994,1,994,[255 240 378 227 241],393,4,2769,2.7829145728643216,0.0,0.0
4995,1,995,[264 267 268 246 223],1,4,2773,2.784136546184739,20.0,20.0
4996,1,996,[230 350 201 301 283],363,0,2773,2.781344032096289,0.0,0.0
4997,1,997,[431 481 264 392 219],429,2,2775,2.780561122244489,0.0,0.0
4998,1,998,[431 420 508 246 217],276,4,2779,2.7817817817817816,0.0,0.0
4999,1,999,[250 452 583 264 268],268,3,2782,2.782,0.0,20.0
5000,1,1000,[222 284 239 431 232],586,0,2782,2.779220779220779,0.0,20.0
5001,1,1001,[298 216 206 223 227],916,2,2784,2.7784431137724552,20.0,40.0
5002,1,1002,[420 215 583 268 255],682,2,2786,2.777666999002991,0.0,20.0
5003,1,1003,[216 239 218 241 211],561,1,2787,2.7758964143426295,0.0,20.0
5004,1,1004,[216 267 239 213 254],1,3,2790,2.7761194029850746,0.0,20.0
5005,1,1005,[290 202 231 300 243],130,2,2792,2.775347912524851,0.0,20.0
5006,1,1006,[300 222 420 367 226],276,4,2796,2.7765640516385304,0.0,40.0
5007,1,1007,[211 212 230 275 209],896,3,2799,2.7767857142857144,0.0,0.0
5008,1,1008,[244 202 223 301 284],500,2,2801,2.77601585728444,20.0,0.0
5009,1,1009,[326 350 236 202 508],592,4,2805,2.777227722772277,0.0,0.0
5010,1,1010,[202 298 299 243 239],880,4,2809,2.778437190900099,0.0,20.0
5011,1,1011,[216 300 219 239 202],130,5,2814,2.780632411067194,0.0,40.0
5012,1,1012,[367 241 232 508 215],933,1,2815,2.7788746298124383,0.0,0.0
5013,1,1013,[315 223 215 202 209],747,4,2819,2.780078895463511,40.0,0.0
5014,1,1014,[300 230 290 215 240],435,0,2819,2.7773399014778324,0.0,20.0
5015,1,1015,[218 213 481 241 452],758,3,2822,2.77755905511811,0.0,0.0
5016,1,1016,[276 216 250 209 507],429,4,2826,2.7787610619469025,0.0,20.0
5017,1,1017,[264 268 202 218 217],1,2,2828,2.7779960707269153,0.0,20.0
5018,1,1018,[222 272 276 218 232],276,4,2832,2.7791952894995093,20.0,20.0
5019,1,1019,[218 321 222 508 215],327,1,2833,2.7774509803921568,0.0,20.0
5020,1,1020,[215 264 218 208 429],293,2,2835,2.7766895200783543,0.0,0.0
5021,1,1021,[230 241 216 276 219],303,4,2839,2.7778864970645794,0.0,20.0
5022,1,1022,[256 250 223 240 211],1,3,2842,2.7781036168132944,20.0,0.0
5023,1,1023,[230 223 215 254 261],1,2,2844,2.77734375,20.0,0.0
5024,1,1024,[431 264 215 293 226],327,1,2845,2.7756097560975608,0.0,0.0
5025,1,1025,[452 240 384 216 202],758,3,2848,2.775828460038986,0.0,20.0
5026,1,1026,[264 209 316 280 227],551,3,2851,2.7760467380720546,20.0,0.0
5027,1,1027,[264 209 227 290 255],293,0,2851,2.7733463035019454,0.0,0.0
5028,1,1028,[507 431 298 481 232],429,4,2855,2.7745383867832847,0.0,20.0
5029,1,1029,[239 218 508 583 344],327,1,2856,2.7728155339805824,0.0,0.0
5030,1,1030,[250 508 227 452 243],130,2,2858,2.7720659553831233,0.0,0.0
5031,1,1031,[250 216 226 367 212],916,3,2861,2.772286821705426,0.0,20.0
5032,1,1032,[303 211 508 240 208],758,4,2865,2.7734753146176185,0.0,0.0
5033,1,1033,[350 331 222 230 206],130,2,2867,2.772727272727273,0.0,20.0
5034,1,1034,[272 215 509 293 283],293,3,2870,2.7729468599033815,20.0,0.0
5035,1,1035,[431 283 226 315 301],363,0,2870,2.77027027027027,20.0,0.0
5036,1,1036,[431 276 485 216 208],862,4,2874,2.7714561234329795,0.0,20.0
5037,1,1037,[217 230 452 378 202],868,0,2874,2.76878612716763,0.0,0.0
5038,1,1038,[284 384 268 246 298],790,4,2878,2.7699711260827717,0.0,40.0
5039,1,1039,[276 240 378 291 367],682,1,2879,2.768269230769231,0.0,0.0
5040,1,1040,[283 206 255 216 300],293,2,2881,2.7675312199807878,0.0,40.0
5041,1,1041,[226 211 227 208 321],435,4,2885,2.7687140115163147,0.0,0.0
5042,1,1042,[276 218 226 227 217],276,5,2890,2.7708533077660595,0.0,0.0
5043,1,1043,[213 509 295 236 290],916,3,2893,2.771072796934866,0.0,0.0
5044,1,1044,[300 230 215 272 216],551,5,2898,2.773205741626794,20.0,40.0
5045,1,1045,[236 390 232 508 321],303,3,2901,2.773422562141491,0.0,0.0
5046,1,1046,[429 420 583 218 202],293,2,2903,2.772683858643744,0.0,0.0
5047,1,1047,[215 231 413 213 226],201,1,2904,2.7709923664122136,0.0,0.0
5048,1,1048,[298 231 413 243 299],130,1,2905,2.76930409914204,0.0,20.0
5049,1,1049,[201 298 217 218 301],919,3,2908,2.7695238095238097,0.0,20.0
5050,1,1050,[230 298 223 583 272],293,3,2911,2.7697431018078023,40.0,20.0
5051,1,1051,[293 290 232 303 316],293,2,2913,2.7690114068441063,20.0,0.0
5052,1,1052,[276 297 259 315 221],592,4,2917,2.7701804368471037,20.0,0.0
5053,1,1053,[290 215 293 275 208],293,2,2919,2.769449715370019,0.0,0.0
5054,1,1054,[218 213 267 212 272],1,2,2921,2.7687203791469193,20.0,0.0
5055,1,1055,[298 268 211 202 583],916,3,2924,2.768939393939394,0.0,40.0
5056,1,1056,[268 367 223 326 219],222,4,2928,2.770104068117313,20.0,20.0
5057,1,1057,[222 216 507 290 223],293,3,2931,2.7703213610586013,20.0,40.0
5058,1,1058,[241 431 485 216 507],429,3,2934,2.770538243626062,0.0,20.0
5059,1,1059,[202 316 217 284 208],293,0,2934,2.767924528301887,20.0,0.0
5060,1,1060,[243 250 301 331 297],919,2,2936,2.767200754005655,0.0,0.0
5061,1,1061,[261 299 392 219 508],130,4,2940,2.768361581920904,0.0,0.0
5062,1,1062,[290 202 264 429 331],276,4,2944,2.7695202257761053,0.0,0.0
5063,1,1063,[297 255 367 250 583],293,1,2945,2.767857142857143,0.0,0.0
5064,1,1064,[326 232 276 316 284],551,5,2950,2.7699530516431925,20.0,0.0
5065,1,1065,[431 326 232 452 331],201,1,2951,2.768292682926829,0.0,0.0
5066,1,1066,[301 429 367 392 216],747,1,2952,2.7666354264292408,0.0,20.0
5067,1,1067,[250 218 315 211 217],407,5,2957,2.7687265917602994,20.0,0.0
5068,1,1068,[232 231 431 485 222],472,4,2961,2.7698783910196445,0.0,20.0
5069,1,1069,[431 300 315 231 284],276,3,2964,2.770093457943925,20.0,20.0
5070,1,1070,[300 254 293 241 223],682,2,2966,2.76937441643324,20.0,20.0
5071,1,1071,[301 268 298 216 283],592,4,2970,2.7705223880597014,0.0,60.0
5072,1,1072,[384 241 390 420 276],303,3,2973,2.7707362534948743,0.0,0.0
5073,1,1073,[452 583 231 215 365],276,1,2974,2.7690875232774674,0.0,0.0
5074,1,1074,[213 231 315 215 431],201,1,2975,2.7674418604651163,20.0,0.0
5075,1,1075,[215 300 250 223 384],682,2,2977,2.766728624535316,20.0,20.0
5076,1,1076,[284 230 298 315 240],293,1,2978,2.7650882079851438,20.0,20.0
5077,1,1077,[231 331 298 227 232],276,3,2981,2.7653061224489797,0.0,20.0
5078,1,1078,[290 509 300 367 227],293,0,2981,2.76274328081557,0.0,20.0
5079,1,1079,[508 420 365 413 219],291,4,2985,2.763888888888889,0.0,0.0
5080,1,1080,[295 301 420 267 240],532,3,2988,2.7641073080481036,0.0,0.0
5081,1,1081,[250 331 208 212 216],758,5,2993,2.766173752310536,0.0,20.0
5082,1,1082,[231 223 216 452 218],222,3,2996,2.766389658356417,20.0,20.0
5083,1,1083,[303 227 250 241 239],276,5,3001,2.768450184501845,0.0,0.0
5084,1,1084,[583 209 300 293 384],303,2,3003,2.767741935483871,0.0,20.0
5085,1,1085,[452 583 202 206 209],201,0,3003,2.765193370165746,0.0,0.0
5086,1,1086,[452 276 413 290 232],303,3,3006,2.765409383624655,0.0,0.0
5087,1,1087,[216 301 295 272 264],592,3,3009,2.765625,20.0,20.0
5088,1,1088,[222 326 365 300 227],551,5,3014,2.7676767676767677,0.0,40.0
5089,1,1089,[241 215 232 431 583],94,3,3017,2.7678899082568806,0.0,0.0
5090,1,1090,[298 226 250 303 213],293,2,3019,2.767186067827681,0.0,20.0
5091,1,1091,[429 413 300 222 264],276,3,3022,2.7673992673992673,0.0,40.0
5092,1,1092,[221 230 240 297 509],758,3,3025,2.767612076852699,0.0,0.0
5093,1,1093,[321 219 216 222 331],201,3,3028,2.7678244972577697,0.0,40.0
5094,1,1094,[250 394 365 293 240],880,2,3030,2.767123287671233,0.0,0.0
5095,1,1095,[206 303 254 367 293],276,3,3033,2.7673357664233578,0.0,0.0
5096,1,1096,[267 219 295 255 218],130,4,3037,2.7684594348222427,0.0,0.0
5097,1,1097,[223 350 236 293 255],592,4,3041,2.7695810564663024,20.0,0.0
5098,1,1098,[217 219 324 222 215],276,5,3046,2.7716105550500454,0.0,20.0
5099,1,1099,[239 583 378 284 384],870,0,3046,2.769090909090909,0.0,0.0
5100,1,1100,[290 209 230 276 231],303,4,3050,2.7702089009990916,0.0,0.0
5101,1,1101,[243 431 239 217 290],660,2,3052,2.7695099818511797,0.0,0.0
5102,1,1102,[452 218 429 206 276],276,4,3056,2.770625566636446,0.0,0.0
5103,1,1103,[202 215 240 316 232],286,3,3059,2.7708333333333335,20.0,0.0
5104,1,1104,[226 326 209 324 331],551,4,3063,2.771945701357466,0.0,0.0
5105,1,1105,[216 219 300 367 420],303,4,3067,2.7730560578661843,0.0,40.0
5106,1,1106,[222 202 331 431 201],201,2,3069,2.772357723577236,0.0,20.0
5107,1,1107,[239 272 508 350 300],758,3,3072,2.7725631768953067,20.0,20.0
5108,1,1108,[384 283 240 231 215],790,1,3073,2.7709648331830476,0.0,0.0
5109,1,1109,[223 291 331 276 213],758,4,3077,2.772072072072072,20.0,0.0
5110,1,1110,[413 276 268 218 291],130,4,3081,2.7731773177317733,0.0,20.0
5111,1,1111,[219 218 300 246 367],178,4,3085,2.7742805755395685,0.0,20.0
5112,1,1112,[254 394 239 293 201],880,3,3088,2.774483378256963,0.0,0.0
5113,1,1113,[276 413 231 316 232],276,2,3090,2.7737881508078996,20.0,0.0
5114,1,1114,[232 215 507 255 219],327,4,3094,2.7748878923766815,0.0,0.0
5115,1,1115,[290 298 429 583 246],276,4,3098,2.7759856630824373,0.0,20.0
5116,1,1116,[240 218 231 247 241],222,1,3099,2.774395702775291,0.0,0.0
5117,1,1117,[272 239 243 255 241],682,2,3101,2.7737030411449015,20.0,0.0
5118,1,1118,[367 211 431 275 217],727,2,3103,2.773011617515639,0.0,0.0
5119,1,1119,[331 299 201 246 211],435,5,3108,2.775,0.0,0.0
5120,1,1120,[261 226 272 231 295],130,3,3111,2.775200713648528,20.0,0.0
5121,1,1121,[223 431 232 241 231],429,3,3114,2.7754010695187166,20.0,0.0
5122,1,1122,[208 209 239 230 218],407,5,3119,2.777382012466607,0.0,0.0
5123,1,1123,[298 222 300 420 290],293,2,3121,2.776690391459075,0.0,60.0
5124,1,1124,[213 212 276 209 284],622,3,3124,2.7768888888888887,0.0,0.0
5125,1,1125,[227 378 392 300 291],429,1,3125,2.775310834813499,0.0,20.0
5126,1,1126,[230 209 392 217 583],276,3,3128,2.7755102040816326,0.0,0.0
5127,1,1127,[201 243 365 223 272],682,2,3130,2.774822695035461,40.0,0.0
5128,1,1128,[392 241 216 367 223],429,2,3132,2.7741364038972542,20.0,20.0
5129,1,1129,[231 268 331 255 206],130,2,3134,2.7734513274336283,0.0,20.0
5130,1,1130,[202 223 211 239 213],758,4,3138,2.7745358090185674,20.0,0.0
5131,1,1131,[211 240 209 216 215],293,3,3141,2.7747349823321557,0.0,20.0
5132,1,1132,[227 394 240 299 250],435,4,3145,2.775816416593116,0.0,0.0
5133,1,1133,[215 255 384 227 206],393,3,3148,2.7760141093474426,0.0,0.0
5134,1,1134,[298 241 284 250 268],790,5,3153,2.777973568281938,0.0,40.0
5135,1,1135,[218 244 268 212 219],916,3,3156,2.778169014084507,0.0,20.0
5136,1,1136,[250 321 230 384 508],303,2,3158,2.777484608619173,0.0,0.0
5137,1,1137,[226 201 507 378 300],429,1,3159,2.775922671353251,0.0,20.0
5138,1,1138,[239 324 481 384 208],758,4,3163,2.7769973661106233,0.0,0.0
5139,1,1139,[290 365 316 284 298],276,4,3167,2.7780701754385966,20.0,20.0
5140,1,1140,[232 230 226 268 223],561,1,3168,2.776511831726556,20.0,20.0
5141,1,1141,[251 331 259 272 264],592,2,3170,2.775831873905429,20.0,0.0
5142,1,1142,[275 508 326 300 202],178,4,3174,2.7769028871391077,0.0,20.0
5143,1,1143,[272 507 291 255 218],293,2,3176,2.7762237762237763,20.0,0.0
5144,1,1144,[336 240 394 315 211],286,4,3180,2.777292576419214,20.0,0.0
5145,1,1145,[300 331 216 316 243],130,3,3183,2.777486910994764,20.0,40.0
5146,1,1146,[272 206 298 420 367],276,4,3187,2.778552746294682,20.0,20.0
5147,1,1147,[250 223 226 508 232],303,5,3192,2.7804878048780486,20.0,0.0
5148,1,1148,[283 303 206 290 378],393,2,3194,2.7798085291557877,0.0,0.0
5149,1,1149,[222 264 202 297 240],919,1,3195,2.7782608695652176,0.0,20.0
5150,1,1150,[276 326 227 264 300],332,3,3198,2.778453518679409,0.0,20.0
5151,1,1151,[218 507 202 301 217],429,2,3200,2.7777777777777777,0.0,0.0
5152,1,1152,[293 241 268 240 264],276,4,3204,2.7788378143972245,0.0,20.0
5153,1,1153,[300 202 429 264 431],70,3,3207,2.7790294627383014,0.0,20.0
5154,1,1154,[509 209 485 239 231],846,4,3211,2.78008658008658,0.0,0.0
5155,1,1155,[240 230 208 394 284],435,2,3213,2.7794117647058822,0.0,0.0
5156,1,1156,[509 272 316 232 507],293,2,3215,2.7787381158167674,40.0,0.0
5157,1,1157,[452 508 300 303 284],276,4,3219,2.7797927461139897,0.0,20.0
5158,1,1158,[508 268 244 240 255],919,2,3221,2.7791199309749786,0.0,20.0
5159,1,1159,[367 301 209 300 284],276,4,3225,2.7801724137931036,0.0,20.0
5160,1,1160,[324 291 431 259 261],592,1,3226,2.7786391042204994,0.0,0.0
5161,1,1161,[217 226 321 431 324],327,0,3226,2.7762478485370052,0.0,0.0
5162,1,1162,[295 276 378 384 241],399,2,3228,2.775580395528805,0.0,0.0
5163,1,1163,[239 218 300 250 298],682,2,3230,2.774914089347079,0.0,40.0
5164,1,1164,[239 223 227 300 208],293,1,3231,2.7733905579399143,20.0,20.0
5165,1,1165,[251 264 244 378 384],299,1,3232,2.771869639794168,0.0,0.0
5166,1,1166,[276 206 367 226 202],561,1,3233,2.770351328191945,0.0,0.0
5167,1,1167,[218 219 211 293 300],682,2,3235,2.7696917808219177,0.0,20.0
5168,1,1168,[431 255 239 206 378],393,3,3238,2.76988879384089,0.0,0.0
5169,1,1169,[259 227 247 254 239],1,2,3240,2.769230769230769,0.0,0.0
5170,1,1170,[216 254 250 202 243],130,2,3242,2.7685738684884713,0.0,20.0
5171,1,1171,[284 303 219 231 226],201,1,3243,2.7670648464163823,0.0,0.0
5172,1,1172,[209 429 420 431 268],276,4,3247,2.7681159420289854,0.0,20.0
5173,1,1173,[315 326 261 293 226],130,5,3252,2.770017035775128,20.0,0.0
5174,1,1174,[384 219 223 276 268],682,1,3253,2.7685106382978724,20.0,20.0
5175,1,1175,[268 239 250 508 232],222,3,3256,2.7687074829931975,0.0,20.0
5176,1,1176,[293 244 250 367 303],919,3,3259,2.768903993203059,0.0,0.0
5177,1,1177,[420 226 299 478 215],896,3,3262,2.769100169779287,20.0,0.0
5178,1,1178,[283 508 275 219 301],429,3,3265,2.769296013570823,0.0,0.0
5179,1,1179,[230 216 283 208 284],293,1,3266,2.7677966101694915,0.0,20.0
5180,1,1180,[583 246 284 223 231],268,3,3269,2.7679932260795934,20.0,0.0
5181,1,1181,[206 295 267 226 413],130,2,3271,2.767343485617597,0.0,0.0
5182,1,1182,[241 264 219 583 291],551,3,3274,2.767540152155537,0.0,0.0
5183,1,1183,[509 209 230 223 268],201,2,3276,2.766891891891892,20.0,20.0
5184,1,1184,[227 219 209 324 240],551,3,3279,2.767088607594937,0.0,0.0
5185,1,1185,[226 452 315 367 222],276,3,3282,2.767284991568297,20.0,20.0
5186,1,1186,[298 392 243 378 283],393,4,3286,2.7683235046335297,0.0,20.0
5187,1,1187,[250 350 315 344 293],592,5,3291,2.7702020202020203,20.0,0.0
5188,1,1188,[226 246 241 300 201],682,3,3294,2.770395290159798,0.0,20.0
5189,1,1189,[250 293 299 297 236],592,3,3297,2.7705882352941176,0.0,0.0
5190,1,1190,[206 303 293 452 268],276,4,3301,2.7716204869857264,0.0,20.0
5191,1,1191,[301 284 508 223 365],429,2,3303,2.7709731543624163,20.0,0.0
5192,1,1192,[316 227 315 202 223],393,4,3307,2.7720033528918693,60.0,0.0
5193,1,1193,[218 272 215 508 201],276,5,3312,2.7738693467336684,20.0,0.0
5194,1,1194,[485 239 507 367 227],846,4,3316,2.77489539748954,0.0,0.0
5195,1,1195,[250 202 367 365 321],429,1,3317,2.7734113712374584,0.0,0.0
5196,1,1196,[254 255 276 259 272],682,1,3318,2.7719298245614037,20.0,0.0
5197,1,1197,[452 239 295 222 268],130,4,3322,2.7729549248747913,0.0,40.0
5198,1,1198,[215 284 259 367 508],178,3,3325,2.773144286905755,0.0,0.0
5199,1,1199,[209 218 259 255 201],303,4,3329,2.7741666666666664,0.0,0.0
5200,1,1200,[217 276 222 272 365],551,4,3333,2.7751873438801,20.0,20.0
5201,1,1201,[255 291 226 217 206],293,1,3334,2.7737104825291183,0.0,0.0
5202,1,1202,[219 431 297 276 298],889,3,3337,2.773898586866168,0.0,20.0
5203,1,1203,[250 231 243 284 217],130,0,3337,2.771594684385382,0.0,0.0
5204,1,1204,[243 202 276 268 255],130,4,3341,2.7726141078838173,0.0,20.0
5205,1,1205,[315 297 222 321 293],919,2,3343,2.771973466003317,20.0,20.0
5206,1,1206,[268 218 215 226 509],201,2,3345,2.7713338856669427,0.0,20.0
5207,1,1207,[202 291 240 236 481],758,4,3349,2.7723509933774833,0.0,0.0
5208,1,1208,[300 243 293 303 244],919,3,3352,2.772539288668321,0.0,20.0
5209,1,1209,[315 367 217 508 227],880,4,3356,2.7735537190082646,20.0,0.0
5210,1,1210,[250 212 240 219 290],291,5,3361,2.7753922378199833,0.0,0.0
5211,1,1211,[219 231 293 420 206],130,3,3364,2.7755775577557755,0.0,0.0
5212,1,1212,[216 300 241 218 231],682,2,3366,2.7749381698268754,0.0,40.0
5213,1,1213,[215 390 276 367 290],303,4,3370,2.775947281713344,0.0,0.0
5214,1,1214,[232 241 223 290 268],303,5,3375,2.7777777777777777,20.0,20.0
5215,1,1215,[272 413 227 293 420],130,3,3378,2.7779605263157894,20.0,0.0
5216,1,1216,[255 208 247 211 261],1,1,3379,2.7764995891536564,0.0,0.0
5217,1,1217,[222 264 246 420 300],276,4,3383,2.777504105090312,0.0,40.0
5218,1,1218,[485 230 508 290 291],429,2,3385,2.7768662838392126,0.0,0.0
5219,1,1219,[284 226 244 275 250],178,4,3389,2.7778688524590165,0.0,0.0
5220,1,1220,[241 507 276 264 222],429,3,3392,2.778050778050778,0.0,20.0
5221,1,1221,[227 315 202 239 250],484,4,3396,2.779050736497545,20.0,0.0
5222,1,1222,[508 291 452 429 219],896,1,3397,2.777596075224857,0.0,0.0
5223,1,1223,[293 219 222 413 264],276,3,3400,2.7777777777777777,0.0,20.0
5224,1,1224,[298 293 367 291 583],303,3,3403,2.7779591836734694,0.0,20.0
5225,1,1225,[272 208 420 283 206],293,3,3406,2.7781402936378465,20.0,0.0
5226,1,1226,[212 201 215 384 209],896,1,3407,2.7766911165444172,0.0,0.0
5227,1,1227,[284 268 211 246 216],870,1,3408,2.775244299674267,0.0,40.0
5228,1,1228,[378 321 227 217 301],429,0,3408,2.7729861676159477,0.0,0.0
5229,1,1229,[431 218 452 413 303],276,2,3410,2.772357723577236,0.0,0.0
5230,1,1230,[211 217 583 219 336],327,1,3411,2.7709179528838344,0.0,0.0
5231,1,1231,[392 246 315 365 218],276,3,3414,2.771103896103896,20.0,0.0
5232,1,1232,[315 481 211 212 216],758,5,3419,2.772911597729116,20.0,20.0
5233,1,1233,[268 241 326 227 259],303,2,3421,2.772285251215559,0.0,20.0
5234,1,1234,[299 243 220 331 221],181,1,3422,2.7708502024291497,0.0,0.0
5235,1,1235,[246 280 272 268 367],682,3,3425,2.7710355987055015,20.0,20.0
5236,1,1236,[223 509 420 211 240],758,3,3428,2.771220695230396,20.0,0.0
5237,1,1237,[272 293 324 201 250],425,3,3431,2.77140549273021,20.0,0.0
5238,1,1238,[284 268 276 367 315],919,2,3433,2.770782889426957,20.0,20.0
5239,1,1239,[365 290 250 222 275],429,2,3435,2.7701612903225805,0.0,20.0
5240,1,1240,[239 212 232 209 420],896,2,3437,2.7695406929895245,0.0,0.0
5241,1,1241,[217 219 223 384 216],896,2,3439,2.7689210950080514,20.0,20.0
5242,1,1242,[378 280 247 223 413],222,1,3440,2.7674979887369267,20.0,0.0
5243,1,1243,[215 478 367 268 264],327,4,3444,2.7684887459807075,20.0,20.0
5244,1,1244,[300 452 508 413 431],222,2,3446,2.767871485943775,0.0,20.0
5245,1,1245,[201 255 222 431 350],592,3,3449,2.7680577849117176,0.0,20.0
5246,1,1246,[413 221 303 284 232],201,0,3449,2.7658380112269447,0.0,0.0
5247,1,1247,[206 367 213 226 264],293,1,3450,2.764423076923077,0.0,0.0
5248,1,1248,[250 227 230 240 223],222,2,3452,2.7638110488390715,20.0,0.0
5249,1,1249,[221 227 390 324 508],303,2,3454,2.7632,0.0,0.0
5250,1,1250,[272 218 217 283 284],919,4,3458,2.7641886490807352,20.0,0.0
5251,1,1251,[268 240 367 254 284],682,3,3461,2.7643769968051117,0.0,20.0
5252,1,1252,[232 231 301 226 246],880,4,3465,2.7653631284916202,0.0,0.0
5253,1,1253,[213 509 303 227 284],293,1,3466,2.7639553429027113,0.0,0.0
5254,1,1254,[324 284 215 236 507],303,4,3470,2.764940239043825,0.0,0.0
5255,1,1255,[218 268 240 250 365],880,3,3473,2.765127388535032,0.0,20.0
5256,1,1256,[230 268 326 452 243],130,3,3476,2.7653142402545745,0.0,20.0
5257,1,1257,[300 208 280 367 298],429,2,3478,2.764705882352941,0.0,40.0
5258,1,1258,[326 259 268 209 283],303,2,3480,2.7640984908657664,0.0,20.0
5259,1,1259,[256 227 202 222 246],1,5,3485,2.765873015873016,0.0,20.0
5260,1,1260,[331 223 222 215 202],551,5,3490,2.767644726407613,20.0,20.0
5261,1,1261,[231 217 250 208 420],497,1,3491,2.766244057052298,0.0,0.0
5262,1,1262,[226 230 219 284 431],429,2,3493,2.7656373713380837,0.0,0.0
5263,1,1263,[452 272 301 316 230],532,5,3498,2.767405063291139,40.0,0.0
5264,1,1264,[508 206 392 219 367],130,4,3502,2.768379446640316,0.0,0.0
5265,1,1265,[218 293 239 301 227],276,5,3507,2.7701421800947865,0.0,0.0
5266,1,1266,[283 215 230 298 280],622,2,3509,2.769534333070245,0.0,20.0
5267,1,1267,[218 392 390 216 208],94,2,3511,2.7689274447949526,0.0,20.0
5268,1,1268,[350 392 452 331 250],130,3,3514,2.769109535066982,0.0,0.0
5269,1,1269,[254 208 213 243 219],1,1,3515,2.767716535433071,0.0,0.0
5270,1,1270,[429 241 202 223 284],896,4,3519,2.7686860739575136,20.0,0.0
5271,1,1271,[293 367 202 218 201],276,4,3523,2.7696540880503147,0.0,0.0
5272,1,1272,[365 216 301 231 276],429,2,3525,2.7690494893951296,0.0,20.0
5273,1,1273,[280 209 315 507 216],293,2,3527,2.768445839874411,20.0,20.0
5274,1,1274,[300 367 283 221 202],303,3,3530,2.768627450980392,0.0,20.0
5275,1,1275,[255 239 420 276 227],130,4,3534,2.769592476489028,0.0,0.0
5276,1,1276,[216 211 291 283 250],429,3,3537,2.769772905246672,0.0,20.0
5277,1,1277,[246 478 431 239 215],327,3,3540,2.7699530516431925,20.0,0.0
5278,1,1278,[217 431 202 212 413],201,1,3541,2.768569194683346,0.0,0.0
5279,1,1279,[293 267 300 230 227],130,3,3544,2.76875,0.0,20.0
5280,1,1280,[239 324 216 227 250],521,1,3545,2.767369242779079,0.0,20.0
5281,1,1281,[431 255 299 201 297],592,3,3548,2.767550702028081,0.0,0.0
5282,1,1282,[223 300 250 227 217],293,1,3549,2.7661730319563524,20.0,20.0
5283,1,1283,[255 378 315 216 219],870,1,3550,2.764797507788162,20.0,20.0
5284,1,1284,[300 255 384 222 254],435,0,3550,2.762645914396887,0.0,40.0
5285,1,1285,[344 365 303 202 283],393,1,3551,2.761275272161742,0.0,0.0
5286,1,1286,[219 209 217 215 384],276,4,3555,2.762237762237762,0.0,0.0
5287,1,1287,[251 209 291 583 485],293,1,3556,2.760869565217391,0.0,0.0
5288,1,1288,[209 298 392 485 243],660,1,3557,2.7595034910783554,0.0,20.0
5289,1,1289,[394 255 298 226 268],435,4,3561,2.76046511627907,0.0,40.0
5290,1,1290,[485 230 217 255 213],293,0,3561,2.758326878388846,0.0,0.0
5291,1,1291,[222 315 324 303 230],276,5,3566,2.760061919504644,20.0,20.0
5292,1,1292,[239 217 241 275 321],201,1,3567,2.7587006960556844,0.0,0.0
5293,1,1293,[508 300 209 239 264],303,2,3569,2.7581143740340033,0.0,20.0
5294,1,1294,[246 211 264 268 507],327,3,3572,2.7583011583011583,0.0,20.0
5295,1,1295,[481 272 255 315 239],870,2,3574,2.757716049382716,40.0,0.0
5296,1,1296,[365 227 206 390 218],94,2,3576,2.7571318427139553,0.0,0.0
5297,1,1297,[507 420 240 365 291],393,1,3577,2.7557781201848996,0.0,0.0
5298,1,1298,[215 202 222 300 206],487,5,3582,2.7575057736720554,0.0,40.0
5299,1,1299,[209 508 284 272 326],551,5,3587,2.7592307692307694,20.0,0.0
5300,1,1300,[240 326 508 331 220],181,1,3588,2.757878554957725,0.0,0.0
5301,1,1301,[226 222 241 268 365],94,2,3590,2.7572964669738864,0.0,40.0
5302,1,1302,[293 208 284 241 232],429,3,3593,2.7574827321565616,0.0,0.0
5303,1,1303,[300 250 267 452 290],130,3,3596,2.7576687116564416,0.0,20.0
5304,1,1304,[230 384 508 246 250],276,4,3600,2.7586206896551726,0.0,0.0
5305,1,1305,[250 240 227 226 420],497,1,3601,2.7572741194486983,0.0,0.0
5306,1,1306,[222 261 259 300 299],181,1,3602,2.75592960979342,0.0,40.0
5307,1,1307,[231 452 301 326 583],425,1,3603,2.7545871559633026,0.0,0.0
5308,1,1308,[378 507 206 290 250],393,2,3605,2.7540106951871657,0.0,0.0
5309,1,1309,[378 239 202 485 208],472,4,3609,2.7549618320610687,0.0,0.0
5310,1,1310,[202 241 261 300 208],222,2,3611,2.754385964912281,0.0,20.0
5311,1,1311,[284 276 218 216 509],551,5,3616,2.7560975609756095,0.0,20.0
5312,1,1312,[315 241 239 316 293],276,5,3621,2.757806549885758,40.0,0.0
5313,1,1313,[211 259 384 367 215],790,2,3623,2.7572298325722984,0.0,0.0
5314,1,1314,[217 268 315 276 452],201,2,3625,2.7566539923954374,20.0,20.0
5315,1,1315,[316 222 216 236 291],758,5,3630,2.7583586626139818,20.0,40.0
5316,1,1316,[297 303 217 218 202],758,4,3634,2.759301442672741,0.0,0.0
5317,1,1317,[384 413 215 291 300],435,1,3635,2.7579666160849774,0.0,20.0
5318,1,1318,[303 222 420 202 300],276,5,3640,2.759666413949962,0.0,40.0
5319,1,1319,[295 413 291 227 268],399,1,3641,2.7583333333333333,0.0,20.0
5320,1,1320,[324 290 452 231 384],268,2,3643,2.75775927327782,0.0,0.0
5321,1,1321,[431 216 452 223 508],758,3,3646,2.7579425113464446,20.0,20.0
5322,1,1322,[216 298 250 291 324],758,5,3651,2.759637188208617,0.0,40.0
5323,1,1323,[431 231 215 222 384],472,4,3655,2.760574018126888,0.0,20.0
5324,1,1324,[211 208 508 268 218],870,2,3657,2.76,0.0,20.0
5325,1,1325,[212 219 226 276 508],201,4,3661,2.7609351432880844,0.0,0.0
5326,1,1326,[202 216 301 255 230],487,4,3665,2.761868877166541,0.0,20.0
5327,1,1327,[290 230 208 226 227],22,5,3670,2.76355421686747,0.0,0.0
5328,1,1328,[208 267 226 211 218],268,3,3673,2.763732129420617,0.0,0.0
5329,1,1329,[298 202 209 276 272],682,3,3676,2.7639097744360903,20.0,20.0
5330,1,1330,[280 509 222 293 290],682,2,3678,2.763335837716003,0.0,20.0
5331,1,1331,[315 326 221 215 222],201,0,3678,2.7612612612612613,20.0,20.0
5332,1,1332,[215 246 384 231 290],276,3,3681,2.7614403600900226,0.0,0.0
5333,1,1333,[218 298 231 202 239],880,4,3685,2.762368815592204,0.0,20.0
5334,1,1334,[222 284 275 215 481],896,5,3690,2.764044943820225,0.0,20.0
5335,1,1335,[336 259 255 236 293],592,2,3692,2.7634730538922154,0.0,0.0
5336,1,1336,[216 215 250 226 231],246,1,3693,2.762154076290202,0.0,20.0
5337,1,1337,[293 206 431 230 219],94,4,3697,2.7630792227204783,0.0,0.0
5338,1,1338,[254 211 394 291 239],435,4,3701,2.764002987303958,0.0,0.0
5339,1,1339,[321 236 209 259 222],303,2,3703,2.7634328358208955,0.0,20.0
5340,1,1340,[239 321 217 213 215],201,1,3704,2.762117822520507,0.0,0.0
5341,1,1341,[226 365 206 315 231],276,3,3707,2.762295081967213,20.0,0.0
5342,1,1342,[290 413 315 222 284],276,4,3711,2.763216679076694,20.0,20.0
5343,1,1343,[239 246 219 227 268],276,5,3716,2.7648809523809526,0.0,20.0
5344,1,1344,[216 291 240 232 264],303,2,3718,2.7643122676579925,0.0,20.0
5345,1,1345,[331 315 365 293 227],276,4,3722,2.765230312035661,20.0,0.0
5346,1,1346,[209 365 301 291 431],429,3,3725,2.765404602821084,0.0,0.0
5347,1,1347,[384 280 276 232 209],880,2,3727,2.7648367952522257,0.0,0.0
5348,1,1348,[202 201 255 236 246],592,4,3731,2.765752409191994,0.0,0.0
5349,1,1349,[246 239 290 215 268],130,4,3735,2.7666666666666666,0.0,20.0
5350,1,1350,[217 300 509 246 211],682,3,3738,2.766839378238342,0.0,20.0
5351,1,1351,[365 230 508 392 413],276,2,3740,2.7662721893491122,0.0,0.0
5352,1,1352,[231 303 218 331 206],201,2,3742,2.7657058388765705,0.0,0.0
5353,1,1353,[276 223 254 420 429],276,4,3746,2.7666174298375186,20.0,0.0
5354,1,1354,[218 239 215 392 290],130,4,3750,2.7675276752767526,0.0,0.0
5355,1,1355,[222 226 217 298 240],293,1,3751,2.7662241887905603,0.0,40.0
5356,1,1356,[508 290 298 261 291],130,4,3755,2.767133382461312,0.0,20.0
5357,1,1357,[255 239 209 222 297],293,1,3756,2.7658321060382915,0.0,20.0
5358,1,1358,[259 485 217 365 298],790,3,3759,2.7660044150110377,0.0,20.0
5359,1,1359,[232 217 239 201 211],727,3,3762,2.7661764705882352,0.0,0.0
5360,1,1360,[202 290 218 583 240],293,0,3762,2.764144011756062,0.0,0.0
5361,1,1361,[392 272 254 215 303],276,3,3765,2.76431718061674,20.0,0.0
5362,1,1362,[239 218 222 478 290],249,2,3767,2.763756419662509,20.0,20.0
5363,1,1363,[239 268 240 324 230],521,2,3769,2.7631964809384164,0.0,20.0
5364,1,1364,[264 239 217 216 583],327,0,3769,2.761172161172161,0.0,20.0
5365,1,1365,[507 316 227 367 392],393,3,3772,2.761346998535871,20.0,0.0
5366,1,1366,[378 413 276 295 230],399,1,3773,2.760058522311631,0.0,0.0
5367,1,1367,[208 485 232 239 315],293,0,3773,2.7580409356725144,20.0,0.0
5368,1,1368,[508 268 239 206 236],130,4,3777,2.7589481373265157,0.0,20.0
5369,1,1369,[239 221 324 276 583],201,2,3779,2.7583941605839417,0.0,0.0
5370,1,1370,[230 201 244 202 208],407,4,3783,2.7592997811816193,0.0,0.0
5371,1,1371,[315 303 241 297 217],758,3,3786,2.759475218658892,20.0,0.0
5372,1,1372,[222 268 201 241 324],303,3,3789,2.759650400582666,0.0,40.0
5373,1,1373,[222 211 218 231 413],109,3,3792,2.7598253275109172,0.0,20.0
5374,1,1374,[236 213 481 250 240],758,4,3796,2.760727272727273,0.0,0.0
5375,1,1375,[508 227 231 239 222],109,4,3800,2.761627906976744,0.0,20.0
5376,1,1376,[241 284 218 452 223],201,2,3802,2.7610748002904866,20.0,0.0
5377,1,1377,[297 218 230 298 280],293,2,3804,2.760522496371553,0.0,20.0
5378,1,1378,[321 324 509 452 268],201,2,3806,2.7599709934735315,0.0,20.0
5379,1,1379,[209 217 290 298 452],276,4,3810,2.760869565217391,0.0,20.0
5380,1,1380,[250 508 231 261 218],222,1,3811,2.759594496741492,0.0,0.0
5381,1,1381,[259 326 508 255 298],592,4,3815,2.760492040520984,0.0,20.0
5382,1,1382,[268 227 255 264 202],435,3,3818,2.760665220535069,0.0,20.0
5383,1,1383,[223 218 243 251 219],1,2,3820,2.760115606936416,20.0,0.0
5384,1,1384,[315 276 222 246 267],130,5,3825,2.7617328519855597,20.0,20.0
5385,1,1385,[201 226 219 367 290],276,4,3829,2.7626262626262625,0.0,0.0
5386,1,1386,[284 208 378 485 276],429,2,3831,2.762076423936554,0.0,0.0
5387,1,1387,[208 217 250 336 226],363,2,3833,2.761527377521614,0.0,0.0
5388,1,1388,[378 243 420 507 365],393,2,3835,2.7609791216702666,0.0,0.0
5389,1,1389,[216 394 291 331 300],435,3,3838,2.7611510791366904,0.0,40.0
5390,1,1390,[241 384 326 300 367],303,2,3840,2.7606038820992094,0.0,20.0
5391,1,1391,[392 300 202 315 293],130,5,3845,2.762212643678161,20.0,20.0
5392,1,1392,[213 202 226 239 392],846,3,3848,2.762383345297918,0.0,0.0
5393,1,1393,[219 216 299 291 240],682,3,3851,2.7625538020086085,0.0,20.0
5394,1,1394,[211 216 241 481 478],299,3,3854,2.7627240143369174,20.0,20.0
5395,1,1395,[209 250 240 290 231],276,4,3858,2.7636103151862463,0.0,0.0
5396,1,1396,[246 217 250 227 413],222,1,3859,2.7623478883321404,0.0,0.0
5397,1,1397,[222 291 208 215 293],303,3,3862,2.7625178826895564,0.0,20.0
5398,1,1398,[390 413 223 298 420],303,3,3865,2.762687634024303,20.0,20.0
5399,1,1399,[367 206 250 431 365],393,1,3866,2.7614285714285716,0.0,0.0
5400,1,1400,[392 367 217 507 485],429,1,3867,2.76017130620985,0.0,0.0
5401,1,1401,[219 217 267 268 246],268,2,3869,2.7596291012838803,0.0,20.0
5402,1,1402,[232 231 230 202 452],846,1,3870,2.758374910905203,0.0,0.0
5403,1,1403,[222 452 326 230 239],303,0,3870,2.7564102564102564,0.0,20.0
5404,1,1404,[413 241 239 324 250],276,4,3874,2.7572953736654804,0.0,0.0
5405,1,1405,[209 202 268 324 272],276,5,3879,2.758890469416785,20.0,20.0
5406,1,1406,[284 217 301 226 202],880,5,3884,2.7604832977967306,0.0,0.0
5407,1,1407,[217 284 209 431 276],276,4,3888,2.7613636363636362,0.0,0.0
5408,1,1408,[367 298 272 250 508],130,4,3892,2.7622427253371185,20.0,20.0
5409,1,1409,[290 223 291 209 217],758,4,3896,2.7631205673758865,20.0,0.0
5410,1,1410,[481 293 300 291 392],429,2,3898,2.7625797306874555,0.0,20.0
5411,1,1411,[227 452 508 420 201],896,2,3900,2.762039660056657,0.0,0.0
5412,1,1412,[268 326 284 218 275],178,4,3904,2.7629157820240624,0.0,20.0
5413,1,1413,[202 297 298 293 264],592,4,3908,2.763790664780764,0.0,20.0
5414,1,1414,[367 230 215 216 392],846,3,3911,2.7639575971731447,0.0,20.0
5415,1,1415,[350 231 230 208 222],363,2,3913,2.763418079096045,0.0,20.0
5416,1,1416,[431 276 452 209 231],758,1,3914,2.7621736062103035,0.0,0.0
5417,1,1417,[290 219 231 367 243],130,2,3916,2.76163610719323,0.0,0.0
5418,1,1418,[261 331 326 202 223],919,2,3918,2.7610993657505287,20.0,0.0
5419,1,1419,[219 295 211 290 268],916,2,3920,2.76056338028169,0.0,20.0
5420,1,1420,[367 236 276 255 321],303,4,3924,2.761435608726249,0.0,0.0
5421,1,1421,[413 508 231 268 239],222,2,3926,2.760900140646976,0.0,20.0
5422,1,1422,[267 264 268 246 272],1,3,3929,2.7610681658468024,20.0,20.0
5423,1,1423,[230 250 231 239 350],758,3,3932,2.7612359550561796,0.0,0.0
5424,1,1424,[508 326 206 295 420],130,3,3935,2.76140350877193,0.0,0.0
5425,1,1425,[226 202 222 316 213],293,0,3935,2.759467040673212,20.0,20.0
5426,1,1426,[232 367 293 420 243],682,1,3936,2.7582340574632096,0.0,0.0
5427,1,1427,[220 241 215 255 367],244,2,3938,2.757703081232493,0.0,0.0
5428,1,1428,[201 222 227 250 217],880,3,3941,2.7578726382085375,0.0,20.0
5429,1,1429,[280 250 255 276 326],178,4,3945,2.7587412587412588,0.0,0.0
5430,1,1430,[209 290 420 583 227],303,3,3948,2.758909853249476,0.0,0.0
5431,1,1431,[365 202 583 219 509],551,4,3952,2.7597765363128492,0.0,0.0
5432,1,1432,[413 261 324 243 256],181,0,3952,2.757850662944871,0.0,0.0
5433,1,1433,[300 350 206 240 243],130,3,3955,2.7580195258019526,0.0,20.0
5434,1,1434,[301 219 324 365 300],276,4,3959,2.7588850174216026,0.0,20.0
5435,1,1435,[367 230 276 295 232],332,3,3962,2.7590529247910864,0.0,0.0
5436,1,1436,[413 239 246 219 222],130,4,3966,2.759916492693111,0.0,20.0
5437,1,1437,[367 250 298 280 223],429,2,3968,2.7593880389429764,20.0,20.0
5438,1,1438,[236 300 275 222 201],919,4,3972,2.760250173731758,0.0,40.0
5439,1,1439,[230 284 241 201 206],276,5,3977,2.7618055555555556,0.0,0.0
5440,1,1440,[215 223 230 316 324],551,4,3981,2.7626648160999308,40.0,0.0
5441,1,1441,[209 231 507 431 230],727,1,3982,2.7614424410540916,0.0,0.0
5442,1,1442,[240 283 222 275 303],293,1,3983,2.7602217602217602,0.0,20.0
5443,1,1443,[250 239 508 316 227],130,3,3986,2.760387811634349,20.0,0.0
5444,1,1444,[316 303 241 384 431],276,3,3989,2.760553633217993,20.0,0.0
5445,1,1445,[211 231 217 208 300],70,3,3992,2.760719225449516,0.0,20.0
5446,1,1446,[431 316 219 295 300],178,4,3996,2.7615756738078785,20.0,20.0
5447,1,1447,[315 392 485 208 429],747,4,4000,2.7624309392265194,20.0,0.0
5448,1,1448,[217 413 202 331 293],130,2,4002,2.761904761904762,0.0,0.0
5449,1,1449,[223 429 272 241 303],276,5,4007,2.763448275862069,40.0,0.0
5450,1,1450,[222 326 272 303 293],592,4,4011,2.764300482425913,20.0,20.0
5451,1,1451,[293 284 255 236 217],919,4,4015,2.765151515151515,0.0,0.0
5452,1,1452,[216 509 272 222 452],201,1,4016,2.763936682725396,20.0,40.0
5453,1,1453,[236 217 250 215 209],1,3,4019,2.764099037138927,0.0,0.0
5454,1,1454,[283 429 217 211 240],293,2,4021,2.763573883161512,0.0,0.0
5455,1,1455,[213 276 321 206 232],201,2,4023,2.7630494505494507,0.0,0.0
5456,1,1456,[221 326 284 202 413],303,3,4026,2.7632120796156485,0.0,0.0
5457,1,1457,[365 378 208 241 223],222,2,4028,2.7626886145404663,20.0,0.0
5458,1,1458,[231 268 202 223 267],1,4,4032,2.7635366689513363,20.0,20.0
5459,1,1459,[202 230 215 212 256],1,4,4036,2.7643835616438355,0.0,0.0
5460,1,1460,[264 452 259 221 384],303,1,4037,2.763175906913073,0.0,0.0
5461,1,1461,[223 298 217 300 431],222,4,4041,2.764021887824897,20.0,40.0
5462,1,1462,[303 276 431 239 384],758,2,4043,2.7634996582365003,0.0,0.0
5463,1,1463,[324 227 209 315 291],276,4,4047,2.764344262295082,20.0,0.0
5464,1,1464,[331 276 326 236 324],181,0,4047,2.762457337883959,0.0,0.0
5465,1,1465,[218 261 267 392 216],130,5,4052,2.7639836289222375,0.0,20.0
5466,1,1466,[268 508 280 230 208],880,3,4055,2.76414451261077,0.0,20.0
5467,1,1467,[413 300 206 215 284],130,2,4057,2.7636239782016347,0.0,20.0
5468,1,1468,[255 201 431 344 239],327,2,4059,2.7631041524846833,0.0,0.0
5469,1,1469,[211 452 212 276 350],758,3,4062,2.763265306122449,0.0,0.0
5470,1,1470,[315 272 508 324 212],201,3,4065,2.7634262406526173,40.0,0.0
5471,1,1471,[384 324 213 303 218],758,5,4070,2.764945652173913,0.0,0.0
5472,1,1472,[215 226 230 202 223],916,1,4071,2.7637474541751526,20.0,0.0
5473,1,1473,[298 222 221 303 246],919,2,4073,2.7632293080054273,0.0,40.0
5474,1,1474,[413 321 206 215 217],435,2,4075,2.76271186440678,0.0,0.0
5475,1,1475,[420 291 378 255 280],682,0,4075,2.760840108401084,0.0,0.0
5476,1,1476,[226 365 230 217 431],94,2,4077,2.760324983073798,0.0,0.0
5477,1,1477,[246 250 367 365 222],682,3,4080,2.760487144790257,0.0,20.0
5478,1,1478,[431 232 227 226 365],472,5,4085,2.762001352265044,0.0,0.0
5479,1,1479,[219 212 223 209 268],201,4,4089,2.762837837837838,20.0,20.0
5480,1,1480,[218 326 230 291 222],303,1,4090,2.761647535449021,0.0,20.0
5481,1,1481,[222 206 218 201 452],276,4,4094,2.7624831309041835,0.0,20.0
5482,1,1482,[239 232 221 583 206],201,0,4094,2.76062036412677,0.0,0.0
5483,1,1483,[240 280 509 219 254],682,1,4095,2.759433962264151,0.0,0.0
5484,1,1484,[217 222 256 218 223],916,2,4097,2.758922558922559,20.0,20.0
5485,1,1485,[222 264 324 240 239],268,2,4099,2.7584118438761775,0.0,20.0
5486,1,1486,[452 413 507 236 241],303,3,4102,2.7585743106926697,0.0,0.0
5487,1,1487,[431 230 226 392 216],222,4,4106,2.7594086021505375,0.0,20.0
5488,1,1488,[280 261 284 208 241],222,0,4106,2.757555406312962,0.0,0.0
5489,1,1489,[227 226 293 222 275],293,1,4107,2.7563758389261745,0.0,20.0
5490,1,1490,[507 206 227 230 429],70,2,4109,2.755868544600939,0.0,0.0
5491,1,1491,[293 211 201 231 301],429,2,4111,2.755361930294906,0.0,0.0
5492,1,1492,[367 280 209 240 202],682,2,4113,2.754855994641661,0.0,0.0
5493,1,1493,[227 276 231 209 299],880,2,4115,2.754350736278447,0.0,0.0
5494,1,1494,[209 392 222 231 275],896,2,4117,2.753846153846154,0.0,20.0
5495,1,1495,[227 213 291 509 303],293,1,4118,2.7526737967914436,0.0,0.0
5496,1,1496,[452 300 222 241 367],222,2,4120,2.7521710086840345,0.0,40.0
5497,1,1497,[276 239 324 420 283],303,2,4122,2.751668891855808,0.0,0.0
5498,1,1498,[420 215 300 275 255],293,2,4124,2.751167444963309,0.0,20.0
5499,1,1499,[324 212 215 240 217],201,2,4126,2.7506666666666666,0.0,0.0
5500,1,1500,[208 300 230 240 231],303,2,4128,2.7501665556295802,0.0,20.0
5501,1,1501,[209 201 223 241 509],682,2,4130,2.7496671105193076,20.0,0.0
5502,1,1502,[211 212 316 217 331],758,4,4134,2.750499001996008,20.0,0.0
5503,1,1503,[246 384 331 222 227],435,3,4137,2.7506648936170213,0.0,20.0
5504,1,1504,[211 208 220 256 231],1,2,4139,2.7501661129568107,0.0,0.0
5505,1,1505,[431 202 429 275 481],896,3,4142,2.750332005312085,0.0,0.0
5506,1,1506,[284 420 230 298 236],130,3,4145,2.7504976775049768,0.0,20.0
5507,1,1507,[227 223 431 232 247],222,3,4148,2.750663129973475,20.0,0.0
5508,1,1508,[241 509 284 206 230],201,0,4148,2.7488402915838304,0.0,0.0
5509,1,1509,[315 316 218 240 261],130,5,4153,2.7503311258278145,40.0,0.0
5510,1,1510,[230 420 226 284 384],246,0,4153,2.7485109199205824,0.0,0.0
5511,1,1511,[211 223 350 301 508],758,4,4157,2.749338624338624,20.0,0.0
5512,1,1512,[276 301 221 208 300],758,1,4158,2.7481824190350297,0.0,20.0
5513,1,1513,[218 226 244 243 219],1,0,4158,2.7463672391017173,0.0,0.0
5514,1,1514,[291 290 212 350 316],758,5,4163,2.747854785478548,20.0,0.0
5515,1,1515,[384 290 272 264 201],276,3,4166,2.7480211081794197,20.0,0.0
5516,1,1516,[315 297 251 298 272],592,5,4171,2.7495056031641396,40.0,20.0
5517,1,1517,[211 226 254 222 231],545,3,4174,2.7496706192358364,0.0,20.0
5518,1,1518,[365 209 298 240 431],276,3,4177,2.749835418038183,0.0,20.0
5519,1,1519,[509 420 275 315 232],293,1,4178,2.748684210526316,20.0,0.0
5520,1,1520,[290 209 293 254 284],682,2,4180,2.7481919789612097,0.0,0.0
5521,1,1521,[230 298 508 284 316],880,4,4184,2.7490144546649145,20.0,20.0
5522,1,1522,[507 268 230 239 219],561,1,4185,2.7478660538411033,0.0,20.0
5523,1,1523,[236 452 413 206 276],130,3,4188,2.748031496062992,0.0,0.0
5524,1,1524,[298 431 268 216 232],916,2,4190,2.7475409836065574,0.0,60.0
5525,1,1525,[226 378 250 367 268],222,1,4191,2.7463958060288336,0.0,20.0
5526,1,1526,[255 293 216 429 223],293,4,4195,2.7472167648984938,20.0,20.0
5527,1,1527,[240 276 431 284 324],201,2,4197,2.7467277486910993,0.0,0.0
5528,1,1528,[350 230 239 316 226],130,4,4201,2.7475474166121647,20.0,0.0
5529,1,1529,[276 298 303 297 336],592,4,4205,2.7483660130718954,0.0,20.0
5530,1,1530,[223 222 209 378 232],429,4,4209,2.7491835401698235,20.0,20.0
5531,1,1531,[223 201 227 321 431],429,2,4211,2.7486945169712795,20.0,0.0
5532,1,1532,[222 295 261 202 236],592,2,4213,2.7482061317677755,0.0,20.0
5533,1,1533,[261 241 367 222 208],222,1,4214,2.747066492829205,0.0,20.0
5534,1,1534,[264 261 222 276 291],592,1,4215,2.745928338762215,0.0,20.0
5535,1,1535,[331 275 221 218 509],201,3,4218,2.74609375,0.0,0.0
5536,1,1536,[202 250 209 211 239],109,3,4221,2.7462589459986986,0.0,0.0
5537,1,1537,[240 206 276 202 239],276,5,4226,2.7477243172951886,0.0,0.0
5538,1,1538,[420 367 227 222 298],497,1,4227,2.746588693957115,0.0,40.0
5539,1,1539,[250 331 284 267 230],532,3,4230,2.7467532467532467,0.0,0.0
5540,1,1540,[230 223 208 236 201],1,4,4234,2.747566515249838,20.0,0.0
5541,1,1541,[350 452 284 300 295],130,3,4237,2.7477302204928664,0.0,20.0
5542,1,1542,[209 367 216 315 298],286,5,4242,2.749189889825016,20.0,40.0
5543,1,1543,[293 331 226 254 227],276,4,4246,2.75,0.0,0.0
5544,1,1544,[392 243 316 230 272],130,3,4249,2.7501618122977347,40.0,0.0
5545,1,1545,[298 431 218 315 316],276,4,4253,2.7509702457956013,40.0,20.0
5546,1,1546,[298 264 268 232 219],276,3,4256,2.751131221719457,0.0,40.0
5547,1,1547,[212 367 431 201 420],896,2,4258,2.750645994832041,0.0,0.0
5548,1,1548,[223 241 420 246 378],399,1,4259,2.749515816655907,20.0,0.0
5549,1,1549,[384 284 211 230 290],435,1,4260,2.7483870967741937,0.0,0.0
5550,1,1550,[291 431 254 420 201],435,3,4263,2.748549323017408,0.0,0.0
5551,1,1551,[365 255 246 367 226],222,2,4265,2.748067010309278,0.0,0.0
5552,1,1552,[508 431 291 392 241],276,2,4267,2.7475853187379267,0.0,0.0
5553,1,1553,[452 390 298 291 259],303,1,4268,2.7464607464607464,0.0,20.0
5554,1,1554,[283 507 301 509 303],608,2,4270,2.7459807073954985,0.0,0.0
5555,1,1555,[208 298 290 315 231],363,2,4272,2.7455012853470437,20.0,20.0
5556,1,1556,[221 250 246 209 290],303,5,4277,2.7469492614001285,0.0,0.0
5557,1,1557,[209 509 223 251 291],293,2,4279,2.746469833119384,20.0,0.0
5558,1,1558,[243 290 315 280 215],393,4,4283,2.747273893521488,20.0,0.0
5559,1,1559,[293 250 283 209 202],429,3,4286,2.7474358974358974,0.0,0.0
5560,1,1560,[291 284 226 300 315],130,4,4290,2.7482383087764255,20.0,20.0
5561,1,1561,[394 240 268 283 246],880,3,4293,2.7483994878361075,0.0,20.0
5562,1,1562,[293 230 298 367 202],880,4,4297,2.7492002559181064,0.0,20.0
5563,1,1563,[268 215 316 226 241],178,5,4302,2.7506393861892584,20.0,20.0
5564,1,1564,[315 209 331 232 365],551,5,4307,2.752076677316294,20.0,0.0
5565,1,1565,[509 583 293 231 239],682,1,4308,2.7509578544061304,0.0,0.0
5566,1,1566,[429 452 217 420 300],276,4,4312,2.7517549457562223,0.0,20.0
5567,1,1567,[259 213 378 202 481],299,2,4314,2.751275510204082,0.0,0.0
5568,1,1568,[284 240 230 202 264],293,0,4314,2.7495219885277247,0.0,0.0
5569,1,1569,[299 298 216 508 268],130,4,4318,2.7503184713375797,0.0,60.0
5570,1,1570,[201 300 298 303 239],276,5,4323,2.751750477402928,0.0,40.0
5571,1,1571,[298 290 431 217 301],276,4,4327,2.7525445292620865,0.0,20.0
5572,1,1572,[392 217 509 478 209],846,4,4331,2.7533375715193897,20.0,0.0
5573,1,1573,[222 255 583 226 507],293,1,4332,2.752223634053367,0.0,20.0
5574,1,1574,[239 255 507 206 251],293,3,4335,2.7523809523809524,0.0,0.0
5575,1,1575,[212 215 291 431 219],896,1,4336,2.751269035532995,0.0,0.0
5576,1,1576,[202 208 276 367 215],864,5,4341,2.7526949904882687,0.0,0.0
5577,1,1577,[452 239 298 384 213],758,3,4344,2.752851711026616,0.0,20.0
5578,1,1578,[268 583 217 276 209],276,4,4348,2.753641545281824,0.0,20.0
5579,1,1579,[509 293 315 218 217],758,3,4351,2.7537974683544304,20.0,0.0
5580,1,1580,[431 217 378 239 201],727,3,4354,2.753953194180898,0.0,0.0
5581,1,1581,[276 216 239 290 452],758,2,4356,2.7534766118836917,0.0,20.0
5582,1,1582,[264 276 298 218 236],303,4,4360,2.754264055590651,0.0,20.0
5583,1,1583,[217 298 365 241 452],276,3,4363,2.754419191919192,0.0,20.0
5584,1,1584,[211 303 218 331 316],758,5,4368,2.7558359621451105,20.0,0.0
5585,1,1585,[201 367 246 293 232],682,3,4371,2.7559899117276165,0.0,0.0
5586,1,1586,[216 246 219 251 226],1,3,4374,2.7561436672967865,0.0,20.0
5587,1,1587,[254 293 316 226 394],880,3,4377,2.7562972292191437,20.0,0.0
5588,1,1588,[208 226 392 215 367],94,3,4380,2.7564505978602893,0.0,0.0
5589,1,1589,[303 331 227 276 254],276,4,4384,2.7572327044025156,0.0,0.0
5590,1,1590,[284 275 583 222 215],293,1,4385,2.7561282212445004,0.0,20.0
5591,1,1591,[276 284 291 216 392],347,1,4386,2.7550251256281406,0.0,20.0
5592,1,1592,[284 301 222 365 240],276,4,4390,2.7558066541117388,0.0,20.0
5593,1,1593,[284 250 384 350 290],363,0,4390,2.754077791718946,0.0,0.0
5594,1,1594,[255 298 222 226 230],130,4,4394,2.754858934169279,0.0,40.0
5595,1,1595,[218 284 221 276 222],916,2,4396,2.754385964912281,0.0,20.0
5596,1,1596,[223 276 202 331 215],551,5,4401,2.7557921102066376,20.0,0.0
5597,1,1597,[268 215 223 219 202],201,3,4404,2.755944931163955,20.0,20.0
5598,1,1598,[251 315 208 264 240],293,1,4405,2.754846779237023,20.0,0.0
5599,1,1599,[201 384 215 236 255],303,4,4409,2.755625,0.0,0.0
5600,1,1600,[246 293 295 223 300],323,3,4412,2.75577763897564,20.0,20.0
5601,1,1601,[202 420 284 201 216],246,1,4413,2.754681647940075,0.0,20.0
5602,1,1602,[246 268 215 429 413],276,4,4417,2.7554585152838427,0.0,20.0
5603,1,1603,[222 241 508 239 284],933,0,4417,2.7537406483790523,0.0,20.0
5604,1,1604,[268 250 420 226 293],276,5,4422,2.755140186915888,0.0,20.0
5605,1,1605,[239 299 222 316 367],880,5,4427,2.75653798256538,20.0,20.0
5606,1,1606,[251 507 202 259 215],303,4,4431,2.7573117610454263,0.0,0.0
5607,1,1607,[202 272 392 230 267],130,4,4435,2.758084577114428,20.0,0.0
5608,1,1608,[413 431 291 264 230],435,1,4436,2.756991920447483,0.0,0.0
5609,1,1609,[218 222 259 230 508],221,3,4439,2.757142857142857,0.0,20.0
5610,1,1610,[226 300 216 431 206],435,2,4441,2.7566728739913096,0.0,40.0
5611,1,1611,[222 392 230 219 239],130,4,4445,2.7574441687344913,0.0,20.0
5612,1,1612,[202 392 583 367 211],429,2,4447,2.7569745815251085,0.0,0.0
5613,1,1613,[243 254 283 208 231],880,1,4448,2.7558859975216854,0.0,0.0
5614,1,1614,[222 208 275 227 240],293,0,4448,2.7541795665634674,0.0,20.0
5615,1,1615,[202 246 431 583 283],790,1,4449,2.7530940594059405,0.0,0.0
5616,1,1616,[216 211 209 583 222],790,2,4451,2.7526283240568956,0.0,40.0
5617,1,1617,[324 452 284 213 275],201,3,4454,2.7527812113720644,0.0,0.0
5618,1,1618,[315 350 202 251 221],592,5,4459,2.754169240271773,20.0,0.0
5619,1,1619,[384 216 208 255 298],435,2,4461,2.7537037037037035,0.0,40.0
5620,1,1620,[239 209 231 218 223],109,3,4464,2.753855644663788,20.0,0.0
5621,1,1621,[298 216 272 240 293],758,3,4467,2.7540073982737363,20.0,40.0
5622,1,1622,[227 206 284 251 300],293,2,4469,2.7535428219346887,0.0,20.0
5623,1,1623,[331 241 240 367 246],276,4,4473,2.7543103448275863,0.0,0.0
5624,1,1624,[247 246 261 378 240],222,1,4474,2.753230769230769,0.0,0.0
5625,1,1625,[275 280 264 227 303],293,1,4475,2.752152521525215,0.0,0.0
5626,1,1626,[251 212 220 250 264],1,3,4478,2.7523048555623846,0.0,0.0
5627,1,1627,[223 209 215 429 231],896,3,4481,2.7524570024570023,20.0,0.0
5628,1,1628,[291 217 300 244 295],21,1,4482,2.751381215469613,0.0,20.0
5629,1,1629,[256 230 202 206 298],916,0,4482,2.7496932515337424,0.0,20.0
5630,1,1630,[508 251 227 215 276],303,4,4486,2.750459840588596,0.0,0.0
5631,1,1631,[431 240 209 478 298],249,5,4491,2.7518382352941178,20.0,20.0
5632,1,1632,[508 250 209 326 367],303,4,4495,2.7526025719534597,0.0,0.0
5633,1,1633,[250 219 284 221 208],303,5,4500,2.7539779681762546,0.0,0.0
5634,1,1634,[290 267 254 202 239],130,3,4503,2.7541284403669724,0.0,0.0
5635,1,1635,[283 290 316 315 251],293,1,4504,2.7530562347188265,40.0,0.0
5636,1,1636,[367 250 272 295 301],532,4,4508,2.7538179596823458,20.0,0.0
5637,1,1637,[275 367 300 217 202],429,2,4510,2.7533577533577533,0.0,20.0
5638,1,1638,[219 507 420 264 384],303,3,4513,2.7535082367297132,0.0,0.0
5639,1,1639,[420 215 240 241 321],303,3,4516,2.7536585365853656,0.0,0.0
5640,1,1640,[208 583 223 508 392],94,3,4519,2.753808653260207,20.0,0.0
5641,1,1641,[241 232 509 284 290],916,2,4521,2.7533495736906213,0.0,0.0
5642,1,1642,[208 215 243 227 220],1,2,4523,2.752891052951917,0.0,0.0
5643,1,1643,[290 384 222 209 218],276,4,4527,2.7536496350364965,0.0,20.0
5644,1,1644,[209 384 241 344 291],758,3,4530,2.7537993920972643,0.0,0.0
5645,1,1645,[216 508 218 276 250],429,3,4533,2.7539489671931956,0.0,20.0
5646,1,1646,[255 250 209 583 300],303,3,4536,2.7540983606557377,0.0,20.0
5647,1,1647,[316 290 255 384 283],393,2,4538,2.753640776699029,20.0,0.0
5648,1,1648,[413 211 303 452 509],201,0,4538,2.7519708914493632,0.0,0.0
5649,1,1649,[508 303 300 326 240],181,0,4538,2.7503030303030305,0.0,20.0
5650,1,1650,[390 298 232 394 212],286,3,4541,2.7504542701393095,0.0,20.0
5651,1,1651,[276 259 291 331 268],592,2,4543,2.75,0.0,20.0
5652,1,1652,[300 272 284 331 241],532,5,4548,2.751361161524501,20.0,20.0
5653,1,1653,[276 300 227 223 255],222,3,4551,2.7515114873035067,20.0,20.0
5654,1,1654,[230 300 231 246 508],222,3,4554,2.7516616314199394,0.0,20.0
5655,1,1655,[276 227 222 208 290],864,4,4558,2.752415458937198,0.0,20.0
5656,1,1656,[331 216 392 326 452],130,4,4562,2.7531683765841883,0.0,20.0
5657,1,1657,[507 583 280 485 202],293,1,4563,2.7521109770808203,0.0,0.0
5658,1,1658,[431 212 240 215 222],622,2,4565,2.7516576250753464,0.0,20.0
5659,1,1659,[232 300 217 478 298],327,2,4567,2.7512048192771084,20.0,40.0
5660,1,1660,[231 365 226 293 209],429,2,4569,2.7507525586995785,0.0,0.0
5661,1,1661,[211 226 284 223 509],293,2,4571,2.750300842358604,20.0,0.0
5662,1,1662,[259 251 291 350 276],592,3,4574,2.750450992182802,0.0,0.0
5663,1,1663,[226 367 295 299 208],880,5,4579,2.7518028846153846,0.0,0.0
5664,1,1664,[230 239 392 201 211],896,3,4582,2.751951951951952,0.0,0.0
5665,1,1665,[275 226 321 201 315],201,2,4584,2.751500600240096,20.0,0.0
5666,1,1666,[215 583 227 280 246],916,2,4586,2.7510497900419915,0.0,0.0
5667,1,1667,[509 300 231 280 223],682,0,4586,2.7494004796163067,20.0,20.0
5668,1,1668,[240 211 303 212 298],758,4,4590,2.750149790293589,0.0,20.0
5669,1,1669,[230 208 232 209 431],727,2,4592,2.749700598802395,0.0,0.0
5670,1,1670,[321 324 315 212 239],201,2,4594,2.749251944943148,20.0,0.0
5671,1,1671,[350 290 298 208 283],363,2,4596,2.748803827751196,0.0,20.0
5672,1,1672,[316 255 268 244 283],500,1,4597,2.747758517632995,20.0,20.0
5673,1,1673,[215 216 206 300 232],896,2,4599,2.747311827956989,0.0,40.0
5674,1,1674,[509 280 236 216 246],916,4,4603,2.7480597014925374,0.0,20.0
5675,1,1675,[223 218 331 226 315],551,5,4608,2.7494033412887826,40.0,0.0
5676,1,1676,[227 276 208 283 239],880,3,4611,2.749552772808587,0.0,0.0
5677,1,1677,[367 246 452 230 315],276,3,4614,2.7497020262216925,20.0,0.0
5678,1,1678,[211 232 365 201 264],429,2,4616,2.7492555092316855,0.0,0.0
5679,1,1679,[232 243 201 246 239],1,2,4618,2.748809523809524,0.0,0.0
5680,1,1680,[217 218 230 220 240],1,1,4619,2.747769185008923,0.0,0.0
5681,1,1681,[280 251 213 202 209],293,1,4620,2.746730083234245,0.0,0.0
5682,1,1682,[367 316 222 365 272],393,3,4623,2.7468805704099823,40.0,20.0
5683,1,1683,[259 293 300 219 280],178,4,4627,2.747624703087886,0.0,20.0
5684,1,1684,[280 259 202 215 284],178,4,4631,2.7483679525222553,0.0,0.0
5685,1,1685,[293 301 223 420 431],758,1,4632,2.7473309608540926,20.0,0.0
5686,1,1686,[219 276 222 508 315],551,5,4637,2.7486662714878483,20.0,20.0
5687,1,1687,[217 202 431 208 315],660,3,4640,2.748815165876777,20.0,0.0
5688,1,1688,[240 290 272 239 378],682,2,4642,2.748371817643576,20.0,0.0
5689,1,1689,[413 268 230 420 201],303,3,4645,2.7485207100591715,0.0,20.0
5690,1,1690,[331 261 243 276 202],130,3,4648,2.748669426374926,0.0,0.0
5691,1,1691,[230 219 241 246 209],303,4,4652,2.7494089834515365,0.0,0.0
5692,1,1692,[298 211 218 201 230],435,3,4655,2.7495569994093327,0.0,20.0
5693,1,1693,[300 251 452 315 227],532,4,4659,2.7502951593860683,20.0,20.0
5694,1,1694,[240 226 452 218 276],442,1,4660,2.7492625368731565,0.0,0.0
5695,1,1695,[202 209 226 583 300],293,0,4660,2.7476415094339623,0.0,20.0
5696,1,1696,[236 272 275 201 244],919,4,4664,2.7483794932233354,20.0,0.0
5697,1,1697,[209 208 276 275 251],299,4,4668,2.7491166077738516,0.0,0.0
5698,1,1698,[267 240 299 315 350],130,4,4672,2.749852854620365,20.0,0.0
5699,1,1699,[223 222 256 583 218],916,2,4674,2.7494117647058824,20.0,20.0
5700,1,1700,[250 217 201 367 202],880,4,4678,2.7501469723691945,0.0,0.0
5701,1,1701,[298 284 276 243 226],130,3,4681,2.7502937720329026,0.0,20.0
5702,1,1702,[293 284 280 227 291],429,2,4683,2.7498532002348797,0.0,0.0
5703,1,1703,[290 250 255 326 291],851,3,4686,2.75,0.0,0.0
5704,1,1704,[226 232 297 316 209],293,1,4687,2.748973607038123,20.0,0.0
5705,1,1705,[413 429 230 240 508],276,4,4691,2.749706916764361,0.0,0.0
5706,1,1706,[298 300 295 254 413],130,2,4693,2.7492677211482133,0.0,40.0
5707,1,1707,[208 240 276 298 226],880,5,4698,2.750585480093677,0.0,20.0
5708,1,1708,[280 298 219 208 431],222,3,4701,2.7507314218841428,0.0,20.0
5709,1,1709,[232 300 275 283 431],178,5,4706,2.752046783625731,0.0,20.0
5710,1,1710,[250 284 420 429 583],276,4,4710,2.7527761542957334,0.0,0.0
5711,1,1711,[231 429 303 209 226],276,4,4714,2.753504672897196,0.0,0.0
5712,1,1712,[219 256 201 232 272],1,1,4715,2.7524810274372444,20.0,0.0
5713,1,1713,[209 231 298 429 272],276,4,4719,2.7532088681446907,20.0,20.0
5714,1,1714,[209 202 344 297 331],758,4,4723,2.7539358600583093,0.0,0.0
5715,1,1715,[208 213 222 206 429],293,2,4725,2.7534965034965033,0.0,20.0
5716,1,1716,[298 201 250 264 202],435,4,4729,2.7542224810716367,0.0,20.0
5717,1,1717,[431 227 254 452 241],276,2,4731,2.7537834691501746,0.0,0.0
5718,1,1718,[241 223 218 215 227],276,5,4736,2.755090168702734,20.0,0.0
5719,1,1719,[218 431 583 250 215],276,3,4739,2.755232558139535,0.0,0.0
5720,1,1720,[250 255 298 208 284],435,3,4742,2.7553747821034285,0.0,20.0
5721,1,1721,[298 250 431 217 219],660,2,4744,2.7549361207897793,0.0,20.0
5722,1,1722,[209 413 232 298 226],222,3,4747,2.7550783517121302,0.0,20.0
5723,1,1723,[240 217 367 227 202],130,3,4750,2.7552204176334105,0.0,0.0
5724,1,1724,[344 301 303 331 255],592,3,4753,2.7553623188405796,0.0,0.0
5725,1,1725,[254 295 231 236 243],130,1,4754,2.754345307068366,0.0,0.0
5726,1,1726,[293 215 241 232 209],94,4,4758,2.755066589461494,0.0,0.0
5727,1,1727,[300 315 219 321 206],130,4,4762,2.755787037037037,20.0,20.0
5728,1,1728,[367 217 241 219 452],222,1,4763,2.7547715442452283,0.0,0.0
5729,1,1729,[367 215 208 255 251],293,2,4765,2.754335260115607,0.0,0.0
5730,1,1730,[321 236 293 231 284],130,3,4768,2.754477180820335,0.0,0.0
5731,1,1731,[218 217 365 216 226],472,5,4773,2.7557736720554273,0.0,20.0
5732,1,1732,[272 290 336 240 215],286,2,4775,2.75533756491633,20.0,0.0
5733,1,1733,[232 392 394 298 272],880,3,4778,2.7554786620530565,20.0,20.0
5734,1,1734,[206 291 324 223 290],276,4,4782,2.7561959654178674,20.0,0.0
5735,1,1735,[222 223 326 211 268],551,5,4787,2.7574884792626726,20.0,40.0
5736,1,1736,[315 290 211 298 291],293,2,4789,2.7570523891767413,20.0,20.0
5737,1,1737,[507 221 321 231 232],303,4,4793,2.757767548906789,0.0,0.0
5738,1,1738,[216 232 250 201 209],303,5,4798,2.759056929269695,0.0,20.0
5739,1,1739,[259 201 230 227 255],1,2,4800,2.7586206896551726,0.0,0.0
5740,1,1740,[209 392 284 254 394],880,1,4801,2.7576105686387136,0.0,0.0
5741,1,1741,[202 250 293 478 215],178,5,4806,2.758897818599311,20.0,0.0
5742,1,1742,[209 303 231 221 276],758,2,4808,2.7584624211130233,0.0,0.0
5743,1,1743,[365 231 219 272 293],276,3,4811,2.7586009174311927,20.0,0.0
5744,1,1744,[254 299 413 367 230],130,1,4812,2.757593123209169,0.0,0.0
5745,1,1745,[431 268 420 276 222],276,4,4816,2.7583046964490263,0.0,40.0
5746,1,1746,[275 508 206 324 230],201,3,4819,2.758443045220378,0.0,0.0
5747,1,1747,[261 241 392 300 223],222,3,4822,2.7585812356979407,20.0,20.0
5748,1,1748,[236 413 221 290 300],303,3,4825,2.7587192681532304,0.0,20.0
5749,1,1749,[268 324 431 583 209],201,2,4827,2.7582857142857145,0.0,20.0
5750,1,1750,[324 206 583 331 217],276,4,4831,2.7589948600799543,0.0,0.0
5751,1,1751,[226 367 268 365 241],276,3,4834,2.759132420091324,0.0,20.0
5752,1,1752,[240 230 291 367 217],276,3,4837,2.7592698231602966,0.0,0.0
5753,1,1753,[259 331 275 284 301],919,3,4840,2.7594070695553023,0.0,0.0
5754,1,1754,[272 280 420 300 250],682,2,4842,2.758974358974359,20.0,20.0
5755,1,1755,[218 222 211 216 241],682,4,4846,2.7596810933940774,0.0,40.0
5756,1,1756,[226 230 211 218 217],327,1,4847,2.7586795674445077,0.0,0.0
5757,1,1757,[250 254 230 232 264],1,2,4849,2.7582480091012513,0.0,0.0
5758,1,1758,[244 254 201 226 243],1,0,4849,2.75667993177942,0.0,0.0
5759,1,1759,[290 413 316 392 239],276,3,4852,2.756818181818182,20.0,0.0
5760,1,1760,[250 232 267 268 246],1,4,4856,2.7575241340147643,0.0,20.0
5761,1,1761,[206 219 217 420 291],130,3,4859,2.757661748013621,0.0,0.0
5762,1,1762,[367 326 384 251 241],303,3,4862,2.757799205899036,0.0,0.0
5763,1,1763,[211 227 215 230 478],846,3,4865,2.757936507936508,20.0,0.0
5764,1,1764,[367 211 243 232 250],682,2,4867,2.7575070821529746,0.0,0.0
5765,1,1765,[218 284 268 216 326],222,4,4871,2.758210645526614,0.0,40.0
5766,1,1766,[583 201 291 250 241],429,1,4872,2.757215619694397,0.0,0.0
5767,1,1767,[247 250 365 209 298],222,3,4875,2.7573529411764706,0.0,20.0
5768,1,1768,[331 413 240 254 223],276,3,4878,2.7574901074053138,20.0,0.0
5769,1,1769,[367 231 240 261 392],222,1,4879,2.756497175141243,0.0,0.0
5770,1,1770,[276 272 583 202 284],551,4,4883,2.7571993224167137,20.0,0.0
5771,1,1771,[201 301 507 223 378],429,2,4885,2.7567720090293455,20.0,0.0
5772,1,1772,[255 215 365 220 324],244,2,4887,2.7563451776649748,0.0,0.0
5773,1,1773,[507 208 284 485 508],429,3,4890,2.756482525366404,0.0,0.0
5774,1,1774,[384 227 206 239 300],435,3,4893,2.7566197183098593,0.0,20.0
5775,1,1775,[284 246 280 283 336],697,3,4896,2.7567567567567566,0.0,0.0
5776,1,1776,[246 300 243 276 255],919,3,4899,2.7568936409679234,0.0,20.0
5777,1,1777,[202 232 222 216 206],521,2,4901,2.7564679415073114,0.0,40.0
5778,1,1778,[202 331 215 276 230],276,5,4906,2.7577290612703766,0.0,0.0
5779,1,1779,[507 283 284 264 241],429,1,4907,2.756741573033708,0.0,0.0
5780,1,1780,[324 221 298 255 243],936,4,4911,2.7574396406513193,0.0,20.0
5781,1,1781,[384 208 250 431 239],727,4,4915,2.7581369248035914,0.0,0.0
5782,1,1782,[247 272 212 218 268],1,2,4917,2.757711721817162,20.0,20.0
5783,1,1783,[583 276 218 324 232],303,3,4920,2.757847533632287,0.0,0.0
5784,1,1784,[299 293 241 365 268],682,4,4924,2.7585434173669467,0.0,20.0
5785,1,1785,[251 420 255 264 241],303,4,4928,2.7592385218365063,0.0,0.0
5786,1,1786,[259 202 227 222 240],727,3,4931,2.7593732512590936,0.0,20.0
5787,1,1787,[215 230 239 336 216],363,1,4932,2.7583892617449663,0.0,20.0
5788,1,1788,[276 227 230 298 208],222,3,4935,2.7585243152599217,0.0,20.0
5789,1,1789,[259 290 384 244 284],268,1,4936,2.7575418994413408,0.0,0.0
5790,1,1790,[384 222 420 507 255],303,3,4939,2.757677275265215,0.0,20.0
5791,1,1791,[216 223 452 222 212],896,3,4942,2.7578125,20.0,40.0
5792,1,1792,[239 367 420 268 284],303,4,4946,2.758505298382599,0.0,20.0
5793,1,1793,[508 217 261 222 367],222,1,4947,2.75752508361204,0.0,20.0
5794,1,1794,[384 268 390 223 324],303,2,4949,2.7571030640668526,20.0,20.0
5795,1,1795,[231 365 208 226 211],429,2,4951,2.7566815144766146,0.0,0.0
5796,1,1796,[246 215 222 508 301],244,3,4954,2.756816917084029,0.0,20.0
5797,1,1797,[232 230 384 227 284],301,4,4958,2.757508342602892,0.0,0.0
5798,1,1798,[326 431 413 378 254],545,2,4960,2.7570872707059477,0.0,0.0
5799,1,1799,[264 227 384 291 222],551,3,4963,2.757222222222222,0.0,20.0
5800,1,1800,[243 283 431 223 392],393,3,4966,2.757357023875625,20.0,0.0
5801,1,1801,[300 303 508 431 509],758,3,4969,2.757491675915649,0.0,20.0
5802,1,1802,[429 367 215 315 239],293,2,4971,2.7570715474209653,20.0,0.0
5803,1,1803,[321 227 246 293 226],303,3,4974,2.7572062084257207,0.0,0.0
5804,1,1804,[298 301 336 283 367],592,3,4977,2.7573407202216065,0.0,20.0
5805,1,1805,[378 209 223 272 259],682,1,4978,2.7563676633444074,40.0,0.0
5806,1,1806,[508 219 384 390 259],303,2,4980,2.7559490868843386,0.0,0.0
5807,1,1807,[367 209 255 509 283],293,0,4980,2.754424778761062,0.0,0.0
5808,1,1808,[378 208 507 259 413],727,2,4982,2.754007739082366,0.0,0.0
5809,1,1809,[344 298 218 222 431],758,3,4985,2.75414364640884,0.0,40.0
5810,1,1810,[247 239 216 209 219],1,3,4988,2.754279403644395,0.0,20.0
5811,1,1811,[236 220 240 324 331],181,1,4989,2.7533112582781456,0.0,0.0
5812,1,1812,[216 209 246 219 244],1,3,4992,2.7534473248758964,0.0,20.0
5813,1,1813,[226 452 222 219 284],303,3,4995,2.753583241455347,0.0,20.0
5814,1,1814,[212 481 509 485 264],299,3,4998,2.7537190082644627,0.0,0.0
5815,1,1815,[367 284 250 508 301],532,4,5002,2.754405286343612,0.0,0.0
5816,1,1816,[367 293 321 246 452],130,5,5007,2.755641166758393,0.0,0.0
5817,1,1817,[215 240 202 264 254],276,3,5010,2.7557755775577557,0.0,0.0
5818,1,1818,[367 276 293 230 300],178,4,5014,2.7564595931830675,0.0,20.0
5819,1,1819,[367 209 283 239 326],303,2,5016,2.756043956043956,0.0,0.0
5820,1,1820,[324 283 201 293 209],303,3,5019,2.756177924217463,0.0,0.0
5821,1,1821,[244 272 250 222 217],1,2,5021,2.75576289791438,20.0,20.0
5822,1,1822,[209 264 231 217 583],276,2,5023,2.755348326933626,0.0,0.0
5823,1,1823,[239 246 508 384 272],276,4,5027,2.756030701754386,20.0,0.0
5824,1,1824,[209 239 283 321 250],303,2,5029,2.7556164383561645,0.0,0.0
5825,1,1825,[215 315 350 227 219],130,4,5033,2.7562979189485213,20.0,0.0
5826,1,1826,[303 583 300 367 429],293,2,5035,2.7558839627805143,0.0,20.0
5827,1,1827,[367 261 331 350 250],592,3,5038,2.7560175054704596,0.0,0.0
5828,1,1828,[211 217 227 212 239],846,4,5042,2.7566976489885184,0.0,0.0
5829,1,1829,[384 324 227 290 240],276,4,5046,2.7573770491803278,0.0,0.0
5830,1,1830,[240 231 431 209 243],682,2,5048,2.756963407973785,0.0,0.0
5831,1,1831,[218 315 284 226 429],293,1,5049,2.756004366812227,20.0,0.0
5832,1,1832,[431 295 283 344 251],592,4,5053,2.756683033278778,0.0,0.0
5833,1,1833,[231 299 222 239 240],682,3,5056,2.756815703380589,0.0,20.0
5834,1,1834,[344 301 201 264 216],592,3,5059,2.756948228882834,0.0,20.0
5835,1,1835,[365 209 227 230 232],551,5,5064,2.758169934640523,0.0,0.0
5836,1,1836,[264 583 275 232 216],429,3,5067,2.75830157866086,0.0,20.0
5837,1,1837,[283 244 284 261 222],919,1,5068,2.7573449401523393,0.0,20.0
5838,1,1838,[283 365 367 508 300],880,2,5070,2.7569331158238173,0.0,20.0
5839,1,1839,[326 298 280 293 232],178,4,5074,2.757608695652174,0.0,20.0
5840,1,1840,[250 212 230 367 222],916,2,5076,2.757197175448126,0.0,20.0
5841,1,1841,[300 283 280 485 218],429,0,5076,2.755700325732899,0.0,20.0
5842,1,1842,[315 298 211 209 202],286,5,5081,2.7569180683667933,20.0,20.0
5843,1,1843,[247 431 255 365 202],222,3,5084,2.75704989154013,0.0,0.0
5844,1,1844,[255 216 240 202 231],1,2,5086,2.756639566395664,0.0,20.0
5845,1,1845,[241 251 221 240 293],303,4,5090,2.7573131094257857,0.0,0.0
5846,1,1846,[431 481 215 241 276],301,3,5093,2.7574445046020575,0.0,0.0
5847,1,1847,[300 239 212 211 201],896,2,5095,2.757034632034632,0.0,20.0
5848,1,1848,[268 300 284 272 226],551,5,5100,2.758247701460249,20.0,40.0
5849,1,1849,[250 208 206 201 268],727,4,5104,2.7589189189189187,0.0,20.0
5850,1,1850,[321 303 507 218 508],608,3,5107,2.7590491626148026,0.0,0.0
5851,1,1851,[394 299 215 226 230],435,3,5110,2.7591792656587475,0.0,0.0
5852,1,1852,[227 208 250 246 211],727,5,5115,2.760388559093362,0.0,0.0
5853,1,1853,[283 226 215 244 298],178,3,5118,2.7605177993527508,0.0,20.0
5854,1,1854,[276 216 583 254 284],682,2,5120,2.7601078167115904,0.0,20.0
5855,1,1855,[240 241 250 255 222],393,4,5124,2.7607758620689653,0.0,20.0
5856,1,1856,[392 280 202 295 239],56,4,5128,2.761443187937534,0.0,0.0
5857,1,1857,[241 218 226 231 240],586,2,5130,2.761033369214209,0.0,0.0
5858,1,1858,[216 250 202 293 255],303,5,5135,2.762237762237762,0.0,20.0
5859,1,1859,[218 219 239 255 420],682,0,5135,2.760752688172043,0.0,0.0
5860,1,1860,[301 254 246 232 226],276,3,5138,2.7608812466415906,0.0,0.0
5861,1,1861,[250 293 222 324 213],758,4,5142,2.761546723952739,0.0,20.0
5862,1,1862,[291 230 202 250 431],497,2,5144,2.7611379495437465,0.0,0.0
5863,1,1863,[316 227 219 232 452],276,3,5147,2.7612660944206007,20.0,0.0
5864,1,1864,[236 384 239 324 227],303,1,5148,2.7603217158176943,0.0,0.0
5865,1,1865,[230 201 452 276 226],276,4,5152,2.7609860664523045,0.0,0.0
5866,1,1866,[226 256 219 213 212],1,2,5154,2.760578468130691,0.0,0.0
5867,1,1867,[413 283 290 390 202],303,2,5156,2.76017130620985,0.0,0.0
5868,1,1868,[217 298 291 230 392],435,3,5159,2.7602996254681647,0.0,20.0
5869,1,1869,[507 239 291 429 206],293,3,5162,2.760427807486631,0.0,0.0
5870,1,1870,[293 431 217 378 222],429,3,5165,2.760555852485302,0.0,20.0
5871,1,1871,[222 291 367 365 239],393,3,5168,2.7606837606837606,0.0,20.0
5872,1,1872,[276 283 268 216 301],592,4,5172,2.761345435130806,0.0,40.0
5873,1,1873,[230 431 206 226 259],487,2,5174,2.76093916755603,0.0,0.0
5874,1,1874,[390 215 241 240 283],303,2,5176,2.7605333333333335,0.0,0.0
5875,1,1875,[219 250 293 280 508],178,4,5180,2.7611940298507465,0.0,0.0
5876,1,1876,[384 231 429 202 392],896,1,5181,2.760255727224294,0.0,0.0
5877,1,1877,[217 316 331 212 384],758,4,5185,2.7609158679446217,20.0,0.0
5878,1,1878,[509 344 300 217 298],758,2,5187,2.760510910058542,0.0,40.0
5879,1,1879,[232 268 508 394 218],880,4,5191,2.7611702127659576,0.0,20.0
5880,1,1880,[208 230 211 222 243],1,3,5194,2.761297182349814,0.0,20.0
5881,1,1881,[384 209 295 222 218],880,3,5197,2.761424017003188,0.0,20.0
5882,1,1882,[208 217 215 485 226],472,4,5201,2.7620817843866172,0.0,0.0
5883,1,1883,[201 208 259 232 226],303,4,5205,2.7627388535031847,0.0,0.0
5884,1,1884,[215 508 261 241 231],222,1,5206,2.7618037135278515,0.0,0.0
5885,1,1885,[222 431 223 293 227],276,4,5210,2.7624602332979853,20.0,20.0
5886,1,1886,[223 221 276 268 244],919,3,5213,2.762586115527292,20.0,20.0
5887,1,1887,[219 241 218 324 326],425,0,5213,2.761122881355932,0.0,0.0
5888,1,1888,[227 485 431 255 283],393,2,5215,2.76071995764955,0.0,0.0
5889,1,1889,[222 367 230 232 209],864,3,5218,2.7608465608465607,0.0,20.0
5890,1,1890,[272 303 298 284 331],919,3,5221,2.7609730301427815,20.0,20.0
5891,1,1891,[246 202 201 324 367],327,4,5225,2.761627906976744,0.0,0.0
5892,1,1892,[222 283 202 250 217],293,0,5225,2.7601690438457473,0.0,20.0
5893,1,1893,[241 367 230 324 298],276,4,5229,2.7608236536430835,0.0,20.0
5894,1,1894,[272 231 293 392 300],487,4,5233,2.7614775725593668,20.0,20.0
5895,1,1895,[226 223 429 215 206],363,2,5235,2.7610759493670884,20.0,0.0
5896,1,1896,[384 202 283 392 215],393,2,5237,2.760674749604639,0.0,0.0
5897,1,1897,[254 217 230 218 246],276,4,5241,2.761327713382508,0.0,0.0
5898,1,1898,[213 218 226 315 275],293,0,5241,2.759873617693523,20.0,0.0
5899,1,1899,[272 290 250 226 431],682,3,5244,2.76,20.0,0.0
5900,1,1900,[227 222 239 268 223],399,0,5244,2.7585481325618098,20.0,40.0
5901,1,1901,[246 219 316 243 413],130,3,5247,2.7586750788643535,20.0,0.0
5902,1,1902,[367 485 267 508 241],532,4,5251,2.7593273778244876,0.0,0.0
5903,1,1903,[226 280 251 272 209],293,2,5253,2.7589285714285716,20.0,0.0
5904,1,1904,[231 202 241 243 507],561,1,5254,2.758005249343832,0.0,0.0
5905,1,1905,[255 250 303 331 367],851,2,5256,2.757607555089192,0.0,0.0
5906,1,1906,[209 508 290 218 236],303,5,5261,2.7587834294703724,0.0,0.0
5907,1,1907,[275 261 217 326 244],919,2,5263,2.758385744234801,0.0,0.0
5908,1,1908,[508 365 231 216 222],429,3,5266,2.7585123101100053,0.0,40.0
5909,1,1909,[481 331 324 272 298],758,5,5271,2.7596858638743456,20.0,20.0
5910,1,1910,[232 219 223 420 583],94,3,5274,2.759811616954474,20.0,0.0
5911,1,1911,[227 232 239 284 209],222,3,5277,2.7599372384937237,0.0,0.0
5912,1,1912,[208 211 223 250 209],758,5,5282,2.7611082070047046,20.0,0.0
5913,1,1913,[299 226 246 211 367],682,3,5285,2.7612330198537096,0.0,0.0
5914,1,1914,[268 232 227 293 230],94,2,5287,2.7608355091383814,0.0,20.0
5915,1,1915,[344 324 261 272 283],592,4,5291,2.761482254697286,20.0,0.0
5916,1,1916,[293 223 478 209 299],567,5,5296,2.7626499739175796,40.0,0.0
5917,1,1917,[384 232 508 202 219],933,0,5296,2.761209593326382,0.0,0.0
5918,1,1918,[217 232 226 298 331],276,4,5300,2.7618551328817094,0.0,20.0
5919,1,1919,[227 331 272 301 240],758,3,5303,2.761979166666667,20.0,0.0
5920,1,1920,[255 201 217 331 276],919,5,5308,2.76314419573139,0.0,0.0
5921,1,1921,[218 217 507 211 293],293,3,5311,2.763267429760666,0.0,0.0
5922,1,1922,[508 280 232 299 392],880,3,5314,2.763390535621425,0.0,0.0
5923,1,1923,[231 201 508 223 303],276,4,5318,2.764033264033264,20.0,0.0
5924,1,1924,[321 209 230 293 208],542,4,5322,2.764675324675325,0.0,0.0
5925,1,1925,[300 246 202 251 276],303,4,5326,2.7653167185877465,0.0,20.0
5926,1,1926,[223 268 244 206 219],1,3,5329,2.765438505448884,20.0,20.0
5927,1,1927,[255 222 367 267 508],130,5,5334,2.766597510373444,0.0,20.0
5928,1,1928,[226 244 291 212 250],291,4,5338,2.767236910316226,0.0,0.0
5929,1,1929,[212 384 509 217 268],773,2,5340,2.766839378238342,0.0,20.0
5930,1,1930,[276 268 259 508 297],919,4,5344,2.767477990678405,0.0,20.0
5931,1,1931,[378 291 209 431 280],682,1,5345,2.7665631469979295,0.0,0.0
5932,1,1932,[216 300 211 420 509],758,3,5348,2.766683911019141,0.0,40.0
5933,1,1933,[240 227 206 392 384],727,2,5350,2.766287487073423,0.0,0.0
5934,1,1934,[300 429 230 241 275],896,4,5354,2.766925064599483,0.0,20.0
5935,1,1935,[217 209 284 219 583],268,2,5356,2.7665289256198347,0.0,0.0
5936,1,1936,[239 365 324 431 240],276,3,5359,2.766649457924626,0.0,0.0
5937,1,1937,[413 222 299 254 201],435,2,5361,2.76625386996904,0.0,20.0
5938,1,1938,[276 264 251 272 216],592,4,5365,2.76689014956163,20.0,20.0
5939,1,1939,[326 208 240 378 222],222,2,5367,2.7664948453608247,0.0,20.0
5940,1,1940,[478 213 230 268 392],846,2,5369,2.7660999484801647,20.0,20.0
5941,1,1941,[413 452 508 367 331],130,3,5372,2.766220391349125,0.0,0.0
5942,1,1942,[250 315 429 241 215],276,5,5377,2.7673700463201234,20.0,0.0
5943,1,1943,[202 431 291 201 212],896,0,5377,2.7659465020576133,0.0,0.0
5944,1,1944,[246 223 324 218 365],276,4,5381,2.7665809768637533,20.0,0.0
5945,1,1945,[211 250 365 275 583],790,4,5385,2.7672147995889005,0.0,0.0
5946,1,1946,[206 226 384 452 250],268,2,5387,2.7668207498715973,0.0,0.0
5947,1,1947,[365 206 227 315 507],393,2,5389,2.7664271047227924,20.0,0.0
5948,1,1948,[365 227 429 219 367],846,3,5392,2.766546947152386,0.0,0.0
5949,1,1949,[297 315 272 259 300],919,4,5396,2.767179487179487,40.0,20.0
5950,1,1950,[218 217 208 244 290],407,3,5399,2.7672988211173757,0.0,0.0
5951,1,1951,[217 241 209 392 284],276,4,5403,2.7679303278688523,0.0,0.0
5952,1,1952,[202 232 392 268 209],846,3,5406,2.7680491551459294,0.0,20.0
5953,1,1953,[240 231 321 216 291],303,2,5408,2.767656090071648,0.0,20.0
5954,1,1954,[295 240 284 218 394],880,4,5412,2.7682864450127878,0.0,0.0
5955,1,1955,[481 275 209 507 201],429,3,5415,2.76840490797546,0.0,0.0
5956,1,1956,[240 226 429 241 284],276,5,5420,2.7695452222789987,0.0,0.0
5957,1,1957,[231 276 230 201 583],276,3,5423,2.769662921348315,0.0,0.0
5958,1,1958,[241 276 365 243 290],682,1,5424,2.768759571209801,0.0,0.0
5959,1,1959,[223 239 478 315 202],305,2,5426,2.7683673469387755,60.0,0.0
5960,1,1960,[384 316 324 291 226],276,3,5429,2.768485466598674,20.0,0.0
5961,1,1961,[431 367 276 293 218],682,2,5431,2.76809378185525,0.0,0.0
5962,1,1962,[420 201 276 232 202],682,2,5433,2.7677024961793175,0.0,0.0
5963,1,1963,[367 251 384 208 259],303,3,5436,2.7678207739307537,0.0,0.0
5964,1,1964,[303 223 241 324 201],276,5,5441,2.7689567430025446,20.0,0.0
5965,1,1965,[213 508 218 231 202],201,3,5444,2.7690742624618516,0.0,0.0
5966,1,1966,[295 254 218 350 326],130,3,5447,2.7691916624300967,0.0,0.0
5967,1,1967,[217 250 331 301 201],276,5,5452,2.7703252032520327,0.0,0.0
5968,1,1968,[283 280 223 290 344],393,2,5454,2.7699339766378874,20.0,0.0
5969,1,1969,[583 206 290 211 215],916,2,5456,2.769543147208122,0.0,0.0
5970,1,1970,[290 227 284 215 232],916,0,5456,2.768138001014713,0.0,0.0
5971,1,1971,[344 250 226 219 232],327,3,5459,2.7682555780933065,0.0,0.0
5972,1,1972,[221 215 413 213 508],201,2,5461,2.767866193613786,0.0,0.0
5973,1,1973,[392 215 367 230 211],896,4,5465,2.7684903748733536,0.0,0.0
5974,1,1974,[255 291 239 452 222],130,5,5470,2.769620253164557,0.0,20.0
5975,1,1975,[222 241 226 280 284],551,4,5474,2.770242914979757,0.0,20.0
5976,1,1976,[298 293 230 283 300],303,2,5476,2.7698533131006577,0.0,40.0
5977,1,1977,[326 300 246 217 261],130,4,5480,2.7704752275025277,0.0,20.0
5978,1,1978,[324 344 301 201 215],592,4,5484,2.771096513390601,0.0,0.0
5979,1,1979,[315 378 240 507 316],393,3,5487,2.771212121212121,40.0,0.0
5980,1,1980,[208 231 246 298 223],268,3,5490,2.7713276123170116,20.0,20.0
5981,1,1981,[219 232 201 208 250],303,5,5495,2.772452068617558,0.0,0.0
5982,1,1982,[215 367 275 255 268],327,4,5499,2.773071104387292,0.0,20.0
5983,1,1983,[219 413 255 331 293],130,3,5502,2.7731854838709675,0.0,0.0
5984,1,1984,[291 365 259 378 243],393,4,5506,2.7738035264483627,0.0,0.0
5985,1,1985,[213 316 275 222 255],293,0,5506,2.772406847935549,20.0,20.0
5986,1,1986,[246 227 215 280 324],347,4,5510,2.7730246602918975,0.0,0.0
5987,1,1987,[241 276 239 367 413],276,3,5513,2.773138832997988,0.0,0.0
5988,1,1988,[264 240 201 331 244],919,2,5515,2.772750125691302,0.0,0.0
5989,1,1989,[268 217 201 276 261],919,3,5518,2.7728643216080404,0.0,20.0
5990,1,1990,[247 216 392 209 232],222,4,5522,2.773480662983425,0.0,20.0
5991,1,1991,[236 297 227 324 223],758,5,5527,2.7745983935742973,20.0,0.0
5992,1,1992,[268 331 254 215 290],276,4,5531,2.775213246362268,0.0,20.0
5993,1,1993,[241 268 226 217 202],916,3,5534,2.7753259779338015,0.0,20.0
5994,1,1994,[507 219 201 298 384],303,4,5538,2.77593984962406,0.0,20.0
5995,1,1995,[209 217 216 316 230],407,5,5543,2.777054108216433,20.0,20.0
5996,1,1996,[413 300 232 583 392],276,1,5544,2.776164246369554,0.0,20.0
5997,1,1997,[222 384 202 240 206],267,4,5548,2.7767767767767766,0.0,20.0
5998,1,1998,[243 250 283 394 202],880,1,5549,2.775887943971986,0.0,0.0
5999,1,1999,[255 293 316 216 246],130,5,5554,2.777,20.0,20.0
6000,1,2000,[283 290 218 255 298],293,1,5555,2.7761119440279862,0.0,20.0
6001,1,2001,[344 507 223 227 384],393,2,5557,2.7757242757242757,20.0,0.0
6002,1,2002,[508 331 431 321 268],201,3,5560,2.775836245631553,0.0,20.0
6003,1,2003,[384 215 283 316 290],363,0,5560,2.7744510978043913,20.0,0.0
6004,1,2004,[243 297 202 268 255],919,2,5562,2.774064837905237,0.0,20.0
6005,1,2005,[202 254 226 219 295],586,3,5565,2.7741774675972084,0.0,0.0
6006,1,2006,[211 241 509 299 291],682,3,5568,2.774289985052317,0.0,0.0
6007,1,2007,[264 206 217 230 420],276,4,5572,2.7749003984063747,0.0,0.0
6008,1,2008,[583 365 293 239 232],682,1,5573,2.7740169238427077,0.0,0.0
6009,1,2009,[239 202 227 298 201],880,4,5577,2.774626865671642,0.0,20.0
6010,1,2010,[321 508 219 221 222],201,2,5579,2.774241670810542,0.0,20.0
6011,1,2011,[208 508 230 223 240],303,3,5582,2.774353876739563,20.0,0.0
6012,1,2012,[507 365 239 232 230],846,1,5583,2.773472429210134,0.0,0.0
6013,1,2013,[284 241 291 378 222],399,1,5584,2.772591857000993,0.0,20.0
6014,1,2014,[241 209 217 284 222],201,0,5584,2.7712158808933003,0.0,20.0
6015,1,2015,[202 227 290 217 231],130,1,5585,2.7703373015873014,0.0,0.0
6016,1,2016,[213 315 264 251 297],293,2,5587,2.7699553792761527,20.0,0.0
6017,1,2017,[300 246 236 226 239],130,5,5592,2.7710604558969276,0.0,20.0
6018,1,2018,[243 276 254 293 202],880,3,5595,2.7711738484398216,0.0,0.0
6019,1,2019,[202 208 384 394 300],435,3,5598,2.771287128712871,0.0,20.0
6020,1,2020,[481 209 216 201 300],429,2,5600,2.7709054923305296,0.0,40.0
6021,1,2021,[236 240 300 299 276],181,0,5600,2.7695351137487636,0.0,20.0
6022,1,2022,[413 216 316 236 331],130,3,5603,2.7696490360850223,20.0,20.0
6023,1,2023,[350 508 326 295 331],592,4,5607,2.7702569169960474,0.0,0.0
6024,1,2024,[299 250 209 231 212],896,0,5607,2.7688888888888887,0.0,0.0
6025,1,2025,[250 452 315 261 321],130,4,5611,2.7694965449160907,20.0,0.0
6026,1,2026,[272 215 206 216 255],293,4,5615,2.7701036013813516,20.0,20.0
6027,1,2027,[219 413 240 298 420],435,3,5618,2.7702169625246547,0.0,20.0
6028,1,2028,[264 508 331 250 236],592,2,5620,2.7698373583045837,0.0,0.0
6029,1,2029,[321 264 367 231 218],429,0,5620,2.768472906403941,0.0,0.0
6030,1,2030,[324 209 215 232 226],327,3,5623,2.7685869030034467,0.0,0.0
6031,1,2031,[420 413 394 298 321],435,3,5626,2.768700787401575,0.0,20.0
6032,1,2032,[217 344 209 255 215],327,3,5629,2.7688145597638956,0.0,0.0
6033,1,2033,[236 213 209 222 303],758,5,5634,2.769911504424779,0.0,20.0
6034,1,2034,[321 452 231 246 290],303,3,5637,2.77002457002457,0.0,0.0
6035,1,2035,[290 350 255 268 218],130,4,5641,2.770628683693517,0.0,20.0
6036,1,2036,[217 283 485 215 367],293,1,5642,2.7697594501718212,0.0,0.0
6037,1,2037,[290 390 223 226 321],303,3,5645,2.7698724239450443,20.0,0.0
6038,1,2038,[240 259 244 209 232],268,2,5647,2.769494850416871,0.0,0.0
6039,1,2039,[232 223 298 215 268],222,5,5652,2.7705882352941176,20.0,40.0
6040,1,2040,[217 291 223 264 290],276,3,5655,2.770700636942675,20.0,0.0
6041,1,2041,[226 259 384 241 218],268,1,5656,2.769833496571988,0.0,0.0
6042,1,2042,[209 230 298 227 303],276,5,5661,2.7709251101321586,0.0,20.0
6043,1,2043,[209 240 275 367 268],727,1,5662,2.7700587084148727,0.0,20.0
6044,1,2044,[216 219 259 215 284],178,4,5666,2.7706601466992664,0.0,20.0
6045,1,2045,[303 211 324 481 301],758,4,5670,2.771260997067449,0.0,0.0
6046,1,2046,[283 583 222 508 280],429,2,5672,2.770884220810943,0.0,20.0
6047,1,2047,[222 293 367 275 250],178,5,5677,2.77197265625,0.0,20.0
6048,1,2048,[209 275 226 290 300],429,2,5679,2.7715959004392388,0.0,20.0
6049,1,2049,[236 218 390 583 223],303,3,5682,2.7717073170731705,20.0,0.0
6050,1,2050,[365 321 216 230 293],429,2,5684,2.7713310580204777,0.0,20.0
6051,1,2051,[218 392 226 227 365],846,3,5687,2.771442495126706,0.0,0.0
6052,1,2052,[222 220 264 250 230],1,3,5690,2.771553823672674,0.0,20.0
6053,1,2053,[272 212 201 276 222],201,3,5693,2.7716650438169426,20.0,20.0
6054,1,2054,[300 431 384 276 241],758,1,5694,2.770802919708029,0.0,20.0
6055,1,2055,[240 222 300 283 394],880,2,5696,2.7704280155642023,0.0,40.0
6056,1,2056,[255 208 219 226 261],222,1,5697,2.7695673310646574,0.0,0.0
6057,1,2057,[275 227 509 272 202],201,2,5699,2.7691933916423714,20.0,0.0
6058,1,2058,[394 230 300 365 240],880,1,5700,2.768334142787761,0.0,20.0
6059,1,2059,[293 251 350 295 255],592,5,5705,2.7694174757281553,0.0,0.0
6060,1,2060,[218 321 232 303 217],201,1,5706,2.7685589519650655,0.0,0.0
6061,1,2061,[298 211 241 239 216],916,3,5709,2.768671193016489,0.0,40.0
6062,1,2062,[268 217 223 392 227],276,4,5713,2.769268056228793,20.0,20.0
6063,1,2063,[367 206 293 226 250],267,4,5717,2.7698643410852712,0.0,0.0
6064,1,2064,[284 239 324 231 268],268,3,5720,2.7699757869249395,0.0,20.0
6065,1,2065,[222 267 254 211 272],1,2,5722,2.769603097773475,20.0,20.0
6066,1,2066,[232 208 231 259 431],790,2,5724,2.769230769230769,0.0,0.0
6067,1,2067,[218 239 206 222 230],293,1,5725,2.768375241779497,0.0,20.0
6068,1,2068,[219 222 290 367 272],276,4,5729,2.7689705171580474,20.0,20.0
6069,1,2069,[215 315 316 226 223],293,2,5731,2.7685990338164252,60.0,0.0
6070,1,2070,[301 221 452 241 240],758,0,5731,2.767262192177692,0.0,0.0
6071,1,2071,[240 219 211 215 232],246,2,5733,2.766891891891892,0.0,0.0
6072,1,2072,[508 208 431 392 280],222,2,5735,2.766521948866377,0.0,0.0
6073,1,2073,[392 208 231 365 485],846,2,5737,2.766152362584378,0.0,0.0
6074,1,2074,[231 218 264 293 583],429,1,5738,2.765301204819277,0.0,0.0
6075,1,2075,[230 268 384 208 276],880,3,5741,2.765414258188825,0.0,20.0
6076,1,2076,[216 250 280 230 268],178,5,5746,2.7664901299951854,0.0,40.0
6077,1,2077,[272 392 201 367 315],880,4,5750,2.7670837343599617,40.0,0.0
6078,1,2078,[251 300 301 227 508],532,5,5755,2.768157768157768,0.0,20.0
6079,1,2079,[276 367 240 300 508],130,5,5760,2.769230769230769,0.0,20.0
6080,1,2080,[222 211 231 392 264],429,2,5762,2.7688611244593946,0.0,20.0
6081,1,2081,[201 259 264 246 420],303,3,5765,2.7689721421709894,0.0,0.0
6082,1,2082,[208 230 240 227 284],16,4,5769,2.769563130100816,0.0,0.0
6083,1,2083,[209 583 222 213 316],293,0,5769,2.7682341650671787,20.0,20.0
6084,1,2084,[208 250 239 299 431],435,4,5773,2.7688249400479616,0.0,0.0
6085,1,2085,[213 216 219 232 212],201,4,5777,2.7694151486097796,0.0,20.0
6086,1,2086,[240 231 223 293 284],276,4,5781,2.7700047915668424,20.0,0.0
6087,1,2087,[227 301 280 232 226],487,3,5784,2.7701149425287355,0.0,0.0
6088,1,2088,[209 216 268 315 275],201,3,5787,2.7702249880325516,20.0,40.0
6089,1,2089,[246 384 223 254 367],276,2,5789,2.7698564593301436,20.0,0.0
6090,1,2090,[365 230 431 485 217],472,4,5793,2.770444763271162,0.0,0.0
6091,1,2091,[583 367 280 301 209],429,1,5794,2.7695984703632885,0.0,0.0
6092,1,2092,[223 251 268 240 367],303,4,5798,2.770186335403727,20.0,20.0
6093,1,2093,[236 331 350 284 316],130,3,5801,2.7702960840496655,20.0,0.0
6094,1,2094,[301 298 365 284 232],276,3,5804,2.770405727923628,0.0,20.0
6095,1,2095,[223 268 583 259 324],303,2,5806,2.770038167938931,20.0,20.0
6096,1,2096,[232 243 365 226 202],880,3,5809,2.7701478302336673,0.0,0.0
6097,1,2097,[268 293 223 324 508],276,5,5814,2.771210676835081,20.0,20.0
6098,1,2098,[331 240 276 241 213],758,2,5816,2.7708432586946166,0.0,0.0
6099,1,2099,[206 280 316 290 239],293,1,5817,2.77,20.0,0.0
6100,1,2100,[298 321 293 367 583],327,1,5818,2.769157544026654,0.0,20.0
6101,1,2101,[508 239 413 209 232],303,3,5821,2.769267364414843,0.0,0.0
6102,1,2102,[276 283 291 326 246],303,2,5823,2.768901569186876,0.0,0.0
6103,1,2103,[250 211 431 255 201],682,4,5827,2.7694866920152093,0.0,0.0
6104,1,2104,[206 217 215 290 209],276,5,5832,2.770546318289786,0.0,0.0
6105,1,2105,[485 202 431 478 230],846,4,5836,2.7711301044634378,20.0,0.0
6106,1,2106,[216 344 508 301 250],592,4,5840,2.7717133364973896,0.0,20.0
6107,1,2107,[250 226 227 231 384],268,4,5844,2.772296015180266,0.0,0.0
6108,1,2108,[321 284 255 244 331],919,2,5846,2.7719298245614037,0.0,0.0
6109,1,2109,[216 298 300 240 275],249,5,5851,2.7729857819905215,0.0,60.0
6110,1,2110,[268 208 202 227 384],880,3,5854,2.7730933207010895,0.0,20.0
6111,1,2111,[240 209 508 431 392],276,3,5857,2.773200757575758,0.0,0.0
6112,1,2112,[211 297 315 227 218],758,5,5862,2.774254614292475,20.0,0.0
6113,1,2113,[299 291 230 216 222],130,3,5865,2.774361400189215,0.0,40.0
6114,1,2114,[392 239 215 217 316],130,4,5869,2.774940898345154,20.0,0.0
6115,1,2115,[246 268 222 431 217],790,3,5872,2.775047258979206,0.0,40.0
6116,1,2116,[216 222 261 508 321],130,5,5877,2.776098252243741,0.0,40.0
6117,1,2117,[226 218 230 215 240],222,3,5880,2.776203966005666,0.0,0.0
6118,1,2118,[509 211 244 216 367],916,4,5884,2.776781500707881,0.0,20.0
6119,1,2119,[254 209 300 384 255],682,0,5884,2.7754716981132077,0.0,20.0
6120,1,2120,[293 223 275 316 508],178,4,5888,2.776049033474776,40.0,0.0
6121,1,2121,[215 236 293 206 209],606,4,5892,2.776625824693685,0.0,0.0
6122,1,2122,[378 209 201 268 216],682,3,5895,2.7767310409797457,0.0,40.0
6123,1,2123,[240 481 202 293 324],758,3,5898,2.7768361581920904,0.0,0.0
6124,1,2124,[230 284 211 246 367],790,5,5903,2.7778823529411767,0.0,0.0
6125,1,2125,[239 209 298 255 303],293,2,5905,2.777516462841016,0.0,20.0
6126,1,2126,[222 227 367 250 259],790,2,5907,2.777150916784203,0.0,20.0
6127,1,2127,[452 508 384 215 236],303,3,5910,2.7772556390977443,0.0,0.0
6128,1,2128,[222 241 298 208 280],222,2,5912,2.776890558947863,0.0,40.0
6129,1,2129,[244 243 217 293 315],919,2,5914,2.7765258215962443,20.0,0.0
6130,1,2130,[208 231 420 384 394],497,0,5914,2.775222900046926,0.0,0.0
6131,1,2131,[276 216 264 227 255],303,3,5917,2.775328330206379,0.0,20.0
6132,1,2132,[283 301 232 316 256],363,0,5917,2.774027191748711,20.0,0.0
6133,1,2133,[583 384 222 217 231],682,2,5919,2.773664479850047,0.0,20.0
6134,1,2134,[293 240 255 507 259],303,3,5922,2.773770491803279,0.0,0.0
6135,1,2135,[222 284 227 216 303],293,2,5924,2.7734082397003745,0.0,40.0
6136,1,2136,[276 326 272 219 206],201,2,5926,2.7730463266261114,20.0,0.0
6137,1,2137,[290 298 300 217 507],429,2,5928,2.772684752104771,0.0,40.0
6138,1,2138,[239 250 241 218 420],758,2,5930,2.7723235156615242,0.0,0.0
6139,1,2139,[478 219 431 232 316],178,5,5935,2.7733644859813085,40.0,0.0
6140,1,2140,[232 243 256 251 268],1,3,5938,2.773470340962167,0.0,20.0
6141,1,2141,[509 241 254 209 276],682,1,5939,2.772642390289449,0.0,0.0
6142,1,2142,[301 264 431 230 215],276,3,5942,2.772748483434438,0.0,0.0
6143,1,2143,[429 212 219 215 211],896,3,5945,2.7728544776119404,0.0,0.0
6144,1,2144,[250 394 431 378 272],393,4,5949,2.7734265734265735,20.0,0.0
6145,1,2145,[268 298 226 215 344],327,3,5952,2.7735321528424977,0.0,40.0
6146,1,2146,[239 452 232 240 264],303,1,5953,2.7727061015370285,0.0,0.0
6147,1,2147,[315 508 431 384 209],870,1,5954,2.771880819366853,20.0,0.0
6148,1,2148,[202 227 240 429 201],301,4,5958,2.772452303396929,0.0,0.0
6149,1,2149,[367 209 215 378 232],222,3,5961,2.7725581395348837,0.0,0.0
6150,1,2150,[326 226 219 272 452],130,5,5966,2.7735936773593677,20.0,0.0
6151,1,2151,[384 223 259 367 291],682,0,5966,2.7723048327137545,20.0,0.0
6152,1,2152,[367 299 240 261 316],130,4,5970,2.772875058058523,20.0,0.0
6153,1,2153,[429 384 240 232 367],301,5,5975,2.7739090064995358,0.0,0.0
6154,1,2154,[452 298 316 222 202],276,4,5979,2.774477958236659,20.0,40.0
6155,1,2155,[239 222 291 250 254],682,2,5981,2.7741187384044528,0.0,20.0
6156,1,2156,[231 223 230 217 324],276,4,5985,2.7746870653685676,20.0,0.0
6157,1,2157,[344 283 251 261 201],592,4,5989,2.7752548656163114,0.0,0.0
6158,1,2158,[217 212 301 336 298],286,3,5992,2.7753589624826307,0.0,20.0
6159,1,2159,[216 215 217 226 206],293,3,5995,2.775462962962963,0.0,20.0
6160,1,2160,[223 324 250 452 206],276,4,5999,2.776029615918556,20.0,0.0
6161,1,2161,[230 299 209 392 211],896,2,6001,2.7756706753006477,0.0,0.0
6162,1,2162,[251 232 485 275 291],293,1,6002,2.774849745723532,0.0,0.0
6163,1,2163,[218 394 254 283 316],880,2,6004,2.77449168207024,20.0,0.0
6164,1,2164,[241 218 201 264 230],303,3,6007,2.77459584295612,0.0,0.0
6165,1,2165,[508 218 212 221 315],201,3,6010,2.7746999076638965,20.0,0.0
6166,1,2166,[365 226 231 508 321],429,1,6011,2.7738809413936316,0.0,0.0
6167,1,2167,[293 208 431 212 223],363,3,6014,2.7739852398523985,20.0,0.0
6168,1,2168,[378 268 240 202 250],222,2,6016,2.7736284001844167,0.0,20.0
6169,1,2169,[241 215 240 452 268],222,2,6018,2.7732718894009216,0.0,20.0
6170,1,2170,[367 378 431 241 509],846,5,6023,2.7742975587286964,0.0,0.0
6171,1,2171,[367 293 202 284 236],130,4,6027,2.7748618784530388,0.0,0.0
6172,1,2172,[264 507 209 384 241],303,3,6030,2.7749654855039116,0.0,0.0
6173,1,2173,[392 367 485 202 215],747,3,6033,2.7750689972401106,0.0,0.0
6174,1,2174,[272 583 284 254 392],276,2,6035,2.774712643678161,20.0,0.0
6175,1,2175,[232 300 246 413 268],276,3,6038,2.7748161764705883,0.0,40.0
6176,1,2176,[232 209 293 507 290],429,4,6042,2.775378961874139,0.0,0.0
6177,1,2177,[264 211 236 241 223],1,3,6045,2.775482093663912,20.0,0.0
6178,1,2178,[290 240 223 226 215],347,4,6049,2.776044056906838,20.0,0.0
6179,1,2179,[202 508 231 254 295],880,3,6052,2.776146788990826,0.0,0.0
6180,1,2180,[231 392 452 217 431],896,0,6052,2.774873911049977,0.0,0.0
6181,1,2181,[212 208 276 236 213],758,4,6056,2.775435380384968,0.0,0.0
6182,1,2182,[316 213 300 202 315],758,4,6060,2.775996335318369,40.0,20.0
6183,1,2183,[268 215 208 232 291],521,1,6061,2.77518315018315,0.0,20.0
6184,1,2184,[431 293 241 227 300],222,2,6063,2.774828375286041,0.0,20.0
6185,1,2185,[222 509 583 255 485],293,0,6063,2.77355901189387,0.0,20.0
6186,1,2186,[208 291 284 226 264],435,3,6066,2.7736625514403292,0.0,0.0
6187,1,2187,[232 431 217 452 215],709,3,6069,2.773765996343693,0.0,0.0
6188,1,2188,[254 509 239 431 367],682,1,6070,2.772955687528552,0.0,0.0
6189,1,2189,[390 298 290 326 508],303,3,6073,2.773059360730594,0.0,20.0
6190,1,2190,[384 583 208 244 209],870,2,6075,2.7727065267001367,0.0,0.0
6191,1,2191,[384 227 583 218 217],268,2,6077,2.77235401459854,0.0,0.0
6192,1,2192,[283 209 478 218 222],249,4,6081,2.7729138166894667,20.0,20.0
6193,1,2193,[365 217 232 201 300],276,3,6084,2.773017319963537,0.0,20.0
6194,1,2194,[276 246 226 201 255],682,2,6086,2.772665148063781,0.0,0.0
6195,1,2195,[241 226 240 298 268],268,2,6088,2.772313296903461,0.0,40.0
6196,1,2196,[264 213 219 222 202],1,2,6090,2.771961766044606,0.0,20.0
6197,1,2197,[206 239 350 316 331],130,3,6093,2.7720655141037307,20.0,0.0
6198,1,2198,[431 298 295 251 350],592,4,6097,2.77262391996362,0.0,20.0
6199,1,2199,[226 583 284 218 413],303,3,6100,2.772727272727273,0.0,0.0
6200,1,2200,[299 202 420 255 254],435,3,6103,2.772830531576556,0.0,0.0
6201,1,2201,[211 230 231 216 280],429,2,6105,2.7724795640326976,0.0,20.0
6202,1,2202,[255 246 413 250 390],303,3,6108,2.772582841579664,0.0,0.0
6203,1,2203,[217 240 226 222 394],880,4,6112,2.7731397459165152,0.0,20.0
6204,1,2204,[365 219 215 378 246],222,4,6116,2.7736961451247164,0.0,0.0
6205,1,2205,[431 209 300 284 206],896,1,6117,2.7728921124206707,0.0,20.0
6206,1,2206,[202 243 291 301 293],592,2,6119,2.7725419120978705,0.0,0.0
6207,1,2207,[216 452 284 321 227],201,2,6121,2.7721920289855073,0.0,20.0
6208,1,2208,[508 219 267 276 298],130,5,6126,2.7732005432322318,0.0,20.0
6209,1,2209,[315 316 429 272 201],660,4,6130,2.773755656108597,60.0,0.0
6210,1,2210,[209 226 478 583 211],327,2,6132,2.773405698778833,20.0,0.0
6211,1,2211,[485 250 230 232 208],472,4,6136,2.7739602169981916,0.0,0.0
6212,1,2212,[367 232 209 507 264],429,3,6139,2.7740623587889743,0.0,0.0
6213,1,2213,[202 230 216 283 275],178,5,6144,2.7750677506775068,0.0,20.0
6214,1,2214,[202 420 201 268 293],276,5,6149,2.77607223476298,0.0,20.0
6215,1,2215,[384 291 290 293 452],758,3,6152,2.776173285198556,0.0,0.0
6216,1,2216,[272 301 295 215 297],592,4,6156,2.776725304465494,20.0,0.0
6217,1,2217,[297 290 208 202 284],293,1,6157,2.7759242560865647,0.0,0.0
6218,1,2218,[215 201 301 508 365],276,4,6161,2.7764758900405586,0.0,0.0
6219,1,2219,[241 215 232 208 452],846,3,6164,2.7765765765765766,0.0,0.0
6220,1,2220,[232 209 218 213 276],201,3,6167,2.7766771724448445,0.0,0.0
6221,1,2221,[272 413 268 223 230],201,2,6169,2.776327632763276,40.0,20.0
6222,1,2222,[290 264 230 367 236],303,3,6172,2.7764282501124606,0.0,0.0
6223,1,2223,[202 241 244 280 216],916,3,6175,2.776528776978417,0.0,20.0
6224,1,2224,[226 219 268 240 290],268,2,6177,2.776179775280899,0.0,20.0
6225,1,2225,[378 384 232 284 226],727,0,6177,2.774932614555256,0.0,0.0
6226,1,2226,[508 291 240 429 218],276,4,6181,2.775482712168837,0.0,0.0
6227,1,2227,[384 508 239 206 230],896,2,6183,2.775134649910233,0.0,0.0
6228,1,2228,[413 293 290 236 206],130,2,6185,2.774786899955137,0.0,0.0
6229,1,2229,[336 216 293 367 300],327,1,6186,2.7739910313901346,0.0,40.0
6230,1,2230,[246 222 293 268 508],470,2,6188,2.7736441057821604,0.0,40.0
6231,1,2231,[208 272 232 413 215],286,3,6191,2.7737455197132617,20.0,0.0
6232,1,2232,[217 367 284 293 239],222,1,6192,2.77295118674429,0.0,0.0
6233,1,2233,[240 290 236 227 250],130,2,6194,2.772605192479857,0.0,0.0
6234,1,2234,[250 303 315 284 226],293,1,6195,2.771812080536913,20.0,0.0
6235,1,2235,[321 291 290 272 250],130,3,6198,2.7719141323792487,20.0,0.0
6236,1,2236,[303 232 201 291 384],276,2,6200,2.7715690657130083,0.0,0.0
6237,1,2237,[240 218 261 247 206],1,1,6201,2.7707774798927614,0.0,0.0
6238,1,2238,[508 284 222 247 300],222,2,6203,2.770433229120143,0.0,40.0
6239,1,2239,[215 316 298 290 232],286,3,6206,2.7705357142857143,20.0,20.0
6240,1,2240,[227 392 201 452 367],276,2,6208,2.7701918786256137,0.0,0.0
6241,1,2241,[241 300 384 251 276],303,3,6211,2.770294380017841,0.0,20.0
6242,1,2242,[293 268 276 223 250],303,5,6216,2.771288452964779,20.0,20.0
6243,1,2243,[236 218 283 240 301],919,3,6219,2.771390374331551,0.0,0.0
6244,1,2244,[202 230 261 254 256],1,3,6222,2.7714922048997774,0.0,0.0
6245,1,2245,[508 331 452 239 218],130,4,6226,2.772039180765806,0.0,0.0
6246,1,2246,[259 246 293 216 223],303,4,6230,2.7725856697819315,20.0,20.0
6247,1,2247,[508 208 222 300 378],299,3,6233,2.7726868327402134,0.0,40.0
6248,1,2248,[268 221 230 241 583],201,1,6234,2.7718986216096044,0.0,20.0
6249,1,2249,[217 268 232 212 211],916,4,6238,2.7724444444444445,0.0,20.0
6250,1,2250,[291 226 215 243 321],130,4,6242,2.7729897823189695,0.0,0.0
6251,1,2251,[390 264 298 507 231],303,3,6245,2.7730905861456483,0.0,20.0
6252,1,2252,[239 264 452 246 331],276,3,6248,2.773191300488238,0.0,0.0
6253,1,2253,[264 216 392 284 230],429,1,6249,2.772404614019521,0.0,20.0
6254,1,2254,[384 241 206 420 227],276,4,6253,2.772949002217295,0.0,0.0
6255,1,2255,[268 298 321 239 246],435,4,6257,2.7734929078014185,0.0,40.0
6256,1,2256,[331 236 239 301 213],758,3,6260,2.7735932653965443,0.0,0.0
6257,1,2257,[244 202 367 431 250],916,2,6262,2.7732506643046944,0.0,0.0
6258,1,2258,[226 478 219 231 507],495,4,6266,2.7737937140327578,20.0,0.0
6259,1,2259,[485 420 202 206 222],293,2,6268,2.7734513274336283,0.0,20.0
6260,1,2260,[384 272 206 507 222],393,2,6270,2.773109243697479,20.0,20.0
6261,1,2261,[223 230 413 301 217],276,4,6274,2.773651635720601,20.0,0.0
6262,1,2262,[509 206 219 367 223],94,5,6279,2.7746354396818385,20.0,0.0
6263,1,2263,[255 367 268 420 321],435,2,6281,2.7742932862190814,0.0,20.0
6264,1,2264,[222 290 217 230 201],429,1,6282,2.7735099337748346,0.0,20.0
6265,1,2265,[201 264 255 223 247],1,1,6283,2.772727272727273,20.0,0.0
6266,1,2266,[231 413 232 202 246],303,4,6287,2.773268636965152,0.0,0.0
6267,1,2267,[231 230 241 254 324],276,3,6290,2.77336860670194,0.0,0.0
6268,1,2268,[275 211 213 272 222],293,2,6292,2.773027765535478,20.0,20.0
6269,1,2269,[240 290 420 452 255],303,3,6295,2.7731277533039647,0.0,0.0
6270,1,2270,[239 241 300 223 230],758,2,6297,2.772787318361955,20.0,20.0
6271,1,2271,[481 324 303 240 236],758,4,6301,2.7733274647887325,0.0,0.0
6272,1,2272,[230 275 367 226 215],864,3,6304,2.7734271887373514,0.0,0.0
6273,1,2273,[429 268 291 227 231],276,3,6307,2.7735268249780125,0.0,20.0
6274,1,2274,[429 284 264 290 272],276,4,6311,2.774065934065934,20.0,0.0
6275,1,2275,[241 272 509 303 452],758,3,6314,2.774165202108963,20.0,0.0
6276,1,2276,[272 303 261 216 344],592,4,6318,2.774703557312253,20.0,20.0
6277,1,2277,[212 301 227 344 298],758,3,6321,2.7748024582967514,0.0,20.0
6278,1,2278,[583 226 222 232 230],201,0,6321,2.7735849056603774,0.0,20.0
6279,1,2279,[300 227 222 293 452],303,1,6322,2.7728070175438595,0.0,40.0
6280,1,2280,[264 268 384 219 583],268,2,6324,2.772468215694871,0.0,20.0
6281,1,2281,[583 215 321 241 219],201,1,6325,2.771691498685364,0.0,0.0
6282,1,2282,[218 216 394 208 246],435,3,6328,2.7717915024091107,0.0,20.0
6283,1,2283,[240 232 218 303 223],293,2,6330,2.7714535901926447,20.0,0.0
6284,1,2284,[239 293 331 429 452],276,4,6334,2.7719912472647703,0.0,0.0
6285,1,2285,[218 227 241 367 293],276,4,6338,2.772528433945757,0.0,0.0
6286,1,2286,[298 431 218 221 481],758,3,6341,2.7726278968080456,0.0,20.0
6287,1,2287,[227 201 413 291 316],276,3,6344,2.772727272727273,20.0,0.0
6288,1,2288,[219 507 227 230 217],495,5,6349,2.7737003058103977,0.0,0.0
6289,1,2289,[413 227 250 219 384],276,3,6352,2.7737991266375546,0.0,0.0
6290,1,2290,[256 201 215 212 227],363,1,6353,2.7730248799650807,0.0,0.0
6291,1,2291,[231 206 300 316 219],130,3,6356,2.7731239092495636,20.0,20.0
6292,1,2292,[295 230 212 219 213],916,2,6358,2.7727867422590493,0.0,0.0
6293,1,2293,[250 217 222 367 206],916,2,6360,2.772449869224063,0.0,20.0
6294,1,2294,[215 222 217 218 324],276,5,6365,2.7734204793028323,0.0,20.0
6295,1,2295,[222 298 276 367 216],682,3,6368,2.773519163763066,0.0,60.0
6296,1,2296,[250 291 215 243 202],682,3,6371,2.77361776229865,0.0,0.0
6297,1,2297,[250 431 481 324 300],758,3,6374,2.773716275021758,0.0,20.0
6298,1,2298,[206 272 378 239 367],393,3,6377,2.7738147020443673,20.0,0.0
6299,1,2299,[452 298 299 240 321],21,3,6380,2.773913043478261,0.0,20.0
6300,1,2300,[300 239 209 378 251],299,2,6382,2.7735767057800955,0.0,20.0
6301,1,2301,[201 218 324 331 250],276,5,6387,2.774543874891399,0.0,0.0
6302,1,2302,[222 431 508 239 392],896,2,6389,2.7742075553625707,0.0,20.0
6303,1,2303,[240 215 201 413 264],303,2,6391,2.7738715277777777,0.0,0.0
6304,1,2304,[300 219 331 216 268],178,5,6396,2.774837310195228,0.0,60.0
6305,1,2305,[232 378 290 226 298],682,1,6397,2.7740676496097136,0.0,20.0
6306,1,2306,[232 299 280 284 293],880,4,6401,2.774599046380581,0.0,0.0
6307,1,2307,[268 298 250 452 508],497,1,6402,2.7738301559792027,0.0,40.0
6308,1,2308,[226 201 392 300 378],429,0,6402,2.772628843655262,0.0,20.0
6309,1,2309,[209 216 255 300 485],293,1,6403,2.771861471861472,0.0,40.0
6310,1,2310,[232 413 215 227 507],303,3,6406,2.7719601903937687,0.0,0.0
6311,1,2311,[390 324 290 259 221],303,2,6408,2.7716262975778547,0.0,0.0
6312,1,2312,[291 431 230 283 583],429,2,6410,2.7712926934716817,0.0,0.0
6313,1,2313,[215 331 226 250 420],435,4,6414,2.7718236819360413,0.0,0.0
6314,1,2314,[295 231 254 316 201],880,3,6417,2.7719222462203024,20.0,0.0
6315,1,2315,[232 583 222 508 420],303,3,6420,2.772020725388601,0.0,20.0
6316,1,2316,[316 208 276 452 272],758,3,6423,2.7721191195511437,40.0,0.0
6317,1,2317,[508 217 223 227 284],896,3,6426,2.7722174288179464,20.0,0.0
6318,1,2318,[583 264 384 268 413],303,1,6427,2.7714532125916342,0.0,20.0
6319,1,2319,[297 255 216 300 202],299,3,6430,2.771551724137931,0.0,40.0
6320,1,2320,[431 300 264 326 241],551,4,6434,2.7720809995691513,0.0,20.0
6321,1,2321,[236 392 254 250 299],130,2,6436,2.771748492678725,0.0,0.0
6322,1,2322,[250 239 236 300 215],130,4,6440,2.772277227722772,0.0,20.0
6323,1,2323,[246 295 244 250 298],919,0,6440,2.7710843373493974,0.0,20.0
6324,1,2324,[240 239 241 431 367],561,0,6440,2.7698924731182797,0.0,0.0
6325,1,2325,[280 222 221 241 212],916,3,6443,2.7699914015477214,0.0,20.0
6326,1,2326,[259 219 315 254 250],660,3,6446,2.77009024495058,20.0,0.0
6327,1,2327,[290 384 316 227 206],363,1,6447,2.7693298969072164,20.0,0.0
6328,1,2328,[223 431 344 331 202],592,3,6450,2.7694289394589955,20.0,0.0
6329,1,2329,[241 222 227 232 223],896,4,6454,2.7699570815450643,20.0,20.0
6330,1,2330,[236 284 223 202 298],303,5,6459,2.770913770913771,20.0,20.0
6331,1,2331,[507 231 384 250 284],303,4,6463,2.771440823327616,0.0,0.0
6332,1,2332,[255 452 246 250 231],303,4,6467,2.7719674239177023,0.0,0.0
6333,1,2333,[239 420 216 284 202],896,4,6471,2.7724935732647813,0.0,20.0
6334,1,2334,[284 324 321 275 215],201,2,6473,2.7721627408993577,0.0,0.0
6335,1,2335,[272 217 218 239 316],880,5,6478,2.773116438356164,40.0,0.0
6336,1,2336,[215 201 507 367 239],303,4,6482,2.7736414206247324,0.0,0.0
6337,1,2337,[583 241 231 413 227],303,2,6484,2.773310521813516,0.0,0.0
6338,1,2338,[478 239 300 293 226],327,1,6485,2.7725523728088928,20.0,20.0
6339,1,2339,[429 206 507 264 208],70,3,6488,2.7726495726495726,0.0,0.0
6340,1,2340,[216 509 303 222 213],201,2,6490,2.7723195215719776,0.0,40.0
6341,1,2341,[508 254 227 268 217],130,2,6492,2.77198975234842,0.0,20.0
6342,1,2342,[316 268 291 272 583],551,4,6496,2.7725138711054202,40.0,20.0
6343,1,2343,[240 508 272 217 255],130,4,6500,2.773037542662116,20.0,0.0
6344,1,2344,[326 324 284 298 268],697,5,6505,2.7739872068230276,0.0,40.0
6345,1,2345,[222 300 209 241 275],249,5,6510,2.7749360613810743,0.0,40.0
6346,1,2346,[293 300 275 201 239],327,2,6512,2.7746058798466127,0.0,20.0
6347,1,2347,[221 206 212 240 223],201,2,6514,2.77427597955707,20.0,0.0
6348,1,2348,[251 280 394 275 290],286,4,6518,2.774797786292039,0.0,0.0
6349,1,2349,[303 219 226 298 239],276,5,6523,2.775744680851064,0.0,20.0
6350,1,2350,[216 230 384 219 217],301,4,6527,2.7762654189706506,0.0,20.0
6351,1,2351,[251 231 268 290 217],286,2,6529,2.7759353741496597,0.0,20.0
6352,1,2352,[222 431 241 216 259],790,2,6531,2.7756056098597535,0.0,40.0
6353,1,2353,[250 241 232 221 276],916,4,6535,2.776125743415463,0.0,0.0
6354,1,2354,[321 239 209 202 232],201,0,6535,2.774946921443737,0.0,0.0
6355,1,2355,[211 239 222 268 223],682,3,6538,2.775042444821732,20.0,40.0
6356,1,2356,[420 222 508 301 272],276,5,6543,2.7759864234196012,20.0,20.0
6357,1,2357,[230 583 215 326 217],551,3,6546,2.776081424936387,0.0,0.0
6358,1,2358,[247 212 202 246 226],1,3,6549,2.7761763459092834,0.0,0.0
6359,1,2359,[213 226 206 284 239],201,1,6550,2.7754237288135593,0.0,0.0
6360,1,2360,[392 227 365 315 508],276,3,6553,2.7755188479457855,20.0,0.0
6361,1,2361,[211 216 215 239 246],327,2,6555,2.775190516511431,0.0,20.0
6362,1,2362,[241 324 231 298 230],425,2,6557,2.7748624629707996,0.0,20.0
6363,1,2363,[230 227 206 267 243],1,4,6561,2.7753807106598987,0.0,0.0
6364,1,2364,[213 222 297 250 232],293,1,6562,2.774630021141649,0.0,20.0
6365,1,2365,[236 223 290 367 246],916,3,6565,2.7747252747252746,20.0,0.0
6366,1,2366,[261 315 268 295 331],130,3,6568,2.77482044782425,20.0,20.0
6367,1,2367,[420 452 240 215 230],276,4,6572,2.7753378378378377,0.0,0.0
6368,1,2368,[293 583 232 324 246],276,3,6575,2.775432672013508,0.0,0.0
6369,1,2369,[293 202 299 394 280],880,3,6578,2.7755274261603375,0.0,0.0
6370,1,2370,[326 392 240 280 202],222,3,6581,2.7756221003795867,0.0,0.0
6371,1,2371,[321 413 583 218 236],303,2,6583,2.7752951096121414,0.0,0.0
6372,1,2372,[223 264 216 226 291],551,4,6587,2.775811209439528,20.0,20.0
6373,1,2373,[213 315 202 301 509],758,4,6591,2.7763268744734626,20.0,0.0
6374,1,2374,[222 218 384 230 431],399,1,6592,2.775578947368421,0.0,20.0
6375,1,2375,[250 508 217 324 221],758,3,6595,2.7756734006734005,0.0,0.0
6376,1,2376,[232 507 213 212 429],846,1,6596,2.7749263777871267,0.0,0.0
6377,1,2377,[298 240 226 303 232],276,4,6600,2.7754415475189234,0.0,20.0
6378,1,2378,[219 272 291 365 209],551,5,6605,2.7763766288356453,20.0,0.0
6379,1,2379,[300 303 413 230 246],276,4,6609,2.776890756302521,0.0,20.0
6380,1,2380,[299 208 254 217 268],435,4,6613,2.7774044519109617,0.0,20.0
6381,1,2381,[268 272 259 420 295],532,4,6617,2.77791771620487,20.0,20.0
6382,1,2382,[413 222 236 255 246],130,4,6621,2.7784305497272346,0.0,20.0
6383,1,2383,[246 291 384 232 365],291,4,6625,2.778942953020134,0.0,0.0
6384,1,2384,[508 326 413 264 251],181,0,6625,2.7777777777777777,0.0,0.0
6385,1,2385,[247 227 254 264 259],1,1,6626,2.7770326906957252,0.0,0.0
6386,1,2386,[413 250 284 243 218],130,1,6627,2.776288227901131,0.0,0.0
6387,1,2387,[284 583 241 315 230],201,0,6627,2.7751256281407035,20.0,0.0
6388,1,2388,[290 303 297 202 240],889,0,6627,2.7739640016743405,0.0,0.0
6389,1,2389,[223 216 367 251 293],592,5,6632,2.77489539748954,20.0,20.0
6390,1,2390,[251 272 240 316 298],293,3,6635,2.7749895441237977,40.0,20.0
6391,1,2391,[222 212 241 211 206],201,1,6636,2.774247491638796,0.0,20.0
6392,1,2392,[222 508 321 261 221],181,1,6637,2.773506059339741,0.0,20.0
6393,1,2393,[222 223 218 321 213],201,3,6640,2.7736006683375103,20.0,20.0
6394,1,2394,[241 223 227 231 201],429,1,6641,2.7728601252609604,20.0,0.0
6395,1,2395,[420 267 226 230 452],130,4,6645,2.773372287145242,0.0,0.0
6396,1,2396,[508 509 231 221 216],201,2,6647,2.773049645390071,0.0,20.0
6397,1,2397,[321 272 201 303 206],201,1,6648,2.772310258548791,20.0,0.0
6398,1,2398,[211 413 227 201 431],246,4,6652,2.7728220091704876,0.0,0.0
6399,1,2399,[240 222 254 276 268],276,4,6656,2.7733333333333334,0.0,40.0
6400,1,2400,[272 227 250 331 291],276,4,6660,2.773844231570179,20.0,0.0
6401,1,2401,[241 326 324 284 226],303,3,6663,2.773938384679434,0.0,0.0
6402,1,2402,[215 508 392 211 218],933,1,6664,2.7732001664585932,0.0,0.0
6403,1,2403,[275 431 227 239 344],393,3,6667,2.7732945091514143,0.0,0.0
6404,1,2404,[478 211 222 219 217],561,2,6669,2.772972972972973,20.0,20.0
6405,1,2405,[429 316 268 392 481],747,4,6673,2.7734829592684953,20.0,20.0
6406,1,2406,[301 209 431 241 280],429,2,6675,2.7731616119651017,0.0,0.0
6407,1,2407,[261 299 326 217 226],130,3,6678,2.7732558139534884,0.0,0.0
6408,1,2408,[231 232 267 208 241],1,3,6681,2.7733499377334994,0.0,0.0
6409,1,2409,[202 230 231 268 254],276,3,6684,2.7734439834024895,0.0,20.0
6410,1,2410,[276 216 202 300 485],429,3,6687,2.7735379510576523,0.0,40.0
6411,1,2411,[218 250 298 241 202],222,3,6690,2.77363184079602,0.0,20.0
6412,1,2412,[226 218 583 231 216],682,1,6691,2.7728968089515127,0.0,20.0
6413,1,2413,[291 431 264 315 429],276,2,6693,2.772576636288318,20.0,0.0
6414,1,2414,[429 219 230 217 509],846,3,6696,2.7726708074534163,0.0,0.0
6415,1,2415,[216 231 509 392 211],747,2,6698,2.7723509933774833,0.0,20.0
6416,1,2416,[209 218 212 275 240],201,3,6701,2.772445179975176,0.0,0.0
6417,1,2417,[264 222 384 392 215],472,3,6704,2.772539288668321,0.0,20.0
6418,1,2418,[232 241 392 300 478],896,2,6706,2.7722199255890865,20.0,20.0
6419,1,2419,[272 209 240 431 291],551,4,6710,2.772727272727273,20.0,0.0
6420,1,2420,[206 202 239 219 276],276,5,6715,2.7736472532011565,0.0,0.0
6421,1,2421,[303 293 295 283 367],592,5,6720,2.7745664739884393,0.0,0.0
6422,1,2422,[250 254 208 255 272],1,2,6722,2.7742468014857615,20.0,0.0
6423,1,2423,[232 246 255 226 201],327,3,6725,2.7743399339933994,0.0,0.0
6424,1,2424,[213 246 298 232 240],790,3,6728,2.774432989690722,0.0,20.0
6425,1,2425,[218 216 241 215 217],201,2,6730,2.774113767518549,0.0,20.0
6426,1,2426,[272 219 239 246 298],276,5,6735,2.7750309023485786,20.0,20.0
6427,1,2427,[509 583 295 212 280],916,3,6738,2.775123558484349,0.0,0.0
6428,1,2428,[331 226 202 219 268],178,5,6743,2.776039522437217,0.0,20.0
6429,1,2429,[220 231 232 213 246],1,1,6744,2.775308641975309,0.0,0.0
6430,1,2430,[239 232 227 324 231],521,1,6745,2.774578362813657,0.0,0.0
6431,1,2431,[246 222 232 209 290],682,2,6747,2.7742598684210527,0.0,20.0
6432,1,2432,[230 431 291 232 276],551,5,6752,2.775174681463214,0.0,0.0
6433,1,2433,[211 215 290 240 213],293,2,6754,2.774856203779786,0.0,0.0
6434,1,2434,[276 344 336 295 367],592,4,6758,2.775359342915811,0.0,0.0
6435,1,2435,[259 227 243 217 315],660,2,6760,2.77504105090312,20.0,0.0
6436,1,2436,[272 583 303 429 202],276,4,6764,2.775543701272056,20.0,0.0
6437,1,2437,[217 284 295 315 250],130,1,6765,2.7748154224774404,20.0,0.0
6438,1,2438,[316 227 230 251 303],293,2,6767,2.7744977449774497,20.0,0.0
6439,1,2439,[222 232 261 212 236],1,3,6770,2.7745901639344264,0.0,20.0
6440,1,2440,[259 420 254 268 240],682,2,6772,2.77427283900041,0.0,20.0
6441,1,2441,[217 232 246 365 215],682,3,6775,2.7743652743652745,0.0,0.0
6442,1,2442,[272 293 303 250 206],293,4,6779,2.774866966844044,20.0,0.0
6443,1,2443,[324 275 215 300 431],327,2,6781,2.7745499181669393,0.0,20.0
6444,1,2444,[336 283 300 291 301],697,4,6785,2.775051124744376,0.0,20.0
6445,1,2445,[230 293 202 272 280],487,5,6790,2.775960752248569,20.0,0.0
6446,1,2446,[227 226 219 206 300],276,5,6795,2.7768696362893337,0.0,20.0
6447,1,2447,[420 240 431 231 298],276,3,6798,2.7769607843137254,0.0,20.0
6448,1,2448,[236 213 216 324 297],758,5,6803,2.777868517762352,0.0,20.0
6449,1,2449,[222 326 272 259 276],592,3,6806,2.7779591836734694,20.0,20.0
6450,1,2450,[231 223 217 255 206],1,2,6808,2.7776417788657692,20.0,0.0
6451,1,2451,[315 246 452 413 367],130,4,6812,2.7781402936378465,20.0,0.0
6452,1,2452,[218 206 219 232 226],94,2,6814,2.777823073787199,0.0,0.0
6453,1,2453,[246 244 211 259 240],1,1,6815,2.7770986145069276,0.0,0.0
6454,1,2454,[367 241 284 509 201],682,3,6818,2.7771894093686353,0.0,0.0
6455,1,2455,[232 268 211 216 201],561,1,6819,2.7764657980456025,0.0,40.0
6456,1,2456,[293 223 231 217 303],276,4,6823,2.776963776963777,20.0,0.0
6457,1,2457,[290 284 250 201 232],363,0,6823,2.775834011391375,0.0,0.0
6458,1,2458,[206 216 209 222 508],606,4,6827,2.7763318422122816,0.0,40.0
6459,1,2459,[219 231 583 291 390],303,2,6829,2.7760162601626015,0.0,0.0
6460,1,2460,[268 227 246 231 201],880,3,6832,2.776107273466071,0.0,20.0
6461,1,2461,[384 201 215 232 452],896,1,6833,2.7753858651502843,0.0,0.0
6462,1,2462,[276 316 222 390 202],747,4,6837,2.7758830694275276,20.0,20.0
6463,1,2463,[222 239 212 478 216],249,4,6841,2.7763798701298703,20.0,40.0
6464,1,2464,[331 241 326 324 315],551,4,6845,2.7768762677484786,20.0,0.0
6465,1,2465,[321 221 259 300 244],919,3,6848,2.7769667477696673,0.0,20.0
6466,1,2466,[231 367 232 250 431],472,5,6853,2.777867855695176,0.0,0.0
6467,1,2467,[231 508 227 431 284],276,3,6856,2.7779578606158832,0.0,0.0
6468,1,2468,[293 209 230 239 206],267,5,6861,2.778857837181045,0.0,0.0
6469,1,2469,[301 315 208 298 218],363,2,6863,2.7785425101214574,20.0,20.0
6470,1,2470,[284 230 209 478 222],561,2,6865,2.7782274382840955,20.0,20.0
6471,1,2471,[316 215 508 241 218],276,5,6870,2.779126213592233,20.0,0.0
6472,1,2472,[431 300 241 202 291],896,1,6871,2.7784067933683785,0.0,20.0
6473,1,2473,[236 256 230 226 250],916,2,6873,2.7780921584478575,0.0,0.0
6474,1,2474,[239 336 384 206 250],363,1,6874,2.7773737373737375,0.0,0.0
6475,1,2475,[297 384 216 239 218],758,4,6878,2.7778675282714054,0.0,20.0
6476,1,2476,[211 232 218 240 217],551,3,6881,2.777957206297941,0.0,0.0
6477,1,2477,[326 226 508 452 583],201,1,6882,2.777239709443099,0.0,0.0
6478,1,2478,[239 326 202 231 240],222,3,6885,2.7773295683743444,0.0,0.0
6479,1,2479,[300 365 202 208 211],429,3,6888,2.7774193548387096,0.0,20.0
6480,1,2480,[202 251 246 223 216],592,5,6893,2.7783151954856913,20.0,20.0
6481,1,2481,[230 215 201 222 216],862,3,6896,2.7784045124899275,0.0,40.0
6482,1,2482,[231 254 246 272 222],682,3,6899,2.7784937575513493,20.0,20.0
6483,1,2483,[280 298 241 243 222],682,3,6902,2.7785829307568437,0.0,40.0
6484,1,2484,[222 215 298 321 452],130,5,6907,2.779476861167002,0.0,40.0
6485,1,2485,[213 226 413 326 221],201,1,6908,2.7787610619469025,0.0,0.0
6486,1,2486,[481 223 219 217 299],896,2,6910,2.7784479292320063,20.0,0.0
6487,1,2487,[508 290 583 202 300],303,3,6913,2.7785369774919615,0.0,20.0
6488,1,2488,[251 243 431 255 293],592,3,6916,2.7786259541984735,0.0,0.0
6489,1,2489,[284 227 276 452 301],276,4,6920,2.7791164658634537,0.0,0.0
6490,1,2490,[291 481 509 217 384],758,4,6924,2.779606583701325,0.0,0.0
6491,1,2491,[232 508 211 275 301],429,4,6928,2.780096308186196,0.0,0.0
6492,1,2492,[217 367 208 276 226],880,5,6933,2.7809867629362213,0.0,0.0
6493,1,2493,[321 583 236 239 293],303,2,6935,2.780673616680032,0.0,0.0
6494,1,2494,[299 283 268 315 316],880,4,6939,2.7811623246492987,40.0,20.0
6495,1,2495,[222 202 209 240 272],201,0,6939,2.780048076923077,20.0,20.0
6496,1,2496,[223 246 215 284 250],291,5,6944,2.7809371245494594,20.0,0.0
6497,1,2497,[268 293 226 241 390],303,4,6948,2.7814251401120895,0.0,20.0
6498,1,2498,[298 509 222 344 216],758,4,6952,2.7819127651060422,0.0,60.0
6499,1,2499,[222 201 231 209 241],201,1,6953,2.7812,0.0,20.0
6500,1,2500,[227 222 315 202 211],660,2,6955,2.7808876449420232,20.0,20.0
6501,1,2501,[240 217 259 291 431],682,3,6958,2.780975219824141,0.0,0.0
6502,1,2502,[255 583 367 509 316],293,0,6958,2.7798641630043948,20.0,0.0
6503,1,2503,[209 232 284 216 206],201,1,6959,2.7791533546325877,0.0,20.0
6504,1,2504,[239 298 217 219 223],682,2,6961,2.7788423153692614,20.0,20.0
6505,1,2505,[240 275 218 284 485],293,0,6961,2.7777334397446127,0.0,0.0
6506,1,2506,[297 275 331 276 240],919,4,6965,2.778220981252493,0.0,0.0
6507,1,2507,[231 213 226 227 283],790,1,6966,2.777511961722488,0.0,0.0
6508,1,2508,[429 284 272 206 413],276,4,6970,2.7779992028696694,20.0,0.0
6509,1,2509,[246 250 211 219 298],435,5,6975,2.7788844621513946,0.0,20.0
6510,1,2510,[420 267 290 367 239],130,4,6979,2.7793707686180804,0.0,0.0
6511,1,2511,[276 201 231 300 239],276,4,6983,2.7798566878980893,0.0,20.0
6512,1,2512,[255 336 295 301 284],851,2,6985,2.7795463589335454,0.0,0.0
6513,1,2513,[202 583 231 284 276],303,4,6989,2.7800318217979316,0.0,0.0
6514,1,2514,[301 367 232 250 215],276,3,6992,2.7801192842942344,0.0,0.0
6515,1,2515,[298 300 291 222 392],276,3,6995,2.7802066772655007,0.0,60.0
6516,1,2516,[384 212 240 367 290],291,5,7000,2.7810885975367503,0.0,0.0
6517,1,2517,[202 367 212 431 219],561,0,7000,2.7799841143764894,0.0,0.0
6518,1,2518,[378 209 367 485 227],429,1,7001,2.779277491067884,0.0,0.0
6519,1,2519,[231 223 303 202 218],758,4,7005,2.7797619047619047,20.0,0.0
6520,1,2520,[481 216 244 268 384],870,2,7007,2.779452598175327,0.0,40.0
6521,1,2521,[303 276 240 218 219],276,5,7012,2.7803330689928627,0.0,0.0
6522,1,2522,[331 231 264 272 293],276,3,7015,2.780420134760206,20.0,0.0
6523,1,2523,[264 255 293 218 420],293,2,7017,2.780110935023772,0.0,0.0
6524,1,2524,[350 293 236 299 303],592,3,7020,2.78019801980198,0.0,0.0
6525,1,2525,[284 215 293 202 300],682,4,7024,2.780680918448139,0.0,20.0
6526,1,2526,[291 218 290 507 276],303,4,7028,2.781163434903047,0.0,0.0
6527,1,2527,[420 293 452 218 236],303,4,7032,2.7816455696202533,0.0,0.0
6528,1,2528,[211 507 378 232 201],727,2,7034,2.7813364966389877,0.0,0.0
6529,1,2529,[300 298 255 240 316],293,1,7035,2.780632411067194,20.0,40.0
6530,1,2530,[254 300 268 392 231],880,1,7036,2.7799288818648757,0.0,40.0
6531,1,2531,[315 324 216 509 213],201,3,7039,2.7800157977883098,20.0,20.0
6532,1,2532,[264 222 336 275 259],459,4,7043,2.780497433872878,0.0,20.0
6533,1,2533,[297 222 507 251 216],293,4,7047,2.7809786898184687,0.0,40.0
6534,1,2534,[291 241 216 232 583],303,3,7050,2.7810650887573964,0.0,20.0
6535,1,2535,[222 230 217 231 272],1,2,7052,2.780757097791798,20.0,20.0
6536,1,2536,[206 240 222 208 392],727,2,7054,2.780449349625542,0.0,20.0
6537,1,2537,[226 211 201 250 254],1,1,7055,2.7797478329393224,0.0,0.0
6538,1,2538,[220 202 209 239 222],1,4,7059,2.7802284363922802,0.0,20.0
6539,1,2539,[431 227 219 223 264],276,3,7062,2.780314960629921,20.0,0.0
6540,1,2540,[268 583 230 413 276],201,2,7064,2.780007870916962,0.0,20.0
6541,1,2541,[211 299 300 284 239],435,3,7067,2.7800944138473644,0.0,20.0
6542,1,2542,[293 452 420 272 301],758,1,7068,2.7793944160440422,20.0,0.0
6543,1,2543,[284 213 290 298 232],916,1,7069,2.778694968553459,0.0,20.0
6544,1,2544,[420 250 231 293 301],758,1,7070,2.7779960707269153,0.0,0.0
6545,1,2545,[208 394 301 275 251],286,5,7075,2.778868813825609,0.0,0.0
6546,1,2546,[291 208 297 316 232],293,1,7076,2.778170396544955,20.0,0.0
6547,1,2547,[240 255 321 209 324],303,2,7078,2.7778649921507066,0.0,0.0
6548,1,2548,[218 272 315 215 227],293,2,7080,2.7775598273832878,40.0,0.0
6549,1,2549,[223 316 367 291 230],293,1,7081,2.776862745098039,40.0,0.0
6550,1,2550,[268 243 284 226 219],682,2,7083,2.7765582124657,0.0,20.0
6551,1,2551,[295 223 508 276 201],919,4,7087,2.777037617554859,20.0,0.0
6552,1,2552,[272 220 213 209 256],1,2,7089,2.7767332549941246,20.0,0.0
6553,1,2553,[268 295 227 326 246],130,3,7092,2.776820673453406,0.0,20.0
6554,1,2554,[303 222 201 250 215],592,4,7096,2.7772994129158515,0.0,20.0
6555,1,2555,[384 321 431 331 299],435,2,7098,2.776995305164319,0.0,0.0
6556,1,2556,[367 478 230 232 201],561,1,7099,2.7763003519749705,20.0,0.0
6557,1,2557,[212 226 241 230 236],1,4,7103,2.7767787333854574,0.0,0.0
6558,1,2558,[431 394 216 413 300],435,1,7104,2.776084407971864,0.0,40.0
6559,1,2559,[255 202 321 259 231],303,3,7107,2.776171875,0.0,0.0
6560,1,2560,[291 283 298 293 230],429,3,7110,2.7762592737212026,0.0,20.0
6561,1,2561,[246 231 316 276 226],130,4,7114,2.776736924277908,20.0,0.0
6562,1,2562,[331 315 216 222 268],201,3,7117,2.776824034334764,20.0,60.0
6563,1,2563,[384 290 223 230 331],276,4,7121,2.7773010920436816,20.0,0.0
6564,1,2564,[331 232 226 222 202],201,1,7122,2.776608187134503,0.0,20.0
6565,1,2565,[211 250 231 300 276],682,2,7124,2.7763055339049103,0.0,20.0
6566,1,2566,[365 239 315 507 227],393,3,7127,2.776392676275808,20.0,0.0
6567,1,2567,[251 218 202 244 256],1,3,7130,2.776479750778816,0.0,0.0
6568,1,2568,[222 365 293 272 217],880,4,7134,2.7769560140132348,20.0,20.0
6569,1,2569,[267 420 222 316 272],130,5,7139,2.7778210116731517,40.0,20.0
6570,1,2570,[250 299 384 222 284],896,2,7141,2.7775184753014392,0.0,20.0
6571,1,2571,[298 239 390 241 367],303,3,7144,2.7776049766718507,0.0,20.0
6572,1,2572,[230 218 223 256 244],916,2,7146,2.777302759424796,20.0,0.0
6573,1,2573,[211 206 231 284 222],201,0,7146,2.7762237762237763,0.0,20.0
6574,1,2574,[300 298 227 420 221],758,2,7148,2.7759223300970874,0.0,40.0
6575,1,2575,[222 420 227 211 301],758,3,7151,2.7760093167701863,0.0,20.0
6576,1,2576,[202 255 239 301 336],327,1,7152,2.7753201396973224,0.0,0.0
6577,1,2577,[298 392 429 254 300],276,3,7155,2.7754072924747866,0.0,40.0
6578,1,2578,[239 299 291 215 481],896,3,7158,2.775494377665762,0.0,0.0
6579,1,2579,[452 215 384 246 326],303,2,7160,2.7751937984496124,0.0,0.0
6580,1,2580,[226 216 276 301 202],487,3,7163,2.7752808988764044,0.0,20.0
6581,1,2581,[218 431 298 240 420],758,2,7165,2.7749806351665374,0.0,20.0
6582,1,2582,[268 291 413 230 583],303,1,7166,2.7742934572202866,0.0,20.0
6583,1,2583,[256 206 216 268 217],916,3,7169,2.7743808049535605,0.0,40.0
6584,1,2584,[246 221 367 315 261],592,4,7173,2.7748549323017406,20.0,0.0
6585,1,2585,[231 202 211 272 259],682,3,7176,2.7749419953596286,20.0,0.0
6586,1,2586,[206 215 246 293 216],130,4,7180,2.775415539234635,0.0,20.0
6587,1,2587,[300 291 215 365 240],551,4,7184,2.7758887171561053,0.0,20.0
6588,1,2588,[315 243 240 222 272],130,4,7188,2.776361529548088,40.0,20.0
6589,1,2589,[243 299 392 413 202],130,2,7190,2.776061776061776,0.0,0.0
6590,1,2590,[218 221 272 298 230],758,4,7194,2.7765341566962563,20.0,20.0
6591,1,2591,[298 230 284 206 326],130,2,7196,2.7762345679012346,0.0,20.0
6592,1,2592,[217 212 241 246 276],916,5,7201,2.7770921712302354,0.0,0.0
6593,1,2593,[324 297 293 255 251],592,5,7206,2.7779491133384733,0.0,0.0
6594,1,2594,[206 321 246 350 267],130,4,7210,2.7784200385356455,0.0,0.0
6595,1,2595,[390 420 226 222 276],303,3,7213,2.7785053929121726,0.0,20.0
6596,1,2596,[223 209 216 202 508],429,5,7218,2.779360800924143,20.0,20.0
6597,1,2597,[240 431 215 452 413],201,0,7218,2.7782909930715936,0.0,0.0
6598,1,2598,[231 283 350 218 222],363,1,7219,2.7776067718353215,0.0,20.0
6599,1,2599,[365 272 315 254 392],276,2,7221,2.7773076923076925,40.0,0.0
6600,1,2600,[223 478 209 230 217],896,3,7224,2.777393310265283,40.0,0.0
6601,1,2601,[211 216 300 215 227],435,2,7226,2.777094542659493,0.0,40.0
6602,1,2602,[295 222 303 297 250],919,2,7228,2.7767960046100653,0.0,20.0
6603,1,2603,[291 201 209 226 331],276,4,7232,2.7772657450076803,0.0,0.0
6604,1,2604,[452 227 297 230 298],758,4,7236,2.777735124760077,0.0,20.0
6605,1,2605,[254 276 246 300 295],130,3,7239,2.7778204144282426,0.0,20.0
6606,1,2606,[209 222 293 250 280],682,3,7242,2.7779056386651324,0.0,20.0
6607,1,2607,[259 264 251 413 291],181,0,7242,2.776840490797546,0.0,0.0
6608,1,2608,[219 485 276 284 209],429,3,7245,2.7769260252970485,0.0,0.0
6609,1,2609,[298 259 231 264 230],303,2,7247,2.7766283524904214,0.0,20.0
6610,1,2610,[216 219 246 295 367],916,2,7249,2.7763309076982,0.0,20.0
6611,1,2611,[420 239 452 231 223],303,3,7252,2.776416539050536,20.0,0.0
6612,1,2612,[324 280 275 331 321],181,1,7253,2.7757367011098353,0.0,0.0
6613,1,2613,[223 226 240 215 201],201,2,7255,2.775439938791125,20.0,0.0
6614,1,2614,[247 264 216 236 213],1,2,7257,2.7751434034416826,0.0,20.0
6615,1,2615,[283 230 208 227 216],429,2,7259,2.774847094801223,0.0,20.0
6616,1,2616,[276 284 255 231 221],303,5,7264,2.7756973633931983,0.0,0.0
6617,1,2617,[246 208 298 268 241],790,4,7268,2.776165011459129,0.0,40.0
6618,1,2618,[295 583 284 222 211],916,2,7270,2.775868652157312,0.0,20.0
6619,1,2619,[276 420 250 241 367],276,4,7274,2.7763358778625955,0.0,0.0
6620,1,2620,[213 232 507 209 218],846,2,7276,2.7760396795116367,0.0,0.0
6621,1,2621,[226 272 413 227 431],276,3,7279,2.7761250953470635,20.0,0.0
6622,1,2622,[216 481 290 331 293],758,4,7283,2.776591688905833,0.0,20.0
6623,1,2623,[509 297 507 367 215],293,3,7286,2.776676829268293,0.0,0.0
6624,1,2624,[217 240 452 420 324],276,4,7290,2.777142857142857,0.0,0.0
6625,1,2625,[431 250 367 222 384],267,4,7294,2.7776085300837776,0.0,20.0
6626,1,2626,[315 291 295 293 299],592,3,7297,2.7776931861438903,20.0,0.0
6627,1,2627,[478 202 240 212 276],299,4,7301,2.778158295281583,20.0,0.0
6628,1,2628,[303 239 583 211 216],201,1,7302,2.777481932293648,0.0,20.0
6629,1,2629,[267 206 216 226 208],1,4,7306,2.7779467680608363,0.0,20.0
6630,1,2630,[227 206 217 240 300],293,1,7307,2.7772709996199163,0.0,20.0
6631,1,2631,[303 384 378 485 209],299,1,7308,2.776595744680851,0.0,0.0
6632,1,2632,[283 217 250 201 208],880,3,7311,2.776680592480061,0.0,0.0
6633,1,2633,[431 230 227 413 201],435,2,7313,2.7763857251328776,0.0,0.0
6634,1,2634,[384 219 206 246 452],268,1,7314,2.775711574952562,0.0,0.0
6635,1,2635,[219 202 231 232 212],896,0,7314,2.774658573596358,0.0,0.0
6636,1,2636,[241 431 226 583 201],276,3,7317,2.7747440273037545,0.0,0.0
6637,1,2637,[390 324 218 250 300],303,2,7319,2.774450341167551,0.0,20.0
6638,1,2638,[303 316 241 324 272],276,5,7324,2.7752936718453958,40.0,0.0
6639,1,2639,[218 300 326 250 240],919,2,7326,2.775,0.0,20.0
6640,1,2640,[284 295 250 276 230],916,2,7328,2.7747065505490345,0.0,0.0
6641,1,2641,[240 216 213 583 232],790,2,7330,2.77441332323997,0.0,20.0
6642,1,2642,[227 201 240 429 276],301,3,7333,2.7744986757472567,0.0,0.0
6643,1,2643,[300 429 367 240 284],276,4,7337,2.7749621785173977,0.0,20.0
6644,1,2644,[298 201 452 217 413],276,3,7340,2.775047258979206,0.0,20.0
6645,1,2645,[429 431 215 213 367],846,3,7343,2.7751322751322753,0.0,0.0
6646,1,2646,[230 215 431 275 276],178,4,7347,2.775595013222516,0.0,0.0
6647,1,2647,[218 227 223 236 209],758,5,7352,2.7764350453172204,20.0,0.0
6648,1,2648,[293 239 350 413 222],130,4,7356,2.7768969422423555,0.0,20.0
6649,1,2649,[246 255 272 222 201],592,4,7360,2.7773584905660376,20.0,20.0
6650,1,2650,[243 268 254 223 255],682,1,7361,2.776688042248208,20.0,20.0
6651,1,2651,[231 243 478 215 209],561,2,7363,2.776395173453997,20.0,0.0
6652,1,2652,[367 230 219 268 331],130,3,7366,2.7764794572182434,0.0,20.0
6653,1,2653,[250 209 226 583 217],293,0,7366,2.7754333082140166,0.0,0.0
6654,1,2654,[227 378 367 211 392],429,1,7367,2.774764595103578,0.0,0.0
6655,1,2655,[202 298 315 316 206],293,2,7369,2.774472891566265,40.0,20.0
6656,1,2656,[298 243 367 226 217],130,3,7372,2.7745577719232215,0.0,20.0
6657,1,2657,[208 219 259 227 239],1,3,7375,2.7746425884123402,0.0,0.0
6658,1,2658,[315 481 478 208 303],747,5,7380,2.7754795035727717,40.0,0.0
6659,1,2659,[243 255 240 259 201],919,3,7383,2.7755639097744362,0.0,0.0
6660,1,2660,[344 485 378 321 291],393,2,7385,2.775272453964675,0.0,0.0
6661,1,2661,[227 298 230 299 246],435,4,7389,2.775732531930879,0.0,20.0
6662,1,2662,[202 218 259 222 241],303,3,7392,2.7758167480285394,0.0,20.0
6663,1,2663,[293 298 390 232 276],303,4,7396,2.7762762762762763,0.0,20.0
6664,1,2664,[241 259 261 217 220],1,1,7397,2.7756097560975608,0.0,0.0
6665,1,2665,[507 452 236 221 300],303,3,7400,2.7756939234808704,0.0,20.0
6666,1,2666,[240 261 298 250 392],130,4,7404,2.77615298087739,0.0,20.0
6667,1,2667,[250 259 268 240 275],919,2,7406,2.7758620689655173,0.0,20.0
6668,1,2668,[215 227 272 231 303],201,1,7407,2.7751967028849758,20.0,0.0
6669,1,2669,[239 316 223 217 227],407,4,7411,2.7756554307116104,40.0,0.0
6670,1,2670,[219 254 284 583 250],276,3,7414,2.775739423436915,0.0,0.0
6671,1,2671,[209 223 231 301 202],429,3,7417,2.775823353293413,20.0,0.0
6672,1,2672,[240 230 215 232 202],551,4,7421,2.7762813318368873,0.0,0.0
6673,1,2673,[250 280 223 201 431],429,2,7423,2.775991024682124,20.0,0.0
6674,1,2674,[216 485 213 215 303],293,3,7426,2.77607476635514,0.0,20.0
6675,1,2675,[316 326 321 246 290],130,4,7430,2.7765321375186844,20.0,0.0
6676,1,2676,[291 481 272 211 213],758,5,7435,2.7773627194620842,20.0,0.0
6677,1,2677,[452 261 264 244 300],21,2,7437,2.777072442120986,0.0,20.0
6678,1,2678,[300 508 241 390 507],303,3,7440,2.777155655095185,0.0,20.0
6679,1,2679,[231 331 295 420 218],130,2,7442,2.776865671641791,0.0,0.0
6680,1,2680,[227 261 215 254 276],130,3,7445,2.7769488996643044,0.0,0.0
6681,1,2681,[276 246 241 508 303],276,5,7450,2.7777777777777777,0.0,0.0
6682,1,2682,[227 344 321 215 239],393,3,7453,2.7778606038017144,0.0,0.0
6683,1,2683,[202 223 219 284 264],276,4,7457,2.7783159463487332,20.0,0.0
6684,1,2684,[216 268 206 276 284],130,3,7460,2.7783985102420856,0.0,40.0
6685,1,2685,[367 232 222 241 239],933,1,7461,2.777736411020104,0.0,20.0
6686,1,2686,[478 241 284 215 280],178,5,7466,2.7785634536657984,20.0,0.0
6687,1,2687,[303 508 218 331 202],758,5,7471,2.779389880952381,0.0,0.0
6688,1,2688,[275 251 583 215 507],293,3,7474,2.7794719226478244,0.0,0.0
6689,1,2689,[241 481 301 509 293],758,2,7476,2.779182156133829,0.0,0.0
6690,1,2690,[209 201 231 378 223],682,1,7477,2.7785209959123,20.0,0.0
6691,1,2691,[202 240 275 272 218],293,1,7478,2.777860326894502,20.0,0.0
6692,1,2692,[226 241 324 331 219],201,3,7481,2.77794281470479,0.0,0.0
6693,1,2693,[250 508 246 236 301],919,2,7483,2.7776540460282106,0.0,0.0
6694,1,2694,[284 231 240 236 507],303,4,7487,2.7781076066790353,0.0,0.0
6695,1,2695,[239 291 230 208 223],303,2,7489,2.7778189910979227,20.0,0.0
6696,1,2696,[280 201 239 227 508],880,3,7492,2.7779013718946977,0.0,0.0
6697,1,2697,[272 255 202 250 251],293,2,7494,2.7776130467012603,20.0,0.0
6698,1,2698,[255 217 218 297 321],919,4,7498,2.7780659503519822,0.0,0.0
6699,1,2699,[508 431 208 276 300],429,4,7502,2.7785185185185184,0.0,20.0
6700,1,2700,[243 226 202 222 276],561,1,7503,2.7778600518326546,0.0,20.0
6701,1,2701,[215 284 209 223 259],303,4,7507,2.778312361213916,20.0,0.0
6702,1,2702,[208 231 280 219 293],222,1,7508,2.7776544580096187,0.0,0.0
6703,1,2703,[413 231 508 321 284],303,3,7511,2.7777366863905324,0.0,0.0
6704,1,2704,[485 452 212 378 231],846,3,7514,2.777818853974122,0.0,0.0
6705,1,2705,[290 219 217 202 215],435,3,7517,2.77790096082779,0.0,0.0
6706,1,2706,[321 291 508 215 239],303,2,7519,2.777613594384928,0.0,0.0
6707,1,2707,[231 316 208 299 239],880,4,7523,2.7780649926144756,20.0,0.0
6708,1,2708,[222 290 239 413 240],435,1,7524,2.777408637873754,0.0,20.0
6709,1,2709,[365 298 268 429 431],276,3,7527,2.777490774907749,0.0,40.0
6710,1,2710,[219 508 232 241 236],303,5,7532,2.7783105864994466,0.0,0.0
6711,1,2711,[240 276 243 315 222],919,1,7533,2.7776548672566372,20.0,20.0
6712,1,2712,[239 230 321 420 254],130,3,7536,2.777736822705492,0.0,0.0
6713,1,2713,[217 284 315 218 208],880,5,7541,2.7785556374355194,20.0,0.0
6714,1,2714,[236 256 254 250 240],1,3,7544,2.7786372007366484,0.0,0.0
6715,1,2715,[230 240 202 303 367],293,1,7545,2.777982326951399,0.0,0.0
6716,1,2716,[392 276 508 226 326],130,5,7550,2.7788001472212,0.0,0.0
6717,1,2717,[392 261 452 241 276],222,2,7552,2.778513612950699,0.0,0.0
6718,1,2718,[276 280 367 284 213],622,3,7555,2.778595071717543,0.0,0.0
6719,1,2719,[300 508 219 272 452],276,4,7559,2.7790441176470586,20.0,20.0
6720,1,2720,[293 246 295 268 478],178,4,7563,2.7794928335170894,20.0,20.0
6721,1,2721,[221 303 218 272 226],201,1,7564,2.7788390889052166,20.0,0.0
6722,1,2722,[227 254 392 216 367],435,1,7565,2.778185824458318,0.0,20.0
6723,1,2723,[321 284 222 259 326],303,1,7566,2.7775330396475773,0.0,20.0
6724,1,2724,[219 230 392 429 315],276,4,7570,2.777981651376147,20.0,0.0
6725,1,2725,[508 221 413 241 259],303,3,7573,2.7780630961115187,0.0,0.0
6726,1,2726,[232 247 230 246 255],222,3,7576,2.778144481114778,0.0,0.0
6727,1,2727,[509 206 367 420 507],293,3,7579,2.778225806451613,0.0,0.0
6728,1,2728,[254 301 384 583 452],276,1,7580,2.7775742030047637,0.0,0.0
6729,1,2729,[293 209 298 583 202],682,3,7583,2.7776556776556776,0.0,20.0
6730,1,2730,[509 223 201 367 272],682,2,7585,2.777370926400586,40.0,0.0
6731,1,2731,[216 222 202 378 239],868,0,7585,2.7763543191800877,0.0,40.0
6732,1,2732,[509 226 583 227 268],551,4,7589,2.7768020490303695,0.0,20.0
6733,1,2733,[230 202 280 298 275],178,4,7593,2.7772494513533283,0.0,20.0
6734,1,2734,[264 201 272 230 220],1,1,7594,2.776599634369287,20.0,0.0
6735,1,2735,[367 241 230 272 583],276,3,7597,2.7766812865497075,20.0,0.0
6736,1,2736,[246 316 230 259 215],178,4,7601,2.7771282426013886,20.0,0.0
6737,1,2737,[384 246 300 509 250],682,2,7603,2.776844411979547,0.0,20.0
6738,1,2738,[215 431 276 218 295],586,1,7604,2.7761956918583426,0.0,0.0
6739,1,2739,[268 392 508 300 301],276,4,7608,2.7766423357664234,0.0,40.0
6740,1,2740,[215 420 324 298 259],303,3,7611,2.7767238234221088,0.0,20.0
6741,1,2741,[219 291 481 280 283],429,2,7613,2.776440554339898,0.0,0.0
6742,1,2742,[231 250 201 247 202],1,2,7615,2.7761574917973024,0.0,0.0
6743,1,2743,[232 390 251 321 283],303,2,7617,2.7758746355685133,0.0,0.0
6744,1,2744,[508 316 218 284 331],532,5,7622,2.7766848816029146,20.0,0.0
6745,1,2745,[219 202 431 206 241],276,4,7626,2.777130371449381,0.0,0.0
6746,1,2746,[219 290 316 202 268],130,4,7630,2.7775755369493993,20.0,20.0
6747,1,2747,[431 232 231 216 508],497,1,7631,2.776928675400291,0.0,20.0
6748,1,2748,[230 209 365 431 208],429,3,7634,2.777009821753365,0.0,0.0
6749,1,2749,[246 268 208 384 251],303,4,7638,2.7774545454545456,0.0,20.0
6750,1,2750,[272 236 481 331 222],758,5,7643,2.7782624500181754,20.0,20.0
6751,1,2751,[384 241 211 431 227],790,2,7645,2.7779796511627906,0.0,0.0
6752,1,2752,[232 268 227 241 431],846,4,7649,2.7784235379585907,0.0,20.0
6753,1,2753,[222 226 284 276 452],399,0,7649,2.7774146695715323,0.0,20.0
6754,1,2754,[223 202 272 365 231],682,2,7651,2.7771324863883846,40.0,0.0
6755,1,2755,[321 216 276 298 246],303,4,7655,2.777576197387518,0.0,40.0
6756,1,2756,[215 254 384 230 485],472,3,7658,2.77765687341313,0.0,0.0
6757,1,2757,[209 321 413 452 508],201,1,7659,2.777012327773749,0.0,0.0
6758,1,2758,[211 413 222 231 227],201,1,7660,2.7763682493657122,0.0,20.0
6759,1,2759,[218 202 227 239 247],222,3,7663,2.7764492753623187,0.0,0.0
6760,1,2760,[452 231 230 267 331],130,2,7665,2.7761680550525174,0.0,0.0
6761,1,2761,[256 206 367 223 236],916,2,7667,2.775887038377987,20.0,0.0
6762,1,2762,[202 429 365 215 583],276,3,7670,2.7759681505609843,0.0,0.0
6763,1,2763,[293 291 384 202 301],758,3,7673,2.7760492040520983,0.0,0.0
6764,1,2764,[300 268 202 293 219],130,5,7678,2.7768535262206147,0.0,40.0
6765,1,2765,[290 291 208 251 264],293,1,7679,2.7762111352133045,0.0,0.0
6766,1,2766,[212 367 231 365 384],291,3,7682,2.7762920130104805,0.0,0.0
6767,1,2767,[215 452 420 316 293],130,5,7687,2.7770953757225434,20.0,0.0
6768,1,2768,[367 226 254 392 315],880,3,7690,2.777175875767425,20.0,0.0
6769,1,2769,[298 209 290 293 284],276,5,7695,2.7779783393501805,0.0,20.0
6770,1,2770,[217 226 232 230 250],407,3,7698,2.7780584626488634,0.0,0.0
6771,1,2771,[236 299 367 297 255],592,3,7701,2.7781385281385282,0.0,0.0
6772,1,2772,[365 316 222 384 243],880,2,7703,2.7778579156148577,20.0,20.0
6773,1,2773,[239 227 303 250 216],293,2,7705,2.777577505407354,0.0,20.0
6774,1,2774,[227 239 208 264 291],435,4,7709,2.778018018018018,0.0,0.0
6775,1,2775,[268 219 218 255 478],178,4,7713,2.778458213256484,20.0,20.0
6776,1,2776,[255 431 230 211 215],327,2,7715,2.7781778898091467,0.0,0.0
6777,1,2777,[429 222 316 324 315],276,5,7720,2.7789776817854572,40.0,20.0
6778,1,2778,[240 268 507 209 583],303,3,7723,2.779057214825477,0.0,20.0
6779,1,2779,[290 230 231 239 283],303,2,7725,2.778776978417266,0.0,0.0
6780,1,2780,[331 246 431 583 315],276,3,7728,2.778856526429342,20.0,0.0
6781,1,2781,[283 315 297 429 206],293,3,7731,2.7789360172537743,20.0,0.0
6782,1,2782,[209 232 244 254 259],1,1,7732,2.778296802012217,0.0,0.0
6783,1,2783,[303 213 209 239 232],293,1,7733,2.7776580459770117,0.0,0.0
6784,1,2784,[507 223 301 321 264],429,2,7735,2.77737881508079,20.0,0.0
6785,1,2785,[264 246 243 202 222],1,3,7738,2.7774587221823404,0.0,20.0
6786,1,2786,[206 201 250 240 231],727,2,7740,2.7771797631862216,0.0,0.0
6787,1,2787,[232 326 508 230 227],303,2,7742,2.7769010043041606,0.0,0.0
6788,1,2788,[284 241 215 239 268],399,1,7743,2.7762638938687703,0.0,20.0
6789,1,2789,[431 241 315 331 209],276,4,7747,2.7767025089605735,20.0,0.0
6790,1,2790,[295 331 230 316 218],532,5,7752,2.777499104263705,20.0,0.0
6791,1,2791,[508 276 290 208 227],758,4,7756,2.7779369627507164,0.0,0.0
6792,1,2792,[209 211 321 303 276],201,1,7757,2.777300393841747,0.0,0.0
6793,1,2793,[276 485 227 508 250],429,2,7759,2.777022190408017,0.0,0.0
6794,1,2794,[272 420 250 255 283],393,3,7762,2.7771019677996422,20.0,0.0
6795,1,2795,[300 209 301 264 293],276,4,7766,2.7775393419170245,0.0,20.0
6796,1,2796,[259 217 301 429 239],660,2,7768,2.77726135144798,0.0,0.0
6797,1,2797,[216 250 264 217 211],429,2,7770,2.7769835596854895,0.0,20.0
6798,1,2798,[481 384 264 367 216],299,2,7772,2.776705966416577,0.0,20.0
6799,1,2799,[508 231 254 227 255],130,2,7774,2.7764285714285712,0.0,0.0
6800,1,2800,[283 243 241 420 298],393,3,7777,2.776508389860764,0.0,20.0
6801,1,2801,[202 250 209 230 478],178,5,7782,2.777301927194861,20.0,0.0
6802,1,2802,[295 384 217 300 315],880,3,7785,2.7773813770959688,20.0,20.0
6803,1,2803,[275 331 206 452 268],201,3,7788,2.7774607703281027,0.0,20.0
6804,1,2804,[223 420 290 232 268],682,1,7789,2.7768270944741533,20.0,20.0
6805,1,2805,[218 202 365 276 280],880,3,7792,2.7769066286528865,0.0,0.0
6806,1,2806,[255 222 246 350 336],592,3,7795,2.7769861061631635,0.0,20.0
6807,1,2807,[202 452 231 215 321],130,4,7799,2.7774216524216526,0.0,0.0
6808,1,2808,[222 431 331 344 324],758,3,7802,2.77750088999644,0.0,20.0
6809,1,2809,[276 217 211 280 250],916,4,7806,2.7779359430604984,0.0,0.0
6810,1,2810,[392 215 218 378 232],472,5,7811,2.7787264318747775,0.0,0.0
6811,1,2811,[240 239 367 293 230],222,2,7813,2.7784495021337126,0.0,0.0
6812,1,2812,[276 336 301 295 255],592,3,7816,2.7785282616423745,0.0,0.0
6813,1,2813,[218 452 231 241 244],425,0,7816,2.777540867093106,0.0,0.0
6814,1,2814,[211 378 240 202 280],682,3,7819,2.777619893428064,0.0,0.0
6815,1,2815,[300 583 264 290 321],303,1,7820,2.7769886363636362,0.0,20.0
6816,1,2816,[202 232 250 390 201],94,3,7823,2.777067802626908,0.0,0.0
6817,1,2817,[227 232 241 583 291],303,2,7825,2.7767920511000708,0.0,0.0
6818,1,2818,[232 275 217 230 226],790,4,7829,2.777225966654842,0.0,0.0
6819,1,2819,[452 216 227 384 250],896,2,7831,2.7769503546099292,0.0,20.0
6820,1,2820,[268 220 326 209 232],178,4,7835,2.7773839064161643,0.0,20.0
6821,1,2821,[222 367 268 267 255],130,5,7840,2.7781715095676827,0.0,40.0
6822,1,2822,[315 264 384 420 316],276,3,7843,2.7782500885582713,40.0,0.0
6823,1,2823,[316 236 392 218 290],130,4,7847,2.778682719546742,20.0,0.0
6824,1,2824,[201 226 212 202 206],1,3,7850,2.7787610619469025,0.0,0.0
6825,1,2825,[202 390 365 508 268],94,3,7853,2.778839348903043,0.0,20.0
6826,1,2826,[293 227 283 230 209],303,2,7855,2.7785638486027593,0.0,0.0
6827,1,2827,[315 239 219 246 236],130,5,7860,2.7793493635077793,20.0,0.0
6828,1,2828,[326 231 223 300 508],222,3,7863,2.7794273594909864,20.0,20.0
6829,1,2829,[202 297 217 344 509],758,3,7866,2.7795053003533567,0.0,0.0
6830,1,2830,[206 291 283 509 216],293,2,7868,2.7792299540798306,0.0,20.0
6831,1,2831,[283 239 215 367 384],303,2,7870,2.778954802259887,0.0,0.0
6832,1,2832,[509 365 485 392 217],846,3,7873,2.779032827391458,0.0,0.0
6833,1,2833,[231 478 216 209 367],846,4,7877,2.7794636556104444,20.0,20.0
6834,1,2834,[367 209 211 392 215],846,3,7880,2.7795414462081127,0.0,0.0
6835,1,2835,[283 284 583 280 303],293,1,7881,2.7789139633286317,0.0,0.0
6836,1,2836,[211 215 208 217 223],1,2,7883,2.7786394078251675,20.0,0.0
6837,1,2837,[231 481 276 230 216],429,2,7885,2.7783650458069062,0.0,20.0
6838,1,2838,[583 226 300 208 240],303,2,7887,2.7780908770693906,0.0,20.0
6839,1,2839,[209 216 223 378 367],870,4,7891,2.7785211267605634,20.0,20.0
6840,1,2840,[298 321 202 226 218],429,2,7893,2.778247096092925,0.0,20.0
6841,1,2841,[297 284 293 240 215],293,3,7896,2.7783251231527095,0.0,0.0
6842,1,2842,[264 223 431 218 280],551,3,7899,2.7784030953218433,20.0,0.0
6843,1,2843,[202 251 431 293 367],592,4,7903,2.778832630098453,0.0,0.0
6844,1,2844,[250 212 217 215 315],286,2,7905,2.7785588752196837,20.0,0.0
6845,1,2845,[230 297 264 420 226],293,2,7907,2.7782853127196065,0.0,0.0
6846,1,2846,[365 268 284 241 216],682,4,7911,2.778714436248683,0.0,40.0
6847,1,2847,[331 227 254 230 239],435,3,7914,2.778792134831461,0.0,0.0
6848,1,2848,[301 344 216 299 251],592,3,7917,2.7788697788697787,0.0,20.0
6849,1,2849,[218 293 227 222 452],303,2,7919,2.77859649122807,0.0,20.0
6850,1,2850,[217 246 301 240 268],919,1,7920,2.777972641178534,0.0,20.0
6851,1,2851,[321 243 206 231 508],130,2,7922,2.7776998597475457,0.0,0.0
6852,1,2852,[232 212 222 264 298],363,2,7924,2.7774272695408344,0.0,40.0
6853,1,2853,[217 283 222 367 280],429,1,7925,2.7768044849334266,0.0,20.0
6854,1,2854,[232 272 300 276 246],682,2,7927,2.776532399299475,20.0,20.0
6855,1,2855,[243 299 218 290 217],682,2,7929,2.7762605042016806,0.0,0.0
6856,1,2856,[216 250 485 226 367],472,4,7933,2.776688834441722,0.0,20.0
6857,1,2857,[293 344 217 209 367],327,3,7936,2.776766969909027,0.0,0.0
6858,1,2858,[261 216 255 215 209],1,2,7938,2.776495278069255,0.0,20.0
6859,1,2859,[216 208 230 293 300],303,3,7941,2.7765734265734268,0.0,40.0
6860,1,2860,[316 226 243 295 298],880,4,7945,2.777001048584411,20.0,20.0
6861,1,2861,[246 222 218 509 583],682,2,7947,2.7767295597484276,0.0,20.0
6862,1,2862,[293 283 297 290 208],293,2,7949,2.77645826056584,0.0,0.0
6863,1,2863,[326 222 219 295 452],130,4,7953,2.776885474860335,0.0,20.0
6864,1,2864,[230 485 209 315 297],293,1,7954,2.776265270506108,20.0,0.0
6865,1,2865,[206 254 240 230 201],276,4,7958,2.776692254012561,0.0,0.0
6866,1,2866,[284 232 315 254 250],276,3,7961,2.776770143006627,20.0,0.0
6867,1,2867,[326 211 240 239 219],201,1,7962,2.776150627615063,0.0,0.0
6868,1,2868,[246 222 390 290 321],303,2,7964,2.775880097594981,0.0,20.0
6869,1,2869,[261 272 230 236 246],1,3,7967,2.77595818815331,20.0,0.0
6870,1,2870,[227 222 217 326 219],425,2,7969,2.775687913618948,0.0,20.0
6871,1,2871,[239 321 240 298 241],393,3,7972,2.7757660167130918,0.0,20.0
6872,1,2872,[211 301 431 392 315],660,3,7975,2.7758440654368255,20.0,0.0
6873,1,2873,[392 232 226 211 431],896,1,7976,2.775226165622825,0.0,0.0
6874,1,2874,[201 240 384 293 217],682,4,7980,2.7756521739130435,0.0,0.0
6875,1,2875,[299 301 280 239 232],880,4,7984,2.776077885952712,0.0,0.0
6876,1,2876,[202 218 431 201 384],276,3,7987,2.776155717761557,0.0,0.0
6877,1,2877,[243 326 331 413 250],130,1,7988,2.7755385684503127,0.0,0.0
6878,1,2878,[232 431 384 299 275],896,1,7989,2.7749218478638418,0.0,0.0
6879,1,2879,[481 230 201 431 507],429,2,7991,2.774652777777778,0.0,0.0
6880,1,2880,[291 240 212 297 211],889,1,7992,2.7740367927802847,0.0,0.0
6881,1,2881,[240 276 250 431 241],586,1,7993,2.7734212352532963,0.0,0.0
6882,1,2882,[255 583 219 240 251],303,3,7996,2.7734998265695454,0.0,0.0
6883,1,2883,[384 208 298 250 284],268,2,7998,2.7732316227461857,0.0,20.0
6884,1,2884,[216 298 206 300 215],435,2,8000,2.7729636048526864,0.0,60.0
6885,1,2885,[264 276 268 280 216],551,3,8003,2.773042273042273,0.0,40.0
6886,1,2886,[275 315 240 293 429],293,2,8005,2.772774506408036,20.0,0.0
6887,1,2887,[246 206 303 331 429],276,5,8010,2.7735457063711912,0.0,0.0
6888,1,2888,[295 250 251 227 268],532,4,8014,2.773970231914157,0.0,20.0
6889,1,2889,[316 336 226 230 301],363,1,8015,2.773356401384083,20.0,0.0
6890,1,2890,[231 420 384 378 264],399,0,8015,2.7723970944309926,0.0,0.0
6891,1,2891,[336 239 215 209 243],514,2,8017,2.7721300138312586,0.0,0.0
6892,1,2892,[583 219 208 255 216],303,4,8021,2.772554441755963,0.0,20.0
6893,1,2893,[508 255 246 217 211],327,1,8022,2.77194194885971,0.0,0.0
6894,1,2894,[250 211 367 206 226],727,2,8024,2.7716753022452503,0.0,0.0
6895,1,2895,[240 222 291 284 298],130,4,8028,2.772099447513812,0.0,40.0
6896,1,2896,[276 217 241 303 384],758,2,8030,2.7718329306178804,0.0,0.0
6897,1,2897,[239 230 394 217 250],497,2,8032,2.771566597653554,0.0,0.0
6898,1,2898,[293 507 209 324 276],303,4,8036,2.771990341497068,0.0,0.0
6899,1,2899,[321 259 331 508 297],919,4,8040,2.7724137931034485,0.0,0.0
6900,1,2900,[217 216 218 420 301],758,2,8042,2.772147535332644,0.0,20.0
6901,1,2901,[243 202 206 232 211],1,2,8044,2.771881461061337,0.0,0.0
6902,1,2902,[297 431 202 239 208],889,3,8047,2.7719600413365484,0.0,0.0
6903,1,2903,[250 290 216 230 507],293,2,8049,2.771694214876033,0.0,20.0
6904,1,2904,[218 276 223 280 392],429,2,8051,2.7714285714285714,20.0,0.0
6905,1,2905,[219 222 243 212 223],561,1,8052,2.770818995182381,20.0,20.0
6906,1,2906,[232 394 268 209 390],286,4,8056,2.7712418300653594,0.0,20.0
6907,1,2907,[208 213 240 378 303],299,2,8058,2.7709766162310867,0.0,0.0
6908,1,2908,[220 276 293 218 283],178,2,8060,2.770711584737023,0.0,0.0
6909,1,2909,[259 276 326 218 241],303,3,8063,2.770790378006873,0.0,0.0
6910,1,2910,[215 221 350 315 250],592,5,8068,2.771556166265888,20.0,0.0
6911,1,2911,[284 272 217 293 206],276,5,8073,2.7723214285714284,20.0,0.0
6912,1,2912,[291 218 300 378 284],429,1,8074,2.77171301064195,0.0,20.0
6913,1,2913,[583 316 429 326 300],425,2,8076,2.7714481811942346,20.0,20.0
6914,1,2914,[247 256 220 201 236],1,2,8078,2.7711835334476844,0.0,0.0
6915,1,2915,[264 216 244 230 267],1,3,8081,2.771262002743484,0.0,20.0
6916,1,2916,[219 239 226 218 367],864,4,8085,2.771683236201577,0.0,0.0
6917,1,2917,[222 239 213 216 209],916,2,8087,2.771418779986292,0.0,40.0
6918,1,2918,[215 209 246 583 206],916,2,8089,2.7711545049674546,0.0,0.0
6919,1,2919,[420 250 231 227 215],896,3,8092,2.771232876712329,0.0,0.0
6920,1,2920,[231 485 298 202 367],429,2,8094,2.770968846285519,0.0,20.0
6921,1,2921,[264 300 452 218 268],303,2,8096,2.7707049965776864,0.0,40.0
6922,1,2922,[452 251 227 230 390],303,1,8097,2.770099213137188,0.0,0.0
6923,1,2923,[244 478 222 241 223],178,4,8101,2.7705198358413132,40.0,20.0
6924,1,2924,[231 232 420 300 226],303,4,8105,2.770940170940171,0.0,20.0
6925,1,2925,[240 222 251 303 239],299,1,8106,2.770334928229665,0.0,20.0
6926,1,2926,[413 202 392 240 507],495,5,8111,2.7710966860266484,0.0,0.0
6927,1,2927,[208 232 485 231 211],846,2,8113,2.7708333333333335,0.0,0.0
6928,1,2928,[217 268 218 215 221],1,2,8115,2.7705701604643225,0.0,20.0
6929,1,2929,[241 216 222 244 284],916,3,8118,2.7706484641638225,0.0,40.0
6930,1,2930,[213 209 217 283 211],790,2,8120,2.7703855339474583,0.0,0.0
6931,1,2931,[216 201 213 232 215],1,1,8121,2.769781718963165,0.0,20.0
6932,1,2932,[299 261 240 276 280],181,1,8122,2.7691783157176952,0.0,0.0
6933,1,2933,[230 217 268 431 367],727,2,8124,2.7689161554192228,0.0,20.0
6934,1,2934,[222 202 218 215 509],293,1,8125,2.7683134582623508,0.0,20.0
6935,1,2935,[299 303 331 300 280],181,1,8126,2.767711171662125,0.0,20.0
6936,1,2936,[255 509 239 241 218],682,1,8127,2.767109295199183,0.0,0.0
6937,1,2937,[384 508 392 223 246],276,3,8130,2.7671885636487406,20.0,0.0
6938,1,2938,[298 206 429 230 201],363,2,8132,2.7669275263695132,0.0,20.0
6939,1,2939,[232 222 384 209 227],933,0,8132,2.765986394557823,0.0,20.0
6940,1,2940,[208 413 384 240 223],246,3,8135,2.7660659639578373,20.0,0.0
6941,1,2941,[290 300 299 202 218],435,2,8137,2.765805574439157,0.0,20.0
6942,1,2942,[240 202 231 452 232],320,2,8139,2.765545361875637,0.0,0.0
6943,1,2943,[208 268 298 232 241],268,2,8141,2.7652853260869565,0.0,40.0
6944,1,2944,[222 251 297 507 218],468,5,8146,2.766044142614601,0.0,20.0
6945,1,2945,[230 276 272 431 250],276,4,8150,2.7664630006788866,20.0,0.0
6946,1,2946,[243 209 272 284 384],880,2,8152,2.7662029182219205,20.0,0.0
6947,1,2947,[232 250 246 367 215],94,4,8156,2.7666214382632295,0.0,0.0
6948,1,2948,[254 219 209 230 290],276,4,8160,2.7670396744659205,0.0,0.0
6949,1,2949,[218 213 241 231 485],846,3,8163,2.7671186440677964,0.0,0.0
6950,1,2950,[223 254 219 452 331],276,3,8166,2.767197560149102,20.0,0.0
6951,1,2951,[217 324 276 215 367],276,4,8170,2.7676151761517613,0.0,0.0
6952,1,2952,[298 485 508 227 208],429,3,8173,2.767693870640027,0.0,20.0
6953,1,2953,[232 316 227 250 226],276,4,8177,2.768111035883548,20.0,0.0
6954,1,2954,[264 243 236 240 326],181,0,8177,2.7671742808798645,0.0,0.0
6955,1,2955,[222 206 431 240 201],201,1,8178,2.766576454668471,0.0,20.0
6956,1,2956,[300 293 583 217 215],276,4,8182,2.76699357456882,0.0,20.0
6957,1,2957,[295 212 230 250 216],916,3,8185,2.767072346179851,0.0,20.0
6958,1,2958,[230 202 384 331 367],276,3,8188,2.767151064548834,0.0,0.0
6959,1,2959,[218 250 264 221 209],303,4,8192,2.7675675675675677,0.0,0.0
6960,1,2960,[250 367 295 202 264],592,4,8196,2.767983789260385,0.0,0.0
6961,1,2961,[232 508 218 283 290],303,4,8200,2.7683997299122214,0.0,0.0
6962,1,2962,[222 290 394 218 201],435,2,8202,2.768140398245022,0.0,20.0
6963,1,2963,[509 211 216 239 231],846,3,8205,2.7682186234817814,0.0,20.0
6964,1,2964,[236 315 272 413 243],130,3,8208,2.7682967959527827,40.0,0.0
6965,1,2965,[324 508 202 259 301],592,3,8211,2.7683749157113957,0.0,0.0
6966,1,2966,[298 251 221 227 268],303,4,8215,2.768790023592855,0.0,40.0
6967,1,2967,[216 272 284 261 255],130,4,8219,2.7692048517520216,20.0,20.0
6968,1,2968,[298 331 223 509 236],758,5,8224,2.76995621421354,20.0,20.0
6969,1,2969,[413 384 227 219 201],276,3,8227,2.77003367003367,0.0,0.0
6970,1,2970,[392 217 255 240 222],130,4,8231,2.770447660720296,0.0,20.0
6971,1,2971,[209 367 303 202 315],293,1,8232,2.7698519515477793,20.0,0.0
6972,1,2972,[293 507 209 251 297],293,4,8236,2.7702657248570466,0.0,0.0
6973,1,2973,[222 232 219 264 268],1,2,8238,2.770006724949563,0.0,40.0
6974,1,2974,[344 301 222 298 300],327,1,8239,2.7694117647058825,0.0,60.0
6975,1,2975,[206 231 215 290 350],363,0,8239,2.768481182795699,0.0,0.0
6976,1,2976,[268 226 221 222 240],201,1,8240,2.767887134699362,0.0,40.0
6977,1,2977,[293 219 216 268 507],327,3,8243,2.7679650772330424,0.0,40.0
6978,1,2978,[227 264 291 365 217],429,1,8244,2.7673716012084593,0.0,0.0
6979,1,2979,[208 280 284 268 452],222,1,8245,2.7667785234899327,0.0,20.0
6980,1,2980,[218 244 247 261 259],1,0,8245,2.765850385776585,0.0,0.0
6981,1,2981,[275 255 226 217 218],293,0,8245,2.7649228705566733,0.0,0.0
6982,1,2982,[301 316 211 303 300],758,3,8248,2.7650016761649345,20.0,20.0
6983,1,2983,[268 284 299 232 254],880,4,8252,2.765415549597855,0.0,20.0
6984,1,2984,[429 420 452 217 240],276,4,8256,2.765829145728643,0.0,0.0
6985,1,2985,[216 239 290 246 240],435,2,8258,2.7655726724715337,0.0,20.0
6986,1,2986,[413 236 261 240 508],181,0,8258,2.764646802812186,0.0,0.0
6987,1,2987,[217 275 367 431 276],429,3,8261,2.7647255689424366,0.0,0.0
6988,1,2988,[272 367 331 201 243],919,4,8265,2.765138842422215,20.0,0.0
6989,1,2989,[261 452 250 290 295],130,2,8267,2.764882943143813,0.0,0.0
6990,1,2990,[227 384 250 219 222],268,3,8270,2.7649615513206287,0.0,20.0
6991,1,2991,[222 264 298 226 291],293,1,8271,2.7643716577540105,0.0,40.0
6992,1,2992,[507 367 283 264 291],303,2,8273,2.764116271299699,0.0,0.0
6993,1,2993,[250 232 298 227 211],429,3,8276,2.764195056780227,0.0,20.0
6994,1,2994,[223 331 275 226 209],201,3,8279,2.764273789649416,20.0,0.0
6995,1,2995,[216 209 240 485 365],790,2,8281,2.764018691588785,0.0,20.0
6996,1,2996,[300 227 291 240 481],758,3,8284,2.7640974307640973,0.0,20.0
6997,1,2997,[241 298 201 290 254],682,3,8287,2.764176117411608,0.0,20.0
6998,1,2998,[276 215 212 250 298],916,3,8290,2.764254751583861,0.0,20.0
6999,1,2999,[218 452 222 264 217],276,3,8293,2.7643333333333335,0.0,20.0
7000,1,3000,[217 420 413 218 254],276,3,8296,2.764411862712429,0.0,0.0
7001,1,3001,[326 321 276 298 226],130,5,8301,2.7651565622918053,0.0,20.0
7002,1,3002,[268 222 431 215 583],276,3,8304,2.7652347652347653,0.0,40.0
7003,1,3003,[298 331 211 350 208],758,5,8309,2.765978695073236,0.0,20.0
7004,1,3004,[226 219 217 232 507],561,1,8310,2.765391014975042,0.0,0.0
7005,1,3005,[232 508 255 367 202],303,5,8315,2.7661343978709247,0.0,0.0
7006,1,3006,[283 508 250 230 367],429,1,8316,2.7655470568673097,0.0,0.0
7007,1,3007,[223 226 222 215 227],864,4,8320,2.765957446808511,20.0,20.0
7008,1,3008,[290 230 392 326 284],130,2,8322,2.765702891326022,0.0,0.0
7009,1,3009,[344 213 216 211 331],758,4,8326,2.7661129568106313,0.0,20.0
7010,1,3010,[230 392 219 250 478],896,2,8328,2.76585851876453,20.0,0.0
7011,1,3011,[293 226 202 301 378],487,4,8332,2.766268260292165,0.0,0.0
7012,1,3012,[202 230 300 231 429],276,4,8336,2.7666777298373715,0.0,20.0
7013,1,3013,[300 420 219 230 429],276,5,8341,2.767418712674187,0.0,20.0
7014,1,3014,[276 230 272 331 201],276,5,8346,2.7681592039800993,20.0,0.0
7015,1,3015,[240 272 350 202 291],758,4,8350,2.768567639257294,20.0,0.0
7016,1,3016,[384 208 215 413 264],303,2,8352,2.768312893602917,0.0,0.0
7017,1,3017,[336 350 221 251 303],592,4,8356,2.768721007289596,0.0,0.0
7018,1,3018,[211 420 209 219 291],896,2,8358,2.7684663795958926,0.0,0.0
7019,1,3019,[222 283 218 202 211],429,3,8361,2.7685430463576157,0.0,20.0
7020,1,3020,[202 321 293 221 218],919,3,8364,2.768619662363456,0.0,0.0
7021,1,3021,[316 297 303 216 452],758,4,8368,2.769027134348114,20.0,20.0
7022,1,3022,[315 216 223 222 276],747,3,8371,2.769103539530268,40.0,40.0
7023,1,3023,[240 226 321 201 276],201,2,8373,2.7688492063492065,0.0,0.0
7024,1,3024,[240 298 267 236 452],130,5,8378,2.769586776859504,0.0,20.0
7025,1,3025,[321 295 275 251 250],936,3,8381,2.769662921348315,0.0,0.0
7026,1,3026,[217 267 298 384 201],268,0,8381,2.7687479352494218,0.0,20.0
7027,1,3027,[219 291 420 378 413],399,0,8381,2.7678335535006604,0.0,0.0
7028,1,3028,[222 240 420 202 208],293,1,8382,2.7672499174645098,0.0,20.0
7029,1,3029,[384 216 315 223 256],363,1,8383,2.7666666666666666,40.0,20.0
7030,1,3030,[232 209 290 324 201],303,4,8387,2.767073573078192,0.0,0.0
7031,1,3031,[276 367 202 298 384],276,3,8390,2.7671503957783643,0.0,20.0
7032,1,3032,[246 231 241 378 384],682,2,8392,2.766897461259479,0.0,0.0
7033,1,3033,[243 508 299 284 321],181,0,8392,2.7659854976928147,0.0,0.0
7034,1,3034,[202 284 275 268 259],790,3,8395,2.7660626029654036,0.0,20.0
7035,1,3035,[264 272 336 508 295],592,3,8398,2.7661396574440054,20.0,0.0
7036,1,3036,[227 315 250 420 299],130,2,8400,2.765887388870596,20.0,0.0
7037,1,3037,[315 201 276 236 298],592,4,8404,2.7662936142198813,20.0,20.0
7038,1,3038,[299 239 232 223 202],896,2,8406,2.76604146100691,20.0,0.0
7039,1,3039,[241 420 201 206 384],896,2,8408,2.7657894736842104,0.0,0.0
7040,1,3040,[247 241 272 212 202],1,3,8411,2.7658664912857613,20.0,0.0
7041,1,3041,[324 276 231 223 226],303,4,8415,2.7662721893491122,20.0,0.0
7042,1,3042,[420 295 250 216 227],130,2,8417,2.766020374630299,0.0,20.0
7043,1,3043,[290 507 300 378 208],429,2,8419,2.7657687253613665,0.0,20.0
7044,1,3044,[240 367 261 299 336],851,3,8422,2.7658456486042695,0.0,0.0
7045,1,3045,[508 420 227 413 583],303,2,8424,2.7655942219304004,0.0,0.0
7046,1,3046,[216 219 226 431 293],222,3,8427,2.7656711519527404,0.0,20.0
7047,1,3047,[211 413 394 230 226],435,3,8430,2.765748031496063,0.0,0.0
7048,1,3048,[293 215 384 298 202],682,4,8434,2.766152836995736,0.0,20.0
7049,1,3049,[240 268 230 316 241],551,4,8438,2.7665573770491805,20.0,20.0
7050,1,3050,[202 246 209 301 452],276,4,8442,2.7669616519174043,0.0,0.0
7051,1,3051,[413 219 254 324 298],276,3,8445,2.767038007863696,0.0,20.0
7052,1,3052,[241 231 211 217 429],896,3,8448,2.767114313789715,0.0,0.0
7053,1,3053,[227 239 367 276 223],916,2,8450,2.766863130320891,20.0,0.0
7054,1,3054,[217 231 268 222 293],682,4,8454,2.767266775777414,0.0,40.0
7055,1,3055,[452 222 241 250 239],276,4,8458,2.767670157068063,0.0,20.0
7056,1,3056,[227 420 221 384 222],758,3,8461,2.767746156362447,0.0,20.0
7057,1,3057,[226 223 215 216 202],293,3,8464,2.7678221059516024,20.0,20.0
7058,1,3058,[254 209 236 250 217],1,3,8467,2.767898005884276,0.0,0.0
7059,1,3059,[216 268 420 299 201],682,4,8471,2.768300653594771,0.0,40.0
7060,1,3060,[213 583 297 284 216],293,2,8473,2.7680496569748447,0.0,20.0
7061,1,3061,[291 259 284 222 219],727,2,8475,2.7677988242978446,0.0,20.0
7062,1,3062,[331 246 215 216 222],130,4,8479,2.7682011100228534,0.0,40.0
7063,1,3063,[255 280 300 218 250],178,4,8483,2.768603133159269,0.0,20.0
7064,1,3064,[246 326 284 209 331],178,5,8488,2.769331158238173,0.0,0.0
7065,1,3065,[254 212 244 220 268],1,2,8490,2.7690802348336594,0.0,20.0
7066,1,3066,[297 298 290 226 218],293,2,8492,2.7688294750570592,0.0,20.0
7067,1,3067,[326 291 301 321 413],181,0,8492,2.7679269882659714,0.0,0.0
7068,1,3068,[298 297 284 215 206],293,4,8496,2.768328445747801,0.0,20.0
7069,1,3069,[223 226 284 219 291],429,3,8499,2.7684039087947885,20.0,0.0
7070,1,3070,[485 239 478 268 201],305,0,8499,2.7675024422012373,20.0,20.0
7071,1,3071,[478 202 211 367 246],327,4,8503,2.7679036458333335,20.0,0.0
7072,1,3072,[367 239 298 291 300],303,2,8505,2.7676537585421412,0.0,40.0
7073,1,3073,[280 321 298 216 223],429,3,8508,2.767729342875732,20.0,40.0
7074,1,3074,[276 298 284 431 227],429,3,8511,2.7678048780487803,0.0,20.0
7075,1,3075,[232 293 284 276 246],880,5,8516,2.7685305591677505,0.0,0.0
7076,1,3076,[250 290 283 255 227],303,3,8519,2.7686057848553784,0.0,0.0
7077,1,3077,[509 367 240 218 316],293,0,8519,2.7677063027940223,20.0,0.0
7078,1,3078,[223 290 254 324 218],276,4,8523,2.768106528093537,20.0,0.0
7079,1,3079,[261 367 218 208 280],222,1,8524,2.7675324675324675,0.0,0.0
7080,1,3080,[508 218 223 230 216],222,4,8528,2.7679324894514767,20.0,20.0
7081,1,3081,[223 268 227 284 209],303,4,8532,2.7683322517845554,20.0,20.0
7082,1,3082,[300 209 303 222 293],293,2,8534,2.768083036003892,0.0,40.0
7083,1,3083,[255 201 367 239 222],303,3,8537,2.7681582360570687,0.0,20.0
7084,1,3084,[275 481 378 298 280],429,2,8539,2.7679092382495947,0.0,20.0
7085,1,3085,[243 230 239 392 295],130,2,8541,2.7676604018146467,0.0,0.0
7086,1,3086,[202 212 219 211 452],201,2,8543,2.7674117265954,0.0,0.0
7087,1,3087,[216 232 384 255 276],303,4,8547,2.7678108808290154,0.0,20.0
7088,1,3088,[291 222 290 216 218],435,1,8548,2.7672385885399806,0.0,40.0
7089,1,3089,[276 246 243 315 367],880,4,8552,2.7676375404530744,20.0,0.0
7090,1,3090,[301 232 218 293 259],425,2,8554,2.7673891944354576,0.0,0.0
7091,1,3091,[246 303 392 583 250],276,3,8557,2.7674644243208277,0.0,0.0
7092,1,3092,[315 413 201 293 431],276,3,8560,2.7675396055609442,20.0,0.0
7093,1,3093,[268 211 299 300 222],682,4,8564,2.7679379444085326,0.0,60.0
7094,1,3094,[284 509 452 583 223],201,1,8565,2.767366720516963,20.0,0.0
7095,1,3095,[206 378 219 413 392],727,1,8566,2.766795865633075,0.0,0.0
7096,1,3096,[230 301 583 227 316],425,4,8570,2.7671940587665484,20.0,0.0
7097,1,3097,[431 316 239 212 218],758,3,8573,2.7672692059393156,20.0,0.0
7098,1,3098,[240 222 243 272 254],682,3,8576,2.767344304614392,20.0,20.0
7099,1,3099,[508 413 218 231 268],399,1,8577,2.766774193548387,0.0,20.0
7100,1,3100,[264 220 209 256 216],1,3,8580,2.7668494034182523,0.0,20.0
7101,1,3101,[240 367 230 284 583],16,3,8583,2.766924564796905,0.0,0.0
7102,1,3102,[209 293 230 236 217],758,3,8586,2.766999677731228,0.0,0.0
7103,1,3103,[290 324 218 255 268],303,4,8590,2.767396907216495,0.0,20.0
7104,1,3104,[213 298 208 324 227],758,5,8595,2.7681159420289854,0.0,20.0
7105,1,3105,[208 293 300 485 583],429,2,8597,2.7678686413393434,0.0,20.0
7106,1,3106,[365 392 222 583 232],276,1,8598,2.7672996459607337,0.0,20.0
7107,1,3107,[217 202 240 226 326],130,4,8602,2.7676962676962678,0.0,0.0
7108,1,3108,[264 202 275 508 481],429,3,8605,2.7677709874557737,0.0,0.0
7109,1,3109,[226 583 217 201 272],276,4,8609,2.7681672025723474,20.0,0.0
7110,1,3110,[250 413 230 255 331],435,2,8611,2.7679202828672453,0.0,0.0
7111,1,3111,[211 261 232 272 219],1,0,8611,2.767030848329049,20.0,0.0
7112,1,3112,[431 392 300 217 247],222,3,8614,2.767105685833601,0.0,20.0
7113,1,3113,[508 303 365 392 202],276,3,8617,2.7671804752729607,0.0,0.0
7114,1,3114,[298 293 246 230 241],347,4,8621,2.7675762439807383,0.0,20.0
7115,1,3115,[206 284 241 264 244],268,1,8622,2.7670089858793325,0.0,0.0
7116,1,3116,[298 315 583 331 316],276,4,8626,2.767404555662496,40.0,20.0
7117,1,3117,[217 315 293 365 367],276,3,8629,2.7674791533033996,20.0,0.0
7118,1,3118,[300 583 250 202 478],249,5,8634,2.7681949342738057,20.0,20.0
7119,1,3119,[267 227 299 226 315],130,3,8637,2.768269230769231,20.0,0.0
7120,1,3120,[583 509 298 215 217],682,3,8640,2.768343479653957,0.0,20.0
7121,1,3121,[367 583 230 378 290],429,0,8640,2.7674567584881484,0.0,0.0
7122,1,3122,[218 301 293 209 481],429,2,8642,2.767211015049632,0.0,0.0
7123,1,3123,[236 222 241 298 507],606,2,8644,2.76696542893726,0.0,40.0
7124,1,3124,[420 452 215 232 251],303,4,8648,2.76736,0.0,0.0
7125,1,3125,[256 298 206 384 201],363,1,8649,2.7667946257197698,0.0,20.0
7126,1,3126,[202 268 301 293 227],276,5,8654,2.767508794371602,0.0,20.0
7127,1,3127,[324 284 240 251 301],181,0,8654,2.766624040920716,0.0,0.0
7128,1,3128,[208 246 268 250 226],222,2,8656,2.7663790348354107,0.0,20.0
7129,1,3129,[220 321 222 303 284],181,2,8658,2.7661341853035144,0.0,20.0
7130,1,3130,[290 222 394 316 250],393,4,8662,2.7665282657297987,20.0,20.0
7131,1,3131,[217 508 583 300 365],429,1,8663,2.7659642401021713,0.0,20.0
7132,1,3132,[508 324 264 219 478],327,2,8665,2.765719757421002,20.0,0.0
7133,1,3133,[283 243 246 331 315],919,2,8667,2.765475430759413,20.0,0.0
7134,1,3134,[232 508 392 264 272],276,2,8669,2.765231259968102,20.0,0.0
7135,1,3135,[293 201 250 216 243],682,4,8673,2.765625,0.0,20.0
7136,1,3136,[276 217 230 209 222],276,5,8678,2.7663372649027735,0.0,20.0
7137,1,3137,[331 208 217 202 240],435,4,8682,2.7667304015296366,0.0,0.0
7138,1,3138,[283 218 250 284 255],293,0,8682,2.7658489964956994,0.0,0.0
7139,1,3139,[213 300 331 301 236],758,3,8685,2.765923566878981,0.0,20.0
7140,1,3140,[215 290 301 284 226],363,0,8685,2.7650429799426934,0.0,0.0
7141,1,3141,[301 300 240 293 209],758,1,8686,2.764481222151496,0.0,20.0
7142,1,3142,[583 250 241 293 365],276,3,8689,2.764556156538339,0.0,0.0
7143,1,3143,[326 316 215 206 202],130,4,8693,2.7649491094147582,20.0,0.0
7144,1,3144,[583 431 300 215 384],682,2,8695,2.764705882352941,0.0,20.0
7145,1,3145,[268 241 246 240 452],268,2,8697,2.7644628099173554,0.0,20.0
7146,1,3146,[301 384 213 223 344],758,3,8700,2.7645376549094376,20.0,0.0
7147,1,3147,[280 298 239 284 241],682,3,8703,2.7646124523506987,0.0,20.0
7148,1,3148,[290 236 227 218 420],130,3,8706,2.76468720228644,0.0,0.0
7149,1,3149,[241 246 239 201 284],682,4,8710,2.765079365079365,0.0,0.0
7150,1,3150,[331 216 222 299 276],592,2,8712,2.7648365598222786,0.0,40.0
7151,1,3151,[481 251 283 384 303],299,1,8713,2.764276649746193,0.0,0.0
7152,1,3152,[250 367 246 293 268],682,4,8717,2.7646685696162385,0.0,20.0
7153,1,3153,[208 227 246 507 222],303,3,8720,2.764743183259353,0.0,20.0
7154,1,3154,[209 215 268 298 326],178,4,8724,2.76513470681458,0.0,40.0
7155,1,3155,[431 202 241 255 298],249,4,8728,2.7655259822560203,0.0,20.0
7156,1,3156,[250 246 239 212 220],1,4,8732,2.7659170098194488,0.0,0.0
7157,1,3157,[217 276 321 509 331],201,2,8734,2.765674477517416,0.0,0.0
7158,1,3158,[293 300 202 201 255],919,4,8738,2.766065210509655,0.0,20.0
7159,1,3159,[301 297 213 293 202],758,3,8741,2.766139240506329,0.0,0.0
7160,1,3160,[240 202 324 321 216],201,2,8743,2.7658968680797216,0.0,20.0
7161,1,3161,[250 202 222 367 230],130,3,8746,2.7659709044908287,0.0,20.0
7162,1,3162,[297 293 208 420 344],758,2,8748,2.7657287385393614,0.0,0.0
7163,1,3163,[241 209 268 231 208],1,4,8752,2.766118836915297,0.0,20.0
7164,1,3164,[481 316 291 236 218],758,5,8757,2.766824644549763,20.0,0.0
7165,1,3165,[276 507 264 326 413],303,2,8759,2.766582438408086,0.0,0.0
7166,1,3166,[222 268 315 223 261],919,1,8760,2.7660246289864223,40.0,40.0
7167,1,3167,[290 392 420 267 261],130,4,8764,2.7664141414141414,0.0,0.0
7168,1,3168,[420 218 222 293 251],293,3,8767,2.7664878510571156,0.0,20.0
7169,1,3169,[227 452 223 215 246],303,3,8770,2.7665615141955837,20.0,0.0
7170,1,3170,[316 246 303 268 293],276,5,8775,2.7672658467360454,20.0,20.0
7171,1,3171,[239 293 392 227 394],880,2,8777,2.7670239596469104,0.0,0.0
7172,1,3172,[284 215 226 250 239],682,3,8780,2.7670973841790105,0.0,0.0
7173,1,3173,[298 283 213 303 227],293,2,8782,2.766855702583491,0.0,20.0
7174,1,3174,[239 217 232 222 431],916,1,8783,2.766299212598425,0.0,20.0
7175,1,3175,[321 280 276 326 275],181,1,8784,2.765743073047859,0.0,0.0
7176,1,3176,[215 231 392 239 255],487,3,8787,2.7658168083097263,0.0,0.0
7177,1,3177,[508 240 291 236 300],758,3,8790,2.76589049716803,0.0,20.0
7178,1,3178,[509 284 264 293 227],293,1,8791,2.7653350110097517,0.0,0.0
7179,1,3179,[324 384 268 232 240],276,3,8794,2.7654088050314467,0.0,20.0
7180,1,3180,[300 324 226 239 232],276,4,8798,2.7657969192077965,0.0,20.0
7181,1,3181,[219 321 452 261 350],130,5,8803,2.766499057196732,0.0,0.0
7182,1,3182,[431 280 284 508 291],429,3,8806,2.766572415959786,0.0,0.0
7183,1,3183,[223 508 367 239 254],276,3,8809,2.766645728643216,20.0,0.0
7184,1,3184,[206 326 239 293 201],606,5,8814,2.76734693877551,0.0,0.0
7185,1,3185,[250 212 217 201 216],896,1,8815,2.766792215944758,0.0,20.0
7186,1,3186,[230 202 239 508 250],606,4,8819,2.767179165359272,0.0,0.0
7187,1,3187,[223 300 324 431 284],551,4,8823,2.767565872020075,20.0,20.0
7188,1,3188,[222 201 264 208 246],268,3,8826,2.7676387582314206,0.0,20.0
7189,1,3189,[290 481 485 268 209],747,3,8829,2.7677115987460814,0.0,20.0
7190,1,3190,[243 336 290 324 291],181,0,8829,2.7668442494515824,0.0,0.0
7191,1,3191,[240 230 275 221 223],201,2,8831,2.7666040100250626,20.0,0.0
7192,1,3192,[231 268 291 300 367],497,2,8833,2.7663639210773567,0.0,40.0
7193,1,3193,[216 218 239 241 217],301,2,8835,2.7661239824671258,0.0,20.0
7194,1,3194,[293 365 218 394 301],880,3,8838,2.7661971830985914,0.0,0.0
7195,1,3195,[259 507 378 201 284],727,2,8840,2.765957446808511,0.0,0.0
7196,1,3196,[212 283 251 485 209],299,3,8843,2.766030653737879,0.0,0.0
7197,1,3197,[254 367 394 202 230],880,2,8845,2.765791119449656,0.0,0.0
7198,1,3198,[431 223 222 290 232],363,2,8847,2.7655517349171617,20.0,20.0
7199,1,3199,[222 211 384 303 227],758,5,8852,2.76625,0.0,20.0
7200,1,3200,[250 209 232 216 231],1,3,8855,2.7663230240549828,0.0,20.0
7201,1,3201,[212 297 251 208 508],299,4,8859,2.7667083073079324,0.0,0.0
7202,1,3202,[272 316 240 293 202],276,5,8864,2.7674055572900405,40.0,0.0
7203,1,3203,[221 509 298 222 250],758,4,8868,2.7677902621722845,0.0,40.0
7204,1,3204,[293 223 276 241 324],758,2,8870,2.767550702028081,20.0,0.0
7205,1,3205,[202 392 367 211 230],933,2,8872,2.7673112913287587,0.0,0.0
7206,1,3206,[583 378 232 367 298],682,1,8873,2.766760212036171,0.0,20.0
7207,1,3207,[230 268 241 250 365],222,3,8876,2.766832917705736,0.0,20.0
7208,1,3208,[275 241 227 232 300],896,3,8879,2.7669055780617016,0.0,20.0
7209,1,3209,[268 230 250 326 452],222,3,8882,2.7669781931464175,0.0,20.0
7210,1,3210,[208 583 206 291 218],293,1,8883,2.766427904079726,0.0,0.0
7211,1,3211,[240 227 211 331 301],758,3,8886,2.7665006226650064,0.0,0.0
7212,1,3212,[216 321 299 290 243],130,2,8888,2.7662620603797072,0.0,20.0
7213,1,3213,[264 259 452 202 298],303,2,8890,2.7660236465463597,0.0,20.0
7214,1,3214,[226 227 209 298 246],222,3,8893,2.7660964230171072,0.0,20.0
7215,1,3215,[508 219 299 226 392],130,4,8897,2.7664800995024876,0.0,0.0
7216,1,3216,[251 272 226 216 220],1,2,8899,2.766241840223811,20.0,20.0
7217,1,3217,[201 223 209 291 219],407,5,8904,2.766935985083903,20.0,0.0
7218,1,3218,[216 326 230 431 321],201,1,8905,2.7663870767319043,0.0,20.0
7219,1,3219,[336 303 246 301 344],592,3,8908,2.7664596273291924,0.0,0.0
7220,1,3220,[315 215 316 261 202],130,5,8913,2.767153058056504,40.0,0.0
7221,1,3221,[215 220 283 478 508],178,3,8916,2.7672253258845436,20.0,0.0
7222,1,3222,[264 301 256 275 280],181,1,8917,2.7666770089978283,0.0,0.0
7223,1,3223,[243 350 216 222 250],592,3,8920,2.7667493796526053,0.0,40.0
7224,1,3224,[232 431 331 201 452],201,2,8922,2.7665116279069766,0.0,0.0
7225,1,3225,[290 315 509 222 478],747,3,8925,2.7665840049597024,40.0,20.0
7226,1,3226,[384 583 508 290 227],303,2,8927,2.7663464518128293,0.0,0.0
7227,1,3227,[209 268 223 240 218],303,4,8931,2.766728624535316,20.0,20.0
7228,1,3228,[219 301 508 216 226],327,1,8932,2.766181480334469,0.0,20.0
7229,1,3229,[284 336 299 264 259],181,0,8932,2.765325077399381,0.0,0.0
7230,1,3230,[251 316 230 298 211],293,3,8935,2.765397709687403,20.0,20.0
7231,1,3231,[315 226 392 215 316],130,5,8940,2.766089108910891,40.0,0.0
7232,1,3232,[241 208 222 240 267],1,4,8944,2.766470770182493,0.0,20.0
7233,1,3233,[392 201 230 202 216],94,1,8945,2.7659245516388373,0.0,20.0
7234,1,3234,[507 326 240 452 283],303,1,8946,2.7653786707882535,0.0,0.0
7235,1,3235,[300 255 232 293 259],487,3,8949,2.765451174289246,0.0,20.0
7236,1,3236,[300 208 231 230 215],521,0,8949,2.7645968489341985,0.0,20.0
7237,1,3237,[283 213 251 264 240],293,1,8950,2.7640518838789374,0.0,0.0
7238,1,3238,[583 298 215 367 384],790,2,8952,2.7638159925903056,0.0,20.0
7239,1,3239,[231 284 291 227 295],130,1,8953,2.7632716049382715,0.0,0.0
7240,1,3240,[219 209 221 216 261],1,3,8956,2.763344646713977,0.0,20.0
7241,1,3241,[481 390 478 223 208],747,5,8961,2.7640345465761875,40.0,0.0
7242,1,3242,[272 259 367 201 336],592,3,8964,2.7641073080481036,20.0,0.0
7243,1,3243,[213 509 508 212 300],758,4,8968,2.7644882860665843,0.0,20.0
7244,1,3244,[275 298 283 208 255],500,2,8970,2.764252696456086,0.0,20.0
7245,1,3245,[272 209 232 301 452],425,2,8972,2.7640172520024646,20.0,0.0
7246,1,3246,[222 331 211 241 284],201,1,8973,2.7634739759778255,0.0,20.0
7247,1,3247,[280 201 431 276 384],682,2,8975,2.7632389162561575,0.0,0.0
7248,1,3248,[413 367 239 268 226],130,4,8979,2.7636195752539243,0.0,20.0
7249,1,3249,[232 508 326 218 209],551,5,8984,2.764307692307692,0.0,0.0
7250,1,3250,[284 216 218 208 384],303,4,8988,2.7646877883728083,0.0,20.0
7251,1,3251,[431 236 420 315 213],758,3,8991,2.764760147601476,20.0,0.0
7252,1,3252,[239 300 431 290 217],758,1,8992,2.764217645250538,0.0,20.0
7253,1,3253,[508 230 392 202 300],222,4,8996,2.7645974185617703,0.0,20.0
7254,1,3254,[209 223 201 202 232],682,2,8998,2.764362519201229,20.0,0.0
7255,1,3255,[365 331 264 298 508],276,3,9001,2.7644348894348894,0.0,20.0
7256,1,3256,[384 507 291 413 390],303,1,9002,2.763893153208474,0.0,0.0
7257,1,3257,[255 230 485 297 239],293,1,9003,2.763351749539595,0.0,0.0
7258,1,3258,[259 202 216 209 218],303,4,9007,2.7637312058913777,0.0,20.0
7259,1,3259,[290 261 220 303 240],181,1,9008,2.76319018404908,0.0,0.0
7260,1,3260,[420 240 201 293 367],276,4,9012,2.763569457221711,0.0,0.0
7261,1,3261,[321 326 303 272 344],3,2,9014,2.7633353770692826,20.0,0.0
7262,1,3262,[250 226 211 206 481],896,2,9016,2.763101440392277,0.0,0.0
7263,1,3263,[250 211 299 215 431],435,3,9019,2.763174019607843,0.0,0.0
7264,1,3264,[259 255 283 202 250],393,3,9022,2.7632465543644718,0.0,0.0
7265,1,3265,[230 217 344 232 222],327,3,9025,2.7633190447030005,0.0,20.0
7266,1,3266,[290 378 209 291 246],682,1,9026,2.7627793082338536,0.0,0.0
7267,1,3267,[241 420 226 254 201],682,2,9028,2.7625458996328027,0.0,0.0
7268,1,3268,[276 236 583 208 298],303,4,9032,2.762924441725298,0.0,20.0
7269,1,3269,[219 218 216 420 206],435,3,9035,2.7629969418960245,0.0,20.0
7270,1,3270,[384 230 299 250 226],880,2,9037,2.76276368083155,0.0,0.0
7271,1,3271,[283 206 226 384 209],727,0,9037,2.761919315403423,0.0,0.0
7272,1,3272,[331 275 231 202 284],201,2,9039,2.761686526122823,0.0,0.0
7273,1,3273,[268 508 300 295 250],178,3,9042,2.761759315821625,0.0,40.0
7274,1,3274,[202 240 394 211 431],435,3,9045,2.761832061068702,0.0,0.0
7275,1,3275,[212 215 507 243 222],561,1,9046,2.7612942612942613,0.0,20.0
7276,1,3276,[295 293 259 246 291],592,3,9049,2.76136710405859,0.0,0.0
7277,1,3277,[202 367 226 232 246],682,2,9051,2.7611348383160466,0.0,0.0
7278,1,3278,[508 300 293 250 201],303,4,9055,2.7615126562976515,0.0,20.0
7279,1,3279,[222 218 217 392 300],880,3,9058,2.7615853658536587,0.0,40.0
7280,1,3280,[298 365 392 232 315],276,2,9060,2.761353245961597,20.0,20.0
7281,1,3281,[272 300 290 299 255],682,2,9062,2.761121267519805,20.0,20.0
7282,1,3282,[227 298 218 413 321],435,2,9064,2.7608894303990255,0.0,20.0
7283,1,3283,[326 246 223 202 222],305,1,9065,2.7603532277710108,20.0,20.0
7284,1,3284,[315 420 243 290 272],393,3,9068,2.760426179604262,40.0,0.0
7285,1,3285,[272 202 275 206 508],201,2,9070,2.76019476567255,20.0,0.0
7286,1,3286,[223 202 431 254 209],682,2,9072,2.7599634925463947,20.0,0.0
7287,1,3287,[201 431 268 365 227],94,3,9075,2.7600364963503647,0.0,20.0
7288,1,3288,[291 217 420 384 212],758,3,9078,2.7601094557616297,0.0,0.0
7289,1,3289,[365 367 254 241 255],682,1,9079,2.7595744680851064,0.0,0.0
7290,1,3290,[236 246 230 290 583],303,3,9082,2.759647523549073,0.0,0.0
7291,1,3291,[232 227 240 293 202],880,4,9086,2.7600243013365735,0.0,0.0
7292,1,3292,[206 217 315 243 261],130,2,9088,2.759793501366535,20.0,0.0
7293,1,3293,[264 331 268 295 218],919,2,9090,2.759562841530055,0.0,20.0
7294,1,3294,[331 350 231 300 315],130,3,9093,2.7596358118361155,20.0,20.0
7295,1,3295,[300 284 206 215 290],293,2,9095,2.7594053398058254,0.0,20.0
7296,1,3296,[232 300 215 392 247],222,4,9099,2.7597816196542313,0.0,20.0
7297,1,3297,[243 272 259 583 209],682,1,9100,2.7592480291085506,20.0,0.0
7298,1,3298,[291 298 508 264 290],276,3,9103,2.7593210063655653,0.0,20.0
7299,1,3299,[583 365 254 215 219],276,2,9105,2.7590909090909093,0.0,0.0
7300,1,3300,[290 230 216 246 268],347,3,9108,2.7591638897303845,0.0,40.0
7301,1,3301,[218 239 280 431 509],682,1,9109,2.758631132646881,0.0,0.0
7302,1,3302,[300 231 240 217 209],222,2,9111,2.7584014532243417,0.0,20.0
7303,1,3303,[365 298 367 239 209],682,1,9112,2.7578692493946733,0.0,20.0
7304,1,3304,[209 367 250 222 583],327,2,9114,2.7576399394856277,0.0,20.0
7305,1,3305,[209 226 331 215 259],178,4,9118,2.7580157289776164,0.0,0.0
7306,1,3306,[276 420 216 208 230],303,4,9122,2.7583912912004838,0.0,20.0
7307,1,3307,[298 232 219 300 254],682,1,9123,2.7578597339782345,0.0,40.0
7308,1,3308,[232 365 208 246 240],790,3,9126,2.757932910244787,0.0,0.0
7309,1,3309,[222 324 276 227 250],276,5,9131,2.7586102719033234,0.0,20.0
7310,1,3310,[431 227 223 384 316],758,4,9135,2.758985200845666,40.0,0.0
7311,1,3311,[222 367 452 431 227],276,2,9137,2.758756038647343,0.0,20.0
7312,1,3312,[217 300 290 420 239],682,1,9138,2.758225173558708,0.0,20.0
7313,1,3313,[218 583 324 201 202],276,4,9142,2.7585998792999398,0.0,0.0
7314,1,3314,[300 208 378 293 239],222,2,9144,2.758371040723982,0.0,20.0
7315,1,3315,[223 508 232 222 206],201,2,9146,2.7581423401688783,20.0,20.0
7316,1,3316,[295 508 215 420 315],532,4,9150,2.758516731986735,20.0,0.0
7317,1,3317,[241 392 227 230 508],347,2,9152,2.758288125376733,0.0,0.0
7318,1,3318,[365 254 583 211 217],682,2,9154,2.758059656523049,0.0,0.0
7319,1,3319,[211 276 275 508 230],429,4,9158,2.758433734939759,0.0,0.0
7320,1,3320,[244 250 218 384 583],268,3,9161,2.7585064739536285,0.0,0.0
7321,1,3321,[290 507 227 216 303],293,3,9164,2.7585791691751957,0.0,20.0
7322,1,3322,[217 378 222 481 365],429,1,9165,2.7580499548600663,0.0,20.0
7323,1,3323,[240 254 420 239 267],130,4,9169,2.7584235860409145,0.0,0.0
7324,1,3324,[367 303 240 315 413],276,3,9172,2.7584962406015037,20.0,0.0
7325,1,3325,[240 230 217 250 272],130,2,9174,2.7582681900180397,20.0,0.0
7326,1,3326,[280 226 223 216 241],347,3,9177,2.75834084761046,20.0,20.0
7327,1,3327,[230 241 583 223 208],429,2,9179,2.758112980769231,20.0,0.0
7328,1,3328,[254 206 202 217 367],276,3,9182,2.758185641333734,0.0,0.0
7329,1,3329,[259 222 272 392 336],514,4,9186,2.7585585585585584,20.0,20.0
7330,1,3330,[243 275 239 485 431],393,3,9189,2.7586310417292106,0.0,0.0
7331,1,3331,[259 291 230 384 378],727,2,9191,2.758403361344538,0.0,0.0
7332,1,3332,[231 223 316 300 268],276,4,9195,2.758775877587759,40.0,40.0
7333,1,3333,[255 241 254 231 272],1,1,9196,2.758248350329934,20.0,0.0
7334,1,3334,[201 223 227 240 231],201,3,9199,2.7583208395802097,20.0,0.0
7335,1,3335,[244 231 232 264 223],268,2,9201,2.758093525179856,20.0,0.0
7336,1,3336,[301 268 272 261 300],587,3,9204,2.758166017380881,20.0,40.0
7337,1,3337,[208 336 216 211 202],514,3,9207,2.7582384661473935,0.0,20.0
7338,1,3338,[268 384 215 303 276],276,4,9211,2.7586103623839473,0.0,20.0
7339,1,3339,[316 350 208 300 221],758,3,9214,2.758682634730539,20.0,20.0
7340,1,3340,[452 291 236 240 212],758,3,9217,2.7587548638132295,0.0,0.0
7341,1,3341,[251 236 321 223 298],303,4,9221,2.7591262716935967,20.0,20.0
7342,1,3342,[264 452 250 255 326],303,2,9223,2.7588991923422075,0.0,0.0
7343,1,3343,[254 220 202 250 222],1,3,9226,2.7589712918660285,0.0,20.0
7344,1,3344,[226 216 247 244 231],1,1,9227,2.7584454409566517,0.0,20.0
7345,1,3345,[276 256 202 367 215],916,1,9228,2.757919904363419,0.0,0.0
7346,1,3346,[223 220 230 232 259],178,3,9231,2.757992231849417,20.0,0.0
7347,1,3347,[452 221 259 284 507],303,3,9234,2.7580645161290325,0.0,0.0
7348,1,3348,[227 485 241 250 219],429,1,9235,2.7575395640489697,0.0,0.0
7349,1,3349,[218 283 276 293 297],919,5,9240,2.7582089552238807,0.0,0.0
7350,1,3350,[202 221 431 276 222],916,2,9242,2.757982691733811,0.0,20.0
7351,1,3351,[276 268 223 246 219],399,0,9242,2.757159904534606,20.0,20.0
7352,1,3352,[231 429 293 230 365],276,3,9245,2.7572323292573815,0.0,0.0
7353,1,3353,[218 251 241 222 206],1,4,9249,2.757602862254025,0.0,20.0
7354,1,3354,[209 211 272 384 241],682,3,9252,2.7576751117734726,20.0,0.0
7355,1,3355,[216 250 218 324 223],303,4,9256,2.7580452920143026,20.0,20.0
7356,1,3356,[321 300 236 250 226],303,3,9259,2.7581173666964554,0.0,20.0
7357,1,3357,[378 240 384 217 201],727,1,9260,2.7575938058368075,0.0,0.0
7358,1,3358,[291 298 230 300 326],332,5,9265,2.758261387317654,0.0,40.0
7359,1,3359,[217 222 452 231 239],222,2,9267,2.758035714285714,0.0,20.0
7360,1,3360,[211 268 316 223 429],747,5,9272,2.758702767033621,40.0,20.0
7361,1,3361,[331 244 268 321 221],919,2,9274,2.7584770969660917,0.0,20.0
7362,1,3362,[213 283 478 241 240],299,2,9276,2.7582515611061553,20.0,0.0
7363,1,3363,[219 250 220 230 227],1,3,9279,2.758323424494649,0.0,0.0
7364,1,3364,[315 508 276 295 240],880,5,9284,2.7589895988112927,20.0,0.0
7365,1,3365,[223 227 275 507 301],429,3,9287,2.759061200237671,20.0,0.0
7366,1,3366,[232 230 283 284 211],727,1,9288,2.7585387585387586,0.0,0.0
7367,1,3367,[365 211 254 218 509],682,1,9289,2.758016627078385,0.0,0.0
7368,1,3368,[268 295 215 232 259],178,3,9292,2.7580884535470465,0.0,20.0
7369,1,3369,[276 202 298 241 261],222,3,9295,2.758160237388724,0.0,20.0
7370,1,3370,[255 202 315 250 272],592,5,9300,2.758825274399288,40.0,0.0
7371,1,3371,[231 290 217 239 267],130,2,9302,2.758600237247924,0.0,0.0
7372,1,3372,[276 268 209 218 431],276,4,9306,2.7589682774977766,0.0,20.0
7373,1,3373,[219 211 378 280 226],682,1,9307,2.7584469472436277,0.0,0.0
7374,1,3374,[413 508 324 293 272],276,4,9311,2.758814814814815,20.0,0.0
7375,1,3375,[250 300 283 284 507],293,1,9312,2.758293838862559,0.0,20.0
7376,1,3376,[280 367 218 295 392],880,3,9315,2.75836541308854,0.0,0.0
7377,1,3377,[251 300 232 413 321],303,2,9317,2.7581409117821196,0.0,20.0
7378,1,3378,[315 236 209 240 217],758,3,9320,2.758212488902042,20.0,0.0
7379,1,3379,[509 303 239 215 300],293,2,9322,2.7579881656804734,0.0,20.0
7380,1,3380,[208 223 236 324 508],303,4,9326,2.7583555161194915,20.0,0.0
7381,1,3381,[202 251 261 301 223],592,3,9329,2.758426966292135,20.0,0.0
7382,1,3382,[209 239 240 583 255],249,3,9332,2.7584983742240614,0.0,0.0
7383,1,3383,[283 216 223 290 268],303,4,9336,2.7588652482269502,20.0,40.0
7384,1,3384,[413 420 236 206 231],130,2,9338,2.7586410635155096,0.0,0.0
7385,1,3385,[272 218 223 365 300],551,5,9343,2.7593030124040165,40.0,20.0
7386,1,3386,[331 264 299 367 295],592,2,9345,2.759078830823738,0.0,0.0
7387,1,3387,[420 202 299 384 219],301,3,9348,2.759149940968123,0.0,0.0
7388,1,3388,[276 216 202 222 201],201,3,9351,2.759221009147241,0.0,40.0
7389,1,3389,[276 336 284 236 508],181,0,9351,2.758407079646018,0.0,0.0
7390,1,3390,[301 255 508 251 299],592,3,9354,2.7584783249778826,0.0,0.0
7391,1,3391,[221 209 256 241 212],916,3,9357,2.7585495283018866,0.0,0.0
7392,1,3392,[217 324 230 222 301],425,3,9360,2.7586206896551726,0.0,20.0
7393,1,3393,[244 293 298 431 300],178,3,9363,2.758691809074838,0.0,40.0
7394,1,3394,[240 216 222 226 208],790,1,9364,2.7581737849779087,0.0,40.0
7395,1,3395,[219 215 221 213 222],201,2,9366,2.7579505300353357,0.0,20.0
7396,1,3396,[284 240 272 367 303],919,3,9369,2.7580217839269943,20.0,0.0
7397,1,3397,[298 255 508 223 276],592,5,9374,2.7586815773984696,20.0,20.0
7398,1,3398,[283 227 202 230 246],303,2,9376,2.7584583701088556,0.0,0.0
7399,1,3399,[583 420 202 509 255],293,1,9377,2.757941176470588,0.0,0.0
7400,1,3400,[246 241 209 268 365],94,4,9381,2.7583063804763306,0.0,20.0
7401,1,3401,[232 218 209 208 201],303,5,9386,2.75896531452087,0.0,0.0
7402,1,3402,[211 508 326 275 212],201,3,9389,2.7590361445783134,0.0,0.0
7403,1,3403,[378 255 264 240 298],299,1,9390,2.7585193889541717,0.0,20.0
7404,1,3404,[230 429 250 301 384],363,1,9391,2.7580029368575625,0.0,0.0
7405,1,3405,[255 326 223 261 202],919,2,9393,2.7577803875513798,20.0,0.0
7406,1,3406,[283 236 246 201 218],919,4,9397,2.7581449955973,0.0,0.0
7407,1,3407,[507 583 301 222 216],429,3,9400,2.7582159624413145,0.0,40.0
7408,1,3408,[226 256 259 219 272],1,1,9401,2.757700205338809,20.0,0.0
7409,1,3409,[344 350 223 216 326],592,5,9406,2.758357771260997,20.0,20.0
7410,1,3410,[378 299 201 276 222],682,3,9409,2.7584286133098797,0.0,20.0
7411,1,3411,[280 326 336 244 254],697,2,9411,2.75820633059789,0.0,0.0
7412,1,3412,[222 283 226 507 208],429,3,9414,2.7582771755054205,0.0,20.0
7413,1,3413,[508 298 268 301 326],592,4,9418,2.7586408904510837,0.0,40.0
7414,1,3414,[230 206 219 316 324],276,5,9423,2.7592972181551976,20.0,0.0
7415,1,3415,[215 255 239 209 208],293,1,9424,2.758782201405152,0.0,0.0
7416,1,3416,[413 227 230 290 215],130,1,9425,2.758267486098917,0.0,0.0
7417,1,3417,[367 315 316 216 301],532,4,9429,2.758630778232885,40.0,20.0
7418,1,3418,[218 250 384 239 583],682,1,9430,2.758116408306522,0.0,0.0
7419,1,3419,[283 295 239 230 243],880,2,9432,2.7578947368421054,0.0,0.0
7420,1,3420,[240 201 227 384 268],303,2,9434,2.7576731949722304,0.0,20.0
7421,1,3421,[321 217 367 230 293],327,2,9436,2.7574517825832845,0.0,0.0
7422,1,3422,[220 275 268 326 240],181,1,9437,2.756938358165352,0.0,20.0
7423,1,3423,[326 208 241 321 221],303,3,9440,2.7570093457943927,0.0,0.0
7424,1,3424,[331 219 226 217 291],435,5,9445,2.757664233576642,0.0,0.0
7425,1,3425,[240 293 324 231 392],276,3,9448,2.757734967892586,0.0,0.0
7426,1,3426,[223 300 365 507 217],429,2,9450,2.757513860519405,20.0,20.0
7427,1,3427,[215 268 367 236 246],303,5,9455,2.7581680280046674,0.0,20.0
7428,1,3428,[201 217 365 223 250],94,4,9459,2.758530183727034,20.0,0.0
7429,1,3429,[255 226 222 240 384],472,4,9463,2.7588921282798835,0.0,20.0
7430,1,3430,[217 298 303 201 392],276,4,9467,2.7592538618478577,0.0,20.0
7431,1,3431,[219 259 268 283 208],303,3,9470,2.7593240093240095,0.0,20.0
7432,1,3432,[429 384 290 246 222],276,4,9474,2.759685406350131,0.0,20.0
7433,1,3433,[206 276 250 583 508],276,4,9478,2.7600465928945837,0.0,0.0
7434,1,3434,[284 384 431 208 241],790,2,9480,2.7598253275109172,0.0,0.0
7435,1,3435,[215 291 298 223 251],303,4,9484,2.760186263096624,20.0,20.0
7436,1,3436,[223 239 244 206 246],1,4,9488,2.760546988652895,20.0,0.0
7437,1,3437,[276 217 215 254 211],682,3,9491,2.7606166375799885,0.0,0.0
7438,1,3438,[324 236 300 219 250],303,3,9494,2.7606862460017445,0.0,20.0
7439,1,3439,[231 232 216 291 280],487,3,9497,2.7607558139534882,0.0,20.0
7440,1,3440,[481 291 324 298 236],758,5,9502,2.761406567858181,0.0,20.0
7441,1,3441,[413 246 222 583 326],303,1,9503,2.76089482858803,0.0,20.0
7442,1,3442,[239 300 420 481 284],301,3,9506,2.760964275341272,0.0,20.0
7443,1,3443,[420 215 217 300 365],682,2,9508,2.7607433217189317,0.0,20.0
7444,1,3444,[222 326 261 508 243],181,1,9509,2.7602322206095793,0.0,20.0
7445,1,3445,[315 293 246 299 290],130,3,9512,2.760301799187464,20.0,0.0
7446,1,3446,[276 230 219 236 231],130,3,9515,2.760371337394836,0.0,0.0
7447,1,3447,[259 324 336 216 215],592,3,9518,2.7604408352668215,0.0,20.0
7448,1,3448,[509 222 301 297 324],758,4,9522,2.7608002319512903,0.0,20.0
7449,1,3449,[221 264 276 431 272],592,3,9525,2.760869565217391,20.0,0.0
7450,1,3450,[295 298 268 420 291],130,4,9529,2.7612286293827877,0.0,40.0
7451,1,3451,[300 227 209 583 215],276,4,9533,2.7615874855156433,0.0,20.0
7452,1,3452,[365 378 420 485 255],393,2,9535,2.7613669273095858,0.0,0.0
7453,1,3453,[246 240 378 275 507],727,1,9536,2.760856977417487,0.0,0.0
7454,1,3454,[431 227 250 392 291],276,2,9538,2.7606367583212736,0.0,0.0
7455,1,3455,[201 222 216 230 202],886,2,9540,2.7604166666666665,0.0,40.0
7456,1,3456,[243 246 218 378 232],682,1,9541,2.7599074341914953,0.0,0.0
7457,1,3457,[219 230 255 246 336],327,3,9544,2.759976865240023,0.0,0.0
7458,1,3458,[220 283 300 259 298],178,2,9546,2.7597571552471813,0.0,40.0
7459,1,3459,[429 226 301 452 231],276,3,9549,2.7598265895953755,0.0,0.0
7460,1,3460,[250 215 413 218 221],303,4,9553,2.760184917653857,0.0,0.0
7461,1,3461,[223 324 268 246 236],592,4,9557,2.76054303870595,20.0,20.0
7462,1,3462,[246 240 316 295 239],130,4,9561,2.7609009529309847,20.0,0.0
7463,1,3463,[276 300 268 230 272],130,4,9565,2.761258660508083,20.0,40.0
7464,1,3464,[215 251 283 231 583],303,3,9568,2.7613275613275614,0.0,0.0
7465,1,3465,[392 276 303 215 481],747,4,9572,2.7616849394114253,0.0,0.0
7466,1,3466,[315 431 216 250 241],484,3,9575,2.7617536775310065,20.0,20.0
7467,1,3467,[276 283 232 202 508],429,4,9579,2.7621107266435985,0.0,0.0
7468,1,3468,[226 392 481 208 250],429,1,9580,2.761602767368118,0.0,0.0
7469,1,3469,[240 284 239 222 583],682,3,9583,2.761671469740634,0.0,20.0
7470,1,3470,[392 276 217 280 232],222,3,9586,2.7617401325266493,0.0,0.0
7471,1,3471,[251 250 240 221 254],1,3,9589,2.7618087557603688,0.0,0.0
7472,1,3472,[216 276 508 284 326],201,3,9592,2.7618773394759573,0.0,20.0
7473,1,3473,[241 243 268 284 255],682,3,9595,2.7619458837075417,0.0,20.0
7474,1,3474,[209 230 324 211 241],268,3,9598,2.7620143884892085,0.0,0.0
7475,1,3475,[223 230 239 209 202],1,5,9603,2.7626582278481013,20.0,0.0
7476,1,3476,[392 367 255 215 222],130,5,9608,2.7633016968651134,0.0,20.0
7477,1,3477,[216 254 413 392 206],130,2,9610,2.7630822311673375,0.0,20.0
7478,1,3478,[211 208 227 215 232],846,3,9613,2.763150330554757,0.0,0.0
7479,1,3479,[217 223 321 222 326],201,1,9614,2.7626436781609196,20.0,20.0
7480,1,3480,[219 217 222 284 268],435,3,9617,2.76271186440678,0.0,40.0
7481,1,3481,[268 226 209 201 420],94,4,9621,2.763067202757036,0.0,20.0
7482,1,3482,[239 206 272 231 247],1,2,9623,2.7628481194372667,20.0,0.0
7483,1,3483,[272 507 283 215 243],393,3,9626,2.7629161882893225,20.0,0.0
7484,1,3484,[232 507 367 231 219],561,1,9627,2.7624103299856526,0.0,0.0
7485,1,3485,[239 413 217 394 218],435,3,9630,2.7624784853700515,0.0,0.0
7486,1,3486,[276 365 232 280 219],429,3,9633,2.762546601663321,0.0,0.0
7487,1,3487,[290 202 215 208 218],303,5,9638,2.7631880733944953,0.0,0.0
7488,1,3488,[240 246 206 250 215],521,2,9640,2.762969332186873,0.0,0.0
7489,1,3489,[326 223 227 276 507],303,3,9643,2.7630372492836677,20.0,0.0
7490,1,3490,[291 264 326 350 223],592,3,9646,2.763105127470639,20.0,0.0
7491,1,3491,[324 301 300 321 508],181,0,9646,2.7623138602520045,0.0,20.0
7492,1,3492,[215 209 230 251 226],293,2,9648,2.7620956198110505,0.0,0.0
7493,1,3493,[240 250 392 230 255],472,5,9653,2.762736119061248,0.0,0.0
7494,1,3494,[365 268 326 219 227],551,5,9658,2.763376251788269,0.0,20.0
7495,1,3495,[321 295 250 255 272],936,3,9661,2.7634439359267735,20.0,0.0
7496,1,3496,[378 227 223 275 283],429,2,9663,2.7632256219616815,20.0,0.0
7497,1,3497,[223 212 268 431 217],889,4,9667,2.76357918810749,20.0,20.0
7498,1,3498,[222 213 298 241 251],299,3,9670,2.763646756216062,0.0,40.0
7499,1,3499,[243 240 232 241 230],1,2,9672,2.7634285714285713,0.0,0.0
7500,1,3500,[384 420 324 272 239],758,3,9675,2.763496143958869,20.0,0.0
7501,1,3501,[261 222 367 201 223],919,3,9678,2.7635636778983437,20.0,20.0
7502,1,3502,[217 213 378 268 222],790,2,9680,2.7633457036825577,0.0,40.0
7503,1,3503,[255 226 507 283 284],293,1,9681,2.7628424657534247,0.0,0.0
7504,1,3504,[231 583 201 315 331],276,3,9684,2.7629101283880173,20.0,0.0
7505,1,3505,[331 326 246 251 201],592,4,9688,2.7632629777524245,0.0,0.0
7506,1,3506,[215 222 276 227 239],347,4,9692,2.763615625891075,0.0,20.0
7507,1,3507,[246 240 216 232 293],682,4,9696,2.7639680729760547,0.0,20.0
7508,1,3508,[216 509 331 326 280],551,4,9700,2.7643203191792534,0.0,20.0
7509,1,3509,[216 290 276 246 300],130,4,9704,2.7646723646723648,0.0,40.0
7510,1,3510,[290 230 291 300 284],130,2,9706,2.7644545713471946,0.0,20.0
7511,1,3511,[392 230 284 217 301],429,0,9706,2.7636674259681095,0.0,0.0
7512,1,3512,[227 485 272 315 250],293,1,9707,2.763165385710219,40.0,0.0
7513,1,3513,[244 250 291 508 226],407,3,9710,2.763232783153102,0.0,0.0
7514,1,3514,[259 508 485 420 226],532,4,9714,2.7635846372688477,0.0,0.0
7515,1,3515,[202 243 239 413 268],130,3,9717,2.763651877133106,0.0,20.0
7516,1,3516,[232 202 230 211 227],916,1,9718,2.763150412283196,0.0,0.0
7517,1,3517,[230 217 276 241 211],916,4,9722,2.763501989766913,0.0,0.0
7518,1,3518,[201 331 344 261 276],592,3,9725,2.76356919579426,0.0,0.0
7519,1,3519,[230 268 223 232 315],551,5,9730,2.7642045454545454,40.0,20.0
7520,1,3520,[226 222 232 206 240],276,4,9734,2.764555523998864,0.0,20.0
7521,1,3521,[230 240 284 316 251],293,1,9735,2.7640545144804087,20.0,0.0
7522,1,3522,[283 331 275 431 280],178,5,9740,2.764689185353392,0.0,0.0
7523,1,3523,[264 283 226 413 300],303,1,9741,2.764188422247446,0.0,20.0
7524,1,3524,[298 232 583 255 268],327,2,9743,2.7639716312056737,0.0,40.0
7525,1,3525,[275 208 209 250 509],293,0,9743,2.763187748156551,0.0,0.0
7526,1,3526,[293 246 268 216 299],592,4,9747,2.763538417918911,0.0,40.0
7527,1,3527,[301 295 298 244 321],21,3,9750,2.7636054421768708,0.0,20.0
7528,1,3528,[284 230 218 226 413],399,1,9751,2.7631056956644944,0.0,0.0
7529,1,3529,[326 222 255 220 316],178,4,9755,2.763456090651558,20.0,20.0
7530,1,3530,[413 231 239 315 261],130,3,9758,2.763523081280091,20.0,0.0
7531,1,3531,[202 246 230 244 239],1,4,9762,2.763873159682899,0.0,0.0
7532,1,3532,[509 208 222 583 293],293,1,9763,2.763373903198415,0.0,20.0
7533,1,3533,[231 227 218 209 261],1,2,9765,2.763157894736842,0.0,0.0
7534,1,3534,[275 507 321 226 290],429,2,9767,2.762942008486563,0.0,0.0
7535,1,3535,[239 226 268 508 300],222,3,9770,2.7630090497737556,0.0,40.0
7536,1,3536,[216 202 256 261 215],1,3,9773,2.763076053152389,0.0,20.0
7537,1,3537,[297 509 431 384 208],758,4,9777,2.763425664217072,0.0,0.0
7538,1,3538,[478 336 264 216 201],327,2,9779,2.7632099463125175,20.0,20.0
7539,1,3539,[259 250 508 331 431],532,3,9782,2.7632768361581923,0.0,0.0
7540,1,3540,[215 275 222 213 241],201,2,9784,2.7630612821236937,0.0,20.0
7541,1,3541,[217 250 509 280 239],916,3,9787,2.7631281761716546,0.0,0.0
7542,1,3542,[298 276 392 420 206],130,4,9791,2.76347727914197,0.0,20.0
7543,1,3543,[291 232 303 208 246],889,2,9793,2.7632618510158014,0.0,0.0
7544,1,3544,[222 206 213 240 247],1,2,9795,2.763046544428773,0.0,20.0
7545,1,3545,[240 394 254 246 331],435,3,9798,2.763113367174281,0.0,0.0
7546,1,3546,[367 293 255 365 291],682,1,9799,2.762616295460953,0.0,0.0
7547,1,3547,[390 221 507 268 222],303,3,9802,2.762683201803833,0.0,40.0
7548,1,3548,[246 218 202 241 232],682,3,9805,2.762750070442378,0.0,0.0
7549,1,3549,[301 243 216 209 215],514,3,9808,2.7628169014084505,0.0,20.0
7550,1,3550,[212 227 254 221 226],1,3,9811,2.762883694733878,0.0,0.0
7551,1,3551,[230 276 227 264 431],429,2,9813,2.762668918918919,0.0,0.0
7552,1,3552,[485 216 429 209 217],660,2,9815,2.7624542640022516,0.0,20.0
7553,1,3553,[241 217 384 280 223],682,2,9817,2.762239729881823,20.0,0.0
7554,1,3554,[247 272 209 226 246],1,2,9819,2.7620253164556963,20.0,0.0
7555,1,3555,[420 246 241 259 211],682,3,9822,2.762092238470191,0.0,0.0
7556,1,3556,[420 384 583 413 209],303,2,9824,2.761877987067754,0.0,0.0
7557,1,3557,[236 452 321 384 241],303,2,9826,2.761663856098932,0.0,0.0
7558,1,3558,[216 324 508 478 431],327,1,9827,2.761168867659455,20.0,20.0
7559,1,3559,[226 280 431 290 201],429,1,9828,2.7606741573033706,0.0,0.0
7560,1,3560,[222 429 303 211 293],293,4,9832,2.761022184779556,0.0,20.0
7561,1,3561,[420 211 290 208 283],293,2,9834,2.7608085345311624,0.0,0.0
7562,1,3562,[230 392 508 367 240],222,2,9836,2.7605950042099354,0.0,0.0
7563,1,3563,[509 291 250 264 218],293,0,9836,2.759820426487093,0.0,0.0
7564,1,3564,[324 303 452 217 213],758,3,9839,2.759887798036466,0.0,0.0
7565,1,3565,[413 315 202 324 227],276,4,9843,2.760235558048233,20.0,0.0
7566,1,3566,[331 297 239 216 211],758,4,9847,2.76058312307261,0.0,20.0
7567,1,3567,[201 219 276 231 392],429,2,9849,2.7603699551569507,0.0,0.0
7568,1,3568,[215 216 239 232 300],896,3,9852,2.760437097226114,0.0,40.0
7569,1,3569,[509 241 295 276 298],916,3,9855,2.7605042016806722,0.0,20.0
7570,1,3570,[206 222 219 509 218],868,1,9856,2.7600112013441613,0.0,20.0
7571,1,3571,[239 216 300 378 367],487,4,9860,2.7603583426651737,0.0,40.0
7572,1,3572,[254 217 420 232 431],472,4,9864,2.760705289672544,0.0,0.0
7573,1,3573,[221 240 297 250 272],758,3,9867,2.760772243984331,20.0,0.0
7574,1,3574,[250 384 301 209 227],276,4,9871,2.761118881118881,0.0,0.0
7575,1,3575,[299 231 226 321 298],130,3,9874,2.761185682326622,0.0,20.0
7576,1,3576,[390 365 211 217 268],94,4,9878,2.7615320100642995,0.0,20.0
7577,1,3577,[209 272 259 243 431],660,4,9882,2.761878144214645,20.0,0.0
7578,1,3578,[222 284 250 275 431],896,3,9885,2.7619446772841574,0.0,20.0
7579,1,3579,[222 326 350 283 303],592,4,9889,2.762290502793296,0.0,20.0
7580,1,3580,[254 283 218 293 316],880,3,9892,2.7623568835520804,20.0,0.0
7581,1,3581,[222 485 217 290 367],429,1,9893,2.7618648799553323,0.0,20.0
7582,1,3582,[261 293 226 243 300],130,4,9897,2.7622104381802957,0.0,20.0
7583,1,3583,[226 291 264 241 208],429,2,9899,2.761997767857143,0.0,0.0
7584,1,3584,[293 216 509 251 208],293,3,9902,2.7620641562064154,0.0,20.0
7585,1,3585,[378 219 223 232 218],399,1,9903,2.7615727830451755,20.0,0.0
7586,1,3586,[378 384 215 254 276],682,1,9904,2.7610816838583774,0.0,0.0
7587,1,3587,[201 222 297 350 295],592,4,9908,2.761426978818283,0.0,20.0
7588,1,3588,[226 365 222 392 240],880,3,9911,2.7614934522151016,0.0,20.0
7589,1,3589,[326 392 272 243 284],130,3,9914,2.761559888579387,20.0,0.0
7590,1,3590,[420 321 331 291 211],435,4,9918,2.761904761904762,0.0,0.0
7591,1,3591,[226 290 251 321 231],303,4,9922,2.7622494432071267,0.0,0.0
7592,1,3592,[367 315 284 208 295],880,5,9927,2.762872251600334,20.0,0.0
7593,1,3593,[231 227 508 268 221],303,4,9931,2.763216471897607,0.0,20.0
7594,1,3594,[452 241 284 267 244],268,1,9932,2.7627260083449237,0.0,0.0
7595,1,3595,[284 255 420 299 222],435,2,9934,2.7625139043381535,0.0,20.0
7596,1,3596,[244 239 267 201 261],1,2,9936,2.762301918265221,0.0,0.0
7597,1,3597,[315 251 291 264 240],293,1,9937,2.761812117843246,20.0,0.0
7598,1,3598,[264 392 241 254 365],276,1,9938,2.7613225896082243,0.0,0.0
7599,1,3599,[230 213 217 216 240],1,2,9940,2.761111111111111,0.0,20.0
7600,1,3600,[507 227 246 324 583],303,2,9942,2.760899750069425,0.0,0.0
7601,1,3601,[324 246 227 201 239],303,2,9944,2.7606885063853417,0.0,0.0
7602,1,3602,[290 295 216 222 254],130,2,9946,2.7604773799611433,0.0,40.0
7603,1,3603,[223 255 227 232 222],222,3,9949,2.7605438401775806,20.0,20.0
7604,1,3604,[276 316 300 254 226],880,3,9952,2.760610263522885,20.0,20.0
7605,1,3605,[216 276 583 326 202],303,3,9955,2.7606766500277318,0.0,20.0
7606,1,3606,[290 324 215 331 301],276,5,9960,2.761297477127807,0.0,0.0
7607,1,3607,[478 209 268 485 365],846,4,9964,2.761640798226164,20.0,20.0
7608,1,3608,[508 367 326 250 261],222,1,9965,2.7611526738708783,0.0,0.0
7609,1,3609,[240 241 284 300 276],551,4,9969,2.761495844875346,0.0,20.0
7610,1,3610,[206 291 222 261 350],130,4,9973,2.761838825810025,0.0,20.0
7611,1,3611,[268 221 251 350 201],592,5,9978,2.762458471760797,0.0,20.0
7612,1,3612,[244 251 255 240 254],1,1,9979,2.7619706615001385,0.0,0.0
7613,1,3613,[507 268 485 231 392],747,2,9981,2.761759822910902,0.0,20.0
7614,1,3614,[300 284 227 250 222],276,5,9986,2.7623789764868603,0.0,40.0
7615,1,3615,[508 226 284 220 255],178,3,9989,2.762444690265487,0.0,0.0
7616,1,3616,[290 367 316 227 394],393,3,9992,2.762510367708045,20.0,0.0
7617,1,3617,[209 431 227 222 223],276,4,9996,2.7628524046434495,20.0,20.0
7618,1,3618,[218 264 206 232 216],363,0,9996,2.762088974854932,0.0,20.0
7619,1,3619,[321 227 206 268 216],435,3,9999,2.7621546961325967,0.0,40.0
7620,1,3620,[298 240 420 452 300],276,4,10003,2.7624965479149406,0.0,40.0
7621,1,3621,[208 290 226 223 291],303,4,10007,2.762838210933186,20.0,0.0
7622,1,3622,[223 250 291 202 321],393,3,10010,2.7629036709908914,20.0,0.0
7623,1,3623,[223 212 218 413 365],291,4,10014,2.763245033112583,20.0,0.0
7624,1,3624,[250 291 227 367 331],276,3,10017,2.763310344827586,0.0,0.0
7625,1,3625,[272 344 291 246 251],592,4,10021,2.7636514065085493,20.0,0.0
7626,1,3626,[431 215 509 209 232],551,5,10026,2.764267990074442,0.0,0.0
7627,1,3627,[324 236 217 384 303],758,4,10030,2.7646085997794927,0.0,0.0
7628,1,3628,[226 230 283 202 300],429,1,10031,2.7641223477542023,0.0,20.0
7629,1,3629,[250 219 284 216 384],896,2,10033,2.7639118457300276,0.0,20.0
7630,1,3630,[218 261 250 452 284],222,1,10034,2.7634260534288075,0.0,0.0
7631,1,3631,[216 321 226 276 303],201,2,10036,2.763215859030837,0.0,20.0
7632,1,3632,[255 344 316 241 321],393,3,10039,2.7632810349573353,20.0,0.0
7633,1,3633,[336 251 250 216 221],592,4,10043,2.763621353880022,0.0,20.0
7634,1,3634,[283 301 507 284 211],429,2,10045,2.763411279229711,0.0,0.0
7635,1,3635,[298 222 231 232 227],497,0,10045,2.7626512651265127,0.0,40.0
7636,1,3636,[300 218 392 272 295],880,3,10048,2.7627165246081935,20.0,20.0
7637,1,3637,[283 326 420 293 367],303,3,10051,2.762781748213304,0.0,0.0
7638,1,3638,[218 240 226 209 202],622,3,10054,2.7628469359714205,0.0,0.0
7639,1,3639,[420 218 215 276 241],276,5,10059,2.7634615384615384,0.0,0.0
7640,1,3640,[231 240 241 217 326],201,0,10059,2.7627025542433397,0.0,0.0
7641,1,3641,[394 268 291 392 367],435,3,10062,2.7627677100494235,0.0,20.0
7642,1,3642,[365 321 392 223 275],429,2,10064,2.7625583310458413,20.0,0.0
7643,1,3643,[583 272 284 276 226],276,4,10068,2.7628979143798023,20.0,0.0
7644,1,3644,[300 222 295 291 275],459,4,10072,2.7632373113854594,0.0,40.0
7645,1,3645,[378 293 239 420 290],682,1,10073,2.7627537026878772,0.0,0.0
7646,1,3646,[231 201 243 230 284],880,2,10075,2.762544557170277,0.0,0.0
7647,1,3647,[222 219 264 211 239],327,1,10076,2.762061403508772,0.0,20.0
7648,1,3648,[384 244 255 209 367],870,2,10078,2.7618525623458483,0.0,0.0
7649,1,3649,[209 255 275 297 213],293,1,10079,2.7613698630136985,0.0,0.0
7650,1,3650,[231 293 324 250 283],303,3,10082,2.7614352232265134,0.0,0.0
7651,1,3651,[240 301 209 431 231],276,3,10085,2.761500547645126,0.0,0.0
7652,1,3652,[324 206 272 215 275],201,2,10087,2.761292088694224,20.0,0.0
7653,1,3653,[367 217 218 226 413],435,2,10089,2.7610837438423643,0.0,0.0
7654,1,3654,[276 231 217 218 299],880,4,10093,2.761422708618331,0.0,0.0
7655,1,3655,[254 301 231 284 250],880,2,10095,2.761214442013129,0.0,0.0
7656,1,3656,[324 431 250 246 299],592,3,10098,2.7612797374897458,0.0,0.0
7657,1,3657,[268 202 413 392 300],276,3,10101,2.761344997266266,0.0,40.0
7658,1,3658,[300 284 230 507 264],293,1,10102,2.7608636239409674,0.0,20.0
7659,1,3659,[583 291 219 222 232],429,4,10106,2.76120218579235,0.0,20.0
7660,1,3660,[431 208 227 250 255],435,3,10109,2.7612674132750614,0.0,0.0
7661,1,3661,[293 268 508 261 250],592,4,10113,2.761605679956308,0.0,20.0
7662,1,3662,[420 298 344 227 230],758,3,10116,2.7616707616707616,0.0,20.0
7663,1,3663,[284 280 206 291 209],293,1,10117,2.7611899563318776,0.0,0.0
7664,1,3664,[293 301 239 350 208],363,2,10119,2.760982264665757,0.0,0.0
7665,1,3665,[297 350 209 223 315],758,5,10124,2.761593016912166,40.0,0.0
7666,1,3666,[221 251 250 272 236],592,4,10128,2.7619307335696757,20.0,0.0
7667,1,3667,[212 213 217 208 209],758,4,10132,2.76226826608506,0.0,0.0
7668,1,3668,[230 316 326 431 331],551,5,10137,2.7628781684382666,20.0,0.0
7669,1,3669,[367 272 222 275 240],919,3,10140,2.7629427792915533,20.0,20.0
7670,1,3670,[284 226 331 227 392],130,2,10142,2.7627349496050124,0.0,0.0
7671,1,3671,[508 331 283 261 321],919,3,10145,2.7627995642701526,0.0,0.0
7672,1,3672,[218 267 243 272 300],130,4,10149,2.7631364007623196,20.0,20.0
7673,1,3673,[268 321 240 217 276],919,2,10151,2.7629286880783885,0.0,20.0
7674,1,3674,[367 227 246 240 221],303,3,10154,2.7629931972789117,0.0,0.0
7675,1,3675,[211 293 264 226 301],327,0,10154,2.762241566920566,0.0,0.0
7676,1,3676,[291 344 324 316 202],758,4,10158,2.762578188740821,20.0,0.0
7677,1,3677,[384 202 367 206 201],435,3,10161,2.7626427406199023,0.0,0.0
7678,1,3678,[230 244 246 255 247],1,2,10163,2.762435444414243,0.0,0.0
7679,1,3679,[303 268 365 583 209],276,3,10166,2.7625,0.0,20.0
7680,1,3680,[301 240 392 303 215],276,4,10170,2.762836185819071,0.0,0.0
7681,1,3681,[283 276 326 300 239],303,1,10171,2.7623574144486693,0.0,20.0
7682,1,3682,[240 284 251 259 222],181,1,10172,2.7618789030681508,0.0,20.0
7683,1,3683,[452 251 507 583 264],303,2,10174,2.761672095548317,0.0,0.0
7684,1,3684,[315 300 272 303 230],758,4,10178,2.7620081411126187,40.0,20.0
7685,1,3685,[250 240 216 226 384],497,1,10179,2.7615301139446555,0.0,20.0
7686,1,3686,[212 211 239 256 202],1,4,10183,2.7618660157309467,0.0,0.0
7687,1,3687,[230 316 240 259 295],532,3,10186,2.761930585683297,20.0,0.0
7688,1,3688,[227 208 413 261 219],222,1,10187,2.761452968284088,0.0,0.0
7689,1,3689,[209 367 336 298 301],286,5,10192,2.762059620596206,0.0,20.0
7690,1,3690,[264 232 508 420 324],276,3,10195,2.762124085613655,0.0,0.0
7691,1,3691,[485 211 222 232 290],293,1,10196,2.7616468039003252,0.0,20.0
7692,1,3692,[215 367 298 218 251],303,5,10201,2.762252910912537,0.0,20.0
7693,1,3693,[239 227 226 218 413],303,2,10203,2.76204656199242,0.0,0.0
7694,1,3694,[431 583 284 230 290],429,1,10204,2.7615696887686063,0.0,0.0
7695,1,3695,[275 227 367 280 300],429,1,10205,2.7610930735930737,0.0,20.0
7696,1,3696,[219 431 217 392 272],660,2,10207,2.760887205842575,20.0,0.0
7697,1,3697,[431 365 231 206 209],276,2,10209,2.7606814494321257,0.0,0.0
7698,1,3698,[222 261 202 247 232],222,3,10212,2.7607461476074615,0.0,20.0
7699,1,3699,[284 508 218 264 452],399,1,10213,2.7602702702702704,0.0,0.0
7700,1,3700,[367 244 583 213 216],916,4,10217,2.7606052418265334,0.0,20.0
7701,1,3701,[222 276 297 315 250],758,4,10221,2.760940032414911,20.0,20.0
7702,1,3702,[226 218 221 452 420],303,4,10225,2.7612746421820145,0.0,0.0
7703,1,3703,[240 215 231 208 255],1,1,10226,2.7607991360691146,0.0,0.0
7704,1,3704,[508 413 240 298 394],497,1,10227,2.760323886639676,0.0,20.0
7705,1,3705,[211 298 206 300 272],293,4,10231,2.7606583917970857,20.0,40.0
7706,1,3706,[268 222 226 231 227],222,2,10233,2.7604531966549772,0.0,40.0
7707,1,3707,[217 485 367 291 509],293,0,10233,2.7597087378640777,0.0,0.0
7708,1,3708,[208 255 392 218 206],435,2,10235,2.759503909409544,0.0,0.0
7709,1,3709,[509 227 508 250 206],94,4,10239,2.7598382749326147,0.0,0.0
7710,1,3710,[583 301 216 231 321],429,1,10240,2.7593640528159527,0.0,20.0
7711,1,3711,[280 227 240 365 316],880,2,10242,2.7591594827586206,20.0,0.0
7712,1,3712,[217 429 392 202 431],896,1,10243,2.7586856988957718,0.0,0.0
7713,1,3713,[241 267 250 217 231],268,2,10245,2.758481421647819,0.0,0.0
7714,1,3714,[485 208 239 272 298],660,2,10247,2.7582772543741587,20.0,20.0
7715,1,3715,[250 239 264 216 283],303,2,10249,2.7580731969860066,0.0,20.0
7716,1,3716,[290 431 413 240 232],276,2,10251,2.7578692493946733,0.0,0.0
7717,1,3717,[276 213 222 290 272],758,4,10255,2.758203335126412,20.0,20.0
7718,1,3718,[239 246 226 413 276],303,3,10258,2.758268351707448,0.0,0.0
7719,1,3719,[213 324 211 321 509],201,2,10260,2.7580645161290325,0.0,0.0
7720,1,3720,[291 240 365 215 290],682,2,10262,2.7578607901101853,0.0,0.0
7721,1,3721,[232 217 250 392 431],727,3,10265,2.7579258463191834,0.0,0.0
7722,1,3722,[218 284 392 209 583],429,1,10266,2.757453666398066,0.0,0.0
7723,1,3723,[264 216 217 583 481],429,1,10267,2.7569817400644467,0.0,20.0
7724,1,3724,[264 298 344 508 272],592,4,10271,2.7573154362416106,20.0,20.0
7725,1,3725,[246 284 315 202 272],276,5,10276,2.7579173376274824,40.0,0.0
7726,1,3726,[384 232 299 284 202],880,4,10280,2.75825060370271,0.0,0.0
7727,1,3727,[209 275 478 244 367],178,4,10284,2.7585836909871246,20.0,0.0
7728,1,3728,[208 251 215 254 272],1,2,10286,2.7583802628050416,20.0,0.0
7729,1,3729,[216 283 298 316 223],500,3,10289,2.758445040214477,40.0,40.0
7730,1,3730,[246 384 284 367 239],880,4,10293,2.758777807558295,0.0,0.0
7731,1,3731,[226 508 326 290 217],130,3,10296,2.7588424437299035,0.0,0.0
7732,1,3732,[206 247 259 219 217],1,1,10297,2.7583712831502814,0.0,0.0
7733,1,3733,[301 239 255 431 209],327,1,10298,2.7579003749330475,0.0,0.0
7734,1,3734,[272 219 392 315 429],660,3,10301,2.7579651941097723,40.0,0.0
7735,1,3735,[507 209 413 390 324],303,2,10303,2.757762312633833,0.0,0.0
7736,1,3736,[222 485 283 226 231],790,1,10304,2.757291945410757,0.0,20.0
7737,1,3737,[384 201 478 367 300],896,2,10306,2.7570893525949707,20.0,20.0
7738,1,3738,[280 209 316 326 230],551,4,10310,2.7574217705268786,20.0,0.0
7739,1,3739,[226 213 208 231 365],790,2,10312,2.7572192513368985,0.0,0.0
7740,1,3740,[301 300 244 452 324],425,1,10313,2.756749532210639,0.0,20.0
7741,1,3741,[211 280 217 284 240],682,4,10317,2.7570817744521645,0.0,0.0
7742,1,3742,[298 222 261 217 268],130,4,10321,2.757413839166444,0.0,60.0
7743,1,3743,[326 219 295 284 246],178,4,10325,2.7577457264957266,0.0,0.0
7744,1,3744,[230 218 202 291 232],407,4,10329,2.7580774365821097,0.0,0.0
7745,1,3745,[299 202 218 420 264],435,3,10332,2.758142018152696,0.0,0.0
7746,1,3746,[202 283 290 241 478],249,4,10336,2.758473445423005,20.0,0.0
7747,1,3747,[239 212 283 336 384],363,1,10337,2.7580042689434365,0.0,0.0
7748,1,3748,[211 209 208 264 280],429,3,10340,2.7580688183515605,0.0,0.0
7749,1,3749,[202 226 223 367 250],222,2,10342,2.7578666666666667,20.0,0.0
7750,1,3750,[272 481 298 420 213],758,4,10346,2.758197813916289,20.0,20.0
7751,1,3751,[291 226 239 326 324],303,1,10347,2.75772921108742,0.0,0.0
7752,1,3752,[218 431 429 232 240],276,3,10350,2.7577937649880098,0.0,0.0
7753,1,3753,[295 290 211 215 256],916,1,10351,2.7573255194459243,0.0,0.0
7754,1,3754,[230 267 222 246 213],1,4,10355,2.7576564580559255,0.0,20.0
7755,1,3755,[326 232 293 275 280],178,5,10360,2.7582534611288603,0.0,0.0
7756,1,3756,[293 284 365 276 202],222,3,10363,2.7583178067607133,0.0,0.0
7757,1,3757,[232 250 326 208 261],222,2,10365,2.7581160191591274,0.0,0.0
7758,1,3758,[290 215 420 264 255],435,1,10366,2.7576483107209366,0.0,0.0
7759,1,3759,[230 202 392 246 315],130,4,10370,2.757978723404255,20.0,0.0
7760,1,3760,[201 202 226 208 221],303,5,10375,2.758574847115129,0.0,0.0
7761,1,3761,[301 268 240 276 239],276,5,10380,2.759170653907496,0.0,20.0
7762,1,3762,[583 223 226 202 280],551,3,10383,2.759234653202232,20.0,0.0
7763,1,3763,[508 272 227 201 291],276,4,10387,2.7595642933049946,20.0,0.0
7764,1,3764,[208 365 316 222 239],880,4,10391,2.759893758300133,20.0,20.0
7765,1,3765,[420 290 239 250 298],435,4,10395,2.7602230483271377,0.0,20.0
7766,1,3766,[226 291 223 239 241],347,4,10399,2.7605521635253516,20.0,0.0
7767,1,3767,[201 264 219 431 222],435,2,10401,2.7603503184713376,0.0,20.0
7768,1,3768,[344 290 324 216 316],758,4,10405,2.760679225258689,20.0,20.0
7769,1,3769,[255 206 272 227 226],1,2,10407,2.760477453580902,20.0,0.0
7770,1,3770,[336 201 326 283 508],592,4,10411,2.7608061522142666,0.0,0.0
7771,1,3771,[230 227 367 216 211],94,2,10413,2.760604453870626,0.0,20.0
7772,1,3772,[217 284 272 298 232],293,2,10415,2.7604028624436787,20.0,20.0
7773,1,3773,[276 222 216 219 223],864,5,10420,2.760996290408055,20.0,40.0
7774,1,3774,[227 300 222 216 213],758,4,10424,2.761324503311258,0.0,60.0
7775,1,3775,[321 219 230 222 324],201,2,10426,2.761122881355932,0.0,20.0
7776,1,3776,[420 219 261 230 413],130,3,10429,2.7611861265554674,0.0,0.0
7777,1,3777,[420 316 293 452 509],758,2,10431,2.7609846479618847,20.0,0.0
7778,1,3778,[246 216 298 583 290],682,3,10434,2.7610478962688543,0.0,40.0
7779,1,3779,[316 324 321 299 326],663,3,10437,2.761111111111111,20.0,0.0
7780,1,3780,[216 206 303 315 219],201,2,10439,2.7609098122189897,20.0,20.0
7781,1,3781,[264 367 261 222 508],919,2,10441,2.7607086197778954,0.0,20.0
7782,1,3782,[227 239 219 244 291],407,3,10444,2.760771874173936,0.0,0.0
7783,1,3783,[240 452 413 218 231],495,3,10447,2.7608350951374208,0.0,0.0
7784,1,3784,[250 209 202 301 365],880,2,10449,2.760634081902246,0.0,0.0
7785,1,3785,[384 429 365 222 298],276,3,10452,2.7606973058637085,0.0,40.0
7786,1,3786,[201 583 290 367 240],682,2,10454,2.76049643517296,0.0,0.0
7787,1,3787,[217 350 216 250 384],758,4,10458,2.7608236536430835,0.0,20.0
7788,1,3788,[331 261 215 231 236],130,3,10461,2.7608867775138557,0.0,0.0
7789,1,3789,[255 218 298 241 299],682,3,10464,2.7609498680738787,0.0,20.0
7790,1,3790,[215 222 254 206 367],130,3,10467,2.761012925349512,0.0,20.0
7791,1,3791,[202 485 452 219 431],846,4,10471,2.7613396624472575,0.0,0.0
7792,1,3792,[272 420 290 202 280],293,2,10473,2.761138940152913,20.0,0.0
7793,1,3793,[384 243 280 217 250],682,2,10475,2.760938323668951,0.0,0.0
7794,1,3794,[246 290 241 217 301],244,3,10478,2.7610013175230566,0.0,0.0
7795,1,3795,[206 211 429 297 239],293,4,10482,2.761327713382508,0.0,0.0
7796,1,3796,[300 232 367 201 283],303,3,10485,2.761390571503819,0.0,20.0
7797,1,3797,[239 219 230 240 212],201,2,10487,2.761190100052659,0.0,0.0
7798,1,3798,[221 202 216 231 201],216,3,10490,2.761252961305607,0.0,20.0
7799,1,3799,[232 226 431 222 246],94,2,10492,2.761052631578947,0.0,20.0
7800,1,3800,[290 301 219 217 211],429,2,10494,2.7608524072612473,0.0,0.0
7801,1,3801,[298 209 291 217 321],429,3,10497,2.7609153077327724,0.0,20.0
7802,1,3802,[290 222 298 226 392],435,2,10499,2.7607152248225084,0.0,40.0
7803,1,3803,[326 250 324 215 321],303,2,10501,2.760515247108307,0.0,0.0
7804,1,3804,[217 431 246 240 508],222,2,10503,2.7603153745072273,0.0,0.0
7805,1,3805,[384 218 216 240 212],773,1,10504,2.759852863899107,0.0,20.0
7806,1,3806,[243 227 326 300 254],130,2,10506,2.7596532702915684,0.0,20.0
7807,1,3807,[217 246 283 268 241],790,4,10510,2.759978991596639,0.0,20.0
7808,1,3808,[250 290 223 218 232],293,1,10511,2.759516933578367,20.0,0.0
7809,1,3809,[420 300 301 241 290],758,1,10512,2.7590551181102363,0.0,20.0
7810,1,3810,[295 230 350 316 202],130,3,10515,2.7591183416426133,20.0,0.0
7811,1,3811,[232 217 392 254 293],880,3,10518,2.7591815320041975,0.0,0.0
7812,1,3812,[232 216 240 215 264],551,3,10521,2.759244689221086,0.0,20.0
7813,1,3813,[413 221 216 202 326],201,1,10522,2.7587834294703724,0.0,20.0
7814,1,3814,[227 226 239 211 291],293,1,10523,2.758322411533421,0.0,0.0
7815,1,3815,[509 365 268 478 208],846,4,10527,2.7586477987421385,20.0,20.0
7816,1,3816,[232 378 202 276 280],222,3,10530,2.7587110296044015,0.0,0.0
7817,1,3817,[211 365 240 431 384],682,3,10533,2.7587742273441593,0.0,0.0
7818,1,3818,[378 211 365 367 222],682,2,10535,2.758575543335952,0.0,20.0
7819,1,3819,[291 264 218 219 209],551,4,10539,2.7589005235602095,0.0,0.0
7820,1,3820,[452 250 226 201 583],303,3,10542,2.7589636220884586,0.0,0.0
7821,1,3821,[298 216 290 219 267],130,4,10546,2.759288330716902,0.0,40.0
7822,1,3822,[223 209 241 508 215],201,2,10548,2.759089720115093,20.0,0.0
7823,1,3823,[250 217 298 230 384],435,3,10551,2.759152719665272,0.0,20.0
7824,1,3824,[321 240 300 206 420],435,2,10553,2.758954248366013,0.0,20.0
7825,1,3825,[413 291 367 246 211],435,3,10556,2.7590172503920543,0.0,0.0
7826,1,3826,[241 246 247 378 227],222,1,10557,2.758557616932323,0.0,0.0
7827,1,3827,[431 232 268 211 509],94,4,10561,2.7588819226750263,0.0,20.0
7828,1,3828,[295 209 298 246 431],916,1,10562,2.7584225646382867,0.0,20.0
7829,1,3829,[290 243 226 227 326],130,2,10564,2.75822454308094,0.0,0.0
7830,1,3830,[284 223 232 226 239],268,1,10565,2.757765596450013,20.0,0.0
7831,1,3831,[420 367 378 246 215],682,2,10567,2.7575678496868474,0.0,0.0
7832,1,3832,[365 208 217 290 201],429,1,10568,2.7571093138533787,0.0,0.0
7833,1,3833,[254 290 218 241 429],276,4,10572,2.757433489827856,0.0,0.0
7834,1,3834,[508 452 241 206 231],276,3,10575,2.757496740547588,0.0,0.0
7835,1,3835,[223 293 211 226 315],293,3,10578,2.7575599582898853,40.0,0.0
7836,1,3836,[215 284 217 298 431],363,1,10579,2.757101902528017,0.0,20.0
7837,1,3837,[275 232 300 239 217],293,0,10579,2.756383533090151,0.0,20.0
7838,1,3838,[254 331 227 246 268],435,4,10583,2.7567074759051837,0.0,20.0
7839,1,3839,[267 241 220 268 212],1,4,10587,2.75703125,0.0,20.0
7840,1,3840,[293 222 264 303 283],293,2,10589,2.7568341577714137,0.0,20.0
7841,1,3841,[255 226 206 211 216],1,2,10591,2.756637168141593,0.0,20.0
7842,1,3842,[201 243 218 226 222],1,1,10592,2.7561800676554773,0.0,20.0
7843,1,3843,[215 293 243 254 246],130,3,10595,2.7562434963579605,0.0,0.0
7844,1,3844,[280 232 478 283 215],178,5,10600,2.756827048114434,20.0,0.0
7845,1,3845,[226 583 222 209 413],201,0,10600,2.7561102444097765,0.0,20.0
7846,1,3846,[508 291 300 226 295],130,4,10604,2.7564335846113854,0.0,20.0
7847,1,3847,[394 230 208 201 215],864,3,10607,2.7564968814968815,0.0,0.0
7848,1,3848,[216 508 583 223 231],429,3,10610,2.756560145492336,20.0,20.0
7849,1,3849,[283 202 259 222 365],790,1,10611,2.756103896103896,0.0,20.0
7850,1,3850,[216 212 240 255 384],299,2,10613,2.7559075564788365,0.0,20.0
7851,1,3851,[217 264 209 429 284],276,4,10617,2.7562305295950154,0.0,0.0
7852,1,3852,[211 315 326 223 231],201,1,10618,2.755774720996626,40.0,0.0
7853,1,3853,[213 232 209 261 223],1,2,10620,2.7555786196159833,20.0,0.0
7854,1,3854,[291 255 202 246 264],592,3,10623,2.7556420233463035,0.0,0.0
7855,1,3855,[255 291 298 222 221],303,3,10626,2.7557053941908713,0.0,40.0
7856,1,3856,[218 254 222 211 226],545,3,10629,2.755768732175266,0.0,20.0
7857,1,3857,[211 202 208 301 255],500,2,10631,2.755572835666148,0.0,0.0
7858,1,3858,[255 367 226 218 254],472,5,10636,2.7561544441565173,0.0,0.0
7859,1,3859,[232 280 226 431 583],429,2,10638,2.755958549222798,0.0,0.0
7860,1,3860,[280 316 206 298 303],293,3,10641,2.756021756021756,20.0,20.0
7861,1,3861,[420 208 216 218 276],758,3,10644,2.7560849300880372,0.0,20.0
7862,1,3862,[301 298 508 216 316],532,5,10649,2.756665803779446,20.0,40.0
7863,1,3863,[212 291 208 239 431],889,3,10652,2.756728778467909,0.0,0.0
7864,1,3864,[295 344 246 326 223],592,5,10657,2.757309184993532,20.0,0.0
7865,1,3865,[201 283 284 250 227],303,3,10660,2.7573719606828764,0.0,0.0
7866,1,3866,[222 202 268 583 324],201,2,10662,2.757176105508146,0.0,40.0
7867,1,3867,[268 239 272 222 431],305,1,10663,2.7567218200620474,20.0,40.0
7868,1,3868,[326 315 344 295 283],592,5,10668,2.7573016283277334,20.0,0.0
7869,1,3869,[259 226 236 250 211],1,2,10670,2.757105943152455,0.0,0.0
7870,1,3870,[367 240 508 223 324],303,3,10673,2.7571686902609147,20.0,0.0
7871,1,3871,[324 219 230 218 326],201,3,10676,2.7572314049586777,0.0,0.0
7872,1,3872,[212 211 291 367 223],896,3,10679,2.7572940872708496,20.0,0.0
7873,1,3873,[250 284 316 222 420],293,1,10680,2.7568404749612805,20.0,20.0
7874,1,3874,[255 201 272 243 221],592,4,10684,2.7571612903225806,20.0,0.0
7875,1,3875,[298 202 276 293 209],429,5,10689,2.7577399380804954,0.0,20.0
7876,1,3876,[303 324 209 284 268],201,2,10691,2.757544493164818,0.0,20.0
7877,1,3877,[227 215 246 300 315],276,5,10696,2.7581227436823106,20.0,20.0
7878,1,3878,[250 420 283 509 251],293,2,10698,2.7579273008507346,0.0,0.0
7879,1,3879,[301 226 222 392 413],276,3,10701,2.7579896907216495,0.0,20.0
7880,1,3880,[202 226 239 509 218],201,1,10702,2.7575367173408916,0.0,0.0
7881,1,3881,[283 326 331 431 508],178,4,10706,2.7578567748583205,0.0,0.0
7882,1,3882,[326 247 255 240 231],222,1,10707,2.7574040690187998,0.0,0.0
7883,1,3883,[268 241 230 240 509],551,4,10711,2.7577239958805357,0.0,20.0
7884,1,3884,[276 583 324 420 241],303,3,10714,2.7577863577863577,0.0,0.0
7885,1,3885,[293 222 392 316 301],880,4,10718,2.7581060216160576,20.0,20.0
7886,1,3886,[268 331 295 275 255],178,4,10722,2.758425520967327,0.0,20.0
7887,1,3887,[230 431 212 209 298],622,3,10725,2.7584876543209877,0.0,20.0
7888,1,3888,[291 232 230 250 217],407,4,10729,2.758806891231679,0.0,0.0
7889,1,3889,[300 206 231 241 216],521,2,10731,2.7586118251928022,0.0,40.0
7890,1,3890,[384 298 246 326 208],303,3,10734,2.758673862760216,0.0,20.0
7891,1,3891,[272 206 303 227 420],393,3,10737,2.7587358684480985,20.0,0.0
7892,1,3892,[219 216 413 217 478],495,5,10742,2.759311584895967,20.0,20.0
7893,1,3893,[216 264 344 259 255],592,3,10745,2.7593733949666155,0.0,20.0
7894,1,3894,[331 276 264 241 226],551,4,10749,2.759691912708601,0.0,0.0
7895,1,3895,[208 216 239 367 276],336,2,10751,2.7594969199178645,0.0,20.0
7896,1,3896,[324 298 219 246 221],303,4,10755,2.759815242494226,0.0,20.0
7897,1,3897,[232 208 211 298 215],286,4,10759,2.7601334017444845,0.0,20.0
7898,1,3898,[241 218 226 413 283],303,3,10762,2.760194921774814,0.0,0.0
7899,1,3899,[230 256 293 384 208],363,2,10764,2.76,0.0,0.0
7900,1,3900,[293 264 485 284 213],293,1,10765,2.759548833632402,0.0,0.0
7901,1,3901,[230 211 452 239 219],868,0,10765,2.7588416196822143,0.0,0.0
7902,1,3902,[275 250 272 251 298],286,5,10770,2.759415833973866,20.0,20.0
7903,1,3903,[231 367 452 209 212],896,1,10771,2.7589651639344264,0.0,0.0
7904,1,3904,[291 226 367 290 420],435,3,10774,2.759026888604353,0.0,0.0
7905,1,3905,[236 212 222 315 223],758,5,10779,2.759600614439324,40.0,20.0
7906,1,3906,[232 211 384 215 420],682,2,10781,2.75940619401075,0.0,0.0
7907,1,3907,[211 218 215 259 212],1,1,10782,2.7589559877175027,0.0,0.0
7908,1,3908,[226 201 231 324 331],201,3,10785,2.7590176515732923,0.0,0.0
7909,1,3909,[216 293 218 222 239],303,3,10788,2.759079283887468,0.0,40.0
7910,1,3910,[298 202 303 209 232],889,1,10789,2.7586295065200717,0.0,20.0
7911,1,3911,[250 344 315 213 217],758,3,10792,2.7586912065439675,20.0,0.0
7912,1,3912,[246 261 290 239 217],130,3,10795,2.758752875031945,0.0,0.0
7913,1,3913,[202 212 230 223 232],896,2,10797,2.7585590189064897,20.0,0.0
7914,1,3914,[316 217 241 315 297],758,3,10800,2.7586206896551726,40.0,0.0
7915,1,3915,[247 244 226 246 230],1,2,10802,2.758426966292135,0.0,0.0
7916,1,3916,[283 216 509 291 209],293,1,10803,2.757978044421751,0.0,20.0
7917,1,3917,[367 508 316 413 300],130,4,10807,2.7582950484941295,20.0,20.0
7918,1,3918,[219 295 209 284 290],916,0,10807,2.757591222250574,0.0,0.0
7919,1,3919,[298 420 259 280 276],682,1,10808,2.757142857142857,0.0,20.0
7920,1,3920,[481 508 298 241 293],758,3,10811,2.7572047946952307,0.0,20.0
7921,1,3921,[293 201 290 239 202],276,5,10816,2.7577766445690974,0.0,0.0
7922,1,3922,[216 215 431 378 226],472,5,10821,2.7583482029059394,0.0,20.0
7923,1,3923,[284 206 221 222 256],916,1,10822,2.7579001019367992,0.0,20.0
7924,1,3924,[452 284 272 227 413],130,2,10824,2.7577070063694267,20.0,0.0
7925,1,3925,[481 219 250 201 276],301,4,10828,2.758023433520122,0.0,0.0
7926,1,3926,[283 290 291 215 202],303,3,10831,2.7580850522026994,0.0,0.0
7927,1,3927,[384 240 218 420 246],291,5,10836,2.758655804480652,0.0,0.0
7928,1,3928,[216 208 202 231 211],1,3,10839,2.758717230847544,0.0,20.0
7929,1,3929,[201 384 284 209 239],276,4,10843,2.759033078880407,0.0,0.0
7930,1,3930,[221 202 226 215 275],201,1,10844,2.7585856016280843,0.0,0.0
7931,1,3931,[227 216 231 276 246],222,3,10847,2.758646998982706,0.0,20.0
7932,1,3932,[431 222 583 232 217],327,1,10848,2.7581998474446987,0.0,20.0
7933,1,3933,[298 244 202 223 218],916,2,10850,2.7580071174377223,20.0,20.0
7934,1,3934,[240 211 583 202 241],201,0,10850,2.7573062261753494,0.0,0.0
7935,1,3935,[239 230 223 259 267],1,4,10854,2.7576219512195124,20.0,0.0
7936,1,3936,[226 215 392 276 218],130,5,10859,2.758191516383033,0.0,0.0
7937,1,3937,[209 212 213 227 202],1,4,10863,2.7585068562722195,0.0,0.0
7938,1,3938,[206 218 227 217 232],268,1,10864,2.758060421426758,0.0,0.0
7939,1,3939,[268 227 326 259 283],303,1,10865,2.7576142131979697,0.0,20.0
7940,1,3940,[284 365 508 212 231],291,3,10868,2.757675716823141,0.0,0.0
7941,1,3941,[508 326 264 367 250],303,3,10871,2.7577371892440388,0.0,0.0
7942,1,3942,[240 290 508 300 293],130,4,10875,2.7580522444838955,0.0,20.0
7943,1,3943,[384 209 509 316 276],758,4,10879,2.758367139959432,20.0,0.0
7944,1,3944,[202 216 583 236 232],916,3,10882,2.7584283903675537,0.0,20.0
7945,1,3945,[295 394 276 367 280],880,3,10885,2.7584896097313734,0.0,0.0
7946,1,3946,[280 216 392 261 300],222,3,10888,2.758550798074487,0.0,40.0
7947,1,3947,[261 246 367 300 301],919,2,10890,2.7583586626139818,0.0,20.0
7948,1,3948,[315 316 217 295 230],130,2,10892,2.758166624461889,40.0,0.0
7949,1,3949,[264 290 283 250 280],293,0,10892,2.75746835443038,0.0,0.0
7950,1,3950,[481 280 321 208 201],429,1,10893,2.757023538344723,0.0,0.0
7951,1,3951,[299 267 217 226 206],130,2,10895,2.756831983805668,0.0,0.0
7952,1,3952,[223 211 243 220 212],1,2,10897,2.756640526182646,20.0,0.0
7953,1,3953,[222 284 244 326 331],697,4,10901,2.7569549822964086,0.0,20.0
7954,1,3954,[250 231 268 236 324],303,4,10905,2.757269279393173,0.0,20.0
7955,1,3955,[227 413 202 420 254],246,2,10907,2.757077856420627,0.0,0.0
7956,1,3956,[236 241 216 268 267],1,5,10912,2.7576446803133687,0.0,40.0
7957,1,3957,[211 202 226 378 507],846,3,10915,2.7577059120768066,0.0,0.0
7958,1,3958,[326 240 365 272 230],551,4,10919,2.7580197019449355,20.0,0.0
7959,1,3959,[303 509 202 219 239],201,1,10920,2.757575757575758,0.0,0.0
7960,1,3960,[231 264 202 230 218],472,4,10924,2.7578894218631658,0.0,0.0
7961,1,3961,[222 508 275 300 478],178,4,10928,2.758202927814235,20.0,40.0
7962,1,3962,[223 316 268 478 293],178,5,10933,2.758768609639162,60.0,20.0
7963,1,3963,[213 283 251 202 222],293,1,10934,2.75832492431887,0.0,20.0
7964,1,3964,[232 222 241 215 413],222,3,10937,2.7583858764186635,0.0,20.0
7965,1,3965,[429 392 241 481 478],896,4,10941,2.758698940998487,20.0,0.0
7966,1,3966,[216 298 222 316 230],363,2,10943,2.758507688429544,20.0,60.0
7967,1,3967,[259 217 431 378 215],682,3,10946,2.758568548387097,0.0,0.0
7968,1,3968,[290 216 583 215 219],303,4,10950,2.758881330309902,0.0,20.0
7969,1,3969,[272 236 268 300 250],919,3,10953,2.758942065491184,20.0,40.0
7970,1,3970,[508 485 208 276 301],429,3,10956,2.7590027700831024,0.0,0.0
7971,1,3971,[218 298 255 293 226],293,2,10958,2.7588116817724067,0.0,20.0
7972,1,3972,[215 301 259 331 240],532,3,10961,2.7588723886232067,0.0,0.0
7973,1,3973,[392 298 202 413 217],130,3,10964,2.758933064921993,0.0,20.0
7974,1,3974,[508 217 485 230 218],943,3,10967,2.758993710691824,0.0,0.0
7975,1,3975,[246 209 256 202 211],916,2,10969,2.7588028169014085,0.0,0.0
7976,1,3976,[365 268 331 218 276],276,4,10973,2.759114910736736,0.0,20.0
7977,1,3977,[219 268 326 509 226],551,5,10978,2.7596782302664655,0.0,20.0
7978,1,3978,[213 209 227 508 201],201,4,10982,2.75998994722292,0.0,0.0
7979,1,3979,[508 284 298 206 299],130,2,10984,2.7597989949748745,0.0,20.0
7980,1,3980,[239 230 241 331 290],758,3,10987,2.759859331826174,0.0,0.0
7981,1,3981,[201 230 232 431 219],276,3,10990,2.759919638372677,0.0,0.0
7982,1,3982,[226 508 239 429 231],896,2,10992,2.7597288476023096,0.0,0.0
7983,1,3983,[321 293 291 508 217],429,3,10995,2.759789156626506,0.0,0.0
7984,1,3984,[295 367 209 231 300],880,2,10997,2.7595984943538268,0.0,20.0
7985,1,3985,[298 202 215 250 264],435,3,11000,2.7596588058203713,0.0,20.0
7986,1,3986,[232 209 324 284 583],303,3,11003,2.759719087032857,0.0,0.0
7987,1,3987,[232 365 284 268 298],276,3,11006,2.759779338014042,0.0,40.0
7988,1,3988,[232 293 240 392 508],222,2,11008,2.7595888693908246,0.0,0.0
7989,1,3989,[201 413 211 217 227],201,2,11010,2.7593984962406015,0.0,0.0
7990,1,3990,[275 218 378 250 223],429,2,11012,2.7592082184916062,20.0,0.0
7991,1,3991,[275 215 384 227 485],790,1,11013,2.7587675350701404,0.0,0.0
7992,1,3992,[246 230 208 211 284],727,3,11016,2.7588279489105934,0.0,0.0
7993,1,3993,[230 413 223 219 209],222,4,11020,2.759138708062093,20.0,0.0
7994,1,3994,[392 215 254 272 230],276,3,11023,2.7591989987484355,20.0,0.0
7995,1,3995,[259 226 216 208 508],303,4,11027,2.7595095095095097,0.0,20.0
7996,1,3996,[255 290 272 227 209],293,1,11028,2.7590693019764823,20.0,0.0
7997,1,3997,[295 264 223 283 276],919,3,11031,2.7591295647823912,20.0,0.0
7998,1,3998,[201 251 275 485 326],305,1,11032,2.7586896724181047,0.0,0.0
7999,1,3999,[232 222 219 240 241],561,0,11032,2.758,0.0,20.0
8000,2,0,[246 394 254 268 392],880,2,2,2.0,0.0,20.0
8001,2,1,[507 394 280 290 250],393,3,5,2.5,0.0,0.0
8002,2,2,[221 272 264 297 293],919,4,9,3.0,20.0,0.0
8003,2,3,[220 215 218 261 201],1,0,9,2.25,0.0,0.0
8004,2,4,[298 202 291 290 222],276,4,13,2.6,0.0,40.0
8005,2,5,[206 420 316 413 331],130,2,15,2.5,20.0,0.0
8006,2,6,[219 231 250 259 215],682,2,17,2.4285714285714284,0.0,0.0
8007,2,7,[250 300 208 509 290],889,2,19,2.375,0.0,20.0
8008,2,8,[268 202 293 221 246],592,5,24,2.6666666666666665,0.0,20.0
8009,2,9,[268 202 293 221 246],303,5,29,2.9,0.0,20.0
8010,2,10,[268 202 293 221 246],592,5,34,3.090909090909091,0.0,20.0
8011,2,11,[268 202 293 221 246],919,2,36,3.0,0.0,20.0
8012,2,12,[420 316 272 222 293],293,3,39,3.0,40.0,20.0
8013,2,13,[209 213 201 206 241],201,2,41,2.9285714285714284,0.0,0.0
8014,2,14,[230 231 217 261 239],1,2,43,2.8666666666666667,0.0,0.0
8015,2,15,[420 213 272 293 239],758,2,45,2.8125,20.0,0.0
8016,2,16,[213 272 280 208 230],293,1,46,2.7058823529411766,20.0,0.0
8017,2,17,[272 221 250 298 297],758,4,50,2.7777777777777777,20.0,20.0
8018,2,18,[272 250 298 297 293],758,4,54,2.8421052631578947,20.0,20.0
8019,2,19,[272 250 298 297 221],592,5,59,2.95,20.0,20.0
8020,2,20,[208 250 216 241 244],1,4,63,3.0,0.0,20.0
8021,2,21,[297 272 298 216 250],758,5,68,3.090909090909091,20.0,40.0
8022,2,22,[367 226 255 232 316],178,5,73,3.1739130434782608,20.0,0.0
8023,2,23,[211 298 217 240 239],293,2,75,3.125,0.0,20.0
8024,2,24,[297 298 232 250 211],889,3,78,3.12,0.0,20.0
8025,2,25,[255 367 272 226 250],293,1,79,3.0384615384615383,20.0,0.0
8026,2,26,[298 272 211 216 250],286,5,84,3.111111111111111,20.0,40.0
8027,2,27,[298 272 211 216 250],682,5,89,3.1785714285714284,20.0,40.0
8028,2,28,[298 272 211 216 250],758,5,94,3.2413793103448274,20.0,40.0
8029,2,29,[298 272 211 216 250],660,3,97,3.2333333333333334,20.0,40.0
8030,2,30,[272 211 250 298 221],758,4,101,3.2580645161290325,20.0,20.0
8031,2,31,[272 211 250 298 216],293,4,105,3.28125,20.0,40.0
8032,2,32,[272 211 298 250 216],293,4,109,3.303030303030303,20.0,40.0
8033,2,33,[230 209 481 201 431],896,2,111,3.264705882352941,0.0,0.0
8034,2,34,[212 202 392 232 367],896,1,112,3.2,0.0,0.0
8035,2,35,[583 211 481 293 216],429,3,115,3.1944444444444446,0.0,20.0
8036,2,36,[478 583 230 239 219],327,3,118,3.189189189189189,20.0,0.0
8037,2,37,[231 219 227 431 216],222,3,121,3.1842105263157894,0.0,20.0
8038,2,38,[261 240 243 290 303],181,0,121,3.1025641025641026,0.0,0.0
8039,2,39,[223 222 208 218 283],864,5,126,3.15,20.0,20.0
8040,2,40,[223 290 216 211 509],293,3,129,3.1463414634146343,20.0,20.0
8041,2,41,[230 218 413 209 431],276,3,132,3.142857142857143,0.0,0.0
8042,2,42,[227 290 420 280 218],293,1,133,3.0930232558139537,0.0,0.0
8043,2,43,[240 217 267 244 227],1,2,135,3.0681818181818183,0.0,0.0
8044,2,44,[300 509 202 201 290],682,2,137,3.0444444444444443,0.0,20.0
8045,2,45,[222 344 331 272 227],758,4,141,3.0652173913043477,20.0,20.0
8046,2,46,[209 206 202 250 216],606,5,146,3.106382978723404,0.0,20.0
8047,2,47,[209 326 315 268 219],551,5,151,3.1458333333333335,20.0,20.0
8048,2,48,[392 268 217 216 218],435,2,153,3.122448979591837,0.0,40.0
8049,2,49,[298 201 367 264 316],276,3,156,3.12,20.0,20.0
8050,2,50,[227 255 507 206 291],293,2,158,3.0980392156862746,0.0,0.0
8051,2,51,[268 507 226 293 246],303,5,163,3.1346153846153846,0.0,20.0
8052,2,52,[223 301 216 201 222],363,2,165,3.1132075471698113,20.0,40.0
8053,2,53,[240 217 298 268 295],130,3,168,3.111111111111111,0.0,40.0
8054,2,54,[365 280 222 384 239],682,1,169,3.0727272727272728,0.0,20.0
8055,2,55,[293 230 255 218 384],303,3,172,3.0714285714285716,0.0,0.0
8056,2,56,[259 216 247 231 241],1,2,174,3.0526315789473686,0.0,20.0
8057,2,57,[246 232 250 231 217],790,5,179,3.086206896551724,0.0,0.0
8058,2,58,[297 240 295 293 508],919,3,182,3.0847457627118646,0.0,0.0
8059,2,59,[208 384 298 226 276],880,4,186,3.1,0.0,20.0
8060,2,60,[206 268 222 244 236],916,3,189,3.098360655737705,0.0,40.0
8061,2,61,[202 239 367 254 331],130,3,192,3.096774193548387,0.0,0.0
8062,2,62,[272 316 226 227 218],532,5,197,3.126984126984127,40.0,0.0
8063,2,63,[215 291 240 209 227],293,1,198,3.09375,0.0,0.0
8064,2,64,[283 268 219 259 275],178,4,202,3.1076923076923078,0.0,20.0
8065,2,65,[202 240 222 217 211],495,5,207,3.1363636363636362,0.0,20.0
8066,2,66,[240 213 211 227 215],790,1,208,3.1044776119402986,0.0,0.0
8067,2,67,[275 508 283 236 326],919,4,212,3.1176470588235294,0.0,0.0
8068,2,68,[213 232 230 239 212],1,3,215,3.1159420289855073,0.0,0.0
8069,2,69,[241 211 217 206 209],916,3,218,3.1142857142857143,0.0,0.0
8070,2,70,[303 297 300 212 232],889,0,218,3.0704225352112675,0.0,20.0
8071,2,71,[507 223 217 301 231],429,2,220,3.0555555555555554,20.0,0.0
8072,2,72,[230 276 243 216 254],130,2,222,3.041095890410959,0.0,20.0
8073,2,73,[246 315 215 250 236],130,4,226,3.054054054054054,20.0,0.0
8074,2,74,[255 298 208 202 293],606,4,230,3.066666666666667,0.0,20.0
8075,2,75,[232 216 227 284 219],916,1,231,3.039473684210526,0.0,20.0
8076,2,76,[298 321 261 315 301],919,0,231,3.0,20.0,20.0
8077,2,77,[223 275 209 231 219],429,4,235,3.0128205128205128,20.0,0.0
8078,2,78,[583 431 509 216 291],551,4,239,3.0253164556962027,0.0,20.0
8079,2,79,[452 272 211 350 241],758,3,242,3.025,20.0,0.0
8080,2,80,[275 236 272 508 223],919,5,247,3.049382716049383,40.0,0.0
8081,2,81,[223 217 321 211 293],429,3,250,3.048780487804878,20.0,0.0
8082,2,82,[275 236 272 508 223],919,5,255,3.072289156626506,40.0,0.0
8083,2,83,[240 283 208 211 213],299,3,258,3.0714285714285716,0.0,0.0
8084,2,84,[223 240 420 250 268],303,4,262,3.0823529411764707,20.0,20.0
8085,2,85,[367 239 202 226 254],276,3,265,3.0813953488372094,0.0,0.0
8086,2,86,[230 202 390 250 216],94,2,267,3.0689655172413794,0.0,20.0
8087,2,87,[429 217 222 316 264],363,2,269,3.0568181818181817,20.0,20.0
8088,2,88,[215 284 390 218 250],303,4,273,3.067415730337079,0.0,0.0
8089,2,89,[298 272 250 350 291],130,4,277,3.077777777777778,20.0,20.0
8090,2,90,[272 250 239 297 213],758,4,281,3.087912087912088,20.0,0.0
8091,2,91,[326 215 236 223 221],592,4,285,3.097826086956522,20.0,0.0
8092,2,92,[276 508 298 291 217],758,3,288,3.096774193548387,0.0,20.0
8093,2,93,[208 209 272 315 301],758,4,292,3.106382978723404,40.0,0.0
8094,2,94,[413 315 272 218 231],130,3,295,3.1052631578947367,40.0,0.0
8095,2,95,[509 212 293 324 508],758,4,299,3.1145833333333335,0.0,0.0
8096,2,96,[241 290 298 215 259],303,4,303,3.1237113402061856,0.0,20.0
8097,2,97,[221 413 202 255 300],303,3,306,3.122448979591837,0.0,20.0
8098,2,98,[246 250 295 331 350],592,4,310,3.1313131313131315,0.0,0.0
8099,2,99,[221 230 244 223 251],1,4,314,3.14,20.0,0.0
8100,2,100,[212 216 280 509 213],916,4,318,3.1485148514851486,0.0,20.0
8101,2,101,[261 219 216 268 241],222,3,321,3.1470588235294117,0.0,40.0
8102,2,102,[367 212 241 255 239],299,2,323,3.1359223300970873,0.0,0.0
8103,2,103,[509 221 272 303 324],201,1,324,3.1153846153846154,20.0,0.0
8104,2,104,[241 217 222 284 219],429,2,326,3.104761904761905,0.0,20.0
8105,2,105,[215 250 218 231 413],276,3,329,3.1037735849056602,0.0,0.0
8106,2,106,[508 367 431 344 236],592,3,332,3.102803738317757,0.0,0.0
8107,2,107,[216 230 226 202 241],94,1,333,3.0833333333333335,0.0,20.0
8108,2,108,[485 384 222 275 216],299,3,336,3.0825688073394497,0.0,40.0
8109,2,109,[275 211 485 251 223],293,3,339,3.081818181818182,20.0,0.0
8110,2,110,[254 232 231 202 324],276,2,341,3.0720720720720722,0.0,0.0
8111,2,111,[219 367 583 209 276],682,0,341,3.044642857142857,0.0,0.0
8112,2,112,[367 227 232 298 268],790,4,345,3.0530973451327434,0.0,40.0
8113,2,113,[300 236 255 208 293],303,4,349,3.06140350877193,0.0,20.0
8114,2,114,[429 291 298 316 367],293,2,351,3.0521739130434784,20.0,20.0
8115,2,115,[202 259 300 226 222],487,3,354,3.0517241379310347,0.0,40.0
8116,2,116,[226 298 250 206 215],276,5,359,3.0683760683760686,0.0,20.0
8117,2,117,[315 295 221 250 259],592,4,363,3.0762711864406778,20.0,0.0
8118,2,118,[413 221 230 272 583],201,0,363,3.0504201680672267,20.0,0.0
8119,2,119,[272 250 384 216 259],682,3,366,3.05,20.0,20.0
8120,2,120,[297 384 303 212 420],758,4,370,3.0578512396694215,0.0,0.0
8121,2,121,[240 276 315 299 219],130,4,374,3.0655737704918034,20.0,0.0
8122,2,122,[216 268 202 293 367],682,4,378,3.073170731707317,0.0,40.0
8123,2,123,[219 392 290 452 413],276,2,380,3.064516129032258,0.0,0.0
8124,2,124,[508 215 240 452 267],532,3,383,3.064,0.0,0.0
8125,2,125,[221 295 509 209 268],916,3,386,3.0634920634920637,0.0,20.0
8126,2,126,[300 208 244 276 259],299,3,389,3.062992125984252,0.0,20.0
8127,2,127,[298 222 583 276 208],429,4,393,3.0703125,0.0,40.0
8128,2,128,[291 254 290 268 217],435,3,396,3.0697674418604652,0.0,20.0
8129,2,129,[222 226 230 378 215],790,1,397,3.0538461538461537,0.0,20.0
8130,2,130,[216 295 250 336 268],592,4,401,3.0610687022900764,0.0,40.0
8131,2,131,[295 208 216 250 246],500,5,406,3.0757575757575757,0.0,20.0
8132,2,132,[367 208 280 272 230],293,1,407,3.0601503759398496,20.0,0.0
8133,2,133,[216 254 226 222 431],435,1,408,3.044776119402985,0.0,40.0
8134,2,134,[280 315 429 272 209],293,2,410,3.037037037037037,40.0,0.0
8135,2,135,[452 331 212 240 219],201,3,413,3.036764705882353,0.0,0.0
8136,2,136,[291 284 206 218 413],276,3,416,3.0364963503649633,0.0,0.0
8137,2,137,[232 272 394 268 293],880,4,420,3.0434782608695654,20.0,20.0
8138,2,138,[216 509 298 202 246],916,3,423,3.0431654676258995,0.0,40.0
8139,2,139,[384 299 280 208 367],880,3,426,3.0428571428571427,0.0,0.0
8140,2,140,[291 209 293 315 202],276,4,430,3.049645390070922,20.0,0.0
8141,2,141,[384 413 431 284 223],399,0,430,3.028169014084507,20.0,0.0
8142,2,142,[272 244 261 254 239],1,1,431,3.013986013986014,20.0,0.0
8143,2,143,[232 431 227 250 367],790,3,434,3.013888888888889,0.0,0.0
8144,2,144,[321 201 344 230 218],327,3,437,3.013793103448276,0.0,0.0
8145,2,145,[230 217 254 431 208],435,2,439,3.006849315068493,0.0,0.0
8146,2,146,[420 284 227 230 298],276,5,444,3.020408163265306,0.0,20.0
8147,2,147,[298 299 272 315 350],592,4,448,3.027027027027027,40.0,20.0
8148,2,148,[321 392 331 413 298],435,2,450,3.0201342281879193,0.0,20.0
8149,2,149,[239 209 284 394 299],880,3,453,3.02,0.0,0.0
8150,2,150,[255 420 250 227 300],435,3,456,3.019867549668874,0.0,20.0
8151,2,151,[284 256 268 326 240],181,0,456,3.0,0.0,20.0
8152,2,152,[413 264 232 390 507],303,2,458,2.9934640522875817,0.0,0.0
8153,2,153,[218 202 365 230 227],222,4,462,3.0,0.0,0.0
8154,2,154,[227 420 236 216 367],130,4,466,3.0064516129032257,0.0,20.0
8155,2,155,[227 301 485 211 219],660,1,467,2.9935897435897436,0.0,0.0
8156,2,156,[384 241 208 507 298],303,4,471,3.0,0.0,20.0
8157,2,157,[276 241 227 420 268],303,4,475,3.0063291139240507,0.0,20.0
8158,2,158,[392 254 508 384 452],276,1,476,2.993710691823899,0.0,0.0
8159,2,159,[303 344 221 216 255],592,5,481,3.00625,0.0,20.0
8160,2,160,[250 215 202 209 211],327,3,484,3.0062111801242235,0.0,0.0
8161,2,161,[394 298 392 365 239],880,2,486,3.0,0.0,20.0
8162,2,162,[217 365 211 222 280],682,3,489,3.0,0.0,20.0
8163,2,163,[420 223 216 429 300],896,4,493,3.0060975609756095,20.0,40.0
8164,2,164,[202 431 255 365 239],472,5,498,3.018181818181818,0.0,0.0
8165,2,165,[254 301 250 209 217],880,2,500,3.0120481927710845,0.0,0.0
8166,2,166,[232 212 218 219 213],846,3,503,3.0119760479041915,0.0,0.0
8167,2,167,[243 215 231 216 232],682,2,505,3.005952380952381,0.0,20.0
8168,2,168,[583 284 300 241 508],429,1,506,2.9940828402366866,0.0,20.0
8169,2,169,[244 250 331 431 220],178,3,509,2.9941176470588236,0.0,0.0
8170,2,170,[365 202 283 255 384],393,1,510,2.982456140350877,0.0,0.0
8171,2,171,[215 367 290 255 219],303,5,515,2.994186046511628,0.0,0.0
8172,2,172,[215 336 478 232 218],327,3,518,2.994219653179191,20.0,0.0
8173,2,173,[300 209 431 303 331],276,4,522,3.0,0.0,20.0
8174,2,174,[431 216 378 247 300],222,3,525,3.0,0.0,40.0
8175,2,175,[201 219 227 241 209],429,2,527,2.9943181818181817,0.0,0.0
8176,2,176,[222 217 300 508 298],327,0,527,2.977401129943503,0.0,60.0
8177,2,177,[291 431 215 301 217],276,3,530,2.9775280898876404,0.0,0.0
8178,2,178,[316 218 202 208 384],758,5,535,2.988826815642458,20.0,0.0
8179,2,179,[218 230 267 211 240],1,2,537,2.9833333333333334,0.0,0.0
8180,2,180,[280 217 367 211 206],293,2,539,2.977900552486188,0.0,0.0
8181,2,181,[367 508 392 201 315],880,4,543,2.9835164835164836,20.0,0.0
8182,2,182,[241 202 209 331 431],276,4,547,2.989071038251366,0.0,0.0
8183,2,183,[206 331 239 508 230],276,5,552,3.0,0.0,0.0
8184,2,184,[236 300 452 202 290],303,3,555,3.0,0.0,20.0
8185,2,185,[350 367 392 300 268],130,5,560,3.010752688172043,0.0,40.0
8186,2,186,[298 336 201 259 293],592,3,563,3.0106951871657754,0.0,20.0
8187,2,187,[300 431 209 378 223],682,1,564,3.0,20.0,20.0
8188,2,188,[291 367 240 239 272],130,5,569,3.0105820105820107,20.0,0.0
8189,2,189,[508 221 299 216 336],592,3,572,3.0105263157894737,0.0,20.0
8190,2,190,[300 231 293 223 583],682,1,573,3.0,20.0,20.0
8191,2,191,[201 254 259 232 211],682,2,575,2.9947916666666665,0.0,0.0
8192,2,192,[241 223 231 239 219],682,1,576,2.9844559585492227,20.0,0.0
8193,2,193,[331 250 301 240 508],770,3,579,2.984536082474227,0.0,0.0
8194,2,194,[507 392 217 208 230],727,2,581,2.9794871794871796,0.0,0.0
8195,2,195,[267 251 244 219 206],1,3,584,2.979591836734694,0.0,0.0
8196,2,196,[218 241 222 211 231],682,3,587,2.979695431472081,0.0,20.0
8197,2,197,[291 452 303 315 481],758,4,591,2.984848484848485,20.0,0.0
8198,2,198,[298 293 232 255 378],487,4,595,2.9899497487437188,0.0,20.0
8199,2,199,[222 212 298 231 230],363,2,597,2.985,0.0,40.0
8200,2,200,[232 268 291 202 452],276,2,599,2.9800995024875623,0.0,20.0
8201,2,201,[240 350 293 202 261],130,5,604,2.99009900990099,0.0,0.0
8202,2,202,[255 295 300 216 246],500,4,608,2.9950738916256157,0.0,40.0
8203,2,203,[326 275 216 478 212],305,1,609,2.985294117647059,20.0,20.0
8204,2,204,[230 280 218 367 216],293,1,610,2.975609756097561,0.0,20.0
8205,2,205,[243 264 291 268 508],181,0,610,2.9611650485436893,0.0,20.0
8206,2,206,[331 284 218 394 291],435,3,613,2.9613526570048307,0.0,0.0
8207,2,207,[284 217 223 246 301],276,5,618,2.9711538461538463,20.0,0.0
8208,2,208,[367 276 212 219 218],561,1,619,2.9617224880382773,0.0,0.0
8209,2,209,[508 259 283 236 303],181,0,619,2.947619047619048,0.0,0.0
8210,2,210,[211 291 250 223 316],293,2,621,2.943127962085308,40.0,0.0
8211,2,211,[392 239 216 226 298],130,5,626,2.952830188679245,0.0,40.0
8212,2,212,[324 219 223 392 232],276,3,629,2.9530516431924885,20.0,0.0
8213,2,213,[216 239 226 206 420],130,4,633,2.957943925233645,0.0,20.0
8214,2,214,[331 250 222 239 298],276,5,638,2.9674418604651165,0.0,40.0
8215,2,215,[295 232 213 298 509],916,2,640,2.962962962962963,0.0,20.0
8216,2,216,[250 215 316 218 217],293,1,641,2.953917050691244,20.0,0.0
8217,2,217,[236 215 291 216 243],130,4,645,2.958715596330275,0.0,20.0
8218,2,218,[215 232 231 209 367],286,3,648,2.958904109589041,0.0,0.0
8219,2,219,[321 264 283 291 220],181,1,649,2.95,0.0,0.0
8220,2,220,[478 507 246 209 202],327,5,654,2.9592760180995477,20.0,0.0
8221,2,221,[583 508 230 283 218],429,1,655,2.9504504504504503,0.0,0.0
8222,2,222,[394 392 299 239 240],435,3,658,2.9506726457399104,0.0,0.0
8223,2,223,[298 293 297 223 509],758,4,662,2.955357142857143,20.0,20.0
8224,2,224,[206 239 300 290 251],293,2,664,2.951111111111111,0.0,20.0
8225,2,225,[420 384 264 326 232],303,2,666,2.9469026548672566,0.0,0.0
8226,2,226,[222 297 218 300 295],919,3,669,2.947136563876652,0.0,40.0
8227,2,227,[264 216 429 315 583],293,2,671,2.942982456140351,20.0,20.0
8228,2,228,[280 508 219 259 298],178,2,673,2.938864628820961,0.0,20.0
8229,2,229,[227 215 413 298 268],222,3,676,2.9391304347826086,0.0,40.0
8230,2,230,[215 212 211 243 284],561,1,677,2.930735930735931,0.0,0.0
8231,2,231,[392 226 236 350 284],130,4,681,2.935344827586207,0.0,0.0
8232,2,232,[216 431 316 230 250],532,4,685,2.939914163090129,20.0,20.0
8233,2,233,[232 392 202 223 298],222,5,690,2.948717948717949,20.0,20.0
8234,2,234,[223 283 217 231 275],864,4,694,2.953191489361702,20.0,0.0
8235,2,235,[298 299 243 227 236],130,2,696,2.9491525423728815,0.0,20.0
8236,2,236,[246 315 367 219 201],276,4,700,2.9535864978902953,20.0,0.0
8237,2,237,[209 300 303 250 284],293,1,701,2.9453781512605044,0.0,20.0
8238,2,238,[283 215 222 291 297],293,2,703,2.9414225941422596,0.0,20.0
8239,2,239,[216 378 202 211 246],682,4,707,2.9458333333333333,0.0,20.0
8240,2,240,[431 331 211 215 202],201,1,708,2.9377593360995853,0.0,0.0
8241,2,241,[508 326 284 321 246],919,1,709,2.9297520661157024,0.0,0.0
8242,2,242,[303 231 218 239 301],758,2,711,2.925925925925926,0.0,0.0
8243,2,243,[218 583 239 276 221],916,3,714,2.9262295081967213,0.0,0.0
8244,2,244,[250 202 295 209 218],109,3,717,2.926530612244898,0.0,0.0
8245,2,245,[251 413 508 218 452],303,3,720,2.926829268292683,0.0,0.0
8246,2,246,[208 420 250 222 209],758,4,724,2.931174089068826,0.0,20.0
8247,2,247,[219 232 220 259 261],1,0,724,2.9193548387096775,0.0,0.0
8248,2,248,[297 350 231 239 240],758,2,726,2.9156626506024095,0.0,0.0
8249,2,249,[259 384 240 272 202],393,2,728,2.912,20.0,0.0
8250,2,250,[452 243 219 301 261],21,3,731,2.912350597609562,0.0,0.0
8251,2,251,[268 321 255 300 236],130,5,736,2.9206349206349205,0.0,40.0
8252,2,252,[293 202 218 295 508],178,2,738,2.91699604743083,0.0,0.0
8253,2,253,[295 216 231 508 227],130,2,740,2.9133858267716537,0.0,20.0
8254,2,254,[315 420 291 344 316],393,3,743,2.9137254901960783,40.0,0.0
8255,2,255,[222 300 293 216 290],303,3,746,2.9140625,0.0,60.0
8256,2,256,[452 392 316 508 291],276,2,748,2.9105058365758754,20.0,0.0
8257,2,257,[420 254 299 240 222],130,3,751,2.9108527131782944,0.0,20.0
8258,2,258,[227 350 384 208 216],758,5,756,2.918918918918919,0.0,20.0
8259,2,259,[231 272 298 209 215],682,3,759,2.919230769230769,20.0,20.0
8260,2,260,[202 431 326 293 215],592,4,763,2.9233716475095783,0.0,0.0
8261,2,261,[384 250 324 240 211],758,4,767,2.927480916030534,0.0,0.0
8262,2,262,[227 290 293 219 350],130,3,770,2.9277566539923954,0.0,0.0
8263,2,263,[429 291 303 283 227],293,2,772,2.9242424242424243,0.0,0.0
8264,2,264,[251 316 223 216 290],293,3,775,2.9245283018867925,40.0,20.0
8265,2,265,[297 261 243 223 293],592,3,778,2.924812030075188,20.0,0.0
8266,2,266,[251 507 420 250 293],303,5,783,2.932584269662921,0.0,0.0
8267,2,267,[217 298 239 250 222],276,5,788,2.9402985074626864,0.0,40.0
8268,2,268,[250 254 509 431 290],682,2,790,2.936802973977695,0.0,0.0
8269,2,269,[284 268 218 209 321],303,4,794,2.9407407407407407,0.0,20.0
8270,2,270,[272 316 331 299 283],104,3,797,2.940959409594096,40.0,0.0
8271,2,271,[290 246 202 431 298],916,1,798,2.9338235294117645,0.0,20.0
8272,2,272,[384 226 202 222 509],551,4,802,2.937728937728938,0.0,20.0
8273,2,273,[384 226 254 246 299],682,2,804,2.934306569343066,0.0,0.0
8274,2,274,[227 254 218 316 240],276,4,808,2.938181818181818,20.0,0.0
8275,2,275,[222 246 223 215 232],303,4,812,2.9420289855072466,20.0,20.0
8276,2,276,[254 293 452 218 420],276,3,815,2.9422382671480145,0.0,0.0
8277,2,277,[208 239 420 251 218],293,2,817,2.9388489208633093,0.0,0.0
8278,2,278,[261 276 250 331 420],130,3,820,2.939068100358423,0.0,0.0
8279,2,279,[215 209 217 431 232],327,3,823,2.9392857142857145,0.0,0.0
8280,2,280,[222 336 251 300 221],181,1,824,2.9323843416370106,0.0,40.0
8281,2,281,[227 241 297 230 221],758,3,827,2.9326241134751774,0.0,0.0
8282,2,282,[331 231 240 290 255],130,2,829,2.929328621908127,0.0,0.0
8283,2,283,[284 241 301 316 231],276,4,833,2.933098591549296,20.0,0.0
8284,2,284,[222 231 240 478 218],495,4,837,2.9368421052631577,20.0,20.0
8285,2,285,[202 216 206 508 284],606,5,842,2.944055944055944,0.0,20.0
8286,2,286,[232 293 264 218 272],276,3,845,2.9442508710801394,20.0,0.0
8287,2,287,[259 293 367 211 217],682,3,848,2.9444444444444446,0.0,0.0
8288,2,288,[284 239 431 223 365],222,4,852,2.9480968858131487,20.0,0.0
8289,2,289,[216 429 303 290 297],293,4,856,2.9517241379310346,0.0,20.0
8290,2,290,[231 331 293 241 315],758,2,858,2.948453608247423,20.0,0.0
8291,2,291,[331 268 299 202 291],592,2,860,2.9452054794520546,0.0,20.0
8292,2,292,[241 231 221 324 413],201,1,861,2.938566552901024,0.0,0.0
8293,2,293,[284 217 226 246 365],790,4,865,2.942176870748299,0.0,0.0
8294,2,294,[223 420 227 413 215],246,3,868,2.942372881355932,20.0,0.0
8295,2,295,[315 509 507 420 255],293,2,870,2.939189189189189,20.0,0.0
8296,2,296,[284 272 206 215 413],276,4,874,2.942760942760943,20.0,0.0
8297,2,297,[215 452 202 367 241],846,4,878,2.946308724832215,0.0,0.0
8298,2,298,[284 261 206 295 250],130,1,879,2.939799331103679,0.0,0.0
8299,2,299,[222 213 217 431 284],201,1,880,2.933333333333333,0.0,20.0
8300,2,300,[217 276 301 350 315],758,2,882,2.9302325581395348,20.0,0.0
8301,2,301,[232 226 218 452 202],495,4,886,2.933774834437086,0.0,0.0
8302,2,302,[232 392 259 378 268],727,3,889,2.933993399339934,0.0,20.0
8303,2,303,[452 367 413 226 231],276,1,890,2.9276315789473686,0.0,0.0
8304,2,304,[227 384 324 365 209],276,3,893,2.9278688524590164,0.0,0.0
8305,2,305,[413 384 331 209 264],276,2,895,2.9248366013071894,0.0,0.0
8306,2,306,[251 208 255 250 272],293,2,897,2.9218241042345277,20.0,0.0
8307,2,307,[218 222 232 300 508],178,3,900,2.9220779220779223,0.0,40.0
8308,2,308,[291 331 236 221 344],758,3,903,2.9223300970873787,0.0,0.0
8309,2,309,[284 232 384 226 222],682,2,905,2.9193548387096775,0.0,20.0
8310,2,310,[232 326 202 239 321],201,0,905,2.909967845659164,0.0,0.0
8311,2,311,[331 201 276 299 367],592,3,908,2.91025641025641,0.0,0.0
8312,2,312,[344 255 243 301 508],592,3,911,2.9105431309904155,0.0,0.0
8313,2,313,[420 303 316 250 255],393,4,915,2.9140127388535033,20.0,0.0
8314,2,314,[232 326 246 390 236],303,3,918,2.914285714285714,0.0,0.0
8315,2,315,[481 431 201 367 239],896,3,921,2.9145569620253164,0.0,0.0
8316,2,316,[212 239 230 222 255],1,4,925,2.917981072555205,0.0,20.0
8317,2,317,[209 215 367 452 241],846,4,929,2.9213836477987423,0.0,0.0
8318,2,318,[227 367 230 226 255],435,2,931,2.9184952978056424,0.0,0.0
8319,2,319,[392 261 300 452 321],130,5,936,2.925,0.0,20.0
8320,2,320,[230 293 300 222 226],429,2,938,2.9221183800623054,0.0,40.0
8321,2,321,[509 316 275 298 211],293,2,940,2.919254658385093,20.0,20.0
8322,2,322,[378 226 216 218 298],487,3,943,2.9195046439628483,0.0,40.0
8323,2,323,[315 246 206 272 293],276,5,948,2.925925925925926,40.0,0.0
8324,2,324,[324 246 216 221 231],303,4,952,2.9292307692307693,0.0,20.0
8325,2,325,[216 227 223 209 247],1,4,956,2.932515337423313,20.0,20.0
8326,2,326,[255 300 259 251 222],299,2,958,2.929663608562691,0.0,40.0
8327,2,327,[209 509 208 276 303],758,4,962,2.932926829268293,0.0,0.0
8328,2,328,[509 211 246 232 583],916,4,966,2.9361702127659575,0.0,0.0
8329,2,329,[420 298 240 429 452],276,4,970,2.9393939393939394,0.0,20.0
8330,2,330,[231 232 201 300 240],682,2,972,2.9365558912386707,0.0,20.0
8331,2,331,[321 583 201 250 232],303,3,975,2.9367469879518073,0.0,0.0
8332,2,332,[215 216 232 272 390],286,3,978,2.936936936936937,20.0,20.0
8333,2,333,[508 452 315 215 299],130,4,982,2.940119760479042,20.0,0.0
8334,2,334,[367 243 231 298 259],682,1,983,2.934328358208955,0.0,20.0
8335,2,335,[240 295 300 508 255],770,4,987,2.9375,0.0,20.0
8336,2,336,[264 236 295 221 272],919,3,990,2.9376854599406528,20.0,0.0
8337,2,337,[222 218 283 298 431],429,3,993,2.937869822485207,0.0,40.0
8338,2,338,[367 392 507 284 298],429,2,995,2.9351032448377583,0.0,20.0
8339,2,339,[201 243 218 209 226],1,1,996,2.929411764705882,0.0,0.0
8340,2,340,[293 384 392 264 365],276,1,997,2.9237536656891496,0.0,0.0
8341,2,341,[202 217 215 283 218],622,3,1000,2.9239766081871346,0.0,0.0
8342,2,342,[321 298 384 226 239],303,2,1002,2.9212827988338192,0.0,20.0
8343,2,343,[509 219 215 241 243],682,2,1004,2.9186046511627906,0.0,0.0
8344,2,344,[413 221 202 284 246],303,4,1008,2.9217391304347826,0.0,0.0
8345,2,345,[221 259 276 201 326],919,4,1012,2.9248554913294798,0.0,0.0
8346,2,346,[217 239 218 240 208],293,0,1012,2.9164265129683,0.0,0.0
8347,2,347,[316 299 331 219 246],130,3,1015,2.9166666666666665,20.0,0.0
8348,2,348,[268 241 231 255 384],303,4,1019,2.9197707736389686,0.0,20.0
8349,2,349,[209 509 284 291 227],293,0,1019,2.9114285714285715,0.0,0.0
8350,2,350,[283 295 384 316 246],880,3,1022,2.9116809116809117,20.0,0.0
8351,2,351,[276 264 291 298 336],592,2,1024,2.909090909090909,0.0,20.0
8352,2,352,[236 243 508 290 220],181,1,1025,2.903682719546742,0.0,0.0
8353,2,353,[315 223 268 300 212],305,2,1027,2.901129943502825,40.0,40.0
8354,2,354,[275 283 246 378 507],727,1,1028,2.895774647887324,0.0,0.0
8355,2,355,[344 255 276 272 268],592,5,1033,2.901685393258427,20.0,20.0
8356,2,356,[298 290 431 217 297],889,3,1036,2.9019607843137254,0.0,20.0
8357,2,357,[215 226 300 247 261],222,2,1038,2.899441340782123,0.0,20.0
8358,2,358,[243 254 240 290 299],682,2,1040,2.896935933147632,0.0,0.0
8359,2,359,[413 331 267 508 315],130,3,1043,2.897222222222222,20.0,0.0
8360,2,360,[230 215 208 293 227],303,3,1046,2.897506925207756,0.0,0.0
8361,2,361,[508 478 202 300 481],896,2,1048,2.8950276243093924,20.0,20.0
8362,2,362,[218 217 485 284 239],293,0,1048,2.887052341597796,0.0,0.0
8363,2,363,[231 201 250 508 392],896,0,1048,2.879120879120879,0.0,0.0
8364,2,364,[298 202 413 315 284],276,4,1052,2.882191780821918,20.0,20.0
8365,2,365,[264 251 201 215 240],1,1,1053,2.877049180327869,0.0,0.0
8366,2,366,[226 420 230 583 223],94,2,1055,2.8746594005449593,20.0,0.0
8367,2,367,[231 324 303 284 223],201,2,1057,2.8722826086956523,20.0,0.0
8368,2,368,[301 316 367 272 254],276,3,1060,2.872628726287263,40.0,0.0
8369,2,369,[413 264 254 216 367],435,0,1060,2.864864864864865,0.0,20.0
8370,2,370,[268 226 413 384 241],399,1,1061,2.8598382749326148,0.0,20.0
8371,2,371,[316 222 267 217 299],130,3,1064,2.860215053763441,20.0,20.0
8372,2,372,[303 431 268 239 219],201,2,1066,2.8579088471849867,0.0,20.0
8373,2,373,[217 481 298 227 250],429,1,1067,2.8529411764705883,0.0,20.0
8374,2,374,[246 227 324 413 216],303,2,1069,2.8506666666666667,0.0,20.0
8375,2,375,[293 216 211 481 284],429,3,1072,2.851063829787234,0.0,20.0
8376,2,376,[240 217 226 239 250],130,3,1075,2.8514588859416445,0.0,0.0
8377,2,377,[211 250 209 218 239],916,2,1077,2.8492063492063493,0.0,0.0
8378,2,378,[390 324 221 218 223],303,3,1080,2.849604221635884,20.0,0.0
8379,2,379,[217 431 250 231 284],363,0,1080,2.8421052631578947,0.0,0.0
8380,2,380,[227 268 226 231 206],268,4,1084,2.8451443569553807,0.0,20.0
8381,2,381,[211 219 264 222 232],268,2,1086,2.842931937172775,0.0,20.0
8382,2,382,[201 250 284 230 232],268,1,1087,2.838120104438642,0.0,0.0
8383,2,383,[280 268 221 291 300],181,1,1088,2.8333333333333335,0.0,40.0
8384,2,384,[223 217 226 232 276],864,4,1092,2.8363636363636364,20.0,0.0
8385,2,385,[202 209 226 259 250],1,3,1095,2.8367875647668392,0.0,0.0
8386,2,386,[209 250 208 251 213],293,1,1096,2.8320413436692506,0.0,0.0
8387,2,387,[230 291 226 222 251],293,1,1097,2.827319587628866,0.0,20.0
8388,2,388,[221 216 239 290 315],758,3,1100,2.827763496143959,20.0,20.0
8389,2,389,[230 201 215 384 290],303,3,1103,2.8282051282051284,0.0,0.0
8390,2,390,[211 219 268 321 223],201,3,1106,2.8286445012787724,20.0,20.0
8391,2,391,[284 227 300 429 226],276,5,1111,2.8341836734693877,0.0,20.0
8392,2,392,[583 276 272 508 201],276,4,1115,2.837150127226463,20.0,0.0
8393,2,393,[326 507 264 583 255],303,2,1117,2.83502538071066,0.0,0.0
8394,2,394,[231 301 429 246 298],276,4,1121,2.837974683544304,0.0,20.0
8395,2,395,[219 239 222 367 240],727,1,1122,2.8333333333333335,0.0,20.0
8396,2,396,[367 508 275 232 209],896,2,1124,2.831234256926952,0.0,0.0
8397,2,397,[221 413 259 236 507],303,3,1127,2.8316582914572863,0.0,0.0
8398,2,398,[268 226 223 215 367],222,3,1130,2.8320802005012533,20.0,20.0
8399,2,399,[264 240 293 239 324],303,1,1131,2.8275,0.0,0.0
8400,2,400,[232 219 300 223 217],682,1,1132,2.8229426433915212,20.0,20.0
8401,2,401,[208 452 232 241 212],846,3,1135,2.8233830845771144,0.0,0.0
8402,2,402,[290 236 217 216 301],758,3,1138,2.823821339950372,0.0,20.0
8403,2,403,[452 290 276 300 420],303,3,1141,2.8242574257425743,0.0,20.0
8404,2,404,[219 284 452 232 222],586,0,1141,2.8172839506172838,0.0,20.0
8405,2,405,[264 208 240 284 209],303,3,1144,2.8177339901477834,0.0,0.0
8406,2,406,[298 431 215 209 367],682,3,1147,2.8181818181818183,0.0,20.0
8407,2,407,[413 221 300 202 290],303,3,1150,2.8186274509803924,0.0,20.0
8408,2,408,[283 223 264 236 507],303,3,1153,2.8190709046454767,20.0,0.0
8409,2,409,[241 239 212 298 227],758,3,1156,2.819512195121951,0.0,20.0
8410,2,410,[209 221 244 220 240],1,2,1158,2.8175182481751824,0.0,0.0
8411,2,411,[226 222 367 217 246],790,3,1161,2.8179611650485437,0.0,20.0
8412,2,412,[219 209 255 232 217],682,1,1162,2.8135593220338984,0.0,0.0
8413,2,413,[392 367 276 295 365],880,3,1165,2.814009661835749,0.0,0.0
8414,2,414,[291 231 268 239 246],889,3,1168,2.814457831325301,0.0,20.0
8415,2,415,[276 211 206 223 219],201,3,1171,2.8149038461538463,20.0,0.0
8416,2,416,[276 301 293 201 284],919,3,1174,2.815347721822542,0.0,0.0
8417,2,417,[218 508 507 211 217],327,1,1175,2.811004784688995,0.0,0.0
8418,2,418,[250 218 298 264 251],303,4,1179,2.8138424821002386,0.0,20.0
8419,2,419,[295 392 239 232 226],880,4,1183,2.816666666666667,0.0,0.0
8420,2,420,[324 344 250 336 367],592,4,1187,2.8194774346793348,0.0,0.0
8421,2,421,[231 202 230 243 222],130,2,1189,2.8175355450236967,0.0,20.0
8422,2,422,[290 284 452 232 239],276,3,1192,2.817966903073286,0.0,0.0
8423,2,423,[222 230 250 217 240],622,3,1195,2.818396226415094,0.0,20.0
8424,2,424,[222 209 208 246 241],1,5,1200,2.823529411764706,0.0,20.0
8425,2,425,[216 256 202 213 215],1,3,1203,2.823943661971831,0.0,20.0
8426,2,426,[246 290 254 413 227],435,2,1205,2.822014051522248,0.0,0.0
8427,2,427,[212 315 231 202 509],201,1,1206,2.817757009345794,20.0,0.0
8428,2,428,[291 241 300 284 507],429,2,1208,2.815850815850816,0.0,20.0
8429,2,429,[300 293 315 267 316],130,5,1213,2.8209302325581396,40.0,20.0
8430,2,430,[394 231 209 283 276],880,1,1214,2.816705336426914,0.0,0.0
8431,2,431,[507 420 217 275 213],293,2,1216,2.814814814814815,0.0,0.0
8432,2,432,[298 215 367 202 247],222,3,1219,2.815242494226328,0.0,20.0
8433,2,433,[284 276 217 227 230],130,1,1220,2.8110599078341014,0.0,0.0
8434,2,434,[244 231 206 250 208],1,3,1223,2.811494252873563,0.0,0.0
8435,2,435,[240 208 226 268 223],268,3,1226,2.811926605504587,20.0,20.0
8436,2,436,[243 284 298 211 420],682,3,1229,2.8123569794050343,0.0,20.0
8437,2,437,[240 202 230 276 246],222,4,1233,2.815068493150685,0.0,0.0
8438,2,438,[291 420 283 236 268],303,3,1236,2.8154897494305238,0.0,20.0
8439,2,439,[255 298 297 331 315],592,4,1240,2.8181818181818183,20.0,20.0
8440,2,440,[298 295 420 218 254],130,3,1243,2.81859410430839,0.0,20.0
8441,2,441,[250 293 231 301 384],758,2,1245,2.816742081447964,0.0,0.0
8442,2,442,[298 485 222 367 321],429,2,1247,2.81489841986456,0.0,40.0
8443,2,443,[215 241 212 213 583],916,4,1251,2.8175675675675675,0.0,0.0
8444,2,444,[301 280 485 275 217],429,1,1252,2.8134831460674157,0.0,0.0
8445,2,445,[324 236 431 216 231],758,3,1255,2.81390134529148,0.0,20.0
8446,2,446,[300 230 303 251 209],293,2,1257,2.8120805369127515,0.0,20.0
8447,2,447,[413 239 254 227 240],130,2,1259,2.810267857142857,0.0,0.0
8448,2,448,[272 206 413 295 261],130,2,1261,2.8084632516703785,20.0,0.0
8449,2,449,[275 315 217 251 202],286,4,1265,2.811111111111111,20.0,0.0
8450,2,450,[240 217 275 283 583],790,2,1267,2.809312638580931,0.0,0.0
8451,2,451,[208 509 583 284 255],293,0,1267,2.8030973451327434,0.0,0.0
8452,2,452,[384 264 227 250 259],303,1,1268,2.7991169977924946,0.0,0.0
8453,2,453,[219 215 293 209 272],682,3,1271,2.799559471365639,20.0,0.0
8454,2,454,[232 268 283 315 243],880,3,1274,2.8,20.0,20.0
8455,2,455,[384 413 290 276 298],303,3,1277,2.800438596491228,0.0,20.0
8456,2,456,[215 384 201 240 219],276,4,1281,2.8030634573304156,0.0,0.0
8457,2,457,[264 230 215 206 250],1,3,1284,2.8034934497816595,0.0,0.0
8458,2,458,[344 250 431 293 283],592,4,1288,2.8061002178649237,0.0,0.0
8459,2,459,[509 208 232 268 378],868,1,1289,2.8021739130434784,0.0,20.0
8460,2,460,[429 264 251 239 509],293,2,1291,2.8004338394793926,0.0,0.0
8461,2,461,[217 211 239 275 316],293,1,1292,2.7965367965367967,20.0,0.0
8462,2,462,[211 218 215 276 280],682,2,1294,2.794816414686825,0.0,0.0
8463,2,463,[295 218 246 316 276],178,2,1296,2.793103448275862,20.0,0.0
8464,2,464,[223 201 230 478 239],561,2,1298,2.7913978494623657,40.0,0.0
8465,2,465,[221 216 217 316 202],758,3,1301,2.791845493562232,20.0,20.0
8466,2,466,[251 303 276 202 264],592,4,1305,2.7944325481798713,0.0,0.0
8467,2,467,[241 246 290 218 267],268,1,1306,2.7905982905982905,0.0,0.0
8468,2,468,[215 264 507 259 202],303,3,1309,2.791044776119403,0.0,0.0
8469,2,469,[227 485 275 240 367],790,2,1311,2.7893617021276595,0.0,0.0
8470,2,470,[226 241 227 331 213],201,3,1314,2.789808917197452,0.0,0.0
8471,2,471,[250 217 295 293 244],919,2,1316,2.788135593220339,0.0,0.0
8472,2,472,[219 316 324 209 218],551,4,1320,2.7906976744186047,20.0,0.0
8473,2,473,[293 239 226 452 243],130,4,1324,2.7932489451476794,0.0,0.0
8474,2,474,[290 239 241 246 413],303,3,1327,2.7936842105263158,0.0,0.0
8475,2,475,[300 232 293 246 365],682,2,1329,2.792016806722689,0.0,20.0
8476,2,476,[481 227 222 223 232],429,3,1332,2.792452830188679,20.0,20.0
8477,2,477,[232 384 215 231 236],291,4,1336,2.794979079497908,0.0,0.0
8478,2,478,[217 429 365 227 211],846,2,1338,2.7933194154488517,0.0,0.0
8479,2,479,[478 219 230 215 201],896,3,1341,2.79375,20.0,0.0
8480,2,480,[298 378 201 583 211],429,2,1343,2.7920997920997923,0.0,20.0
8481,2,481,[300 223 202 420 230],276,5,1348,2.796680497925311,20.0,20.0
8482,2,482,[290 209 231 392 583],276,2,1350,2.7950310559006213,0.0,0.0
8483,2,483,[315 206 350 267 299],130,3,1353,2.7954545454545454,20.0,0.0
8484,2,484,[508 232 226 230 272],551,5,1358,2.8,20.0,0.0
8485,2,485,[261 300 227 231 254],130,2,1360,2.7983539094650207,0.0,20.0
8486,2,486,[300 201 223 284 298],919,3,1363,2.7987679671457903,20.0,40.0
8487,2,487,[284 283 211 367 241],790,4,1367,2.8012295081967213,0.0,0.0
8488,2,488,[275 211 485 226 206],293,2,1369,2.79959100204499,0.0,0.0
8489,2,489,[298 209 226 217 275],790,3,1372,2.8,0.0,20.0
8490,2,490,[201 272 303 276 452],201,2,1374,2.7983706720977595,20.0,0.0
8491,2,491,[236 216 218 240 231],758,3,1377,2.798780487804878,0.0,20.0
8492,2,492,[264 206 217 507 213],293,2,1379,2.797160243407708,0.0,0.0
8493,2,493,[218 219 264 452 246],276,3,1382,2.7975708502024292,0.0,0.0
8494,2,494,[284 413 243 268 206],130,1,1383,2.793939393939394,0.0,20.0
8495,2,495,[272 303 431 216 326],201,1,1384,2.7903225806451615,20.0,20.0
8496,2,496,[303 240 276 300 222],758,2,1386,2.788732394366197,0.0,40.0
8497,2,497,[508 218 230 290 213],758,5,1391,2.7931726907630523,0.0,0.0
8498,2,498,[316 452 232 223 276],276,3,1394,2.7935871743486973,40.0,0.0
8499,2,499,[201 413 211 367 208],727,3,1397,2.794,0.0,0.0
8500,2,500,[208 231 367 217 202],472,5,1402,2.7984031936127742,0.0,0.0
8501,2,501,[367 209 230 218 206],868,2,1404,2.7968127490039842,0.0,0.0
8502,2,502,[452 293 240 324 315],276,4,1408,2.7992047713717696,20.0,0.0
8503,2,503,[420 259 222 255 431],393,3,1411,2.7996031746031744,0.0,20.0
8504,2,504,[209 223 226 250 201],303,5,1416,2.803960396039604,20.0,0.0
8505,2,505,[324 241 201 365 315],276,4,1420,2.8063241106719365,20.0,0.0
8506,2,506,[208 240 211 344 216],758,3,1423,2.806706114398422,0.0,20.0
8507,2,507,[213 216 239 507 255],293,2,1425,2.8051181102362204,0.0,20.0
8508,2,508,[300 299 509 290 246],682,2,1427,2.8035363457760316,0.0,20.0
8509,2,509,[367 290 250 507 315],293,1,1428,2.8,20.0,0.0
8510,2,510,[256 244 243 232 250],1,2,1430,2.7984344422700587,0.0,0.0
8511,2,511,[226 227 250 300 485],293,0,1430,2.79296875,0.0,20.0
8512,2,512,[209 390 298 276 240],303,3,1433,2.793372319688109,0.0,20.0
8513,2,513,[231 268 232 394 226],880,3,1436,2.7937743190661477,0.0,20.0
8514,2,514,[223 298 331 284 508],178,3,1439,2.7941747572815534,20.0,20.0
8515,2,515,[298 244 236 202 206],916,2,1441,2.7926356589147288,0.0,20.0
8516,2,516,[254 212 232 240 218],1,1,1442,2.7891682785299805,0.0,0.0
8517,2,517,[276 226 221 508 223],201,3,1445,2.7895752895752897,20.0,0.0
8518,2,518,[240 254 230 300 268],276,4,1449,2.791907514450867,0.0,40.0
8519,2,519,[254 583 324 384 201],276,2,1451,2.7903846153846152,0.0,0.0
8520,2,520,[239 227 276 301 240],880,4,1455,2.7927063339731286,0.0,0.0
8521,2,521,[216 367 222 250 452],896,3,1458,2.793103448275862,0.0,40.0
8522,2,522,[226 276 321 209 384],303,3,1461,2.7934990439770555,0.0,0.0
8523,2,523,[208 250 431 201 227],429,2,1463,2.7919847328244276,0.0,0.0
8524,2,524,[275 298 240 485 290],293,1,1464,2.7885714285714287,0.0,20.0
8525,2,525,[431 222 250 315 201],363,1,1465,2.785171102661597,20.0,20.0
8526,2,526,[241 276 221 508 298],758,2,1467,2.7836812144212524,0.0,20.0
8527,2,527,[259 290 223 243 315],393,4,1471,2.7859848484848486,40.0,0.0
8528,2,528,[293 290 280 315 215],293,2,1473,2.784499054820416,20.0,0.0
8529,2,529,[321 208 221 230 291],303,2,1475,2.7830188679245285,0.0,0.0
8530,2,530,[284 293 350 239 250],130,3,1478,2.7834274952919023,0.0,0.0
8531,2,531,[227 283 384 315 299],880,2,1480,2.781954887218045,20.0,0.0
8532,2,532,[230 259 413 507 326],303,1,1481,2.778611632270169,0.0,0.0
8533,2,533,[508 202 384 222 276],276,4,1485,2.7808988764044944,0.0,20.0
8534,2,534,[201 367 508 290 216],303,5,1490,2.7850467289719627,0.0,20.0
8535,2,535,[390 218 241 226 223],303,4,1494,2.787313432835821,20.0,0.0
8536,2,536,[280 298 215 303 217],293,3,1497,2.787709497206704,0.0,20.0
8537,2,537,[226 216 211 209 215],561,2,1499,2.7862453531598512,0.0,20.0
8538,2,538,[213 215 217 227 202],622,3,1502,2.7866419294990723,0.0,0.0
8539,2,539,[268 298 230 241 290],347,3,1505,2.787037037037037,0.0,40.0
8540,2,540,[264 219 301 429 420],276,4,1509,2.789279112754159,0.0,0.0
8541,2,541,[295 275 298 272 268],936,4,1513,2.791512915129151,20.0,40.0
8542,2,542,[219 215 216 303 509],201,2,1515,2.7900552486187844,0.0,20.0
8543,2,543,[250 227 221 240 231],303,3,1518,2.7904411764705883,0.0,0.0
8544,2,544,[367 283 508 251 298],592,5,1523,2.7944954128440367,0.0,20.0
8545,2,545,[215 295 272 298 226],130,4,1527,2.7967032967032965,20.0,20.0
8546,2,546,[300 218 227 283 291],293,0,1527,2.7915904936014626,0.0,20.0
8547,2,547,[223 350 239 227 420],758,3,1530,2.791970802919708,20.0,0.0
8548,2,548,[275 241 244 219 222],178,4,1534,2.7941712204007287,0.0,20.0
8549,2,549,[384 276 250 284 392],276,3,1537,2.7945454545454544,0.0,0.0
8550,2,550,[367 231 246 268 392],727,3,1540,2.79491833030853,0.0,20.0
8551,2,551,[392 264 209 378 291],429,2,1542,2.7934782608695654,0.0,0.0
8552,2,552,[232 241 365 217 324],276,3,1545,2.793851717902351,0.0,0.0
8553,2,553,[246 226 209 583 227],94,2,1547,2.792418772563177,0.0,0.0
8554,2,554,[367 300 220 268 295],178,3,1550,2.7927927927927927,0.0,40.0
8555,2,555,[250 211 390 413 367],286,3,1553,2.7931654676258995,0.0,0.0
8556,2,556,[259 365 272 201 239],682,2,1555,2.791741472172352,20.0,0.0
8557,2,557,[215 365 218 508 276],551,5,1560,2.795698924731183,0.0,0.0
8558,2,558,[509 321 218 231 223],201,2,1562,2.7942754919499104,20.0,0.0
8559,2,559,[420 293 485 367 250],293,2,1564,2.7928571428571427,0.0,0.0
8560,2,560,[293 230 216 202 241],303,4,1568,2.7950089126559714,0.0,20.0
8561,2,561,[324 283 331 276 508],592,4,1572,2.797153024911032,0.0,0.0
8562,2,562,[250 259 246 420 298],682,3,1575,2.797513321492007,0.0,20.0
8563,2,563,[240 206 267 298 218],268,0,1575,2.7925531914893615,0.0,20.0
8564,2,564,[223 331 300 254 315],276,4,1579,2.7946902654867256,40.0,20.0
8565,2,565,[268 250 222 219 583],94,3,1582,2.795053003533569,0.0,40.0
8566,2,566,[230 300 367 259 267],532,3,1585,2.7954144620811285,0.0,20.0
8567,2,567,[508 298 264 243 223],919,2,1587,2.7940140845070425,20.0,20.0
8568,2,568,[215 384 367 507 276],303,4,1591,2.796133567662566,0.0,0.0
8569,2,569,[216 583 299 223 298],682,3,1594,2.7964912280701753,20.0,40.0
8570,2,570,[276 232 221 209 324],303,4,1598,2.7985989492119088,0.0,0.0
8571,2,571,[508 243 259 280 326],181,1,1599,2.7954545454545454,0.0,0.0
8572,2,572,[215 202 211 290 507],747,3,1602,2.7958115183246073,0.0,0.0
8573,2,573,[300 243 255 268 392],130,4,1606,2.797909407665505,0.0,40.0
8574,2,574,[295 316 227 230 218],880,3,1609,2.7982608695652176,20.0,0.0
8575,2,575,[219 291 413 216 299],435,3,1612,2.798611111111111,0.0,20.0
8576,2,576,[217 218 222 208 227],222,2,1614,2.7972270363951472,0.0,20.0
8577,2,577,[507 227 420 316 240],293,2,1616,2.795847750865052,20.0,0.0
8578,2,578,[508 239 209 331 452],758,3,1619,2.796200345423143,0.0,0.0
8579,2,579,[298 243 206 507 240],393,2,1621,2.7948275862068965,0.0,20.0
8580,2,580,[290 300 218 219 392],130,4,1625,2.7969018932874357,0.0,20.0
8581,2,581,[275 231 212 508 201],896,1,1626,2.7938144329896906,0.0,0.0
8582,2,582,[202 250 222 394 384],393,3,1629,2.7941680960548885,0.0,20.0
8583,2,583,[239 250 201 202 272],682,4,1633,2.796232876712329,20.0,0.0
8584,2,584,[367 275 255 216 226],293,1,1634,2.793162393162393,0.0,20.0
8585,2,585,[259 303 243 202 326],919,2,1636,2.7918088737201363,0.0,0.0
8586,2,586,[206 293 251 239 284],293,3,1639,2.7921635434412266,0.0,0.0
8587,2,587,[326 350 222 255 298],592,4,1643,2.79421768707483,0.0,40.0
8588,2,588,[284 324 218 508 293],303,4,1647,2.796264855687606,0.0,0.0
8589,2,589,[201 508 255 202 241],303,5,1652,2.8,0.0,0.0
8590,2,590,[283 509 217 222 297],293,1,1653,2.796954314720812,0.0,20.0
8591,2,591,[209 218 232 226 202],682,1,1654,2.793918918918919,0.0,0.0
8592,2,592,[384 293 299 284 243],880,3,1657,2.794266441821248,0.0,0.0
8593,2,593,[507 384 227 230 452],303,1,1658,2.791245791245791,0.0,0.0
8594,2,594,[202 209 507 236 251],303,5,1663,2.794957983193277,0.0,0.0
8595,2,595,[202 212 218 264 216],1,3,1666,2.795302013422819,0.0,20.0
8596,2,596,[303 264 222 508 240],919,2,1668,2.7939698492462313,0.0,20.0
8597,2,597,[217 222 232 261 219],222,3,1671,2.794314381270903,0.0,20.0
8598,2,598,[276 250 217 316 367],880,4,1675,2.7963272120200333,20.0,0.0
8599,2,599,[431 211 420 384 218],758,3,1678,2.796666666666667,0.0,0.0
8600,2,600,[250 290 231 222 223],429,2,1680,2.7953410981697173,20.0,20.0
8601,2,601,[227 218 290 272 583],276,4,1684,2.79734219269103,20.0,0.0
8602,2,602,[216 315 275 452 230],201,2,1686,2.7960199004975124,20.0,20.0
8603,2,603,[201 221 216 272 222],201,2,1688,2.794701986754967,20.0,40.0
8604,2,604,[216 212 227 239 240],1,4,1692,2.796694214876033,0.0,20.0
8605,2,605,[452 227 219 241 216],933,0,1692,2.792079207920792,0.0,20.0
8606,2,606,[367 223 240 259 275],393,3,1695,2.7924217462932455,20.0,0.0
8607,2,607,[222 230 241 315 212],201,1,1696,2.789473684210526,20.0,20.0
8608,2,608,[284 219 507 264 367],303,4,1700,2.7914614121510675,0.0,0.0
8609,2,609,[276 481 217 290 298],429,2,1702,2.7901639344262295,0.0,20.0
8610,2,610,[272 232 221 431 222],201,0,1702,2.785597381342062,20.0,20.0
8611,2,611,[431 344 215 243 272],592,3,1705,2.7859477124183005,20.0,0.0
8612,2,612,[240 218 259 216 202],303,3,1708,2.7862969004893965,0.0,20.0
8613,2,613,[226 290 275 298 232],293,1,1709,2.7833876221498373,0.0,20.0
8614,2,614,[293 316 276 250 212],758,3,1712,2.783739837398374,20.0,0.0
8615,2,615,[331 452 219 272 264],276,3,1715,2.784090909090909,20.0,0.0
8616,2,616,[481 378 230 290 208],429,1,1716,2.781199351701783,0.0,0.0
8617,2,617,[217 259 223 226 254],682,1,1717,2.77831715210356,20.0,0.0
8618,2,618,[211 241 298 219 239],682,3,1720,2.778675282714055,0.0,20.0
8619,2,619,[213 244 239 247 219],1,1,1721,2.7758064516129033,0.0,0.0
8620,2,620,[209 268 420 367 218],682,1,1722,2.7729468599033815,0.0,20.0
8621,2,621,[283 206 216 420 218],293,3,1725,2.7733118971061095,0.0,20.0
8622,2,622,[284 215 300 255 303],293,2,1727,2.7720706260032104,0.0,20.0
8623,2,623,[326 221 219 230 276],303,3,1730,2.7724358974358974,0.0,0.0
8624,2,624,[239 384 208 240 230],497,2,1732,2.7712,0.0,0.0
8625,2,625,[208 230 239 293 272],293,2,1734,2.769968051118211,20.0,0.0
8626,2,626,[431 367 295 226 300],532,5,1739,2.7735247208931417,0.0,20.0
8627,2,627,[240 209 251 272 208],1,3,1742,2.7738853503184715,20.0,0.0
8628,2,628,[324 222 300 202 217],327,1,1743,2.7710651828298887,0.0,40.0
8629,2,629,[216 230 268 206 209],868,3,1746,2.7714285714285714,0.0,40.0
8630,2,630,[259 321 431 316 206],393,2,1748,2.7702060221870046,20.0,0.0
8631,2,631,[316 255 583 283 206],293,1,1749,2.767405063291139,20.0,0.0
8632,2,632,[276 209 239 264 365],276,3,1752,2.7677725118483414,0.0,0.0
8633,2,633,[268 215 213 365 208],790,2,1754,2.7665615141955837,0.0,20.0
8634,2,634,[241 215 250 230 231],303,4,1758,2.768503937007874,0.0,0.0
8635,2,635,[240 216 246 276 365],244,3,1761,2.768867924528302,0.0,20.0
8636,2,636,[301 331 315 295 298],532,4,1765,2.770800627943485,20.0,20.0
8637,2,637,[284 230 232 208 246],727,2,1767,2.769592476489028,0.0,0.0
8638,2,638,[508 299 239 326 293],130,4,1771,2.7715179968701094,0.0,0.0
8639,2,639,[227 223 256 431 284],363,2,1773,2.7703125,20.0,0.0
8640,2,640,[240 218 213 239 297],758,3,1776,2.7706708268330735,0.0,0.0
8641,2,641,[208 202 218 243 231],880,3,1779,2.7710280373831777,0.0,0.0
8642,2,642,[232 239 201 290 240],268,0,1779,2.7667185069984446,0.0,0.0
8643,2,643,[276 268 331 226 392],130,4,1783,2.768633540372671,0.0,20.0
8644,2,644,[298 215 223 264 297],293,4,1787,2.7705426356589147,20.0,20.0
8645,2,645,[215 209 272 316 390],286,3,1790,2.7708978328173375,40.0,0.0
8646,2,646,[209 583 429 201 219],425,1,1791,2.7681607418856258,0.0,0.0
8647,2,647,[222 231 507 303 202],747,2,1793,2.7669753086419755,0.0,20.0
8648,2,648,[284 239 250 226 509],293,0,1793,2.76271186440678,0.0,0.0
8649,2,649,[367 218 255 280 508],222,1,1794,2.76,0.0,0.0
8650,2,650,[290 222 452 246 226],268,3,1797,2.76036866359447,0.0,20.0
8651,2,651,[219 254 261 223 247],1,1,1798,2.7576687116564416,20.0,0.0
8652,2,652,[336 209 301 251 232],286,5,1803,2.761102603369066,0.0,0.0
8653,2,653,[420 201 209 583 291],682,1,1804,2.758409785932722,0.0,0.0
8654,2,654,[291 236 452 295 300],130,4,1808,2.76030534351145,0.0,20.0
8655,2,655,[239 217 429 201 420],276,5,1813,2.763719512195122,0.0,0.0
8656,2,656,[221 201 230 452 276],303,3,1816,2.7640791476407913,0.0,0.0
8657,2,657,[293 303 216 243 272],592,4,1820,2.765957446808511,20.0,20.0
8658,2,658,[255 284 208 206 215],606,4,1824,2.7678300455235205,0.0,0.0
8659,2,659,[315 431 250 230 231],484,3,1827,2.768181818181818,20.0,0.0
8660,2,660,[378 215 485 240 255],472,4,1831,2.7700453857791225,0.0,0.0
8661,2,661,[316 223 236 276 293],758,3,1834,2.770392749244713,40.0,0.0
8662,2,662,[261 239 209 259 226],1,2,1836,2.769230769230769,0.0,0.0
8663,2,663,[232 378 215 231 291],487,3,1839,2.769578313253012,0.0,0.0
8664,2,664,[201 264 508 202 283],429,2,1841,2.768421052631579,0.0,0.0
8665,2,665,[431 420 301 227 298],532,5,1846,2.7717717717717716,0.0,20.0
8666,2,666,[264 208 254 251 202],1,3,1849,2.7721139430284856,0.0,0.0
8667,2,667,[226 250 485 264 275],429,1,1850,2.769461077844311,0.0,0.0
8668,2,668,[218 251 261 206 230],1,3,1853,2.7698056801195814,0.0,0.0
8669,2,669,[283 481 384 241 485],299,1,1854,2.7671641791044777,0.0,0.0
8670,2,670,[208 298 206 216 223],293,4,1858,2.7690014903129656,20.0,40.0
8671,2,671,[250 303 213 226 215],293,2,1860,2.767857142857143,0.0,0.0
8672,2,672,[215 218 226 326 324],551,4,1864,2.7696879643387815,0.0,0.0
8673,2,673,[324 326 227 226 218],551,4,1868,2.771513353115727,0.0,0.0
8674,2,674,[247 216 250 218 236],1,3,1871,2.771851851851852,0.0,20.0
8675,2,675,[394 246 232 201 268],880,4,1875,2.7736686390532546,0.0,20.0
8676,2,676,[211 431 250 219 215],327,2,1877,2.772525849335303,0.0,0.0
8677,2,677,[336 508 299 303 283],181,0,1877,2.7684365781710913,0.0,0.0
8678,2,678,[218 241 268 367 223],94,4,1881,2.7702503681885124,20.0,20.0
8679,2,679,[226 217 431 231 223],561,1,1882,2.7676470588235293,20.0,0.0
8680,2,680,[227 240 222 331 367],130,3,1885,2.7679882525697503,0.0,20.0
8681,2,681,[232 431 216 231 392],429,3,1888,2.768328445747801,0.0,20.0
8682,2,682,[221 268 251 324 298],303,4,1892,2.7701317715959006,0.0,40.0
8683,2,683,[293 255 336 239 211],327,0,1892,2.7660818713450293,0.0,0.0
8684,2,684,[295 213 206 367 250],916,2,1894,2.764963503649635,0.0,0.0
8685,2,685,[481 331 293 297 250],758,4,1898,2.7667638483965016,0.0,0.0
8686,2,686,[508 392 284 272 384],880,3,1901,2.7671033478893743,20.0,0.0
8687,2,687,[202 230 431 215 201],435,2,1903,2.765988372093023,0.0,0.0
8688,2,688,[276 384 291 222 316],276,3,1906,2.7663280116110305,20.0,20.0
8689,2,689,[250 254 255 290 202],130,2,1908,2.765217391304348,0.0,0.0
8690,2,690,[378 215 420 239 367],682,1,1909,2.7626628075253254,0.0,0.0
8691,2,691,[291 215 264 367 431],276,1,1910,2.760115606936416,0.0,0.0
8692,2,692,[227 275 291 232 230],896,3,1913,2.7604617604617605,0.0,0.0
8693,2,693,[509 219 222 246 202],94,3,1916,2.760806916426513,0.0,20.0
8694,2,694,[331 261 508 303 283],592,3,1919,2.7611510791366904,0.0,0.0
8695,2,695,[284 223 365 276 280],551,4,1923,2.7629310344827585,20.0,0.0
8696,2,696,[255 264 384 326 293],303,2,1925,2.7618364418938306,0.0,0.0
8697,2,697,[251 215 259 232 507],303,4,1929,2.7636103151862463,0.0,0.0
8698,2,698,[218 250 256 241 264],1,3,1932,2.763948497854077,0.0,0.0
8699,2,699,[303 508 324 209 291],276,4,1936,2.7657142857142856,0.0,0.0
8700,2,700,[259 321 583 240 290],303,1,1937,2.7631954350927246,0.0,0.0
8701,2,701,[299 219 216 420 226],682,2,1939,2.762108262108262,0.0,20.0
8702,2,702,[509 300 280 251 297],293,2,1941,2.7610241820768135,0.0,20.0
8703,2,703,[236 209 221 222 264],1,4,1945,2.762784090909091,0.0,20.0
8704,2,704,[255 244 250 300 226],178,4,1949,2.7645390070921985,0.0,20.0
8705,2,705,[293 227 230 316 211],758,4,1953,2.76628895184136,20.0,0.0
8706,2,706,[384 367 413 324 223],276,2,1955,2.7652050919377653,20.0,0.0
8707,2,707,[268 211 239 384 216],682,3,1958,2.7655367231638417,0.0,40.0
8708,2,708,[255 299 216 217 268],682,4,1962,2.767277856135402,0.0,40.0
8709,2,709,[276 221 298 272 201],919,4,1966,2.769014084507042,20.0,20.0
8710,2,710,[293 231 217 222 239],222,2,1968,2.7679324894514767,0.0,20.0
8711,2,711,[223 583 241 216 508],303,4,1972,2.769662921348315,20.0,20.0
8712,2,712,[239 429 232 246 227],276,4,1976,2.771388499298738,0.0,0.0
8713,2,713,[272 268 240 316 315],551,4,1980,2.773109243697479,60.0,20.0
8714,2,714,[272 206 316 213 275],293,2,1982,2.772027972027972,40.0,0.0
8715,2,715,[241 384 208 291 217],758,3,1985,2.772346368715084,0.0,0.0
8716,2,716,[290 276 213 241 246],916,4,1989,2.774058577405858,0.0,0.0
8717,2,717,[221 316 250 212 331],758,4,1993,2.7757660167130918,20.0,0.0
8718,2,718,[246 321 209 276 201],303,4,1997,2.777468706536857,0.0,0.0
8719,2,719,[583 293 241 300 209],276,4,2001,2.779166666666667,0.0,20.0
8720,2,720,[218 316 283 301 209],880,3,2004,2.779472954230236,20.0,0.0
8721,2,721,[226 431 384 241 481],896,2,2006,2.778393351800554,0.0,0.0
8722,2,722,[209 222 220 280 244],178,3,2009,2.7786998616874135,0.0,20.0
8723,2,723,[268 215 254 452 231],276,2,2011,2.777624309392265,0.0,20.0
8724,2,724,[209 276 230 316 231],880,2,2013,2.776551724137931,20.0,0.0
8725,2,725,[290 231 367 284 217],429,0,2013,2.772727272727273,0.0,0.0
8726,2,726,[284 413 283 246 241],303,3,2016,2.7730398899587345,0.0,0.0
8727,2,727,[216 508 272 218 212],758,5,2021,2.776098901098901,20.0,20.0
8728,2,728,[315 276 331 236 246],130,4,2025,2.7777777777777777,20.0,0.0
8729,2,729,[236 250 431 211 212],758,4,2029,2.7794520547945205,0.0,0.0
8730,2,730,[216 291 226 478 209],896,2,2031,2.7783857729138166,20.0,20.0
8731,2,731,[293 218 240 283 509],293,1,2032,2.7759562841530054,0.0,0.0
8732,2,732,[392 300 326 280 232],222,4,2036,2.77762619372442,0.0,20.0
8733,2,733,[297 276 223 293 246],919,4,2040,2.779291553133515,20.0,0.0
8734,2,734,[217 298 213 344 202],758,3,2043,2.779591836734694,0.0,20.0
8735,2,735,[316 301 201 392 227],880,3,2046,2.779891304347826,20.0,0.0
8736,2,736,[481 211 241 452 291],896,3,2049,2.780189959294437,0.0,0.0
8737,2,737,[254 211 420 255 299],435,3,2052,2.7804878048780486,0.0,0.0
8738,2,738,[367 280 507 392 283],393,2,2054,2.7794316644113666,0.0,0.0
8739,2,739,[326 239 215 290 367],130,4,2058,2.781081081081081,0.0,0.0
8740,2,740,[208 243 219 213 202],1,2,2060,2.7800269905533064,0.0,0.0
8741,2,741,[413 365 268 420 452],276,2,2062,2.778975741239892,0.0,20.0
8742,2,742,[478 241 226 250 255],178,5,2067,2.781965006729475,20.0,0.0
8743,2,743,[230 222 583 206 226],293,1,2068,2.7795698924731185,0.0,20.0
8744,2,744,[583 420 316 250 298],293,2,2070,2.778523489932886,20.0,20.0
8745,2,745,[290 236 255 261 295],130,3,2073,2.778820375335121,0.0,0.0
8746,2,746,[301 272 206 583 223],276,4,2077,2.78045515394913,40.0,0.0
8747,2,747,[367 508 240 222 299],880,5,2082,2.783422459893048,0.0,20.0
8748,2,748,[232 223 231 264 367],429,2,2084,2.7823765020026703,20.0,0.0
8749,2,749,[218 392 431 507 209],846,3,2087,2.7826666666666666,0.0,0.0
8750,2,750,[218 290 250 267 206],268,1,2088,2.780292942743009,0.0,0.0
8751,2,751,[298 276 217 290 201],682,3,2091,2.7805851063829787,0.0,20.0
8752,2,752,[226 206 244 254 251],1,2,2093,2.7795484727755646,0.0,0.0
8753,2,753,[272 216 231 222 226],682,3,2096,2.779840848806366,20.0,40.0
8754,2,754,[218 223 452 202 232],201,2,2098,2.7788079470198674,20.0,0.0
8755,2,755,[420 217 331 299 367],435,4,2102,2.7804232804232805,0.0,0.0
8756,2,756,[485 429 239 293 297],293,3,2105,2.7807133421400265,0.0,0.0
8757,2,757,[276 215 299 344 255],592,4,2109,2.782321899736148,0.0,0.0
8758,2,758,[232 246 384 213 227],790,2,2111,2.7812911725955205,0.0,0.0
8759,2,759,[239 217 209 222 275],327,2,2113,2.780263157894737,0.0,20.0
8760,2,760,[222 272 276 316 365],880,4,2117,2.7818659658344282,40.0,20.0
8761,2,761,[365 232 254 293 276],880,3,2120,2.7821522309711284,0.0,0.0
8762,2,762,[241 215 429 284 232],276,4,2124,2.783748361730013,0.0,0.0
8763,2,763,[298 232 251 452 264],303,3,2127,2.7840314136125652,0.0,20.0
8764,2,764,[367 218 365 230 213],846,2,2129,2.7830065359477123,0.0,0.0
8765,2,765,[226 291 239 420 384],276,3,2132,2.783289817232376,0.0,0.0
8766,2,766,[213 583 316 485 280],293,0,2132,2.7796610169491527,20.0,0.0
8767,2,767,[250 247 413 226 227],222,0,2132,2.7760416666666665,0.0,0.0
8768,2,768,[215 222 272 291 452],276,3,2135,2.776332899869961,20.0,20.0
8769,2,769,[315 508 208 209 246],542,3,2138,2.7766233766233768,20.0,0.0
8770,2,770,[276 240 392 268 247],222,3,2141,2.776913099870298,0.0,20.0
8771,2,771,[222 276 272 246 230],880,4,2145,2.778497409326425,20.0,20.0
8772,2,772,[291 365 452 272 583],276,1,2146,2.776196636481242,20.0,0.0
8773,2,773,[299 201 255 331 239],435,4,2150,2.7777777777777777,0.0,0.0
8774,2,774,[378 321 384 239 365],393,2,2152,2.776774193548387,0.0,0.0
8775,2,775,[221 254 256 216 227],1,4,2156,2.7783505154639174,0.0,20.0
8776,2,776,[301 206 283 284 431],363,0,2156,2.774774774774775,0.0,0.0
8777,2,777,[206 261 215 291 452],130,4,2160,2.776349614395887,0.0,0.0
8778,2,778,[420 315 367 217 301],276,4,2164,2.777920410783055,20.0,0.0
8779,2,779,[241 431 209 232 215],846,4,2168,2.7794871794871794,0.0,0.0
8780,2,780,[240 232 201 231 239],276,3,2171,2.7797695262483995,0.0,0.0
8781,2,781,[300 298 251 239 240],299,3,2174,2.7800511508951407,0.0,40.0
8782,2,782,[218 276 215 384 268],276,4,2178,2.781609195402299,0.0,20.0
8783,2,783,[297 209 485 291 202],293,1,2179,2.7793367346938775,0.0,0.0
8784,2,784,[331 230 420 316 216],532,5,2184,2.7821656050955412,20.0,20.0
8785,2,785,[208 413 215 227 223],246,4,2188,2.7837150127226464,20.0,0.0
8786,2,786,[230 215 231 452 255],130,3,2191,2.783989834815756,0.0,0.0
8787,2,787,[290 315 268 232 201],99,3,2194,2.784263959390863,20.0,20.0
8788,2,788,[276 231 226 227 284],201,2,2196,2.783269961977186,0.0,0.0
8789,2,789,[231 241 293 378 298],222,1,2197,2.7810126582278483,0.0,20.0
8790,2,790,[215 241 219 231 583],276,3,2200,2.781289506953224,0.0,0.0
8791,2,791,[321 280 241 508 365],429,1,2201,2.779040404040404,0.0,0.0
8792,2,792,[485 241 206 378 239],393,3,2204,2.779319041614124,0.0,0.0
8793,2,793,[201 300 478 216 367],896,3,2207,2.779596977329975,20.0,40.0
8794,2,794,[230 226 378 272 280],487,4,2211,2.781132075471698,20.0,0.0
8795,2,795,[231 222 384 227 250],727,2,2213,2.780150753768844,0.0,20.0
8796,2,796,[284 230 365 298 227],222,3,2216,2.780426599749059,0.0,20.0
8797,2,797,[239 250 215 284 227],301,3,2219,2.780701754385965,0.0,0.0
8798,2,798,[219 298 222 209 230],303,3,2222,2.780976220275344,0.0,40.0
8799,2,799,[217 215 420 321 276],130,4,2226,2.7825,0.0,0.0
8800,2,800,[202 478 208 316 219],407,5,2231,2.7852684144818975,40.0,0.0
8801,2,801,[239 216 226 275 303],201,2,2233,2.78428927680798,0.0,20.0
8802,2,802,[284 222 367 272 239],293,1,2234,2.7820672478206725,20.0,20.0
8803,2,803,[217 246 222 291 452],276,3,2237,2.7823383084577116,0.0,20.0
8804,2,804,[219 431 272 232 324],201,2,2239,2.7813664596273293,20.0,0.0
8805,2,805,[303 226 222 223 392],276,4,2243,2.7828784119106698,20.0,20.0
8806,2,806,[367 209 291 226 216],429,3,2246,2.7831474597273855,0.0,20.0
8807,2,807,[206 583 272 284 239],293,2,2248,2.782178217821782,20.0,0.0
8808,2,808,[226 316 272 267 298],532,4,2252,2.783683559950556,40.0,20.0
8809,2,809,[219 420 240 384 298],276,4,2256,2.785185185185185,0.0,20.0
8810,2,810,[202 217 226 227 275],293,0,2256,2.781750924784217,0.0,0.0
8811,2,811,[236 255 283 298 209],303,4,2260,2.7832512315270934,0.0,20.0
8812,2,812,[291 283 303 280 236],181,1,2261,2.7810578105781056,0.0,0.0
8813,2,813,[365 583 276 392 219],276,2,2263,2.7800982800982803,0.0,0.0
8814,2,814,[583 230 290 240 268],276,4,2267,2.78159509202454,0.0,20.0
8815,2,815,[264 246 227 208 413],435,3,2270,2.781862745098039,0.0,0.0
8816,2,816,[215 481 390 478 301],747,4,2274,2.783353733170135,20.0,0.0
8817,2,817,[236 232 508 218 264],303,4,2278,2.784841075794621,0.0,0.0
8818,2,818,[251 202 420 226 239],293,2,2280,2.7838827838827838,0.0,0.0
8819,2,819,[215 316 284 485 507],293,2,2282,2.7829268292682925,20.0,0.0
8820,2,820,[240 216 290 384 299],682,3,2285,2.7831912302070645,0.0,20.0
8821,2,821,[344 213 231 293 216],758,2,2287,2.7822384428223845,0.0,20.0
8822,2,822,[215 223 431 290 315],363,1,2288,2.7800729040097205,40.0,0.0
8823,2,823,[201 230 246 300 250],435,3,2291,2.7803398058252426,0.0,20.0
8824,2,824,[276 246 378 452 226],399,0,2291,2.776969696969697,0.0,0.0
8825,2,825,[231 232 316 293 429],425,3,2294,2.777239709443099,20.0,0.0
8826,2,826,[251 236 324 259 232],303,3,2297,2.777509068923821,0.0,0.0
8827,2,827,[384 222 431 316 202],758,4,2301,2.778985507246377,20.0,20.0
8828,2,828,[215 240 452 212 219],201,2,2303,2.778045838359469,0.0,0.0
8829,2,829,[227 452 239 276 268],201,3,2306,2.778313253012048,0.0,20.0
8830,2,830,[222 230 227 202 231],660,0,2306,2.7749699157641396,0.0,20.0
8831,2,831,[216 241 219 583 280],551,3,2309,2.7752403846153846,0.0,20.0
8832,2,832,[276 508 227 222 365],880,3,2312,2.7755102040816326,0.0,20.0
8833,2,833,[202 291 384 239 218],303,2,2314,2.774580335731415,0.0,0.0
8834,2,834,[509 241 276 213 256],916,4,2318,2.776047904191617,0.0,0.0
8835,2,835,[223 219 316 583 326],551,4,2322,2.777511961722488,40.0,0.0
8836,2,836,[218 344 478 239 246],327,3,2325,2.7777777777777777,20.0,0.0
8837,2,837,[259 208 264 219 452],303,2,2327,2.7768496420047732,0.0,0.0
8838,2,838,[384 241 250 293 508],276,4,2331,2.7783075089392133,0.0,0.0
8839,2,839,[250 264 221 367 297],592,4,2335,2.7797619047619047,0.0,0.0
8840,2,840,[201 290 217 272 298],682,4,2339,2.7812128418549347,20.0,20.0
8841,2,841,[431 508 583 209 223],201,2,2341,2.7802850356294537,20.0,0.0
8842,2,842,[251 241 259 218 208],1,3,2344,2.7805456702253855,0.0,0.0
8843,2,843,[223 208 244 251 259],1,3,2347,2.7808056872037916,20.0,0.0
8844,2,844,[206 254 300 219 321],435,2,2349,2.7798816568047338,0.0,20.0
8845,2,845,[298 231 241 275 508],429,3,2352,2.780141843971631,0.0,20.0
8846,2,846,[298 251 367 264 275],299,4,2356,2.781582054309327,0.0,20.0
8847,2,847,[331 206 209 211 227],201,2,2358,2.7806603773584904,0.0,0.0
8848,2,848,[508 226 202 223 268],276,5,2363,2.7832744405182566,20.0,20.0
8849,2,849,[507 232 202 293 215],303,5,2368,2.7858823529411763,0.0,0.0
8850,2,850,[226 232 390 216 326],303,3,2371,2.7861339600470036,0.0,20.0
8851,2,851,[275 284 303 240 217],201,1,2372,2.784037558685446,0.0,0.0
8852,2,852,[231 293 291 420 222],303,3,2375,2.7842907385697537,0.0,20.0
8853,2,853,[219 293 215 392 452],276,3,2378,2.7845433255269323,0.0,0.0
8854,2,854,[261 255 236 303 272],919,4,2382,2.7859649122807015,20.0,0.0
8855,2,855,[222 316 206 365 264],276,3,2385,2.786214953271028,20.0,20.0
8856,2,856,[259 326 303 236 268],919,3,2388,2.7864644107351224,0.0,20.0
8857,2,857,[298 264 251 223 326],303,3,2391,2.7867132867132867,20.0,20.0
8858,2,858,[217 240 367 241 431],682,4,2395,2.7881257275902214,0.0,0.0
8859,2,859,[367 280 232 291 259],682,0,2395,2.7848837209302326,0.0,0.0
8860,2,860,[239 384 217 211 259],727,3,2398,2.7851335656213707,0.0,0.0
8861,2,861,[276 221 217 239 219],916,3,2401,2.78538283062645,0.0,0.0
8862,2,862,[275 509 481 485 367],299,4,2405,2.786790266512167,0.0,0.0
8863,2,863,[301 240 217 326 300],21,3,2408,2.787037037037037,0.0,20.0
8864,2,864,[394 246 217 301 384],880,3,2411,2.7872832369942198,0.0,0.0
8865,2,865,[291 420 303 231 241],758,2,2413,2.7863741339491916,0.0,0.0
8866,2,866,[301 392 215 232 303],276,3,2416,2.7866205305651675,0.0,0.0
8867,2,867,[211 218 222 239 431],561,1,2417,2.7845622119815667,0.0,20.0
8868,2,868,[508 241 221 231 259],303,4,2421,2.7859608745684694,0.0,0.0
8869,2,869,[291 264 226 215 239],435,3,2424,2.786206896551724,0.0,0.0
8870,2,870,[230 481 276 290 508],429,2,2426,2.785304247990815,0.0,0.0
8871,2,871,[283 241 324 219 507],303,3,2429,2.7855504587155964,0.0,0.0
8872,2,872,[298 290 223 291 230],429,3,2432,2.785796105383734,20.0,20.0
8873,2,873,[264 303 239 272 413],276,3,2435,2.78604118993135,20.0,0.0
8874,2,874,[231 367 218 226 508],456,2,2437,2.785142857142857,0.0,0.0
8875,2,875,[230 222 239 232 202],222,5,2442,2.787671232876712,0.0,20.0
8876,2,876,[241 268 300 231 250],621,4,2446,2.7890535917901937,0.0,40.0
8877,2,877,[250 209 275 507 201],727,2,2448,2.788154897494305,0.0,0.0
8878,2,878,[211 241 280 231 378],429,1,2449,2.7861205915813425,0.0,0.0
8879,2,879,[256 298 284 230 232],363,1,2450,2.784090909090909,0.0,20.0
8880,2,880,[243 316 300 231 230],130,2,2452,2.783200908059024,20.0,20.0
8881,2,881,[283 201 485 392 290],429,0,2452,2.7800453514739227,0.0,0.0
8882,2,882,[254 431 226 255 394],435,2,2454,2.77916194790487,0.0,0.0
8883,2,883,[301 223 222 246 261],592,2,2456,2.7782805429864252,20.0,20.0
8884,2,884,[240 212 211 268 232],561,1,2457,2.776271186440678,0.0,20.0
8885,2,885,[384 508 236 221 431],758,3,2460,2.7765237020316027,0.0,0.0
8886,2,886,[208 218 261 232 227],1,2,2462,2.7756482525366404,0.0,0.0
8887,2,887,[367 413 206 295 315],130,2,2464,2.774774774774775,20.0,0.0
8888,2,888,[244 276 331 259 293],250,3,2467,2.7750281214848145,0.0,0.0
8889,2,889,[254 350 300 452 255],130,4,2471,2.7764044943820223,0.0,20.0
8890,2,890,[211 509 232 326 324],201,1,2472,2.774410774410774,0.0,0.0
8891,2,891,[324 202 239 226 246],303,3,2475,2.774663677130045,0.0,0.0
8892,2,892,[206 215 299 392 218],130,3,2478,2.77491601343785,0.0,0.0
8893,2,893,[326 221 261 324 284],181,0,2478,2.771812080536913,0.0,0.0
8894,2,894,[239 209 429 202 431],276,4,2482,2.7731843575418993,0.0,0.0
8895,2,895,[202 254 284 431 365],682,3,2485,2.7734375,0.0,0.0
8896,2,896,[301 429 230 208 219],660,2,2487,2.7725752508361206,0.0,0.0
8897,2,897,[452 392 246 321 226],130,5,2492,2.775055679287305,0.0,0.0
8898,2,898,[284 239 243 291 217],682,2,2494,2.774193548387097,0.0,0.0
8899,2,899,[231 452 208 211 293],758,2,2496,2.7733333333333334,0.0,0.0
8900,2,900,[384 230 222 240 202],551,3,2499,2.7735849056603774,0.0,20.0
8901,2,901,[367 254 232 219 284],276,2,2501,2.772727272727273,0.0,0.0
8902,2,902,[213 272 350 384 239],758,4,2505,2.7740863787375414,20.0,0.0
8903,2,903,[276 202 255 223 244],178,3,2508,2.774336283185841,20.0,0.0
8904,2,904,[321 239 202 212 223],201,2,2510,2.773480662983425,20.0,0.0
8905,2,905,[299 284 394 208 367],880,4,2514,2.774834437086093,0.0,0.0
8906,2,906,[297 293 209 300 222],293,2,2516,2.7739801543550167,0.0,40.0
8907,2,907,[420 299 452 226 231],130,3,2519,2.7742290748898677,0.0,0.0
8908,2,908,[392 227 272 255 394],393,5,2524,2.776677667766777,20.0,0.0
8909,2,909,[392 222 507 241 300],429,2,2526,2.7758241758241757,0.0,40.0
8910,2,910,[452 215 367 223 250],276,3,2529,2.7760702524698133,20.0,0.0
8911,2,911,[324 295 222 331 283],592,3,2532,2.776315789473684,0.0,20.0
8912,2,912,[218 212 239 291 223],758,4,2536,2.777656078860898,20.0,0.0
8913,2,913,[226 413 221 384 264],303,2,2538,2.7768052516411377,0.0,0.0
8914,2,914,[226 481 223 283 300],429,1,2539,2.774863387978142,20.0,20.0
8915,2,915,[219 365 301 429 392],276,3,2542,2.7751091703056767,0.0,0.0
8916,2,916,[315 293 236 297 336],592,3,2545,2.7753544165757904,20.0,0.0
8917,2,917,[230 259 246 232 226],268,2,2547,2.7745098039215685,0.0,0.0
8918,2,918,[251 230 241 272 213],1,3,2550,2.7747551686615886,20.0,0.0
8919,2,919,[222 367 452 219 227],933,1,2551,2.7728260869565218,0.0,20.0
8920,2,920,[298 276 290 280 481],429,2,2553,2.771986970684039,0.0,20.0
8921,2,921,[300 291 246 276 208],303,3,2556,2.772234273318872,0.0,20.0
8922,2,922,[239 367 272 246 240],276,4,2560,2.7735644637053087,20.0,0.0
8923,2,923,[583 217 413 331 209],276,3,2563,2.7738095238095237,0.0,0.0
8924,2,924,[230 201 231 507 202],727,2,2565,2.772972972972973,0.0,0.0
8925,2,925,[209 509 215 221 367],916,2,2567,2.7721382289416847,0.0,0.0
8926,2,926,[215 250 284 367 223],291,5,2572,2.7745415318230853,20.0,0.0
8927,2,927,[298 202 250 583 280],429,2,2574,2.773706896551724,0.0,20.0
8928,2,928,[583 218 217 230 431],201,1,2575,2.7717976318622175,0.0,0.0
8929,2,929,[219 241 290 230 226],303,4,2579,2.7731182795698923,0.0,0.0
8930,2,930,[300 452 239 219 201],303,2,2581,2.7722878625134264,0.0,20.0
8931,2,931,[223 508 236 290 291],303,4,2585,2.773605150214592,20.0,0.0
8932,2,932,[202 223 239 216 256],1,5,2590,2.7759914255091105,20.0,20.0
8933,2,933,[222 219 241 217 227],201,2,2592,2.7751605995717346,0.0,20.0
8934,2,934,[226 240 202 254 239],246,0,2592,2.7721925133689838,0.0,0.0
8935,2,935,[264 217 211 413 321],435,2,2594,2.7713675213675213,0.0,0.0
8936,2,936,[268 394 219 239 290],435,4,2598,2.7726787620064033,0.0,20.0
8937,2,937,[431 367 215 290 384],682,2,2600,2.771855010660981,0.0,0.0
8938,2,938,[227 298 250 291 236],303,3,2603,2.77209797657082,0.0,20.0
8939,2,939,[215 276 218 384 217],682,2,2605,2.771276595744681,0.0,0.0
8940,2,940,[261 218 276 284 230],130,3,2608,2.771519659936238,0.0,0.0
8941,2,941,[231 215 378 259 431],790,1,2609,2.76963906581741,0.0,0.0
8942,2,942,[291 331 239 429 367],276,3,2612,2.7698833510074232,0.0,0.0
8943,2,943,[222 231 431 219 293],429,4,2616,2.7711864406779663,0.0,20.0
8944,2,944,[240 241 583 230 283],790,2,2618,2.77037037037037,0.0,0.0
8945,2,945,[255 246 254 215 219],130,4,2622,2.7716701902748415,0.0,0.0
8946,2,946,[201 232 222 298 250],363,2,2624,2.7708553326293557,0.0,40.0
8947,2,947,[250 211 431 336 275],286,5,2629,2.773206751054852,0.0,0.0
8948,2,948,[241 384 202 230 290],758,4,2633,2.77449947312961,0.0,0.0
8949,2,949,[508 280 202 392 324],347,2,2635,2.7736842105263158,0.0,0.0
8950,2,950,[254 208 367 250 272],880,3,2638,2.7739221871713986,20.0,0.0
8951,2,951,[268 413 316 246 290],276,4,2642,2.7752100840336134,20.0,20.0
8952,2,952,[208 247 209 201 261],1,2,2644,2.774396642182581,0.0,0.0
8953,2,953,[321 508 259 293 298],919,3,2647,2.7746331236897275,0.0,20.0
8954,2,954,[300 232 367 227 217],896,2,2649,2.7738219895287957,0.0,20.0
8955,2,955,[261 267 276 218 326],130,5,2654,2.776150627615063,0.0,0.0
8956,2,956,[452 239 315 316 243],130,4,2658,2.7774294670846396,40.0,0.0
8957,2,957,[284 240 218 209 215],303,4,2662,2.778705636743215,0.0,0.0
8958,2,958,[284 220 275 291 283],357,5,2667,2.781021897810219,0.0,0.0
8959,2,959,[213 218 216 223 240],293,2,2669,2.7802083333333334,20.0,20.0
8960,2,960,[280 268 217 227 431],916,2,2671,2.7793964620187306,0.0,20.0
8961,2,961,[431 321 284 219 392],429,2,2673,2.7785862785862787,0.0,0.0
8962,2,962,[227 324 219 365 276],276,4,2677,2.779854620976116,0.0,0.0
8963,2,963,[300 227 298 217 297],293,2,2679,2.779045643153527,0.0,40.0
8964,2,964,[350 290 226 216 284],130,3,2682,2.779274611398964,0.0,20.0
8965,2,965,[209 223 201 244 217],1,2,2684,2.7784679089026914,20.0,0.0
8966,2,966,[316 413 250 324 431],276,3,2687,2.7786970010341263,20.0,0.0
8967,2,967,[227 321 206 392 413],130,2,2689,2.777892561983471,0.0,0.0
8968,2,968,[231 209 201 243 254],1,1,2690,2.7760577915376676,0.0,0.0
8969,2,969,[478 431 276 230 219],178,4,2694,2.777319587628866,20.0,0.0
8970,2,970,[301 336 326 300 291],697,4,2698,2.7785787847579813,0.0,20.0
8971,2,971,[365 293 367 222 217],222,2,2700,2.7777777777777777,0.0,20.0
8972,2,972,[268 227 240 384 217],551,2,2702,2.776978417266187,0.0,20.0
8973,2,973,[326 250 239 246 331],130,3,2705,2.777207392197125,0.0,0.0
8974,2,974,[316 254 216 268 295],130,3,2708,2.7774358974358972,20.0,40.0
8975,2,975,[291 290 280 201 293],682,2,2710,2.776639344262295,0.0,0.0
8976,2,976,[255 321 241 367 283],303,3,2713,2.7768679631525077,0.0,0.0
8977,2,977,[331 223 316 272 291],758,5,2718,2.7791411042944785,60.0,0.0
8978,2,978,[509 218 315 209 583],551,4,2722,2.780388151174668,20.0,0.0
8979,2,979,[222 246 283 261 276],592,3,2725,2.7806122448979593,0.0,20.0
8980,2,980,[209 240 315 272 217],293,1,2726,2.778797145769623,40.0,0.0
8981,2,981,[300 227 276 293 254],880,2,2728,2.7780040733197557,0.0,20.0
8982,2,982,[485 230 283 301 275],429,1,2729,2.7761953204476093,0.0,0.0
8983,2,983,[508 226 315 209 250],880,3,2732,2.7764227642276422,20.0,0.0
8984,2,984,[299 392 219 239 254],435,3,2735,2.7766497461928936,0.0,0.0
8985,2,985,[326 315 250 236 206],130,3,2738,2.7768762677484786,20.0,0.0
8986,2,986,[298 250 202 378 239],682,3,2741,2.7771023302938196,0.0,20.0
8987,2,987,[326 206 507 211 298],606,5,2746,2.779352226720648,0.0,20.0
8988,2,988,[268 508 301 223 392],747,3,2749,2.7795753286147624,20.0,20.0
8989,2,989,[321 344 384 365 290],393,0,2749,2.7767676767676766,0.0,0.0
8990,2,990,[239 211 246 276 227],916,3,2752,2.7769929364278507,0.0,0.0
8991,2,991,[261 295 267 216 413],130,3,2755,2.777217741935484,0.0,20.0
8992,2,992,[298 290 291 211 284],435,3,2758,2.7774420946626384,0.0,20.0
8993,2,993,[272 280 293 213 218],293,2,2760,2.7766599597585513,20.0,0.0
8994,2,994,[272 223 275 227 300],293,2,2762,2.7758793969849247,40.0,20.0
8995,2,995,[206 316 420 452 218],276,4,2766,2.7771084337349397,20.0,0.0
8996,2,996,[255 300 241 244 223],178,4,2770,2.778335005015045,20.0,20.0
8997,2,997,[300 268 220 280 331],178,4,2774,2.779559118236473,0.0,40.0
8998,2,998,[217 290 222 240 239],758,2,2776,2.7787787787787788,0.0,20.0
8999,2,999,[241 223 231 291 208],303,4,2780,2.78,20.0,0.0
9000,2,1000,[240 272 246 226 300],682,3,2783,2.78021978021978,20.0,20.0
9001,2,1001,[227 230 206 283 250],363,1,2784,2.7784431137724552,0.0,0.0
9002,2,1002,[201 208 206 222 413],435,3,2787,2.778664007976072,0.0,20.0
9003,2,1003,[201 264 227 218 293],276,4,2791,2.7798804780876494,0.0,0.0
9004,2,1004,[293 413 219 324 232],291,4,2795,2.781094527363184,0.0,0.0
9005,2,1005,[295 243 264 367 223],592,3,2798,2.7813121272365806,20.0,0.0
9006,2,1006,[232 217 239 284 219],896,2,2800,2.7805362462760677,0.0,0.0
9007,2,1007,[231 246 367 241 201],276,3,2803,2.7807539682539684,0.0,0.0
9008,2,1008,[392 291 226 208 290],429,2,2805,2.77998017839445,0.0,0.0
9009,2,1009,[236 251 246 219 226],303,5,2810,2.782178217821782,0.0,0.0
9010,2,1010,[201 301 295 255 275],919,3,2813,2.782393669634026,0.0,0.0
9011,2,1011,[324 241 390 250 215],303,3,2816,2.782608695652174,0.0,0.0
9012,2,1012,[218 293 300 221 291],758,2,2818,2.7818361303060217,0.0,20.0
9013,2,1013,[201 298 202 290 264],429,2,2820,2.7810650887573964,0.0,20.0
9014,2,1014,[268 452 222 208 420],497,1,2821,2.779310344827586,0.0,40.0
9015,2,1015,[392 301 232 394 202],880,3,2824,2.779527559055118,0.0,0.0
9016,2,1016,[219 230 236 392 255],130,4,2828,2.7807276302851522,0.0,0.0
9017,2,1017,[367 298 300 299 243],682,2,2830,2.7799607072691552,0.0,40.0
9018,2,1018,[211 367 222 290 264],293,1,2831,2.7782139352306183,0.0,20.0
9019,2,1019,[219 217 272 202 223],682,3,2834,2.7784313725490195,40.0,0.0
9020,2,1020,[215 201 429 223 431],363,2,2836,2.7776689520078355,20.0,0.0
9021,2,1021,[261 291 275 236 284],181,0,2836,2.7749510763209395,0.0,0.0
9022,2,1022,[261 272 239 293 295],130,4,2840,2.7761485826001957,20.0,0.0
9023,2,1023,[392 250 272 254 259],660,3,2843,2.7763671875,20.0,0.0
9024,2,1024,[326 297 251 250 303],592,5,2848,2.7785365853658535,0.0,0.0
9025,2,1025,[218 367 276 508 230],429,2,2850,2.7777777777777777,0.0,0.0
9026,2,1026,[390 227 508 218 209],303,3,2853,2.7779941577409932,0.0,0.0
9027,2,1027,[217 280 431 231 239],682,2,2855,2.777237354085603,0.0,0.0
9028,2,1028,[222 215 276 219 226],586,2,2857,2.7764820213799806,0.0,20.0
9029,2,1029,[209 236 239 295 583],916,2,2859,2.775728155339806,0.0,0.0
9030,2,1030,[290 219 221 231 259],303,4,2863,2.7769156159068866,0.0,0.0
9031,2,1031,[215 219 478 392 367],846,4,2867,2.7781007751937983,20.0,0.0
9032,2,1032,[478 251 212 209 298],299,4,2871,2.7792836398838334,20.0,20.0
9033,2,1033,[227 268 290 222 280],916,1,2872,2.7775628626692455,0.0,40.0
9034,2,1034,[509 227 236 219 431],916,2,2874,2.7768115942028984,0.0,0.0
9035,2,1035,[201 202 226 583 268],276,4,2878,2.777992277992278,0.0,20.0
9036,2,1036,[215 218 583 231 222],276,3,2881,2.7782063645130184,0.0,20.0
9037,2,1037,[216 326 208 209 290],303,4,2885,2.779383429672447,0.0,20.0
9038,2,1038,[246 231 290 236 321],130,3,2888,2.7795957651588066,0.0,0.0
9039,2,1039,[221 331 272 222 259],919,4,2892,2.7807692307692307,20.0,20.0
9040,2,1040,[275 232 222 272 251],293,2,2894,2.7800192122958696,20.0,20.0
9041,2,1041,[298 213 230 231 272],758,4,2898,2.781190019193858,20.0,20.0
9042,2,1042,[251 264 216 219 291],303,3,2901,2.7813998082454456,0.0,20.0
9043,2,1043,[215 326 321 420 250],130,4,2905,2.782567049808429,0.0,0.0
9044,2,1044,[268 201 230 256 261],1,3,2908,2.782775119617225,0.0,20.0
9045,2,1045,[241 222 255 220 247],1,2,2910,2.7820267686424476,0.0,20.0
9046,2,1046,[367 251 261 243 201],592,3,2913,2.7822349570200573,0.0,0.0
9047,2,1047,[367 276 321 246 384],303,3,2916,2.782442748091603,0.0,0.0
9048,2,1048,[508 209 226 478 218],407,4,2920,2.7836034318398473,20.0,0.0
9049,2,1049,[227 240 231 226 300],880,2,2922,2.782857142857143,0.0,20.0
9050,2,1050,[267 384 284 223 222],268,1,2923,2.7811607992388203,20.0,20.0
9051,2,1051,[420 509 365 583 300],682,0,2923,2.7785171102661597,0.0,20.0
9052,2,1052,[217 508 209 223 221],758,3,2926,2.778727445394112,20.0,0.0
9053,2,1053,[211 241 251 378 478],299,3,2929,2.7789373814041745,20.0,0.0
9054,2,1054,[301 246 219 420 231],276,4,2933,2.7800947867298578,0.0,0.0
9055,2,1055,[202 431 221 315 240],758,2,2935,2.7793560606060606,20.0,0.0
9056,2,1056,[223 218 217 378 232],222,3,2938,2.7795648060548723,20.0,0.0
9057,2,1057,[202 250 315 255 213],293,0,2938,2.776937618147448,20.0,0.0
9058,2,1058,[300 247 367 268 392],222,3,2941,2.777148253068933,0.0,40.0
9059,2,1059,[240 231 230 255 276],222,2,2943,2.776415094339623,0.0,0.0
9060,2,1060,[216 219 264 384 215],435,1,2944,2.774740810556079,0.0,20.0
9061,2,1061,[293 290 350 243 246],130,3,2947,2.774952919020716,0.0,0.0
9062,2,1062,[215 216 206 217 316],293,3,2950,2.77516462841016,20.0,20.0
9063,2,1063,[583 485 431 298 226],429,2,2952,2.774436090225564,0.0,20.0
9064,2,1064,[208 202 215 209 268],222,4,2956,2.775586854460094,0.0,20.0
9065,2,1065,[256 324 321 264 331],181,0,2956,2.772983114446529,0.0,0.0
9066,2,1066,[250 365 321 394 378],393,3,2959,2.7731958762886597,0.0,0.0
9067,2,1067,[284 321 276 227 232],429,2,2961,2.7724719101123596,0.0,0.0
9068,2,1068,[276 390 239 231 230],303,2,2963,2.7717492984097287,0.0,0.0
9069,2,1069,[298 431 255 219 264],435,2,2965,2.7710280373831777,0.0,20.0
9070,2,1070,[250 298 303 255 201],592,5,2970,2.773109243697479,0.0,20.0
9071,2,1071,[222 431 240 276 239],758,1,2971,2.771455223880597,0.0,20.0
9072,2,1072,[291 413 284 267 367],130,3,2974,2.771668219944082,0.0,0.0
9073,2,1073,[290 255 298 344 272],393,3,2977,2.771880819366853,20.0,20.0
9074,2,1074,[315 219 202 255 326],130,5,2982,2.773953488372093,20.0,0.0
9075,2,1075,[303 315 218 367 583],276,3,2985,2.774163568773234,20.0,0.0
9076,2,1076,[255 392 208 222 217],472,5,2990,2.776230269266481,0.0,20.0
9077,2,1077,[378 259 280 485 316],393,4,2994,2.777365491651206,20.0,0.0
9078,2,1078,[231 227 223 267 218],1,3,2997,2.7775718257645967,20.0,0.0
9079,2,1079,[230 284 231 583 264],303,2,2999,2.776851851851852,0.0,0.0
9080,2,1080,[256 298 350 250 217],363,1,3000,2.775208140610546,0.0,20.0
9081,2,1081,[300 324 293 268 218],327,1,3001,2.7735674676524953,0.0,40.0
9082,2,1082,[293 301 452 420 236],758,1,3002,2.7719298245614037,0.0,0.0
9083,2,1083,[230 208 297 250 226],293,1,3003,2.7702952029520294,0.0,0.0
9084,2,1084,[223 283 367 276 298],429,3,3006,2.7705069124423964,20.0,20.0
9085,2,1085,[219 206 227 211 231],896,2,3008,2.7697974217311234,0.0,0.0
9086,2,1086,[303 509 264 250 215],293,2,3010,2.769089236430543,0.0,0.0
9087,2,1087,[298 246 232 226 218],327,2,3012,2.7683823529411766,0.0,20.0
9088,2,1088,[212 236 202 244 268],916,4,3016,2.7695133149678606,0.0,20.0
9089,2,1089,[241 301 290 413 303],276,4,3020,2.770642201834862,0.0,0.0
9090,2,1090,[431 303 481 239 241],758,2,3022,2.76993583868011,0.0,0.0
9091,2,1091,[208 239 365 284 261],222,2,3024,2.769230769230769,0.0,0.0
9092,2,1092,[316 268 220 508 331],178,3,3027,2.7694419030192132,20.0,20.0
9093,2,1093,[211 255 201 324 293],327,1,3028,2.7678244972577697,0.0,0.0
9094,2,1094,[316 324 301 215 315],276,5,3033,2.76986301369863,40.0,0.0
9095,2,1095,[216 392 300 508 218],130,5,3038,2.771897810218978,0.0,40.0
9096,2,1096,[215 290 583 507 321],303,3,3041,2.772105742935278,0.0,0.0
9097,2,1097,[250 290 226 230 392],521,1,3042,2.7704918032786887,0.0,0.0
9098,2,1098,[223 219 251 231 208],1,3,3045,2.770700636942675,20.0,0.0
9099,2,1099,[221 481 420 300 384],758,2,3047,2.77,0.0,20.0
9100,2,1100,[241 478 201 226 215],561,1,3048,2.768392370572207,20.0,0.0
9101,2,1101,[316 431 211 202 240],551,4,3052,2.7695099818511797,20.0,0.0
9102,2,1102,[222 226 208 300 211],293,1,3053,2.7679057116953762,0.0,40.0
9103,2,1103,[420 413 268 324 227],276,4,3057,2.7690217391304346,0.0,20.0
9104,2,1104,[315 268 272 216 321],130,5,3062,2.7710407239819004,40.0,40.0
9105,2,1105,[264 221 250 243 216],1,3,3065,2.77124773960217,0.0,20.0
9106,2,1106,[219 452 227 226 367],846,4,3069,2.772357723577236,0.0,0.0
9107,2,1107,[384 222 316 301 218],880,4,3073,2.773465703971119,20.0,20.0
9108,2,1108,[254 295 452 215 255],130,3,3076,2.7736699729486025,0.0,0.0
9109,2,1109,[216 250 227 367 251],532,4,3080,2.774774774774775,0.0,20.0
9110,2,1110,[315 232 275 240 230],293,0,3080,2.772277227722772,20.0,0.0
9111,2,1111,[394 202 209 268 299],880,3,3083,2.772482014388489,0.0,20.0
9112,2,1112,[485 583 232 246 240],790,2,3085,2.7717879604672055,0.0,0.0
9113,2,1113,[209 298 367 291 429],276,3,3088,2.771992818671454,0.0,20.0
9114,2,1114,[298 280 295 244 213],916,2,3090,2.7713004484304933,0.0,20.0
9115,2,1115,[481 227 452 239 293],758,2,3092,2.770609318996416,0.0,0.0
9116,2,1116,[232 276 223 241 202],682,2,3094,2.7699194270367054,20.0,0.0
9117,2,1117,[217 264 316 211 232],551,3,3097,2.770125223613596,20.0,0.0
9118,2,1118,[202 223 367 218 209],561,2,3099,2.7694369973190347,20.0,0.0
9119,2,1119,[300 276 293 452 219],276,4,3103,2.7705357142857143,0.0,20.0
9120,2,1120,[226 239 246 202 223],1,4,3107,2.7716324710080285,20.0,0.0
9121,2,1121,[230 507 290 215 297],293,3,3110,2.771836007130125,0.0,0.0
9122,2,1122,[431 208 321 284 264],429,2,3112,2.771148708815672,0.0,0.0
9123,2,1123,[509 227 230 216 431],916,2,3114,2.7704626334519573,0.0,20.0
9124,2,1124,[227 298 239 250 222],293,1,3115,2.7688888888888887,0.0,40.0
9125,2,1125,[367 241 209 231 316],276,3,3118,2.769094138543517,20.0,0.0
9126,2,1126,[241 223 275 478 367],896,5,3123,2.7710736468500445,40.0,0.0
9127,2,1127,[298 284 221 300 201],303,4,3127,2.772163120567376,0.0,40.0
9128,2,1128,[420 390 211 226 509],94,4,3131,2.7732506643046944,0.0,0.0
9129,2,1129,[509 300 298 264 293],293,2,3133,2.7725663716814157,0.0,40.0
9130,2,1130,[420 301 236 431 276],758,1,3134,2.770999115826702,0.0,0.0
9131,2,1131,[240 256 241 206 226],1,3,3137,2.771201413427562,0.0,0.0
9132,2,1132,[216 485 208 367 209],456,3,3140,2.7714033539276257,0.0,20.0
9133,2,1133,[280 250 211 298 299],682,4,3144,2.7724867724867726,0.0,20.0
9134,2,1134,[226 246 268 211 217],435,5,3149,2.7744493392070484,0.0,20.0
9135,2,1135,[215 293 239 291 326],130,5,3154,2.7764084507042255,0.0,0.0
9136,2,1136,[583 201 219 413 324],303,2,3156,2.7757255936675462,0.0,0.0
9137,2,1137,[276 384 315 481 420],758,3,3159,2.775922671353251,20.0,0.0
9138,2,1138,[202 220 223 367 284],178,4,3163,2.7769973661106233,20.0,0.0
9139,2,1139,[221 261 255 250 259],1,2,3165,2.776315789473684,0.0,0.0
9140,2,1140,[316 384 336 222 232],363,2,3167,2.7756354075372482,20.0,20.0
9141,2,1141,[209 202 509 216 239],758,4,3171,2.776707530647986,0.0,20.0
9142,2,1142,[202 290 367 218 243],682,1,3172,2.7751531058617673,0.0,0.0
9143,2,1143,[272 276 431 232 241],276,3,3175,2.7753496503496504,20.0,0.0
9144,2,1144,[246 259 478 295 316],178,3,3178,2.7755458515283844,40.0,0.0
9145,2,1145,[276 216 324 240 272],758,3,3181,2.775741710296684,20.0,20.0
9146,2,1146,[300 226 290 413 219],435,2,3183,2.775065387968614,0.0,20.0
9147,2,1147,[201 202 218 268 284],435,3,3186,2.775261324041812,0.0,20.0
9148,2,1148,[301 211 259 344 431],514,3,3189,2.775456919060052,0.0,0.0
9149,2,1149,[431 344 275 293 209],514,2,3191,2.774782608695652,0.0,0.0
9150,2,1150,[218 300 240 293 298],919,3,3194,2.7749782797567333,0.0,40.0
9151,2,1151,[413 254 206 284 508],276,3,3197,2.775173611111111,0.0,0.0
9152,2,1152,[284 246 217 206 267],130,2,3199,2.774501300954033,0.0,0.0
9153,2,1153,[268 211 208 240 250],790,3,3202,2.7746967071057194,0.0,20.0
9154,2,1154,[251 236 215 326 336],592,3,3205,2.774891774891775,0.0,0.0
9155,2,1155,[250 246 219 331 301],276,5,3210,2.7768166089965396,0.0,0.0
9156,2,1156,[202 209 216 268 218],303,5,3215,2.7787381158167674,0.0,40.0
9157,2,1157,[255 202 239 209 378],682,1,3216,2.77720207253886,0.0,0.0
9158,2,1158,[301 272 222 284 331],276,5,3221,2.7791199309749786,20.0,20.0
9159,2,1159,[244 413 291 284 226],291,4,3225,2.7801724137931036,0.0,0.0
9160,2,1160,[213 254 230 236 251],1,3,3228,2.7803617571059434,0.0,0.0
9161,2,1161,[226 275 251 509 280],293,1,3229,2.778829604130809,0.0,0.0
9162,2,1162,[291 431 300 254 392],435,1,3230,2.777300085984523,0.0,20.0
9163,2,1163,[209 384 227 246 303],276,4,3234,2.7783505154639174,0.0,0.0
9164,2,1164,[218 268 301 298 297],919,2,3236,2.7776824034334764,0.0,40.0
9165,2,1165,[290 413 316 276 230],130,2,3238,2.7770154373927958,20.0,0.0
9166,2,1166,[226 218 241 217 223],222,2,3240,2.776349614395887,20.0,0.0
9167,2,1167,[276 222 206 303 268],201,2,3242,2.7756849315068495,0.0,40.0
9168,2,1168,[378 392 222 246 241],222,3,3245,2.7758768177929856,0.0,20.0
9169,2,1169,[223 246 255 243 212],1,3,3248,2.776068376068376,20.0,0.0
9170,2,1170,[316 413 232 231 227],276,2,3250,2.7754056362083688,20.0,0.0
9171,2,1171,[218 264 452 367 217],276,2,3252,2.7747440273037545,0.0,0.0
9172,2,1172,[222 201 276 301 275],429,3,3255,2.7749360613810743,0.0,20.0
9173,2,1173,[367 208 222 216 211],94,3,3258,2.775127768313458,0.0,40.0
9174,2,1174,[321 240 259 202 264],250,3,3261,2.77531914893617,0.0,0.0
9175,2,1175,[226 331 384 392 250],276,3,3264,2.7755102040816326,0.0,0.0
9176,2,1176,[264 246 217 201 218],327,2,3266,2.774851316907392,0.0,0.0
9177,2,1177,[217 240 293 255 259],682,3,3269,2.775042444821732,0.0,0.0
9178,2,1178,[283 315 264 217 201],363,0,3269,2.7726887192536047,20.0,0.0
9179,2,1179,[218 298 202 246 367],178,3,3272,2.772881355932203,0.0,20.0
9180,2,1180,[508 209 206 241 250],276,5,3277,2.774767146486029,0.0,0.0
9181,2,1181,[222 392 420 230 231],276,3,3280,2.774957698815567,0.0,20.0
9182,2,1182,[420 221 583 507 251],303,4,3284,2.775993237531699,0.0,0.0
9183,2,1183,[392 299 367 300 275],896,2,3286,2.7753378378378377,0.0,20.0
9184,2,1184,[227 300 367 264 226],276,3,3289,2.7755274261603375,0.0,20.0
9185,2,1185,[240 216 232 218 220],1,1,3290,2.7740303541315345,0.0,20.0
9186,2,1186,[211 219 208 367 206],868,1,3291,2.772535804549284,0.0,0.0
9187,2,1187,[321 250 227 508 326],130,3,3294,2.772727272727273,0.0,0.0
9188,2,1188,[206 284 230 209 244],268,2,3296,2.772077375946173,0.0,0.0
9189,2,1189,[283 394 316 291 206],393,3,3299,2.772268907563025,20.0,0.0
9190,2,1190,[478 241 223 481 212],896,4,3303,2.7732997481108312,40.0,0.0
9191,2,1191,[213 232 331 413 321],201,2,3305,2.7726510067114094,0.0,0.0
9192,2,1192,[201 293 215 276 367],682,3,3308,2.7728415758591787,0.0,0.0
9193,2,1193,[244 216 255 202 481],870,2,3310,2.7721943048576216,0.0,20.0
9194,2,1194,[280 300 264 250 219],429,1,3311,2.77071129707113,0.0,20.0
9195,2,1195,[216 384 236 297 290],758,5,3316,2.7725752508361206,0.0,20.0
9196,2,1196,[222 268 452 259 201],303,2,3318,2.7719298245614037,0.0,40.0
9197,2,1197,[283 239 217 209 226],727,1,3319,2.7704507512520866,0.0,0.0
9198,2,1198,[232 293 230 226 231],429,2,3321,2.769808173477898,0.0,0.0
9199,2,1199,[301 231 268 272 367],880,4,3325,2.7708333333333335,20.0,20.0
9200,2,1200,[300 378 508 264 216],429,2,3327,2.7701915070774357,0.0,40.0
9201,2,1201,[268 232 206 211 215],94,4,3331,2.7712146422628954,0.0,20.0
9202,2,1202,[227 209 392 232 226],896,1,3332,2.769742310889443,0.0,0.0
9203,2,1203,[321 216 315 367 268],130,5,3337,2.771594684385382,20.0,40.0
9204,2,1204,[331 365 241 324 298],276,4,3341,2.7726141078838173,0.0,20.0
9205,2,1205,[268 431 202 276 226],276,4,3345,2.77363184079602,0.0,20.0
9206,2,1206,[378 291 216 365 201],682,2,3347,2.7729908864954433,0.0,20.0
9207,2,1207,[202 201 283 243 301],919,2,3349,2.7723509933774833,0.0,0.0
9208,2,1208,[272 367 216 215 221],592,5,3354,2.774193548387097,20.0,20.0
9209,2,1209,[216 212 250 217 239],758,3,3357,2.7743801652892564,0.0,20.0
9210,2,1210,[315 218 367 246 202],919,2,3359,2.773740710156895,20.0,0.0
9211,2,1211,[272 217 301 240 206],276,5,3364,2.7755775577557755,20.0,0.0
9212,2,1212,[303 202 331 227 293],276,5,3369,2.777411376751855,0.0,0.0
9213,2,1213,[344 212 240 223 231],758,2,3371,2.7767710049423395,20.0,0.0
9214,2,1214,[232 211 241 222 226],561,1,3372,2.775308641975309,0.0,20.0
9215,2,1215,[208 291 226 230 321],435,3,3375,2.7754934210526314,0.0,0.0
9216,2,1216,[201 254 392 452 232],276,1,3376,2.7740345110928515,0.0,0.0
9217,2,1217,[213 206 219 232 231],1,1,3377,2.7725779967159276,0.0,0.0
9218,2,1218,[365 241 219 230 202],846,3,3380,2.7727645611156686,0.0,0.0
9219,2,1219,[232 298 392 583 365],276,1,3381,2.7713114754098362,0.0,20.0
9220,2,1220,[222 507 291 283 392],727,2,3383,2.7706797706797706,0.0,20.0
9221,2,1221,[246 301 244 255 331],770,4,3387,2.771685761047463,0.0,0.0
9222,2,1222,[218 239 324 331 230],201,3,3390,2.7718724448078493,0.0,0.0
9223,2,1223,[231 212 209 367 232],846,3,3393,2.7720588235294117,0.0,0.0
9224,2,1224,[231 413 284 219 295],399,1,3394,2.770612244897959,0.0,0.0
9225,2,1225,[284 226 384 431 215],551,4,3398,2.7716150081566067,0.0,0.0
9226,2,1226,[378 298 217 392 268],222,3,3401,2.771801140994295,0.0,40.0
9227,2,1227,[219 268 298 284 254],682,3,3404,2.771986970684039,0.0,40.0
9228,2,1228,[293 301 240 259 202],919,2,3406,2.771358828315704,0.0,0.0
9229,2,1229,[276 507 324 420 241],303,4,3410,2.772357723577236,0.0,0.0
9230,2,1230,[232 267 239 201 202],1,3,3413,2.7725426482534523,0.0,0.0
9231,2,1231,[290 254 206 431 264],276,2,3415,2.7719155844155843,0.0,0.0
9232,2,1232,[206 508 321 326 303],201,1,3416,2.770478507704785,0.0,0.0
9233,2,1233,[230 268 315 316 217],551,4,3420,2.771474878444084,40.0,20.0
9234,2,1234,[211 431 202 227 508],429,4,3424,2.7724696356275302,0.0,0.0
9235,2,1235,[215 276 392 261 326],130,5,3429,2.7742718446601944,0.0,0.0
9236,2,1236,[344 478 219 255 215],327,4,3433,2.775262732417138,20.0,0.0
9237,2,1237,[240 507 298 239 208],293,2,3435,2.774636510500808,0.0,20.0
9238,2,1238,[218 293 290 217 452],130,3,3438,2.774818401937046,0.0,0.0
9239,2,1239,[219 583 202 321 208],303,3,3441,2.775,0.0,0.0
9240,2,1240,[227 255 216 230 251],293,2,3443,2.774375503626108,0.0,20.0
9241,2,1241,[221 276 208 202 231],758,2,3445,2.7737520128824475,0.0,0.0
9242,2,1242,[508 201 272 246 221],592,5,3450,2.7755430410297666,20.0,0.0
9243,2,1243,[255 431 275 216 209],249,4,3454,2.7765273311897105,0.0,20.0
9244,2,1244,[297 209 222 298 300],758,4,3458,2.7775100401606427,0.0,60.0
9245,2,1245,[209 508 211 392 268],94,4,3462,2.778491171749599,0.0,20.0
9246,2,1246,[326 268 215 291 250],130,4,3466,2.779470729751403,0.0,20.0
9247,2,1247,[293 259 261 431 243],592,1,3467,2.778044871794872,0.0,0.0
9248,2,1248,[217 272 209 222 216],660,2,3469,2.77742193755004,20.0,40.0
9249,2,1249,[208 240 239 275 429],293,1,3470,2.776,0.0,0.0
9250,2,1250,[246 452 223 284 230],268,1,3471,2.774580335731415,20.0,0.0
9251,2,1251,[240 331 384 209 218],551,3,3474,2.7747603833865813,0.0,0.0
9252,2,1252,[259 241 344 365 272],393,3,3477,2.7749401436552277,20.0,0.0
9253,2,1253,[283 246 215 367 208],790,2,3479,2.774322169059011,0.0,0.0
9254,2,1254,[241 227 298 208 230],758,4,3483,2.7752988047808764,0.0,20.0
9255,2,1255,[202 218 431 316 331],758,4,3487,2.7762738853503186,20.0,0.0
9256,2,1256,[420 227 290 232 251],303,4,3491,2.777247414478918,0.0,0.0
9257,2,1257,[211 485 232 284 583],293,1,3492,2.7758346581875992,0.0,0.0
9258,2,1258,[216 222 219 413 326],201,2,3494,2.7752184273232725,0.0,40.0
9259,2,1259,[324 300 236 321 452],303,1,3495,2.7738095238095237,0.0,20.0
9260,2,1260,[246 250 295 316 298],500,4,3499,2.774781919111816,20.0,20.0
9261,2,1261,[268 209 212 230 243],1,4,3503,2.7757527733755945,0.0,20.0
9262,2,1262,[226 293 208 276 240],347,3,3506,2.7759303246239115,0.0,0.0
9263,2,1263,[240 230 300 290 298],130,3,3509,2.776107594936709,0.0,40.0
9264,2,1264,[202 226 250 209 230],22,5,3514,2.7778656126482213,0.0,0.0
9265,2,1265,[216 209 231 208 250],44,3,3517,2.778041074249605,0.0,20.0
9266,2,1266,[215 290 481 301 390],747,3,3520,2.7782162588792425,0.0,0.0
9267,2,1267,[230 246 216 293 239],222,4,3524,2.779179810725552,0.0,20.0
9268,2,1268,[392 231 215 431 226],276,2,3526,2.7785657998423954,0.0,0.0
9269,2,1269,[367 219 227 222 206],94,3,3529,2.778740157480315,0.0,20.0
9270,2,1270,[583 239 217 215 241],916,3,3532,2.7789142407553107,0.0,0.0
9271,2,1271,[202 239 241 284 452],222,2,3534,2.7783018867924527,0.0,0.0
9272,2,1272,[231 254 222 384 315],276,2,3536,2.7776904948939514,20.0,20.0
9273,2,1273,[508 206 272 264 241],276,4,3540,2.7786499215070646,20.0,0.0
9274,2,1274,[268 246 378 367 291],682,2,3542,2.7780392156862743,0.0,20.0
9275,2,1275,[201 222 509 217 284],682,4,3546,2.7789968652037618,0.0,20.0
9276,2,1276,[301 290 268 429 508],276,5,3551,2.780736100234926,0.0,20.0
9277,2,1277,[222 202 227 324 209],276,5,3556,2.782472613458529,0.0,20.0
9278,2,1278,[303 239 315 209 431],276,4,3560,2.7834245504300235,20.0,0.0
9279,2,1279,[202 301 295 303 259],919,2,3562,2.7828125,0.0,0.0
9280,2,1280,[250 367 222 240 295],880,4,3566,2.7837626854020296,0.0,20.0
9281,2,1281,[276 298 201 344 215],592,5,3571,2.785491419656786,0.0,20.0
9282,2,1282,[227 250 202 300 226],222,2,3573,2.784879189399844,0.0,20.0
9283,2,1283,[367 246 232 227 508],880,4,3577,2.7858255451713396,0.0,0.0
9284,2,1284,[211 215 240 201 209],201,1,3578,2.7844357976653695,0.0,0.0
9285,2,1285,[315 226 201 254 246],880,4,3582,2.785381026438569,20.0,0.0
9286,2,1286,[508 299 231 240 239],880,4,3586,2.786324786324786,0.0,0.0
9287,2,1287,[241 431 218 230 216],222,4,3590,2.7872670807453415,0.0,20.0
9288,2,1288,[583 222 223 226 315],293,1,3591,2.7858805275407295,40.0,20.0
9289,2,1289,[315 284 350 291 240],130,4,3595,2.7868217054263567,20.0,0.0
9290,2,1290,[293 216 331 290 217],758,3,3598,2.7869868319132456,0.0,20.0
9291,2,1291,[246 284 218 301 226],880,5,3603,2.788699690402477,0.0,0.0
9292,2,1292,[326 264 367 301 221],592,3,3606,2.788863109048724,0.0,0.0
9293,2,1293,[268 267 220 251 236],1,4,3610,2.7897990726429676,0.0,20.0
9294,2,1294,[218 324 420 223 230],758,4,3614,2.790733590733591,20.0,0.0
9295,2,1295,[246 227 268 420 240],303,3,3617,2.790895061728395,0.0,20.0
9296,2,1296,[452 290 350 216 300],130,4,3621,2.7918272937548188,0.0,40.0
9297,2,1297,[201 431 250 280 300],682,3,3624,2.7919876733436055,0.0,20.0
9298,2,1298,[201 231 212 413 226],201,2,3626,2.7913779830638954,0.0,0.0
9299,2,1299,[222 216 280 283 431],429,3,3629,2.7915384615384617,0.0,40.0
9300,2,1300,[216 215 284 244 206],916,2,3631,2.7909300538047654,0.0,20.0
9301,2,1301,[420 223 215 251 297],293,5,3636,2.792626728110599,20.0,0.0
9302,2,1302,[267 298 291 452 239],130,5,3641,2.794320798158097,0.0,20.0
9303,2,1303,[221 326 268 452 321],201,1,3642,2.792944785276074,0.0,20.0
9304,2,1304,[206 218 226 293 239],487,3,3645,2.793103448275862,0.0,0.0
9305,2,1305,[259 243 255 276 350],592,3,3648,2.7932618683001533,0.0,0.0
9306,2,1306,[250 431 206 241 420],276,4,3652,2.794185156847743,0.0,0.0
9307,2,1307,[218 261 255 254 215],1,0,3652,2.7920489296636086,0.0,0.0
9308,2,1308,[431 226 508 392 326],222,3,3655,2.792207792207792,0.0,0.0
9309,2,1309,[324 201 261 243 298],592,3,3658,2.7923664122137404,0.0,20.0
9310,2,1310,[384 315 246 268 202],276,4,3662,2.7932875667429444,20.0,20.0
9311,2,1311,[222 280 232 217 284],682,3,3665,2.7934451219512195,0.0,20.0
9312,2,1312,[431 300 344 508 213],758,2,3667,2.7928408225437926,0.0,20.0
9313,2,1313,[250 218 241 508 284],178,3,3670,2.792998477929985,0.0,0.0
9314,2,1314,[413 272 508 392 290],276,3,3673,2.7931558935361216,20.0,0.0
9315,2,1315,[316 209 429 223 452],276,4,3677,2.7940729483282674,40.0,0.0
9316,2,1316,[331 367 295 303 275],919,4,3681,2.79498861047836,0.0,0.0
9317,2,1317,[384 239 392 508 209],276,3,3684,2.795144157814871,0.0,0.0
9318,2,1318,[290 259 298 209 222],682,2,3686,2.794541319181198,0.0,40.0
9319,2,1319,[211 293 284 230 509],293,2,3688,2.793939393939394,0.0,0.0
9320,2,1320,[241 272 221 331 509],201,1,3689,2.792581377744133,20.0,0.0
9321,2,1321,[227 259 326 201 429],425,2,3691,2.791981845688351,0.0,0.0
9322,2,1322,[250 230 217 254 290],660,2,3693,2.7913832199546484,0.0,0.0
9323,2,1323,[392 481 201 452 431],896,1,3694,2.7900302114803623,0.0,0.0
9324,2,1324,[394 231 315 240 336],286,3,3697,2.790188679245283,20.0,0.0
9325,2,1325,[222 508 236 246 367],130,5,3702,2.7918552036199094,0.0,20.0
9326,2,1326,[303 315 291 272 209],276,4,3706,2.79276563677468,40.0,0.0
9327,2,1327,[215 232 239 508 431],222,4,3710,2.7936746987951806,0.0,0.0
9328,2,1328,[222 276 367 219 227],303,3,3713,2.7938299473288186,0.0,20.0
9329,2,1329,[227 268 378 384 241],790,2,3715,2.793233082706767,0.0,20.0
9330,2,1330,[283 208 315 300 485],293,0,3715,2.7911344853493616,20.0,20.0
9331,2,1331,[250 268 230 239 222],268,3,3718,2.7912912912912913,0.0,40.0
9332,2,1332,[209 290 202 226 293],429,3,3721,2.791447861965491,0.0,0.0
9333,2,1333,[367 264 283 239 251],293,1,3722,2.790104947526237,0.0,0.0
9334,2,1334,[215 227 217 272 223],1,2,3724,2.789513108614232,40.0,0.0
9335,2,1335,[367 211 216 219 301],847,3,3727,2.7896706586826348,0.0,20.0
9336,2,1336,[254 384 215 231 583],276,1,3728,2.788332086761406,0.0,0.0
9337,2,1337,[298 250 216 301 202],660,1,3729,2.786995515695067,0.0,40.0
9338,2,1338,[365 218 243 291 268],682,1,3730,2.7856609410007467,0.0,20.0
9339,2,1339,[291 303 222 298 215],393,5,3735,2.787313432835821,0.0,40.0
9340,2,1340,[218 202 413 227 420],303,3,3738,2.7874720357941833,0.0,0.0
9341,2,1341,[431 216 300 268 201],305,2,3740,2.7868852459016393,0.0,60.0
9342,2,1342,[209 223 481 276 244],870,4,3744,2.7877885331347727,20.0,0.0
9343,2,1343,[264 221 209 420 201],303,4,3748,2.7886904761904763,0.0,0.0
9344,2,1344,[206 227 239 290 209],268,2,3750,2.7881040892193307,0.0,0.0
9345,2,1345,[298 251 216 255 209],293,3,3753,2.788261515601783,0.0,40.0
9346,2,1346,[209 254 365 367 299],880,2,3755,2.787676317743133,0.0,0.0
9347,2,1347,[209 241 301 208 230],429,2,3757,2.787091988130564,0.0,0.0
9348,2,1348,[303 283 508 246 255],919,4,3761,2.787991104521868,0.0,0.0
9349,2,1349,[384 259 429 268 216],514,4,3765,2.7888888888888888,0.0,40.0
9350,2,1350,[241 293 222 413 264],303,2,3767,2.788304959289415,0.0,20.0
9351,2,1351,[291 336 295 243 344],592,2,3769,2.787721893491124,0.0,0.0
9352,2,1352,[268 276 222 290 241],682,3,3772,2.787878787878788,0.0,40.0
9353,2,1353,[215 222 216 218 227],222,4,3776,2.78877400295421,0.0,40.0
9354,2,1354,[222 255 211 508 202],606,4,3780,2.7896678966789668,0.0,20.0
9355,2,1355,[291 420 298 301 250],758,3,3783,2.7898230088495577,0.0,20.0
9356,2,1356,[413 268 583 230 226],276,3,3786,2.7899778924097274,0.0,20.0
9357,2,1357,[217 201 230 298 284],880,4,3790,2.7908689248895433,0.0,20.0
9358,2,1358,[298 222 452 239 331],130,4,3794,2.7917586460632817,0.0,40.0
9359,2,1359,[215 222 276 250 251],303,4,3798,2.7926470588235293,0.0,20.0
9360,2,1360,[264 324 218 452 209],268,2,3800,2.792064658339456,0.0,0.0
9361,2,1361,[316 227 217 223 509],758,4,3804,2.79295154185022,40.0,0.0
9362,2,1362,[431 232 219 331 276],276,3,3807,2.793103448275862,0.0,0.0
9363,2,1363,[202 284 290 276 223],916,2,3809,2.7925219941348973,20.0,0.0
9364,2,1364,[284 367 507 219 230],561,1,3810,2.791208791208791,0.0,0.0
9365,2,1365,[231 291 250 202 301],429,2,3812,2.7906295754026353,0.0,0.0
9366,2,1366,[431 284 316 219 211],551,5,3817,2.7922457937088514,20.0,0.0
9367,2,1367,[299 365 241 291 280],682,2,3819,2.7916666666666665,0.0,0.0
9368,2,1368,[300 367 211 209 202],293,1,3820,2.7903579254930606,0.0,20.0
9369,2,1369,[250 230 240 583 283],303,1,3821,2.7890510948905107,0.0,0.0
9370,2,1370,[507 232 509 240 264],293,1,3822,2.787746170678337,0.0,0.0
9371,2,1371,[216 208 213 316 290],758,5,3827,2.7893586005830904,20.0,20.0
9372,2,1372,[508 219 298 321 284],429,3,3830,2.789512017479971,0.0,20.0
9373,2,1373,[268 241 452 508 226],222,1,3831,2.7882096069868996,0.0,20.0
9374,2,1374,[384 321 367 507 508],303,3,3834,2.7883636363636364,0.0,0.0
9375,2,1375,[350 231 217 316 298],130,3,3837,2.7885174418604652,20.0,20.0
9376,2,1376,[478 244 293 259 298],178,2,3839,2.7879448075526505,20.0,20.0
9377,2,1377,[290 202 420 230 272],758,4,3843,2.788824383164006,20.0,0.0
9378,2,1378,[211 276 254 215 240],682,3,3846,2.788977519941987,0.0,0.0
9379,2,1379,[211 275 321 231 331],201,2,3848,2.7884057971014493,0.0,0.0
9380,2,1380,[259 256 291 220 301],181,1,3849,2.7871107892831284,0.0,0.0
9381,2,1381,[209 300 420 326 216],303,3,3852,2.78726483357453,0.0,40.0
9382,2,1382,[276 367 232 216 275],178,4,3856,2.7881417208966015,0.0,20.0
9383,2,1383,[218 303 268 367 236],919,4,3860,2.7890173410404624,0.0,20.0
9384,2,1384,[240 276 216 208 209],299,3,3863,2.789169675090253,0.0,20.0
9385,2,1385,[236 259 413 300 261],181,0,3863,2.787157287157287,0.0,20.0
9386,2,1386,[452 508 321 227 261],130,4,3867,2.788031723143475,0.0,0.0
9387,2,1387,[251 290 255 275 206],293,2,3869,2.787463976945245,0.0,0.0
9388,2,1388,[227 226 365 392 217],276,3,3872,2.787616990640749,0.0,0.0
9389,2,1389,[208 231 324 583 226],303,3,3875,2.787769784172662,0.0,0.0
9390,2,1390,[259 251 241 324 291],303,2,3877,2.7872034507548524,0.0,0.0
9391,2,1391,[392 275 241 481 222],429,2,3879,2.7866379310344827,0.0,20.0
9392,2,1392,[367 331 246 297 293],919,4,3883,2.7875089734386216,0.0,0.0
9393,2,1393,[250 230 202 209 222],660,2,3885,2.7869440459110475,0.0,20.0
9394,2,1394,[206 250 583 231 240],268,3,3888,2.7870967741935484,0.0,0.0
9395,2,1395,[336 272 367 431 326],592,3,3891,2.787249283667622,20.0,0.0
9396,2,1396,[481 508 583 211 209],429,3,3894,2.7874015748031495,0.0,0.0
9397,2,1397,[316 365 300 291 218],551,5,3899,2.7889842632331905,20.0,20.0
9398,2,1398,[211 293 219 250 232],327,2,3901,2.788420300214439,0.0,0.0
9399,2,1399,[208 216 239 293 290],347,2,3903,2.787857142857143,0.0,20.0
9400,2,1400,[276 481 239 324 315],758,3,3906,2.7880085653104927,20.0,0.0
9401,2,1401,[367 583 259 431 211],790,2,3908,2.787446504992867,0.0,0.0
9402,2,1402,[275 219 230 303 324],201,3,3911,2.7875980042765502,0.0,0.0
9403,2,1403,[218 290 331 202 223],758,5,3916,2.7891737891737893,20.0,0.0
9404,2,1404,[223 226 509 222 215],201,1,3917,2.7879003558718862,20.0,20.0
9405,2,1405,[429 284 298 217 276],276,5,3922,2.789473684210526,0.0,20.0
9406,2,1406,[255 240 222 218 208],293,0,3922,2.787491115849325,0.0,20.0
9407,2,1407,[316 452 284 413 384],276,2,3924,2.7869318181818183,20.0,0.0
9408,2,1408,[392 301 250 222 254],660,1,3925,2.785663591199432,0.0,20.0
9409,2,1409,[239 209 303 316 297],293,2,3927,2.7851063829787233,20.0,0.0
9410,2,1410,[240 227 272 315 280],880,3,3930,2.7852586817859675,40.0,0.0
9411,2,1411,[280 276 365 239 291],682,0,3930,2.78328611898017,0.0,0.0
9412,2,1412,[221 212 227 236 290],916,3,3933,2.78343949044586,0.0,0.0
9413,2,1413,[230 384 221 507 300],303,2,3935,2.782885431400283,0.0,20.0
9414,2,1414,[583 420 230 250 291],293,1,3936,2.781625441696113,0.0,0.0
9415,2,1415,[232 290 216 222 291],429,4,3940,2.7824858757062145,0.0,40.0
9416,2,1416,[211 250 243 255 254],682,2,3942,2.7819336626676074,0.0,0.0
9417,2,1417,[222 219 392 384 413],727,1,3943,2.7806770098730604,0.0,20.0
9418,2,1418,[268 291 284 211 227],435,4,3947,2.7815362931642,0.0,20.0
9419,2,1419,[231 232 420 508 299],896,1,3948,2.780281690140845,0.0,0.0
9420,2,1420,[378 431 268 226 276],399,0,3948,2.7783251231527095,0.0,20.0
9421,2,1421,[291 240 384 300 420],276,3,3951,2.778481012658228,0.0,20.0
9422,2,1422,[213 291 485 300 240],293,0,3951,2.7765284609978917,0.0,20.0
9423,2,1423,[251 216 264 213 509],293,2,3953,2.7759831460674156,0.0,20.0
9424,2,1424,[209 211 222 219 276],429,5,3958,2.7775438596491226,0.0,20.0
9425,2,1425,[283 367 264 326 259],303,1,3959,2.776297335203366,0.0,0.0
9426,2,1426,[250 290 208 336 315],286,4,3963,2.777154870357393,20.0,0.0
9427,2,1427,[201 239 216 261 219],1,2,3965,2.776610644257703,0.0,20.0
9428,2,1428,[264 392 321 217 202],429,1,3966,2.775367389783065,0.0,0.0
9429,2,1429,[226 216 290 223 251],293,3,3969,2.7755244755244757,20.0,20.0
9430,2,1430,[365 367 384 392 324],276,1,3970,2.774283717679944,0.0,0.0
9431,2,1431,[206 508 241 250 431],94,5,3975,2.7758379888268156,0.0,0.0
9432,2,1432,[508 276 241 321 272],201,2,3977,2.7752965806001395,20.0,0.0
9433,2,1433,[259 291 219 217 268],682,2,3979,2.7747559274755926,0.0,20.0
9434,2,1434,[217 507 202 243 211],561,2,3981,2.7742160278745644,0.0,0.0
9435,2,1435,[295 420 321 291 267],130,4,3985,2.7750696378830084,0.0,0.0
9436,2,1436,[227 231 301 583 250],276,3,3988,2.775226165622825,0.0,0.0
9437,2,1437,[219 508 223 226 236],291,5,3993,2.7767732962447846,20.0,0.0
9438,2,1438,[215 223 284 213 226],916,2,3995,2.776233495482974,20.0,0.0
9439,2,1439,[298 227 226 394 384],880,2,3997,2.7756944444444445,0.0,20.0
9440,2,1440,[222 384 231 227 218],399,1,3998,2.774462179042332,0.0,20.0
9441,2,1441,[232 223 219 202 208],222,4,4002,2.7753120665742026,20.0,0.0
9442,2,1442,[392 216 232 211 250],896,2,4004,2.774774774774775,0.0,20.0
9443,2,1443,[280 222 208 216 293],347,3,4007,2.7749307479224377,0.0,40.0
9444,2,1444,[298 452 246 508 239],130,5,4012,2.776470588235294,0.0,20.0
9445,2,1445,[209 293 301 298 221],758,2,4014,2.775933609958506,0.0,20.0
9446,2,1446,[217 240 264 509 365],551,2,4016,2.775397373876987,0.0,0.0
9447,2,1447,[268 316 215 276 241],178,4,4020,2.776243093922652,20.0,20.0
9448,2,1448,[429 230 452 326 232],425,2,4022,2.7757073844030367,0.0,0.0
9449,2,1449,[232 392 284 300 202],880,3,4025,2.7758620689655173,0.0,20.0
9450,2,1450,[268 331 297 315 301],919,2,4027,2.775327360441075,20.0,20.0
9451,2,1451,[300 202 244 216 509],500,4,4031,2.7761707988980717,0.0,40.0
9452,2,1452,[429 301 290 508 392],747,2,4033,2.7756366139022712,0.0,0.0
9453,2,1453,[378 384 431 240 230],472,4,4037,2.776478679504814,0.0,0.0
9454,2,1454,[264 219 420 293 268],276,4,4041,2.777319587628866,0.0,20.0
9455,2,1455,[222 481 216 303 223],758,5,4046,2.7788461538461537,20.0,40.0
9456,2,1456,[350 413 272 218 268],130,4,4050,2.7796842827728208,20.0,20.0
9457,2,1457,[316 324 291 284 326],551,4,4054,2.7805212620027433,20.0,0.0
9458,2,1458,[219 211 226 291 239],896,2,4056,2.779986291980809,0.0,0.0
9459,2,1459,[583 239 212 211 213],916,4,4060,2.780821917808219,0.0,0.0
9460,2,1460,[255 219 250 431 217],327,1,4061,2.779603011635866,0.0,0.0
9461,2,1461,[367 350 291 254 267],130,4,4065,2.780437756497948,0.0,0.0
9462,2,1462,[315 230 208 283 420],293,1,4066,2.779220779220779,20.0,0.0
9463,2,1463,[231 202 241 240 209],758,2,4068,2.778688524590164,0.0,0.0
9464,2,1464,[221 232 268 230 223],303,4,4072,2.7795221843003413,20.0,20.0
9465,2,1465,[583 272 209 259 324],425,1,4073,2.7783083219645293,20.0,0.0
9466,2,1466,[481 201 230 431 232],896,2,4075,2.7777777777777777,0.0,0.0
9467,2,1467,[300 201 507 508 390],303,3,4078,2.7779291553133514,0.0,20.0
9468,2,1468,[508 315 324 367 240],276,4,4082,2.7787610619469025,20.0,0.0
9469,2,1469,[209 507 216 378 215],846,4,4086,2.779591836734694,0.0,20.0
9470,2,1470,[283 212 481 485 384],299,2,4088,2.77906186267845,0.0,0.0
9471,2,1471,[231 300 206 301 276],276,4,4092,2.779891304347826,0.0,20.0
9472,2,1472,[231 222 227 226 291],109,3,4095,2.780040733197556,0.0,20.0
9473,2,1473,[290 241 431 268 219],682,3,4098,2.780189959294437,0.0,20.0
9474,2,1474,[223 222 290 216 209],407,4,4102,2.7810169491525425,20.0,40.0
9475,2,1475,[250 255 264 240 283],303,2,4104,2.7804878048780486,0.0,0.0
9476,2,1476,[284 209 508 280 227],880,2,4106,2.7799593771157753,0.0,0.0
9477,2,1477,[324 226 202 284 268],276,5,4111,2.781461434370771,0.0,20.0
9478,2,1478,[264 291 315 284 275],293,0,4111,2.779580797836376,20.0,0.0
9479,2,1479,[209 222 315 297 272],293,2,4113,2.779054054054054,40.0,20.0
9480,2,1480,[218 226 291 208 413],435,3,4116,2.7792032410533425,0.0,0.0
9481,2,1481,[303 276 298 218 315],276,5,4121,2.780701754385965,20.0,20.0
9482,2,1482,[290 298 324 481 223],758,5,4126,2.782198246797033,20.0,20.0
9483,2,1483,[222 239 226 295 240],586,1,4127,2.7809973045822103,0.0,20.0
9484,2,1484,[223 485 275 218 297],293,2,4129,2.7804713804713805,20.0,0.0
9485,2,1485,[211 219 301 429 208],660,3,4132,2.780619111709287,0.0,0.0
9486,2,1486,[226 217 365 240 231],472,5,4137,2.7821116341627437,0.0,0.0
9487,2,1487,[213 236 202 239 246],916,3,4140,2.782258064516129,0.0,0.0
9488,2,1488,[222 255 232 241 240],1,2,4142,2.7817327065144393,0.0,20.0
9489,2,1489,[250 259 251 216 221],303,4,4146,2.7825503355704697,0.0,20.0
9490,2,1490,[509 275 293 218 216],293,2,4148,2.7820254862508382,0.0,20.0
9491,2,1491,[394 217 231 301 246],880,3,4151,2.782171581769437,0.0,0.0
9492,2,1492,[384 378 284 239 367],727,1,4152,2.780977896851976,0.0,0.0
9493,2,1493,[268 508 300 219 215],327,3,4155,2.781124497991968,0.0,40.0
9494,2,1494,[485 507 293 392 321],429,2,4157,2.780602006688963,0.0,0.0
9495,2,1495,[290 227 303 240 206],293,2,4159,2.7800802139037435,0.0,0.0
9496,2,1496,[275 227 291 223 283],393,4,4163,2.7808951235804944,20.0,0.0
9497,2,1497,[326 293 218 255 216],303,4,4167,2.781708945260347,0.0,20.0
9498,2,1498,[336 276 315 255 326],592,4,4171,2.7825216811207474,20.0,0.0
9499,2,1499,[293 209 420 236 301],758,2,4173,2.782,0.0,0.0
9500,2,1500,[255 431 202 303 268],592,4,4177,2.782811459027315,0.0,20.0
9501,2,1501,[331 303 295 250 236],919,3,4180,2.7829560585885487,0.0,0.0
9502,2,1502,[290 367 315 240 284],130,3,4183,2.7831004657351963,20.0,0.0
9503,2,1503,[217 230 392 216 293],222,3,4186,2.783244680851064,0.0,20.0
9504,2,1504,[211 508 384 208 241],758,4,4190,2.784053156146179,0.0,0.0
9505,2,1505,[241 250 211 222 227],22,3,4193,2.7841965471447545,0.0,20.0
9506,2,1506,[316 239 250 420 223],293,2,4195,2.7836761778367616,40.0,0.0
9507,2,1507,[264 583 283 211 365],429,1,4196,2.782493368700265,0.0,0.0
9508,2,1508,[275 211 219 300 284],429,3,4199,2.7826375082836314,0.0,20.0
9509,2,1509,[206 507 275 239 209],293,2,4201,2.782119205298013,0.0,0.0
9510,2,1510,[583 213 230 485 206],293,1,4202,2.780939774983455,0.0,0.0
9511,2,1511,[220 247 221 211 212],1,2,4204,2.7804232804232805,0.0,0.0
9512,2,1512,[236 264 223 213 219],1,2,4206,2.7799074686054195,20.0,0.0
9513,2,1513,[208 507 420 324 251],303,4,4210,2.7807133421400265,0.0,0.0
9514,2,1514,[508 230 284 452 250],303,3,4213,2.780858085808581,0.0,0.0
9515,2,1515,[276 211 326 230 232],201,1,4214,2.7796833773087073,0.0,0.0
9516,2,1516,[202 232 321 276 215],303,4,4218,2.7804878048780486,0.0,0.0
9517,2,1517,[213 206 295 431 236],916,2,4220,2.7799736495388667,0.0,0.0
9518,2,1518,[509 272 209 227 212],758,5,4225,2.781435154707044,20.0,0.0
9519,2,1519,[226 215 250 254 392],276,3,4228,2.781578947368421,0.0,0.0
9520,2,1520,[485 241 259 303 222],299,1,4229,2.780407626561473,0.0,20.0
9521,2,1521,[452 431 217 290 202],276,3,4232,2.780551905387648,0.0,0.0
9522,2,1522,[246 217 326 250 299],130,2,4234,2.780039395929087,0.0,0.0
9523,2,1523,[227 218 239 254 246],130,3,4237,2.7801837270341205,0.0,0.0
9524,2,1524,[209 384 509 230 236],758,5,4242,2.781639344262295,0.0,0.0
9525,2,1525,[232 215 413 284 231],303,4,4246,2.782437745740498,0.0,0.0
9526,2,1526,[250 227 300 246 208],435,4,4250,2.7832351015062216,0.0,20.0
9527,2,1527,[384 478 222 202 481],896,3,4253,2.7833769633507854,20.0,20.0
9528,2,1528,[367 295 299 280 208],880,4,4257,2.7841726618705036,0.0,0.0
9529,2,1529,[367 226 384 209 246],276,3,4260,2.784313725490196,0.0,0.0
9530,2,1530,[230 384 478 284 508],896,3,4263,2.784454604833442,20.0,0.0
9531,2,1531,[209 284 218 202 452],222,3,4266,2.784595300261097,0.0,0.0
9532,2,1532,[226 240 365 280 394],880,2,4268,2.7840834964122636,0.0,0.0
9533,2,1533,[244 218 201 246 221],919,3,4271,2.7842242503259453,0.0,0.0
9534,2,1534,[209 276 452 413 201],276,3,4274,2.7843648208469056,0.0,0.0
9535,2,1535,[481 219 268 239 202],870,1,4275,2.783203125,0.0,20.0
9536,2,1536,[290 216 298 301 350],363,1,4276,2.782042940793754,0.0,40.0
9537,2,1537,[298 222 315 208 336],363,4,4280,2.7828348504551363,20.0,40.0
9538,2,1538,[217 298 420 239 350],130,4,4284,2.783625730994152,0.0,20.0
9539,2,1539,[280 276 215 220 244],178,2,4286,2.7831168831168833,0.0,0.0
9540,2,1540,[336 293 321 232 226],327,1,4287,2.781959766385464,0.0,0.0
9541,2,1541,[231 280 230 241 431],222,2,4289,2.7814526588845654,0.0,0.0
9542,2,1542,[481 293 298 250 508],429,3,4292,2.7815942968243683,0.0,20.0
9543,2,1543,[326 231 367 222 254],130,3,4295,2.781735751295337,0.0,20.0
9544,2,1544,[222 232 324 298 201],425,2,4297,2.7812297734627833,0.0,40.0
9545,2,1545,[221 232 413 268 223],201,2,4299,2.7807244501940493,20.0,20.0
9546,2,1546,[268 250 216 365 209],790,4,4303,2.7815126050420167,0.0,40.0
9547,2,1547,[218 331 508 240 272],276,5,4308,2.7829457364341086,20.0,0.0
9548,2,1548,[206 261 243 202 284],130,2,4310,2.7824402840542284,0.0,0.0
9549,2,1549,[420 222 240 481 508],758,3,4313,2.7825806451612904,0.0,20.0
9550,2,1550,[222 331 244 223 226],178,4,4317,2.783365570599613,20.0,20.0
9551,2,1551,[250 246 209 216 583],916,4,4321,2.7841494845360826,0.0,20.0
9552,2,1552,[431 413 367 291 217],727,2,4323,2.7836445589182226,0.0,0.0
9553,2,1553,[298 508 291 283 236],592,3,4326,2.7837837837837838,0.0,20.0
9554,2,1554,[239 268 431 384 223],682,2,4328,2.783279742765273,20.0,20.0
9555,2,1555,[202 420 215 222 216],682,4,4332,2.7840616966580978,0.0,40.0
9556,2,1556,[222 264 251 326 202],592,3,4335,2.7842003853564545,0.0,20.0
9557,2,1557,[268 219 299 215 321],130,4,4339,2.7849807445442876,0.0,20.0
9558,2,1558,[290 240 378 223 303],393,3,4342,2.7851186658114178,20.0,0.0
9559,2,1559,[222 336 429 230 226],363,3,4345,2.78525641025641,0.0,20.0
9560,2,1560,[280 223 268 300 246],682,2,4347,2.7847533632286994,20.0,40.0
9561,2,1561,[367 243 216 272 250],130,3,4350,2.7848911651728554,20.0,20.0
9562,2,1562,[250 392 299 222 236],130,3,4353,2.785028790786948,0.0,20.0
9563,2,1563,[420 231 268 272 284],682,3,4356,2.785166240409207,20.0,20.0
9564,2,1564,[365 231 217 226 452],276,2,4358,2.784664536741214,0.0,0.0
9565,2,1565,[231 230 202 384 227],301,3,4361,2.784802043422733,0.0,0.0
9566,2,1566,[303 241 212 284 222],201,1,4362,2.7836630504148054,0.0,20.0
9567,2,1567,[216 268 283 219 223],178,5,4367,2.785076530612245,20.0,40.0
9568,2,1568,[219 485 429 239 392],846,3,4370,2.78521351179095,0.0,0.0
9569,2,1569,[276 365 485 250 378],429,1,4371,2.7840764331210193,0.0,0.0
9570,2,1570,[429 508 217 230 481],896,3,4374,2.784213876511776,0.0,0.0
9571,2,1571,[241 209 291 284 303],276,4,4378,2.7849872773536894,0.0,0.0
9572,2,1572,[212 227 213 344 240],758,3,4381,2.7851239669421486,0.0,0.0
9573,2,1573,[217 216 326 331 236],130,3,4384,2.7852604828462515,0.0,20.0
9574,2,1574,[264 297 226 290 240],293,1,4385,2.784126984126984,0.0,0.0
9575,2,1575,[251 264 508 212 276],299,4,4389,2.7848984771573604,0.0,0.0
9576,2,1576,[290 295 226 216 280],916,1,4390,2.7837666455294863,0.0,20.0
9577,2,1577,[230 290 226 208 250],22,5,4395,2.785171102661597,0.0,0.0
9578,2,1578,[392 267 293 239 290],130,4,4399,2.785940468651045,0.0,0.0
9579,2,1579,[231 230 202 420 431],758,2,4401,2.7854430379746837,0.0,0.0
9580,2,1580,[583 365 209 290 211],682,1,4402,2.784313725490196,0.0,0.0
9581,2,1581,[350 452 209 344 227],758,3,4405,2.7844500632111253,0.0,0.0
9582,2,1582,[365 280 344 227 431],393,2,4407,2.7839545167403665,0.0,0.0
9583,2,1583,[209 293 231 276 240],758,1,4408,2.782828282828283,0.0,0.0
9584,2,1584,[507 250 201 478 255],327,3,4411,2.7829652996845424,20.0,0.0
9585,2,1585,[250 384 367 227 236],303,3,4414,2.7831021437578816,0.0,0.0
9586,2,1586,[231 299 226 201 276],301,2,4416,2.782608695652174,0.0,0.0
9587,2,1587,[344 291 326 350 221],592,4,4420,2.783375314861461,0.0,0.0
9588,2,1588,[226 280 290 215 246],347,4,4424,2.7841409691629955,0.0,0.0
9589,2,1589,[508 295 240 254 208],880,4,4428,2.7849056603773583,0.0,0.0
9590,2,1590,[272 283 336 384 211],514,2,4430,2.7844123192960404,20.0,0.0
9591,2,1591,[508 222 202 264 583],551,3,4433,2.784547738693467,0.0,20.0
9592,2,1592,[208 485 230 231 367],472,4,4437,2.785310734463277,0.0,0.0
9593,2,1593,[255 275 485 300 264],293,0,4437,2.7835633626097867,0.0,20.0
9594,2,1594,[293 276 209 583 231],429,3,4440,2.7836990595611284,0.0,0.0
9595,2,1595,[259 230 215 202 239],1,3,4443,2.7838345864661656,0.0,0.0
9596,2,1596,[250 219 208 508 230],94,4,4447,2.7845961177207266,0.0,0.0
9597,2,1597,[291 298 255 420 219],130,5,4452,2.785982478097622,0.0,20.0
9598,2,1598,[315 301 293 217 206],276,5,4457,2.7873671044402752,20.0,0.0
9599,2,1599,[384 240 583 246 206],276,3,4460,2.7875,0.0,0.0
9600,2,1600,[222 223 215 268 452],222,4,4464,2.788257339163023,20.0,40.0
9601,2,1601,[321 290 231 300 223],429,1,4465,2.7871410736579274,20.0,20.0
9602,2,1602,[299 219 365 290 420],682,1,4466,2.7860262008733625,0.0,0.0
9603,2,1603,[202 303 300 290 297],889,0,4466,2.78428927680798,0.0,20.0
9604,2,1604,[247 452 326 239 226],222,2,4468,2.7838006230529597,0.0,0.0
9605,2,1605,[202 275 232 216 331],178,5,4473,2.7851805728518055,0.0,20.0
9606,2,1606,[212 293 209 431 452],758,2,4475,2.7846919726197883,0.0,0.0
9607,2,1607,[315 201 452 206 246],276,4,4479,2.78544776119403,20.0,0.0
9608,2,1608,[367 293 255 232 209],327,3,4482,2.7855811062771907,0.0,0.0
9609,2,1609,[264 293 275 216 209],429,4,4486,2.7863354037267083,0.0,20.0
9610,2,1610,[268 240 413 232 390],303,2,4488,2.7858472998137804,0.0,20.0
9611,2,1611,[222 254 267 232 223],1,3,4491,2.785980148883375,20.0,20.0
9612,2,1612,[264 316 420 217 303],293,2,4493,2.7854928704277744,20.0,0.0
9613,2,1613,[208 284 392 413 261],222,1,4494,2.7843866171003717,0.0,0.0
9614,2,1614,[295 226 431 218 227],709,2,4496,2.7839009287925696,0.0,0.0
9615,2,1615,[259 331 485 250 508],532,3,4499,2.7840346534653464,0.0,0.0
9616,2,1616,[268 392 209 211 365],94,3,4502,2.784168212739641,0.0,20.0
9617,2,1617,[431 208 227 226 365],222,2,4504,2.783683559950556,0.0,0.0
9618,2,1618,[241 324 290 223 300],276,5,4509,2.785052501544163,20.0,20.0
9619,2,1619,[303 240 223 324 293],276,5,4514,2.78641975308642,20.0,0.0
9620,2,1620,[268 209 452 240 300],276,4,4518,2.787168414558914,0.0,40.0
9621,2,1621,[208 392 202 429 290],660,3,4521,2.7872996300863133,0.0,0.0
9622,2,1622,[240 250 236 256 230],1,4,4525,2.7880468268638325,0.0,0.0
9623,2,1623,[264 239 246 324 211],268,3,4528,2.7881773399014778,0.0,0.0
9624,2,1624,[350 240 290 226 216],130,4,4532,2.788923076923077,0.0,20.0
9625,2,1625,[218 232 231 206 431],487,2,4534,2.788437884378844,0.0,0.0
9626,2,1626,[283 216 211 295 250],500,3,4537,2.7885679164105714,0.0,20.0
9627,2,1627,[222 452 226 232 321],201,0,4537,2.786855036855037,0.0,20.0
9628,2,1628,[276 290 218 230 350],130,3,4540,2.786985880908533,0.0,0.0
9629,2,1629,[255 227 280 202 268],222,2,4542,2.7865030674846625,0.0,20.0
9630,2,1630,[246 255 232 298 241],303,5,4547,2.787860208461067,0.0,20.0
9631,2,1631,[232 218 213 223 431],916,2,4549,2.7873774509803924,20.0,0.0
9632,2,1632,[254 331 219 365 209],276,3,4552,2.7875076546233926,0.0,0.0
9633,2,1633,[239 208 215 272 217],660,2,4554,2.7870257037943698,20.0,0.0
9634,2,1634,[283 206 365 250 290],393,1,4555,2.785932721712538,0.0,0.0
9635,2,1635,[452 272 246 321 217],130,4,4559,2.7866748166259168,20.0,0.0
9636,2,1636,[272 219 420 254 259],682,1,4560,2.7855833842394624,20.0,0.0
9637,2,1637,[259 219 213 216 256],1,2,4562,2.785103785103785,0.0,20.0
9638,2,1638,[321 221 303 297 201],919,4,4566,2.785845027455766,0.0,0.0
9639,2,1639,[392 216 367 365 291],109,1,4567,2.7847560975609755,0.0,20.0
9640,2,1640,[243 272 295 217 384],880,3,4570,2.784887263863498,20.0,0.0
9641,2,1641,[241 508 293 226 217],276,5,4575,2.7862362971985384,0.0,0.0
9642,2,1642,[240 284 300 291 268],130,4,4579,2.7869750456482043,0.0,40.0
9643,2,1643,[250 431 452 222 216],896,2,4581,2.7864963503649633,0.0,40.0
9644,2,1644,[300 508 202 240 218],919,3,4584,2.786626139817629,0.0,20.0
9645,2,1645,[218 239 291 246 298],130,5,4589,2.7879708383961117,0.0,20.0
9646,2,1646,[272 218 392 367 227],880,3,4592,2.788099574984821,20.0,0.0
9647,2,1647,[315 231 276 250 301],880,3,4595,2.7882281553398056,20.0,0.0
9648,2,1648,[221 264 255 431 508],592,3,4598,2.7883565797453,0.0,0.0
9649,2,1649,[272 290 350 315 223],758,5,4603,2.7896969696969696,60.0,0.0
9650,2,1650,[275 218 215 240 431],201,2,4605,2.7892186553603877,0.0,0.0
9651,2,1651,[215 508 299 259 250],592,3,4608,2.7893462469733654,0.0,0.0
9652,2,1652,[206 284 324 264 219],276,4,4612,2.7900786448880823,0.0,0.0
9653,2,1653,[216 227 240 241 326],201,2,4614,2.7896009673518742,0.0,20.0
9654,2,1654,[261 256 208 202 218],1,3,4617,2.789728096676737,0.0,0.0
9655,2,1655,[384 227 254 222 365],472,4,4621,2.7904589371980677,0.0,20.0
9656,2,1656,[232 478 276 250 293],178,4,4625,2.791188895594448,20.0,0.0
9657,2,1657,[219 217 218 209 232],1,1,4626,2.790108564535585,0.0,0.0
9658,2,1658,[227 315 324 291 508],551,4,4630,2.7908378541289935,20.0,0.0
9659,2,1659,[452 217 508 431 230],497,2,4632,2.7903614457831325,0.0,0.0
9660,2,1660,[276 326 250 413 508],303,3,4635,2.790487658037327,0.0,0.0
9661,2,1661,[243 295 246 272 217],919,2,4637,2.790012033694344,20.0,0.0
9662,2,1662,[367 227 508 290 267],130,3,4640,2.7901383042693926,0.0,0.0
9663,2,1663,[239 246 290 321 236],303,3,4643,2.790264423076923,0.0,0.0
9664,2,1664,[261 284 227 202 413],130,2,4645,2.78978978978979,0.0,0.0
9665,2,1665,[452 223 384 239 300],758,2,4647,2.7893157262905164,20.0,20.0
9666,2,1666,[272 231 316 429 250],276,4,4651,2.79004199160168,40.0,0.0
9667,2,1667,[316 232 284 315 202],293,0,4651,2.788369304556355,40.0,0.0
9668,2,1668,[215 202 583 272 275],293,2,4653,2.787896944278011,20.0,0.0
9669,2,1669,[293 367 326 217 298],919,3,4656,2.7880239520958083,0.0,20.0
9670,2,1670,[226 283 251 324 208],303,3,4659,2.7881508078994615,0.0,0.0
9671,2,1671,[201 223 236 264 303],592,3,4662,2.7882775119617227,20.0,0.0
9672,2,1672,[222 284 280 300 508],551,4,4666,2.7890017931858937,0.0,40.0
9673,2,1673,[264 209 226 452 259],303,2,4668,2.7885304659498207,0.0,0.0
9674,2,1674,[226 223 365 291 201],276,3,4671,2.7886567164179104,20.0,0.0
9675,2,1675,[222 230 216 220 206],1,4,4675,2.789379474940334,0.0,40.0
9676,2,1676,[300 276 431 365 223],276,3,4678,2.789505068574836,20.0,20.0
9677,2,1677,[268 241 202 230 420],303,4,4682,2.790226460071514,0.0,20.0
9678,2,1678,[316 315 283 367 284],293,0,4682,2.78856462179869,40.0,0.0
9679,2,1679,[276 583 365 202 291],551,4,4686,2.789285714285714,0.0,0.0
9680,2,1680,[275 208 283 218 240],293,0,4686,2.7876264128494945,0.0,0.0
9681,2,1681,[316 280 315 583 331],551,3,4689,2.787752675386445,40.0,0.0
9682,2,1682,[250 219 201 251 215],303,5,4694,2.7890671420083186,0.0,0.0
9683,2,1683,[201 259 230 429 239],660,2,4696,2.7885985748218527,0.0,0.0
9684,2,1684,[324 218 350 481 298],758,5,4701,2.7899109792284866,0.0,20.0
9685,2,1685,[226 209 321 211 583],429,2,4703,2.7894424673784104,0.0,0.0
9686,2,1686,[268 218 219 344 202],327,4,4707,2.790160047421458,0.0,20.0
9687,2,1687,[316 259 275 321 507],393,3,4710,2.7902843601895735,20.0,0.0
9688,2,1688,[413 218 230 222 251],303,2,4712,2.7898164594434576,0.0,20.0
9689,2,1689,[316 293 206 301 239],363,1,4713,2.788757396449704,20.0,0.0
9690,2,1690,[222 290 202 232 431],521,2,4715,2.7882909520993495,0.0,20.0
9691,2,1691,[413 231 226 268 227],222,1,4716,2.7872340425531914,0.0,20.0
9692,2,1692,[583 316 246 365 293],276,3,4719,2.7873597164796218,20.0,0.0
9693,2,1693,[272 429 206 293 227],276,5,4724,2.7886658795749706,20.0,0.0
9694,2,1694,[232 219 429 420 481],896,3,4727,2.7887905604719765,0.0,0.0
9695,2,1695,[232 583 264 201 284],276,2,4729,2.7883254716981134,0.0,0.0
9696,2,1696,[231 206 293 216 217],130,2,4731,2.7878609310548024,0.0,20.0
9697,2,1697,[507 509 232 264 284],293,1,4732,2.7868080094228502,0.0,0.0
9698,2,1698,[384 226 209 230 583],268,3,4735,2.786933490288405,0.0,0.0
9699,2,1699,[215 283 231 264 232],363,0,4735,2.7852941176470587,0.0,0.0
9700,2,1700,[218 201 240 290 583],276,4,4739,2.786008230452675,0.0,0.0
9701,2,1701,[291 509 315 264 218],551,4,4743,2.7867215041128084,20.0,0.0
9702,2,1702,[208 251 256 221 255],1,4,4747,2.787433940105696,0.0,0.0
9703,2,1703,[367 384 283 208 392],727,2,4749,2.7869718309859155,0.0,0.0
9704,2,1704,[367 230 223 264 232],276,2,4751,2.786510263929619,20.0,0.0
9705,2,1705,[250 268 259 220 223],178,3,4754,2.786635404454865,20.0,20.0
9706,2,1706,[384 429 301 206 291],276,3,4757,2.7867603983596956,0.0,0.0
9707,2,1707,[268 251 250 231 218],303,5,4762,2.788056206088993,0.0,20.0
9708,2,1708,[326 324 315 259 508],663,3,4765,2.7881802223522527,20.0,0.0
9709,2,1709,[217 299 300 240 250],880,3,4768,2.7883040935672514,0.0,20.0
9710,2,1710,[259 246 261 202 211],1,2,4770,2.787843366452367,0.0,0.0
9711,2,1711,[298 481 226 208 219],429,3,4773,2.787967289719626,0.0,20.0
9712,2,1712,[240 221 217 209 298],758,2,4775,2.787507297139521,0.0,20.0
9713,2,1713,[241 508 231 213 221],758,2,4777,2.7870478413068844,0.0,0.0
9714,2,1714,[384 215 202 583 227],303,2,4779,2.786588921282799,0.0,0.0
9715,2,1715,[239 384 216 250 208],363,1,4780,2.7855477855477857,0.0,20.0
9716,2,1716,[250 293 429 507 367],293,3,4783,2.7856726849155504,0.0,0.0
9717,2,1717,[240 413 290 264 367],276,2,4785,2.7852153667054713,0.0,0.0
9718,2,1718,[295 230 316 284 243],130,1,4786,2.784176847004072,20.0,0.0
9719,2,1719,[261 240 243 300 222],919,1,4787,2.783139534883721,0.0,40.0
9720,2,1720,[293 583 290 217 272],682,3,4790,2.7832655432887856,20.0,0.0
9721,2,1721,[216 215 509 583 250],916,4,4794,2.78397212543554,0.0,20.0
9722,2,1722,[264 509 251 255 280],293,1,4795,2.782936738247243,0.0,0.0
9723,2,1723,[223 452 291 216 222],109,2,4797,2.7824825986078885,20.0,40.0
9724,2,1724,[298 215 300 301 384],276,4,4801,2.7831884057971013,0.0,40.0
9725,2,1725,[276 268 365 300 367],880,3,4804,2.783314020857474,0.0,40.0
9726,2,1726,[508 227 420 241 284],399,1,4805,2.7822814128546614,0.0,0.0
9727,2,1727,[241 384 227 239 267],268,1,4806,2.78125,0.0,0.0
9728,2,1728,[291 378 232 284 211],727,2,4808,2.7807981492192018,0.0,0.0
9729,2,1729,[215 208 222 485 213],293,1,4809,2.7797687861271676,0.0,20.0
9730,2,1730,[290 216 303 268 215],747,3,4812,2.779896013864818,0.0,40.0
9731,2,1731,[268 390 336 431 280],286,4,4816,2.7806004618937643,0.0,20.0
9732,2,1732,[378 290 218 280 583],682,0,4816,2.778995960761685,0.0,0.0
9733,2,1733,[215 300 392 231 226],487,3,4819,2.779123414071511,0.0,20.0
9734,2,1734,[231 350 236 326 215],130,4,4823,2.779827089337176,0.0,0.0
9735,2,1735,[508 365 223 280 222],551,4,4827,2.7805299539170507,20.0,20.0
9736,2,1736,[291 202 250 508 478],896,1,4828,2.779504893494531,20.0,0.0
9737,2,1737,[315 254 226 431 413],276,2,4830,2.779056386651323,20.0,0.0
9738,2,1738,[223 239 298 202 378],393,4,4834,2.7797584818861414,20.0,20.0
9739,2,1739,[240 429 284 241 365],276,4,4838,2.7804597701149425,0.0,0.0
9740,2,1740,[226 240 420 239 350],130,5,4843,2.781734635267088,0.0,0.0
9741,2,1741,[276 217 208 227 275],429,3,4846,2.7818599311136625,0.0,0.0
9742,2,1742,[219 365 280 226 222],429,2,4848,2.7814113597246126,0.0,20.0
9743,2,1743,[300 264 384 216 232],551,3,4851,2.7815366972477062,0.0,40.0
9744,2,1744,[218 217 392 241 261],222,2,4853,2.7810888252148995,0.0,0.0
9745,2,1745,[239 236 264 230 220],1,3,4856,2.781214203894616,0.0,0.0
9746,2,1746,[202 326 223 226 227],222,3,4859,2.7813394390383515,20.0,0.0
9747,2,1747,[290 216 241 291 378],682,2,4861,2.780892448512586,0.0,20.0
9748,2,1748,[240 283 276 293 236],303,3,4864,2.781017724413951,0.0,0.0
9749,2,1749,[230 299 209 420 431],896,2,4866,2.7805714285714287,0.0,0.0
9750,2,1750,[291 232 241 219 365],682,1,4867,2.779554540262707,0.0,0.0
9751,2,1751,[232 300 259 219 216],178,4,4871,2.7802511415525113,0.0,40.0
9752,2,1752,[226 212 202 231 268],561,0,4871,2.778665145464917,0.0,20.0
9753,2,1753,[261 236 202 240 413],130,4,4875,2.7793614595210947,0.0,0.0
9754,2,1754,[232 392 293 276 216],429,4,4879,2.78005698005698,0.0,20.0
9755,2,1755,[254 232 272 250 246],682,3,4882,2.7801822323462413,20.0,0.0
9756,2,1756,[240 276 254 243 216],130,3,4885,2.78030734206033,0.0,20.0
9757,2,1757,[226 452 583 217 324],268,3,4888,2.7804323094425483,0.0,0.0
9758,2,1758,[259 222 251 221 508],303,3,4891,2.7805571347356453,0.0,20.0
9759,2,1759,[239 324 219 365 227],276,4,4895,2.78125,0.0,0.0
9760,2,1760,[213 201 218 226 220],1,0,4895,2.779670641680863,0.0,0.0
9761,2,1761,[255 315 243 295 283],919,2,4897,2.779228149829739,20.0,0.0
9762,2,1762,[300 367 481 293 219],429,2,4899,2.7787861599546226,0.0,20.0
9763,2,1763,[324 300 217 508 246],327,1,4900,2.7777777777777777,0.0,20.0
9764,2,1764,[227 222 230 212 219],896,3,4903,2.777903682719547,0.0,20.0
9765,2,1765,[219 301 218 583 508],429,2,4905,2.7774631936579843,0.0,0.0
9766,2,1766,[209 326 227 507 222],303,2,4907,2.7770232031692133,0.0,20.0
9767,2,1767,[217 232 431 240 293],682,4,4911,2.7777149321266967,0.0,0.0
9768,2,1768,[218 291 283 250 275],429,2,4913,2.7772752967778405,0.0,0.0
9769,2,1769,[246 284 208 244 255],500,2,4915,2.7768361581920904,0.0,0.0
9770,2,1770,[583 226 231 290 378],682,0,4915,2.7752682100508186,0.0,0.0
9771,2,1771,[303 508 251 284 259],181,0,4915,2.773702031602709,0.0,0.0
9772,2,1772,[300 316 350 236 221],758,3,4918,2.7738296672306824,20.0,20.0
9773,2,1773,[206 226 291 298 240],435,4,4922,2.774520856820744,0.0,20.0
9774,2,1774,[293 290 240 226 300],303,3,4925,2.7746478873239435,0.0,20.0
9775,2,1775,[221 298 350 208 230],758,4,4929,2.7753378378378377,0.0,20.0
9776,2,1776,[215 276 231 216 209],747,2,4931,2.774901519414744,0.0,20.0
9777,2,1777,[298 217 291 293 250],130,3,4934,2.7750281214848145,0.0,20.0
9778,2,1778,[215 293 223 240 300],682,3,4937,2.7751545812254075,20.0,20.0
9779,2,1779,[284 230 202 211 227],435,3,4940,2.7752808988764044,0.0,0.0
9780,2,1780,[378 291 223 293 254],682,1,4941,2.7742841100505333,20.0,0.0
9781,2,1781,[298 301 246 251 508],592,4,4945,2.7749719416386083,0.0,20.0
9782,2,1782,[218 211 299 384 291],435,3,4948,2.7750981491867637,0.0,0.0
9783,2,1783,[300 240 217 298 231],497,2,4950,2.774663677130045,0.0,40.0
9784,2,1784,[291 206 316 303 230],276,4,4954,2.7753501400560223,20.0,0.0
9785,2,1785,[276 291 226 324 219],303,3,4957,2.775475923852184,0.0,0.0
9786,2,1786,[583 223 384 365 284],276,2,4959,2.775041969781757,20.0,0.0
9787,2,1787,[226 284 201 202 216],896,2,4961,2.774608501118568,0.0,20.0
9788,2,1788,[250 209 231 321 300],303,3,4964,2.7747344885410845,0.0,20.0
9789,2,1789,[583 218 206 255 226],293,1,4965,2.7737430167597767,0.0,0.0
9790,2,1790,[250 202 219 222 232],727,2,4967,2.7733109994416525,0.0,20.0
9791,2,1791,[231 222 227 326 390],303,1,4968,2.7723214285714284,0.0,20.0
9792,2,1792,[221 254 201 256 220],1,2,4970,2.7718906860011154,0.0,0.0
9793,2,1793,[303 331 431 297 276],592,3,4973,2.7720178372352287,0.0,0.0
9794,2,1794,[231 208 201 209 392],660,2,4975,2.7715877437325904,0.0,0.0
9795,2,1795,[384 300 264 583 230],276,2,4977,2.7711581291759466,0.0,20.0
9796,2,1796,[239 217 298 254 384],880,3,4980,2.7712854757929883,0.0,20.0
9797,2,1797,[290 508 226 246 240],347,3,4983,2.771412680756396,0.0,0.0
9798,2,1798,[431 250 331 272 301],276,4,4987,2.772095608671484,20.0,0.0
9799,2,1799,[431 276 295 326 336],592,3,4990,2.772222222222222,0.0,0.0
9800,2,1800,[264 223 226 301 272],276,4,4994,2.7729039422543034,40.0,0.0
9801,2,1801,[240 264 223 221 218],1,2,4996,2.772475027746948,20.0,0.0
9802,2,1802,[226 215 276 255 209],303,5,5001,2.7737104825291183,0.0,0.0
9803,2,1803,[218 485 420 208 384],472,2,5003,2.7732815964523283,0.0,0.0
9804,2,1804,[241 583 284 290 365],429,0,5003,2.7717451523545704,0.0,0.0
9805,2,1805,[420 211 223 226 316],293,3,5006,2.7718715393133997,40.0,0.0
9806,2,1806,[247 367 255 250 232],222,1,5007,2.770890979524073,0.0,0.0
9807,2,1807,[452 226 413 240 223],222,1,5008,2.769911504424779,20.0,0.0
9808,2,1808,[211 431 239 232 231],896,2,5010,2.769485903814262,0.0,0.0
9809,2,1809,[239 236 420 300 293],758,1,5011,2.7685082872928177,0.0,20.0
9810,2,1810,[240 316 508 223 324],758,4,5015,2.7691882937603536,40.0,0.0
9811,2,1811,[218 240 293 222 223],222,3,5018,2.7693156732891833,20.0,20.0
9812,2,1812,[284 218 268 208 221],303,5,5023,2.770546056260342,0.0,20.0
9813,2,1813,[255 227 216 290 221],303,4,5027,2.7712238147739803,0.0,20.0
9814,2,1814,[298 244 268 276 230],178,2,5029,2.770798898071625,0.0,40.0
9815,2,1815,[215 232 221 201 239],201,1,5030,2.7698237885462555,0.0,0.0
9816,2,1816,[241 255 507 293 284],606,4,5034,2.770500825536599,0.0,0.0
9817,2,1817,[508 201 244 275 331],919,4,5038,2.771177117711771,0.0,0.0
9818,2,1818,[226 236 239 215 284],916,1,5039,2.77020340846619,0.0,0.0
9819,2,1819,[367 413 217 431 290],286,2,5041,2.7697802197802197,0.0,0.0
9820,2,1820,[367 201 429 227 420],896,4,5045,2.770455793520044,0.0,0.0
9821,2,1821,[255 215 280 227 239],293,1,5046,2.769484083424808,0.0,0.0
9822,2,1822,[215 326 509 232 217],201,0,5046,2.7679648930334615,0.0,0.0
9823,2,1823,[315 367 268 217 250],286,4,5050,2.768640350877193,20.0,20.0
9824,2,1824,[367 275 222 431 378],790,2,5052,2.768219178082192,0.0,20.0
9825,2,1825,[211 230 298 231 219],660,1,5053,2.7672508214676887,0.0,20.0
9826,2,1826,[202 344 223 326 276],592,5,5058,2.768472906403941,20.0,0.0
9827,2,1827,[215 250 222 231 216],222,3,5061,2.7685995623632387,0.0,40.0
9828,2,1828,[272 413 219 222 583],201,1,5062,2.76763258611263,20.0,20.0
9829,2,1829,[239 216 250 218 284],435,2,5064,2.767213114754098,0.0,20.0
9830,2,1830,[350 298 222 250 241],757,3,5067,2.7673402512288368,0.0,40.0
9831,2,1831,[232 241 202 209 255],682,2,5069,2.7669213973799125,0.0,0.0
9832,2,1832,[268 298 315 259 246],919,1,5070,2.765957446808511,20.0,40.0
9833,2,1833,[209 295 392 316 254],880,2,5072,2.7655398037077425,20.0,0.0
9834,2,1834,[256 215 230 232 217],363,0,5072,2.764032697547684,0.0,0.0
9835,2,1835,[218 272 201 202 268],682,4,5076,2.764705882352941,20.0,20.0
9836,2,1836,[321 324 344 215 201],327,3,5079,2.7648339684267826,0.0,0.0
9837,2,1837,[250 236 201 303 264],919,3,5082,2.764961915125136,0.0,0.0
9838,2,1838,[231 268 240 283 216],790,3,5085,2.7650897226753672,0.0,40.0
9839,2,1839,[420 239 507 209 367],303,4,5089,2.7657608695652174,0.0,0.0
9840,2,1840,[227 226 206 291 232],276,3,5092,2.7658881042911463,0.0,0.0
9841,2,1841,[290 316 221 509 241],758,3,5095,2.766015200868621,20.0,0.0
9842,2,1842,[226 206 291 268 392],276,3,5098,2.7661421595225177,0.0,20.0
9843,2,1843,[227 239 223 217 431],276,4,5102,2.7668112798264644,20.0,0.0
9844,2,1844,[217 365 226 219 201],682,2,5104,2.7663956639566396,0.0,0.0
9845,2,1845,[284 206 218 240 254],276,4,5108,2.7670639219934996,0.0,0.0
9846,2,1846,[298 222 241 300 227],347,4,5112,2.7677314564158095,0.0,60.0
9847,2,1847,[452 209 222 226 218],222,3,5115,2.767857142857143,0.0,20.0
9848,2,1848,[283 293 290 420 223],303,4,5119,2.768523526230395,20.0,0.0
9849,2,1849,[291 275 241 378 394],393,5,5124,2.76972972972973,0.0,0.0
9850,2,1850,[240 221 413 251 223],303,3,5127,2.7698541329011346,20.0,0.0
9851,2,1851,[420 290 218 261 216],130,4,5131,2.7705183585313176,0.0,20.0
9852,2,1852,[431 241 218 223 250],178,4,5135,2.77118186724231,20.0,0.0
9853,2,1853,[392 227 299 217 208],435,4,5139,2.7718446601941746,0.0,0.0
9854,2,1854,[230 300 392 227 217],222,3,5142,2.771967654986523,0.0,20.0
9855,2,1855,[293 268 202 420 227],94,3,5145,2.7720905172413794,0.0,20.0
9856,2,1856,[367 250 208 255 283],500,2,5147,2.771674744211093,0.0,0.0
9857,2,1857,[293 367 216 283 392],429,2,5149,2.771259418729817,0.0,20.0
9858,2,1858,[452 218 223 239 206],268,0,5149,2.769768692845616,20.0,0.0
9859,2,1859,[298 259 291 206 485],393,3,5152,2.7698924731182797,0.0,20.0
9860,2,1860,[250 223 201 300 431],682,3,5155,2.770016120365395,20.0,20.0
9861,2,1861,[291 272 206 227 284],130,2,5157,2.7696025778732545,20.0,0.0
9862,2,1862,[240 250 276 223 254],682,2,5159,2.7691894793344067,20.0,0.0
9863,2,1863,[227 367 239 452 231],453,0,5159,2.767703862660944,0.0,0.0
9864,2,1864,[298 244 280 217 209],916,2,5161,2.7672922252010723,0.0,20.0
9865,2,1865,[246 291 365 219 250],276,3,5164,2.767416934619507,0.0,0.0
9866,2,1866,[284 227 219 206 250],130,1,5165,2.766470273165506,0.0,0.0
9867,2,1867,[316 295 276 219 254],130,3,5168,2.766595289079229,20.0,0.0
9868,2,1868,[298 243 367 255 268],130,4,5172,2.767255216693419,0.0,40.0
9869,2,1869,[217 298 413 219 227],222,2,5174,2.766844919786096,0.0,20.0
9870,2,1870,[230 378 298 208 239],222,3,5177,2.766969535008017,0.0,20.0
9871,2,1871,[583 216 223 390 268],94,3,5180,2.767094017094017,20.0,40.0
9872,2,1872,[213 321 227 272 276],201,3,5183,2.767218366257341,20.0,0.0
9873,2,1873,[216 222 255 268 247],222,3,5186,2.767342582710779,0.0,60.0
9874,2,1874,[392 202 384 291 206],393,2,5188,2.7669333333333332,0.0,0.0
9875,2,1875,[230 268 218 272 298],880,4,5192,2.767590618336887,20.0,40.0
9876,2,1876,[452 230 201 215 216],303,3,5195,2.7677144379328715,0.0,20.0
9877,2,1877,[301 240 227 316 222],276,5,5200,2.768903088391906,20.0,20.0
9878,2,1878,[299 291 261 315 293],592,2,5202,2.7684938797232572,20.0,0.0
9879,2,1879,[413 246 231 452 508],276,2,5204,2.7680851063829786,0.0,0.0
9880,2,1880,[250 275 236 295 268],624,3,5207,2.7682083997873472,0.0,20.0
9881,2,1881,[280 209 215 241 508],222,2,5209,2.7678002125398513,0.0,0.0
9882,2,1882,[315 212 420 231 331],758,3,5212,2.7679235262878388,20.0,0.0
9883,2,1883,[272 206 321 315 303],393,3,5215,2.7680467091295116,40.0,0.0
9884,2,1884,[232 293 202 209 507],293,2,5217,2.7676392572944297,0.0,0.0
9885,2,1885,[216 254 220 232 230],1,2,5219,2.767232237539767,0.0,20.0
9886,2,1886,[284 241 283 223 246],303,4,5223,2.767885532591415,20.0,0.0
9887,2,1887,[217 222 216 202 429],868,0,5223,2.766419491525424,0.0,40.0
9888,2,1888,[280 211 208 291 485],429,3,5226,2.7665431445209103,0.0,0.0
9889,2,1889,[508 216 331 344 452],758,3,5229,2.7666666666666666,0.0,20.0
9890,2,1890,[268 251 420 246 276],303,5,5234,2.7678476996298254,0.0,20.0
9891,2,1891,[284 232 280 231 219],682,1,5235,2.766913319238901,0.0,0.0
9892,2,1892,[384 254 367 218 300],682,0,5235,2.7654516640253566,0.0,20.0
9893,2,1893,[367 222 275 392 344],393,3,5238,2.765575501583949,0.0,20.0
9894,2,1894,[300 384 230 276 217],758,2,5240,2.7651715039577835,0.0,20.0
9895,2,1895,[284 316 291 211 213],293,1,5241,2.7642405063291138,20.0,0.0
9896,2,1896,[227 367 240 250 202],472,5,5246,2.7654190827622562,0.0,0.0
9897,2,1897,[290 226 275 481 209],429,2,5248,2.7650158061116965,0.0,0.0
9898,2,1898,[284 255 240 218 268],682,3,5251,2.7651395471300684,0.0,20.0
9899,2,1899,[226 272 215 583 300],293,2,5253,2.764736842105263,20.0,20.0
9900,2,1900,[291 232 299 226 230],896,1,5254,2.7638085218306156,0.0,0.0
9901,2,1901,[350 272 452 316 209],758,4,5258,2.7644584647739223,40.0,0.0
9902,2,1902,[431 217 202 211 230],495,5,5263,2.765633210719916,0.0,0.0
9903,2,1903,[243 202 276 291 293],130,4,5267,2.766281512605042,0.0,0.0
9904,2,1904,[218 583 226 324 215],303,3,5270,2.7664041994750654,0.0,0.0
9905,2,1905,[232 275 367 217 222],896,3,5273,2.766526757607555,0.0,20.0
9906,2,1906,[217 231 268 378 293],682,3,5276,2.7666491872050343,0.0,20.0
9907,2,1907,[244 240 246 268 209],1,3,5279,2.7667714884696015,0.0,20.0
9908,2,1908,[218 413 231 208 222],303,3,5282,2.7668936616029334,0.0,20.0
9909,2,1909,[202 367 508 246 215],130,5,5287,2.768062827225131,0.0,0.0
9910,2,1910,[219 241 291 290 218],303,4,5291,2.7687074829931975,0.0,0.0
9911,2,1911,[413 384 276 452 324],303,1,5292,2.7677824267782425,0.0,0.0
9912,2,1912,[299 413 251 221 291],181,0,5292,2.7663355985363305,0.0,0.0
9913,2,1913,[209 276 232 218 211],551,5,5297,2.7675026123301985,0.0,0.0
9914,2,1914,[209 272 226 206 232],1,2,5299,2.7671018276762402,20.0,0.0
9915,2,1915,[267 240 227 326 291],130,4,5303,2.7677453027139873,0.0,0.0
9916,2,1916,[324 298 246 336 268],592,4,5307,2.7683881064162756,0.0,40.0
9917,2,1917,[293 290 217 284 509],682,3,5310,2.7685088633993744,0.0,0.0
9918,2,1918,[272 509 250 300 216],293,2,5312,2.768108389786347,20.0,40.0
9919,2,1919,[211 209 367 208 230],94,4,5316,2.76875,0.0,0.0
9920,2,1920,[246 202 413 290 240],276,4,5320,2.769390942217595,0.0,0.0
9921,2,1921,[226 268 291 231 295],130,3,5323,2.7695109261186266,0.0,20.0
9922,2,1922,[267 215 230 216 218],532,4,5327,2.7701508060322415,0.0,20.0
9923,2,1923,[241 259 209 583 413],303,2,5329,2.7697505197505197,0.0,0.0
9924,2,1924,[215 413 284 240 250],303,3,5332,2.76987012987013,0.0,0.0
9925,2,1925,[344 297 452 331 211],758,3,5335,2.7699896157840085,0.0,0.0
9926,2,1926,[221 272 275 283 261],919,4,5339,2.7706279190451477,20.0,0.0
9927,2,1927,[217 213 452 324 272],758,3,5342,2.770746887966805,20.0,0.0
9928,2,1928,[324 300 367 241 264],276,3,5345,2.7708657335406945,0.0,20.0
9929,2,1929,[239 429 509 206 297],293,3,5348,2.770984455958549,0.0,0.0
9930,2,1930,[219 293 241 301 201],429,2,5350,2.7705851890212325,0.0,0.0
9931,2,1931,[413 283 431 250 232],727,2,5352,2.770186335403727,0.0,0.0
9932,2,1932,[250 220 295 241 276],178,2,5354,2.769787894464563,0.0,0.0
9933,2,1933,[215 367 239 268 247],222,3,5357,2.7699069286452946,0.0,20.0
9934,2,1934,[226 508 384 452 230],399,0,5357,2.7684754521963826,0.0,0.0
9935,2,1935,[250 217 241 420 218],94,4,5361,2.769111570247934,0.0,0.0
9936,2,1936,[280 365 227 202 284],551,4,5365,2.769747031491998,0.0,0.0
9937,2,1937,[264 212 227 236 230],1,4,5369,2.7703818369453046,0.0,0.0
9938,2,1938,[509 240 255 217 209],682,2,5371,2.7699845281072717,0.0,0.0
9939,2,1939,[276 209 316 220 478],178,3,5374,2.770103092783505,40.0,0.0
9940,2,1940,[239 209 429 206 478],896,3,5377,2.7702215352910873,20.0,0.0
9941,2,1941,[324 219 268 201 431],327,3,5380,2.7703398558187438,0.0,20.0
9942,2,1942,[240 290 226 232 250],268,2,5382,2.7699433865156973,0.0,0.0
9943,2,1943,[508 452 226 239 300],222,2,5384,2.769547325102881,0.0,20.0
9944,2,1944,[239 268 216 218 250],222,4,5388,2.7701799485861183,0.0,40.0
9945,2,1945,[583 226 213 291 215],293,1,5389,2.7692702980472763,0.0,0.0
9946,2,1946,[284 299 413 254 208],435,2,5391,2.768875192604006,0.0,0.0
9947,2,1947,[365 201 202 222 243],682,3,5394,2.768993839835729,0.0,20.0
9948,2,1948,[264 291 240 392 206],435,2,5396,2.7685992816829144,0.0,0.0
9949,2,1949,[202 222 213 284 509],293,0,5396,2.767179487179487,0.0,20.0
9950,2,1950,[202 215 321 227 216],303,3,5399,2.7672988211173757,0.0,20.0
9951,2,1951,[212 284 240 219 239],561,0,5399,2.7658811475409837,0.0,0.0
9952,2,1952,[300 365 246 392 293],222,4,5403,2.7665130568356373,0.0,20.0
9953,2,1953,[211 222 431 268 300],435,2,5405,2.7661207778915045,0.0,60.0
9954,2,1954,[481 291 316 276 240],758,3,5408,2.7662404092071613,20.0,0.0
9955,2,1955,[216 255 384 508 298],299,3,5411,2.766359918200409,0.0,40.0
9956,2,1956,[295 202 367 326 303],592,5,5416,2.7675012774655086,0.0,0.0
9957,2,1957,[326 508 209 268 300],178,4,5420,2.7681307456588358,0.0,40.0
9958,2,1958,[208 315 231 226 316],880,4,5424,2.768759571209801,40.0,0.0
9959,2,1959,[298 221 232 244 227],916,2,5426,2.7683673469387755,0.0,20.0
9960,2,1960,[431 291 290 321 215],393,2,5428,2.767975522692504,0.0,0.0
9961,2,1961,[208 390 324 276 222],303,2,5430,2.767584097859327,0.0,20.0
9962,2,1962,[222 241 217 284 246],276,5,5435,2.7687213448802854,0.0,20.0
9963,2,1963,[232 431 227 255 216],222,3,5438,2.7688391038696536,0.0,20.0
9964,2,1964,[301 211 315 272 227],660,3,5441,2.7689567430025446,40.0,0.0
9965,2,1965,[231 217 452 215 202],130,3,5444,2.7690742624618516,0.0,0.0
9966,2,1966,[217 216 222 240 230],1,3,5447,2.7691916624300967,0.0,40.0
9967,2,1967,[212 298 222 291 221],758,4,5451,2.769817073170732,0.0,40.0
9968,2,1968,[222 315 230 276 508],201,2,5453,2.7694261046216355,20.0,20.0
9969,2,1969,[221 239 283 227 390],303,1,5454,2.768527918781726,0.0,0.0
9970,2,1970,[216 478 222 301 324],327,1,5455,2.7676306443429732,20.0,40.0
9971,2,1971,[250 218 284 275 255],178,4,5459,2.7682555780933065,0.0,0.0
9972,2,1972,[291 256 284 251 259],181,0,5459,2.7668525088697415,0.0,0.0
9973,2,1973,[232 254 272 291 240],276,2,5461,2.7664640324214793,20.0,0.0
9974,2,1974,[222 240 291 201 230],303,1,5462,2.7655696202531646,0.0,20.0
9975,2,1975,[508 316 350 226 295],130,4,5466,2.766194331983806,20.0,0.0
9976,2,1976,[290 201 293 239 392],276,4,5470,2.766818411734952,0.0,0.0
9977,2,1977,[223 209 283 226 206],293,2,5472,2.7664307381193125,20.0,0.0
9978,2,1978,[231 268 241 250 239],521,3,5475,2.7665487620010105,0.0,20.0
9979,2,1979,[246 231 507 208 384],303,4,5479,2.7671717171717174,0.0,0.0
9980,2,1980,[298 508 283 344 251],592,5,5484,2.768298838970217,0.0,20.0
9981,2,1981,[508 276 223 275 293],919,5,5489,2.7694248234106964,20.0,0.0
9982,2,1982,[231 268 365 250 290],682,2,5491,2.7690368129097327,0.0,20.0
9983,2,1983,[250 217 316 300 211],758,3,5494,2.7691532258064515,20.0,20.0
9984,2,1984,[293 219 215 250 232],291,5,5499,2.7702770780856425,0.0,0.0
9985,2,1985,[315 290 324 250 216],758,5,5504,2.771399798590131,20.0,20.0
9986,2,1986,[223 301 291 254 583],276,2,5506,2.771011575239054,20.0,0.0
9987,2,1987,[384 216 226 508 223],551,4,5510,2.771629778672032,20.0,20.0
9988,2,1988,[303 284 420 293 215],276,5,5515,2.772750125691302,0.0,0.0
9989,2,1989,[213 226 276 219 206],916,2,5517,2.772361809045226,0.0,0.0
9990,2,1990,[303 216 293 202 384],758,4,5521,2.772978402812657,0.0,20.0
9991,2,1991,[315 223 240 215 206],293,3,5524,2.7730923694779115,40.0,0.0
9992,2,1992,[241 222 250 350 213],758,4,5528,2.7737079779227294,0.0,20.0
9993,2,1993,[264 222 478 344 268],327,3,5531,2.7738214643931793,20.0,40.0
9994,2,1994,[300 254 246 264 217],435,2,5533,2.7734335839599,0.0,20.0
9995,2,1995,[223 420 583 240 232],303,3,5536,2.773547094188377,20.0,0.0
9996,2,1996,[291 367 218 239 209],293,0,5536,2.772158237356034,0.0,0.0
9997,2,1997,[221 321 212 452 231],201,1,5537,2.7712712712712713,0.0,0.0
9998,2,1998,[268 243 201 232 507],561,1,5538,2.770385192596298,0.0,20.0
9999,2,1999,[230 298 378 240 268],222,3,5541,2.7705,0.0,40.0
10000,2,2000,[216 206 201 208 227],363,2,5543,2.7701149425287355,0.0,20.0
10001,2,2001,[293 367 209 202 303],293,2,5545,2.7697302697302697,0.0,0.0
10002,2,2002,[240 226 222 290 215],130,4,5549,2.770344483275087,0.0,20.0
10003,2,2003,[209 222 264 211 485],299,2,5551,2.7699600798403194,0.0,20.0
10004,2,2004,[299 259 222 283 256],181,1,5552,2.769077306733167,0.0,20.0
10005,2,2005,[219 324 250 227 217],425,2,5554,2.768693918245264,0.0,0.0
10006,2,2006,[264 297 221 301 295],919,2,5556,2.7683109118086695,0.0,0.0
10007,2,2007,[216 384 331 221 293],758,3,5559,2.768426294820717,0.0,20.0
10008,2,2008,[261 250 222 246 280],222,2,5561,2.7680438028870085,0.0,20.0
10009,2,2009,[215 250 216 298 268],521,1,5562,2.7671641791044777,0.0,60.0
10010,2,2010,[217 227 201 226 291],429,1,5563,2.7662854301342614,0.0,0.0
10011,2,2011,[201 268 303 239 226],201,2,5565,2.7659045725646125,0.0,20.0
10012,2,2012,[261 284 255 202 201],919,2,5567,2.765524093392946,0.0,0.0
10013,2,2013,[240 251 213 316 226],293,1,5568,2.7646474677259185,20.0,0.0
10014,2,2014,[250 216 227 272 268],1,4,5572,2.7652605459057074,20.0,40.0
10015,2,2015,[367 232 219 223 202],291,5,5577,2.7663690476190474,20.0,0.0
10016,2,2016,[293 413 254 298 316],130,3,5580,2.766484878532474,20.0,20.0
10017,2,2017,[232 246 218 264 276],399,1,5581,2.765609514370664,0.0,0.0
10018,2,2018,[431 284 246 394 215],435,2,5583,2.765230312035661,0.0,0.0
10019,2,2019,[219 227 246 240 217],1,2,5585,2.764851485148515,0.0,0.0
10020,2,2020,[485 507 232 216 230],846,2,5587,2.764473033151905,0.0,20.0
10021,2,2021,[326 215 452 231 232],303,3,5590,2.764589515331355,0.0,0.0
10022,2,2022,[293 223 222 264 367],250,4,5594,2.7652001977261493,20.0,20.0
10023,2,2023,[508 293 298 326 300],178,3,5597,2.7653162055335967,0.0,40.0
10024,2,2024,[217 452 384 431 241],896,1,5598,2.7644444444444445,0.0,0.0
10025,2,2025,[219 284 272 232 209],201,1,5599,2.763573543928924,20.0,0.0
10026,2,2026,[216 509 202 481 211],758,5,5604,2.7646768623581646,0.0,20.0
10027,2,2027,[250 215 241 321 223],303,4,5608,2.7652859960552267,20.0,0.0
10028,2,2028,[217 251 202 303 300],293,2,5610,2.764908822079842,0.0,20.0
10029,2,2029,[507 217 284 209 251],293,2,5612,2.7645320197044336,0.0,0.0
10030,2,2030,[261 301 272 315 202],592,3,5615,2.7646479566715905,40.0,0.0
10031,2,2031,[301 344 250 218 508],327,1,5616,2.763779527559055,0.0,0.0
10032,2,2032,[227 272 280 222 290],393,4,5620,2.764387604525332,20.0,20.0
10033,2,2033,[230 326 261 452 250],222,2,5622,2.7640117994100293,0.0,0.0
10034,2,2034,[217 303 315 481 240],758,3,5625,2.764127764127764,20.0,0.0
10035,2,2035,[324 223 202 272 508],758,5,5630,2.7652259332023577,40.0,0.0
10036,2,2036,[222 367 326 215 201],303,3,5633,2.7653411880216003,0.0,20.0
10037,2,2037,[215 246 300 264 226],327,2,5635,2.764965652600589,0.0,20.0
10038,2,2038,[256 226 241 230 208],1,4,5639,2.765571358509073,0.0,0.0
10039,2,2039,[255 284 295 283 331],178,4,5643,2.7661764705882352,0.0,0.0
10040,2,2040,[298 231 223 350 216],363,2,5645,2.7658010779029887,20.0,40.0
10041,2,2041,[300 284 420 392 230],276,4,5649,2.766405484818805,0.0,20.0
10042,2,2042,[246 223 301 324 276],276,5,5654,2.767498776309349,20.0,0.0
10043,2,2043,[223 350 336 264 222],363,3,5657,2.7676125244618395,20.0,20.0
10044,2,2044,[276 291 293 431 298],429,5,5662,2.7687041564792176,0.0,20.0
10045,2,2045,[227 413 219 301 231],399,1,5663,2.767839687194526,0.0,0.0
10046,2,2046,[291 272 221 508 231],758,3,5666,2.767953102100635,20.0,0.0
10047,2,2047,[508 276 509 231 209],201,2,5668,2.767578125,0.0,0.0
10048,2,2048,[211 284 222 431 217],551,4,5672,2.7681795998047827,0.0,20.0
10049,2,2049,[431 259 298 326 367],592,3,5675,2.768292682926829,0.0,20.0
10050,2,2050,[301 508 264 215 299],592,2,5677,2.7679180887372015,0.0,0.0
10051,2,2051,[283 222 365 344 239],393,2,5679,2.767543859649123,0.0,20.0
10052,2,2052,[209 272 251 264 232],293,2,5681,2.7671699951290796,20.0,0.0
10053,2,2053,[241 213 276 291 420],758,2,5683,2.7667964946445958,0.0,0.0
10054,2,2054,[231 202 300 283 299],880,2,5685,2.7664233576642334,0.0,20.0
10055,2,2055,[216 299 384 250 218],301,4,5689,2.767023346303502,0.0,20.0
10056,2,2056,[216 201 508 219 431],94,4,5693,2.767622751579971,0.0,20.0
10057,2,2057,[215 202 240 246 219],130,5,5698,2.7687074829931975,0.0,0.0
10058,2,2058,[268 220 219 243 212],1,2,5700,2.768334142787761,0.0,20.0
10059,2,2059,[241 222 239 213 212],1,4,5704,2.7689320388349516,0.0,20.0
10060,2,2060,[218 295 275 508 246],919,3,5707,2.7690441533236294,0.0,0.0
10061,2,2061,[209 367 221 298 507],303,5,5712,2.770126091173618,0.0,20.0
10062,2,2062,[232 429 264 284 298],293,2,5714,2.7697527872031023,0.0,20.0
10063,2,2063,[226 275 222 481 231],429,2,5716,2.7693798449612403,0.0,20.0
10064,2,2064,[420 284 201 384 216],246,1,5717,2.7685230024213077,0.0,20.0
10065,2,2065,[365 276 246 218 216],222,5,5722,2.769603097773475,0.0,20.0
10066,2,2066,[290 222 255 284 215],303,4,5726,2.7701983551040157,0.0,20.0
10067,2,2067,[232 217 365 226 209],880,3,5729,2.770309477756286,0.0,0.0
10068,2,2068,[290 452 583 508 241],303,3,5732,2.7704204929917835,0.0,0.0
10069,2,2069,[239 452 240 300 209],758,1,5733,2.7695652173913046,0.0,20.0
10070,2,2070,[367 291 276 246 202],276,3,5736,2.7696764847899566,0.0,0.0
10071,2,2071,[222 218 298 246 221],916,2,5738,2.7693050193050195,0.0,40.0
10072,2,2072,[509 215 298 378 291],682,2,5740,2.7689339122045347,0.0,20.0
10073,2,2073,[218 201 300 268 284],276,5,5745,2.770009643201543,0.0,40.0
10074,2,2074,[227 255 331 216 219],435,3,5748,2.770120481927711,0.0,20.0
10075,2,2075,[291 250 583 218 231],303,3,5751,2.770231213872832,0.0,0.0
10076,2,2076,[291 255 216 222 209],244,2,5753,2.7698603755416467,0.0,40.0
10077,2,2077,[276 255 268 218 291],682,1,5754,2.7690086621751684,0.0,20.0
10078,2,2078,[316 250 291 261 350],130,4,5758,2.7696007696007694,20.0,0.0
10079,2,2079,[293 367 394 300 226],880,3,5761,2.7697115384615385,0.0,20.0
10080,2,2080,[255 283 208 201 384],303,3,5764,2.7698222008649687,0.0,0.0
10081,2,2081,[316 315 350 331 344],758,4,5768,2.770413064361191,40.0,0.0
10082,2,2082,[218 259 216 222 239],1,3,5771,2.770523283725396,0.0,40.0
10083,2,2083,[272 230 295 255 276],130,3,5774,2.77063339731286,20.0,0.0
10084,2,2084,[202 222 236 293 250],606,3,5777,2.7707434052757796,0.0,20.0
10085,2,2085,[478 209 295 508 241],178,3,5780,2.7708533077660595,20.0,0.0
10086,2,2086,[272 236 261 226 276],130,5,5785,2.7719214183037852,20.0,0.0
10087,2,2087,[223 420 324 283 452],303,2,5787,2.771551724137931,20.0,0.0
10088,2,2088,[230 241 508 251 268],303,4,5791,2.772139779798947,0.0,20.0
10089,2,2089,[259 254 243 209 431],660,3,5794,2.7722488038277513,0.0,0.0
10090,2,2090,[206 255 222 331 218],130,3,5797,2.772357723577236,0.0,20.0
10091,2,2091,[264 508 218 321 259],919,3,5800,2.7724665391969405,0.0,0.0
10092,2,2092,[275 509 211 507 420],293,3,5803,2.7725752508361206,0.0,0.0
10093,2,2093,[209 201 219 367 268],682,2,5805,2.7722063037249285,0.0,20.0
10094,2,2094,[420 218 583 429 216],293,3,5808,2.7723150357995228,0.0,20.0
10095,2,2095,[256 244 219 241 583],916,3,5811,2.7724236641221376,0.0,0.0
10096,2,2096,[227 431 367 300 331],435,2,5813,2.772055317119695,0.0,20.0
10097,2,2097,[284 217 300 429 297],293,2,5815,2.7716873212583413,0.0,20.0
10098,2,2098,[212 213 267 240 232],1,2,5817,2.7713196760362075,0.0,0.0
10099,2,2099,[215 226 202 251 259],1,2,5819,2.770952380952381,0.0,0.0
10100,2,2100,[297 261 275 268 298],919,2,5821,2.7705854355069013,0.0,40.0
10101,2,2101,[321 216 217 508 326],130,4,5825,2.7711703139866795,0.0,20.0
10102,2,2102,[230 413 321 508 272],201,1,5826,2.7703281027104136,20.0,0.0
10103,2,2103,[264 298 367 324 303],592,4,5830,2.7709125475285172,0.0,20.0
10104,2,2104,[259 201 272 284 217],682,4,5834,2.771496437054632,20.0,0.0
10105,2,2105,[300 239 293 413 291],303,1,5835,2.7706552706552707,0.0,20.0
10106,2,2106,[321 209 231 276 239],303,3,5838,2.770764119601329,0.0,0.0
10107,2,2107,[232 217 212 223 384],363,1,5839,2.769924098671727,20.0,0.0
10108,2,2108,[239 219 255 211 298],682,2,5841,2.7695590327169275,0.0,20.0
10109,2,2109,[201 315 298 230 394],880,3,5844,2.7696682464454976,20.0,20.0
10110,2,2110,[255 298 284 293 272],919,3,5847,2.7697773567029844,20.0,20.0
10111,2,2111,[264 508 231 215 291],303,3,5850,2.7698863636363638,0.0,0.0
10112,2,2112,[283 215 478 280 219],178,5,5855,2.770941788925698,20.0,0.0
10113,2,2113,[255 268 384 583 219],682,1,5856,2.770104068117313,0.0,20.0
10114,2,2114,[452 255 232 290 583],303,3,5859,2.7702127659574467,0.0,0.0
10115,2,2115,[485 251 298 315 326],305,3,5862,2.7703213610586013,20.0,20.0
10116,2,2116,[202 211 275 264 215],327,3,5865,2.7704298535663674,0.0,0.0
10117,2,2117,[240 264 206 211 230],293,2,5867,2.7700661000944287,0.0,0.0
10118,2,2118,[240 241 250 231 218],303,4,5871,2.7706465313827278,0.0,0.0
10119,2,2119,[226 227 222 206 246],435,4,5875,2.7712264150943398,0.0,20.0
10120,2,2120,[206 227 392 222 241],521,3,5878,2.7713342762847715,0.0,20.0
10121,2,2121,[452 299 240 261 298],130,4,5882,2.77191328934967,0.0,20.0
10122,2,2122,[240 232 250 431 365],682,3,5885,2.772020725388601,0.0,0.0
10123,2,2123,[239 272 223 244 212],1,3,5888,2.7721280602636535,40.0,0.0
10124,2,2124,[212 324 301 218 293],758,3,5891,2.772235294117647,0.0,0.0
10125,2,2125,[215 211 217 268 202],327,3,5894,2.7723424270931325,0.0,20.0
10126,2,2126,[212 298 251 208 240],299,4,5898,2.772919605077574,0.0,20.0
10127,2,2127,[290 236 218 219 223],916,2,5900,2.7725563909774436,20.0,0.0
10128,2,2128,[255 216 583 251 298],303,4,5904,2.7731329262564586,0.0,40.0
10129,2,2129,[272 211 208 246 206],1,3,5907,2.7732394366197184,20.0,0.0
10130,2,2130,[431 241 280 215 212],916,2,5909,2.7728765837634914,0.0,0.0
10131,2,2131,[280 291 316 227 218],293,0,5909,2.771575984990619,20.0,0.0
10132,2,2132,[293 508 226 384 367],291,5,5914,2.7726207219878107,0.0,0.0
10133,2,2133,[222 209 331 217 316],551,4,5918,2.7731958762886597,20.0,20.0
10134,2,2134,[367 507 218 275 303],293,2,5920,2.7728337236533958,0.0,0.0
10135,2,2135,[276 216 241 217 303],201,2,5922,2.7724719101123596,0.0,20.0
10136,2,2136,[201 231 216 331 218],201,4,5926,2.7730463266261114,0.0,20.0
10137,2,2137,[316 295 243 254 240],130,2,5928,2.772684752104771,20.0,0.0
10138,2,2138,[201 336 259 202 268],592,3,5931,2.772791023842917,0.0,20.0
10139,2,2139,[276 239 315 219 223],201,3,5934,2.7728971962616824,40.0,0.0
10140,2,2140,[240 226 254 246 431],682,3,5937,2.7730032695002333,0.0,0.0
10141,2,2141,[272 251 507 230 583],293,3,5940,2.773109243697479,20.0,0.0
10142,2,2142,[219 232 326 280 247],222,3,5943,2.7732151189920673,0.0,0.0
10143,2,2143,[250 201 276 300 268],880,3,5946,2.7733208955223883,0.0,40.0
10144,2,2144,[316 201 246 283 209],880,3,5949,2.7734265734265735,20.0,0.0
10145,2,2145,[420 268 384 226 250],303,4,5953,2.7739981360671018,0.0,20.0
10146,2,2146,[431 452 331 232 268],201,2,5955,2.773637633907778,0.0,20.0
10147,2,2147,[272 261 218 240 227],130,4,5959,2.7742085661080074,20.0,0.0
10148,2,2148,[250 301 268 272 297],592,4,5963,2.7747789669613776,20.0,20.0
10149,2,2149,[276 583 509 206 239],916,3,5966,2.7748837209302324,0.0,0.0
10150,2,2150,[508 303 246 259 264],919,3,5969,2.7749883774988375,0.0,0.0
10151,2,2151,[241 250 217 413 222],276,4,5973,2.775557620817844,0.0,20.0
10152,2,2152,[240 384 508 250 284],276,4,5977,2.776126335346029,0.0,0.0
10153,2,2153,[280 215 209 272 231],286,3,5980,2.776230269266481,20.0,0.0
10154,2,2154,[280 231 367 431 276],487,1,5981,2.7754060324825987,0.0,0.0
10155,2,2155,[223 264 324 508 239],303,2,5983,2.7750463821892395,20.0,0.0
10156,2,2156,[209 241 216 232 280],178,5,5988,2.776077885952712,0.0,20.0
10157,2,2157,[299 300 223 209 217],177,3,5991,2.7761816496756255,20.0,20.0
10158,2,2158,[202 218 240 216 217],1,2,5993,2.775822139879574,0.0,20.0
10159,2,2159,[392 219 243 284 299],130,2,5995,2.775462962962963,0.0,0.0
10160,2,2160,[232 316 429 301 215],276,4,5999,2.776029615918556,20.0,0.0
10161,2,2161,[290 413 215 202 284],130,2,6001,2.7756706753006477,0.0,0.0
10162,2,2162,[219 326 226 246 202],303,4,6005,2.776236708275543,0.0,0.0
10163,2,2163,[209 392 239 227 230],846,3,6008,2.77634011090573,0.0,0.0
10164,2,2164,[240 250 236 215 268],130,4,6012,2.776905311778291,0.0,20.0
10165,2,2165,[213 378 367 298 303],299,3,6015,2.7770083102493075,0.0,20.0
10166,2,2166,[222 290 413 201 223],276,4,6019,2.7775726811259807,20.0,20.0
10167,2,2167,[240 295 255 222 331],770,3,6022,2.7776752767527677,0.0,20.0
10168,2,2168,[276 241 413 226 251],303,4,6026,2.7782388197325956,0.0,0.0
10169,2,2169,[227 295 250 241 226],532,4,6030,2.7788018433179724,0.0,0.0
10170,2,2170,[223 508 284 215 268],347,3,6033,2.7789037309995392,20.0,20.0
10171,2,2171,[218 240 254 227 246],1,2,6035,2.7785451197053406,0.0,0.0
10172,2,2172,[384 452 316 367 246],276,2,6037,2.778186838472158,20.0,0.0
10173,2,2173,[264 202 240 208 221],1,3,6040,2.7782888684452622,0.0,0.0
10174,2,2174,[246 215 230 236 261],130,4,6044,2.7788505747126435,0.0,0.0
10175,2,2175,[202 478 215 212 232],896,2,6046,2.7784926470588234,20.0,0.0
10176,2,2176,[324 315 209 250 420],758,4,6050,2.779053743683969,20.0,0.0
10177,2,2177,[230 216 264 222 295],459,3,6053,2.779155188246097,0.0,40.0
10178,2,2178,[226 268 298 303 208],889,3,6056,2.779256539697109,0.0,40.0
10179,2,2179,[232 276 508 230 384],399,0,6056,2.777981651376147,0.0,0.0
10180,2,2180,[246 231 239 250 280],880,2,6058,2.777624942686841,0.0,0.0
10181,2,2181,[431 508 365 239 413],276,2,6060,2.777268560953254,0.0,0.0
10182,2,2182,[284 202 226 213 230],293,0,6060,2.775996335318369,0.0,0.0
10183,2,2183,[217 226 230 250 208],880,3,6063,2.776098901098901,0.0,0.0
10184,2,2184,[251 264 250 297 284],293,2,6065,2.7757437070938216,0.0,0.0
10185,2,2185,[208 223 209 230 298],429,4,6069,2.7763037511436415,20.0,20.0
10186,2,2186,[246 290 316 298 413],276,4,6073,2.7768632830361226,20.0,20.0
10187,2,2187,[394 367 202 206 378],393,2,6075,2.776508226691042,0.0,0.0
10188,2,2188,[384 276 218 219 227],301,3,6078,2.7766103243490177,0.0,0.0
10189,2,2189,[244 243 315 297 283],919,2,6080,2.776255707762557,20.0,0.0
10190,2,2190,[413 298 299 295 267],130,2,6082,2.775901414879051,0.0,20.0
10191,2,2191,[508 365 201 452 227],276,3,6085,2.7760036496350367,0.0,0.0
10192,2,2192,[219 201 218 230 429],301,5,6090,2.7770177838577292,0.0,0.0
10193,2,2193,[384 321 227 226 367],303,2,6092,2.7766636280765726,0.0,0.0
10194,2,2194,[378 218 209 215 485],846,5,6097,2.7776765375854215,0.0,0.0
10195,2,2195,[272 218 223 384 276],870,4,6101,2.778233151183971,40.0,0.0
10196,2,2196,[301 217 452 241 226],276,4,6105,2.778789258079199,0.0,0.0
10197,2,2197,[268 246 202 232 284],222,4,6109,2.7793448589626935,0.0,20.0
10198,2,2198,[284 509 201 280 239],682,2,6111,2.7789904502046383,0.0,0.0
10199,2,2199,[250 216 290 208 209],758,5,6116,2.78,0.0,20.0
10200,2,2200,[222 206 290 216 392],130,3,6119,2.7800999545661065,0.0,40.0
10201,2,2201,[481 303 209 218 316],758,5,6124,2.7811080835603996,20.0,0.0
10202,2,2202,[209 268 227 321 298],303,3,6127,2.781207444394008,0.0,40.0
10203,2,2203,[290 331 219 298 392],276,4,6131,2.781760435571688,0.0,20.0
10204,2,2204,[213 209 293 211 251],293,3,6134,2.781859410430839,0.0,0.0
10205,2,2205,[429 209 208 216 481],747,3,6137,2.7819582955575703,0.0,20.0
10206,2,2206,[219 367 216 227 321],429,2,6139,2.781603987313095,0.0,20.0
10207,2,2207,[413 365 367 232 215],291,4,6143,2.7821557971014492,0.0,0.0
10208,2,2208,[316 431 293 218 240],276,4,6147,2.7827071072883656,20.0,0.0
10209,2,2209,[392 267 215 293 290],130,4,6151,2.783257918552036,0.0,0.0
10210,2,2210,[264 508 221 321 295],919,2,6153,2.7829036635006785,0.0,0.0
10211,2,2211,[215 255 213 232 246],1,1,6154,2.7820976491862566,0.0,0.0
10212,2,2212,[431 290 298 202 212],916,1,6155,2.781292363307727,0.0,20.0
10213,2,2213,[201 227 431 321 284],435,2,6157,2.780939476061427,0.0,0.0
10214,2,2214,[316 226 293 239 420],276,5,6162,2.781941309255079,20.0,0.0
10215,2,2215,[284 299 291 254 298],130,2,6164,2.7815884476534296,0.0,20.0
10216,2,2216,[243 290 201 384 215],682,2,6166,2.781235904375282,0.0,0.0
10217,2,2217,[298 240 283 378 259],393,3,6169,2.7813345356176735,0.0,20.0
10218,2,2218,[227 508 226 298 392],429,2,6171,2.7809824245155474,0.0,20.0
10219,2,2219,[240 209 215 222 431],222,4,6175,2.7815315315315314,0.0,20.0
10220,2,2220,[226 316 321 300 272],130,5,6180,2.7825303917154436,40.0,20.0
10221,2,2221,[227 392 485 223 431],393,3,6183,2.782628262826283,20.0,0.0
10222,2,2222,[246 298 240 230 290],435,2,6185,2.782276203328835,0.0,20.0
10223,2,2223,[350 217 331 261 231],130,2,6187,2.7819244604316546,0.0,0.0
10224,2,2224,[254 293 291 299 268],130,3,6190,2.7820224719101123,0.0,20.0
10225,2,2225,[221 246 256 223 583],916,4,6194,2.7825696316262354,20.0,0.0
10226,2,2226,[303 300 218 284 221],919,4,6198,2.7831162999550965,0.0,20.0
10227,2,2227,[208 420 215 297 272],293,4,6202,2.7836624775583485,20.0,0.0
10228,2,2228,[365 316 231 218 295],880,3,6205,2.78375953342306,20.0,0.0
10229,2,2229,[218 230 240 250 206],293,1,6206,2.7829596412556055,0.0,0.0
10230,2,2230,[218 219 211 284 206],916,1,6207,2.782160466158673,0.0,0.0
10231,2,2231,[367 222 392 232 255],487,3,6210,2.782258064516129,0.0,20.0
10232,2,2232,[291 367 223 259 268],592,3,6213,2.782355575459024,20.0,20.0
10233,2,2233,[291 215 367 254 239],130,4,6217,2.7829006266786034,0.0,0.0
10234,2,2234,[268 239 217 275 509],201,2,6219,2.7825503355704697,0.0,20.0
10235,2,2235,[208 300 378 392 284],429,1,6220,2.78175313059034,0.0,20.0
10236,2,2236,[222 219 201 241 231],896,2,6222,2.781403665623603,0.0,20.0
10237,2,2237,[208 264 300 216 272],293,2,6224,2.781054512957998,20.0,40.0
10238,2,2238,[219 392 250 212 367],896,1,6225,2.780259044216168,0.0,0.0
10239,2,2239,[250 300 215 222 206],896,2,6227,2.7799107142857142,0.0,40.0
10240,2,2240,[230 256 259 216 220],1,3,6230,2.780008924587238,0.0,20.0
10241,2,2241,[452 251 583 230 326],303,1,6231,2.77921498661909,0.0,0.0
10242,2,2242,[378 392 485 365 280],393,3,6234,2.7793134195274187,0.0,0.0
10243,2,2243,[223 250 303 241 324],758,4,6238,2.7798573975044563,20.0,0.0
10244,2,2244,[246 209 254 276 291],276,3,6241,2.779955456570156,0.0,0.0
10245,2,2245,[290 315 291 240 283],293,0,6241,2.778717720391808,20.0,0.0
10246,2,2246,[583 259 236 240 215],303,2,6243,2.7783711615487316,0.0,0.0
10247,2,2247,[231 384 240 226 209],276,3,6246,2.7784697508896796,0.0,0.0
10248,2,2248,[331 321 264 295 246],919,1,6247,2.7776789684304135,0.0,0.0
10249,2,2249,[276 331 215 211 232],201,2,6249,2.7773333333333334,0.0,0.0
10250,2,2250,[290 218 227 378 298],429,1,6250,2.7765437583296313,0.0,20.0
10251,2,2251,[275 227 392 315 223],393,5,6255,2.77753108348135,40.0,0.0
10252,2,2252,[206 239 201 232 481],896,2,6257,2.777185974256547,0.0,0.0
10253,2,2253,[303 206 291 255 251],293,3,6260,2.777284826974268,0.0,0.0
10254,2,2254,[231 272 384 283 240],880,2,6262,2.776940133037694,20.0,0.0
10255,2,2255,[508 303 331 413 240],201,2,6264,2.776595744680851,0.0,0.0
10256,2,2256,[215 209 208 431 509],846,5,6269,2.7775808595480727,0.0,0.0
10257,2,2257,[276 295 268 223 336],592,4,6273,2.7781222320637733,20.0,20.0
10258,2,2258,[222 202 232 261 217],222,3,6276,2.7782204515272246,0.0,20.0
10259,2,2259,[239 202 240 331 215],276,5,6281,2.779203539823009,0.0,0.0
10260,2,2260,[215 211 509 209 583],201,0,6281,2.77797434763379,0.0,0.0
10261,2,2261,[299 321 280 300 316],663,3,6284,2.778072502210433,20.0,20.0
10262,2,2262,[268 213 431 218 276],201,4,6288,2.778612461334512,0.0,20.0
10263,2,2263,[485 367 211 431 209],846,4,6292,2.7791519434628977,0.0,0.0
10264,2,2264,[226 215 300 378 431],222,3,6295,2.7792494481236205,0.0,20.0
10265,2,2265,[303 239 215 217 420],293,3,6298,2.7793468667255077,0.0,0.0
10266,2,2266,[239 241 226 431 295],399,2,6300,2.779003087781209,0.0,0.0
10267,2,2267,[300 508 298 255 295],323,3,6303,2.7791005291005293,0.0,40.0
10268,2,2268,[290 232 241 227 219],916,1,6304,2.7783164389598944,0.0,0.0
10269,2,2269,[331 243 264 250 297],919,2,6306,2.777973568281938,0.0,0.0
10270,2,2270,[241 215 208 222 293],606,2,6308,2.7776309995596655,0.0,20.0
10271,2,2271,[367 485 431 298 481],429,2,6310,2.777288732394366,0.0,20.0
10272,2,2272,[276 485 219 431 365],429,3,6313,2.777386713594369,0.0,0.0
10273,2,2273,[244 295 268 230 300],178,3,6316,2.777484608619173,0.0,40.0
10274,2,2274,[215 231 217 209 240],222,2,6318,2.777142857142857,0.0,0.0
10275,2,2275,[227 255 231 250 219],222,1,6319,2.7763620386643235,0.0,0.0
10276,2,2276,[201 367 243 250 255],919,3,6322,2.7764602547211243,0.0,0.0
10277,2,2277,[283 241 509 244 275],299,2,6324,2.7761194029850746,0.0,0.0
10278,2,2278,[251 264 367 316 485],293,1,6325,2.7753400614304518,20.0,0.0
10279,2,2279,[303 508 431 367 241],276,3,6328,2.7754385964912283,0.0,0.0
10280,2,2280,[226 297 290 485 222],293,1,6329,2.774660236738273,0.0,20.0
10281,2,2281,[291 216 276 452 272],130,5,6334,2.7756354075372482,20.0,20.0
10282,2,2282,[236 344 221 227 293],758,2,6336,2.7752956636005255,0.0,0.0
10283,2,2283,[276 251 350 215 250],592,5,6341,2.7762697022767076,0.0,0.0
10284,2,2284,[378 226 216 201 211],495,4,6345,2.7768052516411377,0.0,20.0
10285,2,2285,[284 219 384 508 241],399,1,6346,2.7760279965004373,0.0,0.0
10286,2,2286,[293 268 209 231 392],880,2,6348,2.7756886751202448,0.0,20.0
10287,2,2287,[283 316 392 239 218],880,3,6351,2.7757867132867133,20.0,0.0
10288,2,2288,[298 218 367 226 283],880,4,6355,2.776321537789428,0.0,20.0
10289,2,2289,[315 280 227 223 291],293,1,6356,2.7755458515283844,40.0,0.0
10290,2,2290,[326 219 284 452 392],130,4,6360,2.7760803142732433,0.0,0.0
10291,2,2291,[219 209 218 280 250],222,3,6363,2.776178010471204,0.0,0.0
10292,2,2292,[218 247 202 206 211],1,2,6365,2.7758395115569123,0.0,0.0
10293,2,2293,[509 239 420 284 280],682,1,6366,2.775065387968614,0.0,0.0
10294,2,2294,[365 227 331 429 315],276,4,6370,2.775599128540305,20.0,0.0
10295,2,2295,[226 390 202 583 283],303,2,6372,2.775261324041812,0.0,0.0
10296,2,2296,[331 315 240 420 413],276,4,6376,2.7757945145842404,20.0,0.0
10297,2,2297,[239 303 300 232 298],293,2,6378,2.775456919060052,0.0,40.0
10298,2,2298,[324 300 230 298 206],521,1,6379,2.7746846454980427,0.0,40.0
10299,2,2299,[226 268 230 290 250],435,3,6382,2.774782608695652,0.0,20.0
10300,2,2300,[222 507 283 219 218],429,3,6385,2.7748804867448937,0.0,20.0
10301,2,2301,[365 378 275 209 268],790,3,6388,2.7749782797567333,0.0,20.0
10302,2,2302,[217 218 284 240 268],276,5,6393,2.77594442032132,0.0,20.0
10303,2,2303,[268 390 222 209 201],94,4,6397,2.7764756944444446,0.0,40.0
10304,2,2304,[331 250 240 301 251],532,3,6400,2.7765726681127982,0.0,0.0
10305,2,2305,[293 227 316 250 218],130,3,6403,2.776669557675629,20.0,0.0
10306,2,2306,[583 226 217 243 431],682,2,6405,2.776332899869961,0.0,0.0
10307,2,2307,[384 227 293 216 218],363,2,6407,2.7759965337954937,0.0,20.0
10308,2,2308,[241 290 344 367 303],393,2,6409,2.7756604590731917,0.0,0.0
10309,2,2309,[223 413 390 250 236],303,3,6412,2.775757575757576,20.0,0.0
10310,2,2310,[206 209 220 219 243],1,2,6414,2.775421895283427,0.0,0.0
10311,2,2311,[241 431 293 275 276],429,4,6418,2.7759515570934257,0.0,0.0
10312,2,2312,[222 239 231 259 202],682,2,6420,2.775616083009079,0.0,20.0
10313,2,2313,[216 250 268 300 272],532,4,6424,2.7761452031114953,20.0,60.0
10314,2,2314,[365 218 291 485 280],429,1,6425,2.775377969762419,0.0,0.0
10315,2,2315,[201 243 264 508 324],592,3,6428,2.775474956822107,0.0,0.0
10316,2,2316,[211 240 226 246 324],268,4,6432,2.7760034527406128,0.0,0.0
10317,2,2317,[303 222 268 250 508],276,5,6437,2.776962899050906,0.0,40.0
10318,2,2318,[247 508 280 268 326],222,2,6439,2.7766278568348426,0.0,20.0
10319,2,2319,[583 508 250 218 221],303,4,6443,2.777155172413793,0.0,0.0
10320,2,2320,[293 241 250 222 223],758,3,6446,2.7772511848341233,20.0,20.0
10321,2,2321,[264 222 202 223 272],919,2,6448,2.776916451335056,40.0,20.0
10322,2,2322,[219 331 216 208 431],435,3,6451,2.7770124838570815,0.0,20.0
10323,2,2323,[268 231 209 478 452],846,3,6454,2.7771084337349397,20.0,20.0
10324,2,2324,[227 202 208 239 215],407,3,6457,2.777204301075269,0.0,0.0
10325,2,2325,[272 367 264 293 452],276,2,6459,2.7768701633705932,20.0,0.0
10326,2,2326,[241 392 365 250 321],429,0,6459,2.775676837129351,0.0,0.0
10327,2,2327,[295 213 290 250 268],916,3,6462,2.7757731958762886,0.0,20.0
10328,2,2328,[241 216 299 583 367],682,3,6465,2.7758694718763417,0.0,20.0
10329,2,2329,[280 209 222 208 264],293,0,6465,2.774678111587983,0.0,20.0
10330,2,2330,[452 217 250 267 300],130,3,6468,2.774774774774775,0.0,20.0
10331,2,2331,[250 216 390 211 420],94,4,6472,2.775300171526587,0.0,20.0
10332,2,2332,[315 324 508 583 284],201,2,6474,2.7749678525503643,20.0,0.0
10333,2,2333,[222 202 227 230 326],130,3,6477,2.7750642673521853,0.0,20.0
10334,2,2334,[227 232 217 222 226],201,1,6478,2.774304068522484,0.0,20.0
10335,2,2335,[218 250 291 219 259],303,3,6481,2.774400684931507,0.0,0.0
10336,2,2336,[303 508 583 321 227],201,2,6483,2.774069319640565,0.0,0.0
10337,2,2337,[240 392 219 431 239],435,2,6485,2.773738237810094,0.0,0.0
10338,2,2338,[429 209 239 485 208],293,1,6486,2.7729799059427105,0.0,0.0
10339,2,2339,[485 231 250 255 208],472,4,6490,2.7735042735042734,0.0,0.0
10340,2,2340,[392 217 208 230 201],660,1,6491,2.7727466894489536,0.0,0.0
10341,2,2341,[254 230 250 222 239],435,2,6493,2.772416737830914,0.0,20.0
10342,2,2342,[291 209 367 226 299],682,1,6494,2.7716602646180113,0.0,0.0
10343,2,2343,[219 246 223 390 216],303,4,6498,2.772184300341297,20.0,20.0
10344,2,2344,[300 272 293 284 290],130,3,6501,2.77228144989339,20.0,20.0
10345,2,2345,[365 222 276 230 300],276,4,6505,2.7728047740835464,0.0,40.0
10346,2,2346,[223 232 259 420 507],303,4,6509,2.7733276523221133,20.0,0.0
10347,2,2347,[275 251 300 226 209],293,1,6510,2.7725724020442932,0.0,20.0
10348,2,2348,[222 246 283 299 240],880,4,6514,2.773094934014474,0.0,20.0
10349,2,2349,[254 227 206 299 284],130,0,6514,2.7719148936170215,0.0,0.0
10350,2,2350,[232 230 227 367 284],222,2,6516,2.7715865589111015,0.0,0.0
10351,2,2351,[420 298 280 240 250],393,3,6519,2.7716836734693877,0.0,20.0
10352,2,2352,[215 216 431 420 384],682,3,6522,2.771780705482363,0.0,20.0
10353,2,2353,[232 201 331 272 324],276,4,6526,2.772302463891249,20.0,0.0
10354,2,2354,[217 223 378 218 284],682,2,6528,2.7719745222929935,20.0,0.0
10355,2,2355,[231 290 215 291 324],276,3,6531,2.7720713073005094,0.0,0.0
10356,2,2356,[211 251 267 232 219],1,2,6533,2.7717437420449724,0.0,0.0
10357,2,2357,[211 420 452 208 297],758,3,6536,2.7718405428329094,0.0,0.0
10358,2,2358,[255 219 276 254 293],130,4,6540,2.7723611699872825,0.0,0.0
10359,2,2359,[365 215 231 239 222],472,5,6545,2.7733050847457625,0.0,20.0
10360,2,2360,[239 246 452 283 420],303,2,6547,2.7729775518847948,0.0,0.0
10361,2,2361,[508 240 384 452 290],303,2,6549,2.772650296359018,0.0,0.0
10362,2,2362,[293 291 299 301 280],717,5,6554,2.7735928903935676,0.0,0.0
10363,2,2363,[303 209 509 276 297],299,2,6556,2.77326565143824,0.0,0.0
10364,2,2364,[209 256 217 218 220],1,2,6558,2.7729386892177588,0.0,0.0
10365,2,2365,[290 221 231 223 420],758,2,6560,2.772612003381234,20.0,0.0
10366,2,2366,[241 324 508 316 583],276,4,6564,2.7731305449936627,20.0,0.0
10367,2,2367,[239 212 303 420 216],758,3,6567,2.7732263513513513,0.0,20.0
10368,2,2368,[209 222 295 276 283],880,3,6570,2.773322076825665,0.0,20.0
10369,2,2369,[250 298 255 215 268],500,3,6573,2.7734177215189875,0.0,40.0
10370,2,2370,[216 508 295 272 240],130,4,6577,2.7739350485027416,20.0,20.0
10371,2,2371,[268 300 293 365 209],276,4,6581,2.774451939291737,0.0,40.0
10372,2,2372,[259 280 215 507 303],393,4,6585,2.774968394437421,0.0,0.0
10373,2,2373,[259 283 284 367 226],303,3,6588,2.775063184498736,0.0,0.0
10374,2,2374,[232 291 300 226 283],303,2,6590,2.774736842105263,0.0,20.0
10375,2,2375,[509 280 268 201 298],682,3,6593,2.7748316498316496,0.0,40.0
10376,2,2376,[236 202 508 298 326],606,4,6597,2.775347076146403,0.0,20.0
10377,2,2377,[211 208 431 255 202],435,3,6600,2.7754415475189234,0.0,0.0
10378,2,2378,[255 220 261 209 232],1,1,6601,2.7746952501050863,0.0,0.0
10379,2,2379,[219 276 218 222 367],442,1,6602,2.7739495798319327,0.0,20.0
10380,2,2380,[268 384 208 284 240],435,2,6604,2.7736245275094498,0.0,20.0
10381,2,2381,[222 240 301 413 299],21,2,6606,2.7732997481108312,0.0,20.0
10382,2,2382,[239 215 583 232 202],916,1,6607,2.7725556021821234,0.0,0.0
10383,2,2383,[218 208 201 384 290],363,1,6608,2.771812080536913,0.0,0.0
10384,2,2384,[268 217 231 259 211],1,1,6609,2.771069182389937,0.0,20.0
10385,2,2385,[250 206 201 226 240],435,4,6613,2.7715842414082146,0.0,0.0
10386,2,2386,[250 429 232 284 452],276,3,6616,2.7716799329702555,0.0,0.0
10387,2,2387,[298 291 239 222 227],293,1,6617,2.7709380234505865,0.0,40.0
10388,2,2388,[301 216 276 202 367],500,3,6620,2.771033905399749,0.0,20.0
10389,2,2389,[420 583 215 222 268],276,4,6624,2.7715481171548118,0.0,40.0
10390,2,2390,[413 315 508 431 583],276,2,6626,2.7712254286909244,20.0,0.0
10391,2,2391,[202 217 268 431 336],327,2,6628,2.770903010033445,0.0,20.0
10392,2,2392,[226 508 227 219 250],130,3,6631,2.7709987463435017,0.0,0.0
10393,2,2393,[227 276 485 211 216],429,3,6634,2.77109440267335,0.0,20.0
10394,2,2394,[284 268 264 300 291],551,4,6638,2.77160751565762,0.0,40.0
10395,2,2395,[216 222 261 227 240],130,4,6642,2.7721202003338896,0.0,40.0
10396,2,2396,[291 223 222 218 227],276,4,6646,2.7726324572382146,20.0,20.0
10397,2,2397,[246 452 420 303 227],276,4,6650,2.773144286905755,0.0,0.0
10398,2,2398,[232 291 202 219 583],551,4,6654,2.7736556898707794,0.0,0.0
10399,2,2399,[212 291 239 231 217],758,2,6656,2.7733333333333334,0.0,0.0
10400,2,2400,[216 283 291 326 431],592,3,6659,2.7734277384423156,0.0,20.0
10401,2,2401,[230 217 202 413 250],435,3,6662,2.7735220649458783,0.0,0.0
10402,2,2402,[250 384 301 367 331],276,3,6665,2.773616312942156,0.0,0.0
10403,2,2403,[268 231 326 223 321],303,3,6668,2.7737104825291183,20.0,20.0
10404,2,2404,[297 284 315 202 508],919,2,6670,2.773388773388773,20.0,0.0
10405,2,2405,[272 300 290 219 431],276,4,6674,2.773898586866168,20.0,20.0
10406,2,2406,[232 231 236 230 508],303,4,6678,2.7744079767345244,0.0,0.0
10407,2,2407,[223 219 211 209 509],682,1,6679,2.773671096345515,20.0,0.0
10408,2,2408,[226 293 298 507 583],327,1,6680,2.7729348277293484,0.0,20.0
10409,2,2409,[240 202 217 239 331],435,4,6684,2.7734439834024895,0.0,0.0
10410,2,2410,[222 508 240 291 301],181,1,6685,2.772708419742845,0.0,20.0
10411,2,2411,[420 431 429 481 219],896,3,6688,2.772802653399668,0.0,0.0
10412,2,2412,[250 241 201 481 300],896,2,6690,2.7724823870700375,0.0,20.0
10413,2,2413,[247 255 236 213 241],1,2,6692,2.772162386081193,0.0,0.0
10414,2,2414,[275 213 215 216 217],790,3,6695,2.772256728778468,0.0,20.0
10415,2,2415,[324 212 384 209 431],773,1,6696,2.771523178807947,0.0,0.0
10416,2,2416,[202 246 284 272 431],276,4,6700,2.772031443938767,20.0,0.0
10417,2,2417,[350 301 264 221 303],592,3,6703,2.7721257237386268,0.0,0.0
10418,2,2418,[420 206 215 226 268],276,5,6708,2.773046713517983,0.0,20.0
10419,2,2419,[217 250 202 316 276],130,3,6711,2.773140495867769,20.0,0.0
10420,2,2420,[246 218 268 219 264],327,3,6714,2.7732342007434942,0.0,20.0
10421,2,2421,[344 222 202 217 226],327,2,6716,2.772914946325351,0.0,20.0
10422,2,2422,[378 209 392 247 226],222,2,6718,2.7725959554271564,0.0,0.0
10423,2,2423,[222 316 293 230 236],130,4,6722,2.7731023102310233,20.0,20.0
10424,2,2424,[232 241 230 413 246],222,3,6725,2.7731958762886597,0.0,0.0
10425,2,2425,[226 452 231 284 222],933,0,6725,2.772052761747733,0.0,20.0
10426,2,2426,[244 316 300 259 268],178,3,6728,2.7721466831479193,20.0,40.0
10427,2,2427,[218 247 268 217 267],1,2,6730,2.771828665568369,0.0,20.0
10428,2,2428,[276 291 202 231 219],429,4,6734,2.7723342939481266,0.0,0.0
10429,2,2429,[508 222 316 290 244],407,3,6737,2.7724279835390946,20.0,20.0
10430,2,2430,[452 239 431 293 324],758,1,6738,2.771698889345948,0.0,0.0
10431,2,2431,[239 298 206 218 321],130,4,6742,2.7722039473684212,0.0,20.0
10432,2,2432,[219 268 202 413 508],201,3,6745,2.7722975750102754,0.0,20.0
10433,2,2433,[201 298 301 431 315],363,1,6746,2.771569433032046,20.0,20.0
10434,2,2434,[420 275 298 284 291],293,2,6748,2.771252566735113,0.0,20.0
10435,2,2435,[284 215 367 291 218],291,5,6753,2.772167487684729,0.0,0.0
10436,2,2436,[240 283 243 284 244],919,1,6754,2.7714402954452195,0.0,0.0
10437,2,2437,[509 222 508 324 232],551,4,6758,2.77194421657096,0.0,20.0
10438,2,2438,[217 392 240 367 230],472,5,6763,2.7728577285772857,0.0,0.0
10439,2,2439,[315 431 303 217 213],758,3,6766,2.7729508196721313,20.0,0.0
10440,2,2440,[222 250 240 218 223],919,2,6768,2.7726341663252767,20.0,20.0
10441,2,2441,[217 222 208 213 202],790,1,6769,2.7719082719082717,0.0,20.0
10442,2,2442,[272 216 217 218 202],758,4,6773,2.7724109701187065,20.0,20.0
10443,2,2443,[284 219 240 508 583],303,3,6776,2.772504091653028,0.0,0.0
10444,2,2444,[300 226 293 218 280],429,1,6777,2.7717791411042945,0.0,20.0
10445,2,2445,[297 284 240 246 217],919,2,6779,2.7714636140637774,0.0,0.0
10446,2,2446,[217 478 321 209 300],327,2,6781,2.7711483449121372,20.0,20.0
10447,2,2447,[217 392 508 367 431],94,4,6785,2.7716503267973858,0.0,0.0
10448,2,2448,[390 223 583 209 255],303,3,6788,2.7717435688035934,20.0,0.0
10449,2,2449,[230 509 202 201 241],201,1,6789,2.7710204081632654,0.0,0.0
10450,2,2450,[218 268 331 300 216],435,2,6791,2.770705834353325,0.0,60.0
10451,2,2451,[300 508 284 219 431],896,1,6792,2.769983686786297,0.0,20.0
10452,2,2452,[268 420 378 239 231],682,1,6793,2.7692621280065226,0.0,20.0
10453,2,2453,[232 209 227 452 219],868,1,6794,2.7685411572942136,0.0,0.0
10454,2,2454,[240 254 452 350 202],130,4,6798,2.769042769857434,0.0,0.0
10455,2,2455,[239 298 222 223 283],249,4,6802,2.769543973941368,20.0,40.0
10456,2,2456,[431 223 300 211 284],682,3,6805,2.7696377696377694,20.0,20.0
10457,2,2457,[239 272 216 202 331],130,4,6809,2.770138323840521,20.0,20.0
10458,2,2458,[280 240 298 583 241],682,3,6812,2.7702318015453438,0.0,20.0
10459,2,2459,[202 509 218 284 297],293,1,6813,2.7695121951219512,0.0,0.0
10460,2,2460,[227 315 209 583 218],551,4,6817,2.770012190166599,20.0,0.0
10461,2,2461,[202 247 280 293 232],222,2,6819,2.7696994313566208,0.0,0.0
10462,2,2462,[299 227 246 226 264],435,4,6823,2.7701989443767765,0.0,0.0
10463,2,2463,[213 236 211 218 206],1,2,6825,2.7698863636363638,0.0,0.0
10464,2,2464,[202 239 321 291 230],435,3,6828,2.769979716024341,0.0,0.0
10465,2,2465,[246 290 267 216 295],130,3,6831,2.77007299270073,0.0,20.0
10466,2,2466,[367 239 290 315 223],293,1,6832,2.7693554925010133,40.0,0.0
10467,2,2467,[259 344 216 508 243],592,3,6835,2.7694489465153973,0.0,20.0
10468,2,2468,[392 331 431 215 291],276,2,6837,2.7691373025516404,0.0,0.0
10469,2,2469,[295 222 284 508 201],880,5,6842,2.7700404858299597,0.0,20.0
10470,2,2470,[272 261 293 283 295],592,4,6846,2.770538243626062,20.0,0.0
10471,2,2471,[219 223 222 583 284],276,4,6850,2.7710355987055015,20.0,20.0
10472,2,2472,[250 217 264 201 240],435,3,6853,2.7711281843914275,0.0,0.0
10473,2,2473,[241 268 212 231 222],1,4,6857,2.7716248989490704,0.0,40.0
10474,2,2474,[230 223 217 280 481],429,1,6858,2.770909090909091,20.0,0.0
10475,2,2475,[298 299 315 209 276],880,4,6862,2.77140549273021,20.0,20.0
10476,2,2476,[297 222 240 324 291],758,4,6866,2.7719014937424302,0.0,20.0
10477,2,2477,[290 239 219 209 431],916,0,6866,2.770782889426957,0.0,0.0
10478,2,2478,[298 272 384 230 206],276,4,6870,2.771278741427995,20.0,20.0
10479,2,2479,[206 429 222 217 481],896,3,6873,2.7713709677419356,0.0,20.0
10480,2,2480,[218 206 268 293 350],130,4,6877,2.7718661829907294,0.0,20.0
10481,2,2481,[241 324 217 202 264],551,2,6879,2.7715551974214345,0.0,0.0
10482,2,2482,[226 212 331 315 222],201,2,6881,2.771244462343939,20.0,20.0
10483,2,2483,[291 251 297 222 221],592,3,6884,2.7713365539452495,0.0,20.0
10484,2,2484,[394 208 246 216 291],435,4,6888,2.771830985915493,0.0,20.0
10485,2,2485,[226 230 256 212 222],916,1,6889,2.771118262268705,0.0,20.0
10486,2,2486,[268 232 367 272 219],682,2,6891,2.7708082026537997,20.0,20.0
10487,2,2487,[208 215 201 275 226],864,4,6895,2.7713022508038585,0.0,0.0
10488,2,2488,[222 254 230 290 201],660,1,6896,2.7705905986339894,0.0,20.0
10489,2,2489,[223 583 202 227 212],201,3,6899,2.7706827309236948,20.0,0.0
10490,2,2490,[272 420 365 290 223],393,2,6901,2.7703733440385387,40.0,0.0
10491,2,2491,[227 452 378 219 295],399,1,6902,2.769662921348315,0.0,0.0
10492,2,2492,[259 236 261 299 283],592,1,6903,2.7689530685920576,0.0,0.0
10493,2,2493,[284 222 315 244 300],919,1,6904,2.768243785084202,20.0,40.0
10494,2,2494,[223 508 222 326 226],551,5,6909,2.769138276553106,20.0,20.0
10495,2,2495,[209 231 213 217 236],758,3,6912,2.769230769230769,0.0,0.0
10496,2,2496,[316 243 240 255 508],130,4,6916,2.7697236684020825,20.0,0.0
10497,2,2497,[268 284 223 244 201],268,2,6918,2.7694155324259406,20.0,20.0
10498,2,2498,[209 206 284 227 230],727,1,6919,2.7687074829931975,0.0,0.0
10499,2,2499,[241 219 255 223 268],682,2,6921,2.7684,20.0,20.0
10500,2,2500,[420 250 290 227 298],276,5,6926,2.7692922830867652,0.0,20.0
10501,2,2501,[290 223 227 226 298],363,3,6929,2.769384492406075,20.0,20.0
10502,2,2502,[211 316 251 217 226],293,2,6931,2.769077107471035,20.0,0.0
10503,2,2503,[202 392 250 315 367],880,3,6934,2.7691693290734825,20.0,0.0
10504,2,2504,[241 367 222 413 219],303,3,6937,2.7692614770459083,0.0,20.0
10505,2,2505,[295 276 367 509 217],916,3,6940,2.7693535514764567,0.0,0.0
10506,2,2506,[283 215 201 290 275],864,4,6944,2.769844435580375,0.0,0.0
10507,2,2507,[431 202 209 315 222],660,3,6947,2.7699362041467306,20.0,20.0
10508,2,2508,[217 384 211 272 509],551,3,6950,2.7700278995615784,20.0,0.0
10509,2,2509,[344 218 241 290 231],758,2,6952,2.7697211155378487,0.0,0.0
10510,2,2510,[315 316 275 217 211],286,4,6956,2.77021107128634,40.0,0.0
10511,2,2511,[507 429 303 232 315],293,3,6959,2.770302547770701,20.0,0.0
10512,2,2512,[267 246 219 208 268],1,4,6963,2.770791882212495,0.0,20.0
10513,2,2513,[230 284 202 481 241],301,4,6967,2.771280827366746,0.0,0.0
10514,2,2514,[211 298 231 241 219],682,3,6970,2.771371769383698,0.0,20.0
10515,2,2515,[201 303 209 232 290],276,4,6974,2.771860095389507,0.0,0.0
10516,2,2516,[250 231 316 429 227],425,4,6978,2.772348033373063,20.0,0.0
10517,2,2517,[217 215 218 212 350],363,0,6978,2.7712470214455918,0.0,0.0
10518,2,2518,[222 255 259 272 251],1,2,6980,2.7709408495434698,20.0,20.0
10519,2,2519,[208 261 239 246 367],222,2,6982,2.7706349206349206,0.0,0.0
10520,2,2520,[202 206 215 293 315],293,3,6985,2.7707259024196746,20.0,0.0
10521,2,2521,[331 255 268 324 295],592,4,6989,2.7712133227597144,0.0,20.0
10522,2,2522,[201 261 264 255 212],1,1,6990,2.7705112960761,0.0,0.0
10523,2,2523,[246 243 211 268 291],682,3,6993,2.7706022187004753,0.0,20.0
10524,2,2524,[390 230 216 583 283],303,1,6994,2.7699009900990097,0.0,20.0
10525,2,2525,[413 290 241 315 508],276,4,6998,2.770387965162312,20.0,0.0
10526,2,2526,[227 222 202 201 232],303,3,7001,2.7704788286505737,0.0,20.0
10527,2,2527,[293 221 298 209 301],758,2,7003,2.7701740506329116,0.0,20.0
10528,2,2528,[232 230 326 219 202],178,5,7008,2.771055753262159,0.0,0.0
10529,2,2529,[209 216 218 240 255],303,4,7012,2.7715415019762846,0.0,20.0
10530,2,2530,[293 284 217 275 283],919,4,7016,2.772026866851047,0.0,0.0
10531,2,2531,[223 240 429 255 208],293,2,7018,2.7717219589257502,20.0,0.0
10532,2,2532,[290 276 261 206 508],130,3,7021,2.771812080536913,0.0,0.0
10533,2,2533,[507 209 250 236 321],303,4,7025,2.772296764009471,0.0,0.0
10534,2,2534,[267 218 243 250 208],1,3,7028,2.7723865877712033,0.0,0.0
10535,2,2535,[227 222 365 239 326],222,4,7032,2.772870662460568,0.0,20.0
10536,2,2536,[264 297 283 378 209],299,0,7032,2.771777690185258,0.0,0.0
10537,2,2537,[303 246 222 272 301],592,3,7035,2.771867612293144,20.0,20.0
10538,2,2538,[222 264 218 209 324],327,1,7036,2.7711697518708154,0.0,20.0
10539,2,2539,[392 272 293 284 217],130,3,7039,2.771259842519685,20.0,0.0
10540,2,2540,[367 219 208 509 227],868,0,7039,2.7701692247146794,0.0,0.0
10541,2,2541,[254 231 232 276 227],880,2,7041,2.7698662470495674,0.0,0.0
10542,2,2542,[226 215 420 272 301],532,5,7046,2.7707432166732207,20.0,0.0
10543,2,2543,[202 217 290 303 240],293,1,7047,2.770047169811321,0.0,0.0
10544,2,2544,[226 259 217 250 231],682,2,7049,2.7697445972495087,0.0,0.0
10545,2,2545,[216 290 291 420 218],682,1,7050,2.7690494893951296,0.0,20.0
10546,2,2546,[298 284 275 326 295],178,3,7053,2.7691401648998824,0.0,20.0
10547,2,2547,[212 231 315 202 390],286,2,7055,2.7688383045525904,20.0,0.0
10548,2,2548,[219 275 384 227 201],727,2,7057,2.7685366810513927,0.0,0.0
10549,2,2549,[231 276 201 208 300],303,4,7061,2.7690196078431373,0.0,20.0
10550,2,2550,[429 293 324 227 231],425,3,7064,2.769110152881223,0.0,0.0
10551,2,2551,[316 509 230 217 303],758,4,7068,2.769592476489028,20.0,0.0
10552,2,2552,[221 209 241 246 240],303,4,7072,2.770074422248335,0.0,0.0
10553,2,2553,[264 219 241 300 291],429,2,7074,2.769772905246672,0.0,20.0
10554,2,2554,[268 216 226 420 259],303,4,7078,2.7702544031311156,0.0,40.0
10555,2,2555,[485 250 209 216 431],790,2,7080,2.7699530516431925,0.0,20.0
10556,2,2556,[321 239 303 243 378],393,4,7084,2.770434102463825,0.0,0.0
10557,2,2557,[227 264 331 209 230],276,4,7088,2.7709147771696636,0.0,0.0
10558,2,2558,[367 240 324 236 218],291,4,7092,2.771395076201641,0.0,0.0
10559,2,2559,[303 420 250 367 218],276,4,7096,2.771875,0.0,0.0
10560,2,2560,[217 276 202 246 215],682,4,7100,2.7723545490042953,0.0,0.0
10561,2,2561,[367 303 250 284 218],293,1,7101,2.771662763466042,0.0,0.0
10562,2,2562,[275 220 280 301 256],181,2,7103,2.771361685524776,0.0,0.0
10563,2,2563,[212 291 241 239 221],758,2,7105,2.7710608424336973,0.0,0.0
10564,2,2564,[259 209 250 508 268],178,3,7108,2.771150097465887,0.0,20.0
10565,2,2565,[221 261 236 293 508],919,4,7112,2.7716289945440375,0.0,0.0
10566,2,2566,[280 209 223 284 239],682,1,7113,2.7709388391118037,20.0,0.0
10567,2,2567,[219 231 300 481 478],896,2,7115,2.7706386292834893,20.0,20.0
10568,2,2568,[254 272 223 226 212],1,2,7117,2.7703386531724408,40.0,0.0
10569,2,2569,[218 316 217 321 202],130,4,7121,2.770817120622568,20.0,0.0
10570,2,2570,[246 215 284 268 485],790,3,7124,2.7709062621548037,0.0,20.0
10571,2,2571,[452 298 250 583 300],276,3,7127,2.77099533437014,0.0,40.0
10572,2,2572,[251 367 255 324 226],303,4,7131,2.77147298872911,0.0,0.0
10573,2,2573,[284 508 241 378 247],222,0,7131,2.7703962703962706,0.0,0.0
10574,2,2574,[202 239 508 272 299],880,5,7136,2.77126213592233,20.0,0.0
10575,2,2575,[272 264 222 255 213],1,1,7137,2.7705745341614905,20.0,20.0
10576,2,2576,[291 264 232 509 202],293,0,7137,2.769499417927823,0.0,0.0
10577,2,2577,[365 222 241 290 217],429,1,7138,2.7688130333591934,0.0,20.0
10578,2,2578,[202 255 300 508 378],222,2,7140,2.7685149282667703,0.0,20.0
10579,2,2579,[209 300 378 431 301],429,2,7142,2.768217054263566,0.0,20.0
10580,2,2580,[241 236 255 251 220],1,3,7145,2.7683068578070515,0.0,0.0
10581,2,2581,[218 293 222 431 301],276,4,7149,2.768783888458559,0.0,20.0
10582,2,2582,[508 209 217 268 215],222,3,7152,2.7688734030197444,0.0,20.0
10583,2,2583,[293 232 227 250 300],880,2,7154,2.768575851393189,0.0,20.0
10584,2,2584,[236 213 212 255 202],1,3,7157,2.7686653771760157,0.0,0.0
10585,2,2585,[365 240 300 301 315],276,4,7161,2.769141531322506,20.0,20.0
10586,2,2586,[315 202 326 508 336],592,4,7165,2.769617317356011,20.0,0.0
10587,2,2587,[201 230 202 255 243],1,2,7167,2.769319938176198,0.0,0.0
10588,2,2588,[276 280 227 290 219],429,2,7169,2.769022788721514,0.0,0.0
10589,2,2589,[226 208 268 413 209],727,2,7171,2.768725868725869,0.0,20.0
10590,2,2590,[272 202 209 384 431],682,3,7174,2.768815129293709,20.0,0.0
10591,2,2591,[201 231 293 219 227],429,2,7176,2.7685185185185186,0.0,0.0
10592,2,2592,[222 216 230 239 244],407,4,7180,2.768993443887389,0.0,40.0
10593,2,2593,[240 209 324 231 276],758,2,7182,2.7686969930609098,0.0,0.0
10594,2,2594,[239 201 275 272 508],201,3,7185,2.76878612716763,20.0,0.0
10595,2,2595,[378 291 231 300 259],682,0,7185,2.7677195685670264,0.0,20.0
10596,2,2596,[303 201 255 215 259],592,4,7189,2.7681940700808627,0.0,0.0
10597,2,2597,[219 239 231 429 315],276,4,7193,2.7686682063125483,20.0,0.0
10598,2,2598,[241 227 219 215 481],301,3,7196,2.7687572143131973,0.0,0.0
10599,2,2599,[209 250 241 303 291],276,4,7200,2.769230769230769,0.0,0.0
10600,2,2600,[243 215 216 246 236],130,4,7204,2.7697039600153786,0.0,20.0
10601,2,2601,[481 276 264 231 301],429,1,7205,2.7690238278247503,0.0,0.0
10602,2,2602,[217 420 267 284 230],130,2,7207,2.768728390318863,0.0,0.0
10603,2,2603,[315 324 209 202 508],276,5,7212,2.769585253456221,20.0,0.0
10604,2,2604,[264 298 201 365 431],429,2,7214,2.769289827255278,0.0,20.0
10605,2,2605,[321 236 202 508 218],303,4,7218,2.7697620874904065,0.0,0.0
10606,2,2606,[219 239 211 326 509],201,1,7219,2.769083237437668,0.0,0.0
10607,2,2607,[208 315 216 230 291],407,5,7224,2.7699386503067487,20.0,20.0
10608,2,2608,[264 429 230 336 232],363,2,7226,2.769643541586815,0.0,0.0
10609,2,2609,[272 227 216 276 218],130,4,7230,2.7701149425287355,20.0,20.0
10610,2,2610,[227 583 367 239 202],293,0,7230,2.76905400229797,0.0,0.0
10611,2,2611,[298 272 216 243 254],682,3,7233,2.7691424196018377,20.0,40.0
10612,2,2612,[478 240 243 219 211],561,2,7235,2.7688480673555302,20.0,0.0
10613,2,2613,[299 261 251 221 336],181,0,7235,2.76778882938026,0.0,0.0
10614,2,2614,[276 219 267 321 298],130,5,7240,2.768642447418738,0.0,20.0
10615,2,2615,[290 298 206 222 259],393,3,7243,2.768730886850153,0.0,40.0
10616,2,2616,[290 226 392 367 321],130,4,7247,2.76920137562094,0.0,0.0
10617,2,2617,[226 250 217 232 290],268,2,7249,2.76890756302521,0.0,0.0
10618,2,2618,[390 259 240 223 209],303,2,7251,2.7686139747995417,20.0,0.0
10619,2,2619,[315 326 331 222 392],130,4,7255,2.769083969465649,20.0,20.0
10620,2,2620,[222 223 283 284 230],178,5,7260,2.7699351392598244,20.0,20.0
10621,2,2621,[213 452 239 481 350],758,3,7263,2.7700228832951943,0.0,0.0
10622,2,2622,[303 223 219 431 324],201,3,7266,2.7701105604269918,20.0,0.0
10623,2,2623,[420 293 316 232 300],293,2,7268,2.769817073170732,20.0,20.0
10624,2,2624,[276 272 293 331 219],130,4,7272,2.7702857142857145,20.0,0.0
10625,2,2625,[507 202 215 232 222],561,1,7273,2.7696115765422697,0.0,20.0
10626,2,2626,[261 208 452 293 326],222,1,7274,2.7689379520365436,0.0,0.0
10627,2,2627,[201 230 293 208 243],880,3,7277,2.7690258751902586,0.0,0.0
10628,2,2628,[219 201 231 429 239],896,2,7279,2.7687333586915175,0.0,0.0
10629,2,2629,[300 216 293 250 226],222,2,7281,2.7684410646387834,0.0,40.0
10630,2,2630,[293 291 297 223 216],592,4,7285,2.768909160015203,20.0,20.0
10631,2,2631,[326 241 240 431 201],201,1,7286,2.7682370820668694,0.0,0.0
10632,2,2632,[240 202 206 226 215],521,2,7288,2.7679453095328523,0.0,0.0
10633,2,2633,[255 208 209 293 227],293,1,7289,2.7672741078208047,0.0,0.0
10634,2,2634,[209 583 384 284 365],790,2,7291,2.7669829222011386,0.0,0.0
10635,2,2635,[336 293 243 392 275],514,2,7293,2.766691957511381,0.0,0.0
10636,2,2636,[298 239 509 280 217],682,2,7295,2.7664012135001896,0.0,20.0
10637,2,2637,[367 378 206 215 227],487,3,7298,2.7664897649734645,0.0,0.0
10638,2,2638,[244 230 250 315 478],407,4,7302,2.766957180750284,40.0,0.0
10639,2,2639,[261 299 276 298 291],592,2,7304,2.7666666666666666,0.0,20.0
10640,2,2640,[201 206 413 230 254],435,2,7306,2.7663763725861417,0.0,0.0
10641,2,2641,[367 326 255 336 240],851,2,7308,2.766086298258895,0.0,0.0
10642,2,2642,[244 478 230 227 232],407,2,7310,2.76579644343549,20.0,0.0
10643,2,2643,[217 208 275 250 215],864,4,7314,2.7662632375189107,0.0,0.0
10644,2,2644,[222 420 239 250 243],393,4,7318,2.7667296786389413,0.0,20.0
10645,2,2645,[272 299 241 209 201],682,4,7322,2.767195767195767,20.0,0.0
10646,2,2646,[227 394 246 299 431],435,4,7326,2.7676615035889687,0.0,0.0
10647,2,2647,[216 240 367 275 290],286,3,7329,2.767749244712991,0.0,20.0
10648,2,2648,[209 211 583 255 378],870,1,7330,2.767081917704794,0.0,0.0
10649,2,2649,[275 478 250 316 331],178,5,7335,2.767924528301887,40.0,0.0
10650,2,2650,[276 206 218 231 392],276,3,7338,2.7680120709166354,0.0,0.0
10651,2,2651,[201 251 223 384 226],303,4,7342,2.768476621417798,20.0,0.0
10652,2,2652,[290 216 367 239 384],682,1,7343,2.767810026385224,0.0,20.0
10653,2,2653,[226 241 211 481 216],896,4,7347,2.76827430293896,0.0,20.0
10654,2,2654,[206 431 240 223 226],201,1,7348,2.767608286252354,20.0,0.0
10655,2,2655,[290 208 264 212 429],363,2,7350,2.7673192771084336,0.0,0.0
10656,2,2656,[231 250 217 303 291],758,3,7353,2.767406849830636,0.0,0.0
10657,2,2657,[413 324 331 240 232],276,3,7356,2.7674943566591423,0.0,0.0
10658,2,2658,[230 208 247 268 223],1,4,7360,2.767957878901843,20.0,20.0
10659,2,2659,[291 508 216 231 413],497,0,7360,2.7669172932330826,0.0,20.0
10660,2,2660,[219 276 227 223 202],303,4,7364,2.7673806839534008,20.0,0.0
10661,2,2661,[365 201 291 217 218],429,1,7365,2.76671675432006,0.0,0.0
10662,2,2662,[250 507 246 384 508],303,4,7369,2.767179872324446,0.0,0.0
10663,2,2663,[231 326 202 201 264],303,3,7372,2.7672672672672673,0.0,0.0
10664,2,2664,[227 230 226 208 321],429,1,7373,2.7666041275797375,0.0,0.0
10665,2,2665,[217 291 250 293 218],130,3,7376,2.7666916729182294,0.0,0.0
10666,2,2666,[298 254 246 280 315],880,3,7379,2.7667791526059244,20.0,20.0
10667,2,2667,[219 218 284 293 230],276,5,7384,2.767616191904048,0.0,0.0
10668,2,2668,[284 293 251 413 241],303,4,7388,2.7680779318096667,0.0,0.0
10669,2,2669,[295 293 283 336 222],592,3,7391,2.7681647940074905,0.0,20.0
10670,2,2670,[218 268 261 293 300],222,3,7394,2.7682515911643577,0.0,40.0
10671,2,2671,[208 211 239 509 365],846,3,7397,2.7683383233532934,0.0,0.0
10672,2,2672,[255 431 211 226 276],682,2,7399,2.7680508791619904,0.0,0.0
10673,2,2673,[246 293 315 290 219],130,4,7403,2.768511593118923,20.0,0.0
10674,2,2674,[316 209 255 250 583],293,0,7403,2.7674766355140186,20.0,0.0
10675,2,2675,[208 272 240 303 250],293,2,7405,2.767189835575486,20.0,0.0
10676,2,2676,[220 227 231 240 251],1,2,7407,2.766903249906612,0.0,0.0
10677,2,2677,[301 239 509 231 452],758,1,7408,2.7662434652725914,0.0,0.0
10678,2,2678,[316 227 215 239 211],660,2,7410,2.765957446808511,20.0,0.0
10679,2,2679,[508 209 431 216 202],94,3,7413,2.766044776119403,0.0,20.0
10680,2,2680,[268 413 420 240 392],276,3,7416,2.7661320402834764,0.0,20.0
10681,2,2681,[227 230 232 201 216],886,1,7417,2.765473527218494,0.0,20.0
10682,2,2682,[216 222 221 413 452],303,2,7419,2.7651882221393964,0.0,40.0
10683,2,2683,[300 367 267 295 284],532,4,7423,2.7656482861400895,0.0,20.0
10684,2,2684,[331 268 429 365 217],276,4,7427,2.7661080074487896,0.0,20.0
10685,2,2685,[367 254 219 202 255],682,1,7428,2.765450483991065,0.0,0.0
10686,2,2686,[232 315 295 230 246],880,4,7432,2.7659099367324154,20.0,0.0
10687,2,2687,[315 254 232 276 365],276,2,7434,2.765625,20.0,0.0
10688,2,2688,[392 240 226 316 413],130,4,7438,2.766084046113797,20.0,0.0
10689,2,2689,[284 231 331 392 272],276,3,7441,2.766171003717472,20.0,0.0
10690,2,2690,[276 209 216 247 208],222,3,7444,2.766257896692679,0.0,20.0
10691,2,2691,[268 218 420 324 508],303,4,7448,2.7667161961367013,0.0,20.0
10692,2,2692,[301 303 283 268 236],592,3,7451,2.766802822131452,0.0,20.0
10693,2,2693,[209 208 241 293 211],758,3,7454,2.766889383815887,0.0,0.0
10694,2,2694,[239 216 215 250 284],303,4,7458,2.76734693877551,0.0,20.0
10695,2,2695,[508 316 267 222 254],130,4,7462,2.7678041543026706,20.0,20.0
10696,2,2696,[215 300 239 275 485],305,0,7462,2.7667779013718947,0.0,20.0
10697,2,2697,[299 295 384 201 202],880,4,7466,2.7672349888806522,0.0,0.0
10698,2,2698,[208 250 392 240 315],880,3,7469,2.7673212300852166,20.0,0.0
10699,2,2699,[209 390 250 202 365],94,3,7472,2.7674074074074073,0.0,0.0
10700,2,2700,[293 300 326 298 202],222,4,7476,2.767863754165124,0.0,40.0
10701,2,2701,[226 431 215 316 250],363,0,7476,2.766839378238342,20.0,0.0
10702,2,2702,[390 215 290 216 250],286,2,7478,2.766555678875324,0.0,20.0
10703,2,2703,[216 246 222 507 209],468,5,7483,2.7673816568047336,0.0,40.0
10704,2,2704,[583 230 250 429 231],276,3,7486,2.767467652495379,0.0,0.0
10705,2,2705,[240 208 217 384 209],886,1,7487,2.7668144863266813,0.0,0.0
10706,2,2706,[218 232 293 239 583],293,1,7488,2.7661618027336536,0.0,0.0
10707,2,2707,[223 220 293 295 316],178,3,7491,2.766248153618907,40.0,0.0
10708,2,2708,[209 215 508 264 452],276,3,7494,2.7663344407530452,0.0,0.0
10709,2,2709,[209 246 250 291 420],682,2,7496,2.766051660516605,0.0,0.0
10710,2,2710,[300 243 268 392 240],130,4,7500,2.766506824050166,0.0,40.0
10711,2,2711,[219 508 255 350 298],130,5,7505,2.767330383480826,0.0,20.0
10712,2,2712,[222 291 303 583 202],293,1,7506,2.7666789531883524,0.0,20.0
10713,2,2713,[507 413 222 227 264],303,1,7507,2.766028002947679,0.0,20.0
10714,2,2714,[583 202 276 226 246],276,4,7511,2.7664825046040518,0.0,0.0
10715,2,2715,[298 250 293 420 255],682,3,7514,2.7665684830633284,0.0,20.0
10716,2,2716,[206 315 378 298 291],393,4,7518,2.7670224512329775,20.0,20.0
10717,2,2717,[236 222 201 216 226],303,4,7522,2.76747608535688,0.0,40.0
10718,2,2718,[507 216 321 301 223],429,3,7525,2.76756160353071,20.0,20.0
10719,2,2719,[209 259 239 300 216],682,1,7526,2.7669117647058825,0.0,40.0
10720,2,2720,[344 452 241 223 250],758,2,7528,2.7666299154722527,20.0,0.0
10721,2,2721,[221 241 201 268 254],1,3,7531,2.7667156502571637,0.0,20.0
10722,2,2722,[508 222 255 230 227],303,2,7533,2.7664340800587586,0.0,20.0
10723,2,2723,[272 367 299 202 321],130,4,7537,2.7668869309838473,20.0,0.0
10724,2,2724,[243 230 239 392 301],660,0,7537,2.7658715596330277,0.0,0.0
10725,2,2725,[300 297 208 239 350],758,3,7540,2.765957446808511,0.0,20.0
10726,2,2726,[222 215 297 223 420],293,4,7544,2.7664099743307666,20.0,20.0
10727,2,2727,[218 290 241 212 231],758,3,7547,2.7664956011730206,0.0,0.0
10728,2,2728,[384 298 239 202 431],682,3,7550,2.766581165262001,0.0,20.0
10729,2,2729,[236 221 298 297 212],758,4,7554,2.767032967032967,0.0,20.0
10730,2,2730,[264 378 275 227 241],429,1,7555,2.7663859392164043,0.0,0.0
10731,2,2731,[209 300 431 276 240],758,1,7556,2.765739385065886,0.0,20.0
10732,2,2732,[583 365 230 217 240],276,3,7559,2.765825100622027,0.0,0.0
10733,2,2733,[230 216 241 223 218],201,3,7562,2.7659107534747625,20.0,20.0
10734,2,2734,[254 230 231 223 246],276,3,7565,2.76599634369287,20.0,0.0
10735,2,2735,[222 239 244 217 223],916,3,7568,2.7660818713450293,20.0,20.0
10736,2,2736,[261 276 300 284 392],130,4,7572,2.7665327000365365,0.0,20.0
10737,2,2737,[508 303 298 367 215],276,4,7576,2.7669831994156318,0.0,20.0
10738,2,2738,[230 217 275 509 208],293,0,7576,2.7659729828404527,0.0,0.0
10739,2,2739,[276 222 303 219 218],276,5,7581,2.7667883211678834,0.0,20.0
10740,2,2740,[217 202 215 240 300],301,4,7585,2.7672382342210873,0.0,20.0
10741,2,2741,[240 209 276 583 226],276,4,7589,2.7676878191101384,0.0,0.0
10742,2,2742,[246 367 240 315 217],276,4,7593,2.7681370761939483,20.0,0.0
10743,2,2743,[384 202 216 241 250],790,3,7596,2.7682215743440235,0.0,20.0
10744,2,2744,[365 301 298 209 300],880,2,7598,2.7679417122040073,0.0,40.0
10745,2,2745,[280 227 232 223 206],916,1,7599,2.7672978878368535,20.0,0.0
10746,2,2746,[276 241 217 293 280],222,1,7600,2.766654532216964,0.0,0.0
10747,2,2747,[202 217 241 431 239],586,3,7603,2.766739446870451,0.0,0.0
10748,2,2748,[280 232 256 212 246],916,2,7605,2.766460531102219,0.0,0.0
10749,2,2749,[268 209 276 431 221],916,3,7608,2.7665454545454544,0.0,20.0
10750,2,2750,[452 301 231 297 202],758,2,7610,2.7662668120683387,0.0,0.0
10751,2,2751,[507 246 227 290 255],303,4,7614,2.76671511627907,0.0,0.0
10752,2,2752,[218 300 280 247 508],222,2,7616,2.766436614602252,0.0,20.0
10753,2,2753,[268 384 367 227 201],886,2,7618,2.766158315177923,0.0,20.0
10754,2,2754,[220 246 216 231 247],1,2,7620,2.765880217785844,0.0,20.0
10755,2,2755,[201 240 241 231 232],682,3,7623,2.765965166908563,0.0,0.0
10756,2,2756,[485 283 227 365 215],393,2,7625,2.765687341313021,0.0,0.0
10757,2,2757,[219 241 283 293 216],303,4,7629,2.7661348803480785,0.0,20.0
10758,2,2758,[297 230 208 221 276],758,3,7632,2.76621964479884,0.0,0.0
10759,2,2759,[583 208 227 226 202],94,1,7633,2.7655797101449275,0.0,0.0
10760,2,2760,[202 218 222 275 280],178,4,7637,2.766026801883376,0.0,20.0
10761,2,2761,[290 298 272 232 509],293,2,7639,2.765749456915279,20.0,20.0
10762,2,2762,[212 276 241 206 217],561,1,7640,2.7651103872602243,0.0,0.0
10763,2,2763,[295 508 297 250 202],919,2,7642,2.7648335745296673,0.0,0.0
10764,2,2764,[219 223 250 316 255],407,5,7647,2.7656419529837253,40.0,0.0
10765,2,2765,[508 254 201 246 315],276,4,7651,2.7660882140274765,20.0,0.0
10766,2,2766,[215 264 293 206 290],293,3,7654,2.7661727502710516,0.0,0.0
10767,2,2767,[259 365 209 290 420],682,0,7654,2.7651734104046244,0.0,0.0
10768,2,2768,[230 316 295 202 326],130,3,7657,2.7652582159624415,20.0,0.0
10769,2,2769,[259 300 276 384 209],303,2,7659,2.764981949458484,0.0,20.0
10770,2,2770,[284 268 246 240 303],276,5,7664,2.7657885239985567,0.0,20.0
10771,2,2771,[226 212 201 217 223],896,1,7665,2.765151515151515,20.0,0.0
10772,2,2772,[230 508 222 300 268],303,2,7667,2.7648755860079337,0.0,60.0
10773,2,2773,[378 215 272 209 384],682,2,7669,2.764599855803893,20.0,0.0
10774,2,2774,[431 208 239 336 367],514,4,7673,2.7650450450450452,0.0,0.0
10775,2,2775,[216 230 211 251 215],1,3,7676,2.7651296829971184,0.0,20.0
10776,2,2776,[250 293 284 295 246],130,2,7678,2.764854159164566,0.0,0.0
10777,2,2777,[246 293 280 250 226],880,3,7681,2.7649388048956083,0.0,0.0
10778,2,2778,[259 297 264 272 431],592,2,7683,2.764663548038863,20.0,0.0
10779,2,2779,[239 331 276 230 431],201,2,7685,2.764388489208633,0.0,0.0
10780,2,2780,[452 326 201 232 508],201,2,7687,2.764113628191298,0.0,0.0
10781,2,2781,[222 201 420 384 215],435,2,7689,2.7638389647735444,0.0,20.0
10782,2,2782,[378 218 226 365 219],429,1,7690,2.763205174272368,0.0,0.0
10783,2,2783,[264 367 481 240 239],299,1,7691,2.7625718390804597,0.0,0.0
10784,2,2784,[384 222 211 226 219],268,3,7694,2.762657091561939,0.0,20.0
10785,2,2785,[222 367 280 508 394],880,3,7697,2.7627422828427854,0.0,20.0
10786,2,2786,[283 303 221 272 336],592,4,7701,2.7631862217438106,20.0,0.0
10787,2,2787,[298 293 272 230 316],758,4,7705,2.763629842180775,40.0,20.0
10788,2,2788,[316 255 326 291 276],130,5,7710,2.764431695948369,20.0,0.0
10789,2,2789,[254 291 219 250 217],130,2,7712,2.76415770609319,0.0,0.0
10790,2,2790,[429 218 223 420 272],276,5,7717,2.7649587961304194,40.0,0.0
10791,2,2791,[241 232 231 452 509],846,2,7719,2.7646848137535818,0.0,0.0
10792,2,2792,[295 326 215 293 219],130,4,7723,2.765127103472968,0.0,0.0
10793,2,2793,[254 284 315 227 321],130,2,7725,2.7648532569792414,20.0,0.0
10794,2,2794,[315 326 206 452 431],201,0,7725,2.76386404293381,20.0,0.0
10795,2,2795,[316 216 300 315 226],532,4,7729,2.7643061516452074,40.0,40.0
10796,2,2796,[268 303 301 275 300],919,3,7732,2.764390418305327,0.0,40.0
10797,2,2797,[298 216 326 276 232],303,4,7736,2.764832022873481,0.0,40.0
10798,2,2798,[232 213 295 244 246],916,3,7739,2.7649160414433727,0.0,0.0
10799,2,2799,[250 272 259 261 206],1,2,7741,2.764642857142857,20.0,0.0
10800,2,2800,[267 208 218 240 217],268,1,7742,2.7640128525526597,0.0,0.0
10801,2,2801,[239 240 241 222 226],1,3,7745,2.764097073518915,0.0,20.0
10802,2,2802,[365 209 230 293 239],276,4,7749,2.7645379950053512,0.0,0.0
10803,2,2803,[201 509 299 250 583],682,3,7752,2.7646219686162623,0.0,0.0
10804,2,2804,[239 298 284 324 216],347,2,7754,2.764349376114082,0.0,40.0
10805,2,2805,[222 268 509 420 241],94,4,7758,2.7647897362794014,0.0,40.0
10806,2,2806,[367 218 221 217 431],916,2,7760,2.7645172782329888,0.0,0.0
10807,2,2807,[232 209 272 298 390],286,4,7764,2.764957264957265,20.0,20.0
10808,2,2808,[202 219 508 321 230],201,2,7766,2.764684941260235,0.0,0.0
10809,2,2809,[508 276 583 378 223],429,3,7769,2.7647686832740215,20.0,0.0
10810,2,2810,[231 227 219 298 284],222,2,7771,2.7644966204197794,0.0,20.0
10811,2,2811,[230 331 452 255 250],130,2,7773,2.7642247510668563,0.0,0.0
10812,2,2812,[298 315 243 217 367],130,3,7776,2.7643085673658017,20.0,20.0
10813,2,2813,[316 227 315 300 208],758,4,7780,2.7647476901208243,40.0,20.0
10814,2,2814,[315 222 208 216 485],293,1,7781,2.7641207815275313,20.0,40.0
10815,2,2815,[250 452 303 290 230],758,4,7785,2.764559659090909,0.0,0.0
10816,2,2816,[583 230 240 219 267],268,1,7786,2.763933262335818,0.0,0.0
10817,2,2817,[206 201 232 226 218],268,1,7787,2.7633073101490417,0.0,0.0
10818,2,2818,[324 291 295 336 272],592,3,7790,2.7633912735012416,20.0,0.0
10819,2,2819,[222 264 239 215 227],435,2,7792,2.7631205673758865,0.0,20.0
10820,2,2820,[268 223 230 431 232],561,1,7793,2.7624955689471817,20.0,20.0
10821,2,2821,[223 208 232 283 280],293,1,7794,2.761871013465627,20.0,0.0
10822,2,2822,[216 413 226 431 394],435,2,7796,2.761601133545873,0.0,20.0
10823,2,2823,[250 272 208 239 254],880,3,7799,2.7616855524079322,20.0,0.0
10824,2,2824,[222 508 226 365 227],94,1,7800,2.7610619469026547,0.0,20.0
10825,2,2825,[218 215 509 508 392],94,3,7803,2.761146496815287,0.0,0.0
10826,2,2826,[290 264 431 227 384],363,1,7804,2.7605235231694376,0.0,0.0
10827,2,2827,[201 276 230 217 284],880,4,7808,2.760961810466761,0.0,0.0
10828,2,2828,[290 297 211 291 216],758,5,7813,2.76175326970661,0.0,20.0
10829,2,2829,[217 300 202 226 255],327,1,7814,2.76113074204947,0.0,20.0
10830,2,2830,[227 202 276 508 209],429,4,7818,2.761568350406217,0.0,0.0
10831,2,2831,[413 367 216 255 240],222,1,7819,2.760946327683616,0.0,20.0
10832,2,2832,[218 208 230 378 217],545,3,7822,2.761030709495235,0.0,0.0
10833,2,2833,[392 429 206 291 250],276,3,7825,2.7611150317572335,0.0,0.0
10834,2,2834,[255 240 290 226 218],130,4,7829,2.761552028218695,0.0,0.0
10835,2,2835,[367 259 222 303 321],393,3,7832,2.76163610719323,0.0,20.0
10836,2,2836,[239 208 344 272 211],758,3,7835,2.7617201268946068,20.0,0.0
10837,2,2837,[236 300 231 384 298],758,3,7838,2.7618040873854826,0.0,40.0
10838,2,2838,[378 452 367 218 209],868,1,7839,2.7611835153222968,0.0,0.0
10839,2,2839,[230 392 222 295 232],880,3,7842,2.761267605633803,0.0,20.0
10840,2,2840,[275 215 202 315 226],201,1,7843,2.760647659274903,20.0,0.0
10841,2,2841,[218 321 202 315 232],201,1,7844,2.7600281491907106,20.0,0.0
10842,2,2842,[392 240 420 201 268],276,4,7848,2.7604642982764687,0.0,20.0
10843,2,2843,[300 222 284 291 431],276,3,7851,2.7605485232067513,0.0,40.0
10844,2,2844,[246 240 250 219 201],1,2,7853,2.760281195079086,0.0,0.0
10845,2,2845,[208 226 268 297 303],889,2,7855,2.760014054813774,0.0,20.0
10846,2,2846,[216 223 231 209 509],201,2,7857,2.7597471022128555,20.0,20.0
10847,2,2847,[508 201 301 321 268],919,2,7859,2.7594803370786516,0.0,20.0
10848,2,2848,[213 209 230 384 211],790,2,7861,2.7592137592137593,0.0,0.0
10849,2,2849,[276 264 239 315 206],276,4,7865,2.7596491228070175,20.0,0.0
10850,2,2850,[293 390 218 413 290],303,3,7868,2.759733426867766,0.0,0.0
10851,2,2851,[215 230 227 331 392],435,2,7870,2.759467040673212,0.0,0.0
10852,2,2852,[301 420 367 298 299],621,3,7873,2.759551349456712,0.0,20.0
10853,2,2853,[251 268 301 231 272],286,4,7877,2.7599859845830412,20.0,20.0
10854,2,2854,[212 244 218 241 236],916,4,7881,2.7604203152364275,0.0,0.0
10855,2,2855,[413 384 367 284 211],435,1,7882,2.7598039215686274,0.0,0.0
10856,2,2856,[259 216 223 244 219],1,2,7884,2.759537976898845,20.0,20.0
10857,2,2857,[452 413 508 321 246],303,2,7886,2.7592722183344995,0.0,0.0
10858,2,2858,[284 350 230 367 293],332,5,7891,2.760055963623645,0.0,0.0
10859,2,2859,[280 241 299 298 255],682,3,7894,2.7601398601398603,0.0,20.0
10860,2,2860,[367 431 280 216 298],222,3,7897,2.7602236980076897,0.0,40.0
10861,2,2861,[250 246 206 232 241],276,4,7901,2.7606568832983926,0.0,0.0
10862,2,2862,[255 485 215 300 367],293,1,7902,2.760041914076144,0.0,20.0
10863,2,2863,[215 291 392 250 226],276,3,7905,2.7601256983240225,0.0,0.0
10864,2,2864,[280 226 298 295 250],880,3,7908,2.7602094240837696,0.0,20.0
10865,2,2865,[365 378 241 202 261],222,2,7910,2.759944173063503,0.0,0.0
10866,2,2866,[300 221 201 255 240],919,4,7914,2.7603767003836763,0.0,20.0
10867,2,2867,[221 223 206 280 213],916,3,7917,2.760460251046025,20.0,0.0
10868,2,2868,[429 215 211 250 227],660,3,7920,2.7605437434646216,0.0,0.0
10869,2,2869,[208 236 316 303 315],758,5,7925,2.7613240418118465,40.0,0.0
10870,2,2870,[239 284 227 231 259],268,2,7927,2.7610588645071403,0.0,0.0
10871,2,2871,[299 321 250 226 392],435,3,7930,2.761142061281337,0.0,0.0
10872,2,2872,[223 201 250 301 239],363,1,7931,2.7605290636964845,20.0,0.0
10873,2,2873,[283 284 509 315 211],293,1,7932,2.759916492693111,20.0,0.0
10874,2,2874,[315 298 452 300 226],276,4,7936,2.7603478260869565,20.0,40.0
10875,2,2875,[216 298 321 276 350],130,5,7941,2.761126564673157,0.0,40.0
10876,2,2876,[452 216 315 231 218],758,3,7944,2.761209593326382,20.0,20.0
10877,2,2877,[367 261 246 226 241],222,1,7945,2.760597637248089,0.0,0.0
10878,2,2878,[236 267 293 261 215],130,5,7950,2.7613754775963875,0.0,0.0
10879,2,2879,[218 259 239 264 390],303,1,7951,2.760763888888889,0.0,0.0
10880,2,2880,[303 291 232 331 272],276,3,7954,2.760846928149948,20.0,0.0
10881,2,2881,[246 230 239 223 201],268,1,7955,2.760235947258848,20.0,0.0
10882,2,2882,[230 231 218 291 259],303,2,7957,2.759972251127298,0.0,0.0
10883,2,2883,[507 291 208 583 218],429,3,7960,2.7600554785020806,0.0,0.0
10884,2,2884,[201 284 217 232 429],276,4,7964,2.760485268630849,0.0,0.0
10885,2,2885,[251 208 303 315 298],293,3,7967,2.7605682605682604,20.0,20.0
10886,2,2886,[365 227 211 284 300],551,5,7972,2.7613439556633184,0.0,20.0
10887,2,2887,[276 326 321 209 324],303,2,7974,2.761080332409972,0.0,0.0
10888,2,2888,[268 241 246 230 240],347,4,7978,2.761509172724126,0.0,20.0
10889,2,2889,[202 280 240 315 298],393,3,7981,2.76159169550173,20.0,20.0
10890,2,2890,[365 300 211 276 264],429,2,7983,2.7613282601176063,0.0,20.0
10891,2,2891,[241 583 298 452 209],276,3,7986,2.7614107883817427,0.0,20.0
10892,2,2892,[336 350 261 264 216],592,2,7988,2.7611475976494986,0.0,20.0
10893,2,2893,[232 276 240 243 583],682,1,7989,2.760539046302695,0.0,0.0
10894,2,2894,[221 246 236 247 250],1,4,7993,2.7609671848013817,0.0,0.0
10895,2,2895,[209 250 217 230 481],429,1,7994,2.7603591160220993,0.0,0.0
10896,2,2896,[268 295 298 250 230],532,4,7998,2.7607870210562653,0.0,40.0
10897,2,2897,[299 231 243 209 378],682,1,7999,2.7601794340924775,0.0,0.0
10898,2,2898,[219 280 202 255 240],222,2,8001,2.759917212832011,0.0,0.0
10899,2,2899,[246 255 452 367 583],303,3,8004,2.76,0.0,0.0
10900,2,2900,[206 324 250 223 239],276,5,8009,2.7607721475353326,20.0,0.0
10901,2,2901,[299 219 413 367 222],435,2,8011,2.7605099931082013,0.0,20.0
10902,2,2902,[201 583 216 284 211],682,4,8015,2.7609369617636927,0.0,20.0
10903,2,2903,[243 261 254 211 223],1,1,8016,2.760330578512397,20.0,0.0
10904,2,2904,[206 431 298 367 212],622,3,8019,2.7604130808950087,0.0,20.0
10905,2,2905,[240 295 259 293 236],919,3,8022,2.760495526496903,0.0,0.0
10906,2,2906,[232 219 206 227 420],276,4,8026,2.760921912624699,0.0,0.0
10907,2,2907,[367 261 326 236 298],130,5,8031,2.7616918844566714,0.0,20.0
10908,2,2908,[226 219 280 222 268],551,4,8035,2.7621175661739428,0.0,40.0
10909,2,2909,[255 301 291 236 326],592,2,8037,2.7618556701030927,0.0,0.0
10910,2,2910,[226 239 231 316 284],276,4,8041,2.762281003091721,20.0,0.0
10911,2,2911,[291 255 507 216 230],303,3,8044,2.7623626373626373,0.0,20.0
10912,2,2912,[254 222 209 216 227],806,2,8046,2.762100926879506,0.0,40.0
10913,2,2913,[429 583 209 232 315],293,1,8047,2.76149622512011,20.0,0.0
10914,2,2914,[321 239 227 268 384],303,1,8048,2.760891938250429,0.0,20.0
10915,2,2915,[230 231 299 326 227],130,1,8049,2.7602880658436213,0.0,0.0
10916,2,2916,[298 392 316 222 280],880,3,8052,2.760370243400754,20.0,40.0
10917,2,2917,[261 508 272 250 243],919,2,8054,2.76010966415353,20.0,0.0
10918,2,2918,[299 240 239 295 300],880,4,8058,2.760534429599178,0.0,20.0
10919,2,2919,[316 213 298 217 300],293,1,8059,2.759931506849315,20.0,40.0
10920,2,2920,[291 222 290 280 211],682,2,8061,2.7596713454296475,0.0,20.0
10921,2,2921,[230 202 232 206 208],868,1,8062,2.759069130732375,0.0,0.0
10922,2,2922,[268 208 226 231 211],727,3,8065,2.759151556619911,0.0,20.0
10923,2,2923,[209 378 208 230 291],727,2,8067,2.758891928864569,0.0,0.0
10924,2,2924,[226 232 268 236 259],303,4,8071,2.7593162393162394,0.0,20.0
10925,2,2925,[220 230 206 268 208],1,4,8075,2.75974025974026,0.0,20.0
10926,2,2926,[226 246 222 431 390],94,3,8078,2.7598223436966176,0.0,20.0
10927,2,2927,[240 232 367 299 246],682,3,8081,2.7599043715846996,0.0,0.0
10928,2,2928,[508 276 413 220 261],181,1,8082,2.7593035165585524,0.0,0.0
10929,2,2929,[300 236 222 211 218],758,4,8086,2.759726962457338,0.0,40.0
10930,2,2930,[232 230 202 268 246],916,2,8088,2.759467758444217,0.0,20.0
10931,2,2931,[507 239 202 259 232],303,3,8091,2.759549795361528,0.0,0.0
10932,2,2932,[293 276 223 508 236],919,5,8096,2.760313672008183,20.0,0.0
10933,2,2933,[367 413 232 211 431],727,2,8098,2.760054533060668,0.0,0.0
10934,2,2934,[243 300 324 264 218],21,2,8100,2.7597955706984667,0.0,20.0
10935,2,2935,[429 240 250 226 217],301,4,8104,2.760217983651226,0.0,0.0
10936,2,2936,[367 226 241 478 298],178,4,8108,2.760640108954716,20.0,20.0
10937,2,2937,[508 250 239 301 246],276,5,8113,2.7614023144996596,0.0,0.0
10938,2,2938,[321 507 293 283 209],303,3,8116,2.7614834977883636,0.0,0.0
10939,2,2939,[201 209 413 298 508],303,4,8120,2.761904761904762,0.0,20.0
10940,2,2940,[264 583 413 367 508],276,1,8121,2.7613056783407006,0.0,0.0
10941,2,2941,[298 290 259 217 216],682,3,8124,2.761386811692726,0.0,40.0
10942,2,2942,[219 272 300 276 298],682,2,8126,2.761128100577642,20.0,40.0
10943,2,2943,[236 290 316 431 331],758,4,8130,2.761548913043478,20.0,0.0
10944,2,2944,[217 284 219 331 216],435,3,8133,2.7616298811544993,0.0,20.0
10945,2,2945,[315 297 276 272 420],758,3,8136,2.7617107942973522,40.0,0.0
10946,2,2946,[240 208 303 297 344],758,3,8139,2.7617916525279944,0.0,0.0
10947,2,2947,[254 452 303 420 202],276,3,8142,2.7618724559023065,0.0,0.0
10948,2,2948,[291 255 508 303 324],592,4,8146,2.7622923024754154,0.0,0.0
10949,2,2949,[452 298 221 350 231],758,2,8148,2.7620338983050847,0.0,20.0
10950,2,2950,[223 250 246 275 276],919,3,8151,2.762114537444934,20.0,0.0
10951,2,2951,[239 230 280 217 240],880,3,8154,2.7621951219512195,0.0,0.0
10952,2,2952,[298 508 284 247 239],222,2,8156,2.761937013206908,0.0,20.0
10953,2,2953,[215 316 246 298 268],500,3,8159,2.7620176032498307,20.0,40.0
10954,2,2954,[272 215 316 276 508],276,5,8164,2.7627749576988156,40.0,0.0
10955,2,2955,[324 268 243 303 344],592,4,8168,2.76319350473613,0.0,20.0
10956,2,2956,[250 315 241 300 298],758,3,8171,2.7632735880960433,20.0,40.0
10957,2,2957,[222 485 365 420 507],393,1,8172,2.762677484787018,0.0,20.0
10958,2,2958,[324 283 268 291 240],181,0,8172,2.7617438323758026,0.0,20.0
10959,2,2959,[230 240 367 272 231],880,3,8175,2.761824324324324,20.0,0.0
10960,2,2960,[241 202 215 239 218],933,0,8175,2.7608915906788245,0.0,0.0
10961,2,2961,[219 208 291 209 240],303,3,8178,2.760972316002701,0.0,0.0
10962,2,2962,[240 227 230 206 219],435,3,8181,2.7610529868376643,0.0,0.0
10963,2,2963,[431 216 256 583 211],916,3,8184,2.7611336032388665,0.0,20.0
10964,2,2964,[226 217 509 276 259],682,1,8185,2.7605396290050592,0.0,0.0
10965,2,2965,[298 261 367 259 264],919,2,8187,2.7602832097100474,0.0,20.0
10966,2,2966,[251 267 223 250 215],1,4,8191,2.760701044826424,20.0,0.0
10967,2,2967,[239 231 420 240 255],472,4,8195,2.7611185983827493,0.0,0.0
10968,2,2968,[230 365 509 268 202],846,3,8198,2.7611990569215226,0.0,20.0
10969,2,2969,[290 301 239 230 303],276,5,8203,2.761952861952862,0.0,0.0
10970,2,2970,[226 209 246 216 264],1,3,8206,2.7620329855267585,0.0,20.0
10971,2,2971,[284 431 392 241 300],276,3,8209,2.762113055181696,0.0,20.0
10972,2,2972,[215 211 268 221 331],201,2,8211,2.761856710393542,0.0,20.0
10973,2,2973,[384 241 215 508 275],896,3,8214,2.761936785474109,0.0,0.0
10974,2,2974,[431 324 218 201 216],201,4,8218,2.7623529411764705,0.0,20.0
10975,2,2975,[239 206 211 431 481],896,3,8221,2.7624327956989245,0.0,0.0
10976,2,2976,[222 324 226 202 239],521,3,8224,2.762512596573732,0.0,20.0
10977,2,2977,[232 211 201 227 226],407,2,8226,2.7622565480188044,0.0,0.0
10978,2,2978,[202 509 384 218 223],758,5,8231,2.763007720711648,20.0,0.0
10979,2,2979,[211 290 209 226 202],407,3,8234,2.763087248322148,0.0,0.0
10980,2,2980,[212 230 301 250 316],758,4,8238,2.76350218047635,20.0,0.0
10981,2,2981,[246 218 209 243 217],1,2,8240,2.7632461435278337,0.0,0.0
10982,2,2982,[336 478 583 222 232],327,2,8242,2.7629902782433793,20.0,20.0
10983,2,2983,[250 216 219 295 230],916,2,8244,2.7627345844504023,0.0,20.0
10984,2,2984,[241 211 275 303 378],299,2,8246,2.7624790619765496,0.0,0.0
10985,2,2985,[509 230 392 208 217],94,3,8249,2.762558606831882,0.0,0.0
10986,2,2986,[275 219 509 212 315],201,3,8252,2.762638098426515,20.0,0.0
10987,2,2987,[276 367 298 392 226],487,2,8254,2.7623828647925035,0.0,20.0
10988,2,2988,[431 298 284 276 218],682,3,8257,2.762462361993978,0.0,20.0
10989,2,2989,[230 344 367 321 300],327,3,8260,2.762541806020067,0.0,20.0
10990,2,2990,[259 227 264 326 246],303,1,8261,2.7619525242393848,0.0,0.0
10991,2,2991,[298 240 291 246 209],303,3,8264,2.7620320855614975,0.0,20.0
10992,2,2992,[452 284 255 280 239],222,1,8265,2.761443367858336,0.0,0.0
10993,2,2993,[208 290 324 298 300],347,2,8267,2.761189044756179,0.0,40.0
10994,2,2994,[295 298 216 244 255],178,2,8269,2.76093489148581,0.0,40.0
10995,2,2995,[217 201 202 241 227],429,1,8270,2.760347129506008,0.0,0.0
10996,2,2996,[208 250 367 240 452],497,2,8272,2.7600934267600934,0.0,0.0
10997,2,2997,[227 254 413 261 284],130,1,8273,2.7595063375583724,0.0,0.0
10998,2,2998,[216 478 217 392 239],846,4,8277,2.7599199733244415,20.0,20.0
10999,2,2999,[221 276 211 240 301],758,1,8278,2.759333333333333,0.0,0.0
11000,2,3000,[507 290 298 509 208],293,2,8280,2.7590803065644787,0.0,20.0
11001,2,3001,[583 268 231 508 201],201,3,8283,2.7591605596269155,0.0,20.0
11002,2,3002,[367 227 268 202 216],222,3,8286,2.7592407592407593,0.0,40.0
11003,2,3003,[300 298 216 202 215],303,4,8290,2.7596537949400797,0.0,60.0
11004,2,3004,[250 240 316 315 202],286,4,8294,2.7600665557404325,40.0,0.0
11005,2,3005,[420 218 268 246 216],130,5,8299,2.760811709913506,0.0,40.0
11006,2,3006,[481 367 275 212 215],896,4,8303,2.761223811107416,0.0,0.0
11007,2,3007,[231 509 216 583 217],682,2,8305,2.760970744680851,0.0,20.0
11008,2,3008,[392 300 272 384 232],276,2,8307,2.760717846460618,20.0,20.0
11009,2,3009,[264 218 222 507 201],429,2,8309,2.76046511627907,0.0,20.0
11010,2,3010,[431 219 230 216 301],327,2,8311,2.760212553968781,0.0,20.0
11011,2,3011,[218 201 208 240 217],495,4,8315,2.76062416998672,0.0,0.0
11012,2,3012,[261 223 216 243 230],1,3,8318,2.7607036176568203,20.0,20.0
11013,2,3013,[254 300 367 315 284],880,3,8321,2.7607830126078303,20.0,20.0
11014,2,3014,[275 218 298 283 303],293,2,8323,2.760530679933665,0.0,20.0
11015,2,3015,[264 291 268 240 413],435,2,8325,2.7602785145888595,0.0,20.0
11016,2,3016,[293 223 316 431 246],178,5,8330,2.7610208816705337,40.0,0.0
11017,2,3017,[276 211 583 291 201],682,2,8332,2.7607687210072895,0.0,0.0
11018,2,3018,[227 272 209 301 452],276,4,8336,2.7611791984100695,20.0,0.0
11019,2,3019,[507 280 222 392 227],429,2,8338,2.7609271523178807,0.0,20.0
11020,2,3020,[384 226 232 217 230],551,3,8341,2.761006289308176,0.0,0.0
11021,2,3021,[221 223 230 202 275],201,2,8343,2.7607544672402384,20.0,0.0
11022,2,3022,[509 293 420 315 209],293,2,8345,2.760502811776381,20.0,0.0
11023,2,3023,[293 452 222 232 231],425,2,8347,2.760251322751323,0.0,20.0
11024,2,3024,[250 236 209 267 268],1,5,8352,2.76099173553719,0.0,20.0
11025,2,3025,[202 321 299 413 250],435,3,8355,2.7610707204230005,0.0,0.0
11026,2,3026,[508 420 246 231 291],291,4,8359,2.7614800132144035,0.0,0.0
11027,2,3027,[246 232 365 231 367],276,1,8360,2.760898282694848,0.0,0.0
11028,2,3028,[331 276 244 232 300],178,3,8363,2.760977220204688,0.0,20.0
11029,2,3029,[367 295 394 272 217],880,4,8367,2.761386138613861,20.0,0.0
11030,2,3030,[420 365 246 222 219],94,3,8370,2.7614648630814913,0.0,20.0
11031,2,3031,[452 259 241 221 232],303,3,8373,2.761543535620053,0.0,0.0
11032,2,3032,[230 227 507 321 250],303,2,8375,2.7612924497197495,0.0,0.0
11033,2,3033,[300 291 508 230 209],303,2,8377,2.761041529334212,0.0,20.0
11034,2,3034,[208 276 241 230 268],303,4,8381,2.7614497528830313,0.0,20.0
11035,2,3035,[284 222 227 239 431],896,4,8385,2.7618577075098814,0.0,20.0
11036,2,3036,[208 220 276 222 216],244,3,8388,2.7619361211722095,0.0,40.0
11037,2,3037,[220 268 280 202 255],178,4,8392,2.762343647136274,0.0,20.0
11038,2,3038,[202 218 272 291 240],682,3,8395,2.7624218492925303,20.0,0.0
11039,2,3039,[478 298 316 250 220],178,3,8398,2.7625,40.0,20.0
11040,2,3040,[230 272 218 259 227],487,2,8400,2.762249260111805,20.0,0.0
11041,2,3041,[223 384 316 303 301],758,4,8404,2.762656147271532,40.0,0.0
11042,2,3042,[331 215 272 232 321],201,1,8405,2.7620768977982255,20.0,0.0
11043,2,3043,[226 216 298 215 218],130,5,8410,2.7628120893561103,0.0,40.0
11044,2,3044,[392 250 215 384 378],472,4,8414,2.7632183908045977,0.0,0.0
11045,2,3045,[212 226 217 244 272],1,1,8415,2.762639527248851,20.0,0.0
11046,2,3046,[219 221 321 202 222],303,3,8418,2.7627174269773547,0.0,20.0
11047,2,3047,[331 324 300 250 272],276,5,8423,2.763451443569554,20.0,20.0
11048,2,3048,[268 226 452 202 508],497,2,8425,2.7632010495244343,0.0,20.0
11049,2,3049,[201 250 276 223 232],303,5,8430,2.763934426229508,20.0,0.0
11050,2,3050,[326 392 215 250 219],222,4,8434,2.764339560799738,0.0,0.0
11051,2,3051,[293 315 509 290 232],293,1,8435,2.7637614678899083,20.0,0.0
11052,2,3052,[241 291 284 231 508],896,2,8437,2.7635113003603013,0.0,0.0
11053,2,3053,[298 240 290 384 250],435,2,8439,2.7632612966601178,0.0,20.0
11054,2,3054,[223 209 303 222 481],758,5,8444,2.7639934533551553,20.0,20.0
11055,2,3055,[284 291 243 431 217],682,3,8447,2.764070680628272,0.0,0.0
11056,2,3056,[303 246 283 331 216],592,4,8451,2.7644749754661433,0.0,20.0
11057,2,3057,[275 272 255 217 316],293,1,8452,2.763897972531066,40.0,0.0
11058,2,3058,[378 268 420 295 301],399,2,8454,2.7636482510624387,0.0,20.0
11059,2,3059,[209 268 241 384 246],790,3,8457,2.7637254901960784,0.0,20.0
11060,2,3060,[215 222 227 350 384],363,2,8459,2.7634759882391373,0.0,20.0
11061,2,3061,[509 218 290 251 485],293,1,8460,2.7629000653167863,0.0,0.0
11062,2,3062,[239 298 222 221 291],758,3,8463,2.762977473065622,0.0,40.0
11063,2,3063,[276 232 297 226 239],889,2,8465,2.762728459530026,0.0,0.0
11064,2,3064,[326 208 239 246 226],303,3,8468,2.762805872756933,0.0,0.0
11065,2,3065,[378 218 452 478 211],846,3,8471,2.762883235485975,20.0,0.0
11066,2,3066,[246 221 239 213 256],1,4,8475,2.7632865992826865,0.0,0.0
11067,2,3067,[230 246 232 223 219],399,0,8475,2.76238591916558,20.0,0.0
11068,2,3068,[420 231 206 219 217],276,4,8479,2.762789182144021,0.0,0.0
11069,2,3069,[227 452 219 209 413],276,3,8482,2.762866449511401,0.0,0.0
11070,2,3070,[215 232 324 413 254],276,2,8484,2.7626180397264735,0.0,0.0
11071,2,3071,[227 290 316 350 201],363,1,8485,2.7620442708333335,20.0,0.0
11072,2,3072,[201 223 216 324 431],201,4,8489,2.7624471200781,20.0,20.0
11073,2,3073,[240 297 315 213 212],758,4,8493,2.7628497072218607,20.0,0.0
11074,2,3074,[321 291 211 481 378],429,2,8495,2.7626016260162602,0.0,0.0
11075,2,3075,[293 272 509 216 315],758,4,8499,2.763003901170351,40.0,20.0
11076,2,3076,[231 240 208 268 452],222,1,8500,2.7624309392265194,0.0,20.0
11077,2,3077,[321 413 284 290 220],181,1,8501,2.761858349577648,0.0,0.0
11078,2,3078,[208 276 384 230 221],758,3,8504,2.7619356934069503,0.0,0.0
11079,2,3079,[394 226 367 276 239],880,4,8508,2.7623376623376625,0.0,0.0
11080,2,3080,[250 256 231 202 267],1,4,8512,2.762739370334307,0.0,0.0
11081,2,3081,[211 321 219 276 209],201,2,8514,2.762491888384166,0.0,0.0
11082,2,3082,[290 261 507 367 211],847,2,8516,2.7622445669802143,0.0,0.0
11083,2,3083,[392 230 232 272 303],276,3,8519,2.7623216601815823,20.0,0.0
11084,2,3084,[264 246 295 367 261],919,1,8520,2.761750405186386,0.0,0.0
11085,2,3085,[268 321 254 243 272],130,3,8523,2.7618276085547633,20.0,20.0
11086,2,3086,[268 217 301 202 392],276,4,8527,2.762228701004211,0.0,20.0
11087,2,3087,[236 246 219 315 243],130,4,8531,2.7626295336787563,20.0,0.0
11088,2,3088,[227 240 250 508 215],221,4,8535,2.7630301068306897,0.0,0.0
11089,2,3089,[230 254 231 226 280],880,1,8536,2.7624595469255664,0.0,0.0
11090,2,3090,[413 236 219 326 367],130,4,8540,2.762859915884827,0.0,0.0
11091,2,3091,[367 250 283 275 222],178,5,8545,2.763583441138422,0.0,20.0
11092,2,3092,[367 392 230 215 255],472,5,8550,2.764306498545102,0.0,0.0
11093,2,3093,[208 365 300 231 219],429,2,8552,2.764059469941823,0.0,20.0
11094,2,3094,[208 223 222 420 452],303,3,8555,2.764135702746365,20.0,20.0
11095,2,3095,[223 336 251 297 315],592,4,8559,2.76453488372093,40.0,0.0
11096,2,3096,[315 268 298 324 223],276,5,8564,2.7652567000322894,40.0,40.0
11097,2,3097,[246 431 247 284 223],222,3,8567,2.765332472562944,20.0,0.0
11098,2,3098,[272 300 226 251 211],293,3,8570,2.76540819619232,20.0,20.0
11099,2,3099,[300 324 226 215 201],303,3,8573,2.765483870967742,0.0,20.0
11100,2,3100,[226 243 299 239 413],130,2,8575,2.765237020316027,0.0,0.0
11101,2,3101,[583 378 291 275 367],429,2,8577,2.764990328820116,0.0,0.0
11102,2,3102,[206 209 218 231 202],622,3,8580,2.765066065098292,0.0,0.0
11103,2,3103,[217 508 222 315 202],880,5,8585,2.765786082474227,20.0,20.0
11104,2,3104,[232 268 231 321 216],201,2,8587,2.7655394524959744,0.0,40.0
11105,2,3105,[250 216 251 267 272],1,4,8591,2.7659368963296846,20.0,20.0
11106,2,3106,[367 231 232 299 239],682,1,8592,2.7653685226906983,0.0,0.0
11107,2,3107,[367 295 202 236 215],130,4,8596,2.765765765765766,0.0,0.0
11108,2,3108,[217 239 218 301 300],327,0,8596,2.764876165969765,0.0,20.0
11109,2,3109,[284 326 300 226 216],222,3,8599,2.764951768488746,0.0,40.0
11110,2,3110,[218 222 230 227 429],363,3,8602,2.7650273224043715,0.0,20.0
11111,2,3111,[268 316 315 284 264],276,4,8606,2.7654241645244215,40.0,20.0
11112,2,3112,[272 264 232 583 216],551,3,8609,2.765499518149695,20.0,20.0
11113,2,3113,[324 264 223 255 390],303,2,8611,2.765253692999358,20.0,0.0
11114,2,3114,[326 284 267 299 239],130,3,8614,2.7653290529695025,0.0,0.0
11115,2,3115,[254 315 392 384 316],276,2,8616,2.7650834403080875,40.0,0.0
11116,2,3116,[367 222 206 227 508],130,3,8619,2.7651588065447545,0.0,20.0
11117,2,3117,[244 211 208 223 202],407,4,8623,2.7655548428479793,20.0,0.0
11118,2,3118,[420 365 239 268 384],276,3,8626,2.7656300096184676,0.0,20.0
11119,2,3119,[284 231 209 218 243],561,1,8627,2.7650641025641027,0.0,0.0
11120,2,3120,[290 250 256 280 232],916,1,8628,2.764498558154438,0.0,0.0
11121,2,3121,[290 240 222 384 232],303,2,8630,2.764253683536195,0.0,20.0
11122,2,3122,[209 240 420 226 246],682,2,8632,2.764008965738072,0.0,0.0
11123,2,3123,[251 226 201 264 240],303,3,8635,2.7640845070422535,0.0,0.0
11124,2,3124,[315 232 239 268 290],276,4,8639,2.76448,20.0,20.0
11125,2,3125,[231 243 217 240 201],1,0,8639,2.7635956493921947,0.0,0.0
11126,2,3126,[217 291 222 202 431],682,4,8643,2.7639910457307324,0.0,20.0
11127,2,3127,[413 246 254 230 291],435,2,8645,2.7637468030690537,0.0,0.0
11128,2,3128,[275 276 264 250 222],429,3,8648,2.7638223074464685,0.0,20.0
11129,2,3129,[394 321 219 206 420],435,4,8652,2.764217252396166,0.0,0.0
11130,2,3130,[298 215 255 221 243],592,4,8656,2.7646119450654743,0.0,20.0
11131,2,3131,[315 268 295 222 243],130,3,8659,2.7646871008939975,20.0,40.0
11132,2,3132,[295 215 218 283 478],178,3,8662,2.764762208745611,20.0,0.0
11133,2,3133,[209 211 250 231 583],429,2,8664,2.764518187619655,0.0,0.0
11134,2,3134,[264 378 295 291 239],399,1,8665,2.7639553429027113,0.0,0.0
11135,2,3135,[264 300 293 367 350],332,4,8669,2.764349489795918,0.0,20.0
11136,2,3136,[276 275 315 206 230],201,2,8671,2.76410583359898,20.0,0.0
11137,2,3137,[365 219 227 293 384],276,3,8674,2.764181007010835,0.0,0.0
11138,2,3138,[250 227 316 218 291],407,4,8678,2.7645747053201655,20.0,0.0
11139,2,3139,[452 232 206 290 267],268,0,8678,2.7636942675159237,0.0,0.0
11140,2,3140,[367 223 227 508 509],453,3,8681,2.763769500159185,20.0,0.0
11141,2,3141,[290 209 300 276 236],303,4,8685,2.764162953532782,0.0,20.0
11142,2,3142,[284 223 241 413 429],276,4,8689,2.764556156538339,20.0,0.0
11143,2,3143,[315 244 202 276 261],919,1,8690,2.763994910941476,20.0,0.0
11144,2,3144,[250 222 298 231 315],660,2,8692,2.763751987281399,20.0,40.0
11145,2,3145,[298 431 481 227 209],429,3,8695,2.7638270820089,0.0,20.0
11146,2,3146,[264 227 223 201 276],276,4,8699,2.7642198919605976,20.0,0.0
11147,2,3147,[315 272 509 264 230],293,1,8700,2.763659466327827,40.0,0.0
11148,2,3148,[239 206 230 232 231],487,4,8704,2.764052080025405,0.0,0.0
11149,2,3149,[331 276 297 508 300],919,5,8709,2.764761904761905,0.0,20.0
11150,2,3150,[291 295 226 452 231],109,2,8711,2.7645192002538876,0.0,0.0
11151,2,3151,[243 250 239 259 201],682,2,8713,2.764276649746193,0.0,0.0
11152,2,3152,[217 394 283 227 209],864,3,8716,2.7643514113542658,0.0,0.0
11153,2,3153,[239 350 217 315 250],363,0,8716,2.7634749524413444,20.0,0.0
11154,2,3154,[232 211 392 284 250],727,3,8719,2.7635499207606973,0.0,0.0
11155,2,3155,[218 240 321 209 291],303,2,8721,2.7633079847908744,0.0,0.0
11156,2,3156,[227 301 254 420 290],276,4,8725,2.7636997149192273,0.0,0.0
11157,2,3157,[219 201 218 243 231],561,0,8725,2.7628245725142495,0.0,0.0
11158,2,3158,[264 336 367 326 216],592,3,8728,2.7628996517885405,0.0,20.0
11159,2,3159,[452 276 226 218 232],586,1,8729,2.7623417721518986,0.0,0.0
11160,2,3160,[268 254 264 244 267],1,2,8731,2.762100601075609,0.0,20.0
11161,2,3161,[201 508 218 413 452],303,3,8734,2.7621758380771664,0.0,0.0
11162,2,3162,[250 301 251 230 431],532,4,8738,2.762567183054063,0.0,0.0
11163,2,3163,[290 315 316 291 254],130,3,8741,2.7626422250316054,40.0,0.0
11164,2,3164,[216 255 478 431 230],178,5,8746,2.763349131121643,20.0,20.0
11165,2,3165,[206 301 284 392 291],276,3,8749,2.7634238787113077,0.0,0.0
11166,2,3166,[231 254 250 206 232],1,2,8751,2.7631828228607516,0.0,0.0
11167,2,3167,[420 241 239 344 298],393,3,8754,2.7632575757575757,0.0,20.0
11168,2,3168,[222 321 240 293 413],303,1,8755,2.7627011675607447,0.0,20.0
11169,2,3169,[211 251 232 215 206],1,2,8757,2.762460567823344,0.0,0.0
11170,2,3170,[291 208 284 227 298],429,3,8760,2.762535477767266,0.0,20.0
11171,2,3171,[324 326 227 452 240],201,2,8762,2.762295081967213,0.0,0.0
11172,2,3172,[250 283 201 300 226],880,2,8764,2.762054837693035,0.0,20.0
11173,2,3173,[250 291 367 452 243],130,3,8767,2.762129804662886,0.0,0.0
11174,2,3174,[331 222 301 392 250],276,4,8771,2.7625196850393703,0.0,20.0
11175,2,3175,[227 222 218 219 241],268,2,8773,2.76227959697733,0.0,20.0
11176,2,3176,[231 211 221 243 247],1,1,8774,2.761724897702235,0.0,0.0
11177,2,3177,[250 218 211 280 268],916,3,8777,2.761799874134676,0.0,20.0
11178,2,3178,[280 240 300 384 365],551,2,8779,2.7615602390688894,0.0,20.0
11179,2,3179,[230 227 264 283 300],293,0,8779,2.760691823899371,0.0,20.0
11180,2,3180,[246 331 276 217 365],276,4,8783,2.7610814209368124,0.0,0.0
11181,2,3181,[367 222 218 267 215],130,5,8788,2.761785040854808,0.0,20.0
11182,2,3182,[227 276 508 208 326],303,3,8791,2.7618598806157713,0.0,0.0
11183,2,3183,[284 222 367 350 290],130,3,8794,2.761934673366834,0.0,20.0
11184,2,3184,[243 365 250 293 230],880,1,8795,2.76138147566719,0.0,0.0
11185,2,3185,[367 250 303 255 431],393,3,8798,2.7614563716258633,0.0,0.0
11186,2,3186,[413 226 298 219 284],303,4,8802,2.7618449952933792,0.0,20.0
11187,2,3187,[239 230 227 413 218],399,1,8803,2.7612923462986196,0.0,0.0
11188,2,3188,[276 221 300 259 324],936,3,8806,2.7613671997491376,0.0,20.0
11189,2,3189,[280 232 384 431 324],551,2,8808,2.761128526645768,0.0,0.0
11190,2,3190,[232 291 239 431 218],399,1,8809,2.760576621748668,0.0,0.0
11191,2,3191,[231 227 236 241 251],1,4,8813,2.7609649122807016,0.0,0.0
11192,2,3192,[268 583 250 392 331],276,3,8816,2.7610397745067337,0.0,20.0
11193,2,3193,[218 241 239 509 211],201,1,8817,2.760488415779587,0.0,0.0
11194,2,3194,[232 201 452 331 413],276,2,8819,2.7602503912363066,0.0,0.0
11195,2,3195,[420 226 290 241 299],682,2,8821,2.7600125156445556,0.0,0.0
11196,2,3196,[284 218 226 232 222],332,5,8826,2.7607131685955584,0.0,20.0
11197,2,3197,[222 221 261 301 255],919,2,8828,2.7604752970606627,0.0,20.0
11198,2,3198,[209 275 250 431 378],790,2,8830,2.7602375742419505,0.0,0.0
11199,2,3199,[223 208 239 420 452],303,3,8833,2.7603125,20.0,0.0
11200,2,3200,[216 217 243 213 259],1,1,8834,2.759762574195564,0.0,20.0
11201,2,3201,[452 276 300 255 268],130,5,8839,2.760462211118051,0.0,40.0
11202,2,3202,[297 291 384 208 276],758,4,8843,2.760849203871371,0.0,0.0
11203,2,3203,[202 243 250 283 261],919,1,8844,2.7602996254681647,0.0,0.0
11204,2,3204,[350 276 222 303 298],758,4,8848,2.7606864274570984,0.0,40.0
11205,2,3205,[222 241 384 208 291],303,2,8850,2.7604491578290706,0.0,20.0
11206,2,3206,[367 297 298 299 264],592,3,8853,2.7605238540692234,0.0,20.0
11207,2,3207,[301 246 300 208 250],500,4,8857,2.7609102244389025,0.0,20.0
11208,2,3208,[326 431 218 413 227],222,3,8860,2.760984730445622,0.0,0.0
11209,2,3209,[246 209 226 241 293],682,3,8863,2.7610591900311525,0.0,0.0
11210,2,3210,[297 209 239 431 212],889,2,8865,2.7608221737776395,0.0,0.0
11211,2,3211,[239 236 227 413 232],246,3,8868,2.7608966376089663,0.0,0.0
11212,2,3212,[261 259 240 202 243],1,1,8869,2.7603485838779958,0.0,0.0
11213,2,3213,[232 223 221 452 384],303,3,8872,2.760423148724331,20.0,0.0
11214,2,3214,[384 236 231 239 202],758,3,8875,2.76049766718507,0.0,0.0
11215,2,3215,[315 202 211 431 303],201,0,8875,2.759639303482587,20.0,0.0
11216,2,3216,[240 293 291 239 290],347,4,8879,2.7600248678893378,0.0,0.0
11217,2,3217,[227 239 293 223 251],293,3,8882,2.760099440646364,20.0,0.0
11218,2,3218,[202 509 239 222 241],299,2,8884,2.7598633115874494,0.0,20.0
11219,2,3219,[226 209 255 300 280],178,5,8889,2.76055900621118,0.0,20.0
11220,2,3220,[227 316 222 507 251],293,2,8891,2.7603228810928284,20.0,20.0
11221,2,3221,[301 240 250 230 303],276,5,8896,2.761018001241465,0.0,0.0
11222,2,3222,[276 201 291 232 239],276,3,8899,2.7610921501706485,0.0,0.0
11223,2,3223,[431 206 276 215 226],487,2,8901,2.7608560794044665,0.0,0.0
11224,2,3224,[390 284 290 218 413],303,3,8904,2.7609302325581395,0.0,0.0
11225,2,3225,[215 211 384 216 259],514,3,8907,2.761004339739616,0.0,20.0
11226,2,3226,[223 431 244 218 227],916,2,8909,2.7607685156492097,20.0,0.0
11227,2,3227,[431 275 268 367 300],178,5,8914,2.761462205700124,0.0,40.0
11228,2,3228,[250 232 239 261 267],1,3,8917,2.761536079281511,0.0,0.0
11229,2,3229,[452 246 208 239 209],222,3,8920,2.761609907120743,0.0,0.0
11230,2,3230,[431 217 392 231 264],276,1,8921,2.7610646858557724,0.0,0.0
11231,2,3231,[232 264 250 290 201],363,0,8921,2.760210396039604,0.0,0.0
11232,2,3232,[583 231 250 223 291],303,3,8924,2.7602845654191155,20.0,0.0
11233,2,3233,[206 321 261 276 230],130,3,8927,2.7603586889301175,0.0,0.0
11234,2,3234,[231 243 232 250 384],880,1,8928,2.7598145285935085,0.0,0.0
11235,2,3235,[284 303 211 367 509],293,2,8930,2.7595797280593324,0.0,0.0
11236,2,3236,[216 255 212 239 250],1,4,8934,2.7599629286376275,0.0,20.0
11237,2,3237,[291 272 301 293 268],276,4,8938,2.7603458925262507,20.0,20.0
11238,2,3238,[315 217 215 208 394],286,3,8941,2.7604198826798396,20.0,0.0
11239,2,3239,[219 295 298 231 239],56,3,8944,2.7604938271604937,0.0,20.0
11240,2,3240,[219 230 255 295 215],130,3,8947,2.7605677260104904,0.0,0.0
11241,2,3241,[219 206 367 202 256],916,0,8947,2.7597162245527453,0.0,0.0
11242,2,3242,[241 218 217 201 452],201,2,8949,2.759481961147086,0.0,0.0
11243,2,3243,[413 219 431 206 217],727,1,8950,2.7589395807644883,0.0,0.0
11244,2,3244,[303 350 209 276 316],758,4,8954,2.759322033898305,20.0,0.0
11245,2,3245,[298 231 301 201 209],425,2,8956,2.7590881084411585,0.0,20.0
11246,2,3246,[226 201 392 264 299],435,3,8959,2.7591623036649215,0.0,0.0
11247,2,3247,[217 293 420 202 240],276,5,8964,2.7598522167487687,0.0,0.0
11248,2,3248,[256 232 255 272 215],1,1,8965,2.7593105570944907,20.0,0.0
11249,2,3249,[222 218 290 254 431],276,3,8968,2.7593846153846155,0.0,20.0
11250,2,3250,[290 223 216 206 420],293,4,8972,2.759766225776684,20.0,20.0
11251,2,3251,[226 250 295 268 216],532,4,8976,2.7601476014760147,0.0,40.0
11252,2,3252,[275 431 209 276 295],178,3,8979,2.7602213341530892,0.0,0.0
11253,2,3253,[299 251 331 259 275],181,0,8979,2.7593730792870312,0.0,0.0
11254,2,3254,[293 321 206 231 316],130,3,8982,2.759447004608295,20.0,0.0
11255,2,3255,[507 283 240 250 211],727,2,8984,2.7592137592137593,0.0,0.0
11256,2,3256,[218 250 216 452 321],130,4,8988,2.7595947190666257,0.0,20.0
11257,2,3257,[201 243 215 211 213],1,0,8988,2.758747697974217,0.0,0.0
11258,2,3258,[367 280 431 243 420],393,2,8990,2.758514881865603,0.0,0.0
11259,2,3259,[215 232 206 452 222],896,2,8992,2.758282208588957,0.0,20.0
11260,2,3260,[217 255 316 230 291],407,5,8997,2.7589696412143514,20.0,0.0
11261,2,3261,[230 246 508 324 226],303,3,9000,2.7590435315757205,0.0,0.0
11262,2,3262,[202 216 583 300 276],682,2,9002,2.7588109102053324,0.0,40.0
11263,2,3263,[231 284 508 240 291],303,3,9005,2.7588848039215685,0.0,0.0
11264,2,3264,[240 283 300 259 367],299,2,9007,2.7586523736600306,0.0,20.0
11265,2,3265,[300 243 365 215 240],682,2,9009,2.758420085731782,0.0,20.0
11266,2,3266,[259 326 452 583 291],303,0,9009,2.757575757575758,0.0,0.0
11267,2,3267,[452 246 291 217 222],276,3,9012,2.7576499388004896,0.0,20.0
11268,2,3268,[431 240 324 509 227],758,3,9015,2.7577240746405627,0.0,0.0
11269,2,3269,[231 275 481 507 250],429,2,9017,2.7574923547400614,0.0,0.0
11270,2,3270,[215 222 202 290 217],682,4,9021,2.7578722103332316,0.0,20.0
11271,2,3271,[284 255 326 413 239],222,2,9023,2.757640586797066,0.0,0.0
11272,2,3272,[583 223 290 213 244],916,4,9027,2.758020164986251,20.0,0.0
11273,2,3273,[431 291 213 217 227],758,3,9030,2.758094074526573,0.0,0.0
11274,2,3274,[230 231 315 331 219],276,4,9034,2.7584732824427483,20.0,0.0
11275,2,3275,[583 303 420 218 219],276,4,9038,2.758852258852259,0.0,0.0
11276,2,3276,[268 239 508 246 227],347,4,9042,2.759231003967043,0.0,20.0
11277,2,3277,[298 283 276 243 268],880,3,9045,2.7593044539353264,0.0,40.0
11278,2,3278,[481 272 227 221 509],758,4,9049,2.7596828301311374,20.0,0.0
11279,2,3279,[291 215 232 231 230],521,0,9049,2.758841463414634,0.0,0.0
11280,2,3280,[295 202 298 218 261],130,4,9053,2.759219750076196,0.0,20.0
11281,2,3281,[232 300 303 218 226],293,1,9054,2.7586837294332724,0.0,20.0
11282,2,3282,[431 280 300 508 222],551,4,9058,2.7590618336886994,0.0,40.0
11283,2,3283,[222 392 230 218 350],130,4,9062,2.7594397076735686,0.0,20.0
11284,2,3284,[324 431 583 240 239],201,1,9063,2.758904109589041,0.0,0.0
11285,2,3285,[429 303 583 509 284],293,2,9065,2.7586731588557516,0.0,0.0
11286,2,3286,[280 283 478 326 219],178,5,9070,2.7593550349863096,20.0,0.0
11287,2,3287,[392 413 429 206 276],276,3,9073,2.7594282238442824,0.0,0.0
11288,2,3288,[231 208 232 223 222],864,4,9077,2.759805411979325,20.0,20.0
11289,2,3289,[293 218 392 206 284],130,3,9080,2.7598784194528876,0.0,0.0
11290,2,3290,[250 290 264 583 321],303,2,9082,2.759647523549073,0.0,0.0
11291,2,3291,[227 236 240 272 324],758,4,9086,2.7600243013365735,20.0,0.0
11292,2,3292,[201 290 251 232 268],303,5,9091,2.7607045247494684,0.0,20.0
11293,2,3293,[221 201 256 231 202],1,3,9094,2.760777170613236,0.0,0.0
11294,2,3294,[230 217 227 290 250],429,0,9094,2.7599393019726857,0.0,0.0
11295,2,3295,[272 413 367 452 300],276,2,9096,2.7597087378640777,20.0,20.0
11296,2,3296,[384 272 303 508 219],276,4,9100,2.760084925690021,20.0,0.0
11297,2,3297,[219 293 268 217 202],130,4,9104,2.760460885385082,0.0,20.0
11298,2,3298,[367 420 231 211 223],896,4,9108,2.760836617156714,20.0,0.0
11299,2,3299,[222 283 275 284 508],357,5,9113,2.7615151515151517,0.0,20.0
11300,2,3300,[331 272 223 326 230],551,5,9118,2.7621932747652225,40.0,0.0
11301,2,3301,[390 246 264 283 367],303,2,9120,2.761962447001817,0.0,0.0
11302,2,3302,[246 583 367 226 208],94,3,9123,2.7620345140781106,0.0,0.0
11303,2,3303,[276 208 284 431 218],870,3,9126,2.7621065375302662,0.0,0.0
11304,2,3304,[293 239 254 216 300],130,4,9130,2.762481089258699,0.0,40.0
11305,2,3305,[221 223 211 247 254],1,2,9132,2.762250453720508,20.0,0.0
11306,2,3306,[218 326 268 384 232],551,4,9136,2.762624735409737,0.0,20.0
11307,2,3307,[222 223 239 230 218],916,1,9137,2.762091898428053,20.0,20.0
11308,2,3308,[232 429 365 211 208],846,1,9138,2.761559383499547,0.0,0.0
11309,2,3309,[206 365 219 222 232],276,3,9141,2.761631419939577,0.0,20.0
11310,2,3310,[394 431 216 222 321],435,1,9142,2.7610993657505287,0.0,40.0
11311,2,3311,[226 217 241 231 431],301,2,9144,2.760869565217391,0.0,0.0
11312,2,3312,[392 226 206 246 284],435,3,9147,2.7609417446423183,0.0,0.0
11313,2,3313,[247 261 240 280 326],222,1,9148,2.7604103802051903,0.0,0.0
11314,2,3314,[431 239 344 365 243],393,2,9150,2.760180995475113,0.0,0.0
11315,2,3315,[272 211 223 230 222],1,3,9153,2.7602533172496986,40.0,20.0
11316,2,3316,[218 216 230 211 239],933,1,9154,2.759722640940609,0.0,20.0
11317,2,3317,[298 250 241 240 218],532,3,9157,2.759795057263412,0.0,20.0
11318,2,3318,[218 268 259 216 315],532,3,9160,2.7598674299487795,20.0,40.0
11319,2,3319,[202 290 218 216 240],130,4,9164,2.7602409638554217,0.0,20.0
11320,2,3320,[218 507 275 264 367],429,2,9166,2.76001204456489,0.0,0.0
11321,2,3321,[201 246 324 508 255],327,2,9168,2.7597832630945214,0.0,0.0
11322,2,3322,[226 222 241 290 216],521,3,9171,2.7598555522118566,0.0,40.0
11323,2,3323,[209 384 231 250 216],22,3,9174,2.759927797833935,0.0,20.0
11324,2,3324,[583 452 324 284 290],303,2,9176,2.7596992481203007,0.0,0.0
11325,2,3325,[431 201 236 508 336],592,2,9178,2.7594708358388456,0.0,0.0
11326,2,3326,[344 272 297 250 331],592,4,9182,2.759843703035768,20.0,0.0
11327,2,3327,[202 300 276 507 230],429,3,9185,2.7599158653846154,0.0,20.0
11328,2,3328,[217 230 231 431 315],758,2,9187,2.7596875938720338,20.0,0.0
11329,2,3329,[223 232 452 259 324],303,2,9189,2.7594594594594595,20.0,0.0
11330,2,3330,[212 216 431 211 268],286,4,9193,2.759831882317622,0.0,40.0
11331,2,3331,[222 583 378 201 226],682,2,9195,2.759603841536615,0.0,20.0
11332,2,3332,[236 324 295 222 243],592,2,9197,2.7593759375937594,0.0,20.0
11333,2,3333,[227 326 250 284 291],130,2,9199,2.759148170365927,0.0,0.0
11334,2,3334,[215 218 219 268 256],916,1,9200,2.7586206896551726,0.0,20.0
11335,2,3335,[215 299 217 227 350],130,2,9202,2.7583932853717026,0.0,0.0
11336,2,3336,[367 291 298 201 508],276,3,9205,2.7584656877434823,0.0,20.0
11337,2,3337,[216 202 280 222 231],682,3,9208,2.7585380467345715,0.0,40.0
11338,2,3338,[392 246 261 217 268],222,3,9211,2.7586103623839473,0.0,20.0
11339,2,3339,[239 293 300 507 284],293,2,9213,2.758383233532934,0.0,20.0
11340,2,3340,[202 344 293 298 264],327,2,9215,2.758156240646513,0.0,20.0
11341,2,3341,[291 431 250 481 583],429,2,9217,2.757929383602633,0.0,0.0
11342,2,3342,[218 293 222 276 295],178,2,9219,2.7577026622793896,0.0,20.0
11343,2,3343,[365 394 367 280 507],393,2,9221,2.757476076555024,0.0,0.0
11344,2,3344,[201 452 290 268 315],276,4,9225,2.757847533632287,20.0,20.0
11345,2,3345,[202 219 215 300 231],276,4,9229,2.75821876867902,0.0,20.0
11346,2,3346,[230 413 284 209 215],276,4,9233,2.7585897818942335,0.0,0.0
11347,2,3347,[324 293 298 291 264],303,2,9235,2.758363201911589,0.0,20.0
11348,2,3348,[583 232 367 239 206],916,1,9236,2.7578381606449685,0.0,0.0
11349,2,3349,[219 256 268 244 206],916,2,9238,2.7576119402985073,0.0,20.0
11350,2,3350,[230 226 367 284 236],303,4,9242,2.757982691733811,0.0,0.0
11351,2,3351,[218 283 212 298 206],622,2,9244,2.7577565632458234,0.0,20.0
11352,2,3352,[272 254 240 583 202],276,3,9247,2.757828810020877,20.0,0.0
11353,2,3353,[208 272 218 293 431],758,3,9250,2.7579010137149673,20.0,0.0
11354,2,3354,[290 236 231 509 202],758,4,9254,2.7582712369597617,0.0,0.0
11355,2,3355,[507 431 293 216 275],327,2,9256,2.7580452920143026,0.0,20.0
11356,2,3356,[216 215 202 240 246],222,4,9260,2.758415251712839,0.0,20.0
11357,2,3357,[481 324 301 240 216],758,3,9263,2.758487194758785,0.0,20.0
11358,2,3358,[420 226 413 300 268],497,1,9264,2.7579636796665676,0.0,40.0
11359,2,3359,[378 202 300 291 254],682,1,9265,2.7574404761904763,0.0,20.0
11360,2,3360,[583 202 246 206 219],94,3,9268,2.757512645046117,0.0,0.0
11361,2,3361,[321 240 378 223 316],393,3,9271,2.757584770969661,40.0,0.0
11362,2,3362,[227 213 209 272 259],1,2,9273,2.7573595004460305,20.0,0.0
11363,2,3363,[239 230 429 300 226],293,1,9274,2.756837098692033,0.0,20.0
11364,2,3364,[222 239 206 202 232],868,1,9275,2.7563150074294205,0.0,20.0
11365,2,3365,[301 367 485 431 264],429,1,9276,2.7557932263814617,0.0,0.0
11366,2,3366,[255 275 244 367 202],919,3,9279,2.7558657558657558,0.0,0.0
11367,2,3367,[264 236 300 275 240],919,3,9282,2.755938242280285,0.0,20.0
11368,2,3368,[227 268 291 226 208],497,1,9283,2.755417037696646,0.0,20.0
11369,2,3369,[209 291 226 429 367],293,1,9284,2.7548961424332346,0.0,0.0
11370,2,3370,[255 250 232 236 211],1,2,9286,2.754672204093741,0.0,0.0
11371,2,3371,[276 227 367 331 452],276,3,9289,2.7547449584816133,0.0,0.0
11372,2,3372,[246 367 284 365 227],276,3,9292,2.7548176697302105,0.0,0.0
11373,2,3373,[211 290 212 583 232],916,3,9295,2.7548903378778897,0.0,0.0
11374,2,3374,[219 507 284 276 300],303,4,9299,2.755259259259259,0.0,20.0
11375,2,3375,[230 324 226 298 431],521,2,9301,2.7550355450236967,0.0,20.0
11376,2,3376,[429 367 222 331 316],276,4,9305,2.755404204915606,20.0,20.0
11377,2,3377,[293 272 420 298 209],758,3,9308,2.7554766133806985,20.0,20.0
11378,2,3378,[230 316 227 218 240],532,4,9312,2.7558449245338856,20.0,0.0
11379,2,3379,[227 268 429 223 300],276,5,9317,2.756508875739645,20.0,40.0
11380,2,3380,[293 367 209 509 219],682,1,9318,2.7559893522626444,0.0,0.0
11381,2,3381,[215 283 290 251 326],303,3,9321,2.756061502069781,0.0,0.0
11382,2,3382,[291 290 239 231 300],889,1,9322,2.755542417972214,0.0,20.0
11383,2,3383,[226 215 508 240 413],222,1,9323,2.7550236406619386,0.0,0.0
11384,2,3384,[298 283 316 217 218],293,1,9324,2.7545051698670604,20.0,20.0
11385,2,3385,[259 208 583 216 202],303,3,9327,2.7545776727702305,0.0,20.0
11386,2,3386,[420 243 367 261 202],130,4,9331,2.754945379391792,0.0,0.0
11387,2,3387,[321 239 254 240 216],130,4,9335,2.7553128689492326,0.0,20.0
11388,2,3388,[241 222 300 583 227],276,4,9339,2.7556801416347003,0.0,40.0
11389,2,3389,[276 202 219 275 226],201,3,9342,2.7557522123893805,0.0,0.0
11390,2,3390,[241 280 250 209 290],429,1,9343,2.7552344441167795,0.0,0.0
11391,2,3391,[202 350 321 420 261],130,5,9348,2.755896226415094,0.0,0.0
11392,2,3392,[350 303 331 508 291],758,5,9353,2.756557618626584,0.0,0.0
11393,2,3393,[326 215 206 236 218],130,4,9357,2.7569239835002946,0.0,0.0
11394,2,3394,[219 211 215 290 223],682,2,9359,2.756701030927835,20.0,0.0
11395,2,3395,[413 301 315 276 583],276,3,9362,2.7567726737338045,20.0,0.0
11396,2,3396,[413 239 226 298 202],497,2,9364,2.756549896967913,0.0,20.0
11397,2,3397,[336 243 264 201 216],592,2,9366,2.7563272513243082,0.0,20.0
11398,2,3398,[232 236 321 218 264],303,3,9369,2.75639894086496,0.0,0.0
11399,2,3399,[244 211 232 239 316],407,3,9372,2.756470588235294,20.0,0.0
11400,2,3400,[301 218 413 222 201],21,3,9375,2.7565421934725083,0.0,20.0
11401,2,3401,[209 268 276 290 298],916,2,9377,2.7563198118753673,0.0,40.0
11402,2,3402,[219 226 283 583 378],429,1,9378,2.7558037026153395,0.0,0.0
11403,2,3403,[291 272 218 267 295],130,4,9382,2.756169212690952,20.0,0.0
11404,2,3404,[291 209 283 230 321],303,1,9383,2.755653450807636,0.0,0.0
11405,2,3405,[223 232 241 300 284],303,4,9387,2.7560187903699354,20.0,20.0
11406,2,3406,[221 326 216 321 413],303,2,9389,2.7557968887584385,0.0,20.0
11407,2,3407,[290 264 280 508 275],181,1,9390,2.755281690140845,0.0,0.0
11408,2,3408,[420 239 202 276 264],276,4,9394,2.75564681724846,0.0,0.0
11409,2,3409,[508 321 324 259 246],936,2,9396,2.755425219941349,0.0,0.0
11410,2,3410,[272 246 218 261 315],919,2,9398,2.75520375256523,40.0,0.0
11411,2,3411,[431 291 365 218 239],682,1,9399,2.754689331770223,0.0,0.0
11412,2,3412,[291 481 509 202 236],758,5,9404,2.7553472018751832,0.0,0.0
11413,2,3413,[211 226 250 202 384],727,3,9407,2.755418863503222,0.0,0.0
11414,2,3414,[215 280 316 211 217],293,2,9409,2.755197657393851,20.0,0.0
11415,2,3415,[240 326 254 217 295],130,2,9411,2.754976580796253,0.0,0.0
11416,2,3416,[226 240 241 324 222],303,2,9413,2.7547556335967225,0.0,20.0
11417,2,3417,[280 300 295 250 508],880,2,9415,2.7545348156816853,0.0,20.0
11418,2,3418,[268 293 240 276 201],919,3,9418,2.754606610119918,0.0,20.0
11419,2,3419,[283 222 290 217 280],293,0,9418,2.7538011695906435,0.0,20.0
11420,2,3420,[213 222 276 303 275],201,3,9421,2.7538731365097924,0.0,20.0
11421,2,3421,[246 261 298 202 247],222,3,9424,2.753945061367621,0.0,20.0
11422,2,3422,[367 240 232 222 413],303,2,9426,2.7537248028045576,0.0,20.0
11423,2,3423,[230 246 378 218 240],222,3,9429,2.7537967289719627,0.0,0.0
11424,2,3424,[202 300 226 240 201],880,4,9433,2.754160583941606,0.0,20.0
11425,2,3425,[431 268 508 250 298],592,4,9437,2.754524226503211,0.0,40.0
11426,2,3426,[236 239 209 222 231],758,3,9440,2.754595856434199,0.0,20.0
11427,2,3427,[243 244 255 216 202],1,2,9442,2.7543757292882147,0.0,20.0
11428,2,3428,[227 583 223 272 209],201,2,9444,2.7541557305336832,40.0,0.0
11429,2,3429,[215 291 219 326 251],303,3,9447,2.7542274052478133,0.0,0.0
11430,2,3430,[201 240 202 268 217],727,3,9450,2.7542990381812884,0.0,20.0
11431,2,3431,[300 217 246 413 280],222,2,9452,2.754079254079254,0.0,20.0
11432,2,3432,[291 295 336 284 255],851,3,9455,2.7541508884357704,0.0,0.0
11433,2,3433,[209 208 250 268 413],286,4,9459,2.7545136866627837,0.0,20.0
11434,2,3434,[215 231 452 202 239],201,0,9459,2.7537117903930133,0.0,0.0
11435,2,3435,[230 255 244 326 478],178,4,9463,2.7540745052386497,20.0,0.0
11436,2,3436,[268 240 290 293 201],276,5,9468,2.7547279604306083,0.0,20.0
11437,2,3437,[254 384 268 222 284],276,3,9471,2.7547993019197206,0.0,40.0
11438,2,3438,[452 202 276 218 209],303,4,9475,2.7551613841232916,0.0,0.0
11439,2,3439,[429 384 230 231 264],276,2,9477,2.754941860465116,0.0,0.0
11440,2,3440,[452 268 365 367 218],846,3,9480,2.755013077593723,0.0,20.0
11441,2,3441,[202 365 384 240 216],551,3,9483,2.7550842533410806,0.0,20.0
11442,2,3442,[239 509 365 231 431],846,3,9486,2.755155387743247,0.0,0.0
11443,2,3443,[272 297 215 300 275],293,3,9489,2.755226480836237,20.0,20.0
11444,2,3444,[216 231 378 276 508],429,3,9492,2.7552975326560234,0.0,20.0
11445,2,3445,[331 303 202 509 208],758,5,9497,2.755948926291352,0.0,0.0
11446,2,3446,[452 420 301 508 241],399,2,9499,2.755729619959385,0.0,0.0
11447,2,3447,[236 244 221 232 251],1,3,9502,2.7558004640371228,0.0,0.0
11448,2,3448,[280 367 298 209 378],222,2,9504,2.7555813279211367,0.0,20.0
11449,2,3449,[209 290 392 231 218],276,3,9507,2.7556521739130435,0.0,0.0
11450,2,3450,[261 315 272 300 316],587,4,9511,2.756012749927557,60.0,20.0
11451,2,3451,[300 222 217 216 243],682,3,9514,2.7560834298957126,0.0,60.0
11452,2,3452,[485 300 315 223 201],305,2,9516,2.7558644656820155,40.0,20.0
11453,2,3453,[219 216 206 201 215],896,2,9518,2.7556456282570934,0.0,20.0
11454,2,3454,[384 241 223 413 264],303,2,9520,2.755426917510854,20.0,0.0
11455,2,3455,[420 431 293 221 227],758,1,9521,2.7549189814814814,0.0,0.0
11456,2,3456,[255 236 276 293 261],592,3,9524,2.7549898756146947,0.0,0.0
11457,2,3457,[201 227 452 324 583],201,3,9527,2.7550607287449393,0.0,0.0
11458,2,3458,[231 239 300 291 202],758,2,9529,2.754842440011564,0.0,20.0
11459,2,3459,[300 240 243 219 254],130,3,9532,2.7549132947976878,0.0,20.0
11460,2,3460,[293 276 284 290 226],429,2,9534,2.7546951748049695,0.0,0.0
11461,2,3461,[293 268 222 206 217],276,5,9539,2.7553437319468514,0.0,40.0
11462,2,3462,[218 246 315 284 283],919,2,9541,2.755125613629801,20.0,0.0
11463,2,3463,[222 208 246 264 268],268,4,9545,2.7554849884526558,0.0,40.0
11464,2,3464,[367 290 255 365 509],682,0,9545,2.7546897546897546,0.0,0.0
11465,2,3465,[259 202 208 264 213],1,2,9547,2.754472013848817,0.0,0.0
11466,2,3466,[365 232 283 240 250],880,2,9549,2.754254398615518,0.0,0.0
11467,2,3467,[431 336 215 239 202],327,2,9551,2.7540369088811993,0.0,0.0
11468,2,3468,[232 215 236 239 268],303,4,9555,2.7543960795618334,0.0,20.0
11469,2,3469,[222 218 301 232 268],399,2,9557,2.754178674351585,0.0,40.0
11470,2,3470,[429 485 226 222 227],293,1,9558,2.7536732929991357,0.0,20.0
11471,2,3471,[218 226 507 227 219],429,2,9560,2.7534562211981566,0.0,0.0
11472,2,3472,[365 284 280 218 324],551,3,9563,2.7535272099049815,0.0,0.0
11473,2,3473,[315 280 283 298 209],293,1,9564,2.7530224525043177,20.0,20.0
11474,2,3474,[240 268 227 223 246],222,3,9567,2.7530935251798563,20.0,20.0
11475,2,3475,[283 250 223 221 243],592,4,9571,2.753452243958573,20.0,0.0
11476,2,3476,[384 283 290 208 226],363,1,9572,2.752947943629566,0.0,0.0
11477,2,3477,[240 384 217 324 259],268,1,9573,2.7524439332949973,0.0,0.0
11478,2,3478,[239 299 420 217 384],301,1,9574,2.7519402127048003,0.0,0.0
11479,2,3479,[367 209 293 222 226],293,1,9575,2.7514367816091956,0.0,20.0
11480,2,3480,[240 208 420 291 290],293,1,9576,2.75093363975869,0.0,0.0
11481,2,3481,[206 300 315 209 222],276,5,9581,2.75157955198162,20.0,40.0
11482,2,3482,[429 301 431 230 276],276,4,9585,2.751937984496124,0.0,0.0
11483,2,3483,[509 583 275 217 230],293,0,9585,2.7511481056257177,0.0,0.0
11484,2,3484,[231 216 215 236 222],1,3,9588,2.7512195121951217,0.0,40.0
11485,2,3485,[230 217 507 239 300],293,1,9589,2.7507171543316122,0.0,20.0
11486,2,3486,[218 268 223 201 321],303,4,9593,2.751075422999713,20.0,20.0
11487,2,3487,[350 206 508 284 290],130,2,9595,2.750860091743119,0.0,0.0
11488,2,3488,[392 367 226 206 222],276,3,9598,2.7509314989968474,0.0,20.0
11489,2,3489,[223 251 509 485 291],293,2,9600,2.7507163323782233,20.0,0.0
11490,2,3490,[251 508 293 299 272],592,4,9604,2.751074190776282,20.0,0.0
11491,2,3491,[299 226 227 392 431],896,1,9605,2.7505727376861397,0.0,0.0
11492,2,3492,[420 241 276 268 227],303,4,9609,2.7509304322931576,0.0,20.0
11493,2,3493,[298 241 301 331 202],276,5,9614,2.751574127074986,0.0,20.0
11494,2,3494,[276 215 246 431 295],399,1,9615,2.7510729613733904,0.0,0.0
11495,2,3495,[231 230 244 209 300],425,1,9616,2.7505720823798625,0.0,20.0
11496,2,3496,[246 261 267 223 218],1,3,9619,2.7506434086359737,20.0,0.0
11497,2,3497,[268 230 217 303 324],201,2,9621,2.7504288164665525,0.0,20.0
11498,2,3498,[508 217 275 283 218],919,5,9626,2.751071734781366,0.0,0.0
11499,2,3499,[293 261 227 202 331],130,3,9629,2.7511428571428573,0.0,0.0
11500,2,3500,[240 202 384 223 365],393,1,9630,2.7506426735218508,20.0,0.0
11501,2,3501,[223 254 239 215 222],276,4,9634,2.7509994288977726,20.0,20.0
11502,2,3502,[227 215 268 420 222],399,0,9634,2.750214102198116,0.0,40.0
11503,2,3503,[324 272 219 583 223],201,3,9637,2.7502853881278537,40.0,0.0
11504,2,3504,[222 284 251 300 321],303,2,9639,2.750071326676177,0.0,40.0
11505,2,3505,[216 276 209 315 223],758,4,9643,2.7504278379920137,40.0,20.0
11506,2,3506,[283 326 300 321 284],919,2,9645,2.7502138579982893,0.0,20.0
11507,2,3507,[215 259 250 293 246],682,4,9649,2.7505701254275943,0.0,0.0
11508,2,3508,[300 209 264 431 215],551,4,9653,2.750926189797663,0.0,20.0
11509,2,3509,[300 429 227 298 367],293,2,9655,2.7507122507122506,0.0,40.0
11510,2,3510,[215 231 236 284 223],246,2,9657,2.7504984334947307,20.0,0.0
11511,2,3511,[218 272 298 255 202],293,2,9659,2.7502847380410023,20.0,20.0
11512,2,3512,[298 259 303 283 275],299,2,9661,2.7500711642470823,0.0,20.0
11513,2,3513,[295 420 431 284 241],399,2,9663,2.7498577120091063,0.0,0.0
11514,2,3514,[583 215 241 201 293],303,4,9667,2.750213371266003,0.0,0.0
11515,2,3515,[232 420 272 217 239],682,2,9669,2.75,20.0,0.0
11516,2,3516,[321 293 390 236 215],303,3,9672,2.750071083309639,0.0,0.0
11517,2,3517,[218 250 227 390 201],303,3,9675,2.7501421262080727,0.0,0.0
11518,2,3518,[239 211 244 212 509],299,3,9678,2.7502131287297527,0.0,0.0
11519,2,3519,[384 300 239 507 202],303,2,9680,2.75,0.0,20.0
11520,2,3520,[324 223 300 452 236],303,2,9682,2.7497869923317237,20.0,20.0
11521,2,3521,[222 280 324 508 326],181,2,9684,2.749574105621806,0.0,20.0
11522,2,3522,[413 431 240 284 326],201,0,9684,2.7487936417825716,0.0,0.0
11523,2,3523,[239 227 202 221 276],758,2,9686,2.7485811577752552,0.0,0.0
11524,2,3524,[508 202 246 223 219],870,1,9687,2.7480851063829785,20.0,0.0
11525,2,3525,[275 508 452 221 218],201,3,9690,2.748156551332955,0.0,0.0
11526,2,3526,[378 365 280 215 227],222,2,9692,2.74794442869294,0.0,0.0
11527,2,3527,[232 321 303 226 222],201,0,9692,2.747165532879819,0.0,20.0
11528,2,3528,[232 239 236 219 254],1,2,9694,2.7469538112779825,0.0,0.0
11529,2,3529,[240 202 284 275 315],201,1,9695,2.7464589235127477,20.0,0.0
11530,2,3530,[250 201 215 239 216],363,0,9695,2.7456811101670913,0.0,20.0
11531,2,3531,[221 272 209 384 303],758,4,9699,2.7460362400906004,20.0,0.0
11532,2,3532,[264 272 215 291 222],551,4,9703,2.7463911689782057,20.0,20.0
11533,2,3533,[250 232 222 284 293],178,5,9708,2.7470288624787775,0.0,20.0
11534,2,3534,[212 413 291 231 219],291,4,9712,2.7473833097595475,0.0,0.0
11535,2,3535,[267 272 420 246 222],130,5,9717,2.74802036199095,20.0,20.0
11536,2,3536,[222 509 232 431 268],916,2,9719,2.74780887757987,0.0,40.0
11537,2,3537,[300 280 298 231 211],429,2,9721,2.74759751271905,0.0,40.0
11538,2,3538,[223 291 222 331 336],592,1,9722,2.7471037016106243,20.0,20.0
11539,2,3539,[508 431 272 222 301],276,4,9726,2.747457627118644,20.0,20.0
11540,2,3540,[261 250 209 243 267],1,3,9729,2.747528946625247,0.0,0.0
11541,2,3541,[216 223 221 202 344],758,3,9732,2.7476002258610954,20.0,20.0
11542,2,3542,[251 507 246 268 226],303,5,9737,2.748235958227491,0.0,20.0
11543,2,3543,[420 250 230 298 246],130,3,9740,2.7483069977426635,0.0,20.0
11544,2,3544,[227 250 222 212 230],622,2,9742,2.748095909732017,0.0,20.0
11545,2,3545,[365 508 276 291 201],429,3,9745,2.748166948674563,0.0,0.0
11546,2,3546,[226 259 218 300 215],532,4,9749,2.748519875951508,0.0,20.0
11547,2,3547,[367 283 300 384 301],880,2,9751,2.7483089064261557,0.0,20.0
11548,2,3548,[284 222 240 243 217],682,4,9755,2.748661594815441,0.0,20.0
11549,2,3549,[241 268 367 392 240],276,3,9758,2.748732394366197,0.0,20.0
11550,2,3550,[365 230 300 226 384],276,3,9761,2.748803154041115,0.0,20.0
11551,2,3551,[211 206 209 223 219],561,3,9764,2.748873873873874,20.0,0.0
11552,2,3552,[268 367 384 232 431],773,1,9765,2.748381649310442,0.0,20.0
11553,2,3553,[231 316 226 217 240],276,4,9769,2.748733821046708,20.0,0.0
11554,2,3554,[291 202 378 219 230],429,3,9772,2.7488045007032347,0.0,0.0
11555,2,3555,[284 331 211 223 291],551,5,9777,2.749437570303712,20.0,0.0
11556,2,3556,[367 283 236 297 264],592,3,9780,2.749508012369975,0.0,0.0
11557,2,3557,[209 202 218 222 236],916,1,9781,2.749016301292861,0.0,20.0
11558,2,3558,[212 201 230 213 244],1,2,9783,2.7488058443382974,0.0,0.0
11559,2,3559,[244 259 298 315 284],919,1,9784,2.748314606741573,20.0,20.0
11560,2,3560,[299 219 217 331 290],435,4,9788,2.748666105026678,0.0,0.0
11561,2,3561,[420 293 259 223 298],303,4,9792,2.7490174059517125,20.0,20.0
11562,2,3562,[201 384 293 218 315],276,4,9796,2.7493685096828515,20.0,0.0
11563,2,3563,[272 300 452 254 315],130,4,9800,2.749719416386083,40.0,20.0
11564,2,3564,[324 283 299 201 276],592,4,9804,2.750070126227209,0.0,0.0
11565,2,3565,[219 232 223 509 420],94,4,9808,2.7504206393718453,20.0,0.0
11566,2,3566,[217 367 218 250 226],293,0,9808,2.749649565461172,0.0,0.0
11567,2,3567,[217 230 218 268 227],201,3,9811,2.749719730941704,0.0,20.0
11568,2,3568,[392 293 202 508 284],130,4,9815,2.75007004763239,0.0,0.0
11569,2,3569,[236 240 508 250 226],291,5,9820,2.750700280112045,0.0,0.0
11570,2,3570,[284 367 215 420 384],896,4,9824,2.7510501260151217,0.0,0.0
11571,2,3571,[216 227 301 218 508],532,5,9829,2.751679731243001,0.0,20.0
11572,2,3572,[315 291 392 223 202],276,3,9832,2.751749230338651,40.0,0.0
11573,2,3573,[420 303 316 272 222],276,5,9837,2.7523782876329044,40.0,20.0
11574,2,3574,[259 255 216 384 241],299,1,9838,2.7518881118881118,0.0,20.0
11575,2,3575,[240 290 211 298 209],293,2,9840,2.751677852348993,0.0,20.0
11576,2,3576,[431 227 264 218 392],472,4,9844,2.7520268381325135,0.0,0.0
11577,2,3577,[230 241 213 226 250],790,3,9847,2.752096143096702,0.0,0.0
11578,2,3578,[232 291 331 231 429],276,2,9849,2.751886001676446,0.0,0.0
11579,2,3579,[209 223 272 226 300],276,5,9854,2.7525139664804468,40.0,20.0
11580,2,3580,[508 268 226 291 209],303,4,9858,2.7528623289583916,0.0,20.0
11581,2,3581,[259 211 264 230 215],1,1,9859,2.7523729759910665,0.0,0.0
11582,2,3582,[268 300 272 206 243],130,3,9862,2.752442087636059,20.0,40.0
11583,2,3583,[216 230 275 478 219],327,4,9866,2.7527901785714284,20.0,20.0
11584,2,3584,[236 243 254 267 216],130,3,9869,2.7528591352859135,0.0,20.0
11585,2,3585,[213 219 239 211 215],846,3,9872,2.7529280535415506,0.0,0.0
11586,2,3586,[452 268 259 583 236],303,2,9874,2.752718148870923,0.0,20.0
11587,2,3587,[284 301 222 508 250],276,5,9879,2.7533444816053514,0.0,20.0
11588,2,3588,[201 216 243 254 213],1,1,9880,2.7528559487322375,0.0,20.0
11589,2,3589,[272 206 261 240 315],130,4,9884,2.7532033426183844,40.0,0.0
11590,2,3590,[431 208 209 298 316],660,4,9888,2.753550543024227,20.0,20.0
11591,2,3591,[206 276 219 202 301],276,5,9893,2.754175946547884,0.0,0.0
11592,2,3592,[367 481 226 223 222],429,2,9895,2.7539660450876706,20.0,20.0
11593,2,3593,[378 255 227 202 392],222,2,9897,2.7537562604340566,0.0,0.0
11594,2,3594,[275 290 321 218 250],429,1,9898,2.7532684283727398,0.0,0.0
11595,2,3595,[218 284 211 331 206],435,3,9901,2.7533370411568407,0.0,0.0
11596,2,3596,[231 284 276 202 283],303,4,9905,2.753683625243258,0.0,0.0
11597,2,3597,[284 226 216 331 211],435,3,9908,2.753752084491384,0.0,20.0
11598,2,3598,[208 321 367 452 216],303,3,9911,2.7538205056960265,0.0,20.0
11599,2,3599,[227 226 218 295 326],332,4,9915,2.754166666666667,0.0,0.0
11600,2,3600,[299 293 276 216 508],592,4,9919,2.7545126353790614,0.0,20.0
11601,2,3601,[219 255 272 230 293],130,4,9923,2.7548584119933373,20.0,0.0
11602,2,3602,[223 241 259 227 315],393,5,9928,2.755481543158479,40.0,0.0
11603,2,3603,[367 324 321 202 331],250,3,9931,2.7555493895671477,0.0,0.0
11604,2,3604,[206 378 240 283 291],393,2,9933,2.7553398058252427,0.0,0.0
11605,2,3605,[508 321 384 209 226],303,3,9936,2.75540765391015,0.0,0.0
11606,2,3606,[230 223 255 227 250],1,4,9940,2.7557527030773494,20.0,0.0
11607,2,3607,[431 222 240 284 298],435,1,9941,2.7552660753880267,0.0,40.0
11608,2,3608,[226 219 291 223 316],551,5,9946,2.7558880576336935,40.0,0.0
11609,2,3609,[239 219 254 220 211],1,1,9947,2.7554016620498616,0.0,0.0
11610,2,3610,[272 509 222 241 284],551,5,9952,2.756023262254223,20.0,20.0
11611,2,3611,[222 431 250 420 211],758,3,9955,2.7560908084163898,0.0,20.0
11612,2,3612,[392 276 367 227 268],222,3,9958,2.7561583171879325,0.0,20.0
11613,2,3613,[223 293 301 222 508],919,3,9961,2.7562257885998895,20.0,20.0
11614,2,3614,[231 250 226 217 223],268,3,9964,2.756293222683264,20.0,0.0
11615,2,3615,[236 250 254 264 201],1,2,9966,2.7560840707964602,0.0,0.0
11616,2,3616,[216 264 250 300 303],293,2,9968,2.755875034559027,0.0,40.0
11617,2,3617,[331 316 429 293 284],276,5,9973,2.756495301271421,20.0,0.0
11618,2,3618,[259 275 255 283 202],919,4,9977,2.756838905775076,0.0,0.0
11619,2,3619,[236 221 202 251 231],303,5,9982,2.7574585635359115,0.0,0.0
11620,2,3620,[230 222 212 209 211],561,2,9984,2.757249378624689,0.0,20.0
11621,2,3621,[250 227 239 431 212],363,1,9985,2.756764218663722,0.0,0.0
11622,2,3622,[217 239 230 452 254],130,2,9987,2.7565553408777257,0.0,0.0
11623,2,3623,[367 485 297 275 255],299,3,9990,2.756622516556291,0.0,0.0
11624,2,3624,[298 272 420 226 275],293,3,9993,2.756689655172414,20.0,20.0
11625,2,3625,[215 202 208 240 251],1,3,9996,2.7567567567567566,0.0,0.0
11626,2,3626,[367 244 250 316 268],178,4,10000,2.7570995312930795,20.0,20.0
11627,2,3627,[508 301 239 392 209],880,3,10003,2.7571664829106948,0.0,0.0
11628,2,3628,[223 298 255 240 508],222,2,10005,2.756957839625241,20.0,20.0
11629,2,3629,[280 283 227 481 226],429,0,10005,2.756198347107438,0.0,0.0
11630,2,3630,[291 299 261 303 336],851,4,10009,2.7565408978242907,0.0,0.0
11631,2,3631,[315 429 300 211 485],293,2,10011,2.756332599118943,20.0,20.0
11632,2,3632,[280 222 297 284 218],293,1,10012,2.755849160473438,0.0,20.0
11633,2,3633,[240 219 509 268 290],682,2,10014,2.755641166758393,0.0,20.0
11634,2,3634,[222 507 232 390 251],303,3,10017,2.7557083906464923,0.0,20.0
11635,2,3635,[583 241 219 206 216],201,2,10019,2.7555005500550056,0.0,20.0
11636,2,3636,[264 324 508 299 336],592,2,10021,2.755292823755843,0.0,0.0
11637,2,3637,[261 264 250 239 217],1,2,10023,2.7550852116547553,0.0,0.0
11638,2,3638,[209 226 201 215 321],303,4,10027,2.7554273151964828,0.0,0.0
11639,2,3639,[240 259 231 219 246],268,2,10029,2.75521978021978,0.0,0.0
11640,2,3640,[508 255 247 239 250],222,1,10030,2.754737709420489,0.0,0.0
11641,2,3641,[251 326 291 221 300],303,2,10032,2.754530477759473,0.0,20.0
11642,2,3642,[223 367 275 431 218],429,3,10035,2.754597858907494,20.0,0.0
11643,2,3643,[291 413 227 250 240],303,1,10036,2.7541163556531285,0.0,0.0
11644,2,3644,[202 284 507 227 217],293,1,10037,2.7536351165980797,0.0,0.0
11645,2,3645,[264 291 201 243 295],592,2,10039,2.7534284147010424,0.0,0.0
11646,2,3646,[267 413 219 216 206],130,3,10042,2.7534960241294213,0.0,20.0
11647,2,3647,[246 284 315 280 222],880,4,10046,2.7538377192982457,20.0,20.0
11648,2,3648,[215 326 298 221 431],592,4,10050,2.75417922718553,0.0,20.0
11649,2,3649,[367 300 246 321 331],919,3,10053,2.754246575342466,0.0,20.0
11650,2,3650,[219 202 261 220 251],1,2,10055,2.7540399890440974,0.0,0.0
11651,2,3651,[219 216 481 478 384],896,3,10058,2.7541073384446877,20.0,20.0
11652,2,3652,[392 218 324 240 413],276,3,10061,2.754174650971804,0.0,0.0
11653,2,3653,[420 291 267 452 250],130,4,10065,2.7545155993431854,0.0,0.0
11654,2,3654,[321 299 230 239 290],435,2,10067,2.7543091655266756,0.0,0.0
11655,2,3655,[367 384 226 324 223],276,3,10070,2.7543763676148796,20.0,0.0
11656,2,3656,[206 223 232 280 202],293,2,10072,2.754170084768936,20.0,0.0
11657,2,3657,[227 239 222 240 201],276,5,10077,2.7547840349917987,0.0,20.0
11658,2,3658,[293 218 230 217 246],880,4,10081,2.7551243509155507,0.0,0.0
11659,2,3659,[300 276 420 218 230],276,5,10086,2.7557377049180327,0.0,20.0
11660,2,3660,[283 367 293 365 231],429,1,10087,2.7552581261950286,0.0,0.0
11661,2,3661,[431 378 240 208 219],495,5,10092,2.7558711086837793,0.0,0.0
11662,2,3662,[201 219 276 365 240],682,2,10094,2.7556647556647555,0.0,0.0
11663,2,3663,[429 251 316 280 284],293,2,10096,2.7554585152838427,20.0,0.0
11664,2,3664,[247 256 241 221 218],1,3,10099,2.755525238744884,0.0,0.0
11665,2,3665,[223 431 218 481 344],758,3,10102,2.755591925804692,20.0,0.0
11666,2,3666,[216 218 331 284 217],130,2,10104,2.7553858740114534,0.0,20.0
11667,2,3667,[481 217 218 236 240],758,3,10107,2.755452562704471,0.0,0.0
11668,2,3668,[300 298 367 420 264],435,2,10109,2.75524666121559,0.0,40.0
11669,2,3669,[230 239 293 276 280],347,4,10113,2.75558583106267,0.0,0.0
11670,2,3670,[231 378 209 268 275],727,1,10114,2.7551076001089623,0.0,20.0
11671,2,3671,[290 227 583 316 276],276,4,10118,2.755446623093682,20.0,0.0
11672,2,3672,[384 315 218 206 350],363,0,10118,2.754696433433161,20.0,0.0
11673,2,3673,[239 284 280 232 293],682,2,10120,2.754491017964072,0.0,0.0
11674,2,3674,[509 583 239 244 202],916,3,10123,2.7545578231292516,0.0,0.0
11675,2,3675,[268 226 202 452 239],201,1,10124,2.754080522306855,0.0,20.0
11676,2,3676,[217 222 215 298 223],276,5,10129,2.754691324449279,20.0,40.0
11677,2,3677,[290 316 223 222 211],407,4,10133,2.755029907558456,40.0,20.0
11678,2,3678,[223 264 303 300 297],293,3,10136,2.7550964936123945,20.0,20.0
11679,2,3679,[216 219 326 202 211],201,2,10138,2.7548913043478263,0.0,20.0
11680,2,3680,[243 315 218 209 295],880,3,10141,2.7549578918772073,20.0,0.0
11681,2,3681,[316 202 295 272 291],130,4,10145,2.7552960347637154,40.0,0.0
11682,2,3682,[208 243 264 202 231],1,2,10147,2.755090958457779,0.0,0.0
11683,2,3683,[217 243 508 275 272],919,4,10151,2.75542888165038,20.0,0.0
11684,2,3684,[293 209 321 217 222],327,1,10152,2.7549525101763908,0.0,20.0
11685,2,3685,[275 431 239 365 316],393,3,10155,2.755018990775909,20.0,0.0
11686,2,3686,[222 230 429 215 316],363,2,10157,2.7548142120965555,20.0,20.0
11687,2,3687,[240 452 208 507 291],303,2,10159,2.7546095444685466,0.0,0.0
11688,2,3688,[215 326 232 226 324],201,1,10160,2.7541339116291677,0.0,0.0
11689,2,3689,[331 268 350 276 295],130,3,10163,2.75420054200542,0.0,20.0
11690,2,3690,[367 241 300 384 216],682,2,10165,2.7539962069899757,0.0,40.0
11691,2,3691,[336 283 300 256 243],181,0,10165,2.753250270855905,0.0,20.0
11692,2,3692,[201 219 241 431 272],201,2,10167,2.753046303818034,20.0,0.0
11693,2,3693,[240 326 365 202 255],222,3,10170,2.753113156469951,0.0,0.0
11694,2,3694,[216 254 255 243 246],682,2,10172,2.7529093369418134,0.0,20.0
11695,2,3695,[208 326 246 222 378],222,3,10175,2.7529761904761907,0.0,20.0
11696,2,3696,[326 284 276 509 299],663,3,10178,2.753043007844198,0.0,0.0
11697,2,3697,[298 241 324 508 367],276,4,10182,2.7533802055164953,0.0,20.0
11698,2,3698,[321 240 303 222 275],919,2,10184,2.753176534198432,0.0,20.0
11699,2,3699,[301 280 227 290 291],429,1,10185,2.752702702702703,0.0,0.0
11700,2,3700,[232 216 223 231 583],303,4,10189,2.753039718994866,20.0,20.0
11701,2,3701,[241 230 202 222 213],790,2,10191,2.7528363047001623,0.0,20.0
11702,2,3702,[303 508 284 316 232],276,4,10195,2.753173102889549,20.0,0.0
11703,2,3703,[240 301 481 218 293],758,2,10197,2.7529697624190064,0.0,0.0
11704,2,3704,[291 209 230 250 241],276,4,10201,2.753306342780027,0.0,0.0
11705,2,3705,[255 222 246 583 284],682,3,10204,2.753372908796546,0.0,20.0
11706,2,3706,[227 367 507 217 232],429,2,10206,2.7531696789857025,0.0,0.0
11707,2,3707,[239 201 215 291 222],276,4,10210,2.7535059331175837,0.0,20.0
11708,2,3708,[508 507 420 221 291],303,4,10214,2.753842005931518,0.0,0.0
11709,2,3709,[209 268 213 251 267],1,4,10218,2.754177897574124,0.0,20.0
11710,2,3710,[268 243 264 261 299],592,1,10219,2.7537052007545135,0.0,20.0
11711,2,3711,[223 280 241 384 298],682,2,10221,2.7535021551724137,20.0,20.0
11712,2,3712,[244 216 259 222 243],1,2,10223,2.7532992189604095,0.0,40.0
11713,2,3713,[264 303 299 344 321],3,2,10225,2.753096392030156,0.0,0.0
11714,2,3714,[216 222 508 236 268],592,3,10228,2.7531628532974426,0.0,60.0
11715,2,3715,[284 429 392 291 290],276,3,10231,2.7532292787944024,0.0,0.0
11716,2,3716,[230 315 239 217 452],201,0,10231,2.752488566047888,20.0,0.0
11717,2,3717,[264 211 215 218 219],1,0,10231,2.7517482517482517,0.0,0.0
11718,2,3718,[201 378 367 232 216],429,2,10233,2.751546114546921,0.0,20.0
11719,2,3719,[232 300 324 206 583],276,3,10236,2.7516129032258063,0.0,20.0
11720,2,3720,[420 222 219 201 583],276,4,10240,2.751948400967482,0.0,20.0
11721,2,3721,[227 223 226 326 215],201,2,10242,2.7517463729177862,20.0,0.0
11722,2,3722,[240 290 431 300 367],435,0,10242,2.7510072522159548,0.0,20.0
11723,2,3723,[232 222 452 211 241],268,2,10244,2.7508055853920514,0.0,20.0
11724,2,3724,[230 452 222 232 284],896,3,10247,2.7508724832214764,0.0,20.0
11725,2,3725,[218 236 221 268 251],1,4,10251,2.751207729468599,0.0,20.0
11726,2,3726,[226 227 209 284 201],896,2,10253,2.751006171183257,0.0,0.0
11727,2,3727,[243 259 217 298 219],682,2,10255,2.750804721030043,0.0,20.0
11728,2,3728,[331 206 272 221 231],201,1,10256,2.7503352105122016,20.0,0.0
11729,2,3729,[259 222 280 215 431],682,3,10259,2.750402144772118,0.0,20.0
11730,2,3730,[221 241 201 250 255],303,5,10264,2.751005092468507,0.0,0.0
11731,2,3731,[240 217 298 291 384],682,3,10267,2.7510718113612005,0.0,20.0
11732,2,3732,[290 315 226 215 284],363,0,10267,2.750334851326011,20.0,0.0
11733,2,3733,[367 215 268 264 201],327,4,10271,2.7506695232994107,0.0,20.0
11734,2,3734,[222 264 221 209 201],1,3,10274,2.7507362784471217,0.0,20.0
11735,2,3735,[508 247 452 230 218],222,2,10276,2.7505353319057817,0.0,0.0
11736,2,3736,[215 244 219 275 293],178,4,10280,2.750869681562751,0.0,0.0
11737,2,3737,[316 350 298 293 295],130,4,10284,2.751203852327448,20.0,20.0
11738,2,3738,[230 215 452 231 261],222,2,10286,2.7510029419630917,0.0,0.0
11739,2,3739,[206 316 291 272 226],293,2,10288,2.7508021390374333,40.0,0.0
11740,2,3740,[218 272 206 255 201],1,1,10289,2.7503341352579525,20.0,0.0
11741,2,3741,[276 232 227 236 226],303,4,10293,2.7506680919294495,0.0,0.0
11742,2,3742,[218 222 283 452 236],303,2,10295,2.750467539406893,0.0,20.0
11743,2,3743,[218 219 255 226 367],178,4,10299,2.750801282051282,0.0,0.0
11744,2,3744,[208 283 209 290 251],293,1,10300,2.7503337783711617,0.0,0.0
11745,2,3745,[231 316 217 215 301],363,0,10300,2.7495995728777363,20.0,0.0
11746,2,3746,[218 268 298 241 251],532,5,10305,2.7502001601281023,0.0,40.0
11747,2,3747,[261 223 272 202 250],1,3,10308,2.7502668089647813,40.0,0.0
11748,2,3748,[316 202 226 367 218],130,5,10313,2.750866897839424,20.0,0.0
11749,2,3749,[246 295 219 350 300],130,4,10317,2.7512,0.0,20.0
11750,2,3750,[223 216 241 250 220],1,4,10321,2.7515329245534526,20.0,20.0
11751,2,3751,[431 231 384 300 213],758,2,10323,2.7513326226012795,0.0,20.0
11752,2,3752,[272 223 350 300 218],758,4,10327,2.7516653343991475,40.0,20.0
11753,2,3753,[216 240 431 280 290],286,3,10330,2.7517314864144913,0.0,20.0
11754,2,3754,[420 241 240 219 243],682,2,10332,2.751531291611185,0.0,0.0
11755,2,3755,[236 316 384 291 250],758,5,10337,2.7521299254526093,20.0,0.0
11756,2,3756,[276 220 255 241 240],244,2,10339,2.7519297311684854,0.0,0.0
11757,2,3757,[264 222 303 301 259],592,1,10340,2.751463544438531,0.0,20.0
11758,2,3758,[227 413 230 232 246],727,2,10342,2.7512636339451984,0.0,0.0
11759,2,3759,[241 431 223 324 222],201,2,10344,2.751063829787234,20.0,20.0
11760,2,3760,[240 326 206 331 303],201,1,10345,2.7505982451475672,0.0,0.0
11761,2,3761,[321 243 246 284 250],919,0,10345,2.749867091972355,0.0,0.0
11762,2,3762,[324 315 291 303 583],276,3,10348,2.749933563646027,20.0,0.0
11763,2,3763,[509 291 216 280 230],293,1,10349,2.7494686503719445,0.0,20.0
11764,2,3764,[264 367 232 202 365],276,1,10350,2.749003984063745,0.0,0.0
11765,2,3765,[283 272 297 223 209],293,3,10353,2.7490706319702602,40.0,0.0
11766,2,3766,[218 202 315 392 452],130,5,10358,2.7496681709583224,20.0,0.0
11767,2,3767,[268 259 219 365 231],682,1,10359,2.749203821656051,0.0,20.0
11768,2,3768,[222 264 298 241 283],299,1,10360,2.748739718758291,0.0,40.0
11769,2,3769,[217 392 218 227 216],472,5,10365,2.749336870026525,0.0,20.0
11770,2,3770,[293 241 215 201 216],606,4,10369,2.7496685229382125,0.0,20.0
11771,2,3771,[316 508 431 272 295],532,5,10374,2.7502651113467658,40.0,0.0
11772,2,3772,[250 219 276 208 297],889,3,10377,2.7503313013517094,0.0,0.0
11773,2,3773,[295 300 272 230 239],130,3,10380,2.750397456279809,20.0,20.0
11774,2,3774,[384 295 316 250 298],880,3,10383,2.7504635761589404,20.0,20.0
11775,2,3775,[259 326 236 218 241],303,3,10386,2.750529661016949,0.0,0.0
11776,2,3776,[481 298 452 227 231],758,3,10389,2.750595710881652,0.0,20.0
11777,2,3777,[232 478 202 300 223],896,2,10391,2.750397035468502,40.0,20.0
11778,2,3778,[222 250 283 290 275],864,3,10394,2.7504630854723473,0.0,20.0
11779,2,3779,[268 209 222 202 367],886,4,10398,2.750793650793651,0.0,40.0
11780,2,3780,[261 230 326 413 232],222,3,10401,2.7508595609627084,0.0,0.0
11781,2,3781,[240 231 272 250 239],276,4,10405,2.751189846641988,20.0,0.0
11782,2,3782,[244 217 223 209 250],407,4,10409,2.7515199577055247,20.0,0.0
11783,2,3783,[227 392 331 215 367],435,2,10411,2.751321353065539,0.0,0.0
11784,2,3784,[378 243 431 365 272],393,3,10414,2.7513870541611625,20.0,0.0
11785,2,3785,[316 217 291 243 202],130,3,10417,2.7514527205493926,20.0,0.0
11786,2,3786,[212 215 275 324 268],201,4,10421,2.7517824135199365,0.0,20.0
11787,2,3787,[272 297 350 301 213],758,4,10425,2.7521119324181624,20.0,0.0
11788,2,3788,[236 217 420 452 344],758,1,10426,2.7516495117445237,0.0,0.0
11789,2,3789,[218 240 392 236 290],130,4,10430,2.7519788918205803,0.0,0.0
11790,2,3790,[223 231 324 227 452],276,3,10433,2.7520443154840413,20.0,0.0
11791,2,3791,[222 431 280 420 321],393,2,10435,2.7518459915611815,0.0,20.0
11792,2,3792,[202 239 284 259 272],682,3,10438,2.7519114157658846,20.0,0.0
11793,2,3793,[276 316 326 280 431],178,4,10442,2.752240379546653,20.0,0.0
11794,2,3794,[250 420 276 251 283],303,4,10446,2.7525691699604744,0.0,0.0
11795,2,3795,[300 420 367 384 231],303,3,10449,2.7526343519494203,0.0,20.0
11796,2,3796,[209 246 276 284 508],178,3,10452,2.7526994996049514,0.0,0.0
11797,2,3797,[509 219 583 268 227],94,3,10455,2.7527646129541865,0.0,20.0
11798,2,3798,[201 209 507 478 222],561,3,10458,2.752829692024217,20.0,20.0
11799,2,3799,[365 275 241 226 583],429,1,10459,2.7523684210526316,0.0,0.0
11800,2,3800,[384 230 215 508 231],933,0,10459,2.751644304130492,0.0,0.0
11801,2,3801,[246 413 284 583 251],303,3,10462,2.751709626512362,0.0,0.0
11802,2,3802,[215 231 284 211 291],896,3,10465,2.751774914541152,0.0,0.0
11803,2,3803,[293 272 208 300 250],880,3,10468,2.751840168243954,20.0,20.0
11804,2,3804,[485 283 206 239 344],393,1,10469,2.7513797634691195,0.0,0.0
11805,2,3805,[212 326 226 232 413],201,1,10470,2.750919600630583,0.0,0.0
11806,2,3806,[392 284 226 295 276],130,3,10473,2.7509850275807723,0.0,0.0
11807,2,3807,[264 350 246 261 331],592,2,10475,2.7507878151260505,0.0,0.0
11808,2,3808,[298 321 508 202 208],429,4,10479,2.751115778419533,0.0,20.0
11809,2,3809,[202 208 222 239 217],886,1,10480,2.7506561679790025,0.0,20.0
11810,2,3810,[223 236 300 276 509],758,3,10483,2.7507215953817896,20.0,20.0
11811,2,3811,[259 255 300 230 232],178,4,10487,2.7510493179433366,0.0,20.0
11812,2,3812,[202 217 316 298 255],293,1,10488,2.7505900865460267,20.0,20.0
11813,2,3813,[209 276 255 297 275],299,2,10490,2.750393287886733,0.0,0.0
11814,2,3814,[208 216 240 251 250],293,2,10492,2.750196592398427,0.0,20.0
11815,2,3815,[215 239 392 420 226],435,3,10495,2.7502620545073375,0.0,0.0
11816,2,3816,[209 507 283 509 298],293,2,10497,2.750065496463191,0.0,20.0
11817,2,3817,[250 413 431 392 295],109,1,10498,2.749607124148769,0.0,0.0
11818,2,3818,[300 261 284 280 231],222,1,10499,2.749148991882692,0.0,20.0
11819,2,3819,[276 331 222 240 326],201,2,10501,2.748952879581152,0.0,20.0
11820,2,3820,[241 226 291 239 208],347,3,10504,2.7490185815231616,0.0,0.0
11821,2,3821,[246 272 300 218 268],880,4,10508,2.749345892203035,20.0,40.0
11822,2,3822,[218 254 243 293 250],682,2,10510,2.7491498822913942,0.0,0.0
11823,2,3823,[218 244 223 219 280],916,2,10512,2.7489539748953975,20.0,0.0
11824,2,3824,[280 250 384 227 272],393,4,10516,2.749281045751634,20.0,0.0
11825,2,3825,[240 226 231 250 384],267,3,10519,2.7493465760585467,0.0,0.0
11826,2,3826,[250 367 206 201 227],896,2,10521,2.749150770838777,0.0,0.0
11827,2,3827,[206 268 246 284 218],916,2,10523,2.748955067920585,0.0,20.0
11828,2,3828,[239 251 367 216 298],299,4,10527,2.7492817968137895,0.0,40.0
11829,2,3829,[250 251 206 218 315],293,2,10529,2.7490861618798954,20.0,0.0
11830,2,3830,[213 217 223 350 452],758,3,10532,2.7491516575306707,20.0,0.0
11831,2,3831,[365 392 413 247 280],222,2,10534,2.748956158663883,0.0,0.0
11832,2,3832,[215 240 211 326 272],201,0,10534,2.7482389773023743,20.0,0.0
11833,2,3833,[283 206 272 215 378],393,3,10537,2.7483046426708397,20.0,0.0
11834,2,3834,[293 240 223 284 384],291,5,10542,2.7488917861799216,20.0,0.0
11835,2,3835,[230 219 392 508 226],896,1,10543,2.7484358706986445,0.0,0.0
11836,2,3836,[209 280 298 507 208],293,2,10545,2.748240813135262,0.0,20.0
11837,2,3837,[326 241 284 331 231],201,1,10546,2.747785304846274,0.0,0.0
11838,2,3838,[215 201 331 324 250],592,4,10550,2.7481114873665016,0.0,0.0
11839,2,3839,[420 394 216 219 321],435,3,10553,2.748177083333333,0.0,20.0
11840,2,3840,[290 222 431 230 217],276,4,10557,2.748502994011976,0.0,20.0
11841,2,3841,[243 303 250 227 298],393,5,10562,2.7490890161374284,0.0,20.0
11842,2,3842,[300 239 293 301 230],758,1,10563,2.748633879781421,0.0,20.0
11843,2,3843,[206 211 241 230 222],916,2,10565,2.74843912591051,0.0,20.0
11844,2,3844,[255 298 219 431 247],222,3,10568,2.74850455136541,0.0,20.0
11845,2,3845,[208 240 246 211 239],889,4,10572,2.7488299531981277,0.0,0.0
11846,2,3846,[420 250 509 201 232],682,2,10574,2.7486353002339485,0.0,0.0
11847,2,3847,[291 420 221 508 218],303,4,10578,2.748960498960499,0.0,0.0
11848,2,3848,[452 254 303 209 230],276,3,10581,2.749025720966485,0.0,0.0
11849,2,3849,[509 211 232 291 222],551,5,10586,2.7496103896103894,0.0,20.0
11850,2,3850,[326 222 240 275 227],201,2,10588,2.749415736172423,0.0,20.0
11851,2,3851,[280 241 226 230 247],222,1,10589,2.7489615784008308,0.0,0.0
11852,2,3852,[215 276 378 226 230],222,3,10592,2.749026732416299,0.0,0.0
11853,2,3853,[254 211 206 250 264],1,2,10594,2.748832381940841,0.0,0.0
11854,2,3854,[201 223 206 250 290],276,5,10599,2.7494163424124514,20.0,0.0
11855,2,3855,[222 241 452 246 293],222,2,10601,2.7492219917012446,0.0,20.0
11856,2,3856,[219 293 431 300 303],276,4,10605,2.749546279491833,0.0,20.0
11857,2,3857,[331 223 202 291 315],758,5,10610,2.750129600829445,40.0,0.0
11858,2,3858,[298 213 250 216 583],916,4,10614,2.7504534853589013,0.0,40.0
11859,2,3859,[231 208 272 250 331],758,4,10618,2.750777202072539,20.0,0.0
11860,2,3860,[250 413 290 251 293],303,4,10622,2.751100751100751,0.0,0.0
11861,2,3861,[326 246 223 378 216],222,4,10626,2.751424132573796,20.0,20.0
11862,2,3862,[413 250 367 431 222],222,2,10628,2.7512296142894126,0.0,20.0
11863,2,3863,[239 299 300 293 326],130,4,10632,2.751552795031056,0.0,20.0
11864,2,3864,[298 280 230 219 508],429,3,10635,2.7516170763260024,0.0,20.0
11865,2,3865,[241 239 481 284 202],896,4,10639,2.7519399896533887,0.0,0.0
11866,2,3866,[300 297 218 244 272],919,4,10643,2.752262735971037,20.0,20.0
11867,2,3867,[236 344 208 508 213],758,4,10647,2.7525853154084796,0.0,0.0
11868,2,3868,[324 218 251 268 264],773,1,10648,2.7521323339364177,0.0,20.0
11869,2,3869,[241 211 261 251 240],1,2,10650,2.751937984496124,0.0,0.0
11870,2,3870,[217 431 384 222 301],276,3,10653,2.7520020666494447,0.0,20.0
11871,2,3871,[251 378 241 255 244],299,1,10654,2.7515495867768593,0.0,0.0
11872,2,3872,[215 246 283 268 255],500,2,10656,2.7513555383423705,0.0,20.0
11873,2,3873,[217 276 316 431 231],276,3,10659,2.751419721218379,20.0,0.0
11874,2,3874,[291 217 297 290 344],758,3,10662,2.751483870967742,0.0,0.0
11875,2,3875,[222 284 211 250 241],896,4,10666,2.7518059855521155,0.0,20.0
11876,2,3876,[300 232 227 250 583],429,1,10667,2.7513541397988135,0.0,20.0
11877,2,3877,[268 227 222 295 300],880,3,10670,2.751418256833419,0.0,60.0
11878,2,3878,[290 324 250 202 268],303,4,10674,2.7517401392111367,0.0,20.0
11879,2,3879,[300 254 241 413 246],276,3,10677,2.75180412371134,0.0,20.0
11880,2,3880,[239 367 206 246 299],130,3,10680,2.7518680752383404,0.0,0.0
11881,2,3881,[226 223 300 227 251],293,2,10682,2.7516743946419373,20.0,20.0
11882,2,3882,[208 254 300 293 276],880,3,10685,2.7517383466391965,0.0,20.0
11883,2,3883,[217 239 378 240 216],868,1,10686,2.751287332646756,0.0,20.0
11884,2,3884,[227 293 254 202 246],130,3,10689,2.7513513513513512,0.0,0.0
11885,2,3885,[298 431 219 321 227],429,3,10692,2.7514153371075656,0.0,20.0
11886,2,3886,[420 293 301 291 231],758,1,10693,2.7509647543092357,0.0,0.0
11887,2,3887,[420 272 254 255 236],130,4,10697,2.7512860082304527,20.0,0.0
11888,2,3888,[324 298 300 272 236],936,4,10701,2.7516070969400874,20.0,40.0
11889,2,3889,[272 300 240 223 211],682,3,10704,2.7516709511568123,40.0,20.0
11890,2,3890,[276 390 209 283 583],303,2,10706,2.7514777692109997,0.0,0.0
11891,2,3891,[216 211 284 255 264],435,1,10707,2.751027749229188,0.0,20.0
11892,2,3892,[230 232 478 268 226],561,1,10708,2.750577960441819,20.0,20.0
11893,2,3893,[227 239 222 284 394],880,3,10711,2.7506420133538776,0.0,20.0
11894,2,3894,[301 226 231 201 250],363,0,10711,2.749935815147625,0.0,0.0
11895,2,3895,[301 231 250 324 481],758,3,10714,2.75,0.0,0.0
11896,2,3896,[250 232 378 431 275],790,3,10717,2.750064151911727,0.0,0.0
11897,2,3897,[324 219 331 303 508],201,4,10721,2.750384812724474,0.0,0.0
11898,2,3898,[227 202 365 300 367],429,1,10722,2.749935880995127,0.0,20.0
11899,2,3899,[226 232 290 202 478],407,2,10724,2.7497435897435896,20.0,0.0
11900,2,3900,[222 268 208 219 431],94,4,10728,2.750064086131761,0.0,40.0
11901,2,3901,[217 291 326 331 219],130,3,10731,2.7501281394156845,0.0,0.0
11902,2,3902,[315 293 284 365 209],276,4,10735,2.7504483730463747,20.0,0.0
11903,2,3903,[202 208 241 481 244],299,2,10737,2.7502561475409837,0.0,0.0
11904,2,3904,[250 290 283 284 208],363,1,10738,2.749807938540333,0.0,0.0
11905,2,3905,[272 219 215 218 217],201,2,10740,2.749615975422427,20.0,0.0
11906,2,3906,[478 227 508 291 392],896,2,10742,2.7494241105707706,20.0,0.0
11907,2,3907,[208 301 231 216 201],363,1,10743,2.7489764585465712,0.0,20.0
11908,2,3908,[583 300 275 217 264],293,0,10743,2.748273215656178,0.0,20.0
11909,2,3909,[256 303 280 284 221],181,1,10744,2.747826086956522,0.0,0.0
11910,2,3910,[223 336 315 256 201],363,2,10746,2.747634875990795,40.0,0.0
11911,2,3911,[315 236 324 239 298],758,4,10750,2.747955010224949,20.0,20.0
11912,2,3912,[221 276 259 268 246],592,4,10754,2.7482749808331204,0.0,20.0
11913,2,3913,[316 219 218 226 367],130,5,10759,2.748850281042412,20.0,0.0
11914,2,3914,[202 254 232 276 223],682,1,10760,2.7484035759897827,20.0,0.0
11915,2,3915,[268 226 367 507 206],727,1,10761,2.7479570990806947,0.0,20.0
11916,2,3916,[276 241 202 226 298],757,3,10764,2.7480214449834057,0.0,20.0
11917,2,3917,[219 452 267 264 240],268,0,10764,2.747320061255743,0.0,0.0
11918,2,3918,[301 218 208 227 216],758,4,10768,2.747639704006124,0.0,20.0
11919,2,3919,[246 259 290 452 227],268,2,10770,2.747448979591837,0.0,0.0
11920,2,3920,[239 378 215 384 227],472,4,10774,2.747768426421831,0.0,0.0
11921,2,3921,[241 216 215 478 226],846,5,10779,2.7483426823049464,20.0,20.0
11922,2,3922,[206 231 209 240 216],267,5,10784,2.74891664542442,0.0,20.0
11923,2,3923,[209 316 250 218 255],407,5,10789,2.7494903160040773,20.0,0.0
11924,2,3924,[241 268 508 324 429],276,5,10794,2.750063694267516,0.0,20.0
11925,2,3925,[232 384 367 284 209],880,3,10797,2.750127356087621,0.0,0.0
11926,2,3926,[283 276 232 222 219],178,4,10801,2.750445632798574,0.0,20.0
11927,2,3927,[223 392 331 201 272],276,4,10805,2.750763747454175,40.0,0.0
11928,2,3928,[384 452 215 324 232],276,2,10807,2.750572664800204,0.0,0.0
11929,2,3929,[241 223 485 206 344],393,2,10809,2.7503816793893128,20.0,0.0
11930,2,3930,[239 431 222 217 209],916,1,10810,2.7499364029509032,0.0,20.0
11931,2,3931,[239 507 232 240 230],561,1,10811,2.749491353001017,0.0,0.0
11932,2,3932,[350 221 283 264 216],592,4,10815,2.749809305873379,0.0,20.0
11933,2,3933,[213 227 485 272 283],293,1,10816,2.7493645144890695,20.0,0.0
11934,2,3934,[413 452 236 261 298],130,4,10820,2.7496823379923763,0.0,20.0
11935,2,3935,[384 367 209 246 239],880,3,10823,2.7497459349593494,0.0,0.0
11936,2,3936,[280 254 246 255 217],682,2,10825,2.7495554991109983,0.0,0.0
11937,2,3937,[413 299 276 240 326],181,0,10825,2.748857287963433,0.0,0.0
11938,2,3938,[331 431 250 202 230],276,4,10829,2.7491749174917492,0.0,0.0
11939,2,3939,[231 222 227 219 209],201,2,10831,2.748984771573604,0.0,20.0
11940,2,3940,[255 300 303 250 218],919,4,10835,2.7493022075615325,0.0,20.0
11941,2,3941,[326 208 268 227 283],303,2,10837,2.7491121258244546,0.0,20.0
11942,2,3942,[221 222 218 232 390],303,3,10840,2.7491757545016484,0.0,20.0
11943,2,3943,[290 243 326 231 420],130,2,10842,2.7489858012170387,0.0,0.0
11944,2,3944,[232 208 276 216 246],244,5,10847,2.749556400506971,0.0,20.0
11945,2,3945,[331 254 300 272 243],130,2,10849,2.749366447034972,20.0,20.0
11946,2,3946,[209 221 255 208 240],303,4,10853,2.749683303775019,0.0,0.0
11947,2,3947,[420 254 298 219 226],276,4,10857,2.75,0.0,20.0
11948,2,3948,[276 240 508 213 293],758,2,10859,2.7498100785008863,0.0,0.0
11949,2,3949,[239 280 392 298 230],222,4,10863,2.750126582278481,0.0,20.0
11950,2,3950,[209 326 208 202 508],303,4,10867,2.750442925841559,0.0,0.0
11951,2,3951,[255 509 280 290 213],293,0,10867,2.749746963562753,0.0,0.0
11952,2,3952,[276 431 241 300 231],429,2,10869,2.7495572982544902,0.0,20.0
11953,2,3953,[275 250 222 378 259],790,2,10871,2.7493677288821448,0.0,20.0
11954,2,3954,[216 213 297 293 227],758,4,10875,2.74968394437421,0.0,20.0
11955,2,3955,[365 431 509 259 201],682,2,10877,2.749494438827098,0.0,0.0
11956,2,3956,[508 298 295 268 276],919,2,10879,2.749305029062421,0.0,40.0
11957,2,3957,[230 240 223 222 303],276,5,10884,2.7498736735725116,20.0,20.0
11958,2,3958,[226 232 315 291 231],407,2,10886,2.7496842637029553,20.0,0.0
11959,2,3959,[240 276 206 272 331],201,2,10888,2.7494949494949497,20.0,0.0
11960,2,3960,[232 247 226 268 293],222,2,10890,2.7493057308760416,0.0,20.0
11961,2,3961,[259 336 508 300 321],181,0,10890,2.7486118122160526,0.0,20.0
11962,2,3962,[221 217 239 212 223],201,2,10892,2.7484229119354024,20.0,0.0
11963,2,3963,[227 223 215 231 232],363,2,10894,2.748234106962664,20.0,0.0
11964,2,3964,[275 213 231 209 232],201,2,10896,2.748045397225725,0.0,0.0
11965,2,3965,[202 275 283 300 507],293,1,10897,2.7476046394351994,0.0,20.0
11966,2,3966,[378 290 291 226 241],429,1,10898,2.747164103856819,0.0,0.0
11967,2,3967,[272 268 276 316 321],624,5,10903,2.7477318548387095,40.0,20.0
11968,2,3968,[239 222 240 392 384],276,3,10906,2.747795414462081,0.0,20.0
11969,2,3969,[261 246 508 206 452],130,4,10910,2.748110831234257,0.0,0.0
11970,2,3970,[226 244 211 261 206],1,1,10911,2.74767061193654,0.0,0.0
11971,2,3971,[367 217 300 276 264],429,1,10912,2.7472306143001006,0.0,20.0
11972,2,3972,[212 230 206 268 211],561,1,10913,2.7467908381575636,0.0,20.0
11973,2,3973,[264 241 239 244 209],1,3,10916,2.746854554604932,0.0,0.0
11974,2,3974,[201 507 413 259 226],727,2,10918,2.7466666666666666,0.0,0.0
11975,2,3975,[259 290 222 208 244],268,3,10921,2.7467303822937628,0.0,20.0
11976,2,3976,[276 284 215 218 232],561,1,10922,2.7462911742519487,0.0,0.0
11977,2,3977,[276 219 212 250 221],916,4,10926,2.746606334841629,0.0,0.0
11978,2,3978,[303 250 276 326 221],592,5,10931,2.7471726564463435,0.0,0.0
11979,2,3979,[215 276 297 222 261],592,3,10934,2.7472361809045225,0.0,20.0
11980,2,3980,[217 392 298 291 216],130,4,10938,2.747550866616428,0.0,40.0
11981,2,3981,[223 240 508 209 301],758,3,10941,2.74761426418885,20.0,0.0
11982,2,3982,[316 209 508 201 227],880,3,10944,2.747677629927191,20.0,0.0
11983,2,3983,[508 219 218 211 367],429,3,10947,2.7477409638554215,0.0,0.0
11984,2,3984,[230 216 215 231 284],301,4,10951,2.748055207026349,0.0,20.0
11985,2,3985,[227 431 300 231 240],758,1,10952,2.7476166583040644,0.0,20.0
11986,2,3986,[316 213 240 209 324],758,4,10956,2.747930775018811,20.0,0.0
11987,2,3987,[240 324 301 212 231],758,2,10958,2.747743229689067,0.0,0.0
11988,2,3988,[291 202 508 264 251],592,3,10961,2.7478064677864125,0.0,0.0
11989,2,3989,[202 315 218 230 222],880,4,10965,2.7481203007518795,20.0,20.0
11990,2,3990,[284 583 301 392 217],276,3,10968,2.7481834126785265,0.0,0.0
11991,2,3991,[276 413 243 316 261],130,3,10971,2.748246492985972,20.0,0.0
11992,2,3992,[202 217 254 227 201],276,4,10975,2.7485599799649387,0.0,0.0
11993,2,3993,[222 202 231 246 507],303,4,10979,2.7488733099649476,0.0,20.0
11994,2,3994,[272 209 316 208 222],660,4,10983,2.74918648310388,40.0,20.0
11995,2,3995,[431 241 392 227 216],521,2,10985,2.748998998998999,0.0,20.0
11996,2,3996,[284 240 264 301 255],919,1,10986,2.748561421065799,0.0,0.0
11997,2,3997,[226 208 231 264 239],268,3,10989,2.748624312156078,0.0,0.0
11998,2,3998,[240 201 250 272 239],682,4,10993,2.748937234308577,20.0,0.0
11999,2,3999,[431 218 241 209 222],178,4,10997,2.74925,0.0,20.0
