,iteration,visit,item_id_list,visitor_id,reward,total_reward,fraction_relevant,percentage_overlap_rating,percentage_overlap_like
0,0,0,[384 367 227 420 394],13,2,2,2.0,0.0,0.0
1,0,1,[222 208 232 239 211],897,4,6,3.0,0.0,40.0
2,0,2,[227 420 222 232 211],64,2,8,2.6666666666666665,0.0,40.0
3,0,3,[222 211 208 227 420],882,5,13,3.25,0.0,40.0
4,0,4,[222 211 208 227 420],311,3,16,3.2,0.0,40.0
5,0,5,[222 208 227 211 420],311,3,19,3.1666666666666665,0.0,40.0
6,0,6,[222 208 227 211 232],311,3,22,3.142857142857143,0.0,40.0
7,0,7,[222 208 227 211 420],843,0,22,2.75,0.0,40.0
8,0,8,[222 208 227 211 420],843,0,22,2.4444444444444446,0.0,40.0
9,0,9,[222 208 227 211 232],650,3,25,2.5,0.0,40.0
10,0,10,[222 208 227 211 420],650,3,28,2.5454545454545454,0.0,40.0
11,0,11,[219 481 239 284 208],308,3,31,2.5833333333333335,0.0,0.0
12,0,12,[284 481 208 222 211],82,3,34,2.6153846153846154,0.0,40.0
13,0,13,[284 481 208 222 211],82,3,37,2.642857142857143,0.0,40.0
14,0,14,[284 481 208 222 211],194,1,38,2.533333333333333,0.0,40.0
15,0,15,[284 481 208 222 211],406,1,39,2.4375,0.0,40.0
16,0,16,[211 284 481 208 222],194,1,40,2.3529411764705883,0.0,40.0
17,0,17,[211 208 222 227 481],524,3,43,2.388888888888889,0.0,40.0
18,0,18,[211 481 208 222 284],474,4,47,2.473684210526316,0.0,40.0
19,0,19,[211 481 284 208 222],194,1,48,2.4,0.0,40.0
20,0,20,[211 481 208 222 284],194,1,49,2.3333333333333335,0.0,40.0
21,0,21,[211 481 208 222 227],13,3,52,2.3636363636363638,0.0,40.0
22,0,22,[211 208 227 481 222],474,4,56,2.4347826086956523,0.0,40.0
23,0,23,[211 227 481 208 222],474,4,60,2.5,0.0,40.0
24,0,24,[221 298 215 420 230],85,3,63,2.52,0.0,0.0
25,0,25,[298 215 211 227 481],474,4,67,2.576923076923077,0.0,20.0
26,0,26,[215 211 227 481 222],474,5,72,2.6666666666666665,0.0,40.0
27,0,27,[215 211 227 481 222],328,1,73,2.607142857142857,0.0,40.0
28,0,28,[241 481 298 275 230],308,5,78,2.689655172413793,0.0,20.0
29,0,29,[241 275 211 215 298],308,4,82,2.7333333333333334,0.0,40.0
30,0,30,[211 219 259 216 321],279,2,84,2.7096774193548385,0.0,20.0
31,0,31,[316 284 215 230 226],328,1,85,2.65625,20.0,0.0
32,0,32,[241 321 316 275 211],13,2,87,2.6363636363636362,20.0,40.0
33,0,33,[350 215 303 290 315],13,4,91,2.676470588235294,20.0,0.0
34,0,34,[478 222 223 202 507],650,3,94,2.6857142857142855,20.0,20.0
35,0,35,[303 315 290 507 316],13,4,98,2.7222222222222223,40.0,0.0
36,0,36,[232 261 275 431 350],13,0,98,2.6486486486486487,0.0,20.0
37,0,37,[300 231 485 208 241],537,1,99,2.6052631578947367,0.0,20.0
38,0,38,[303 290 315 316 478],13,5,104,2.6666666666666665,40.0,0.0
39,0,39,[303 290 315 316 478],13,5,109,2.725,40.0,0.0
40,0,40,[217 350 276 303 429],13,3,112,2.731707317073171,0.0,20.0
41,0,41,[303 290 315 316 478],13,5,117,2.7857142857142856,40.0,0.0
42,0,42,[303 290 315 316 478],13,5,122,2.8372093023255816,40.0,0.0
43,0,43,[315 215 272 217 202],13,4,126,2.8636363636363638,20.0,0.0
44,0,44,[303 316 315 478 429],13,5,131,2.911111111111111,40.0,0.0
45,0,45,[254 222 216 239 215],804,5,136,2.9565217391304346,0.0,20.0
46,0,46,[478 303 272 315 429],13,5,141,3.0,20.0,0.0
47,0,47,[507 206 508 301 272],537,3,144,3.0,0.0,0.0
48,0,48,[508 303 272 315 429],13,4,148,3.020408163265306,20.0,0.0
49,0,49,[478 303 272 315 429],13,5,153,3.06,20.0,0.0
50,0,50,[478 303 272 315 429],537,4,157,3.0784313725490198,20.0,0.0
51,0,51,[300 508 293 230 275],455,4,161,3.0961538461538463,0.0,40.0
52,0,52,[223 276 367 216 230],308,4,165,3.1132075471698113,20.0,20.0
53,0,53,[413 331 429 299 420],13,2,167,3.0925925925925926,0.0,0.0
54,0,54,[316 222 241 206 478],234,2,169,3.0727272727272728,20.0,20.0
55,0,55,[303 272 316 293 315],334,4,173,3.0892857142857144,40.0,0.0
56,0,56,[452 507 583 321 218],308,2,175,3.0701754385964914,0.0,0.0
57,0,57,[227 283 326 244 221],334,2,177,3.0517241379310347,0.0,0.0
58,0,58,[316 276 303 272 315],894,5,182,3.0847457627118646,40.0,20.0
59,0,59,[316 276 303 272 315],13,5,187,3.1166666666666667,40.0,20.0
60,0,60,[316 276 303 272 315],894,5,192,3.1475409836065573,40.0,20.0
61,0,61,[264 420 239 226 215],13,5,197,3.1774193548387095,0.0,0.0
62,0,62,[316 276 290 283 303],894,3,200,3.1746031746031744,20.0,20.0
63,0,63,[223 268 367 217 227],387,2,202,3.15625,20.0,0.0
64,0,64,[227 452 232 316 367],650,0,202,3.1076923076923078,20.0,0.0
65,0,65,[211 240 284 326 485],749,4,206,3.121212121212121,0.0,20.0
66,0,66,[420 230 392 202 227],881,4,210,3.1343283582089554,0.0,0.0
67,0,67,[452 218 321 226 508],13,1,211,3.1029411764705883,0.0,0.0
68,0,68,[300 211 208 485 231],313,2,213,3.0869565217391304,0.0,40.0
69,0,69,[246 227 331 219 217],145,3,216,3.085714285714286,0.0,0.0
70,0,70,[246 276 272 315 303],894,5,221,3.112676056338028,20.0,20.0
71,0,71,[246 276 272 315 303],334,5,226,3.138888888888889,20.0,20.0
72,0,72,[246 276 272 315 303],894,5,231,3.164383561643836,20.0,20.0
73,0,73,[246 276 272 315 303],334,5,236,3.189189189189189,20.0,20.0
74,0,74,[246 276 272 315 303],334,5,241,3.2133333333333334,20.0,20.0
75,0,75,[202 227 331 243 280],13,3,244,3.210526315789474,0.0,0.0
76,0,76,[246 276 272 315 303],894,5,249,3.2337662337662336,20.0,20.0
77,0,77,[246 276 272 315 303],334,5,254,3.2564102564102564,20.0,20.0
78,0,78,[202 241 255 226 276],308,4,258,3.2658227848101267,0.0,20.0
79,0,79,[300 201 485 243 301],13,0,258,3.225,0.0,20.0
80,0,80,[209 208 283 268 213],334,4,262,3.234567901234568,0.0,0.0
81,0,81,[216 259 509 239 250],279,1,263,3.207317073170732,0.0,0.0
82,0,82,[293 239 275 236 250],334,2,265,3.1927710843373496,0.0,20.0
83,0,83,[246 324 316 344 213],894,4,269,3.2023809523809526,20.0,0.0
84,0,84,[268 222 508 211 206],537,3,272,3.2,0.0,40.0
85,0,85,[216 378 507 219 251],385,0,272,3.1627906976744184,20.0,0.0
86,0,86,[246 280 236 272 303],894,4,276,3.1724137931034484,0.0,0.0
87,0,87,[231 509 227 226 326],378,1,277,3.147727272727273,0.0,0.0
88,0,88,[290 202 241 283 212],537,1,278,3.1235955056179776,0.0,0.0
89,0,89,[367 290 232 315 331],13,2,280,3.111111111111111,20.0,0.0
90,0,90,[227 478 216 485 202],398,3,283,3.10989010989011,0.0,0.0
91,0,91,[268 336 275 485 232],13,1,284,3.0869565217391304,0.0,20.0
92,0,92,[507 481 209 218 301],90,5,289,3.10752688172043,0.0,0.0
93,0,93,[226 321 316 300 222],13,2,291,3.095744680851064,20.0,40.0
94,0,94,[507 212 429 378 431],7,4,295,3.1052631578947367,0.0,0.0
95,0,95,[509 301 315 299 202],13,3,298,3.1041666666666665,20.0,0.0
96,0,96,[209 215 202 212 291],537,1,299,3.082474226804124,0.0,0.0
97,0,97,[367 211 275 301 290],13,2,301,3.0714285714285716,0.0,40.0
98,0,98,[452 384 267 367 429],833,0,301,3.04040404040404,0.0,0.0
99,0,99,[218 232 222 217 216],295,4,305,3.05,0.0,20.0
100,0,100,[255 246 272 303 315],894,4,309,3.0594059405940595,20.0,0.0
101,0,101,[227 367 211 223 321],13,3,312,3.0588235294117645,20.0,20.0
102,0,102,[268 222 241 481 202],13,2,314,3.0485436893203883,0.0,20.0
103,0,103,[222 219 507 220 215],406,1,315,3.0288461538461537,0.0,20.0
104,0,104,[344 321 331 226 215],13,2,317,3.019047619047619,0.0,0.0
105,0,105,[254 209 211 384 431],279,4,321,3.0283018867924527,0.0,20.0
106,0,106,[250 283 226 331 284],548,3,324,3.02803738317757,0.0,0.0
107,0,107,[264 485 230 413 222],13,1,325,3.009259259259259,0.0,20.0
108,0,108,[219 215 211 431 452],843,0,325,2.981651376146789,0.0,20.0
109,0,109,[236 209 226 284 219],234,1,326,2.963636363636364,0.0,0.0
110,0,110,[392 367 215 226 280],378,1,327,2.945945945945946,0.0,0.0
111,0,111,[303 216 290 261 276],13,3,330,2.9464285714285716,0.0,20.0
112,0,112,[215 431 211 300 326],454,3,333,2.9469026548672566,0.0,40.0
113,0,113,[232 378 485 223 481],7,4,337,2.956140350877193,20.0,0.0
114,0,114,[223 212 509 384 275],7,3,340,2.9565217391304346,20.0,20.0
115,0,115,[316 213 485 268 222],334,4,344,2.9655172413793105,20.0,20.0
116,0,116,[291 507 222 215 218],234,1,345,2.948717948717949,0.0,20.0
117,0,117,[367 275 295 216 255],533,3,348,2.9491525423728815,0.0,20.0
118,0,118,[509 211 239 230 367],650,2,350,2.9411764705882355,0.0,20.0
119,0,119,[208 211 321 206 239],537,2,352,2.933333333333333,0.0,20.0
120,0,120,[284 227 350 275 232],328,1,353,2.9173553719008263,0.0,20.0
121,0,121,[303 315 276 213 246],334,5,358,2.9344262295081966,20.0,20.0
122,0,122,[303 315 276 213 246],334,5,363,2.951219512195122,20.0,20.0
123,0,123,[303 315 276 213 246],894,5,368,2.967741935483871,20.0,20.0
124,0,124,[246 303 239 221 213],334,4,372,2.976,0.0,0.0
125,0,125,[276 213 303 272 295],894,4,376,2.984126984126984,0.0,20.0
126,0,126,[315 241 378 236 284],537,1,377,2.968503937007874,20.0,0.0
127,0,127,[303 213 264 272 276],894,4,381,2.9765625,0.0,20.0
128,0,128,[303 315 272 276 213],537,5,386,2.992248062015504,20.0,20.0
129,0,129,[303 315 272 276 213],894,5,391,3.0076923076923077,20.0,20.0
130,0,130,[250 272 221 276 326],334,3,394,3.0076335877862594,0.0,20.0
131,0,131,[254 321 293 216 284],308,2,396,3.0,0.0,0.0
132,0,132,[254 201 226 236 219],279,3,399,3.0,0.0,0.0
133,0,133,[222 367 211 259 212],194,1,400,2.985074626865672,0.0,40.0
134,0,134,[303 209 293 298 316],144,3,403,2.9851851851851854,20.0,0.0
135,0,135,[222 202 231 239 478],537,1,404,2.9705882352941178,0.0,20.0
136,0,136,[290 241 507 291 272],537,2,406,2.9635036496350367,0.0,0.0
137,0,137,[481 275 222 321 413],13,0,406,2.9420289855072466,0.0,40.0
138,0,138,[272 321 452 276 303],13,3,409,2.9424460431654675,0.0,20.0
139,0,139,[209 367 208 231 300],311,3,412,2.942857142857143,0.0,20.0
140,0,140,[384 241 251 212 239],883,3,415,2.9432624113475176,20.0,0.0
141,0,141,[367 230 420 481 211],13,2,417,2.936619718309859,0.0,20.0
142,0,142,[481 261 212 201 268],13,2,419,2.93006993006993,0.0,0.0
143,0,143,[268 350 290 344 508],13,2,421,2.923611111111111,0.0,0.0
144,0,144,[211 284 241 218 429],64,3,424,2.924137931034483,0.0,20.0
145,0,145,[211 481 218 208 264],13,3,427,2.9246575342465753,0.0,20.0
146,0,146,[276 303 272 315 213],894,5,432,2.938775510204082,20.0,20.0
147,0,147,[276 303 272 315 213],894,5,437,2.9527027027027026,20.0,20.0
148,0,148,[276 303 272 315 213],537,5,442,2.966442953020134,20.0,20.0
149,0,149,[276 303 272 315 213],537,5,447,2.98,20.0,20.0
150,0,150,[276 303 272 315 213],894,5,452,2.993377483443709,20.0,20.0
151,0,151,[276 303 272 315 213],894,5,457,3.0065789473684212,20.0,20.0
152,0,152,[276 303 272 315 213],334,5,462,3.019607843137255,20.0,20.0
153,0,153,[276 303 272 315 213],334,5,467,3.0324675324675323,20.0,20.0
154,0,154,[276 303 272 315 213],334,5,472,3.0451612903225804,20.0,20.0
155,0,155,[276 303 272 315 213],334,5,477,3.0576923076923075,20.0,20.0
156,0,156,[276 303 272 315 213],334,5,482,3.070063694267516,20.0,20.0
157,0,157,[276 303 272 315 213],894,5,487,3.0822784810126582,20.0,20.0
158,0,158,[276 303 272 315 213],334,5,492,3.0943396226415096,20.0,20.0
159,0,159,[276 303 272 315 213],537,5,497,3.10625,20.0,20.0
160,0,160,[276 303 272 315 213],334,5,502,3.1180124223602483,20.0,20.0
161,0,161,[276 303 272 315 213],334,5,507,3.1296296296296298,20.0,20.0
162,0,162,[276 303 272 315 213],334,5,512,3.1411042944785277,20.0,20.0
163,0,163,[276 303 272 315 213],894,5,517,3.152439024390244,20.0,20.0
164,0,164,[276 303 272 315 213],537,5,522,3.1636363636363636,20.0,20.0
165,0,165,[276 303 272 315 213],334,5,527,3.174698795180723,20.0,20.0
166,0,166,[276 303 272 315 213],537,5,532,3.18562874251497,20.0,20.0
167,0,167,[276 303 272 315 213],894,5,537,3.1964285714285716,20.0,20.0
168,0,168,[276 303 272 315 213],537,5,542,3.2071005917159763,20.0,20.0
169,0,169,[276 303 272 315 213],537,5,547,3.2176470588235295,20.0,20.0
170,0,170,[276 303 272 315 213],894,5,552,3.2280701754385963,20.0,20.0
171,0,171,[276 303 272 315 213],894,5,557,3.238372093023256,20.0,20.0
172,0,172,[276 290 331 293 244],894,4,561,3.2427745664739884,0.0,20.0
173,0,173,[276 303 272 315 213],334,5,566,3.2528735632183907,20.0,20.0
174,0,174,[276 303 272 315 213],537,5,571,3.262857142857143,20.0,20.0
175,0,175,[276 303 272 315 213],537,5,576,3.272727272727273,20.0,20.0
176,0,176,[276 303 272 315 213],334,5,581,3.2824858757062145,20.0,20.0
177,0,177,[276 303 272 315 213],894,5,586,3.292134831460674,20.0,20.0
178,0,178,[276 303 272 315 213],537,5,591,3.3016759776536313,20.0,20.0
179,0,179,[276 303 272 315 213],334,5,596,3.311111111111111,20.0,20.0
180,0,180,[276 303 272 315 213],334,5,601,3.320441988950276,20.0,20.0
181,0,181,[276 303 272 315 213],537,5,606,3.32967032967033,20.0,20.0
182,0,182,[276 303 272 315 213],537,5,611,3.33879781420765,20.0,20.0
183,0,183,[276 303 272 315 213],334,5,616,3.347826086956522,20.0,20.0
184,0,184,[276 303 272 315 213],537,5,621,3.3567567567567567,20.0,20.0
185,0,185,[429 299 301 507 420],13,2,623,3.349462365591398,0.0,0.0
186,0,186,[303 276 272 246 315],894,5,628,3.358288770053476,20.0,20.0
187,0,187,[303 276 272 246 315],894,5,633,3.367021276595745,20.0,20.0
188,0,188,[303 276 272 246 315],894,5,638,3.375661375661376,20.0,20.0
189,0,189,[303 276 272 246 315],334,5,643,3.3842105263157896,20.0,20.0
190,0,190,[301 211 230 226 344],13,2,645,3.3769633507853403,0.0,20.0
191,0,191,[201 268 507 259 429],7,2,647,3.3697916666666665,0.0,0.0
192,0,192,[219 315 350 413 481],13,1,648,3.3575129533678756,20.0,0.0
193,0,193,[275 230 227 378 293],533,4,652,3.3608247422680413,0.0,20.0
194,0,194,[583 223 264 226 300],7,4,656,3.364102564102564,20.0,20.0
195,0,195,[276 213 246 272 303],894,5,661,3.372448979591837,0.0,20.0
196,0,196,[276 213 246 272 303],6,2,663,3.3654822335025383,0.0,20.0
197,0,197,[315 272 213 303 276],537,5,668,3.3737373737373737,20.0,20.0
198,0,198,[315 272 213 303 276],894,5,673,3.3819095477386933,20.0,20.0
199,0,199,[315 272 213 303 276],537,5,678,3.39,20.0,20.0
200,0,200,[315 272 213 303 276],334,5,683,3.398009950248756,20.0,20.0
201,0,201,[315 272 213 303 276],537,5,688,3.405940594059406,20.0,20.0
202,0,202,[315 272 213 303 276],894,5,693,3.413793103448276,20.0,20.0
203,0,203,[315 272 213 303 276],537,5,698,3.4215686274509802,20.0,20.0
204,0,204,[315 272 213 303 276],894,5,703,3.4292682926829268,20.0,20.0
205,0,205,[315 272 213 303 276],537,5,708,3.436893203883495,20.0,20.0
206,0,206,[315 272 213 303 276],334,5,713,3.4444444444444446,20.0,20.0
207,0,207,[315 272 213 303 276],334,5,718,3.451923076923077,20.0,20.0
208,0,208,[315 272 213 303 276],334,5,723,3.45933014354067,20.0,20.0
209,0,209,[230 272 212 316 485],13,3,726,3.4571428571428573,20.0,0.0
210,0,210,[326 222 315 272 241],328,4,730,3.4597156398104265,20.0,20.0
211,0,211,[315 272 213 303 276],894,5,735,3.4669811320754715,20.0,20.0
212,0,212,[315 272 213 303 276],537,5,740,3.4741784037558685,20.0,20.0
213,0,213,[315 272 213 303 276],334,5,745,3.4813084112149535,20.0,20.0
214,0,214,[315 272 213 303 276],894,5,750,3.488372093023256,20.0,20.0
215,0,215,[315 272 213 303 276],537,5,755,3.4953703703703702,20.0,20.0
216,0,216,[315 272 213 303 276],537,5,760,3.5023041474654377,20.0,20.0
217,0,217,[315 272 213 303 276],334,5,765,3.5091743119266057,20.0,20.0
218,0,218,[315 272 213 303 276],894,5,770,3.5159817351598175,20.0,20.0
219,0,219,[315 272 213 303 276],894,5,775,3.522727272727273,20.0,20.0
220,0,220,[315 272 213 303 276],894,5,780,3.5294117647058822,20.0,20.0
221,0,221,[315 272 213 303 276],894,5,785,3.536036036036036,20.0,20.0
222,0,222,[315 272 213 303 276],334,5,790,3.5426008968609866,20.0,20.0
223,0,223,[315 272 213 303 276],537,5,795,3.549107142857143,20.0,20.0
224,0,224,[315 272 213 303 276],334,5,800,3.5555555555555554,20.0,20.0
225,0,225,[315 272 213 303 276],334,5,805,3.561946902654867,20.0,20.0
226,0,226,[315 272 213 303 276],894,5,810,3.5682819383259914,20.0,20.0
227,0,227,[315 272 213 303 276],894,5,815,3.574561403508772,20.0,20.0
228,0,228,[315 272 213 303 276],537,5,820,3.5807860262008733,20.0,20.0
229,0,229,[315 272 213 303 276],537,5,825,3.5869565217391304,20.0,20.0
230,0,230,[315 272 213 303 276],537,5,830,3.593073593073593,20.0,20.0
231,0,231,[315 272 213 303 276],537,5,835,3.5991379310344827,20.0,20.0
232,0,232,[315 272 213 303 276],537,5,840,3.6051502145922747,20.0,20.0
233,0,233,[315 272 213 303 276],894,5,845,3.611111111111111,20.0,20.0
234,0,234,[315 272 213 303 276],894,5,850,3.617021276595745,20.0,20.0
235,0,235,[315 272 213 303 276],537,5,855,3.6228813559322033,20.0,20.0
236,0,236,[315 272 213 303 276],334,5,860,3.628691983122363,20.0,20.0
237,0,237,[315 272 213 303 276],334,5,865,3.634453781512605,20.0,20.0
238,0,238,[315 272 213 303 276],334,5,870,3.6401673640167362,20.0,20.0
239,0,239,[315 272 213 303 276],894,5,875,3.6458333333333335,20.0,20.0
240,0,240,[315 272 213 303 276],894,5,880,3.6514522821576763,20.0,20.0
241,0,241,[315 272 213 303 276],334,5,885,3.65702479338843,20.0,20.0
242,0,242,[295 215 202 392 226],378,1,886,3.646090534979424,0.0,0.0
243,0,243,[272 315 213 303 276],334,5,891,3.651639344262295,20.0,20.0
244,0,244,[272 315 213 303 276],894,5,896,3.657142857142857,20.0,20.0
245,0,245,[272 315 213 303 276],537,5,901,3.66260162601626,20.0,20.0
246,0,246,[272 315 213 303 276],894,5,906,3.668016194331984,20.0,20.0
247,0,247,[272 315 213 303 276],334,5,911,3.6733870967741935,20.0,20.0
248,0,248,[272 315 213 303 276],537,5,916,3.678714859437751,20.0,20.0
249,0,249,[272 315 213 303 276],894,5,921,3.684,20.0,20.0
250,0,250,[272 315 213 303 276],537,5,926,3.689243027888446,20.0,20.0
251,0,251,[272 315 213 303 276],537,5,931,3.6944444444444446,20.0,20.0
252,0,252,[272 315 213 303 276],537,5,936,3.699604743083004,20.0,20.0
253,0,253,[272 315 213 303 276],537,5,941,3.704724409448819,20.0,20.0
254,0,254,[272 315 213 303 276],334,5,946,3.7098039215686276,20.0,20.0
255,0,255,[226 212 227 231 429],7,2,948,3.703125,0.0,0.0
256,0,256,[315 272 213 303 276],894,5,953,3.708171206225681,20.0,20.0
257,0,257,[315 272 213 303 276],894,5,958,3.7131782945736433,20.0,20.0
258,0,258,[315 272 213 303 276],537,5,963,3.718146718146718,20.0,20.0
259,0,259,[315 272 213 303 276],334,5,968,3.723076923076923,20.0,20.0
260,0,260,[315 272 213 303 276],334,5,973,3.7279693486590038,20.0,20.0
261,0,261,[315 272 213 303 276],537,5,978,3.732824427480916,20.0,20.0
262,0,262,[215 219 255 507 392],308,2,980,3.726235741444867,0.0,0.0
263,0,263,[315 213 272 303 276],894,5,985,3.731060606060606,20.0,20.0
264,0,264,[315 213 272 303 276],334,5,990,3.7358490566037736,20.0,20.0
265,0,265,[315 213 272 303 276],894,5,995,3.7406015037593985,20.0,20.0
266,0,266,[315 213 272 303 276],334,5,1000,3.745318352059925,20.0,20.0
267,0,267,[315 213 272 303 276],334,5,1005,3.75,20.0,20.0
268,0,268,[315 213 272 303 276],334,5,1010,3.7546468401486988,20.0,20.0
269,0,269,[315 213 272 303 276],537,5,1015,3.759259259259259,20.0,20.0
270,0,270,[315 213 272 303 276],894,5,1020,3.763837638376384,20.0,20.0
271,0,271,[315 213 272 303 276],537,5,1025,3.7683823529411766,20.0,20.0
272,0,272,[315 213 272 303 276],894,5,1030,3.772893772893773,20.0,20.0
273,0,273,[213 276 485 284 209],474,5,1035,3.7773722627737225,0.0,20.0
274,0,274,[315 213 272 303 276],537,5,1040,3.7818181818181817,20.0,20.0
275,0,275,[315 213 272 303 276],537,5,1045,3.786231884057971,20.0,20.0
276,0,276,[241 485 230 219 384],7,2,1047,3.779783393501805,0.0,0.0
277,0,277,[315 213 272 303 276],537,5,1052,3.7841726618705036,20.0,20.0
278,0,278,[315 213 272 303 276],894,5,1057,3.7885304659498207,20.0,20.0
279,0,279,[315 213 272 303 276],894,5,1062,3.7928571428571427,20.0,20.0
280,0,280,[315 213 272 303 276],537,5,1067,3.797153024911032,20.0,20.0
281,0,281,[315 213 272 303 276],537,5,1072,3.801418439716312,20.0,20.0
282,0,282,[315 213 272 303 276],334,5,1077,3.8056537102473498,20.0,20.0
283,0,283,[315 213 272 303 276],334,5,1082,3.8098591549295775,20.0,20.0
284,0,284,[315 213 272 303 276],334,5,1087,3.814035087719298,20.0,20.0
285,0,285,[315 213 272 303 276],334,5,1092,3.8181818181818183,20.0,20.0
286,0,286,[315 213 272 303 276],334,5,1097,3.822299651567944,20.0,20.0
287,0,287,[211 231 299 201 326],13,1,1098,3.8125,0.0,20.0
288,0,288,[301 223 264 217 268],13,3,1101,3.809688581314879,20.0,0.0
289,0,289,[315 213 272 303 276],334,5,1106,3.8137931034482757,20.0,20.0
290,0,290,[315 213 272 303 276],334,5,1111,3.8178694158075603,20.0,20.0
291,0,291,[315 213 272 303 276],537,5,1116,3.8219178082191783,20.0,20.0
292,0,292,[211 384 301 250 321],279,4,1120,3.8225255972696246,0.0,20.0
293,0,293,[315 213 272 303 276],537,5,1125,3.826530612244898,20.0,20.0
294,0,294,[315 213 272 303 276],334,5,1130,3.830508474576271,20.0,20.0
295,0,295,[413 293 230 202 431],774,2,1132,3.824324324324324,0.0,0.0
296,0,296,[272 315 213 303 276],537,5,1137,3.8282828282828283,20.0,20.0
297,0,297,[272 315 213 303 276],537,5,1142,3.8322147651006713,20.0,20.0
298,0,298,[272 315 213 303 276],894,5,1147,3.8361204013377925,20.0,20.0
299,0,299,[272 315 213 303 276],894,5,1152,3.84,20.0,20.0
300,0,300,[272 315 213 303 276],894,5,1157,3.8438538205980066,20.0,20.0
301,0,301,[272 315 213 303 276],894,5,1162,3.847682119205298,20.0,20.0
302,0,302,[272 315 213 303 276],894,5,1167,3.8514851485148514,20.0,20.0
303,0,303,[272 315 213 303 276],334,5,1172,3.8552631578947367,20.0,20.0
304,0,304,[223 300 276 331 239],13,3,1175,3.8524590163934427,20.0,40.0
305,0,305,[272 315 213 303 276],894,5,1180,3.8562091503267975,20.0,20.0
306,0,306,[272 315 213 303 276],894,5,1185,3.8599348534201954,20.0,20.0
307,0,307,[272 315 213 303 276],537,5,1190,3.8636363636363638,20.0,20.0
308,0,308,[272 315 213 303 276],894,5,1195,3.867313915857605,20.0,20.0
309,0,309,[272 315 213 303 276],334,5,1200,3.870967741935484,20.0,20.0
310,0,310,[272 315 213 303 276],537,5,1205,3.87459807073955,20.0,20.0
311,0,311,[272 315 213 303 276],894,5,1210,3.878205128205128,20.0,20.0
312,0,312,[272 315 213 303 276],894,5,1215,3.8817891373801916,20.0,20.0
313,0,313,[272 315 213 303 276],334,5,1220,3.8853503184713376,20.0,20.0
314,0,314,[272 315 213 303 276],537,5,1225,3.888888888888889,20.0,20.0
315,0,315,[272 315 213 303 276],894,5,1230,3.892405063291139,20.0,20.0
316,0,316,[272 315 213 303 276],334,5,1235,3.8958990536277605,20.0,20.0
317,0,317,[272 315 213 303 276],334,5,1240,3.89937106918239,20.0,20.0
318,0,318,[272 315 213 303 276],334,5,1245,3.90282131661442,20.0,20.0
319,0,319,[367 420 429 299 315],13,3,1248,3.9,20.0,0.0
320,0,320,[272 315 213 303 276],894,5,1253,3.9034267912772584,20.0,20.0
321,0,321,[272 315 213 303 276],894,5,1258,3.906832298136646,20.0,20.0
322,0,322,[272 315 213 303 276],537,5,1263,3.9102167182662537,20.0,20.0
323,0,323,[272 315 213 303 276],537,5,1268,3.9135802469135803,20.0,20.0
324,0,324,[272 315 213 303 276],894,5,1273,3.916923076923077,20.0,20.0
325,0,325,[272 315 213 303 276],537,5,1278,3.920245398773006,20.0,20.0
326,0,326,[272 315 213 303 276],334,5,1283,3.923547400611621,20.0,20.0
327,0,327,[272 315 213 303 276],894,5,1288,3.926829268292683,20.0,20.0
328,0,328,[272 315 213 303 276],334,5,1293,3.930091185410334,20.0,20.0
329,0,329,[272 315 213 303 276],334,5,1298,3.933333333333333,20.0,20.0
330,0,330,[272 315 213 303 276],894,5,1303,3.9365558912386707,20.0,20.0
331,0,331,[272 315 213 303 276],537,5,1308,3.9397590361445785,20.0,20.0
332,0,332,[272 315 213 303 276],894,5,1313,3.942942942942943,20.0,20.0
333,0,333,[272 315 213 303 276],334,5,1318,3.946107784431138,20.0,20.0
334,0,334,[272 315 213 303 276],334,5,1323,3.9492537313432834,20.0,20.0
335,0,335,[272 315 213 303 276],537,5,1328,3.9523809523809526,20.0,20.0
336,0,336,[272 315 213 303 276],894,5,1333,3.9554896142433233,20.0,20.0
337,0,337,[272 315 213 303 276],537,5,1338,3.9585798816568047,20.0,20.0
338,0,338,[272 315 213 303 276],334,5,1343,3.96165191740413,20.0,20.0
339,0,339,[272 315 213 303 276],334,5,1348,3.9647058823529413,20.0,20.0
340,0,340,[272 315 213 303 276],334,5,1353,3.967741935483871,20.0,20.0
341,0,341,[413 243 336 231 485],13,0,1353,3.956140350877193,0.0,0.0
342,0,342,[272 315 213 303 276],894,5,1358,3.9591836734693877,20.0,20.0
343,0,343,[272 315 213 303 276],894,5,1363,3.9622093023255816,20.0,20.0
344,0,344,[272 315 213 303 276],894,5,1368,3.965217391304348,20.0,20.0
345,0,345,[272 315 213 303 276],334,5,1373,3.968208092485549,20.0,20.0
346,0,346,[272 315 213 303 276],334,5,1378,3.9711815561959654,20.0,20.0
347,0,347,[272 315 213 303 276],334,5,1383,3.9741379310344827,20.0,20.0
348,0,348,[509 508 231 452 290],13,2,1385,3.968481375358166,0.0,0.0
349,0,349,[315 213 272 303 276],334,5,1390,3.9714285714285715,20.0,20.0
350,0,350,[315 213 272 303 276],334,5,1395,3.9743589743589745,20.0,20.0
351,0,351,[315 213 272 303 276],334,5,1400,3.977272727272727,20.0,20.0
352,0,352,[315 213 272 303 276],537,5,1405,3.9801699716713883,20.0,20.0
353,0,353,[315 213 272 303 276],894,5,1410,3.983050847457627,20.0,20.0
354,0,354,[315 213 272 303 276],894,5,1415,3.9859154929577465,20.0,20.0
355,0,355,[315 213 272 303 276],894,5,1420,3.9887640449438204,20.0,20.0
356,0,356,[315 213 272 303 276],334,5,1425,3.991596638655462,20.0,20.0
357,0,357,[226 230 201 264 223],13,3,1428,3.988826815642458,20.0,0.0
358,0,358,[315 213 272 303 276],537,5,1433,3.9916434540389973,20.0,20.0
359,0,359,[315 213 272 303 276],334,5,1438,3.9944444444444445,20.0,20.0
360,0,360,[315 213 272 303 276],334,5,1443,3.9972299168975067,20.0,20.0
361,0,361,[315 213 272 303 276],537,5,1448,4.0,20.0,20.0
362,0,362,[315 213 272 303 276],537,5,1453,4.002754820936639,20.0,20.0
363,0,363,[315 213 272 303 276],334,5,1458,4.0054945054945055,20.0,20.0
364,0,364,[315 213 272 303 276],334,5,1463,4.008219178082192,20.0,20.0
365,0,365,[315 213 272 303 276],894,5,1468,4.0109289617486334,20.0,20.0
366,0,366,[315 213 272 303 276],894,5,1473,4.013623978201635,20.0,20.0
367,0,367,[315 213 272 303 276],334,5,1478,4.016304347826087,20.0,20.0
368,0,368,[315 213 272 303 276],894,5,1483,4.018970189701897,20.0,20.0
369,0,369,[315 213 272 303 276],537,5,1488,4.021621621621621,20.0,20.0
370,0,370,[315 213 272 303 276],334,5,1493,4.024258760107816,20.0,20.0
371,0,371,[315 213 272 303 276],334,5,1498,4.026881720430108,20.0,20.0
372,0,372,[315 213 272 303 276],537,5,1503,4.029490616621984,20.0,20.0
373,0,373,[315 213 272 303 276],334,5,1508,4.032085561497326,20.0,20.0
374,0,374,[315 213 272 303 276],334,5,1513,4.034666666666666,20.0,20.0
375,0,375,[315 213 272 303 276],334,5,1518,4.037234042553192,20.0,20.0
376,0,376,[315 213 272 303 276],334,5,1523,4.039787798408488,20.0,20.0
377,0,377,[315 213 272 303 276],537,5,1528,4.042328042328043,20.0,20.0
378,0,378,[315 213 272 303 276],537,5,1533,4.044854881266491,20.0,20.0
379,0,379,[315 213 272 303 276],894,5,1538,4.0473684210526315,20.0,20.0
380,0,380,[315 213 272 303 276],537,5,1543,4.0498687664042,20.0,20.0
381,0,381,[315 213 272 303 276],334,5,1548,4.052356020942408,20.0,20.0
382,0,382,[315 213 272 303 276],894,5,1553,4.054830287206267,20.0,20.0
383,0,383,[276 367 209 222 509],194,0,1553,4.044270833333333,0.0,40.0
384,0,384,[315 213 272 303 276],894,5,1558,4.046753246753247,20.0,20.0
385,0,385,[315 213 272 303 276],334,5,1563,4.049222797927461,20.0,20.0
386,0,386,[315 213 272 303 276],894,5,1568,4.051679586563307,20.0,20.0
387,0,387,[315 213 272 303 276],537,5,1573,4.054123711340206,20.0,20.0
388,0,388,[315 213 272 303 276],537,5,1578,4.056555269922879,20.0,20.0
389,0,389,[283 295 509 213 250],479,4,1582,4.056410256410256,0.0,0.0
390,0,390,[272 315 213 303 276],894,5,1587,4.0588235294117645,20.0,20.0
391,0,391,[365 295 509 280 255],378,2,1589,4.053571428571429,0.0,0.0
392,0,392,[272 315 213 303 276],894,5,1594,4.0559796437659035,20.0,20.0
393,0,393,[272 315 213 303 276],894,5,1599,4.058375634517766,20.0,20.0
394,0,394,[272 315 213 303 276],537,5,1604,4.060759493670886,20.0,20.0
395,0,395,[272 315 213 303 276],334,5,1609,4.063131313131313,20.0,20.0
396,0,396,[272 315 213 303 276],334,5,1614,4.065491183879093,20.0,20.0
397,0,397,[272 315 213 303 276],334,5,1619,4.067839195979899,20.0,20.0
398,0,398,[272 315 213 303 276],334,5,1624,4.0701754385964914,20.0,20.0
399,0,399,[272 315 213 303 276],894,5,1629,4.0725,20.0,20.0
400,0,400,[272 315 213 303 276],537,5,1634,4.074812967581047,20.0,20.0
401,0,401,[272 315 213 303 276],334,5,1639,4.077114427860696,20.0,20.0
402,0,402,[272 315 213 303 276],894,5,1644,4.079404466501241,20.0,20.0
403,0,403,[272 315 213 303 276],537,5,1649,4.0816831683168315,20.0,20.0
404,0,404,[272 315 213 303 276],894,5,1654,4.083950617283951,20.0,20.0
405,0,405,[272 315 213 303 276],537,5,1659,4.086206896551724,20.0,20.0
406,0,406,[215 222 301 211 227],650,2,1661,4.081081081081081,0.0,40.0
407,0,407,[272 315 213 303 276],334,5,1666,4.083333333333333,20.0,20.0
408,0,408,[272 315 213 303 276],537,5,1671,4.08557457212714,20.0,20.0
409,0,409,[272 315 213 303 276],334,5,1676,4.087804878048781,20.0,20.0
410,0,410,[272 315 213 303 276],537,5,1681,4.090024330900243,20.0,20.0
411,0,411,[272 315 213 303 276],537,5,1686,4.092233009708738,20.0,20.0
412,0,412,[272 315 213 303 276],334,5,1691,4.094430992736077,20.0,20.0
413,0,413,[272 315 213 303 276],894,5,1696,4.096618357487923,20.0,20.0
414,0,414,[272 315 213 303 276],894,5,1701,4.098795180722892,20.0,20.0
415,0,415,[272 315 213 303 276],537,5,1706,4.100961538461538,20.0,20.0
416,0,416,[272 315 213 303 276],334,5,1711,4.103117505995204,20.0,20.0
417,0,417,[272 315 213 303 276],334,5,1716,4.105263157894737,20.0,20.0
418,0,418,[272 315 213 303 276],894,5,1721,4.107398568019093,20.0,20.0
419,0,419,[272 315 213 303 276],894,5,1726,4.109523809523809,20.0,20.0
420,0,420,[272 315 213 303 276],894,5,1731,4.111638954869359,20.0,20.0
421,0,421,[272 315 213 303 276],894,5,1736,4.113744075829384,20.0,20.0
422,0,422,[272 315 213 303 276],537,5,1741,4.115839243498818,20.0,20.0
423,0,423,[272 315 213 303 276],334,5,1746,4.117924528301887,20.0,20.0
424,0,424,[272 315 213 303 276],537,5,1751,4.12,20.0,20.0
425,0,425,[272 315 213 303 276],894,5,1756,4.122065727699531,20.0,20.0
426,0,426,[272 315 213 303 276],894,5,1761,4.124121779859485,20.0,20.0
427,0,427,[272 315 213 303 276],894,5,1766,4.126168224299065,20.0,20.0
428,0,428,[272 315 213 303 276],537,5,1771,4.128205128205129,20.0,20.0
429,0,429,[219 209 239 213 232],194,0,1771,4.118604651162791,0.0,0.0
430,0,430,[272 315 303 213 276],537,5,1776,4.120649651972157,20.0,20.0
431,0,431,[272 315 303 213 276],894,5,1781,4.122685185185185,20.0,20.0
432,0,432,[272 315 303 213 276],334,5,1786,4.124711316397229,20.0,20.0
433,0,433,[272 315 303 213 276],537,5,1791,4.126728110599078,20.0,20.0
434,0,434,[272 315 303 213 276],537,5,1796,4.128735632183908,20.0,20.0
435,0,435,[272 315 303 213 276],894,5,1801,4.1307339449541285,20.0,20.0
436,0,436,[272 315 303 213 276],537,5,1806,4.132723112128146,20.0,20.0
437,0,437,[272 315 303 213 276],537,5,1811,4.134703196347032,20.0,20.0
438,0,438,[272 315 303 213 276],894,5,1816,4.136674259681094,20.0,20.0
439,0,439,[272 315 303 213 276],894,5,1821,4.138636363636364,20.0,20.0
440,0,440,[272 315 303 213 276],894,5,1826,4.140589569160998,20.0,20.0
441,0,441,[208 241 222 212 452],13,2,1828,4.135746606334842,0.0,20.0
442,0,442,[272 315 303 213 276],334,5,1833,4.1376975169300225,20.0,20.0
443,0,443,[272 315 303 213 276],537,5,1838,4.13963963963964,20.0,20.0
444,0,444,[230 215 216 507 485],474,4,1842,4.139325842696629,0.0,0.0
445,0,445,[272 243 216 350 202],13,2,1844,4.134529147982063,0.0,0.0
446,0,446,[230 236 429 208 321],279,5,1849,4.136465324384788,0.0,0.0
447,0,447,[272 315 303 213 276],894,5,1854,4.138392857142857,20.0,20.0
448,0,448,[272 315 303 213 276],894,5,1859,4.140311804008909,20.0,20.0
449,0,449,[272 315 303 213 276],894,5,1864,4.142222222222222,20.0,20.0
450,0,450,[272 315 303 213 276],334,5,1869,4.144124168514413,20.0,20.0
451,0,451,[272 315 303 213 276],894,5,1874,4.146017699115045,20.0,20.0
452,0,452,[223 219 481 275 268],13,2,1876,4.141280353200883,20.0,20.0
453,0,453,[272 315 303 213 276],334,5,1881,4.143171806167401,20.0,20.0
454,0,454,[272 315 303 213 276],894,5,1886,4.145054945054945,20.0,20.0
455,0,455,[272 315 303 213 276],894,5,1891,4.146929824561403,20.0,20.0
456,0,456,[272 315 303 213 276],537,5,1896,4.1487964989059085,20.0,20.0
457,0,457,[272 315 303 213 276],537,5,1901,4.150655021834061,20.0,20.0
458,0,458,[272 315 303 213 276],334,5,1906,4.152505446623094,20.0,20.0
459,0,459,[272 315 303 213 276],894,5,1911,4.154347826086957,20.0,20.0
460,0,460,[272 315 303 213 276],894,5,1916,4.156182212581345,20.0,20.0
461,0,461,[272 315 303 213 276],894,5,1921,4.158008658008658,20.0,20.0
462,0,462,[272 315 303 213 276],894,5,1926,4.159827213822894,20.0,20.0
463,0,463,[272 315 303 213 276],537,5,1931,4.161637931034483,20.0,20.0
464,0,464,[272 315 303 213 276],537,5,1936,4.163440860215053,20.0,20.0
465,0,465,[272 315 303 213 276],334,5,1941,4.165236051502146,20.0,20.0
466,0,466,[272 315 303 213 276],334,5,1946,4.167023554603855,20.0,20.0
467,0,467,[272 315 303 213 276],334,5,1951,4.168803418803419,20.0,20.0
468,0,468,[272 315 303 213 276],894,5,1956,4.1705756929637525,20.0,20.0
469,0,469,[272 315 303 213 276],894,5,1961,4.172340425531915,20.0,20.0
470,0,470,[272 315 303 213 276],894,5,1966,4.174097664543525,20.0,20.0
471,0,471,[272 315 303 213 276],894,5,1971,4.1758474576271185,20.0,20.0
472,0,472,[272 315 303 213 276],334,5,1976,4.177589852008457,20.0,20.0
473,0,473,[272 315 303 213 276],894,5,1981,4.179324894514768,20.0,20.0
474,0,474,[272 315 303 213 276],334,5,1986,4.181052631578948,20.0,20.0
475,0,475,[272 315 303 213 276],334,5,1991,4.182773109243698,20.0,20.0
476,0,476,[272 315 303 213 276],537,5,1996,4.184486373165618,20.0,20.0
477,0,477,[272 315 303 213 276],334,5,2001,4.186192468619247,20.0,20.0
478,0,478,[272 315 303 213 276],537,5,2006,4.187891440501044,20.0,20.0
479,0,479,[272 315 303 213 276],894,5,2011,4.189583333333333,20.0,20.0
480,0,480,[272 315 303 213 276],334,5,2016,4.1912681912681915,20.0,20.0
481,0,481,[272 315 303 213 276],334,5,2021,4.1929460580912865,20.0,20.0
482,0,482,[272 315 303 213 276],537,5,2026,4.194616977225673,20.0,20.0
483,0,483,[272 315 303 213 276],894,5,2031,4.196280991735537,20.0,20.0
484,0,484,[272 315 303 213 276],334,5,2036,4.197938144329897,20.0,20.0
485,0,485,[213 215 485 202 218],90,3,2039,4.195473251028806,0.0,0.0
486,0,486,[315 272 303 213 276],537,5,2044,4.1971252566735116,20.0,20.0
487,0,487,[315 272 303 213 276],894,5,2049,4.198770491803279,20.0,20.0
488,0,488,[315 272 303 213 276],894,5,2054,4.2004089979550105,20.0,20.0
489,0,489,[315 272 303 213 276],537,5,2059,4.202040816326531,20.0,20.0
490,0,490,[315 272 303 213 276],537,5,2064,4.203665987780041,20.0,20.0
491,0,491,[315 272 303 213 276],537,5,2069,4.205284552845528,20.0,20.0
492,0,492,[315 272 303 213 276],334,5,2074,4.206896551724138,20.0,20.0
493,0,493,[315 272 303 213 276],894,5,2079,4.208502024291498,20.0,20.0
494,0,494,[315 272 303 213 276],334,5,2084,4.21010101010101,20.0,20.0
495,0,495,[315 272 303 213 276],894,5,2089,4.211693548387097,20.0,20.0
496,0,496,[315 272 303 213 276],334,5,2094,4.21327967806841,20.0,20.0
497,0,497,[485 284 239 429 236],537,0,2094,4.204819277108434,0.0,0.0
498,0,498,[315 272 303 213 276],334,5,2099,4.206412825651302,20.0,20.0
499,0,499,[315 272 303 213 276],537,5,2104,4.208,20.0,20.0
500,0,500,[315 272 303 213 276],537,5,2109,4.209580838323354,20.0,20.0
501,0,501,[315 272 303 213 276],334,5,2114,4.211155378486056,20.0,20.0
502,0,502,[239 221 297 303 316],334,4,2118,4.210735586481113,40.0,0.0
503,0,503,[315 272 297 303 213],334,5,2123,4.212301587301587,40.0,0.0
504,0,504,[315 272 297 303 213],894,5,2128,4.213861386138614,40.0,0.0
505,0,505,[315 272 297 303 213],334,5,2133,4.215415019762846,40.0,0.0
506,0,506,[315 272 297 303 213],334,5,2138,4.216962524654832,40.0,0.0
507,0,507,[315 272 297 303 213],334,5,2143,4.218503937007874,40.0,0.0
508,0,508,[315 272 297 303 213],334,5,2148,4.220039292730845,40.0,0.0
509,0,509,[315 272 297 303 213],334,5,2153,4.2215686274509805,40.0,0.0
510,0,510,[315 272 297 303 213],334,5,2158,4.223091976516634,40.0,0.0
511,0,511,[315 272 297 303 213],334,5,2163,4.224609375,40.0,0.0
512,0,512,[315 272 297 303 213],894,5,2168,4.226120857699805,40.0,0.0
513,0,513,[315 272 297 303 213],334,5,2173,4.227626459143969,40.0,0.0
514,0,514,[315 272 297 303 213],334,5,2178,4.229126213592233,40.0,0.0
515,0,515,[315 272 297 303 213],334,5,2183,4.23062015503876,40.0,0.0
516,0,516,[315 272 297 303 213],334,5,2188,4.2321083172147,40.0,0.0
517,0,517,[315 272 297 303 213],334,5,2193,4.2335907335907335,40.0,0.0
518,0,518,[315 272 297 303 213],894,5,2198,4.235067437379576,40.0,0.0
519,0,519,[315 272 297 303 213],894,5,2203,4.236538461538461,40.0,0.0
520,0,520,[315 272 297 303 213],334,5,2208,4.2380038387715935,40.0,0.0
521,0,521,[315 272 297 303 213],334,5,2213,4.239463601532567,40.0,0.0
522,0,522,[315 272 297 303 213],334,5,2218,4.240917782026768,40.0,0.0
523,0,523,[315 272 297 303 213],334,5,2223,4.24236641221374,40.0,0.0
524,0,524,[315 272 297 303 213],894,5,2228,4.2438095238095235,40.0,0.0
525,0,525,[315 272 297 303 213],334,5,2233,4.245247148288973,40.0,0.0
526,0,526,[315 272 297 303 213],334,5,2238,4.246679316888046,40.0,0.0
527,0,527,[315 272 297 303 213],334,5,2243,4.2481060606060606,40.0,0.0
528,0,528,[227 222 259 243 384],254,2,2245,4.2438563327032135,0.0,20.0
529,0,529,[223 227 509 264 384],7,3,2248,4.241509433962264,20.0,0.0
530,0,530,[315 272 297 303 213],334,5,2253,4.242937853107344,40.0,0.0
531,0,531,[315 272 297 303 213],894,5,2258,4.2443609022556394,40.0,0.0
532,0,532,[315 272 297 303 213],334,5,2263,4.24577861163227,40.0,0.0
533,0,533,[509 240 508 226 246],643,3,2266,4.2434456928838955,0.0,0.0
534,0,534,[297 315 272 303 213],334,5,2271,4.244859813084112,40.0,0.0
535,0,535,[239 212 507 232 384],13,2,2273,4.240671641791045,0.0,0.0
536,0,536,[297 272 315 303 213],894,5,2278,4.242085661080075,40.0,0.0
537,0,537,[297 272 315 303 213],894,5,2283,4.243494423791821,40.0,0.0
538,0,538,[297 272 315 303 213],894,5,2288,4.244897959183674,40.0,0.0
539,0,539,[297 272 315 303 213],334,5,2293,4.246296296296296,40.0,0.0
540,0,540,[297 272 315 303 213],894,5,2298,4.247689463955638,40.0,0.0
541,0,541,[211 236 291 431 223],234,0,2298,4.239852398523985,20.0,20.0
542,0,542,[272 297 315 303 213],894,5,2303,4.241252302025782,40.0,0.0
543,0,543,[272 297 315 303 213],894,5,2308,4.242647058823529,40.0,0.0
544,0,544,[272 297 315 303 213],894,5,2313,4.244036697247706,40.0,0.0
545,0,545,[481 344 429 232 268],13,2,2315,4.23992673992674,0.0,0.0
546,0,546,[272 297 315 303 213],334,5,2320,4.2413162705667276,40.0,0.0
547,0,547,[291 208 227 213 230],524,3,2323,4.239051094890511,0.0,0.0
548,0,548,[272 297 315 303 213],334,5,2328,4.240437158469946,40.0,0.0
549,0,549,[272 297 315 303 213],334,5,2333,4.241818181818182,40.0,0.0
550,0,550,[272 297 315 303 213],334,5,2338,4.243194192377495,40.0,0.0
551,0,551,[272 297 315 303 213],894,5,2343,4.244565217391305,40.0,0.0
552,0,552,[272 297 315 303 213],894,5,2348,4.245931283905968,40.0,0.0
553,0,553,[272 297 315 303 213],894,5,2353,4.247292418772563,40.0,0.0
554,0,554,[272 297 315 303 213],334,5,2358,4.248648648648649,40.0,0.0
555,0,555,[272 297 315 303 213],894,5,2363,4.25,40.0,0.0
556,0,556,[272 297 315 303 213],334,5,2368,4.2513464991023335,40.0,0.0
557,0,557,[272 297 315 303 213],894,5,2373,4.252688172043011,40.0,0.0
558,0,558,[272 297 315 303 213],894,5,2378,4.254025044722719,40.0,0.0
559,0,559,[272 297 315 303 213],334,5,2383,4.255357142857143,40.0,0.0
560,0,560,[213 223 336 344 221],894,4,2387,4.254901960784314,20.0,0.0
561,0,561,[216 429 290 211 301],13,3,2390,4.252669039145908,0.0,20.0
562,0,562,[272 297 315 303 213],894,5,2395,4.253996447602131,40.0,0.0
563,0,563,[272 297 315 303 213],894,5,2400,4.25531914893617,40.0,0.0
564,0,564,[272 297 315 303 213],334,5,2405,4.256637168141593,40.0,0.0
565,0,565,[215 300 268 219 452],7,3,2408,4.254416961130742,0.0,20.0
566,0,566,[272 297 315 303 213],894,5,2413,4.255731922398589,40.0,0.0
567,0,567,[272 297 315 303 213],894,5,2418,4.257042253521127,40.0,0.0
568,0,568,[272 297 315 303 213],894,5,2423,4.258347978910369,40.0,0.0
569,0,569,[272 297 315 303 213],334,5,2428,4.2596491228070175,40.0,0.0
570,0,570,[272 297 315 303 213],334,5,2433,4.260945709281962,40.0,0.0
571,0,571,[272 297 315 303 213],334,5,2438,4.2622377622377625,40.0,0.0
572,0,572,[485 429 209 239 230],650,2,2440,4.2582897033158815,0.0,0.0
573,0,573,[283 507 284 216 202],537,2,2442,4.2543554006968645,0.0,0.0
574,0,574,[216 231 217 300 208],13,1,2443,4.248695652173913,0.0,20.0
575,0,575,[297 315 272 303 213],894,5,2448,4.25,40.0,0.0
576,0,576,[297 315 272 303 213],334,5,2453,4.251299826689775,40.0,0.0
577,0,577,[297 315 272 303 213],894,5,2458,4.252595155709343,40.0,0.0
578,0,578,[297 315 272 303 213],894,5,2463,4.253886010362694,40.0,0.0
579,0,579,[297 315 272 303 213],334,5,2468,4.255172413793104,40.0,0.0
580,0,580,[297 315 272 303 213],334,5,2473,4.256454388984509,40.0,0.0
581,0,581,[297 315 272 303 213],334,5,2478,4.257731958762887,40.0,0.0
582,0,582,[297 315 272 303 213],894,5,2483,4.259005145797599,40.0,0.0
583,0,583,[297 315 272 303 213],334,5,2488,4.260273972602739,40.0,0.0
584,0,584,[297 315 272 303 213],334,5,2493,4.2615384615384615,40.0,0.0
585,0,585,[297 315 272 303 213],894,5,2498,4.262798634812286,40.0,0.0
586,0,586,[297 315 272 303 213],334,5,2503,4.264054514480409,40.0,0.0
587,0,587,[485 431 392 420 232],311,2,2505,4.260204081632653,0.0,0.0
588,0,588,[297 272 315 303 213],894,5,2510,4.261460101867572,40.0,0.0
589,0,589,[297 272 315 303 213],334,5,2515,4.262711864406779,40.0,0.0
590,0,590,[297 272 315 303 213],894,5,2520,4.2639593908629445,40.0,0.0
591,0,591,[297 272 315 303 213],334,5,2525,4.265202702702703,40.0,0.0
592,0,592,[297 272 315 303 213],334,5,2530,4.266441821247892,40.0,0.0
593,0,593,[300 241 213 231 509],537,2,2532,4.262626262626263,0.0,20.0
594,0,594,[297 315 272 303 213],334,5,2537,4.263865546218487,40.0,0.0
595,0,595,[297 315 272 303 213],894,5,2542,4.26510067114094,40.0,0.0
596,0,596,[297 315 272 303 213],894,5,2547,4.266331658291457,40.0,0.0
597,0,597,[297 315 272 303 213],894,5,2552,4.2675585284280935,40.0,0.0
598,0,598,[297 315 272 303 213],334,5,2557,4.268781302170284,40.0,0.0
599,0,599,[297 315 272 303 213],334,5,2562,4.27,40.0,0.0
600,0,600,[297 315 272 303 213],334,5,2567,4.271214642262895,40.0,0.0
601,0,601,[297 315 272 303 213],894,5,2572,4.2724252491694354,40.0,0.0
602,0,602,[297 315 272 303 213],334,5,2577,4.27363184079602,40.0,0.0
603,0,603,[297 315 272 303 213],334,5,2582,4.274834437086093,40.0,0.0
604,0,604,[297 315 272 303 213],894,5,2587,4.276033057851239,40.0,0.0
605,0,605,[297 315 272 303 213],334,5,2592,4.2772277227722775,40.0,0.0
606,0,606,[297 315 272 303 213],334,5,2597,4.27841845140033,40.0,0.0
607,0,607,[297 315 272 303 213],894,5,2602,4.279605263157895,40.0,0.0
608,0,608,[297 315 272 303 213],334,5,2607,4.280788177339901,40.0,0.0
609,0,609,[297 315 272 303 213],334,5,2612,4.281967213114754,40.0,0.0
610,0,610,[297 315 272 303 213],894,5,2617,4.283142389525368,40.0,0.0
611,0,611,[297 315 272 303 213],334,5,2622,4.284313725490196,40.0,0.0
612,0,612,[297 315 272 303 213],894,5,2627,4.285481239804241,40.0,0.0
613,0,613,[297 315 272 303 213],894,5,2632,4.286644951140065,40.0,0.0
614,0,614,[297 315 272 303 213],334,5,2637,4.287804878048781,40.0,0.0
615,0,615,[255 212 284 222 259],474,4,2641,4.287337662337662,0.0,20.0
616,0,616,[297 315 272 303 213],334,5,2646,4.288492706645057,40.0,0.0
617,0,617,[297 315 272 303 213],894,5,2651,4.289644012944984,40.0,0.0
618,0,618,[297 315 272 303 213],894,5,2656,4.290791599353796,40.0,0.0
619,0,619,[297 315 272 303 213],334,5,2661,4.291935483870968,40.0,0.0
620,0,620,[297 315 272 303 213],334,5,2666,4.293075684380033,40.0,0.0
621,0,621,[232 275 509 259 283],85,1,2667,4.287781350482315,0.0,20.0
622,0,622,[297 315 272 303 213],334,5,2672,4.28892455858748,40.0,0.0
623,0,623,[297 315 272 303 213],894,5,2677,4.290064102564102,40.0,0.0
624,0,624,[297 315 272 303 213],334,5,2682,4.2912,40.0,0.0
625,0,625,[297 315 272 303 213],334,5,2687,4.292332268370607,40.0,0.0
626,0,626,[297 315 272 303 213],894,5,2692,4.293460925039873,40.0,0.0
627,0,627,[297 315 272 303 213],334,5,2697,4.294585987261146,40.0,0.0
628,0,628,[297 315 272 303 213],894,5,2702,4.29570747217806,40.0,0.0
629,0,629,[297 315 272 303 213],894,5,2707,4.296825396825397,40.0,0.0
630,0,630,[367 392 321 254 216],308,2,2709,4.293185419968304,0.0,0.0
631,0,631,[297 315 272 303 213],334,5,2714,4.294303797468355,40.0,0.0
632,0,632,[297 315 272 303 213],334,5,2719,4.295418641390206,40.0,0.0
633,0,633,[297 315 272 303 213],894,5,2724,4.296529968454259,40.0,0.0
634,0,634,[297 315 272 303 213],334,5,2729,4.29763779527559,40.0,0.0
635,0,635,[297 315 272 303 213],334,5,2734,4.29874213836478,40.0,0.0
636,0,636,[297 315 272 303 213],334,5,2739,4.2998430141287285,40.0,0.0
637,0,637,[297 315 272 303 213],894,5,2744,4.300940438871473,40.0,0.0
638,0,638,[297 315 272 303 213],334,5,2749,4.302034428794992,40.0,0.0
639,0,639,[297 315 272 303 213],894,5,2754,4.303125,40.0,0.0
640,0,640,[297 315 272 303 213],894,5,2759,4.30421216848674,40.0,0.0
641,0,641,[297 315 272 303 213],894,5,2764,4.305295950155763,40.0,0.0
642,0,642,[331 223 336 231 241],13,1,2765,4.300155520995334,20.0,0.0
643,0,643,[297 315 272 303 213],894,5,2770,4.301242236024844,40.0,0.0
644,0,644,[297 315 272 303 213],894,5,2775,4.3023255813953485,40.0,0.0
645,0,645,[297 315 272 303 213],894,5,2780,4.303405572755418,40.0,0.0
646,0,646,[297 315 272 303 213],334,5,2785,4.304482225656878,40.0,0.0
647,0,647,[297 315 272 303 213],334,5,2790,4.305555555555555,40.0,0.0
648,0,648,[297 315 272 303 213],894,5,2795,4.306625577812018,40.0,0.0
649,0,649,[297 315 272 303 213],894,5,2800,4.3076923076923075,40.0,0.0
650,0,650,[239 336 243 367 452],13,1,2801,4.302611367127496,0.0,0.0
651,0,651,[297 315 272 303 213],334,5,2806,4.303680981595092,40.0,0.0
652,0,652,[297 315 272 303 213],334,5,2811,4.304747320061256,40.0,0.0
653,0,653,[297 315 272 303 213],894,5,2816,4.3058103975535165,40.0,0.0
654,0,654,[297 315 272 303 213],334,5,2821,4.306870229007633,40.0,0.0
655,0,655,[297 315 272 303 213],894,5,2826,4.307926829268292,40.0,0.0
656,0,656,[297 315 272 303 213],894,5,2831,4.308980213089802,40.0,0.0
657,0,657,[297 315 272 303 213],894,5,2836,4.310030395136778,40.0,0.0
658,0,658,[297 315 272 303 213],334,5,2841,4.311077389984826,40.0,0.0
659,0,659,[297 315 272 303 213],894,5,2846,4.3121212121212125,40.0,0.0
660,0,660,[297 315 272 303 213],334,5,2851,4.3131618759455375,40.0,0.0
661,0,661,[297 315 272 303 213],334,5,2856,4.314199395770393,40.0,0.0
662,0,662,[297 315 272 303 213],334,5,2861,4.315233785822021,40.0,0.0
663,0,663,[297 315 272 303 213],334,5,2866,4.316265060240964,40.0,0.0
664,0,664,[297 315 272 303 213],894,5,2871,4.317293233082707,40.0,0.0
665,0,665,[297 315 272 303 213],334,5,2876,4.318318318318318,40.0,0.0
666,0,666,[316 211 219 209 300],13,2,2878,4.314842578710644,20.0,40.0
667,0,667,[297 315 272 303 213],894,5,2883,4.315868263473054,40.0,0.0
668,0,668,[297 315 272 303 213],894,5,2888,4.316890881913303,40.0,0.0
669,0,669,[384 321 223 315 344],13,2,2890,4.313432835820896,40.0,0.0
670,0,670,[297 315 272 303 213],334,5,2895,4.3144560357675115,40.0,0.0
671,0,671,[297 315 272 303 213],894,5,2900,4.315476190476191,40.0,0.0
672,0,672,[297 315 272 303 213],334,5,2905,4.316493313521545,40.0,0.0
673,0,673,[297 315 272 303 213],334,5,2910,4.317507418397626,40.0,0.0
674,0,674,[297 315 272 303 213],334,5,2915,4.318518518518519,40.0,0.0
675,0,675,[297 315 272 303 213],334,5,2920,4.319526627218935,40.0,0.0
676,0,676,[297 315 272 303 213],334,5,2925,4.320531757754801,40.0,0.0
677,0,677,[297 315 272 303 213],894,5,2930,4.321533923303835,40.0,0.0
678,0,678,[232 226 243 324 583],387,2,2932,4.3181148748159055,0.0,0.0
679,0,679,[297 315 272 303 213],894,5,2937,4.319117647058824,40.0,0.0
680,0,680,[297 315 272 303 213],894,5,2942,4.320117474302497,40.0,0.0
681,0,681,[239 213 215 300 315],311,4,2946,4.319648093841642,20.0,20.0
682,0,682,[297 315 272 303 213],894,5,2951,4.320644216691069,40.0,0.0
683,0,683,[297 315 272 303 213],894,5,2956,4.321637426900585,40.0,0.0
684,0,684,[297 315 272 303 213],894,5,2961,4.322627737226277,40.0,0.0
685,0,685,[297 315 272 303 213],894,5,2966,4.3236151603498545,40.0,0.0
686,0,686,[297 315 272 303 213],894,5,2971,4.324599708879185,40.0,0.0
687,0,687,[297 315 272 303 213],894,5,2976,4.325581395348837,40.0,0.0
688,0,688,[297 315 272 303 213],334,5,2981,4.32656023222061,40.0,0.0
689,0,689,[297 315 272 303 213],894,5,2986,4.327536231884058,40.0,0.0
690,0,690,[297 315 272 303 213],894,5,2991,4.328509406657019,40.0,0.0
691,0,691,[230 255 218 217 275],378,2,2993,4.32514450867052,0.0,20.0
692,0,692,[272 315 297 303 213],894,5,2998,4.326118326118326,40.0,0.0
693,0,693,[272 315 297 303 213],894,5,3003,4.327089337175792,40.0,0.0
694,0,694,[272 315 297 303 213],334,5,3008,4.3280575539568344,40.0,0.0
695,0,695,[272 315 297 303 213],894,5,3013,4.329022988505747,40.0,0.0
696,0,696,[272 315 297 303 213],334,5,3018,4.3299856527977045,40.0,0.0
697,0,697,[272 315 297 303 213],334,5,3023,4.330945558739255,40.0,0.0
698,0,698,[276 300 232 223 344],13,2,3025,4.32761087267525,20.0,40.0
699,0,699,[297 315 272 303 213],894,5,3030,4.328571428571428,40.0,0.0
700,0,700,[297 315 272 303 213],334,5,3035,4.329529243937232,40.0,0.0
701,0,701,[283 216 202 261 324],479,2,3037,4.3262108262108265,0.0,0.0
702,0,702,[297 315 272 303 213],894,5,3042,4.327169274537695,40.0,0.0
703,0,703,[297 315 272 303 213],894,5,3047,4.328125,40.0,0.0
704,0,704,[297 315 272 303 213],334,5,3052,4.329078014184397,40.0,0.0
705,0,705,[297 315 272 303 213],334,5,3057,4.330028328611898,40.0,0.0
706,0,706,[297 315 272 303 213],894,5,3062,4.330975954738331,40.0,0.0
707,0,707,[297 315 272 303 213],894,5,3067,4.331920903954802,40.0,0.0
708,0,708,[297 315 272 303 213],894,5,3072,4.332863187588153,40.0,0.0
709,0,709,[297 315 272 303 213],334,5,3077,4.333802816901408,40.0,0.0
710,0,710,[297 315 272 303 213],894,5,3082,4.334739803094234,40.0,0.0
711,0,711,[297 315 272 303 213],334,5,3087,4.33567415730337,40.0,0.0
712,0,712,[297 315 272 303 213],334,5,3092,4.336605890603086,40.0,0.0
713,0,713,[297 315 272 303 213],334,5,3097,4.337535014005602,40.0,0.0
714,0,714,[213 290 216 275 222],524,2,3099,4.334265734265735,0.0,40.0
715,0,715,[297 315 272 303 213],894,5,3104,4.335195530726257,40.0,0.0
716,0,716,[297 315 272 303 213],334,5,3109,4.336122733612274,40.0,0.0
717,0,717,[297 315 272 303 213],334,5,3114,4.337047353760446,40.0,0.0
718,0,718,[297 315 272 303 213],894,5,3119,4.337969401947149,40.0,0.0
719,0,719,[297 315 272 303 213],334,5,3124,4.338888888888889,40.0,0.0
720,0,720,[297 315 272 303 213],894,5,3129,4.339805825242719,40.0,0.0
721,0,721,[297 315 272 303 213],894,5,3134,4.340720221606648,40.0,0.0
722,0,722,[297 315 272 303 213],894,5,3139,4.341632088520055,40.0,0.0
723,0,723,[297 315 272 303 213],894,5,3144,4.342541436464089,40.0,0.0
724,0,724,[284 316 298 246 275],145,3,3147,4.3406896551724135,20.0,20.0
725,0,725,[297 315 272 303 213],334,5,3152,4.341597796143251,40.0,0.0
726,0,726,[297 315 272 303 213],894,5,3157,4.342503438789546,40.0,0.0
727,0,727,[297 315 272 303 213],334,5,3162,4.343406593406593,40.0,0.0
728,0,728,[297 315 272 303 213],334,5,3167,4.344307270233196,40.0,0.0
729,0,729,[297 315 272 303 213],894,5,3172,4.345205479452055,40.0,0.0
730,0,730,[297 315 272 303 213],894,5,3177,4.346101231190151,40.0,0.0
731,0,731,[297 315 272 303 213],894,5,3182,4.3469945355191255,40.0,0.0
732,0,732,[297 315 272 303 213],334,5,3187,4.3478854024556615,40.0,0.0
733,0,733,[297 315 272 303 213],894,5,3192,4.348773841961853,40.0,0.0
734,0,734,[297 315 272 303 213],894,5,3197,4.349659863945578,40.0,0.0
735,0,735,[303 221 284 485 276],6,2,3199,4.346467391304348,0.0,20.0
736,0,736,[297 315 272 213 303],334,5,3204,4.347354138398915,40.0,0.0
737,0,737,[297 315 272 213 303],334,5,3209,4.348238482384824,40.0,0.0
738,0,738,[297 315 272 213 303],894,5,3214,4.349120433017592,40.0,0.0
739,0,739,[297 315 272 213 303],894,5,3219,4.35,40.0,0.0
740,0,740,[297 315 272 213 303],894,5,3224,4.350877192982456,40.0,0.0
741,0,741,[297 315 272 213 303],334,5,3229,4.3517520215633425,40.0,0.0
742,0,742,[297 315 272 213 303],894,5,3234,4.352624495289367,40.0,0.0
743,0,743,[297 315 272 213 303],334,5,3239,4.353494623655914,40.0,0.0
744,0,744,[297 315 272 213 303],334,5,3244,4.354362416107382,40.0,0.0
745,0,745,[297 315 272 213 303],894,5,3249,4.355227882037534,40.0,0.0
746,0,746,[297 315 272 213 303],334,5,3254,4.356091030789826,40.0,0.0
747,0,747,[297 315 272 213 303],334,5,3259,4.356951871657754,40.0,0.0
748,0,748,[297 315 272 213 303],334,5,3264,4.35781041388518,40.0,0.0
749,0,749,[297 315 272 213 303],334,5,3269,4.358666666666666,40.0,0.0
750,0,750,[297 315 272 213 303],894,5,3274,4.359520639147803,40.0,0.0
751,0,751,[297 315 272 213 303],334,5,3279,4.360372340425532,40.0,0.0
752,0,752,[297 315 272 213 303],894,5,3284,4.3612217795484725,40.0,0.0
753,0,753,[297 315 272 213 303],894,5,3289,4.362068965517241,40.0,0.0
754,0,754,[297 315 272 213 303],894,5,3294,4.362913907284768,40.0,0.0
755,0,755,[297 315 272 213 303],894,5,3299,4.363756613756614,40.0,0.0
756,0,756,[297 315 272 213 303],894,5,3304,4.364597093791281,40.0,0.0
757,0,757,[297 315 272 213 303],894,5,3309,4.3654353562005275,40.0,0.0
758,0,758,[297 315 272 213 303],334,5,3314,4.366271409749671,40.0,0.0
759,0,759,[297 315 272 213 303],894,5,3319,4.367105263157895,40.0,0.0
760,0,760,[275 222 299 221 243],537,1,3320,4.362680683311432,0.0,40.0
761,0,761,[297 315 272 213 303],894,5,3325,4.363517060367454,40.0,0.0
762,0,762,[297 315 272 213 303],894,5,3330,4.3643512450851905,40.0,0.0
763,0,763,[297 315 272 213 303],334,5,3335,4.365183246073299,40.0,0.0
764,0,764,[297 315 272 213 303],894,5,3340,4.366013071895424,40.0,0.0
765,0,765,[297 315 272 213 303],894,5,3345,4.366840731070496,40.0,0.0
766,0,766,[297 315 272 213 303],894,5,3350,4.367666232073011,40.0,0.0
767,0,767,[297 315 272 213 303],894,5,3355,4.368489583333333,40.0,0.0
768,0,768,[297 315 272 213 303],894,5,3360,4.369310793237972,40.0,0.0
769,0,769,[297 315 272 213 303],334,5,3365,4.37012987012987,40.0,0.0
770,0,770,[211 478 230 284 215],537,2,3367,4.367055771725032,0.0,20.0
771,0,771,[301 223 315 217 429],650,1,3368,4.362694300518135,40.0,0.0
772,0,772,[216 321 268 272 508],13,2,3370,4.359637774902976,0.0,0.0
773,0,773,[272 297 315 213 303],894,5,3375,4.3604651162790695,40.0,0.0
774,0,774,[272 297 315 213 303],334,5,3380,4.361290322580645,40.0,0.0
775,0,775,[272 297 315 213 303],334,5,3385,4.362113402061856,40.0,0.0
776,0,776,[230 367 215 478 209],650,2,3387,4.359073359073359,0.0,0.0
777,0,777,[272 297 315 213 303],334,5,3392,4.359897172236503,40.0,0.0
778,0,778,[272 297 315 213 303],894,5,3397,4.360718870346598,40.0,0.0
779,0,779,[272 297 315 213 303],894,5,3402,4.361538461538461,40.0,0.0
780,0,780,[272 297 315 213 303],894,5,3407,4.36235595390525,40.0,0.0
781,0,781,[264 230 218 420 268],13,3,3410,4.360613810741688,0.0,0.0
782,0,782,[202 300 208 222 215],537,1,3411,4.35632183908046,0.0,40.0
783,0,783,[272 297 315 213 303],334,5,3416,4.357142857142857,40.0,0.0
784,0,784,[272 297 315 213 303],334,5,3421,4.357961783439491,40.0,0.0
785,0,785,[272 297 315 213 303],334,5,3426,4.358778625954199,40.0,0.0
786,0,786,[272 297 315 213 303],334,5,3431,4.3595933926302415,40.0,0.0
787,0,787,[209 223 508 276 280],13,3,3434,4.3578680203045685,20.0,20.0
788,0,788,[272 297 315 213 303],334,5,3439,4.358681875792142,40.0,0.0
789,0,789,[272 297 315 213 303],334,5,3444,4.359493670886076,40.0,0.0
790,0,790,[272 297 315 213 303],894,5,3449,4.360303413400758,40.0,0.0
791,0,791,[272 297 315 213 303],334,5,3454,4.361111111111111,40.0,0.0
792,0,792,[272 297 315 213 303],334,5,3459,4.3619167717528375,40.0,0.0
793,0,793,[272 297 315 213 303],334,5,3464,4.36272040302267,40.0,0.0
794,0,794,[272 297 315 213 303],334,5,3469,4.363522012578616,40.0,0.0
795,0,795,[272 297 315 213 303],334,5,3474,4.364321608040201,40.0,0.0
796,0,796,[272 297 315 213 303],894,5,3479,4.365119196988708,40.0,0.0
797,0,797,[272 297 315 213 303],334,5,3484,4.365914786967418,40.0,0.0
798,0,798,[272 297 315 213 303],334,5,3489,4.366708385481853,40.0,0.0
799,0,799,[272 297 315 213 303],894,5,3494,4.3675,40.0,0.0
800,0,800,[272 297 315 213 303],894,5,3499,4.368289637952559,40.0,0.0
801,0,801,[272 297 315 213 303],334,5,3504,4.369077306733167,40.0,0.0
802,0,802,[272 297 315 213 303],334,5,3509,4.36986301369863,40.0,0.0
803,0,803,[272 297 315 213 303],334,5,3514,4.370646766169155,40.0,0.0
804,0,804,[272 297 315 213 303],334,5,3519,4.371428571428571,40.0,0.0
805,0,805,[272 297 315 213 303],894,5,3524,4.3722084367245655,40.0,0.0
806,0,806,[272 297 315 213 303],894,5,3529,4.372986369268897,40.0,0.0
807,0,807,[272 297 315 213 303],334,5,3534,4.373762376237623,40.0,0.0
808,0,808,[272 297 315 213 303],334,5,3539,4.374536464771323,40.0,0.0
809,0,809,[272 297 315 213 303],334,5,3544,4.375308641975309,40.0,0.0
810,0,810,[272 297 315 213 303],334,5,3549,4.3760789149198525,40.0,0.0
811,0,811,[272 297 315 213 303],334,5,3554,4.376847290640394,40.0,0.0
812,0,812,[272 297 315 213 303],334,5,3559,4.377613776137761,40.0,0.0
813,0,813,[316 301 431 209 276],145,4,3563,4.377149877149877,20.0,20.0
814,0,814,[272 297 315 213 303],334,5,3568,4.3779141104294474,40.0,0.0
815,0,815,[272 297 315 213 303],334,5,3573,4.3786764705882355,40.0,0.0
816,0,816,[272 297 315 213 303],334,5,3578,4.379436964504284,40.0,0.0
817,0,817,[272 297 315 213 303],894,5,3583,4.380195599022005,40.0,0.0
818,0,818,[272 297 315 213 303],894,5,3588,4.380952380952381,40.0,0.0
819,0,819,[272 297 315 213 303],894,5,3593,4.381707317073171,40.0,0.0
820,0,820,[272 297 315 213 303],334,5,3598,4.382460414129111,40.0,0.0
821,0,821,[272 297 315 213 303],894,5,3603,4.383211678832117,40.0,0.0
822,0,822,[272 297 315 213 303],334,5,3608,4.383961117861483,40.0,0.0
823,0,823,[272 297 315 213 303],334,5,3613,4.384708737864078,40.0,0.0
824,0,824,[272 297 315 213 303],334,5,3618,4.385454545454546,40.0,0.0
825,0,825,[272 297 315 213 303],334,5,3623,4.386198547215496,40.0,0.0
826,0,826,[272 297 315 213 303],334,5,3628,4.386940749697702,40.0,0.0
827,0,827,[272 297 315 213 303],334,5,3633,4.38768115942029,40.0,0.0
828,0,828,[272 297 315 213 303],334,5,3638,4.388419782870929,40.0,0.0
829,0,829,[272 297 315 213 303],334,5,3643,4.389156626506024,40.0,0.0
830,0,830,[272 297 315 213 303],334,5,3648,4.389891696750903,40.0,0.0
831,0,831,[272 297 315 213 303],334,5,3653,4.390625,40.0,0.0
832,0,832,[272 297 315 213 303],334,5,3658,4.391356542617046,40.0,0.0
833,0,833,[272 297 315 213 303],894,5,3663,4.392086330935252,40.0,0.0
834,0,834,[326 208 218 392 420],311,3,3666,4.390419161676647,0.0,0.0
835,0,835,[272 297 315 213 303],334,5,3671,4.391148325358851,40.0,0.0
836,0,836,[272 297 315 213 303],894,5,3676,4.391875746714456,40.0,0.0
837,0,837,[272 297 315 213 303],334,5,3681,4.392601431980907,40.0,0.0
838,0,838,[272 297 315 213 303],894,5,3686,4.393325387365912,40.0,0.0
839,0,839,[331 215 301 218 481],13,1,3687,4.389285714285714,0.0,0.0
840,0,840,[272 297 315 213 303],894,5,3692,4.390011890606421,40.0,0.0
841,0,841,[272 297 315 213 303],334,5,3697,4.390736342042755,40.0,0.0
842,0,842,[272 297 315 213 303],894,5,3702,4.391459074733096,40.0,0.0
843,0,843,[236 255 283 326 295],937,3,3705,4.389810426540285,0.0,0.0
844,0,844,[272 297 315 213 303],334,5,3710,4.390532544378698,40.0,0.0
845,0,845,[272 297 315 213 303],894,5,3715,4.391252955082742,40.0,0.0
846,0,846,[222 390 239 211 301],279,3,3718,4.3896103896103895,0.0,40.0
847,0,847,[272 297 315 213 303],894,5,3723,4.390330188679245,40.0,0.0
848,0,848,[272 297 315 213 303],894,5,3728,4.391048292108363,40.0,0.0
849,0,849,[272 297 315 213 303],894,5,3733,4.391764705882353,40.0,0.0
850,0,850,[272 297 315 213 303],334,5,3738,4.392479435957696,40.0,0.0
851,0,851,[272 297 315 213 303],334,5,3743,4.393192488262911,40.0,0.0
852,0,852,[272 297 315 213 303],334,5,3748,4.39390386869871,40.0,0.0
853,0,853,[394 301 264 485 201],13,1,3749,4.389929742388759,0.0,0.0
854,0,854,[272 297 315 213 303],894,5,3754,4.390643274853801,40.0,0.0
855,0,855,[272 297 315 213 303],334,5,3759,4.391355140186916,40.0,0.0
856,0,856,[272 297 315 213 303],334,5,3764,4.392065344224037,40.0,0.0
857,0,857,[272 297 315 213 303],334,5,3769,4.392773892773893,40.0,0.0
858,0,858,[272 297 315 213 303],334,5,3774,4.393480791618161,40.0,0.0
859,0,859,[272 297 315 213 303],894,5,3779,4.394186046511628,40.0,0.0
860,0,860,[272 297 315 213 303],894,5,3784,4.394889663182346,40.0,0.0
861,0,861,[272 297 315 213 303],894,5,3789,4.395591647331787,40.0,0.0
862,0,862,[272 297 315 213 303],894,5,3794,4.3962920046349945,40.0,0.0
863,0,863,[272 297 315 213 303],334,5,3799,4.3969907407407405,40.0,0.0
864,0,864,[272 297 315 213 303],334,5,3804,4.3976878612716765,40.0,0.0
865,0,865,[272 297 315 213 303],334,5,3809,4.3983833718244805,40.0,0.0
866,0,866,[272 297 315 213 303],334,5,3814,4.399077277970012,40.0,0.0
867,0,867,[272 297 315 213 303],894,5,3819,4.399769585253456,40.0,0.0
868,0,868,[272 297 315 213 303],334,5,3824,4.400460299194476,40.0,0.0
869,0,869,[272 297 315 213 303],894,5,3829,4.401149425287357,40.0,0.0
870,0,870,[272 297 315 213 303],334,5,3834,4.401836969001148,40.0,0.0
871,0,871,[272 297 315 213 303],334,5,3839,4.402522935779817,40.0,0.0
872,0,872,[272 297 315 213 303],334,5,3844,4.403207331042383,40.0,0.0
873,0,873,[272 297 315 213 303],334,5,3849,4.4038901601830664,40.0,0.0
874,0,874,[272 297 315 213 303],894,5,3854,4.404571428571429,40.0,0.0
875,0,875,[272 297 315 213 303],334,5,3859,4.405251141552512,40.0,0.0
876,0,876,[272 297 315 213 303],894,5,3864,4.405929304446978,40.0,0.0
877,0,877,[272 297 315 213 303],334,5,3869,4.406605922551253,40.0,0.0
878,0,878,[272 297 315 213 303],334,5,3874,4.407281001137656,40.0,0.0
879,0,879,[272 297 315 213 303],894,5,3879,4.407954545454546,40.0,0.0
880,0,880,[272 297 315 213 303],334,5,3884,4.408626560726447,40.0,0.0
881,0,881,[272 297 315 213 303],894,5,3889,4.409297052154195,40.0,0.0
882,0,882,[272 297 315 213 303],894,5,3894,4.409966024915062,40.0,0.0
883,0,883,[272 297 315 213 303],894,5,3899,4.410633484162896,40.0,0.0
884,0,884,[272 297 315 213 303],894,5,3904,4.411299435028249,40.0,0.0
885,0,885,[280 246 297 350 264],894,2,3906,4.408577878103838,20.0,0.0
886,0,886,[272 297 315 213 303],894,5,3911,4.409244644870349,40.0,0.0
887,0,887,[272 297 315 213 303],334,5,3916,4.40990990990991,40.0,0.0
888,0,888,[208 226 241 336 230],13,2,3918,4.407199100112486,0.0,0.0
889,0,889,[272 297 315 213 303],894,5,3923,4.407865168539326,40.0,0.0
890,0,890,[272 297 315 213 303],334,5,3928,4.408529741863076,40.0,0.0
891,0,891,[272 297 315 213 303],334,5,3933,4.4091928251121075,40.0,0.0
892,0,892,[272 297 315 213 303],334,5,3938,4.409854423292273,40.0,0.0
893,0,893,[272 297 315 213 303],894,5,3943,4.410514541387025,40.0,0.0
894,0,894,[272 297 315 213 303],334,5,3948,4.4111731843575415,40.0,0.0
895,0,895,[431 218 219 485 507],406,1,3949,4.407366071428571,0.0,0.0
896,0,896,[272 297 315 213 303],894,5,3954,4.408026755852843,40.0,0.0
897,0,897,[272 297 315 213 303],894,5,3959,4.408685968819599,40.0,0.0
898,0,898,[272 297 315 213 303],334,5,3964,4.409343715239155,40.0,0.0
899,0,899,[272 297 315 213 303],894,5,3969,4.41,40.0,0.0
900,0,900,[272 297 315 213 303],334,5,3974,4.410654827968924,40.0,0.0
901,0,901,[272 297 315 213 303],334,5,3979,4.411308203991131,40.0,0.0
902,0,902,[272 297 315 213 303],894,5,3984,4.411960132890365,40.0,0.0
903,0,903,[478 429 239 280 231],749,5,3989,4.412610619469026,0.0,0.0
904,0,904,[272 297 315 213 303],334,5,3994,4.413259668508287,40.0,0.0
905,0,905,[272 297 315 213 303],894,5,3999,4.413907284768212,40.0,0.0
906,0,906,[232 227 261 452 217],13,1,4000,4.410143329658214,0.0,0.0
907,0,907,[272 297 315 213 303],894,5,4005,4.4107929515418505,40.0,0.0
908,0,908,[272 297 315 213 303],334,5,4010,4.411441144114411,40.0,0.0
909,0,909,[272 297 315 213 303],334,5,4015,4.412087912087912,40.0,0.0
910,0,910,[272 297 315 213 303],894,5,4020,4.4127332601536775,40.0,0.0
911,0,911,[272 297 315 213 303],334,5,4025,4.413377192982456,40.0,0.0
912,0,912,[272 297 315 213 303],894,5,4030,4.414019715224534,40.0,0.0
913,0,913,[272 297 315 213 303],334,5,4035,4.414660831509847,40.0,0.0
914,0,914,[272 297 315 213 303],894,5,4040,4.415300546448087,40.0,0.0
915,0,915,[272 297 315 213 303],894,5,4045,4.415938864628821,40.0,0.0
916,0,916,[272 297 315 213 303],894,5,4050,4.416575790621592,40.0,0.0
917,0,917,[272 297 315 213 303],894,5,4055,4.417211328976035,40.0,0.0
918,0,918,[384 331 239 275 315],883,1,4056,4.413492927094668,20.0,20.0
919,0,919,[272 297 213 303 315],334,5,4061,4.414130434782609,40.0,0.0
920,0,920,[272 297 213 303 315],894,5,4066,4.414766558089034,40.0,0.0
921,0,921,[272 297 213 303 315],334,5,4071,4.415401301518438,40.0,0.0
922,0,922,[272 297 213 303 315],334,5,4076,4.416034669555796,40.0,0.0
923,0,923,[272 297 213 303 315],334,5,4081,4.416666666666667,40.0,0.0
924,0,924,[272 297 213 303 315],894,5,4086,4.4172972972972975,40.0,0.0
925,0,925,[420 276 202 509 216],452,1,4087,4.413606911447085,0.0,20.0
926,0,926,[297 272 213 303 315],894,5,4092,4.414239482200648,40.0,0.0
927,0,927,[297 272 213 303 315],334,5,4097,4.414870689655173,40.0,0.0
928,0,928,[297 272 213 303 315],894,5,4102,4.4155005382131325,40.0,0.0
929,0,929,[297 272 213 303 315],894,5,4107,4.416129032258064,40.0,0.0
930,0,930,[297 272 213 303 315],894,5,4112,4.4167561761546725,40.0,0.0
931,0,931,[222 227 226 211 378],843,0,4112,4.412017167381975,0.0,40.0
932,0,932,[272 297 213 303 315],334,5,4117,4.412647374062165,40.0,0.0
933,0,933,[272 297 213 303 315],894,5,4122,4.413276231263383,40.0,0.0
934,0,934,[272 297 213 303 315],894,5,4127,4.413903743315508,40.0,0.0
935,0,935,[272 297 213 303 315],894,5,4132,4.414529914529915,40.0,0.0
936,0,936,[272 297 213 303 315],894,5,4137,4.415154749199573,40.0,0.0
937,0,937,[272 297 213 303 315],894,5,4142,4.415778251599147,40.0,0.0
938,0,938,[272 297 213 303 315],334,5,4147,4.41640042598509,40.0,0.0
939,0,939,[272 297 213 303 315],334,5,4152,4.417021276595745,40.0,0.0
940,0,940,[272 297 213 303 315],334,5,4157,4.417640807651435,40.0,0.0
941,0,941,[272 297 213 303 315],334,5,4162,4.418259023354564,40.0,0.0
942,0,942,[272 297 213 303 315],334,5,4167,4.418875927889713,40.0,0.0
943,0,943,[378 485 216 367 478],234,2,4169,4.416313559322034,0.0,0.0
944,0,944,[231 452 384 367 213],7,2,4171,4.413756613756614,0.0,0.0
945,0,945,[212 202 232 259 226],194,0,4171,4.409090909090909,0.0,0.0
946,0,946,[297 272 303 315 213],894,5,4176,4.409714889123548,40.0,0.0
947,0,947,[297 272 303 315 213],894,5,4181,4.410337552742616,40.0,0.0
948,0,948,[297 272 303 315 213],334,5,4186,4.410958904109589,40.0,0.0
949,0,949,[297 272 303 315 213],894,5,4191,4.4115789473684215,40.0,0.0
950,0,950,[297 272 303 315 213],894,5,4196,4.412197686645636,40.0,0.0
951,0,951,[297 272 303 315 213],334,5,4201,4.41281512605042,40.0,0.0
952,0,952,[297 272 303 315 213],894,5,4206,4.413431269674711,40.0,0.0
953,0,953,[297 272 303 315 213],334,5,4211,4.414046121593292,40.0,0.0
954,0,954,[227 226 216 259 583],7,2,4213,4.4115183246073295,0.0,0.0
955,0,955,[315 297 256 324 244],894,3,4216,4.410041841004184,40.0,0.0
956,0,956,[297 272 303 315 213],894,5,4221,4.410658307210031,40.0,0.0
957,0,957,[297 272 303 315 213],894,5,4226,4.411273486430063,40.0,0.0
958,0,958,[297 272 303 315 213],334,5,4231,4.411887382690303,40.0,0.0
959,0,959,[297 272 303 315 213],334,5,4236,4.4125,40.0,0.0
960,0,960,[297 272 303 315 213],334,5,4241,4.4131113423517165,40.0,0.0
961,0,961,[297 272 303 315 213],894,5,4246,4.413721413721413,40.0,0.0
962,0,962,[297 272 303 315 213],894,5,4251,4.414330218068536,40.0,0.0
963,0,963,[297 272 303 315 213],894,5,4256,4.4149377593361,40.0,0.0
964,0,964,[231 219 201 220 239],92,2,4258,4.412435233160622,0.0,0.0
965,0,965,[297 272 303 315 213],334,5,4263,4.413043478260869,40.0,0.0
966,0,966,[297 272 303 315 213],894,5,4268,4.413650465356773,40.0,0.0
967,0,967,[223 485 429 507 208],650,3,4271,4.412190082644628,20.0,0.0
968,0,968,[297 272 303 315 213],334,5,4276,4.412796697626419,40.0,0.0
969,0,969,[297 272 303 315 213],894,5,4281,4.41340206185567,40.0,0.0
970,0,970,[231 283 226 431 230],537,2,4283,4.41091658084449,0.0,0.0
971,0,971,[272 297 303 315 213],334,5,4288,4.411522633744856,40.0,0.0
972,0,972,[272 297 303 315 213],334,5,4293,4.4121274409044196,40.0,0.0
973,0,973,[272 297 303 315 213],334,5,4298,4.412731006160164,40.0,0.0
974,0,974,[272 297 303 315 213],334,5,4303,4.413333333333333,40.0,0.0
975,0,975,[206 222 226 213 276],234,1,4304,4.409836065573771,0.0,40.0
976,0,976,[264 226 508 315 222],13,3,4307,4.408393039918117,20.0,20.0
977,0,977,[272 297 315 303 213],334,5,4312,4.408997955010225,40.0,0.0
978,0,978,[272 297 315 303 213],334,5,4317,4.409601634320736,40.0,0.0
979,0,979,[272 297 315 303 213],894,5,4322,4.410204081632653,40.0,0.0
980,0,980,[272 297 315 303 213],894,5,4327,4.410805300713558,40.0,0.0
981,0,981,[272 297 315 303 213],894,5,4332,4.411405295315682,40.0,0.0
982,0,982,[272 297 315 303 213],894,5,4337,4.412004069175992,40.0,0.0
983,0,983,[284 223 236 429 300],234,1,4338,4.408536585365853,20.0,20.0
984,0,984,[272 297 315 303 213],894,5,4343,4.409137055837563,40.0,0.0
985,0,985,[272 297 315 303 213],334,5,4348,4.40973630831643,40.0,0.0
986,0,986,[272 297 315 303 213],334,5,4353,4.410334346504559,40.0,0.0
987,0,987,[272 297 315 303 213],894,5,4358,4.410931174089069,40.0,0.0
988,0,988,[272 297 315 303 213],334,5,4363,4.411526794742164,40.0,0.0
989,0,989,[272 297 315 303 213],894,5,4368,4.412121212121212,40.0,0.0
990,0,990,[272 297 315 303 213],334,5,4373,4.412714429868819,40.0,0.0
991,0,991,[272 297 315 303 213],334,5,4378,4.413306451612903,40.0,0.0
992,0,992,[429 208 230 367 218],59,5,4383,4.413897280966768,0.0,0.0
993,0,993,[272 297 315 303 213],894,5,4388,4.414486921529175,40.0,0.0
994,0,994,[272 297 315 303 213],334,5,4393,4.415075376884422,40.0,0.0
995,0,995,[272 297 315 303 213],334,5,4398,4.4156626506024095,40.0,0.0
996,0,996,[272 297 315 303 213],334,5,4403,4.4162487462387165,40.0,0.0
997,0,997,[264 202 431 280 315],13,4,4407,4.415831663326653,20.0,0.0
998,0,998,[243 239 315 280 223],13,4,4411,4.415415415415415,40.0,0.0
999,0,999,[272 297 315 303 213],894,5,4416,4.416,40.0,0.0
1000,0,1000,[272 297 315 303 213],894,5,4421,4.416583416583417,40.0,0.0
1001,0,1001,[272 297 315 303 213],894,5,4426,4.417165668662674,40.0,0.0
1002,0,1002,[272 297 315 303 213],334,5,4431,4.4177467597208375,40.0,0.0
1003,0,1003,[452 413 315 222 241],13,1,4432,4.414342629482071,20.0,20.0
1004,0,1004,[272 297 315 303 213],334,5,4437,4.414925373134328,40.0,0.0
1005,0,1005,[272 297 315 303 213],894,5,4442,4.415506958250497,40.0,0.0
1006,0,1006,[272 297 315 303 213],894,5,4447,4.416087388282026,40.0,0.0
1007,0,1007,[272 297 315 303 213],894,5,4452,4.416666666666667,40.0,0.0
1008,0,1008,[226 218 216 367 239],92,2,4454,4.414271555996035,0.0,0.0
1009,0,1009,[272 297 315 303 213],894,5,4459,4.414851485148515,40.0,0.0
1010,0,1010,[272 297 315 303 213],894,5,4464,4.415430267062314,40.0,0.0
1011,0,1011,[272 297 315 303 213],334,5,4469,4.41600790513834,40.0,0.0
1012,0,1012,[272 297 315 303 213],894,5,4474,4.416584402764067,40.0,0.0
1013,0,1013,[272 297 315 303 213],334,5,4479,4.4171597633136095,40.0,0.0
1014,0,1014,[272 297 315 303 213],334,5,4484,4.4177339901477835,40.0,0.0
1015,0,1015,[272 297 315 303 213],894,5,4489,4.418307086614173,40.0,0.0
1016,0,1016,[272 297 315 303 213],334,5,4494,4.4188790560471976,40.0,0.0
1017,0,1017,[272 297 315 303 213],334,5,4499,4.419449901768173,40.0,0.0
1018,0,1018,[272 297 315 303 213],334,5,4504,4.420019627085378,40.0,0.0
1019,0,1019,[272 297 315 303 213],894,5,4509,4.420588235294118,40.0,0.0
1020,0,1020,[272 297 315 303 213],894,5,4514,4.421155729676787,40.0,0.0
1021,0,1021,[272 297 315 303 213],894,5,4519,4.421722113502935,40.0,0.0
1022,0,1022,[272 297 315 303 213],334,5,4524,4.422287390029325,40.0,0.0
1023,0,1023,[272 297 315 303 213],894,5,4529,4.4228515625,40.0,0.0
1024,0,1024,[272 297 315 303 213],334,5,4534,4.423414634146342,40.0,0.0
1025,0,1025,[272 297 315 303 213],334,5,4539,4.423976608187134,40.0,0.0
1026,0,1026,[272 297 315 303 213],334,5,4544,4.424537487828627,40.0,0.0
1027,0,1027,[272 297 315 303 213],334,5,4549,4.425097276264592,40.0,0.0
1028,0,1028,[272 297 315 303 213],334,5,4554,4.425655976676385,40.0,0.0
1029,0,1029,[272 297 315 303 213],894,5,4559,4.42621359223301,40.0,0.0
1030,0,1030,[272 297 315 303 213],334,5,4564,4.426770126091173,40.0,0.0
1031,0,1031,[272 297 315 303 213],894,5,4569,4.4273255813953485,40.0,0.0
1032,0,1032,[272 297 315 303 213],894,5,4574,4.4278799612778315,40.0,0.0
1033,0,1033,[272 297 315 303 213],894,5,4579,4.428433268858801,40.0,0.0
1034,0,1034,[272 297 315 303 213],894,5,4584,4.428985507246376,40.0,0.0
1035,0,1035,[272 297 315 303 213],334,5,4589,4.42953667953668,40.0,0.0
1036,0,1036,[272 297 315 303 213],894,5,4594,4.430086788813886,40.0,0.0
1037,0,1037,[272 297 315 303 213],334,5,4599,4.430635838150289,40.0,0.0
1038,0,1038,[230 226 219 216 259],7,2,4601,4.4282964388835415,0.0,0.0
1039,0,1039,[272 297 315 303 213],894,5,4606,4.428846153846154,40.0,0.0
1040,0,1040,[209 239 241 230 216],194,0,4606,4.424591738712776,0.0,0.0
1041,0,1041,[272 297 315 303 213],894,5,4611,4.425143953934741,40.0,0.0
1042,0,1042,[272 297 315 303 213],894,5,4616,4.425695110258869,40.0,0.0
1043,0,1043,[272 297 315 303 213],334,5,4621,4.426245210727969,40.0,0.0
1044,0,1044,[272 297 315 303 213],334,5,4626,4.426794258373206,40.0,0.0
1045,0,1045,[272 297 315 303 213],334,5,4631,4.427342256214149,40.0,0.0
1046,0,1046,[272 297 315 303 213],334,5,4636,4.4278892072588345,40.0,0.0
1047,0,1047,[272 297 315 303 213],334,5,4641,4.4284351145038165,40.0,0.0
1048,0,1048,[272 297 315 303 213],894,5,4646,4.428979980934223,40.0,0.0
1049,0,1049,[272 297 315 303 213],334,5,4651,4.429523809523809,40.0,0.0
1050,0,1050,[215 241 221 202 201],537,0,4651,4.425309229305423,0.0,0.0
1051,0,1051,[315 276 326 222 239],311,3,4654,4.423954372623574,20.0,40.0
1052,0,1052,[272 297 315 303 213],894,5,4659,4.4245014245014245,40.0,0.0
1053,0,1053,[272 297 315 303 213],334,5,4664,4.425047438330171,40.0,0.0
1054,0,1054,[272 297 315 303 213],334,5,4669,4.425592417061611,40.0,0.0
1055,0,1055,[272 297 315 303 213],894,5,4674,4.426136363636363,40.0,0.0
1056,0,1056,[272 297 315 303 213],894,5,4679,4.426679280983917,40.0,0.0
1057,0,1057,[272 297 315 303 213],894,5,4684,4.427221172022684,40.0,0.0
1058,0,1058,[272 297 315 303 213],894,5,4689,4.427762039660057,40.0,0.0
1059,0,1059,[272 297 315 303 213],894,5,4694,4.428301886792453,40.0,0.0
1060,0,1060,[272 297 315 303 213],894,5,4699,4.4288407163053725,40.0,0.0
1061,0,1061,[420 254 275 223 583],308,4,4703,4.428436911487759,20.0,20.0
1062,0,1062,[272 297 315 303 213],334,5,4708,4.4289746001881465,40.0,0.0
1063,0,1063,[272 297 315 303 213],894,5,4713,4.429511278195489,40.0,0.0
1064,0,1064,[272 297 315 303 213],894,5,4718,4.430046948356807,40.0,0.0
1065,0,1065,[272 297 315 303 213],334,5,4723,4.430581613508442,40.0,0.0
1066,0,1066,[272 297 315 303 213],894,5,4728,4.431115276476101,40.0,0.0
1067,0,1067,[272 297 315 303 213],894,5,4733,4.431647940074907,40.0,0.0
1068,0,1068,[272 297 315 303 213],334,5,4738,4.432179607109448,40.0,0.0
1069,0,1069,[272 297 315 303 213],334,5,4743,4.432710280373832,40.0,0.0
1070,0,1070,[272 297 315 303 213],894,5,4748,4.433239962651728,40.0,0.0
1071,0,1071,[272 297 315 303 213],894,5,4753,4.433768656716418,40.0,0.0
1072,0,1072,[272 297 315 303 213],894,5,4758,4.434296365330848,40.0,0.0
1073,0,1073,[272 297 315 303 213],894,5,4763,4.434823091247672,40.0,0.0
1074,0,1074,[272 297 315 303 213],334,5,4768,4.435348837209302,40.0,0.0
1075,0,1075,[231 298 202 226 300],102,1,4769,4.432156133828996,0.0,20.0
1076,0,1076,[297 272 315 303 213],894,5,4774,4.432683379758589,40.0,0.0
1077,0,1077,[297 272 315 303 213],894,5,4779,4.433209647495362,40.0,0.0
1078,0,1078,[297 272 315 303 213],894,5,4784,4.433734939759036,40.0,0.0
1079,0,1079,[297 272 315 303 213],894,5,4789,4.434259259259259,40.0,0.0
1080,0,1080,[297 272 315 303 213],334,5,4794,4.434782608695652,40.0,0.0
1081,0,1081,[297 272 315 303 213],334,5,4799,4.435304990757856,40.0,0.0
1082,0,1082,[297 272 315 303 213],334,5,4804,4.435826408125577,40.0,0.0
1083,0,1083,[303 276 246 283 209],334,4,4808,4.435424354243542,0.0,20.0
1084,0,1084,[297 272 315 303 213],334,5,4813,4.43594470046083,40.0,0.0
1085,0,1085,[297 272 315 303 213],334,5,4818,4.43646408839779,40.0,0.0
1086,0,1086,[297 272 315 303 213],334,5,4823,4.436982520699172,40.0,0.0
1087,0,1087,[297 272 315 303 213],334,5,4828,4.4375,40.0,0.0
1088,0,1088,[297 272 315 303 213],894,5,4833,4.43801652892562,40.0,0.0
1089,0,1089,[297 272 315 303 213],334,5,4838,4.438532110091743,40.0,0.0
1090,0,1090,[297 272 315 303 213],334,5,4843,4.439046746104491,40.0,0.0
1091,0,1091,[297 272 315 303 213],894,5,4848,4.43956043956044,40.0,0.0
1092,0,1092,[297 272 315 303 213],894,5,4853,4.44007319304666,40.0,0.0
1093,0,1093,[297 272 315 303 213],894,5,4858,4.440585009140768,40.0,0.0
1094,0,1094,[297 272 315 303 213],334,5,4863,4.441095890410959,40.0,0.0
1095,0,1095,[297 272 315 303 213],894,5,4868,4.4416058394160585,40.0,0.0
1096,0,1096,[226 507 239 413 431],13,2,4870,4.439380127620784,0.0,0.0
1097,0,1097,[227 275 452 481 350],13,1,4871,4.436247723132969,0.0,20.0
1098,0,1098,[297 272 315 303 213],334,5,4876,4.436760691537762,40.0,0.0
1099,0,1099,[297 272 315 303 213],894,5,4881,4.4372727272727275,40.0,0.0
1100,0,1100,[297 272 315 303 213],894,5,4886,4.437783832879201,40.0,0.0
1101,0,1101,[297 272 315 303 213],334,5,4891,4.438294010889292,40.0,0.0
1102,0,1102,[297 272 315 303 213],894,5,4896,4.438803263825929,40.0,0.0
1103,0,1103,[297 272 315 303 213],894,5,4901,4.4393115942028984,40.0,0.0
1104,0,1104,[297 272 315 303 213],894,5,4906,4.439819004524887,40.0,0.0
1105,0,1105,[297 272 315 303 213],334,5,4911,4.440325497287523,40.0,0.0
1106,0,1106,[297 272 315 303 213],894,5,4916,4.4408310749774165,40.0,0.0
1107,0,1107,[297 272 315 303 213],334,5,4921,4.441335740072202,40.0,0.0
1108,0,1108,[297 272 315 303 213],334,5,4926,4.441839495040577,40.0,0.0
1109,0,1109,[208 230 209 431 227],59,4,4930,4.441441441441442,0.0,0.0
1110,0,1110,[297 272 315 303 213],894,5,4935,4.441944194419442,40.0,0.0
1111,0,1111,[297 272 315 303 213],334,5,4940,4.442446043165468,40.0,0.0
1112,0,1112,[297 272 315 303 213],894,5,4945,4.442946990116801,40.0,0.0
1113,0,1113,[297 272 315 303 213],894,5,4950,4.443447037701975,40.0,0.0
1114,0,1114,[297 272 315 303 213],894,5,4955,4.443946188340807,40.0,0.0
1115,0,1115,[297 272 315 303 213],894,5,4960,4.444444444444445,40.0,0.0
1116,0,1116,[297 272 315 303 213],334,5,4965,4.444941808415399,40.0,0.0
1117,0,1117,[297 272 315 303 213],334,5,4970,4.445438282647585,40.0,0.0
1118,0,1118,[222 213 231 392 255],378,2,4972,4.44325290437891,0.0,20.0
1119,0,1119,[297 272 315 303 213],894,5,4977,4.44375,40.0,0.0
1120,0,1120,[297 272 315 303 213],894,5,4982,4.444246208742195,40.0,0.0
1121,0,1121,[297 272 315 303 213],334,5,4987,4.444741532976827,40.0,0.0
1122,0,1122,[478 303 507 216 452],13,2,4989,4.442564559216384,0.0,0.0
1123,0,1123,[297 272 315 303 213],894,5,4994,4.443060498220641,40.0,0.0
1124,0,1124,[219 485 222 217 508],13,0,4994,4.439111111111111,0.0,20.0
1125,0,1125,[297 272 315 303 213],334,5,4999,4.439609236234459,40.0,0.0
1126,0,1126,[297 272 315 303 213],894,5,5004,4.440106477373558,40.0,0.0
1127,0,1127,[297 272 315 303 213],894,5,5009,4.440602836879433,40.0,0.0
1128,0,1128,[297 272 315 303 213],894,5,5014,4.441098317094774,40.0,0.0
1129,0,1129,[303 420 280 211 268],13,5,5019,4.441592920353982,0.0,20.0
1130,0,1130,[297 272 315 303 213],334,5,5024,4.4420866489832,40.0,0.0
1131,0,1131,[297 272 315 303 213],894,5,5029,4.442579505300353,40.0,0.0
1132,0,1132,[297 272 315 303 213],894,5,5034,4.443071491615181,40.0,0.0
1133,0,1133,[297 272 315 303 213],894,5,5039,4.443562610229277,40.0,0.0
1134,0,1134,[297 272 315 303 213],894,5,5044,4.444052863436124,40.0,0.0
1135,0,1135,[321 315 212 301 507],537,2,5046,4.441901408450704,20.0,0.0
1136,0,1136,[297 272 315 303 213],894,5,5051,4.442392260334213,40.0,0.0
1137,0,1137,[297 272 315 303 213],334,5,5056,4.442882249560633,40.0,0.0
1138,0,1138,[297 272 315 303 213],894,5,5061,4.443371378402107,40.0,0.0
1139,0,1139,[202 223 209 481 367],90,4,5065,4.442982456140351,20.0,0.0
1140,0,1140,[297 272 315 303 213],894,5,5070,4.443470639789658,40.0,0.0
1141,0,1141,[367 303 344 226 321],13,2,5072,4.441330998248686,0.0,0.0
1142,0,1142,[297 272 315 303 213],334,5,5077,4.441819772528434,40.0,0.0
1143,0,1143,[297 272 315 303 213],334,5,5082,4.4423076923076925,40.0,0.0
1144,0,1144,[315 202 209 222 239],13,3,5085,4.441048034934497,20.0,20.0
1145,0,1145,[297 272 315 303 213],334,5,5090,4.441535776614311,40.0,0.0
1146,0,1146,[297 272 315 303 213],894,5,5095,4.44202266782912,40.0,0.0
1147,0,1147,[297 272 315 303 213],894,5,5100,4.442508710801394,40.0,0.0
1148,0,1148,[297 272 315 303 213],334,5,5105,4.442993907745866,40.0,0.0
1149,0,1149,[297 272 315 303 213],894,5,5110,4.443478260869565,40.0,0.0
1150,0,1150,[297 272 315 303 213],334,5,5115,4.443961772371851,40.0,0.0
1151,0,1151,[297 272 315 303 213],334,5,5120,4.444444444444445,40.0,0.0
1152,0,1152,[297 272 315 303 213],334,5,5125,4.444926279271466,40.0,0.0
1153,0,1153,[297 272 315 303 213],334,5,5130,4.445407279029463,40.0,0.0
1154,0,1154,[216 240 413 217 236],145,2,5132,4.443290043290044,0.0,0.0
1155,0,1155,[272 297 315 303 213],894,5,5137,4.443771626297578,40.0,0.0
1156,0,1156,[413 216 316 394 300],145,2,5139,4.441659464131374,20.0,20.0
1157,0,1157,[272 297 315 303 213],894,5,5144,4.442141623488774,40.0,0.0
1158,0,1158,[272 297 315 303 213],894,5,5149,4.442622950819672,40.0,0.0
1159,0,1159,[272 297 315 303 213],334,5,5154,4.4431034482758625,40.0,0.0
1160,0,1160,[272 297 315 303 213],894,5,5159,4.4435831180017225,40.0,0.0
1161,0,1161,[272 297 315 303 213],334,5,5164,4.444061962134251,40.0,0.0
1162,0,1162,[226 231 218 222 254],774,0,5164,4.4402407566638,0.0,20.0
1163,0,1163,[272 297 315 303 213],894,5,5169,4.440721649484536,40.0,0.0
1164,0,1164,[272 297 315 303 213],334,5,5174,4.441201716738197,40.0,0.0
1165,0,1165,[284 283 276 236 218],533,1,5175,4.438250428816467,0.0,20.0
1166,0,1166,[272 297 315 303 213],334,5,5180,4.438731790916881,40.0,0.0
1167,0,1167,[272 297 315 303 213],894,5,5185,4.439212328767123,40.0,0.0
1168,0,1168,[272 297 315 303 213],894,5,5190,4.439692044482464,40.0,0.0
1169,0,1169,[272 297 315 303 213],334,5,5195,4.44017094017094,40.0,0.0
1170,0,1170,[272 297 315 303 213],894,5,5200,4.44064901793339,40.0,0.0
1171,0,1171,[272 297 315 303 213],334,5,5205,4.441126279863481,40.0,0.0
1172,0,1172,[272 297 315 303 213],894,5,5210,4.441602728047741,40.0,0.0
1173,0,1173,[216 508 303 201 212],537,2,5212,4.439522998296423,0.0,0.0
1174,0,1174,[272 297 315 303 213],894,5,5217,4.44,40.0,0.0
1175,0,1175,[272 297 315 303 213],334,5,5222,4.440476190476191,40.0,0.0
1176,0,1176,[272 297 315 303 213],334,5,5227,4.440951571792693,40.0,0.0
1177,0,1177,[268 232 485 212 508],85,2,5229,4.438879456706282,0.0,0.0
1178,0,1178,[272 297 315 303 213],894,5,5234,4.439355385920272,40.0,0.0
1179,0,1179,[509 215 452 218 284],308,3,5237,4.438135593220339,0.0,0.0
1180,0,1180,[272 297 315 303 213],334,5,5242,4.438611346316681,40.0,0.0
1181,0,1181,[272 297 315 303 213],894,5,5247,4.439086294416244,40.0,0.0
1182,0,1182,[508 264 239 452 272],13,3,5250,4.437869822485207,0.0,0.0
1183,0,1183,[272 297 315 303 213],894,5,5255,4.438344594594595,40.0,0.0
1184,0,1184,[272 297 315 303 213],894,5,5260,4.438818565400844,40.0,0.0
1185,0,1185,[272 297 315 303 213],334,5,5265,4.43929173693086,40.0,0.0
1186,0,1186,[272 297 315 303 213],894,5,5270,4.439764111204718,40.0,0.0
1187,0,1187,[272 297 315 303 213],334,5,5275,4.44023569023569,40.0,0.0
1188,0,1188,[272 297 315 303 213],894,5,5280,4.440706476030278,40.0,0.0
1189,0,1189,[290 350 226 452 326],13,2,5282,4.438655462184874,0.0,0.0
1190,0,1190,[272 297 315 303 213],334,5,5287,4.439126784214945,40.0,0.0
1191,0,1191,[272 297 315 303 213],894,5,5292,4.439597315436242,40.0,0.0
1192,0,1192,[452 261 384 241 243],13,0,5292,4.4358759430008385,0.0,0.0
1193,0,1193,[211 350 227 384 232],13,2,5294,4.433835845896147,0.0,20.0
1194,0,1194,[202 215 367 284 276],308,4,5298,4.43347280334728,0.0,20.0
1195,0,1195,[272 297 315 303 213],894,5,5303,4.433946488294314,40.0,0.0
1196,0,1196,[272 297 315 303 213],894,5,5308,4.434419381787803,40.0,0.0
1197,0,1197,[272 297 315 303 213],334,5,5313,4.434891485809683,40.0,0.0
1198,0,1198,[272 297 315 303 213],334,5,5318,4.43536280233528,40.0,0.0
1199,0,1199,[272 297 315 303 213],334,5,5323,4.435833333333333,40.0,0.0
1200,0,1200,[272 297 315 303 213],334,5,5328,4.436303080766028,40.0,0.0
1201,0,1201,[272 297 315 303 213],894,5,5333,4.436772046589018,40.0,0.0
1202,0,1202,[272 297 315 303 213],334,5,5338,4.437240232751455,40.0,0.0
1203,0,1203,[272 297 315 303 213],334,5,5343,4.437707641196013,40.0,0.0
1204,0,1204,[272 297 315 303 213],894,5,5348,4.438174273858921,40.0,0.0
1205,0,1205,[272 297 315 303 213],894,5,5353,4.438640132669984,40.0,0.0
1206,0,1206,[272 297 315 303 213],334,5,5358,4.4391052195526095,40.0,0.0
1207,0,1207,[272 297 315 303 213],894,5,5363,4.439569536423841,40.0,0.0
1208,0,1208,[241 240 230 231 201],774,1,5364,4.4367245657568235,0.0,0.0
1209,0,1209,[209 223 326 222 478],749,4,5368,4.4363636363636365,20.0,20.0
1210,0,1210,[297 272 315 303 213],334,5,5373,4.436829066886871,40.0,0.0
1211,0,1211,[297 272 315 303 213],334,5,5378,4.4372937293729375,40.0,0.0
1212,0,1212,[297 272 315 303 213],334,5,5383,4.4377576257213525,40.0,0.0
1213,0,1213,[420 216 321 367 213],378,3,5386,4.436573311367381,0.0,0.0
1214,0,1214,[297 272 315 303 213],894,5,5391,4.437037037037037,40.0,0.0
1215,0,1215,[297 272 315 303 213],894,5,5396,4.4375,40.0,0.0
1216,0,1216,[297 272 315 303 213],334,5,5401,4.437962202136401,40.0,0.0
1217,0,1217,[297 272 315 303 213],334,5,5406,4.438423645320197,40.0,0.0
1218,0,1218,[297 272 315 303 213],894,5,5411,4.438884331419196,40.0,0.0
1219,0,1219,[297 272 315 303 213],894,5,5416,4.439344262295082,40.0,0.0
1220,0,1220,[243 223 284 212 268],234,0,5416,4.4357084357084355,20.0,0.0
1221,0,1221,[297 272 315 303 213],894,5,5421,4.4361702127659575,40.0,0.0
1222,0,1222,[297 272 315 303 213],334,5,5426,4.436631234668847,40.0,0.0
1223,0,1223,[297 272 315 303 213],894,5,5431,4.437091503267974,40.0,0.0
1224,0,1224,[297 272 315 303 213],334,5,5436,4.437551020408163,40.0,0.0
1225,0,1225,[429 213 241 365 275],7,4,5440,4.437194127243067,0.0,20.0
1226,0,1226,[297 272 315 303 213],334,5,5445,4.4376528117359415,40.0,0.0
1227,0,1227,[297 272 315 303 213],894,5,5450,4.438110749185668,40.0,0.0
1228,0,1228,[297 272 315 303 213],894,5,5455,4.438567941415785,40.0,0.0
1229,0,1229,[222 202 208 378 223],650,2,5457,4.4365853658536585,20.0,20.0
1230,0,1230,[297 272 315 303 213],334,5,5462,4.437043054427295,40.0,0.0
1231,0,1231,[297 272 315 303 213],894,5,5467,4.4375,40.0,0.0
1232,0,1232,[297 272 315 303 213],894,5,5472,4.437956204379562,40.0,0.0
1233,0,1233,[297 272 315 303 213],894,5,5477,4.438411669367909,40.0,0.0
1234,0,1234,[297 272 315 303 213],894,5,5482,4.438866396761133,40.0,0.0
1235,0,1235,[384 264 452 336 301],13,1,5483,4.436084142394822,0.0,0.0
1236,0,1236,[297 272 315 303 213],894,5,5488,4.4365400161681485,40.0,0.0
1237,0,1237,[297 272 315 303 213],334,5,5493,4.436995153473344,40.0,0.0
1238,0,1238,[297 272 315 303 213],334,5,5498,4.437449556093624,40.0,0.0
1239,0,1239,[297 272 315 303 213],894,5,5503,4.437903225806451,40.0,0.0
1240,0,1240,[297 272 315 303 213],334,5,5508,4.438356164383562,40.0,0.0
1241,0,1241,[297 272 315 303 213],894,5,5513,4.438808373590982,40.0,0.0
1242,0,1242,[297 272 315 303 213],894,5,5518,4.439259855189059,40.0,0.0
1243,0,1243,[297 272 315 303 213],334,5,5523,4.439710610932476,40.0,0.0
1244,0,1244,[431 452 240 241 284],92,1,5524,4.436947791164658,0.0,0.0
1245,0,1245,[272 297 315 303 213],894,5,5529,4.437399678972713,40.0,0.0
1246,0,1246,[272 297 315 303 213],894,5,5534,4.4378508420208505,40.0,0.0
1247,0,1247,[272 297 315 303 213],334,5,5539,4.438301282051282,40.0,0.0
1248,0,1248,[272 297 315 303 213],334,5,5544,4.43875100080064,40.0,0.0
1249,0,1249,[272 297 315 303 213],334,5,5549,4.4392,40.0,0.0
1250,0,1250,[272 297 315 303 213],894,5,5554,4.4396482813749,40.0,0.0
1251,0,1251,[272 297 315 303 213],894,5,5559,4.4400958466453675,40.0,0.0
1252,0,1252,[254 321 297 211 384],87,3,5562,4.4389465283320035,20.0,20.0
1253,0,1253,[365 239 321 212 227],311,2,5564,4.437001594896332,0.0,0.0
1254,0,1254,[301 276 280 298 220],486,2,5566,4.435059760956175,0.0,20.0
1255,0,1255,[272 297 315 303 213],894,5,5571,4.435509554140127,40.0,0.0
1256,0,1256,[272 297 315 303 213],334,5,5576,4.435958631662689,40.0,0.0
1257,0,1257,[272 297 315 303 213],334,5,5581,4.4364069952305245,40.0,0.0
1258,0,1258,[272 297 315 303 213],334,5,5586,4.436854646544877,40.0,0.0
1259,0,1259,[272 297 315 303 213],894,5,5591,4.4373015873015875,40.0,0.0
1260,0,1260,[272 297 315 303 213],334,5,5596,4.437747819191118,40.0,0.0
1261,0,1261,[272 297 315 303 213],334,5,5601,4.438193343898574,40.0,0.0
1262,0,1262,[272 297 315 303 213],894,5,5606,4.438638163103722,40.0,0.0
1263,0,1263,[272 297 315 303 213],894,5,5611,4.4390822784810124,40.0,0.0
1264,0,1264,[272 297 315 303 213],894,5,5616,4.439525691699605,40.0,0.0
1265,0,1265,[272 297 315 303 213],334,5,5621,4.4399684044233805,40.0,0.0
1266,0,1266,[272 297 315 303 213],894,5,5626,4.440410418310971,40.0,0.0
1267,0,1267,[272 297 315 303 213],334,5,5631,4.440851735015773,40.0,0.0
1268,0,1268,[272 297 315 303 213],894,5,5636,4.441292356185973,40.0,0.0
1269,0,1269,[222 272 299 216 241],537,1,5637,4.438582677165354,0.0,20.0
1270,0,1270,[272 297 315 303 213],334,5,5642,4.439024390243903,40.0,0.0
1271,0,1271,[212 413 272 507 243],13,2,5644,4.437106918238993,0.0,0.0
1272,0,1272,[272 297 315 303 213],334,5,5649,4.437549096622153,40.0,0.0
1273,0,1273,[272 297 315 303 213],894,5,5654,4.437990580847724,40.0,0.0
1274,0,1274,[272 297 315 303 213],334,5,5659,4.43843137254902,40.0,0.0
1275,0,1275,[272 297 315 303 213],894,5,5664,4.438871473354232,40.0,0.0
1276,0,1276,[367 583 485 223 452],308,3,5667,4.437744714173845,20.0,0.0
1277,0,1277,[272 297 315 303 213],894,5,5672,4.438184663536776,40.0,0.0
1278,0,1278,[272 297 315 303 213],334,5,5677,4.438623924941361,40.0,0.0
1279,0,1279,[272 297 315 303 213],334,5,5682,4.4390625,40.0,0.0
1280,0,1280,[218 215 202 259 255],881,2,5684,4.437158469945355,0.0,0.0
1281,0,1281,[272 297 315 303 213],334,5,5689,4.437597503900156,40.0,0.0
1282,0,1282,[290 240 431 283 226],279,4,5693,4.4372564302416215,0.0,0.0
1283,0,1283,[272 297 315 303 213],894,5,5698,4.437694704049845,40.0,0.0
1284,0,1284,[272 297 315 303 213],334,5,5703,4.438132295719845,40.0,0.0
1285,0,1285,[272 297 315 303 213],894,5,5708,4.438569206842923,40.0,0.0
1286,0,1286,[272 297 315 303 213],894,5,5713,4.439005439005439,40.0,0.0
1287,0,1287,[217 331 481 299 272],13,1,5714,4.436335403726708,0.0,0.0
1288,0,1288,[272 297 315 303 213],334,5,5719,4.43677269200931,40.0,0.0
1289,0,1289,[272 297 315 303 213],894,5,5724,4.437209302325582,40.0,0.0
1290,0,1290,[290 384 208 420 321],13,3,5727,4.436096049573973,0.0,0.0
1291,0,1291,[212 227 239 452 215],650,0,5727,4.432662538699691,0.0,0.0
1292,0,1292,[272 297 315 303 213],894,5,5732,4.433101314771848,40.0,0.0
1293,0,1293,[272 297 315 303 213],894,5,5737,4.43353941267388,40.0,0.0
1294,0,1294,[272 297 315 303 213],894,5,5742,4.433976833976834,40.0,0.0
1295,0,1295,[272 297 315 303 213],334,5,5747,4.434413580246914,40.0,0.0
1296,0,1296,[264 241 321 431 508],13,1,5748,4.431765612952969,0.0,0.0
1297,0,1297,[272 297 315 303 213],894,5,5753,4.432203389830509,40.0,0.0
1298,0,1298,[272 297 315 303 213],894,5,5758,4.432640492686682,40.0,0.0
1299,0,1299,[272 297 315 303 213],334,5,5763,4.433076923076923,40.0,0.0
1300,0,1300,[272 297 315 303 213],334,5,5768,4.433512682551883,40.0,0.0
1301,0,1301,[272 297 315 303 213],894,5,5773,4.43394777265745,40.0,0.0
1302,0,1302,[272 297 315 303 213],334,5,5778,4.4343821949347655,40.0,0.0
1303,0,1303,[272 297 315 303 213],894,5,5783,4.434815950920245,40.0,0.0
1304,0,1304,[272 297 315 303 213],334,5,5788,4.4352490421455935,40.0,0.0
1305,0,1305,[272 297 315 303 213],334,5,5793,4.435681470137825,40.0,0.0
1306,0,1306,[272 297 315 303 213],334,5,5798,4.436113236419281,40.0,0.0
1307,0,1307,[272 297 315 303 213],334,5,5803,4.436544342507645,40.0,0.0
1308,0,1308,[272 297 315 303 213],894,5,5808,4.436974789915967,40.0,0.0
1309,0,1309,[272 297 315 303 213],894,5,5813,4.437404580152672,40.0,0.0
1310,0,1310,[272 297 315 303 213],334,5,5818,4.437833714721586,40.0,0.0
1311,0,1311,[384 219 222 429 275],279,2,5820,4.435975609756097,0.0,40.0
1312,0,1312,[272 297 315 303 213],334,5,5825,4.436405178979436,40.0,0.0
1313,0,1313,[272 297 315 303 213],334,5,5830,4.436834094368341,40.0,0.0
1314,0,1314,[272 297 315 303 213],334,5,5835,4.437262357414449,40.0,0.0
1315,0,1315,[272 297 315 303 213],334,5,5840,4.437689969604863,40.0,0.0
1316,0,1316,[336 211 331 222 241],13,1,5841,4.43507972665148,0.0,40.0
1317,0,1317,[272 297 315 303 213],894,5,5846,4.435508345978755,40.0,0.0
1318,0,1318,[254 206 240 202 365],804,4,5850,4.435178165276724,0.0,0.0
1319,0,1319,[272 297 315 303 213],334,5,5855,4.4356060606060606,40.0,0.0
1320,0,1320,[272 297 315 303 213],334,5,5860,4.436033308099924,40.0,0.0
1321,0,1321,[272 297 315 303 213],334,5,5865,4.436459909228442,40.0,0.0
1322,0,1322,[264 211 316 452 275],13,3,5868,4.4353741496598635,20.0,40.0
1323,0,1323,[211 275 241 243 280],13,2,5870,4.433534743202417,0.0,40.0
1324,0,1324,[272 297 315 303 213],334,5,5875,4.433962264150943,40.0,0.0
1325,0,1325,[272 297 315 303 213],334,5,5880,4.4343891402714934,40.0,0.0
1326,0,1326,[223 290 227 508 239],653,1,5881,4.431801055011304,20.0,0.0
1327,0,1327,[272 297 315 303 213],894,5,5886,4.432228915662651,40.0,0.0
1328,0,1328,[272 297 315 303 213],334,5,5891,4.432656132430399,40.0,0.0
1329,0,1329,[272 297 315 303 213],334,5,5896,4.433082706766918,40.0,0.0
1330,0,1330,[350 211 216 478 280],13,3,5899,4.432006010518407,0.0,20.0
1331,0,1331,[272 297 315 303 213],894,5,5904,4.4324324324324325,40.0,0.0
1332,0,1332,[272 297 315 303 213],334,5,5909,4.432858214553638,40.0,0.0
1333,0,1333,[272 297 315 303 213],894,5,5914,4.43328335832084,40.0,0.0
1334,0,1334,[272 297 315 303 213],334,5,5919,4.4337078651685395,40.0,0.0
1335,0,1335,[272 297 315 303 213],334,5,5924,4.434131736526946,40.0,0.0
1336,0,1336,[394 232 326 212 301],13,1,5925,4.431563201196709,0.0,0.0
1337,0,1337,[272 297 315 303 213],334,5,5930,4.431988041853513,40.0,0.0
1338,0,1338,[272 297 315 303 213],334,5,5935,4.432412247946228,40.0,0.0
1339,0,1339,[272 297 315 303 213],334,5,5940,4.432835820895522,40.0,0.0
1340,0,1340,[508 485 268 226 209],13,2,5942,4.431021625652498,0.0,0.0
1341,0,1341,[272 297 315 303 213],894,5,5947,4.431445603576751,40.0,0.0
1342,0,1342,[272 297 315 303 213],894,5,5952,4.43186895011169,40.0,0.0
1343,0,1343,[272 297 315 303 213],894,5,5957,4.432291666666667,40.0,0.0
1344,0,1344,[272 297 315 303 213],894,5,5962,4.43271375464684,40.0,0.0
1345,0,1345,[367 290 209 481 230],524,3,5965,4.431649331352155,0.0,0.0
1346,0,1346,[272 297 315 303 213],334,5,5970,4.432071269487751,40.0,0.0
1347,0,1347,[272 297 315 303 213],894,5,5975,4.432492581602374,40.0,0.0
1348,0,1348,[272 297 315 303 213],334,5,5980,4.432913269088213,40.0,0.0
1349,0,1349,[272 297 315 303 213],334,5,5985,4.433333333333334,40.0,0.0
1350,0,1350,[272 297 315 303 213],894,5,5990,4.433752775721688,40.0,0.0
1351,0,1351,[272 297 315 303 213],894,5,5995,4.434171597633136,40.0,0.0
1352,0,1352,[420 413 211 300 431],843,0,5995,4.430894308943089,0.0,40.0
1353,0,1353,[272 297 315 303 213],334,5,6000,4.431314623338257,40.0,0.0
1354,0,1354,[272 297 315 303 213],334,5,6005,4.431734317343174,40.0,0.0
1355,0,1355,[272 297 315 303 213],894,5,6010,4.432153392330384,40.0,0.0
1356,0,1356,[272 297 315 303 213],334,5,6015,4.432571849668387,40.0,0.0
1357,0,1357,[272 297 315 303 213],334,5,6020,4.43298969072165,40.0,0.0
1358,0,1358,[272 297 315 303 213],894,5,6025,4.433406916850625,40.0,0.0
1359,0,1359,[272 297 315 303 213],334,5,6030,4.4338235294117645,40.0,0.0
1360,0,1360,[272 297 315 303 213],894,5,6035,4.434239529757531,40.0,0.0
1361,0,1361,[272 297 315 303 213],334,5,6040,4.434654919236417,40.0,0.0
1362,0,1362,[272 297 315 303 213],334,5,6045,4.435069699192956,40.0,0.0
1363,0,1363,[272 297 315 303 213],894,5,6050,4.435483870967742,40.0,0.0
1364,0,1364,[272 297 315 303 213],334,5,6055,4.435897435897436,40.0,0.0
1365,0,1365,[272 297 315 303 213],334,5,6060,4.436310395314788,40.0,0.0
1366,0,1366,[272 297 315 303 213],334,5,6065,4.436722750548647,40.0,0.0
1367,0,1367,[272 297 315 303 213],334,5,6070,4.437134502923977,40.0,0.0
1368,0,1368,[272 297 315 303 213],894,5,6075,4.43754565376187,40.0,0.0
1369,0,1369,[272 297 315 303 213],334,5,6080,4.437956204379562,40.0,0.0
1370,0,1370,[272 297 315 303 213],334,5,6085,4.438366156090445,40.0,0.0
1371,0,1371,[272 297 315 303 213],334,5,6090,4.438775510204081,40.0,0.0
1372,0,1372,[303 213 275 208 209],6,4,6094,4.438455935906774,0.0,20.0
1373,0,1373,[272 297 315 303 213],894,5,6099,4.43886462882096,40.0,0.0
1374,0,1374,[272 297 315 303 213],894,5,6104,4.439272727272727,40.0,0.0
1375,0,1375,[272 297 315 303 213],894,5,6109,4.43968023255814,40.0,0.0
1376,0,1376,[272 297 315 303 213],894,5,6114,4.440087145969499,40.0,0.0
1377,0,1377,[272 297 315 303 213],334,5,6119,4.4404934687953554,40.0,0.0
1378,0,1378,[272 297 315 303 213],894,5,6124,4.440899202320522,40.0,0.0
1379,0,1379,[481 264 509 261 344],13,2,6126,4.439130434782609,0.0,0.0
1380,0,1380,[297 202 429 507 367],840,4,6130,4.43881245474294,20.0,0.0
1381,0,1381,[239 321 209 201 208],387,2,6132,4.437047756874096,0.0,0.0
1382,0,1382,[272 297 315 303 213],334,5,6137,4.437454808387563,40.0,0.0
1383,0,1383,[272 297 315 303 213],894,5,6142,4.437861271676301,40.0,0.0
1384,0,1384,[272 297 315 303 213],894,5,6147,4.4382671480144404,40.0,0.0
1385,0,1385,[272 297 315 303 213],334,5,6152,4.438672438672438,40.0,0.0
1386,0,1386,[272 297 315 303 213],894,5,6157,4.439077144917087,40.0,0.0
1387,0,1387,[272 297 315 303 213],894,5,6162,4.439481268011527,40.0,0.0
1388,0,1388,[202 219 384 272 218],13,2,6164,4.4377249820014395,0.0,0.0
1389,0,1389,[272 297 315 303 213],334,5,6169,4.438129496402878,40.0,0.0
1390,0,1390,[272 297 315 303 213],894,5,6174,4.438533429187634,40.0,0.0
1391,0,1391,[272 297 315 303 213],334,5,6179,4.438936781609195,40.0,0.0
1392,0,1392,[272 297 315 303 213],894,5,6184,4.439339554917445,40.0,0.0
1393,0,1393,[272 297 315 303 213],334,5,6189,4.43974175035868,40.0,0.0
1394,0,1394,[272 297 315 303 213],334,5,6194,4.440143369175627,40.0,0.0
1395,0,1395,[272 297 315 303 213],894,5,6199,4.44054441260745,40.0,0.0
1396,0,1396,[272 297 315 303 213],334,5,6204,4.440944881889764,40.0,0.0
1397,0,1397,[272 297 315 303 213],334,5,6209,4.441344778254649,40.0,0.0
1398,0,1398,[272 297 315 303 213],894,5,6214,4.441744102930665,40.0,0.0
1399,0,1399,[303 384 276 394 231],13,2,6216,4.44,0.0,20.0
1400,0,1400,[218 344 215 223 241],328,4,6220,4.439685938615275,20.0,0.0
1401,0,1401,[272 297 315 303 213],894,5,6225,4.440085592011412,40.0,0.0
1402,0,1402,[272 297 315 303 213],894,5,6230,4.44048467569494,40.0,0.0
1403,0,1403,[272 297 315 303 213],334,5,6235,4.4408831908831905,40.0,0.0
1404,0,1404,[272 297 315 303 213],894,5,6240,4.4412811387900355,40.0,0.0
1405,0,1405,[283 213 275 378 216],85,2,6242,4.439544807965861,0.0,20.0
1406,0,1406,[272 297 315 303 213],334,5,6247,4.439943141435679,40.0,0.0
1407,0,1407,[272 297 315 303 213],334,5,6252,4.440340909090909,40.0,0.0
1408,0,1408,[241 478 211 215 275],13,3,6255,4.439318665720369,0.0,40.0
1409,0,1409,[268 211 413 420 280],13,4,6259,4.439007092198581,0.0,20.0
1410,0,1410,[272 297 315 303 213],894,5,6264,4.439404677533664,40.0,0.0
1411,0,1411,[272 297 315 303 213],894,5,6269,4.439801699716714,40.0,0.0
1412,0,1412,[272 297 315 303 213],894,5,6274,4.440198159943383,40.0,0.0
1413,0,1413,[272 297 315 303 213],334,5,6279,4.4405940594059405,40.0,0.0
1414,0,1414,[321 213 291 290 239],537,1,6280,4.438162544169611,0.0,0.0
1415,0,1415,[272 297 315 303 213],334,5,6285,4.438559322033898,40.0,0.0
1416,0,1416,[272 297 315 303 213],334,5,6290,4.438955539872971,40.0,0.0
1417,0,1417,[272 297 315 303 213],334,5,6295,4.43935119887165,40.0,0.0
1418,0,1418,[272 297 315 303 213],894,5,6300,4.439746300211416,40.0,0.0
1419,0,1419,[272 297 315 303 213],334,5,6305,4.440140845070423,40.0,0.0
1420,0,1420,[272 297 315 303 213],334,5,6310,4.440534834623505,40.0,0.0
1421,0,1421,[481 212 209 485 350],13,1,6311,4.438115330520394,0.0,0.0
1422,0,1422,[272 297 315 303 213],334,5,6316,4.438510189739986,40.0,0.0
1423,0,1423,[272 297 315 303 213],334,5,6321,4.438904494382022,40.0,0.0
1424,0,1424,[272 297 315 303 213],334,5,6326,4.439298245614035,40.0,0.0
1425,0,1425,[272 297 315 303 213],334,5,6331,4.439691444600281,40.0,0.0
1426,0,1426,[272 297 315 303 213],334,5,6336,4.440084092501752,40.0,0.0
1427,0,1427,[227 217 283 365 222],378,1,6337,4.437675070028011,0.0,20.0
1428,0,1428,[272 297 315 303 213],334,5,6342,4.438068579426172,40.0,0.0
1429,0,1429,[268 326 350 284 295],894,0,6342,4.434965034965035,0.0,0.0
1430,0,1430,[301 222 326 452 232],13,0,6342,4.431865828092243,0.0,20.0
1431,0,1431,[272 297 315 303 213],894,5,6347,4.432262569832402,40.0,0.0
1432,0,1432,[272 297 315 303 213],334,5,6352,4.432658757850663,40.0,0.0
1433,0,1433,[272 297 315 303 213],334,5,6357,4.433054393305439,40.0,0.0
1434,0,1434,[272 297 315 303 213],334,5,6362,4.433449477351917,40.0,0.0
1435,0,1435,[272 297 315 303 213],334,5,6367,4.433844011142061,40.0,0.0
1436,0,1436,[272 297 315 303 213],894,5,6372,4.434237995824635,40.0,0.0
1437,0,1437,[236 283 223 293 272],894,4,6376,4.433936022253129,20.0,0.0
1438,0,1438,[272 297 315 303 213],334,5,6381,4.4343293954134815,40.0,0.0
1439,0,1439,[272 297 315 303 213],894,5,6386,4.434722222222222,40.0,0.0
1440,0,1440,[392 215 291 303 507],537,2,6388,4.433032616238723,0.0,0.0
1441,0,1441,[272 297 315 303 213],334,5,6393,4.433425797503467,40.0,0.0
1442,0,1442,[272 297 315 303 213],894,5,6398,4.433818433818434,40.0,0.0
1443,0,1443,[272 297 315 303 213],894,5,6403,4.434210526315789,40.0,0.0
1444,0,1444,[215 478 202 222 230],749,3,6406,4.433217993079585,0.0,20.0
1445,0,1445,[272 297 315 303 213],334,5,6411,4.433609958506224,40.0,0.0
1446,0,1446,[272 297 315 303 213],894,5,6416,4.434001382170007,40.0,0.0
1447,0,1447,[272 297 315 303 213],334,5,6421,4.43439226519337,40.0,0.0
1448,0,1448,[272 297 315 303 213],334,5,6426,4.434782608695652,40.0,0.0
1449,0,1449,[272 297 315 303 213],894,5,6431,4.4351724137931035,40.0,0.0
1450,0,1450,[272 297 315 303 213],894,5,6436,4.435561681598897,40.0,0.0
1451,0,1451,[272 297 315 303 213],334,5,6441,4.43595041322314,40.0,0.0
1452,0,1452,[272 297 315 303 213],334,5,6446,4.436338609772884,40.0,0.0
1453,0,1453,[215 243 231 452 226],650,0,6446,4.433287482806052,0.0,0.0
1454,0,1454,[276 243 208 218 241],13,2,6448,4.431615120274914,0.0,20.0
1455,0,1455,[272 297 315 303 213],334,5,6453,4.4320054945054945,40.0,0.0
1456,0,1456,[272 297 315 303 213],894,5,6458,4.432395332875772,40.0,0.0
1457,0,1457,[272 297 315 303 213],894,5,6463,4.43278463648834,40.0,0.0
1458,0,1458,[217 201 227 239 367],92,1,6464,4.430431802604524,0.0,0.0
1459,0,1459,[272 297 315 303 213],334,5,6469,4.4308219178082195,40.0,0.0
1460,0,1460,[272 297 315 303 213],894,5,6474,4.431211498973306,40.0,0.0
1461,0,1461,[485 219 218 217 367],650,0,6474,4.4281805745554035,0.0,0.0
1462,0,1462,[272 297 315 303 213],334,5,6479,4.428571428571429,40.0,0.0
1463,0,1463,[272 297 315 303 213],334,5,6484,4.4289617486338795,40.0,0.0
1464,0,1464,[272 297 315 303 213],334,5,6489,4.429351535836178,40.0,0.0
1465,0,1465,[272 297 315 303 213],894,5,6494,4.429740791268759,40.0,0.0
1466,0,1466,[272 297 315 303 213],894,5,6499,4.430129516019087,40.0,0.0
1467,0,1467,[272 297 315 303 213],894,5,6504,4.430517711171662,40.0,0.0
1468,0,1468,[272 297 315 303 213],334,5,6509,4.430905377808033,40.0,0.0
1469,0,1469,[272 297 315 303 213],894,5,6514,4.431292517006803,40.0,0.0
1470,0,1470,[272 297 315 303 213],894,5,6519,4.431679129843644,40.0,0.0
1471,0,1471,[272 297 315 303 213],894,5,6524,4.432065217391305,40.0,0.0
1472,0,1472,[272 297 315 303 213],334,5,6529,4.43245078071962,40.0,0.0
1473,0,1473,[272 297 315 303 213],334,5,6534,4.432835820895522,40.0,0.0
1474,0,1474,[272 297 315 303 213],894,5,6539,4.433220338983051,40.0,0.0
1475,0,1475,[272 297 315 303 213],894,5,6544,4.43360433604336,40.0,0.0
1476,0,1476,[272 297 315 303 213],894,5,6549,4.433987813134733,40.0,0.0
1477,0,1477,[272 297 315 303 213],334,5,6554,4.434370771312585,40.0,0.0
1478,0,1478,[272 297 315 303 213],894,5,6559,4.434753211629479,40.0,0.0
1479,0,1479,[272 297 315 303 213],894,5,6564,4.435135135135135,40.0,0.0
1480,0,1480,[272 297 315 303 213],334,5,6569,4.435516542876435,40.0,0.0
1481,0,1481,[431 268 218 290 321],234,0,6569,4.432523616734143,0.0,0.0
1482,0,1482,[272 297 315 303 213],894,5,6574,4.432906271072151,40.0,0.0
1483,0,1483,[272 297 315 303 213],334,5,6579,4.433288409703504,40.0,0.0
1484,0,1484,[272 297 315 303 213],894,5,6584,4.433670033670034,40.0,0.0
1485,0,1485,[272 297 315 303 213],334,5,6589,4.434051144010767,40.0,0.0
1486,0,1486,[272 297 315 303 213],894,5,6594,4.434431741761937,40.0,0.0
1487,0,1487,[272 297 315 303 213],334,5,6599,4.434811827956989,40.0,0.0
1488,0,1488,[272 297 315 303 213],894,5,6604,4.435191403626595,40.0,0.0
1489,0,1489,[272 297 315 303 213],894,5,6609,4.435570469798658,40.0,0.0
1490,0,1490,[219 268 331 276 223],13,3,6612,4.434607645875252,20.0,20.0
1491,0,1491,[272 297 315 303 213],334,5,6617,4.434986595174263,40.0,0.0
1492,0,1492,[272 297 315 303 213],334,5,6622,4.43536503683858,40.0,0.0
1493,0,1493,[303 239 508 264 316],13,4,6626,4.435073627844712,20.0,0.0
1494,0,1494,[272 297 315 303 213],894,5,6631,4.435451505016722,40.0,0.0
1495,0,1495,[223 367 508 201 326],13,1,6632,4.433155080213904,20.0,0.0
1496,0,1496,[272 297 315 303 213],894,5,6637,4.433533734134937,40.0,0.0
1497,0,1497,[272 297 315 303 213],334,5,6642,4.433911882510014,40.0,0.0
1498,0,1498,[272 297 315 303 213],334,5,6647,4.4342895263509,40.0,0.0
1499,0,1499,[272 297 315 303 213],334,5,6652,4.434666666666667,40.0,0.0
1500,0,1500,[272 297 315 303 213],334,5,6657,4.435043304463691,40.0,0.0
1501,0,1501,[272 297 315 303 213],334,5,6662,4.435419440745672,40.0,0.0
1502,0,1502,[272 297 315 303 213],334,5,6667,4.43579507651364,40.0,0.0
1503,0,1503,[243 226 211 485 268],537,2,6669,4.434175531914893,0.0,20.0
1504,0,1504,[481 509 429 268 272],13,4,6673,4.433887043189369,0.0,0.0
1505,0,1505,[272 297 315 303 213],334,5,6678,4.434262948207171,40.0,0.0
1506,0,1506,[272 297 315 303 213],894,5,6683,4.434638354346384,40.0,0.0
1507,0,1507,[215 239 583 208 298],387,1,6684,4.43236074270557,0.0,0.0
1508,0,1508,[272 297 315 303 213],894,5,6689,4.43273691186216,40.0,0.0
1509,0,1509,[272 297 315 303 213],894,5,6694,4.433112582781457,40.0,0.0
1510,0,1510,[272 297 315 303 213],894,5,6699,4.4334877564526805,40.0,0.0
1511,0,1511,[272 297 315 303 213],334,5,6704,4.4338624338624335,40.0,0.0
1512,0,1512,[272 297 315 303 213],334,5,6709,4.434236615994712,40.0,0.0
1513,0,1513,[485 293 378 507 264],308,1,6710,4.431968295904888,0.0,0.0
1514,0,1514,[272 297 315 303 213],334,5,6715,4.432343234323432,40.0,0.0
1515,0,1515,[367 259 392 201 275],308,4,6719,4.4320580474934035,0.0,20.0
1516,0,1516,[272 297 315 303 213],894,5,6724,4.4324324324324325,40.0,0.0
1517,0,1517,[272 297 315 303 213],334,5,6729,4.432806324110672,40.0,0.0
1518,0,1518,[272 297 315 303 213],334,5,6734,4.433179723502304,40.0,0.0
1519,0,1519,[272 297 315 303 213],894,5,6739,4.433552631578947,40.0,0.0
1520,0,1520,[272 297 315 303 213],894,5,6744,4.433925049309665,40.0,0.0
1521,0,1521,[272 297 315 303 213],894,5,6749,4.434296977660972,40.0,0.0
1522,0,1522,[272 297 315 303 213],894,5,6754,4.434668417596848,40.0,0.0
1523,0,1523,[272 297 315 303 213],894,5,6759,4.43503937007874,40.0,0.0
1524,0,1524,[222 291 213 231 206],804,3,6762,4.434098360655738,0.0,20.0
1525,0,1525,[272 297 315 303 213],894,5,6767,4.434469200524246,40.0,0.0
1526,0,1526,[272 297 315 303 213],334,5,6772,4.434839554682384,40.0,0.0
1527,0,1527,[481 485 276 211 275],13,2,6774,4.433246073298429,0.0,60.0
1528,0,1528,[272 297 315 303 213],334,5,6779,4.433616742969261,40.0,0.0
1529,0,1529,[272 297 315 303 213],334,5,6784,4.433986928104575,40.0,0.0
1530,0,1530,[272 297 315 303 213],894,5,6789,4.434356629653821,40.0,0.0
1531,0,1531,[272 297 315 303 213],334,5,6794,4.434725848563969,40.0,0.0
1532,0,1532,[272 297 315 303 213],334,5,6799,4.435094585779518,40.0,0.0
1533,0,1533,[272 297 315 303 213],894,5,6804,4.4354628422425035,40.0,0.0
1534,0,1534,[243 261 280 230 209],13,1,6805,4.4332247557003255,0.0,0.0
1535,0,1535,[321 209 202 276 431],234,1,6806,4.430989583333333,0.0,20.0
1536,0,1536,[272 297 315 303 213],334,5,6811,4.431359791802212,40.0,0.0
1537,0,1537,[272 297 315 303 213],334,5,6816,4.431729518855657,40.0,0.0
1538,0,1538,[272 297 315 303 213],334,5,6821,4.432098765432099,40.0,0.0
1539,0,1539,[272 297 315 303 213],334,5,6826,4.432467532467532,40.0,0.0
1540,0,1540,[272 297 315 303 213],894,5,6831,4.432835820895522,40.0,0.0
1541,0,1541,[272 297 315 303 213],894,5,6836,4.433203631647212,40.0,0.0
1542,0,1542,[367 452 208 336 331],13,1,6837,4.430978613091381,0.0,0.0
1543,0,1543,[272 297 315 303 213],894,5,6842,4.431347150259067,40.0,0.0
1544,0,1544,[272 297 315 303 213],894,5,6847,4.431715210355987,40.0,0.0
1545,0,1545,[272 297 315 303 213],894,5,6852,4.432082794307892,40.0,0.0
1546,0,1546,[272 297 315 303 213],894,5,6857,4.432449903038139,40.0,0.0
1547,0,1547,[272 297 315 303 213],334,5,6862,4.4328165374677,40.0,0.0
1548,0,1548,[272 297 315 303 213],894,5,6867,4.433182698515171,40.0,0.0
1549,0,1549,[272 297 315 303 213],334,5,6872,4.433548387096774,40.0,0.0
1550,0,1550,[223 429 326 298 230],749,4,6876,4.433268858800774,20.0,0.0
1551,0,1551,[272 297 315 303 213],894,5,6881,4.433634020618556,40.0,0.0
1552,0,1552,[272 297 315 303 213],334,5,6886,4.433998712169994,40.0,0.0
1553,0,1553,[272 297 315 303 213],334,5,6891,4.434362934362935,40.0,0.0
1554,0,1554,[272 297 315 303 213],894,5,6896,4.434726688102894,40.0,0.0
1555,0,1555,[272 297 315 303 213],334,5,6901,4.435089974293059,40.0,0.0
1556,0,1556,[272 297 315 303 213],334,5,6906,4.435452793834297,40.0,0.0
1557,0,1557,[272 297 315 303 213],894,5,6911,4.435815147625161,40.0,0.0
1558,0,1558,[280 216 331 315 299],13,2,6913,4.434252726106479,20.0,0.0
1559,0,1559,[272 297 315 303 213],334,5,6918,4.434615384615385,40.0,0.0
1560,0,1560,[272 297 315 303 213],334,5,6923,4.434977578475336,40.0,0.0
1561,0,1561,[272 297 315 303 213],894,5,6928,4.435339308578746,40.0,0.0
1562,0,1562,[218 230 232 350 509],13,1,6929,4.433141394753679,0.0,0.0
1563,0,1563,[272 297 315 303 213],334,5,6934,4.4335038363171355,40.0,0.0
1564,0,1564,[272 297 315 303 213],334,5,6939,4.433865814696485,40.0,0.0
1565,0,1565,[272 297 315 303 213],894,5,6944,4.434227330779055,40.0,0.0
1566,0,1566,[272 297 315 303 213],334,5,6949,4.434588385449905,40.0,0.0
1567,0,1567,[272 297 315 303 213],894,5,6954,4.434948979591836,40.0,0.0
1568,0,1568,[272 297 315 303 213],334,5,6959,4.435309114085404,40.0,0.0
1569,0,1569,[272 297 315 303 213],334,5,6964,4.4356687898089175,40.0,0.0
1570,0,1570,[272 297 315 303 213],334,5,6969,4.436028007638447,40.0,0.0
1571,0,1571,[272 297 315 303 213],894,5,6974,4.4363867684478375,40.0,0.0
1572,0,1572,[272 297 315 303 213],894,5,6979,4.4367450731087095,40.0,0.0
1573,0,1573,[272 297 315 303 213],334,5,6984,4.43710292249047,40.0,0.0
1574,0,1574,[272 297 315 303 213],334,5,6989,4.437460317460317,40.0,0.0
1575,0,1575,[272 297 315 303 213],334,5,6994,4.437817258883249,40.0,0.0
1576,0,1576,[272 297 315 303 213],334,5,6999,4.438173747622067,40.0,0.0
1577,0,1577,[272 297 315 303 213],894,5,7004,4.438529784537389,40.0,0.0
1578,0,1578,[272 297 315 303 213],334,5,7009,4.43888537048765,40.0,0.0
1579,0,1579,[272 297 315 303 213],334,5,7014,4.439240506329114,40.0,0.0
1580,0,1580,[272 297 315 303 213],334,5,7019,4.439595192915876,40.0,0.0
1581,0,1581,[283 275 367 211 218],10,5,7024,4.4399494310998735,0.0,40.0
1582,0,1582,[272 297 315 303 213],334,5,7029,4.440303221730891,40.0,0.0
1583,0,1583,[272 297 315 303 213],334,5,7034,4.440656565656566,40.0,0.0
1584,0,1584,[272 297 315 303 213],334,5,7039,4.441009463722398,40.0,0.0
1585,0,1585,[272 297 315 303 213],334,5,7044,4.441361916771752,40.0,0.0
1586,0,1586,[272 297 315 303 213],334,5,7049,4.441713925645873,40.0,0.0
1587,0,1587,[272 297 315 303 213],894,5,7054,4.442065491183879,40.0,0.0
1588,0,1588,[272 297 315 303 213],894,5,7059,4.442416614222782,40.0,0.0
1589,0,1589,[272 297 315 303 213],894,5,7064,4.442767295597484,40.0,0.0
1590,0,1590,[272 297 315 303 213],334,5,7069,4.443117536140792,40.0,0.0
1591,0,1591,[272 297 315 303 213],334,5,7074,4.443467336683417,40.0,0.0
1592,0,1592,[272 297 315 303 213],334,5,7079,4.443816698053986,40.0,0.0
1593,0,1593,[272 297 315 303 213],894,5,7084,4.444165621079047,40.0,0.0
1594,0,1594,[272 297 315 303 213],334,5,7089,4.444514106583072,40.0,0.0
1595,0,1595,[272 297 315 303 213],334,5,7094,4.4448621553884715,40.0,0.0
1596,0,1596,[272 297 315 303 213],334,5,7099,4.445209768315592,40.0,0.0
1597,0,1597,[272 297 315 303 213],894,5,7104,4.4455569461827285,40.0,0.0
1598,0,1598,[272 297 315 303 213],334,5,7109,4.445903689806129,40.0,0.0
1599,0,1599,[326 290 508 239 316],334,1,7110,4.44375,20.0,0.0
1600,0,1600,[272 297 315 303 213],894,5,7115,4.444097439100562,40.0,0.0
1601,0,1601,[272 297 315 303 213],334,5,7120,4.444444444444445,40.0,0.0
1602,0,1602,[272 297 315 303 213],334,5,7125,4.444791016843419,40.0,0.0
1603,0,1603,[272 297 315 303 213],894,5,7130,4.445137157107232,40.0,0.0
1604,0,1604,[272 297 315 303 213],334,5,7135,4.445482866043614,40.0,0.0
1605,0,1605,[272 297 315 303 213],894,5,7140,4.4458281444582815,40.0,0.0
1606,0,1606,[272 297 315 303 213],334,5,7145,4.446172993154947,40.0,0.0
1607,0,1607,[272 297 315 303 213],894,5,7150,4.446517412935323,40.0,0.0
1608,0,1608,[272 297 315 303 213],894,5,7155,4.4468614045991295,40.0,0.0
1609,0,1609,[384 216 223 336 218],13,1,7156,4.44472049689441,20.0,0.0
1610,0,1610,[272 297 315 303 213],894,5,7161,4.445065176908752,40.0,0.0
1611,0,1611,[272 297 315 303 213],894,5,7166,4.445409429280397,40.0,0.0
1612,0,1612,[272 297 315 303 213],894,5,7171,4.445753254804711,40.0,0.0
1613,0,1613,[272 297 315 303 213],894,5,7176,4.446096654275093,40.0,0.0
1614,0,1614,[272 297 315 303 213],334,5,7181,4.446439628482972,40.0,0.0
1615,0,1615,[272 297 315 303 213],334,5,7186,4.446782178217822,40.0,0.0
1616,0,1616,[272 297 315 303 213],334,5,7191,4.447124304267161,40.0,0.0
1617,0,1617,[272 297 315 303 213],894,5,7196,4.447466007416564,40.0,0.0
1618,0,1618,[272 297 315 303 213],334,5,7201,4.447807288449661,40.0,0.0
1619,0,1619,[212 241 239 215 213],311,2,7203,4.446296296296296,0.0,0.0
1620,0,1620,[272 297 315 303 213],334,5,7208,4.446637877853177,40.0,0.0
1621,0,1621,[272 297 315 303 213],334,5,7213,4.4469790382244145,40.0,0.0
1622,0,1622,[272 297 315 303 213],894,5,7218,4.44731977818854,40.0,0.0
1623,0,1623,[272 297 315 303 213],334,5,7223,4.447660098522167,40.0,0.0
1624,0,1624,[272 297 315 303 213],894,5,7228,4.448,40.0,0.0
1625,0,1625,[272 297 315 303 213],894,5,7233,4.448339483394834,40.0,0.0
1626,0,1626,[272 297 315 303 213],894,5,7238,4.448678549477566,40.0,0.0
1627,0,1627,[272 297 315 303 213],334,5,7243,4.449017199017199,40.0,0.0
1628,0,1628,[272 297 315 303 213],334,5,7248,4.449355432780847,40.0,0.0
1629,0,1629,[272 297 315 303 213],334,5,7253,4.449693251533742,40.0,0.0
1630,0,1630,[209 283 215 251 236],385,1,7254,4.447578172900061,20.0,0.0
1631,0,1631,[293 208 429 202 378],653,0,7254,4.444852941176471,0.0,0.0
1632,0,1632,[272 297 315 303 213],894,5,7259,4.445192896509492,40.0,0.0
1633,0,1633,[272 297 315 303 213],334,5,7264,4.445532435740514,40.0,0.0
1634,0,1634,[272 297 315 303 213],894,5,7269,4.445871559633027,40.0,0.0
1635,0,1635,[219 429 232 259 365],7,2,7271,4.44437652811736,0.0,0.0
1636,0,1636,[272 297 315 303 213],894,5,7276,4.4447159437996335,40.0,0.0
1637,0,1637,[272 297 315 303 213],334,5,7281,4.445054945054945,40.0,0.0
1638,0,1638,[272 297 315 303 213],334,5,7286,4.445393532641855,40.0,0.0
1639,0,1639,[236 283 239 255 291],533,1,7287,4.443292682926829,0.0,0.0
1640,0,1640,[272 297 315 303 213],894,5,7292,4.443631931748934,40.0,0.0
1641,0,1641,[272 297 315 303 213],334,5,7297,4.443970767356882,40.0,0.0
1642,0,1642,[272 297 315 303 213],334,5,7302,4.444309190505173,40.0,0.0
1643,0,1643,[272 297 315 303 213],334,5,7307,4.444647201946472,40.0,0.0
1644,0,1644,[272 297 315 303 213],894,5,7312,4.444984802431611,40.0,0.0
1645,0,1645,[272 297 315 303 213],334,5,7317,4.445321992709599,40.0,0.0
1646,0,1646,[272 297 315 303 213],334,5,7322,4.445658773527626,40.0,0.0
1647,0,1647,[272 297 315 303 213],334,5,7327,4.445995145631068,40.0,0.0
1648,0,1648,[272 297 315 303 213],334,5,7332,4.446331109763493,40.0,0.0
1649,0,1649,[272 297 315 303 213],334,5,7337,4.446666666666666,40.0,0.0
1650,0,1650,[272 297 315 303 213],334,5,7342,4.447001817080557,40.0,0.0
1651,0,1651,[272 297 315 303 213],894,5,7347,4.447336561743342,40.0,0.0
1652,0,1652,[227 303 394 429 211],13,4,7351,4.447065940713854,0.0,20.0
1653,0,1653,[272 297 315 303 213],894,5,7356,4.447400241837968,40.0,0.0
1654,0,1654,[272 297 315 303 213],894,5,7361,4.44773413897281,40.0,0.0
1655,0,1655,[272 297 315 303 213],334,5,7366,4.4480676328502415,40.0,0.0
1656,0,1656,[272 297 315 303 213],894,5,7371,4.448400724200362,40.0,0.0
1657,0,1657,[231 230 272 275 276],334,4,7375,4.448130277442702,0.0,40.0
1658,0,1658,[272 297 315 303 213],334,5,7380,4.448462929475587,40.0,0.0
1659,0,1659,[272 297 315 303 213],334,5,7385,4.448795180722891,40.0,0.0
1660,0,1660,[350 221 275 256 336],894,2,7387,4.4473208910295,0.0,20.0
1661,0,1661,[272 297 315 303 213],894,5,7392,4.447653429602888,40.0,0.0
1662,0,1662,[272 297 315 303 213],894,5,7397,4.44798556825015,40.0,0.0
1663,0,1663,[272 297 315 303 213],894,5,7402,4.4483173076923075,40.0,0.0
1664,0,1664,[272 297 315 303 213],334,5,7407,4.448648648648649,40.0,0.0
1665,0,1665,[272 297 315 303 213],334,5,7412,4.448979591836735,40.0,0.0
1666,0,1666,[272 297 315 303 213],334,5,7417,4.449310137972406,40.0,0.0
1667,0,1667,[509 236 324 255 272],894,3,7420,4.448441247002398,0.0,0.0
1668,0,1668,[272 297 315 303 213],334,5,7425,4.44877171959257,40.0,0.0
1669,0,1669,[272 297 315 303 213],334,5,7430,4.449101796407185,40.0,0.0
1670,0,1670,[272 297 315 303 213],894,5,7435,4.449431478156792,40.0,0.0
1671,0,1671,[336 216 300 481 478],13,1,7436,4.447368421052632,0.0,20.0
1672,0,1672,[227 212 378 240 230],804,4,7440,4.4471010161386735,0.0,0.0
1673,0,1673,[272 297 315 303 213],334,5,7445,4.447431302270012,40.0,0.0
1674,0,1674,[272 297 315 303 213],894,5,7450,4.447761194029851,40.0,0.0
1675,0,1675,[272 297 315 303 213],894,5,7455,4.448090692124105,40.0,0.0
1676,0,1676,[272 297 315 303 213],334,5,7460,4.4484197972570065,40.0,0.0
1677,0,1677,[272 297 315 303 213],894,5,7465,4.448748510131108,40.0,0.0
1678,0,1678,[284 254 218 344 275],548,1,7466,4.446694460988684,0.0,20.0
1679,0,1679,[218 316 202 301 429],13,3,7469,4.445833333333334,20.0,0.0
1680,0,1680,[272 297 315 303 213],894,5,7474,4.446162998215348,40.0,0.0
1681,0,1681,[221 218 508 208 378],385,1,7475,4.444114149821641,0.0,0.0
1682,0,1682,[272 297 315 303 213],334,5,7480,4.444444444444445,40.0,0.0
1683,0,1683,[272 297 315 303 213],894,5,7485,4.444774346793349,40.0,0.0
1684,0,1684,[272 297 315 303 213],334,5,7490,4.445103857566766,40.0,0.0
1685,0,1685,[272 297 315 303 213],334,5,7495,4.445432977461447,40.0,0.0
1686,0,1686,[272 297 315 303 213],894,5,7500,4.445761707172496,40.0,0.0
1687,0,1687,[272 297 315 303 213],894,5,7505,4.446090047393365,40.0,0.0
1688,0,1688,[272 297 315 303 213],334,5,7510,4.446417998815868,40.0,0.0
1689,0,1689,[298 316 209 236 216],145,3,7513,4.445562130177515,20.0,0.0
1690,0,1690,[272 297 315 303 213],334,5,7518,4.44589000591366,40.0,0.0
1691,0,1691,[272 297 315 303 213],894,5,7523,4.446217494089835,40.0,0.0
1692,0,1692,[272 297 315 303 213],894,5,7528,4.446544595392794,40.0,0.0
1693,0,1693,[272 297 315 303 213],334,5,7533,4.4468713105076745,40.0,0.0
1694,0,1694,[272 297 315 303 213],334,5,7538,4.447197640117994,40.0,0.0
1695,0,1695,[272 297 315 303 213],334,5,7543,4.44752358490566,40.0,0.0
1696,0,1696,[272 297 315 303 213],894,5,7548,4.447849145550972,40.0,0.0
1697,0,1697,[272 297 315 303 213],334,5,7553,4.448174322732626,40.0,0.0
1698,0,1698,[272 297 315 303 213],894,5,7558,4.448499117127723,40.0,0.0
1699,0,1699,[272 297 315 303 213],334,5,7563,4.448823529411765,40.0,0.0
1700,0,1700,[272 297 315 303 213],894,5,7568,4.449147560258671,40.0,0.0
1701,0,1701,[272 297 315 303 213],334,5,7573,4.449471210340776,40.0,0.0
1702,0,1702,[272 231 290 509 420],650,1,7574,4.447445684086905,0.0,0.0
1703,0,1703,[272 297 315 303 213],894,5,7579,4.447769953051643,40.0,0.0
1704,0,1704,[272 297 315 303 213],894,5,7584,4.448093841642229,40.0,0.0
1705,0,1705,[272 297 315 303 213],334,5,7589,4.44841735052755,40.0,0.0
1706,0,1706,[272 297 315 303 213],894,5,7594,4.448740480374926,40.0,0.0
1707,0,1707,[272 297 315 303 213],334,5,7599,4.4490632318501175,40.0,0.0
1708,0,1708,[272 297 315 303 213],894,5,7604,4.44938560561732,40.0,0.0
1709,0,1709,[272 297 315 303 213],894,5,7609,4.449707602339181,40.0,0.0
1710,0,1710,[272 297 315 303 213],894,5,7614,4.450029222676797,40.0,0.0
1711,0,1711,[272 297 315 303 213],894,5,7619,4.45035046728972,40.0,0.0
1712,0,1712,[272 297 315 303 213],334,5,7624,4.450671336835961,40.0,0.0
1713,0,1713,[272 297 315 303 213],334,5,7629,4.450991831971995,40.0,0.0
1714,0,1714,[272 297 315 303 213],334,5,7634,4.45131195335277,40.0,0.0
1715,0,1715,[259 246 275 316 211],85,2,7636,4.44988344988345,20.0,40.0
1716,0,1716,[284 218 298 485 291],308,3,7639,4.449039021549214,0.0,0.0
1717,0,1717,[272 297 315 303 213],894,5,7644,4.449359720605355,40.0,0.0
1718,0,1718,[272 297 315 303 213],894,5,7649,4.449680046538686,40.0,0.0
1719,0,1719,[215 221 291 300 478],234,0,7649,4.447093023255814,0.0,20.0
1720,0,1720,[272 297 315 303 213],334,5,7654,4.447414294015108,40.0,0.0
1721,0,1721,[272 297 315 303 213],894,5,7659,4.447735191637631,40.0,0.0
1722,0,1722,[272 297 315 303 213],894,5,7664,4.44805571677307,40.0,0.0
1723,0,1723,[272 297 315 303 213],334,5,7669,4.448375870069605,40.0,0.0
1724,0,1724,[272 297 315 303 213],894,5,7674,4.448695652173913,40.0,0.0
1725,0,1725,[272 297 315 303 213],334,5,7679,4.449015063731171,40.0,0.0
1726,0,1726,[300 243 240 218 283],533,1,7680,4.447017950202664,0.0,20.0
1727,0,1727,[272 297 315 303 213],894,5,7685,4.447337962962963,40.0,0.0
1728,0,1728,[272 297 315 303 213],334,5,7690,4.447657605552342,40.0,0.0
1729,0,1729,[272 297 315 303 213],894,5,7695,4.4479768786127165,40.0,0.0
1730,0,1730,[481 321 231 507 227],13,1,7696,4.445984979780474,0.0,0.0
1731,0,1731,[272 297 315 303 213],334,5,7701,4.446304849884527,40.0,0.0
1732,0,1732,[209 284 232 316 509],85,2,7703,4.444893248701673,20.0,0.0
1733,0,1733,[272 297 315 303 213],894,5,7708,4.445213379469434,40.0,0.0
1734,0,1734,[272 297 315 303 213],894,5,7713,4.445533141210374,40.0,0.0
1735,0,1735,[272 297 315 303 213],334,5,7718,4.445852534562212,40.0,0.0
1736,0,1736,[272 297 315 303 213],334,5,7723,4.446171560161197,40.0,0.0
1737,0,1737,[272 297 315 303 213],894,5,7728,4.446490218642118,40.0,0.0
1738,0,1738,[272 297 315 303 213],894,5,7733,4.446808510638298,40.0,0.0
1739,0,1739,[272 297 315 303 213],894,5,7738,4.447126436781609,40.0,0.0
1740,0,1740,[230 429 208 316 303],334,5,7743,4.44744399770247,20.0,0.0
1741,0,1741,[272 297 315 303 213],334,5,7748,4.447761194029851,40.0,0.0
1742,0,1742,[272 297 315 303 213],894,5,7753,4.448078026391279,40.0,0.0
1743,0,1743,[272 297 315 303 213],894,5,7758,4.448394495412844,40.0,0.0
1744,0,1744,[272 297 315 303 213],894,5,7763,4.448710601719197,40.0,0.0
1745,0,1745,[272 297 315 303 213],334,5,7768,4.449026345933563,40.0,0.0
1746,0,1746,[272 297 315 303 213],334,5,7773,4.449341728677734,40.0,0.0
1747,0,1747,[272 297 315 303 213],334,5,7778,4.449656750572083,40.0,0.0
1748,0,1748,[272 297 315 303 213],894,5,7783,4.449971412235564,40.0,0.0
1749,0,1749,[298 221 222 324 250],486,2,7785,4.448571428571428,0.0,20.0
1750,0,1750,[272 297 315 303 213],894,5,7790,4.4488863506567675,40.0,0.0
1751,0,1751,[272 297 315 303 213],894,5,7795,4.449200913242009,40.0,0.0
1752,0,1752,[272 297 315 303 213],894,5,7800,4.4495151169423846,40.0,0.0
1753,0,1753,[299 509 268 217 280],13,3,7803,4.4486887115165334,0.0,0.0
1754,0,1754,[272 297 315 303 213],894,5,7808,4.449002849002849,40.0,0.0
1755,0,1755,[272 297 315 303 213],334,5,7813,4.449316628701594,40.0,0.0
1756,0,1756,[272 297 315 303 213],894,5,7818,4.449630051223677,40.0,0.0
1757,0,1757,[272 297 315 303 213],334,5,7823,4.449943117178612,40.0,0.0
1758,0,1758,[216 226 367 321 232],194,0,7823,4.447413303013076,0.0,0.0
1759,0,1759,[272 297 315 303 213],894,5,7828,4.447727272727272,40.0,0.0
1760,0,1760,[272 297 315 303 213],334,5,7833,4.448040885860307,40.0,0.0
1761,0,1761,[272 297 315 303 213],334,5,7838,4.448354143019296,40.0,0.0
1762,0,1762,[272 297 315 303 213],894,5,7843,4.448667044809983,40.0,0.0
1763,0,1763,[272 297 315 303 213],334,5,7848,4.448979591836735,40.0,0.0
1764,0,1764,[272 297 315 303 213],334,5,7853,4.44929178470255,40.0,0.0
1765,0,1765,[272 297 315 303 213],894,5,7858,4.44960362400906,40.0,0.0
1766,0,1766,[508 478 208 321 213],524,3,7861,4.44878324844369,0.0,0.0
1767,0,1767,[272 297 315 303 213],334,5,7866,4.449095022624435,40.0,0.0
1768,0,1768,[272 297 315 303 213],334,5,7871,4.449406444318824,40.0,0.0
1769,0,1769,[272 297 315 303 213],334,5,7876,4.449717514124294,40.0,0.0
1770,0,1770,[272 297 315 303 213],894,5,7881,4.450028232636928,40.0,0.0
1771,0,1771,[272 297 315 303 213],334,5,7886,4.450338600451468,40.0,0.0
1772,0,1772,[272 297 315 303 213],894,5,7891,4.450648618161308,40.0,0.0
1773,0,1773,[272 297 315 303 213],334,5,7896,4.450958286358512,40.0,0.0
1774,0,1774,[272 297 315 303 213],894,5,7901,4.451267605633803,40.0,0.0
1775,0,1775,[272 297 315 303 213],334,5,7906,4.451576576576577,40.0,0.0
1776,0,1776,[272 297 315 303 213],334,5,7911,4.451885199774901,40.0,0.0
1777,0,1777,[272 297 315 303 213],334,5,7916,4.452193475815523,40.0,0.0
1778,0,1778,[223 275 232 583 226],7,3,7919,4.451377178189994,20.0,20.0
1779,0,1779,[272 297 315 303 213],894,5,7924,4.451685393258427,40.0,0.0
1780,0,1780,[250 284 326 298 316],894,2,7926,4.450308815272319,20.0,0.0
1781,0,1781,[272 297 315 303 213],894,5,7931,4.450617283950617,40.0,0.0
1782,0,1782,[272 297 315 303 213],894,5,7936,4.450925406618059,40.0,0.0
1783,0,1783,[272 297 315 303 213],334,5,7941,4.451233183856503,40.0,0.0
1784,0,1784,[272 297 315 303 213],894,5,7946,4.451540616246499,40.0,0.0
1785,0,1785,[272 297 315 303 213],894,5,7951,4.451847704367301,40.0,0.0
1786,0,1786,[272 297 315 303 213],334,5,7956,4.4521544487968665,40.0,0.0
1787,0,1787,[272 297 315 303 213],894,5,7961,4.452460850111857,40.0,0.0
1788,0,1788,[272 297 315 303 213],334,5,7966,4.4527669088876465,40.0,0.0
1789,0,1789,[272 297 315 303 213],334,5,7971,4.453072625698324,40.0,0.0
1790,0,1790,[272 297 315 303 213],334,5,7976,4.453378001116695,40.0,0.0
1791,0,1791,[272 297 315 303 213],894,5,7981,4.453683035714286,40.0,0.0
1792,0,1792,[272 297 315 303 213],894,5,7986,4.45398773006135,40.0,0.0
1793,0,1793,[272 297 315 303 213],334,5,7991,4.454292084726867,40.0,0.0
1794,0,1794,[272 297 315 303 213],894,5,7996,4.454596100278551,40.0,0.0
1795,0,1795,[272 297 315 303 213],334,5,8001,4.454899777282851,40.0,0.0
1796,0,1796,[272 297 315 303 213],334,5,8006,4.455203116304952,40.0,0.0
1797,0,1797,[272 297 315 303 213],334,5,8011,4.455506117908787,40.0,0.0
1798,0,1798,[300 208 231 212 276],537,2,8013,4.45414118954975,0.0,40.0
1799,0,1799,[272 297 315 303 213],334,5,8018,4.454444444444444,40.0,0.0
1800,0,1800,[272 297 315 303 213],334,5,8023,4.454747362576346,40.0,0.0
1801,0,1801,[272 297 315 303 213],334,5,8028,4.455049944506104,40.0,0.0
1802,0,1802,[272 297 315 303 213],894,5,8033,4.455352190793122,40.0,0.0
1803,0,1803,[272 297 315 303 213],894,5,8038,4.455654101995566,40.0,0.0
1804,0,1804,[254 276 231 239 280],378,1,8039,4.4537396121883654,0.0,20.0
1805,0,1805,[244 220 299 298 295],486,0,8039,4.451273532668882,0.0,0.0
1806,0,1806,[272 297 315 303 213],334,5,8044,4.451577199778638,40.0,0.0
1807,0,1807,[272 297 315 303 213],894,5,8049,4.451880530973451,40.0,0.0
1808,0,1808,[272 297 315 303 213],894,5,8054,4.452183526810392,40.0,0.0
1809,0,1809,[299 202 508 321 507],13,1,8055,4.4502762430939224,0.0,0.0
1810,0,1810,[272 297 315 303 213],894,5,8060,4.450579790171176,40.0,0.0
1811,0,1811,[272 297 315 303 213],334,5,8065,4.450883002207505,40.0,0.0
1812,0,1812,[272 297 315 303 213],334,5,8070,4.4511858797573085,40.0,0.0
1813,0,1813,[272 297 315 303 213],334,5,8075,4.4514884233737595,40.0,0.0
1814,0,1814,[272 297 315 303 213],334,5,8080,4.451790633608815,40.0,0.0
1815,0,1815,[272 297 315 303 213],334,5,8085,4.452092511013216,40.0,0.0
1816,0,1816,[272 297 315 303 213],894,5,8090,4.452394056136488,40.0,0.0
1817,0,1817,[272 297 315 303 213],334,5,8095,4.452695269526953,40.0,0.0
1818,0,1818,[272 297 315 303 213],334,5,8100,4.452996151731721,40.0,0.0
1819,0,1819,[272 297 315 303 213],894,5,8105,4.4532967032967035,40.0,0.0
1820,0,1820,[272 297 315 303 213],894,5,8110,4.453596924766612,40.0,0.0
1821,0,1821,[272 297 315 303 213],334,5,8115,4.453896816684962,40.0,0.0
1822,0,1822,[367 216 321 478 215],13,2,8117,4.452550740537576,0.0,0.0
1823,0,1823,[272 297 315 303 213],894,5,8122,4.452850877192983,40.0,0.0
1824,0,1824,[272 297 315 303 213],894,5,8127,4.453150684931507,40.0,0.0
1825,0,1825,[261 303 331 280 272],13,3,8130,4.452354874041621,0.0,0.0
1826,0,1826,[272 297 315 303 213],334,5,8135,4.452654625068418,40.0,0.0
1827,0,1827,[272 297 315 303 213],894,5,8140,4.452954048140044,40.0,0.0
1828,0,1828,[272 297 315 303 213],894,5,8145,4.453253143794424,40.0,0.0
1829,0,1829,[272 297 315 303 213],894,5,8150,4.453551912568306,40.0,0.0
1830,0,1830,[272 297 315 303 213],334,5,8155,4.453850354997269,40.0,0.0
1831,0,1831,[272 297 315 303 213],334,5,8160,4.454148471615721,40.0,0.0
1832,0,1832,[272 297 315 303 213],334,5,8165,4.4544462629569015,40.0,0.0
1833,0,1833,[272 297 315 303 213],334,5,8170,4.45474372955289,40.0,0.0
1834,0,1834,[272 297 315 303 213],334,5,8175,4.455040871934605,40.0,0.0
1835,0,1835,[321 219 212 478 241],234,0,8175,4.4526143790849675,0.0,0.0
1836,0,1836,[272 297 315 303 213],894,5,8180,4.4529123571039735,40.0,0.0
1837,0,1837,[272 297 315 303 213],334,5,8185,4.453210010881393,40.0,0.0
1838,0,1838,[272 297 315 303 213],334,5,8190,4.4535073409461665,40.0,0.0
1839,0,1839,[272 297 315 303 213],334,5,8195,4.453804347826087,40.0,0.0
1840,0,1840,[272 297 315 303 213],334,5,8200,4.4541010320478005,40.0,0.0
1841,0,1841,[431 208 241 478 215],13,3,8203,4.453311617806732,0.0,0.0
1842,0,1842,[272 297 315 303 213],334,5,8208,4.453608247422681,40.0,0.0
1843,0,1843,[239 290 231 303 216],13,3,8211,4.452819956616052,0.0,0.0
1844,0,1844,[272 297 315 303 213],894,5,8216,4.453116531165311,40.0,0.0
1845,0,1845,[272 297 315 303 213],894,5,8221,4.4534127843987,40.0,0.0
1846,0,1846,[272 297 315 303 213],334,5,8226,4.453708716838116,40.0,0.0
1847,0,1847,[290 485 284 316 268],234,1,8227,4.4518398268398265,20.0,0.0
1848,0,1848,[272 297 315 303 213],334,5,8232,4.452136289886425,40.0,0.0
1849,0,1849,[272 297 315 303 213],894,5,8237,4.452432432432432,40.0,0.0
1850,0,1850,[272 297 315 303 213],334,5,8242,4.452728254997298,40.0,0.0
1851,0,1851,[226 431 298 295 219],648,4,8246,4.452483801295896,0.0,0.0
1852,0,1852,[392 231 216 420 255],378,3,8249,4.451699946033459,0.0,0.0
1853,0,1853,[272 297 315 303 213],894,5,8254,4.451995685005394,40.0,0.0
1854,0,1854,[272 297 315 303 213],334,5,8259,4.452291105121294,40.0,0.0
1855,0,1855,[272 297 315 303 213],334,5,8264,4.452586206896552,40.0,0.0
1856,0,1856,[272 297 315 303 213],894,5,8269,4.45288099084545,40.0,0.0
1857,0,1857,[272 297 315 303 213],894,5,8274,4.453175457481162,40.0,0.0
1858,0,1858,[272 297 315 303 213],894,5,8279,4.453469607315761,40.0,0.0
1859,0,1859,[272 297 315 303 213],894,5,8284,4.453763440860215,40.0,0.0
1860,0,1860,[272 297 315 303 213],894,5,8289,4.454056958624395,40.0,0.0
1861,0,1861,[293 216 275 217 284],158,4,8293,4.453813104189044,0.0,20.0
1862,0,1862,[272 297 315 303 213],894,5,8298,4.454106280193237,40.0,0.0
1863,0,1863,[272 297 315 303 213],894,5,8303,4.454399141630901,40.0,0.0
1864,0,1864,[272 297 315 303 213],894,5,8308,4.454691689008043,40.0,0.0
1865,0,1865,[272 297 315 303 213],334,5,8313,4.454983922829582,40.0,0.0
1866,0,1866,[272 297 315 303 213],894,5,8318,4.455275843599357,40.0,0.0
1867,0,1867,[507 276 378 275 315],271,3,8321,4.454496788008566,20.0,40.0
1868,0,1868,[272 297 315 303 213],334,5,8326,4.454788657035848,40.0,0.0
1869,0,1869,[272 297 315 303 213],334,5,8331,4.455080213903743,40.0,0.0
1870,0,1870,[272 297 315 303 213],894,5,8336,4.455371459112774,40.0,0.0
1871,0,1871,[272 297 315 303 213],894,5,8341,4.4556623931623935,40.0,0.0
1872,0,1872,[272 297 315 303 213],334,5,8346,4.455953016550987,40.0,0.0
1873,0,1873,[272 297 315 303 213],894,5,8351,4.45624332977588,40.0,0.0
1874,0,1874,[272 297 315 303 213],334,5,8356,4.456533333333334,40.0,0.0
1875,0,1875,[272 297 315 303 213],894,5,8361,4.45682302771855,40.0,0.0
1876,0,1876,[272 297 315 303 213],894,5,8366,4.457112413425679,40.0,0.0
1877,0,1877,[272 297 315 303 213],894,5,8371,4.457401490947817,40.0,0.0
1878,0,1878,[272 297 315 303 213],334,5,8376,4.457690260777009,40.0,0.0
1879,0,1879,[272 297 315 303 213],894,5,8381,4.457978723404255,40.0,0.0
1880,0,1880,[272 297 315 303 213],894,5,8386,4.458266879319511,40.0,0.0
1881,0,1881,[272 297 315 303 213],894,5,8391,4.45855472901169,40.0,0.0
1882,0,1882,[485 202 219 211 215],406,1,8392,4.456718003186404,0.0,20.0
1883,0,1883,[272 297 315 303 213],894,5,8397,4.457006369426751,40.0,0.0
1884,0,1884,[272 297 315 303 213],334,5,8402,4.457294429708223,40.0,0.0
1885,0,1885,[272 297 315 303 213],334,5,8407,4.457582184517498,40.0,0.0
1886,0,1886,[272 297 315 303 213],894,5,8412,4.457869634340223,40.0,0.0
1887,0,1887,[272 297 315 303 213],334,5,8417,4.458156779661017,40.0,0.0
1888,0,1888,[272 297 315 303 213],334,5,8422,4.458443620963473,40.0,0.0
1889,0,1889,[272 297 315 303 213],894,5,8427,4.458730158730159,40.0,0.0
1890,0,1890,[272 297 315 303 213],894,5,8432,4.459016393442623,40.0,0.0
1891,0,1891,[272 297 315 303 213],334,5,8437,4.459302325581396,40.0,0.0
1892,0,1892,[272 297 315 303 213],894,5,8442,4.459587955625991,40.0,0.0
1893,0,1893,[272 297 315 303 213],334,5,8447,4.45987328405491,40.0,0.0
1894,0,1894,[272 297 315 303 213],894,5,8452,4.460158311345646,40.0,0.0
1895,0,1895,[272 297 315 303 213],894,5,8457,4.4604430379746836,40.0,0.0
1896,0,1896,[272 297 315 303 213],334,5,8462,4.460727464417501,40.0,0.0
1897,0,1897,[331 508 246 316 223],894,4,8466,4.460484720758694,40.0,0.0
1898,0,1898,[272 297 315 303 213],334,5,8471,4.460768825697736,40.0,0.0
1899,0,1899,[272 297 315 303 213],894,5,8476,4.461052631578947,40.0,0.0
1900,0,1900,[272 297 315 303 213],894,5,8481,4.461336138874277,40.0,0.0
1901,0,1901,[272 297 315 303 213],894,5,8486,4.461619348054679,40.0,0.0
1902,0,1902,[272 297 315 303 213],894,5,8491,4.461902259590121,40.0,0.0
1903,0,1903,[272 297 315 303 213],894,5,8496,4.46218487394958,40.0,0.0
1904,0,1904,[298 326 508 291 250],825,5,8501,4.46246719160105,0.0,0.0
1905,0,1905,[272 297 315 303 213],894,5,8506,4.462749213011542,40.0,0.0
1906,0,1906,[272 297 315 303 213],334,5,8511,4.46303093864709,40.0,0.0
1907,0,1907,[272 297 315 303 213],894,5,8516,4.463312368972747,40.0,0.0
1908,0,1908,[216 219 367 293 211],385,1,8517,4.461498166579361,0.0,20.0
1909,0,1909,[394 231 275 321 485],13,0,8517,4.459162303664922,0.0,20.0
1910,0,1910,[272 297 315 303 213],894,5,8522,4.459445316588174,40.0,0.0
1911,0,1911,[272 297 315 303 213],894,5,8527,4.459728033472803,40.0,0.0
1912,0,1912,[272 297 315 303 213],334,5,8532,4.460010454783063,40.0,0.0
1913,0,1913,[272 297 315 303 213],334,5,8537,4.4602925809822365,40.0,0.0
1914,0,1914,[272 297 315 303 213],334,5,8542,4.460574412532637,40.0,0.0
1915,0,1915,[272 297 315 303 213],894,5,8547,4.460855949895616,40.0,0.0
1916,0,1916,[272 297 315 303 213],334,5,8552,4.46113719353156,40.0,0.0
1917,0,1917,[201 485 509 226 290],537,1,8553,4.459332638164755,0.0,0.0
1918,0,1918,[272 297 315 303 213],334,5,8558,4.459614382490881,40.0,0.0
1919,0,1919,[230 202 250 241 284],158,4,8562,4.459375,0.0,0.0
1920,0,1920,[272 297 315 303 213],894,5,8567,4.4596564289432585,40.0,0.0
1921,0,1921,[227 215 201 452 431],7,3,8570,4.458896982310094,0.0,0.0
1922,0,1922,[272 297 315 303 213],894,5,8575,4.459178367134685,40.0,0.0
1923,0,1923,[227 202 367 231 211],447,1,8576,4.457380457380458,0.0,20.0
1924,0,1924,[226 202 431 331 344],13,2,8578,4.456103896103896,0.0,0.0
1925,0,1925,[367 226 216 350 326],13,1,8579,4.454309449636552,0.0,0.0
1926,0,1926,[272 297 315 303 213],334,5,8584,4.4545926310326935,40.0,0.0
1927,0,1927,[272 297 315 303 213],894,5,8589,4.454875518672199,40.0,0.0
1928,0,1928,[272 297 315 303 213],894,5,8594,4.455158113011923,40.0,0.0
1929,0,1929,[239 509 213 226 218],378,2,8596,4.4538860103626945,0.0,0.0
1930,0,1930,[272 297 315 303 213],334,5,8601,4.454168824443293,40.0,0.0
1931,0,1931,[272 297 315 303 213],894,5,8606,4.454451345755694,40.0,0.0
1932,0,1932,[272 297 315 303 213],334,5,8611,4.454733574754268,40.0,0.0
1933,0,1933,[272 297 315 303 213],334,5,8616,4.455015511892451,40.0,0.0
1934,0,1934,[272 297 315 303 213],334,5,8621,4.455297157622739,40.0,0.0
1935,0,1935,[272 297 315 303 213],334,5,8626,4.455578512396694,40.0,0.0
1936,0,1936,[272 297 315 303 213],894,5,8631,4.455859576664945,40.0,0.0
1937,0,1937,[272 297 315 303 213],894,5,8636,4.456140350877193,40.0,0.0
1938,0,1938,[272 297 315 303 213],894,5,8641,4.4564208354822075,40.0,0.0
1939,0,1939,[272 297 315 303 213],334,5,8646,4.456701030927835,40.0,0.0
1940,0,1940,[272 297 315 303 213],334,5,8651,4.456980937660999,40.0,0.0
1941,0,1941,[272 297 315 303 213],334,5,8656,4.457260556127704,40.0,0.0
1942,0,1942,[272 297 315 303 213],894,5,8661,4.457539886773032,40.0,0.0
1943,0,1943,[300 301 268 227 350],13,2,8663,4.4562757201646095,0.0,20.0
1944,0,1944,[272 297 315 303 213],334,5,8668,4.456555269922879,40.0,0.0
1945,0,1945,[272 297 315 303 213],894,5,8673,4.456834532374101,40.0,0.0
1946,0,1946,[272 297 315 303 213],334,5,8678,4.457113507960965,40.0,0.0
1947,0,1947,[272 297 315 303 213],894,5,8683,4.457392197125257,40.0,0.0
1948,0,1948,[272 297 315 303 213],334,5,8688,4.45767060030785,40.0,0.0
1949,0,1949,[272 297 315 303 213],334,5,8693,4.457948717948718,40.0,0.0
1950,0,1950,[272 297 315 303 213],894,5,8698,4.45822655048693,40.0,0.0
1951,0,1951,[272 297 315 303 213],894,5,8703,4.458504098360656,40.0,0.0
1952,0,1952,[272 297 315 303 213],894,5,8708,4.458781362007168,40.0,0.0
1953,0,1953,[326 413 276 284 298],548,2,8710,4.457523029682702,0.0,20.0
1954,0,1954,[272 297 315 303 213],894,5,8715,4.457800511508951,40.0,0.0
1955,0,1955,[272 297 315 303 213],894,5,8720,4.458077709611452,40.0,0.0
1956,0,1956,[272 297 315 303 213],894,5,8725,4.458354624425141,40.0,0.0
1957,0,1957,[272 297 315 303 213],334,5,8730,4.4586312563840655,40.0,0.0
1958,0,1958,[272 297 315 303 213],894,5,8735,4.458907605921389,40.0,0.0
1959,0,1959,[272 297 315 303 213],894,5,8740,4.459183673469388,40.0,0.0
1960,0,1960,[272 297 315 303 213],334,5,8745,4.45945945945946,40.0,0.0
1961,0,1961,[209 384 321 429 344],13,1,8746,4.45769622833843,0.0,0.0
1962,0,1962,[272 297 315 303 213],334,5,8751,4.457972491085074,40.0,0.0
1963,0,1963,[272 297 315 303 213],894,5,8756,4.458248472505091,40.0,0.0
1964,0,1964,[272 297 315 303 213],334,5,8761,4.45852417302799,40.0,0.0
1965,0,1965,[272 297 315 303 213],894,5,8766,4.458799593082401,40.0,0.0
1966,0,1966,[272 297 315 303 213],334,5,8771,4.459074733096085,40.0,0.0
1967,0,1967,[378 211 250 215 291],804,5,8776,4.459349593495935,0.0,20.0
1968,0,1968,[272 297 315 303 213],334,5,8781,4.459624174707973,40.0,0.0
1969,0,1969,[272 297 315 303 213],334,5,8786,4.459898477157361,40.0,0.0
1970,0,1970,[272 297 315 303 213],894,5,8791,4.460172501268391,40.0,0.0
1971,0,1971,[272 297 315 303 213],894,5,8796,4.460446247464503,40.0,0.0
1972,0,1972,[272 297 315 303 213],894,5,8801,4.4607197161682715,40.0,0.0
1973,0,1973,[272 297 315 303 213],334,5,8806,4.460992907801418,40.0,0.0
1974,0,1974,[272 297 315 303 213],894,5,8811,4.46126582278481,40.0,0.0
1975,0,1975,[272 297 315 303 213],894,5,8816,4.461538461538462,40.0,0.0
1976,0,1976,[272 297 315 303 213],894,5,8821,4.461810824481538,40.0,0.0
1977,0,1977,[272 297 315 303 213],334,5,8826,4.462082912032356,40.0,0.0
1978,0,1978,[272 297 315 303 213],894,5,8831,4.462354724608388,40.0,0.0
1979,0,1979,[272 297 315 303 213],894,5,8836,4.462626262626262,40.0,0.0
1980,0,1980,[272 297 315 303 213],894,5,8841,4.4628975265017665,40.0,0.0
1981,0,1981,[300 211 509 275 326],454,2,8843,4.461654894046418,0.0,60.0
1982,0,1982,[272 297 315 303 213],894,5,8848,4.461926374180535,40.0,0.0
1983,0,1983,[272 297 315 303 213],894,5,8853,4.462197580645161,40.0,0.0
1984,0,1984,[272 297 315 303 213],894,5,8858,4.462468513853905,40.0,0.0
1985,0,1985,[272 297 315 303 213],334,5,8863,4.462739174219537,40.0,0.0
1986,0,1986,[272 297 315 303 213],334,5,8868,4.463009562154001,40.0,0.0
1987,0,1987,[272 297 315 303 213],334,5,8873,4.46327967806841,40.0,0.0
1988,0,1988,[272 297 315 303 213],334,5,8878,4.463549522373052,40.0,0.0
1989,0,1989,[272 297 315 303 213],894,5,8883,4.463819095477387,40.0,0.0
1990,0,1990,[272 297 315 303 213],894,5,8888,4.464088397790055,40.0,0.0
1991,0,1991,[272 297 315 303 213],894,5,8893,4.464357429718875,40.0,0.0
1992,0,1992,[272 297 315 303 213],894,5,8898,4.464626191670848,40.0,0.0
1993,0,1993,[272 297 315 303 213],894,5,8903,4.464894684052156,40.0,0.0
1994,0,1994,[272 297 315 303 213],894,5,8908,4.46516290726817,40.0,0.0
1995,0,1995,[272 297 315 303 213],334,5,8913,4.465430861723447,40.0,0.0
1996,0,1996,[272 297 315 303 213],894,5,8918,4.465698547821733,40.0,0.0
1997,0,1997,[272 297 315 303 213],894,5,8923,4.465965965965966,40.0,0.0
1998,0,1998,[272 297 315 303 213],334,5,8928,4.466233116558279,40.0,0.0
1999,0,1999,[272 297 315 303 213],894,5,8933,4.4665,40.0,0.0
2000,0,2000,[272 297 315 303 213],334,5,8938,4.466766616691654,40.0,0.0
2001,0,2001,[272 297 315 303 213],894,5,8943,4.467032967032967,40.0,0.0
2002,0,2002,[301 485 220 478 218],184,2,8945,4.465801298052921,0.0,0.0
2003,0,2003,[272 297 315 303 213],334,5,8950,4.466067864271457,40.0,0.0
2004,0,2004,[272 297 315 303 213],334,5,8955,4.466334164588528,40.0,0.0
2005,0,2005,[321 208 275 392 378],537,2,8957,4.4651046859421735,0.0,20.0
2006,0,2006,[272 297 315 303 213],334,5,8962,4.46537120079721,40.0,0.0
2007,0,2007,[272 297 315 303 213],334,5,8967,4.465637450199203,40.0,0.0
2008,0,2008,[208 481 213 268 291],85,4,8971,4.4654056744649075,0.0,0.0
2009,0,2009,[272 297 315 303 213],894,5,8976,4.465671641791045,40.0,0.0
2010,0,2010,[272 297 315 303 213],894,5,8981,4.465937344604674,40.0,0.0
2011,0,2011,[272 297 315 303 213],894,5,8986,4.466202783300199,40.0,0.0
2012,0,2012,[272 297 315 303 213],334,5,8991,4.466467958271237,40.0,0.0
2013,0,2013,[272 297 315 303 213],894,5,8996,4.466732869910626,40.0,0.0
2014,0,2014,[272 297 315 303 213],334,5,9001,4.466997518610422,40.0,0.0
2015,0,2015,[272 297 315 303 213],334,5,9006,4.467261904761905,40.0,0.0
2016,0,2016,[272 297 315 303 213],894,5,9011,4.467526028755578,40.0,0.0
2017,0,2017,[272 297 315 303 213],334,5,9016,4.4677898909811695,40.0,0.0
2018,0,2018,[509 226 290 485 431],13,3,9019,4.467062902426944,0.0,0.0
2019,0,2019,[272 297 315 303 213],894,5,9024,4.467326732673268,40.0,0.0
2020,0,2020,[272 297 315 303 213],334,5,9029,4.467590301830777,40.0,0.0
2021,0,2021,[272 297 315 303 213],334,5,9034,4.467853610286845,40.0,0.0
2022,0,2022,[272 297 315 303 213],334,5,9039,4.468116658428077,40.0,0.0
2023,0,2023,[272 297 315 303 213],894,5,9044,4.468379446640316,40.0,0.0
2024,0,2024,[485 431 209 283 206],234,2,9046,4.46716049382716,0.0,0.0
2025,0,2025,[272 297 315 303 213],894,5,9051,4.467423494570583,40.0,0.0
2026,0,2026,[272 297 315 303 213],894,5,9056,4.467686235816478,40.0,0.0
2027,0,2027,[272 297 315 303 213],894,5,9061,4.467948717948718,40.0,0.0
2028,0,2028,[301 420 350 303 241],13,2,9063,4.466732380482997,0.0,0.0
2029,0,2029,[272 297 315 303 213],894,5,9068,4.466995073891626,40.0,0.0
2030,0,2030,[272 297 315 303 213],894,5,9073,4.467257508616445,40.0,0.0
2031,0,2031,[272 297 315 303 213],894,5,9078,4.46751968503937,40.0,0.0
2032,0,2032,[272 297 315 303 213],334,5,9083,4.467781603541564,40.0,0.0
2033,0,2033,[272 297 315 303 213],334,5,9088,4.468043264503441,40.0,0.0
2034,0,2034,[272 297 315 303 213],334,5,9093,4.468304668304668,40.0,0.0
2035,0,2035,[272 297 315 303 213],334,5,9098,4.468565815324165,40.0,0.0
2036,0,2036,[272 297 315 303 213],894,5,9103,4.468826705940108,40.0,0.0
2037,0,2037,[272 297 315 303 213],894,5,9108,4.469087340529931,40.0,0.0
2038,0,2038,[272 297 315 303 213],894,5,9113,4.469347719470329,40.0,0.0
2039,0,2039,[201 236 215 301 508],537,1,9114,4.4676470588235295,0.0,0.0
2040,0,2040,[272 297 315 303 213],334,5,9119,4.467907888290054,40.0,0.0
2041,0,2041,[272 297 315 303 213],334,5,9124,4.468168462291871,40.0,0.0
2042,0,2042,[272 297 315 303 213],334,5,9129,4.4684287812041115,40.0,0.0
2043,0,2043,[272 297 315 303 213],894,5,9134,4.468688845401174,40.0,0.0
2044,0,2044,[272 297 315 303 213],334,5,9139,4.468948655256724,40.0,0.0
2045,0,2045,[272 297 315 303 213],894,5,9144,4.469208211143695,40.0,0.0
2046,0,2046,[272 297 315 303 213],334,5,9149,4.469467513434294,40.0,0.0
2047,0,2047,[272 297 315 303 213],334,5,9154,4.4697265625,40.0,0.0
2048,0,2048,[272 297 315 303 213],334,5,9159,4.4699853587115665,40.0,0.0
2049,0,2049,[420 284 298 223 219],308,4,9163,4.469756097560976,20.0,0.0
2050,0,2050,[272 297 315 303 213],894,5,9168,4.470014627011214,40.0,0.0
2051,0,2051,[272 297 315 303 213],894,5,9173,4.470272904483431,40.0,0.0
2052,0,2052,[272 297 315 303 213],894,5,9178,4.470530930345835,40.0,0.0
2053,0,2053,[272 297 315 303 213],894,5,9183,4.47078870496592,40.0,0.0
2054,0,2054,[232 452 420 508 208],13,2,9185,4.469586374695864,0.0,0.0
2055,0,2055,[272 297 315 303 213],334,5,9190,4.469844357976654,40.0,0.0
2056,0,2056,[272 297 315 303 213],894,5,9195,4.470102090422946,40.0,0.0
2057,0,2057,[272 297 315 303 213],334,5,9200,4.470359572400389,40.0,0.0
2058,0,2058,[272 297 315 303 213],894,5,9205,4.470616804273919,40.0,0.0
2059,0,2059,[272 297 315 303 213],334,5,9210,4.470873786407767,40.0,0.0
2060,0,2060,[272 297 315 303 213],894,5,9215,4.471130519165453,40.0,0.0
2061,0,2061,[272 297 315 303 213],894,5,9220,4.471387002909796,40.0,0.0
2062,0,2062,[268 481 230 211 209],85,4,9224,4.4711585070285995,0.0,20.0
2063,0,2063,[272 297 315 303 213],334,5,9229,4.471414728682171,40.0,0.0
2064,0,2064,[272 297 315 303 213],894,5,9234,4.471670702179177,40.0,0.0
2065,0,2065,[222 215 275 431 507],474,4,9238,4.4714424007744435,0.0,40.0
2066,0,2066,[272 297 315 303 213],894,5,9243,4.471698113207547,40.0,0.0
2067,0,2067,[272 297 315 303 213],334,5,9248,4.471953578336557,40.0,0.0
2068,0,2068,[272 297 315 303 213],334,5,9253,4.472208796520058,40.0,0.0
2069,0,2069,[227 507 275 429 268],7,3,9256,4.471497584541063,0.0,20.0
2070,0,2070,[272 297 315 303 213],894,5,9261,4.471752776436504,40.0,0.0
2071,0,2071,[272 297 315 303 213],894,5,9266,4.472007722007722,40.0,0.0
2072,0,2072,[272 297 315 303 213],334,5,9271,4.472262421611192,40.0,0.0
2073,0,2073,[272 297 315 303 213],334,5,9276,4.4725168756027,40.0,0.0
2074,0,2074,[272 297 315 303 213],894,5,9281,4.472771084337349,40.0,0.0
2075,0,2075,[212 321 236 209 213],234,1,9282,4.471098265895954,0.0,0.0
2076,0,2076,[272 297 315 303 213],894,5,9287,4.471352912855079,40.0,0.0
2077,0,2077,[272 297 315 303 213],894,5,9292,4.471607314725698,40.0,0.0
2078,0,2078,[272 297 315 303 213],334,5,9297,4.471861471861472,40.0,0.0
2079,0,2079,[272 297 315 303 213],894,5,9302,4.4721153846153845,40.0,0.0
2080,0,2080,[272 297 315 303 213],334,5,9307,4.47236905333974,40.0,0.0
2081,0,2081,[272 297 315 303 213],334,5,9312,4.472622478386167,40.0,0.0
2082,0,2082,[272 297 315 303 213],334,5,9317,4.4728756601056165,40.0,0.0
2083,0,2083,[227 232 331 264 209],13,2,9319,4.471689059500959,0.0,0.0
2084,0,2084,[272 297 315 303 213],334,5,9324,4.471942446043165,40.0,0.0
2085,0,2085,[272 297 315 303 213],334,5,9329,4.472195589645254,40.0,0.0
2086,0,2086,[272 297 315 303 213],894,5,9334,4.472448490656444,40.0,0.0
2087,0,2087,[272 297 315 303 213],334,5,9339,4.472701149425287,40.0,0.0
2088,0,2088,[259 243 213 218 431],804,3,9342,4.4719961704164675,0.0,0.0
2089,0,2089,[367 301 211 394 429],13,2,9344,4.470813397129187,0.0,20.0
2090,0,2090,[227 378 509 420 239],311,2,9346,4.469631755141081,0.0,0.0
2091,0,2091,[272 297 315 303 213],334,5,9351,4.469885277246654,40.0,0.0
2092,0,2092,[255 301 275 272 223],334,3,9354,4.469182990922121,20.0,20.0
2093,0,2093,[272 297 315 303 213],334,5,9359,4.469436485195797,40.0,0.0
2094,0,2094,[485 209 222 213 227],334,2,9361,4.468257756563246,0.0,20.0
2095,0,2095,[272 297 315 303 213],334,5,9366,4.468511450381679,40.0,0.0
2096,0,2096,[272 297 315 303 213],894,5,9371,4.468764902241297,40.0,0.0
2097,0,2097,[272 297 315 303 213],894,5,9376,4.469018112488084,40.0,0.0
2098,0,2098,[272 297 315 303 213],334,5,9381,4.469271081467365,40.0,0.0
2099,0,2099,[272 297 315 303 213],894,5,9386,4.4695238095238095,40.0,0.0
2100,0,2100,[272 297 315 303 213],894,5,9391,4.469776297001428,40.0,0.0
2101,0,2101,[272 297 315 303 213],334,5,9396,4.470028544243577,40.0,0.0
2102,0,2102,[272 297 315 303 213],894,5,9401,4.470280551592962,40.0,0.0
2103,0,2103,[272 297 315 303 213],334,5,9406,4.470532319391635,40.0,0.0
2104,0,2104,[264 384 275 324 378],7,3,9409,4.469833729216152,0.0,20.0
2105,0,2105,[272 297 315 303 213],334,5,9414,4.47008547008547,40.0,0.0
2106,0,2106,[272 297 315 303 213],894,5,9419,4.470336971998101,40.0,0.0
2107,0,2107,[272 297 315 303 213],334,5,9424,4.470588235294118,40.0,0.0
2108,0,2108,[226 481 367 239 222],892,4,9428,4.470365101944049,0.0,20.0
2109,0,2109,[272 297 315 303 213],334,5,9433,4.470616113744076,40.0,0.0
2110,0,2110,[272 297 315 303 213],334,5,9438,4.470866887730933,40.0,0.0
2111,0,2111,[272 297 315 303 213],894,5,9443,4.471117424242424,40.0,0.0
2112,0,2112,[272 297 315 303 213],894,5,9448,4.471367723615712,40.0,0.0
2113,0,2113,[272 297 315 303 213],334,5,9453,4.4716177861873225,40.0,0.0
2114,0,2114,[272 297 315 303 213],894,5,9458,4.471867612293144,40.0,0.0
2115,0,2115,[272 297 315 303 213],334,5,9463,4.472117202268431,40.0,0.0
2116,0,2116,[272 297 315 303 213],334,5,9468,4.4723665564478035,40.0,0.0
2117,0,2117,[272 297 315 303 213],894,5,9473,4.47261567516525,40.0,0.0
2118,0,2118,[272 297 315 303 213],334,5,9478,4.47286455875413,40.0,0.0
2119,0,2119,[272 297 315 303 213],334,5,9483,4.47311320754717,40.0,0.0
2120,0,2120,[272 297 315 303 213],894,5,9488,4.473361621876474,40.0,0.0
2121,0,2121,[272 297 315 303 213],334,5,9493,4.473609802073516,40.0,0.0
2122,0,2122,[272 297 315 303 213],894,5,9498,4.473857748469148,40.0,0.0
2123,0,2123,[272 297 315 303 213],334,5,9503,4.474105461393597,40.0,0.0
2124,0,2124,[272 297 315 303 213],334,5,9508,4.474352941176471,40.0,0.0
2125,0,2125,[272 297 315 303 213],894,5,9513,4.474600188146755,40.0,0.0
2126,0,2126,[284 300 215 392 209],537,1,9514,4.472966619652092,0.0,20.0
2127,0,2127,[272 297 315 303 213],894,5,9519,4.473214285714286,40.0,0.0
2128,0,2128,[272 297 315 303 213],334,5,9524,4.473461719116957,40.0,0.0
2129,0,2129,[272 297 315 303 213],894,5,9529,4.473708920187794,40.0,0.0
2130,0,2130,[272 297 315 303 213],894,5,9534,4.4739558892538716,40.0,0.0
2131,0,2131,[272 297 315 303 213],894,5,9539,4.4742026266416515,40.0,0.0
2132,0,2132,[222 291 211 244 300],699,0,9539,4.472105016408814,0.0,60.0
2133,0,2133,[272 297 315 303 213],334,5,9544,4.472352389878163,40.0,0.0
2134,0,2134,[272 297 315 303 213],894,5,9549,4.472599531615925,40.0,0.0
2135,0,2135,[226 485 208 507 429],650,3,9552,4.47191011235955,0.0,0.0
2136,0,2136,[272 297 315 303 213],334,5,9557,4.472157229761348,40.0,0.0
2137,0,2137,[272 297 315 303 213],334,5,9562,4.472404115996258,40.0,0.0
2138,0,2138,[272 297 315 303 213],334,5,9567,4.4726507713884995,40.0,0.0
2139,0,2139,[272 297 315 303 213],334,5,9572,4.472897196261682,40.0,0.0
2140,0,2140,[272 297 315 303 213],334,5,9577,4.473143390938814,40.0,0.0
2141,0,2141,[272 297 315 303 213],894,5,9582,4.473389355742297,40.0,0.0
2142,0,2142,[272 297 315 303 213],894,5,9587,4.473635090993934,40.0,0.0
2143,0,2143,[272 297 315 303 213],334,5,9592,4.473880597014926,40.0,0.0
2144,0,2144,[272 297 315 303 213],894,5,9597,4.474125874125874,40.0,0.0
2145,0,2145,[272 297 315 303 213],334,5,9602,4.474370922646785,40.0,0.0
2146,0,2146,[272 297 315 303 213],334,5,9607,4.474615742897066,40.0,0.0
2147,0,2147,[272 297 315 303 213],894,5,9612,4.4748603351955305,40.0,0.0
2148,0,2148,[272 297 315 303 213],894,5,9617,4.4751046998604,40.0,0.0
2149,0,2149,[272 297 315 303 213],894,5,9622,4.475348837209302,40.0,0.0
2150,0,2150,[272 297 315 303 213],334,5,9627,4.475592747559275,40.0,0.0
2151,0,2151,[272 297 315 303 213],334,5,9632,4.4758364312267656,40.0,0.0
2152,0,2152,[507 211 508 481 213],474,4,9636,4.475615420343707,0.0,20.0
2153,0,2153,[272 297 315 303 213],334,5,9641,4.47585886722377,40.0,0.0
2154,0,2154,[243 509 202 280 299],13,3,9644,4.475174013921114,0.0,0.0
2155,0,2155,[272 297 315 303 213],334,5,9649,4.475417439703154,40.0,0.0
2156,0,2156,[272 297 315 303 213],334,5,9654,4.475660639777469,40.0,0.0
2157,0,2157,[272 297 315 303 213],894,5,9659,4.475903614457831,40.0,0.0
2158,0,2158,[272 297 315 303 213],894,5,9664,4.476146364057434,40.0,0.0
2159,0,2159,[272 297 315 303 213],334,5,9669,4.476388888888889,40.0,0.0
2160,0,2160,[272 297 315 303 213],334,5,9674,4.476631189264229,40.0,0.0
2161,0,2161,[272 297 315 303 213],894,5,9679,4.476873265494912,40.0,0.0
2162,0,2162,[272 297 315 303 213],334,5,9684,4.477115117891817,40.0,0.0
2163,0,2163,[272 297 315 303 213],894,5,9689,4.47735674676525,40.0,0.0
2164,0,2164,[508 216 202 298 481],6,2,9691,4.47621247113164,0.0,0.0
2165,0,2165,[272 297 315 303 213],334,5,9696,4.476454293628809,40.0,0.0
2166,0,2166,[272 297 315 303 213],894,5,9701,4.4766958929395475,40.0,0.0
2167,0,2167,[272 297 315 303 213],894,5,9706,4.476937269372693,40.0,0.0
2168,0,2168,[272 297 315 303 213],334,5,9711,4.477178423236515,40.0,0.0
2169,0,2169,[272 297 315 303 213],894,5,9716,4.47741935483871,40.0,0.0
2170,0,2170,[326 211 222 226 429],749,4,9720,4.477199447259327,0.0,40.0
2171,0,2171,[215 280 261 508 321],13,2,9722,4.476058931860037,0.0,0.0
2172,0,2172,[272 297 315 303 213],334,5,9727,4.476300046019328,40.0,0.0
2173,0,2173,[272 297 315 303 213],894,5,9732,4.476540938362466,40.0,0.0
2174,0,2174,[272 297 315 303 213],894,5,9737,4.4767816091954025,40.0,0.0
2175,0,2175,[272 297 315 303 213],894,5,9742,4.477022058823529,40.0,0.0
2176,0,2176,[272 297 315 303 213],334,5,9747,4.477262287551676,40.0,0.0
2177,0,2177,[272 297 315 303 213],334,5,9752,4.477502295684114,40.0,0.0
2178,0,2178,[272 297 315 303 213],894,5,9757,4.477742083524553,40.0,0.0
2179,0,2179,[272 297 315 303 213],334,5,9762,4.477981651376147,40.0,0.0
2180,0,2180,[272 297 315 303 213],334,5,9767,4.478220999541494,40.0,0.0
2181,0,2181,[272 297 315 303 213],334,5,9772,4.47846012832264,40.0,0.0
2182,0,2182,[272 297 315 303 213],334,5,9777,4.478699038021072,40.0,0.0
2183,0,2183,[272 297 315 303 213],894,5,9782,4.478937728937729,40.0,0.0
2184,0,2184,[272 297 315 303 213],894,5,9787,4.479176201372998,40.0,0.0
2185,0,2185,[209 202 431 216 212],804,3,9790,4.478499542543458,0.0,0.0
2186,0,2186,[250 283 222 509 230],479,5,9795,4.478737997256515,0.0,20.0
2187,0,2187,[272 297 315 303 213],894,5,9800,4.478976234003657,40.0,0.0
2188,0,2188,[272 297 315 303 213],894,5,9805,4.4792142530836,40.0,0.0
2189,0,2189,[272 297 315 303 213],894,5,9810,4.47945205479452,40.0,0.0
2190,0,2190,[272 297 315 303 213],334,5,9815,4.479689639434048,40.0,0.0
2191,0,2191,[272 297 315 303 213],894,5,9820,4.4799270072992705,40.0,0.0
2192,0,2192,[272 297 315 303 213],334,5,9825,4.480164158686731,40.0,0.0
2193,0,2193,[272 297 315 303 213],334,5,9830,4.480401093892434,40.0,0.0
2194,0,2194,[272 297 315 303 213],334,5,9835,4.480637813211845,40.0,0.0
2195,0,2195,[272 297 315 303 213],334,5,9840,4.48087431693989,40.0,0.0
2196,0,2196,[272 297 315 303 213],894,5,9845,4.481110605370961,40.0,0.0
2197,0,2197,[272 297 315 303 213],334,5,9850,4.481346678798908,40.0,0.0
2198,0,2198,[272 297 315 303 213],334,5,9855,4.4815825375170535,40.0,0.0
2199,0,2199,[272 297 315 303 213],334,5,9860,4.4818181818181815,40.0,0.0
2200,0,2200,[272 297 315 303 213],334,5,9865,4.482053611994548,40.0,0.0
2201,0,2201,[272 297 315 303 213],894,5,9870,4.482288828337874,40.0,0.0
2202,0,2202,[272 297 315 303 213],894,5,9875,4.482523831139355,40.0,0.0
2203,0,2203,[272 297 315 303 213],334,5,9880,4.482758620689655,40.0,0.0
2204,0,2204,[272 297 315 303 213],894,5,9885,4.482993197278912,40.0,0.0
2205,0,2205,[272 297 315 303 213],894,5,9890,4.4832275611967365,40.0,0.0
2206,0,2206,[272 297 315 303 213],334,5,9895,4.483461712732216,40.0,0.0
2207,0,2207,[272 297 315 303 213],894,5,9900,4.483695652173913,40.0,0.0
2208,0,2208,[272 297 315 303 213],334,5,9905,4.483929379809869,40.0,0.0
2209,0,2209,[272 297 315 303 213],334,5,9910,4.484162895927602,40.0,0.0
2210,0,2210,[272 297 315 303 213],894,5,9915,4.484396200814111,40.0,0.0
2211,0,2211,[272 297 315 303 213],334,5,9920,4.4846292947558775,40.0,0.0
2212,0,2212,[272 297 315 303 213],334,5,9925,4.484862178038862,40.0,0.0
2213,0,2213,[272 297 315 303 213],894,5,9930,4.485094850948509,40.0,0.0
2214,0,2214,[272 297 315 303 213],334,5,9935,4.485327313769751,40.0,0.0
2215,0,2215,[272 297 315 303 213],894,5,9940,4.485559566787003,40.0,0.0
2216,0,2216,[272 297 315 303 213],894,5,9945,4.485791610284168,40.0,0.0
2217,0,2217,[272 297 315 303 213],334,5,9950,4.486023444544635,40.0,0.0
2218,0,2218,[272 297 315 303 213],894,5,9955,4.486255069851285,40.0,0.0
2219,0,2219,[272 297 315 303 213],894,5,9960,4.486486486486487,40.0,0.0
2220,0,2220,[272 297 315 303 213],894,5,9965,4.486717694732103,40.0,0.0
2221,0,2221,[272 297 315 303 213],334,5,9970,4.486948694869487,40.0,0.0
2222,0,2222,[272 297 315 303 213],894,5,9975,4.487179487179487,40.0,0.0
2223,0,2223,[272 297 315 303 213],894,5,9980,4.487410071942446,40.0,0.0
2224,0,2224,[226 429 212 250 202],804,4,9984,4.487191011235955,0.0,0.0
2225,0,2225,[272 297 315 303 213],894,5,9989,4.487421383647798,40.0,0.0
2226,0,2226,[231 211 315 272 241],328,4,9993,4.487202514593624,20.0,20.0
2227,0,2227,[272 297 315 303 213],334,5,9998,4.487432675044883,40.0,0.0
2228,0,2228,[272 297 315 303 213],894,5,10003,4.487662628981606,40.0,0.0
2229,0,2229,[272 297 315 303 213],894,5,10008,4.487892376681614,40.0,0.0
2230,0,2230,[272 297 315 303 213],894,5,10013,4.488121918422232,40.0,0.0
2231,0,2231,[272 297 315 303 213],894,5,10018,4.488351254480286,40.0,0.0
2232,0,2232,[272 297 315 303 213],334,5,10023,4.488580385132109,40.0,0.0
2233,0,2233,[272 297 315 303 213],334,5,10028,4.4888093106535365,40.0,0.0
2234,0,2234,[272 297 315 303 213],334,5,10033,4.48903803131991,40.0,0.0
2235,0,2235,[272 297 315 303 213],334,5,10038,4.489266547406082,40.0,0.0
2236,0,2236,[272 297 315 303 213],334,5,10043,4.489494859186411,40.0,0.0
2237,0,2237,[300 223 268 216 478],13,3,10046,4.488829311885612,20.0,20.0
2238,0,2238,[272 297 315 303 213],334,5,10051,4.4890576150067,40.0,0.0
2239,0,2239,[272 297 315 303 213],894,5,10056,4.489285714285714,40.0,0.0
2240,0,2240,[272 297 315 303 213],334,5,10061,4.489513609995537,40.0,0.0
2241,0,2241,[272 297 315 303 213],894,5,10066,4.4897413024085635,40.0,0.0
2242,0,2242,[284 378 215 216 211],318,3,10069,4.489077128845296,0.0,20.0
2243,0,2243,[272 297 315 303 213],894,5,10074,4.489304812834225,40.0,0.0
2244,0,2244,[272 297 315 303 213],894,5,10079,4.489532293986637,40.0,0.0
2245,0,2245,[272 297 315 303 213],334,5,10084,4.489759572573464,40.0,0.0
2246,0,2246,[272 297 315 303 213],334,5,10089,4.489986648865154,40.0,0.0
2247,0,2247,[272 297 315 303 213],894,5,10094,4.490213523131673,40.0,0.0
2248,0,2248,[272 297 315 303 213],894,5,10099,4.490440195642508,40.0,0.0
2249,0,2249,[272 297 315 303 213],334,5,10104,4.490666666666667,40.0,0.0
2250,0,2250,[272 297 315 303 213],894,5,10109,4.490892936472679,40.0,0.0
2251,0,2251,[272 297 315 303 213],334,5,10114,4.4911190053285965,40.0,0.0
2252,0,2252,[272 297 315 303 213],334,5,10119,4.491344873501998,40.0,0.0
2253,0,2253,[272 297 315 303 213],334,5,10124,4.491570541259982,40.0,0.0
2254,0,2254,[272 297 315 303 213],894,5,10129,4.49179600886918,40.0,0.0
2255,0,2255,[331 255 256 213 272],894,3,10132,4.49113475177305,0.0,0.0
2256,0,2256,[272 297 315 303 213],334,5,10137,4.4913602126716885,40.0,0.0
2257,0,2257,[272 297 315 303 213],894,5,10142,4.491585473870682,40.0,0.0
2258,0,2258,[272 297 315 303 213],334,5,10147,4.491810535635237,40.0,0.0
2259,0,2259,[272 297 315 303 213],894,5,10152,4.4920353982300885,40.0,0.0
2260,0,2260,[272 297 315 303 213],334,5,10157,4.492260061919505,40.0,0.0
2261,0,2261,[272 297 315 303 213],894,5,10162,4.492484526967286,40.0,0.0
2262,0,2262,[272 297 315 303 213],334,5,10167,4.492708793636766,40.0,0.0
2263,0,2263,[272 297 315 303 213],894,5,10172,4.492932862190813,40.0,0.0
2264,0,2264,[272 297 315 303 213],894,5,10177,4.4931567328918325,40.0,0.0
2265,0,2265,[272 297 315 303 213],334,5,10182,4.493380406001765,40.0,0.0
2266,0,2266,[272 297 315 303 213],894,5,10187,4.493603881782091,40.0,0.0
2267,0,2267,[272 297 315 303 213],894,5,10192,4.493827160493828,40.0,0.0
2268,0,2268,[250 227 209 508 268],387,4,10196,4.493609519612164,0.0,0.0
2269,0,2269,[272 297 315 303 213],334,5,10201,4.493832599118943,40.0,0.0
2270,0,2270,[272 297 315 303 213],894,5,10206,4.494055482166447,40.0,0.0
2271,0,2271,[272 297 315 303 213],334,5,10211,4.494278169014085,40.0,0.0
2272,0,2272,[272 297 315 303 213],894,5,10216,4.49450065992081,40.0,0.0
2273,0,2273,[431 508 272 206 275],537,4,10220,4.494283201407212,0.0,20.0
2274,0,2274,[272 297 315 303 213],894,5,10225,4.4945054945054945,40.0,0.0
2275,0,2275,[272 297 315 303 213],334,5,10230,4.494727592267135,40.0,0.0
2276,0,2276,[272 297 315 303 213],894,5,10235,4.494949494949495,40.0,0.0
2277,0,2277,[272 297 315 303 213],894,5,10240,4.495171202809482,40.0,0.0
2278,0,2278,[241 239 215 218 295],92,3,10243,4.494515138218517,0.0,0.0
2279,0,2279,[272 297 315 303 213],334,5,10248,4.494736842105263,40.0,0.0
2280,0,2280,[272 297 315 303 213],894,5,10253,4.494958351600175,40.0,0.0
2281,0,2281,[272 297 315 303 213],334,5,10258,4.495179666958808,40.0,0.0
2282,0,2282,[230 283 259 367 275],308,3,10261,4.4945247481384145,0.0,20.0
2283,0,2283,[202 298 378 344 429],833,3,10264,4.493870402802101,0.0,0.0
2284,0,2284,[272 297 315 303 213],334,5,10269,4.494091903719912,40.0,0.0
2285,0,2285,[272 297 315 303 213],334,5,10274,4.494313210848644,40.0,0.0
2286,0,2286,[272 297 315 303 213],894,5,10279,4.494534324442501,40.0,0.0
2287,0,2287,[272 297 315 303 213],894,5,10284,4.494755244755245,40.0,0.0
2288,0,2288,[272 297 315 303 213],334,5,10289,4.4949759720401925,40.0,0.0
2289,0,2289,[272 297 315 303 213],334,5,10294,4.495196506550219,40.0,0.0
2290,0,2290,[272 297 315 303 213],334,5,10299,4.495416848537756,40.0,0.0
2291,0,2291,[201 236 216 230 208],279,4,10303,4.4952006980802794,0.0,0.0
2292,0,2292,[272 297 315 303 213],334,5,10308,4.4954208460532055,40.0,0.0
2293,0,2293,[272 297 315 303 213],894,5,10313,4.495640802092415,40.0,0.0
2294,0,2294,[272 297 315 303 213],894,5,10318,4.495860566448802,40.0,0.0
2295,0,2295,[272 297 315 303 213],334,5,10323,4.496080139372823,40.0,0.0
2296,0,2296,[272 297 315 303 213],894,5,10328,4.496299521114497,40.0,0.0
2297,0,2297,[272 297 315 303 213],894,5,10333,4.496518711923412,40.0,0.0
2298,0,2298,[272 297 315 303 213],334,5,10338,4.496737712048716,40.0,0.0
2299,0,2299,[392 365 295 275 283],308,2,10340,4.495652173913044,0.0,20.0
2300,0,2300,[272 297 315 303 213],894,5,10345,4.49587136027814,40.0,0.0
2301,0,2301,[272 297 315 303 213],894,5,10350,4.496090356211989,40.0,0.0
2302,0,2302,[272 297 315 303 213],894,5,10355,4.496309161962658,40.0,0.0
2303,0,2303,[272 297 315 303 213],894,5,10360,4.496527777777778,40.0,0.0
2304,0,2304,[272 297 315 303 213],894,5,10365,4.496746203904555,40.0,0.0
2305,0,2305,[272 297 315 303 213],894,5,10370,4.496964440589766,40.0,0.0
2306,0,2306,[272 297 315 303 213],894,5,10375,4.4971824880797575,40.0,0.0
2307,0,2307,[583 291 321 378 276],308,2,10377,4.496100519930676,0.0,20.0
2308,0,2308,[272 297 315 303 213],334,5,10382,4.4963187527068,40.0,0.0
2309,0,2309,[272 297 315 303 213],334,5,10387,4.496536796536796,40.0,0.0
2310,0,2310,[272 297 315 303 213],894,5,10392,4.496754651665945,40.0,0.0
2311,0,2311,[272 297 315 303 213],334,5,10397,4.4969723183391,40.0,0.0
2312,0,2312,[272 297 315 303 213],334,5,10402,4.497189796800692,40.0,0.0
2313,0,2313,[272 297 315 303 213],334,5,10407,4.497407087294728,40.0,0.0
2314,0,2314,[272 297 315 303 213],334,5,10412,4.497624190064795,40.0,0.0
2315,0,2315,[272 297 315 303 213],334,5,10417,4.497841105354059,40.0,0.0
2316,0,2316,[272 297 315 303 213],334,5,10422,4.498057833405265,40.0,0.0
2317,0,2317,[272 297 315 303 213],894,5,10427,4.498274374460742,40.0,0.0
2318,0,2318,[272 297 315 303 213],334,5,10432,4.498490728762397,40.0,0.0
2319,0,2319,[272 297 315 303 213],334,5,10437,4.498706896551724,40.0,0.0
2320,0,2320,[272 297 315 303 213],894,5,10442,4.498922878069798,40.0,0.0
2321,0,2321,[272 297 315 303 213],894,5,10447,4.499138673557278,40.0,0.0
2322,0,2322,[272 297 315 303 213],334,5,10452,4.499354283254412,40.0,0.0
2323,0,2323,[272 297 315 303 213],334,5,10457,4.499569707401033,40.0,0.0
2324,0,2324,[272 297 315 303 213],334,5,10462,4.499784946236559,40.0,0.0
2325,0,2325,[272 297 315 303 213],894,5,10467,4.5,40.0,0.0
2326,0,2326,[272 297 315 303 213],894,5,10472,4.500214868929953,40.0,0.0
2327,0,2327,[272 297 315 303 213],894,5,10477,4.500429553264605,40.0,0.0
2328,0,2328,[272 297 315 303 213],894,5,10482,4.500644053241735,40.0,0.0
2329,0,2329,[272 297 315 303 213],334,5,10487,4.5008583690987125,40.0,0.0
2330,0,2330,[272 297 315 303 213],894,5,10492,4.5010725010725015,40.0,0.0
2331,0,2331,[272 297 315 303 213],334,5,10497,4.501286449399657,40.0,0.0
2332,0,2332,[272 297 315 303 213],334,5,10502,4.501500214316331,40.0,0.0
2333,0,2333,[272 297 315 303 213],334,5,10507,4.501713796058269,40.0,0.0
2334,0,2334,[272 297 315 303 213],894,5,10512,4.501927194860814,40.0,0.0
2335,0,2335,[272 297 315 303 213],894,5,10517,4.502140410958904,40.0,0.0
2336,0,2336,[272 297 315 303 213],894,5,10522,4.502353444587078,40.0,0.0
2337,0,2337,[272 297 315 303 213],894,5,10527,4.502566295979469,40.0,0.0
2338,0,2338,[452 299 264 216 215],13,2,10529,4.501496365968363,0.0,0.0
2339,0,2339,[272 297 315 303 213],894,5,10534,4.501709401709402,40.0,0.0
2340,0,2340,[272 297 315 303 213],334,5,10539,4.501922255446391,40.0,0.0
2341,0,2341,[202 420 208 367 261],13,3,10542,4.501280956447481,0.0,0.0
2342,0,2342,[272 297 315 303 213],894,5,10547,4.501493811352966,40.0,0.0
2343,0,2343,[272 297 315 303 213],894,5,10552,4.501706484641638,40.0,0.0
2344,0,2344,[272 297 315 303 213],334,5,10557,4.501918976545842,40.0,0.0
2345,0,2345,[300 222 326 241 215],64,2,10559,4.5008525149190115,0.0,40.0
2346,0,2346,[272 297 315 303 213],894,5,10564,4.501065189603749,40.0,0.0
2347,0,2347,[485 243 261 384 216],13,0,10564,4.499148211243612,0.0,0.0
2348,0,2348,[272 297 315 303 213],894,5,10569,4.499361430395913,40.0,0.0
2349,0,2349,[272 297 315 303 213],894,5,10574,4.499574468085107,40.0,0.0
2350,0,2350,[272 297 315 303 213],334,5,10579,4.499787324542748,40.0,0.0
2351,0,2351,[290 275 230 236 209],279,4,10583,4.499574829931973,0.0,20.0
2352,0,2352,[272 297 315 303 213],894,5,10588,4.4997875053123675,40.0,0.0
2353,0,2353,[272 297 315 303 213],334,5,10593,4.5,40.0,0.0
2354,0,2354,[272 297 315 303 213],894,5,10598,4.500212314225053,40.0,0.0
2355,0,2355,[272 297 315 303 213],894,5,10603,4.500424448217317,40.0,0.0
2356,0,2356,[272 297 315 303 213],334,5,10608,4.500636402206195,40.0,0.0
2357,0,2357,[226 231 223 268 481],13,3,10611,4.5,20.0,0.0
2358,0,2358,[272 297 315 303 213],334,5,10616,4.500211954217889,40.0,0.0
2359,0,2359,[272 297 315 303 213],334,5,10621,4.500423728813559,40.0,0.0
2360,0,2360,[272 297 315 303 213],894,5,10626,4.5006353240152475,40.0,0.0
2361,0,2361,[272 297 315 303 213],334,5,10631,4.500846740050805,40.0,0.0
2362,0,2362,[272 297 315 303 213],334,5,10636,4.501057977147694,40.0,0.0
2363,0,2363,[272 297 315 303 213],334,5,10641,4.501269035532995,40.0,0.0
2364,0,2364,[272 297 315 303 213],334,5,10646,4.5014799154334035,40.0,0.0
2365,0,2365,[316 216 241 239 290],207,2,10648,4.500422654268808,20.0,0.0
2366,0,2366,[272 297 315 303 213],334,5,10653,4.50063371356147,40.0,0.0
2367,0,2367,[272 297 315 303 213],334,5,10658,4.500844594594595,40.0,0.0
2368,0,2368,[272 297 315 303 213],894,5,10663,4.501055297593921,40.0,0.0
2369,0,2369,[272 297 315 303 213],894,5,10668,4.50126582278481,40.0,0.0
2370,0,2370,[272 297 315 303 213],334,5,10673,4.501476170392239,40.0,0.0
2371,0,2371,[272 297 315 303 213],894,5,10678,4.501686340640809,40.0,0.0
2372,0,2372,[429 481 316 236 213],334,5,10683,4.501896333754741,20.0,0.0
2373,0,2373,[272 297 315 303 213],334,5,10688,4.502106149957877,40.0,0.0
2374,0,2374,[272 297 315 303 213],894,5,10693,4.502315789473684,40.0,0.0
2375,0,2375,[272 297 315 303 213],334,5,10698,4.502525252525253,40.0,0.0
2376,0,2376,[272 297 315 303 213],334,5,10703,4.502734539335297,40.0,0.0
2377,0,2377,[272 297 315 303 213],334,5,10708,4.502943650126157,40.0,0.0
2378,0,2378,[272 297 315 303 213],894,5,10713,4.503152585119798,40.0,0.0
2379,0,2379,[272 297 315 303 213],894,5,10718,4.503361344537815,40.0,0.0
2380,0,2380,[272 297 315 303 213],334,5,10723,4.503569928601428,40.0,0.0
2381,0,2381,[272 297 315 303 213],894,5,10728,4.503778337531486,40.0,0.0
2382,0,2382,[508 202 212 222 201],13,2,10730,4.502727654217373,0.0,20.0
2383,0,2383,[272 297 315 303 213],894,5,10735,4.502936241610739,40.0,0.0
2384,0,2384,[299 276 298 301 300],119,4,10739,4.5027253668763105,0.0,40.0
2385,0,2385,[272 297 315 303 213],894,5,10744,4.5029337803855825,40.0,0.0
2386,0,2386,[272 297 315 303 213],894,5,10749,4.503142019271052,40.0,0.0
2387,0,2387,[272 297 315 303 213],894,5,10754,4.5033500837520934,40.0,0.0
2388,0,2388,[272 297 315 303 213],334,5,10759,4.503557974047719,40.0,0.0
2389,0,2389,[272 297 315 303 213],334,5,10764,4.503765690376569,40.0,0.0
2390,0,2390,[272 297 315 303 213],894,5,10769,4.5039732329569215,40.0,0.0
2391,0,2391,[222 272 507 478 300],13,2,10771,4.502926421404682,0.0,40.0
2392,0,2392,[272 297 315 303 213],894,5,10776,4.503134141245299,40.0,0.0
2393,0,2393,[272 297 315 303 213],334,5,10781,4.503341687552214,40.0,0.0
2394,0,2394,[272 297 315 303 213],894,5,10786,4.503549060542798,40.0,0.0
2395,0,2395,[272 297 315 303 213],894,5,10791,4.503756260434057,40.0,0.0
2396,0,2396,[272 297 315 303 213],894,5,10796,4.5039632874426365,40.0,0.0
2397,0,2397,[272 297 315 303 213],894,5,10801,4.504170141784821,40.0,0.0
2398,0,2398,[259 268 272 209 297],6,2,10803,4.503126302626094,20.0,0.0
2399,0,2399,[272 315 297 303 213],894,5,10808,4.503333333333333,40.0,0.0
2400,0,2400,[272 315 297 303 213],334,5,10813,4.503540191586839,40.0,0.0
2401,0,2401,[272 315 297 303 213],894,5,10818,4.503746877601999,40.0,0.0
2402,0,2402,[326 301 384 239 272],102,0,10818,4.50187265917603,0.0,0.0
2403,0,2403,[272 315 297 303 213],334,5,10823,4.502079866888519,40.0,0.0
2404,0,2404,[272 315 297 303 213],334,5,10828,4.502286902286902,40.0,0.0
2405,0,2405,[431 300 326 201 219],13,0,10828,4.500415627597673,0.0,20.0
2406,0,2406,[272 315 297 303 213],334,5,10833,4.500623182384711,40.0,0.0
2407,0,2407,[272 315 297 303 213],334,5,10838,4.500830564784053,40.0,0.0
2408,0,2408,[272 315 297 303 213],894,5,10843,4.501037775010378,40.0,0.0
2409,0,2409,[272 315 297 303 213],334,5,10848,4.501244813278008,40.0,0.0
2410,0,2410,[272 315 297 303 213],334,5,10853,4.501451679800913,40.0,0.0
2411,0,2411,[272 315 297 303 213],894,5,10858,4.5016583747927035,40.0,0.0
2412,0,2412,[272 315 297 303 213],334,5,10863,4.501864898466639,40.0,0.0
2413,0,2413,[272 315 297 303 213],334,5,10868,4.502071251035625,40.0,0.0
2414,0,2414,[272 315 297 303 213],334,5,10873,4.502277432712216,40.0,0.0
2415,0,2415,[272 315 297 303 213],334,5,10878,4.502483443708609,40.0,0.0
2416,0,2416,[272 315 297 303 213],334,5,10883,4.502689284236657,40.0,0.0
2417,0,2417,[206 208 217 264 324],833,1,10884,4.5012406947890815,0.0,0.0
2418,0,2418,[212 239 276 259 315],537,2,10886,4.500206696982224,20.0,20.0
2419,0,2419,[272 315 297 303 213],894,5,10891,4.500413223140496,40.0,0.0
2420,0,2420,[272 315 297 303 213],894,5,10896,4.500619578686493,40.0,0.0
2421,0,2421,[272 315 297 303 213],334,5,10901,4.5008257638315445,40.0,0.0
2422,0,2422,[272 315 297 303 213],334,5,10906,4.501031778786628,40.0,0.0
2423,0,2423,[272 315 297 303 213],894,5,10911,4.501237623762377,40.0,0.0
2424,0,2424,[272 315 297 303 213],894,5,10916,4.501443298969072,40.0,0.0
2425,0,2425,[272 315 297 303 213],894,5,10921,4.501648804616653,40.0,0.0
2426,0,2426,[272 315 297 303 213],894,5,10926,4.50185414091471,40.0,0.0
2427,0,2427,[272 315 297 303 213],334,5,10931,4.5020593080724876,40.0,0.0
2428,0,2428,[272 315 297 303 213],894,5,10936,4.502264306298889,40.0,0.0
2429,0,2429,[272 315 297 303 213],334,5,10941,4.502469135802469,40.0,0.0
2430,0,2430,[272 315 297 303 213],334,5,10946,4.502673796791444,40.0,0.0
2431,0,2431,[272 315 297 303 213],894,5,10951,4.502878289473684,40.0,0.0
2432,0,2432,[272 315 297 303 213],334,5,10956,4.50308261405672,40.0,0.0
2433,0,2433,[272 315 297 303 213],334,5,10961,4.50328677074774,40.0,0.0
2434,0,2434,[272 315 297 303 213],334,5,10966,4.503490759753594,40.0,0.0
2435,0,2435,[272 315 297 303 213],894,5,10971,4.503694581280788,40.0,0.0
2436,0,2436,[272 315 297 303 213],894,5,10976,4.503898235535495,40.0,0.0
2437,0,2437,[272 315 297 303 213],894,5,10981,4.504101722723544,40.0,0.0
2438,0,2438,[272 315 297 303 213],894,5,10986,4.50430504305043,40.0,0.0
2439,0,2439,[283 321 290 284 301],537,1,10987,4.502868852459017,0.0,0.0
2440,0,2440,[272 315 297 303 213],334,5,10992,4.5030725112658745,40.0,0.0
2441,0,2441,[236 259 219 206 221],234,1,10993,4.5016380016380015,0.0,0.0
2442,0,2442,[272 315 297 303 213],894,5,10998,4.501841997544004,40.0,0.0
2443,0,2443,[272 315 297 303 213],334,5,11003,4.502045826513911,40.0,0.0
2444,0,2444,[272 315 297 303 213],334,5,11008,4.502249488752557,40.0,0.0
2445,0,2445,[272 315 297 303 213],894,5,11013,4.502452984464432,40.0,0.0
2446,0,2446,[272 315 297 303 213],334,5,11018,4.502656313853699,40.0,0.0
2447,0,2447,[272 315 297 303 213],334,5,11023,4.502859477124183,40.0,0.0
2448,0,2448,[272 315 297 303 213],894,5,11028,4.503062474479379,40.0,0.0
2449,0,2449,[272 315 297 303 213],334,5,11033,4.503265306122449,40.0,0.0
2450,0,2450,[272 315 297 303 213],334,5,11038,4.503467972256222,40.0,0.0
2451,0,2451,[272 315 297 303 213],334,5,11043,4.503670473083197,40.0,0.0
2452,0,2452,[272 315 297 303 213],894,5,11048,4.503872808805545,40.0,0.0
2453,0,2453,[272 315 297 303 213],894,5,11053,4.504074979625102,40.0,0.0
2454,0,2454,[272 315 297 303 213],894,5,11058,4.504276985743381,40.0,0.0
2455,0,2455,[272 315 297 303 213],894,5,11063,4.504478827361564,40.0,0.0
2456,0,2456,[272 315 297 303 213],334,5,11068,4.504680504680505,40.0,0.0
2457,0,2457,[272 315 297 303 213],334,5,11073,4.504882017900733,40.0,0.0
2458,0,2458,[272 315 297 303 213],334,5,11078,4.505083367222448,40.0,0.0
2459,0,2459,[272 315 297 303 213],334,5,11083,4.505284552845528,40.0,0.0
2460,0,2460,[272 315 297 303 213],334,5,11088,4.505485574969525,40.0,0.0
2461,0,2461,[272 315 297 303 213],334,5,11093,4.505686433793664,40.0,0.0
2462,0,2462,[272 216 429 300 299],13,2,11095,4.50466910272026,0.0,20.0
2463,0,2463,[222 300 507 291 485],537,1,11096,4.503246753246753,0.0,40.0
2464,0,2464,[272 315 297 303 213],334,5,11101,4.503448275862069,40.0,0.0
2465,0,2465,[276 244 485 218 268],334,2,11103,4.502433090024331,0.0,20.0
2466,0,2466,[272 315 297 303 213],894,5,11108,4.502634779083907,40.0,0.0
2467,0,2467,[272 315 297 303 213],334,5,11113,4.502836304700162,40.0,0.0
2468,0,2468,[272 315 297 303 213],894,5,11118,4.5030376670716885,40.0,0.0
2469,0,2469,[272 315 297 303 213],894,5,11123,4.503238866396761,40.0,0.0
2470,0,2470,[272 315 297 303 213],334,5,11128,4.503439902873331,40.0,0.0
2471,0,2471,[272 315 297 303 213],894,5,11133,4.503640776699029,40.0,0.0
2472,0,2472,[272 315 297 303 213],894,5,11138,4.503841488071169,40.0,0.0
2473,0,2473,[272 315 297 303 213],334,5,11143,4.504042037186742,40.0,0.0
2474,0,2474,[272 315 297 303 213],894,5,11148,4.504242424242424,40.0,0.0
2475,0,2475,[272 315 297 303 213],334,5,11153,4.504442649434572,40.0,0.0
2476,0,2476,[272 315 297 303 213],334,5,11158,4.504642712959225,40.0,0.0
2477,0,2477,[272 315 297 303 213],334,5,11163,4.504842615012106,40.0,0.0
2478,0,2478,[272 315 297 303 213],334,5,11168,4.505042355788625,40.0,0.0
2479,0,2479,[272 315 297 303 213],334,5,11173,4.505241935483871,40.0,0.0
2480,0,2480,[272 315 297 303 213],334,5,11178,4.505441354292624,40.0,0.0
2481,0,2481,[272 315 297 303 213],334,5,11183,4.505640612409347,40.0,0.0
2482,0,2482,[272 315 297 303 213],894,5,11188,4.505839710028192,40.0,0.0
2483,0,2483,[272 315 297 303 213],334,5,11193,4.506038647342995,40.0,0.0
2484,0,2484,[272 315 297 303 213],894,5,11198,4.506237424547284,40.0,0.0
2485,0,2485,[272 315 297 303 213],894,5,11203,4.506436041834272,40.0,0.0
2486,0,2486,[272 315 297 303 213],334,5,11208,4.5066344993968634,40.0,0.0
2487,0,2487,[272 315 297 303 213],334,5,11213,4.506832797427653,40.0,0.0
2488,0,2488,[272 315 297 303 213],894,5,11218,4.507030936118923,40.0,0.0
2489,0,2489,[272 315 297 303 213],894,5,11223,4.50722891566265,40.0,0.0
2490,0,2490,[324 227 239 431 321],387,2,11225,4.506222400642312,0.0,0.0
2491,0,2491,[272 315 297 303 213],894,5,11230,4.506420545746389,40.0,0.0
2492,0,2492,[272 315 297 303 213],334,5,11235,4.50661853188929,40.0,0.0
2493,0,2493,[272 315 297 303 213],334,5,11240,4.5068163592622295,40.0,0.0
2494,0,2494,[272 315 297 303 213],894,5,11245,4.507014028056112,40.0,0.0
2495,0,2495,[272 315 297 303 213],334,5,11250,4.507211538461538,40.0,0.0
2496,0,2496,[272 315 297 303 213],334,5,11255,4.507408890668803,40.0,0.0
2497,0,2497,[272 315 297 303 213],334,5,11260,4.507606084867894,40.0,0.0
2498,0,2498,[272 315 297 303 213],894,5,11265,4.507803121248499,40.0,0.0
2499,0,2499,[272 315 297 303 213],894,5,11270,4.508,40.0,0.0
2500,0,2500,[272 315 297 303 213],334,5,11275,4.508196721311475,40.0,0.0
2501,0,2501,[272 315 297 303 213],334,5,11280,4.508393285371703,40.0,0.0
2502,0,2502,[272 315 297 303 213],334,5,11285,4.508589692369157,40.0,0.0
2503,0,2503,[272 315 297 303 213],894,5,11290,4.508785942492013,40.0,0.0
2504,0,2504,[272 315 297 303 213],894,5,11295,4.508982035928144,40.0,0.0
2505,0,2505,[272 315 297 303 213],894,5,11300,4.509177972865124,40.0,0.0
2506,0,2506,[272 315 297 303 213],894,5,11305,4.509373753490228,40.0,0.0
2507,0,2507,[272 315 297 303 213],334,5,11310,4.509569377990431,40.0,0.0
2508,0,2508,[272 315 297 303 213],334,5,11315,4.509764846552411,40.0,0.0
2509,0,2509,[272 315 297 303 213],894,5,11320,4.50996015936255,40.0,0.0
2510,0,2510,[272 315 297 303 213],894,5,11325,4.510155316606929,40.0,0.0
2511,0,2511,[272 315 297 303 213],334,5,11330,4.510350318471337,40.0,0.0
2512,0,2512,[272 315 297 303 213],334,5,11335,4.510545165141266,40.0,0.0
2513,0,2513,[272 315 297 303 213],894,5,11340,4.5107398568019095,40.0,0.0
2514,0,2514,[272 315 297 303 213],334,5,11345,4.510934393638171,40.0,0.0
2515,0,2515,[272 315 297 303 213],334,5,11350,4.511128775834658,40.0,0.0
2516,0,2516,[272 315 297 303 213],894,5,11355,4.5113230035756855,40.0,0.0
2517,0,2517,[272 315 297 303 213],334,5,11360,4.511517077045274,40.0,0.0
2518,0,2518,[272 315 297 303 213],894,5,11365,4.511710996427154,40.0,0.0
2519,0,2519,[272 315 297 303 213],334,5,11370,4.511904761904762,40.0,0.0
2520,0,2520,[272 315 297 303 213],894,5,11375,4.512098373661246,40.0,0.0
2521,0,2521,[272 315 297 303 213],894,5,11380,4.512291831879461,40.0,0.0
2522,0,2522,[272 315 297 303 213],894,5,11385,4.512485136741974,40.0,0.0
2523,0,2523,[272 315 297 303 213],894,5,11390,4.5126782884310614,40.0,0.0
2524,0,2524,[272 315 297 303 213],894,5,11395,4.512871287128712,40.0,0.0
2525,0,2525,[293 298 254 215 429],308,3,11398,4.512272367379255,0.0,0.0
2526,0,2526,[394 218 350 485 336],13,0,11398,4.510486743173724,0.0,0.0
2527,0,2527,[272 315 297 303 213],894,5,11403,4.5106803797468356,40.0,0.0
2528,0,2528,[272 315 297 303 213],334,5,11408,4.51087386318703,40.0,0.0
2529,0,2529,[272 315 297 303 213],334,5,11413,4.511067193675889,40.0,0.0
2530,0,2530,[272 315 297 303 213],894,5,11418,4.511260371394705,40.0,0.0
2531,0,2531,[272 315 297 303 213],334,5,11423,4.5114533965244865,40.0,0.0
2532,0,2532,[272 315 297 303 213],894,5,11428,4.511646269245953,40.0,0.0
2533,0,2533,[272 315 297 303 213],334,5,11433,4.511838989739542,40.0,0.0
2534,0,2534,[272 315 297 303 213],894,5,11438,4.512031558185404,40.0,0.0
2535,0,2535,[272 315 297 303 213],334,5,11443,4.5122239747634065,40.0,0.0
2536,0,2536,[272 315 297 303 213],894,5,11448,4.512416239653134,40.0,0.0
2537,0,2537,[272 315 297 303 213],334,5,11453,4.512608353033885,40.0,0.0
2538,0,2538,[272 315 297 303 213],894,5,11458,4.512800315084679,40.0,0.0
2539,0,2539,[272 315 297 303 213],334,5,11463,4.512992125984252,40.0,0.0
2540,0,2540,[272 315 297 303 213],894,5,11468,4.513183785911059,40.0,0.0
2541,0,2541,[272 315 297 303 213],334,5,11473,4.513375295043273,40.0,0.0
2542,0,2542,[272 315 297 303 213],334,5,11478,4.513566653558788,40.0,0.0
2543,0,2543,[301 255 236 209 316],334,2,11480,4.512578616352202,20.0,0.0
2544,0,2544,[272 315 297 303 213],334,5,11485,4.512770137524558,40.0,0.0
2545,0,2545,[272 315 297 303 213],894,5,11490,4.512961508248233,40.0,0.0
2546,0,2546,[272 315 297 303 213],334,5,11495,4.513152728700432,40.0,0.0
2547,0,2547,[272 315 297 303 213],894,5,11500,4.5133437990580845,40.0,0.0
2548,0,2548,[272 315 297 303 213],894,5,11505,4.513534719497843,40.0,0.0
2549,0,2549,[272 315 297 303 213],334,5,11510,4.513725490196078,40.0,0.0
2550,0,2550,[272 315 297 303 213],894,5,11515,4.513916111328891,40.0,0.0
2551,0,2551,[272 315 297 303 213],334,5,11520,4.5141065830721,40.0,0.0
2552,0,2552,[272 315 297 303 213],894,5,11525,4.514296905601253,40.0,0.0
2553,0,2553,[272 315 297 303 213],894,5,11530,4.514487079091621,40.0,0.0
2554,0,2554,[272 315 297 303 213],334,5,11535,4.514677103718199,40.0,0.0
2555,0,2555,[272 315 297 303 213],334,5,11540,4.514866979655712,40.0,0.0
2556,0,2556,[272 315 297 303 213],894,5,11545,4.515056707078608,40.0,0.0
2557,0,2557,[276 509 201 394 478],13,3,11548,4.5144644253322905,0.0,20.0
2558,0,2558,[272 315 297 303 213],334,5,11553,4.514654161781946,40.0,0.0
2559,0,2559,[272 315 297 303 213],894,5,11558,4.51484375,40.0,0.0
2560,0,2560,[272 315 297 303 213],894,5,11563,4.515033190160094,40.0,0.0
2561,0,2561,[272 315 297 303 213],334,5,11568,4.515222482435597,40.0,0.0
2562,0,2562,[272 315 297 303 213],894,5,11573,4.51541162699961,40.0,0.0
2563,0,2563,[217 367 452 481 232],13,0,11573,4.513650546021841,0.0,0.0
2564,0,2564,[272 315 297 303 213],334,5,11578,4.513840155945419,40.0,0.0
2565,0,2565,[272 315 297 303 213],894,5,11583,4.514029618082619,40.0,0.0
2566,0,2566,[272 315 297 303 213],334,5,11588,4.5142189326061555,40.0,0.0
2567,0,2567,[272 315 297 303 213],334,5,11593,4.514408099688474,40.0,0.0
2568,0,2568,[272 315 297 303 213],894,5,11598,4.514597119501752,40.0,0.0
2569,0,2569,[272 315 297 303 213],894,5,11603,4.514785992217899,40.0,0.0
2570,0,2570,[284 213 255 259 291],474,4,11607,4.514585764294049,0.0,0.0
2571,0,2571,[272 315 297 303 213],894,5,11612,4.514774494556765,40.0,0.0
2572,0,2572,[272 315 297 303 213],334,5,11617,4.514963078118927,40.0,0.0
2573,0,2573,[272 315 297 303 213],894,5,11622,4.515151515151516,40.0,0.0
2574,0,2574,[272 315 297 303 213],334,5,11627,4.515339805825243,40.0,0.0
2575,0,2575,[272 315 297 303 213],894,5,11632,4.515527950310559,40.0,0.0
2576,0,2576,[272 315 297 303 213],894,5,11637,4.515715948777649,40.0,0.0
2577,0,2577,[276 290 272 478 231],13,4,11641,4.515515903801396,0.0,20.0
2578,0,2578,[272 315 297 303 213],894,5,11646,4.515703761147732,40.0,0.0
2579,0,2579,[223 321 485 420 413],13,2,11648,4.514728682170543,20.0,0.0
2580,0,2580,[275 250 481 420 507],85,3,11651,4.514141805501744,0.0,20.0
2581,0,2581,[431 212 206 240 239],406,1,11652,4.5127807900852055,0.0,0.0
2582,0,2582,[272 315 297 303 213],894,5,11657,4.51296941540844,40.0,0.0
2583,0,2583,[272 315 297 303 213],894,5,11662,4.5131578947368425,40.0,0.0
2584,0,2584,[272 315 297 303 213],894,5,11667,4.513346228239845,40.0,0.0
2585,0,2585,[272 315 297 303 213],894,5,11672,4.51353441608662,40.0,0.0
2586,0,2586,[272 315 297 303 213],894,5,11677,4.513722458446076,40.0,0.0
2587,0,2587,[272 315 297 303 213],334,5,11682,4.513910355486862,40.0,0.0
2588,0,2588,[272 315 297 303 213],334,5,11687,4.514098107377365,40.0,0.0
2589,0,2589,[272 315 297 303 213],894,5,11692,4.514285714285714,40.0,0.0
2590,0,2590,[272 315 297 303 213],334,5,11697,4.514473176379776,40.0,0.0
2591,0,2591,[272 315 297 303 213],894,5,11702,4.514660493827161,40.0,0.0
2592,0,2592,[241 303 367 280 431],13,2,11704,4.51369070574624,0.0,0.0
2593,0,2593,[272 315 297 303 213],334,5,11709,4.513878180416345,40.0,0.0
2594,0,2594,[272 315 297 303 213],334,5,11714,4.514065510597303,40.0,0.0
2595,0,2595,[272 315 297 303 213],334,5,11719,4.5142526964560865,40.0,0.0
2596,0,2596,[272 315 297 303 213],334,5,11724,4.514439738159415,40.0,0.0
2597,0,2597,[272 315 297 303 213],894,5,11729,4.514626635873749,40.0,0.0
2598,0,2598,[272 315 297 303 213],894,5,11734,4.514813389765294,40.0,0.0
2599,0,2599,[272 315 297 303 213],334,5,11739,4.515,40.0,0.0
2600,0,2600,[272 315 297 303 213],894,5,11744,4.51518646674356,40.0,0.0
2601,0,2601,[272 315 297 303 213],894,5,11749,4.515372790161415,40.0,0.0
2602,0,2602,[272 315 297 303 213],334,5,11754,4.5155589704187475,40.0,0.0
2603,0,2603,[272 315 297 303 213],334,5,11759,4.515745007680492,40.0,0.0
2604,0,2604,[272 315 297 303 213],894,5,11764,4.515930902111324,40.0,0.0
2605,0,2605,[478 290 485 216 211],537,2,11766,4.514965464313123,0.0,20.0
2606,0,2606,[272 315 297 303 213],334,5,11771,4.515151515151516,40.0,0.0
2607,0,2607,[272 315 297 303 213],334,5,11776,4.515337423312883,40.0,0.0
2608,0,2608,[272 315 297 303 213],334,5,11781,4.5155231889612875,40.0,0.0
2609,0,2609,[272 315 297 303 213],334,5,11786,4.515708812260536,40.0,0.0
2610,0,2610,[272 315 297 303 213],894,5,11791,4.515894293374187,40.0,0.0
2611,0,2611,[272 315 297 303 213],894,5,11796,4.5160796324655434,40.0,0.0
2612,0,2612,[272 315 297 303 213],894,5,11801,4.516264829697666,40.0,0.0
2613,0,2613,[272 315 297 303 213],894,5,11806,4.516449885233359,40.0,0.0
2614,0,2614,[272 315 297 303 213],894,5,11811,4.516634799235182,40.0,0.0
2615,0,2615,[272 315 297 303 213],334,5,11816,4.516819571865444,40.0,0.0
2616,0,2616,[219 202 232 350 413],13,1,11817,4.515475735575086,0.0,0.0
2617,0,2617,[272 315 297 303 213],894,5,11822,4.515660809778457,40.0,0.0
2618,0,2618,[272 315 297 303 213],334,5,11827,4.515845742649867,40.0,0.0
2619,0,2619,[429 284 208 226 378],537,1,11828,4.514503816793893,0.0,0.0
2620,0,2620,[272 315 297 303 213],334,5,11833,4.514689049980923,40.0,0.0
2621,0,2621,[272 315 297 303 213],334,5,11838,4.51487414187643,40.0,0.0
2622,0,2622,[272 315 297 303 213],894,5,11843,4.515059092642013,40.0,0.0
2623,0,2623,[272 315 297 303 213],894,5,11848,4.515243902439025,40.0,0.0
2624,0,2624,[280 298 478 213 284],144,2,11850,4.514285714285714,0.0,0.0
2625,0,2625,[272 315 297 303 213],894,5,11855,4.514470677837014,40.0,0.0
2626,0,2626,[219 222 226 223 431],234,0,11855,4.512752188808527,20.0,20.0
2627,0,2627,[272 315 297 303 213],334,5,11860,4.512937595129376,40.0,0.0
2628,0,2628,[481 223 243 321 226],234,1,11861,4.511601369341955,20.0,0.0
2629,0,2629,[272 315 297 303 213],894,5,11866,4.511787072243346,40.0,0.0
2630,0,2630,[272 315 297 303 213],334,5,11871,4.511972633979475,40.0,0.0
2631,0,2631,[272 315 297 303 213],334,5,11876,4.5121580547112465,40.0,0.0
2632,0,2632,[272 315 297 303 213],894,5,11881,4.512343334599317,40.0,0.0
2633,0,2633,[272 315 297 303 213],334,5,11886,4.5125284738041005,40.0,0.0
2634,0,2634,[272 315 297 303 213],334,5,11891,4.5127134724857685,40.0,0.0
2635,0,2635,[272 315 297 303 213],334,5,11896,4.512898330804249,40.0,0.0
2636,0,2636,[272 315 297 303 213],334,5,11901,4.513083048919226,40.0,0.0
2637,0,2637,[272 315 297 303 213],334,5,11906,4.513267626990144,40.0,0.0
2638,0,2638,[272 315 297 303 213],894,5,11911,4.513452065176203,40.0,0.0
2639,0,2639,[272 315 297 303 213],334,5,11916,4.513636363636364,40.0,0.0
2640,0,2640,[272 315 297 303 213],894,5,11921,4.513820522529345,40.0,0.0
2641,0,2641,[344 315 276 316 431],548,2,11923,4.512869038607116,40.0,20.0
2642,0,2642,[272 297 303 315 213],894,5,11928,4.5130533484676505,40.0,0.0
2643,0,2643,[272 297 303 315 213],894,5,11933,4.513237518910741,40.0,0.0
2644,0,2644,[272 297 303 315 213],334,5,11938,4.513421550094518,40.0,0.0
2645,0,2645,[272 297 303 315 213],334,5,11943,4.51360544217687,40.0,0.0
2646,0,2646,[272 297 303 315 213],334,5,11948,4.513789195315452,40.0,0.0
2647,0,2647,[272 297 303 315 213],894,5,11953,4.513972809667674,40.0,0.0
2648,0,2648,[272 297 303 315 213],334,5,11958,4.514156285390714,40.0,0.0
2649,0,2649,[272 297 303 315 213],894,5,11963,4.51433962264151,40.0,0.0
2650,0,2650,[272 297 303 315 213],334,5,11968,4.514522821576763,40.0,0.0
2651,0,2651,[272 297 303 315 213],334,5,11973,4.514705882352941,40.0,0.0
2652,0,2652,[272 297 303 315 213],334,5,11978,4.514888805126272,40.0,0.0
2653,0,2653,[272 297 303 315 213],894,5,11983,4.5150715900527505,40.0,0.0
2654,0,2654,[272 297 303 315 213],894,5,11988,4.5152542372881355,40.0,0.0
2655,0,2655,[272 297 303 315 213],334,5,11993,4.515436746987952,40.0,0.0
2656,0,2656,[272 297 303 315 213],334,5,11998,4.515619119307489,40.0,0.0
2657,0,2657,[272 297 303 315 213],894,5,12003,4.515801354401806,40.0,0.0
2658,0,2658,[272 297 303 315 213],894,5,12008,4.515983452425724,40.0,0.0
2659,0,2659,[272 297 303 315 213],894,5,12013,4.516165413533835,40.0,0.0
2660,0,2660,[206 226 259 208 392],537,1,12014,4.5148440435926345,0.0,0.0
2661,0,2661,[272 297 303 315 213],334,5,12019,4.515026296018031,40.0,0.0
2662,0,2662,[429 452 478 209 367],406,3,12022,4.514457378895982,0.0,0.0
2663,0,2663,[272 297 303 315 213],894,5,12027,4.51463963963964,40.0,0.0
2664,0,2664,[272 297 303 315 213],334,5,12032,4.514821763602251,40.0,0.0
2665,0,2665,[507 213 316 268 212],234,2,12034,4.513878469617405,20.0,0.0
2666,0,2666,[272 297 303 315 213],894,5,12039,4.5140607424071995,40.0,0.0
2667,0,2667,[272 297 303 315 213],894,5,12044,4.51424287856072,40.0,0.0
2668,0,2668,[272 297 303 315 213],334,5,12049,4.514424878231547,40.0,0.0
2669,0,2669,[211 215 300 303 226],533,5,12054,4.514606741573034,0.0,40.0
2670,0,2670,[272 297 303 315 213],894,5,12059,4.5147884687383,40.0,0.0
2671,0,2671,[272 297 303 315 213],894,5,12064,4.514970059880239,40.0,0.0
2672,0,2672,[272 297 303 315 213],334,5,12069,4.515151515151516,40.0,0.0
2673,0,2673,[272 297 303 315 213],894,5,12074,4.515332834704562,40.0,0.0
2674,0,2674,[272 297 303 315 213],334,5,12079,4.515514018691589,40.0,0.0
2675,0,2675,[272 297 303 315 213],334,5,12084,4.515695067264574,40.0,0.0
2676,0,2676,[272 297 303 315 213],894,5,12089,4.515875980575271,40.0,0.0
2677,0,2677,[272 297 303 315 213],334,5,12094,4.516056758775205,40.0,0.0
2678,0,2678,[272 297 303 315 213],334,5,12099,4.516237402015678,40.0,0.0
2679,0,2679,[272 297 303 315 213],894,5,12104,4.516417910447761,40.0,0.0
2680,0,2680,[272 297 303 315 213],334,5,12109,4.516598284222305,40.0,0.0
2681,0,2681,[272 297 303 315 213],334,5,12114,4.516778523489933,40.0,0.0
2682,0,2682,[272 227 485 283 202],378,3,12117,4.516213194185613,0.0,0.0
2683,0,2683,[272 297 303 315 213],894,5,12122,4.516393442622951,40.0,0.0
2684,0,2684,[272 297 303 315 213],894,5,12127,4.51657355679702,40.0,0.0
2685,0,2685,[272 297 303 315 213],894,5,12132,4.516753536857781,40.0,0.0
2686,0,2686,[272 297 303 315 213],894,5,12137,4.516933382954968,40.0,0.0
2687,0,2687,[243 212 431 290 299],537,1,12138,4.515625,0.0,0.0
2688,0,2688,[272 297 303 315 213],894,5,12143,4.515805132019338,40.0,0.0
2689,0,2689,[272 297 303 315 213],334,5,12148,4.515985130111524,40.0,0.0
2690,0,2690,[508 295 218 208 206],387,2,12150,4.51505016722408,0.0,0.0
2691,0,2691,[272 297 303 315 213],894,5,12155,4.515230312035661,40.0,0.0
2692,0,2692,[283 431 226 239 211],279,4,12159,4.515038989974006,0.0,20.0
2693,0,2693,[272 297 303 315 213],334,5,12164,4.515219005196734,40.0,0.0
2694,0,2694,[272 297 303 315 213],334,5,12169,4.515398886827458,40.0,0.0
2695,0,2695,[272 297 303 315 213],334,5,12174,4.515578635014837,40.0,0.0
2696,0,2696,[485 507 290 303 217],13,2,12176,4.514645902855024,0.0,0.0
2697,0,2697,[272 297 303 315 213],894,5,12181,4.514825796886583,40.0,0.0
2698,0,2698,[272 297 303 315 213],894,5,12186,4.515005557613931,40.0,0.0
2699,0,2699,[272 297 303 315 213],334,5,12191,4.515185185185185,40.0,0.0
2700,0,2700,[272 297 303 315 213],334,5,12196,4.515364679748242,40.0,0.0
2701,0,2701,[217 509 241 276 202],13,3,12199,4.5148038490007405,0.0,20.0
2702,0,2702,[272 297 303 315 213],894,5,12204,4.514983351831298,40.0,0.0
2703,0,2703,[272 297 303 315 213],334,5,12209,4.515162721893491,40.0,0.0
2704,0,2704,[272 297 303 315 213],894,5,12214,4.515341959334566,40.0,0.0
2705,0,2705,[272 297 303 315 213],334,5,12219,4.515521064301552,40.0,0.0
2706,0,2706,[272 297 303 315 213],334,5,12224,4.515700036941263,40.0,0.0
2707,0,2707,[272 297 303 315 213],894,5,12229,4.515878877400295,40.0,0.0
2708,0,2708,[272 297 303 315 213],334,5,12234,4.516057585825028,40.0,0.0
2709,0,2709,[272 297 303 315 213],334,5,12239,4.516236162361624,40.0,0.0
2710,0,2710,[272 297 303 315 213],334,5,12244,4.516414607156031,40.0,0.0
2711,0,2711,[272 297 303 315 213],334,5,12249,4.5165929203539825,40.0,0.0
2712,0,2712,[272 297 303 315 213],894,5,12254,4.5167711021009955,40.0,0.0
2713,0,2713,[272 297 303 315 213],894,5,12259,4.516949152542373,40.0,0.0
2714,0,2714,[272 297 303 315 213],334,5,12264,4.517127071823205,40.0,0.0
2715,0,2715,[272 297 303 315 213],334,5,12269,4.517304860088365,40.0,0.0
2716,0,2716,[272 297 303 315 213],894,5,12274,4.5174825174825175,40.0,0.0
2717,0,2717,[272 297 303 315 213],894,5,12279,4.5176600441501105,40.0,0.0
2718,0,2718,[272 297 303 315 213],894,5,12284,4.517837440235381,40.0,0.0
2719,0,2719,[272 297 303 315 213],334,5,12289,4.5180147058823525,40.0,0.0
2720,0,2720,[239 276 227 208 283],334,3,12292,4.517456817346564,0.0,20.0
2721,0,2721,[272 297 303 315 213],894,5,12297,4.517634092578986,40.0,0.0
2722,0,2722,[336 201 481 230 350],13,0,12297,4.515975027543151,0.0,0.0
2723,0,2723,[272 297 303 315 213],894,5,12302,4.516152716593245,40.0,0.0
2724,0,2724,[272 297 303 315 213],334,5,12307,4.5163302752293575,40.0,0.0
2725,0,2725,[272 297 303 315 213],334,5,12312,4.516507703595011,40.0,0.0
2726,0,2726,[272 297 303 315 213],334,5,12317,4.516685001833516,40.0,0.0
2727,0,2727,[272 297 303 315 213],334,5,12322,4.516862170087976,40.0,0.0
2728,0,2728,[272 297 303 315 213],894,5,12327,4.5170392085012825,40.0,0.0
2729,0,2729,[272 297 303 315 213],334,5,12332,4.517216117216117,40.0,0.0
2730,0,2730,[272 297 303 315 213],334,5,12337,4.517392896374954,40.0,0.0
2731,0,2731,[478 202 219 272 420],650,2,12339,4.516471449487555,0.0,0.0
2732,0,2732,[272 297 303 315 213],894,5,12344,4.516648371752653,40.0,0.0
2733,0,2733,[272 297 303 315 213],894,5,12349,4.516825164594001,40.0,0.0
2734,0,2734,[272 297 303 315 213],894,5,12354,4.517001828153565,40.0,0.0
2735,0,2735,[272 297 303 315 213],894,5,12359,4.517178362573099,40.0,0.0
2736,0,2736,[272 297 303 315 213],334,5,12364,4.517354767994155,40.0,0.0
2737,0,2737,[272 297 303 315 213],334,5,12369,4.517531044558072,40.0,0.0
2738,0,2738,[272 297 303 315 213],334,5,12374,4.517707192405988,40.0,0.0
2739,0,2739,[272 297 303 315 213],894,5,12379,4.517883211678832,40.0,0.0
2740,0,2740,[227 212 321 218 219],194,1,12380,4.516599781101788,0.0,0.0
2741,0,2741,[272 297 303 315 213],334,5,12385,4.516776075857039,40.0,0.0
2742,0,2742,[272 297 303 315 213],894,5,12390,4.516952242070725,40.0,0.0
2743,0,2743,[272 297 303 315 213],334,5,12395,4.517128279883382,40.0,0.0
2744,0,2744,[272 297 303 315 213],894,5,12400,4.517304189435337,40.0,0.0
2745,0,2745,[272 297 303 315 213],894,5,12405,4.517479970866715,40.0,0.0
2746,0,2746,[272 297 303 315 213],334,5,12410,4.517655624317437,40.0,0.0
2747,0,2747,[272 297 303 315 213],334,5,12415,4.51783114992722,40.0,0.0
2748,0,2748,[212 236 223 315 324],894,4,12419,4.517642779192434,40.0,0.0
2749,0,2749,[272 297 303 315 213],894,5,12424,4.517818181818182,40.0,0.0
2750,0,2750,[272 297 303 315 213],334,5,12429,4.517993456924755,40.0,0.0
2751,0,2751,[272 297 303 315 213],894,5,12434,4.518168604651163,40.0,0.0
2752,0,2752,[272 297 303 315 213],894,5,12439,4.5183436251362155,40.0,0.0
2753,0,2753,[272 297 303 315 213],894,5,12444,4.518518518518518,40.0,0.0
2754,0,2754,[272 297 303 315 213],894,5,12449,4.518693284936479,40.0,0.0
2755,0,2755,[272 297 303 315 213],334,5,12454,4.518867924528302,40.0,0.0
2756,0,2756,[272 297 303 315 213],334,5,12459,4.519042437431991,40.0,0.0
2757,0,2757,[295 209 254 276 293],308,3,12462,4.51849166062364,0.0,20.0
2758,0,2758,[272 297 303 315 213],334,5,12467,4.518666183399782,40.0,0.0
2759,0,2759,[272 297 303 315 213],334,5,12472,4.518840579710145,40.0,0.0
2760,0,2760,[272 297 303 315 213],894,5,12477,4.519014849692141,40.0,0.0
2761,0,2761,[272 297 303 315 213],334,5,12482,4.519188993482984,40.0,0.0
2762,0,2762,[272 297 303 315 213],894,5,12487,4.5193630112196885,40.0,0.0
2763,0,2763,[272 297 303 315 213],334,5,12492,4.519536903039074,40.0,0.0
2764,0,2764,[272 297 303 315 213],334,5,12497,4.5197106690777575,40.0,0.0
2765,0,2765,[272 297 303 315 213],894,5,12502,4.519884309472162,40.0,0.0
2766,0,2766,[272 297 303 315 213],334,5,12507,4.520057824358511,40.0,0.0
2767,0,2767,[216 336 209 367 232],13,0,12507,4.51842485549133,0.0,0.0
2768,0,2768,[272 297 303 315 213],334,5,12512,4.518598772119899,40.0,0.0
2769,0,2769,[272 297 303 315 213],894,5,12517,4.518772563176896,40.0,0.0
2770,0,2770,[272 297 303 315 213],894,5,12522,4.518946228798268,40.0,0.0
2771,0,2771,[272 297 303 315 213],334,5,12527,4.5191197691197695,40.0,0.0
2772,0,2772,[276 283 485 226 326],378,3,12530,4.518571943743239,0.0,20.0
2773,0,2773,[272 297 303 315 213],334,5,12535,4.518745493871665,40.0,0.0
2774,0,2774,[272 297 303 315 213],334,5,12540,4.518918918918919,40.0,0.0
2775,0,2775,[272 297 303 315 213],894,5,12545,4.519092219020173,40.0,0.0
2776,0,2776,[272 297 303 315 213],894,5,12550,4.519265394310407,40.0,0.0
2777,0,2777,[272 297 303 315 213],334,5,12555,4.519438444924406,40.0,0.0
2778,0,2778,[208 230 218 509 219],194,1,12556,4.5181720043181,0.0,0.0
2779,0,2779,[272 297 303 315 213],334,5,12561,4.518345323741007,40.0,0.0
2780,0,2780,[236 241 290 429 315],537,1,12562,4.517080186983099,20.0,0.0
2781,0,2781,[272 297 303 315 213],894,5,12567,4.5172537742631205,40.0,0.0
2782,0,2782,[508 367 394 264 303],13,2,12569,4.5163492633848366,0.0,0.0
2783,0,2783,[272 297 303 315 213],334,5,12574,4.516522988505747,40.0,0.0
2784,0,2784,[272 297 303 315 213],894,5,12579,4.516696588868941,40.0,0.0
2785,0,2785,[272 297 303 315 213],894,5,12584,4.516870064608758,40.0,0.0
2786,0,2786,[272 297 303 315 213],894,5,12589,4.517043415859347,40.0,0.0
2787,0,2787,[208 219 420 429 202],406,2,12591,4.516140602582497,0.0,0.0
2788,0,2788,[272 297 303 315 213],894,5,12596,4.5163140910720685,40.0,0.0
2789,0,2789,[272 297 303 315 213],334,5,12601,4.516487455197133,40.0,0.0
2790,0,2790,[384 431 300 215 219],7,3,12604,4.515944106055177,0.0,20.0
2791,0,2791,[452 261 230 212 211],13,2,12606,4.515042979942693,0.0,20.0
2792,0,2792,[272 297 303 315 213],894,5,12611,4.515216612960974,40.0,0.0
2793,0,2793,[201 231 223 365 254],308,2,12613,4.514316392269148,20.0,0.0
2794,0,2794,[272 297 303 315 213],334,5,12618,4.514490161001789,40.0,0.0
2795,0,2795,[272 297 303 315 213],894,5,12623,4.514663805436338,40.0,0.0
2796,0,2796,[272 297 303 315 213],334,5,12628,4.514837325706114,40.0,0.0
2797,0,2797,[272 297 303 315 213],334,5,12633,4.515010721944246,40.0,0.0
2798,0,2798,[272 297 303 315 213],334,5,12638,4.515183994283673,40.0,0.0
2799,0,2799,[272 297 303 315 213],334,5,12643,4.515357142857143,40.0,0.0
2800,0,2800,[272 297 303 315 213],334,5,12648,4.515530167797215,40.0,0.0
2801,0,2801,[272 297 303 315 213],334,5,12653,4.51570306923626,40.0,0.0
2802,0,2802,[272 297 303 315 213],334,5,12658,4.515875847306457,40.0,0.0
2803,0,2803,[272 297 303 315 213],894,5,12663,4.5160485021398005,40.0,0.0
2804,0,2804,[272 297 303 315 213],334,5,12668,4.516221033868093,40.0,0.0
2805,0,2805,[326 344 215 315 300],13,2,12670,4.5153243050605845,20.0,20.0
2806,0,2806,[272 297 303 315 213],894,5,12675,4.5154969718560745,40.0,0.0
2807,0,2807,[272 297 303 315 213],334,5,12680,4.515669515669516,40.0,0.0
2808,0,2808,[508 212 276 209 452],13,2,12682,4.514773940904236,0.0,20.0
2809,0,2809,[272 297 303 315 213],334,5,12687,4.514946619217082,40.0,0.0
2810,0,2810,[272 297 303 315 213],334,5,12692,4.515119174670936,40.0,0.0
2811,0,2811,[272 297 303 315 213],334,5,12697,4.515291607396871,40.0,0.0
2812,0,2812,[272 297 303 315 213],894,5,12702,4.515463917525773,40.0,0.0
2813,0,2813,[272 297 303 315 213],894,5,12707,4.515636105188344,40.0,0.0
2814,0,2814,[272 297 303 315 213],334,5,12712,4.515808170515098,40.0,0.0
2815,0,2815,[272 297 303 315 213],894,5,12717,4.515980113636363,40.0,0.0
2816,0,2816,[272 297 303 315 213],894,5,12722,4.516151934682286,40.0,0.0
2817,0,2817,[272 297 303 315 213],894,5,12727,4.516323633782824,40.0,0.0
2818,0,2818,[507 202 230 290 227],650,2,12729,4.515431003902093,0.0,0.0
2819,0,2819,[272 297 303 315 213],334,5,12734,4.515602836879433,40.0,0.0
2820,0,2820,[272 297 303 315 213],334,5,12739,4.515774548032613,40.0,0.0
2821,0,2821,[272 297 303 315 213],334,5,12744,4.515946137491141,40.0,0.0
2822,0,2822,[315 293 284 222 219],145,5,12749,4.516117605384343,20.0,20.0
2823,0,2823,[272 297 303 315 213],894,5,12754,4.51628895184136,40.0,0.0
2824,0,2824,[272 297 303 315 213],894,5,12759,4.51646017699115,40.0,0.0
2825,0,2825,[208 219 213 283 429],234,2,12761,4.515569709837226,0.0,0.0
2826,0,2826,[272 297 303 315 213],894,5,12766,4.515741068270251,40.0,0.0
2827,0,2827,[295 365 485 218 231],378,1,12767,4.514497878359265,0.0,0.0
2828,0,2828,[272 297 303 315 213],894,5,12772,4.514669494521032,40.0,0.0
2829,0,2829,[272 297 303 315 213],334,5,12777,4.514840989399294,40.0,0.0
2830,0,2830,[272 297 303 315 213],334,5,12782,4.515012363122572,40.0,0.0
2831,0,2831,[290 241 243 227 384],13,2,12784,4.5141242937853105,0.0,0.0
2832,0,2832,[272 297 303 315 213],334,5,12789,4.514295799505824,40.0,0.0
2833,0,2833,[272 297 303 315 213],894,5,12794,4.514467184191955,40.0,0.0
2834,0,2834,[272 297 303 315 213],894,5,12799,4.514638447971781,40.0,0.0
2835,0,2835,[254 226 201 218 250],774,0,12799,4.513046544428773,0.0,0.0
2836,0,2836,[272 297 303 315 213],894,5,12804,4.513218188227,40.0,0.0
2837,0,2837,[272 297 303 315 213],334,5,12809,4.5133897110641295,40.0,0.0
2838,0,2838,[272 297 303 315 213],334,5,12814,4.513561113067982,40.0,0.0
2839,0,2839,[272 297 303 315 213],894,5,12819,4.5137323943661976,40.0,0.0
2840,0,2840,[272 297 303 315 213],334,5,12824,4.513903555086237,40.0,0.0
2841,0,2841,[272 297 303 315 213],894,5,12829,4.514074595355384,40.0,0.0
2842,0,2842,[272 297 303 315 213],894,5,12834,4.514245515300739,40.0,0.0
2843,0,2843,[226 209 507 290 241],13,2,12836,4.513361462728551,0.0,0.0
2844,0,2844,[272 297 303 315 213],894,5,12841,4.513532513181019,40.0,0.0
2845,0,2845,[272 297 303 315 213],334,5,12846,4.513703443429375,40.0,0.0
2846,0,2846,[272 297 303 315 213],334,5,12851,4.513874253600281,40.0,0.0
2847,0,2847,[272 297 303 315 213],334,5,12856,4.514044943820225,40.0,0.0
2848,0,2848,[272 297 303 315 213],894,5,12861,4.514215514215514,40.0,0.0
2849,0,2849,[272 297 303 315 213],894,5,12866,4.514385964912281,40.0,0.0
2850,0,2850,[509 275 208 301 215],85,4,12870,4.514205541915118,0.0,20.0
2851,0,2851,[222 431 429 209 212],804,3,12873,4.51367461430575,0.0,20.0
2852,0,2852,[272 297 303 315 213],894,5,12878,4.513845075359271,40.0,0.0
2853,0,2853,[272 297 303 315 213],894,5,12883,4.514015416958655,40.0,0.0
2854,0,2854,[272 297 303 315 213],894,5,12888,4.514185639229422,40.0,0.0
2855,0,2855,[272 297 303 315 213],894,5,12893,4.514355742296919,40.0,0.0
2856,0,2856,[272 297 303 315 213],334,5,12898,4.5145257262863145,40.0,0.0
2857,0,2857,[272 297 303 315 213],894,5,12903,4.514695591322603,40.0,0.0
2858,0,2858,[272 297 303 315 213],894,5,12908,4.514865337530605,40.0,0.0
2859,0,2859,[272 297 303 315 213],894,5,12913,4.515034965034965,40.0,0.0
2860,0,2860,[272 297 303 315 213],334,5,12918,4.515204473960154,40.0,0.0
2861,0,2861,[272 297 303 315 213],334,5,12923,4.515373864430468,40.0,0.0
2862,0,2862,[239 217 223 219 378],650,0,12923,4.5137967167307025,20.0,0.0
2863,0,2863,[272 297 303 315 213],334,5,12928,4.5139664804469275,40.0,0.0
2864,0,2864,[272 297 303 315 213],334,5,12933,4.51413612565445,40.0,0.0
2865,0,2865,[243 301 241 201 413],13,0,12933,4.512561060711794,0.0,0.0
2866,0,2866,[272 297 303 315 213],334,5,12938,4.512731077781654,40.0,0.0
2867,0,2867,[272 297 303 315 213],334,5,12943,4.512900976290098,40.0,0.0
2868,0,2868,[272 297 303 315 213],894,5,12948,4.513070756361102,40.0,0.0
2869,0,2869,[272 297 303 315 213],334,5,12953,4.513240418118467,40.0,0.0
2870,0,2870,[272 297 303 315 213],334,5,12958,4.513409961685824,40.0,0.0
2871,0,2871,[272 297 303 315 213],334,5,12963,4.513579387186629,40.0,0.0
2872,0,2872,[272 297 303 315 213],894,5,12968,4.51374869474417,40.0,0.0
2873,0,2873,[350 264 219 227 336],13,2,12970,4.512874043145442,0.0,0.0
2874,0,2874,[272 297 303 315 213],334,5,12975,4.51304347826087,40.0,0.0
2875,0,2875,[365 226 254 431 280],749,3,12978,4.5125173852573015,0.0,0.0
2876,0,2876,[272 297 303 315 213],894,5,12983,4.51268682655544,40.0,0.0
2877,0,2877,[272 297 303 315 213],894,5,12988,4.5128561501042395,40.0,0.0
2878,0,2878,[272 297 303 315 213],334,5,12993,4.513025356026398,40.0,0.0
2879,0,2879,[272 297 303 315 213],894,5,12998,4.513194444444444,40.0,0.0
2880,0,2880,[272 297 303 315 213],334,5,13003,4.513363415480736,40.0,0.0
2881,0,2881,[272 297 303 315 213],334,5,13008,4.51353226925746,40.0,0.0
2882,0,2882,[272 297 303 315 213],334,5,13013,4.513701005896635,40.0,0.0
2883,0,2883,[272 297 303 315 213],894,5,13018,4.513869625520111,40.0,0.0
2884,0,2884,[272 297 303 315 213],334,5,13023,4.514038128249567,40.0,0.0
2885,0,2885,[272 297 303 315 213],894,5,13028,4.514206514206514,40.0,0.0
2886,0,2886,[272 297 303 315 213],334,5,13033,4.514374783512297,40.0,0.0
2887,0,2887,[272 297 303 315 213],894,5,13038,4.5145429362880884,40.0,0.0
2888,0,2888,[272 297 303 315 213],334,5,13043,4.514710972654898,40.0,0.0
2889,0,2889,[272 297 303 315 213],894,5,13048,4.514878892733564,40.0,0.0
2890,0,2890,[272 297 303 315 213],334,5,13053,4.5150466966447595,40.0,0.0
2891,0,2891,[272 297 303 315 213],334,5,13058,4.51521438450899,40.0,0.0
2892,0,2892,[217 420 508 284 392],378,2,13060,4.514344970618735,0.0,0.0
2893,0,2893,[272 297 303 315 213],334,5,13065,4.514512785072564,40.0,0.0
2894,0,2894,[394 344 326 222 275],13,0,13065,4.512953367875648,0.0,40.0
2895,0,2895,[275 215 326 478 201],13,2,13067,4.512085635359116,0.0,20.0
2896,0,2896,[272 297 303 315 213],334,5,13072,4.512254055919917,40.0,0.0
2897,0,2897,[272 297 303 315 213],334,5,13077,4.512422360248447,40.0,0.0
2898,0,2898,[272 297 303 315 213],334,5,13082,4.5125905484649875,40.0,0.0
2899,0,2899,[272 297 303 315 213],334,5,13087,4.512758620689655,40.0,0.0
2900,0,2900,[272 297 303 315 213],334,5,13092,4.512926577042399,40.0,0.0
2901,0,2901,[272 297 303 315 213],334,5,13097,4.513094417643005,40.0,0.0
2902,0,2902,[272 297 303 315 213],894,5,13102,4.513262142611092,40.0,0.0
2903,0,2903,[272 297 303 315 213],334,5,13107,4.5134297520661155,40.0,0.0
2904,0,2904,[272 297 303 315 213],334,5,13112,4.513597246127366,40.0,0.0
2905,0,2905,[272 297 303 315 213],334,5,13117,4.513764624913971,40.0,0.0
2906,0,2906,[272 297 303 315 213],334,5,13122,4.513931888544891,40.0,0.0
2907,0,2907,[272 297 303 315 213],334,5,13127,4.514099037138927,40.0,0.0
2908,0,2908,[272 297 303 315 213],334,5,13132,4.514266070814713,40.0,0.0
2909,0,2909,[243 316 222 201 223],13,2,13134,4.51340206185567,40.0,20.0
2910,0,2910,[272 297 303 315 213],334,5,13139,4.513569220199244,40.0,0.0
2911,0,2911,[272 297 303 315 213],894,5,13144,4.513736263736264,40.0,0.0
2912,0,2912,[272 297 303 315 213],334,5,13149,4.513903192584964,40.0,0.0
2913,0,2913,[275 268 326 221 315],334,4,13153,4.51372683596431,20.0,20.0
2914,0,2914,[275 216 290 378 420],95,3,13156,4.513207547169811,0.0,20.0
2915,0,2915,[272 297 303 315 213],334,5,13161,4.5133744855967075,40.0,0.0
2916,0,2916,[201 413 429 367 315],13,2,13163,4.512512855673637,20.0,0.0
2917,0,2917,[272 297 303 315 213],894,5,13168,4.512679917751885,40.0,0.0
2918,0,2918,[272 297 303 315 213],334,5,13173,4.512846865364851,40.0,0.0
2919,0,2919,[283 255 298 211 367],308,4,13177,4.512671232876713,0.0,20.0
2920,0,2920,[272 297 303 315 213],894,5,13182,4.512838069154399,40.0,0.0
2921,0,2921,[272 297 303 315 213],334,5,13187,4.5130047912388775,40.0,0.0
2922,0,2922,[272 297 303 315 213],334,5,13192,4.513171399247349,40.0,0.0
2923,0,2923,[272 297 303 315 213],894,5,13197,4.513337893296853,40.0,0.0
2924,0,2924,[272 297 303 315 213],894,5,13202,4.513504273504274,40.0,0.0
2925,0,2925,[272 297 303 315 213],894,5,13207,4.51367053998633,40.0,0.0
2926,0,2926,[272 297 303 315 213],334,5,13212,4.513836692859583,40.0,0.0
2927,0,2927,[272 297 303 315 213],334,5,13217,4.514002732240437,40.0,0.0
2928,0,2928,[272 297 303 315 213],894,5,13222,4.514168658245135,40.0,0.0
2929,0,2929,[272 297 303 315 213],334,5,13227,4.514334470989761,40.0,0.0
2930,0,2930,[272 297 303 315 213],894,5,13232,4.514500170590242,40.0,0.0
2931,0,2931,[272 297 303 315 213],894,5,13237,4.514665757162346,40.0,0.0
2932,0,2932,[272 297 303 315 213],334,5,13242,4.5148312308216845,40.0,0.0
2933,0,2933,[272 297 303 315 213],894,5,13247,4.514996591683708,40.0,0.0
2934,0,2934,[272 297 303 315 213],334,5,13252,4.515161839863714,40.0,0.0
2935,0,2935,[272 297 303 315 213],334,5,13257,4.515326975476839,40.0,0.0
2936,0,2936,[272 297 303 315 213],334,5,13262,4.515491998638066,40.0,0.0
2937,0,2937,[272 297 303 315 213],894,5,13267,4.515656909462219,40.0,0.0
2938,0,2938,[272 297 303 315 213],334,5,13272,4.515821708063967,40.0,0.0
2939,0,2939,[272 297 303 315 213],894,5,13277,4.515986394557823,40.0,0.0
2940,0,2940,[272 297 303 315 213],894,5,13282,4.516150969058144,40.0,0.0
2941,0,2941,[276 336 231 215 429],13,3,13285,4.515635622025833,0.0,20.0
2942,0,2942,[272 226 394 212 241],13,3,13288,4.515120625212369,0.0,0.0
2943,0,2943,[272 297 303 315 213],894,5,13293,4.515285326086956,40.0,0.0
2944,0,2944,[272 297 303 315 213],334,5,13298,4.515449915110357,40.0,0.0
2945,0,2945,[272 297 303 315 213],894,5,13303,4.51561439239647,40.0,0.0
2946,0,2946,[272 297 303 315 213],894,5,13308,4.515778758059043,40.0,0.0
2947,0,2947,[272 297 303 315 213],334,5,13313,4.515943012211669,40.0,0.0
2948,0,2948,[272 297 303 315 213],894,5,13318,4.516107154967786,40.0,0.0
2949,0,2949,[272 297 303 315 213],894,5,13323,4.516271186440678,40.0,0.0
2950,0,2950,[272 297 303 315 213],894,5,13328,4.516435106743477,40.0,0.0
2951,0,2951,[272 297 303 315 213],334,5,13333,4.51659891598916,40.0,0.0
2952,0,2952,[272 297 303 315 213],894,5,13338,4.516762614290552,40.0,0.0
2953,0,2953,[272 297 303 315 213],334,5,13343,4.516926201760325,40.0,0.0
2954,0,2954,[272 297 303 315 213],894,5,13348,4.517089678510998,40.0,0.0
2955,0,2955,[272 297 303 315 213],334,5,13353,4.5172530446549395,40.0,0.0
2956,0,2956,[272 297 303 315 213],334,5,13358,4.517416300304363,40.0,0.0
2957,0,2957,[272 297 303 315 213],894,5,13363,4.517579445571332,40.0,0.0
2958,0,2958,[272 297 303 315 213],894,5,13368,4.517742480567759,40.0,0.0
2959,0,2959,[272 297 303 315 213],334,5,13373,4.517905405405405,40.0,0.0
2960,0,2960,[272 297 303 315 213],334,5,13378,4.51806822019588,40.0,0.0
2961,0,2961,[272 297 303 315 213],894,5,13383,4.518230925050641,40.0,0.0
2962,0,2962,[272 297 303 315 213],894,5,13388,4.518393520080999,40.0,0.0
2963,0,2963,[272 297 303 315 213],334,5,13393,4.518556005398111,40.0,0.0
2964,0,2964,[272 297 303 315 213],894,5,13398,4.5187183811129845,40.0,0.0
2965,0,2965,[226 241 264 261 230],479,1,13399,4.517532029669589,0.0,0.0
2966,0,2966,[227 239 208 315 272],13,5,13404,4.517694641051567,20.0,0.0
2967,0,2967,[272 297 315 303 213],894,5,13409,4.517857142857143,40.0,0.0
2968,0,2968,[272 297 315 303 213],894,5,13414,4.518019535197036,40.0,0.0
2969,0,2969,[272 297 315 303 213],894,5,13419,4.5181818181818185,40.0,0.0
2970,0,2970,[272 297 315 303 213],334,5,13424,4.5183439919219115,40.0,0.0
2971,0,2971,[272 297 315 303 213],334,5,13429,4.518506056527591,40.0,0.0
2972,0,2972,[272 297 315 303 213],894,5,13434,4.51866801210898,40.0,0.0
2973,0,2973,[272 297 315 303 213],894,5,13439,4.518829858776059,40.0,0.0
2974,0,2974,[216 222 227 259 201],279,2,13441,4.517983193277311,0.0,20.0
2975,0,2975,[272 297 315 303 213],894,5,13446,4.518145161290323,40.0,0.0
2976,0,2976,[272 297 315 303 213],334,5,13451,4.518307020490426,40.0,0.0
2977,0,2977,[272 297 315 303 213],334,5,13456,4.51846877098724,40.0,0.0
2978,0,2978,[255 213 367 220 218],378,2,13458,4.517623363544813,0.0,0.0
2979,0,2979,[272 297 315 303 213],894,5,13463,4.517785234899329,40.0,0.0
2980,0,2980,[272 297 315 303 213],334,5,13468,4.517946997651794,40.0,0.0
2981,0,2981,[272 297 315 303 213],894,5,13473,4.518108651911469,40.0,0.0
2982,0,2982,[272 297 315 303 213],894,5,13478,4.518270197787462,40.0,0.0
2983,0,2983,[239 481 211 315 275],271,3,13481,4.517761394101877,20.0,40.0
2984,0,2984,[272 297 315 303 213],334,5,13486,4.517922948073702,40.0,0.0
2985,0,2985,[272 297 315 303 213],894,5,13491,4.51808439383791,40.0,0.0
2986,0,2986,[276 221 297 316 275],894,5,13496,4.51824573150318,40.0,40.0
2987,0,2987,[272 297 315 303 213],334,5,13501,4.518406961178045,40.0,0.0
2988,0,2988,[272 297 315 303 213],894,5,13506,4.518568082970893,40.0,0.0
2989,0,2989,[272 297 315 303 213],334,5,13511,4.518729096989967,40.0,0.0
2990,0,2990,[272 297 315 303 213],894,5,13516,4.518890003343364,40.0,0.0
2991,0,2991,[272 297 315 303 213],894,5,13521,4.519050802139038,40.0,0.0
2992,0,2992,[272 297 315 303 213],334,5,13526,4.519211493484798,40.0,0.0
2993,0,2993,[272 297 315 303 213],334,5,13531,4.51937207748831,40.0,0.0
2994,0,2994,[272 297 315 303 213],894,5,13536,4.519532554257095,40.0,0.0
2995,0,2995,[272 297 315 303 213],894,5,13541,4.519692923898531,40.0,0.0
2996,0,2996,[272 297 315 303 213],334,5,13546,4.519853186519853,40.0,0.0
2997,0,2997,[272 297 315 303 213],894,5,13551,4.520013342228152,40.0,0.0
2998,0,2998,[272 297 315 303 213],334,5,13556,4.520173391130377,40.0,0.0
2999,0,2999,[272 297 315 303 213],894,5,13561,4.520333333333333,40.0,0.0
3000,0,3000,[272 297 315 303 213],334,5,13566,4.520493168943686,40.0,0.0
3001,0,3001,[272 297 315 303 213],894,5,13571,4.520652898067954,40.0,0.0
3002,0,3002,[272 297 315 303 213],334,5,13576,4.5208125208125205,40.0,0.0
3003,0,3003,[272 297 315 303 213],894,5,13581,4.520972037283622,40.0,0.0
3004,0,3004,[272 297 315 303 213],894,5,13586,4.521131447587354,40.0,0.0
3005,0,3005,[272 297 315 303 213],894,5,13591,4.521290751829674,40.0,0.0
3006,0,3006,[272 297 315 303 213],894,5,13596,4.521449950116395,40.0,0.0
3007,0,3007,[272 297 315 303 213],894,5,13601,4.521609042553192,40.0,0.0
3008,0,3008,[272 297 315 303 213],334,5,13606,4.521768029245597,40.0,0.0
3009,0,3009,[272 297 315 303 213],894,5,13611,4.521926910299003,40.0,0.0
3010,0,3010,[212 230 429 209 452],650,2,13613,4.521089339090003,0.0,0.0
3011,0,3011,[272 297 315 303 213],894,5,13618,4.52124833997344,40.0,0.0
3012,0,3012,[272 297 315 303 213],334,5,13623,4.5214072353136405,40.0,0.0
3013,0,3013,[272 297 315 303 213],334,5,13628,4.521566025215661,40.0,0.0
3014,0,3014,[272 297 315 303 213],334,5,13633,4.5217247097844115,40.0,0.0
3015,0,3015,[272 297 315 303 213],894,5,13638,4.521883289124668,40.0,0.0
3016,0,3016,[272 297 315 303 213],894,5,13643,4.522041763341067,40.0,0.0
3017,0,3017,[272 297 315 303 213],334,5,13648,4.522200132538105,40.0,0.0
3018,0,3018,[272 297 315 303 213],894,5,13653,4.522358396820139,40.0,0.0
3019,0,3019,[272 297 315 303 213],334,5,13658,4.522516556291391,40.0,0.0
3020,0,3020,[272 297 315 303 213],334,5,13663,4.522674611055942,40.0,0.0
3021,0,3021,[272 297 315 303 213],894,5,13668,4.5228325612177365,40.0,0.0
3022,0,3022,[272 297 315 303 213],334,5,13673,4.522990406880583,40.0,0.0
3023,0,3023,[272 297 315 303 213],334,5,13678,4.523148148148148,40.0,0.0
3024,0,3024,[272 297 315 303 213],894,5,13683,4.523305785123967,40.0,0.0
3025,0,3025,[272 297 315 303 213],334,5,13688,4.5234633179114345,40.0,0.0
3026,0,3026,[272 297 315 303 213],334,5,13693,4.523620746613809,40.0,0.0
3027,0,3027,[272 297 315 303 213],334,5,13698,4.523778071334214,40.0,0.0
3028,0,3028,[272 297 315 303 213],894,5,13703,4.5239352921756355,40.0,0.0
3029,0,3029,[272 297 315 303 213],334,5,13708,4.524092409240924,40.0,0.0
3030,0,3030,[272 297 315 303 213],894,5,13713,4.524249422632795,40.0,0.0
3031,0,3031,[272 297 315 303 213],334,5,13718,4.524406332453826,40.0,0.0
3032,0,3032,[272 297 315 303 213],334,5,13723,4.524563138806462,40.0,0.0
3033,0,3033,[284 211 221 300 268],85,2,13725,4.5237310481212925,0.0,40.0
3034,0,3034,[272 297 315 303 213],894,5,13730,4.523887973640857,40.0,0.0
3035,0,3035,[272 297 315 303 213],894,5,13735,4.524044795783926,40.0,0.0
3036,0,3036,[272 297 315 303 213],334,5,13740,4.524201514652618,40.0,0.0
3037,0,3037,[272 297 315 303 213],334,5,13745,4.524358130348913,40.0,0.0
3038,0,3038,[272 297 315 303 213],334,5,13750,4.524514642974663,40.0,0.0
3039,0,3039,[272 297 315 303 213],334,5,13755,4.524671052631579,40.0,0.0
3040,0,3040,[241 227 429 303 232],13,3,13758,4.524169681025978,0.0,0.0
3041,0,3041,[272 297 315 303 213],894,5,13763,4.524326101249178,40.0,0.0
3042,0,3042,[208 276 429 509 316],13,5,13768,4.52448241866579,20.0,20.0
3043,0,3043,[272 297 315 303 213],894,5,13773,4.524638633377135,40.0,0.0
3044,0,3044,[272 297 315 303 213],894,5,13778,4.5247947454844,40.0,0.0
3045,0,3045,[272 297 315 303 213],894,5,13783,4.524950755088641,40.0,0.0
3046,0,3046,[272 297 315 303 213],334,5,13788,4.525106662290778,40.0,0.0
3047,0,3047,[216 367 209 227 283],279,2,13790,4.524278215223097,0.0,0.0
3048,0,3048,[272 297 315 303 213],894,5,13795,4.524434240734667,40.0,0.0
3049,0,3049,[272 297 315 303 213],334,5,13800,4.524590163934426,40.0,0.0
3050,0,3050,[272 297 315 303 213],894,5,13805,4.524745984922976,40.0,0.0
3051,0,3051,[272 297 315 303 213],334,5,13810,4.524901703800786,40.0,0.0
3052,0,3052,[272 297 315 303 213],894,5,13815,4.525057320668195,40.0,0.0
3053,0,3053,[272 297 315 303 213],334,5,13820,4.5252128356254095,40.0,0.0
3054,0,3054,[272 297 315 303 213],334,5,13825,4.525368248772504,40.0,0.0
3055,0,3055,[272 297 315 303 213],894,5,13830,4.525523560209424,40.0,0.0
3056,0,3056,[272 297 315 303 213],334,5,13835,4.525678770035983,40.0,0.0
3057,0,3057,[272 297 315 303 213],894,5,13840,4.525833878351864,40.0,0.0
3058,0,3058,[272 297 315 303 213],334,5,13845,4.52598888525662,40.0,0.0
3059,0,3059,[272 297 315 303 213],334,5,13850,4.526143790849673,40.0,0.0
3060,0,3060,[272 297 315 303 213],334,5,13855,4.526298595230317,40.0,0.0
3061,0,3061,[272 297 315 303 213],894,5,13860,4.526453298497714,40.0,0.0
3062,0,3062,[272 297 315 303 213],894,5,13865,4.526607900750898,40.0,0.0
3063,0,3063,[272 297 315 303 213],894,5,13870,4.526762402088773,40.0,0.0
3064,0,3064,[272 297 315 303 213],894,5,13875,4.526916802610114,40.0,0.0
3065,0,3065,[272 297 315 303 213],334,5,13880,4.527071102413569,40.0,0.0
3066,0,3066,[272 297 315 303 213],334,5,13885,4.527225301597652,40.0,0.0
3067,0,3067,[272 297 315 303 213],894,5,13890,4.527379400260756,40.0,0.0
3068,0,3068,[272 297 315 303 213],334,5,13895,4.527533398501141,40.0,0.0
3069,0,3069,[272 297 315 303 213],334,5,13900,4.527687296416938,40.0,0.0
3070,0,3070,[272 297 315 303 213],894,5,13905,4.527841094106154,40.0,0.0
3071,0,3071,[275 239 431 221 217],158,3,13908,4.52734375,0.0,20.0
3072,0,3072,[226 232 241 431 344],13,1,13909,4.526195899772209,0.0,0.0
3073,0,3073,[336 485 208 280 219],13,2,13911,4.52537410540013,0.0,0.0
3074,0,3074,[202 213 378 478 223],184,4,13915,4.5252032520325205,20.0,0.0
3075,0,3075,[272 297 315 303 213],334,5,13920,4.525357607282185,40.0,0.0
3076,0,3076,[272 297 315 303 213],334,5,13925,4.5255118622034445,40.0,0.0
3077,0,3077,[272 297 315 303 213],894,5,13930,4.525666016894087,40.0,0.0
3078,0,3078,[272 297 315 303 213],894,5,13935,4.52582007145177,40.0,0.0
3079,0,3079,[272 297 315 303 213],334,5,13940,4.525974025974026,40.0,0.0
3080,0,3080,[272 297 315 303 213],334,5,13945,4.52612788055826,40.0,0.0
3081,0,3081,[272 297 315 303 213],334,5,13950,4.5262816353017525,40.0,0.0
3082,0,3082,[392 507 298 202 291],308,3,13953,4.5257865715212455,0.0,0.0
3083,0,3083,[272 297 315 303 213],894,5,13958,4.525940337224384,40.0,0.0
3084,0,3084,[222 212 215 227 239],804,4,13962,4.525769854132901,0.0,20.0
3085,0,3085,[272 297 315 303 213],334,5,13967,4.525923525599482,40.0,0.0
3086,0,3086,[272 297 315 303 213],334,5,13972,4.526077097505669,40.0,0.0
3087,0,3087,[272 297 315 303 213],894,5,13977,4.526230569948186,40.0,0.0
3088,0,3088,[272 297 315 303 213],334,5,13982,4.526383943023633,40.0,0.0
3089,0,3089,[272 297 315 303 213],334,5,13987,4.526537216828479,40.0,0.0
3090,0,3090,[272 297 315 303 213],334,5,13992,4.526690391459074,40.0,0.0
3091,0,3091,[272 297 315 303 213],894,5,13997,4.526843467011643,40.0,0.0
3092,0,3092,[272 297 315 303 213],894,5,14002,4.5269964435822825,40.0,0.0
3093,0,3093,[290 231 243 394 219],13,1,14003,4.525856496444732,0.0,0.0
3094,0,3094,[275 219 283 226 284],279,1,14004,4.524717285945073,0.0,20.0
3095,0,3095,[272 297 315 303 213],334,5,14009,4.524870801033591,40.0,0.0
3096,0,3096,[290 485 420 216 331],13,2,14011,4.524055537617048,0.0,0.0
3097,0,3097,[272 297 315 303 213],894,5,14016,4.524209167204648,40.0,0.0
3098,0,3098,[272 297 315 303 213],334,5,14021,4.524362697644402,40.0,0.0
3099,0,3099,[209 507 268 299 315],537,4,14025,4.524193548387097,20.0,0.0
3100,0,3100,[272 297 315 303 213],334,5,14030,4.524346984843599,40.0,0.0
3101,0,3101,[272 297 315 303 213],334,5,14035,4.5245003223726625,40.0,0.0
3102,0,3102,[272 297 315 303 213],334,5,14040,4.5246535610699326,40.0,0.0
3103,0,3103,[272 297 315 303 213],894,5,14045,4.524806701030927,40.0,0.0
3104,0,3104,[272 297 315 303 213],894,5,14050,4.524959742351046,40.0,0.0
3105,0,3105,[272 297 315 303 213],334,5,14055,4.525112685125563,40.0,0.0
3106,0,3106,[272 297 315 303 213],334,5,14060,4.52526552944963,40.0,0.0
3107,0,3107,[272 297 315 303 213],894,5,14065,4.525418275418275,40.0,0.0
3108,0,3108,[239 321 478 208 290],524,1,14066,4.524284335799292,0.0,0.0
3109,0,3109,[272 297 315 303 213],334,5,14071,4.52443729903537,40.0,0.0
3110,0,3110,[272 297 315 303 213],894,5,14076,4.524590163934426,40.0,0.0
3111,0,3111,[272 297 315 303 213],894,5,14081,4.52474293059126,40.0,0.0
3112,0,3112,[272 297 315 303 213],334,5,14086,4.524895599100546,40.0,0.0
3113,0,3113,[272 297 315 303 213],894,5,14091,4.52504816955684,40.0,0.0
3114,0,3114,[272 297 315 303 213],334,5,14096,4.525200642054575,40.0,0.0
3115,0,3115,[272 297 315 303 213],334,5,14101,4.525353016688062,40.0,0.0
3116,0,3116,[272 297 315 303 213],334,5,14106,4.5255052935514914,40.0,0.0
3117,0,3117,[272 297 315 303 213],894,5,14111,4.525657472738935,40.0,0.0
3118,0,3118,[272 297 315 303 213],334,5,14116,4.525809554344341,40.0,0.0
3119,0,3119,[215 290 226 276 275],537,2,14118,4.525,0.0,40.0
3120,0,3120,[272 297 315 303 213],334,5,14123,4.525152194809356,40.0,0.0
3121,0,3121,[272 297 315 303 213],894,5,14128,4.525304292120436,40.0,0.0
3122,0,3122,[202 230 316 211 243],650,2,14130,4.524495677233429,20.0,20.0
3123,0,3123,[272 297 315 303 213],334,5,14135,4.524647887323944,40.0,0.0
3124,0,3124,[272 297 315 303 213],334,5,14140,4.5248,40.0,0.0
3125,0,3125,[272 297 315 303 213],894,5,14145,4.524952015355086,40.0,0.0
3126,0,3126,[272 297 315 303 213],894,5,14150,4.525103933482571,40.0,0.0
3127,0,3127,[303 227 350 241 290],13,3,14153,4.524616368286445,0.0,0.0
3128,0,3128,[272 297 315 303 213],334,5,14158,4.524768296580377,40.0,0.0
3129,0,3129,[272 297 315 303 213],334,5,14163,4.524920127795527,40.0,0.0
3130,0,3130,[272 297 315 303 213],894,5,14168,4.525071862024912,40.0,0.0
3131,0,3131,[226 230 208 227 507],650,3,14171,4.524584929757344,0.0,0.0
3132,0,3132,[272 297 315 303 213],894,5,14176,4.524736674114267,40.0,0.0
3133,0,3133,[272 297 315 303 213],894,5,14181,4.524888321633695,40.0,0.0
3134,0,3134,[272 297 315 303 213],894,5,14186,4.525039872408294,40.0,0.0
3135,0,3135,[264 276 280 255 221],486,2,14188,4.524234693877551,0.0,20.0
3136,0,3136,[272 297 315 303 213],334,5,14193,4.524386356391457,40.0,0.0
3137,0,3137,[272 297 315 303 213],334,5,14198,4.524537922243467,40.0,0.0
3138,0,3138,[275 336 303 272 261],13,2,14200,4.523733673144314,0.0,20.0
3139,0,3139,[230 291 431 481 276],892,5,14205,4.523885350318471,0.0,20.0
3140,0,3140,[272 297 303 315 213],334,5,14210,4.524036930913722,40.0,0.0
3141,0,3141,[272 297 303 315 213],334,5,14215,4.524188415022278,40.0,0.0
3142,0,3142,[272 297 303 315 213],894,5,14220,4.52433980273624,40.0,0.0
3143,0,3143,[272 297 303 315 213],334,5,14225,4.524491094147582,40.0,0.0
3144,0,3144,[272 297 303 315 213],894,5,14230,4.524642289348172,40.0,0.0
3145,0,3145,[272 297 303 315 213],334,5,14235,4.524793388429752,40.0,0.0
3146,0,3146,[272 297 303 315 213],334,5,14240,4.524944391483953,40.0,0.0
3147,0,3147,[272 297 303 315 213],334,5,14245,4.525095298602287,40.0,0.0
3148,0,3148,[272 297 303 315 213],334,5,14250,4.525246109876151,40.0,0.0
3149,0,3149,[301 239 261 367 272],13,2,14252,4.524444444444445,0.0,0.0
3150,0,3150,[272 297 303 315 213],894,5,14257,4.524595366550302,40.0,0.0
3151,0,3151,[272 297 303 315 213],334,5,14262,4.524746192893401,40.0,0.0
3152,0,3152,[272 297 303 315 213],334,5,14267,4.524896923564859,40.0,0.0
3153,0,3153,[272 297 303 315 213],894,5,14272,4.525047558655675,40.0,0.0
3154,0,3154,[208 394 299 321 219],13,1,14273,4.523930269413629,0.0,0.0
3155,0,3155,[272 297 303 315 213],894,5,14278,4.524081115335868,40.0,0.0
3156,0,3156,[272 297 303 315 213],894,5,14283,4.52423186569528,40.0,0.0
3157,0,3157,[272 297 303 315 213],334,5,14288,4.524382520582647,40.0,0.0
3158,0,3158,[272 297 303 315 213],894,5,14293,4.524533080088636,40.0,0.0
3159,0,3159,[240 209 478 222 508],339,5,14298,4.524683544303797,0.0,20.0
3160,0,3160,[272 297 303 315 213],334,5,14303,4.52483391331857,40.0,0.0
3161,0,3161,[272 297 303 315 213],334,5,14308,4.524984187223277,40.0,0.0
3162,0,3162,[211 284 259 226 216],804,5,14313,4.525134366108126,0.0,20.0
3163,0,3163,[272 297 303 315 213],894,5,14318,4.525284450063211,40.0,0.0
3164,0,3164,[272 297 303 315 213],894,5,14323,4.525434439178515,40.0,0.0
3165,0,3165,[272 297 303 315 213],334,5,14328,4.525584333543904,40.0,0.0
3166,0,3166,[272 297 303 315 213],334,5,14333,4.525734133249132,40.0,0.0
3167,0,3167,[272 297 303 315 213],334,5,14338,4.525883838383838,40.0,0.0
3168,0,3168,[290 367 275 209 413],13,1,14339,4.524771221205428,0.0,20.0
3169,0,3169,[272 297 303 315 213],334,5,14344,4.524921135646688,40.0,0.0
3170,0,3170,[202 367 268 220 216],92,1,14345,4.523809523809524,0.0,0.0
3171,0,3171,[272 297 303 315 213],894,5,14350,4.523959646910466,40.0,0.0
3172,0,3172,[272 297 303 315 213],334,5,14355,4.52410967538607,40.0,0.0
3173,0,3173,[272 297 303 315 213],894,5,14360,4.524259609325772,40.0,0.0
3174,0,3174,[272 297 303 315 213],894,5,14365,4.524409448818898,40.0,0.0
3175,0,3175,[272 297 303 315 213],894,5,14370,4.52455919395466,40.0,0.0
3176,0,3176,[272 297 303 315 213],334,5,14375,4.524708844822159,40.0,0.0
3177,0,3177,[272 297 303 315 213],334,5,14380,4.524858401510384,40.0,0.0
3178,0,3178,[272 297 303 315 213],334,5,14385,4.52500786410821,40.0,0.0
3179,0,3179,[272 297 303 315 213],334,5,14390,4.5251572327044025,40.0,0.0
3180,0,3180,[272 297 303 315 213],334,5,14395,4.525306507387614,40.0,0.0
3181,0,3181,[272 297 303 315 213],334,5,14400,4.525455688246386,40.0,0.0
3182,0,3182,[272 297 303 315 213],894,5,14405,4.525604775369149,40.0,0.0
3183,0,3183,[272 297 303 315 213],894,5,14410,4.525753768844221,40.0,0.0
3184,0,3184,[272 297 303 315 213],334,5,14415,4.525902668759811,40.0,0.0
3185,0,3185,[272 297 303 315 213],894,5,14420,4.526051475204017,40.0,0.0
3186,0,3186,[272 297 303 315 213],334,5,14425,4.526200188264826,40.0,0.0
3187,0,3187,[272 297 303 315 213],334,5,14430,4.526348808030113,40.0,0.0
3188,0,3188,[272 297 303 315 213],334,5,14435,4.526497334587645,40.0,0.0
3189,0,3189,[378 206 508 221 202],537,1,14436,4.525391849529781,0.0,0.0
3190,0,3190,[272 297 303 315 213],334,5,14441,4.525540582889376,40.0,0.0
3191,0,3191,[272 297 303 315 213],894,5,14446,4.525689223057644,40.0,0.0
3192,0,3192,[218 301 222 431 208],102,1,14447,4.524585029752584,0.0,20.0
3193,0,3193,[272 297 303 315 213],334,5,14452,4.524733876017533,40.0,0.0
3194,0,3194,[272 297 303 315 213],334,5,14457,4.524882629107982,40.0,0.0
3195,0,3195,[350 201 275 509 420],13,2,14459,4.524092615769712,0.0,20.0
3196,0,3196,[272 297 303 315 213],334,5,14464,4.52424147638411,40.0,0.0
3197,0,3197,[326 272 316 300 250],392,2,14466,4.523452157598499,20.0,20.0
3198,0,3198,[272 297 303 315 213],894,5,14471,4.523601125351672,40.0,0.0
3199,0,3199,[272 297 303 315 213],894,5,14476,4.52375,40.0,0.0
3200,0,3200,[272 297 303 315 213],894,5,14481,4.5238987816307406,40.0,0.0
3201,0,3201,[250 321 211 202 239],387,2,14483,4.523110555902561,0.0,20.0
3202,0,3202,[272 297 303 315 213],894,5,14488,4.523259444270996,40.0,0.0
3203,0,3203,[272 297 303 315 213],334,5,14493,4.523408239700374,40.0,0.0
3204,0,3204,[272 297 303 315 213],894,5,14498,4.523556942277691,40.0,0.0
3205,0,3205,[272 297 303 315 213],894,5,14503,4.523705552089831,40.0,0.0
3206,0,3206,[272 297 303 315 213],894,5,14508,4.523854069223574,40.0,0.0
3207,0,3207,[378 255 478 202 250],454,2,14510,4.5230673316708225,0.0,0.0
3208,0,3208,[272 297 303 315 213],894,5,14515,4.523215955126208,40.0,0.0
3209,0,3209,[272 297 303 315 213],894,5,14520,4.5233644859813085,40.0,0.0
3210,0,3210,[291 221 218 431 316],234,1,14521,4.522267206477733,20.0,0.0
3211,0,3211,[272 297 303 315 213],334,5,14526,4.5224159402241595,40.0,0.0
3212,0,3212,[272 297 303 315 213],334,5,14531,4.522564581388111,40.0,0.0
3213,0,3213,[272 297 303 315 213],334,5,14536,4.522713130056005,40.0,0.0
3214,0,3214,[272 297 303 315 213],894,5,14541,4.522861586314153,40.0,0.0
3215,0,3215,[226 268 583 284 241],92,1,14542,4.521766169154229,0.0,0.0
3216,0,3216,[272 297 303 315 213],894,5,14547,4.5219148274790175,40.0,0.0
3217,0,3217,[272 297 303 315 213],894,5,14552,4.522063393412057,40.0,0.0
3218,0,3218,[272 297 303 315 213],334,5,14557,4.522211867039453,40.0,0.0
3219,0,3219,[272 297 303 315 213],334,5,14562,4.522360248447205,40.0,0.0
3220,0,3220,[272 297 303 315 213],894,5,14567,4.522508537721205,40.0,0.0
3221,0,3221,[272 297 303 315 213],894,5,14572,4.522656734947238,40.0,0.0
3222,0,3222,[272 297 303 315 213],894,5,14577,4.522804840210983,40.0,0.0
3223,0,3223,[272 297 303 315 213],894,5,14582,4.522952853598015,40.0,0.0
3224,0,3224,[481 218 208 231 227],13,2,14584,4.522170542635659,0.0,0.0
3225,0,3225,[272 297 303 315 213],894,5,14589,4.522318660880347,40.0,0.0
3226,0,3226,[272 297 303 315 213],334,5,14594,4.522466687325689,40.0,0.0
3227,0,3227,[272 297 303 315 213],894,5,14599,4.522614622057001,40.0,0.0
3228,0,3228,[272 297 303 315 213],894,5,14604,4.522762465159492,40.0,0.0
3229,0,3229,[272 297 303 315 213],334,5,14609,4.522910216718266,40.0,0.0
3230,0,3230,[272 297 303 315 213],334,5,14614,4.5230578768183225,40.0,0.0
3231,0,3231,[272 297 303 315 213],334,5,14619,4.523205445544554,40.0,0.0
3232,0,3232,[272 297 303 315 213],334,5,14624,4.523352922981751,40.0,0.0
3233,0,3233,[272 297 303 315 213],894,5,14629,4.523500309214595,40.0,0.0
3234,0,3234,[507 272 208 243 316],650,3,14632,4.5230293663060275,20.0,0.0
3235,0,3235,[272 297 303 315 213],334,5,14637,4.523176761433869,40.0,0.0
3236,0,3236,[272 297 303 315 213],334,5,14642,4.52332406549274,40.0,0.0
3237,0,3237,[272 297 303 315 213],334,5,14647,4.523471278567016,40.0,0.0
3238,0,3238,[208 275 212 284 239],406,0,14647,4.52207471441803,0.0,20.0
3239,0,3239,[272 297 303 315 213],334,5,14652,4.522222222222222,40.0,0.0
3240,0,3240,[272 297 303 315 213],334,5,14657,4.522369639000309,40.0,0.0
3241,0,3241,[272 297 303 315 213],334,5,14662,4.52251696483652,40.0,0.0
3242,0,3242,[222 221 223 431 276],234,0,14662,4.521122417514647,20.0,40.0
3243,0,3243,[272 297 303 315 213],894,5,14667,4.5212700369913685,40.0,0.0
3244,0,3244,[272 297 303 315 213],334,5,14672,4.521417565485362,40.0,0.0
3245,0,3245,[213 297 290 350 250],894,3,14675,4.520948860135552,20.0,0.0
3246,0,3246,[272 297 303 315 213],894,5,14680,4.521096396673853,40.0,0.0
3247,0,3247,[272 297 303 315 213],334,5,14685,4.521243842364532,40.0,0.0
3248,0,3248,[230 509 367 316 241],13,2,14687,4.52046783625731,20.0,0.0
3249,0,3249,[378 243 321 212 241],537,0,14687,4.519076923076923,0.0,0.0
3250,0,3250,[315 216 284 206 509],537,2,14689,4.518302060904337,20.0,0.0
3251,0,3251,[272 297 315 303 213],894,5,14694,4.518450184501845,40.0,0.0
3252,0,3252,[272 297 315 303 213],334,5,14699,4.5185982170304335,40.0,0.0
3253,0,3253,[272 297 315 303 213],894,5,14704,4.5187461585740625,40.0,0.0
3254,0,3254,[272 297 315 303 213],334,5,14709,4.51889400921659,40.0,0.0
3255,0,3255,[272 297 315 303 213],894,5,14714,4.5190417690417695,40.0,0.0
3256,0,3256,[272 297 315 303 213],334,5,14719,4.519189438133251,40.0,0.0
3257,0,3257,[272 297 315 303 213],334,5,14724,4.519337016574585,40.0,0.0
3258,0,3258,[272 297 315 303 213],334,5,14729,4.519484504449218,40.0,0.0
3259,0,3259,[272 297 315 303 213],334,5,14734,4.519631901840491,40.0,0.0
3260,0,3260,[208 324 295 217 230],387,1,14735,4.5185525912296844,0.0,0.0
3261,0,3261,[272 297 315 303 213],894,5,14740,4.518700183936235,40.0,0.0
3262,0,3262,[272 297 315 303 213],894,5,14745,4.518847686178363,40.0,0.0
3263,0,3263,[272 297 315 303 213],334,5,14750,4.518995098039215,40.0,0.0
3264,0,3264,[272 297 315 303 213],894,5,14755,4.519142419601837,40.0,0.0
3265,0,3265,[272 297 315 303 213],894,5,14760,4.519289650949173,40.0,0.0
3266,0,3266,[272 297 315 303 213],894,5,14765,4.519436792164065,40.0,0.0
3267,0,3267,[272 297 315 303 213],334,5,14770,4.5195838433292534,40.0,0.0
3268,0,3268,[272 297 315 303 213],334,5,14775,4.519730804527378,40.0,0.0
3269,0,3269,[272 297 315 303 213],894,5,14780,4.519877675840979,40.0,0.0
3270,0,3270,[272 297 315 303 213],334,5,14785,4.520024457352491,40.0,0.0
3271,0,3271,[272 297 315 303 213],334,5,14790,4.520171149144255,40.0,0.0
3272,0,3272,[272 297 315 303 213],334,5,14795,4.520317751298503,40.0,0.0
3273,0,3273,[272 297 315 303 213],894,5,14800,4.520464263897373,40.0,0.0
3274,0,3274,[230 301 481 218 239],13,1,14801,4.5193893129771,0.0,0.0
3275,0,3275,[272 297 315 303 213],334,5,14806,4.5195360195360195,40.0,0.0
3276,0,3276,[272 297 315 303 213],894,5,14811,4.519682636557827,40.0,0.0
3277,0,3277,[272 297 315 303 213],334,5,14816,4.519829164124467,40.0,0.0
3278,0,3278,[272 297 315 303 213],334,5,14821,4.51997560231778,40.0,0.0
3279,0,3279,[272 297 315 303 213],894,5,14826,4.5201219512195125,40.0,0.0
3280,0,3280,[272 297 315 303 213],334,5,14831,4.520268210911308,40.0,0.0
3281,0,3281,[272 297 315 303 213],894,5,14836,4.52041438147471,40.0,0.0
3282,0,3282,[272 297 315 303 213],894,5,14841,4.520560462991167,40.0,0.0
3283,0,3283,[272 297 315 303 213],894,5,14846,4.5207064555420216,40.0,0.0
3284,0,3284,[272 297 315 303 213],334,5,14851,4.520852359208524,40.0,0.0
3285,0,3285,[272 297 315 303 213],894,5,14856,4.52099817407182,40.0,0.0
3286,0,3286,[272 297 315 303 213],894,5,14861,4.5211439002129605,40.0,0.0
3287,0,3287,[272 297 315 303 213],894,5,14866,4.521289537712895,40.0,0.0
3288,0,3288,[272 297 315 303 213],334,5,14871,4.521435086652478,40.0,0.0
3289,0,3289,[299 394 212 217 268],145,2,14873,4.520668693009118,0.0,0.0
3290,0,3290,[272 297 315 303 213],334,5,14878,4.520814342145244,40.0,0.0
3291,0,3291,[272 297 315 303 213],894,5,14883,4.520959902794654,40.0,0.0
3292,0,3292,[272 297 315 303 213],334,5,14888,4.521105375037959,40.0,0.0
3293,0,3293,[290 241 276 344 481],13,2,14890,4.520340012143291,0.0,20.0
3294,0,3294,[272 297 315 303 213],334,5,14895,4.5204855842185125,40.0,0.0
3295,0,3295,[272 297 315 303 213],334,5,14900,4.520631067961165,40.0,0.0
3296,0,3296,[272 297 315 303 213],334,5,14905,4.5207764634516225,40.0,0.0
3297,0,3297,[272 297 315 303 213],894,5,14910,4.520921770770164,40.0,0.0
3298,0,3298,[272 297 315 303 213],334,5,14915,4.521066989996969,40.0,0.0
3299,0,3299,[272 297 315 303 213],334,5,14920,4.5212121212121215,40.0,0.0
3300,0,3300,[272 297 315 303 213],334,5,14925,4.521357164495607,40.0,0.0
3301,0,3301,[272 297 315 303 213],894,5,14930,4.521502119927317,40.0,0.0
3302,0,3302,[272 297 315 303 213],894,5,14935,4.521646987587042,40.0,0.0
3303,0,3303,[272 297 315 303 213],334,5,14940,4.521791767554479,40.0,0.0
3304,0,3304,[272 297 315 303 213],334,5,14945,4.521936459909228,40.0,0.0
3305,0,3305,[272 297 315 303 213],894,5,14950,4.522081064730792,40.0,0.0
3306,0,3306,[272 297 315 303 213],334,5,14955,4.522225582098579,40.0,0.0
3307,0,3307,[272 297 315 303 213],334,5,14960,4.522370012091899,40.0,0.0
3308,0,3308,[272 297 315 303 213],334,5,14965,4.522514354789966,40.0,0.0
3309,0,3309,[272 297 315 303 213],894,5,14970,4.522658610271903,40.0,0.0
3310,0,3310,[272 297 315 303 213],894,5,14975,4.522802778616732,40.0,0.0
3311,0,3311,[272 297 315 303 213],894,5,14980,4.5229468599033815,40.0,0.0
3312,0,3312,[212 202 508 301 431],537,2,14982,4.522185330516148,0.0,0.0
3313,0,3313,[211 275 254 226 201],279,3,14985,4.521726010863006,0.0,40.0
3314,0,3314,[272 297 315 303 213],334,5,14990,4.521870286576169,40.0,0.0
3315,0,3315,[272 297 315 303 213],894,5,14995,4.522014475271411,40.0,0.0
3316,0,3316,[272 297 315 303 213],334,5,15000,4.522158577027435,40.0,0.0
3317,0,3317,[272 297 315 303 213],894,5,15005,4.522302591922845,40.0,0.0
3318,0,3318,[272 297 315 303 213],894,5,15010,4.522446520036156,40.0,0.0
3319,0,3319,[272 297 315 303 213],894,5,15015,4.522590361445783,40.0,0.0
3320,0,3320,[202 452 268 264 420],13,4,15019,4.522433002107799,0.0,0.0
3321,0,3321,[272 297 315 303 213],894,5,15024,4.522576760987357,40.0,0.0
3322,0,3322,[272 297 315 303 213],894,5,15029,4.522720433343364,40.0,0.0
3323,0,3323,[272 297 315 303 213],334,5,15034,4.522864019253911,40.0,0.0
3324,0,3324,[272 297 315 303 213],334,5,15039,4.523007518796993,40.0,0.0
3325,0,3325,[272 297 315 303 213],894,5,15044,4.523150932050511,40.0,0.0
3326,0,3326,[272 297 315 303 213],894,5,15049,4.523294259092276,40.0,0.0
3327,0,3327,[272 297 315 303 213],334,5,15054,4.5234375,40.0,0.0
3328,0,3328,[272 297 315 303 213],334,5,15059,4.5235806548513064,40.0,0.0
3329,0,3329,[276 201 216 212 481],452,1,15060,4.5225225225225225,0.0,20.0
3330,0,3330,[272 297 315 303 213],894,5,15065,4.522665866106275,40.0,0.0
3331,0,3331,[272 297 315 303 213],894,5,15070,4.52280912364946,40.0,0.0
3332,0,3332,[272 297 315 303 213],894,5,15075,4.522952295229523,40.0,0.0
3333,0,3333,[272 297 315 303 213],894,5,15080,4.523095380923815,40.0,0.0
3334,0,3334,[272 297 315 303 213],334,5,15085,4.5232383808095955,40.0,0.0
3335,0,3335,[272 297 315 303 213],334,5,15090,4.523381294964029,40.0,0.0
3336,0,3336,[230 254 239 226 283],279,3,15093,4.522924782738987,0.0,0.0
3337,0,3337,[268 485 232 275 507],85,3,15096,4.522468544038347,0.0,20.0
3338,0,3338,[272 297 315 303 213],334,5,15101,4.52261156034741,40.0,0.0
3339,0,3339,[215 219 218 226 259],804,4,15105,4.522455089820359,0.0,0.0
3340,0,3340,[272 297 315 303 213],334,5,15110,4.52259802454355,40.0,0.0
3341,0,3341,[272 297 315 303 213],894,5,15115,4.522740873728306,40.0,0.0
3342,0,3342,[272 297 315 303 213],334,5,15120,4.5228836374513905,40.0,0.0
3343,0,3343,[272 297 315 303 213],334,5,15125,4.5230263157894735,40.0,0.0
3344,0,3344,[272 297 315 303 213],334,5,15130,4.523168908819133,40.0,0.0
3345,0,3345,[272 297 315 303 213],334,5,15135,4.523311416616856,40.0,0.0
3346,0,3346,[272 297 315 303 213],334,5,15140,4.523453839259038,40.0,0.0
3347,0,3347,[272 297 315 303 213],894,5,15145,4.523596176821983,40.0,0.0
3348,0,3348,[276 226 230 264 315],13,4,15149,4.523439832785907,20.0,20.0
3349,0,3349,[272 297 315 303 213],894,5,15154,4.523582089552239,40.0,0.0
3350,0,3350,[272 297 315 303 213],334,5,15159,4.523724261414503,40.0,0.0
3351,0,3351,[272 297 315 303 213],334,5,15164,4.523866348448688,40.0,0.0
3352,0,3352,[272 297 315 303 213],894,5,15169,4.524008350730689,40.0,0.0
3353,0,3353,[272 297 315 303 213],334,5,15174,4.524150268336315,40.0,0.0
3354,0,3354,[272 297 315 303 213],334,5,15179,4.524292101341282,40.0,0.0
3355,0,3355,[272 297 315 303 213],894,5,15184,4.524433849821215,40.0,0.0
3356,0,3356,[272 297 315 303 213],894,5,15189,4.524575513851653,40.0,0.0
3357,0,3357,[276 485 216 283 303],409,4,15193,4.524419297200715,0.0,20.0
3358,0,3358,[272 297 315 303 213],894,5,15198,4.524560881214647,40.0,0.0
3359,0,3359,[272 297 315 303 213],334,5,15203,4.524702380952381,40.0,0.0
3360,0,3360,[272 297 315 303 213],334,5,15208,4.52484379648914,40.0,0.0
3361,0,3361,[272 297 315 303 213],894,5,15213,4.5249851279000595,40.0,0.0
3362,0,3362,[272 297 315 303 213],894,5,15218,4.525126375260184,40.0,0.0
3363,0,3363,[272 297 315 303 213],334,5,15223,4.525267538644471,40.0,0.0
3364,0,3364,[507 226 272 259 209],537,3,15226,4.52481426448737,0.0,0.0
3365,0,3365,[324 208 284 267 218],833,1,15227,4.523767082590612,0.0,0.0
3366,0,3366,[478 244 326 215 227],474,4,15231,4.523611523611524,0.0,0.0
3367,0,3367,[272 297 315 303 213],894,5,15236,4.52375296912114,40.0,0.0
3368,0,3368,[272 297 315 303 213],894,5,15241,4.523894330661918,40.0,0.0
3369,0,3369,[272 297 315 303 213],894,5,15246,4.524035608308606,40.0,0.0
3370,0,3370,[272 297 315 303 213],334,5,15251,4.524176802135865,40.0,0.0
3371,0,3371,[272 297 315 303 213],894,5,15256,4.524317912218268,40.0,0.0
3372,0,3372,[272 297 315 303 213],894,5,15261,4.5244589386303,40.0,0.0
3373,0,3373,[272 297 315 303 213],334,5,15266,4.524599881446354,40.0,0.0
3374,0,3374,[272 297 315 303 213],334,5,15271,4.524740740740741,40.0,0.0
3375,0,3375,[272 297 315 303 213],334,5,15276,4.524881516587678,40.0,0.0
3376,0,3376,[222 297 326 255 208],334,3,15279,4.52442996742671,20.0,20.0
3377,0,3377,[222 509 216 508 378],653,1,15280,4.523386619301362,0.0,20.0
3378,0,3378,[272 297 315 303 213],894,5,15285,4.523527670908553,40.0,0.0
3379,0,3379,[272 297 315 303 213],894,5,15290,4.523668639053255,40.0,0.0
3380,0,3380,[272 297 315 303 213],334,5,15295,4.523809523809524,40.0,0.0
3381,0,3381,[272 297 315 303 213],894,5,15300,4.523950325251331,40.0,0.0
3382,0,3382,[272 297 315 303 213],894,5,15305,4.5240910434525565,40.0,0.0
3383,0,3383,[272 297 315 303 213],894,5,15310,4.524231678486998,40.0,0.0
3384,0,3384,[272 297 315 303 213],334,5,15315,4.5243722304283605,40.0,0.0
3385,0,3385,[272 297 315 303 213],334,5,15320,4.524512699350266,40.0,0.0
3386,0,3386,[272 297 315 303 213],894,5,15325,4.524653085326247,40.0,0.0
3387,0,3387,[272 297 315 303 213],334,5,15330,4.524793388429752,40.0,0.0
3388,0,3388,[272 297 315 303 213],334,5,15335,4.52493360873414,40.0,0.0
3389,0,3389,[272 297 315 303 213],894,5,15340,4.525073746312684,40.0,0.0
3390,0,3390,[272 297 315 303 213],334,5,15345,4.525213801238572,40.0,0.0
3391,0,3391,[272 297 315 303 213],334,5,15350,4.525353773584905,40.0,0.0
3392,0,3392,[272 297 315 303 213],894,5,15355,4.525493663424698,40.0,0.0
3393,0,3393,[272 297 315 303 213],334,5,15360,4.525633470830878,40.0,0.0
3394,0,3394,[272 297 315 303 213],334,5,15365,4.525773195876289,40.0,0.0
3395,0,3395,[272 297 315 303 213],894,5,15370,4.525912838633687,40.0,0.0
3396,0,3396,[272 297 315 303 213],894,5,15375,4.526052399175743,40.0,0.0
3397,0,3397,[272 297 315 303 213],894,5,15380,4.5261918775750445,40.0,0.0
3398,0,3398,[272 297 315 303 213],894,5,15385,4.5263312739040895,40.0,0.0
3399,0,3399,[272 297 315 303 213],334,5,15390,4.526470588235294,40.0,0.0
3400,0,3400,[272 297 315 303 213],334,5,15395,4.526609820640988,40.0,0.0
3401,0,3401,[272 297 315 303 213],894,5,15400,4.526748971193416,40.0,0.0
3402,0,3402,[272 297 315 303 213],894,5,15405,4.526888039964737,40.0,0.0
3403,0,3403,[420 215 264 231 284],308,2,15407,4.526145710928319,0.0,0.0
3404,0,3404,[272 297 315 303 213],334,5,15412,4.526284875183554,40.0,0.0
3405,0,3405,[272 297 315 303 213],894,5,15417,4.526423957721668,40.0,0.0
3406,0,3406,[272 297 315 303 213],894,5,15422,4.526562958614617,40.0,0.0
3407,0,3407,[272 297 315 303 213],894,5,15427,4.526701877934272,40.0,0.0
3408,0,3408,[272 297 315 303 213],334,5,15432,4.52684071575242,40.0,0.0
3409,0,3409,[272 297 315 303 213],894,5,15437,4.526979472140763,40.0,0.0
3410,0,3410,[272 297 315 303 213],334,5,15442,4.527118147170918,40.0,0.0
3411,0,3411,[272 297 315 303 213],334,5,15447,4.52725674091442,40.0,0.0
3412,0,3412,[272 297 315 303 213],894,5,15452,4.527395253442719,40.0,0.0
3413,0,3413,[272 297 315 303 213],894,5,15457,4.5275336848271825,40.0,0.0
3414,0,3414,[272 223 209 208 303],6,4,15461,4.527379209370425,20.0,0.0
3415,0,3415,[272 297 315 303 213],334,5,15466,4.52751756440281,40.0,0.0
3416,0,3416,[272 297 315 303 213],894,5,15471,4.527655838454785,40.0,0.0
3417,0,3417,[272 297 315 303 213],334,5,15476,4.527794031597425,40.0,0.0
3418,0,3418,[384 264 226 216 219],13,2,15478,4.5270546943550745,0.0,0.0
3419,0,3419,[272 297 315 303 213],894,5,15483,4.527192982456141,40.0,0.0
3420,0,3420,[290 268 202 261 219],13,3,15486,4.526746565331774,0.0,0.0
3421,0,3421,[272 297 315 303 213],334,5,15491,4.526884862653419,40.0,0.0
3422,0,3422,[272 297 315 303 213],894,5,15496,4.527023079170318,40.0,0.0
3423,0,3423,[272 297 315 303 213],894,5,15501,4.527161214953271,40.0,0.0
3424,0,3424,[230 367 350 218 478],13,1,15502,4.526131386861314,0.0,0.0
3425,0,3425,[272 297 315 303 213],334,5,15507,4.526269702276707,40.0,0.0
3426,0,3426,[272 297 315 303 213],894,5,15512,4.526407936971112,40.0,0.0
3427,0,3427,[272 297 315 303 213],334,5,15517,4.526546091015169,40.0,0.0
3428,0,3428,[272 297 315 303 213],334,5,15522,4.52668416447944,40.0,0.0
3429,0,3429,[272 297 315 303 213],334,5,15527,4.5268221574344025,40.0,0.0
3430,0,3430,[272 297 315 303 213],894,5,15532,4.5269600699504515,40.0,0.0
3431,0,3431,[272 297 315 303 213],894,5,15537,4.5270979020979025,40.0,0.0
3432,0,3432,[272 297 315 303 213],894,5,15542,4.527235653946986,40.0,0.0
3433,0,3433,[272 297 315 303 213],334,5,15547,4.527373325567851,40.0,0.0
3434,0,3434,[272 297 315 303 213],894,5,15552,4.527510917030567,40.0,0.0
3435,0,3435,[272 297 315 303 213],894,5,15557,4.527648428405122,40.0,0.0
3436,0,3436,[272 297 315 303 213],894,5,15562,4.52778585976142,40.0,0.0
3437,0,3437,[272 297 315 303 213],894,5,15567,4.527923211169284,40.0,0.0
3438,0,3438,[272 297 315 303 213],334,5,15572,4.528060482698459,40.0,0.0
3439,0,3439,[272 297 315 303 213],334,5,15577,4.528197674418605,40.0,0.0
3440,0,3440,[272 297 315 303 213],894,5,15582,4.528334786399302,40.0,0.0
3441,0,3441,[272 297 315 303 213],334,5,15587,4.528471818710052,40.0,0.0
3442,0,3442,[272 297 315 303 213],894,5,15592,4.528608771420273,40.0,0.0
3443,0,3443,[272 275 509 243 213],537,4,15596,4.528455284552845,0.0,20.0
3444,0,3444,[272 275 276 223 336],13,3,15599,4.528011611030479,20.0,40.0
3445,0,3445,[272 297 315 303 213],334,5,15604,4.52814857806152,40.0,0.0
3446,0,3446,[272 297 315 303 213],334,5,15609,4.528285465622281,40.0,0.0
3447,0,3447,[272 297 315 303 213],894,5,15614,4.528422273781903,40.0,0.0
3448,0,3448,[272 297 315 303 213],334,5,15619,4.528559002609452,40.0,0.0
3449,0,3449,[216 201 413 336 290],13,1,15620,4.527536231884058,0.0,0.0
3450,0,3450,[272 297 315 303 213],894,5,15625,4.5276731382208055,40.0,0.0
3451,0,3451,[272 297 315 303 213],894,5,15630,4.527809965237544,40.0,0.0
3452,0,3452,[272 297 315 303 213],894,5,15635,4.527946713003185,40.0,0.0
3453,0,3453,[272 297 315 303 213],334,5,15640,4.528083381586566,40.0,0.0
3454,0,3454,[272 297 315 303 213],894,5,15645,4.52821997105644,40.0,0.0
3455,0,3455,[272 297 315 303 213],894,5,15650,4.528356481481482,40.0,0.0
3456,0,3456,[384 223 231 429 215],13,3,15653,4.527914376627133,20.0,0.0
3457,0,3457,[272 297 315 303 213],894,5,15658,4.5280508964719495,40.0,0.0
3458,0,3458,[272 297 315 303 213],334,5,15663,4.5281873373807455,40.0,0.0
3459,0,3459,[272 297 315 303 213],894,5,15668,4.528323699421965,40.0,0.0
3460,0,3460,[272 297 315 303 213],894,5,15673,4.5284599826639695,40.0,0.0
3461,0,3461,[272 297 315 303 213],894,5,15678,4.528596187175044,40.0,0.0
3462,0,3462,[272 297 315 303 213],894,5,15683,4.52873231302339,40.0,0.0
3463,0,3463,[272 297 315 303 213],334,5,15688,4.528868360277136,40.0,0.0
3464,0,3464,[272 297 315 303 213],894,5,15693,4.529004329004329,40.0,0.0
3465,0,3465,[268 290 485 213 429],537,2,15695,4.528274668205424,0.0,0.0
3466,0,3466,[272 297 315 303 213],334,5,15700,4.528410729737526,40.0,0.0
3467,0,3467,[295 230 223 254 291],308,2,15702,4.527681660899654,20.0,0.0
3468,0,3468,[272 297 315 303 213],334,5,15707,4.527817814932257,40.0,0.0
3469,0,3469,[218 222 213 378 226],804,4,15711,4.527665706051873,0.0,20.0
3470,0,3470,[272 297 315 303 213],334,5,15716,4.5278017862287525,40.0,0.0
3471,0,3471,[272 297 315 303 213],334,5,15721,4.527937788018433,40.0,0.0
3472,0,3472,[272 297 315 303 213],894,5,15726,4.528073711488626,40.0,0.0
3473,0,3473,[272 297 315 303 213],894,5,15731,4.528209556706966,40.0,0.0
3474,0,3474,[264 431 316 215 223],13,4,15735,4.528057553956835,40.0,0.0
3475,0,3475,[272 297 315 303 213],334,5,15740,4.52819332566168,40.0,0.0
3476,0,3476,[315 212 478 276 301],13,4,15744,4.528041415012942,20.0,20.0
3477,0,3477,[272 297 315 303 213],334,5,15749,4.528177113283497,40.0,0.0
3478,0,3478,[272 297 315 303 213],894,5,15754,4.528312733544122,40.0,0.0
3479,0,3479,[272 297 315 303 213],894,5,15759,4.528448275862069,40.0,0.0
3480,0,3480,[272 297 315 303 213],894,5,15764,4.52858374030451,40.0,0.0
3481,0,3481,[272 297 315 303 213],894,5,15769,4.528719126938541,40.0,0.0
3482,0,3482,[272 297 315 303 213],894,5,15774,4.52885443583118,40.0,0.0
3483,0,3483,[272 297 315 303 213],334,5,15779,4.528989667049369,40.0,0.0
3484,0,3484,[272 297 315 303 213],334,5,15784,4.5291248206599715,40.0,0.0
3485,0,3485,[272 297 315 303 213],334,5,15789,4.529259896729776,40.0,0.0
3486,0,3486,[272 297 315 303 213],334,5,15794,4.5293948953254946,40.0,0.0
3487,0,3487,[272 297 315 303 213],894,5,15799,4.529529816513762,40.0,0.0
3488,0,3488,[272 297 315 303 213],334,5,15804,4.529664660361135,40.0,0.0
3489,0,3489,[272 297 315 303 213],894,5,15809,4.5297994269340975,40.0,0.0
3490,0,3490,[272 297 315 303 213],334,5,15814,4.529934116299055,40.0,0.0
3491,0,3491,[272 297 315 303 213],894,5,15819,4.530068728522337,40.0,0.0
3492,0,3492,[272 297 315 303 213],894,5,15824,4.530203263670198,40.0,0.0
3493,0,3493,[272 297 315 303 213],894,5,15829,4.530337721808815,40.0,0.0
3494,0,3494,[272 297 315 303 213],894,5,15834,4.530472103004292,40.0,0.0
3495,0,3495,[272 297 315 303 213],334,5,15839,4.530606407322654,40.0,0.0
3496,0,3496,[272 297 315 303 213],334,5,15844,4.530740634829854,40.0,0.0
3497,0,3497,[272 297 315 303 213],894,5,15849,4.530874785591767,40.0,0.0
3498,0,3498,[272 297 315 303 213],894,5,15854,4.531008859674192,40.0,0.0
3499,0,3499,[272 297 315 303 213],894,5,15859,4.531142857142857,40.0,0.0
3500,0,3500,[272 297 315 303 213],334,5,15864,4.53127677806341,40.0,0.0
3501,0,3501,[272 297 315 303 213],894,5,15869,4.5314106225014275,40.0,0.0
3502,0,3502,[272 297 315 303 213],334,5,15874,4.531544390522409,40.0,0.0
3503,0,3503,[272 297 315 303 213],894,5,15879,4.531678082191781,40.0,0.0
3504,0,3504,[272 297 315 303 213],334,5,15884,4.531811697574893,40.0,0.0
3505,0,3505,[420 227 215 300 301],378,3,15887,4.531374786081004,0.0,20.0
3506,0,3506,[272 297 315 303 213],334,5,15892,4.531508411747932,40.0,0.0
3507,0,3507,[272 297 315 303 213],334,5,15897,4.531641961231471,40.0,0.0
3508,0,3508,[272 297 315 303 213],894,5,15902,4.531775434596751,40.0,0.0
3509,0,3509,[272 297 315 303 213],334,5,15907,4.531908831908832,40.0,0.0
3510,0,3510,[272 297 315 303 213],334,5,15912,4.532042153232697,40.0,0.0
3511,0,3511,[507 243 303 331 232],13,1,15913,4.5310364464692485,0.0,0.0
3512,0,3512,[272 297 315 303 213],334,5,15918,4.531169940222032,40.0,0.0
3513,0,3513,[272 297 315 303 213],334,5,15923,4.531303357996585,40.0,0.0
3514,0,3514,[272 297 315 303 213],894,5,15928,4.531436699857752,40.0,0.0
3515,0,3515,[485 232 241 211 272],85,3,15931,4.531001137656427,0.0,20.0
3516,0,3516,[272 297 315 303 213],894,5,15936,4.531134489621837,40.0,0.0
3517,0,3517,[272 297 315 303 213],334,5,15941,4.531267765776009,40.0,0.0
3518,0,3518,[272 297 315 303 213],894,5,15946,4.531400966183575,40.0,0.0
3519,0,3519,[507 378 213 365 291],308,1,15947,4.530397727272727,0.0,0.0
3520,0,3520,[209 243 507 219 478],650,2,15949,4.529679068446464,0.0,0.0
3521,0,3521,[272 297 315 303 213],894,5,15954,4.529812606473595,40.0,0.0
3522,0,3522,[272 297 315 303 213],894,5,15959,4.529946068691456,40.0,0.0
3523,0,3523,[272 297 315 303 213],334,5,15964,4.530079455164586,40.0,0.0
3524,0,3524,[272 297 315 303 213],894,5,15969,4.5302127659574465,40.0,0.0
3525,0,3525,[272 297 315 303 213],334,5,15974,4.53034600113443,40.0,0.0
3526,0,3526,[272 297 315 303 213],334,5,15979,4.530479160759852,40.0,0.0
3527,0,3527,[220 284 222 301 509],378,1,15980,4.529478458049887,0.0,20.0
3528,0,3528,[272 297 315 303 213],334,5,15985,4.529611788041938,40.0,0.0
3529,0,3529,[272 297 315 303 213],334,5,15990,4.529745042492918,40.0,0.0
3530,0,3530,[272 297 315 303 213],334,5,15995,4.529878221467007,40.0,0.0
3531,0,3531,[272 297 315 303 213],894,5,16000,4.530011325028313,40.0,0.0
3532,0,3532,[272 297 315 303 213],894,5,16005,4.530144353240872,40.0,0.0
3533,0,3533,[272 297 315 303 213],894,5,16010,4.530277306168648,40.0,0.0
3534,0,3534,[272 297 315 303 213],334,5,16015,4.530410183875531,40.0,0.0
3535,0,3535,[272 297 315 303 213],334,5,16020,4.530542986425339,40.0,0.0
3536,0,3536,[272 297 315 303 213],334,5,16025,4.530675713881821,40.0,0.0
3537,0,3537,[272 297 315 303 213],894,5,16030,4.530808366308649,40.0,0.0
3538,0,3538,[300 246 222 324 283],699,3,16033,4.530375812376377,0.0,40.0
3539,0,3539,[272 297 315 303 213],334,5,16038,4.530508474576271,40.0,0.0
3540,0,3540,[272 297 315 303 213],334,5,16043,4.530641061846936,40.0,0.0
3541,0,3541,[272 297 315 303 213],894,5,16048,4.530773574251835,40.0,0.0
3542,0,3542,[272 297 315 303 213],334,5,16053,4.530906011854361,40.0,0.0
3543,0,3543,[272 297 315 303 213],334,5,16058,4.531038374717833,40.0,0.0
3544,0,3544,[272 297 315 303 213],334,5,16063,4.531170662905501,40.0,0.0
3545,0,3545,[272 297 315 303 213],894,5,16068,4.531302876480542,40.0,0.0
3546,0,3546,[272 297 315 303 213],894,5,16073,4.531435015506061,40.0,0.0
3547,0,3547,[272 297 315 303 213],894,5,16078,4.531567080045096,40.0,0.0
3548,0,3548,[272 297 315 303 213],334,5,16083,4.531699070160609,40.0,0.0
3549,0,3549,[299 201 232 507 261],13,0,16083,4.530422535211268,0.0,0.0
3550,0,3550,[272 297 315 303 213],894,5,16088,4.530554773303295,40.0,0.0
3551,0,3551,[272 297 315 303 213],894,5,16093,4.530686936936937,40.0,0.0
3552,0,3552,[485 290 509 226 219],95,4,16097,4.530537573881227,0.0,0.0
3553,0,3553,[227 209 222 367 219],650,1,16098,4.529544175576815,0.0,20.0
3554,0,3554,[272 297 315 303 213],334,5,16103,4.529676511954993,40.0,0.0
3555,0,3555,[272 297 315 303 213],334,5,16108,4.529808773903262,40.0,0.0
3556,0,3556,[272 297 315 303 213],334,5,16113,4.529940961484397,40.0,0.0
3557,0,3557,[272 297 315 303 213],334,5,16118,4.530073074761102,40.0,0.0
3558,0,3558,[272 297 315 303 213],894,5,16123,4.53020511379601,40.0,0.0
3559,0,3559,[272 297 315 303 213],334,5,16128,4.5303370786516854,40.0,0.0
3560,0,3560,[272 297 315 303 213],894,5,16133,4.530468969390621,40.0,0.0
3561,0,3561,[272 297 315 303 213],334,5,16138,4.530600786075238,40.0,0.0
3562,0,3562,[303 508 478 300 367],13,2,16140,4.529890541678361,0.0,20.0
3563,0,3563,[272 297 315 303 213],334,5,16145,4.530022446689113,40.0,0.0
3564,0,3564,[272 297 315 303 213],334,5,16150,4.53015427769986,40.0,0.0
3565,0,3565,[272 297 315 303 213],894,5,16155,4.530286034772855,40.0,0.0
3566,0,3566,[452 215 420 315 331],13,3,16158,4.529857022708158,20.0,0.0
3567,0,3567,[272 297 315 303 213],334,5,16163,4.5299887892376685,40.0,0.0
3568,0,3568,[272 297 315 303 213],334,5,16168,4.530120481927711,40.0,0.0
3569,0,3569,[301 275 246 255 390],116,2,16170,4.529411764705882,0.0,20.0
3570,0,3570,[272 297 315 303 213],894,5,16175,4.529543545225427,40.0,0.0
3571,0,3571,[272 297 315 303 213],894,5,16180,4.529675251959686,40.0,0.0
3572,0,3572,[230 284 300 215 509],378,3,16183,4.529247131262244,0.0,20.0
3573,0,3573,[509 301 223 212 220],90,5,16188,4.529378847229994,20.0,0.0
3574,0,3574,[272 297 315 303 213],894,5,16193,4.529510489510489,40.0,0.0
3575,0,3575,[272 297 315 303 213],894,5,16198,4.529642058165548,40.0,0.0
3576,0,3576,[429 217 394 241 384],13,1,16199,4.528655297735533,0.0,0.0
3577,0,3577,[209 261 326 223 239],13,2,16201,4.527948574622695,20.0,0.0
3578,0,3578,[272 297 315 303 213],334,5,16206,4.528080469404862,40.0,0.0
3579,0,3579,[218 223 481 331 300],13,1,16207,4.527094972067039,20.0,20.0
3580,0,3580,[272 297 315 303 213],334,5,16212,4.527227031555431,40.0,0.0
3581,0,3581,[272 297 315 303 213],334,5,16217,4.527359017308766,40.0,0.0
3582,0,3582,[272 297 315 303 213],334,5,16222,4.52749092938878,40.0,0.0
3583,0,3583,[272 297 315 303 213],894,5,16227,4.527622767857143,40.0,0.0
3584,0,3584,[272 297 315 303 213],334,5,16232,4.527754532775453,40.0,0.0
3585,0,3585,[509 303 201 485 216],537,2,16234,4.527049637479085,0.0,0.0
3586,0,3586,[272 297 315 303 213],334,5,16239,4.527181488709227,40.0,0.0
3587,0,3587,[272 297 315 303 213],894,5,16244,4.527313266443701,40.0,0.0
3588,0,3588,[272 297 315 303 213],334,5,16249,4.5274449707439395,40.0,0.0
3589,0,3589,[272 297 315 303 213],894,5,16254,4.527576601671309,40.0,0.0
3590,0,3590,[272 297 315 303 213],334,5,16259,4.527708159287107,40.0,0.0
3591,0,3591,[272 297 315 303 213],894,5,16264,4.527839643652562,40.0,0.0
3592,0,3592,[272 297 315 303 213],334,5,16269,4.527971054828834,40.0,0.0
3593,0,3593,[420 394 367 226 239],13,3,16272,4.527545909849749,0.0,0.0
3594,0,3594,[272 297 315 303 213],894,5,16277,4.5276773296244786,40.0,0.0
3595,0,3595,[272 297 315 303 213],894,5,16282,4.527808676307008,40.0,0.0
3596,0,3596,[209 485 256 208 290],385,3,16285,4.527383931053656,0.0,0.0
3597,0,3597,[272 297 315 303 213],894,5,16290,4.52751528627015,40.0,0.0
3598,0,3598,[201 231 219 215 507],308,1,16291,4.526535148652403,0.0,0.0
3599,0,3599,[420 239 222 215 216],13,3,16294,4.526111111111111,0.0,20.0
3600,0,3600,[272 297 315 303 213],894,5,16299,4.5262427103582334,40.0,0.0
3601,0,3601,[272 297 315 303 213],894,5,16304,4.526374236535259,40.0,0.0
3602,0,3602,[272 297 315 303 213],334,5,16309,4.526505689703026,40.0,0.0
3603,0,3603,[272 297 315 303 213],894,5,16314,4.526637069922309,40.0,0.0
3604,0,3604,[272 297 315 303 213],894,5,16319,4.5267683772538145,40.0,0.0
3605,0,3605,[272 297 315 303 213],334,5,16324,4.526899611758181,40.0,0.0
3606,0,3606,[239 202 315 507 259],537,2,16326,4.526199057388411,20.0,0.0
3607,0,3607,[272 297 315 303 213],894,5,16331,4.526330376940133,40.0,0.0
3608,0,3608,[272 297 315 303 213],894,5,16336,4.526461623718482,40.0,0.0
3609,0,3609,[272 297 315 303 213],894,5,16341,4.526592797783933,40.0,0.0
3610,0,3610,[272 297 315 303 213],894,5,16346,4.526723899196899,40.0,0.0
3611,0,3611,[272 297 315 303 213],334,5,16351,4.526854928017719,40.0,0.0
3612,0,3612,[272 297 315 303 213],334,5,16356,4.52698588430667,40.0,0.0
3613,0,3613,[272 297 315 303 213],334,5,16361,4.527116768123962,40.0,0.0
3614,0,3614,[272 297 315 303 213],894,5,16366,4.527247579529737,40.0,0.0
3615,0,3615,[222 213 226 218 243],234,0,16366,4.525995575221239,0.0,20.0
3616,0,3616,[212 202 300 216 420],7,3,16369,4.525573679845175,0.0,20.0
3617,0,3617,[272 297 315 303 213],334,5,16374,4.525704809286899,40.0,0.0
3618,0,3618,[272 297 315 303 213],334,5,16379,4.525835866261398,40.0,0.0
3619,0,3619,[272 297 315 303 213],334,5,16384,4.52596685082873,40.0,0.0
3620,0,3620,[272 297 315 303 213],894,5,16389,4.526097763048882,40.0,0.0
3621,0,3621,[272 297 315 303 213],894,5,16394,4.526228602981778,40.0,0.0
3622,0,3622,[272 297 315 303 213],894,5,16399,4.526359370687276,40.0,0.0
3623,0,3623,[272 297 315 303 213],334,5,16404,4.526490066225166,40.0,0.0
3624,0,3624,[215 295 250 218 508],92,4,16408,4.526344827586207,0.0,0.0
3625,0,3625,[272 297 315 303 213],334,5,16413,4.526475455046883,40.0,0.0
3626,0,3626,[272 297 315 303 213],894,5,16418,4.5266060104769785,40.0,0.0
3627,0,3627,[272 297 315 303 213],334,5,16423,4.526736493936053,40.0,0.0
3628,0,3628,[272 297 315 303 213],894,5,16428,4.526866905483605,40.0,0.0
3629,0,3629,[272 297 315 303 213],894,5,16433,4.526997245179063,40.0,0.0
3630,0,3630,[272 297 315 303 213],894,5,16438,4.527127513081796,40.0,0.0
3631,0,3631,[272 297 315 303 213],334,5,16443,4.527257709251101,40.0,0.0
3632,0,3632,[272 297 315 303 213],334,5,16448,4.527387833746215,40.0,0.0
3633,0,3633,[272 297 315 303 213],894,5,16453,4.527517886626307,40.0,0.0
3634,0,3634,[219 202 276 209 485],308,3,16456,4.527097661623109,0.0,20.0
3635,0,3635,[272 297 315 303 213],894,5,16461,4.5272277227722775,40.0,0.0
3636,0,3636,[272 297 315 303 213],894,5,16466,4.52735771240033,40.0,0.0
3637,0,3637,[272 297 315 303 213],894,5,16471,4.527487630566245,40.0,0.0
3638,0,3638,[272 297 315 303 213],894,5,16476,4.527617477328937,40.0,0.0
3639,0,3639,[272 297 315 303 213],894,5,16481,4.527747252747253,40.0,0.0
3640,0,3640,[272 297 315 303 213],894,5,16486,4.527876956879978,40.0,0.0
3641,0,3641,[272 297 315 303 213],894,5,16491,4.528006589785832,40.0,0.0
3642,0,3642,[272 297 315 303 213],894,5,16496,4.528136151523469,40.0,0.0
3643,0,3643,[272 297 315 303 213],894,5,16501,4.5282656421514815,40.0,0.0
3644,0,3644,[272 297 315 303 213],334,5,16506,4.5283950617283955,40.0,0.0
3645,0,3645,[272 297 315 303 213],894,5,16511,4.528524410312672,40.0,0.0
3646,0,3646,[208 315 350 275 336],13,2,16513,4.527831094049904,20.0,20.0
3647,0,3647,[272 297 315 303 213],894,5,16518,4.527960526315789,40.0,0.0
3648,0,3648,[213 429 431 222 508],653,1,16519,4.526993696903261,0.0,20.0
3649,0,3649,[272 297 315 303 213],894,5,16524,4.527123287671233,40.0,0.0
3650,0,3650,[272 297 315 303 213],334,5,16529,4.527252807450013,40.0,0.0
3651,0,3651,[272 297 315 303 213],894,5,16534,4.527382256297919,40.0,0.0
3652,0,3652,[272 297 315 303 213],334,5,16539,4.5275116342732,40.0,0.0
3653,0,3653,[272 297 315 303 213],334,5,16544,4.527640941434045,40.0,0.0
3654,0,3654,[272 297 315 303 213],894,5,16549,4.527770177838577,40.0,0.0
3655,0,3655,[268 227 239 301 236],334,2,16551,4.527078774617068,0.0,0.0
3656,0,3656,[272 297 315 303 213],894,5,16556,4.527208094066174,40.0,0.0
3657,0,3657,[272 297 315 303 213],894,5,16561,4.527337342810279,40.0,0.0
3658,0,3658,[272 297 315 303 213],894,5,16566,4.5274665209073515,40.0,0.0
3659,0,3659,[272 297 315 303 213],334,5,16571,4.527595628415301,40.0,0.0
3660,0,3660,[272 297 315 303 213],334,5,16576,4.527724665391969,40.0,0.0
3661,0,3661,[219 239 583 264 275],308,2,16578,4.527034407427635,0.0,20.0
3662,0,3662,[272 297 315 303 213],334,5,16583,4.527163527163527,40.0,0.0
3663,0,3663,[272 297 315 303 213],894,5,16588,4.527292576419214,40.0,0.0
3664,0,3664,[272 297 315 303 213],334,5,16593,4.5274215552523875,40.0,0.0
3665,0,3665,[202 208 272 367 206],650,3,16596,4.527004909983633,0.0,0.0
3666,0,3666,[223 222 209 208 226],92,4,16600,4.5268611944368695,20.0,20.0
3667,0,3667,[272 297 315 303 213],334,5,16605,4.526990185387132,40.0,0.0
3668,0,3668,[272 297 315 303 213],334,5,16610,4.52711910602344,40.0,0.0
3669,0,3669,[272 297 315 303 213],894,5,16615,4.5272479564032695,40.0,0.0
3670,0,3670,[272 297 315 303 213],894,5,16620,4.527376736584037,40.0,0.0
3671,0,3671,[272 297 315 303 213],894,5,16625,4.527505446623094,40.0,0.0
3672,0,3672,[272 297 315 303 213],894,5,16630,4.52763408657773,40.0,0.0
3673,0,3673,[326 227 255 239 254],378,1,16631,4.526673924877517,0.0,0.0
3674,0,3674,[272 297 315 303 213],894,5,16636,4.526802721088435,40.0,0.0
3675,0,3675,[272 297 315 303 213],334,5,16641,4.526931447225245,40.0,0.0
3676,0,3676,[272 297 315 303 213],334,5,16646,4.527060103345118,40.0,0.0
3677,0,3677,[272 297 315 303 213],894,5,16651,4.527188689505166,40.0,0.0
3678,0,3678,[272 297 315 303 213],894,5,16656,4.527317205762436,40.0,0.0
3679,0,3679,[272 297 315 303 213],894,5,16661,4.527445652173913,40.0,0.0
3680,0,3680,[272 297 315 303 213],334,5,16666,4.527574028796523,40.0,0.0
3681,0,3681,[272 297 315 303 213],894,5,16671,4.527702335687127,40.0,0.0
3682,0,3682,[272 297 315 303 213],334,5,16676,4.527830572902525,40.0,0.0
3683,0,3683,[272 297 315 303 213],894,5,16681,4.527958740499457,40.0,0.0
3684,0,3684,[272 297 315 303 213],334,5,16686,4.5280868385346,40.0,0.0
3685,0,3685,[315 213 283 508 264],894,2,16688,4.527400976668475,20.0,0.0
3686,0,3686,[272 297 315 303 213],334,5,16693,4.527529156495796,40.0,0.0
3687,0,3687,[272 297 315 303 213],894,5,16698,4.52765726681128,40.0,0.0
3688,0,3688,[272 297 315 303 213],894,5,16703,4.527785307671456,40.0,0.0
3689,0,3689,[272 297 315 303 213],334,5,16708,4.527913279132791,40.0,0.0
3690,0,3690,[272 297 315 303 213],894,5,16713,4.528041181251694,40.0,0.0
3691,0,3691,[272 297 315 303 213],894,5,16718,4.528169014084507,40.0,0.0
3692,0,3692,[272 297 315 303 213],334,5,16723,4.528296777687517,40.0,0.0
3693,0,3693,[272 297 315 303 213],894,5,16728,4.528424472116947,40.0,0.0
3694,0,3694,[272 297 315 303 213],334,5,16733,4.528552097428958,40.0,0.0
3695,0,3695,[272 297 315 303 213],334,5,16738,4.528679653679654,40.0,0.0
3696,0,3696,[221 226 216 378 508],533,4,16742,4.528536651338923,0.0,0.0
3697,0,3697,[272 297 315 303 213],894,5,16747,4.528664142779881,40.0,0.0
3698,0,3698,[272 297 315 303 213],334,5,16752,4.528791565287916,40.0,0.0
3699,0,3699,[272 297 315 303 213],894,5,16757,4.528918918918919,40.0,0.0
3700,0,3700,[367 250 230 246 431],387,1,16758,4.52796541475277,0.0,0.0
3701,0,3701,[272 297 315 303 213],334,5,16763,4.528092922744462,40.0,0.0
3702,0,3702,[272 297 315 303 213],894,5,16768,4.528220361868755,40.0,0.0
3703,0,3703,[272 297 315 303 213],894,5,16773,4.528347732181426,40.0,0.0
3704,0,3704,[272 297 315 303 213],334,5,16778,4.528475033738192,40.0,0.0
3705,0,3705,[275 202 259 201 452],308,3,16781,4.528062601187264,0.0,20.0
3706,0,3706,[272 297 315 303 213],334,5,16786,4.528189910979228,40.0,0.0
3707,0,3707,[272 297 315 303 213],334,5,16791,4.5283171521035595,40.0,0.0
3708,0,3708,[272 297 315 303 213],334,5,16796,4.5284443246157995,40.0,0.0
3709,0,3709,[272 297 315 303 213],334,5,16801,4.5285714285714285,40.0,0.0
3710,0,3710,[272 297 315 303 213],894,5,16806,4.528698464025869,40.0,0.0
3711,0,3711,[272 297 315 303 213],334,5,16811,4.528825431034483,40.0,0.0
3712,0,3712,[272 297 315 303 213],334,5,16816,4.528952329652572,40.0,0.0
3713,0,3713,[272 297 315 303 213],894,5,16821,4.52907915993538,40.0,0.0
3714,0,3714,[272 297 315 303 213],334,5,16826,4.529205921938089,40.0,0.0
3715,0,3715,[272 297 315 303 213],894,5,16831,4.529332615715823,40.0,0.0
3716,0,3716,[272 297 315 303 213],334,5,16836,4.529459241323648,40.0,0.0
3717,0,3717,[272 297 315 303 213],894,5,16841,4.529585798816568,40.0,0.0
3718,0,3718,[272 297 315 303 213],894,5,16846,4.529712288249529,40.0,0.0
3719,0,3719,[272 297 315 303 213],894,5,16851,4.52983870967742,40.0,0.0
3720,0,3720,[272 297 315 303 213],894,5,16856,4.529965063155066,40.0,0.0
3721,0,3721,[272 297 315 303 213],894,5,16861,4.530091348737238,40.0,0.0
3722,0,3722,[272 297 315 303 213],894,5,16866,4.530217566478647,40.0,0.0
3723,0,3723,[272 297 315 303 213],334,5,16871,4.530343716433942,40.0,0.0
3724,0,3724,[213 324 231 429 485],7,2,16873,4.529664429530201,0.0,0.0
3725,0,3725,[241 431 344 216 367],13,0,16873,4.528448738593666,0.0,0.0
3726,0,3726,[272 297 315 303 213],334,5,16878,4.528575261604508,40.0,0.0
3727,0,3727,[272 297 315 303 213],894,5,16883,4.5287017167381975,40.0,0.0
3728,0,3728,[272 297 315 303 213],894,5,16888,4.528828104049343,40.0,0.0
3729,0,3729,[272 297 315 303 213],894,5,16893,4.528954423592493,40.0,0.0
3730,0,3730,[272 297 315 303 213],894,5,16898,4.529080675422139,40.0,0.0
3731,0,3731,[272 297 315 303 213],334,5,16903,4.529206859592712,40.0,0.0
3732,0,3732,[272 297 315 303 213],334,5,16908,4.529332976158585,40.0,0.0
3733,0,3733,[272 297 315 303 213],334,5,16913,4.529459025174076,40.0,0.0
3734,0,3734,[272 297 315 303 213],894,5,16918,4.52958500669344,40.0,0.0
3735,0,3735,[272 297 315 303 213],894,5,16923,4.529710920770878,40.0,0.0
3736,0,3736,[272 297 315 303 213],894,5,16928,4.52983676746053,40.0,0.0
3737,0,3737,[272 297 315 303 213],894,5,16933,4.5299625468164795,40.0,0.0
3738,0,3738,[272 297 315 303 213],334,5,16938,4.530088258892752,40.0,0.0
3739,0,3739,[272 297 315 303 213],894,5,16943,4.530213903743316,40.0,0.0
3740,0,3740,[272 297 315 303 213],334,5,16948,4.53033948142208,40.0,0.0
3741,0,3741,[272 297 315 303 213],334,5,16953,4.530464991982897,40.0,0.0
3742,0,3742,[272 297 315 303 213],894,5,16958,4.530590435479562,40.0,0.0
3743,0,3743,[272 297 315 303 213],894,5,16963,4.530715811965812,40.0,0.0
3744,0,3744,[259 209 254 272 315],119,4,16967,4.530574098798398,20.0,0.0
3745,0,3745,[272 297 315 303 213],894,5,16972,4.530699412706888,40.0,0.0
3746,0,3746,[272 297 315 303 213],894,5,16977,4.530824659727783,40.0,0.0
3747,0,3747,[276 392 241 202 209],59,4,16981,4.53068303094984,0.0,20.0
3748,0,3748,[272 297 315 303 213],334,5,16986,4.530808215524139,40.0,0.0
3749,0,3749,[272 297 315 303 213],894,5,16991,4.5309333333333335,40.0,0.0
3750,0,3750,[272 297 315 303 213],894,5,16996,4.5310583844308185,40.0,0.0
3751,0,3751,[272 297 315 303 213],334,5,17001,4.531183368869936,40.0,0.0
3752,0,3752,[272 297 315 303 213],334,5,17006,4.53130828670397,40.0,0.0
3753,0,3753,[272 297 315 303 213],334,5,17011,4.5314331379861486,40.0,0.0
3754,0,3754,[259 291 230 211 478],85,2,17013,4.530758988015979,0.0,20.0
3755,0,3755,[272 297 315 303 213],334,5,17018,4.530883919062833,40.0,0.0
3756,0,3756,[272 297 315 303 213],894,5,17023,4.531008783603939,40.0,0.0
3757,0,3757,[272 297 315 303 213],334,5,17028,4.53113358169239,40.0,0.0
3758,0,3758,[272 297 315 303 213],334,5,17033,4.531258313381218,40.0,0.0
3759,0,3759,[272 297 315 303 213],894,5,17038,4.531382978723404,40.0,0.0
3760,0,3760,[272 297 315 303 213],334,5,17043,4.531507577771869,40.0,0.0
3761,0,3761,[272 297 315 303 213],334,5,17048,4.531632110579479,40.0,0.0
3762,0,3762,[272 297 315 303 213],894,5,17053,4.531756577199043,40.0,0.0
3763,0,3763,[290 336 316 275 213],894,3,17056,4.531349628055261,20.0,20.0
3764,0,3764,[272 297 315 303 213],334,5,17061,4.531474103585658,40.0,0.0
3765,0,3765,[272 297 315 303 213],894,5,17066,4.5315985130111525,40.0,0.0
3766,0,3766,[392 216 321 218 209],59,4,17070,4.531457393151048,0.0,0.0
3767,0,3767,[272 297 315 303 213],334,5,17075,4.5315817409766455,40.0,0.0
3768,0,3768,[272 297 315 303 213],894,5,17080,4.5317060228177235,40.0,0.0
3769,0,3769,[272 297 315 303 213],334,5,17085,4.531830238726791,40.0,0.0
3770,0,3770,[272 297 315 303 213],894,5,17090,4.531954388756298,40.0,0.0
3771,0,3771,[272 297 315 303 213],334,5,17095,4.532078472958642,40.0,0.0
3772,0,3772,[272 297 315 303 213],334,5,17100,4.5322024913861645,40.0,0.0
3773,0,3773,[272 297 315 303 213],894,5,17105,4.53232644409115,40.0,0.0
3774,0,3774,[272 297 315 303 213],334,5,17110,4.532450331125828,40.0,0.0
3775,0,3775,[272 297 315 303 213],334,5,17115,4.532574152542373,40.0,0.0
3776,0,3776,[272 297 315 303 213],334,5,17120,4.532697908392905,40.0,0.0
3777,0,3777,[272 297 315 303 213],894,5,17125,4.532821598729487,40.0,0.0
3778,0,3778,[272 297 315 303 213],894,5,17130,4.532945223604128,40.0,0.0
3779,0,3779,[272 297 315 303 213],334,5,17135,4.533068783068783,40.0,0.0
3780,0,3780,[272 297 315 303 213],894,5,17140,4.533192277175351,40.0,0.0
3781,0,3781,[507 243 336 431 211],13,1,17141,4.532258064516129,0.0,20.0
3782,0,3782,[272 297 315 303 213],894,5,17146,4.5323817076394395,40.0,0.0
3783,0,3783,[272 297 315 303 213],334,5,17151,4.532505285412262,40.0,0.0
3784,0,3784,[272 297 315 303 213],334,5,17156,4.532628797886393,40.0,0.0
3785,0,3785,[272 297 315 303 213],894,5,17161,4.532752245113576,40.0,0.0
3786,0,3786,[272 297 315 303 213],894,5,17166,4.532875627145498,40.0,0.0
3787,0,3787,[272 297 315 303 213],334,5,17171,4.532998944033791,40.0,0.0
3788,0,3788,[272 297 315 303 213],894,5,17176,4.5331221958300345,40.0,0.0
3789,0,3789,[272 297 315 303 213],894,5,17181,4.533245382585752,40.0,0.0
3790,0,3790,[272 297 315 303 213],334,5,17186,4.5333685043524135,40.0,0.0
3791,0,3791,[272 297 315 303 213],334,5,17191,4.533491561181434,40.0,0.0
3792,0,3792,[272 297 315 303 213],894,5,17196,4.533614553124176,40.0,0.0
3793,0,3793,[216 378 226 429 392],308,2,17198,4.532946758039009,0.0,0.0
3794,0,3794,[272 297 315 303 213],334,5,17203,4.533069828722002,40.0,0.0
3795,0,3795,[213 230 209 268 316],334,4,17207,4.532929399367756,20.0,0.0
3796,0,3796,[272 297 315 303 213],334,5,17212,4.533052409797208,40.0,0.0
3797,0,3797,[272 297 315 303 213],334,5,17217,4.533175355450237,40.0,0.0
3798,0,3798,[301 283 508 241 392],378,3,17220,4.532771782047908,0.0,0.0
3799,0,3799,[272 297 315 303 213],334,5,17225,4.532894736842105,40.0,0.0
3800,0,3800,[272 297 315 303 213],334,5,17230,4.533017626940278,40.0,0.0
3801,0,3801,[272 297 315 303 213],334,5,17235,4.533140452393477,40.0,0.0
3802,0,3802,[272 297 315 303 213],334,5,17240,4.533263213252695,40.0,0.0
3803,0,3803,[272 297 315 303 213],334,5,17245,4.533385909568874,40.0,0.0
3804,0,3804,[272 297 315 303 213],894,5,17250,4.533508541392904,40.0,0.0
3805,0,3805,[295 256 324 331 223],894,2,17252,4.532842879663689,20.0,0.0
3806,0,3806,[272 297 315 303 213],334,5,17257,4.532965589703179,40.0,0.0
3807,0,3807,[272 297 315 303 213],334,5,17262,4.533088235294118,40.0,0.0
3808,0,3808,[272 297 315 303 213],894,5,17267,4.533210816487267,40.0,0.0
3809,0,3809,[272 297 315 303 213],894,5,17272,4.533333333333333,40.0,0.0
3810,0,3810,[272 297 315 303 213],334,5,17277,4.53345578588297,40.0,0.0
3811,0,3811,[272 297 315 303 213],894,5,17282,4.533578174186778,40.0,0.0
3812,0,3812,[272 297 315 303 213],894,5,17287,4.533700498295306,40.0,0.0
3813,0,3813,[272 297 315 303 213],334,5,17292,4.533822758259046,40.0,0.0
3814,0,3814,[272 297 315 303 213],894,5,17297,4.53394495412844,40.0,0.0
3815,0,3815,[272 297 315 303 213],894,5,17302,4.534067085953878,40.0,0.0
3816,0,3816,[272 297 315 303 213],894,5,17307,4.534189153785696,40.0,0.0
3817,0,3817,[272 275 241 301 378],85,3,17310,4.533787323205867,0.0,20.0
3818,0,3818,[301 239 231 226 223],650,0,17310,4.532600157109191,20.0,0.0
3819,0,3819,[222 299 350 231 216],328,0,17310,4.531413612565445,0.0,20.0
3820,0,3820,[272 297 315 303 213],334,5,17315,4.531536247055745,40.0,0.0
3821,0,3821,[272 297 315 303 213],894,5,17320,4.531658817373103,40.0,0.0
3822,0,3822,[344 211 367 452 478],13,2,17322,4.530996599529166,0.0,20.0
3823,0,3823,[272 297 315 303 213],894,5,17327,4.531119246861925,40.0,0.0
3824,0,3824,[272 297 315 303 213],334,5,17332,4.531241830065359,40.0,0.0
3825,0,3825,[272 297 315 303 213],894,5,17337,4.531364349189754,40.0,0.0
3826,0,3826,[272 297 315 303 213],334,5,17342,4.531486804285341,40.0,0.0
3827,0,3827,[272 297 315 303 213],334,5,17347,4.531609195402299,40.0,0.0
3828,0,3828,[272 297 315 303 213],894,5,17352,4.531731522590754,40.0,0.0
3829,0,3829,[272 297 315 303 213],334,5,17357,4.5318537859007835,40.0,0.0
3830,0,3830,[272 297 315 303 213],334,5,17362,4.531975985382407,40.0,0.0
3831,0,3831,[272 297 315 303 213],334,5,17367,4.532098121085595,40.0,0.0
3832,0,3832,[298 264 259 284 231],308,2,17369,4.531437516305766,0.0,0.0
3833,0,3833,[272 297 315 303 213],894,5,17374,4.5315597287428275,40.0,0.0
3834,0,3834,[272 297 315 303 213],894,5,17379,4.53168187744459,40.0,0.0
3835,0,3835,[272 297 315 303 213],894,5,17384,4.531803962460897,40.0,0.0
3836,0,3836,[272 297 315 303 213],334,5,17389,4.531925983841543,40.0,0.0
3837,0,3837,[272 297 315 303 213],894,5,17394,4.532047941636269,40.0,0.0
3838,0,3838,[272 297 315 303 213],334,5,17399,4.532169835894765,40.0,0.0
3839,0,3839,[272 297 315 303 213],894,5,17404,4.532291666666667,40.0,0.0
3840,0,3840,[272 297 315 303 213],894,5,17409,4.532413434001562,40.0,0.0
3841,0,3841,[226 250 246 284 452],92,2,17411,4.531754294638209,0.0,0.0
3842,0,3842,[272 297 315 303 213],894,5,17416,4.531876138433516,40.0,0.0
3843,0,3843,[272 297 315 303 213],894,5,17421,4.531997918834548,40.0,0.0
3844,0,3844,[272 297 315 303 213],334,5,17426,4.532119635890767,40.0,0.0
3845,0,3845,[272 297 315 303 213],334,5,17431,4.532241289651586,40.0,0.0
3846,0,3846,[272 297 315 303 213],894,5,17436,4.532362880166364,40.0,0.0
3847,0,3847,[272 297 315 303 213],894,5,17441,4.532484407484407,40.0,0.0
3848,0,3848,[272 297 315 303 213],334,5,17446,4.532605871654975,40.0,0.0
3849,0,3849,[272 297 315 303 213],894,5,17451,4.532727272727273,40.0,0.0
3850,0,3850,[272 297 315 303 213],334,5,17456,4.532848610750454,40.0,0.0
3851,0,3851,[272 297 315 303 213],334,5,17461,4.532969885773624,40.0,0.0
3852,0,3852,[272 297 315 303 213],894,5,17466,4.533091097845834,40.0,0.0
3853,0,3853,[202 280 392 231 365],378,0,17466,4.531914893617022,0.0,0.0
3854,0,3854,[272 297 315 303 213],334,5,17471,4.532036316472114,40.0,0.0
3855,0,3855,[272 297 315 303 213],334,5,17476,4.532157676348548,40.0,0.0
3856,0,3856,[272 297 315 303 213],334,5,17481,4.532278973295307,40.0,0.0
3857,0,3857,[201 284 250 226 211],833,1,17482,4.531363400725764,0.0,20.0
3858,0,3858,[272 297 315 303 213],894,5,17487,4.531484840632288,40.0,0.0
3859,0,3859,[272 297 315 303 213],894,5,17492,4.53160621761658,40.0,0.0
3860,0,3860,[272 297 315 303 213],894,5,17497,4.531727531727531,40.0,0.0
3861,0,3861,[272 297 315 303 213],894,5,17502,4.531848783013983,40.0,0.0
3862,0,3862,[226 208 378 227 365],311,5,17507,4.531969971524722,0.0,0.0
3863,0,3863,[272 297 315 303 213],894,5,17512,4.532091097308489,40.0,0.0
3864,0,3864,[478 231 275 216 344],13,1,17513,4.53117723156533,0.0,20.0
3865,0,3865,[272 297 315 303 213],334,5,17518,4.531298499741335,40.0,0.0
3866,0,3866,[272 297 315 303 213],894,5,17523,4.531419705197828,40.0,0.0
3867,0,3867,[272 297 315 303 213],334,5,17528,4.531540847983454,40.0,0.0
3868,0,3868,[272 297 315 303 213],894,5,17533,4.531661928146808,40.0,0.0
3869,0,3869,[272 297 315 303 213],334,5,17538,4.531782945736434,40.0,0.0
3870,0,3870,[272 297 315 303 213],894,5,17543,4.531903900800827,40.0,0.0
3871,0,3871,[227 301 201 299 280],13,2,17545,4.53125,0.0,0.0
3872,0,3872,[272 297 315 303 213],894,5,17550,4.53137103020914,40.0,0.0
3873,0,3873,[272 297 315 303 213],334,5,17555,4.531491997934951,40.0,0.0
3874,0,3874,[272 297 315 303 213],334,5,17560,4.531612903225806,40.0,0.0
3875,0,3875,[272 297 315 303 213],894,5,17565,4.531733746130031,40.0,0.0
3876,0,3876,[272 297 315 303 213],334,5,17570,4.5318545266958985,40.0,0.0
3877,0,3877,[272 297 315 303 213],334,5,17575,4.531975244971635,40.0,0.0
3878,0,3878,[272 297 315 303 213],334,5,17580,4.532095901005413,40.0,0.0
3879,0,3879,[272 297 315 303 213],894,5,17585,4.532216494845361,40.0,0.0
3880,0,3880,[272 297 315 303 213],334,5,17590,4.532337026539552,40.0,0.0
3881,0,3881,[272 297 315 303 213],894,5,17595,4.532457496136012,40.0,0.0
3882,0,3882,[272 297 315 303 213],894,5,17600,4.53257790368272,40.0,0.0
3883,0,3883,[365 202 420 275 268],7,3,17603,4.532183316168898,0.0,20.0
3884,0,3884,[272 297 315 303 213],894,5,17608,4.532303732303732,40.0,0.0
3885,0,3885,[272 297 315 303 213],334,5,17613,4.53242408646423,40.0,0.0
3886,0,3886,[272 297 315 303 213],894,5,17618,4.5325443786982245,40.0,0.0
3887,0,3887,[272 297 315 303 213],894,5,17623,4.532664609053498,40.0,0.0
3888,0,3888,[272 297 315 303 213],334,5,17628,4.532784777577784,40.0,0.0
3889,0,3889,[272 297 315 303 213],894,5,17633,4.532904884318766,40.0,0.0
3890,0,3890,[272 297 315 303 213],894,5,17638,4.533024929324081,40.0,0.0
3891,0,3891,[272 297 315 303 213],334,5,17643,4.5331449126413155,40.0,0.0
3892,0,3892,[272 297 315 303 213],894,5,17648,4.533264834318007,40.0,0.0
3893,0,3893,[272 297 315 303 213],894,5,17653,4.533384694401644,40.0,0.0
3894,0,3894,[272 297 315 303 213],334,5,17658,4.533504492939667,40.0,0.0
3895,0,3895,[272 297 315 303 213],334,5,17663,4.533624229979466,40.0,0.0
3896,0,3896,[272 297 315 303 213],894,5,17668,4.533743905568386,40.0,0.0
3897,0,3897,[272 297 315 303 213],334,5,17673,4.53386351975372,40.0,0.0
3898,0,3898,[272 297 315 303 213],894,5,17678,4.533983072582713,40.0,0.0
3899,0,3899,[272 297 315 303 213],334,5,17683,4.5341025641025645,40.0,0.0
3900,0,3900,[272 297 315 303 213],334,5,17688,4.53422199436042,40.0,0.0
3901,0,3901,[202 268 241 217 223],13,3,17691,4.5338288057406455,20.0,0.0
3902,0,3902,[272 297 315 303 213],334,5,17696,4.53394824493979,40.0,0.0
3903,0,3903,[272 297 315 303 213],894,5,17701,4.53406762295082,40.0,0.0
3904,0,3904,[272 297 315 303 213],894,5,17706,4.534186939820743,40.0,0.0
3905,0,3905,[272 297 315 303 213],334,5,17711,4.5343061955965185,40.0,0.0
3906,0,3906,[272 297 315 303 213],894,5,17716,4.534425390325057,40.0,0.0
3907,0,3907,[272 297 315 303 213],894,5,17721,4.534544524053224,40.0,0.0
3908,0,3908,[272 297 315 303 213],894,5,17726,4.5346635968278335,40.0,0.0
3909,0,3909,[272 297 315 303 213],894,5,17731,4.534782608695652,40.0,0.0
3910,0,3910,[272 297 315 303 213],334,5,17736,4.534901559703401,40.0,0.0
3911,0,3911,[272 297 315 303 213],334,5,17741,4.53502044989775,40.0,0.0
3912,0,3912,[272 297 315 303 213],334,5,17746,4.535139279325326,40.0,0.0
3913,0,3913,[272 297 315 303 213],894,5,17751,4.535258048032703,40.0,0.0
3914,0,3914,[213 226 208 221 241],537,2,17753,4.534610472541507,0.0,0.0
3915,0,3915,[272 297 315 303 213],334,5,17758,4.534729315628192,40.0,0.0
3916,0,3916,[272 297 315 303 213],334,5,17763,4.53484809803421,40.0,0.0
3917,0,3917,[272 297 315 303 213],894,5,17768,4.534966819806024,40.0,0.0
3918,0,3918,[272 297 315 303 213],334,5,17773,4.535085480990048,40.0,0.0
3919,0,3919,[272 297 315 303 213],334,5,17778,4.535204081632653,40.0,0.0
3920,0,3920,[272 297 315 303 213],334,5,17783,4.535322621780158,40.0,0.0
3921,0,3921,[272 297 315 303 213],334,5,17788,4.535441101478837,40.0,0.0
3922,0,3922,[272 297 315 303 213],894,5,17793,4.5355595207749175,40.0,0.0
3923,0,3923,[272 297 315 303 213],334,5,17798,4.535677879714577,40.0,0.0
3924,0,3924,[272 297 315 303 213],894,5,17803,4.535796178343949,40.0,0.0
3925,0,3925,[272 297 315 303 213],334,5,17808,4.535914416709119,40.0,0.0
3926,0,3926,[272 297 315 303 213],334,5,17813,4.536032594856124,40.0,0.0
3927,0,3927,[272 297 315 303 213],334,5,17818,4.536150712830957,40.0,0.0
3928,0,3928,[272 297 315 303 213],334,5,17823,4.536268770679563,40.0,0.0
3929,0,3929,[272 297 315 303 213],334,5,17828,4.536386768447837,40.0,0.0
3930,0,3930,[272 297 315 303 213],334,5,17833,4.536504706181633,40.0,0.0
3931,0,3931,[344 227 331 280 201],13,2,17835,4.535859613428281,0.0,0.0
3932,0,3932,[272 297 315 303 213],894,5,17840,4.535977625222476,40.0,0.0
3933,0,3933,[272 297 315 303 213],894,5,17845,4.536095577020844,40.0,0.0
3934,0,3934,[272 297 315 303 213],334,5,17850,4.536213468869123,40.0,0.0
3935,0,3935,[272 297 315 303 213],334,5,17855,4.536331300813008,40.0,0.0
3936,0,3936,[272 297 315 303 213],894,5,17860,4.5364490728981455,40.0,0.0
3937,0,3937,[272 297 315 303 213],334,5,17865,4.5365667851701375,40.0,0.0
3938,0,3938,[272 297 315 303 213],334,5,17870,4.536684437674537,40.0,0.0
3939,0,3939,[272 297 315 303 213],334,5,17875,4.536802030456853,40.0,0.0
3940,0,3940,[272 297 315 303 213],334,5,17880,4.536919563562548,40.0,0.0
3941,0,3941,[272 297 315 303 213],894,5,17885,4.537037037037037,40.0,0.0
3942,0,3942,[344 217 222 509 367],13,1,17886,4.53613999492772,0.0,20.0
3943,0,3943,[272 297 315 303 213],334,5,17891,4.536257606490873,40.0,0.0
3944,0,3944,[272 297 315 303 213],894,5,17896,4.53637515842839,40.0,0.0
3945,0,3945,[272 297 315 303 213],894,5,17901,4.536492650785606,40.0,0.0
3946,0,3946,[272 297 315 303 213],334,5,17906,4.536610083607804,40.0,0.0
3947,0,3947,[272 297 315 303 213],334,5,17911,4.5367274569402225,40.0,0.0
3948,0,3948,[272 297 315 303 213],334,5,17916,4.536844770828058,40.0,0.0
3949,0,3949,[272 297 315 303 213],894,5,17921,4.5369620253164555,40.0,0.0
3950,0,3950,[272 297 315 303 213],894,5,17926,4.537079220450519,40.0,0.0
3951,0,3951,[272 297 315 303 213],334,5,17931,4.537196356275303,40.0,0.0
3952,0,3952,[222 485 509 481 291],474,5,17936,4.537313432835821,0.0,20.0
3953,0,3953,[272 297 315 303 213],334,5,17941,4.537430450177036,40.0,0.0
3954,0,3954,[272 297 315 303 213],894,5,17946,4.537547408343869,40.0,0.0
3955,0,3955,[272 297 315 303 213],894,5,17951,4.537664307381193,40.0,0.0
3956,0,3956,[272 297 315 303 213],894,5,17956,4.537781147333839,40.0,0.0
3957,0,3957,[431 326 367 365 226],311,3,17959,4.537392622536634,0.0,0.0
3958,0,3958,[272 297 315 303 213],894,5,17964,4.537509472088911,40.0,0.0
3959,0,3959,[272 297 315 303 213],894,5,17969,4.5376262626262625,40.0,0.0
3960,0,3960,[272 297 315 303 213],334,5,17974,4.537742994193385,40.0,0.0
3961,0,3961,[272 297 315 303 213],334,5,17979,4.537859666834932,40.0,0.0
3962,0,3962,[272 297 315 303 213],334,5,17984,4.537976280595508,40.0,0.0
3963,0,3963,[272 297 315 303 213],334,5,17989,4.538092835519677,40.0,0.0
3964,0,3964,[272 297 315 303 213],894,5,17994,4.538209331651955,40.0,0.0
3965,0,3965,[272 297 315 303 213],334,5,17999,4.538325769036813,40.0,0.0
3966,0,3966,[272 297 315 303 213],894,5,18004,4.538442147718679,40.0,0.0
3967,0,3967,[213 326 230 283 250],334,3,18007,4.538054435483871,0.0,0.0
3968,0,3968,[272 297 315 303 213],894,5,18012,4.5381708238851095,40.0,0.0
3969,0,3969,[272 297 315 303 213],894,5,18017,4.5382871536523925,40.0,0.0
3970,0,3970,[272 297 315 303 213],334,5,18022,4.538403424830018,40.0,0.0
3971,0,3971,[272 297 315 303 213],894,5,18027,4.538519637462236,40.0,0.0
3972,0,3972,[272 297 315 303 213],894,5,18032,4.538635791593254,40.0,0.0
3973,0,3973,[272 297 315 303 213],894,5,18037,4.538751887267237,40.0,0.0
3974,0,3974,[272 297 315 303 213],894,5,18042,4.538867924528302,40.0,0.0
3975,0,3975,[272 297 315 303 213],334,5,18047,4.538983903420523,40.0,0.0
3976,0,3976,[272 297 315 303 213],894,5,18052,4.5390998239879305,40.0,0.0
3977,0,3977,[272 297 315 303 213],334,5,18057,4.53921568627451,40.0,0.0
3978,0,3978,[272 297 315 303 213],334,5,18062,4.539331490324202,40.0,0.0
3979,0,3979,[272 297 315 303 213],334,5,18067,4.539447236180904,40.0,0.0
3980,0,3980,[272 297 315 303 213],894,5,18072,4.53956292388847,40.0,0.0
3981,0,3981,[272 297 315 303 213],894,5,18077,4.539678553490708,40.0,0.0
3982,0,3982,[272 297 315 303 213],334,5,18082,4.539794125031383,40.0,0.0
3983,0,3983,[272 297 315 303 213],894,5,18087,4.539909638554217,40.0,0.0
3984,0,3984,[272 297 315 303 213],894,5,18092,4.5400250941028855,40.0,0.0
3985,0,3985,[272 297 315 303 213],894,5,18097,4.540140491721024,40.0,0.0
3986,0,3986,[272 297 315 303 213],334,5,18102,4.54025583145222,40.0,0.0
3987,0,3987,[272 297 315 303 213],894,5,18107,4.54037111334002,40.0,0.0
3988,0,3988,[272 297 315 303 213],894,5,18112,4.540486337427927,40.0,0.0
3989,0,3989,[272 297 315 303 213],334,5,18117,4.540601503759398,40.0,0.0
3990,0,3990,[272 297 315 303 213],894,5,18122,4.54071661237785,40.0,0.0
3991,0,3991,[211 326 321 431 485],311,1,18123,4.539829659318637,0.0,20.0
3992,0,3992,[272 297 315 303 213],334,5,18128,4.539944903581267,40.0,0.0
3993,0,3993,[272 297 315 303 213],894,5,18133,4.540060090135203,40.0,0.0
3994,0,3994,[230 227 219 481 241],7,2,18135,4.539424280350438,0.0,0.0
3995,0,3995,[272 297 315 303 213],894,5,18140,4.53953953953954,40.0,0.0
3996,0,3996,[272 297 315 303 213],334,5,18145,4.5396547410557915,40.0,0.0
3997,0,3997,[272 297 315 303 213],894,5,18150,4.539769884942471,40.0,0.0
3998,0,3998,[272 297 315 303 213],334,5,18155,4.53988497124281,40.0,0.0
3999,0,3999,[272 297 315 303 213],334,5,18160,4.54,40.0,0.0
4000,1,0,[295 290 275 244 212],894,3,3,3.0,0.0,20.0
4001,1,1,[244 212 275 221 509],894,5,8,4.0,0.0,20.0
4002,1,2,[244 221 509 212 275],894,5,13,4.333333333333333,0.0,20.0
4003,1,3,[244 221 509 212 275],894,5,18,4.5,0.0,20.0
4004,1,4,[244 221 509 212 275],474,4,22,4.4,0.0,20.0
4005,1,5,[244 221 509 212 275],894,5,27,4.5,0.0,20.0
4006,1,6,[244 221 509 212 275],894,5,32,4.571428571428571,0.0,20.0
4007,1,7,[244 221 509 212 275],894,5,37,4.625,0.0,20.0
4008,1,8,[244 221 509 212 275],894,5,42,4.666666666666667,0.0,20.0
4009,1,9,[244 221 509 212 275],894,5,47,4.7,0.0,20.0
4010,1,10,[244 221 509 212 275],894,5,52,4.7272727272727275,0.0,20.0
4011,1,11,[275 303 216 209 478],6,4,56,4.666666666666667,0.0,20.0
4012,1,12,[244 221 509 209 212],474,5,61,4.6923076923076925,0.0,0.0
4013,1,13,[244 221 509 209 212],474,5,66,4.714285714285714,0.0,0.0
4014,1,14,[244 221 509 209 212],474,5,71,4.733333333333333,0.0,0.0
4015,1,15,[244 221 509 209 212],474,5,76,4.75,0.0,0.0
4016,1,16,[244 221 509 209 212],474,5,81,4.764705882352941,0.0,0.0
4017,1,17,[244 221 509 209 212],474,5,86,4.777777777777778,0.0,0.0
4018,1,18,[244 221 509 209 212],474,5,91,4.7894736842105265,0.0,0.0
4019,1,19,[244 221 509 209 212],474,5,96,4.8,0.0,0.0
4020,1,20,[244 221 509 209 212],474,5,101,4.809523809523809,0.0,0.0
4021,1,21,[413 326 231 507 241],13,0,101,4.590909090909091,0.0,0.0
4022,1,22,[244 221 509 209 212],474,5,106,4.608695652173913,0.0,0.0
4023,1,23,[244 221 509 209 212],474,5,111,4.625,0.0,0.0
4024,1,24,[244 221 509 209 212],474,5,116,4.64,0.0,0.0
4025,1,25,[244 221 509 209 212],474,5,121,4.653846153846154,0.0,0.0
4026,1,26,[227 250 295 240 218],92,2,123,4.555555555555555,0.0,0.0
4027,1,27,[250 478 216 509 218],339,3,126,4.5,0.0,0.0
4028,1,28,[250 478 509 209 212],339,5,131,4.517241379310345,0.0,0.0
4029,1,29,[250 478 509 209 212],85,3,134,4.466666666666667,0.0,0.0
4030,1,30,[478 509 209 244 221],474,5,139,4.483870967741935,0.0,0.0
4031,1,31,[478 509 209 244 221],474,5,144,4.5,0.0,0.0
4032,1,32,[215 478 212 216 206],234,1,145,4.393939393939394,0.0,0.0
4033,1,33,[481 291 206 284 209],234,3,148,4.352941176470588,0.0,0.0
4034,1,34,[241 226 243 316 211],13,3,151,4.314285714285714,20.0,20.0
4035,1,35,[413 301 261 507 300],13,0,151,4.194444444444445,0.0,20.0
4036,1,36,[301 239 217 220 290],334,0,151,4.081081081081081,0.0,0.0
4037,1,37,[284 481 378 485 507],308,2,153,4.026315789473684,0.0,0.0
4038,1,38,[316 244 221 509 209],474,5,158,4.051282051282051,20.0,0.0
4039,1,39,[209 241 431 213 420],295,5,163,4.075,0.0,0.0
4040,1,40,[211 213 221 316 244],474,5,168,4.097560975609756,20.0,20.0
4041,1,41,[211 213 221 316 244],474,5,173,4.119047619047619,20.0,20.0
4042,1,42,[211 213 221 316 244],474,5,178,4.1395348837209305,20.0,20.0
4043,1,43,[508 215 291 226 321],524,2,180,4.090909090909091,0.0,0.0
4044,1,44,[485 231 481 209 378],85,4,184,4.088888888888889,0.0,0.0
4045,1,45,[217 227 316 264 241],102,1,185,4.021739130434782,20.0,0.0
4046,1,46,[212 303 241 321 211],537,2,187,3.978723404255319,0.0,20.0
4047,1,47,[246 315 227 272 236],334,4,191,3.9791666666666665,20.0,0.0
4048,1,48,[236 211 509 508 209],537,4,195,3.979591836734694,0.0,20.0
4049,1,49,[246 211 509 508 209],643,4,199,3.98,0.0,20.0
4050,1,50,[246 211 508 209 431],387,3,202,3.9607843137254903,0.0,20.0
4051,1,51,[321 218 507 201 420],13,1,203,3.9038461538461537,0.0,0.0
4052,1,52,[244 215 284 241 392],271,1,204,3.849056603773585,0.0,0.0
4053,1,53,[452 230 202 215 300],313,3,207,3.8333333333333335,0.0,20.0
4054,1,54,[261 301 315 316 215],13,3,210,3.8181818181818183,40.0,0.0
4055,1,55,[206 213 209 508 211],406,2,212,3.7857142857142856,0.0,20.0
4056,1,56,[429 209 231 250 211],387,3,215,3.7719298245614037,0.0,20.0
4057,1,57,[217 241 223 431 219],92,3,218,3.7586206896551726,20.0,0.0
4058,1,58,[217 215 481 350 301],13,1,219,3.711864406779661,0.0,0.0
4059,1,59,[223 272 508 219 211],653,1,220,3.6666666666666665,20.0,20.0
4060,1,60,[321 202 208 215 367],234,2,222,3.639344262295082,0.0,0.0
4061,1,61,[478 413 485 202 394],13,2,224,3.6129032258064515,0.0,0.0
4062,1,62,[367 218 241 420 431],13,1,225,3.5714285714285716,0.0,0.0
4063,1,63,[299 223 326 303 250],894,3,228,3.5625,20.0,0.0
4064,1,64,[291 211 209 216 478],666,3,231,3.5538461538461537,0.0,20.0
4065,1,65,[284 509 365 378 295],308,2,233,3.5303030303030303,0.0,0.0
4066,1,66,[365 255 295 272 227],378,2,235,3.5074626865671643,0.0,0.0
4067,1,67,[268 239 221 297 209],334,3,238,3.5,20.0,0.0
4068,1,68,[226 429 283 202 259],234,1,239,3.463768115942029,0.0,0.0
4069,1,69,[507 227 315 202 241],13,3,242,3.4571428571428573,20.0,0.0
4070,1,70,[392 231 241 272 509],537,2,244,3.436619718309859,0.0,0.0
4071,1,71,[284 378 226 321 300],234,1,245,3.4027777777777777,0.0,20.0
4072,1,72,[299 300 211 202 420],13,3,248,3.3972602739726026,0.0,40.0
4073,1,73,[326 350 384 429 290],13,2,250,3.3783783783783785,0.0,0.0
4074,1,74,[226 276 209 227 365],311,4,254,3.3866666666666667,0.0,20.0
4075,1,75,[209 283 290 202 213],537,3,257,3.3815789473684212,0.0,0.0
4076,1,76,[290 215 485 420 212],650,0,257,3.3376623376623376,0.0,0.0
4077,1,77,[272 315 255 297 208],334,4,261,3.3461538461538463,40.0,0.0
4078,1,78,[272 315 297 208 276],334,5,266,3.367088607594937,40.0,20.0
4079,1,79,[272 315 297 208 276],334,5,271,3.3875,40.0,20.0
4080,1,80,[222 297 236 218 255],334,3,274,3.382716049382716,20.0,20.0
4081,1,81,[276 221 272 297 315],334,5,279,3.402439024390244,40.0,20.0
4082,1,82,[276 221 272 297 315],894,5,284,3.4216867469879517,40.0,20.0
4083,1,83,[276 221 272 297 315],334,5,289,3.4404761904761907,40.0,20.0
4084,1,84,[209 290 291 208 378],537,2,291,3.4235294117647057,0.0,0.0
4085,1,85,[230 241 583 275 284],524,2,293,3.4069767441860463,0.0,20.0
4086,1,86,[321 431 384 429 390],279,4,297,3.413793103448276,0.0,0.0
4087,1,87,[452 222 413 508 230],774,0,297,3.375,0.0,20.0
4088,1,88,[212 215 206 211 478],650,3,300,3.3707865168539324,0.0,20.0
4089,1,89,[250 201 509 209 216],279,2,302,3.3555555555555556,0.0,0.0
4090,1,90,[223 217 384 227 431],833,1,303,3.32967032967033,20.0,0.0
4091,1,91,[241 219 303 208 507],13,2,305,3.3152173913043477,0.0,0.0
4092,1,92,[268 221 297 315 272],116,2,307,3.3010752688172045,40.0,0.0
4093,1,93,[211 202 344 300 223],13,3,310,3.297872340425532,20.0,40.0
4094,1,94,[509 321 217 280 367],13,2,312,3.2842105263157895,0.0,0.0
4095,1,95,[295 291 255 298 293],533,2,314,3.2708333333333335,0.0,0.0
4096,1,96,[267 209 218 206 384],833,3,317,3.268041237113402,0.0,0.0
4097,1,97,[429 217 241 231 227],387,1,318,3.2448979591836733,0.0,0.0
4098,1,98,[350 321 429 507 261],13,1,319,3.2222222222222223,0.0,0.0
4099,1,99,[275 215 246 222 301],85,3,322,3.22,0.0,40.0
4100,1,100,[216 300 293 298 299],145,3,325,3.217821782178218,0.0,20.0
4101,1,101,[276 219 481 211 429],308,4,329,3.2254901960784315,0.0,40.0
4102,1,102,[321 276 326 226 209],311,2,331,3.2135922330097086,0.0,20.0
4103,1,103,[315 291 485 284 208],537,2,333,3.201923076923077,20.0,0.0
4104,1,104,[280 213 255 272 217],378,3,336,3.2,0.0,0.0
4105,1,105,[508 202 201 239 226],537,1,337,3.1792452830188678,0.0,0.0
4106,1,106,[326 217 209 261 367],13,0,337,3.149532710280374,0.0,0.0
4107,1,107,[222 223 217 218 261],13,1,338,3.1296296296296298,20.0,20.0
4108,1,108,[429 300 241 239 217],64,1,339,3.110091743119266,0.0,20.0
4109,1,109,[485 211 478 226 217],650,2,341,3.1,0.0,20.0
4110,1,110,[201 239 275 208 272],537,3,344,3.099099099099099,0.0,20.0
4111,1,111,[429 507 367 208 293],385,2,346,3.0892857142857144,0.0,0.0
4112,1,112,[272 299 209 212 478],537,3,349,3.088495575221239,0.0,0.0
4113,1,113,[231 208 201 256 367],385,3,352,3.087719298245614,0.0,0.0
4114,1,114,[231 384 429 219 227],254,2,354,3.0782608695652174,0.0,0.0
4115,1,115,[583 213 378 431 324],7,2,356,3.0689655172413794,0.0,0.0
4116,1,116,[256 268 276 221 244],894,3,359,3.0683760683760686,0.0,20.0
4117,1,117,[202 218 300 211 367],234,1,360,3.0508474576271185,0.0,40.0
4118,1,118,[221 276 244 509 272],271,1,361,3.033613445378151,0.0,20.0
4119,1,119,[216 220 508 431 239],92,3,364,3.033333333333333,0.0,0.0
4120,1,120,[221 509 244 478 315],474,5,369,3.049586776859504,20.0,0.0
4121,1,121,[221 509 244 478 315],474,5,374,3.0655737704918034,20.0,0.0
4122,1,122,[280 255 283 509 250],894,2,376,3.0569105691056913,0.0,0.0
4123,1,123,[221 509 244 478 315],474,5,381,3.0725806451612905,20.0,0.0
4124,1,124,[221 509 244 478 315],474,5,386,3.088,20.0,0.0
4125,1,125,[221 509 244 478 315],474,5,391,3.1031746031746033,20.0,0.0
4126,1,126,[275 316 485 324 223],334,4,395,3.1102362204724407,40.0,20.0
4127,1,127,[221 509 244 478 315],474,5,400,3.125,20.0,0.0
4128,1,128,[276 367 268 485 259],234,1,401,3.108527131782946,0.0,20.0
4129,1,129,[221 509 244 478 315],474,5,406,3.123076923076923,20.0,0.0
4130,1,130,[221 509 244 478 315],474,5,411,3.1374045801526718,20.0,0.0
4131,1,131,[298 268 216 321 209],6,2,413,3.128787878787879,0.0,0.0
4132,1,132,[221 509 244 478 315],474,5,418,3.142857142857143,20.0,0.0
4133,1,133,[231 246 230 202 232],387,0,418,3.1194029850746268,0.0,0.0
4134,1,134,[221 509 244 478 315],474,5,423,3.1333333333333333,20.0,0.0
4135,1,135,[221 509 478 244 315],474,5,428,3.1470588235294117,20.0,0.0
4136,1,136,[221 509 478 244 315],474,5,433,3.1605839416058394,20.0,0.0
4137,1,137,[221 509 478 315 244],474,5,438,3.1739130434782608,20.0,0.0
4138,1,138,[221 509 478 315 244],474,5,443,3.1870503597122304,20.0,0.0
4139,1,139,[221 478 509 315 244],474,5,448,3.2,20.0,0.0
4140,1,140,[478 420 216 217 219],406,3,451,3.198581560283688,0.0,0.0
4141,1,141,[221 478 509 315 244],474,5,456,3.211267605633803,20.0,0.0
4142,1,142,[478 236 217 231 223],343,4,460,3.2167832167832167,20.0,0.0
4143,1,143,[227 220 209 485 219],59,2,462,3.2083333333333335,0.0,0.0
4144,1,144,[221 478 315 509 244],474,5,467,3.220689655172414,20.0,0.0
4145,1,145,[221 478 315 509 244],474,5,472,3.232876712328767,20.0,0.0
4146,1,146,[293 326 246 283 227],334,2,474,3.2244897959183674,0.0,0.0
4147,1,147,[221 478 315 509 244],474,5,479,3.2364864864864864,20.0,0.0
4148,1,148,[221 478 315 509 244],474,5,484,3.248322147651007,20.0,0.0
4149,1,149,[221 478 315 509 244],474,5,489,3.26,20.0,0.0
4150,1,150,[221 478 315 509 244],474,5,494,3.271523178807947,20.0,0.0
4151,1,151,[221 478 315 509 244],474,5,499,3.2828947368421053,20.0,0.0
4152,1,152,[209 321 298 239 429],387,1,500,3.2679738562091503,0.0,0.0
4153,1,153,[336 384 215 452 231],13,1,501,3.2532467532467533,0.0,0.0
4154,1,154,[221 478 315 509 244],474,5,506,3.264516129032258,20.0,0.0
4155,1,155,[221 478 315 509 244],474,5,511,3.2756410256410255,20.0,0.0
4156,1,156,[221 478 315 509 244],474,5,516,3.286624203821656,20.0,0.0
4157,1,157,[215 226 485 222 239],524,0,516,3.2658227848101267,0.0,20.0
4158,1,158,[246 250 236 220 280],486,0,516,3.2452830188679247,0.0,0.0
4159,1,159,[221 478 315 509 244],474,5,521,3.25625,20.0,0.0
4160,1,160,[212 378 303 206 509],537,2,523,3.248447204968944,0.0,0.0
4161,1,161,[326 230 301 217 429],334,2,525,3.240740740740741,0.0,0.0
4162,1,162,[221 478 315 509 244],474,5,530,3.2515337423312882,20.0,0.0
4163,1,163,[221 478 315 509 244],474,5,535,3.2621951219512195,20.0,0.0
4164,1,164,[509 300 212 246 316],85,2,537,3.2545454545454544,20.0,20.0
4165,1,165,[239 230 420 223 215],378,3,540,3.253012048192771,20.0,0.0
4166,1,166,[221 478 315 509 244],474,5,545,3.2634730538922154,20.0,0.0
4167,1,167,[221 478 315 509 244],474,5,550,3.2738095238095237,20.0,0.0
4168,1,168,[221 478 315 509 244],474,5,555,3.2840236686390534,20.0,0.0
4169,1,169,[367 291 218 284 208],308,4,559,3.288235294117647,0.0,0.0
4170,1,170,[221 478 315 509 244],474,5,564,3.2982456140350878,20.0,0.0
4171,1,171,[221 478 315 509 244],474,5,569,3.308139534883721,20.0,0.0
4172,1,172,[221 478 315 509 244],474,5,574,3.3179190751445087,20.0,0.0
4173,1,173,[221 478 315 509 244],474,5,579,3.3275862068965516,20.0,0.0
4174,1,174,[221 478 315 509 244],474,5,584,3.337142857142857,20.0,0.0
4175,1,175,[221 478 315 509 244],474,5,589,3.346590909090909,20.0,0.0
4176,1,176,[221 478 315 509 244],474,5,594,3.3559322033898304,20.0,0.0
4177,1,177,[221 478 315 509 244],474,5,599,3.365168539325843,20.0,0.0
4178,1,178,[221 478 315 509 244],474,5,604,3.374301675977654,20.0,0.0
4179,1,179,[221 478 315 509 244],474,5,609,3.3833333333333333,20.0,0.0
4180,1,180,[221 478 315 509 244],474,5,614,3.3922651933701657,20.0,0.0
4181,1,181,[221 478 315 509 244],474,5,619,3.401098901098901,20.0,0.0
4182,1,182,[221 478 315 509 244],474,5,624,3.4098360655737703,20.0,0.0
4183,1,183,[221 478 315 509 244],474,5,629,3.4184782608695654,20.0,0.0
4184,1,184,[221 478 315 509 244],474,5,634,3.427027027027027,20.0,0.0
4185,1,185,[221 478 315 509 244],474,5,639,3.435483870967742,20.0,0.0
4186,1,186,[221 478 315 509 244],474,5,644,3.443850267379679,20.0,0.0
4187,1,187,[384 275 218 276 227],13,2,646,3.4361702127659575,0.0,40.0
4188,1,188,[221 478 315 509 244],474,5,651,3.4444444444444446,20.0,0.0
4189,1,189,[221 478 315 509 244],474,5,656,3.4526315789473685,20.0,0.0
4190,1,190,[321 295 215 230 209],387,1,657,3.43979057591623,0.0,0.0
4191,1,191,[246 298 272 212 509],85,4,661,3.4427083333333335,0.0,0.0
4192,1,192,[221 478 315 509 244],474,5,666,3.4507772020725387,20.0,0.0
4193,1,193,[221 478 315 509 244],474,5,671,3.4587628865979383,20.0,0.0
4194,1,194,[315 206 215 208 478],537,3,674,3.4564102564102566,20.0,0.0
4195,1,195,[230 509 264 336 344],13,2,676,3.4489795918367347,0.0,0.0
4196,1,196,[221 478 315 509 244],474,5,681,3.4568527918781724,20.0,0.0
4197,1,197,[220 295 280 217 272],378,1,682,3.4444444444444446,0.0,0.0
4198,1,198,[221 478 315 509 244],474,5,687,3.4522613065326633,20.0,0.0
4199,1,199,[221 478 315 509 244],474,5,692,3.46,20.0,0.0
4200,1,200,[221 478 315 509 244],474,5,697,3.4676616915422884,20.0,0.0
4201,1,201,[365 202 259 284 218],308,3,700,3.4653465346534653,0.0,0.0
4202,1,202,[221 478 315 509 244],474,5,705,3.4729064039408866,20.0,0.0
4203,1,203,[221 478 315 509 244],474,5,710,3.480392156862745,20.0,0.0
4204,1,204,[276 230 211 217 202],13,3,713,3.478048780487805,0.0,40.0
4205,1,205,[221 478 315 509 244],474,5,718,3.4854368932038833,20.0,0.0
4206,1,206,[215 239 202 378 367],650,0,718,3.468599033816425,0.0,0.0
4207,1,207,[232 216 222 301 452],13,0,718,3.451923076923077,0.0,20.0
4208,1,208,[221 478 315 509 244],474,5,723,3.45933014354067,20.0,0.0
4209,1,209,[221 478 315 509 244],474,5,728,3.466666666666667,20.0,0.0
4210,1,210,[221 478 315 509 244],474,5,733,3.4739336492890995,20.0,0.0
4211,1,211,[221 478 315 509 244],474,5,738,3.481132075471698,20.0,0.0
4212,1,212,[221 478 315 509 244],474,5,743,3.488262910798122,20.0,0.0
4213,1,213,[221 478 315 509 244],474,5,748,3.4953271028037385,20.0,0.0
4214,1,214,[221 478 315 509 244],474,5,753,3.5023255813953487,20.0,0.0
4215,1,215,[221 478 315 509 244],474,5,758,3.509259259259259,20.0,0.0
4216,1,216,[221 478 315 509 244],474,5,763,3.5161290322580645,20.0,0.0
4217,1,217,[221 478 315 509 244],474,5,768,3.522935779816514,20.0,0.0
4218,1,218,[239 212 276 378 241],537,1,769,3.5114155251141552,0.0,20.0
4219,1,219,[221 478 315 509 244],474,5,774,3.518181818181818,20.0,0.0
4220,1,220,[221 478 315 509 244],474,5,779,3.524886877828054,20.0,0.0
4221,1,221,[221 478 315 509 244],474,5,784,3.5315315315315314,20.0,0.0
4222,1,222,[230 507 264 223 394],13,2,786,3.524663677130045,20.0,0.0
4223,1,223,[365 226 295 298 284],749,3,789,3.5223214285714284,0.0,0.0
4224,1,224,[212 392 241 367 202],59,4,793,3.5244444444444443,0.0,0.0
4225,1,225,[221 478 315 509 244],474,5,798,3.5309734513274336,20.0,0.0
4226,1,226,[221 478 315 509 244],474,5,803,3.537444933920705,20.0,0.0
4227,1,227,[221 478 315 509 244],474,5,808,3.543859649122807,20.0,0.0
4228,1,228,[221 478 315 509 244],474,5,813,3.550218340611354,20.0,0.0
4229,1,229,[221 478 315 509 244],474,5,818,3.5565217391304347,20.0,0.0
4230,1,230,[239 324 211 243 367],387,2,820,3.54978354978355,0.0,20.0
4231,1,231,[429 230 259 239 301],537,0,820,3.5344827586206895,0.0,0.0
4232,1,232,[221 478 315 509 244],474,5,825,3.540772532188841,20.0,0.0
4233,1,233,[336 201 219 216 485],13,0,825,3.5256410256410255,0.0,0.0
4234,1,234,[221 478 315 509 244],474,5,830,3.5319148936170213,20.0,0.0
4235,1,235,[221 478 315 509 244],474,5,835,3.538135593220339,20.0,0.0
4236,1,236,[221 478 315 509 244],474,5,840,3.5443037974683542,20.0,0.0
4237,1,237,[221 478 315 509 244],474,5,845,3.5504201680672267,20.0,0.0
4238,1,238,[221 478 315 509 244],474,5,850,3.5564853556485354,20.0,0.0
4239,1,239,[221 478 315 509 244],474,5,855,3.5625,20.0,0.0
4240,1,240,[221 478 315 509 244],474,5,860,3.5684647302904566,20.0,0.0
4241,1,241,[221 478 315 509 244],474,5,865,3.574380165289256,20.0,0.0
4242,1,242,[221 478 315 509 244],474,5,870,3.580246913580247,20.0,0.0
4243,1,243,[221 478 315 509 244],474,5,875,3.5860655737704916,20.0,0.0
4244,1,244,[276 321 299 344 208],13,2,877,3.5795918367346937,0.0,20.0
4245,1,245,[221 478 315 509 244],474,5,882,3.5853658536585367,20.0,0.0
4246,1,246,[221 478 315 509 244],474,5,887,3.591093117408907,20.0,0.0
4247,1,247,[221 478 315 509 244],474,5,892,3.596774193548387,20.0,0.0
4248,1,248,[221 478 315 509 244],474,5,897,3.602409638554217,20.0,0.0
4249,1,249,[243 481 223 367 213],234,2,899,3.596,20.0,0.0
4250,1,250,[221 478 315 509 244],474,5,904,3.601593625498008,20.0,0.0
4251,1,251,[221 478 315 509 244],474,5,909,3.607142857142857,20.0,0.0
4252,1,252,[221 478 315 509 244],474,5,914,3.6126482213438735,20.0,0.0
4253,1,253,[221 478 315 509 244],474,5,919,3.6181102362204722,20.0,0.0
4254,1,254,[221 478 315 509 244],474,5,924,3.623529411764706,20.0,0.0
4255,1,255,[239 326 485 316 268],13,3,927,3.62109375,20.0,0.0
4256,1,256,[221 478 315 509 244],474,5,932,3.6264591439688716,20.0,0.0
4257,1,257,[221 478 315 509 244],474,5,937,3.631782945736434,20.0,0.0
4258,1,258,[221 478 315 509 244],474,5,942,3.637065637065637,20.0,0.0
4259,1,259,[221 478 315 509 244],474,5,947,3.6423076923076922,20.0,0.0
4260,1,260,[221 478 315 509 244],474,5,952,3.6475095785440614,20.0,0.0
4261,1,261,[509 298 246 301 250],85,4,956,3.648854961832061,0.0,0.0
4262,1,262,[221 478 315 509 244],474,5,961,3.653992395437262,20.0,0.0
4263,1,263,[221 478 315 509 244],474,5,966,3.659090909090909,20.0,0.0
4264,1,264,[221 478 315 509 244],474,5,971,3.6641509433962263,20.0,0.0
4265,1,265,[221 478 315 509 244],474,5,976,3.669172932330827,20.0,0.0
4266,1,266,[283 298 275 208 509],308,4,980,3.6704119850187267,0.0,20.0
4267,1,267,[221 478 315 509 244],474,5,985,3.675373134328358,20.0,0.0
4268,1,268,[221 478 315 509 244],474,5,990,3.680297397769517,20.0,0.0
4269,1,269,[221 478 315 509 244],474,5,995,3.685185185185185,20.0,0.0
4270,1,270,[221 478 315 509 244],474,5,1000,3.690036900369004,20.0,0.0
4271,1,271,[221 478 315 509 244],474,5,1005,3.6948529411764706,20.0,0.0
4272,1,272,[221 478 315 509 244],474,5,1010,3.6996336996337,20.0,0.0
4273,1,273,[221 478 315 509 244],474,5,1015,3.704379562043796,20.0,0.0
4274,1,274,[221 478 315 509 244],474,5,1020,3.709090909090909,20.0,0.0
4275,1,275,[208 431 293 240 232],774,1,1021,3.699275362318841,0.0,0.0
4276,1,276,[221 478 315 509 244],474,5,1026,3.703971119133574,20.0,0.0
4277,1,277,[276 275 315 243 478],537,4,1030,3.7050359712230216,20.0,40.0
4278,1,278,[221 478 315 509 244],474,5,1035,3.7096774193548385,20.0,0.0
4279,1,279,[212 280 315 201 336],13,3,1038,3.7071428571428573,20.0,0.0
4280,1,280,[221 478 315 509 244],474,5,1043,3.711743772241993,20.0,0.0
4281,1,281,[221 478 315 509 244],474,5,1048,3.7163120567375887,20.0,0.0
4282,1,282,[221 478 315 509 244],474,5,1053,3.7208480565371023,20.0,0.0
4283,1,283,[221 478 315 509 244],474,5,1058,3.7253521126760565,20.0,0.0
4284,1,284,[508 290 331 478 232],13,2,1060,3.719298245614035,0.0,0.0
4285,1,285,[221 478 315 509 244],474,5,1065,3.7237762237762237,20.0,0.0
4286,1,286,[221 478 315 509 244],474,5,1070,3.7282229965156795,20.0,0.0
4287,1,287,[264 226 331 299 315],13,3,1073,3.7256944444444446,20.0,0.0
4288,1,288,[293 316 350 213 298],894,3,1076,3.7231833910034604,20.0,0.0
4289,1,289,[221 478 315 509 244],474,5,1081,3.7275862068965515,20.0,0.0
4290,1,290,[221 478 315 509 244],474,5,1086,3.731958762886598,20.0,0.0
4291,1,291,[300 219 239 290 222],13,2,1088,3.7260273972602738,0.0,40.0
4292,1,292,[212 509 300 431 478],13,3,1091,3.7235494880546076,0.0,20.0
4293,1,293,[221 478 315 509 244],474,5,1096,3.727891156462585,20.0,0.0
4294,1,294,[275 222 239 272 508],334,3,1099,3.7254237288135594,0.0,40.0
4295,1,295,[221 478 315 509 244],474,5,1104,3.72972972972973,20.0,0.0
4296,1,296,[478 208 216 230 315],13,3,1107,3.727272727272727,20.0,0.0
4297,1,297,[221 478 315 509 244],474,5,1112,3.7315436241610738,20.0,0.0
4298,1,298,[221 478 315 509 244],474,5,1117,3.7357859531772575,20.0,0.0
4299,1,299,[227 413 232 481 216],13,1,1118,3.7266666666666666,0.0,0.0
4300,1,300,[221 478 315 509 244],474,5,1123,3.7308970099667773,20.0,0.0
4301,1,301,[221 478 315 509 244],474,5,1128,3.7350993377483444,20.0,0.0
4302,1,302,[221 478 315 509 244],474,5,1133,3.7392739273927393,20.0,0.0
4303,1,303,[221 478 315 509 244],474,5,1138,3.7434210526315788,20.0,0.0
4304,1,304,[221 478 315 509 244],474,5,1143,3.7475409836065574,20.0,0.0
4305,1,305,[239 509 215 284 213],318,3,1146,3.7450980392156863,0.0,0.0
4306,1,306,[221 478 315 509 244],474,5,1151,3.749185667752443,20.0,0.0
4307,1,307,[221 478 315 509 244],474,5,1156,3.7532467532467533,20.0,0.0
4308,1,308,[221 478 315 509 244],474,5,1161,3.7572815533980584,20.0,0.0
4309,1,309,[221 478 315 509 244],474,5,1166,3.761290322580645,20.0,0.0
4310,1,310,[221 478 315 509 244],474,5,1171,3.765273311897106,20.0,0.0
4311,1,311,[221 478 315 509 244],474,5,1176,3.769230769230769,20.0,0.0
4312,1,312,[221 478 315 509 244],474,5,1181,3.7731629392971247,20.0,0.0
4313,1,313,[221 478 315 509 244],474,5,1186,3.7770700636942673,20.0,0.0
4314,1,314,[221 478 315 509 244],474,5,1191,3.780952380952381,20.0,0.0
4315,1,315,[221 478 315 509 244],474,5,1196,3.7848101265822787,20.0,0.0
4316,1,316,[220 316 301 283 293],334,2,1198,3.779179810725552,20.0,0.0
4317,1,317,[221 478 315 509 244],474,5,1203,3.7830188679245285,20.0,0.0
4318,1,318,[272 220 215 241 208],90,3,1206,3.780564263322884,0.0,0.0
4319,1,319,[221 478 315 509 244],474,5,1211,3.784375,20.0,0.0
4320,1,320,[221 478 315 509 244],474,5,1216,3.7881619937694704,20.0,0.0
4321,1,321,[221 478 315 509 244],474,5,1221,3.7919254658385095,20.0,0.0
4322,1,322,[221 478 315 509 244],474,5,1226,3.7956656346749225,20.0,0.0
4323,1,323,[221 478 315 509 244],474,5,1231,3.799382716049383,20.0,0.0
4324,1,324,[221 478 315 509 244],474,5,1236,3.8030769230769232,20.0,0.0
4325,1,325,[226 275 212 299 213],537,2,1238,3.7975460122699385,0.0,20.0
4326,1,326,[221 478 315 509 244],474,5,1243,3.801223241590214,20.0,0.0
4327,1,327,[365 217 215 326 220],378,1,1244,3.792682926829268,0.0,0.0
4328,1,328,[221 478 315 509 244],474,5,1249,3.7963525835866263,20.0,0.0
4329,1,329,[221 478 315 509 244],474,5,1254,3.8,20.0,0.0
4330,1,330,[221 478 315 509 244],474,5,1259,3.8036253776435047,20.0,0.0
4331,1,331,[221 478 315 509 244],474,5,1264,3.8072289156626504,20.0,0.0
4332,1,332,[221 478 315 509 244],474,5,1269,3.810810810810811,20.0,0.0
4333,1,333,[221 478 315 509 244],474,5,1274,3.81437125748503,20.0,0.0
4334,1,334,[221 478 315 509 244],474,5,1279,3.817910447761194,20.0,0.0
4335,1,335,[221 478 315 509 244],474,5,1284,3.8214285714285716,20.0,0.0
4336,1,336,[485 219 509 259 216],7,3,1287,3.8189910979228485,0.0,0.0
4337,1,337,[221 478 315 509 244],474,5,1292,3.8224852071005917,20.0,0.0
4338,1,338,[221 478 315 509 244],474,5,1297,3.825958702064897,20.0,0.0
4339,1,339,[213 508 239 226 583],524,3,1300,3.823529411764706,0.0,0.0
4340,1,340,[221 478 315 509 244],474,5,1305,3.8269794721407626,20.0,0.0
4341,1,341,[221 478 315 509 244],474,5,1310,3.8304093567251463,20.0,0.0
4342,1,342,[221 478 315 509 244],474,5,1315,3.8338192419825075,20.0,0.0
4343,1,343,[350 367 268 481 222],13,1,1316,3.8255813953488373,0.0,20.0
4344,1,344,[221 478 315 509 244],474,5,1321,3.8289855072463768,20.0,0.0
4345,1,345,[221 478 315 509 244],474,5,1326,3.832369942196532,20.0,0.0
4346,1,346,[221 478 315 509 244],474,5,1331,3.835734870317003,20.0,0.0
4347,1,347,[221 478 315 509 244],474,5,1336,3.839080459770115,20.0,0.0
4348,1,348,[221 478 315 509 244],474,5,1341,3.842406876790831,20.0,0.0
4349,1,349,[221 478 315 509 244],474,5,1346,3.8457142857142856,20.0,0.0
4350,1,350,[221 478 315 509 244],474,5,1351,3.849002849002849,20.0,0.0
4351,1,351,[221 478 315 509 244],474,5,1356,3.852272727272727,20.0,0.0
4352,1,352,[221 478 315 509 244],474,5,1361,3.855524079320113,20.0,0.0
4353,1,353,[221 478 315 509 244],474,5,1366,3.8587570621468927,20.0,0.0
4354,1,354,[221 478 315 509 244],474,5,1371,3.8619718309859157,20.0,0.0
4355,1,355,[221 478 315 509 244],474,5,1376,3.865168539325843,20.0,0.0
4356,1,356,[221 478 315 509 244],474,5,1381,3.8683473389355743,20.0,0.0
4357,1,357,[221 478 315 509 244],474,5,1386,3.8715083798882683,20.0,0.0
4358,1,358,[221 478 315 509 244],474,5,1391,3.8746518105849583,20.0,0.0
4359,1,359,[208 452 331 243 230],13,1,1392,3.8666666666666667,0.0,0.0
4360,1,360,[209 208 216 217 213],406,1,1393,3.858725761772853,0.0,0.0
4361,1,361,[221 478 315 509 244],474,5,1398,3.861878453038674,20.0,0.0
4362,1,362,[221 478 315 509 244],474,5,1403,3.8650137741046833,20.0,0.0
4363,1,363,[221 478 315 509 244],474,5,1408,3.868131868131868,20.0,0.0
4364,1,364,[221 478 315 509 244],474,5,1413,3.871232876712329,20.0,0.0
4365,1,365,[293 240 216 217 485],339,3,1416,3.8688524590163933,0.0,0.0
4366,1,366,[290 293 223 303 280],894,3,1419,3.8664850136239783,20.0,0.0
4367,1,367,[221 478 315 509 244],474,5,1424,3.869565217391304,20.0,0.0
4368,1,368,[221 478 315 509 244],474,5,1429,3.872628726287263,20.0,0.0
4369,1,369,[221 478 315 509 244],474,5,1434,3.8756756756756756,20.0,0.0
4370,1,370,[221 478 315 509 244],474,5,1439,3.8787061994609164,20.0,0.0
4371,1,371,[221 478 315 509 244],474,5,1444,3.881720430107527,20.0,0.0
4372,1,372,[221 478 315 509 244],474,5,1449,3.8847184986595176,20.0,0.0
4373,1,373,[221 478 315 509 244],474,5,1454,3.8877005347593583,20.0,0.0
4374,1,374,[221 478 315 509 244],474,5,1459,3.8906666666666667,20.0,0.0
4375,1,375,[221 478 315 509 244],474,5,1464,3.893617021276596,20.0,0.0
4376,1,376,[221 478 315 509 244],474,5,1469,3.896551724137931,20.0,0.0
4377,1,377,[221 478 315 509 244],474,5,1474,3.8994708994708995,20.0,0.0
4378,1,378,[221 478 315 509 244],474,5,1479,3.9023746701846966,20.0,0.0
4379,1,379,[221 478 315 509 244],474,5,1484,3.905263157894737,20.0,0.0
4380,1,380,[378 250 291 508 298],833,2,1486,3.900262467191601,0.0,0.0
4381,1,381,[213 300 291 211 231],85,2,1488,3.8952879581151834,0.0,40.0
4382,1,382,[221 478 315 509 244],474,5,1493,3.898172323759791,20.0,0.0
4383,1,383,[221 478 315 509 244],474,5,1498,3.9010416666666665,20.0,0.0
4384,1,384,[221 478 315 509 244],474,5,1503,3.9038961038961038,20.0,0.0
4385,1,385,[221 478 315 509 244],474,5,1508,3.906735751295337,20.0,0.0
4386,1,386,[221 478 315 509 244],474,5,1513,3.909560723514212,20.0,0.0
4387,1,387,[221 478 315 509 244],474,5,1518,3.9123711340206184,20.0,0.0
4388,1,388,[221 478 315 509 244],474,5,1523,3.9151670951156814,20.0,0.0
4389,1,389,[221 478 315 509 244],474,5,1528,3.917948717948718,20.0,0.0
4390,1,390,[221 478 315 509 244],474,5,1533,3.920716112531969,20.0,0.0
4391,1,391,[221 478 315 509 244],474,5,1538,3.923469387755102,20.0,0.0
4392,1,392,[221 478 315 509 244],474,5,1543,3.926208651399491,20.0,0.0
4393,1,393,[221 478 315 509 244],474,5,1548,3.9289340101522843,20.0,0.0
4394,1,394,[221 478 315 509 244],474,5,1553,3.9316455696202532,20.0,0.0
4395,1,395,[221 478 315 509 244],474,5,1558,3.9343434343434343,20.0,0.0
4396,1,396,[221 478 315 509 244],474,5,1563,3.9370277078085643,20.0,0.0
4397,1,397,[221 478 315 509 244],474,5,1568,3.9396984924623117,20.0,0.0
4398,1,398,[221 478 315 509 244],474,5,1573,3.9423558897243107,20.0,0.0
4399,1,399,[221 478 315 509 244],474,5,1578,3.945,20.0,0.0
4400,1,400,[221 478 315 509 244],474,5,1583,3.947630922693267,20.0,0.0
4401,1,401,[221 478 315 509 244],474,5,1588,3.9502487562189055,20.0,0.0
4402,1,402,[431 429 301 290 378],537,1,1589,3.9429280397022333,0.0,0.0
4403,1,403,[297 239 275 378 222],533,4,1593,3.9430693069306932,20.0,40.0
4404,1,404,[221 478 315 509 244],474,5,1598,3.945679012345679,20.0,0.0
4405,1,405,[221 478 315 509 244],474,5,1603,3.9482758620689653,20.0,0.0
4406,1,406,[298 246 300 485 507],85,4,1607,3.9484029484029484,0.0,20.0
4407,1,407,[221 478 315 509 244],474,5,1612,3.950980392156863,20.0,0.0
4408,1,408,[221 478 315 509 244],474,5,1617,3.9535452322738385,20.0,0.0
4409,1,409,[221 478 315 509 244],474,5,1622,3.9560975609756097,20.0,0.0
4410,1,410,[221 478 315 509 244],474,5,1627,3.9586374695863746,20.0,0.0
4411,1,411,[507 216 212 300 272],13,2,1629,3.953883495145631,0.0,20.0
4412,1,412,[221 478 315 509 244],474,5,1634,3.956416464891041,20.0,0.0
4413,1,413,[231 211 384 239 290],13,3,1637,3.9541062801932365,0.0,20.0
4414,1,414,[218 478 384 209 316],13,2,1639,3.9493975903614458,20.0,0.0
4415,1,415,[221 478 315 509 244],474,5,1644,3.951923076923077,20.0,0.0
4416,1,416,[221 478 315 509 244],474,5,1649,3.9544364508393284,20.0,0.0
4417,1,417,[221 478 315 509 244],474,5,1654,3.9569377990430623,20.0,0.0
4418,1,418,[290 276 283 250 324],894,2,1656,3.952267303102625,0.0,20.0
4419,1,419,[221 478 315 509 244],474,5,1661,3.954761904761905,20.0,0.0
4420,1,420,[217 481 216 223 202],7,4,1665,3.954869358669834,20.0,0.0
4421,1,421,[221 478 315 509 244],474,5,1670,3.957345971563981,20.0,0.0
4422,1,422,[221 478 315 509 244],474,5,1675,3.9598108747044916,20.0,0.0
4423,1,423,[215 378 431 298 300],843,0,1675,3.9504716981132075,0.0,20.0
4424,1,424,[221 478 315 509 244],474,5,1680,3.9529411764705884,20.0,0.0
4425,1,425,[221 478 315 509 244],474,5,1685,3.955399061032864,20.0,0.0
4426,1,426,[221 478 315 509 244],474,5,1690,3.9578454332552693,20.0,0.0
4427,1,427,[221 478 315 509 244],474,5,1695,3.960280373831776,20.0,0.0
4428,1,428,[218 208 293 326 507],474,3,1698,3.958041958041958,0.0,0.0
4429,1,429,[221 478 315 509 244],474,5,1703,3.9604651162790696,20.0,0.0
4430,1,430,[213 276 223 208 218],194,2,1705,3.9559164733178656,20.0,20.0
4431,1,431,[226 208 365 378 223],749,4,1709,3.9560185185185186,20.0,0.0
4432,1,432,[218 452 429 367 211],406,3,1712,3.953810623556582,0.0,20.0
4433,1,433,[221 478 315 509 244],474,5,1717,3.956221198156682,20.0,0.0
4434,1,434,[221 478 315 509 244],474,5,1722,3.9586206896551723,20.0,0.0
4435,1,435,[221 478 315 509 244],474,5,1727,3.9610091743119265,20.0,0.0
4436,1,436,[230 213 254 420 367],378,2,1729,3.9565217391304346,0.0,0.0
4437,1,437,[221 478 315 509 244],474,5,1734,3.958904109589041,20.0,0.0
4438,1,438,[221 478 315 509 244],474,5,1739,3.9612756264236904,20.0,0.0
4439,1,439,[221 478 315 509 244],474,5,1744,3.963636363636364,20.0,0.0
4440,1,440,[221 478 315 509 244],474,5,1749,3.9659863945578233,20.0,0.0
4441,1,441,[221 478 315 509 244],474,5,1754,3.9683257918552037,20.0,0.0
4442,1,442,[221 478 315 509 244],474,5,1759,3.9706546275395036,20.0,0.0
4443,1,443,[221 478 315 509 244],474,5,1764,3.972972972972973,20.0,0.0
4444,1,444,[221 478 315 509 244],474,5,1769,3.9752808988764046,20.0,0.0
4445,1,445,[221 478 315 509 244],474,5,1774,3.977578475336323,20.0,0.0
4446,1,446,[221 478 315 509 244],474,5,1779,3.9798657718120807,20.0,0.0
4447,1,447,[221 478 315 509 244],474,5,1784,3.982142857142857,20.0,0.0
4448,1,448,[221 478 315 509 244],474,5,1789,3.9844097995545655,20.0,0.0
4449,1,449,[221 478 315 509 244],474,5,1794,3.986666666666667,20.0,0.0
4450,1,450,[221 478 315 509 244],474,5,1799,3.988913525498891,20.0,0.0
4451,1,451,[221 478 315 509 244],474,5,1804,3.9911504424778763,20.0,0.0
4452,1,452,[221 478 315 509 244],474,5,1809,3.993377483443709,20.0,0.0
4453,1,453,[218 478 208 321 481],13,2,1811,3.988986784140969,0.0,0.0
4454,1,454,[221 478 315 509 244],474,5,1816,3.9912087912087912,20.0,0.0
4455,1,455,[221 478 315 509 244],474,5,1821,3.9934210526315788,20.0,0.0
4456,1,456,[221 478 315 509 244],474,5,1826,3.9956236323851204,20.0,0.0
4457,1,457,[221 478 315 509 244],474,5,1831,3.997816593886463,20.0,0.0
4458,1,458,[299 241 208 268 206],537,2,1833,3.9934640522875817,0.0,0.0
4459,1,459,[250 508 301 268 321],486,2,1835,3.989130434782609,0.0,0.0
4460,1,460,[221 478 315 509 244],474,5,1840,3.9913232104121477,20.0,0.0
4461,1,461,[221 478 315 509 244],474,5,1845,3.9935064935064934,20.0,0.0
4462,1,462,[583 378 241 239 211],308,3,1848,3.9913606911447084,0.0,20.0
4463,1,463,[241 394 420 276 384],13,2,1850,3.9870689655172415,0.0,20.0
4464,1,464,[221 478 315 509 244],474,5,1855,3.989247311827957,20.0,0.0
4465,1,465,[221 478 315 509 244],474,5,1860,3.9914163090128754,20.0,0.0
4466,1,466,[221 478 315 509 244],474,5,1865,3.993576017130621,20.0,0.0
4467,1,467,[221 478 315 509 244],474,5,1870,3.9957264957264957,20.0,0.0
4468,1,468,[221 478 315 509 244],474,5,1875,3.997867803837953,20.0,0.0
4469,1,469,[215 276 218 250 213],346,0,1875,3.9893617021276597,0.0,20.0
4470,1,470,[221 478 315 509 244],474,5,1880,3.991507430997877,20.0,0.0
4471,1,471,[221 478 315 509 244],474,5,1885,3.9936440677966103,20.0,0.0
4472,1,472,[221 478 315 509 244],474,5,1890,3.995771670190275,20.0,0.0
4473,1,473,[221 478 315 509 244],474,5,1895,3.99789029535865,20.0,0.0
4474,1,474,[384 429 202 221 509],271,3,1898,3.9957894736842103,0.0,0.0
4475,1,475,[478 315 509 221 244],474,5,1903,3.9978991596638656,20.0,0.0
4476,1,476,[478 315 509 221 244],474,5,1908,4.0,20.0,0.0
4477,1,477,[478 315 509 221 244],474,5,1913,4.002092050209205,20.0,0.0
4478,1,478,[478 315 509 221 244],474,5,1918,4.004175365344468,20.0,0.0
4479,1,479,[478 315 509 221 244],474,5,1923,4.00625,20.0,0.0
4480,1,480,[478 315 509 221 244],474,5,1928,4.008316008316008,20.0,0.0
4481,1,481,[276 507 283 429 378],537,3,1931,4.0062240663900415,0.0,20.0
4482,1,482,[478 315 509 221 244],474,5,1936,4.008281573498965,20.0,0.0
4483,1,483,[212 284 275 300 431],537,2,1938,4.0041322314049586,0.0,40.0
4484,1,484,[478 315 509 221 244],474,5,1943,4.006185567010309,20.0,0.0
4485,1,485,[478 315 509 221 244],474,5,1948,4.008230452674897,20.0,0.0
4486,1,486,[209 431 230 222 239],804,4,1952,4.008213552361396,0.0,20.0
4487,1,487,[478 315 509 221 244],474,5,1957,4.010245901639344,20.0,0.0
4488,1,488,[209 216 226 223 481],234,2,1959,4.006134969325154,20.0,0.0
4489,1,489,[478 315 509 221 244],474,5,1964,4.0081632653061225,20.0,0.0
4490,1,490,[201 209 231 255 452],308,3,1967,4.006109979633401,0.0,0.0
4491,1,491,[478 315 509 221 244],474,5,1972,4.008130081300813,20.0,0.0
4492,1,492,[478 315 509 221 244],474,5,1977,4.0101419878296145,20.0,0.0
4493,1,493,[478 315 509 221 244],474,5,1982,4.012145748987854,20.0,0.0
4494,1,494,[478 315 509 221 244],474,5,1987,4.014141414141414,20.0,0.0
4495,1,495,[250 246 284 255 293],486,0,1987,4.006048387096774,0.0,0.0
4496,1,496,[478 315 509 221 244],474,5,1992,4.00804828973843,20.0,0.0
4497,1,497,[293 378 344 291 384],833,2,1994,4.004016064257028,0.0,0.0
4498,1,498,[478 315 509 221 244],474,5,1999,4.006012024048096,20.0,0.0
4499,1,499,[478 315 509 221 244],474,5,2004,4.008,20.0,0.0
4500,1,500,[478 315 509 221 244],474,5,2009,4.009980039920159,20.0,0.0
4501,1,501,[478 315 509 221 244],474,5,2014,4.01195219123506,20.0,0.0
4502,1,502,[478 315 509 221 244],474,5,2019,4.013916500994036,20.0,0.0
4503,1,503,[478 315 509 221 244],474,5,2024,4.015873015873016,20.0,0.0
4504,1,504,[222 215 243 291 284],92,3,2027,4.013861386138614,0.0,20.0
4505,1,505,[478 315 509 221 244],474,5,2032,4.015810276679842,20.0,0.0
4506,1,506,[478 315 509 221 244],474,5,2037,4.017751479289941,20.0,0.0
4507,1,507,[478 315 509 221 244],474,5,2042,4.019685039370079,20.0,0.0
4508,1,508,[478 315 509 221 244],474,5,2047,4.0216110019646365,20.0,0.0
4509,1,509,[478 315 509 221 244],474,5,2052,4.023529411764706,20.0,0.0
4510,1,510,[478 315 509 221 244],474,5,2057,4.025440313111546,20.0,0.0
4511,1,511,[227 268 226 276 216],92,2,2059,4.021484375,0.0,20.0
4512,1,512,[478 315 509 221 244],474,5,2064,4.023391812865497,20.0,0.0
4513,1,513,[478 315 509 221 244],474,5,2069,4.025291828793774,20.0,0.0
4514,1,514,[478 315 509 221 244],474,5,2074,4.027184466019418,20.0,0.0
4515,1,515,[478 315 509 221 244],474,5,2079,4.02906976744186,20.0,0.0
4516,1,516,[509 429 230 276 212],13,4,2083,4.029013539651838,0.0,20.0
4517,1,517,[478 315 509 221 244],474,5,2088,4.030888030888031,20.0,0.0
4518,1,518,[478 315 509 221 244],474,5,2093,4.032755298651252,20.0,0.0
4519,1,519,[478 315 509 221 244],474,5,2098,4.0346153846153845,20.0,0.0
4520,1,520,[478 315 509 221 244],474,5,2103,4.036468330134357,20.0,0.0
4521,1,521,[478 315 509 221 244],474,5,2108,4.038314176245211,20.0,0.0
4522,1,522,[478 315 509 221 244],474,5,2113,4.040152963671128,20.0,0.0
4523,1,523,[321 215 301 275 223],378,3,2116,4.038167938931298,20.0,20.0
4524,1,524,[478 315 509 221 244],474,5,2121,4.04,20.0,0.0
4525,1,525,[478 315 509 221 244],474,5,2126,4.0418250950570345,20.0,0.0
4526,1,526,[413 226 268 230 216],13,2,2128,4.0379506641366225,0.0,0.0
4527,1,527,[478 315 509 221 244],474,5,2133,4.0397727272727275,20.0,0.0
4528,1,528,[507 222 508 212 290],537,2,2135,4.0359168241965975,0.0,20.0
4529,1,529,[478 315 509 221 244],474,5,2140,4.037735849056604,20.0,0.0
4530,1,530,[478 315 509 221 244],474,5,2145,4.03954802259887,20.0,0.0
4531,1,531,[478 315 509 221 244],474,5,2150,4.041353383458647,20.0,0.0
4532,1,532,[367 264 478 212 420],13,4,2154,4.041275797373358,0.0,0.0
4533,1,533,[226 232 301 350 509],13,2,2156,4.037453183520599,0.0,0.0
4534,1,534,[211 219 217 208 230],650,3,2159,4.035514018691589,0.0,20.0
4535,1,535,[478 315 509 221 244],474,5,2164,4.037313432835821,20.0,0.0
4536,1,536,[478 315 509 221 244],474,5,2169,4.039106145251397,20.0,0.0
4537,1,537,[478 315 509 221 244],474,5,2174,4.04089219330855,20.0,0.0
4538,1,538,[478 315 509 221 244],474,5,2179,4.042671614100185,20.0,0.0
4539,1,539,[478 315 509 221 244],474,5,2184,4.044444444444444,20.0,0.0
4540,1,540,[478 315 509 221 244],474,5,2189,4.046210720887246,20.0,0.0
4541,1,541,[478 315 509 221 244],474,5,2194,4.047970479704797,20.0,0.0
4542,1,542,[478 315 509 221 244],474,5,2199,4.0497237569060776,20.0,0.0
4543,1,543,[478 315 509 221 244],474,5,2204,4.051470588235294,20.0,0.0
4544,1,544,[478 315 509 221 244],474,5,2209,4.053211009174312,20.0,0.0
4545,1,545,[478 315 509 221 244],474,5,2214,4.054945054945055,20.0,0.0
4546,1,546,[478 315 509 221 244],474,5,2219,4.056672760511883,20.0,0.0
4547,1,547,[478 315 509 221 244],474,5,2224,4.0583941605839415,20.0,0.0
4548,1,548,[478 315 509 221 244],474,5,2229,4.060109289617486,20.0,0.0
4549,1,549,[267 378 219 218 429],833,2,2231,4.056363636363637,0.0,0.0
4550,1,550,[478 315 509 221 244],474,5,2236,4.058076225045372,20.0,0.0
4551,1,551,[478 315 509 221 244],474,5,2241,4.059782608695652,20.0,0.0
4552,1,552,[478 315 509 221 244],474,5,2246,4.061482820976492,20.0,0.0
4553,1,553,[478 315 509 221 244],474,5,2251,4.063176895306859,20.0,0.0
4554,1,554,[478 315 509 221 244],474,5,2256,4.064864864864865,20.0,0.0
4555,1,555,[221 268 231 284 290],537,1,2257,4.059352517985611,0.0,0.0
4556,1,556,[507 300 239 336 219],13,1,2258,4.053859964093357,0.0,20.0
4557,1,557,[478 315 509 244 221],474,5,2263,4.055555555555555,20.0,0.0
4558,1,558,[230 326 275 209 215],311,3,2266,4.053667262969588,0.0,20.0
4559,1,559,[478 315 509 244 221],474,5,2271,4.055357142857143,20.0,0.0
4560,1,560,[478 315 509 244 221],474,5,2276,4.057040998217468,20.0,0.0
4561,1,561,[478 315 509 244 221],474,5,2281,4.0587188612099645,20.0,0.0
4562,1,562,[211 231 284 413 222],279,2,2283,4.0550621669627,0.0,40.0
4563,1,563,[478 315 509 244 221],474,5,2288,4.056737588652482,20.0,0.0
4564,1,564,[478 315 509 244 221],474,5,2293,4.058407079646018,20.0,0.0
4565,1,565,[478 315 509 244 221],474,5,2298,4.060070671378092,20.0,0.0
4566,1,566,[478 315 509 244 221],474,5,2303,4.061728395061729,20.0,0.0
4567,1,567,[478 315 509 244 221],474,5,2308,4.063380281690141,20.0,0.0
4568,1,568,[478 315 509 244 221],474,5,2313,4.065026362038664,20.0,0.0
4569,1,569,[478 315 509 244 221],474,5,2318,4.066666666666666,20.0,0.0
4570,1,570,[478 315 509 244 221],474,5,2323,4.0683012259194395,20.0,0.0
4571,1,571,[508 300 316 218 209],13,1,2324,4.062937062937063,20.0,20.0
4572,1,572,[478 315 509 244 221],474,5,2329,4.06457242582897,20.0,0.0
4573,1,573,[478 315 509 244 221],474,5,2334,4.066202090592334,20.0,0.0
4574,1,574,[478 315 509 244 221],474,5,2339,4.067826086956522,20.0,0.0
4575,1,575,[478 315 509 244 221],474,5,2344,4.069444444444445,20.0,0.0
4576,1,576,[202 244 232 293 222],158,3,2347,4.067590987868284,0.0,20.0
4577,1,577,[478 315 509 244 221],474,5,2352,4.069204152249135,20.0,0.0
4578,1,578,[478 315 509 244 221],474,5,2357,4.070811744386874,20.0,0.0
4579,1,579,[478 315 509 244 221],474,5,2362,4.072413793103448,20.0,0.0
4580,1,580,[478 315 509 244 221],474,5,2367,4.074010327022375,20.0,0.0
4581,1,581,[275 507 221 429 226],537,2,2369,4.070446735395189,0.0,20.0
4582,1,582,[478 315 509 244 221],474,5,2374,4.072041166380789,20.0,0.0
4583,1,583,[478 315 509 244 221],474,5,2379,4.073630136986301,20.0,0.0
4584,1,584,[478 315 509 244 221],474,5,2384,4.075213675213675,20.0,0.0
4585,1,585,[478 315 509 244 221],474,5,2389,4.07679180887372,20.0,0.0
4586,1,586,[378 300 227 367 226],892,4,2393,4.076660988074957,0.0,20.0
4587,1,587,[478 315 509 244 221],474,5,2398,4.078231292517007,20.0,0.0
4588,1,588,[478 315 509 244 221],474,5,2403,4.079796264855688,20.0,0.0
4589,1,589,[367 218 291 230 216],804,4,2407,4.079661016949153,0.0,0.0
4590,1,590,[478 315 509 244 221],474,5,2412,4.081218274111675,20.0,0.0
4591,1,591,[485 231 232 300 331],13,0,2412,4.074324324324325,0.0,20.0
4592,1,592,[478 315 509 244 221],474,5,2417,4.075885328836425,20.0,0.0
4593,1,593,[215 478 243 232 217],650,1,2418,4.070707070707071,0.0,0.0
4594,1,594,[478 315 509 244 221],474,5,2423,4.072268907563025,20.0,0.0
4595,1,595,[478 315 509 244 221],474,5,2428,4.073825503355705,20.0,0.0
4596,1,596,[478 315 509 244 221],474,5,2433,4.075376884422111,20.0,0.0
4597,1,597,[478 315 509 244 221],474,5,2438,4.076923076923077,20.0,0.0
4598,1,598,[478 315 509 244 221],474,5,2443,4.078464106844741,20.0,0.0
4599,1,599,[478 315 509 244 221],474,5,2448,4.08,20.0,0.0
4600,1,600,[201 226 413 283 301],279,4,2452,4.079866888519135,0.0,0.0
4601,1,601,[478 315 509 244 221],474,5,2457,4.0813953488372094,20.0,0.0
4602,1,602,[261 478 350 231 507],13,1,2458,4.076285240464345,0.0,0.0
4603,1,603,[478 315 509 244 221],474,5,2463,4.077814569536423,20.0,0.0
4604,1,604,[478 315 509 244 221],474,5,2468,4.079338842975207,20.0,0.0
4605,1,605,[478 315 509 244 221],474,5,2473,4.080858085808581,20.0,0.0
4606,1,606,[255 254 365 276 295],308,2,2475,4.077429983525535,0.0,20.0
4607,1,607,[206 298 202 324 201],833,4,2479,4.077302631578948,0.0,0.0
4608,1,608,[478 315 509 244 221],474,5,2484,4.078817733990148,20.0,0.0
4609,1,609,[478 315 509 244 221],474,5,2489,4.080327868852459,20.0,0.0
4610,1,610,[478 315 509 244 221],474,5,2494,4.081833060556465,20.0,0.0
4611,1,611,[392 431 300 227 384],64,1,2495,4.076797385620915,0.0,20.0
4612,1,612,[478 315 509 244 221],474,5,2500,4.078303425774878,20.0,0.0
4613,1,613,[478 315 509 244 221],474,5,2505,4.079804560260587,20.0,0.0
4614,1,614,[478 315 509 244 221],474,5,2510,4.08130081300813,20.0,0.0
4615,1,615,[431 321 226 217 202],387,0,2510,4.074675324675325,0.0,0.0
4616,1,616,[478 315 509 244 221],474,5,2515,4.076175040518638,20.0,0.0
4617,1,617,[478 315 509 244 221],474,5,2520,4.077669902912621,20.0,0.0
4618,1,618,[284 321 227 365 213],378,1,2521,4.072697899838449,0.0,0.0
4619,1,619,[478 315 509 244 221],474,5,2526,4.074193548387097,20.0,0.0
4620,1,620,[478 315 509 244 221],474,5,2531,4.0756843800322065,20.0,0.0
4621,1,621,[478 315 509 244 221],474,5,2536,4.077170418006431,20.0,0.0
4622,1,622,[299 280 509 243 276],13,3,2539,4.075441412520064,0.0,20.0
4623,1,623,[219 485 290 216 231],13,1,2540,4.07051282051282,0.0,0.0
4624,1,624,[211 272 301 300 303],537,3,2543,4.0688,0.0,40.0
4625,1,625,[384 452 217 206 324],833,1,2544,4.063897763578275,0.0,0.0
4626,1,626,[478 315 509 244 221],474,5,2549,4.065390749601276,20.0,0.0
4627,1,627,[478 315 509 244 221],474,5,2554,4.06687898089172,20.0,0.0
4628,1,628,[478 315 509 244 221],474,5,2559,4.068362480127186,20.0,0.0
4629,1,629,[478 315 509 244 221],474,5,2564,4.06984126984127,20.0,0.0
4630,1,630,[478 315 509 244 221],474,5,2569,4.071315372424722,20.0,0.0
4631,1,631,[478 315 509 244 221],474,5,2574,4.072784810126582,20.0,0.0
4632,1,632,[478 202 219 227 344],13,3,2577,4.071090047393365,0.0,0.0
4633,1,633,[478 315 509 244 221],474,5,2582,4.072555205047319,20.0,0.0
4634,1,634,[230 264 481 223 276],13,3,2585,4.070866141732283,20.0,20.0
4635,1,635,[478 315 509 244 221],474,5,2590,4.072327044025157,20.0,0.0
4636,1,636,[478 315 509 244 221],474,5,2595,4.073783359497646,20.0,0.0
4637,1,637,[231 226 280 227 230],13,3,2598,4.072100313479623,0.0,0.0
4638,1,638,[478 315 509 244 221],474,5,2603,4.073552425665102,20.0,0.0
4639,1,639,[216 243 241 261 413],13,0,2603,4.0671875,0.0,0.0
4640,1,640,[478 315 509 244 221],474,5,2608,4.068642745709829,20.0,0.0
4641,1,641,[431 209 392 213 241],311,3,2611,4.066978193146418,0.0,0.0
4642,1,642,[478 315 509 244 221],474,5,2616,4.0684292379471225,20.0,0.0
4643,1,643,[478 315 509 244 221],474,5,2621,4.069875776397516,20.0,0.0
4644,1,644,[478 315 509 244 221],474,5,2626,4.071317829457365,20.0,0.0
4645,1,645,[478 315 509 244 221],474,5,2631,4.072755417956657,20.0,0.0
4646,1,646,[478 315 509 244 221],474,5,2636,4.0741885625966,20.0,0.0
4647,1,647,[478 315 509 244 221],474,5,2641,4.075617283950617,20.0,0.0
4648,1,648,[478 315 509 244 221],474,5,2646,4.077041602465331,20.0,0.0
4649,1,649,[478 315 509 244 221],474,5,2651,4.078461538461538,20.0,0.0
4650,1,650,[478 315 509 244 221],474,5,2656,4.0798771121351765,20.0,0.0
4651,1,651,[478 315 509 244 221],474,5,2661,4.081288343558282,20.0,0.0
4652,1,652,[478 315 509 244 221],474,5,2666,4.0826952526799385,20.0,0.0
4653,1,653,[478 315 509 244 221],474,5,2671,4.084097859327217,20.0,0.0
4654,1,654,[236 280 211 378 215],234,1,2672,4.079389312977099,0.0,20.0
4655,1,655,[478 315 509 244 221],474,5,2677,4.0807926829268295,20.0,0.0
4656,1,656,[478 315 509 244 221],474,5,2682,4.082191780821918,20.0,0.0
4657,1,657,[246 217 268 227 240],92,2,2684,4.079027355623101,0.0,0.0
4658,1,658,[478 315 509 244 221],474,5,2689,4.0804248861911985,20.0,0.0
4659,1,659,[478 315 509 244 221],474,5,2694,4.081818181818182,20.0,0.0
4660,1,660,[209 218 208 324 221],334,3,2697,4.08018154311649,0.0,0.0
4661,1,661,[478 315 509 244 221],474,5,2702,4.081570996978852,20.0,0.0
4662,1,662,[478 315 509 244 221],474,5,2707,4.082956259426847,20.0,0.0
4663,1,663,[202 219 230 298 232],387,0,2707,4.076807228915663,0.0,0.0
4664,1,664,[478 315 509 244 221],474,5,2712,4.078195488721804,20.0,0.0
4665,1,665,[478 315 509 244 221],474,5,2717,4.07957957957958,20.0,0.0
4666,1,666,[478 315 509 244 221],474,5,2722,4.08095952023988,20.0,0.0
4667,1,667,[478 315 509 244 221],474,5,2727,4.082335329341317,20.0,0.0
4668,1,668,[478 315 509 244 221],474,5,2732,4.083707025411061,20.0,0.0
4669,1,669,[478 315 509 244 221],474,5,2737,4.085074626865672,20.0,0.0
4670,1,670,[478 315 509 244 221],474,5,2742,4.086438152011922,20.0,0.0
4671,1,671,[478 315 509 244 221],474,5,2747,4.087797619047619,20.0,0.0
4672,1,672,[478 315 509 244 221],474,5,2752,4.089153046062407,20.0,0.0
4673,1,673,[212 429 485 303 316],13,4,2756,4.089020771513353,20.0,0.0
4674,1,674,[478 315 509 244 221],474,5,2761,4.09037037037037,20.0,0.0
4675,1,675,[478 315 509 244 221],474,5,2766,4.091715976331361,20.0,0.0
4676,1,676,[478 315 509 244 221],474,5,2771,4.0930576070901035,20.0,0.0
4677,1,677,[478 315 509 244 221],474,5,2776,4.094395280235989,20.0,0.0
4678,1,678,[478 315 509 244 221],474,5,2781,4.095729013254786,20.0,0.0
4679,1,679,[478 315 509 244 221],474,5,2786,4.097058823529411,20.0,0.0
4680,1,680,[300 280 264 336 209],13,2,2788,4.093979441997063,0.0,20.0
4681,1,681,[478 315 509 244 221],474,5,2793,4.095307917888563,20.0,0.0
4682,1,682,[478 315 509 244 221],474,5,2798,4.096632503660322,20.0,0.0
4683,1,683,[478 315 509 244 221],474,5,2803,4.097953216374269,20.0,0.0
4684,1,684,[478 315 509 244 221],474,5,2808,4.0992700729927005,20.0,0.0
4685,1,685,[478 315 509 244 221],474,5,2813,4.100583090379009,20.0,0.0
4686,1,686,[478 315 509 244 221],474,5,2818,4.1018922852983986,20.0,0.0
4687,1,687,[202 420 230 276 431],200,5,2823,4.103197674418604,0.0,20.0
4688,1,688,[478 315 509 244 221],474,5,2828,4.104499274310595,20.0,0.0
4689,1,689,[478 315 509 244 221],474,5,2833,4.105797101449276,20.0,0.0
4690,1,690,[478 315 509 244 221],474,5,2838,4.107091172214182,20.0,0.0
4691,1,691,[217 481 219 211 394],13,1,2839,4.1026011560693645,0.0,20.0
4692,1,692,[255 298 244 246 275],894,3,2842,4.101010101010101,0.0,20.0
4693,1,693,[508 293 236 485 231],385,1,2843,4.096541786743516,0.0,0.0
4694,1,694,[232 227 293 431 300],774,2,2845,4.093525179856115,0.0,20.0
4695,1,695,[478 315 509 244 221],474,5,2850,4.094827586206897,20.0,0.0
4696,1,696,[301 216 316 230 215],85,2,2852,4.091822094691535,20.0,0.0
4697,1,697,[478 315 509 244 221],474,5,2857,4.093123209169055,20.0,0.0
4698,1,698,[478 315 509 244 221],474,5,2862,4.094420600858369,20.0,0.0
4699,1,699,[478 315 509 244 221],474,5,2867,4.095714285714286,20.0,0.0
4700,1,700,[478 315 509 244 221],474,5,2872,4.09700427960057,20.0,0.0
4701,1,701,[218 300 211 344 384],13,1,2873,4.092592592592593,0.0,40.0
4702,1,702,[478 315 509 244 221],474,5,2878,4.093883357041252,20.0,0.0
4703,1,703,[478 315 509 244 221],474,5,2883,4.095170454545454,20.0,0.0
4704,1,704,[218 293 429 236 222],334,3,2886,4.093617021276596,0.0,20.0
4705,1,705,[478 315 509 244 221],474,5,2891,4.094900849858357,20.0,0.0
4706,1,706,[478 315 509 244 221],474,5,2896,4.096181046676096,20.0,0.0
4707,1,707,[478 315 509 244 221],474,5,2901,4.0974576271186445,20.0,0.0
4708,1,708,[478 315 509 244 221],474,5,2906,4.098730606488012,20.0,0.0
4709,1,709,[478 315 509 244 221],474,5,2911,4.1,20.0,0.0
4710,1,710,[202 301 212 268 290],234,0,2911,4.094233473980309,0.0,0.0
4711,1,711,[478 384 219 301 429],13,2,2913,4.091292134831461,0.0,0.0
4712,1,712,[478 315 509 244 221],474,5,2918,4.092566619915848,20.0,0.0
4713,1,713,[478 315 509 244 221],474,5,2923,4.093837535014005,20.0,0.0
4714,1,714,[478 315 509 244 221],474,5,2928,4.095104895104895,20.0,0.0
4715,1,715,[232 272 300 219 508],13,1,2929,4.090782122905028,0.0,20.0
4716,1,716,[268 276 280 212 367],234,1,2930,4.0864714086471405,0.0,20.0
4717,1,717,[478 315 509 244 221],474,5,2935,4.087743732590529,20.0,0.0
4718,1,718,[478 315 509 244 221],474,5,2940,4.089012517385258,20.0,0.0
4719,1,719,[478 315 509 244 221],474,5,2945,4.090277777777778,20.0,0.0
4720,1,720,[478 315 509 244 221],474,5,2950,4.091539528432732,20.0,0.0
4721,1,721,[478 315 509 244 221],474,5,2955,4.092797783933518,20.0,0.0
4722,1,722,[478 315 509 244 221],474,5,2960,4.094052558782849,20.0,0.0
4723,1,723,[478 315 509 244 221],474,5,2965,4.095303867403315,20.0,0.0
4724,1,724,[478 315 509 244 221],474,5,2970,4.096551724137931,20.0,0.0
4725,1,725,[478 315 509 244 221],474,5,2975,4.097796143250688,20.0,0.0
4726,1,726,[243 431 276 300 301],13,1,2976,4.09353507565337,0.0,40.0
4727,1,727,[478 315 509 244 221],474,5,2981,4.09478021978022,20.0,0.0
4728,1,728,[478 315 509 244 221],474,5,2986,4.096021947873799,20.0,0.0
4729,1,729,[478 315 509 244 221],474,5,2991,4.097260273972603,20.0,0.0
4730,1,730,[478 315 509 244 221],474,5,2996,4.098495212038304,20.0,0.0
4731,1,731,[478 315 509 244 221],474,5,3001,4.0997267759562845,20.0,0.0
4732,1,732,[478 315 509 244 221],474,5,3006,4.100954979536152,20.0,0.0
4733,1,733,[283 298 226 239 230],158,1,3007,4.0967302452316074,0.0,0.0
4734,1,734,[478 315 509 244 221],474,5,3012,4.09795918367347,20.0,0.0
4735,1,735,[478 315 509 244 221],474,5,3017,4.099184782608695,20.0,0.0
4736,1,736,[478 315 509 244 221],474,5,3022,4.100407055630936,20.0,0.0
4737,1,737,[478 315 509 244 221],474,5,3027,4.1016260162601625,20.0,0.0
4738,1,738,[243 298 321 209 222],387,2,3029,4.098782138024357,0.0,20.0
4739,1,739,[230 239 261 215 509],13,3,3032,4.097297297297297,0.0,0.0
4740,1,740,[478 315 509 244 221],474,5,3037,4.098515519568151,20.0,0.0
4741,1,741,[478 315 509 244 221],474,5,3042,4.099730458221024,20.0,0.0
4742,1,742,[211 250 485 326 254],749,3,3045,4.098250336473755,0.0,20.0
4743,1,743,[478 315 509 244 221],474,5,3050,4.099462365591398,20.0,0.0
4744,1,744,[478 315 509 244 221],474,5,3055,4.100671140939597,20.0,0.0
4745,1,745,[478 315 509 244 221],474,5,3060,4.101876675603217,20.0,0.0
4746,1,746,[478 315 509 244 221],474,5,3065,4.103078982597055,20.0,0.0
4747,1,747,[478 315 509 244 221],474,5,3070,4.10427807486631,20.0,0.0
4748,1,748,[429 213 222 215 431],892,4,3074,4.104138851802404,0.0,20.0
4749,1,749,[478 315 509 244 221],474,5,3079,4.105333333333333,20.0,0.0
4750,1,750,[206 367 243 213 212],804,0,3079,4.099866844207723,0.0,0.0
4751,1,751,[290 509 275 212 202],13,4,3083,4.099734042553192,0.0,20.0
4752,1,752,[478 315 509 244 221],474,5,3088,4.100929614873838,20.0,0.0
4753,1,753,[478 315 509 244 221],474,5,3093,4.1021220159151195,20.0,0.0
4754,1,754,[478 315 509 244 221],474,5,3098,4.103311258278146,20.0,0.0
4755,1,755,[478 315 509 244 221],474,5,3103,4.104497354497354,20.0,0.0
4756,1,756,[478 315 509 244 221],474,5,3108,4.105680317040951,20.0,0.0
4757,1,757,[478 315 509 244 221],474,5,3113,4.1068601583113455,20.0,0.0
4758,1,758,[478 315 509 244 221],474,5,3118,4.108036890645586,20.0,0.0
4759,1,759,[222 218 216 211 290],804,5,3123,4.109210526315789,0.0,40.0
4760,1,760,[301 223 336 300 315],13,2,3125,4.106438896189225,40.0,20.0
4761,1,761,[478 315 509 244 221],474,5,3130,4.107611548556431,20.0,0.0
4762,1,762,[478 315 509 244 221],474,5,3135,4.108781127129751,20.0,0.0
4763,1,763,[283 300 508 215 481],85,2,3137,4.106020942408377,0.0,20.0
4764,1,764,[231 315 299 209 216],13,1,3138,4.101960784313725,20.0,0.0
4765,1,765,[509 298 275 236 300],894,4,3142,4.101827676240209,0.0,40.0
4766,1,766,[478 315 509 244 221],474,5,3147,4.102998696219035,20.0,0.0
4767,1,767,[478 315 509 244 221],474,5,3152,4.104166666666667,20.0,0.0
4768,1,768,[478 315 509 244 221],474,5,3157,4.105331599479844,20.0,0.0
4769,1,769,[478 315 509 244 221],474,5,3162,4.106493506493506,20.0,0.0
4770,1,770,[478 315 509 244 221],474,5,3167,4.107652399481193,20.0,0.0
4771,1,771,[478 315 509 244 221],474,5,3172,4.108808290155441,20.0,0.0
4772,1,772,[226 208 230 485 331],13,2,3174,4.106080206985769,0.0,0.0
4773,1,773,[478 315 509 244 221],474,5,3179,4.107235142118863,20.0,0.0
4774,1,774,[384 303 218 219 316],13,2,3181,4.104516129032258,20.0,0.0
4775,1,775,[478 315 509 244 221],474,5,3186,4.105670103092783,20.0,0.0
4776,1,776,[478 315 509 244 221],474,5,3191,4.106821106821107,20.0,0.0
4777,1,777,[478 315 509 244 221],474,5,3196,4.107969151670951,20.0,0.0
4778,1,778,[241 452 202 275 324],7,3,3199,4.106546854942233,0.0,20.0
4779,1,779,[478 315 509 244 221],474,5,3204,4.107692307692307,20.0,0.0
4780,1,780,[478 315 509 244 221],474,5,3209,4.108834827144686,20.0,0.0
4781,1,781,[478 315 509 244 221],474,5,3214,4.10997442455243,20.0,0.0
4782,1,782,[478 315 509 244 221],474,5,3219,4.111111111111111,20.0,0.0
4783,1,783,[478 315 509 244 221],474,5,3224,4.112244897959184,20.0,0.0
4784,1,784,[478 315 509 244 221],474,5,3229,4.113375796178344,20.0,0.0
4785,1,785,[478 315 509 244 221],474,5,3234,4.114503816793893,20.0,0.0
4786,1,786,[478 315 509 244 221],474,5,3239,4.115628970775095,20.0,0.0
4787,1,787,[485 275 481 209 507],13,0,3239,4.1104060913705585,0.0,20.0
4788,1,788,[478 315 509 244 221],474,5,3244,4.111533586818758,20.0,0.0
4789,1,789,[478 315 509 244 221],474,5,3249,4.112658227848101,20.0,0.0
4790,1,790,[478 315 509 244 221],474,5,3254,4.11378002528445,20.0,0.0
4791,1,791,[478 315 509 244 221],474,5,3259,4.11489898989899,20.0,0.0
4792,1,792,[478 315 509 244 221],474,5,3264,4.116015132408575,20.0,0.0
4793,1,793,[206 232 230 215 429],387,1,3265,4.1120906801007555,0.0,0.0
4794,1,794,[478 315 509 244 221],474,5,3270,4.113207547169812,20.0,0.0
4795,1,795,[255 272 300 321 230],378,3,3273,4.11180904522613,0.0,20.0
4796,1,796,[478 315 509 244 221],474,5,3278,4.112923462986198,20.0,0.0
4797,1,797,[478 315 509 244 221],474,5,3283,4.114035087719298,20.0,0.0
4798,1,798,[284 485 226 321 509],308,2,3285,4.111389236545682,0.0,0.0
4799,1,799,[478 315 509 244 221],474,5,3290,4.1125,20.0,0.0
4800,1,800,[478 315 509 244 221],474,5,3295,4.1136079900124844,20.0,0.0
4801,1,801,[478 315 509 244 221],474,5,3300,4.114713216957606,20.0,0.0
4802,1,802,[478 315 509 244 221],474,5,3305,4.115815691158157,20.0,0.0
4803,1,803,[478 315 509 244 221],474,5,3310,4.116915422885572,20.0,0.0
4804,1,804,[478 315 509 244 221],474,5,3315,4.118012422360248,20.0,0.0
4805,1,805,[478 315 509 244 221],474,5,3320,4.119106699751861,20.0,0.0
4806,1,806,[478 315 509 244 221],474,5,3325,4.120198265179678,20.0,0.0
4807,1,807,[478 315 509 244 221],474,5,3330,4.121287128712871,20.0,0.0
4808,1,808,[478 315 509 244 221],474,5,3335,4.122373300370828,20.0,0.0
4809,1,809,[478 315 509 244 221],474,5,3340,4.1234567901234565,20.0,0.0
4810,1,810,[478 315 509 244 221],474,5,3345,4.124537607891492,20.0,0.0
4811,1,811,[219 211 276 316 350],13,3,3348,4.123152709359606,20.0,40.0
4812,1,812,[478 315 509 244 221],474,5,3353,4.124231242312423,20.0,0.0
4813,1,813,[478 315 509 244 221],474,5,3358,4.125307125307125,20.0,0.0
4814,1,814,[478 315 509 244 221],474,5,3363,4.126380368098159,20.0,0.0
4815,1,815,[478 315 509 244 221],474,5,3368,4.127450980392157,20.0,0.0
4816,1,816,[478 315 509 244 221],474,5,3373,4.128518971848226,20.0,0.0
4817,1,817,[478 315 509 244 221],474,5,3378,4.12958435207824,20.0,0.0
4818,1,818,[478 315 509 244 221],474,5,3383,4.130647130647131,20.0,0.0
4819,1,819,[272 209 431 213 300],479,4,3387,4.130487804878049,0.0,20.0
4820,1,820,[218 202 293 227 223],447,3,3390,4.129110840438489,20.0,0.0
4821,1,821,[478 315 509 244 221],474,5,3395,4.130170316301703,20.0,0.0
4822,1,822,[478 315 509 244 221],474,5,3400,4.131227217496963,20.0,0.0
4823,1,823,[478 315 509 244 221],474,5,3405,4.132281553398058,20.0,0.0
4824,1,824,[478 315 509 244 221],474,5,3410,4.133333333333334,20.0,0.0
4825,1,825,[478 315 509 244 221],474,5,3415,4.134382566585956,20.0,0.0
4826,1,826,[478 315 509 244 221],474,5,3420,4.1354292623941955,20.0,0.0
4827,1,827,[452 250 211 202 254],774,1,3421,4.131642512077295,0.0,20.0
4828,1,828,[478 315 509 244 221],474,5,3426,4.132689987937274,20.0,0.0
4829,1,829,[478 315 509 244 221],474,5,3431,4.133734939759036,20.0,0.0
4830,1,830,[478 315 509 244 221],474,5,3436,4.134777376654633,20.0,0.0
4831,1,831,[508 211 208 216 275],406,2,3438,4.132211538461538,0.0,40.0
4832,1,832,[478 315 509 244 221],474,5,3443,4.133253301320528,20.0,0.0
4833,1,833,[478 315 509 244 221],474,5,3448,4.134292565947242,20.0,0.0
4834,1,834,[268 301 222 394 212],145,3,3451,4.132934131736527,0.0,20.0
4835,1,835,[301 202 230 394 290],13,2,3453,4.130382775119617,0.0,0.0
4836,1,836,[431 264 316 326 218],102,0,3453,4.125448028673835,20.0,0.0
4837,1,837,[276 315 367 331 223],13,3,3456,4.124105011933175,40.0,20.0
4838,1,838,[478 315 509 244 221],474,5,3461,4.125148986889154,20.0,0.0
4839,1,839,[478 315 509 244 221],474,5,3466,4.126190476190477,20.0,0.0
4840,1,840,[478 315 509 244 221],474,5,3471,4.127229488703924,20.0,0.0
4841,1,841,[478 315 509 244 221],474,5,3476,4.128266033254157,20.0,0.0
4842,1,842,[478 315 509 244 221],474,5,3481,4.129300118623962,20.0,0.0
4843,1,843,[478 315 509 244 221],474,5,3486,4.130331753554502,20.0,0.0
4844,1,844,[478 315 509 244 221],474,5,3491,4.131360946745562,20.0,0.0
4845,1,845,[478 315 509 244 221],474,5,3496,4.132387706855792,20.0,0.0
4846,1,846,[478 315 509 244 221],474,5,3501,4.133412042502951,20.0,0.0
4847,1,847,[478 315 509 244 221],474,5,3506,4.134433962264151,20.0,0.0
4848,1,848,[246 208 429 276 216],334,4,3510,4.134275618374558,0.0,20.0
4849,1,849,[478 315 509 244 221],474,5,3515,4.135294117647059,20.0,0.0
4850,1,850,[478 315 509 244 221],474,5,3520,4.136310223266745,20.0,0.0
4851,1,851,[478 315 509 244 221],474,5,3525,4.137323943661972,20.0,0.0
4852,1,852,[478 315 509 244 221],474,5,3530,4.138335287221571,20.0,0.0
4853,1,853,[478 315 509 244 221],474,5,3535,4.139344262295082,20.0,0.0
4854,1,854,[478 315 509 244 221],474,5,3540,4.140350877192983,20.0,0.0
4855,1,855,[420 216 215 223 365],7,5,3545,4.141355140186916,20.0,0.0
4856,1,856,[241 202 216 239 256],883,4,3549,4.141190198366394,0.0,0.0
4857,1,857,[478 315 509 244 221],474,5,3554,4.142191142191142,20.0,0.0
4858,1,858,[478 315 509 244 221],474,5,3559,4.1431897555296855,20.0,0.0
4859,1,859,[478 315 509 244 221],474,5,3564,4.144186046511628,20.0,0.0
4860,1,860,[478 315 509 244 221],474,5,3569,4.145180023228804,20.0,0.0
4861,1,861,[213 284 283 230 222],85,1,3570,4.1415313225058,0.0,20.0
4862,1,862,[478 315 509 244 221],474,5,3575,4.14252607184241,20.0,0.0
4863,1,863,[478 315 509 244 221],474,5,3580,4.143518518518518,20.0,0.0
4864,1,864,[478 315 509 244 221],474,5,3585,4.144508670520231,20.0,0.0
4865,1,865,[478 315 509 244 221],474,5,3590,4.145496535796767,20.0,0.0
4866,1,866,[478 315 509 244 221],474,5,3595,4.146482122260669,20.0,0.0
4867,1,867,[478 315 509 244 221],474,5,3600,4.147465437788019,20.0,0.0
4868,1,868,[478 315 509 244 221],474,5,3605,4.148446490218642,20.0,0.0
4869,1,869,[478 315 509 244 221],474,5,3610,4.149425287356322,20.0,0.0
4870,1,870,[478 315 509 244 221],474,5,3615,4.150401836969001,20.0,0.0
4871,1,871,[481 284 276 206 218],234,2,3617,4.147935779816514,0.0,20.0
4872,1,872,[478 315 509 244 221],474,5,3622,4.148911798396335,20.0,0.0
4873,1,873,[478 315 509 244 221],474,5,3627,4.149885583524028,20.0,0.0
4874,1,874,[429 231 508 275 303],334,3,3630,4.148571428571429,0.0,20.0
4875,1,875,[218 378 478 268 215],234,1,3631,4.144977168949771,0.0,0.0
4876,1,876,[315 509 244 478 221],474,5,3636,4.145952109464082,20.0,0.0
4877,1,877,[315 509 244 478 221],474,5,3641,4.146924829157175,20.0,0.0
4878,1,878,[315 509 244 478 221],474,5,3646,4.147895335608646,20.0,0.0
4879,1,879,[315 509 244 478 221],474,5,3651,4.148863636363636,20.0,0.0
4880,1,880,[315 509 244 478 221],474,5,3656,4.149829738933031,20.0,0.0
4881,1,881,[394 219 226 367 272],13,2,3658,4.147392290249433,0.0,0.0
4882,1,882,[315 509 244 478 221],474,5,3663,4.148357870894677,20.0,0.0
4883,1,883,[315 509 244 478 221],474,5,3668,4.149321266968326,20.0,0.0
4884,1,884,[208 206 226 215 212],537,1,3669,4.145762711864407,0.0,0.0
4885,1,885,[315 509 244 478 221],474,5,3674,4.146726862302483,20.0,0.0
4886,1,886,[315 509 244 478 221],474,5,3679,4.147688838782413,20.0,0.0
4887,1,887,[315 509 244 478 221],474,5,3684,4.148648648648648,20.0,0.0
4888,1,888,[315 509 244 478 221],474,5,3689,4.149606299212598,20.0,0.0
4889,1,889,[315 509 244 478 221],474,5,3694,4.150561797752809,20.0,0.0
4890,1,890,[315 509 244 478 221],474,5,3699,4.151515151515151,20.0,0.0
4891,1,891,[264 227 243 299 239],13,3,3702,4.150224215246637,0.0,0.0
4892,1,892,[315 509 244 478 221],474,5,3707,4.151175811870101,20.0,0.0
4893,1,893,[315 509 244 478 221],474,5,3712,4.152125279642058,20.0,0.0
4894,1,894,[315 509 244 478 221],474,5,3717,4.153072625698324,20.0,0.0
4895,1,895,[315 509 244 478 221],474,5,3722,4.154017857142857,20.0,0.0
4896,1,896,[212 300 507 211 280],234,1,3723,4.150501672240803,0.0,40.0
4897,1,897,[315 509 244 478 221],474,5,3728,4.151447661469933,20.0,0.0
4898,1,898,[315 509 244 478 221],474,5,3733,4.152391546162403,20.0,0.0
4899,1,899,[378 272 202 236 215],537,1,3734,4.148888888888889,0.0,0.0
4900,1,900,[315 509 244 478 221],474,5,3739,4.1498335183129855,20.0,0.0
4901,1,901,[315 509 244 478 221],474,5,3744,4.150776053215077,20.0,0.0
4902,1,902,[315 509 244 478 221],474,5,3749,4.15171650055371,20.0,0.0
4903,1,903,[315 509 244 478 221],474,5,3754,4.152654867256637,20.0,0.0
4904,1,904,[315 509 244 478 221],474,5,3759,4.153591160220994,20.0,0.0
4905,1,905,[315 509 244 478 221],474,5,3764,4.154525386313466,20.0,0.0
4906,1,906,[276 268 222 221 206],234,1,3765,4.151047409040793,0.0,40.0
4907,1,907,[315 509 244 478 221],474,5,3770,4.151982378854625,20.0,0.0
4908,1,908,[315 509 244 478 221],474,5,3775,4.152915291529153,20.0,0.0
4909,1,909,[315 509 244 478 221],474,5,3780,4.153846153846154,20.0,0.0
4910,1,910,[315 509 244 478 221],474,5,3785,4.154774972557629,20.0,0.0
4911,1,911,[315 509 244 478 221],474,5,3790,4.155701754385965,20.0,0.0
4912,1,912,[209 481 507 420 232],85,4,3794,4.1555312157721795,0.0,0.0
4913,1,913,[315 509 244 478 221],474,5,3799,4.156455142231947,20.0,0.0
4914,1,914,[212 367 254 259 240],804,3,3802,4.1551912568306015,0.0,0.0
4915,1,915,[315 509 244 478 221],474,5,3807,4.156113537117904,20.0,0.0
4916,1,916,[315 509 244 478 221],474,5,3812,4.1570338058887675,20.0,0.0
4917,1,917,[315 509 244 478 221],474,5,3817,4.157952069716775,20.0,0.0
4918,1,918,[315 509 244 478 221],474,5,3822,4.158868335146899,20.0,0.0
4919,1,919,[315 509 244 478 221],474,5,3827,4.159782608695652,20.0,0.0
4920,1,920,[315 509 244 478 221],474,5,3832,4.160694896851249,20.0,0.0
4921,1,921,[222 202 231 429 217],650,2,3834,4.158351409978308,0.0,20.0
4922,1,922,[315 509 244 478 221],474,5,3839,4.159263271939328,20.0,0.0
4923,1,923,[226 255 508 301 298],378,2,3841,4.156926406926407,0.0,0.0
4924,1,924,[315 509 244 478 221],474,5,3846,4.157837837837838,20.0,0.0
4925,1,925,[315 509 244 478 221],474,5,3851,4.158747300215983,20.0,0.0
4926,1,926,[315 509 244 478 221],474,5,3856,4.1596548004314995,20.0,0.0
4927,1,927,[315 509 244 478 221],474,5,3861,4.160560344827586,20.0,0.0
4928,1,928,[315 509 244 478 221],474,5,3866,4.161463939720129,20.0,0.0
4929,1,929,[315 509 244 478 221],474,5,3871,4.162365591397849,20.0,0.0
4930,1,930,[315 509 244 478 221],474,5,3876,4.163265306122449,20.0,0.0
4931,1,931,[315 509 244 478 221],474,5,3881,4.164163090128755,20.0,0.0
4932,1,932,[420 232 223 452 212],13,3,3884,4.162915326902465,20.0,0.0
4933,1,933,[315 509 244 478 221],474,5,3889,4.163811563169165,20.0,0.0
4934,1,934,[315 509 244 478 221],474,5,3894,4.1647058823529415,20.0,0.0
4935,1,935,[478 384 315 226 508],13,3,3897,4.163461538461538,20.0,0.0
4936,1,936,[218 223 215 226 275],13,3,3900,4.16221985058698,20.0,20.0
4937,1,937,[315 509 244 478 221],474,5,3905,4.163113006396588,20.0,0.0
4938,1,938,[226 478 298 250 276],339,3,3908,4.161874334398296,0.0,20.0
4939,1,939,[315 509 244 478 221],474,5,3913,4.162765957446808,20.0,0.0
4940,1,940,[315 509 244 478 221],474,5,3918,4.16365568544102,20.0,0.0
4941,1,941,[208 321 213 223 216],234,1,3919,4.160297239915074,20.0,0.0
4942,1,942,[226 507 431 216 222],194,2,3921,4.158006362672323,0.0,20.0
4943,1,943,[315 509 244 478 221],474,5,3926,4.158898305084746,20.0,0.0
4944,1,944,[315 509 244 478 221],474,5,3931,4.15978835978836,20.0,0.0
4945,1,945,[209 367 420 226 255],643,4,3935,4.159619450317125,0.0,0.0
4946,1,946,[315 509 244 478 221],474,5,3940,4.160506863780359,20.0,0.0
4947,1,947,[315 509 244 478 221],474,5,3945,4.1613924050632916,20.0,0.0
4948,1,948,[300 324 223 429 227],7,3,3948,4.160168598524763,20.0,20.0
4949,1,949,[315 509 244 478 221],474,5,3953,4.161052631578947,20.0,0.0
4950,1,950,[315 509 244 478 221],474,5,3958,4.161934805467928,20.0,0.0
4951,1,951,[315 509 244 478 221],474,5,3963,4.16281512605042,20.0,0.0
4952,1,952,[315 509 244 478 221],474,5,3968,4.1636935991605455,20.0,0.0
4953,1,953,[315 509 244 478 221],474,5,3973,4.164570230607967,20.0,0.0
4954,1,954,[315 509 244 478 221],474,5,3978,4.16544502617801,20.0,0.0
4955,1,955,[315 509 244 478 221],474,5,3983,4.166317991631799,20.0,0.0
4956,1,956,[212 251 213 283 222],883,3,3986,4.165099268547545,20.0,20.0
4957,1,957,[300 216 365 452 275],7,5,3991,4.165970772442589,0.0,40.0
4958,1,958,[208 275 212 300 259],90,2,3993,4.1637122002085505,0.0,40.0
4959,1,959,[215 213 276 300 283],537,3,3996,4.1625,0.0,40.0
4960,1,960,[211 508 219 215 202],13,3,3999,4.161290322580645,0.0,20.0
4961,1,961,[201 219 367 316 321],13,1,4000,4.158004158004158,20.0,0.0
4962,1,962,[222 481 208 241 350],13,1,4001,4.15472481827622,0.0,20.0
4963,1,963,[226 481 268 507 216],13,2,4003,4.152489626556017,0.0,0.0
4964,1,964,[284 478 239 295 215],749,4,4007,4.152331606217617,0.0,0.0
4965,1,965,[275 212 509 213 231],537,3,4010,4.151138716356107,0.0,20.0
4966,1,966,[264 223 268 300 431],7,4,4014,4.1509824198552225,20.0,20.0
4967,1,967,[485 241 507 276 264],308,2,4016,4.148760330578512,0.0,20.0
4968,1,968,[216 231 283 452 223],308,1,4017,4.145510835913313,20.0,0.0
4969,1,969,[293 481 209 284 221],6,3,4020,4.144329896907217,0.0,0.0
4970,1,970,[508 420 272 217 336],13,2,4022,4.142121524201854,0.0,0.0
4971,1,971,[259 209 367 509 303],6,2,4024,4.139917695473251,0.0,0.0
4972,1,972,[250 392 206 300 208],843,1,4025,4.136690647482014,0.0,20.0
4973,1,973,[300 336 264 213 508],894,2,4027,4.134496919917864,0.0,20.0
4974,1,974,[259 236 378 226 299],537,0,4027,4.13025641025641,0.0,0.0
4975,1,975,[485 276 284 392 208],59,2,4029,4.128073770491803,0.0,20.0
4976,1,976,[365 392 216 394 226],346,1,4030,4.1248720573183215,0.0,0.0
4977,1,977,[431 429 209 202 392],59,4,4034,4.124744376278119,0.0,0.0
4978,1,978,[241 230 429 321 378],537,0,4034,4.1205311542390195,0.0,0.0
4979,1,979,[218 509 231 508 211],339,3,4037,4.119387755102041,0.0,20.0
4980,1,980,[226 222 384 202 208],883,2,4039,4.117227319062182,0.0,20.0
4981,1,981,[276 299 321 201 211],13,2,4041,4.115071283095723,0.0,40.0
4982,1,982,[276 485 220 206 211],406,2,4043,4.112919633774161,0.0,40.0
4983,1,983,[219 301 254 431 231],279,2,4045,4.110772357723577,0.0,0.0
4984,1,984,[244 324 268 315 227],334,3,4048,4.109644670050762,20.0,0.0
4985,1,985,[284 208 211 216 293],308,4,4052,4.109533468559838,0.0,20.0
4986,1,986,[275 201 485 202 236],125,3,4055,4.108409321175278,0.0,20.0
4987,1,987,[239 283 301 231 218],378,1,4056,4.105263157894737,0.0,0.0
4988,1,988,[350 208 452 413 481],13,1,4057,4.102123356926188,0.0,0.0
4989,1,989,[300 231 239 216 211],311,3,4060,4.101010101010101,0.0,40.0
4990,1,990,[231 326 485 217 301],334,0,4060,4.096871846619576,0.0,0.0
4991,1,991,[209 284 392 276 583],59,3,4063,4.095766129032258,0.0,20.0
4992,1,992,[276 301 280 218 215],234,0,4063,4.091641490433031,0.0,20.0
4993,1,993,[384 481 212 509 219],13,2,4065,4.089537223340041,0.0,0.0
4994,1,994,[239 222 429 508 367],406,3,4068,4.088442211055276,0.0,20.0
4995,1,995,[324 208 298 240 226],833,2,4070,4.086345381526105,0.0,0.0
4996,1,996,[222 367 298 275 208],158,3,4073,4.085255767301906,0.0,40.0
4997,1,997,[378 413 208 209 290],804,4,4077,4.085170340681363,0.0,0.0
4998,1,998,[221 213 316 293 246],334,4,4081,4.085085085085085,20.0,0.0
4999,1,999,[284 223 295 230 220],378,1,4082,4.082,20.0,0.0
5000,1,1000,[218 508 240 276 202],406,3,4085,4.080919080919081,0.0,20.0
5001,1,1001,[481 485 268 299 301],13,1,4086,4.077844311377246,0.0,0.0
5002,1,1002,[344 431 276 303 211],13,3,4089,4.076769690927218,0.0,40.0
5003,1,1003,[208 365 275 452 231],308,2,4091,4.074701195219124,0.0,20.0
5004,1,1004,[431 211 201 230 231],387,2,4093,4.072636815920398,0.0,20.0
5005,1,1005,[222 215 367 478 230],650,3,4096,4.071570576540755,0.0,20.0
5006,1,1006,[231 213 208 290 240],804,4,4100,4.07149950347567,0.0,0.0
5007,1,1007,[250 295 255 275 331],486,1,4101,4.068452380952381,0.0,20.0
5008,1,1008,[315 213 283 478 226],537,4,4105,4.068384539147671,20.0,0.0
5009,1,1009,[254 218 212 219 216],804,3,4108,4.067326732673267,0.0,0.0
5010,1,1010,[272 293 481 246 298],6,2,4110,4.0652818991097925,0.0,0.0
5011,1,1011,[211 478 420 507 226],13,4,4114,4.065217391304348,0.0,20.0
5012,1,1012,[239 211 216 508 226],524,3,4117,4.064165844027641,0.0,20.0
5013,1,1013,[217 232 507 413 344],13,0,4117,4.060157790927022,0.0,0.0
5014,1,1014,[420 208 326 431 478],13,3,4120,4.059113300492611,0.0,0.0
5015,1,1015,[222 218 216 268 431],13,1,4121,4.056102362204724,0.0,20.0
5016,1,1016,[240 206 431 508 212],406,2,4123,4.054080629301868,0.0,0.0
5017,1,1017,[290 259 283 321 236],537,1,4124,4.051080550098232,0.0,0.0
5018,1,1018,[384 240 508 324 227],833,2,4126,4.049067713444553,0.0,0.0
5019,1,1019,[367 481 303 261 507],13,1,4127,4.046078431372549,0.0,0.0
5020,1,1020,[212 218 215 230 216],804,4,4131,4.046033300685602,0.0,0.0
5021,1,1021,[478 384 315 227 216],13,3,4134,4.045009784735812,20.0,0.0
5022,1,1022,[222 295 219 226 220],648,4,4138,4.044965786901271,0.0,20.0
5023,1,1023,[231 420 209 213 300],85,3,4141,4.0439453125,0.0,20.0
5024,1,1024,[221 367 301 429 290],524,3,4144,4.042926829268293,0.0,0.0
5025,1,1025,[298 481 272 508 284],6,2,4146,4.04093567251462,0.0,0.0
5026,1,1026,[301 508 215 241 481],85,3,4149,4.039922103213242,0.0,0.0
5027,1,1027,[300 202 209 231 218],506,2,4151,4.037937743190661,0.0,20.0
5028,1,1028,[215 211 413 226 378],804,5,4156,4.038872691933917,0.0,20.0
5029,1,1029,[431 222 429 478 295],749,3,4159,4.037864077669903,0.0,20.0
5030,1,1030,[239 478 299 261 367],13,2,4161,4.035887487875849,0.0,0.0
5031,1,1031,[290 226 316 217 264],13,4,4165,4.035852713178294,20.0,0.0
5032,1,1032,[508 413 326 344 227],13,1,4166,4.032913843175217,0.0,0.0
5033,1,1033,[220 217 222 231 209],92,2,4168,4.0309477756286265,0.0,20.0
5034,1,1034,[478 226 378 223 206],234,2,4170,4.028985507246377,20.0,0.0
5035,1,1035,[485 276 221 324 300],334,3,4173,4.027992277992278,0.0,40.0
5036,1,1036,[321 219 326 452 420],13,1,4174,4.025072324011572,0.0,0.0
5037,1,1037,[208 336 508 222 268],13,2,4176,4.023121387283237,0.0,20.0
5038,1,1038,[275 211 209 218 452],13,1,4177,4.020211742059673,0.0,40.0
5039,1,1039,[268 507 350 241 413],13,1,4178,4.017307692307693,0.0,0.0
5040,1,1040,[202 231 431 250 508],387,2,4180,4.015369836695485,0.0,0.0
5041,1,1041,[295 365 420 478 211],749,3,4183,4.014395393474088,0.0,20.0
5042,1,1042,[276 259 429 507 365],308,2,4185,4.012464046021093,0.0,20.0
5043,1,1043,[293 264 298 367 583],308,4,4189,4.012452107279693,0.0,0.0
5044,1,1044,[272 223 230 321 255],378,3,4192,4.0114832535885165,20.0,0.0
5045,1,1045,[276 231 226 300 212],311,4,4196,4.011472275334608,0.0,40.0
5046,1,1046,[275 478 227 222 255],474,4,4200,4.011461318051576,0.0,40.0
5047,1,1047,[392 284 211 222 378],537,1,4201,4.008587786259542,0.0,40.0
5048,1,1048,[301 232 485 215 241],13,1,4202,4.005719733079123,0.0,0.0
5049,1,1049,[209 226 208 326 231],749,5,4207,4.006666666666667,0.0,0.0
5050,1,1050,[392 239 301 303 215],537,1,4208,4.003805899143673,0.0,0.0
5051,1,1051,[255 254 485 259 321],184,2,4210,4.001901140684411,0.0,0.0
5052,1,1052,[209 283 478 206 222],234,2,4212,4.0,0.0,20.0
5053,1,1053,[230 431 201 215 508],537,2,4214,3.998102466793169,0.0,0.0
5054,1,1054,[293 239 219 583 452],308,2,4216,3.996208530805687,0.0,0.0
5055,1,1055,[230 291 220 209 239],92,3,4219,3.9952651515151514,0.0,0.0
5056,1,1056,[217 226 230 367 431],7,4,4223,3.9952696310312206,0.0,0.0
5057,1,1057,[232 217 230 429 264],7,3,4226,3.9943289224952743,0.0,0.0
5058,1,1058,[213 255 295 283 209],308,3,4229,3.9933899905571293,0.0,0.0
5059,1,1059,[367 300 301 213 221],234,1,4230,3.990566037735849,0.0,20.0
5060,1,1060,[226 276 261 367 217],13,2,4232,3.9886899151743638,0.0,20.0
5061,1,1061,[217 216 239 326 275],378,2,4234,3.9868173258003767,0.0,20.0
5062,1,1062,[276 261 216 268 211],6,2,4236,3.984948259642521,0.0,40.0
5063,1,1063,[280 301 255 220 300],378,2,4238,3.9830827067669174,0.0,20.0
5064,1,1064,[290 201 378 230 232],897,5,4243,3.984037558685446,0.0,0.0
5065,1,1065,[272 241 301 367 344],13,1,4244,3.9812382739212007,0.0,0.0
5066,1,1066,[331 219 212 209 298],145,2,4246,3.979381443298969,0.0,0.0
5067,1,1067,[241 481 284 222 316],234,2,4248,3.9775280898876404,20.0,20.0
5068,1,1068,[209 485 508 236 276],537,3,4251,3.9766136576239477,0.0,20.0
5069,1,1069,[231 485 331 367 212],13,1,4252,3.9738317757009347,0.0,0.0
5070,1,1070,[216 429 241 315 201],13,2,4254,3.9719887955182074,20.0,0.0
5071,1,1071,[239 218 272 485 276],378,3,4257,3.971082089552239,0.0,20.0
5072,1,1072,[509 215 485 301 268],13,3,4260,3.9701770736253494,0.0,0.0
5073,1,1073,[216 223 429 431 239],653,2,4262,3.968342644320298,20.0,0.0
5074,1,1074,[291 216 215 507 276],474,5,4267,3.9693023255813955,0.0,20.0
5075,1,1075,[481 431 276 508 209],13,1,4268,3.966542750929368,0.0,20.0
5076,1,1076,[261 301 241 384 243],13,0,4268,3.9628597957288765,0.0,0.0
5077,1,1077,[211 202 215 300 291],653,2,4270,3.961038961038961,0.0,40.0
5078,1,1078,[226 212 268 284 231],537,1,4271,3.958294717330862,0.0,0.0
5079,1,1079,[420 481 226 367 241],308,4,4275,3.9583333333333335,0.0,0.0
5080,1,1080,[211 240 208 283 230],279,4,4279,3.958371877890842,0.0,20.0
5081,1,1081,[212 236 243 216 276],234,0,4279,3.954713493530499,0.0,20.0
5082,1,1082,[344 384 222 326 217],13,0,4279,3.951061865189289,0.0,20.0
5083,1,1083,[230 231 213 275 300],85,1,4280,3.9483394833948338,0.0,40.0
5084,1,1084,[202 209 301 300 268],13,2,4282,3.946543778801843,0.0,20.0
5085,1,1085,[226 232 216 378 275],7,4,4286,3.9465930018416207,0.0,20.0
5086,1,1086,[211 231 240 429 201],279,4,4290,3.9466421343146276,0.0,20.0
5087,1,1087,[223 321 295 275 280],378,2,4292,3.9448529411764706,20.0,20.0
5088,1,1088,[326 230 276 212 293],474,3,4295,3.9439853076216713,0.0,20.0
5089,1,1089,[244 331 299 268 293],486,0,4295,3.9403669724770642,0.0,0.0
5090,1,1090,[239 218 276 212 213],311,3,4298,3.9395050412465626,0.0,20.0
5091,1,1091,[218 268 344 507 367],13,1,4299,3.9368131868131866,0.0,0.0
5092,1,1092,[300 209 331 259 268],145,2,4301,3.9350411710887467,0.0,20.0
5093,1,1093,[316 452 290 336 420],13,3,4304,3.9341864716636197,20.0,0.0
5094,1,1094,[251 216 283 221 218],385,1,4305,3.9315068493150687,20.0,0.0
5095,1,1095,[315 509 478 244 221],474,5,4310,3.9324817518248176,20.0,0.0
5096,1,1096,[315 509 478 244 221],474,5,4315,3.9334548769371014,20.0,0.0
5097,1,1097,[221 208 291 216 206],234,2,4317,3.931693989071038,0.0,0.0
5098,1,1098,[315 509 478 244 221],474,5,4322,3.9326660600545953,20.0,0.0
5099,1,1099,[315 509 478 244 221],474,5,4327,3.9336363636363636,20.0,0.0
5100,1,1100,[315 509 478 244 221],474,5,4332,3.9346049046321525,20.0,0.0
5101,1,1101,[209 367 226 239 223],13,3,4335,3.9337568058076227,20.0,0.0
5102,1,1102,[300 212 261 336 209],13,1,4336,3.931097008159565,0.0,20.0
5103,1,1103,[315 509 478 244 221],474,5,4341,3.932065217391304,20.0,0.0
5104,1,1104,[315 509 478 244 221],474,5,4346,3.9330316742081446,20.0,0.0
5105,1,1105,[201 324 211 272 215],479,3,4349,3.9321880650994574,0.0,20.0
5106,1,1106,[315 509 478 244 221],474,5,4354,3.933152664859982,20.0,0.0
5107,1,1107,[315 509 478 244 221],474,5,4359,3.934115523465704,20.0,0.0
5108,1,1108,[315 509 478 244 221],474,5,4364,3.935076645626691,20.0,0.0
5109,1,1109,[315 509 478 244 221],474,5,4369,3.936036036036036,20.0,0.0
5110,1,1110,[315 509 478 244 221],474,5,4374,3.936993699369937,20.0,0.0
5111,1,1111,[315 509 478 244 221],474,5,4379,3.9379496402877696,20.0,0.0
5112,1,1112,[315 509 478 244 221],474,5,4384,3.938903863432165,20.0,0.0
5113,1,1113,[315 509 478 244 221],474,5,4389,3.9398563734290843,20.0,0.0
5114,1,1114,[315 509 478 244 221],474,5,4394,3.9408071748878926,20.0,0.0
5115,1,1115,[315 509 478 244 221],474,5,4399,3.9417562724014337,20.0,0.0
5116,1,1116,[315 509 478 244 221],474,5,4404,3.9427036705461056,20.0,0.0
5117,1,1117,[315 509 478 244 221],474,5,4409,3.943649373881932,20.0,0.0
5118,1,1118,[315 509 478 244 221],474,5,4414,3.9445933869526364,20.0,0.0
5119,1,1119,[315 509 478 244 221],474,5,4419,3.945535714285714,20.0,0.0
5120,1,1120,[315 509 478 244 221],474,5,4424,3.9464763603925066,20.0,0.0
5121,1,1121,[315 509 478 244 221],474,5,4429,3.947415329768271,20.0,0.0
5122,1,1122,[315 509 478 244 221],474,5,4434,3.948352626892253,20.0,0.0
5123,1,1123,[315 509 478 244 221],474,5,4439,3.949288256227758,20.0,0.0
5124,1,1124,[315 509 478 244 221],474,5,4444,3.950222222222222,20.0,0.0
5125,1,1125,[315 509 478 244 221],474,5,4449,3.9511545293072823,20.0,0.0
5126,1,1126,[315 509 478 244 221],474,5,4454,3.9520851818988465,20.0,0.0
5127,1,1127,[315 509 478 244 221],474,5,4459,3.953014184397163,20.0,0.0
5128,1,1128,[315 509 478 244 221],474,5,4464,3.9539415411868912,20.0,0.0
5129,1,1129,[315 509 478 244 221],474,5,4469,3.954867256637168,20.0,0.0
5130,1,1130,[583 298 232 321 217],387,1,4470,3.952254641909814,0.0,0.0
5131,1,1131,[315 509 478 244 221],474,5,4475,3.9531802120141344,20.0,0.0
5132,1,1132,[315 509 478 244 221],474,5,4480,3.9541041482789057,20.0,0.0
5133,1,1133,[315 509 478 244 221],474,5,4485,3.955026455026455,20.0,0.0
5134,1,1134,[315 509 478 244 221],474,5,4490,3.9559471365638768,20.0,0.0
5135,1,1135,[315 509 478 244 221],474,5,4495,3.9568661971830985,20.0,0.0
5136,1,1136,[315 509 478 244 221],474,5,4500,3.9577836411609497,20.0,0.0
5137,1,1137,[315 509 478 244 221],474,5,4505,3.9586994727592266,20.0,0.0
5138,1,1138,[275 290 295 300 244],894,3,4508,3.957857769973661,0.0,40.0
5139,1,1139,[208 211 429 215 221],524,3,4511,3.9570175438596493,0.0,20.0
5140,1,1140,[315 509 478 244 221],474,5,4516,3.957931638913234,20.0,0.0
5141,1,1141,[315 509 478 244 221],474,5,4521,3.958844133099825,20.0,0.0
5142,1,1142,[315 509 478 244 221],474,5,4526,3.959755030621172,20.0,0.0
5143,1,1143,[315 509 478 244 221],474,5,4531,3.960664335664336,20.0,0.0
5144,1,1144,[315 509 478 244 221],474,5,4536,3.961572052401747,20.0,0.0
5145,1,1145,[315 509 478 244 221],474,5,4541,3.962478184991274,20.0,0.0
5146,1,1146,[315 509 478 244 221],474,5,4546,3.963382737576286,20.0,0.0
5147,1,1147,[315 509 478 244 221],474,5,4551,3.9642857142857144,20.0,0.0
5148,1,1148,[298 241 301 350 239],102,0,4551,3.960835509138381,0.0,0.0
5149,1,1149,[315 509 478 244 221],474,5,4556,3.9617391304347827,20.0,0.0
5150,1,1150,[275 268 250 244 213],894,4,4560,3.961772371850565,0.0,20.0
5151,1,1151,[315 509 478 244 221],474,5,4565,3.962673611111111,20.0,0.0
5152,1,1152,[218 222 216 301 264],13,1,4566,3.9601040763226365,0.0,20.0
5153,1,1153,[315 509 478 244 221],474,5,4571,3.961005199306759,20.0,0.0
5154,1,1154,[315 509 478 244 221],474,5,4576,3.961904761904762,20.0,0.0
5155,1,1155,[219 485 316 478 215],650,1,4577,3.959342560553633,20.0,0.0
5156,1,1156,[315 509 478 244 221],474,5,4582,3.9602420051858256,20.0,0.0
5157,1,1157,[315 509 478 244 221],474,5,4587,3.961139896373057,20.0,0.0
5158,1,1158,[216 291 213 222 290],234,0,4587,3.9577221742881794,0.0,20.0
5159,1,1159,[315 509 478 244 221],474,5,4592,3.9586206896551723,20.0,0.0
5160,1,1160,[394 316 246 202 226],145,3,4595,3.9577950043066323,20.0,0.0
5161,1,1161,[315 509 478 244 221],474,5,4600,3.9586919104991396,20.0,0.0
5162,1,1162,[315 509 478 244 221],474,5,4605,3.9595872742906275,20.0,0.0
5163,1,1163,[336 201 243 478 452],13,1,4606,3.957044673539519,0.0,0.0
5164,1,1164,[315 509 478 244 221],474,5,4611,3.95793991416309,20.0,0.0
5165,1,1165,[208 209 392 321 226],308,3,4614,3.9571183533447685,0.0,0.0
5166,1,1166,[315 509 478 244 221],474,5,4619,3.958011996572408,20.0,0.0
5167,1,1167,[315 509 478 244 221],474,5,4624,3.958904109589041,20.0,0.0
5168,1,1168,[293 429 213 295 208],308,4,4628,3.9589392643284858,0.0,0.0
5169,1,1169,[315 509 478 244 221],474,5,4633,3.95982905982906,20.0,0.0
5170,1,1170,[315 509 478 244 221],474,5,4638,3.9607173356105894,20.0,0.0
5171,1,1171,[315 509 478 244 221],474,5,4643,3.96160409556314,20.0,0.0
5172,1,1172,[315 509 478 244 221],474,5,4648,3.9624893435635125,20.0,0.0
5173,1,1173,[315 509 478 244 221],474,5,4653,3.963373083475298,20.0,0.0
5174,1,1174,[315 509 478 244 221],474,5,4658,3.9642553191489363,20.0,0.0
5175,1,1175,[315 509 478 244 221],474,5,4663,3.9651360544217686,20.0,0.0
5176,1,1176,[315 509 478 244 221],474,5,4668,3.966015293118097,20.0,0.0
5177,1,1177,[315 509 478 244 221],474,5,4673,3.966893039049236,20.0,0.0
5178,1,1178,[431 209 250 255 202],479,4,4677,3.9669211195928753,0.0,0.0
5179,1,1179,[315 509 478 244 221],474,5,4682,3.9677966101694917,20.0,0.0
5180,1,1180,[315 509 478 244 221],474,5,4687,3.968670618120237,20.0,0.0
5181,1,1181,[315 509 478 244 221],474,5,4692,3.969543147208122,20.0,0.0
5182,1,1182,[315 509 478 244 221],474,5,4697,3.970414201183432,20.0,0.0
5183,1,1183,[315 509 478 244 221],474,5,4702,3.9712837837837838,20.0,0.0
5184,1,1184,[315 509 478 244 221],474,5,4707,3.972151898734177,20.0,0.0
5185,1,1185,[315 509 478 244 221],474,5,4712,3.973018549747049,20.0,0.0
5186,1,1186,[315 509 478 244 221],474,5,4717,3.973883740522325,20.0,0.0
5187,1,1187,[255 275 508 509 272],378,5,4722,3.974747474747475,0.0,20.0
5188,1,1188,[315 509 478 244 221],474,5,4727,3.975609756097561,20.0,0.0
5189,1,1189,[315 509 478 244 221],474,5,4732,3.976470588235294,20.0,0.0
5190,1,1190,[315 509 478 244 221],474,5,4737,3.977329974811083,20.0,0.0
5191,1,1191,[315 509 478 244 221],474,5,4742,3.978187919463087,20.0,0.0
5192,1,1192,[315 509 478 244 221],474,5,4747,3.9790444258172672,20.0,0.0
5193,1,1193,[300 276 321 236 331],486,2,4749,3.977386934673367,0.0,40.0
5194,1,1194,[315 509 478 244 221],474,5,4754,3.9782426778242677,20.0,0.0
5195,1,1195,[315 509 478 244 221],474,5,4759,3.979096989966555,20.0,0.0
5196,1,1196,[315 509 478 244 221],474,5,4764,3.979949874686717,20.0,0.0
5197,1,1197,[315 509 478 244 221],474,5,4769,3.9808013355592653,20.0,0.0
5198,1,1198,[315 509 478 244 221],474,5,4774,3.981651376146789,20.0,0.0
5199,1,1199,[315 509 478 244 221],474,5,4779,3.9825,20.0,0.0
5200,1,1200,[222 215 261 485 431],13,1,4780,3.980016652789342,0.0,20.0
5201,1,1201,[301 298 299 295 250],486,1,4781,3.9775374376039934,0.0,0.0
5202,1,1202,[315 509 478 244 221],474,5,4786,3.978387364921031,20.0,0.0
5203,1,1203,[315 509 478 244 221],474,5,4791,3.979235880398671,20.0,0.0
5204,1,1204,[315 509 478 244 221],474,5,4796,3.9800829875518673,20.0,0.0
5205,1,1205,[315 509 478 244 221],474,5,4801,3.9809286898839136,20.0,0.0
5206,1,1206,[208 218 336 223 507],13,2,4803,3.979287489643745,20.0,0.0
5207,1,1207,[315 509 478 244 221],474,5,4808,3.980132450331126,20.0,0.0
5208,1,1208,[315 509 478 244 221],474,5,4813,3.980976013234078,20.0,0.0
5209,1,1209,[315 509 478 244 221],474,5,4818,3.981818181818182,20.0,0.0
5210,1,1210,[315 509 478 244 221],474,5,4823,3.9826589595375723,20.0,0.0
5211,1,1211,[315 509 478 244 221],474,5,4828,3.9834983498349836,20.0,0.0
5212,1,1212,[315 509 478 244 221],474,5,4833,3.9843363561417973,20.0,0.0
5213,1,1213,[481 508 261 227 321],13,1,4834,3.981878088962109,0.0,0.0
5214,1,1214,[315 509 478 244 221],474,5,4839,3.982716049382716,20.0,0.0
5215,1,1215,[315 509 478 244 221],474,5,4844,3.9835526315789473,20.0,0.0
5216,1,1216,[315 509 478 244 221],474,5,4849,3.9843878389482335,20.0,0.0
5217,1,1217,[315 509 478 244 221],474,5,4854,3.9852216748768474,20.0,0.0
5218,1,1218,[315 509 478 244 221],474,5,4859,3.9860541427399507,20.0,0.0
5219,1,1219,[315 509 478 244 221],474,5,4864,3.9868852459016395,20.0,0.0
5220,1,1220,[315 509 478 244 221],474,5,4869,3.9877149877149876,20.0,0.0
5221,1,1221,[315 509 478 244 221],474,5,4874,3.988543371522095,20.0,0.0
5222,1,1222,[315 509 478 244 221],474,5,4879,3.989370400654129,20.0,0.0
5223,1,1223,[326 297 222 303 221],334,4,4883,3.9893790849673203,20.0,20.0
5224,1,1224,[315 509 478 244 221],474,5,4888,3.990204081632653,20.0,0.0
5225,1,1225,[315 509 478 244 221],474,5,4893,3.9910277324632952,20.0,0.0
5226,1,1226,[315 509 478 244 221],474,5,4898,3.9918500407497963,20.0,0.0
5227,1,1227,[315 509 478 244 221],474,5,4903,3.992671009771987,20.0,0.0
5228,1,1228,[291 215 429 478 367],892,5,4908,3.9934906427990238,0.0,0.0
5229,1,1229,[315 509 478 244 221],474,5,4913,3.9943089430894307,20.0,0.0
5230,1,1230,[315 509 478 244 221],474,5,4918,3.9951259138911452,20.0,0.0
5231,1,1231,[315 509 478 244 221],474,5,4923,3.9959415584415585,20.0,0.0
5232,1,1232,[315 509 478 244 221],474,5,4928,3.9967558799675587,20.0,0.0
5233,1,1233,[481 244 326 315 208],334,3,4931,3.9959481361426255,20.0,0.0
5234,1,1234,[291 221 239 230 241],524,3,4934,3.9951417004048584,0.0,0.0
5235,1,1235,[315 509 478 244 221],474,5,4939,3.9959546925566345,20.0,0.0
5236,1,1236,[315 509 478 244 221],474,5,4944,3.996766370250606,20.0,0.0
5237,1,1237,[315 509 478 244 221],474,5,4949,3.997576736672052,20.0,0.0
5238,1,1238,[315 509 478 244 221],474,5,4954,3.9983857949959645,20.0,0.0
5239,1,1239,[478 208 222 378 216],474,4,4958,3.9983870967741937,0.0,20.0
5240,1,1240,[315 509 478 244 221],474,5,4963,3.999194198227236,20.0,0.0
5241,1,1241,[219 508 218 209 221],385,2,4965,3.997584541062802,0.0,0.0
5242,1,1242,[272 284 303 295 300],894,3,4968,3.996781979082864,0.0,20.0
5243,1,1243,[315 509 478 244 221],474,5,4973,3.997588424437299,20.0,0.0
5244,1,1244,[315 509 478 244 221],474,5,4978,3.9983935742971886,20.0,0.0
5245,1,1245,[315 509 478 244 221],474,5,4983,3.9991974317817016,20.0,0.0
5246,1,1246,[315 509 478 244 221],474,5,4988,4.0,20.0,0.0
5247,1,1247,[315 509 478 244 221],474,5,4993,4.000801282051282,20.0,0.0
5248,1,1248,[481 244 231 220 268],334,2,4995,3.99919935948759,0.0,0.0
5249,1,1249,[315 509 478 244 221],474,5,5000,4.0,20.0,0.0
5250,1,1250,[315 509 478 244 221],474,5,5005,4.000799360511591,20.0,0.0
5251,1,1251,[315 509 478 244 221],474,5,5010,4.001597444089457,20.0,0.0
5252,1,1252,[315 509 478 244 221],474,5,5015,4.002394253790902,20.0,0.0
5253,1,1253,[276 218 223 209 216],194,2,5017,4.000797448165869,20.0,20.0
5254,1,1254,[315 509 478 244 221],474,5,5022,4.001593625498008,20.0,0.0
5255,1,1255,[315 509 478 244 221],474,5,5027,4.002388535031847,20.0,0.0
5256,1,1256,[315 509 478 244 221],474,5,5032,4.003182179793158,20.0,0.0
5257,1,1257,[315 509 478 244 221],474,5,5037,4.003974562798092,20.0,0.0
5258,1,1258,[315 509 478 244 221],474,5,5042,4.004765687053217,20.0,0.0
5259,1,1259,[315 509 478 244 221],474,5,5047,4.0055555555555555,20.0,0.0
5260,1,1260,[315 509 478 244 221],474,5,5052,4.006344171292625,20.0,0.0
5261,1,1261,[315 509 478 244 221],474,5,5057,4.007131537242472,20.0,0.0
5262,1,1262,[315 509 478 244 221],474,5,5062,4.0079176563737136,20.0,0.0
5263,1,1263,[315 509 478 244 221],474,5,5067,4.00870253164557,20.0,0.0
5264,1,1264,[315 509 478 244 221],474,5,5072,4.009486166007905,20.0,0.0
5265,1,1265,[315 509 478 244 221],474,5,5077,4.010268562401264,20.0,0.0
5266,1,1266,[211 485 583 226 230],59,4,5081,4.01026045777427,0.0,20.0
5267,1,1267,[293 243 275 367 227],533,2,5083,4.0086750788643535,0.0,20.0
5268,1,1268,[315 509 478 244 221],474,5,5088,4.009456264775413,20.0,0.0
5269,1,1269,[315 509 478 244 221],474,5,5093,4.010236220472441,20.0,0.0
5270,1,1270,[315 509 478 244 221],474,5,5098,4.011014948859166,20.0,0.0
5271,1,1271,[315 509 478 244 221],474,5,5103,4.011792452830188,20.0,0.0
5272,1,1272,[315 509 478 244 221],474,5,5108,4.012568735271014,20.0,0.0
5273,1,1273,[315 509 478 244 221],474,5,5113,4.0133437990580845,20.0,0.0
5274,1,1274,[218 231 452 336 344],13,0,5113,4.010196078431372,0.0,0.0
5275,1,1275,[315 509 478 244 221],474,5,5118,4.0109717868338555,20.0,0.0
5276,1,1276,[315 509 478 244 221],474,5,5123,4.011746280344558,20.0,0.0
5277,1,1277,[315 509 478 244 221],474,5,5128,4.012519561815337,20.0,0.0
5278,1,1278,[315 509 478 244 221],474,5,5133,4.013291634089132,20.0,0.0
5279,1,1279,[315 509 478 244 221],474,5,5138,4.0140625,20.0,0.0
5280,1,1280,[315 509 478 244 221],474,5,5143,4.014832162373146,20.0,0.0
5281,1,1281,[315 509 478 244 221],474,5,5148,4.015600624024961,20.0,0.0
5282,1,1282,[315 509 478 244 221],474,5,5153,4.016367887763056,20.0,0.0
5283,1,1283,[315 509 478 244 221],474,5,5158,4.017133956386293,20.0,0.0
5284,1,1284,[315 509 478 244 221],474,5,5163,4.017898832684825,20.0,0.0
5285,1,1285,[326 303 212 219 431],13,2,5165,4.016329704510109,0.0,0.0
5286,1,1286,[315 509 478 244 221],474,5,5170,4.017094017094017,20.0,0.0
5287,1,1287,[315 509 478 244 221],474,5,5175,4.017857142857143,20.0,0.0
5288,1,1288,[315 509 478 244 221],474,5,5180,4.018619084561676,20.0,0.0
5289,1,1289,[485 326 367 255 283],454,4,5184,4.018604651162791,0.0,0.0
5290,1,1290,[300 429 315 216 241],537,1,5185,4.016266460108443,20.0,20.0
5291,1,1291,[315 509 478 244 221],474,5,5190,4.0170278637770895,20.0,0.0
5292,1,1292,[315 509 478 244 221],474,5,5195,4.017788089713844,20.0,0.0
5293,1,1293,[315 509 478 244 221],474,5,5200,4.01854714064915,20.0,0.0
5294,1,1294,[315 509 478 244 221],474,5,5205,4.019305019305019,20.0,0.0
5295,1,1295,[226 298 241 232 208],158,2,5207,4.017746913580247,0.0,0.0
5296,1,1296,[315 509 478 244 221],474,5,5212,4.018504240555127,20.0,0.0
5297,1,1297,[316 261 239 232 268],13,3,5215,4.017719568567026,20.0,0.0
5298,1,1298,[315 509 478 244 221],474,5,5220,4.018475750577367,20.0,0.0
5299,1,1299,[315 509 478 244 221],474,5,5225,4.019230769230769,20.0,0.0
5300,1,1300,[315 509 478 244 221],474,5,5230,4.019984627209839,20.0,0.0
5301,1,1301,[429 509 215 211 478],406,3,5233,4.019201228878648,0.0,20.0
5302,1,1302,[315 509 478 244 221],474,5,5238,4.019953952417498,20.0,0.0
5303,1,1303,[315 509 478 244 221],474,5,5243,4.020705521472393,20.0,0.0
5304,1,1304,[244 221 303 276 264],486,3,5246,4.01992337164751,0.0,20.0
5305,1,1305,[315 509 478 221 244],474,5,5251,4.020673813169985,20.0,0.0
5306,1,1306,[315 509 478 221 244],474,5,5256,4.02142310635042,20.0,0.0
5307,1,1307,[211 367 218 219 216],308,3,5259,4.020642201834862,0.0,20.0
5308,1,1308,[241 212 211 272 431],659,3,5262,4.019862490450726,0.0,20.0
5309,1,1309,[315 509 478 221 244],474,5,5267,4.0206106870229,20.0,0.0
5310,1,1310,[315 509 478 221 244],474,5,5272,4.021357742181541,20.0,0.0
5311,1,1311,[315 509 478 221 244],474,5,5277,4.022103658536586,20.0,0.0
5312,1,1312,[315 509 478 221 244],474,5,5282,4.022848438690023,20.0,0.0
5313,1,1313,[215 244 212 259 276],474,4,5286,4.0228310502283104,0.0,20.0
5314,1,1314,[315 509 478 221 244],474,5,5291,4.023574144486692,20.0,0.0
5315,1,1315,[315 509 478 221 244],474,5,5296,4.024316109422492,20.0,0.0
5316,1,1316,[315 509 478 221 244],474,5,5301,4.0250569476082,20.0,0.0
5317,1,1317,[239 211 326 208 230],311,2,5303,4.023520485584219,0.0,20.0
5318,1,1318,[227 219 209 275 420],95,3,5306,4.022744503411675,0.0,20.0
5319,1,1319,[230 222 298 240 284],145,4,5310,4.0227272727272725,0.0,20.0
5320,1,1320,[315 509 478 221 244],474,5,5315,4.023467070401211,20.0,0.0
5321,1,1321,[315 509 478 221 244],474,5,5320,4.024205748865356,20.0,0.0
5322,1,1322,[478 212 367 215 299],13,3,5323,4.023431594860166,0.0,0.0
5323,1,1323,[315 509 478 221 244],474,5,5328,4.02416918429003,20.0,0.0
5324,1,1324,[315 509 478 221 244],474,5,5333,4.0249056603773585,20.0,0.0
5325,1,1325,[268 246 276 216 297],6,1,5334,4.02262443438914,20.0,20.0
5326,1,1326,[315 509 478 221 244],474,5,5339,4.023360964581763,20.0,0.0
5327,1,1327,[272 227 275 226 208],13,4,5343,4.023343373493976,0.0,20.0
5328,1,1328,[315 509 478 221 244],474,5,5348,4.024078254326561,20.0,0.0
5329,1,1329,[315 509 478 221 244],474,5,5353,4.024812030075188,20.0,0.0
5330,1,1330,[315 509 478 221 244],474,5,5358,4.025544703230653,20.0,0.0
5331,1,1331,[485 478 298 226 208],339,3,5361,4.024774774774775,0.0,0.0
5332,1,1332,[315 509 478 221 244],474,5,5366,4.025506376594149,20.0,0.0
5333,1,1333,[315 509 478 221 244],474,5,5371,4.02623688155922,20.0,0.0
5334,1,1334,[315 509 478 221 244],474,5,5376,4.026966292134832,20.0,0.0
5335,1,1335,[315 509 478 221 244],474,5,5381,4.027694610778443,20.0,0.0
5336,1,1336,[240 218 284 215 367],64,3,5384,4.026925953627524,0.0,0.0
5337,1,1337,[315 509 478 221 244],474,5,5389,4.027653213751869,20.0,0.0
5338,1,1338,[315 509 478 221 244],474,5,5394,4.028379387602689,20.0,0.0
5339,1,1339,[213 331 301 208 293],666,3,5397,4.027611940298508,0.0,0.0
5340,1,1340,[290 485 226 216 230],524,1,5398,4.025354213273676,0.0,0.0
5341,1,1341,[315 509 478 221 244],474,5,5403,4.026080476900149,20.0,0.0
5342,1,1342,[315 509 478 221 244],474,5,5408,4.0268056589724495,20.0,0.0
5343,1,1343,[315 509 478 221 244],474,5,5413,4.027529761904762,20.0,0.0
5344,1,1344,[315 509 478 221 244],474,5,5418,4.028252788104089,20.0,0.0
5345,1,1345,[315 509 478 221 244],474,5,5423,4.028974739970282,20.0,0.0
5346,1,1346,[384 212 316 452 350],13,2,5425,4.0274684484038605,20.0,0.0
5347,1,1347,[315 509 478 221 244],474,5,5430,4.028189910979228,20.0,0.0
5348,1,1348,[222 227 243 293 208],387,3,5433,4.0274277242401775,0.0,20.0
5349,1,1349,[315 509 478 221 244],474,5,5438,4.028148148148148,20.0,0.0
5350,1,1350,[583 301 241 212 211],524,5,5443,4.028867505551443,0.0,20.0
5351,1,1351,[509 367 290 316 243],13,3,5446,4.02810650887574,20.0,0.0
5352,1,1352,[315 509 478 221 244],474,5,5451,4.028824833702883,20.0,0.0
5353,1,1353,[315 509 478 221 244],474,5,5456,4.029542097488922,20.0,0.0
5354,1,1354,[315 509 478 221 244],474,5,5461,4.030258302583026,20.0,0.0
5355,1,1355,[315 509 478 221 244],474,5,5466,4.030973451327434,20.0,0.0
5356,1,1356,[221 216 283 241 485],85,1,5467,4.028739867354458,0.0,0.0
5357,1,1357,[315 509 478 244 221],474,5,5472,4.029455081001473,20.0,0.0
5358,1,1358,[315 509 478 244 221],474,5,5477,4.030169242089772,20.0,0.0
5359,1,1359,[315 509 478 244 221],474,5,5482,4.030882352941177,20.0,0.0
5360,1,1360,[315 509 478 244 221],474,5,5487,4.031594415870683,20.0,0.0
5361,1,1361,[315 509 478 244 221],474,5,5492,4.03230543318649,20.0,0.0
5362,1,1362,[315 509 478 244 221],474,5,5497,4.033015407190022,20.0,0.0
5363,1,1363,[485 367 201 211 251],385,3,5500,4.032258064516129,20.0,20.0
5364,1,1364,[315 509 478 244 221],474,5,5505,4.032967032967033,20.0,0.0
5365,1,1365,[223 272 275 216 509],90,5,5510,4.033674963396779,20.0,20.0
5366,1,1366,[315 509 478 244 221],474,5,5515,4.034381858083394,20.0,0.0
5367,1,1367,[268 227 295 583 217],387,2,5517,4.032894736842105,0.0,0.0
5368,1,1368,[290 508 321 231 316],13,2,5519,4.0314097881665445,20.0,0.0
5369,1,1369,[315 509 478 244 221],474,5,5524,4.032116788321168,20.0,0.0
5370,1,1370,[315 509 478 244 221],474,5,5529,4.032822757111598,20.0,0.0
5371,1,1371,[315 509 478 244 221],474,5,5534,4.033527696793003,20.0,0.0
5372,1,1372,[315 509 478 244 221],474,5,5539,4.034231609613984,20.0,0.0
5373,1,1373,[212 211 301 231 478],650,2,5541,4.032751091703057,0.0,20.0
5374,1,1374,[315 509 478 244 221],474,5,5546,4.033454545454545,20.0,0.0
5375,1,1375,[315 509 478 244 221],474,5,5551,4.034156976744186,20.0,0.0
5376,1,1376,[507 259 215 291 378],308,0,5551,4.03122730573711,0.0,0.0
5377,1,1377,[315 509 478 244 221],474,5,5556,4.031930333817126,20.0,0.0
5378,1,1378,[315 509 478 244 221],474,5,5561,4.0326323422770125,20.0,0.0
5379,1,1379,[215 221 220 218 303],90,4,5565,4.032608695652174,0.0,0.0
5380,1,1380,[315 509 478 244 221],474,5,5570,4.033309196234613,20.0,0.0
5381,1,1381,[315 509 478 244 221],474,5,5575,4.034008683068017,20.0,0.0
5382,1,1382,[315 509 478 244 221],474,5,5580,4.03470715835141,20.0,0.0
5383,1,1383,[315 509 478 244 221],474,5,5585,4.035404624277457,20.0,0.0
5384,1,1384,[315 509 478 244 221],474,5,5590,4.036101083032491,20.0,0.0
5385,1,1385,[315 509 478 244 221],474,5,5595,4.036796536796537,20.0,0.0
5386,1,1386,[315 509 478 244 221],474,5,5600,4.037490987743331,20.0,0.0
5387,1,1387,[315 509 478 244 221],474,5,5605,4.0381844380403455,20.0,0.0
5388,1,1388,[315 509 478 244 221],474,5,5610,4.038876889848812,20.0,0.0
5389,1,1389,[315 509 478 244 221],474,5,5615,4.039568345323741,20.0,0.0
5390,1,1390,[230 301 315 222 220],334,3,5618,4.03882099209202,20.0,20.0
5391,1,1391,[367 208 429 219 215],234,3,5621,4.038074712643678,0.0,0.0
5392,1,1392,[315 509 478 244 221],474,5,5626,4.038765254845657,20.0,0.0
5393,1,1393,[315 509 478 244 221],474,5,5631,4.039454806312769,20.0,0.0
5394,1,1394,[315 509 478 244 221],474,5,5636,4.040143369175627,20.0,0.0
5395,1,1395,[315 216 481 509 222],474,5,5641,4.0408309455587395,20.0,20.0
5396,1,1396,[315 509 478 244 221],474,5,5646,4.04151753758053,20.0,0.0
5397,1,1397,[216 301 241 378 259],85,2,5648,4.0400572246065805,0.0,0.0
5398,1,1398,[315 509 478 244 221],474,5,5653,4.0407433881343815,20.0,0.0
5399,1,1399,[315 509 478 244 221],474,5,5658,4.041428571428572,20.0,0.0
5400,1,1400,[293 299 297 298 272],894,3,5661,4.0406852248394,20.0,0.0
5401,1,1401,[315 509 478 244 221],474,5,5666,4.041369472182597,20.0,0.0
5402,1,1402,[230 509 211 259 239],308,3,5669,4.040627227369922,0.0,20.0
5403,1,1403,[315 509 478 244 221],474,5,5674,4.0413105413105415,20.0,0.0
5404,1,1404,[315 509 478 244 221],474,5,5679,4.041992882562278,20.0,0.0
5405,1,1405,[315 509 478 244 221],474,5,5684,4.042674253200569,20.0,0.0
5406,1,1406,[315 509 478 244 221],474,5,5689,4.043354655294954,20.0,0.0
5407,1,1407,[336 429 290 276 218],13,3,5692,4.042613636363637,0.0,20.0
5408,1,1408,[315 509 478 244 221],474,5,5697,4.043293115684883,20.0,0.0
5409,1,1409,[429 276 264 239 283],308,2,5699,4.041843971631206,0.0,20.0
5410,1,1410,[315 509 478 244 221],474,5,5704,4.04252303330971,20.0,0.0
5411,1,1411,[315 509 478 244 221],474,5,5709,4.043201133144476,20.0,0.0
5412,1,1412,[315 509 478 244 221],474,5,5714,4.043878273177636,20.0,0.0
5413,1,1413,[291 284 202 420 321],892,4,5718,4.043847241867044,0.0,0.0
5414,1,1414,[315 509 478 244 221],474,5,5723,4.04452296819788,20.0,0.0
5415,1,1415,[300 392 254 218 220],378,1,5724,4.0423728813559325,0.0,20.0
5416,1,1416,[315 509 478 244 221],474,5,5729,4.043048694424841,20.0,0.0
5417,1,1417,[315 509 478 244 221],474,5,5734,4.043723554301834,20.0,0.0
5418,1,1418,[315 509 478 244 221],474,5,5739,4.044397463002114,20.0,0.0
5419,1,1419,[315 509 478 244 221],474,5,5744,4.045070422535211,20.0,0.0
5420,1,1420,[315 509 478 244 221],474,5,5749,4.045742434904996,20.0,0.0
5421,1,1421,[315 509 478 244 221],474,5,5754,4.046413502109704,20.0,0.0
5422,1,1422,[315 509 478 244 221],474,5,5759,4.047083626141954,20.0,0.0
5423,1,1423,[392 219 276 507 201],308,3,5762,4.046348314606742,0.0,20.0
5424,1,1424,[315 509 478 244 221],474,5,5767,4.047017543859649,20.0,0.0
5425,1,1425,[315 509 478 244 221],474,5,5772,4.047685834502103,20.0,0.0
5426,1,1426,[315 509 478 244 221],474,5,5777,4.048353188507358,20.0,0.0
5427,1,1427,[315 509 478 244 221],474,5,5782,4.049019607843137,20.0,0.0
5428,1,1428,[315 509 478 244 221],474,5,5787,4.049685094471658,20.0,0.0
5429,1,1429,[315 509 478 244 221],474,5,5792,4.05034965034965,20.0,0.0
5430,1,1430,[485 202 301 208 284],234,1,5793,4.048218029350105,0.0,0.0
5431,1,1431,[315 509 478 244 221],474,5,5798,4.048882681564246,20.0,0.0
5432,1,1432,[315 509 478 244 221],474,5,5803,4.049546406140963,20.0,0.0
5433,1,1433,[315 509 478 244 221],474,5,5808,4.050209205020921,20.0,0.0
5434,1,1434,[315 509 478 244 221],474,5,5813,4.050871080139373,20.0,0.0
5435,1,1435,[315 509 478 244 221],474,5,5818,4.0515320334261835,20.0,0.0
5436,1,1436,[315 509 478 244 221],474,5,5823,4.052192066805845,20.0,0.0
5437,1,1437,[315 509 478 244 221],474,5,5828,4.052851182197497,20.0,0.0
5438,1,1438,[315 509 478 244 221],474,5,5833,4.053509381514941,20.0,0.0
5439,1,1439,[315 509 478 244 221],474,5,5838,4.054166666666666,20.0,0.0
5440,1,1440,[315 509 478 244 221],474,5,5843,4.054823039555864,20.0,0.0
5441,1,1441,[315 509 478 244 221],474,5,5848,4.055478502080444,20.0,0.0
5442,1,1442,[315 509 478 244 221],474,5,5853,4.056133056133056,20.0,0.0
5443,1,1443,[223 227 202 378 213],7,2,5855,4.054709141274238,20.0,0.0
5444,1,1444,[315 509 478 244 221],474,5,5860,4.055363321799308,20.0,0.0
5445,1,1445,[315 509 478 244 221],474,5,5865,4.056016597510373,20.0,0.0
5446,1,1446,[315 509 478 244 221],474,5,5870,4.0566689702833445,20.0,0.0
5447,1,1447,[384 485 275 215 394],13,1,5871,4.054558011049724,0.0,20.0
5448,1,1448,[315 509 478 244 221],474,5,5876,4.055210489993098,20.0,0.0
5449,1,1449,[315 509 478 244 221],474,5,5881,4.055862068965517,20.0,0.0
5450,1,1450,[315 509 478 244 221],474,5,5886,4.056512749827705,20.0,0.0
5451,1,1451,[315 509 478 244 221],474,5,5891,4.057162534435261,20.0,0.0
5452,1,1452,[394 261 231 218 276],13,1,5892,4.0550584996558845,0.0,20.0
5453,1,1453,[315 509 478 244 221],474,5,5897,4.055708390646492,20.0,0.0
5454,1,1454,[315 509 478 244 221],474,5,5902,4.056357388316151,20.0,0.0
5455,1,1455,[315 509 478 244 221],474,5,5907,4.0570054945054945,20.0,0.0
5456,1,1456,[315 509 478 244 221],474,5,5912,4.057652711050103,20.0,0.0
5457,1,1457,[315 509 478 244 221],474,5,5917,4.058299039780521,20.0,0.0
5458,1,1458,[452 218 223 367 212],92,3,5920,4.057573680603153,20.0,0.0
5459,1,1459,[315 509 478 244 221],474,5,5925,4.058219178082192,20.0,0.0
5460,1,1460,[315 509 478 244 221],474,5,5930,4.05886379192334,20.0,0.0
5461,1,1461,[315 509 478 244 221],474,5,5935,4.059507523939809,20.0,0.0
5462,1,1462,[315 509 478 244 221],474,5,5940,4.06015037593985,20.0,0.0
5463,1,1463,[315 509 478 244 221],474,5,5945,4.060792349726776,20.0,0.0
5464,1,1464,[315 509 478 244 221],474,5,5950,4.061433447098976,20.0,0.0
5465,1,1465,[315 509 478 244 221],474,5,5955,4.062073669849932,20.0,0.0
5466,1,1466,[315 509 478 244 221],474,5,5960,4.062713019768235,20.0,0.0
5467,1,1467,[315 509 478 244 221],474,5,5965,4.063351498637602,20.0,0.0
5468,1,1468,[315 509 478 244 221],474,5,5970,4.063989108236896,20.0,0.0
5469,1,1469,[315 509 478 244 221],474,5,5975,4.0646258503401365,20.0,0.0
5470,1,1470,[315 509 478 244 221],474,5,5980,4.065261726716519,20.0,0.0
5471,1,1471,[315 509 478 244 221],474,5,5985,4.065896739130435,20.0,0.0
5472,1,1472,[315 509 478 244 221],474,5,5990,4.06653088934148,20.0,0.0
5473,1,1473,[315 509 478 244 221],474,5,5995,4.067164179104478,20.0,0.0
5474,1,1474,[315 509 478 244 221],474,5,6000,4.067796610169491,20.0,0.0
5475,1,1475,[315 509 478 244 221],474,5,6005,4.068428184281843,20.0,0.0
5476,1,1476,[291 367 222 219 216],648,3,6008,4.0677048070412996,0.0,20.0
5477,1,1477,[315 509 478 244 221],474,5,6013,4.068335588633288,20.0,0.0
5478,1,1478,[315 509 478 244 221],474,5,6018,4.068965517241379,20.0,0.0
5479,1,1479,[315 509 478 244 221],474,5,6023,4.069594594594594,20.0,0.0
5480,1,1480,[315 509 478 244 221],474,5,6028,4.070222822417286,20.0,0.0
5481,1,1481,[315 509 478 244 221],474,5,6033,4.07085020242915,20.0,0.0
5482,1,1482,[315 509 478 244 221],474,5,6038,4.071476736345246,20.0,0.0
5483,1,1483,[315 509 478 244 221],474,5,6043,4.072102425876011,20.0,0.0
5484,1,1484,[315 509 478 244 221],474,5,6048,4.072727272727272,20.0,0.0
5485,1,1485,[315 509 478 244 221],474,5,6053,4.073351278600269,20.0,0.0
5486,1,1486,[315 509 478 244 221],474,5,6058,4.073974445191661,20.0,0.0
5487,1,1487,[276 326 293 509 221],474,4,6062,4.073924731182796,0.0,20.0
5488,1,1488,[315 509 478 244 221],474,5,6067,4.074546675621222,20.0,0.0
5489,1,1489,[290 272 300 284 378],537,1,6068,4.07248322147651,0.0,20.0
5490,1,1490,[452 301 208 478 280],13,3,6071,4.07176391683434,0.0,0.0
5491,1,1491,[315 509 478 244 221],474,5,6076,4.072386058981233,20.0,0.0
5492,1,1492,[315 509 478 244 221],474,5,6081,4.073007367716008,20.0,0.0
5493,1,1493,[226 291 303 218 283],533,2,6083,4.071619812583668,0.0,0.0
5494,1,1494,[315 509 478 244 221],474,5,6088,4.072240802675585,20.0,0.0
5495,1,1495,[315 509 478 244 221],474,5,6093,4.072860962566845,20.0,0.0
5496,1,1496,[315 509 478 244 221],474,5,6098,4.073480293921175,20.0,0.0
5497,1,1497,[315 509 478 244 221],474,5,6103,4.074098798397864,20.0,0.0
5498,1,1498,[211 219 293 429 202],308,4,6107,4.074049366244163,0.0,20.0
5499,1,1499,[315 509 478 244 221],474,5,6112,4.074666666666666,20.0,0.0
5500,1,1500,[202 223 222 429 384],13,3,6115,4.073950699533644,20.0,20.0
5501,1,1501,[315 509 478 244 221],474,5,6120,4.0745672436751,20.0,0.0
5502,1,1502,[315 509 478 244 221],474,5,6125,4.075182967398536,20.0,0.0
5503,1,1503,[508 240 367 452 215],406,3,6128,4.074468085106383,0.0,0.0
5504,1,1504,[315 509 478 244 221],474,5,6133,4.075083056478405,20.0,0.0
5505,1,1505,[350 321 280 211 216],13,2,6135,4.073705179282869,0.0,20.0
5506,1,1506,[315 509 478 244 221],474,5,6140,4.074319840743199,20.0,0.0
5507,1,1507,[259 226 481 241 301],524,3,6143,4.073607427055703,0.0,0.0
5508,1,1508,[315 509 478 244 221],474,5,6148,4.074221338634858,20.0,0.0
5509,1,1509,[315 509 478 244 221],474,5,6153,4.074834437086093,20.0,0.0
5510,1,1510,[315 509 478 244 221],474,5,6158,4.075446724023825,20.0,0.0
5511,1,1511,[315 509 478 244 221],474,5,6163,4.076058201058201,20.0,0.0
5512,1,1512,[315 509 478 244 221],474,5,6168,4.0766688697951095,20.0,0.0
5513,1,1513,[315 509 478 244 221],474,5,6173,4.077278731836196,20.0,0.0
5514,1,1514,[315 509 478 244 221],474,5,6178,4.077887788778878,20.0,0.0
5515,1,1515,[216 431 221 275 213],474,4,6182,4.077836411609499,0.0,20.0
5516,1,1516,[275 218 219 350 509],13,1,6183,4.075807514831905,0.0,20.0
5517,1,1517,[213 485 216 298 275],6,4,6187,4.075757575757576,0.0,20.0
5518,1,1518,[315 509 478 244 221],474,5,6192,4.076366030283081,20.0,0.0
5519,1,1519,[315 509 478 244 221],474,5,6197,4.076973684210526,20.0,0.0
5520,1,1520,[315 509 478 244 221],474,5,6202,4.077580539119,20.0,0.0
5521,1,1521,[315 509 478 244 221],474,5,6207,4.078186596583443,20.0,0.0
5522,1,1522,[315 509 478 244 221],474,5,6212,4.078791858174656,20.0,0.0
5523,1,1523,[315 509 478 244 221],474,5,6217,4.079396325459317,20.0,0.0
5524,1,1524,[315 509 478 244 221],474,5,6222,4.08,20.0,0.0
5525,1,1525,[315 509 478 244 221],474,5,6227,4.080602883355177,20.0,0.0
5526,1,1526,[315 509 478 244 221],474,5,6232,4.08120497707924,20.0,0.0
5527,1,1527,[315 509 478 244 221],474,5,6237,4.081806282722513,20.0,0.0
5528,1,1528,[315 509 478 244 221],474,5,6242,4.0824068018312625,20.0,0.0
5529,1,1529,[300 326 315 218 367],311,3,6245,4.0816993464052285,20.0,20.0
5530,1,1530,[201 215 208 276 293],308,4,6249,4.081645983017635,0.0,20.0
5531,1,1531,[326 509 394 217 212],13,2,6251,4.080287206266319,0.0,0.0
5532,1,1532,[315 509 478 244 221],474,5,6256,4.0808871493803,20.0,0.0
5533,1,1533,[315 509 478 244 221],474,5,6261,4.081486310299869,20.0,0.0
5534,1,1534,[243 232 315 481 223],13,2,6263,4.080130293159609,40.0,0.0
5535,1,1535,[315 509 478 244 221],474,5,6268,4.080729166666667,20.0,0.0
5536,1,1536,[315 509 478 244 221],474,5,6273,4.081327260897853,20.0,0.0
5537,1,1537,[315 509 478 244 221],474,5,6278,4.081924577373212,20.0,0.0
5538,1,1538,[315 509 478 244 221],474,5,6283,4.082521117608837,20.0,0.0
5539,1,1539,[478 301 264 226 413],13,3,6286,4.081818181818182,0.0,0.0
5540,1,1540,[315 509 478 244 221],474,5,6291,4.0824140168721605,20.0,0.0
5541,1,1541,[315 509 478 244 221],474,5,6296,4.083009079118028,20.0,0.0
5542,1,1542,[315 509 478 244 221],474,5,6301,4.083603370058328,20.0,0.0
5543,1,1543,[232 326 321 227 431],311,2,6303,4.0822538860103625,0.0,0.0
5544,1,1544,[315 509 478 244 221],474,5,6308,4.082847896440129,20.0,0.0
5545,1,1545,[315 509 478 244 221],474,5,6313,4.083441138421733,20.0,0.0
5546,1,1546,[315 509 478 244 221],474,5,6318,4.084033613445378,20.0,0.0
5547,1,1547,[215 420 321 413 300],13,2,6320,4.082687338501292,0.0,20.0
5548,1,1548,[315 509 478 244 221],474,5,6325,4.08327953518399,20.0,0.0
5549,1,1549,[315 509 478 244 221],474,5,6330,4.083870967741936,20.0,0.0
5550,1,1550,[315 509 478 244 221],474,5,6335,4.084461637653127,20.0,0.0
5551,1,1551,[315 509 478 244 221],474,5,6340,4.085051546391752,20.0,0.0
5552,1,1552,[315 509 478 244 221],474,5,6345,4.085640695428204,20.0,0.0
5553,1,1553,[315 509 478 244 221],474,5,6350,4.086229086229086,20.0,0.0
5554,1,1554,[315 509 478 244 221],474,5,6355,4.086816720257235,20.0,0.0
5555,1,1555,[275 208 485 481 244],474,3,6358,4.086118251928021,0.0,20.0
5556,1,1556,[239 272 212 384 276],13,4,6362,4.086062941554271,0.0,20.0
5557,1,1557,[300 215 350 290 272],13,3,6365,4.085365853658536,0.0,20.0
5558,1,1558,[315 509 478 244 221],474,5,6370,4.0859525336754325,20.0,0.0
5559,1,1559,[485 261 300 201 413],13,0,6370,4.083333333333333,0.0,20.0
5560,1,1560,[315 509 478 244 221],474,5,6375,4.0839205637411915,20.0,0.0
5561,1,1561,[315 509 478 244 221],474,5,6380,4.084507042253521,20.0,0.0
5562,1,1562,[315 509 478 244 221],474,5,6385,4.0850927703135,20.0,0.0
5563,1,1563,[315 509 478 244 221],474,5,6390,4.085677749360614,20.0,0.0
5564,1,1564,[315 509 478 244 221],474,5,6395,4.086261980830671,20.0,0.0
5565,1,1565,[507 226 301 394 331],13,1,6396,4.084291187739463,0.0,0.0
5566,1,1566,[202 481 264 222 331],13,2,6398,4.082961072112316,0.0,20.0
5567,1,1567,[315 509 478 244 221],474,5,6403,4.083545918367347,20.0,0.0
5568,1,1568,[280 219 201 232 241],13,1,6404,4.081580624601657,0.0,0.0
5569,1,1569,[315 509 478 244 221],474,5,6409,4.0821656050955415,20.0,0.0
5570,1,1570,[315 509 478 244 221],474,5,6414,4.082749840865691,20.0,0.0
5571,1,1571,[211 264 303 239 275],13,4,6418,4.082697201017812,0.0,40.0
5572,1,1572,[315 509 478 244 221],474,5,6423,4.083280356007629,20.0,0.0
5573,1,1573,[507 216 231 215 209],13,1,6424,4.081321473951715,0.0,0.0
5574,1,1574,[315 509 478 244 221],474,5,6429,4.081904761904762,20.0,0.0
5575,1,1575,[315 509 478 244 221],474,5,6434,4.08248730964467,20.0,0.0
5576,1,1576,[315 509 478 244 221],474,5,6439,4.083069118579582,20.0,0.0
5577,1,1577,[315 509 478 244 221],474,5,6444,4.083650190114068,20.0,0.0
5578,1,1578,[215 293 216 367 291],308,2,6446,4.082330588980367,0.0,0.0
5579,1,1579,[298 232 217 583 221],158,1,6447,4.080379746835443,0.0,0.0
5580,1,1580,[315 509 478 244 221],474,5,6452,4.0809614168247945,20.0,0.0
5581,1,1581,[315 509 478 244 221],474,5,6457,4.081542351453856,20.0,0.0
5582,1,1582,[315 509 478 244 221],474,5,6462,4.082122552116235,20.0,0.0
5583,1,1583,[315 509 478 244 221],474,5,6467,4.08270202020202,20.0,0.0
5584,1,1584,[315 509 478 244 221],474,5,6472,4.083280757097792,20.0,0.0
5585,1,1585,[315 509 478 244 221],474,5,6477,4.083858764186633,20.0,0.0
5586,1,1586,[315 509 478 244 221],474,5,6482,4.084436042848141,20.0,0.0
5587,1,1587,[315 509 478 244 221],474,5,6487,4.085012594458438,20.0,0.0
5588,1,1588,[315 509 478 244 221],474,5,6492,4.085588420390183,20.0,0.0
5589,1,1589,[315 509 478 244 221],474,5,6497,4.086163522012579,20.0,0.0
5590,1,1590,[315 509 478 244 221],474,5,6502,4.086737900691389,20.0,0.0
5591,1,1591,[315 509 478 244 221],474,5,6507,4.0873115577889445,20.0,0.0
5592,1,1592,[315 509 478 244 221],474,5,6512,4.087884494664156,20.0,0.0
5593,1,1593,[315 509 478 244 221],474,5,6517,4.088456712672522,20.0,0.0
5594,1,1594,[215 213 321 243 221],234,0,6517,4.0858934169279,0.0,0.0
5595,1,1595,[315 509 478 244 221],474,5,6522,4.086466165413534,20.0,0.0
5596,1,1596,[315 509 478 244 221],474,5,6527,4.08703819661866,20.0,0.0
5597,1,1597,[315 509 478 244 221],474,5,6532,4.0876095118898625,20.0,0.0
5598,1,1598,[209 367 259 239 222],524,2,6534,4.086303939962477,0.0,20.0
5599,1,1599,[315 509 478 244 221],474,5,6539,4.086875,20.0,0.0
5600,1,1600,[315 509 478 244 221],474,5,6544,4.087445346658338,20.0,0.0
5601,1,1601,[226 212 209 291 219],92,4,6548,4.087390761548065,0.0,0.0
5602,1,1602,[303 208 290 275 485],334,3,6551,4.0867124142233315,0.0,20.0
5603,1,1603,[275 272 217 344 222],13,1,6552,4.084788029925187,0.0,40.0
5604,1,1604,[315 509 478 244 221],474,5,6557,4.085358255451713,20.0,0.0
5605,1,1605,[315 509 478 244 221],474,5,6562,4.085927770859278,20.0,0.0
5606,1,1606,[315 509 478 244 221],474,5,6567,4.086496577473553,20.0,0.0
5607,1,1607,[315 509 478 244 221],474,5,6572,4.087064676616915,20.0,0.0
5608,1,1608,[315 509 478 244 221],474,5,6577,4.0876320696084525,20.0,0.0
5609,1,1609,[315 509 478 244 221],474,5,6582,4.088198757763975,20.0,0.0
5610,1,1610,[315 509 478 244 221],474,5,6587,4.088764742396028,20.0,0.0
5611,1,1611,[315 509 478 244 221],474,5,6592,4.089330024813896,20.0,0.0
5612,1,1612,[315 509 478 244 221],474,5,6597,4.089894606323621,20.0,0.0
5613,1,1613,[315 509 478 244 221],474,5,6602,4.090458488228005,20.0,0.0
5614,1,1614,[315 509 478 244 221],474,5,6607,4.091021671826625,20.0,0.0
5615,1,1615,[509 276 485 209 213],474,5,6612,4.091584158415841,0.0,20.0
5616,1,1616,[315 509 478 244 221],474,5,6617,4.092145949288806,20.0,0.0
5617,1,1617,[315 509 478 244 221],474,5,6622,4.092707045735476,20.0,0.0
5618,1,1618,[315 509 478 244 221],474,5,6627,4.093267449042619,20.0,0.0
5619,1,1619,[315 509 478 244 221],474,5,6632,4.093827160493827,20.0,0.0
5620,1,1620,[268 211 209 239 272],537,4,6636,4.093769278223319,0.0,20.0
5621,1,1621,[315 509 478 244 221],474,5,6641,4.094327990135635,20.0,0.0
5622,1,1622,[315 509 478 244 221],474,5,6646,4.094886013555144,20.0,0.0
5623,1,1623,[301 243 326 239 211],13,2,6648,4.093596059113301,0.0,20.0
5624,1,1624,[315 509 478 244 221],474,5,6653,4.094153846153846,20.0,0.0
5625,1,1625,[315 509 478 244 221],474,5,6658,4.094710947109471,20.0,0.0
5626,1,1626,[315 509 478 244 221],474,5,6663,4.095267363245236,20.0,0.0
5627,1,1627,[315 509 478 244 221],474,5,6668,4.0958230958230954,20.0,0.0
5628,1,1628,[213 240 239 212 220],406,1,6669,4.093922651933702,0.0,0.0
5629,1,1629,[315 509 478 244 221],474,5,6674,4.094478527607362,20.0,0.0
5630,1,1630,[315 509 478 244 221],474,5,6679,4.095033721643164,20.0,0.0
5631,1,1631,[219 208 206 211 209],387,3,6682,4.0943627450980395,0.0,20.0
5632,1,1632,[315 509 478 244 221],474,5,6687,4.094917330067361,20.0,0.0
5633,1,1633,[284 259 202 300 301],145,3,6690,4.094247246022031,0.0,20.0
5634,1,1634,[212 429 300 264 272],13,4,6694,4.094189602446483,0.0,20.0
5635,1,1635,[378 481 315 276 216],271,3,6697,4.093520782396088,20.0,20.0
5636,1,1636,[299 243 321 478 216],13,1,6698,4.0916310323762985,0.0,0.0
5637,1,1637,[315 509 478 244 221],474,5,6703,4.092185592185592,20.0,0.0
5638,1,1638,[315 509 478 244 221],474,5,6708,4.092739475289811,20.0,0.0
5639,1,1639,[315 509 478 244 221],474,5,6713,4.09329268292683,20.0,0.0
5640,1,1640,[315 509 478 244 221],474,5,6718,4.0938452163315056,20.0,0.0
5641,1,1641,[315 509 478 244 221],474,5,6723,4.094397076735688,20.0,0.0
5642,1,1642,[367 211 508 226 215],533,4,6727,4.09433962264151,0.0,20.0
5643,1,1643,[367 241 485 452 211],326,2,6729,4.093065693430657,0.0,20.0
5644,1,1644,[321 394 272 413 326],13,1,6730,4.091185410334346,0.0,0.0
5645,1,1645,[507 216 223 508 243],13,1,6731,4.089307411907655,20.0,0.0
5646,1,1646,[315 509 478 244 221],474,5,6736,4.089860352155434,20.0,0.0
5647,1,1647,[315 509 478 244 221],474,5,6741,4.090412621359223,20.0,0.0
5648,1,1648,[315 509 478 244 221],474,5,6746,4.090964220739842,20.0,0.0
5649,1,1649,[315 509 478 244 221],474,5,6751,4.091515151515152,20.0,0.0
5650,1,1650,[315 509 478 244 221],474,5,6756,4.092065414900061,20.0,0.0
5651,1,1651,[344 481 326 227 218],13,1,6757,4.090193704600484,0.0,0.0
5652,1,1652,[315 509 478 244 221],474,5,6762,4.090744101633394,20.0,0.0
5653,1,1653,[315 509 478 244 221],474,5,6767,4.091293833131802,20.0,0.0
5654,1,1654,[315 509 478 244 221],474,5,6772,4.091842900302114,20.0,0.0
5655,1,1655,[315 509 478 244 221],474,5,6777,4.092391304347826,20.0,0.0
5656,1,1656,[315 509 478 244 221],474,5,6782,4.092939046469524,20.0,0.0
5657,1,1657,[230 291 509 485 293],474,4,6786,4.092882991556092,0.0,0.0
5658,1,1658,[315 509 478 244 221],474,5,6791,4.093429776974081,20.0,0.0
5659,1,1659,[315 509 478 244 221],474,5,6796,4.093975903614457,20.0,0.0
5660,1,1660,[315 509 478 244 221],474,5,6801,4.094521372667068,20.0,0.0
5661,1,1661,[208 507 220 259 272],90,3,6804,4.093862815884476,0.0,0.0
5662,1,1662,[315 509 478 244 221],474,5,6809,4.094407696933253,20.0,0.0
5663,1,1663,[315 509 478 244 221],474,5,6814,4.094951923076923,20.0,0.0
5664,1,1664,[315 509 478 244 221],474,5,6819,4.095495495495496,20.0,0.0
5665,1,1665,[284 222 211 507 485],406,2,6821,4.094237695078031,0.0,40.0
5666,1,1666,[315 509 478 244 221],474,5,6826,4.094781043791242,20.0,0.0
5667,1,1667,[297 213 326 303 331],894,4,6830,4.094724220623501,20.0,0.0
5668,1,1668,[326 209 481 246 236],334,3,6833,4.094068304373876,0.0,0.0
5669,1,1669,[315 509 478 244 221],474,5,6838,4.094610778443114,20.0,0.0
5670,1,1670,[315 509 478 244 221],474,5,6843,4.095152603231598,20.0,0.0
5671,1,1671,[315 509 478 244 221],474,5,6848,4.095693779904306,20.0,0.0
5672,1,1672,[315 509 478 244 221],474,5,6853,4.096234309623431,20.0,0.0
5673,1,1673,[315 509 478 244 221],474,5,6858,4.096774193548387,20.0,0.0
5674,1,1674,[315 509 478 244 221],474,5,6863,4.097313432835821,20.0,0.0
5675,1,1675,[315 509 478 244 221],474,5,6868,4.097852028639618,20.0,0.0
5676,1,1676,[315 509 478 244 221],474,5,6873,4.098389982110913,20.0,0.0
5677,1,1677,[315 509 478 244 221],474,5,6878,4.098927294398093,20.0,0.0
5678,1,1678,[315 509 478 244 221],474,5,6883,4.099463966646813,20.0,0.0
5679,1,1679,[315 509 478 244 221],474,5,6888,4.1,20.0,0.0
5680,1,1680,[315 509 478 244 221],474,5,6893,4.100535395597858,20.0,0.0
5681,1,1681,[315 509 478 244 221],474,5,6898,4.101070154577884,20.0,0.0
5682,1,1682,[315 509 478 244 221],474,5,6903,4.101604278074866,20.0,0.0
5683,1,1683,[315 509 478 244 221],474,5,6908,4.102137767220903,20.0,0.0
5684,1,1684,[315 509 478 244 221],474,5,6913,4.102670623145401,20.0,0.0
5685,1,1685,[315 509 478 244 221],474,5,6918,4.103202846975089,20.0,0.0
5686,1,1686,[315 509 478 244 221],474,5,6923,4.1037344398340245,20.0,0.0
5687,1,1687,[315 509 478 244 221],474,5,6928,4.104265402843602,20.0,0.0
5688,1,1688,[315 509 478 244 221],474,5,6933,4.104795737122558,20.0,0.0
5689,1,1689,[315 509 478 244 221],474,5,6938,4.105325443786982,20.0,0.0
5690,1,1690,[315 509 478 244 221],474,5,6943,4.105854523950326,20.0,0.0
5691,1,1691,[315 509 478 244 221],474,5,6948,4.1063829787234045,20.0,0.0
5692,1,1692,[201 276 321 291 284],308,3,6951,4.105729474305965,0.0,20.0
5693,1,1693,[315 509 478 244 221],474,5,6956,4.106257378984652,20.0,0.0
5694,1,1694,[202 254 239 378 209],308,2,6958,4.105014749262537,0.0,0.0
5695,1,1695,[315 509 478 244 221],474,5,6963,4.105542452830188,20.0,0.0
5696,1,1696,[315 509 478 244 221],474,5,6968,4.106069534472598,20.0,0.0
5697,1,1697,[315 509 478 244 221],474,5,6973,4.106595995288575,20.0,0.0
5698,1,1698,[315 509 478 244 221],474,5,6978,4.107121836374338,20.0,0.0
5699,1,1699,[315 509 478 244 221],474,5,6983,4.107647058823529,20.0,0.0
5700,1,1700,[315 509 478 244 221],474,5,6988,4.108171663727219,20.0,0.0
5701,1,1701,[315 509 478 244 221],474,5,6993,4.108695652173913,20.0,0.0
5702,1,1702,[212 478 209 316 283],474,4,6997,4.108631826189078,20.0,0.0
5703,1,1703,[315 509 478 244 221],474,5,7002,4.109154929577465,20.0,0.0
5704,1,1704,[315 509 478 244 221],474,5,7007,4.109677419354838,20.0,0.0
5705,1,1705,[315 509 478 244 221],474,5,7012,4.110199296600235,20.0,0.0
5706,1,1706,[315 509 478 244 221],474,5,7017,4.110720562390158,20.0,0.0
5707,1,1707,[367 221 268 276 202],90,4,7021,4.110655737704918,0.0,20.0
5708,1,1708,[315 509 478 244 221],474,5,7026,4.111176126389702,20.0,0.0
5709,1,1709,[231 226 216 392 284],537,0,7026,4.108771929824561,0.0,0.0
5710,1,1710,[315 509 478 244 221],474,5,7031,4.109292811221508,20.0,0.0
5711,1,1711,[219 365 583 276 215],308,2,7033,4.108060747663552,0.0,20.0
5712,1,1712,[218 420 321 209 367],311,1,7034,4.106246351430239,0.0,0.0
5713,1,1713,[290 508 326 316 301],334,1,7035,4.1044340723453905,20.0,0.0
5714,1,1714,[243 284 230 315 485],537,1,7036,4.1026239067055394,20.0,0.0
5715,1,1715,[216 284 212 227 254],804,4,7040,4.102564102564102,0.0,0.0
5716,1,1716,[315 509 478 244 221],474,5,7045,4.103086779266162,20.0,0.0
5717,1,1717,[272 420 301 431 243],13,2,7047,4.10186263096624,0.0,0.0
5718,1,1718,[315 509 478 244 221],474,5,7052,4.10238510762071,20.0,0.0
5719,1,1719,[315 509 478 244 221],474,5,7057,4.102906976744186,20.0,0.0
5720,1,1720,[315 509 478 244 221],474,5,7062,4.1034282393957,20.0,0.0
5721,1,1721,[315 509 478 244 221],474,5,7067,4.103948896631824,20.0,0.0
5722,1,1722,[315 509 478 244 221],474,5,7072,4.104468949506675,20.0,0.0
5723,1,1723,[202 211 227 208 291],882,5,7077,4.104988399071925,0.0,20.0
5724,1,1724,[315 509 478 244 221],474,5,7082,4.105507246376812,20.0,0.0
5725,1,1725,[315 509 478 244 221],474,5,7087,4.1060254924681345,20.0,0.0
5726,1,1726,[431 201 243 276 508],537,3,7090,4.105385060799073,0.0,20.0
5727,1,1727,[315 509 478 244 221],474,5,7095,4.105902777777778,20.0,0.0
5728,1,1728,[230 208 268 220 291],92,3,7098,4.105263157894737,0.0,0.0
5729,1,1729,[315 509 478 244 221],474,5,7103,4.10578034682081,20.0,0.0
5730,1,1730,[315 509 478 244 221],474,5,7108,4.10629693818602,20.0,0.0
5731,1,1731,[315 509 478 244 221],474,5,7113,4.106812933025404,20.0,0.0
5732,1,1732,[315 509 478 244 221],474,5,7118,4.10732833237161,20.0,0.0
5733,1,1733,[315 509 478 244 221],474,5,7123,4.107843137254902,20.0,0.0
5734,1,1734,[315 509 478 244 221],474,5,7128,4.10835734870317,20.0,0.0
5735,1,1735,[315 509 478 244 221],474,5,7133,4.108870967741935,20.0,0.0
5736,1,1736,[291 223 206 478 208],666,2,7135,4.107656879677605,20.0,0.0
5737,1,1737,[315 509 478 244 221],474,5,7140,4.108170310701956,20.0,0.0
5738,1,1738,[315 509 478 244 221],474,5,7145,4.108683151236343,20.0,0.0
5739,1,1739,[212 275 223 324 507],7,3,7148,4.1080459770114945,20.0,20.0
5740,1,1740,[212 246 301 508 231],85,2,7150,4.106835152211373,0.0,0.0
5741,1,1741,[315 509 478 244 221],474,5,7155,4.107347876004592,20.0,0.0
5742,1,1742,[315 509 478 244 221],474,5,7160,4.107860011474469,20.0,0.0
5743,1,1743,[315 509 478 244 221],474,5,7165,4.108371559633028,20.0,0.0
5744,1,1744,[231 255 280 218 301],378,1,7166,4.106590257879656,0.0,0.0
5745,1,1745,[315 509 478 244 221],474,5,7171,4.1071019473081325,20.0,0.0
5746,1,1746,[208 275 213 367 250],883,3,7174,4.106468231253578,0.0,20.0
5747,1,1747,[315 509 478 244 221],474,5,7179,4.106979405034325,20.0,0.0
5748,1,1748,[315 509 478 244 221],474,5,7184,4.107489994282447,20.0,0.0
5749,1,1749,[315 509 478 244 221],474,5,7189,4.108,20.0,0.0
5750,1,1750,[315 509 478 244 221],474,5,7194,4.10850942318675,20.0,0.0
5751,1,1751,[481 202 507 283 298],308,3,7197,4.107876712328767,0.0,0.0
5752,1,1752,[315 509 478 244 221],474,5,7202,4.108385624643469,20.0,0.0
5753,1,1753,[315 509 478 244 221],474,5,7207,4.108893956670467,20.0,0.0
5754,1,1754,[315 509 478 244 221],474,5,7212,4.109401709401709,20.0,0.0
5755,1,1755,[420 481 316 232 507],85,3,7215,4.10876993166287,20.0,0.0
5756,1,1756,[507 452 509 215 478],650,2,7217,4.107569721115538,0.0,0.0
5757,1,1757,[272 276 384 413 241],13,2,7219,4.10637087599545,0.0,20.0
5758,1,1758,[301 431 212 367 429],234,2,7221,4.105173393973849,0.0,0.0
5759,1,1759,[315 509 478 244 221],474,5,7226,4.105681818181818,20.0,0.0
5760,1,1760,[221 246 255 331 299],116,2,7228,4.104486087450312,0.0,0.0
5761,1,1761,[315 509 478 244 221],474,5,7233,4.104994324631101,20.0,0.0
5762,1,1762,[315 509 478 244 221],474,5,7238,4.105501985252411,20.0,0.0
5763,1,1763,[293 223 298 481 378],308,4,7242,4.105442176870748,20.0,0.0
5764,1,1764,[365 230 284 218 300],378,1,7243,4.103682719546742,0.0,20.0
5765,1,1765,[219 413 321 336 276],13,1,7244,4.101925254813137,0.0,20.0
5766,1,1766,[315 509 478 244 221],474,5,7249,4.1024335031126204,20.0,0.0
5767,1,1767,[378 259 219 240 431],804,4,7253,4.10237556561086,0.0,0.0
5768,1,1768,[315 509 478 244 221],474,5,7258,4.10288298473714,20.0,0.0
5769,1,1769,[315 509 478 244 221],474,5,7263,4.103389830508474,20.0,0.0
5770,1,1770,[315 509 478 244 221],474,5,7268,4.103896103896104,20.0,0.0
5771,1,1771,[315 509 478 244 221],474,5,7273,4.104401805869075,20.0,0.0
5772,1,1772,[315 509 478 244 221],474,5,7278,4.104906937394247,20.0,0.0
5773,1,1773,[315 509 478 244 221],474,5,7283,4.105411499436302,20.0,0.0
5774,1,1774,[315 509 478 244 221],474,5,7288,4.105915492957746,20.0,0.0
5775,1,1775,[315 509 478 244 221],474,5,7293,4.106418918918919,20.0,0.0
5776,1,1776,[392 243 202 284 299],537,0,7293,4.104108047270681,0.0,0.0
5777,1,1777,[326 239 226 208 211],313,3,7296,4.103487064116985,0.0,20.0
5778,1,1778,[315 509 478 244 221],474,5,7301,4.103991006183249,20.0,0.0
5779,1,1779,[315 509 478 244 221],474,5,7306,4.104494382022472,20.0,0.0
5780,1,1780,[315 509 478 244 221],474,5,7311,4.104997192588433,20.0,0.0
5781,1,1781,[315 509 478 244 221],474,5,7316,4.105499438832772,20.0,0.0
5782,1,1782,[315 509 478 244 221],474,5,7321,4.106001121704992,20.0,0.0
5783,1,1783,[315 509 478 244 221],474,5,7326,4.106502242152466,20.0,0.0
5784,1,1784,[315 509 478 244 221],474,5,7331,4.107002801120448,20.0,0.0
5785,1,1785,[315 509 478 244 221],474,5,7336,4.107502799552072,20.0,0.0
5786,1,1786,[211 508 218 250 378],833,2,7338,4.106323447118075,0.0,20.0
5787,1,1787,[202 452 298 378 240],833,3,7341,4.105704697986577,0.0,0.0
5788,1,1788,[583 232 218 219 211],387,2,7343,4.104527669088877,0.0,20.0
5789,1,1789,[367 264 301 299 202],13,2,7345,4.103351955307263,0.0,0.0
5790,1,1790,[219 290 243 222 452],650,1,7346,4.101619207146845,0.0,20.0
5791,1,1791,[315 509 478 244 221],474,5,7351,4.102120535714286,20.0,0.0
5792,1,1792,[315 509 478 244 221],474,5,7356,4.102621305075293,20.0,0.0
5793,1,1793,[315 509 478 244 221],474,5,7361,4.103121516164994,20.0,0.0
5794,1,1794,[315 509 478 244 221],474,5,7366,4.103621169916434,20.0,0.0
5795,1,1795,[212 217 275 299 236],145,1,7367,4.101893095768374,0.0,20.0
5796,1,1796,[315 509 478 244 221],474,5,7372,4.102392877017251,20.0,0.0
5797,1,1797,[315 509 478 244 221],474,5,7377,4.102892102335929,20.0,0.0
5798,1,1798,[227 485 394 429 508],13,2,7379,4.101723179544191,0.0,0.0
5799,1,1799,[315 509 478 244 221],474,5,7384,4.102222222222222,20.0,0.0
5800,1,1800,[315 509 478 244 221],474,5,7389,4.102720710716269,20.0,0.0
5801,1,1801,[315 509 478 244 221],474,5,7394,4.103218645948946,20.0,0.0
5802,1,1802,[315 509 478 244 221],474,5,7399,4.103716028840821,20.0,0.0
5803,1,1803,[315 509 478 244 221],474,5,7404,4.1042128603104215,20.0,0.0
5804,1,1804,[315 509 478 244 221],474,5,7409,4.104709141274238,20.0,0.0
5805,1,1805,[315 509 478 244 221],474,5,7414,4.105204872646733,20.0,0.0
5806,1,1806,[315 509 478 244 221],474,5,7419,4.1057000553403435,20.0,0.0
5807,1,1807,[315 509 478 244 221],474,5,7424,4.106194690265487,20.0,0.0
5808,1,1808,[230 250 508 226 219],92,3,7427,4.105583195135434,0.0,0.0
5809,1,1809,[315 509 478 244 221],474,5,7432,4.106077348066298,20.0,0.0
5810,1,1810,[315 509 478 244 221],474,5,7437,4.106570955273329,20.0,0.0
5811,1,1811,[315 509 478 244 221],474,5,7442,4.107064017660044,20.0,0.0
5812,1,1812,[315 509 478 244 221],474,5,7447,4.107556536127965,20.0,0.0
5813,1,1813,[315 509 478 244 221],474,5,7452,4.1080485115766265,20.0,0.0
5814,1,1814,[315 509 478 244 221],474,5,7457,4.1085399449035815,20.0,0.0
5815,1,1815,[315 509 478 244 221],474,5,7462,4.109030837004405,20.0,0.0
5816,1,1816,[315 509 478 244 221],474,5,7467,4.109521188772702,20.0,0.0
5817,1,1817,[218 316 290 201 243],13,2,7469,4.108360836083609,20.0,0.0
5818,1,1818,[420 394 321 485 226],13,2,7471,4.1072017592083565,0.0,0.0
5819,1,1819,[315 509 478 244 221],474,5,7476,4.107692307692307,20.0,0.0
5820,1,1820,[367 202 222 378 255],454,2,7478,4.106534870950028,0.0,20.0
5821,1,1821,[315 509 478 244 221],474,5,7483,4.1070252469813395,20.0,0.0
5822,1,1822,[315 509 478 244 221],474,5,7488,4.107515085024684,20.0,0.0
5823,1,1823,[315 509 478 244 221],474,5,7493,4.108004385964913,20.0,0.0
5824,1,1824,[315 509 478 244 221],474,5,7498,4.108493150684931,20.0,0.0
5825,1,1825,[315 509 478 244 221],474,5,7503,4.108981380065718,20.0,0.0
5826,1,1826,[315 509 478 244 221],474,5,7508,4.1094690749863165,20.0,0.0
5827,1,1827,[315 509 478 244 221],474,5,7513,4.1099562363238515,20.0,0.0
5828,1,1828,[315 509 478 244 221],474,5,7518,4.1104428649535265,20.0,0.0
5829,1,1829,[315 509 478 244 221],474,5,7523,4.110928961748634,20.0,0.0
5830,1,1830,[315 509 478 244 221],474,5,7528,4.111414527580557,20.0,0.0
5831,1,1831,[315 509 478 244 221],474,5,7533,4.111899563318778,20.0,0.0
5832,1,1832,[315 509 478 244 221],474,5,7538,4.1123840698308785,20.0,0.0
5833,1,1833,[315 509 478 244 221],474,5,7543,4.112868047982552,20.0,0.0
5834,1,1834,[315 509 478 244 221],474,5,7548,4.113351498637602,20.0,0.0
5835,1,1835,[315 509 478 244 221],474,5,7553,4.113834422657952,20.0,0.0
5836,1,1836,[315 509 478 244 221],474,5,7558,4.114316820903647,20.0,0.0
5837,1,1837,[315 509 478 244 221],474,5,7563,4.114798694232862,20.0,0.0
5838,1,1838,[315 509 478 244 221],474,5,7568,4.115280043501903,20.0,0.0
5839,1,1839,[315 509 478 244 221],474,5,7573,4.115760869565217,20.0,0.0
5840,1,1840,[283 272 508 250 255],334,2,7575,4.114611624117328,0.0,0.0
5841,1,1841,[315 509 478 244 221],474,5,7580,4.1150922909880565,20.0,0.0
5842,1,1842,[315 509 478 244 221],474,5,7585,4.115572436245253,20.0,0.0
5843,1,1843,[315 509 478 244 221],474,5,7590,4.116052060737527,20.0,0.0
5844,1,1844,[315 509 478 244 221],474,5,7595,4.116531165311653,20.0,0.0
5845,1,1845,[216 208 211 226 240],643,4,7599,4.116468039003251,0.0,20.0
5846,1,1846,[268 227 236 209 213],334,3,7602,4.115863562533838,0.0,0.0
5847,1,1847,[315 509 478 244 221],474,5,7607,4.116341991341991,20.0,0.0
5848,1,1848,[509 223 219 431 264],13,3,7610,4.115738236884803,20.0,0.0
5849,1,1849,[315 509 478 244 221],474,5,7615,4.116216216216216,20.0,0.0
5850,1,1850,[315 509 478 244 221],474,5,7620,4.116693679092383,20.0,0.0
5851,1,1851,[290 218 217 378 236],385,0,7620,4.114470842332613,0.0,0.0
5852,1,1852,[315 509 478 244 221],474,5,7625,4.114948731786292,20.0,0.0
5853,1,1853,[315 509 478 244 221],474,5,7630,4.1154261057173676,20.0,0.0
5854,1,1854,[241 431 218 509 216],13,1,7631,4.113746630727762,0.0,0.0
5855,1,1855,[315 509 478 244 221],474,5,7636,4.114224137931035,20.0,0.0
5856,1,1856,[509 303 283 209 213],615,5,7641,4.114701130856219,0.0,0.0
5857,1,1857,[315 509 478 244 221],474,5,7646,4.115177610333692,20.0,0.0
5858,1,1858,[315 509 478 244 221],474,5,7651,4.115653577192039,20.0,0.0
5859,1,1859,[315 509 478 244 221],474,5,7656,4.116129032258065,20.0,0.0
5860,1,1860,[315 509 478 244 221],474,5,7661,4.116603976356798,20.0,0.0
5861,1,1861,[315 509 478 244 221],474,5,7666,4.117078410311493,20.0,0.0
5862,1,1862,[315 509 478 244 221],474,5,7671,4.117552334943639,20.0,0.0
5863,1,1863,[315 509 478 244 221],474,5,7676,4.118025751072961,20.0,0.0
5864,1,1864,[315 212 298 394 226],145,1,7677,4.116353887399463,20.0,0.0
5865,1,1865,[315 509 478 244 221],474,5,7682,4.116827438370847,20.0,0.0
5866,1,1866,[315 413 429 331 223],13,3,7685,4.116229244777719,40.0,0.0
5867,1,1867,[315 509 478 244 221],474,5,7690,4.116702355460386,20.0,0.0
5868,1,1868,[315 509 478 244 221],474,5,7695,4.117174959871589,20.0,0.0
5869,1,1869,[315 509 478 244 221],474,5,7700,4.117647058823529,20.0,0.0
5870,1,1870,[315 509 478 244 221],474,5,7705,4.11811865312667,20.0,0.0
5871,1,1871,[315 509 478 244 221],474,5,7710,4.118589743589744,20.0,0.0
5872,1,1872,[315 509 478 244 221],474,5,7715,4.119060331019754,20.0,0.0
5873,1,1873,[216 211 226 243 219],804,3,7718,4.11846318036286,0.0,20.0
5874,1,1874,[315 509 478 244 221],474,5,7723,4.118933333333334,20.0,0.0
5875,1,1875,[315 509 478 244 221],474,5,7728,4.119402985074627,20.0,0.0
5876,1,1876,[315 509 478 244 221],474,5,7733,4.119872136387853,20.0,0.0
5877,1,1877,[478 291 226 367 215],892,4,7737,4.119808306709265,0.0,0.0
5878,1,1878,[315 509 478 244 221],474,5,7742,4.120276742948377,20.0,0.0
5879,1,1879,[315 509 478 244 221],474,5,7747,4.120744680851064,20.0,0.0
5880,1,1880,[429 300 420 243 331],13,2,7749,4.119617224880383,0.0,20.0
5881,1,1881,[315 509 478 244 221],474,5,7754,4.1200850159404885,20.0,0.0
5882,1,1882,[315 509 478 244 221],474,5,7759,4.120552310143388,20.0,0.0
5883,1,1883,[315 509 478 244 221],474,5,7764,4.1210191082802545,20.0,0.0
5884,1,1884,[478 213 378 284 212],234,1,7765,4.119363395225464,0.0,0.0
5885,1,1885,[315 509 478 244 221],474,5,7770,4.11983032873807,20.0,0.0
5886,1,1886,[315 509 478 244 221],474,5,7775,4.120296767355591,20.0,0.0
5887,1,1887,[315 509 478 244 221],474,5,7780,4.120762711864407,20.0,0.0
5888,1,1888,[367 583 230 295 216],92,0,7780,4.118581259925887,0.0,0.0
5889,1,1889,[211 326 431 202 215],454,2,7782,4.117460317460317,0.0,20.0
5890,1,1890,[315 509 478 244 221],474,5,7787,4.117927022739291,20.0,0.0
5891,1,1891,[315 509 478 244 221],474,5,7792,4.118393234672304,20.0,0.0
5892,1,1892,[481 231 212 211 216],82,4,7796,4.118330692023243,0.0,20.0
5893,1,1893,[321 301 231 283 221],184,3,7799,4.117740232312566,0.0,0.0
5894,1,1894,[315 509 478 244 221],474,5,7804,4.118205804749341,20.0,0.0
5895,1,1895,[272 365 239 254 255],378,2,7806,4.117088607594937,0.0,0.0
5896,1,1896,[315 509 478 244 221],474,5,7811,4.117554032683184,20.0,0.0
5897,1,1897,[315 509 478 244 221],474,5,7816,4.118018967334036,20.0,0.0
5898,1,1898,[315 509 478 244 221],474,5,7821,4.118483412322274,20.0,0.0
5899,1,1899,[315 509 478 244 221],474,5,7826,4.118947368421052,20.0,0.0
5900,1,1900,[315 509 478 244 221],474,5,7831,4.119410836401894,20.0,0.0
5901,1,1901,[315 509 478 244 221],474,5,7836,4.1198738170347005,20.0,0.0
5902,1,1902,[315 509 478 244 221],474,5,7841,4.120336311087756,20.0,0.0
5903,1,1903,[291 246 367 208 284],92,3,7844,4.119747899159663,0.0,0.0
5904,1,1904,[315 509 478 244 221],474,5,7849,4.120209973753281,20.0,0.0
5905,1,1905,[208 239 232 298 485],749,5,7854,4.120671563483736,0.0,0.0
5906,1,1906,[315 509 478 244 221],474,5,7859,4.121132669113791,20.0,0.0
5907,1,1907,[303 217 509 201 350],13,2,7861,4.120020964360587,0.0,0.0
5908,1,1908,[315 509 478 244 221],474,5,7866,4.120481927710843,20.0,0.0
5909,1,1909,[315 509 478 244 221],474,5,7871,4.120942408376964,20.0,0.0
5910,1,1910,[315 509 478 244 221],474,5,7876,4.121402407116693,20.0,0.0
5911,1,1911,[315 509 478 244 221],474,5,7881,4.1218619246861925,20.0,0.0
5912,1,1912,[315 509 478 244 221],474,5,7886,4.122320961840042,20.0,0.0
5913,1,1913,[315 509 478 244 221],474,5,7891,4.122779519331243,20.0,0.0
5914,1,1914,[315 509 478 244 221],474,5,7896,4.123237597911227,20.0,0.0
5915,1,1915,[315 509 478 244 221],474,5,7901,4.1236951983298535,20.0,0.0
5916,1,1916,[315 509 478 244 221],474,5,7906,4.12415232133542,20.0,0.0
5917,1,1917,[315 509 478 244 221],474,5,7911,4.124608967674661,20.0,0.0
5918,1,1918,[315 509 478 244 221],474,5,7916,4.125065138092757,20.0,0.0
5919,1,1919,[315 509 478 244 221],474,5,7921,4.125520833333334,20.0,0.0
5920,1,1920,[420 301 243 384 290],13,2,7923,4.124414367516918,0.0,0.0
5921,1,1921,[315 509 478 244 221],474,5,7928,4.124869927159209,20.0,0.0
5922,1,1922,[315 509 478 244 221],474,5,7933,4.12532501300052,20.0,0.0
5923,1,1923,[315 509 478 244 221],474,5,7938,4.125779625779626,20.0,0.0
5924,1,1924,[315 509 478 244 221],474,5,7943,4.126233766233766,20.0,0.0
5925,1,1925,[315 509 478 244 221],474,5,7948,4.12668743509865,20.0,0.0
5926,1,1926,[283 485 291 284 219],308,1,7949,4.125064867669954,0.0,0.0
5927,1,1927,[315 509 478 244 221],474,5,7954,4.125518672199171,20.0,0.0
5928,1,1928,[315 509 478 244 221],474,5,7959,4.12597200622084,20.0,0.0
5929,1,1929,[315 509 478 244 221],474,5,7964,4.126424870466321,20.0,0.0
5930,1,1930,[481 284 215 221 213],85,3,7967,4.1258415328845155,0.0,0.0
5931,1,1931,[315 509 478 244 221],474,5,7972,4.126293995859213,20.0,0.0
5932,1,1932,[478 206 275 507 315],537,4,7976,4.126228660113813,20.0,20.0
5933,1,1933,[315 509 478 244 221],474,5,7981,4.126680455015512,20.0,0.0
5934,1,1934,[315 509 478 244 221],474,5,7986,4.127131782945736,20.0,0.0
5935,1,1935,[315 509 478 244 221],474,5,7991,4.127582644628099,20.0,0.0
5936,1,1936,[315 509 478 244 221],474,5,7996,4.128033040784719,20.0,0.0
5937,1,1937,[315 509 478 244 221],474,5,8001,4.128482972136223,20.0,0.0
5938,1,1938,[315 509 478 244 221],474,5,8006,4.128932439401754,20.0,0.0
5939,1,1939,[315 509 478 244 221],474,5,8011,4.1293814432989695,20.0,0.0
5940,1,1940,[315 509 478 244 221],474,5,8016,4.12982998454405,20.0,0.0
5941,1,1941,[315 211 201 208 239],13,4,8020,4.1297631307929965,20.0,20.0
5942,1,1942,[315 509 478 244 221],474,5,8025,4.130211013896037,20.0,0.0
5943,1,1943,[315 509 478 244 221],474,5,8030,4.1306584362139915,20.0,0.0
5944,1,1944,[315 509 478 244 221],474,5,8035,4.131105398457583,20.0,0.0
5945,1,1945,[315 509 478 244 221],474,5,8040,4.131551901336074,20.0,0.0
5946,1,1946,[315 509 478 244 221],474,5,8045,4.131997945557267,20.0,0.0
5947,1,1947,[211 392 284 507 221],537,2,8047,4.130903490759754,0.0,20.0
5948,1,1948,[226 283 321 220 254],378,1,8048,4.129297075423294,0.0,0.0
5949,1,1949,[413 315 227 232 218],13,2,8050,4.128205128205129,20.0,0.0
5950,1,1950,[315 509 478 244 221],474,5,8055,4.128651973347002,20.0,0.0
5951,1,1951,[264 232 243 350 223],13,2,8057,4.127561475409836,20.0,0.0
5952,1,1952,[315 509 478 244 221],474,5,8062,4.128008192524321,20.0,0.0
5953,1,1953,[315 509 478 244 221],474,5,8067,4.128454452405323,20.0,0.0
5954,1,1954,[259 218 216 291 392],346,1,8068,4.126854219948849,0.0,0.0
5955,1,1955,[315 509 478 244 221],474,5,8073,4.127300613496932,20.0,0.0
5956,1,1956,[239 213 211 378 275],308,3,8076,4.126724578436383,0.0,40.0
5957,1,1957,[315 509 478 244 221],474,5,8081,4.127170582226762,20.0,0.0
5958,1,1958,[420 384 508 316 268],13,3,8084,4.126595201633487,20.0,0.0
5959,1,1959,[315 509 478 244 221],474,5,8089,4.127040816326531,20.0,0.0
5960,1,1960,[221 284 209 485 241],85,2,8091,4.12595614482407,0.0,0.0
5961,1,1961,[315 509 478 244 221],474,5,8096,4.126401630988787,20.0,0.0
5962,1,1962,[315 509 478 244 221],474,5,8101,4.126846663270505,20.0,0.0
5963,1,1963,[315 509 478 244 221],474,5,8106,4.127291242362525,20.0,0.0
5964,1,1964,[315 509 478 244 221],474,5,8111,4.127735368956743,20.0,0.0
5965,1,1965,[315 509 478 244 221],474,5,8116,4.128179043743642,20.0,0.0
5966,1,1966,[315 509 478 244 221],474,5,8121,4.128622267412303,20.0,0.0
5967,1,1967,[315 509 478 244 221],474,5,8126,4.129065040650406,20.0,0.0
5968,1,1968,[222 206 284 316 215],234,2,8128,4.12798374809548,20.0,20.0
5969,1,1969,[315 509 478 244 221],474,5,8133,4.128426395939086,20.0,0.0
5970,1,1970,[315 509 478 244 221],474,5,8138,4.128868594622019,20.0,0.0
5971,1,1971,[315 509 478 244 221],474,5,8143,4.129310344827586,20.0,0.0
5972,1,1972,[315 509 478 244 221],474,5,8148,4.129751647237709,20.0,0.0
5973,1,1973,[315 509 478 244 221],474,5,8153,4.130192502532928,20.0,0.0
5974,1,1974,[315 509 478 244 221],474,5,8158,4.130632911392405,20.0,0.0
5975,1,1975,[315 509 478 244 221],474,5,8163,4.131072874493927,20.0,0.0
5976,1,1976,[227 244 293 367 230],158,3,8166,4.130500758725342,0.0,0.0
5977,1,1977,[315 509 478 244 221],474,5,8171,4.130940343781598,20.0,0.0
5978,1,1978,[315 509 478 244 221],474,5,8176,4.131379484588176,20.0,0.0
5979,1,1979,[315 509 478 244 221],474,5,8181,4.131818181818182,20.0,0.0
5980,1,1980,[315 509 478 244 221],474,5,8186,4.132256436143362,20.0,0.0
5981,1,1981,[315 509 478 244 221],474,5,8191,4.132694248234107,20.0,0.0
5982,1,1982,[315 509 478 244 221],474,5,8196,4.133131618759456,20.0,0.0
5983,1,1983,[315 509 478 244 221],474,5,8201,4.133568548387097,20.0,0.0
5984,1,1984,[315 509 478 244 221],474,5,8206,4.134005037783376,20.0,0.0
5985,1,1985,[315 509 478 244 221],474,5,8211,4.134441087613293,20.0,0.0
5986,1,1986,[315 509 478 244 221],474,5,8216,4.134876698540514,20.0,0.0
5987,1,1987,[315 509 478 244 221],474,5,8221,4.135311871227364,20.0,0.0
5988,1,1988,[240 211 212 367 216],59,4,8225,4.1352438411261945,0.0,20.0
5989,1,1989,[315 509 478 244 221],474,5,8230,4.135678391959799,20.0,0.0
5990,1,1990,[315 509 478 244 221],474,5,8235,4.136112506278252,20.0,0.0
5991,1,1991,[284 481 226 202 230],194,0,8235,4.134036144578313,0.0,0.0
5992,1,1992,[241 485 478 201 275],537,2,8237,4.13296537882589,0.0,20.0
5993,1,1993,[315 509 478 244 221],474,5,8242,4.133400200601805,20.0,0.0
5994,1,1994,[315 509 478 244 221],474,5,8247,4.133834586466166,20.0,0.0
5995,1,1995,[315 509 478 244 221],474,5,8252,4.134268537074148,20.0,0.0
5996,1,1996,[378 509 429 239 241],200,4,8256,4.134201301952929,0.0,0.0
5997,1,1997,[315 509 478 244 221],474,5,8261,4.134634634634635,20.0,0.0
5998,1,1998,[315 509 478 244 221],474,5,8266,4.135067533766883,20.0,0.0
5999,1,1999,[315 509 478 244 221],474,5,8271,4.1355,20.0,0.0
6000,1,2000,[315 509 478 244 221],474,5,8276,4.135932033983009,20.0,0.0
6001,1,2001,[315 509 478 244 221],474,5,8281,4.136363636363637,20.0,0.0
6002,1,2002,[315 509 478 244 221],474,5,8286,4.136794807788317,20.0,0.0
6003,1,2003,[213 211 216 507 384],934,4,8290,4.136726546906187,0.0,20.0
6004,1,2004,[315 509 478 244 221],474,5,8295,4.13715710723192,20.0,0.0
6005,1,2005,[315 509 478 244 221],474,5,8300,4.137587238285144,20.0,0.0
6006,1,2006,[315 509 478 244 221],474,5,8305,4.138016940707524,20.0,0.0
6007,1,2007,[315 509 478 244 221],474,5,8310,4.138446215139442,20.0,0.0
6008,1,2008,[315 509 478 244 221],474,5,8315,4.13887506222001,20.0,0.0
6009,1,2009,[211 485 350 431 231],13,1,8316,4.137313432835821,0.0,20.0
6010,1,2010,[478 507 227 384 303],13,3,8319,4.136747886623571,0.0,0.0
6011,1,2011,[315 509 478 244 221],474,5,8324,4.137176938369781,20.0,0.0
6012,1,2012,[315 509 478 244 221],474,5,8329,4.137605563835072,20.0,0.0
6013,1,2013,[315 509 478 244 221],474,5,8334,4.138033763654419,20.0,0.0
6014,1,2014,[268 481 241 420 231],7,3,8337,4.137468982630273,0.0,0.0
6015,1,2015,[315 509 478 244 221],474,5,8342,4.137896825396825,20.0,0.0
6016,1,2016,[315 509 478 244 221],474,5,8347,4.138324243926624,20.0,0.0
6017,1,2017,[315 509 478 244 221],474,5,8352,4.138751238850347,20.0,0.0
6018,1,2018,[315 509 478 244 221],474,5,8357,4.139177810797425,20.0,0.0
6019,1,2019,[315 509 478 244 221],474,5,8362,4.139603960396039,20.0,0.0
6020,1,2020,[507 239 206 316 367],650,2,8364,4.1385452746165265,20.0,0.0
6021,1,2021,[291 378 367 202 216],308,2,8366,4.137487636003956,0.0,0.0
6022,1,2022,[485 315 241 239 201],13,2,8368,4.136431043005437,20.0,0.0
6023,1,2023,[315 509 478 244 221],474,5,8373,4.136857707509882,20.0,0.0
6024,1,2024,[301 213 241 365 420],378,3,8376,4.136296296296297,0.0,0.0
6025,1,2025,[315 509 478 244 221],474,5,8381,4.1367226061204345,20.0,0.0
6026,1,2026,[315 509 478 244 221],474,5,8386,4.137148495313271,20.0,0.0
6027,1,2027,[315 509 478 244 221],474,5,8391,4.137573964497041,20.0,0.0
6028,1,2028,[275 283 230 213 212],85,1,8392,4.136027599802858,0.0,20.0
6029,1,2029,[315 509 478 244 221],474,5,8397,4.136453201970443,20.0,0.0
6030,1,2030,[315 509 478 244 221],474,5,8402,4.136878385032004,20.0,0.0
6031,1,2031,[509 211 219 222 291],279,1,8403,4.135334645669292,0.0,40.0
6032,1,2032,[315 509 478 244 221],474,5,8408,4.1357599606492865,20.0,0.0
6033,1,2033,[315 509 478 244 221],474,5,8413,4.136184857423795,20.0,0.0
6034,1,2034,[297 231 324 208 241],343,4,8417,4.1361179361179365,20.0,0.0
6035,1,2035,[315 509 478 244 221],474,5,8422,4.136542239685658,20.0,0.0
6036,1,2036,[315 509 478 244 221],474,5,8427,4.136966126656849,20.0,0.0
6037,1,2037,[315 509 478 244 221],474,5,8432,4.1373895976447495,20.0,0.0
6038,1,2038,[481 452 215 255 321],308,2,8434,4.136341343795978,0.0,0.0
6039,1,2039,[315 509 478 244 221],474,5,8439,4.136764705882353,20.0,0.0
6040,1,2040,[315 509 478 244 221],474,5,8444,4.13718765311122,20.0,0.0
6041,1,2041,[315 509 478 244 221],474,5,8449,4.137610186092067,20.0,0.0
6042,1,2042,[208 201 264 392 283],308,3,8452,4.137053352912384,0.0,0.0
6043,1,2043,[315 509 478 244 221],474,5,8457,4.137475538160469,20.0,0.0
6044,1,2044,[315 509 478 244 221],474,5,8462,4.137897310513448,20.0,0.0
6045,1,2045,[315 509 478 244 221],474,5,8467,4.138318670576735,20.0,0.0
6046,1,2046,[315 509 478 244 221],474,5,8472,4.138739618954568,20.0,0.0
6047,1,2047,[315 509 478 244 221],474,5,8477,4.13916015625,20.0,0.0
6048,1,2048,[315 509 478 244 221],474,5,8482,4.13958028306491,20.0,0.0
6049,1,2049,[315 509 478 244 221],474,5,8487,4.14,20.0,0.0
6050,1,2050,[216 246 218 272 268],334,3,8490,4.1394441735738665,0.0,0.0
6051,1,2051,[315 509 478 244 221],474,5,8495,4.139863547758285,20.0,0.0
6052,1,2052,[275 509 220 218 216],378,3,8498,4.1393083292742325,0.0,20.0
6053,1,2053,[315 509 478 244 221],474,5,8503,4.139727361246349,20.0,0.0
6054,1,2054,[293 324 326 244 230],334,2,8505,4.138686131386861,0.0,0.0
6055,1,2055,[315 509 478 244 221],474,5,8510,4.139105058365759,20.0,0.0
6056,1,2056,[315 509 478 244 221],474,5,8515,4.139523578026252,20.0,0.0
6057,1,2057,[315 509 478 244 221],474,5,8520,4.139941690962099,20.0,0.0
6058,1,2058,[315 509 478 244 221],474,5,8525,4.140359397765906,20.0,0.0
6059,1,2059,[315 509 478 244 221],474,5,8530,4.140776699029126,20.0,0.0
6060,1,2060,[315 509 478 244 221],474,5,8535,4.141193595342067,20.0,0.0
6061,1,2061,[315 509 478 244 221],474,5,8540,4.1416100872938895,20.0,0.0
6062,1,2062,[299 241 392 478 236],537,1,8541,4.140087251575376,0.0,0.0
6063,1,2063,[315 509 478 244 221],474,5,8546,4.140503875968992,20.0,0.0
6064,1,2064,[315 509 478 244 221],474,5,8551,4.1409200968523,20.0,0.0
6065,1,2065,[508 243 291 298 283],825,4,8555,4.140851887705711,0.0,0.0
6066,1,2066,[315 509 478 244 221],474,5,8560,4.1412675374939525,20.0,0.0
6067,1,2067,[208 365 230 583 509],7,3,8563,4.140715667311412,0.0,0.0
6068,1,2068,[315 509 478 244 221],474,5,8568,4.141130981150314,20.0,0.0
6069,1,2069,[211 264 365 230 216],7,4,8572,4.141062801932367,0.0,20.0
6070,1,2070,[272 508 420 268 215],85,4,8576,4.140994688556253,0.0,0.0
6071,1,2071,[315 509 478 244 221],474,5,8581,4.1414092664092665,20.0,0.0
6072,1,2072,[315 509 478 244 221],474,5,8586,4.141823444283647,20.0,0.0
6073,1,2073,[315 509 478 244 221],474,5,8591,4.142237222757956,20.0,0.0
6074,1,2074,[315 509 478 244 221],474,5,8596,4.142650602409638,20.0,0.0
6075,1,2075,[315 509 478 244 221],474,5,8601,4.143063583815029,20.0,0.0
6076,1,2076,[315 509 478 244 221],474,5,8606,4.14347616754935,20.0,0.0
6077,1,2077,[315 509 478 244 221],474,5,8611,4.143888354186718,20.0,0.0
6078,1,2078,[315 509 478 244 221],474,5,8616,4.144300144300145,20.0,0.0
6079,1,2079,[315 509 478 244 221],474,5,8621,4.1447115384615385,20.0,0.0
6080,1,2080,[315 509 478 244 221],474,5,8626,4.14512253724171,20.0,0.0
6081,1,2081,[211 481 239 299 301],13,2,8628,4.144092219020173,0.0,20.0
6082,1,2082,[315 509 478 244 221],474,5,8633,4.14450312049928,20.0,0.0
6083,1,2083,[315 509 478 244 221],474,5,8638,4.144913627639156,20.0,0.0
6084,1,2084,[315 509 478 244 221],474,5,8643,4.145323741007195,20.0,0.0
6085,1,2085,[315 509 478 244 221],474,5,8648,4.145733461169703,20.0,0.0
6086,1,2086,[315 509 478 244 221],474,5,8653,4.146142788691902,20.0,0.0
6087,1,2087,[507 254 209 216 420],934,3,8656,4.145593869731801,0.0,0.0
6088,1,2088,[315 509 478 244 221],474,5,8661,4.146002872187649,20.0,0.0
6089,1,2089,[315 509 478 244 221],474,5,8666,4.146411483253589,20.0,0.0
6090,1,2090,[315 509 478 244 221],474,5,8671,4.146819703491152,20.0,0.0
6091,1,2091,[315 509 478 244 221],474,5,8676,4.147227533460803,20.0,0.0
6092,1,2092,[315 509 478 244 221],474,5,8681,4.147634973721931,20.0,0.0
6093,1,2093,[315 509 478 244 221],474,5,8686,4.148042024832856,20.0,0.0
6094,1,2094,[315 509 478 244 221],474,5,8691,4.148448687350835,20.0,0.0
6095,1,2095,[315 509 478 244 221],474,5,8696,4.148854961832061,20.0,0.0
6096,1,2096,[315 509 478 244 221],474,5,8701,4.1492608488316645,20.0,0.0
6097,1,2097,[315 509 478 244 221],474,5,8706,4.149666348903718,20.0,0.0
6098,1,2098,[209 208 241 316 290],13,3,8709,4.149118627918056,20.0,0.0
6099,1,2099,[315 509 478 244 221],474,5,8714,4.149523809523809,20.0,0.0
6100,1,2100,[509 215 283 223 485],378,5,8719,4.149928605425988,20.0,0.0
6101,1,2101,[315 509 478 244 221],474,5,8724,4.150333016175072,20.0,0.0
6102,1,2102,[315 509 478 244 221],474,5,8729,4.150737042320494,20.0,0.0
6103,1,2103,[215 241 211 226 268],387,1,8730,4.149239543726236,0.0,20.0
6104,1,2104,[315 509 478 244 221],474,5,8735,4.149643705463183,20.0,0.0
6105,1,2105,[217 275 213 211 583],7,3,8738,4.149097815764482,0.0,40.0
6106,1,2106,[315 509 478 244 221],474,5,8743,4.149501661129568,20.0,0.0
6107,1,2107,[315 509 478 244 221],474,5,8748,4.149905123339659,20.0,0.0
6108,1,2108,[315 509 478 244 221],474,5,8753,4.150308202939782,20.0,0.0
6109,1,2109,[227 326 431 481 367],13,1,8754,4.148815165876777,0.0,0.0
6110,1,2110,[315 509 478 244 221],474,5,8759,4.149218379914732,20.0,0.0
6111,1,2111,[315 509 478 244 221],474,5,8764,4.149621212121212,20.0,0.0
6112,1,2112,[315 509 478 244 221],474,5,8769,4.1500236630383345,20.0,0.0
6113,1,2113,[315 509 478 244 221],474,5,8774,4.15042573320719,20.0,0.0
6114,1,2114,[315 509 478 244 221],474,5,8779,4.150827423167849,20.0,0.0
6115,1,2115,[315 509 478 244 221],474,5,8784,4.151228733459357,20.0,0.0
6116,1,2116,[226 259 215 300 431],7,4,8788,4.151157298063297,0.0,20.0
6117,1,2117,[315 509 478 244 221],474,5,8793,4.151558073654391,20.0,0.0
6118,1,2118,[315 509 478 244 221],474,5,8798,4.151958470976876,20.0,0.0
6119,1,2119,[315 509 478 244 221],474,5,8803,4.152358490566038,20.0,0.0
6120,1,2120,[230 240 226 201 227],279,5,8808,4.152758132956153,0.0,0.0
6121,1,2121,[315 509 478 244 221],474,5,8813,4.15315739868049,20.0,0.0
6122,1,2122,[315 509 478 244 221],474,5,8818,4.153556288271314,20.0,0.0
6123,1,2123,[315 509 478 244 221],474,5,8823,4.153954802259887,20.0,0.0
6124,1,2124,[315 509 478 244 221],474,5,8828,4.15435294117647,20.0,0.0
6125,1,2125,[315 509 478 244 221],474,5,8833,4.154750705550329,20.0,0.0
6126,1,2126,[315 509 478 244 221],474,5,8838,4.155148095909732,20.0,0.0
6127,1,2127,[315 509 478 244 221],474,5,8843,4.1555451127819545,20.0,0.0
6128,1,2128,[394 275 218 336 316],13,1,8844,4.154062940347581,20.0,20.0
6129,1,2129,[315 509 478 244 221],474,5,8849,4.154460093896714,20.0,0.0
6130,1,2130,[481 239 429 284 485],406,1,8850,4.1529798216799625,0.0,0.0
6131,1,2131,[315 509 478 244 221],474,5,8855,4.1533771106941835,20.0,0.0
6132,1,2132,[315 509 478 244 221],474,5,8860,4.153774027191749,20.0,0.0
6133,1,2133,[315 509 478 244 221],474,5,8865,4.154170571696345,20.0,0.0
6134,1,2134,[315 509 478 244 221],474,5,8870,4.154566744730679,20.0,0.0
6135,1,2135,[315 509 478 244 221],474,5,8875,4.1549625468164795,20.0,0.0
6136,1,2136,[315 509 478 244 221],474,5,8880,4.155357978474497,20.0,0.0
6137,1,2137,[315 509 478 244 221],474,5,8885,4.155753040224509,20.0,0.0
6138,1,2138,[315 509 478 244 221],474,5,8890,4.15614773258532,20.0,0.0
6139,1,2139,[315 509 478 244 221],474,5,8895,4.156542056074766,20.0,0.0
6140,1,2140,[315 509 478 244 221],474,5,8900,4.156936011209715,20.0,0.0
6141,1,2141,[315 509 478 244 221],474,5,8905,4.157329598506069,20.0,0.0
6142,1,2142,[231 291 230 284 250],899,2,8907,4.15632291180588,0.0,0.0
6143,1,2143,[315 509 478 244 221],474,5,8912,4.156716417910448,20.0,0.0
6144,1,2144,[315 509 478 244 221],474,5,8917,4.157109557109557,20.0,0.0
6145,1,2145,[216 212 254 290 250],804,4,8921,4.157036346691519,0.0,0.0
6146,1,2146,[315 509 478 244 221],474,5,8926,4.1574289706567304,20.0,0.0
6147,1,2147,[315 509 478 244 221],474,5,8931,4.157821229050279,20.0,0.0
6148,1,2148,[315 509 478 244 221],474,5,8936,4.158213122382503,20.0,0.0
6149,1,2149,[226 246 231 209 219],387,1,8937,4.156744186046511,0.0,0.0
6150,1,2150,[315 509 478 244 221],474,5,8942,4.157136215713622,20.0,0.0
6151,1,2151,[315 509 478 244 221],474,5,8947,4.157527881040892,20.0,0.0
6152,1,2152,[315 509 478 244 221],474,5,8952,4.157919182535997,20.0,0.0
6153,1,2153,[315 509 478 244 221],474,5,8957,4.158310120705664,20.0,0.0
6154,1,2154,[315 509 478 244 221],474,5,8962,4.158700696055685,20.0,0.0
6155,1,2155,[250 201 241 202 508],387,3,8965,4.158163265306122,0.0,0.0
6156,1,2156,[315 509 478 244 221],474,5,8970,4.15855354659249,20.0,0.0
6157,1,2157,[315 509 478 244 221],474,5,8975,4.158943466172381,20.0,0.0
6158,1,2158,[315 509 478 244 221],474,5,8980,4.159333024548402,20.0,0.0
6159,1,2159,[315 509 478 244 221],474,5,8985,4.159722222222222,20.0,0.0
6160,1,2160,[275 392 201 365 583],308,4,8989,4.159648310967145,0.0,20.0
6161,1,2161,[315 509 478 244 221],474,5,8994,4.1600370027752085,20.0,0.0
6162,1,2162,[315 509 478 244 221],474,5,8999,4.160425335182617,20.0,0.0
6163,1,2163,[508 300 295 240 246],294,4,9003,4.160351201478743,0.0,20.0
6164,1,2164,[315 509 478 244 221],474,5,9008,4.160739030023095,20.0,0.0
6165,1,2165,[315 509 478 244 221],474,5,9013,4.16112650046168,20.0,0.0
6166,1,2166,[315 509 478 244 221],474,5,9018,4.161513613290263,20.0,0.0
6167,1,2167,[315 509 478 244 221],474,5,9023,4.16190036900369,20.0,0.0
6168,1,2168,[315 509 478 244 221],474,5,9028,4.162286768095897,20.0,0.0
6169,1,2169,[315 509 478 244 221],474,5,9033,4.162672811059908,20.0,0.0
6170,1,2170,[315 509 478 244 221],474,5,9038,4.16305849838784,20.0,0.0
6171,1,2171,[315 509 478 244 221],474,5,9043,4.163443830570903,20.0,0.0
6172,1,2172,[315 509 478 244 221],474,5,9048,4.163828808099402,20.0,0.0
6173,1,2173,[315 509 478 244 221],474,5,9053,4.164213431462741,20.0,0.0
6174,1,2174,[215 227 485 216 232],13,2,9055,4.163218390804598,0.0,0.0
6175,1,2175,[315 509 478 244 221],474,5,9060,4.163602941176471,20.0,0.0
6176,1,2176,[315 509 478 244 221],474,5,9065,4.163987138263666,20.0,0.0
6177,1,2177,[315 509 478 244 221],474,5,9070,4.164370982552801,20.0,0.0
6178,1,2178,[315 509 478 244 221],474,5,9075,4.164754474529601,20.0,0.0
6179,1,2179,[315 509 478 244 221],474,5,9080,4.165137614678899,20.0,0.0
6180,1,2180,[507 283 250 276 293],385,0,9080,4.163227877120587,0.0,20.0
6181,1,2181,[365 208 378 239 226],311,4,9084,4.163153070577452,0.0,0.0
6182,1,2182,[315 509 478 244 221],474,5,9089,4.163536417773706,20.0,0.0
6183,1,2183,[268 316 509 481 508],85,3,9092,4.163003663003663,20.0,0.0
6184,1,2184,[315 509 478 244 221],474,5,9097,4.1633867276887875,20.0,0.0
6185,1,2185,[315 509 478 244 221],474,5,9102,4.163769441903019,20.0,0.0
6186,1,2186,[315 509 478 244 221],474,5,9107,4.164151806127115,20.0,0.0
6187,1,2187,[291 236 215 218 208],533,3,9110,4.163619744058501,0.0,0.0
6188,1,2188,[231 217 301 202 394],13,1,9111,4.162174508908177,0.0,0.0
6189,1,2189,[239 452 264 201 216],13,2,9113,4.161187214611872,0.0,0.0
6190,1,2190,[272 208 202 321 222],13,3,9116,4.160657234139662,0.0,20.0
6191,1,2191,[420 208 509 211 240],406,3,9119,4.1601277372262775,0.0,20.0
6192,1,2192,[315 478 509 244 221],474,5,9124,4.160510715914273,20.0,0.0
6193,1,2193,[315 478 509 244 221],474,5,9129,4.160893345487693,20.0,0.0
6194,1,2194,[315 478 509 244 221],474,5,9134,4.1612756264236905,20.0,0.0
6195,1,2195,[315 478 509 244 221],474,5,9139,4.1616575591985425,20.0,0.0
6196,1,2196,[315 478 509 244 221],474,5,9144,4.162039144287665,20.0,0.0
6197,1,2197,[293 216 276 223 303],6,2,9146,4.1610555050045495,20.0,20.0
6198,1,2198,[365 272 215 216 301],378,3,9149,4.160527512505684,0.0,0.0
6199,1,2199,[315 478 509 244 221],474,5,9154,4.160909090909091,20.0,0.0
6200,1,2200,[240 220 231 202 284],82,2,9156,4.159927305770104,0.0,0.0
6201,1,2201,[315 478 509 244 221],474,5,9161,4.1603088101725705,20.0,0.0
6202,1,2202,[315 478 509 244 221],474,5,9166,4.160689968225148,20.0,0.0
6203,1,2203,[290 226 394 303 209],13,3,9169,4.16016333938294,0.0,0.0
6204,1,2204,[315 478 509 244 221],474,5,9174,4.160544217687074,20.0,0.0
6205,1,2205,[315 478 509 244 221],474,5,9179,4.160924750679964,20.0,0.0
6206,1,2206,[315 478 509 244 221],474,5,9184,4.161304938830992,20.0,0.0
6207,1,2207,[365 431 222 230 239],749,2,9186,4.1603260869565215,0.0,20.0
6208,1,2208,[243 208 223 220 209],92,3,9189,4.159800814848348,20.0,0.0
6209,1,2209,[315 478 509 244 221],474,5,9194,4.160180995475113,20.0,0.0
6210,1,2210,[315 478 509 244 221],474,5,9199,4.1605608322026235,20.0,0.0
6211,1,2211,[315 478 509 244 221],474,5,9204,4.160940325497288,20.0,0.0
6212,1,2212,[284 221 259 297 509],6,2,9206,4.159963849977406,20.0,0.0
6213,1,2213,[315 478 509 244 221],474,5,9211,4.160343270099368,20.0,0.0
6214,1,2214,[315 478 509 244 221],474,5,9216,4.160722347629797,20.0,0.0
6215,1,2215,[315 478 509 244 221],474,5,9221,4.161101083032491,20.0,0.0
6216,1,2216,[315 478 509 244 221],474,5,9226,4.161479476770411,20.0,0.0
6217,1,2217,[315 478 509 244 221],474,5,9231,4.1618575293056805,20.0,0.0
6218,1,2218,[384 429 211 201 264],833,1,9232,4.160432627309599,0.0,20.0
6219,1,2219,[485 431 507 231 365],7,4,9236,4.16036036036036,0.0,0.0
6220,1,2220,[315 478 509 244 221],474,5,9241,4.160738406123368,20.0,0.0
6221,1,2221,[315 478 509 244 221],474,5,9246,4.161116111611161,20.0,0.0
6222,1,2222,[315 478 509 244 221],474,5,9251,4.161493477282951,20.0,0.0
6223,1,2223,[218 431 227 208 202],311,5,9256,4.161870503597123,0.0,0.0
6224,1,2224,[315 478 509 244 221],474,5,9261,4.162247191011236,20.0,0.0
6225,1,2225,[315 478 509 244 221],474,5,9266,4.162623539982031,20.0,0.0
6226,1,2226,[246 227 508 230 201],92,2,9268,4.1616524472384375,0.0,0.0
6227,1,2227,[236 202 301 299 429],537,0,9268,4.159784560143627,0.0,0.0
6228,1,2228,[315 478 509 244 221],474,5,9273,4.160161507402423,20.0,0.0
6229,1,2229,[583 298 230 216 202],158,1,9274,4.158744394618834,0.0,0.0
6230,1,2230,[315 478 509 244 221],474,5,9279,4.159121470192739,20.0,0.0
6231,1,2231,[276 227 326 215 367],13,3,9282,4.158602150537634,0.0,20.0
6232,1,2232,[509 216 275 230 215],85,2,9284,4.157635467980295,0.0,20.0
6233,1,2233,[315 478 509 244 221],474,5,9289,4.158012533572068,20.0,0.0
6234,1,2234,[315 478 509 244 221],474,5,9294,4.158389261744967,20.0,0.0
6235,1,2235,[315 478 509 244 221],474,5,9299,4.1587656529517,20.0,0.0
6236,1,2236,[315 478 509 244 221],474,5,9304,4.159141707644166,20.0,0.0
6237,1,2237,[315 478 509 244 221],474,5,9309,4.159517426273458,20.0,0.0
6238,1,2238,[452 298 367 392 295],308,3,9312,4.158999553372041,0.0,0.0
6239,1,2239,[315 478 509 244 221],474,5,9317,4.159375,20.0,0.0
6240,1,2240,[315 478 509 244 221],474,5,9322,4.15975011155734,20.0,0.0
6241,1,2241,[315 478 509 244 221],474,5,9327,4.160124888492417,20.0,0.0
6242,1,2242,[315 478 509 244 221],474,5,9332,4.160499331252787,20.0,0.0
6243,1,2243,[315 478 509 244 221],474,5,9337,4.160873440285205,20.0,0.0
6244,1,2244,[315 478 509 244 221],474,5,9342,4.161247216035635,20.0,0.0
6245,1,2245,[315 478 509 244 221],474,5,9347,4.161620658949243,20.0,0.0
6246,1,2246,[315 478 509 244 221],474,5,9352,4.161993769470405,20.0,0.0
6247,1,2247,[315 478 509 244 221],474,5,9357,4.162366548042705,20.0,0.0
6248,1,2248,[315 478 509 244 221],474,5,9362,4.1627389951089375,20.0,0.0
6249,1,2249,[315 478 509 244 221],474,5,9367,4.163111111111111,20.0,0.0
6250,1,2250,[367 231 508 201 316],13,1,9368,4.161705908485118,20.0,0.0
6251,1,2251,[315 478 509 244 221],474,5,9373,4.162078152753108,20.0,0.0
6252,1,2252,[315 478 509 244 221],474,5,9378,4.162450066577896,20.0,0.0
6253,1,2253,[315 478 509 244 221],474,5,9383,4.16282165039929,20.0,0.0
6254,1,2254,[431 243 452 212 276],92,3,9386,4.16230598669623,0.0,20.0
6255,1,2255,[208 216 202 215 227],506,5,9391,4.162677304964539,0.0,0.0
6256,1,2256,[315 478 509 244 221],474,5,9396,4.1630482941958356,20.0,0.0
6257,1,2257,[315 478 509 244 221],474,5,9401,4.16341895482728,20.0,0.0
6258,1,2258,[315 478 509 244 221],474,5,9406,4.1637892872952635,20.0,0.0
6259,1,2259,[315 478 509 244 221],474,5,9411,4.164159292035398,20.0,0.0
6260,1,2260,[315 478 509 244 221],474,5,9416,4.16452896948253,20.0,0.0
6261,1,2261,[211 321 331 481 239],13,2,9418,4.1635720601237844,0.0,20.0
6262,1,2262,[315 478 509 244 221],474,5,9423,4.163941670349094,20.0,0.0
6263,1,2263,[226 222 259 485 300],537,0,9423,4.1621024734982335,0.0,40.0
6264,1,2264,[315 478 509 244 221],474,5,9428,4.162472406181015,20.0,0.0
6265,1,2265,[315 478 509 244 221],474,5,9433,4.162842012356576,20.0,0.0
6266,1,2266,[315 478 509 244 221],474,5,9438,4.1632112924569915,20.0,0.0
6267,1,2267,[315 478 509 244 221],474,5,9443,4.16358024691358,20.0,0.0
6268,1,2268,[315 478 509 244 221],474,5,9448,4.163948876156898,20.0,0.0
6269,1,2269,[315 478 509 244 221],474,5,9453,4.16431718061674,20.0,0.0
6270,1,2270,[315 478 509 244 221],474,5,9458,4.164685160722149,20.0,0.0
6271,1,2271,[315 478 509 244 221],474,5,9463,4.165052816901408,20.0,0.0
6272,1,2272,[315 478 509 244 221],474,5,9468,4.16542014958205,20.0,0.0
6273,1,2273,[315 478 509 244 221],474,5,9473,4.165787159190853,20.0,0.0
6274,1,2274,[315 478 509 244 221],474,5,9478,4.166153846153846,20.0,0.0
6275,1,2275,[478 293 326 216 211],749,5,9483,4.1665202108963095,0.0,20.0
6276,1,2276,[315 478 509 244 221],474,5,9488,4.166886253842776,20.0,0.0
6277,1,2277,[315 478 509 244 221],474,5,9493,4.167251975417033,20.0,0.0
6278,1,2278,[315 478 509 244 221],474,5,9498,4.167617376042124,20.0,0.0
6279,1,2279,[241 509 232 239 226],311,1,9499,4.166228070175438,0.0,0.0
6280,1,2280,[315 478 509 244 221],474,5,9504,4.166593599298554,20.0,0.0
6281,1,2281,[315 478 509 244 221],474,5,9509,4.166958808063103,20.0,0.0
6282,1,2282,[315 478 509 244 221],474,5,9514,4.167323696890057,20.0,0.0
6283,1,2283,[315 478 509 244 221],474,5,9519,4.16768826619965,20.0,0.0
6284,1,2284,[315 478 509 244 221],474,5,9524,4.168052516411379,20.0,0.0
6285,1,2285,[315 478 509 244 221],474,5,9529,4.168416447944007,20.0,0.0
6286,1,2286,[315 478 509 244 221],474,5,9534,4.168780061215566,20.0,0.0
6287,1,2287,[259 211 219 226 250],279,2,9536,4.1678321678321675,0.0,20.0
6288,1,2288,[231 216 272 431 283],537,3,9539,4.167321974661424,0.0,0.0
6289,1,2289,[315 478 509 244 221],474,5,9544,4.1676855895196505,20.0,0.0
6290,1,2290,[367 227 218 301 241],524,3,9547,4.167175905718027,0.0,0.0
6291,1,2291,[315 478 509 244 221],474,5,9552,4.167539267015707,20.0,0.0
6292,1,2292,[315 478 509 244 221],474,5,9557,4.167902311382468,20.0,0.0
6293,1,2293,[315 478 509 244 221],474,5,9562,4.168265039232781,20.0,0.0
6294,1,2294,[303 272 326 384 367],13,2,9564,4.167320261437909,0.0,0.0
6295,1,2295,[315 478 509 244 221],474,5,9569,4.1676829268292686,20.0,0.0
6296,1,2296,[315 478 509 244 221],474,5,9574,4.168045276447541,20.0,0.0
6297,1,2297,[315 478 509 244 221],474,5,9579,4.168407310704961,20.0,0.0
6298,1,2298,[315 478 509 244 221],474,5,9584,4.168769030013049,20.0,0.0
6299,1,2299,[315 478 509 244 221],474,5,9589,4.169130434782609,20.0,0.0
6300,1,2300,[315 478 509 244 221],474,5,9594,4.169491525423729,20.0,0.0
6301,1,2301,[202 212 206 321 268],234,1,9595,4.168114682884449,0.0,0.0
6302,1,2302,[315 478 509 244 221],474,5,9600,4.168475900998697,20.0,0.0
6303,1,2303,[219 215 261 218 350],13,1,9601,4.167100694444445,0.0,0.0
6304,1,2304,[315 478 509 244 221],474,5,9606,4.167462039045553,20.0,0.0
6305,1,2305,[315 478 509 244 221],474,5,9611,4.167823070251518,20.0,0.0
6306,1,2306,[241 290 413 367 219],13,1,9612,4.166449934980494,0.0,0.0
6307,1,2307,[315 478 509 244 221],474,5,9617,4.166811091854419,20.0,0.0
6308,1,2308,[315 478 509 244 221],474,5,9622,4.167171935902989,20.0,0.0
6309,1,2309,[315 478 509 244 221],474,5,9627,4.167532467532467,20.0,0.0
6310,1,2310,[315 478 509 244 221],474,5,9632,4.167892687148421,20.0,0.0
6311,1,2311,[315 478 509 244 221],474,5,9637,4.1682525951557095,20.0,0.0
6312,1,2312,[212 367 202 246 208],92,3,9640,4.167747514051016,0.0,0.0
6313,1,2313,[315 478 509 244 221],474,5,9645,4.168107173725152,20.0,0.0
6314,1,2314,[315 478 509 244 221],474,5,9650,4.168466522678186,20.0,0.0
6315,1,2315,[315 478 509 244 221],474,5,9655,4.168825561312608,20.0,0.0
6316,1,2316,[315 478 509 244 221],474,5,9660,4.169184290030212,20.0,0.0
6317,1,2317,[315 478 509 244 221],474,5,9665,4.169542709232097,20.0,0.0
6318,1,2318,[202 241 221 367 217],158,4,9669,4.169469598965071,0.0,0.0
6319,1,2319,[211 275 300 384 215],7,4,9673,4.169396551724138,0.0,60.0
6320,1,2320,[315 478 509 244 221],474,5,9678,4.169754416199914,20.0,0.0
6321,1,2321,[315 478 509 244 221],474,5,9683,4.170111972437554,20.0,0.0
6322,1,2322,[315 478 509 244 221],474,5,9688,4.170469220835127,20.0,0.0
6323,1,2323,[315 478 509 244 221],474,5,9693,4.170826161790017,20.0,0.0
6324,1,2324,[315 478 509 244 221],474,5,9698,4.1711827956989245,20.0,0.0
6325,1,2325,[315 478 509 244 221],474,5,9703,4.171539122957868,20.0,0.0
6326,1,2326,[223 268 365 275 211],7,4,9707,4.171465406102278,20.0,40.0
6327,1,2327,[315 478 509 244 221],474,5,9712,4.171821305841925,20.0,0.0
6328,1,2328,[315 478 509 244 221],474,5,9717,4.172176899957063,20.0,0.0
6329,1,2329,[315 478 509 244 221],474,5,9722,4.172532188841202,20.0,0.0
6330,1,2330,[315 478 509 244 221],474,5,9727,4.172887172887173,20.0,0.0
6331,1,2331,[315 478 509 244 221],474,5,9732,4.173241852487135,20.0,0.0
6332,1,2332,[315 478 509 244 221],474,5,9737,4.173596228032576,20.0,0.0
6333,1,2333,[315 478 509 244 221],474,5,9742,4.17395029991431,20.0,0.0
6334,1,2334,[315 478 509 244 221],474,5,9747,4.174304068522484,20.0,0.0
6335,1,2335,[315 478 509 244 221],474,5,9752,4.174657534246576,20.0,0.0
6336,1,2336,[315 478 509 244 221],474,5,9757,4.175010697475396,20.0,0.0
6337,1,2337,[315 478 509 244 221],474,5,9762,4.175363558597091,20.0,0.0
6338,1,2338,[315 478 509 244 221],474,5,9767,4.175716117999145,20.0,0.0
6339,1,2339,[315 478 509 244 221],474,5,9772,4.176068376068376,20.0,0.0
6340,1,2340,[298 223 216 300 316],144,3,9775,4.175565997436992,40.0,20.0
6341,1,2341,[315 478 509 244 221],474,5,9780,4.175918018787361,20.0,0.0
6342,1,2342,[315 478 509 244 221],474,5,9785,4.176269739650022,20.0,0.0
6343,1,2343,[315 478 509 244 221],474,5,9790,4.176621160409557,20.0,0.0
6344,1,2344,[315 478 509 244 221],474,5,9795,4.176972281449894,20.0,0.0
6345,1,2345,[315 478 509 244 221],474,5,9800,4.177323103154305,20.0,0.0
6346,1,2346,[215 240 392 431 284],59,2,9802,4.176395398380912,0.0,0.0
6347,1,2347,[315 478 509 244 221],474,5,9807,4.176746166950596,20.0,0.0
6348,1,2348,[315 478 509 244 221],474,5,9812,4.177096636866752,20.0,0.0
6349,1,2349,[209 276 321 239 230],308,3,9815,4.176595744680851,0.0,20.0
6350,1,2350,[300 264 478 218 481],13,2,9817,4.175669927690344,0.0,20.0
6351,1,2351,[315 478 509 244 221],474,5,9822,4.176020408163265,20.0,0.0
6352,1,2352,[315 478 509 244 221],474,5,9827,4.176370590735232,20.0,0.0
6353,1,2353,[315 478 509 244 221],474,5,9832,4.1767204757858964,20.0,0.0
6354,1,2354,[290 230 429 316 219],650,2,9834,4.1757961783439494,20.0,0.0
6355,1,2355,[384 295 230 219 429],648,5,9839,4.176146010186757,0.0,0.0
6356,1,2356,[315 478 509 244 221],474,5,9844,4.176495545184556,20.0,0.0
6357,1,2357,[315 478 509 244 221],474,5,9849,4.176844783715013,20.0,0.0
6358,1,2358,[315 478 509 244 221],474,5,9854,4.17719372615515,20.0,0.0
6359,1,2359,[315 478 509 244 221],474,5,9859,4.177542372881356,20.0,0.0
6360,1,2360,[315 478 509 244 221],474,5,9864,4.1778907242693775,20.0,0.0
6361,1,2361,[315 478 509 244 221],474,5,9869,4.178238780694326,20.0,0.0
6362,1,2362,[350 219 201 290 508],13,1,9870,4.176893779094372,0.0,0.0
6363,1,2363,[315 478 509 244 221],474,5,9875,4.177241962774958,20.0,0.0
6364,1,2364,[315 478 509 244 221],474,5,9880,4.177589852008457,20.0,0.0
6365,1,2365,[315 478 509 244 221],474,5,9885,4.177937447168216,20.0,0.0
6366,1,2366,[315 478 509 244 221],474,5,9890,4.178284748626954,20.0,0.0
6367,1,2367,[509 324 378 212 231],7,2,9892,4.177364864864865,0.0,0.0
6368,1,2368,[315 478 509 244 221],474,5,9897,4.177712114816378,20.0,0.0
6369,1,2369,[213 268 481 321 221],6,3,9900,4.177215189873418,0.0,0.0
6370,1,2370,[321 283 275 216 215],308,1,9901,4.175875158161113,0.0,20.0
6371,1,2371,[209 227 272 219 208],650,2,9903,4.174957841483979,0.0,0.0
6372,1,2372,[213 509 232 367 241],194,0,9903,4.173198482932996,0.0,0.0
6373,1,2373,[259 420 485 201 298],308,3,9906,4.1727042965459145,0.0,0.0
6374,1,2374,[315 478 509 244 221],474,5,9911,4.173052631578948,20.0,0.0
6375,1,2375,[315 478 509 244 221],474,5,9916,4.173400673400673,20.0,0.0
6376,1,2376,[315 478 509 244 221],474,5,9921,4.173748422381153,20.0,0.0
6377,1,2377,[315 478 509 244 221],474,5,9926,4.1740958788898235,20.0,0.0
6378,1,2378,[315 478 509 244 221],474,5,9931,4.174443043295502,20.0,0.0
6379,1,2379,[315 478 509 244 221],474,5,9936,4.174789915966387,20.0,0.0
6380,1,2380,[315 478 509 244 221],474,5,9941,4.175136497270055,20.0,0.0
6381,1,2381,[315 478 509 244 221],474,5,9946,4.1754827875734675,20.0,0.0
6382,1,2382,[315 478 509 244 221],474,5,9951,4.175828787242971,20.0,0.0
6383,1,2383,[315 478 509 244 221],474,5,9956,4.176174496644295,20.0,0.0
6384,1,2384,[315 478 509 244 221],474,5,9961,4.176519916142557,20.0,0.0
6385,1,2385,[429 301 221 290 275],334,3,9964,4.176026823134954,0.0,20.0
6386,1,2386,[222 367 280 420 303],13,3,9967,4.175534143276079,0.0,20.0
6387,1,2387,[315 478 509 244 221],474,5,9972,4.175879396984925,20.0,0.0
6388,1,2388,[315 478 509 244 221],474,5,9977,4.176224361657598,20.0,0.0
6389,1,2389,[215 201 217 231 336],13,1,9978,4.174895397489539,0.0,0.0
6390,1,2390,[315 478 509 244 221],474,5,9983,4.1752404851526554,20.0,0.0
6391,1,2391,[315 478 509 244 221],474,5,9988,4.1755852842809364,20.0,0.0
6392,1,2392,[378 230 226 291 298],749,4,9992,4.175511909736732,0.0,0.0
6393,1,2393,[231 208 420 367 583],7,3,9995,4.175020885547202,0.0,0.0
6394,1,2394,[315 478 509 244 221],474,5,10000,4.175365344467641,20.0,0.0
6395,1,2395,[315 478 509 244 221],474,5,10005,4.175709515859766,20.0,0.0
6396,1,2396,[315 478 509 244 221],474,5,10010,4.176053400083438,20.0,0.0
6397,1,2397,[217 219 431 300 215],7,4,10014,4.175979983319433,0.0,20.0
6398,1,2398,[478 452 507 211 367],406,4,10018,4.1759066277615675,0.0,20.0
6399,1,2399,[315 478 509 244 221],474,5,10023,4.17625,20.0,0.0
6400,1,2400,[315 478 509 244 221],474,5,10028,4.176593086214077,20.0,0.0
6401,1,2401,[222 300 208 293 272],653,2,10030,4.175686927560366,0.0,40.0
6402,1,2402,[315 478 509 244 221],474,5,10035,4.176029962546816,20.0,0.0
6403,1,2403,[315 478 509 244 221],474,5,10040,4.1763727121464225,20.0,0.0
6404,1,2404,[315 478 509 244 221],474,5,10045,4.1767151767151764,20.0,0.0
6405,1,2405,[315 478 509 244 221],474,5,10050,4.177057356608479,20.0,0.0
6406,1,2406,[315 478 509 244 221],474,5,10055,4.1773992521811385,20.0,0.0
6407,1,2407,[315 478 509 244 221],474,5,10060,4.177740863787376,20.0,0.0
6408,1,2408,[315 478 509 244 221],474,5,10065,4.178082191780822,20.0,0.0
6409,1,2409,[315 478 509 244 221],474,5,10070,4.178423236514523,20.0,0.0
6410,1,2410,[208 344 431 452 222],13,1,10071,4.1771049357113235,0.0,20.0
6411,1,2411,[315 478 509 244 221],474,5,10076,4.177446102819237,20.0,0.0
6412,1,2412,[315 478 509 244 221],474,5,10081,4.177786987152921,20.0,0.0
6413,1,2413,[326 223 250 331 280],894,3,10084,4.177299088649544,20.0,0.0
6414,1,2414,[264 243 431 485 303],13,2,10086,4.176397515527951,0.0,0.0
6415,1,2415,[315 478 509 244 221],474,5,10091,4.176738410596027,20.0,0.0
6416,1,2416,[481 239 226 283 211],308,2,10093,4.175837815473728,0.0,20.0
6417,1,2417,[315 478 509 244 221],474,5,10098,4.176178660049628,20.0,0.0
6418,1,2418,[315 478 509 244 221],474,5,10103,4.176519222819347,20.0,0.0
6419,1,2419,[315 478 509 244 221],474,5,10108,4.176859504132231,20.0,0.0
6420,1,2420,[315 478 509 244 221],474,5,10113,4.177199504337051,20.0,0.0
6421,1,2421,[213 227 230 392 485],311,4,10117,4.177126341866226,0.0,0.0
6422,1,2422,[315 478 509 244 221],474,5,10122,4.177465951300041,20.0,0.0
6423,1,2423,[315 478 509 244 221],474,5,10127,4.177805280528053,20.0,0.0
6424,1,2424,[303 217 212 219 230],13,2,10129,4.176907216494845,0.0,0.0
6425,1,2425,[315 478 509 244 221],474,5,10134,4.17724649629019,20.0,0.0
6426,1,2426,[315 478 509 244 221],474,5,10139,4.177585496497734,20.0,0.0
6427,1,2427,[315 478 509 244 221],474,5,10144,4.177924217462932,20.0,0.0
6428,1,2428,[315 478 509 244 221],474,5,10149,4.178262659530671,20.0,0.0
6429,1,2429,[315 478 509 244 221],474,5,10154,4.178600823045268,20.0,0.0
6430,1,2430,[315 478 509 244 221],474,5,10159,4.178938708350473,20.0,0.0
6431,1,2431,[315 478 509 244 221],474,5,10164,4.1792763157894735,20.0,0.0
6432,1,2432,[256 315 324 221 246],894,3,10167,4.178791615289765,20.0,0.0
6433,1,2433,[315 478 509 244 221],474,5,10172,4.179129005751848,20.0,0.0
6434,1,2434,[315 478 509 244 221],474,5,10177,4.179466119096509,20.0,0.0
6435,1,2435,[208 215 211 316 218],650,2,10179,4.178571428571429,20.0,20.0
6436,1,2436,[315 478 509 244 221],474,5,10184,4.178908494050061,20.0,0.0
6437,1,2437,[276 201 213 301 226],537,2,10186,4.178014766201804,0.0,20.0
6438,1,2438,[315 478 509 244 221],474,5,10191,4.178351783517835,20.0,0.0
6439,1,2439,[284 202 226 300 208],537,1,10192,4.177049180327868,0.0,20.0
6440,1,2440,[315 478 509 244 221],474,5,10197,4.177386317083163,20.0,0.0
6441,1,2441,[315 478 509 244 221],474,5,10202,4.177723177723178,20.0,0.0
6442,1,2442,[315 478 509 244 221],474,5,10207,4.178059762586983,20.0,0.0
6443,1,2443,[315 478 509 244 221],474,5,10212,4.1783960720130935,20.0,0.0
6444,1,2444,[315 478 509 244 221],474,5,10217,4.178732106339468,20.0,0.0
6445,1,2445,[315 478 509 244 221],474,5,10222,4.179067865903516,20.0,0.0
6446,1,2446,[315 478 509 244 221],474,5,10227,4.179403351042092,20.0,0.0
6447,1,2447,[212 301 283 478 202],184,3,10230,4.178921568627451,0.0,0.0
6448,1,2448,[315 478 509 244 221],474,5,10235,4.179256839526337,20.0,0.0
6449,1,2449,[219 344 264 331 350],13,1,10236,4.17795918367347,0.0,0.0
6450,1,2450,[315 478 509 244 221],474,5,10241,4.178294573643411,20.0,0.0
6451,1,2451,[315 478 509 244 221],474,5,10246,4.17862969004894,20.0,0.0
6452,1,2452,[315 478 509 244 221],474,5,10251,4.178964533224623,20.0,0.0
6453,1,2453,[315 478 509 244 221],474,5,10256,4.179299103504483,20.0,0.0
6454,1,2454,[315 478 509 244 221],474,5,10261,4.179633401221996,20.0,0.0
6455,1,2455,[315 478 509 244 221],474,5,10266,4.179967426710098,20.0,0.0
6456,1,2456,[315 478 509 244 221],474,5,10271,4.18030118030118,20.0,0.0
6457,1,2457,[315 478 509 244 221],474,5,10276,4.180634662327095,20.0,0.0
6458,1,2458,[315 478 509 244 221],474,5,10281,4.180967873119154,20.0,0.0
6459,1,2459,[315 478 509 244 221],474,5,10286,4.18130081300813,20.0,0.0
6460,1,2460,[264 298 223 324 295],894,1,10287,4.180008126777732,20.0,0.0
6461,1,2461,[478 429 284 211 221],524,2,10289,4.179122664500406,0.0,20.0
6462,1,2462,[315 478 509 244 221],474,5,10294,4.179455948030856,20.0,0.0
6463,1,2463,[315 478 509 244 221],474,5,10299,4.179788961038961,20.0,0.0
6464,1,2464,[315 478 509 244 221],474,5,10304,4.180121703853955,20.0,0.0
6465,1,2465,[315 478 509 244 221],474,5,10309,4.180454176804542,20.0,0.0
6466,1,2466,[259 301 206 202 478],234,1,10310,4.179164977705716,0.0,0.0
6467,1,2467,[321 429 384 478 215],13,3,10313,4.178687196110211,0.0,0.0
6468,1,2468,[315 478 509 244 221],474,5,10318,4.179019846091535,20.0,0.0
6469,1,2469,[315 478 509 244 221],474,5,10323,4.179352226720648,20.0,0.0
6470,1,2470,[303 299 478 223 452],13,3,10326,4.178874949413193,20.0,0.0
6471,1,2471,[315 478 509 244 221],474,5,10331,4.1792071197411005,20.0,0.0
6472,1,2472,[315 478 509 244 221],474,5,10336,4.179539021431459,20.0,0.0
6473,1,2473,[315 478 509 244 221],474,5,10341,4.179870654810024,20.0,0.0
6474,1,2474,[315 478 509 244 221],474,5,10346,4.18020202020202,20.0,0.0
6475,1,2475,[315 478 509 244 221],474,5,10351,4.180533117932149,20.0,0.0
6476,1,2476,[315 478 509 244 221],474,5,10356,4.180863948324586,20.0,0.0
6477,1,2477,[315 478 509 244 221],474,5,10361,4.181194511702986,20.0,0.0
6478,1,2478,[315 478 509 244 221],474,5,10366,4.18152480839048,20.0,0.0
6479,1,2479,[315 478 509 244 221],474,5,10371,4.181854838709677,20.0,0.0
6480,1,2480,[315 478 509 244 221],474,5,10376,4.182184602982669,20.0,0.0
6481,1,2481,[315 478 509 244 221],474,5,10381,4.182514101531023,20.0,0.0
6482,1,2482,[315 478 509 244 221],474,5,10386,4.182843334675796,20.0,0.0
6483,1,2483,[315 478 509 244 221],474,5,10391,4.18317230273752,20.0,0.0
6484,1,2484,[250 291 300 264 431],548,5,10396,4.183501006036217,0.0,20.0
6485,1,2485,[315 478 509 244 221],474,5,10401,4.1838294448913915,20.0,0.0
6486,1,2486,[315 478 509 244 221],474,5,10406,4.1841576196220345,20.0,0.0
6487,1,2487,[315 478 509 244 221],474,5,10411,4.184485530546624,20.0,0.0
6488,1,2488,[315 478 509 244 221],474,5,10416,4.184813177983126,20.0,0.0
6489,1,2489,[315 478 509 244 221],474,5,10421,4.185140562248996,20.0,0.0
6490,1,2490,[315 478 509 244 221],474,5,10426,4.18546768366118,20.0,0.0
6491,1,2491,[315 478 509 244 221],474,5,10431,4.185794542536115,20.0,0.0
6492,1,2492,[315 478 509 244 221],474,5,10436,4.186121139189731,20.0,0.0
6493,1,2493,[291 230 431 367 209],279,3,10439,4.185645549318364,0.0,0.0
6494,1,2494,[315 478 509 244 221],474,5,10444,4.185971943887775,20.0,0.0
6495,1,2495,[315 478 509 244 221],474,5,10449,4.186298076923077,20.0,0.0
6496,1,2496,[315 478 509 244 221],474,5,10454,4.186623948738486,20.0,0.0
6497,1,2497,[315 478 509 244 221],474,5,10459,4.186949559647718,20.0,0.0
6498,1,2498,[239 452 211 208 431],13,3,10462,4.186474589835934,0.0,20.0
6499,1,2499,[315 478 509 244 221],474,5,10467,4.1868,20.0,0.0
6500,1,2500,[315 478 509 244 221],474,5,10472,4.187125149940024,20.0,0.0
6501,1,2501,[315 478 509 244 221],474,5,10477,4.1874500399680255,20.0,0.0
6502,1,2502,[315 478 509 244 221],474,5,10482,4.187774670395525,20.0,0.0
6503,1,2503,[315 478 509 244 221],474,5,10487,4.188099041533547,20.0,0.0
6504,1,2504,[315 478 509 244 221],474,5,10492,4.188423153692614,20.0,0.0
6505,1,2505,[315 478 509 244 221],474,5,10497,4.188747007182761,20.0,0.0
6506,1,2506,[315 478 509 244 221],474,5,10502,4.189070602313522,20.0,0.0
6507,1,2507,[315 478 509 244 221],474,5,10507,4.1893939393939394,20.0,0.0
6508,1,2508,[315 478 509 244 221],474,5,10512,4.189717018732563,20.0,0.0
6509,1,2509,[315 478 509 244 221],474,5,10517,4.19003984063745,20.0,0.0
6510,1,2510,[243 413 215 254 240],83,1,10518,4.188769414575866,0.0,0.0
6511,1,2511,[429 350 268 218 215],13,3,10521,4.188296178343949,0.0,0.0
6512,1,2512,[315 478 509 244 221],474,5,10526,4.188619180262634,20.0,0.0
6513,1,2513,[384 264 507 241 583],7,3,10529,4.188146380270485,0.0,0.0
6514,1,2514,[315 478 509 244 221],474,5,10534,4.188469184890656,20.0,0.0
6515,1,2515,[315 478 509 244 221],474,5,10539,4.18879173290938,20.0,0.0
6516,1,2516,[315 478 509 244 221],474,5,10544,4.189114024632499,20.0,0.0
6517,1,2517,[231 250 221 202 227],158,2,10546,4.1882446386020655,0.0,0.0
6518,1,2518,[315 478 509 244 221],474,5,10551,4.18856689162366,20.0,0.0
6519,1,2519,[315 478 509 244 221],474,5,10556,4.188888888888889,20.0,0.0
6520,1,2520,[315 478 509 244 221],474,5,10561,4.189210630702102,20.0,0.0
6521,1,2521,[315 478 509 244 221],474,5,10566,4.189532117367169,20.0,0.0
6522,1,2522,[315 478 509 244 221],474,5,10571,4.189853349187476,20.0,0.0
6523,1,2523,[481 299 301 331 227],328,1,10572,4.188589540412044,0.0,0.0
6524,1,2524,[315 478 509 244 221],474,5,10577,4.188910891089109,20.0,0.0
6525,1,2525,[315 478 509 244 221],474,5,10582,4.18923198733175,20.0,0.0
6526,1,2526,[485 202 217 208 215],295,5,10587,4.189552829442026,0.0,0.0
6527,1,2527,[315 478 509 244 221],474,5,10592,4.189873417721519,20.0,0.0
6528,1,2528,[315 478 509 244 221],474,5,10597,4.190193752471332,20.0,0.0
6529,1,2529,[315 478 509 244 221],474,5,10602,4.190513833992095,20.0,0.0
6530,1,2530,[315 478 509 244 221],474,5,10607,4.190833662583959,20.0,0.0
6531,1,2531,[315 478 509 244 221],474,5,10612,4.191153238546604,20.0,0.0
6532,1,2532,[315 478 509 244 221],474,5,10617,4.191472562179234,20.0,0.0
6533,1,2533,[297 485 221 293 276],6,2,10619,4.19060773480663,20.0,20.0
6534,1,2534,[315 478 509 244 221],474,5,10624,4.190927021696252,20.0,0.0
6535,1,2535,[315 478 509 244 221],474,5,10629,4.191246056782334,20.0,0.0
6536,1,2536,[315 478 509 244 221],474,5,10634,4.191564840362633,20.0,0.0
6537,1,2537,[315 478 509 244 221],474,5,10639,4.191883372734437,20.0,0.0
6538,1,2538,[315 478 509 244 221],474,5,10644,4.192201654194565,20.0,0.0
6539,1,2539,[315 478 509 244 221],474,5,10649,4.19251968503937,20.0,0.0
6540,1,2540,[301 221 293 208 246],6,2,10651,4.191656828020465,0.0,0.0
6541,1,2541,[315 478 509 244 221],474,5,10656,4.191974822974037,20.0,0.0
6542,1,2542,[315 478 509 244 221],474,5,10661,4.192292567833268,20.0,0.0
6543,1,2543,[315 478 509 244 221],474,5,10666,4.192610062893082,20.0,0.0
6544,1,2544,[315 478 509 244 221],474,5,10671,4.1929273084479375,20.0,0.0
6545,1,2545,[315 478 509 244 221],474,5,10676,4.19324430479183,20.0,0.0
6546,1,2546,[315 478 509 244 221],474,5,10681,4.193561052218296,20.0,0.0
6547,1,2547,[208 215 211 202 276],406,2,10683,4.192700156985871,0.0,40.0
6548,1,2548,[315 478 509 244 221],474,5,10688,4.193016869360534,20.0,0.0
6549,1,2549,[255 218 220 221 239],334,1,10689,4.191764705882353,0.0,0.0
6550,1,2550,[315 478 509 244 221],474,5,10694,4.192081536652293,20.0,0.0
6551,1,2551,[315 478 509 244 221],474,5,10699,4.192398119122257,20.0,0.0
6552,1,2552,[315 478 509 244 221],474,5,10704,4.192714453584019,20.0,0.0
6553,1,2553,[315 478 509 244 221],474,5,10709,4.193030540328896,20.0,0.0
6554,1,2554,[315 478 509 244 221],474,5,10714,4.19334637964775,20.0,0.0
6555,1,2555,[315 478 509 244 221],474,5,10719,4.193661971830986,20.0,0.0
6556,1,2556,[315 478 509 244 221],474,5,10724,4.193977317168557,20.0,0.0
6557,1,2557,[226 298 384 211 208],833,1,10725,4.192728694292416,0.0,20.0
6558,1,2558,[315 478 509 244 221],474,5,10730,4.193044157874169,20.0,0.0
6559,1,2559,[315 478 509 244 221],474,5,10735,4.193359375,20.0,0.0
6560,1,2560,[315 256 290 283 350],894,1,10736,4.192112456071847,20.0,0.0
6561,1,2561,[350 300 218 230 211],102,0,10736,4.190476190476191,0.0,40.0
6562,1,2562,[315 478 509 244 221],474,5,10741,4.190792040577448,20.0,0.0
6563,1,2563,[315 478 509 244 221],474,5,10746,4.191107644305772,20.0,0.0
6564,1,2564,[243 241 221 239 236],537,0,10746,4.189473684210526,0.0,0.0
6565,1,2565,[315 478 509 244 221],474,5,10751,4.189789555728761,20.0,0.0
6566,1,2566,[300 478 326 293 212],144,4,10755,4.189715621347877,0.0,20.0
6567,1,2567,[315 478 509 244 221],474,5,10760,4.190031152647975,20.0,0.0
6568,1,2568,[315 478 509 244 221],474,5,10765,4.190346438302842,20.0,0.0
6569,1,2569,[315 478 509 244 221],474,5,10770,4.190661478599222,20.0,0.0
6570,1,2570,[315 478 509 244 221],474,5,10775,4.190976273823415,20.0,0.0
6571,1,2571,[315 478 509 244 221],474,5,10780,4.191290824261276,20.0,0.0
6572,1,2572,[315 478 509 244 221],474,5,10785,4.191605130198212,20.0,0.0
6573,1,2573,[315 478 509 244 221],474,5,10790,4.191919191919192,20.0,0.0
6574,1,2574,[315 478 509 244 221],474,5,10795,4.192233009708738,20.0,0.0
6575,1,2575,[315 478 509 244 221],474,5,10800,4.192546583850931,20.0,0.0
6576,1,2576,[315 478 509 244 221],474,5,10805,4.192859914629414,20.0,0.0
6577,1,2577,[283 301 429 243 236],234,1,10806,4.191621411947246,0.0,0.0
6578,1,2578,[315 478 509 244 221],474,5,10811,4.191934858472276,20.0,0.0
6579,1,2579,[315 478 509 244 221],474,5,10816,4.192248062015504,20.0,0.0
6580,1,2580,[315 478 509 244 221],474,5,10821,4.192561022859357,20.0,0.0
6581,1,2581,[315 478 509 244 221],474,5,10826,4.192873741285825,20.0,0.0
6582,1,2582,[284 298 208 231 275],308,4,10830,4.192799070847851,0.0,20.0
6583,1,2583,[315 478 509 244 221],474,5,10835,4.193111455108359,20.0,0.0
6584,1,2584,[315 478 509 244 221],474,5,10840,4.193423597678917,20.0,0.0
6585,1,2585,[350 241 232 367 212],13,1,10841,4.192188708430008,0.0,0.0
6586,1,2586,[315 478 509 244 221],474,5,10846,4.192500966370313,20.0,0.0
6587,1,2587,[315 478 509 244 221],474,5,10851,4.192812982998454,20.0,0.0
6588,1,2588,[315 478 509 244 221],474,5,10856,4.193124758594052,20.0,0.0
6589,1,2589,[315 478 509 244 221],474,5,10861,4.193436293436293,20.0,0.0
6590,1,2590,[315 478 509 244 221],474,5,10866,4.193747587803936,20.0,0.0
6591,1,2591,[315 478 509 244 221],474,5,10871,4.1940586419753085,20.0,0.0
6592,1,2592,[315 478 509 244 221],474,5,10876,4.194369456228307,20.0,0.0
6593,1,2593,[315 478 509 244 221],474,5,10881,4.194680030840401,20.0,0.0
6594,1,2594,[201 485 227 220 218],59,2,10883,4.19383429672447,0.0,0.0
6595,1,2595,[315 478 509 244 221],474,5,10888,4.194144838212635,20.0,0.0
6596,1,2596,[315 478 509 244 221],474,5,10893,4.1944551405467845,20.0,0.0
6597,1,2597,[315 478 509 244 221],474,5,10898,4.19476520400308,20.0,0.0
6598,1,2598,[315 478 509 244 221],474,5,10903,4.195075028857253,20.0,0.0
6599,1,2599,[315 478 509 244 221],474,5,10908,4.195384615384615,20.0,0.0
6600,1,2600,[315 478 509 244 221],474,5,10913,4.195693963860053,20.0,0.0
6601,1,2601,[303 239 272 216 324],543,2,10915,4.194850115295926,0.0,0.0
6602,1,2602,[315 478 509 244 221],474,5,10920,4.195159431425279,20.0,0.0
6603,1,2603,[315 478 509 244 221],474,5,10925,4.195468509984639,20.0,0.0
6604,1,2604,[315 478 509 244 221],474,5,10930,4.1957773512476,20.0,0.0
6605,1,2605,[378 215 216 275 276],271,4,10934,4.195702225633155,0.0,40.0
6606,1,2606,[315 478 509 244 221],474,5,10939,4.196010740314538,20.0,0.0
6607,1,2607,[315 478 509 244 221],474,5,10944,4.196319018404908,20.0,0.0
6608,1,2608,[315 478 509 244 221],474,5,10949,4.196627060176313,20.0,0.0
6609,1,2609,[315 478 509 244 221],474,5,10954,4.196934865900383,20.0,0.0
6610,1,2610,[315 478 509 244 221],474,5,10959,4.197242435848334,20.0,0.0
6611,1,2611,[315 478 509 244 221],474,5,10964,4.197549770290965,20.0,0.0
6612,1,2612,[315 478 509 244 221],474,5,10969,4.19785686949866,20.0,0.0
6613,1,2613,[208 230 394 300 478],13,2,10971,4.197016067329763,0.0,20.0
6614,1,2614,[299 230 215 222 219],13,1,10972,4.195793499043977,0.0,20.0
6615,1,2615,[206 221 507 202 216],537,1,10973,4.194571865443425,0.0,0.0
6616,1,2616,[431 259 300 213 211],7,3,10976,4.19411539931219,0.0,40.0
6617,1,2617,[315 478 509 244 221],474,5,10981,4.194423223834988,20.0,0.0
6618,1,2618,[315 478 509 244 221],474,5,10986,4.1947308132875145,20.0,0.0
6619,1,2619,[315 478 509 244 221],474,5,10991,4.1950381679389315,20.0,0.0
6620,1,2620,[299 509 413 212 227],13,3,10994,4.194582220526517,0.0,0.0
6621,1,2621,[315 478 509 244 221],474,5,10999,4.19488939740656,20.0,0.0
6622,1,2622,[315 478 509 244 221],474,5,11004,4.195196340068624,20.0,0.0
6623,1,2623,[315 478 509 244 221],474,5,11009,4.195503048780488,20.0,0.0
6624,1,2624,[315 478 509 244 221],474,5,11014,4.195809523809523,20.0,0.0
6625,1,2625,[315 478 509 244 221],474,5,11019,4.196115765422696,20.0,0.0
6626,1,2626,[315 478 509 244 221],474,5,11024,4.196421773886563,20.0,0.0
6627,1,2627,[223 231 211 272 222],650,3,11027,4.195966514459665,20.0,40.0
6628,1,2628,[315 478 509 244 221],474,5,11032,4.196272346899962,20.0,0.0
6629,1,2629,[485 509 316 202 239],650,0,11032,4.19467680608365,20.0,0.0
6630,1,2630,[315 478 244 509 221],474,5,11037,4.194982896237172,20.0,0.0
6631,1,2631,[315 478 244 509 221],474,5,11042,4.195288753799392,20.0,0.0
6632,1,2632,[315 478 244 509 221],474,5,11047,4.195594379035321,20.0,0.0
6633,1,2633,[315 478 244 509 221],474,5,11052,4.195899772209567,20.0,0.0
6634,1,2634,[315 478 244 509 221],474,5,11057,4.196204933586338,20.0,0.0
6635,1,2635,[315 478 244 509 221],474,5,11062,4.196509863429439,20.0,0.0
6636,1,2636,[315 478 244 509 221],474,5,11067,4.196814562002276,20.0,0.0
6637,1,2637,[315 478 244 509 221],474,5,11072,4.197119029567855,20.0,0.0
6638,1,2638,[508 220 290 481 316],334,2,11074,4.196286472148541,20.0,0.0
6639,1,2639,[315 478 244 509 221],474,5,11079,4.196590909090909,20.0,0.0
6640,1,2640,[315 478 244 509 221],474,5,11084,4.196895115486558,20.0,0.0
6641,1,2641,[315 478 244 509 221],474,5,11089,4.197199091597275,20.0,0.0
6642,1,2642,[298 291 222 508 255],455,2,11091,4.196367763904654,0.0,20.0
6643,1,2643,[315 478 244 509 221],474,5,11096,4.196671709531014,20.0,0.0
6644,1,2644,[209 264 321 392 276],308,3,11099,4.196219281663516,0.0,20.0
6645,1,2645,[283 509 280 222 218],378,2,11101,4.1953892668178385,0.0,20.0
6646,1,2646,[315 478 244 509 221],474,5,11106,4.195693237627503,20.0,0.0
6647,1,2647,[315 478 244 509 221],474,5,11111,4.195996978851964,20.0,0.0
6648,1,2648,[315 478 244 509 221],474,5,11116,4.196300490751227,20.0,0.0
6649,1,2649,[239 208 300 431 384],102,1,11117,4.195094339622641,0.0,20.0
6650,1,2650,[315 478 244 509 221],474,5,11122,4.195397963032818,20.0,0.0
6651,1,2651,[315 478 244 509 221],474,5,11127,4.1957013574660635,20.0,0.0
6652,1,2652,[315 478 244 509 221],474,5,11132,4.196004523181304,20.0,0.0
6653,1,2653,[315 478 244 509 221],474,5,11137,4.196307460437076,20.0,0.0
6654,1,2654,[315 478 244 509 221],474,5,11142,4.196610169491525,20.0,0.0
6655,1,2655,[315 478 244 509 221],474,5,11147,4.1969126506024095,20.0,0.0
6656,1,2656,[315 478 244 509 221],474,5,11152,4.197214904027098,20.0,0.0
6657,1,2657,[315 478 244 509 221],474,5,11157,4.197516930022573,20.0,0.0
6658,1,2658,[481 276 485 213 583],308,4,11161,4.197442647611884,0.0,20.0
6659,1,2659,[378 216 481 507 202],308,2,11163,4.196616541353383,0.0,0.0
6660,1,2660,[315 478 244 509 221],474,5,11168,4.196918451709884,20.0,0.0
6661,1,2661,[315 478 244 509 221],474,5,11173,4.197220135236664,20.0,0.0
6662,1,2662,[315 478 244 509 221],474,5,11178,4.19752159218926,20.0,0.0
6663,1,2663,[315 478 244 509 221],474,5,11183,4.197822822822823,20.0,0.0
6664,1,2664,[315 478 244 509 221],474,5,11188,4.19812382739212,20.0,0.0
6665,1,2665,[315 478 244 509 221],474,5,11193,4.198424606151538,20.0,0.0
6666,1,2666,[315 478 244 509 221],474,5,11198,4.198725159355081,20.0,0.0
6667,1,2667,[315 478 244 509 221],474,5,11203,4.199025487256372,20.0,0.0
6668,1,2668,[315 478 244 509 221],474,5,11208,4.199325590108655,20.0,0.0
6669,1,2669,[367 241 227 208 222],311,3,11211,4.198876404494382,0.0,20.0
6670,1,2670,[202 291 316 367 300],234,2,11213,4.198053163609135,20.0,20.0
6671,1,2671,[230 227 301 478 367],524,2,11215,4.197230538922156,0.0,0.0
6672,1,2672,[315 478 244 509 221],474,5,11220,4.197530864197531,20.0,0.0
6673,1,2673,[219 212 276 275 293],145,2,11222,4.196709050112191,0.0,40.0
6674,1,2674,[331 243 384 301 507],13,0,11222,4.1951401869158875,0.0,0.0
6675,1,2675,[315 478 244 509 221],474,5,11227,4.195440956651719,20.0,0.0
6676,1,2676,[315 478 244 509 221],474,5,11232,4.1957415016809865,20.0,0.0
6677,1,2677,[315 478 244 509 221],474,5,11237,4.196041822255414,20.0,0.0
6678,1,2678,[315 478 244 509 221],474,5,11242,4.196341918626353,20.0,0.0
6679,1,2679,[315 478 244 509 221],474,5,11247,4.196641791044776,20.0,0.0
6680,1,2680,[213 284 485 239 223],194,1,11248,4.195449459157031,20.0,0.0
6681,1,2681,[367 240 293 300 215],774,0,11248,4.193885160328113,0.0,20.0
6682,1,2682,[315 478 244 509 221],474,5,11253,4.194185613119642,20.0,0.0
6683,1,2683,[508 275 227 316 290],13,3,11256,4.193740685543964,20.0,20.0
6684,1,2684,[202 217 215 321 431],13,2,11258,4.1929236499068905,0.0,0.0
6685,1,2685,[315 478 244 509 221],474,5,11263,4.193224125093075,20.0,0.0
6686,1,2686,[315 478 244 509 221],474,5,11268,4.1935243766282095,20.0,0.0
6687,1,2687,[315 478 244 509 221],474,5,11273,4.193824404761905,20.0,0.0
6688,1,2688,[300 303 452 212 507],13,2,11275,4.193008553365563,0.0,20.0
6689,1,2689,[315 478 244 509 221],474,5,11280,4.193308550185874,20.0,0.0
6690,1,2690,[326 478 217 290 452],13,2,11282,4.1924934968413226,0.0,0.0
6691,1,2691,[315 478 244 509 221],474,5,11287,4.192793462109956,20.0,0.0
6692,1,2692,[315 478 244 509 221],474,5,11292,4.19309320460453,20.0,0.0
6693,1,2693,[315 478 244 509 221],474,5,11297,4.193392724573125,20.0,0.0
6694,1,2694,[315 478 244 509 221],474,5,11302,4.193692022263451,20.0,0.0
6695,1,2695,[331 259 301 275 326],116,1,11303,4.192507418397626,0.0,20.0
6696,1,2696,[293 213 316 275 431],474,4,11307,4.192436040044494,20.0,20.0
6697,1,2697,[315 478 244 509 221],474,5,11312,4.1927353595255745,20.0,0.0
6698,1,2698,[315 478 244 509 221],474,5,11317,4.193034457206373,20.0,0.0
6699,1,2699,[267 217 240 431 223],833,2,11319,4.192222222222222,20.0,0.0
6700,1,2700,[216 219 276 223 452],13,2,11321,4.191410588670863,20.0,20.0
6701,1,2701,[213 208 222 420 241],311,3,11324,4.1909696521095485,0.0,20.0
6702,1,2702,[293 316 222 275 218],548,4,11328,4.190899001109878,20.0,40.0
6703,1,2703,[298 231 215 239 509],378,2,11330,4.19008875739645,0.0,0.0
6704,1,2704,[275 217 268 215 261],13,2,11332,4.189279112754159,0.0,20.0
6705,1,2705,[315 478 244 509 221],474,5,11337,4.189578713968958,20.0,0.0
6706,1,2706,[315 478 244 509 221],474,5,11342,4.189878093830809,20.0,0.0
6707,1,2707,[315 478 244 509 221],474,5,11347,4.190177252584934,20.0,0.0
6708,1,2708,[208 227 298 244 213],474,3,11350,4.189737910668144,0.0,0.0
6709,1,2709,[315 478 244 509 221],474,5,11355,4.1900369003690034,20.0,0.0
6710,1,2710,[315 478 244 509 221],474,5,11360,4.190335669494652,20.0,0.0
6711,1,2711,[321 218 217 315 216],13,1,11361,4.189159292035399,20.0,0.0
6712,1,2712,[315 478 244 509 221],474,5,11366,4.189458164393661,20.0,0.0
6713,1,2713,[315 478 244 509 221],474,5,11371,4.189756816507001,20.0,0.0
6714,1,2714,[315 478 244 509 221],474,5,11376,4.190055248618784,20.0,0.0
6715,1,2715,[315 478 244 509 221],474,5,11381,4.190353460972018,20.0,0.0
6716,1,2716,[315 478 244 509 221],474,5,11386,4.190651453809348,20.0,0.0
6717,1,2717,[315 478 244 509 221],474,5,11391,4.190949227373069,20.0,0.0
6718,1,2718,[202 301 254 215 509],184,2,11393,4.190143435086429,0.0,0.0
6719,1,2719,[315 478 244 509 221],474,5,11398,4.190441176470588,20.0,0.0
6720,1,2720,[315 478 244 509 221],474,5,11403,4.190738699007718,20.0,0.0
6721,1,2721,[226 268 206 209 241],387,2,11405,4.189933872152829,0.0,0.0
6722,1,2722,[378 301 321 291 211],537,1,11406,4.188762394417921,0.0,20.0
6723,1,2723,[315 478 244 509 221],474,5,11411,4.189060205580029,20.0,0.0
6724,1,2724,[315 478 244 509 221],474,5,11416,4.189357798165138,20.0,0.0
6725,1,2725,[211 429 283 202 481],234,2,11418,4.1885546588407925,0.0,20.0
6726,1,2726,[315 478 244 509 221],474,5,11423,4.188852218555189,20.0,0.0
6727,1,2727,[213 275 290 222 272],334,4,11427,4.188782991202346,0.0,40.0
6728,1,2728,[315 478 244 509 221],474,5,11432,4.189080249175523,20.0,0.0
6729,1,2729,[315 478 244 509 221],474,5,11437,4.18937728937729,20.0,0.0
6730,1,2730,[315 478 244 509 221],474,5,11442,4.18967411204687,20.0,0.0
6731,1,2731,[261 219 301 336 272],13,1,11443,4.188506588579795,0.0,0.0
6732,1,2732,[315 478 244 509 221],474,5,11448,4.18880351262349,20.0,0.0
6733,1,2733,[213 231 216 272 300],378,4,11452,4.188734455010973,0.0,20.0
6734,1,2734,[221 303 295 509 344],894,4,11456,4.188665447897623,0.0,0.0
6735,1,2735,[315 478 244 509 221],474,5,11461,4.188961988304094,20.0,0.0
6736,1,2736,[315 478 244 509 221],474,5,11466,4.189258312020461,20.0,0.0
6737,1,2737,[211 291 231 241 293],308,3,11469,4.188823959094229,0.0,20.0
6738,1,2738,[315 478 244 509 221],474,5,11474,4.18912011683096,20.0,0.0
6739,1,2739,[315 478 244 509 221],474,5,11479,4.18941605839416,20.0,0.0
6740,1,2740,[226 301 431 211 507],650,2,11481,4.188617292958774,0.0,20.0
6741,1,2741,[315 478 244 509 221],474,5,11486,4.188913202042305,20.0,0.0
6742,1,2742,[315 478 244 509 221],474,5,11491,4.189208895370033,20.0,0.0
6743,1,2743,[315 478 244 509 221],474,5,11496,4.189504373177843,20.0,0.0
6744,1,2744,[315 478 244 509 221],474,5,11501,4.1897996357012754,20.0,0.0
6745,1,2745,[315 478 244 509 221],474,5,11506,4.190094683175528,20.0,0.0
6746,1,2746,[315 478 244 509 221],474,5,11511,4.190389515835457,20.0,0.0
6747,1,2747,[315 478 244 509 221],474,5,11516,4.190684133915575,20.0,0.0
6748,1,2748,[230 324 216 509 384],7,2,11518,4.1898872317206255,0.0,0.0
6749,1,2749,[315 478 244 509 221],474,5,11523,4.190181818181818,20.0,0.0
6750,1,2750,[230 211 209 226 300],843,0,11523,4.1886586695747,0.0,40.0
6751,1,2751,[420 485 202 299 239],13,3,11526,4.188226744186046,0.0,0.0
6752,1,2752,[259 284 222 215 219],804,4,11530,4.188158372684344,0.0,20.0
6753,1,2753,[315 478 244 509 221],474,5,11535,4.188453159041394,20.0,0.0
6754,1,2754,[300 367 227 384 216],64,2,11537,4.187658802177858,0.0,20.0
6755,1,2755,[315 478 244 509 221],474,5,11542,4.187953555878084,20.0,0.0
6756,1,2756,[315 478 244 509 221],474,5,11547,4.188248095756257,20.0,0.0
6757,1,2757,[315 478 244 509 221],474,5,11552,4.18854242204496,20.0,0.0
6758,1,2758,[315 478 244 509 221],474,5,11557,4.188836534976441,20.0,0.0
6759,1,2759,[315 478 244 509 221],474,5,11562,4.189130434782609,20.0,0.0
6760,1,2760,[315 478 244 509 221],474,5,11567,4.189424121695038,20.0,0.0
6761,1,2761,[202 283 208 321 583],308,3,11570,4.188993482983346,0.0,0.0
6762,1,2762,[221 217 223 218 321],184,3,11573,4.188563155989866,20.0,0.0
6763,1,2763,[315 478 244 509 221],474,5,11578,4.188856729377713,20.0,0.0
6764,1,2764,[485 378 211 216 209],766,2,11580,4.188065099457504,0.0,20.0
6765,1,2765,[315 478 244 509 221],474,5,11585,4.188358640636298,20.0,0.0
6766,1,2766,[315 478 244 509 221],474,5,11590,4.188651969642212,20.0,0.0
6767,1,2767,[315 478 244 509 221],474,5,11595,4.1889450867052025,20.0,0.0
6768,1,2768,[315 478 244 509 221],474,5,11600,4.189237992054894,20.0,0.0
6769,1,2769,[315 478 244 509 221],474,5,11605,4.189530685920578,20.0,0.0
6770,1,2770,[315 478 244 509 221],474,5,11610,4.189823168531216,20.0,0.0
6771,1,2771,[315 478 244 509 221],474,5,11615,4.19011544011544,20.0,0.0
6772,1,2772,[315 478 244 509 221],474,5,11620,4.190407500901551,20.0,0.0
6773,1,2773,[315 478 244 509 221],474,5,11625,4.1906993511175195,20.0,0.0
6774,1,2774,[315 478 244 509 221],474,5,11630,4.190990990990991,20.0,0.0
6775,1,2775,[324 206 201 250 243],387,4,11634,4.1909221902017295,0.0,0.0
6776,1,2776,[315 478 244 509 221],474,5,11639,4.191213539791142,20.0,0.0
6777,1,2777,[315 478 244 509 221],474,5,11644,4.19150467962563,20.0,0.0
6778,1,2778,[315 478 244 509 221],474,5,11649,4.1917956099316305,20.0,0.0
6779,1,2779,[231 202 420 290 509],650,0,11649,4.190287769784173,0.0,0.0
6780,1,2780,[315 478 244 509 221],474,5,11654,4.190578928443006,20.0,0.0
6781,1,2781,[209 392 481 378 283],308,3,11657,4.190150970524802,0.0,0.0
6782,1,2782,[246 208 209 215 420],85,5,11662,4.190441969098096,0.0,0.0
6783,1,2783,[315 478 244 509 221],474,5,11667,4.1907327586206895,20.0,0.0
6784,1,2784,[315 478 244 509 221],474,5,11672,4.191023339317773,20.0,0.0
6785,1,2785,[219 208 239 216 295],308,1,11673,4.189877961234745,0.0,0.0
6786,1,2786,[231 291 384 259 509],279,1,11674,4.188733405095085,0.0,0.0
6787,1,2787,[283 276 239 221 202],271,2,11676,4.187948350071736,0.0,20.0
6788,1,2788,[315 478 244 509 221],474,5,11681,4.188239512370025,20.0,0.0
6789,1,2789,[315 478 244 509 221],474,5,11686,4.188530465949821,20.0,0.0
6790,1,2790,[272 481 478 215 208],13,4,11690,4.188462916517377,0.0,0.0
6791,1,2791,[315 478 244 509 221],474,5,11695,4.188753581661891,20.0,0.0
6792,1,2792,[315 478 244 509 221],474,5,11700,4.189044038668099,20.0,0.0
6793,1,2793,[315 478 244 509 221],474,5,11705,4.189334287759484,20.0,0.0
6794,1,2794,[213 378 212 509 298],85,4,11709,4.189266547406082,0.0,0.0
6795,1,2795,[315 478 244 509 221],474,5,11714,4.189556509298998,20.0,0.0
6796,1,2796,[315 478 244 509 221],474,5,11719,4.18984626385413,20.0,0.0
6797,1,2797,[315 478 244 509 221],474,5,11724,4.190135811293781,20.0,0.0
6798,1,2798,[300 321 217 227 280],378,1,11725,4.188996070025009,0.0,20.0
6799,1,2799,[315 478 244 509 221],474,5,11730,4.189285714285714,20.0,0.0
6800,1,2800,[315 478 244 509 221],474,5,11735,4.189575151731525,20.0,0.0
6801,1,2801,[315 478 244 509 221],474,5,11740,4.189864382583869,20.0,0.0
6802,1,2802,[315 478 244 509 221],474,5,11745,4.19015340706386,20.0,0.0
6803,1,2803,[315 478 244 509 221],474,5,11750,4.190442225392297,20.0,0.0
6804,1,2804,[209 227 213 230 378],474,4,11754,4.190374331550802,0.0,0.0
6805,1,2805,[315 478 244 509 221],474,5,11759,4.190662865288667,20.0,0.0
6806,1,2806,[218 336 481 216 321],13,0,11759,4.189169932312077,0.0,0.0
6807,1,2807,[250 429 241 240 219],774,2,11761,4.188390313390314,0.0,0.0
6808,1,2808,[315 478 244 509 221],474,5,11766,4.188679245283019,20.0,0.0
6809,1,2809,[231 268 230 316 222],85,1,11767,4.187544483985765,20.0,20.0
6810,1,2810,[321 413 509 275 211],279,3,11770,4.187122020633226,0.0,40.0
6811,1,2811,[315 478 244 509 221],474,5,11775,4.1874110953058326,20.0,0.0
6812,1,2812,[315 478 244 509 221],474,5,11780,4.187699964450764,20.0,0.0
6813,1,2813,[315 478 244 509 221],474,5,11785,4.187988628287136,20.0,0.0
6814,1,2814,[315 478 244 509 221],474,5,11790,4.188277087033748,20.0,0.0
6815,1,2815,[315 478 244 509 221],474,5,11795,4.188565340909091,20.0,0.0
6816,1,2816,[315 478 244 509 221],474,5,11800,4.188853390131346,20.0,0.0
6817,1,2817,[315 478 244 509 221],474,5,11805,4.189141234918382,20.0,0.0
6818,1,2818,[215 222 209 213 227],295,5,11810,4.189428875487762,0.0,20.0
6819,1,2819,[295 227 239 226 300],533,4,11814,4.18936170212766,0.0,20.0
6820,1,2820,[315 478 244 509 221],474,5,11819,4.189649060616802,20.0,0.0
6821,1,2821,[315 478 244 509 221],474,5,11824,4.189936215450035,20.0,0.0
6822,1,2822,[315 478 244 509 221],474,5,11829,4.190223166843783,20.0,0.0
6823,1,2823,[315 478 244 509 221],474,5,11834,4.1905099150141645,20.0,0.0
6824,1,2824,[507 241 378 367 218],234,3,11837,4.190088495575221,0.0,0.0
6825,1,2825,[315 478 244 509 221],474,5,11842,4.19037508846426,20.0,0.0
6826,1,2826,[315 478 244 509 221],474,5,11847,4.190661478599222,20.0,0.0
6827,1,2827,[384 350 226 303 315],13,3,11850,4.19024045261669,20.0,0.0
6828,1,2828,[315 478 244 509 221],474,5,11855,4.1905266878755745,20.0,0.0
6829,1,2829,[315 478 244 509 221],474,5,11860,4.190812720848056,20.0,0.0
6830,1,2830,[315 478 244 509 221],474,5,11865,4.191098551748499,20.0,0.0
6831,1,2831,[315 478 244 509 221],474,5,11870,4.19138418079096,20.0,0.0
6832,1,2832,[315 478 244 509 221],474,5,11875,4.191669608189199,20.0,0.0
6833,1,2833,[315 478 244 509 221],474,5,11880,4.191954834156669,20.0,0.0
6834,1,2834,[315 478 244 509 221],474,5,11885,4.192239858906525,20.0,0.0
6835,1,2835,[315 478 244 509 221],474,5,11890,4.192524682651622,20.0,0.0
6836,1,2836,[315 478 244 509 221],474,5,11895,4.192809305604512,20.0,0.0
6837,1,2837,[315 478 244 509 221],474,5,11900,4.193093727977449,20.0,0.0
6838,1,2838,[315 478 244 509 221],474,5,11905,4.193377949982388,20.0,0.0
6839,1,2839,[315 478 244 509 221],474,5,11910,4.193661971830986,20.0,0.0
6840,1,2840,[261 275 219 211 201],13,1,11911,4.192537838789159,0.0,40.0
6841,1,2841,[315 478 244 509 221],474,5,11916,4.192821956368754,20.0,0.0
6842,1,2842,[227 275 301 226 216],13,2,11918,4.192050650721069,0.0,20.0
6843,1,2843,[315 478 244 509 221],474,5,11923,4.192334739803094,20.0,0.0
6844,1,2844,[315 478 244 509 221],474,5,11928,4.19261862917399,20.0,0.0
6845,1,2845,[429 336 481 326 478],13,2,11930,4.191848208011244,0.0,0.0
6846,1,2846,[315 478 244 509 221],474,5,11935,4.192132068844398,20.0,0.0
6847,1,2847,[227 223 226 211 230],194,2,11937,4.191362359550562,20.0,20.0
6848,1,2848,[315 478 244 509 221],474,5,11942,4.191646191646192,20.0,0.0
6849,1,2849,[315 478 244 509 221],474,5,11947,4.191929824561403,20.0,0.0
6850,1,2850,[315 478 244 509 221],474,5,11952,4.192213258505787,20.0,0.0
6851,1,2851,[315 478 244 509 221],474,5,11957,4.1924964936886395,20.0,0.0
6852,1,2852,[268 232 213 211 507],7,2,11959,4.191728005608132,0.0,20.0
6853,1,2853,[315 478 244 509 221],474,5,11964,4.192011212333567,20.0,0.0
6854,1,2854,[209 485 478 221 303],6,4,11968,4.191943957968476,0.0,0.0
6855,1,2855,[315 478 244 509 221],474,5,11973,4.192226890756302,20.0,0.0
6856,1,2856,[315 478 244 509 221],474,5,11978,4.192509625481274,20.0,0.0
6857,1,2857,[315 478 244 509 221],474,5,11983,4.192792162351295,20.0,0.0
6858,1,2858,[315 478 244 509 221],474,5,11988,4.193074501573977,20.0,0.0
6859,1,2859,[429 300 336 212 239],13,3,11991,4.192657342657343,0.0,20.0
6860,1,2860,[315 478 244 509 221],474,5,11996,4.192939531632296,20.0,0.0
6861,1,2861,[315 478 244 509 221],474,5,12001,4.193221523410203,20.0,0.0
6862,1,2862,[315 478 244 509 221],474,5,12006,4.193503318197695,20.0,0.0
6863,1,2863,[315 478 244 509 221],474,5,12011,4.193784916201118,20.0,0.0
6864,1,2864,[315 478 244 509 221],474,5,12016,4.194066317626527,20.0,0.0
6865,1,2865,[315 478 244 509 221],474,5,12021,4.194347522679693,20.0,0.0
6866,1,2866,[315 478 244 509 221],474,5,12026,4.194628531566097,20.0,0.0
6867,1,2867,[315 478 244 509 221],474,5,12031,4.1949093444909344,20.0,0.0
6868,1,2868,[315 478 244 509 221],474,5,12036,4.195189961659115,20.0,0.0
6869,1,2869,[222 392 216 420 226],843,0,12036,4.193728222996516,0.0,20.0
6870,1,2870,[331 216 316 231 226],13,2,12038,4.192964123998607,20.0,0.0
6871,1,2871,[315 478 244 509 221],474,5,12043,4.19324512534819,20.0,0.0
6872,1,2872,[315 478 244 509 221],474,5,12048,4.193525931082492,20.0,0.0
6873,1,2873,[315 478 244 509 221],474,5,12053,4.193806541405706,20.0,0.0
6874,1,2874,[315 478 244 509 221],474,5,12058,4.19408695652174,20.0,0.0
6875,1,2875,[206 231 215 378 212],537,0,12058,4.192628650904034,0.0,0.0
6876,1,2876,[216 218 315 217 367],650,1,12059,4.191518943343761,20.0,0.0
6877,1,2877,[222 232 215 378 230],653,0,12059,4.19006254343294,0.0,20.0
6878,1,2878,[212 216 211 290 478],234,0,12059,4.188607155262244,0.0,20.0
6879,1,2879,[315 244 478 509 221],474,5,12064,4.188888888888889,20.0,0.0
6880,1,2880,[315 244 478 509 221],474,5,12069,4.189170426935092,20.0,0.0
6881,1,2881,[315 244 478 509 221],474,5,12074,4.1894517696044415,20.0,0.0
6882,1,2882,[218 276 212 213 290],234,0,12074,4.187998612556365,0.0,20.0
6883,1,2883,[295 275 264 583 291],308,2,12076,4.187239944521498,0.0,20.0
6884,1,2884,[315 244 478 509 221],474,5,12081,4.1875216637781625,20.0,0.0
6885,1,2885,[315 244 478 509 221],474,5,12086,4.187803187803188,20.0,0.0
6886,1,2886,[315 244 478 509 221],474,5,12091,4.188084516799446,20.0,0.0
6887,1,2887,[315 244 478 509 221],474,5,12096,4.188365650969529,20.0,0.0
6888,1,2888,[315 244 478 509 221],474,5,12101,4.1886465905157495,20.0,0.0
6889,1,2889,[216 291 429 300 213],892,4,12105,4.188581314878893,0.0,20.0
6890,1,2890,[315 244 478 509 221],474,5,12110,4.188861985472155,20.0,0.0
6891,1,2891,[315 244 478 509 221],474,5,12115,4.189142461964039,20.0,0.0
6892,1,2892,[378 420 276 298 283],308,3,12118,4.188731420670584,0.0,20.0
6893,1,2893,[315 244 478 509 221],474,5,12123,4.189011748445059,20.0,0.0
6894,1,2894,[315 244 478 509 221],474,5,12128,4.189291882556131,20.0,0.0
6895,1,2895,[315 244 478 509 221],474,5,12133,4.18957182320442,20.0,0.0
6896,1,2896,[315 244 478 509 221],474,5,12138,4.189851570590266,20.0,0.0
6897,1,2897,[315 244 478 509 221],474,5,12143,4.190131124913734,20.0,0.0
6898,1,2898,[315 244 478 509 221],474,5,12148,4.190410486374612,20.0,0.0
6899,1,2899,[315 244 478 509 221],474,5,12153,4.190689655172414,20.0,0.0
6900,1,2900,[315 244 478 509 221],474,5,12158,4.190968631506377,20.0,0.0
6901,1,2901,[315 244 478 509 221],474,5,12163,4.191247415575465,20.0,0.0
6902,1,2902,[315 244 478 509 221],474,5,12168,4.191526007578367,20.0,0.0
6903,1,2903,[315 244 478 509 221],474,5,12173,4.191804407713499,20.0,0.0
6904,1,2904,[509 275 481 226 316],13,3,12176,4.191394148020654,20.0,20.0
6905,1,2905,[315 244 478 509 221],474,5,12181,4.191672401927048,20.0,0.0
6906,1,2906,[315 244 478 509 221],474,5,12186,4.191950464396285,20.0,0.0
6907,1,2907,[315 244 478 509 221],474,5,12191,4.19222833562586,20.0,0.0
6908,1,2908,[315 231 208 290 299],13,3,12194,4.191818494327948,20.0,0.0
6909,1,2909,[209 509 227 202 232],311,2,12196,4.19106529209622,0.0,0.0
6910,1,2910,[241 508 213 509 223],378,5,12201,4.191343181037444,20.0,0.0
6911,1,2911,[315 244 478 509 221],474,5,12206,4.1916208791208796,20.0,0.0
6912,1,2912,[509 218 283 254 213],378,3,12209,4.191211809131479,0.0,0.0
6913,1,2913,[315 244 478 509 221],474,5,12214,4.191489361702128,20.0,0.0
6914,1,2914,[284 212 218 231 215],804,4,12218,4.191423670668954,0.0,0.0
6915,1,2915,[315 244 478 509 221],474,5,12223,4.191700960219479,20.0,0.0
6916,1,2916,[315 244 478 509 221],474,5,12228,4.191978059650325,20.0,0.0
6917,1,2917,[315 244 478 509 221],474,5,12233,4.192254969156957,20.0,0.0
6918,1,2918,[315 244 478 509 221],474,5,12238,4.192531688934567,20.0,0.0
6919,1,2919,[315 244 478 509 221],474,5,12243,4.192808219178082,20.0,0.0
6920,1,2920,[315 244 478 509 221],474,5,12248,4.193084560082164,20.0,0.0
6921,1,2921,[315 244 478 509 221],474,5,12253,4.193360711841205,20.0,0.0
6922,1,2922,[315 244 478 509 221],474,5,12258,4.1936366746493325,20.0,0.0
6923,1,2923,[315 244 478 509 221],474,5,12263,4.19391244870041,20.0,0.0
6924,1,2924,[315 244 478 509 221],474,5,12268,4.194188034188034,20.0,0.0
6925,1,2925,[378 452 230 264 324],833,0,12268,4.192754613807246,0.0,0.0
6926,1,2926,[315 244 478 509 221],474,5,12273,4.193030406559617,20.0,0.0
6927,1,2927,[315 244 478 509 221],474,5,12278,4.1933060109289615,20.0,0.0
6928,1,2928,[230 301 232 215 331],13,1,12279,4.192215773301468,0.0,0.0
6929,1,2929,[429 420 202 485 216],7,4,12283,4.192150170648464,0.0,0.0
6930,1,2930,[315 244 478 509 221],474,5,12288,4.1924257932446265,20.0,0.0
6931,1,2931,[315 244 478 509 221],474,5,12293,4.192701227830832,20.0,0.0
6932,1,2932,[315 244 478 509 221],474,5,12298,4.192976474599386,20.0,0.0
6933,1,2933,[315 244 478 509 221],474,5,12303,4.193251533742331,20.0,0.0
6934,1,2934,[315 244 478 509 221],474,5,12308,4.193526405451448,20.0,0.0
6935,1,2935,[315 244 478 509 221],474,5,12313,4.1938010899182565,20.0,0.0
6936,1,2936,[315 244 478 509 221],474,5,12318,4.194075587334014,20.0,0.0
6937,1,2937,[315 244 478 509 221],474,5,12323,4.194349897889721,20.0,0.0
6938,1,2938,[431 226 223 367 508],387,2,12325,4.193603266417148,20.0,0.0
6939,1,2939,[315 244 478 509 221],474,5,12330,4.1938775510204085,20.0,0.0
6940,1,2940,[315 244 478 509 221],474,5,12335,4.194151649098946,20.0,0.0
6941,1,2941,[315 244 478 509 221],474,5,12340,4.194425560842964,20.0,0.0
6942,1,2942,[315 244 478 509 221],474,5,12345,4.194699286442406,20.0,0.0
6943,1,2943,[222 299 478 300 336],13,1,12346,4.193614130434782,0.0,40.0
6944,1,2944,[243 208 201 227 429],59,3,12349,4.19320882852292,0.0,0.0
6945,1,2945,[315 244 478 509 221],474,5,12354,4.193482688391039,20.0,0.0
6946,1,2946,[316 420 272 209 215],13,4,12358,4.193417034272141,20.0,0.0
6947,1,2947,[227 215 420 276 315],311,4,12362,4.193351424694709,20.0,20.0
6948,1,2948,[315 244 478 509 221],474,5,12367,4.19362495761275,20.0,0.0
6949,1,2949,[315 244 478 509 221],474,5,12372,4.193898305084746,20.0,0.0
6950,1,2950,[216 300 507 264 223],666,0,12372,4.192477126397831,20.0,20.0
6951,1,2951,[213 478 275 206 481],406,1,12373,4.19139566395664,0.0,20.0
6952,1,2952,[291 295 230 255 239],533,2,12375,4.190653572637995,0.0,0.0
6953,1,2953,[250 211 481 246 216],85,3,12378,4.190250507786053,0.0,20.0
6954,1,2954,[315 244 478 509 221],474,5,12383,4.190524534686971,20.0,0.0
6955,1,2955,[315 244 478 509 221],474,5,12388,4.190798376184032,20.0,0.0
6956,1,2956,[315 244 478 509 221],474,5,12393,4.191072032465336,20.0,0.0
6957,1,2957,[315 244 478 509 221],474,5,12398,4.191345503718729,20.0,0.0
6958,1,2958,[315 244 478 509 221],474,5,12403,4.191618790131801,20.0,0.0
6959,1,2959,[315 244 478 509 221],474,5,12408,4.191891891891892,20.0,0.0
6960,1,2960,[315 244 478 509 221],474,5,12413,4.192164809186086,20.0,0.0
6961,1,2961,[315 244 478 509 221],474,5,12418,4.1924375422012155,20.0,0.0
6962,1,2962,[315 244 478 509 221],474,5,12423,4.192710091123861,20.0,0.0
6963,1,2963,[315 244 478 509 221],474,5,12428,4.192982456140351,20.0,0.0
6964,1,2964,[315 244 478 509 221],474,5,12433,4.1932546374367625,20.0,0.0
6965,1,2965,[272 212 429 275 215],13,4,12437,4.193189480782198,0.0,20.0
6966,1,2966,[384 507 272 261 303],13,2,12439,4.1924502864846644,0.0,0.0
6967,1,2967,[298 223 250 227 222],749,3,12442,4.192048517520216,20.0,20.0
6968,1,2968,[321 350 336 367 209],13,0,12442,4.1906365779723815,0.0,0.0
6969,1,2969,[315 244 478 509 221],474,5,12447,4.1909090909090905,20.0,0.0
6970,1,2970,[315 244 478 509 221],474,5,12452,4.1911814203971725,20.0,0.0
6971,1,2971,[202 227 276 283 226],533,3,12455,4.19078061911171,0.0,20.0
6972,1,2972,[392 222 276 275 255],378,3,12458,4.19038008745375,0.0,60.0
6973,1,2973,[315 244 478 509 221],474,5,12463,4.190652320107599,20.0,0.0
6974,1,2974,[259 211 222 283 239],537,2,12465,4.189915966386555,0.0,40.0
6975,1,2975,[315 244 478 509 221],474,5,12470,4.190188172043011,20.0,0.0
6976,1,2976,[315 244 478 509 221],474,5,12475,4.190460194827007,20.0,0.0
6977,1,2977,[315 244 478 509 221],474,5,12480,4.190732034922767,20.0,0.0
6978,1,2978,[315 244 478 509 221],474,5,12485,4.191003692514267,20.0,0.0
6979,1,2979,[315 244 478 509 221],474,5,12490,4.191275167785235,20.0,0.0
6980,1,2980,[315 244 478 509 221],474,5,12495,4.191546460919155,20.0,0.0
6981,1,2981,[315 244 478 509 221],474,5,12500,4.1918175720992625,20.0,0.0
6982,1,2982,[315 244 478 509 221],474,5,12505,4.1920885015085485,20.0,0.0
6983,1,2983,[211 226 202 384 213],934,5,12510,4.192359249329758,0.0,20.0
6984,1,2984,[315 244 478 509 221],474,5,12515,4.192629815745394,20.0,0.0
6985,1,2985,[315 244 478 509 221],474,5,12520,4.192900200937709,20.0,0.0
6986,1,2986,[315 244 478 509 221],474,5,12525,4.1931704050887175,20.0,0.0
6987,1,2987,[227 290 509 215 413],13,4,12529,4.193105756358769,0.0,0.0
6988,1,2988,[315 244 478 509 221],474,5,12534,4.1933757109401135,20.0,0.0
6989,1,2989,[315 244 478 509 221],474,5,12539,4.193645484949832,20.0,0.0
6990,1,2990,[315 244 478 509 221],474,5,12544,4.193915078569041,20.0,0.0
6991,1,2991,[315 244 478 509 221],474,5,12549,4.19418449197861,20.0,0.0
6992,1,2992,[315 244 478 509 221],474,5,12554,4.194453725359171,20.0,0.0
6993,1,2993,[315 244 478 509 221],474,5,12559,4.194722778891116,20.0,0.0
6994,1,2994,[315 244 478 509 221],474,5,12564,4.194991652754591,20.0,0.0
6995,1,2995,[315 244 478 509 221],474,5,12569,4.195260347129506,20.0,0.0
6996,1,2996,[315 244 478 509 221],474,5,12574,4.195528862195529,20.0,0.0
6997,1,2997,[315 244 478 509 221],474,5,12579,4.195797198132088,20.0,0.0
6998,1,2998,[315 244 478 509 221],474,5,12584,4.196065355118373,20.0,0.0
6999,1,2999,[315 244 478 509 221],474,5,12589,4.1963333333333335,20.0,0.0
7000,1,3000,[315 244 478 509 221],474,5,12594,4.196601132955681,20.0,0.0
7001,1,3001,[315 244 478 509 221],474,5,12599,4.196868754163891,20.0,0.0
7002,1,3002,[315 244 478 509 221],474,5,12604,4.197136197136198,20.0,0.0
7003,1,3003,[202 231 208 365 230],200,5,12609,4.197403462050599,0.0,0.0
7004,1,3004,[315 244 478 509 221],474,5,12614,4.197670549084859,20.0,0.0
7005,1,3005,[243 211 508 384 202],125,1,12615,4.196606786427146,0.0,20.0
7006,1,3006,[315 244 478 509 221],474,5,12620,4.19687396075823,20.0,0.0
7007,1,3007,[315 244 478 509 221],474,5,12625,4.197140957446808,20.0,0.0
7008,1,3008,[283 226 241 212 299],537,1,12626,4.196078431372549,0.0,0.0
7009,1,3009,[315 244 478 509 221],474,5,12631,4.196345514950166,20.0,0.0
7010,1,3010,[315 244 478 509 221],474,5,12636,4.196612421122551,20.0,0.0
7011,1,3011,[284 259 221 301 485],234,0,12636,4.195219123505976,0.0,0.0
7012,1,3012,[315 244 478 509 221],474,5,12641,4.195486226352473,20.0,0.0
7013,1,3013,[315 244 478 509 221],474,5,12646,4.195753151957532,20.0,0.0
7014,1,3014,[315 244 478 509 221],474,5,12651,4.196019900497513,20.0,0.0
7015,1,3015,[315 244 478 509 221],474,5,12656,4.196286472148541,20.0,0.0
7016,1,3016,[315 244 478 509 221],474,5,12661,4.19655286708651,20.0,0.0
7017,1,3017,[315 244 478 509 221],474,5,12666,4.1968190854870775,20.0,0.0
7018,1,3018,[315 244 478 509 221],474,5,12671,4.19708512752567,20.0,0.0
7019,1,3019,[315 244 478 509 221],474,5,12676,4.1973509933774835,20.0,0.0
7020,1,3020,[291 264 241 283 365],308,1,12677,4.1962926183382985,0.0,0.0
7021,1,3021,[315 244 478 509 221],474,5,12682,4.196558570483123,20.0,0.0
7022,1,3022,[315 244 478 509 221],474,5,12687,4.196824346675488,20.0,0.0
7023,1,3023,[315 244 478 509 221],474,5,12692,4.197089947089947,20.0,0.0
7024,1,3024,[202 209 291 208 227],804,4,12696,4.1970247933884295,0.0,0.0
7025,1,3025,[315 244 478 509 221],474,5,12701,4.197290152015863,20.0,0.0
7026,1,3026,[452 481 303 232 275],13,1,12702,4.1962338949454905,0.0,20.0
7027,1,3027,[315 244 478 509 221],474,5,12707,4.196499339498018,20.0,0.0
7028,1,3028,[290 429 321 208 222],537,1,12708,4.195444040937603,0.0,20.0
7029,1,3029,[315 244 478 509 221],474,5,12713,4.195709570957096,20.0,0.0
7030,1,3030,[315 244 478 509 221],474,5,12718,4.195974925767073,20.0,0.0
7031,1,3031,[315 244 478 509 221],474,5,12723,4.196240105540897,20.0,0.0
7032,1,3032,[315 244 478 509 221],474,5,12728,4.196505110451698,20.0,0.0
7033,1,3033,[315 244 478 509 221],474,5,12733,4.19676994067238,20.0,0.0
7034,1,3034,[315 244 478 509 221],474,5,12738,4.197034596375618,20.0,0.0
7035,1,3035,[315 244 478 509 221],474,5,12743,4.19729907773386,20.0,0.0
7036,1,3036,[315 244 478 509 221],474,5,12748,4.197563384919328,20.0,0.0
7037,1,3037,[315 244 478 509 221],474,5,12753,4.197827518104016,20.0,0.0
7038,1,3038,[315 244 478 509 221],474,5,12758,4.19809147745969,20.0,0.0
7039,1,3039,[315 244 478 509 221],474,5,12763,4.198355263157895,20.0,0.0
7040,1,3040,[240 216 230 218 420],64,2,12765,4.197632357777047,0.0,0.0
7041,1,3041,[315 244 478 509 221],474,5,12770,4.197896120973044,20.0,0.0
7042,1,3042,[315 244 478 509 221],474,5,12775,4.198159710811699,20.0,0.0
7043,1,3043,[315 244 478 509 221],474,5,12780,4.1984231274638635,20.0,0.0
7044,1,3044,[315 244 478 509 221],474,5,12785,4.198686371100164,20.0,0.0
7045,1,3045,[315 244 478 509 221],474,5,12790,4.1989494418910045,20.0,0.0
7046,1,3046,[507 211 452 509 583],7,4,12794,4.198884148342632,0.0,20.0
7047,1,3047,[315 244 478 509 221],474,5,12799,4.199146981627297,20.0,0.0
7048,1,3048,[315 244 478 509 221],474,5,12804,4.1994096425057394,20.0,0.0
7049,1,3049,[315 244 478 509 221],474,5,12809,4.199672131147541,20.0,0.0
7050,1,3050,[315 244 478 509 221],474,5,12814,4.199934447722058,20.0,0.0
7051,1,3051,[315 244 478 509 221],474,5,12819,4.200196592398427,20.0,0.0
7052,1,3052,[291 201 367 392 583],308,4,12823,4.20013101867016,0.0,0.0
7053,1,3053,[315 244 478 509 221],474,5,12828,4.200392927308448,20.0,0.0
7054,1,3054,[290 209 222 254 367],279,2,12830,4.199672667757774,0.0,20.0
7055,1,3055,[315 244 478 509 221],474,5,12835,4.199934554973822,20.0,0.0
7056,1,3056,[315 244 478 509 221],474,5,12840,4.200196270853779,20.0,0.0
7057,1,3057,[301 303 268 236 280],486,2,12842,4.199476782210595,0.0,0.0
7058,1,3058,[315 244 478 509 221],474,5,12847,4.199738476626348,20.0,0.0
7059,1,3059,[315 244 478 509 221],474,5,12852,4.2,20.0,0.0
7060,1,3060,[315 244 478 509 221],474,5,12857,4.200261352499183,20.0,0.0
7061,1,3061,[301 300 239 222 367],13,1,12858,4.199216198563031,0.0,40.0
7062,1,3062,[315 244 478 509 221],474,5,12863,4.199477636304277,20.0,0.0
7063,1,3063,[315 244 478 509 221],474,5,12868,4.199738903394256,20.0,0.0
7064,1,3064,[315 244 478 509 221],474,5,12873,4.2,20.0,0.0
7065,1,3065,[315 244 478 509 221],474,5,12878,4.2002609262883235,20.0,0.0
7066,1,3066,[230 216 217 303 485],334,2,12880,4.199543527877404,0.0,0.0
7067,1,3067,[315 244 478 509 221],474,5,12885,4.19980443285528,20.0,0.0
7068,1,3068,[315 244 478 509 221],474,5,12890,4.200065167807104,20.0,0.0
7069,1,3069,[315 244 478 509 221],474,5,12895,4.200325732899023,20.0,0.0
7070,1,3070,[315 244 478 509 221],474,5,12900,4.200586128296972,20.0,0.0
7071,1,3071,[315 244 478 509 221],474,5,12905,4.200846354166667,20.0,0.0
7072,1,3072,[315 244 478 509 221],474,5,12910,4.201106410673609,20.0,0.0
7073,1,3073,[315 244 478 509 221],474,5,12915,4.201366297983084,20.0,0.0
7074,1,3074,[315 244 478 509 221],474,5,12920,4.201626016260162,20.0,0.0
7075,1,3075,[315 244 478 509 221],474,5,12925,4.201885565669701,20.0,0.0
7076,1,3076,[315 244 478 509 221],474,5,12930,4.2021449463763405,20.0,0.0
7077,1,3077,[315 244 478 509 221],474,5,12935,4.2024041585445095,20.0,0.0
7078,1,3078,[315 244 478 509 221],474,5,12940,4.202663202338422,20.0,0.0
7079,1,3079,[315 244 478 509 221],474,5,12945,4.202922077922078,20.0,0.0
7080,1,3080,[509 212 211 481 298],85,4,12949,4.202856215514443,0.0,20.0
7081,1,3081,[394 290 367 275 507],13,1,12950,4.201817001946788,0.0,20.0
7082,1,3082,[315 244 478 509 221],474,5,12955,4.202075900097308,20.0,0.0
7083,1,3083,[485 222 284 223 213],194,1,12956,4.2010376134889755,20.0,20.0
7084,1,3084,[485 321 209 290 211],59,3,12959,4.20064829821718,0.0,20.0
7085,1,3085,[221 478 212 215 222],524,2,12961,4.199935191186001,0.0,20.0
7086,1,3086,[315 244 478 509 221],474,5,12966,4.200194363459669,20.0,0.0
7087,1,3087,[507 209 213 298 378],85,5,12971,4.200453367875648,0.0,0.0
7088,1,3088,[315 244 478 509 221],474,5,12976,4.200712204596957,20.0,0.0
7089,1,3089,[315 244 478 509 221],474,5,12981,4.2009708737864075,20.0,0.0
7090,1,3090,[244 508 221 250 485],334,1,12982,4.199935296020706,0.0,0.0
7091,1,3091,[315 244 478 509 221],474,5,12987,4.20019404915912,20.0,0.0
7092,1,3092,[429 222 223 215 259],234,1,12988,4.199159392175881,20.0,20.0
7093,1,3093,[216 226 276 241 321],378,3,12991,4.198771816418875,0.0,20.0
7094,1,3094,[315 244 478 509 221],474,5,12996,4.199030694668821,20.0,0.0
7095,1,3095,[315 244 478 509 221],474,5,13001,4.1992894056847545,20.0,0.0
7096,1,3096,[315 244 478 509 221],474,5,13006,4.1995479496286725,20.0,0.0
7097,1,3097,[226 208 429 201 220],59,4,13010,4.199483537766301,0.0,0.0
7098,1,3098,[420 241 283 220 213],378,4,13014,4.199419167473378,0.0,0.0
7099,1,3099,[316 331 394 276 275],13,2,13016,4.198709677419354,20.0,40.0
7100,1,3100,[315 244 478 509 221],474,5,13021,4.198968074814576,20.0,0.0
7101,1,3101,[315 244 478 509 221],474,5,13026,4.199226305609284,20.0,0.0
7102,1,3102,[315 244 478 509 221],474,5,13031,4.1994843699645505,20.0,0.0
7103,1,3103,[315 244 478 509 221],474,5,13036,4.199742268041237,20.0,0.0
7104,1,3104,[315 244 478 509 221],474,5,13041,4.2,20.0,0.0
7105,1,3105,[315 244 478 509 221],474,5,13046,4.200257566001288,20.0,0.0
7106,1,3106,[315 244 478 509 221],474,5,13051,4.2005149662053425,20.0,0.0
7107,1,3107,[315 244 478 509 221],474,5,13056,4.2007722007722,20.0,0.0
7108,1,3108,[283 392 213 211 208],308,4,13060,4.200707623029913,0.0,20.0
7109,1,3109,[315 244 478 509 221],474,5,13065,4.20096463022508,20.0,0.0
7110,1,3110,[315 244 478 509 221],474,5,13070,4.201221472195436,20.0,0.0
7111,1,3111,[478 276 268 202 293],6,1,13071,4.200192802056555,0.0,20.0
7112,1,3112,[315 244 478 509 221],474,5,13076,4.2004497269514935,20.0,0.0
7113,1,3113,[315 244 478 509 221],474,5,13081,4.2007064868336546,20.0,0.0
7114,1,3114,[315 244 478 509 221],474,5,13086,4.200963081861958,20.0,0.0
7115,1,3115,[315 244 478 509 221],474,5,13091,4.201219512195122,20.0,0.0
7116,1,3116,[315 244 478 509 221],474,5,13096,4.201475777991659,20.0,0.0
7117,1,3117,[315 244 478 509 221],474,5,13101,4.201731879409878,20.0,0.0
7118,1,3118,[315 244 478 509 221],474,5,13106,4.201987816607887,20.0,0.0
7119,1,3119,[315 244 478 509 221],474,5,13111,4.20224358974359,20.0,0.0
7120,1,3120,[315 244 478 509 221],474,5,13116,4.202499198974688,20.0,0.0
7121,1,3121,[315 244 478 509 221],474,5,13121,4.202754644458681,20.0,0.0
7122,1,3122,[315 244 478 509 221],474,5,13126,4.203009926352866,20.0,0.0
7123,1,3123,[223 222 284 280 227],374,3,13129,4.2026248399487836,20.0,20.0
7124,1,3124,[315 244 478 509 221],474,5,13134,4.20288,20.0,0.0
7125,1,3125,[315 244 478 509 221],474,5,13139,4.203134996801023,20.0,0.0
7126,1,3126,[230 268 221 226 222],537,1,13140,4.2021106491845215,0.0,20.0
7127,1,3127,[315 244 478 509 221],474,5,13145,4.202365728900256,20.0,0.0
7128,1,3128,[315 244 478 509 221],474,5,13150,4.202620645573666,20.0,0.0
7129,1,3129,[315 244 478 509 221],474,5,13155,4.202875399361022,20.0,0.0
7130,1,3130,[315 244 478 509 221],474,5,13160,4.203129990418397,20.0,0.0
7131,1,3131,[272 315 509 508 413],13,3,13163,4.202745849297574,20.0,0.0
7132,1,3132,[209 226 218 268 219],234,1,13164,4.201723587615704,0.0,0.0
7133,1,3133,[232 216 394 212 230],13,1,13165,4.200701978302489,0.0,0.0
7134,1,3134,[315 244 478 509 221],474,5,13170,4.2009569377990434,20.0,0.0
7135,1,3135,[315 244 478 509 221],474,5,13175,4.201211734693878,20.0,0.0
7136,1,3136,[315 244 478 509 221],474,5,13180,4.2014663691424925,20.0,0.0
7137,1,3137,[315 244 478 509 221],474,5,13185,4.201720841300191,20.0,0.0
7138,1,3138,[315 244 478 509 221],474,5,13190,4.201975151322077,20.0,0.0
7139,1,3139,[240 291 230 208 226],804,5,13195,4.202229299363057,0.0,0.0
7140,1,3140,[315 244 478 509 221],474,5,13200,4.202483285577841,20.0,0.0
7141,1,3141,[227 215 250 241 431],387,2,13202,4.2017823042648,0.0,0.0
7142,1,3142,[315 244 478 509 221],474,5,13207,4.202036271078588,20.0,0.0
7143,1,3143,[315 244 478 509 221],474,5,13212,4.202290076335878,20.0,0.0
7144,1,3144,[231 299 315 326 276],13,2,13214,4.201589825119237,20.0,20.0
7145,1,3145,[315 244 478 509 221],474,5,13219,4.20184361093452,20.0,0.0
7146,1,3146,[222 481 367 208 211],194,1,13220,4.200826183666984,0.0,40.0
7147,1,3147,[239 284 209 301 429],524,2,13222,4.200127064803049,0.0,0.0
7148,1,3148,[315 244 478 509 221],474,5,13227,4.200381073356621,20.0,0.0
7149,1,3149,[315 244 478 509 221],474,5,13232,4.20063492063492,20.0,0.0
7150,1,3150,[315 244 478 509 221],474,5,13237,4.200888606791494,20.0,0.0
7151,1,3151,[283 275 208 315 481],474,2,13239,4.2001903553299496,20.0,20.0
7152,1,3152,[299 315 429 218 280],13,3,13242,4.199809705042816,20.0,0.0
7153,1,3153,[315 244 478 509 221],474,5,13247,4.2000634115409,20.0,0.0
7154,1,3154,[315 244 478 509 221],474,5,13252,4.200316957210776,20.0,0.0
7155,1,3155,[315 244 478 509 221],474,5,13257,4.2005703422053235,20.0,0.0
7156,1,3156,[315 244 478 509 221],474,5,13262,4.200823566677225,20.0,0.0
7157,1,3157,[216 261 208 336 413],13,1,13263,4.199810006333122,0.0,0.0
7158,1,3158,[315 244 478 509 221],474,5,13268,4.200063311174422,20.0,0.0
7159,1,3159,[222 295 208 280 202],749,3,13271,4.199683544303798,0.0,20.0
7160,1,3160,[315 244 478 509 221],474,5,13276,4.199936728883265,20.0,0.0
7161,1,3161,[315 244 478 509 221],474,5,13281,4.200189753320683,20.0,0.0
7162,1,3162,[315 244 478 509 221],474,5,13286,4.2004426177679415,20.0,0.0
7163,1,3163,[315 244 478 509 221],474,5,13291,4.200695322376738,20.0,0.0
7164,1,3164,[315 244 478 509 221],474,5,13296,4.200947867298578,20.0,0.0
7165,1,3165,[315 244 478 509 221],474,5,13301,4.201200252684775,20.0,0.0
7166,1,3166,[264 299 331 226 507],13,2,13303,4.200505209977897,0.0,0.0
7167,1,3167,[315 244 478 509 221],474,5,13308,4.200757575757576,20.0,0.0
7168,1,3168,[315 244 478 509 221],474,5,13313,4.201009782265699,20.0,0.0
7169,1,3169,[239 315 236 268 272],334,4,13317,4.2009463722397475,20.0,0.0
7170,1,3170,[246 485 231 324 250],334,2,13319,4.200252286345002,0.0,0.0
7171,1,3171,[315 244 478 509 221],474,5,13324,4.200504413619168,20.0,0.0
7172,1,3172,[218 201 280 315 429],13,3,13327,4.200126063662149,20.0,0.0
7173,1,3173,[232 316 223 222 226],328,2,13329,4.199432892249527,40.0,20.0
7174,1,3174,[315 244 478 509 221],474,5,13334,4.199685039370078,20.0,0.0
7175,1,3175,[299 392 485 222 290],537,0,13334,4.198362720403023,0.0,20.0
7176,1,3176,[315 244 478 509 221],474,5,13339,4.198615045640541,20.0,0.0
7177,1,3177,[261 239 413 429 485],13,2,13341,4.197923222152297,0.0,0.0
7178,1,3178,[315 244 478 509 221],474,5,13346,4.19817552689525,20.0,0.0
7179,1,3179,[208 218 283 303 276],533,2,13348,4.1974842767295595,0.0,20.0
7180,1,3180,[315 244 478 509 221],474,5,13353,4.197736560829927,20.0,0.0
7181,1,3181,[315 244 478 509 221],474,5,13358,4.197988686360779,20.0,0.0
7182,1,3182,[315 244 478 509 221],474,5,13363,4.198240653471568,20.0,0.0
7183,1,3183,[315 244 478 509 221],474,5,13368,4.198492462311558,20.0,0.0
7184,1,3184,[315 244 478 509 221],474,5,13373,4.198744113029828,20.0,0.0
7185,1,3185,[293 276 246 219 236],145,3,13376,4.198367859384809,0.0,20.0
7186,1,3186,[315 244 478 509 221],474,5,13381,4.198619391277063,20.0,0.0
7187,1,3187,[315 244 478 509 221],474,5,13386,4.198870765370138,20.0,0.0
7188,1,3188,[315 244 478 509 221],474,5,13391,4.19912198181248,20.0,0.0
7189,1,3189,[315 244 478 509 221],474,5,13396,4.199373040752351,20.0,0.0
7190,1,3190,[315 244 478 509 221],474,5,13401,4.199623942337825,20.0,0.0
7191,1,3191,[315 244 478 509 221],474,5,13406,4.199874686716792,20.0,0.0
7192,1,3192,[315 244 478 509 221],474,5,13411,4.200125274036956,20.0,0.0
7193,1,3193,[315 244 478 509 221],474,5,13416,4.200375704445836,20.0,0.0
7194,1,3194,[315 244 478 509 221],474,5,13421,4.200625978090767,20.0,0.0
7195,1,3195,[315 244 478 509 221],474,5,13426,4.200876095118899,20.0,0.0
7196,1,3196,[209 222 239 485 227],524,1,13427,4.199874882702534,0.0,20.0
7197,1,3197,[315 244 478 509 221],474,5,13432,4.200125078173858,20.0,0.0
7198,1,3198,[293 211 255 215 213],308,4,13436,4.200062519537355,0.0,20.0
7199,1,3199,[223 215 290 452 206],650,1,13437,4.1990625,20.0,0.0
7200,1,3200,[315 244 478 509 221],474,5,13442,4.1993127147766325,20.0,0.0
7201,1,3201,[350 217 230 218 344],13,0,13442,4.198001249219238,0.0,0.0
7202,1,3202,[315 244 478 509 221],474,5,13447,4.198251639088355,20.0,0.0
7203,1,3203,[315 244 478 509 221],474,5,13452,4.198501872659176,20.0,0.0
7204,1,3204,[231 481 315 221 255],334,3,13455,4.198127925117005,20.0,0.0
7205,1,3205,[209 241 264 223 226],13,3,13458,4.197754210854647,20.0,0.0
7206,1,3206,[218 215 231 227 209],311,4,13462,4.197692547552229,0.0,0.0
7207,1,3207,[326 394 231 508 218],13,0,13462,4.196384039900249,0.0,0.0
7208,1,3208,[315 244 478 509 221],474,5,13467,4.196634465565597,20.0,0.0
7209,1,3209,[209 264 283 215 213],479,3,13470,4.196261682242991,0.0,0.0
7210,1,3210,[315 244 478 509 221],474,5,13475,4.196511990034257,20.0,0.0
7211,1,3211,[201 301 300 222 212],13,1,13476,4.1955168119551685,0.0,40.0
7212,1,3212,[315 244 478 509 221],474,5,13481,4.195767195767195,20.0,0.0
7213,1,3213,[481 209 283 478 291],474,4,13485,4.195706285003111,0.0,0.0
7214,1,3214,[315 244 478 509 221],474,5,13490,4.195956454121307,20.0,0.0
7215,1,3215,[315 244 478 509 221],474,5,13495,4.196206467661692,20.0,0.0
7216,1,3216,[315 244 478 509 221],474,5,13500,4.196456325769351,20.0,0.0
7217,1,3217,[315 244 478 509 221],474,5,13505,4.196706028589186,20.0,0.0
7218,1,3218,[211 291 275 478 255],474,4,13509,4.196644920782852,0.0,40.0
7219,1,3219,[315 244 478 509 221],474,5,13514,4.196894409937888,20.0,0.0
7220,1,3220,[315 244 478 509 221],474,5,13519,4.197143744178827,20.0,0.0
7221,1,3221,[254 315 295 218 300],548,3,13522,4.196772191185599,20.0,20.0
7222,1,3222,[315 244 478 509 221],474,5,13527,4.197021408625504,20.0,0.0
7223,1,3223,[315 244 478 509 221],474,5,13532,4.197270471464019,20.0,0.0
7224,1,3224,[315 244 478 509 221],474,5,13537,4.1975193798449615,20.0,0.0
7225,1,3225,[240 218 217 227 209],92,2,13539,4.196838189708617,0.0,0.0
7226,1,3226,[315 244 478 509 221],474,5,13544,4.197087077781221,20.0,0.0
7227,1,3227,[315 244 478 509 221],474,5,13549,4.197335811648079,20.0,0.0
7228,1,3228,[315 244 478 509 221],474,5,13554,4.197584391452462,20.0,0.0
7229,1,3229,[315 244 478 509 221],474,5,13559,4.197832817337462,20.0,0.0
7230,1,3230,[315 244 478 509 221],474,5,13564,4.198081089445992,20.0,0.0
7231,1,3231,[315 244 478 509 221],474,5,13569,4.198329207920792,20.0,0.0
7232,1,3232,[275 481 259 218 298],308,4,13573,4.198267862666254,0.0,20.0
7233,1,3233,[315 244 478 509 221],474,5,13578,4.198515769944342,20.0,0.0
7234,1,3234,[315 244 478 509 221],474,5,13583,4.198763523956723,20.0,0.0
7235,1,3235,[336 303 324 284 331],894,2,13585,4.198084054388134,0.0,0.0
7236,1,3236,[315 244 478 509 221],474,5,13590,4.198331788693235,20.0,0.0
7237,1,3237,[240 485 321 209 202],59,3,13593,4.197961704756022,0.0,0.0
7238,1,3238,[315 244 478 509 221],474,5,13598,4.198209323865391,20.0,0.0
7239,1,3239,[315 244 478 509 221],474,5,13603,4.198456790123457,20.0,0.0
7240,1,3240,[315 244 478 509 221],474,5,13608,4.198704103671706,20.0,0.0
7241,1,3241,[315 244 478 509 221],474,5,13613,4.198951264651449,20.0,0.0
7242,1,3242,[509 240 367 275 384],279,2,13615,4.19827320382362,0.0,20.0
7243,1,3243,[232 217 226 231 298],387,0,13615,4.1969790382244145,0.0,0.0
7244,1,3244,[315 244 478 509 221],474,5,13620,4.197226502311248,20.0,0.0
7245,1,3245,[315 244 478 509 221],474,5,13625,4.19747381392483,20.0,0.0
7246,1,3246,[350 420 336 394 222],13,1,13626,4.196489066830921,0.0,20.0
7247,1,3247,[315 244 478 509 221],474,5,13631,4.196736453201971,20.0,0.0
7248,1,3248,[315 244 478 509 221],474,5,13636,4.196983687288396,20.0,0.0
7249,1,3249,[315 244 478 509 221],474,5,13641,4.197230769230769,20.0,0.0
7250,1,3250,[507 280 321 431 208],13,2,13643,4.196554906182713,0.0,0.0
7251,1,3251,[315 244 478 509 221],474,5,13648,4.19680196801968,20.0,0.0
7252,1,3252,[315 244 478 509 221],474,5,13653,4.1970488779588075,20.0,0.0
7253,1,3253,[315 244 478 509 221],474,5,13658,4.197295636140135,20.0,0.0
7254,1,3254,[315 244 478 509 221],474,5,13663,4.197542242703533,20.0,0.0
7255,1,3255,[315 244 478 509 221],474,5,13668,4.197788697788698,20.0,0.0
7256,1,3256,[315 244 478 509 221],474,5,13673,4.198035001535155,20.0,0.0
7257,1,3257,[315 244 478 509 221],474,5,13678,4.198281154082259,20.0,0.0
7258,1,3258,[315 244 478 509 221],474,5,13683,4.198527155569193,20.0,0.0
7259,1,3259,[315 244 478 509 221],474,5,13688,4.198773006134969,20.0,0.0
7260,1,3260,[315 244 478 509 221],474,5,13693,4.19901870591843,20.0,0.0
7261,1,3261,[315 244 478 509 221],474,5,13698,4.199264255058247,20.0,0.0
7262,1,3262,[315 244 478 509 221],474,5,13703,4.199509653692921,20.0,0.0
7263,1,3263,[315 244 478 509 221],474,5,13708,4.199754901960785,20.0,0.0
7264,1,3264,[208 211 315 212 378],650,2,13710,4.199081163859112,20.0,20.0
7265,1,3265,[315 244 478 509 221],474,5,13715,4.199326393141457,20.0,0.0
7266,1,3266,[508 220 429 241 215],59,4,13719,4.1992653810835625,0.0,0.0
7267,1,3267,[315 244 478 509 221],474,5,13724,4.1995104039167686,20.0,0.0
7268,1,3268,[316 481 222 243 301],13,1,13725,4.198531661058428,20.0,20.0
7269,1,3269,[507 259 275 231 315],537,3,13728,4.198165137614679,20.0,20.0
7270,1,3270,[344 509 209 201 264],13,2,13730,4.197493121369612,0.0,0.0
7271,1,3271,[315 244 478 509 221],474,5,13735,4.197738386308068,20.0,0.0
7272,1,3272,[315 244 478 509 221],474,5,13740,4.197983501374885,20.0,0.0
7273,1,3273,[452 216 276 485 350],13,1,13741,4.197006719609041,0.0,20.0
7274,1,3274,[315 244 478 509 221],474,5,13746,4.197251908396947,20.0,0.0
7275,1,3275,[315 244 478 509 221],474,5,13751,4.197496947496948,20.0,0.0
7276,1,3276,[315 244 478 509 221],474,5,13756,4.197741837046078,20.0,0.0
7277,1,3277,[315 244 478 509 221],474,5,13761,4.197986577181208,20.0,0.0
7278,1,3278,[315 244 478 509 221],474,5,13766,4.198231168039037,20.0,0.0
7279,1,3279,[315 244 478 509 221],474,5,13771,4.198475609756097,20.0,0.0
7280,1,3280,[315 244 478 509 221],474,5,13776,4.19871990246876,20.0,0.0
7281,1,3281,[315 244 478 509 221],474,5,13781,4.198964046313224,20.0,0.0
7282,1,3282,[315 244 478 509 221],474,5,13786,4.199208041425526,20.0,0.0
7283,1,3283,[394 264 215 227 212],13,4,13790,4.199147381242387,0.0,0.0
7284,1,3284,[240 275 250 413 384],648,3,13793,4.198782343987824,0.0,20.0
7285,1,3285,[230 478 508 316 216],13,2,13795,4.19811320754717,20.0,0.0
7286,1,3286,[315 244 478 509 221],474,5,13800,4.19835716458777,20.0,0.0
7287,1,3287,[315 244 478 509 221],474,5,13805,4.19860097323601,20.0,0.0
7288,1,3288,[315 244 478 509 221],474,5,13810,4.1988446336272425,20.0,0.0
7289,1,3289,[315 244 478 509 221],474,5,13815,4.199088145896656,20.0,0.0
7290,1,3290,[315 244 478 509 221],474,5,13820,4.1993315101792765,20.0,0.0
7291,1,3291,[268 220 215 222 219],92,4,13824,4.199270959902795,0.0,20.0
7292,1,3292,[315 244 478 509 221],474,5,13829,4.199514120862435,20.0,0.0
7293,1,3293,[315 244 478 509 221],474,5,13834,4.199757134183364,20.0,0.0
7294,1,3294,[226 219 431 218 485],59,4,13838,4.199696509863429,0.0,0.0
7295,1,3295,[315 244 478 509 221],474,5,13843,4.199939320388349,20.0,0.0
7296,1,3296,[315 244 478 509 221],474,5,13848,4.200181983621474,20.0,0.0
7297,1,3297,[315 244 478 509 221],474,5,13853,4.200424499696786,20.0,0.0
7298,1,3298,[315 244 478 509 221],474,5,13858,4.2006668687481055,20.0,0.0
7299,1,3299,[315 244 478 509 221],474,5,13863,4.200909090909091,20.0,0.0
7300,1,3300,[315 244 478 509 221],474,5,13868,4.201151166313238,20.0,0.0
7301,1,3301,[429 217 303 283 244],334,3,13871,4.200787401574803,0.0,0.0
7302,1,3302,[315 478 244 509 221],474,5,13876,4.201029367241901,20.0,0.0
7303,1,3303,[315 478 244 509 221],474,5,13881,4.201271186440678,20.0,0.0
7304,1,3304,[315 478 244 509 221],474,5,13886,4.201512859304085,20.0,0.0
7305,1,3305,[264 230 202 231 222],13,2,13888,4.200846944948578,0.0,20.0
7306,1,3306,[315 478 244 509 221],474,5,13893,4.201088599939522,20.0,0.0
7307,1,3307,[315 478 244 509 221],474,5,13898,4.201330108827086,20.0,0.0
7308,1,3308,[276 226 300 268 284],537,2,13900,4.200664853430039,0.0,40.0
7309,1,3309,[315 478 244 509 221],474,5,13905,4.2009063444108765,20.0,0.0
7310,1,3310,[315 478 244 509 221],474,5,13910,4.201147689519782,20.0,0.0
7311,1,3311,[315 478 244 509 221],474,5,13915,4.201388888888889,20.0,0.0
7312,1,3312,[315 478 244 509 221],474,5,13920,4.201629942650166,20.0,0.0
7313,1,3313,[429 291 227 222 452],648,2,13922,4.2009656004828,0.0,20.0
7314,1,3314,[218 202 219 240 378],833,4,13926,4.200904977375566,0.0,0.0
7315,1,3315,[431 392 291 276 213],537,3,13929,4.200542822677925,0.0,20.0
7316,1,3316,[315 478 244 509 221],474,5,13934,4.200783840820018,20.0,0.0
7317,1,3317,[315 478 244 509 221],474,5,13939,4.2010247136829415,20.0,0.0
7318,1,3318,[202 275 240 215 367],406,2,13941,4.200361554685146,0.0,20.0
7319,1,3319,[315 478 244 509 221],474,5,13946,4.200602409638554,20.0,0.0
7320,1,3320,[321 509 241 213 326],378,3,13949,4.200240891297802,0.0,0.0
7321,1,3321,[315 478 244 509 221],474,5,13954,4.20048163756773,20.0,0.0
7322,1,3322,[315 478 244 509 221],474,5,13959,4.200722238940716,20.0,0.0
7323,1,3323,[230 201 215 226 507],59,5,13964,4.200962695547533,0.0,0.0
7324,1,3324,[315 478 244 509 221],474,5,13969,4.201203007518797,20.0,0.0
7325,1,3325,[315 478 244 509 221],474,5,13974,4.201443174984967,20.0,0.0
7326,1,3326,[315 478 244 509 221],474,5,13979,4.201683198076345,20.0,0.0
7327,1,3327,[315 478 244 509 221],474,5,13984,4.201923076923077,20.0,0.0
7328,1,3328,[315 478 244 509 221],474,5,13989,4.2021628116551515,20.0,0.0
7329,1,3329,[315 478 244 509 221],474,5,13994,4.202402402402402,20.0,0.0
7330,1,3330,[216 583 226 212 217],92,1,13995,4.2014410087060945,0.0,0.0
7331,1,3331,[315 478 244 509 221],474,5,14000,4.201680672268908,20.0,0.0
7332,1,3332,[315 478 244 509 221],474,5,14005,4.201920192019202,20.0,0.0
7333,1,3333,[230 215 239 272 213],653,2,14007,4.20125974805039,0.0,0.0
7334,1,3334,[315 478 244 509 221],474,5,14012,4.2014992503748125,20.0,0.0
7335,1,3335,[218 429 276 221 226],234,1,14013,4.200539568345324,0.0,20.0
7336,1,3336,[284 211 230 293 315],474,4,14017,4.200479472580162,20.0,20.0
7337,1,3337,[290 236 246 268 213],334,4,14021,4.20041941282205,0.0,0.0
7338,1,3338,[230 293 202 378 283],308,3,14024,4.200059898173106,0.0,0.0
7339,1,3339,[315 478 244 509 221],474,5,14029,4.200299401197605,20.0,0.0
7340,1,3340,[315 222 336 219 508],13,1,14030,4.199341514516612,20.0,20.0
7341,1,3341,[219 239 485 216 284],194,0,14030,4.1980849790544585,0.0,0.0
7342,1,3342,[315 478 244 509 221],474,5,14035,4.198324857912055,20.0,0.0
7343,1,3343,[222 321 226 211 243],234,0,14035,4.197069377990431,0.0,40.0
7344,1,3344,[315 478 244 509 221],474,5,14040,4.197309417040358,20.0,0.0
7345,1,3345,[315 478 244 509 221],474,5,14045,4.197549312612074,20.0,0.0
7346,1,3346,[315 478 244 509 221],474,5,14050,4.19778906483418,20.0,0.0
7347,1,3347,[213 295 284 226 509],308,3,14053,4.197431302270012,0.0,0.0
7348,1,3348,[315 478 244 509 221],474,5,14058,4.197670946551209,20.0,0.0
7349,1,3349,[321 272 218 202 280],13,3,14061,4.197313432835821,0.0,0.0
7350,1,3350,[315 478 244 509 221],474,5,14066,4.197552969262906,20.0,0.0
7351,1,3351,[315 478 244 509 221],474,5,14071,4.197792362768497,20.0,0.0
7352,1,3352,[222 215 344 478 202],13,3,14074,4.197435132716969,0.0,20.0
7353,1,3353,[315 478 244 509 221],474,5,14079,4.1976744186046515,20.0,0.0
7354,1,3354,[315 478 244 509 221],474,5,14084,4.197913561847988,20.0,0.0
7355,1,3355,[452 231 350 303 316],13,2,14086,4.1972586412395705,20.0,0.0
7356,1,3356,[215 301 230 241 367],378,2,14088,4.196604110813226,0.0,0.0
7357,1,3357,[315 478 244 509 221],474,5,14093,4.196843359142346,20.0,0.0
7358,1,3358,[315 478 244 509 221],474,5,14098,4.197082465019351,20.0,0.0
7359,1,3359,[315 478 244 509 221],474,5,14103,4.197321428571429,20.0,0.0
7360,1,3360,[315 478 244 509 221],474,5,14108,4.197560249925617,20.0,0.0
7361,1,3361,[315 478 244 509 221],474,5,14113,4.197798929208805,20.0,0.0
7362,1,3362,[276 226 201 230 268],537,2,14115,4.197145405887601,0.0,20.0
7363,1,3363,[315 478 244 509 221],474,5,14120,4.197384066587396,20.0,0.0
7364,1,3364,[315 478 244 509 221],474,5,14125,4.197622585438336,20.0,0.0
7365,1,3365,[315 478 244 509 221],474,5,14130,4.197860962566845,20.0,0.0
7366,1,3366,[315 478 244 509 221],474,5,14135,4.198099198099198,20.0,0.0
7367,1,3367,[315 478 244 509 221],474,5,14140,4.19833729216152,20.0,0.0
7368,1,3368,[315 478 244 509 221],474,5,14145,4.198575244879787,20.0,0.0
7369,1,3369,[315 478 244 509 221],474,5,14150,4.198813056379822,20.0,0.0
7370,1,3370,[315 478 244 509 221],474,5,14155,4.199050726787304,20.0,0.0
7371,1,3371,[315 478 244 509 221],474,5,14160,4.199288256227758,20.0,0.0
7372,1,3372,[315 478 244 509 221],474,5,14165,4.199525644826564,20.0,0.0
7373,1,3373,[315 478 244 509 221],474,5,14170,4.199762892708951,20.0,0.0
7374,1,3374,[241 420 452 413 272],13,2,14172,4.199111111111111,0.0,0.0
7375,1,3375,[315 478 244 509 221],474,5,14177,4.199348341232228,20.0,0.0
7376,1,3376,[315 478 244 509 221],474,5,14182,4.199585430855789,20.0,0.0
7377,1,3377,[315 478 244 509 221],474,5,14187,4.199822380106572,20.0,0.0
7378,1,3378,[315 478 244 509 221],474,5,14192,4.200059189109204,20.0,0.0
7379,1,3379,[213 230 431 222 212],804,3,14195,4.199704142011834,0.0,20.0
7380,1,3380,[315 478 244 509 221],474,5,14200,4.199940845903579,20.0,0.0
7381,1,3381,[315 478 244 509 221],474,5,14205,4.200177409816677,20.0,0.0
7382,1,3382,[315 478 244 509 221],474,5,14210,4.200413833875259,20.0,0.0
7383,1,3383,[315 478 244 509 221],474,5,14215,4.20065011820331,20.0,0.0
7384,1,3384,[315 478 244 509 221],474,5,14220,4.2008862629246675,20.0,0.0
7385,1,3385,[315 478 244 509 221],474,5,14225,4.201122268163024,20.0,0.0
7386,1,3386,[315 478 244 509 221],474,5,14230,4.201358134041925,20.0,0.0
7387,1,3387,[315 478 244 509 221],474,5,14235,4.20159386068477,20.0,0.0
7388,1,3388,[315 478 244 509 221],474,5,14240,4.201829448214813,20.0,0.0
7389,1,3389,[315 478 244 509 221],474,5,14245,4.202064896755163,20.0,0.0
7390,1,3390,[315 478 244 509 221],474,5,14250,4.202300206428782,20.0,0.0
7391,1,3391,[315 478 244 509 221],474,5,14255,4.20253537735849,20.0,0.0
7392,1,3392,[216 367 326 303 321],13,1,14256,4.201591511936339,0.0,0.0
7393,1,3393,[315 478 244 509 221],474,5,14261,4.201826753093695,20.0,0.0
7394,1,3394,[301 218 583 284 508],524,3,14264,4.201472754050074,0.0,0.0
7395,1,3395,[315 478 244 509 221],474,5,14269,4.20170789163722,20.0,0.0
7396,1,3396,[315 478 244 509 221],474,5,14274,4.201942890785988,20.0,0.0
7397,1,3397,[509 316 231 217 485],650,0,14274,4.200706297822248,20.0,0.0
7398,1,3398,[315 478 244 509 221],474,5,14279,4.200941453368638,20.0,0.0
7399,1,3399,[315 478 244 509 221],474,5,14284,4.201176470588235,20.0,0.0
7400,1,3400,[315 478 244 509 221],474,5,14289,4.201411349603058,20.0,0.0
7401,1,3401,[315 478 244 509 221],474,5,14294,4.20164609053498,20.0,0.0
7402,1,3402,[315 478 244 509 221],474,5,14299,4.20188069350573,20.0,0.0
7403,1,3403,[315 478 244 509 221],474,5,14304,4.202115158636897,20.0,0.0
7404,1,3404,[315 478 244 509 221],474,5,14309,4.202349486049926,20.0,0.0
7405,1,3405,[315 478 244 509 221],474,5,14314,4.202583675866118,20.0,0.0
7406,1,3406,[315 478 244 509 221],474,5,14319,4.202817728206633,20.0,0.0
7407,1,3407,[315 478 244 509 221],474,5,14324,4.203051643192488,20.0,0.0
7408,1,3408,[315 478 244 509 221],474,5,14329,4.2032854209445585,20.0,0.0
7409,1,3409,[315 478 244 509 221],474,5,14334,4.203519061583577,20.0,0.0
7410,1,3410,[315 478 244 509 221],474,5,14339,4.203752565230138,20.0,0.0
7411,1,3411,[315 478 244 509 221],474,5,14344,4.20398593200469,20.0,0.0
7412,1,3412,[336 344 213 331 324],894,3,14347,4.203633167301494,0.0,0.0
7413,1,3413,[315 478 244 509 221],474,5,14352,4.203866432337434,20.0,0.0
7414,1,3414,[315 478 244 509 221],474,5,14357,4.204099560761347,20.0,0.0
7415,1,3415,[315 478 244 509 221],474,5,14362,4.2043325526932085,20.0,0.0
7416,1,3416,[315 478 244 509 221],474,5,14367,4.204565408252853,20.0,0.0
7417,1,3417,[315 478 244 509 221],474,5,14372,4.204798127559976,20.0,0.0
7418,1,3418,[315 478 244 509 221],474,5,14377,4.205030710734133,20.0,0.0
7419,1,3419,[315 478 244 509 221],474,5,14382,4.205263157894737,20.0,0.0
7420,1,3420,[315 478 244 509 221],474,5,14387,4.205495469161064,20.0,0.0
7421,1,3421,[315 478 244 509 221],474,5,14392,4.20572764465225,20.0,0.0
7422,1,3422,[315 478 244 509 221],474,5,14397,4.205959684487292,20.0,0.0
7423,1,3423,[315 478 244 509 221],474,5,14402,4.206191588785047,20.0,0.0
7424,1,3424,[315 478 244 509 221],474,5,14407,4.206423357664233,20.0,0.0
7425,1,3425,[315 478 244 509 221],474,5,14412,4.206654991243433,20.0,0.0
7426,1,3426,[315 478 244 509 221],474,5,14417,4.206886489641086,20.0,0.0
7427,1,3427,[218 507 219 301 243],13,0,14417,4.205659276546091,0.0,0.0
7428,1,3428,[215 243 264 316 232],13,3,14420,4.205307669874599,20.0,0.0
7429,1,3429,[315 478 244 509 221],474,5,14425,4.205539358600583,20.0,0.0
7430,1,3430,[315 213 239 221 212],537,2,14427,4.204896531623433,20.0,0.0
7431,1,3431,[315 478 244 509 221],474,5,14432,4.205128205128205,20.0,0.0
7432,1,3432,[226 202 299 301 276],537,1,14433,4.2041945819982525,0.0,20.0
7433,1,3433,[315 478 244 509 221],474,5,14438,4.20442632498544,20.0,0.0
7434,1,3434,[315 478 244 509 221],474,5,14443,4.2046579330422125,20.0,0.0
7435,1,3435,[315 478 244 509 221],474,5,14448,4.204889406286379,20.0,0.0
7436,1,3436,[315 478 244 509 221],474,5,14453,4.205120744835613,20.0,0.0
7437,1,3437,[315 478 244 509 221],474,5,14458,4.205351948807446,20.0,0.0
7438,1,3438,[315 478 244 509 221],474,5,14463,4.205583018319279,20.0,0.0
7439,1,3439,[315 478 244 509 221],474,5,14468,4.205813953488372,20.0,0.0
7440,1,3440,[315 478 244 509 221],474,5,14473,4.2060447544318516,20.0,0.0
7441,1,3441,[315 478 244 509 221],474,5,14478,4.206275421266706,20.0,0.0
7442,1,3442,[315 478 244 509 221],474,5,14483,4.206505954109788,20.0,0.0
7443,1,3443,[254 367 201 485 219],308,2,14485,4.205865272938444,0.0,0.0
7444,1,3444,[315 478 244 509 221],474,5,14490,4.206095791001451,20.0,0.0
7445,1,3445,[222 431 209 284 232],194,1,14491,4.2051654091700525,0.0,20.0
7446,1,3446,[315 478 244 509 221],474,5,14496,4.205395996518712,20.0,0.0
7447,1,3447,[315 478 244 509 221],474,5,14501,4.205626450116009,20.0,0.0
7448,1,3448,[202 413 429 275 219],13,2,14503,4.204986952739924,0.0,20.0
7449,1,3449,[222 209 212 367 429],13,2,14505,4.2043478260869565,0.0,20.0
7450,1,3450,[315 478 244 509 221],474,5,14510,4.204578383077369,20.0,0.0
7451,1,3451,[315 478 244 509 221],474,5,14515,4.204808806488992,20.0,0.0
7452,1,3452,[227 222 211 367 413],42,3,14518,4.204459889950767,0.0,40.0
7453,1,3453,[315 478 244 509 221],474,5,14523,4.204690214244354,20.0,0.0
7454,1,3454,[227 219 431 384 321],13,1,14524,4.2037626628075255,0.0,0.0
7455,1,3455,[315 478 244 509 221],474,5,14529,4.203993055555555,20.0,0.0
7456,1,3456,[280 336 264 321 508],13,2,14531,4.203355510558287,0.0,0.0
7457,1,3457,[336 508 299 212 326],13,1,14532,4.202429149797571,0.0,0.0
7458,1,3458,[315 478 244 509 221],474,5,14537,4.202659728245157,20.0,0.0
7459,1,3459,[315 478 244 509 221],474,5,14542,4.202890173410404,20.0,0.0
7460,1,3460,[298 236 230 227 240],145,3,14545,4.202542617740537,0.0,0.0
7461,1,3461,[315 478 244 509 221],474,5,14550,4.202772963604852,20.0,0.0
7462,1,3462,[315 478 244 509 221],474,5,14555,4.203003176436615,20.0,0.0
7463,1,3463,[315 478 244 509 221],474,5,14560,4.203233256351039,20.0,0.0
7464,1,3464,[315 478 244 509 221],474,5,14565,4.203463203463204,20.0,0.0
7465,1,3465,[315 478 244 509 221],474,5,14570,4.203693017888056,20.0,0.0
7466,1,3466,[384 201 256 219 251],385,2,14572,4.203057398327084,20.0,0.0
7467,1,3467,[222 290 218 272 217],334,2,14574,4.20242214532872,0.0,20.0
7468,1,3468,[315 478 244 509 221],474,5,14579,4.202652061112713,20.0,0.0
7469,1,3469,[315 478 244 509 221],474,5,14584,4.2028818443804035,20.0,0.0
7470,1,3470,[315 478 244 509 221],474,5,14589,4.203111495246326,20.0,0.0
7471,1,3471,[315 478 244 509 221],474,5,14594,4.203341013824885,20.0,0.0
7472,1,3472,[315 478 244 509 221],474,5,14599,4.2035704002303484,20.0,0.0
7473,1,3473,[222 241 331 452 272],13,1,14600,4.202648244099021,0.0,20.0
7474,1,3474,[315 478 244 509 221],474,5,14605,4.202877697841727,20.0,0.0
7475,1,3475,[315 478 244 509 221],474,5,14610,4.203107019562716,20.0,0.0
7476,1,3476,[315 478 244 509 221],474,5,14615,4.203336209375899,20.0,0.0
7477,1,3477,[431 226 365 231 284],749,4,14619,4.203277745830937,0.0,0.0
7478,1,3478,[315 478 244 509 221],474,5,14624,4.203506754814602,20.0,0.0
7479,1,3479,[315 478 244 509 221],474,5,14629,4.203735632183908,20.0,0.0
7480,1,3480,[315 478 244 509 221],474,5,14634,4.203964378052284,20.0,0.0
7481,1,3481,[315 478 244 509 221],474,5,14639,4.204192992533027,20.0,0.0
7482,1,3482,[315 478 244 509 221],474,5,14644,4.204421475739305,20.0,0.0
7483,1,3483,[315 478 244 509 221],474,5,14649,4.204649827784156,20.0,0.0
7484,1,3484,[315 478 244 509 221],474,5,14654,4.204878048780488,20.0,0.0
7485,1,3485,[315 478 244 509 221],474,5,14659,4.205106138841079,20.0,0.0
7486,1,3486,[315 478 244 509 221],474,5,14664,4.205334098078578,20.0,0.0
7487,1,3487,[315 478 244 509 221],474,5,14669,4.205561926605505,20.0,0.0
7488,1,3488,[315 478 244 509 221],474,5,14674,4.20578962453425,20.0,0.0
7489,1,3489,[243 261 420 232 336],13,1,14675,4.20487106017192,0.0,0.0
7490,1,3490,[315 478 244 509 221],474,5,14680,4.205098825551418,20.0,0.0
7491,1,3491,[315 478 244 509 221],474,5,14685,4.2053264604811,20.0,0.0
7492,1,3492,[315 478 244 509 221],474,5,14690,4.205553965073003,20.0,0.0
7493,1,3493,[365 485 481 215 298],308,2,14692,4.2049227246708645,0.0,0.0
7494,1,3494,[431 217 367 232 508],13,0,14692,4.203719599427754,0.0,0.0
7495,1,3495,[301 212 218 230 217],13,1,14693,4.202803203661327,0.0,0.0
7496,1,3496,[315 478 244 509 221],474,5,14698,4.20303116957392,20.0,0.0
7497,1,3497,[301 303 507 211 231],13,2,14700,4.202401372212693,0.0,20.0
7498,1,3498,[295 452 215 431 231],92,2,14702,4.201771934838526,0.0,0.0
7499,1,3499,[315 478 244 509 221],474,5,14707,4.202,20.0,0.0
7500,1,3500,[315 478 244 509 221],474,5,14712,4.20222793487575,20.0,0.0
7501,1,3501,[315 478 244 509 221],474,5,14717,4.202455739577385,20.0,0.0
7502,1,3502,[290 211 276 241 239],537,2,14719,4.201827005423922,0.0,40.0
7503,1,3503,[315 478 244 509 221],474,5,14724,4.2020547945205475,20.0,0.0
7504,1,3504,[212 226 213 217 324],7,2,14726,4.201426533523538,0.0,0.0
7505,1,3505,[315 478 244 509 221],474,5,14731,4.201654306902453,20.0,0.0
7506,1,3506,[283 243 208 215 392],537,2,14733,4.201026518391788,0.0,0.0
7507,1,3507,[315 478 244 509 221],474,5,14738,4.201254275940707,20.0,0.0
7508,1,3508,[268 226 303 222 208],537,3,14741,4.200911940723853,0.0,20.0
7509,1,3509,[315 478 244 509 221],474,5,14746,4.201139601139601,20.0,0.0
7510,1,3510,[303 316 230 211 222],13,3,14749,4.200797493591569,20.0,40.0
7511,1,3511,[315 478 244 509 221],474,5,14754,4.201025056947608,20.0,0.0
7512,1,3512,[485 230 216 226 259],194,0,14754,4.199829205807003,0.0,0.0
7513,1,3513,[315 478 244 509 221],474,5,14759,4.200056915196358,20.0,0.0
7514,1,3514,[217 216 254 202 241],378,2,14761,4.199431009957325,0.0,0.0
7515,1,3515,[315 478 244 509 221],474,5,14766,4.199658703071672,20.0,0.0
7516,1,3516,[315 478 244 509 221],474,5,14771,4.199886266704578,20.0,0.0
7517,1,3517,[378 223 452 284 217],833,1,14772,4.198976691301876,20.0,0.0
7518,1,3518,[315 478 244 509 221],474,5,14777,4.199204319408923,20.0,0.0
7519,1,3519,[321 230 280 241 367],378,1,14778,4.1982954545454545,0.0,0.0
7520,1,3520,[315 478 244 509 221],474,5,14783,4.198523146833286,20.0,0.0
7521,1,3521,[315 478 244 509 221],474,5,14788,4.198750709823964,20.0,0.0
7522,1,3522,[315 478 244 509 221],474,5,14793,4.19897814362759,20.0,0.0
7523,1,3523,[315 478 244 509 221],474,5,14798,4.199205448354143,20.0,0.0
7524,1,3524,[315 478 244 509 221],474,5,14803,4.199432624113475,20.0,0.0
7525,1,3525,[315 478 244 509 221],474,5,14808,4.199659671015315,20.0,0.0
7526,1,3526,[315 478 244 509 221],474,5,14813,4.199886589169266,20.0,0.0
7527,1,3527,[315 478 244 509 221],474,5,14818,4.200113378684807,20.0,0.0
7528,1,3528,[315 478 244 509 221],474,5,14823,4.200340039671295,20.0,0.0
7529,1,3529,[209 216 259 226 230],308,2,14825,4.19971671388102,0.0,0.0
7530,1,3530,[315 478 244 509 221],474,5,14830,4.199943358821863,20.0,0.0
7531,1,3531,[315 478 244 509 221],474,5,14835,4.200169875424689,20.0,0.0
7532,1,3532,[315 429 272 291 392],537,2,14837,4.199547127087461,20.0,0.0
7533,1,3533,[315 478 244 509 221],474,5,14842,4.1997736276174304,20.0,0.0
7534,1,3534,[315 478 244 509 221],474,5,14847,4.2,20.0,0.0
7535,1,3535,[315 478 244 509 221],474,5,14852,4.200226244343892,20.0,0.0
7536,1,3536,[315 478 244 509 221],474,5,14857,4.200452360757704,20.0,0.0
7537,1,3537,[315 478 244 509 221],474,5,14862,4.200678349349915,20.0,0.0
7538,1,3538,[315 478 244 509 221],474,5,14867,4.200904210228878,20.0,0.0
7539,1,3539,[315 478 244 509 221],474,5,14872,4.201129943502825,20.0,0.0
7540,1,3540,[209 276 485 230 223],334,3,14875,4.200790737079921,20.0,20.0
7541,1,3541,[315 478 244 509 221],474,5,14880,4.201016374929418,20.0,0.0
7542,1,3542,[315 478 244 509 221],474,5,14885,4.201241885407846,20.0,0.0
7543,1,3543,[315 478 244 509 221],474,5,14890,4.201467268623025,20.0,0.0
7544,1,3544,[315 478 244 509 221],474,5,14895,4.2016925246826515,20.0,0.0
7545,1,3545,[303 509 241 290 315],13,4,14899,4.201635645798082,20.0,0.0
7546,1,3546,[290 217 336 216 280],13,2,14901,4.20101494220468,0.0,0.0
7547,1,3547,[507 259 367 429 481],7,4,14905,4.200958286358512,0.0,0.0
7548,1,3548,[315 478 244 509 221],474,5,14910,4.201183431952662,20.0,0.0
7549,1,3549,[315 478 244 509 221],474,5,14915,4.201408450704226,20.0,0.0
7550,1,3550,[315 478 244 509 221],474,5,14920,4.201633342720361,20.0,0.0
7551,1,3551,[315 478 244 509 221],474,5,14925,4.201858108108108,20.0,0.0
7552,1,3552,[315 478 244 509 221],474,5,14930,4.202082746974388,20.0,0.0
7553,1,3553,[213 392 276 365 223],378,3,14933,4.2017445132245355,20.0,20.0
7554,1,3554,[324 367 378 230 336],833,0,14933,4.20056258790436,0.0,0.0
7555,1,3555,[315 478 244 509 221],474,5,14938,4.200787401574803,20.0,0.0
7556,1,3556,[315 478 244 509 221],474,5,14943,4.201012088838909,20.0,0.0
7557,1,3557,[315 478 244 509 221],474,5,14948,4.20123664980326,20.0,0.0
7558,1,3558,[315 478 244 509 221],474,5,14953,4.201461084574318,20.0,0.0
7559,1,3559,[315 478 244 509 221],474,5,14958,4.201685393258427,20.0,0.0
7560,1,3560,[231 218 275 213 367],311,4,14962,4.201628755967425,0.0,20.0
7561,1,3561,[315 478 244 509 221],474,5,14967,4.201852891633914,20.0,0.0
7562,1,3562,[231 221 378 216 384],385,1,14968,4.200954252034802,0.0,0.0
7563,1,3563,[315 478 244 509 221],474,5,14973,4.201178451178452,20.0,0.0
7564,1,3564,[315 478 244 509 221],474,5,14978,4.2014025245441795,20.0,0.0
7565,1,3565,[315 478 244 509 221],474,5,14983,4.201626472237802,20.0,0.0
7566,1,3566,[315 478 244 509 221],474,5,14988,4.201850294365013,20.0,0.0
7567,1,3567,[315 478 244 509 221],474,5,14993,4.20207399103139,20.0,0.0
7568,1,3568,[315 478 244 509 221],474,5,14998,4.202297562342393,20.0,0.0
7569,1,3569,[315 478 244 509 221],474,5,15003,4.2025210084033615,20.0,0.0
7570,1,3570,[315 478 244 509 221],474,5,15008,4.202744329319518,20.0,0.0
7571,1,3571,[507 321 209 326 290],13,1,15009,4.201847704367301,0.0,0.0
7572,1,3572,[315 478 244 509 221],474,5,15014,4.202071088720963,20.0,0.0
7573,1,3573,[315 478 244 509 221],474,5,15019,4.20229434806939,20.0,0.0
7574,1,3574,[315 478 244 509 221],474,5,15024,4.202517482517482,20.0,0.0
7575,1,3575,[315 478 244 509 221],474,5,15029,4.202740492170022,20.0,0.0
7576,1,3576,[315 478 244 509 221],474,5,15034,4.202963377131675,20.0,0.0
7577,1,3577,[315 478 244 509 221],474,5,15039,4.203186137506987,20.0,0.0
7578,1,3578,[315 478 244 509 221],474,5,15044,4.203408773400391,20.0,0.0
7579,1,3579,[315 478 244 509 221],474,5,15049,4.203631284916201,20.0,0.0
7580,1,3580,[315 478 244 509 221],474,5,15054,4.203853672158615,20.0,0.0
7581,1,3581,[283 429 202 321 221],537,1,15055,4.202959240647683,0.0,0.0
7582,1,3582,[226 215 230 478 429],537,1,15056,4.2020653084007815,0.0,0.0
7583,1,3583,[315 478 244 509 221],474,5,15061,4.202287946428571,20.0,0.0
7584,1,3584,[315 478 244 509 221],474,5,15066,4.202510460251046,20.0,0.0
7585,1,3585,[315 478 244 509 221],474,5,15071,4.202732849972114,20.0,0.0
7586,1,3586,[315 478 244 509 221],474,5,15076,4.202955115695567,20.0,0.0
7587,1,3587,[315 478 244 509 221],474,5,15081,4.203177257525083,20.0,0.0
7588,1,3588,[315 478 244 509 221],474,5,15086,4.203399275564224,20.0,0.0
7589,1,3589,[315 478 244 509 221],474,5,15091,4.203621169916435,20.0,0.0
7590,1,3590,[315 478 244 509 221],474,5,15096,4.203842940685046,20.0,0.0
7591,1,3591,[227 326 259 222 478],474,3,15099,4.203507795100223,0.0,20.0
7592,1,3592,[315 478 244 509 221],474,5,15104,4.2037294739771776,20.0,0.0
7593,1,3593,[315 478 244 509 221],474,5,15109,4.2039510294936004,20.0,0.0
7594,1,3594,[315 478 244 509 221],474,5,15114,4.204172461752434,20.0,0.0
7595,1,3595,[315 478 244 509 221],474,5,15119,4.204393770856507,20.0,0.0
7596,1,3596,[315 478 244 509 221],474,5,15124,4.204614956908535,20.0,0.0
7597,1,3597,[315 478 244 509 221],474,5,15129,4.2048360200111174,20.0,0.0
7598,1,3598,[222 208 212 295 268],92,4,15133,4.20477910530703,0.0,20.0
7599,1,3599,[315 478 244 509 221],474,5,15138,4.205,20.0,0.0
7600,1,3600,[315 478 244 509 221],474,5,15143,4.205220772007776,20.0,0.0
7601,1,3601,[315 478 244 509 221],474,5,15148,4.205441421432537,20.0,0.0
7602,1,3602,[367 452 231 208 291],92,2,15150,4.204829308909242,0.0,0.0
7603,1,3603,[315 478 244 509 221],474,5,15155,4.205049944506104,20.0,0.0
7604,1,3604,[315 478 244 509 221],474,5,15160,4.205270457697642,20.0,0.0
7605,1,3605,[315 478 244 509 221],474,5,15165,4.205490848585691,20.0,0.0
7606,1,3606,[208 303 211 321 268],537,4,15169,4.2054338785694485,0.0,20.0
7607,1,3607,[284 268 367 301 478],234,1,15170,4.204545454545454,0.0,0.0
7608,1,3608,[315 244 478 509 221],474,5,15175,4.204765863119978,20.0,0.0
7609,1,3609,[315 244 478 509 221],474,5,15180,4.204986149584488,20.0,0.0
7610,1,3610,[315 244 478 509 221],474,5,15185,4.205206314040432,20.0,0.0
7611,1,3611,[315 244 478 509 221],474,5,15190,4.205426356589148,20.0,0.0
7612,1,3612,[315 244 478 509 221],474,5,15195,4.205646277331857,20.0,0.0
7613,1,3613,[315 244 478 509 221],474,5,15200,4.205866076369674,20.0,0.0
7614,1,3614,[315 244 478 509 221],474,5,15205,4.206085753803596,20.0,0.0
7615,1,3615,[315 244 478 509 221],474,5,15210,4.206305309734513,20.0,0.0
7616,1,3616,[413 431 202 230 232],774,2,15212,4.2056953276195745,0.0,0.0
7617,1,3617,[315 244 478 509 221],474,5,15217,4.205914870093975,20.0,0.0
7618,1,3618,[315 244 478 509 221],474,5,15222,4.206134291240674,20.0,0.0
7619,1,3619,[215 223 222 209 508],13,2,15224,4.205524861878453,20.0,20.0
7620,1,3620,[315 244 478 509 221],474,5,15229,4.205744269538801,20.0,0.0
7621,1,3621,[315 244 478 509 221],474,5,15234,4.205963556046383,20.0,0.0
7622,1,3622,[315 244 478 509 221],474,5,15239,4.206182721501518,20.0,0.0
7623,1,3623,[507 223 213 429 236],234,2,15241,4.205573951434879,20.0,0.0
7624,1,3624,[315 244 478 509 221],474,5,15246,4.205793103448276,20.0,0.0
7625,1,3625,[315 244 478 509 221],474,5,15251,4.206012134583563,20.0,0.0
7626,1,3626,[272 241 239 300 226],13,3,15254,4.205679625034464,0.0,20.0
7627,1,3627,[315 244 478 509 221],474,5,15259,4.205898566703418,20.0,0.0
7628,1,3628,[315 244 478 509 221],474,5,15264,4.206117387710113,20.0,0.0
7629,1,3629,[315 244 478 509 221],474,5,15269,4.20633608815427,20.0,0.0
7630,1,3630,[315 244 478 509 221],474,5,15274,4.2065546681354995,20.0,0.0
7631,1,3631,[315 244 478 509 221],474,5,15279,4.206773127753304,20.0,0.0
7632,1,3632,[315 244 478 509 221],474,5,15284,4.206991467107074,20.0,0.0
7633,1,3633,[315 244 478 509 221],474,5,15289,4.207209686296093,20.0,0.0
7634,1,3634,[315 244 478 509 221],474,5,15294,4.207427785419532,20.0,0.0
7635,1,3635,[315 244 478 509 221],474,5,15299,4.207645764576458,20.0,0.0
7636,1,3636,[315 244 478 509 221],474,5,15304,4.207863623865824,20.0,0.0
7637,1,3637,[331 236 297 255 244],486,1,15305,4.206981858163826,20.0,0.0
7638,1,3638,[315 478 244 509 221],474,5,15310,4.207199780159384,20.0,0.0
7639,1,3639,[315 478 244 509 221],474,5,15315,4.207417582417582,20.0,0.0
7640,1,3640,[280 508 344 215 211],13,3,15318,4.207085965394122,0.0,20.0
7641,1,3641,[315 478 244 509 221],474,5,15323,4.207303679297089,20.0,0.0
7642,1,3642,[315 478 244 509 221],474,5,15328,4.2075212736755425,20.0,0.0
7643,1,3643,[244 250 297 223 276],894,5,15333,4.207738748627881,40.0,20.0
7644,1,3644,[315 478 244 509 221],474,5,15338,4.207956104252401,20.0,0.0
7645,1,3645,[315 478 244 509 221],474,5,15343,4.208173340647285,20.0,0.0
7646,1,3646,[315 478 244 509 221],474,5,15348,4.208390457910611,20.0,0.0
7647,1,3647,[315 478 244 509 221],474,5,15353,4.208607456140351,20.0,0.0
7648,1,3648,[315 478 244 509 221],474,5,15358,4.2088243354343655,20.0,0.0
7649,1,3649,[315 478 244 509 221],474,5,15363,4.209041095890411,20.0,0.0
7650,1,3650,[315 478 244 509 221],474,5,15368,4.209257737606135,20.0,0.0
7651,1,3651,[315 478 244 509 221],474,5,15373,4.20947426067908,20.0,0.0
7652,1,3652,[413 261 239 218 222],13,1,15374,4.208595674787846,0.0,20.0
7653,1,3653,[429 208 215 202 227],648,3,15377,4.208264915161467,0.0,0.0
7654,1,3654,[315 478 244 509 221],474,5,15382,4.208481532147743,20.0,0.0
7655,1,3655,[315 478 244 509 221],474,5,15387,4.208698030634573,20.0,0.0
7656,1,3656,[315 478 244 509 221],474,5,15392,4.208914410719169,20.0,0.0
7657,1,3657,[213 508 240 211 209],339,5,15397,4.209130672498633,0.0,20.0
7658,1,3658,[315 478 244 509 221],474,5,15402,4.2093468160699645,20.0,0.0
7659,1,3659,[315 478 244 509 221],474,5,15407,4.2095628415300546,20.0,0.0
7660,1,3660,[275 507 202 321 211],6,3,15410,4.209232450150232,0.0,40.0
7661,1,3661,[315 478 244 509 221],474,5,15415,4.209448388858547,20.0,0.0
7662,1,3662,[315 478 244 509 221],474,5,15420,4.20966420966421,20.0,0.0
7663,1,3663,[452 230 315 384 226],13,2,15422,4.209061135371179,20.0,0.0
7664,1,3664,[321 230 485 295 284],378,1,15423,4.20818553888131,0.0,0.0
7665,1,3665,[315 478 244 509 221],474,5,15428,4.208401527550464,20.0,0.0
7666,1,3666,[315 478 244 509 221],474,5,15433,4.208617398418325,20.0,0.0
7667,1,3667,[315 478 244 509 221],474,5,15438,4.208833151581243,20.0,0.0
7668,1,3668,[315 478 244 509 221],474,5,15443,4.209048787135459,20.0,0.0
7669,1,3669,[315 478 244 509 221],474,5,15448,4.209264305177112,20.0,0.0
7670,1,3670,[315 478 244 509 221],474,5,15453,4.2094797058022335,20.0,0.0
7671,1,3671,[365 202 420 218 239],311,3,15456,4.209150326797386,0.0,0.0
7672,1,3672,[315 478 244 509 221],474,5,15461,4.20936564116526,20.0,0.0
7673,1,3673,[315 478 244 509 221],474,5,15466,4.209580838323354,20.0,0.0
7674,1,3674,[315 478 244 509 221],474,5,15471,4.209795918367347,20.0,0.0
7675,1,3675,[315 478 244 509 221],474,5,15476,4.210010881392818,20.0,0.0
7676,1,3676,[264 241 452 216 226],308,1,15477,4.209137884144683,0.0,0.0
7677,1,3677,[315 478 244 509 221],474,5,15482,4.209352909189777,20.0,0.0
7678,1,3678,[315 478 244 509 221],474,5,15487,4.209567817341669,20.0,0.0
7679,1,3679,[315 478 244 509 221],474,5,15492,4.209782608695652,20.0,0.0
7680,1,3680,[315 478 244 509 221],474,5,15497,4.209997283346917,20.0,0.0
7681,1,3681,[276 303 315 295 283],894,3,15500,4.2096686583378595,20.0,20.0
7682,1,3682,[218 420 219 508 280],13,2,15502,4.209068693999457,0.0,0.0
7683,1,3683,[315 478 244 509 221],474,5,15507,4.20928338762215,20.0,0.0
7684,1,3684,[315 478 244 509 221],474,5,15512,4.209497964721845,20.0,0.0
7685,1,3685,[378 208 222 202 275],311,5,15517,4.209712425393381,0.0,40.0
7686,1,3686,[315 478 244 509 221],474,5,15522,4.209926769731489,20.0,0.0
7687,1,3687,[315 478 244 509 221],474,5,15527,4.210140997830803,20.0,0.0
7688,1,3688,[315 478 244 509 221],474,5,15532,4.21035510978585,20.0,0.0
7689,1,3689,[255 251 297 295 280],486,2,15534,4.209756097560976,40.0,0.0
7690,1,3690,[231 212 211 316 508],13,3,15537,4.209428339203468,20.0,20.0
7691,1,3691,[315 478 244 509 221],474,5,15542,4.209642470205851,20.0,0.0
7692,1,3692,[315 478 244 509 221],474,5,15547,4.209856485242351,20.0,0.0
7693,1,3693,[239 259 291 218 367],524,2,15549,4.209258256632377,0.0,0.0
7694,1,3694,[315 478 244 509 221],474,5,15554,4.209472259810555,20.0,0.0
7695,1,3695,[212 413 420 367 264],13,3,15557,4.209145021645021,0.0,0.0
7696,1,3696,[392 243 231 222 226],537,0,15557,4.2080064917500675,0.0,20.0
7697,1,3697,[315 478 244 509 221],474,5,15562,4.208220659816117,20.0,0.0
7698,1,3698,[209 275 212 508 276],474,3,15565,4.207894025412274,0.0,40.0
7699,1,3699,[315 478 244 509 221],474,5,15570,4.208108108108108,20.0,0.0
7700,1,3700,[315 478 244 509 221],474,5,15575,4.208322075114834,20.0,0.0
7701,1,3701,[315 478 244 509 221],474,5,15580,4.208535926526202,20.0,0.0
7702,1,3702,[315 478 244 509 221],474,5,15585,4.208749662435863,20.0,0.0
7703,1,3703,[315 478 244 509 221],474,5,15590,4.208963282937365,20.0,0.0
7704,1,3704,[315 478 244 509 221],474,5,15595,4.209176788124156,20.0,0.0
7705,1,3705,[315 478 244 509 221],474,5,15600,4.209390178089585,20.0,0.0
7706,1,3706,[315 212 201 280 481],13,3,15603,4.209063933099541,20.0,0.0
7707,1,3707,[315 478 244 509 221],474,5,15608,4.209277238403452,20.0,0.0
7708,1,3708,[315 478 244 509 221],474,5,15613,4.209490428686977,20.0,0.0
7709,1,3709,[315 478 244 509 221],474,5,15618,4.2097035040431265,20.0,0.0
7710,1,3710,[384 507 301 316 331],13,1,15619,4.208838587981676,20.0,0.0
7711,1,3711,[315 478 244 509 221],474,5,15624,4.209051724137931,20.0,0.0
7712,1,3712,[452 300 509 275 264],13,2,15626,4.2084567734985185,0.0,40.0
7713,1,3713,[315 478 244 509 221],474,5,15631,4.2086698976844374,20.0,0.0
7714,1,3714,[315 478 244 509 221],474,5,15636,4.208882907133243,20.0,0.0
7715,1,3715,[316 216 350 508 367],13,1,15637,4.208019375672767,20.0,0.0
7716,1,3716,[315 478 244 509 221],474,5,15642,4.208232445520581,20.0,0.0
7717,1,3717,[344 315 384 226 208],13,3,15645,4.207907477138247,20.0,0.0
7718,1,3718,[222 230 275 301 384],13,0,15645,4.2067760150578115,0.0,40.0
7719,1,3719,[315 478 244 509 221],474,5,15650,4.206989247311828,20.0,0.0
7720,1,3720,[315 478 244 509 221],474,5,15655,4.207202364955657,20.0,0.0
7721,1,3721,[315 478 244 509 221],474,5,15660,4.207415368081676,20.0,0.0
7722,1,3722,[365 392 231 218 420],311,4,15664,4.207359656191244,0.0,0.0
7723,1,3723,[208 223 275 246 250],334,4,15668,4.207303974221268,20.0,20.0
7724,1,3724,[315 478 244 509 221],474,5,15673,4.20751677852349,20.0,0.0
7725,1,3725,[321 209 211 507 299],537,3,15676,4.207192699946323,0.0,20.0
7726,1,3726,[315 478 244 509 221],474,5,15681,4.207405419908774,20.0,0.0
7727,1,3727,[315 478 244 509 221],474,5,15686,4.207618025751073,20.0,0.0
7728,1,3728,[315 478 244 509 221],474,5,15691,4.207830517565031,20.0,0.0
7729,1,3729,[315 478 244 509 221],474,5,15696,4.208042895442359,20.0,0.0
7730,1,3730,[315 478 244 509 221],474,5,15701,4.208255159474672,20.0,0.0
7731,1,3731,[315 478 244 509 221],474,5,15706,4.208467309753483,20.0,0.0
7732,1,3732,[315 478 244 509 221],474,5,15711,4.208679346370212,20.0,0.0
7733,1,3733,[315 478 244 509 221],474,5,15716,4.208891269416176,20.0,0.0
7734,1,3734,[315 478 244 509 221],474,5,15721,4.209103078982597,20.0,0.0
7735,1,3735,[315 478 244 509 221],474,5,15726,4.2093147751606,20.0,0.0
7736,1,3736,[315 478 244 509 221],474,5,15731,4.2095263580412094,20.0,0.0
7737,1,3737,[315 478 244 509 221],474,5,15736,4.209737827715355,20.0,0.0
7738,1,3738,[221 223 300 226 316],234,1,15737,4.208879379513239,40.0,20.0
7739,1,3739,[315 478 244 509 221],474,5,15742,4.209090909090909,20.0,0.0
7740,1,3740,[315 478 244 509 221],474,5,15747,4.209302325581396,20.0,0.0
7741,1,3741,[315 478 244 509 221],474,5,15752,4.209513629075361,20.0,0.0
7742,1,3742,[315 478 244 509 221],474,5,15757,4.209724819663371,20.0,0.0
7743,1,3743,[315 478 244 509 221],474,5,15762,4.209935897435898,20.0,0.0
7744,1,3744,[315 478 244 509 221],474,5,15767,4.210146862483311,20.0,0.0
7745,1,3745,[315 478 244 509 221],474,5,15772,4.210357714895889,20.0,0.0
7746,1,3746,[276 280 208 481 212],234,2,15774,4.209767814251401,0.0,20.0
7747,1,3747,[315 478 244 509 221],474,5,15779,4.209978655282818,20.0,0.0
7748,1,3748,[315 478 244 509 221],474,5,15784,4.210189383835689,20.0,0.0
7749,1,3749,[240 283 222 290 275],279,2,15786,4.2096,0.0,40.0
7750,1,3750,[315 478 244 509 221],474,5,15791,4.209810717142095,20.0,0.0
7751,1,3751,[315 478 244 509 221],474,5,15796,4.21002132196162,20.0,0.0
7752,1,3752,[315 478 244 509 221],474,5,15801,4.2102318145483615,20.0,0.0
7753,1,3753,[315 478 244 509 221],474,5,15806,4.210442194992009,20.0,0.0
7754,1,3754,[315 478 244 509 221],474,5,15811,4.210652463382157,20.0,0.0
7755,1,3755,[315 478 244 509 221],474,5,15816,4.210862619808307,20.0,0.0
7756,1,3756,[315 478 244 509 221],474,5,15821,4.211072664359862,20.0,0.0
7757,1,3757,[315 478 244 509 221],474,5,15826,4.2112825971261305,20.0,0.0
7758,1,3758,[315 478 244 509 221],474,5,15831,4.211492418196329,20.0,0.0
7759,1,3759,[478 431 209 223 291],749,5,15836,4.211702127659574,20.0,0.0
7760,1,3760,[315 478 244 509 221],474,5,15841,4.211911725604892,20.0,0.0
7761,1,3761,[315 478 244 509 221],474,5,15846,4.212121212121212,20.0,0.0
7762,1,3762,[420 508 315 429 326],13,3,15849,4.211799096465586,20.0,0.0
7763,1,3763,[315 478 244 509 221],474,5,15854,4.212008501594049,20.0,0.0
7764,1,3764,[315 478 244 509 221],474,5,15859,4.212217795484728,20.0,0.0
7765,1,3765,[315 478 244 509 221],474,5,15864,4.212426978226235,20.0,0.0
7766,1,3766,[413 431 212 246 236],145,2,15866,4.211839660207061,0.0,0.0
7767,1,3767,[315 478 244 509 221],474,5,15871,4.212048832271762,20.0,0.0
7768,1,3768,[315 478 244 509 221],474,5,15876,4.212257893340409,20.0,0.0
7769,1,3769,[315 478 244 509 221],474,5,15881,4.212466843501327,20.0,0.0
7770,1,3770,[315 478 244 509 221],474,5,15886,4.212675682842748,20.0,0.0
7771,1,3771,[315 478 244 509 221],474,5,15891,4.21288441145281,20.0,0.0
7772,1,3772,[315 478 244 509 221],474,5,15896,4.21309302941956,20.0,0.0
7773,1,3773,[315 478 244 509 221],474,5,15901,4.213301536830949,20.0,0.0
7774,1,3774,[315 478 244 509 221],474,5,15906,4.2135099337748345,20.0,0.0
7775,1,3775,[290 268 336 324 246],894,1,15907,4.212658898305085,0.0,0.0
7776,1,3776,[315 478 244 509 221],474,5,15912,4.212867355043685,20.0,0.0
7777,1,3777,[284 243 215 431 240],804,4,15916,4.212811011116993,0.0,0.0
7778,1,3778,[315 478 244 509 221],474,5,15921,4.213019317279704,20.0,0.0
7779,1,3779,[315 478 244 509 221],474,5,15926,4.213227513227514,20.0,0.0
7780,1,3780,[276 297 301 255 230],334,3,15929,4.2129066384554354,20.0,20.0
7781,1,3781,[315 478 244 509 221],474,5,15934,4.213114754098361,20.0,0.0
7782,1,3782,[291 507 209 268 211],234,2,15936,4.212529738302934,0.0,20.0
7783,1,3783,[315 478 244 509 221],474,5,15941,4.212737843551797,20.0,0.0
7784,1,3784,[315 478 244 509 221],474,5,15946,4.212945838837516,20.0,0.0
7785,1,3785,[315 478 244 509 221],474,5,15951,4.213153724247227,20.0,0.0
7786,1,3786,[315 276 431 299 206],537,3,15954,4.212833377343544,20.0,20.0
7787,1,3787,[315 478 244 509 221],474,5,15959,4.213041182682154,20.0,0.0
7788,1,3788,[315 478 244 509 221],474,5,15964,4.2132488783320134,20.0,0.0
7789,1,3789,[315 478 244 509 221],474,5,15969,4.213456464379947,20.0,0.0
7790,1,3790,[315 478 244 509 221],474,5,15974,4.213663940912688,20.0,0.0
7791,1,3791,[431 275 230 350 219],13,0,15974,4.212552742616034,0.0,20.0
7792,1,3792,[315 478 244 509 221],474,5,15979,4.212760348009491,20.0,0.0
7793,1,3793,[315 478 244 509 221],474,5,15984,4.212967843964154,20.0,0.0
7794,1,3794,[420 216 239 209 217],406,2,15986,4.212384716732543,0.0,0.0
7795,1,3795,[315 478 244 509 221],474,5,15991,4.21259220231823,20.0,0.0
7796,1,3796,[276 268 485 221 291],234,0,15991,4.21148274953911,0.0,20.0
7797,1,3797,[315 478 244 509 221],474,5,15996,4.211690363349131,20.0,0.0
7798,1,3798,[284 241 208 218 232],194,1,15997,4.21084495919979,0.0,0.0
7799,1,3799,[315 478 244 509 221],474,5,16002,4.211052631578947,20.0,0.0
7800,1,3800,[315 478 244 509 221],474,5,16007,4.211260194685609,20.0,0.0
7801,1,3801,[315 478 244 509 221],474,5,16012,4.211467648605997,20.0,0.0
7802,1,3802,[315 478 244 509 221],474,5,16017,4.211674993426242,20.0,0.0
7803,1,3803,[485 239 293 255 241],308,3,16020,4.211356466876971,0.0,0.0
7804,1,3804,[315 478 244 509 221],474,5,16025,4.211563731931669,20.0,0.0
7805,1,3805,[272 300 452 350 303],13,2,16027,4.210982658959537,0.0,20.0
7806,1,3806,[315 478 244 509 221],474,5,16032,4.211189913317573,20.0,0.0
7807,1,3807,[315 478 244 509 221],474,5,16037,4.211397058823529,20.0,0.0
7808,1,3808,[315 478 244 509 221],474,5,16042,4.21160409556314,20.0,0.0
7809,1,3809,[315 478 244 509 221],474,5,16047,4.211811023622047,20.0,0.0
7810,1,3810,[420 429 326 298 216],749,5,16052,4.212017843085804,0.0,0.0
7811,1,3811,[215 290 232 223 431],13,3,16055,4.211699895068206,20.0,0.0
7812,1,3812,[315 478 244 509 221],474,5,16060,4.211906635195384,20.0,0.0
7813,1,3813,[315 478 244 509 221],474,5,16065,4.212113266911379,20.0,0.0
7814,1,3814,[315 478 244 509 221],474,5,16070,4.212319790301442,20.0,0.0
7815,1,3815,[315 478 244 509 221],474,5,16075,4.212526205450734,20.0,0.0
7816,1,3816,[217 219 509 452 209],406,1,16076,4.211684569033272,0.0,0.0
7817,1,3817,[315 478 244 509 221],474,5,16081,4.211891042430592,20.0,0.0
7818,1,3818,[208 231 378 283 316],85,2,16083,4.211311861743912,20.0,0.0
7819,1,3819,[315 478 244 509 221],474,5,16088,4.21151832460733,20.0,0.0
7820,1,3820,[315 478 244 509 221],474,5,16093,4.211724679403297,20.0,0.0
7821,1,3821,[230 218 219 485 315],13,1,16094,4.210884353741497,20.0,0.0
7822,1,3822,[315 478 244 509 221],474,5,16099,4.211090766413811,20.0,0.0
7823,1,3823,[202 413 315 301 276],145,3,16102,4.210774058577406,20.0,20.0
7824,1,3824,[315 478 244 509 221],474,5,16107,4.210980392156863,20.0,0.0
7825,1,3825,[315 478 244 509 221],474,5,16112,4.211186617877679,20.0,0.0
7826,1,3826,[226 509 268 221 201],537,2,16114,4.210608831983277,0.0,0.0
7827,1,3827,[315 478 244 509 221],474,5,16119,4.210815047021944,20.0,0.0
7828,1,3828,[315 478 244 509 221],474,5,16124,4.211021154348394,20.0,0.0
7829,1,3829,[315 478 244 509 221],474,5,16129,4.211227154046997,20.0,0.0
7830,1,3830,[315 478 244 509 221],474,5,16134,4.211433046202036,20.0,0.0
7831,1,3831,[315 478 244 509 221],474,5,16139,4.211638830897703,20.0,0.0
7832,1,3832,[315 478 244 509 221],474,5,16144,4.211844508218106,20.0,0.0
7833,1,3833,[315 478 244 509 221],474,5,16149,4.212050078247262,20.0,0.0
7834,1,3834,[236 206 268 276 316],234,2,16151,4.211473272490221,20.0,20.0
7835,1,3835,[255 420 298 231 583],308,4,16155,4.211418143899896,0.0,0.0
7836,1,3836,[315 478 244 509 221],474,5,16160,4.211623664321084,20.0,0.0
7837,1,3837,[315 478 244 509 221],474,5,16165,4.211829077644606,20.0,0.0
7838,1,3838,[219 326 232 509 413],13,1,16166,4.210992445949466,0.0,0.0
7839,1,3839,[324 303 216 220 250],334,2,16168,4.210416666666666,0.0,0.0
7840,1,3840,[315 478 244 509 221],474,5,16173,4.210622233793283,20.0,0.0
7841,1,3841,[299 211 231 209 315],537,3,16176,4.210307131702239,20.0,20.0
7842,1,3842,[315 478 244 509 221],474,5,16181,4.210512620348686,20.0,0.0
7843,1,3843,[315 478 244 509 221],474,5,16186,4.210718002081165,20.0,0.0
7844,1,3844,[226 241 222 384 336],13,1,16187,4.2098829648894665,0.0,20.0
7845,1,3845,[315 478 244 509 221],474,5,16192,4.210088403536141,20.0,0.0
7846,1,3846,[315 478 244 509 221],474,5,16197,4.210293735378217,20.0,0.0
7847,1,3847,[223 367 215 206 246],387,2,16199,4.209719334719335,20.0,0.0
7848,1,3848,[315 478 244 509 221],474,5,16204,4.209924655754741,20.0,0.0
7849,1,3849,[315 478 244 509 221],474,5,16209,4.21012987012987,20.0,0.0
7850,1,3850,[315 478 244 509 221],474,5,16214,4.210334977927811,20.0,0.0
7851,1,3851,[315 478 244 509 221],474,5,16219,4.210539979231568,20.0,0.0
7852,1,3852,[315 478 244 509 221],474,5,16224,4.210744874124059,20.0,0.0
7853,1,3853,[315 478 244 509 221],474,5,16229,4.210949662688116,20.0,0.0
7854,1,3854,[315 478 244 509 221],474,5,16234,4.211154345006485,20.0,0.0
7855,1,3855,[303 275 321 261 429],13,2,16236,4.210580912863071,0.0,20.0
7856,1,3856,[315 478 244 509 221],474,5,16241,4.210785584651283,20.0,0.0
7857,1,3857,[315 478 244 509 221],474,5,16246,4.210990150336962,20.0,0.0
7858,1,3858,[478 239 211 216 509],406,2,16248,4.210417206530189,0.0,20.0
7859,1,3859,[315 478 244 509 221],474,5,16253,4.2106217616580315,20.0,0.0
7860,1,3860,[315 478 244 509 221],474,5,16258,4.210826210826211,20.0,0.0
7861,1,3861,[429 350 209 316 243],13,2,16260,4.2102537545313306,20.0,0.0
7862,1,3862,[283 211 303 221 202],537,3,16263,4.209940460781776,0.0,20.0
7863,1,3863,[272 283 236 300 221],334,4,16267,4.209886128364389,0.0,20.0
7864,1,3864,[315 478 244 509 221],474,5,16272,4.210090556274256,20.0,0.0
7865,1,3865,[315 478 244 509 221],474,5,16277,4.210294878427315,20.0,0.0
7866,1,3866,[315 478 244 509 221],474,5,16282,4.210499094905612,20.0,0.0
7867,1,3867,[315 478 244 509 221],474,5,16287,4.2107032057911065,20.0,0.0
7868,1,3868,[222 215 231 259 206],537,0,16287,4.209614887567847,0.0,20.0
7869,1,3869,[429 275 219 217 240],648,3,16290,4.209302325581396,0.0,20.0
7870,1,3870,[315 478 244 509 221],474,5,16295,4.209506587445104,20.0,0.0
7871,1,3871,[315 478 244 509 221],474,5,16300,4.2097107438016526,20.0,0.0
7872,1,3872,[315 478 244 509 221],474,5,16305,4.209914794732765,20.0,0.0
7873,1,3873,[315 478 244 509 221],474,5,16310,4.210118740320083,20.0,0.0
7874,1,3874,[315 478 244 509 221],474,5,16315,4.210322580645161,20.0,0.0
7875,1,3875,[315 478 244 509 221],474,5,16320,4.2105263157894735,20.0,0.0
7876,1,3876,[315 478 244 509 221],474,5,16325,4.210729945834408,20.0,0.0
7877,1,3877,[315 478 244 509 221],474,5,16330,4.210933470861269,20.0,0.0
7878,1,3878,[315 478 244 509 221],474,5,16335,4.211136890951276,20.0,0.0
7879,1,3879,[315 478 244 509 221],474,5,16340,4.211340206185567,20.0,0.0
7880,1,3880,[315 478 244 509 221],474,5,16345,4.211543416645195,20.0,0.0
7881,1,3881,[213 208 212 509 485],537,3,16348,4.211231324059763,0.0,0.0
7882,1,3882,[315 478 244 509 221],474,5,16353,4.2114344578933816,20.0,0.0
7883,1,3883,[413 202 452 272 478],13,3,16356,4.2111225540679715,0.0,0.0
7884,1,3884,[315 478 244 509 221],474,5,16361,4.211325611325611,20.0,0.0
7885,1,3885,[315 478 244 509 221],474,5,16366,4.211528564076171,20.0,0.0
7886,1,3886,[315 478 244 509 221],474,5,16371,4.211731412400309,20.0,0.0
7887,1,3887,[315 478 244 509 221],474,5,16376,4.211934156378601,20.0,0.0
7888,1,3888,[315 478 244 509 221],474,5,16381,4.21213679609154,20.0,0.0
7889,1,3889,[315 478 244 509 221],474,5,16386,4.212339331619537,20.0,0.0
7890,1,3890,[315 478 244 509 221],474,5,16391,4.212541763042919,20.0,0.0
7891,1,3891,[212 331 336 276 303],894,4,16395,4.212487153134635,0.0,20.0
7892,1,3892,[315 478 244 509 221],474,5,16400,4.212689442589263,20.0,0.0
7893,1,3893,[315 478 244 509 221],474,5,16405,4.212891628145865,20.0,0.0
7894,1,3894,[315 478 244 509 221],474,5,16410,4.213093709884467,20.0,0.0
7895,1,3895,[315 478 244 509 221],474,5,16415,4.21329568788501,20.0,0.0
7896,1,3896,[315 478 244 509 221],474,5,16420,4.213497562227355,20.0,0.0
7897,1,3897,[216 290 211 392 212],59,3,16423,4.213186249358645,0.0,20.0
7898,1,3898,[315 478 244 509 221],474,5,16428,4.2133880482174915,20.0,0.0
7899,1,3899,[478 216 217 300 239],13,2,16430,4.212820512820513,0.0,20.0
7900,1,3900,[315 478 244 509 221],474,5,16435,4.213022301973853,20.0,0.0
7901,1,3901,[315 478 244 509 221],474,5,16440,4.213223987698616,20.0,0.0
7902,1,3902,[219 209 508 268 222],13,1,16441,4.212400717396874,0.0,20.0
7903,1,3903,[315 478 244 509 221],474,5,16446,4.212602459016393,20.0,0.0
7904,1,3904,[280 218 223 478 290],13,4,16450,4.212548015364916,20.0,0.0
7905,1,3905,[246 213 478 275 284],6,3,16453,4.212237583205325,0.0,20.0
7906,1,3906,[315 478 244 509 221],474,5,16458,4.212439211671359,20.0,0.0
7907,1,3907,[315 478 244 509 221],474,5,16463,4.212640736949846,20.0,0.0
7908,1,3908,[315 478 244 509 221],474,5,16468,4.21284215911998,20.0,0.0
7909,1,3909,[315 478 244 509 221],474,5,16473,4.21304347826087,20.0,0.0
7910,1,3910,[315 478 244 509 221],474,5,16478,4.2132446944515465,20.0,0.0
7911,1,3911,[315 478 244 509 221],474,5,16483,4.213445807770961,20.0,0.0
7912,1,3912,[315 478 244 509 221],474,5,16488,4.213646818297981,20.0,0.0
7913,1,3913,[315 478 244 509 221],474,5,16493,4.213847726111395,20.0,0.0
7914,1,3914,[315 478 244 509 221],474,5,16498,4.214048531289911,20.0,0.0
7915,1,3915,[315 478 244 509 221],474,5,16503,4.214249233912155,20.0,0.0
7916,1,3916,[315 478 244 509 221],474,5,16508,4.214449834056676,20.0,0.0
7917,1,3917,[315 478 244 509 221],474,5,16513,4.2146503318019395,20.0,0.0
7918,1,3918,[218 219 293 215 209],385,1,16514,4.2138300586884405,0.0,0.0
7919,1,3919,[201 209 290 240 507],59,3,16517,4.213520408163265,0.0,0.0
7920,1,3920,[201 223 429 227 211],387,4,16521,4.213465952563122,20.0,20.0
7921,1,3921,[315 478 244 509 221],474,5,16526,4.213666496685365,20.0,0.0
7922,1,3922,[315 478 244 509 221],474,5,16531,4.213866938567423,20.0,0.0
7923,1,3923,[315 478 244 509 221],474,5,16536,4.2140672782874615,20.0,0.0
7924,1,3924,[431 485 321 230 261],13,0,16536,4.212993630573249,0.0,0.0
7925,1,3925,[315 478 244 509 221],474,5,16541,4.2131940906775345,20.0,0.0
7926,1,3926,[315 478 244 509 221],474,5,16546,4.213394448688566,20.0,0.0
7927,1,3927,[290 268 222 206 508],537,2,16548,4.212830957230143,0.0,20.0
7928,1,3928,[315 478 244 509 221],474,5,16553,4.213031305675744,20.0,0.0
7929,1,3929,[429 211 227 240 264],833,1,16554,4.212213740458015,0.0,20.0
7930,1,3930,[218 202 367 215 216],659,4,16558,4.212159755787331,0.0,0.0
7931,1,3931,[315 478 244 509 221],474,5,16563,4.21236012207528,20.0,0.0
7932,1,3932,[315 478 244 509 221],474,5,16568,4.21256038647343,20.0,0.0
7933,1,3933,[315 478 244 509 221],474,5,16573,4.212760549059482,20.0,0.0
7934,1,3934,[315 478 244 509 221],474,5,16578,4.212960609911055,20.0,0.0
7935,1,3935,[315 478 244 509 221],474,5,16583,4.213160569105691,20.0,0.0
7936,1,3936,[315 478 244 509 221],474,5,16588,4.213360426720853,20.0,0.0
7937,1,3937,[315 478 244 509 221],474,5,16593,4.213560182833926,20.0,0.0
7938,1,3938,[315 478 244 509 221],474,5,16598,4.213759837522214,20.0,0.0
7939,1,3939,[315 478 244 509 221],474,5,16603,4.213959390862944,20.0,0.0
7940,1,3940,[315 478 244 509 221],474,5,16608,4.214158842933266,20.0,0.0
7941,1,3941,[300 221 268 331 255],486,2,16610,4.213597158802639,0.0,20.0
7942,1,3942,[315 478 244 509 221],474,5,16615,4.213796601572406,20.0,0.0
7943,1,3943,[315 478 244 509 221],474,5,16620,4.213995943204869,20.0,0.0
7944,1,3944,[315 478 244 509 221],474,5,16625,4.2141951837769325,20.0,0.0
7945,1,3945,[315 478 244 509 221],474,5,16630,4.2143943233654335,20.0,0.0
7946,1,3946,[315 478 244 509 221],474,5,16635,4.2145933620471245,20.0,0.0
7947,1,3947,[315 478 244 509 221],474,5,16640,4.214792299898683,20.0,0.0
7948,1,3948,[315 478 244 509 221],474,5,16645,4.214991136996708,20.0,0.0
7949,1,3949,[315 478 244 509 221],474,5,16650,4.215189873417722,20.0,0.0
7950,1,3950,[315 478 244 509 221],474,5,16655,4.215388509238168,20.0,0.0
7951,1,3951,[315 478 244 509 221],474,5,16660,4.215587044534413,20.0,0.0
7952,1,3952,[315 478 244 509 221],474,5,16665,4.215785479382747,20.0,0.0
7953,1,3953,[315 478 244 509 221],474,5,16670,4.215983813859383,20.0,0.0
7954,1,3954,[315 478 244 509 221],474,5,16675,4.216182048040455,20.0,0.0
7955,1,3955,[226 202 218 230 215],200,5,16680,4.216380182002022,0.0,0.0
7956,1,3956,[315 478 244 509 221],474,5,16685,4.216578215820066,20.0,0.0
7957,1,3957,[226 259 232 213 365],7,2,16687,4.216018191005558,0.0,0.0
7958,1,3958,[315 478 244 509 221],474,5,16692,4.216216216216216,20.0,0.0
7959,1,3959,[315 478 244 509 221],474,5,16697,4.216414141414141,20.0,0.0
7960,1,3960,[315 478 244 509 221],474,5,16702,4.216611966675082,20.0,0.0
7961,1,3961,[315 478 244 509 221],474,5,16707,4.21680969207471,20.0,0.0
7962,1,3962,[315 478 244 509 221],474,5,16712,4.21700731768862,20.0,0.0
7963,1,3963,[315 478 244 509 221],474,5,16717,4.217204843592331,20.0,0.0
7964,1,3964,[315 478 244 509 221],474,5,16722,4.217402269861286,20.0,0.0
7965,1,3965,[298 226 420 300 239],749,5,16727,4.217599596570852,0.0,20.0
7966,1,3966,[315 478 244 509 221],474,5,16732,4.21779682379632,20.0,0.0
7967,1,3967,[315 478 244 509 221],474,5,16737,4.217993951612903,20.0,0.0
7968,1,3968,[246 268 316 378 231],85,3,16740,4.217687074829932,20.0,0.0
7969,1,3969,[315 478 244 509 221],474,5,16745,4.217884130982368,20.0,0.0
7970,1,3970,[239 241 420 301 220],378,2,16747,4.2173256106774115,0.0,0.0
7971,1,3971,[315 478 244 509 221],474,5,16752,4.217522658610272,20.0,0.0
7972,1,3972,[315 478 244 509 221],474,5,16757,4.2177196073496095,20.0,0.0
7973,1,3973,[301 223 209 268 250],334,2,16759,4.217161550075491,20.0,0.0
7974,1,3974,[315 478 244 509 221],474,5,16764,4.2173584905660375,20.0,0.0
7975,1,3975,[315 478 244 509 221],474,5,16769,4.217555331991952,20.0,0.0
7976,1,3976,[239 485 298 326 321],378,1,16770,4.216746291174252,0.0,0.0
7977,1,3977,[315 478 244 509 221],474,5,16775,4.216943187531423,20.0,0.0
7978,1,3978,[315 478 244 509 221],474,5,16780,4.217139984920834,20.0,0.0
7979,1,3979,[583 202 295 509 216],308,3,16783,4.216834170854272,0.0,0.0
7980,1,3980,[315 478 244 509 221],474,5,16788,4.217030896759608,20.0,0.0
7981,1,3981,[315 478 244 509 221],474,5,16793,4.217227523857358,20.0,0.0
7982,1,3982,[315 478 244 509 221],474,5,16798,4.2174240522219435,20.0,0.0
7983,1,3983,[315 478 244 509 221],474,5,16803,4.217620481927711,20.0,0.0
7984,1,3984,[315 478 244 509 221],474,5,16808,4.217816813048933,20.0,0.0
7985,1,3985,[315 478 244 509 221],474,5,16813,4.218013045659809,20.0,0.0
7986,1,3986,[315 478 244 509 221],474,5,16818,4.218209179834462,20.0,0.0
7987,1,3987,[315 478 244 509 221],474,5,16823,4.218405215646941,20.0,0.0
7988,1,3988,[315 478 244 509 221],474,5,16828,4.218601153171221,20.0,0.0
7989,1,3989,[315 478 244 509 221],474,5,16833,4.218796992481203,20.0,0.0
7990,1,3990,[315 478 244 509 221],474,5,16838,4.2189927336507145,20.0,0.0
7991,1,3991,[315 211 272 290 215],13,5,16843,4.219188376753507,20.0,20.0
7992,1,3992,[315 478 244 509 221],474,5,16848,4.219383921863261,20.0,0.0
7993,1,3993,[315 478 244 509 221],474,5,16853,4.21957936905358,20.0,0.0
7994,1,3994,[315 478 244 509 221],474,5,16858,4.219774718397997,20.0,0.0
7995,1,3995,[315 478 244 509 221],474,5,16863,4.21996996996997,20.0,0.0
7996,1,3996,[315 478 244 509 221],474,5,16868,4.220165123842882,20.0,0.0
7997,1,3997,[316 326 231 350 284],328,2,16870,4.2196098049024515,20.0,0.0
7998,1,3998,[212 261 264 239 394],13,3,16873,4.219304826206551,0.0,0.0
7999,1,3999,[268 227 232 222 264],13,3,16876,4.219,0.0,20.0
8000,2,0,[226 429 215 367 509],650,1,1,1.0,0.0,0.0
8001,2,1,[208 217 431 206 227],843,1,2,1.0,0.0,0.0
8002,2,2,[240 226 284 216 215],92,1,3,1.0,0.0,0.0
8003,2,3,[244 303 336 284 223],894,3,6,1.5,20.0,0.0
8004,2,4,[244 223 303 429 217],334,3,9,1.8,20.0,0.0
8005,2,5,[201 230 509 261 413],13,1,10,1.6666666666666667,0.0,0.0
8006,2,6,[226 220 202 275 216],648,4,14,2.0,0.0,20.0
8007,2,7,[429 303 202 275 223],343,5,19,2.375,20.0,20.0
8008,2,8,[481 217 384 230 508],13,0,19,2.111111111111111,0.0,0.0
8009,2,9,[212 301 316 507 509],85,3,22,2.2,20.0,0.0
8010,2,10,[301 507 202 275 429],13,2,24,2.1818181818181817,0.0,20.0
8011,2,11,[221 392 478 303 208],537,3,27,2.25,0.0,0.0
8012,2,12,[202 478 429 223 303],13,5,32,2.4615384615384617,20.0,0.0
8013,2,13,[202 478 429 223 303],409,4,36,2.5714285714285716,20.0,0.0
8014,2,14,[275 272 299 331 390],116,1,37,2.466666666666667,0.0,20.0
8015,2,15,[213 231 216 284 202],378,2,39,2.4375,0.0,0.0
8016,2,16,[276 420 291 321 216],892,4,43,2.5294117647058822,0.0,20.0
8017,2,17,[431 250 226 219 394],145,3,46,2.5555555555555554,0.0,0.0
8018,2,18,[378 481 216 219 283],234,2,48,2.526315789473684,0.0,0.0
8019,2,19,[280 420 241 202 264],13,4,52,2.6,0.0,0.0
8020,2,20,[223 429 378 321 478],234,2,54,2.5714285714285716,20.0,0.0
8021,2,21,[232 213 264 231 583],7,1,55,2.5,0.0,0.0
8022,2,22,[299 275 231 291 300],328,3,58,2.5217391304347827,0.0,40.0
8023,2,23,[378 268 217 231 213],7,2,60,2.5,0.0,0.0
8024,2,24,[507 431 212 485 213],537,3,63,2.52,0.0,0.0
8025,2,25,[275 298 295 301 244],486,2,65,2.5,0.0,20.0
8026,2,26,[452 220 291 219 295],648,2,67,2.4814814814814814,0.0,0.0
8027,2,27,[300 394 336 222 218],13,0,67,2.392857142857143,0.0,40.0
8028,2,28,[223 429 394 202 367],13,3,70,2.413793103448276,20.0,0.0
8029,2,29,[202 208 209 239 232],13,3,73,2.433333333333333,0.0,0.0
8030,2,30,[303 276 429 239 280],13,5,78,2.5161290322580645,0.0,20.0
8031,2,31,[303 276 429 239 280],13,5,83,2.59375,0.0,20.0
8032,2,32,[303 276 429 239 280],13,5,88,2.6666666666666665,0.0,20.0
8033,2,33,[303 276 429 239 280],13,5,93,2.735294117647059,0.0,20.0
8034,2,34,[303 276 429 239 280],13,5,98,2.8,0.0,20.0
8035,2,35,[226 284 212 221 508],524,3,101,2.8055555555555554,0.0,0.0
8036,2,36,[230 226 478 485 429],326,3,104,2.810810810810811,0.0,0.0
8037,2,37,[429 272 315 226 231],650,2,106,2.789473684210526,20.0,0.0
8038,2,38,[201 221 300 283 216],537,1,107,2.7435897435897436,0.0,20.0
8039,2,39,[283 215 276 275 298],378,4,111,2.775,0.0,40.0
8040,2,40,[218 209 299 222 367],13,0,111,2.707317073170732,0.0,20.0
8041,2,41,[298 291 293 236 222],533,3,114,2.7142857142857144,0.0,20.0
8042,2,42,[231 211 222 284 378],537,1,115,2.6744186046511627,0.0,40.0
8043,2,43,[378 284 508 222 392],537,1,116,2.6363636363636362,0.0,20.0
8044,2,44,[299 297 326 255 264],116,0,116,2.577777777777778,20.0,0.0
8045,2,45,[226 243 298 206 218],387,1,117,2.5434782608695654,0.0,0.0
8046,2,46,[202 507 259 227 201],7,1,118,2.5106382978723403,0.0,0.0
8047,2,47,[367 223 219 431 216],7,4,122,2.5416666666666665,20.0,0.0
8048,2,48,[227 485 276 509 209],311,2,124,2.5306122448979593,0.0,20.0
8049,2,49,[283 232 275 244 208],158,4,128,2.56,0.0,20.0
8050,2,50,[236 222 367 284 226],279,2,130,2.549019607843137,0.0,20.0
8051,2,51,[211 208 213 255 276],474,4,134,2.576923076923077,0.0,40.0
8052,2,52,[384 293 236 256 378],385,1,135,2.547169811320755,0.0,0.0
8053,2,53,[216 321 509 215 209],308,2,137,2.537037037037037,0.0,0.0
8054,2,54,[211 231 250 220 507],648,2,139,2.5272727272727273,0.0,20.0
8055,2,55,[350 227 222 485 268],13,2,141,2.517857142857143,0.0,20.0
8056,2,56,[507 246 223 216 202],6,3,144,2.526315789473684,20.0,0.0
8057,2,57,[509 350 394 222 209],13,1,145,2.5,0.0,20.0
8058,2,58,[230 216 429 239 283],279,3,148,2.5084745762711864,0.0,0.0
8059,2,59,[295 223 300 321 217],378,2,150,2.5,20.0,20.0
8060,2,60,[303 255 297 350 509],894,3,153,2.5081967213114753,20.0,0.0
8061,2,61,[303 217 336 231 208],13,2,155,2.5,0.0,0.0
8062,2,62,[216 478 261 217 241],13,1,156,2.4761904761904763,0.0,0.0
8063,2,63,[485 230 232 276 367],59,3,159,2.484375,0.0,20.0
8064,2,64,[268 246 293 256 272],894,3,162,2.4923076923076923,0.0,0.0
8065,2,65,[202 211 215 284 216],234,0,162,2.4545454545454546,0.0,20.0
8066,2,66,[208 378 303 509 485],537,3,165,2.462686567164179,0.0,0.0
8067,2,67,[276 367 299 331 272],13,2,167,2.4558823529411766,0.0,20.0
8068,2,68,[481 239 420 272 208],13,4,171,2.4782608695652173,0.0,0.0
8069,2,69,[213 508 212 226 283],537,3,174,2.4857142857142858,0.0,0.0
8070,2,70,[321 367 202 241 431],387,0,174,2.4507042253521125,0.0,0.0
8071,2,71,[215 216 213 254 321],308,1,175,2.4305555555555554,0.0,0.0
8072,2,72,[243 300 413 303 315],13,2,177,2.4246575342465753,20.0,20.0
8073,2,73,[232 481 208 223 507],7,4,181,2.445945945945946,20.0,0.0
8074,2,74,[315 227 331 268 222],145,4,185,2.466666666666667,20.0,20.0
8075,2,75,[350 431 209 336 299],13,0,185,2.4342105263157894,0.0,0.0
8076,2,76,[394 232 507 431 350],13,0,185,2.4025974025974026,0.0,0.0
8077,2,77,[231 208 365 227 241],200,5,190,2.4358974358974357,0.0,0.0
8078,2,78,[208 202 420 230 321],311,3,193,2.4430379746835444,0.0,0.0
8079,2,79,[303 315 321 291 259],537,2,195,2.4375,20.0,0.0
8080,2,80,[208 216 206 212 230],537,1,196,2.419753086419753,0.0,0.0
8081,2,81,[212 275 202 215 218],90,3,199,2.426829268292683,0.0,20.0
8082,2,82,[326 280 509 275 481],13,2,201,2.4216867469879517,0.0,20.0
8083,2,83,[208 378 211 259 509],7,4,205,2.4404761904761907,0.0,20.0
8084,2,84,[507 212 290 231 336],13,2,207,2.4352941176470586,0.0,0.0
8085,2,85,[227 232 276 485 230],194,0,207,2.4069767441860463,0.0,20.0
8086,2,86,[507 299 431 429 226],13,2,209,2.4022988505747125,0.0,0.0
8087,2,87,[202 236 478 301 291],666,4,213,2.4204545454545454,0.0,0.0
8088,2,88,[240 216 227 219 276],59,3,216,2.4269662921348316,0.0,20.0
8089,2,89,[291 420 218 208 202],200,4,220,2.4444444444444446,0.0,0.0
8090,2,90,[222 431 202 232 230],650,2,222,2.4395604395604398,0.0,20.0
8091,2,91,[221 272 509 283 336],894,3,225,2.4456521739130435,0.0,0.0
8092,2,92,[507 226 243 290 300],13,2,227,2.4408602150537635,0.0,20.0
8093,2,93,[222 211 202 275 291],279,2,229,2.4361702127659575,0.0,60.0
8094,2,94,[222 378 202 223 226],234,1,230,2.4210526315789473,20.0,20.0
8095,2,95,[227 331 291 232 275],328,3,233,2.4270833333333335,0.0,20.0
8096,2,96,[481 420 268 276 218],643,4,237,2.443298969072165,0.0,20.0
8097,2,97,[481 507 301 429 236],234,3,240,2.4489795918367347,0.0,0.0
8098,2,98,[378 215 509 209 202],537,2,242,2.4444444444444446,0.0,0.0
8099,2,99,[507 226 264 478 202],13,4,246,2.46,0.0,0.0
8100,2,100,[230 231 201 300 259],7,1,247,2.4455445544554455,0.0,20.0
8101,2,101,[365 215 217 216 420],378,3,250,2.450980392156863,0.0,0.0
8102,2,102,[413 299 509 429 243],13,2,252,2.4466019417475726,0.0,0.0
8103,2,103,[209 230 213 227 202],804,3,255,2.451923076923077,0.0,0.0
8104,2,104,[220 276 209 392 485],59,2,257,2.447619047619048,0.0,20.0
8105,2,105,[209 211 219 485 217],650,1,258,2.4339622641509435,0.0,20.0
8106,2,106,[336 315 217 394 507],13,1,259,2.4205607476635516,20.0,0.0
8107,2,107,[222 508 485 206 509],537,2,261,2.4166666666666665,0.0,20.0
8108,2,108,[230 299 239 429 331],13,2,263,2.4128440366972477,0.0,0.0
8109,2,109,[481 394 219 431 344],13,0,263,2.390909090909091,0.0,0.0
8110,2,110,[429 284 298 485 202],308,4,267,2.4054054054054053,0.0,0.0
8111,2,111,[298 331 326 324 221],116,1,268,2.392857142857143,0.0,0.0
8112,2,112,[429 290 250 239 303],334,2,270,2.3893805309734515,0.0,0.0
8113,2,113,[284 202 429 485 219],234,1,271,2.3771929824561404,0.0,0.0
8114,2,114,[384 392 202 217 275],64,2,273,2.373913043478261,0.0,20.0
8115,2,115,[509 478 218 413 243],13,2,275,2.3706896551724137,0.0,0.0
8116,2,116,[239 299 272 230 201],13,2,277,2.3675213675213675,0.0,0.0
8117,2,117,[222 209 215 216 230],85,2,279,2.364406779661017,0.0,20.0
8118,2,118,[316 221 222 208 255],334,4,283,2.3781512605042017,20.0,20.0
8119,2,119,[300 231 299 481 272],13,1,284,2.3666666666666667,0.0,20.0
8120,2,120,[211 231 212 431 230],804,4,288,2.3801652892561984,0.0,20.0
8121,2,121,[378 232 478 230 485],326,2,290,2.377049180327869,0.0,0.0
8122,2,122,[316 485 215 222 231],13,2,292,2.3739837398373984,20.0,20.0
8123,2,123,[239 226 215 452 509],650,0,292,2.3548387096774195,0.0,0.0
8124,2,124,[268 508 431 212 275],537,4,296,2.368,0.0,20.0
8125,2,125,[246 220 268 239 208],334,3,299,2.373015873015873,0.0,0.0
8126,2,126,[420 241 215 392 452],308,3,302,2.377952755905512,0.0,0.0
8127,2,127,[300 367 508 299 208],13,1,303,2.3671875,0.0,20.0
8128,2,128,[429 508 231 217 222],13,1,304,2.356589147286822,0.0,20.0
8129,2,129,[344 431 290 261 208],13,2,306,2.353846153846154,0.0,0.0
8130,2,130,[232 231 226 216 209],749,5,311,2.3740458015267176,0.0,0.0
8131,2,131,[315 283 321 226 206],537,2,313,2.371212121212121,20.0,0.0
8132,2,132,[508 227 276 509 316],13,4,317,2.3834586466165413,20.0,20.0
8133,2,133,[275 452 215 206 508],406,1,318,2.373134328358209,0.0,20.0
8134,2,134,[275 509 431 230 268],7,3,321,2.3777777777777778,0.0,20.0
8135,2,135,[212 290 201 216 231],13,2,323,2.375,0.0,0.0
8136,2,136,[316 478 202 268 227],13,5,328,2.394160583941606,20.0,0.0
8137,2,137,[230 231 324 211 219],7,1,329,2.3840579710144927,0.0,20.0
8138,2,138,[201 301 213 291 231],537,1,330,2.3741007194244603,0.0,0.0
8139,2,139,[272 217 336 350 201],13,1,331,2.3642857142857143,0.0,0.0
8140,2,140,[315 209 326 321 367],13,1,332,2.354609929078014,20.0,0.0
8141,2,141,[223 429 303 300 321],409,3,335,2.359154929577465,20.0,20.0
8142,2,142,[413 230 209 392 298],843,0,335,2.3426573426573425,0.0,0.0
8143,2,143,[226 291 221 303 215],537,1,336,2.3333333333333335,0.0,0.0
8144,2,144,[212 219 300 250 226],145,2,338,2.331034482758621,0.0,20.0
8145,2,145,[216 283 223 230 276],334,4,342,2.3424657534246576,20.0,20.0
8146,2,146,[226 217 367 202 378],650,0,342,2.326530612244898,0.0,0.0
8147,2,147,[216 259 215 221 284],474,4,346,2.3378378378378377,0.0,0.0
8148,2,148,[283 429 276 241 392],271,2,348,2.335570469798658,0.0,20.0
8149,2,149,[223 217 227 231 295],387,2,350,2.3333333333333335,20.0,0.0
8150,2,150,[211 300 226 222 276],537,2,352,2.3311258278145695,0.0,80.0
8151,2,151,[239 326 508 219 223],13,2,354,2.3289473684210527,20.0,0.0
8152,2,152,[202 299 272 243 241],537,1,355,2.320261437908497,0.0,0.0
8153,2,153,[236 230 268 431 222],145,4,359,2.331168831168831,0.0,20.0
8154,2,154,[255 301 250 324 315],334,2,361,2.329032258064516,20.0,0.0
8155,2,155,[507 202 230 429 211],308,4,365,2.33974358974359,0.0,20.0
8156,2,156,[272 222 431 299 276],537,3,368,2.343949044585987,0.0,40.0
8157,2,157,[261 264 215 295 216],479,0,368,2.329113924050633,0.0,0.0
8158,2,158,[315 218 220 227 244],334,1,369,2.3207547169811322,20.0,0.0
8159,2,159,[299 326 201 232 208],13,1,370,2.3125,0.0,0.0
8160,2,160,[275 290 218 231 239],334,1,371,2.3043478260869565,0.0,20.0
8161,2,161,[275 394 485 344 202],13,1,372,2.2962962962962963,0.0,20.0
8162,2,162,[221 213 275 478 246],85,3,375,2.3006134969325154,0.0,20.0
8163,2,163,[321 208 275 290 226],279,4,379,2.3109756097560976,0.0,20.0
8164,2,164,[220 250 431 218 226],92,3,382,2.315151515151515,0.0,0.0
8165,2,165,[365 208 239 431 215],804,5,387,2.3313253012048194,0.0,0.0
8166,2,166,[350 485 367 290 268],13,2,389,2.3293413173652695,0.0,0.0
8167,2,167,[478 290 264 336 217],13,3,392,2.3333333333333335,0.0,0.0
8168,2,168,[420 226 243 219 230],13,2,394,2.331360946745562,0.0,0.0
8169,2,169,[209 208 215 239 202],194,0,394,2.3176470588235296,0.0,0.0
8170,2,170,[303 301 211 290 299],13,3,397,2.3216374269005846,0.0,20.0
8171,2,171,[429 485 431 226 212],59,4,401,2.3313953488372094,0.0,0.0
8172,2,172,[280 251 268 221 324],486,3,404,2.3352601156069364,20.0,0.0
8173,2,173,[250 583 216 284 209],158,3,407,2.339080459770115,0.0,0.0
8174,2,174,[303 429 250 218 222],334,3,410,2.342857142857143,0.0,20.0
8175,2,175,[420 239 212 336 326],13,3,413,2.346590909090909,0.0,0.0
8176,2,176,[295 244 268 222 280],486,0,413,2.3333333333333335,0.0,20.0
8177,2,177,[276 508 394 202 219],13,2,415,2.331460674157303,0.0,20.0
8178,2,178,[230 222 202 378 303],533,5,420,2.346368715083799,0.0,20.0
8179,2,179,[276 429 209 326 223],409,4,424,2.3555555555555556,20.0,20.0
8180,2,180,[211 201 255 215 367],308,4,428,2.3646408839779007,0.0,20.0
8181,2,181,[231 481 478 300 222],85,2,430,2.3626373626373627,0.0,40.0
8182,2,182,[367 226 420 276 239],308,3,433,2.366120218579235,0.0,20.0
8183,2,183,[220 298 301 255 392],378,1,434,2.358695652173913,0.0,0.0
8184,2,184,[230 293 255 485 508],474,3,437,2.362162162162162,0.0,0.0
8185,2,185,[211 231 264 429 219],308,2,439,2.360215053763441,0.0,20.0
8186,2,186,[217 431 219 321 367],13,0,439,2.3475935828877006,0.0,0.0
8187,2,187,[259 420 509 293 211],308,4,443,2.356382978723404,0.0,20.0
8188,2,188,[300 216 227 240 280],749,4,447,2.365079365079365,0.0,20.0
8189,2,189,[227 202 231 291 240],749,4,451,2.373684210526316,0.0,0.0
8190,2,190,[326 268 350 384 222],13,1,452,2.3664921465968587,0.0,20.0
8191,2,191,[452 321 243 226 299],13,1,453,2.359375,0.0,0.0
8192,2,192,[208 259 507 201 241],537,2,455,2.3575129533678756,0.0,0.0
8193,2,193,[213 217 264 452 223],7,4,459,2.365979381443299,20.0,0.0
8194,2,194,[218 303 227 209 223],13,3,462,2.3692307692307693,20.0,0.0
8195,2,195,[211 208 254 209 241],308,4,466,2.377551020408163,0.0,20.0
8196,2,196,[215 507 254 256 219],385,1,467,2.3705583756345177,0.0,0.0
8197,2,197,[230 284 239 431 243],537,1,468,2.3636363636363638,0.0,0.0
8198,2,198,[350 303 321 384 222],13,1,469,2.35678391959799,0.0,20.0
8199,2,199,[283 230 222 216 509],85,1,470,2.35,0.0,20.0
8200,2,200,[378 230 227 431 217],295,5,475,2.36318407960199,0.0,0.0
8201,2,201,[485 367 216 211 202],311,2,477,2.3613861386138613,0.0,20.0
8202,2,202,[223 211 452 272 268],13,4,481,2.3694581280788176,20.0,20.0
8203,2,203,[326 275 508 218 209],13,0,481,2.357843137254902,0.0,20.0
8204,2,204,[276 261 202 212 303],13,4,485,2.3658536585365852,0.0,20.0
8205,2,205,[226 315 298 275 222],119,4,489,2.3737864077669903,20.0,40.0
8206,2,206,[301 250 284 240 243],552,1,490,2.367149758454106,0.0,0.0
8207,2,207,[215 509 481 223 209],643,3,493,2.3701923076923075,20.0,0.0
8208,2,208,[478 268 315 219 303],13,4,497,2.3779904306220097,20.0,0.0
8209,2,209,[384 201 485 217 509],13,1,498,2.3714285714285714,0.0,0.0
8210,2,210,[230 211 219 206 209],387,3,501,2.374407582938389,0.0,20.0
8211,2,211,[218 226 272 212 239],215,1,502,2.3679245283018866,0.0,0.0
8212,2,212,[431 201 284 222 202],279,3,505,2.3708920187793425,0.0,20.0
8213,2,213,[321 254 202 241 298],378,1,506,2.364485981308411,0.0,0.0
8214,2,214,[344 303 219 231 201],13,1,507,2.358139534883721,0.0,0.0
8215,2,215,[485 478 216 241 290],537,1,508,2.3518518518518516,0.0,0.0
8216,2,216,[509 261 452 272 431],13,2,510,2.3502304147465436,0.0,0.0
8217,2,217,[481 478 429 241 321],234,2,512,2.3486238532110093,0.0,0.0
8218,2,218,[202 212 219 316 275],145,3,515,2.3515981735159817,20.0,20.0
8219,2,219,[413 219 276 331 301],145,2,517,2.35,0.0,20.0
8220,2,220,[276 241 429 226 509],13,4,521,2.3574660633484164,0.0,20.0
8221,2,221,[222 413 280 219 384],13,1,522,2.3513513513513513,0.0,20.0
8222,2,222,[254 218 272 212 213],184,3,525,2.3542600896860986,0.0,0.0
8223,2,223,[201 301 268 431 232],13,1,526,2.3482142857142856,0.0,0.0
8224,2,224,[316 243 431 222 301],13,1,527,2.3422222222222224,20.0,20.0
8225,2,225,[216 276 215 208 378],533,4,531,2.349557522123894,0.0,20.0
8226,2,226,[212 239 215 272 478],537,2,533,2.3480176211453743,0.0,0.0
8227,2,227,[208 283 259 508 431],474,1,534,2.3421052631578947,0.0,0.0
8228,2,228,[259 431 236 241 209],537,2,536,2.3406113537117905,0.0,0.0
8229,2,229,[243 240 284 227 297],533,2,538,2.3391304347826085,20.0,0.0
8230,2,230,[295 213 246 336 236],894,3,541,2.341991341991342,0.0,0.0
8231,2,231,[215 264 209 201 295],479,2,543,2.3405172413793105,0.0,0.0
8232,2,232,[209 290 231 384 216],279,3,546,2.3433476394849784,0.0,0.0
8233,2,233,[222 367 241 250 232],158,3,549,2.3461538461538463,0.0,20.0
8234,2,234,[583 452 293 254 481],308,3,552,2.348936170212766,0.0,0.0
8235,2,235,[211 216 429 275 481],7,5,557,2.360169491525424,0.0,40.0
8236,2,236,[378 300 298 250 230],85,2,559,2.3586497890295357,0.0,20.0
8237,2,237,[226 295 392 509 219],308,2,561,2.357142857142857,0.0,0.0
8238,2,238,[221 290 315 222 213],537,2,563,2.3556485355648538,20.0,20.0
8239,2,239,[326 219 315 215 303],13,3,566,2.3583333333333334,20.0,0.0
8240,2,240,[259 212 275 283 378],537,2,568,2.3568464730290457,0.0,20.0
8241,2,241,[315 431 230 218 299],145,4,572,2.3636363636363638,20.0,0.0
8242,2,242,[231 218 227 250 219],804,4,576,2.3703703703703702,0.0,0.0
8243,2,243,[275 384 478 331 431],13,1,577,2.3647540983606556,0.0,20.0
8244,2,244,[367 219 478 326 507],13,1,578,2.3591836734693876,0.0,0.0
8245,2,245,[261 241 344 321 384],13,0,578,2.3495934959349594,0.0,0.0
8246,2,246,[226 209 218 429 331],13,2,580,2.348178137651822,0.0,0.0
8247,2,247,[507 211 206 230 303],537,3,583,2.350806451612903,0.0,20.0
8248,2,248,[300 350 227 272 218],102,1,584,2.3453815261044175,0.0,20.0
8249,2,249,[259 431 209 215 243],804,3,587,2.348,0.0,0.0
8250,2,250,[507 429 367 261 226],13,2,589,2.346613545816733,0.0,0.0
8251,2,251,[217 243 295 583 208],92,1,590,2.3412698412698414,0.0,0.0
8252,2,252,[508 215 241 315 243],13,2,592,2.3399209486166006,20.0,0.0
8253,2,253,[255 275 392 284 222],378,2,594,2.338582677165354,0.0,40.0
8254,2,254,[299 303 508 300 255],113,4,598,2.3450980392156864,0.0,20.0
8255,2,255,[212 290 231 239 413],804,4,602,2.3515625,0.0,0.0
8256,2,256,[202 201 230 295 208],387,1,603,2.3463035019455254,0.0,0.0
8257,2,257,[243 241 201 420 275],13,1,604,2.3410852713178296,0.0,20.0
8258,2,258,[255 223 241 365 220],378,3,607,2.3436293436293436,20.0,0.0
8259,2,259,[336 236 268 255 303],486,1,608,2.3384615384615386,0.0,0.0
8260,2,260,[216 227 230 275 218],60,5,613,2.3486590038314175,0.0,20.0
8261,2,261,[295 250 221 344 246],116,4,617,2.354961832061069,0.0,0.0
8262,2,262,[431 201 250 215 429],387,2,619,2.3536121673003803,0.0,0.0
8263,2,263,[202 431 264 452 315],13,3,622,2.356060606060606,20.0,0.0
8264,2,264,[508 244 216 431 326],474,3,625,2.358490566037736,0.0,0.0
8265,2,265,[219 509 293 218 215],308,3,628,2.3609022556390977,0.0,0.0
8266,2,266,[384 227 209 326 413],13,1,629,2.355805243445693,0.0,0.0
8267,2,267,[336 299 223 485 264],13,2,631,2.3544776119402986,20.0,0.0
8268,2,268,[240 326 232 222 485],749,3,634,2.356877323420074,0.0,20.0
8269,2,269,[321 283 208 223 259],308,2,636,2.3555555555555556,20.0,0.0
8270,2,270,[213 315 275 272 226],119,4,640,2.3616236162361623,20.0,20.0
8271,2,271,[254 420 275 220 300],378,3,643,2.363970588235294,0.0,40.0
8272,2,272,[290 413 429 291 231],804,5,648,2.3736263736263736,0.0,0.0
8273,2,273,[212 275 272 300 280],894,4,652,2.3795620437956204,0.0,40.0
8274,2,274,[222 211 230 241 301],102,0,652,2.370909090909091,0.0,40.0
8275,2,275,[213 251 209 478 316],144,4,656,2.3768115942028984,40.0,0.0
8276,2,276,[240 239 213 222 275],406,1,657,2.371841155234657,0.0,40.0
8277,2,277,[324 264 315 326 300],489,4,661,2.3776978417266186,20.0,20.0
8278,2,278,[452 321 367 219 211],308,2,663,2.3763440860215055,0.0,20.0
8279,2,279,[227 431 231 298 300],102,1,664,2.3714285714285714,0.0,20.0
8280,2,280,[217 216 219 367 478],13,1,665,2.3665480427046264,0.0,0.0
8281,2,281,[291 284 316 481 223],234,2,667,2.3652482269503547,40.0,0.0
8282,2,282,[485 201 303 216 290],13,2,669,2.363957597173145,0.0,0.0
8283,2,283,[509 217 232 300 230],13,1,670,2.359154929577465,0.0,20.0
8284,2,284,[221 216 227 275 208],334,3,673,2.3614035087719296,0.0,20.0
8285,2,285,[276 211 321 226 583],59,5,678,2.370629370629371,0.0,40.0
8286,2,286,[420 290 211 232 212],650,1,679,2.3658536585365852,0.0,20.0
8287,2,287,[208 212 213 272 211],537,4,683,2.3715277777777777,0.0,20.0
8288,2,288,[392 293 378 315 202],454,2,685,2.370242214532872,20.0,0.0
8289,2,289,[216 241 232 212 284],59,3,688,2.372413793103448,0.0,0.0
8290,2,290,[202 246 222 316 240],145,5,693,2.381443298969072,20.0,20.0
8291,2,291,[209 413 291 231 213],804,3,696,2.3835616438356166,0.0,0.0
8292,2,292,[299 297 246 350 331],116,1,697,2.378839590443686,20.0,0.0
8293,2,293,[223 222 301 291 250],455,1,698,2.3741496598639458,20.0,20.0
8294,2,294,[315 431 481 290 300],13,2,700,2.3728813559322033,20.0,20.0
8295,2,295,[241 509 299 272 326],13,2,702,2.3716216216216215,0.0,0.0
8296,2,296,[208 219 209 246 239],387,1,703,2.367003367003367,0.0,0.0
8297,2,297,[218 291 255 208 216],899,4,707,2.37248322147651,0.0,0.0
8298,2,298,[413 299 303 201 507],13,1,708,2.367892976588629,0.0,0.0
8299,2,299,[481 208 241 283 507],234,3,711,2.37,0.0,0.0
8300,2,300,[478 208 268 215 259],85,4,715,2.3754152823920265,0.0,0.0
8301,2,301,[212 218 290 272 216],650,2,717,2.3741721854304636,0.0,0.0
8302,2,302,[230 272 316 485 231],85,2,719,2.372937293729373,20.0,0.0
8303,2,303,[215 276 241 259 295],308,2,721,2.3717105263157894,0.0,20.0
8304,2,304,[223 275 202 217 295],378,2,723,2.3704918032786884,20.0,20.0
8305,2,305,[230 293 211 507 276],474,4,727,2.3758169934640523,0.0,40.0
8306,2,306,[212 213 211 300 219],7,2,729,2.3745928338762217,0.0,40.0
8307,2,307,[508 219 206 223 298],387,3,732,2.3766233766233764,20.0,0.0
8308,2,308,[303 429 326 208 485],334,3,735,2.378640776699029,0.0,0.0
8309,2,309,[243 201 216 208 284],537,1,736,2.3741935483870966,0.0,0.0
8310,2,310,[267 211 209 219 378],833,2,738,2.372990353697749,0.0,20.0
8311,2,311,[481 331 217 261 226],13,1,739,2.3685897435897436,0.0,0.0
8312,2,312,[264 365 216 208 209],308,2,741,2.36741214057508,0.0,0.0
8313,2,313,[508 236 275 300 240],533,4,745,2.372611464968153,0.0,40.0
8314,2,314,[241 239 222 315 209],883,1,746,2.3682539682539683,20.0,20.0
8315,2,315,[509 429 211 213 485],7,4,750,2.3734177215189876,0.0,20.0
8316,2,316,[301 481 264 212 241],13,2,752,2.3722397476340693,0.0,0.0
8317,2,317,[236 413 390 230 509],279,3,755,2.3742138364779874,0.0,0.0
8318,2,318,[240 280 216 284 222],374,2,757,2.373040752351097,0.0,20.0
8319,2,319,[209 276 509 478 315],474,5,762,2.38125,20.0,20.0
8320,2,320,[255 297 216 208 367],533,3,765,2.383177570093458,20.0,0.0
8321,2,321,[221 283 268 275 223],894,3,768,2.3850931677018634,20.0,20.0
8322,2,322,[250 283 230 301 208],279,3,771,2.386996904024768,0.0,0.0
8323,2,323,[218 222 326 241 239],311,2,773,2.3858024691358026,0.0,20.0
8324,2,324,[216 209 431 236 429],537,2,775,2.3846153846153846,0.0,0.0
8325,2,325,[220 303 507 276 509],90,5,780,2.392638036809816,0.0,20.0
8326,2,326,[429 384 316 413 331],13,2,782,2.3914373088685017,20.0,0.0
8327,2,327,[413 218 315 232 202],13,2,784,2.3902439024390243,20.0,0.0
8328,2,328,[241 367 509 276 394],13,2,786,2.3890577507598785,0.0,20.0
8329,2,329,[259 378 243 213 209],234,2,788,2.3878787878787877,0.0,0.0
8330,2,330,[241 420 276 230 239],378,3,791,2.389728096676737,0.0,20.0
8331,2,331,[243 384 394 230 326],13,0,791,2.3825301204819276,0.0,0.0
8332,2,332,[241 291 208 211 246],85,3,794,2.3843843843843846,0.0,20.0
8333,2,333,[420 276 365 226 216],311,4,798,2.3892215568862274,0.0,20.0
8334,2,334,[243 284 240 250 239],92,2,800,2.388059701492537,0.0,0.0
8335,2,335,[250 240 299 222 293],294,3,803,2.3898809523809526,0.0,20.0
8336,2,336,[275 261 211 420 212],13,3,806,2.391691394658754,0.0,40.0
8337,2,337,[201 231 202 243 431],387,1,807,2.3875739644970415,0.0,0.0
8338,2,338,[300 394 219 223 508],13,1,808,2.383480825958702,20.0,20.0
8339,2,339,[220 392 254 301 272],378,1,809,2.3794117647058823,0.0,0.0
8340,2,340,[230 392 211 212 243],59,3,812,2.3812316715542523,0.0,20.0
8341,2,341,[222 303 509 300 226],537,2,814,2.3801169590643276,0.0,40.0
8342,2,342,[243 508 300 216 321],13,0,814,2.373177842565598,0.0,20.0
8343,2,343,[276 420 264 392 283],308,3,817,2.375,0.0,20.0
8344,2,344,[218 326 216 231 272],13,1,818,2.371014492753623,0.0,0.0
8345,2,345,[507 485 259 384 212],7,2,820,2.3699421965317917,0.0,0.0
8346,2,346,[297 221 231 220 268],334,3,823,2.371757925072046,20.0,0.0
8347,2,347,[226 283 217 216 232],158,2,825,2.3706896551724137,0.0,0.0
8348,2,348,[222 297 221 300 303],334,4,829,2.3753581661891117,20.0,40.0
8349,2,349,[216 213 230 231 295],378,2,831,2.374285714285714,0.0,0.0
8350,2,350,[431 283 222 378 209],234,2,833,2.3732193732193734,0.0,20.0
8351,2,351,[222 321 230 216 378],892,5,838,2.3806818181818183,0.0,20.0
8352,2,352,[300 268 326 295 284],894,1,839,2.376770538243626,0.0,20.0
8353,2,353,[367 326 241 232 226],311,1,840,2.3728813559322033,0.0,0.0
8354,2,354,[276 331 295 336 316],894,3,843,2.3746478873239436,20.0,20.0
8355,2,355,[208 222 209 284 481],524,3,846,2.3764044943820224,0.0,20.0
8356,2,356,[507 206 223 378 301],650,2,848,2.3753501400560224,20.0,0.0
8357,2,357,[276 283 284 216 315],537,3,851,2.377094972067039,20.0,20.0
8358,2,358,[212 264 201 300 420],7,3,854,2.3788300835654597,0.0,20.0
8359,2,359,[212 344 336 326 508],13,1,855,2.375,0.0,0.0
8360,2,360,[290 481 301 239 223],13,3,858,2.376731301939058,20.0,0.0
8361,2,361,[275 209 431 241 392],95,1,859,2.3729281767955803,0.0,20.0
8362,2,362,[299 261 276 226 280],13,3,862,2.37465564738292,0.0,20.0
8363,2,363,[452 276 216 291 250],92,3,865,2.3763736263736264,0.0,20.0
8364,2,364,[227 219 208 201 211],774,2,867,2.3753424657534246,0.0,20.0
8365,2,365,[246 508 208 268 250],92,5,872,2.3825136612021858,0.0,0.0
8366,2,366,[583 201 232 481 275],7,2,874,2.3814713896457764,0.0,20.0
8367,2,367,[227 290 208 264 280],13,5,879,2.3885869565217392,0.0,0.0
8368,2,368,[227 218 226 217 211],102,1,880,2.3848238482384825,0.0,20.0
8369,2,369,[326 202 215 384 303],13,3,883,2.3864864864864863,0.0,0.0
8370,2,370,[219 223 218 275 344],13,1,884,2.3827493261455523,20.0,20.0
8371,2,371,[230 241 431 202 211],774,3,887,2.3844086021505375,0.0,20.0
8372,2,372,[211 485 350 300 481],13,1,888,2.3806970509383376,0.0,40.0
8373,2,373,[344 223 321 478 232],13,2,890,2.379679144385027,20.0,0.0
8374,2,374,[280 478 431 420 284],749,5,895,2.3866666666666667,0.0,0.0
8375,2,375,[290 268 300 236 255],894,2,897,2.3856382978723403,0.0,20.0
8376,2,376,[508 291 507 272 236],537,3,900,2.387267904509284,0.0,0.0
8377,2,377,[275 212 217 216 276],184,4,904,2.3915343915343916,0.0,40.0
8378,2,378,[230 272 261 321 209],13,1,905,2.387862796833773,0.0,0.0
8379,2,379,[508 208 299 206 301],537,2,907,2.386842105263158,0.0,0.0
8380,2,380,[208 246 239 272 255],334,3,910,2.388451443569554,0.0,0.0
8381,2,381,[431 276 231 230 344],13,1,911,2.384816753926702,0.0,20.0
8382,2,382,[276 478 222 211 508],406,4,915,2.3890339425587466,0.0,60.0
8383,2,383,[367 201 321 209 215],387,2,917,2.3880208333333335,0.0,0.0
8384,2,384,[212 218 222 223 261],13,2,919,2.387012987012987,20.0,20.0
8385,2,385,[226 429 583 239 246],387,1,920,2.383419689119171,0.0,0.0
8386,2,386,[485 209 232 290 507],650,1,921,2.37984496124031,0.0,0.0
8387,2,387,[431 344 218 241 216],328,3,924,2.381443298969072,0.0,0.0
8388,2,388,[213 211 222 206 208],804,3,927,2.3830334190231364,0.0,40.0
8389,2,389,[276 250 452 201 367],92,2,929,2.382051282051282,0.0,20.0
8390,2,390,[508 208 212 220 254],184,3,932,2.3836317135549874,0.0,0.0
8391,2,391,[275 276 291 250 508],455,3,935,2.385204081632653,0.0,40.0
8392,2,392,[384 431 226 259 231],7,2,937,2.3842239185750635,0.0,0.0
8393,2,393,[315 283 246 221 316],894,4,941,2.3883248730964466,40.0,0.0
8394,2,394,[272 384 227 431 300],13,2,943,2.3873417721518986,0.0,20.0
8395,2,395,[217 239 246 508 218],334,1,944,2.3838383838383836,0.0,0.0
8396,2,396,[231 208 293 283 254],308,2,946,2.3828715365239295,0.0,0.0
8397,2,397,[219 218 211 227 239],650,1,947,2.379396984924623,0.0,20.0
8398,2,398,[212 208 300 230 478],537,2,949,2.3784461152882206,0.0,20.0
8399,2,399,[212 507 378 211 208],537,3,952,2.38,0.0,20.0
8400,2,400,[315 215 231 291 241],328,3,955,2.3815461346633415,20.0,0.0
8401,2,401,[290 216 213 209 508],334,1,956,2.3781094527363185,0.0,0.0
8402,2,402,[201 208 478 367 300],13,2,958,2.3771712158808933,0.0,20.0
8403,2,403,[216 301 275 316 507],90,5,963,2.383663366336634,20.0,20.0
8404,2,404,[283 254 230 431 219],279,2,965,2.382716049382716,0.0,0.0
8405,2,405,[212 509 331 290 231],13,3,968,2.3842364532019706,0.0,0.0
8406,2,406,[223 350 290 272 218],13,3,971,2.385749385749386,20.0,0.0
8407,2,407,[276 223 378 275 321],308,3,974,2.3872549019607843,20.0,40.0
8408,2,408,[222 331 507 243 219],13,0,974,2.3814180929095357,0.0,20.0
8409,2,409,[255 283 276 298 275],458,4,978,2.3853658536585365,0.0,40.0
8410,2,410,[212 507 275 300 241],13,1,979,2.3819951338199514,0.0,40.0
8411,2,411,[216 420 429 232 243],650,2,981,2.3810679611650487,0.0,0.0
8412,2,412,[431 241 206 485 221],537,1,982,2.37772397094431,0.0,0.0
8413,2,413,[230 201 219 394 331],13,0,982,2.3719806763285023,0.0,0.0
8414,2,414,[222 413 331 230 481],13,0,982,2.366265060240964,0.0,20.0
8415,2,415,[485 283 420 276 509],308,3,985,2.3677884615384617,0.0,20.0
8416,2,416,[275 243 206 221 508],537,2,987,2.366906474820144,0.0,20.0
8417,2,417,[485 261 268 223 246],6,2,989,2.3660287081339715,20.0,0.0
8418,2,418,[213 232 365 211 259],7,2,991,2.3651551312649164,0.0,20.0
8419,2,419,[378 212 291 321 367],234,2,993,2.3642857142857143,0.0,0.0
8420,2,420,[315 231 206 316 219],650,1,994,2.36104513064133,40.0,0.0
8421,2,421,[268 384 326 239 243],13,2,996,2.360189573459716,0.0,0.0
8422,2,422,[227 290 283 241 298],158,3,999,2.3617021276595747,0.0,0.0
8423,2,423,[420 217 350 272 212],13,3,1002,2.3632075471698113,0.0,0.0
8424,2,424,[213 206 211 268 243],537,3,1005,2.364705882352941,0.0,20.0
8425,2,425,[223 429 280 209 298],749,5,1010,2.3708920187793425,20.0,0.0
8426,2,426,[218 365 259 241 429],308,3,1013,2.3723653395784545,0.0,0.0
8427,2,427,[241 230 215 284 485],59,3,1016,2.3738317757009346,0.0,0.0
8428,2,428,[227 431 222 230 216],13,1,1017,2.370629370629371,0.0,20.0
8429,2,429,[211 429 392 201 221],537,1,1018,2.3674418604651164,0.0,20.0
8430,2,430,[315 276 244 507 216],474,5,1023,2.3735498839907194,20.0,20.0
8431,2,431,[201 284 321 239 223],308,3,1026,2.375,20.0,0.0
8432,2,432,[284 232 215 227 218],59,2,1028,2.3741339491916857,0.0,0.0
8433,2,433,[508 290 275 297 236],894,3,1031,2.3755760368663594,20.0,20.0
8434,2,434,[208 316 222 230 236],334,5,1036,2.381609195402299,20.0,20.0
8435,2,435,[215 202 297 236 222],533,5,1041,2.3876146788990824,20.0,20.0
8436,2,436,[300 250 280 232 378],749,4,1045,2.391304347826087,0.0,20.0
8437,2,437,[217 231 321 509 222],13,1,1046,2.3881278538812785,0.0,20.0
8438,2,438,[300 344 316 243 326],13,1,1047,2.3849658314350797,20.0,20.0
8439,2,439,[211 420 452 231 202],308,3,1050,2.3863636363636362,0.0,20.0
8440,2,440,[344 384 303 272 264],13,3,1053,2.3877551020408165,0.0,0.0
8441,2,441,[350 478 394 321 275],13,1,1054,2.3846153846153846,0.0,20.0
8442,2,442,[300 231 507 299 275],13,0,1054,2.379232505643341,0.0,40.0
8443,2,443,[209 275 208 239 452],308,3,1057,2.380630630630631,0.0,20.0
8444,2,444,[485 301 227 392 509],378,2,1059,2.3797752808988766,0.0,0.0
8445,2,445,[202 431 275 299 301],13,1,1060,2.376681614349776,0.0,20.0
8446,2,446,[264 344 272 303 429],13,4,1064,2.3803131991051454,0.0,0.0
8447,2,447,[211 219 291 420 507],308,2,1066,2.3794642857142856,0.0,20.0
8448,2,448,[583 392 209 230 243],59,3,1069,2.3808463251670378,0.0,0.0
8449,2,449,[316 221 264 223 280],894,3,1072,2.382222222222222,40.0,0.0
8450,2,450,[201 222 236 275 413],279,3,1075,2.3835920177383594,0.0,40.0
8451,2,451,[216 280 236 208 223],234,1,1076,2.3805309734513274,20.0,0.0
8452,2,452,[222 218 208 211 202],194,2,1078,2.3796909492273732,0.0,40.0
8453,2,453,[226 378 299 272 508],537,2,1080,2.3788546255506606,0.0,0.0
8454,2,454,[218 331 232 303 367],13,1,1081,2.375824175824176,0.0,0.0
8455,2,455,[216 212 218 326 222],311,3,1084,2.3771929824561404,0.0,20.0
8456,2,456,[209 268 202 275 211],13,3,1087,2.3785557986870898,0.0,40.0
8457,2,457,[243 231 272 367 211],650,2,1089,2.3777292576419216,0.0,20.0
8458,2,458,[209 254 250 384 508],385,1,1090,2.374727668845316,0.0,0.0
8459,2,459,[219 208 213 201 232],7,1,1091,2.371739130434783,0.0,0.0
8460,2,460,[217 232 268 431 212],13,2,1093,2.370932754880694,0.0,0.0
8461,2,461,[394 215 201 299 208],13,2,1095,2.3701298701298703,0.0,0.0
8462,2,462,[226 211 452 431 295],648,4,1099,2.373650107991361,0.0,20.0
8463,2,463,[216 452 243 259 508],83,1,1100,2.3706896551724137,0.0,0.0
8464,2,464,[202 226 212 206 429],537,0,1100,2.3655913978494625,0.0,0.0
8465,2,465,[211 232 326 202 208],311,2,1102,2.3648068669527897,0.0,20.0
8466,2,466,[208 420 239 226 240],749,4,1106,2.3683083511777303,0.0,0.0
8467,2,467,[276 243 250 255 300],644,5,1111,2.373931623931624,0.0,40.0
8468,2,468,[478 216 508 275 212],524,3,1114,2.375266524520256,0.0,20.0
8469,2,469,[336 431 218 208 240],833,2,1116,2.374468085106383,0.0,0.0
8470,2,470,[241 378 283 219 507],308,1,1117,2.3715498938428876,0.0,0.0
8471,2,471,[202 216 297 298 291],533,4,1121,2.375,20.0,0.0
8472,2,472,[485 280 255 227 275],378,3,1124,2.376321353065539,0.0,20.0
8473,2,473,[216 206 222 217 290],650,3,1127,2.3776371308016877,0.0,20.0
8474,2,474,[211 321 216 223 213],234,0,1127,2.3726315789473684,20.0,20.0
8475,2,475,[231 209 481 431 509],13,1,1128,2.369747899159664,0.0,0.0
8476,2,476,[219 211 202 481 367],234,2,1130,2.368972746331237,0.0,20.0
8477,2,477,[300 452 231 293 215],774,0,1130,2.3640167364016738,0.0,20.0
8478,2,478,[268 217 209 350 384],13,1,1131,2.361169102296451,0.0,0.0
8479,2,479,[222 241 300 298 509],479,2,1133,2.3604166666666666,0.0,40.0
8480,2,480,[208 241 212 275 223],184,4,1137,2.363825363825364,20.0,20.0
8481,2,481,[276 507 227 508 316],13,3,1140,2.3651452282157677,20.0,20.0
8482,2,482,[284 212 431 485 507],406,1,1141,2.36231884057971,0.0,0.0
8483,2,483,[261 231 509 481 209],13,1,1142,2.3595041322314048,0.0,0.0
8484,2,484,[261 201 241 231 508],13,0,1142,2.354639175257732,0.0,0.0
8485,2,485,[272 481 219 321 394],13,1,1143,2.3518518518518516,0.0,0.0
8486,2,486,[276 507 221 283 293],474,4,1147,2.35523613963039,0.0,20.0
8487,2,487,[264 227 232 280 231],13,3,1150,2.3565573770491803,0.0,0.0
8488,2,488,[420 299 350 226 303],13,3,1153,2.357873210633947,0.0,0.0
8489,2,489,[212 291 208 239 202],92,4,1157,2.3612244897959185,0.0,0.0
8490,2,490,[336 452 291 267 264],833,0,1157,2.3564154786150713,0.0,0.0
8491,2,491,[315 202 217 507 478],13,3,1160,2.3577235772357725,20.0,0.0
8492,2,492,[293 365 216 213 431],346,1,1161,2.3549695740365113,0.0,0.0
8493,2,493,[219 212 276 240 222],92,4,1165,2.3582995951417005,0.0,40.0
8494,2,494,[508 212 218 216 220],82,2,1167,2.3575757575757574,0.0,0.0
8495,2,495,[324 507 208 481 485],7,4,1171,2.3608870967741935,0.0,0.0
8496,2,496,[272 227 481 315 201],13,3,1174,2.3621730382293764,20.0,0.0
8497,2,497,[299 420 243 209 481],13,1,1175,2.359437751004016,0.0,0.0
8498,2,498,[431 429 217 508 293],833,2,1177,2.3587174348697393,0.0,0.0
8499,2,499,[208 206 583 293 219],387,3,1180,2.36,0.0,0.0
8500,2,500,[452 420 211 212 217],7,4,1184,2.363273453093812,0.0,20.0
8501,2,501,[508 481 291 509 221],474,4,1188,2.366533864541833,0.0,0.0
8502,2,502,[321 507 485 215 429],234,2,1190,2.3658051689860833,0.0,0.0
8503,2,503,[452 509 431 215 485],406,0,1190,2.361111111111111,0.0,0.0
8504,2,504,[283 378 255 211 236],533,3,1193,2.3623762376237623,0.0,20.0
8505,2,505,[231 268 211 283 212],85,2,1195,2.3616600790513833,0.0,20.0
8506,2,506,[384 217 509 208 211],13,3,1198,2.3629191321499015,0.0,20.0
8507,2,507,[583 276 509 218 365],308,4,1202,2.3661417322834644,0.0,20.0
8508,2,508,[216 365 291 280 222],749,3,1205,2.3673870333988214,0.0,20.0
8509,2,509,[209 392 215 452 201],308,3,1208,2.368627450980392,0.0,0.0
8510,2,510,[255 217 272 485 300],334,1,1209,2.3659491193737767,0.0,20.0
8511,2,511,[326 507 413 508 213],195,2,1211,2.365234375,0.0,0.0
8512,2,512,[299 201 222 485 243],537,0,1211,2.3606237816764133,0.0,20.0
8513,2,513,[219 367 431 220 481],406,1,1212,2.357976653696498,0.0,0.0
8514,2,514,[509 291 478 392 420],200,4,1216,2.3611650485436892,0.0,0.0
8515,2,515,[509 268 336 256 283],894,1,1217,2.358527131782946,0.0,0.0
8516,2,516,[284 202 315 206 478],537,2,1219,2.357833655705996,20.0,0.0
8517,2,517,[216 231 384 507 283],385,0,1219,2.353281853281853,0.0,0.0
8518,2,518,[276 321 239 300 284],378,2,1221,2.352601156069364,0.0,40.0
8519,2,519,[509 365 301 321 230],378,1,1222,2.35,0.0,0.0
8520,2,520,[275 208 324 429 272],334,5,1227,2.3550863723608444,0.0,20.0
8521,2,521,[213 431 231 218 226],339,2,1229,2.3544061302681993,0.0,0.0
8522,2,522,[508 293 326 290 243],825,4,1233,2.35755258126195,0.0,0.0
8523,2,523,[272 241 300 209 350],13,1,1234,2.354961832061069,0.0,20.0
8524,2,524,[226 394 222 239 509],13,3,1237,2.356190476190476,0.0,20.0
8525,2,525,[481 303 315 244 208],334,4,1241,2.359315589353612,20.0,0.0
8526,2,526,[508 276 244 298 255],486,2,1243,2.3586337760910814,0.0,20.0
8527,2,527,[298 507 429 215 220],648,1,1244,2.356060606060606,0.0,0.0
8528,2,528,[507 344 230 331 201],13,0,1244,2.3516068052930055,0.0,0.0
8529,2,529,[299 509 315 508 481],13,2,1246,2.3509433962264152,20.0,0.0
8530,2,530,[201 223 219 509 264],7,3,1249,2.352165725047081,20.0,0.0
8531,2,531,[392 213 219 452 264],308,2,1251,2.351503759398496,0.0,0.0
8532,2,532,[208 485 420 264 290],13,4,1255,2.354596622889306,0.0,0.0
8533,2,533,[219 230 429 218 206],843,1,1256,2.352059925093633,0.0,0.0
8534,2,534,[429 268 231 321 478],13,3,1259,2.353271028037383,0.0,0.0
8535,2,535,[220 297 321 331 293],486,1,1260,2.3507462686567164,20.0,0.0
8536,2,536,[367 218 261 241 485],13,0,1260,2.346368715083799,0.0,0.0
8537,2,537,[227 230 250 202 240],92,1,1261,2.3438661710037176,0.0,0.0
8538,2,538,[208 209 222 226 202],234,2,1263,2.3432282003710574,0.0,20.0
8539,2,539,[272 509 301 241 215],90,4,1267,2.346296296296296,0.0,0.0
8540,2,540,[280 236 300 215 222],234,0,1267,2.3419593345656193,0.0,40.0
8541,2,541,[431 481 212 230 283],474,3,1270,2.3431734317343174,0.0,0.0
8542,2,542,[275 227 509 384 481],13,2,1272,2.342541436464088,0.0,20.0
8543,2,543,[276 429 230 243 239],537,1,1273,2.3400735294117645,0.0,20.0
8544,2,544,[291 452 481 259 226],308,1,1274,2.3376146788990826,0.0,0.0
8545,2,545,[420 213 481 297 303],934,5,1279,2.3424908424908426,20.0,0.0
8546,2,546,[324 255 264 413 268],294,2,1281,2.341864716636197,0.0,0.0
8547,2,547,[230 326 508 209 290],13,1,1282,2.3394160583941606,0.0,0.0
8548,2,548,[222 291 212 259 378],234,1,1283,2.336976320582878,0.0,20.0
8549,2,549,[213 276 485 209 284],6,3,1286,2.3381818181818184,0.0,20.0
8550,2,550,[481 301 213 236 226],234,1,1287,2.335753176043557,0.0,0.0
8551,2,551,[201 239 219 246 231],387,1,1288,2.3333333333333335,0.0,0.0
8552,2,552,[223 239 209 218 201],13,2,1290,2.332730560578662,20.0,0.0
8553,2,553,[218 219 222 239 216],13,1,1291,2.3303249097472922,0.0,20.0
8554,2,554,[236 218 231 244 429],334,2,1293,2.32972972972973,0.0,0.0
8555,2,555,[299 268 226 344 290],13,3,1296,2.3309352517985613,0.0,0.0
8556,2,556,[431 299 301 243 227],13,1,1297,2.3285457809694794,0.0,0.0
8557,2,557,[350 255 276 213 297],894,3,1300,2.3297491039426523,20.0,20.0
8558,2,558,[227 321 507 508 344],13,1,1301,2.32737030411449,0.0,0.0
8559,2,559,[326 485 216 261 321],13,0,1301,2.3232142857142857,0.0,0.0
8560,2,560,[208 508 367 293 218],533,2,1303,2.322638146167558,0.0,0.0
8561,2,561,[215 384 350 261 218],13,1,1304,2.320284697508897,0.0,0.0
8562,2,562,[429 222 283 218 290],234,1,1305,2.3179396092362343,0.0,20.0
8563,2,563,[243 230 216 226 431],804,4,1309,2.3209219858156027,0.0,0.0
8564,2,564,[227 276 508 216 222],13,2,1311,2.320353982300885,0.0,40.0
8565,2,565,[331 275 201 218 215],13,1,1312,2.3180212014134276,0.0,20.0
8566,2,566,[223 202 293 206 300],447,4,1316,2.3209876543209877,20.0,20.0
8567,2,567,[222 298 211 367 206],387,3,1319,2.3221830985915495,0.0,40.0
8568,2,568,[350 429 216 413 202],13,2,1321,2.321616871704745,0.0,0.0
8569,2,569,[429 218 219 222 392],843,1,1322,2.319298245614035,0.0,20.0
8570,2,570,[367 275 429 509 215],13,3,1325,2.320490367775832,0.0,20.0
8571,2,571,[215 211 481 212 216],90,4,1329,2.3234265734265733,0.0,20.0
8572,2,572,[226 230 208 232 202],194,0,1329,2.319371727748691,0.0,0.0
8573,2,573,[295 202 300 222 367],506,3,1332,2.3205574912891986,0.0,40.0
8574,2,574,[509 367 583 268 230],7,2,1334,2.32,0.0,0.0
8575,2,575,[227 230 218 250 413],648,2,1336,2.3194444444444446,0.0,0.0
8576,2,576,[429 241 481 336 508],13,1,1337,2.317157712305026,0.0,0.0
8577,2,577,[246 583 208 211 217],387,2,1339,2.3166089965397925,0.0,20.0
8578,2,578,[367 216 394 429 241],13,1,1340,2.31433506044905,0.0,0.0
8579,2,579,[222 303 394 227 201],13,2,1342,2.3137931034482757,0.0,20.0
8580,2,580,[243 216 378 241 259],537,0,1342,2.3098106712564546,0.0,0.0
8581,2,581,[275 213 264 231 481],7,3,1345,2.310996563573883,0.0,20.0
8582,2,582,[227 250 315 223 301],334,2,1347,2.3104631217838767,40.0,0.0
8583,2,583,[507 223 303 215 275],90,4,1351,2.3133561643835616,20.0,20.0
8584,2,584,[218 216 283 213 220],184,3,1354,2.3145299145299147,0.0,0.0
8585,2,585,[413 290 429 202 452],648,2,1356,2.3139931740614332,0.0,0.0
8586,2,586,[231 394 300 336 452],13,0,1356,2.3100511073253833,0.0,20.0
8587,2,587,[223 291 208 231 431],749,5,1361,2.314625850340136,20.0,0.0
8588,2,588,[239 431 301 230 236],537,1,1362,2.3123938879456705,0.0,0.0
8589,2,589,[283 226 236 213 508],537,3,1365,2.3135593220338984,0.0,0.0
8590,2,590,[208 284 478 231 246],85,3,1368,2.314720812182741,0.0,0.0
8591,2,591,[211 485 280 222 507],13,2,1370,2.314189189189189,0.0,40.0
8592,2,592,[350 344 485 215 223],13,2,1372,2.3136593591905563,20.0,0.0
8593,2,593,[326 301 227 367 268],13,2,1374,2.313131313131313,0.0,0.0
8594,2,594,[429 508 276 583 485],59,4,1378,2.315966386554622,0.0,20.0
8595,2,595,[301 429 290 209 230],537,1,1379,2.313758389261745,0.0,0.0
8596,2,596,[246 275 293 315 508],894,4,1383,2.3165829145728645,20.0,20.0
8597,2,597,[227 431 290 223 211],653,1,1384,2.31438127090301,20.0,20.0
8598,2,598,[201 367 336 394 300],13,0,1384,2.310517529215359,0.0,20.0
8599,2,599,[264 216 261 283 485],479,1,1385,2.308333333333333,0.0,0.0
8600,2,600,[208 227 507 250 230],648,3,1388,2.3094841930116474,0.0,0.0
8601,2,601,[243 291 508 206 431],537,2,1390,2.308970099667774,0.0,0.0
8602,2,602,[211 485 219 413 239],843,0,1390,2.3051409618573797,0.0,20.0
8603,2,603,[226 216 215 212 240],804,4,1394,2.30794701986755,0.0,0.0
8604,2,604,[208 275 216 215 420],843,0,1394,2.304132231404959,0.0,20.0
8605,2,605,[300 255 268 326 223],894,2,1396,2.3036303630363038,20.0,20.0
8606,2,606,[217 298 215 222 326],378,1,1397,2.301482701812191,0.0,20.0
8607,2,607,[212 508 275 211 290],13,3,1400,2.3026315789473686,0.0,40.0
8608,2,608,[478 208 232 240 243],897,4,1404,2.3054187192118225,0.0,0.0
8609,2,609,[507 429 509 272 243],650,3,1407,2.3065573770491805,0.0,0.0
8610,2,610,[213 211 485 208 316],474,4,1411,2.309328968903437,20.0,20.0
8611,2,611,[239 321 298 223 231],378,1,1412,2.30718954248366,20.0,0.0
8612,2,612,[231 275 284 378 226],308,2,1414,2.306688417618271,0.0,20.0
8613,2,613,[226 243 295 201 231],92,0,1414,2.3029315960912053,0.0,0.0
8614,2,614,[392 300 272 276 239],537,2,1416,2.3024390243902437,0.0,40.0
8615,2,615,[429 420 243 509 507],13,3,1419,2.3035714285714284,0.0,0.0
8616,2,616,[226 394 478 485 223],13,3,1422,2.304700162074554,20.0,0.0
8617,2,617,[241 219 216 420 213],308,3,1425,2.3058252427184467,0.0,0.0
8618,2,618,[298 452 293 291 508],833,3,1428,2.3069466882067853,0.0,0.0
8619,2,619,[241 213 324 431 216],7,3,1431,2.3080645161290323,0.0,0.0
8620,2,620,[485 301 226 218 300],13,1,1432,2.3059581320450886,0.0,20.0
8621,2,621,[478 420 219 272 215],13,4,1436,2.3086816720257235,0.0,0.0
8622,2,622,[367 509 429 268 452],7,4,1440,2.3113964686998396,0.0,0.0
8623,2,623,[202 413 240 250 231],279,3,1443,2.3125,0.0,0.0
8624,2,624,[452 315 222 509 478],650,2,1445,2.312,20.0,20.0
8625,2,625,[213 298 211 208 293],474,3,1448,2.313099041533546,0.0,20.0
8626,2,626,[485 378 420 241 211],95,3,1451,2.314194577352472,0.0,20.0
8627,2,627,[208 367 301 303 275],6,2,1453,2.3136942675159236,0.0,20.0
8628,2,628,[272 216 293 300 221],334,2,1455,2.313195548489666,0.0,20.0
8629,2,629,[509 213 215 239 299],537,2,1457,2.312698412698413,0.0,0.0
8630,2,630,[211 367 344 232 384],13,1,1458,2.3106180665610143,0.0,20.0
8631,2,631,[208 211 507 321 259],537,3,1461,2.3117088607594938,0.0,20.0
8632,2,632,[236 222 321 243 392],537,0,1461,2.308056872037915,0.0,20.0
8633,2,633,[209 300 485 211 326],409,2,1463,2.307570977917981,0.0,40.0
8634,2,634,[230 264 365 583 216],308,2,1465,2.3070866141732282,0.0,0.0
8635,2,635,[413 336 276 239 216],13,2,1467,2.306603773584906,0.0,20.0
8636,2,636,[508 336 420 413 429],13,2,1469,2.306122448979592,0.0,0.0
8637,2,637,[208 485 216 431 276],339,4,1473,2.3087774294670846,0.0,20.0
8638,2,638,[247 226 291 280 240],374,1,1474,2.3067292644757433,0.0,0.0
8639,2,639,[394 326 209 350 301],13,0,1474,2.303125,0.0,0.0
8640,2,640,[509 256 299 316 295],894,2,1476,2.3026521060842433,20.0,0.0
8641,2,641,[321 230 508 209 367],59,5,1481,2.3068535825545173,0.0,0.0
8642,2,642,[212 429 239 259 216],524,2,1483,2.3063763608087093,0.0,0.0
8643,2,643,[280 261 212 316 315],13,4,1487,2.309006211180124,40.0,0.0
8644,2,644,[509 481 507 478 431],932,3,1490,2.310077519379845,0.0,0.0
8645,2,645,[241 215 219 431 222],774,3,1493,2.3111455108359134,0.0,20.0
8646,2,646,[485 216 478 226 213],234,0,1493,2.3075734157650696,0.0,0.0
8647,2,647,[321 216 212 230 452],13,1,1494,2.3055555555555554,0.0,0.0
8648,2,648,[202 367 429 231 291],308,3,1497,2.3066255778120186,0.0,0.0
8649,2,649,[367 583 507 213 420],7,3,1500,2.3076923076923075,0.0,0.0
8650,2,650,[223 212 215 316 478],144,5,1505,2.3118279569892475,40.0,0.0
8651,2,651,[272 331 390 275 299],116,1,1506,2.3098159509202456,0.0,20.0
8652,2,652,[367 431 201 378 508],833,2,1508,2.3093415007656968,0.0,0.0
8653,2,653,[208 478 212 222 367],524,3,1511,2.3103975535168195,0.0,20.0
8654,2,654,[316 261 217 219 268],13,2,1513,2.3099236641221372,20.0,0.0
8655,2,655,[336 478 413 201 321],13,1,1514,2.307926829268293,0.0,0.0
8656,2,656,[301 226 429 211 485],650,2,1516,2.3074581430745815,0.0,20.0
8657,2,657,[218 276 283 316 478],234,1,1517,2.3054711246200608,20.0,20.0
8658,2,658,[481 232 431 264 218],13,1,1518,2.3034901365705616,0.0,0.0
8659,2,659,[429 485 301 344 420],13,2,1520,2.303030303030303,0.0,0.0
8660,2,660,[431 485 259 299 429],537,1,1521,2.301059001512859,0.0,0.0
8661,2,661,[431 223 230 378 290],653,1,1522,2.299093655589124,20.0,0.0
8662,2,662,[284 365 202 213 239],378,1,1523,2.2971342383107087,0.0,0.0
8663,2,663,[216 201 219 227 378],7,2,1525,2.2966867469879517,0.0,0.0
8664,2,664,[301 481 261 216 212],13,1,1526,2.294736842105263,0.0,0.0
8665,2,665,[420 226 211 231 268],13,4,1530,2.2972972972972974,0.0,20.0
8666,2,666,[227 230 209 208 215],311,4,1534,2.2998500749625186,0.0,0.0
8667,2,667,[216 250 276 275 212],184,5,1539,2.303892215568862,0.0,40.0
8668,2,668,[485 431 413 226 261],13,1,1540,2.301943198804185,0.0,0.0
8669,2,669,[222 275 509 227 344],13,2,1542,2.301492537313433,0.0,40.0
8670,2,670,[264 429 239 392 481],308,3,1545,2.302533532041729,0.0,0.0
8671,2,671,[331 300 326 222 316],328,4,1549,2.3050595238095237,20.0,40.0
8672,2,672,[217 227 239 230 290],13,3,1552,2.3060921248142643,0.0,0.0
8673,2,673,[272 452 239 481 485],13,2,1554,2.3056379821958455,0.0,0.0
8674,2,674,[367 326 336 212 226],13,2,1556,2.3051851851851852,0.0,0.0
8675,2,675,[326 336 219 218 276],13,1,1557,2.3032544378698225,0.0,20.0
8676,2,676,[507 259 218 301 485],234,1,1558,2.3013293943870017,0.0,0.0
8677,2,677,[239 280 509 431 508],13,3,1561,2.3023598820059,0.0,0.0
8678,2,678,[283 216 509 239 209],537,3,1564,2.303387334315169,0.0,0.0
8679,2,679,[212 217 431 290 413],13,2,1566,2.302941176470588,0.0,0.0
8680,2,680,[251 212 331 216 227],883,3,1569,2.303964757709251,20.0,0.0
8681,2,681,[509 276 213 212 431],537,4,1573,2.306451612903226,0.0,20.0
8682,2,682,[452 507 276 268 301],13,2,1575,2.3060029282576866,0.0,20.0
8683,2,683,[280 384 485 208 481],13,2,1577,2.3055555555555554,0.0,0.0
8684,2,684,[254 230 259 231 283],279,1,1578,2.3036496350364963,0.0,0.0
8685,2,685,[298 378 218 209 275],843,0,1578,2.3002915451895043,0.0,20.0
8686,2,686,[431 216 211 485 215],311,3,1581,2.3013100436681224,0.0,20.0
8687,2,687,[219 222 392 230 255],210,2,1583,2.300872093023256,0.0,20.0
8688,2,688,[272 481 508 208 216],6,4,1587,2.3033381712626997,0.0,0.0
8689,2,689,[264 215 208 227 280],13,5,1592,2.307246376811594,0.0,0.0
8690,2,690,[272 255 297 295 259],116,1,1593,2.305354558610709,20.0,0.0
8691,2,691,[209 217 215 350 276],13,2,1595,2.304913294797688,0.0,20.0
8692,2,692,[239 220 208 240 219],406,1,1596,2.303030303030303,0.0,0.0
8693,2,693,[255 216 268 230 244],334,2,1598,2.3025936599423633,0.0,0.0
8694,2,694,[321 216 485 215 239],311,2,1600,2.302158273381295,0.0,0.0
8695,2,695,[222 268 206 300 431],234,1,1601,2.300287356321839,0.0,40.0
8696,2,696,[431 326 413 478 218],13,1,1602,2.298421807747489,0.0,0.0
8697,2,697,[212 478 508 244 259],474,3,1605,2.299426934097421,0.0,0.0
8698,2,698,[227 276 211 216 298],533,4,1609,2.3018597997138768,0.0,40.0
8699,2,699,[246 268 208 222 218],387,1,1610,2.3,0.0,20.0
8700,2,700,[301 275 218 303 217],334,2,1612,2.2995720399429387,0.0,20.0
8701,2,701,[315 272 222 478 384],13,3,1615,2.3005698005698005,20.0,20.0
8702,2,702,[211 250 241 284 246],85,2,1617,2.3001422475106685,0.0,20.0
8703,2,703,[324 275 211 291 221],699,2,1619,2.299715909090909,0.0,40.0
8704,2,704,[241 232 222 219 208],387,1,1620,2.297872340425532,0.0,20.0
8705,2,705,[350 429 394 201 261],13,1,1621,2.2960339943342776,0.0,0.0
8706,2,706,[324 255 280 336 220],486,1,1622,2.294200848656294,0.0,0.0
8707,2,707,[321 216 301 315 211],318,5,1627,2.2980225988700567,20.0,20.0
8708,2,708,[507 431 212 201 211],13,2,1629,2.297602256699577,0.0,20.0
8709,2,709,[331 231 218 226 350],328,2,1631,2.297183098591549,0.0,0.0
8710,2,710,[211 215 208 255 315],318,4,1635,2.29957805907173,20.0,20.0
8711,2,711,[216 206 202 211 478],406,2,1637,2.2991573033707864,0.0,20.0
8712,2,712,[202 485 275 478 208],184,4,1641,2.3015427769985974,0.0,20.0
8713,2,713,[290 236 202 213 284],537,1,1642,2.299719887955182,0.0,0.0
8714,2,714,[485 507 509 478 211],13,3,1645,2.300699300699301,0.0,20.0
8715,2,715,[429 508 272 208 209],334,3,1648,2.3016759776536313,0.0,0.0
8716,2,716,[298 378 316 208 250],85,3,1651,2.302649930264993,20.0,0.0
8717,2,717,[232 221 231 212 208],85,1,1652,2.3008356545961,0.0,0.0
8718,2,718,[485 321 201 239 261],13,1,1653,2.299026425591099,0.0,0.0
8719,2,719,[239 429 321 268 213],537,2,1655,2.298611111111111,0.0,0.0
8720,2,720,[216 452 261 508 201],13,0,1655,2.2954230235783633,0.0,0.0
8721,2,721,[216 251 208 283 209],385,1,1656,2.293628808864266,20.0,0.0
8722,2,722,[303 272 276 315 509],537,5,1661,2.297372060857538,20.0,20.0
8723,2,723,[303 272 276 315 509],537,5,1666,2.3011049723756907,20.0,20.0
8724,2,724,[303 272 315 276 509],13,5,1671,2.3048275862068968,20.0,20.0
8725,2,725,[303 272 315 276 509],13,5,1676,2.3085399449035813,20.0,20.0
8726,2,726,[303 315 272 276 509],537,5,1681,2.312242090784044,20.0,20.0
8727,2,727,[303 315 272 276 509],537,5,1686,2.315934065934066,20.0,20.0
8728,2,728,[303 315 272 276 509],894,5,1691,2.319615912208505,20.0,20.0
8729,2,729,[303 315 272 276 509],13,5,1696,2.3232876712328765,20.0,20.0
8730,2,730,[303 315 272 276 509],537,5,1701,2.3269493844049247,20.0,20.0
8731,2,731,[303 315 272 276 509],894,5,1706,2.330601092896175,20.0,20.0
8732,2,732,[365 321 295 239 272],378,1,1707,2.328785811732606,0.0,0.0
8733,2,733,[303 315 272 276 509],537,5,1712,2.332425068119891,20.0,20.0
8734,2,734,[236 301 293 297 272],334,3,1715,2.3333333333333335,20.0,0.0
8735,2,735,[303 272 315 276 509],537,5,1720,2.3369565217391304,20.0,20.0
8736,2,736,[303 315 272 276 509],537,5,1725,2.340569877883311,20.0,20.0
8737,2,737,[303 315 272 276 509],13,5,1730,2.3441734417344176,20.0,20.0
8738,2,738,[303 315 272 276 509],13,5,1735,2.3477672530446547,20.0,20.0
8739,2,739,[303 315 272 276 509],894,5,1740,2.3513513513513513,20.0,20.0
8740,2,740,[303 315 272 276 509],894,5,1745,2.3549257759784075,20.0,20.0
8741,2,741,[303 315 272 276 509],537,5,1750,2.358490566037736,20.0,20.0
8742,2,742,[303 315 272 276 509],894,5,1755,2.3620457604306866,20.0,20.0
8743,2,743,[303 315 272 276 509],537,5,1760,2.3655913978494625,20.0,20.0
8744,2,744,[303 315 272 276 509],13,5,1765,2.3691275167785233,20.0,20.0
8745,2,745,[303 315 272 276 509],537,5,1770,2.3726541554959786,20.0,20.0
8746,2,746,[303 315 272 276 509],894,5,1775,2.3761713520749663,20.0,20.0
8747,2,747,[303 315 272 276 509],537,5,1780,2.379679144385027,20.0,20.0
8748,2,748,[303 315 272 276 509],13,5,1785,2.383177570093458,20.0,20.0
8749,2,749,[303 315 272 276 509],537,5,1790,2.3866666666666667,20.0,20.0
8750,2,750,[303 315 272 276 509],13,5,1795,2.3901464713715046,20.0,20.0
8751,2,751,[303 315 272 276 509],537,5,1800,2.393617021276596,20.0,20.0
8752,2,752,[303 315 272 276 509],894,5,1805,2.397078353253652,20.0,20.0
8753,2,753,[231 315 275 216 316],328,3,1808,2.3978779840848805,40.0,20.0
8754,2,754,[303 315 272 276 509],537,5,1813,2.4013245033112582,20.0,20.0
8755,2,755,[303 315 272 276 509],894,5,1818,2.4047619047619047,20.0,20.0
8756,2,756,[303 315 272 276 509],13,5,1823,2.408190224570674,20.0,20.0
8757,2,757,[303 315 272 276 509],894,5,1828,2.411609498680739,20.0,20.0
8758,2,758,[303 315 272 276 509],894,5,1833,2.4150197628458496,20.0,20.0
8759,2,759,[303 315 272 276 509],894,5,1838,2.418421052631579,20.0,20.0
8760,2,760,[303 315 272 276 509],13,5,1843,2.4218134034165573,20.0,20.0
8761,2,761,[508 220 250 293 303],334,1,1844,2.41994750656168,0.0,0.0
8762,2,762,[303 315 272 276 509],537,5,1849,2.4233289646133684,20.0,20.0
8763,2,763,[303 315 272 276 509],13,5,1854,2.426701570680628,20.0,20.0
8764,2,764,[303 315 272 276 509],537,5,1859,2.430065359477124,20.0,20.0
8765,2,765,[303 315 272 276 509],13,5,1864,2.433420365535248,20.0,20.0
8766,2,766,[303 315 272 276 509],894,5,1869,2.4367666232073013,20.0,20.0
8767,2,767,[303 315 272 276 509],537,5,1874,2.4401041666666665,20.0,20.0
8768,2,768,[303 315 272 276 509],13,5,1879,2.443433029908973,20.0,20.0
8769,2,769,[303 315 272 276 509],537,5,1884,2.446753246753247,20.0,20.0
8770,2,770,[303 315 272 276 509],537,5,1889,2.450064850843061,20.0,20.0
8771,2,771,[303 315 272 276 509],13,5,1894,2.4533678756476682,20.0,20.0
8772,2,772,[303 315 272 276 509],537,5,1899,2.4566623544631305,20.0,20.0
8773,2,773,[303 315 272 276 509],537,5,1904,2.4599483204134365,20.0,20.0
8774,2,774,[303 315 272 276 509],894,5,1909,2.463225806451613,20.0,20.0
8775,2,775,[303 315 272 276 509],13,5,1914,2.466494845360825,20.0,20.0
8776,2,776,[303 315 272 276 509],537,5,1919,2.46975546975547,20.0,20.0
8777,2,777,[303 315 272 276 509],537,5,1924,2.473007712082262,20.0,20.0
8778,2,778,[303 315 272 276 509],894,5,1929,2.4762516046213094,20.0,20.0
8779,2,779,[303 315 272 276 509],537,5,1934,2.4794871794871796,20.0,20.0
8780,2,780,[303 315 272 276 509],894,5,1939,2.4827144686299616,20.0,20.0
8781,2,781,[303 315 272 276 509],894,5,1944,2.4859335038363173,20.0,20.0
8782,2,782,[303 315 272 276 509],894,5,1949,2.4891443167305236,20.0,20.0
8783,2,783,[303 315 272 276 509],894,5,1954,2.49234693877551,20.0,20.0
8784,2,784,[303 315 272 276 509],537,5,1959,2.4955414012738855,20.0,20.0
8785,2,785,[303 315 272 276 509],13,5,1964,2.4987277353689565,20.0,20.0
8786,2,786,[303 315 272 276 509],13,5,1969,2.5019059720457433,20.0,20.0
8787,2,787,[303 315 272 276 509],537,5,1974,2.50507614213198,20.0,20.0
8788,2,788,[303 315 272 276 509],13,5,1979,2.508238276299113,20.0,20.0
8789,2,789,[303 315 272 276 509],894,5,1984,2.511392405063291,20.0,20.0
8790,2,790,[303 315 272 276 509],894,5,1989,2.5145385587863465,20.0,20.0
8791,2,791,[240 211 250 384 291],833,1,1990,2.5126262626262625,0.0,20.0
8792,2,792,[303 315 272 276 509],13,5,1995,2.5157629255989913,20.0,20.0
8793,2,793,[303 315 272 276 509],894,5,2000,2.5188916876574305,20.0,20.0
8794,2,794,[303 315 272 276 509],894,5,2005,2.5220125786163523,20.0,20.0
8795,2,795,[303 315 272 276 509],894,5,2010,2.5251256281407035,20.0,20.0
8796,2,796,[344 331 241 264 300],13,1,2011,2.523212045169385,0.0,20.0
8797,2,797,[303 315 272 276 509],894,5,2016,2.526315789473684,20.0,20.0
8798,2,798,[303 315 272 276 509],13,5,2021,2.5294117647058822,20.0,20.0
8799,2,799,[303 315 272 276 509],13,5,2026,2.5325,20.0,20.0
8800,2,800,[222 481 239 431 227],194,1,2027,2.530586766541823,0.0,20.0
8801,2,801,[303 315 272 276 509],894,5,2032,2.533665835411471,20.0,20.0
8802,2,802,[303 315 272 276 509],537,5,2037,2.5367372353673723,20.0,20.0
8803,2,803,[212 478 507 215 232],650,2,2039,2.5360696517412937,0.0,0.0
8804,2,804,[429 250 227 222 232],774,1,2040,2.5341614906832297,0.0,20.0
8805,2,805,[303 315 272 276 509],13,5,2045,2.5372208436724564,20.0,20.0
8806,2,806,[303 315 272 276 509],894,5,2050,2.540272614622057,20.0,20.0
8807,2,807,[303 315 272 276 509],537,5,2055,2.5433168316831685,20.0,20.0
8808,2,808,[303 315 272 276 509],894,5,2060,2.546353522867738,20.0,20.0
8809,2,809,[303 315 272 276 509],13,5,2065,2.549382716049383,20.0,20.0
8810,2,810,[303 315 272 276 509],13,5,2070,2.5524044389642415,20.0,20.0
8811,2,811,[222 243 303 230 275],537,2,2072,2.5517241379310347,0.0,40.0
8812,2,812,[303 315 272 276 509],13,5,2077,2.5547355473554734,20.0,20.0
8813,2,813,[303 315 272 276 509],537,5,2082,2.557739557739558,20.0,20.0
8814,2,814,[303 315 272 276 509],537,5,2087,2.5607361963190183,20.0,20.0
8815,2,815,[303 315 272 276 509],537,5,2092,2.5637254901960786,20.0,20.0
8816,2,816,[303 315 272 276 509],894,5,2097,2.566707466340269,20.0,20.0
8817,2,817,[303 315 272 276 509],894,5,2102,2.569682151589242,20.0,20.0
8818,2,818,[303 315 272 276 509],894,5,2107,2.572649572649573,20.0,20.0
8819,2,819,[303 315 272 276 509],537,5,2112,2.575609756097561,20.0,20.0
8820,2,820,[303 315 272 276 509],894,5,2117,2.5785627283800245,20.0,20.0
8821,2,821,[303 315 272 276 509],894,5,2122,2.5815085158150852,20.0,20.0
8822,2,822,[303 315 272 276 509],894,5,2127,2.5844471445929527,20.0,20.0
8823,2,823,[303 315 272 276 509],537,5,2132,2.587378640776699,20.0,20.0
8824,2,824,[303 315 272 276 509],537,5,2137,2.5903030303030303,20.0,20.0
8825,2,825,[303 315 272 276 509],13,5,2142,2.593220338983051,20.0,20.0
8826,2,826,[303 315 272 276 509],13,5,2147,2.596130592503023,20.0,20.0
8827,2,827,[303 315 272 276 509],894,5,2152,2.5990338164251208,20.0,20.0
8828,2,828,[303 315 272 276 509],537,5,2157,2.6019300361881785,20.0,20.0
8829,2,829,[303 315 272 276 509],537,5,2162,2.6048192771084335,20.0,20.0
8830,2,830,[303 315 272 276 509],13,5,2167,2.607701564380265,20.0,20.0
8831,2,831,[303 315 272 276 509],13,5,2172,2.610576923076923,20.0,20.0
8832,2,832,[303 315 272 276 509],894,5,2177,2.6134453781512605,20.0,20.0
8833,2,833,[303 315 272 276 509],537,5,2182,2.616306954436451,20.0,20.0
8834,2,834,[303 315 272 276 509],13,5,2187,2.6191616766467067,20.0,20.0
8835,2,835,[303 315 272 276 509],894,5,2192,2.6220095693779903,20.0,20.0
8836,2,836,[303 315 272 276 509],537,5,2197,2.6248506571087216,20.0,20.0
8837,2,837,[268 378 299 431 485],537,2,2199,2.624105011933174,0.0,0.0
8838,2,838,[303 315 272 276 509],894,5,2204,2.626936829558999,20.0,20.0
8839,2,839,[303 315 272 276 509],537,5,2209,2.6297619047619047,20.0,20.0
8840,2,840,[303 315 272 276 509],894,5,2214,2.632580261593341,20.0,20.0
8841,2,841,[303 315 272 276 509],13,5,2219,2.6353919239904986,20.0,20.0
8842,2,842,[303 315 272 276 509],13,5,2224,2.638196915776987,20.0,20.0
8843,2,843,[303 315 272 276 509],13,5,2229,2.640995260663507,20.0,20.0
8844,2,844,[303 315 272 276 509],13,5,2234,2.6437869822485207,20.0,20.0
8845,2,845,[303 315 272 276 509],537,5,2239,2.6465721040189125,20.0,20.0
8846,2,846,[303 315 272 276 509],894,5,2244,2.6493506493506493,20.0,20.0
8847,2,847,[303 315 272 276 509],13,5,2249,2.652122641509434,20.0,20.0
8848,2,848,[303 315 272 276 509],537,5,2254,2.6548881036513547,20.0,20.0
8849,2,849,[303 315 272 276 509],894,5,2259,2.6576470588235295,20.0,20.0
8850,2,850,[303 315 272 276 509],537,5,2264,2.660399529964747,20.0,20.0
8851,2,851,[303 315 272 276 509],894,5,2269,2.6631455399061035,20.0,20.0
8852,2,852,[303 315 272 276 509],894,5,2274,2.6658851113716295,20.0,20.0
8853,2,853,[303 315 272 276 509],537,5,2279,2.668618266978923,20.0,20.0
8854,2,854,[303 315 272 276 509],537,5,2284,2.6713450292397662,20.0,20.0
8855,2,855,[303 315 272 276 509],13,5,2289,2.6740654205607477,20.0,20.0
8856,2,856,[303 315 272 276 509],894,5,2294,2.676779463243874,20.0,20.0
8857,2,857,[303 315 272 276 509],894,5,2299,2.6794871794871793,20.0,20.0
8858,2,858,[303 315 272 276 509],894,5,2304,2.682188591385332,20.0,20.0
8859,2,859,[303 315 272 276 509],894,5,2309,2.6848837209302325,20.0,20.0
8860,2,860,[303 315 272 276 509],537,5,2314,2.6875725900116145,20.0,20.0
8861,2,861,[303 315 272 276 509],537,5,2319,2.6902552204176335,20.0,20.0
8862,2,862,[303 315 272 276 509],537,5,2324,2.6929316338354576,20.0,20.0
8863,2,863,[303 315 272 276 509],894,5,2329,2.6956018518518516,20.0,20.0
8864,2,864,[303 315 272 276 509],13,5,2334,2.698265895953757,20.0,20.0
8865,2,865,[303 315 272 276 509],13,5,2339,2.7009237875288683,20.0,20.0
8866,2,866,[303 315 272 276 509],537,5,2344,2.703575547866205,20.0,20.0
8867,2,867,[303 315 272 276 509],894,5,2349,2.706221198156682,20.0,20.0
8868,2,868,[303 315 272 276 509],894,5,2354,2.7088607594936707,20.0,20.0
8869,2,869,[303 315 272 276 509],537,5,2359,2.711494252873563,20.0,20.0
8870,2,870,[202 303 509 268 201],13,4,2363,2.7129735935706085,0.0,0.0
8871,2,871,[201 241 218 230 367],59,5,2368,2.7155963302752295,0.0,0.0
8872,2,872,[303 315 272 276 509],894,5,2373,2.718213058419244,20.0,20.0
8873,2,873,[303 315 272 276 509],13,5,2378,2.720823798627002,20.0,20.0
8874,2,874,[303 315 272 276 509],13,5,2383,2.7234285714285713,20.0,20.0
8875,2,875,[303 315 272 276 509],13,5,2388,2.7260273972602738,20.0,20.0
8876,2,876,[303 315 272 276 509],13,5,2393,2.7286202964652224,20.0,20.0
8877,2,877,[303 315 272 276 509],894,5,2398,2.7312072892938497,20.0,20.0
8878,2,878,[303 315 272 276 509],13,5,2403,2.733788395904437,20.0,20.0
8879,2,879,[303 315 272 276 509],894,5,2408,2.7363636363636363,20.0,20.0
8880,2,880,[303 315 272 276 509],537,5,2413,2.738933030646992,20.0,20.0
8881,2,881,[303 315 272 276 509],894,5,2418,2.741496598639456,20.0,20.0
8882,2,882,[303 315 272 276 509],13,5,2423,2.7440543601359004,20.0,20.0
8883,2,883,[303 315 272 276 509],894,5,2428,2.746606334841629,20.0,20.0
8884,2,884,[303 315 272 276 509],537,5,2433,2.7491525423728813,20.0,20.0
8885,2,885,[303 315 272 276 509],13,5,2438,2.7516930022573365,20.0,20.0
8886,2,886,[303 315 272 276 509],537,5,2443,2.754227733934611,20.0,20.0
8887,2,887,[303 315 272 276 509],537,5,2448,2.7567567567567566,20.0,20.0
8888,2,888,[303 315 272 276 509],537,5,2453,2.7592800899887515,20.0,20.0
8889,2,889,[303 315 272 276 509],537,5,2458,2.761797752808989,20.0,20.0
8890,2,890,[303 315 272 276 509],894,5,2463,2.7643097643097643,20.0,20.0
8891,2,891,[303 315 272 276 509],894,5,2468,2.766816143497758,20.0,20.0
8892,2,892,[226 239 431 509 232],13,3,2471,2.767077267637178,0.0,0.0
8893,2,893,[303 315 272 276 509],13,5,2476,2.7695749440715884,20.0,20.0
8894,2,894,[303 315 272 276 509],537,5,2481,2.7720670391061453,20.0,20.0
8895,2,895,[303 315 272 276 509],894,5,2486,2.7745535714285716,20.0,20.0
8896,2,896,[303 315 272 276 509],537,5,2491,2.7770345596432553,20.0,20.0
8897,2,897,[303 315 272 276 509],894,5,2496,2.779510022271715,20.0,20.0
8898,2,898,[303 315 272 276 509],894,5,2501,2.781979977753059,20.0,20.0
8899,2,899,[303 315 272 276 509],13,5,2506,2.7844444444444445,20.0,20.0
8900,2,900,[303 315 272 276 509],13,5,2511,2.786903440621532,20.0,20.0
8901,2,901,[303 315 272 276 509],13,5,2516,2.789356984478936,20.0,20.0
8902,2,902,[303 315 272 276 509],537,5,2521,2.7918050941306753,20.0,20.0
8903,2,903,[303 315 272 276 509],894,5,2526,2.7942477876106193,20.0,20.0
8904,2,904,[303 315 272 276 509],13,5,2531,2.796685082872928,20.0,20.0
8905,2,905,[303 315 272 276 509],13,5,2536,2.7991169977924946,20.0,20.0
8906,2,906,[303 315 272 276 509],537,5,2541,2.8015435501653805,20.0,20.0
8907,2,907,[254 223 321 485 284],378,2,2543,2.800660792951542,20.0,0.0
8908,2,908,[256 280 244 276 300],894,3,2546,2.800880088008801,0.0,40.0
8909,2,909,[303 315 272 276 509],13,5,2551,2.803296703296703,20.0,20.0
8910,2,910,[303 315 272 276 509],894,5,2556,2.805708013172338,20.0,20.0
8911,2,911,[303 315 272 276 509],537,5,2561,2.808114035087719,20.0,20.0
8912,2,912,[303 315 272 276 509],894,5,2566,2.810514786418401,20.0,20.0
8913,2,913,[303 315 272 276 509],13,5,2571,2.812910284463895,20.0,20.0
8914,2,914,[303 315 272 276 509],537,5,2576,2.8153005464480874,20.0,20.0
8915,2,915,[303 315 272 276 509],894,5,2581,2.817685589519651,20.0,20.0
8916,2,916,[303 315 272 276 509],537,5,2586,2.8200654307524538,20.0,20.0
8917,2,917,[303 315 272 276 509],537,5,2591,2.8224400871459694,20.0,20.0
8918,2,918,[303 315 272 276 509],13,5,2596,2.82480957562568,20.0,20.0
8919,2,919,[303 315 272 276 509],894,5,2601,2.8271739130434783,20.0,20.0
8920,2,920,[303 315 272 276 509],894,5,2606,2.8295331161780672,20.0,20.0
8921,2,921,[303 315 272 276 509],13,5,2611,2.831887201735358,20.0,20.0
8922,2,922,[303 315 272 276 509],537,5,2616,2.8342361863488623,20.0,20.0
8923,2,923,[303 315 272 276 509],894,5,2621,2.8365800865800868,20.0,20.0
8924,2,924,[303 315 272 276 509],537,5,2626,2.838918918918919,20.0,20.0
8925,2,925,[303 315 272 276 509],894,5,2631,2.8412526997840173,20.0,20.0
8926,2,926,[303 315 272 276 509],894,5,2636,2.843581445523193,20.0,20.0
8927,2,927,[303 315 272 276 509],13,5,2641,2.845905172413793,20.0,20.0
8928,2,928,[303 315 272 276 509],13,5,2646,2.8482238966630784,20.0,20.0
8929,2,929,[303 315 272 276 509],537,5,2651,2.850537634408602,20.0,20.0
8930,2,930,[303 315 272 276 509],537,5,2656,2.852846401718582,20.0,20.0
8931,2,931,[303 315 272 276 509],894,5,2661,2.8551502145922747,20.0,20.0
8932,2,932,[303 315 272 276 509],537,5,2666,2.857449088960343,20.0,20.0
8933,2,933,[303 315 272 276 509],13,5,2671,2.859743040685225,20.0,20.0
8934,2,934,[303 315 272 276 509],537,5,2676,2.862032085561497,20.0,20.0
8935,2,935,[303 315 272 276 509],537,5,2681,2.8643162393162394,20.0,20.0
8936,2,936,[303 315 272 276 509],537,5,2686,2.8665955176093916,20.0,20.0
8937,2,937,[303 315 272 276 509],537,5,2691,2.868869936034115,20.0,20.0
8938,2,938,[303 315 272 276 509],13,5,2696,2.8711395101171457,20.0,20.0
8939,2,939,[303 315 272 276 509],537,5,2701,2.873404255319149,20.0,20.0
8940,2,940,[303 315 272 276 509],13,5,2706,2.875664187035069,20.0,20.0
8941,2,941,[303 315 272 276 509],13,5,2711,2.8779193205944797,20.0,20.0
8942,2,942,[303 315 272 276 509],537,5,2716,2.88016967126193,20.0,20.0
8943,2,943,[303 315 272 276 509],13,5,2721,2.882415254237288,20.0,20.0
8944,2,944,[303 315 272 276 509],537,5,2726,2.8846560846560845,20.0,20.0
8945,2,945,[303 315 272 276 509],537,5,2731,2.886892177589852,20.0,20.0
8946,2,946,[303 315 272 276 509],13,5,2736,2.8891235480464625,20.0,20.0
8947,2,947,[303 315 272 276 509],13,5,2741,2.8913502109704643,20.0,20.0
8948,2,948,[303 315 272 276 509],537,5,2746,2.8935721812434143,20.0,20.0
8949,2,949,[303 315 272 276 509],537,5,2751,2.8957894736842107,20.0,20.0
8950,2,950,[303 315 272 276 509],537,5,2756,2.898002103049422,20.0,20.0
8951,2,951,[303 315 272 276 509],537,5,2761,2.9002100840336134,20.0,20.0
8952,2,952,[303 315 272 276 509],894,5,2766,2.9024134312696748,20.0,20.0
8953,2,953,[303 315 272 276 509],13,5,2771,2.9046121593291403,20.0,20.0
8954,2,954,[303 315 272 276 509],13,5,2776,2.906806282722513,20.0,20.0
8955,2,955,[303 315 272 276 509],894,5,2781,2.9089958158995817,20.0,20.0
8956,2,956,[303 315 272 276 509],537,5,2786,2.911180773249739,20.0,20.0
8957,2,957,[303 315 272 276 509],537,5,2791,2.9133611691022963,20.0,20.0
8958,2,958,[218 211 208 201 226],387,2,2793,2.9124087591240877,0.0,20.0
8959,2,959,[303 315 272 276 509],537,5,2798,2.9145833333333333,20.0,20.0
8960,2,960,[303 315 272 276 509],13,5,2803,2.9167533818938605,20.0,20.0
8961,2,961,[303 315 272 276 509],537,5,2808,2.918918918918919,20.0,20.0
8962,2,962,[303 315 272 276 509],894,5,2813,2.921079958463136,20.0,20.0
8963,2,963,[303 315 272 276 509],537,5,2818,2.9232365145228214,20.0,20.0
8964,2,964,[211 508 254 208 226],774,0,2818,2.9202072538860104,0.0,20.0
8965,2,965,[303 315 272 276 509],537,5,2823,2.922360248447205,20.0,20.0
8966,2,966,[303 315 272 276 509],13,5,2828,2.9245087900723887,20.0,20.0
8967,2,967,[303 315 272 276 509],537,5,2833,2.9266528925619837,20.0,20.0
8968,2,968,[303 315 272 276 509],13,5,2838,2.928792569659443,20.0,20.0
8969,2,969,[303 315 272 276 509],13,5,2843,2.930927835051546,20.0,20.0
8970,2,970,[303 315 272 276 509],537,5,2848,2.933058702368692,20.0,20.0
8971,2,971,[303 315 272 276 509],537,5,2853,2.935185185185185,20.0,20.0
8972,2,972,[303 315 272 276 509],894,5,2858,2.9373072970195273,20.0,20.0
8973,2,973,[202 365 215 201 264],308,2,2860,2.9363449691991788,0.0,0.0
8974,2,974,[303 315 272 276 509],537,5,2865,2.9384615384615387,20.0,20.0
8975,2,975,[303 315 272 276 509],13,5,2870,2.9405737704918034,20.0,20.0
8976,2,976,[303 315 272 276 509],894,5,2875,2.9426816786079835,20.0,20.0
8977,2,977,[303 315 272 276 509],537,5,2880,2.9447852760736195,20.0,20.0
8978,2,978,[303 315 272 276 509],13,5,2885,2.9468845760980593,20.0,20.0
8979,2,979,[303 315 272 276 509],894,5,2890,2.9489795918367347,20.0,20.0
8980,2,980,[303 315 272 276 509],13,5,2895,2.9510703363914375,20.0,20.0
8981,2,981,[303 315 272 276 509],537,5,2900,2.9531568228105907,20.0,20.0
8982,2,982,[303 315 272 276 509],894,5,2905,2.955239064089522,20.0,20.0
8983,2,983,[303 315 272 276 509],537,5,2910,2.957317073170732,20.0,20.0
8984,2,984,[303 315 272 276 509],537,5,2915,2.9593908629441623,20.0,20.0
8985,2,985,[303 315 272 276 509],13,5,2920,2.9614604462474645,20.0,20.0
8986,2,986,[303 315 272 276 509],894,5,2925,2.9635258358662613,20.0,20.0
8987,2,987,[303 315 272 276 509],13,5,2930,2.965587044534413,20.0,20.0
8988,2,988,[303 315 272 276 509],894,5,2935,2.967644084934277,20.0,20.0
8989,2,989,[303 315 272 276 509],894,5,2940,2.9696969696969697,20.0,20.0
8990,2,990,[303 315 272 276 509],894,5,2945,2.971745711402624,20.0,20.0
8991,2,991,[217 378 429 431 223],7,5,2950,2.973790322580645,20.0,0.0
8992,2,992,[303 315 272 276 509],13,5,2955,2.97583081570997,20.0,20.0
8993,2,993,[303 315 272 276 509],894,5,2960,2.977867203219316,20.0,20.0
8994,2,994,[303 315 272 276 509],894,5,2965,2.979899497487437,20.0,20.0
8995,2,995,[303 315 272 276 509],13,5,2970,2.9819277108433737,20.0,20.0
8996,2,996,[303 315 272 276 509],894,5,2975,2.9839518555667,20.0,20.0
8997,2,997,[303 315 272 276 509],537,5,2980,2.9859719438877756,20.0,20.0
8998,2,998,[420 211 268 275 219],7,3,2983,2.985985985985986,0.0,40.0
8999,2,999,[290 231 209 208 298],158,3,2986,2.986,0.0,0.0
9000,2,1000,[303 315 272 276 509],894,5,2991,2.988011988011988,20.0,20.0
9001,2,1001,[367 218 221 236 211],234,1,2992,2.9860279441117763,0.0,20.0
9002,2,1002,[303 315 272 276 509],13,5,2997,2.988035892323031,20.0,20.0
9003,2,1003,[303 315 272 276 509],13,5,3002,2.99003984063745,20.0,20.0
9004,2,1004,[303 315 272 276 509],894,5,3007,2.992039800995025,20.0,20.0
9005,2,1005,[303 315 272 276 509],894,5,3012,2.99403578528827,20.0,20.0
9006,2,1006,[303 315 272 276 509],894,5,3017,2.9960278053624627,20.0,20.0
9007,2,1007,[303 315 272 276 509],13,5,3022,2.998015873015873,20.0,20.0
9008,2,1008,[230 209 216 211 303],537,3,3025,2.9980178394449952,0.0,20.0
9009,2,1009,[303 315 272 276 509],13,5,3030,3.0,20.0,20.0
9010,2,1010,[303 315 272 276 509],894,5,3035,3.0019782393669634,20.0,20.0
9011,2,1011,[303 315 272 276 509],894,5,3040,3.0039525691699605,20.0,20.0
9012,2,1012,[303 315 272 276 509],13,5,3045,3.005923000987167,20.0,20.0
9013,2,1013,[303 315 272 276 509],13,5,3050,3.007889546351085,20.0,20.0
9014,2,1014,[303 315 272 276 509],537,5,3055,3.0098522167487687,20.0,20.0
9015,2,1015,[303 315 272 276 509],13,5,3060,3.0118110236220472,20.0,20.0
9016,2,1016,[303 315 272 276 509],894,5,3065,3.0137659783677484,20.0,20.0
9017,2,1017,[303 315 272 276 509],537,5,3070,3.0157170923379173,20.0,20.0
9018,2,1018,[303 315 272 276 509],894,5,3075,3.017664376840039,20.0,20.0
9019,2,1019,[303 315 272 276 509],537,5,3080,3.019607843137255,20.0,20.0
9020,2,1020,[303 315 272 276 509],537,5,3085,3.0215475024485796,20.0,20.0
9021,2,1021,[303 315 272 276 509],13,5,3090,3.0234833659491196,20.0,20.0
9022,2,1022,[303 315 272 276 509],894,5,3095,3.0254154447702835,20.0,20.0
9023,2,1023,[303 315 272 276 509],894,5,3100,3.02734375,20.0,20.0
9024,2,1024,[303 315 272 276 509],537,5,3105,3.029268292682927,20.0,20.0
9025,2,1025,[303 315 272 276 509],894,5,3110,3.0311890838206628,20.0,20.0
9026,2,1026,[303 315 272 276 509],13,5,3115,3.033106134371957,20.0,20.0
9027,2,1027,[303 315 272 276 509],894,5,3120,3.035019455252918,20.0,20.0
9028,2,1028,[303 315 272 276 509],13,5,3125,3.0369290573372205,20.0,20.0
9029,2,1029,[303 315 272 276 509],537,5,3130,3.0388349514563107,20.0,20.0
9030,2,1030,[303 315 272 276 509],537,5,3135,3.040737148399612,20.0,20.0
9031,2,1031,[303 315 272 276 509],894,5,3140,3.0426356589147288,20.0,20.0
9032,2,1032,[303 315 272 276 509],537,5,3145,3.0445304937076476,20.0,20.0
9033,2,1033,[303 315 272 276 509],537,5,3150,3.04642166344294,20.0,20.0
9034,2,1034,[303 315 272 276 509],537,5,3155,3.0483091787439616,20.0,20.0
9035,2,1035,[303 315 272 276 509],894,5,3160,3.0501930501930503,20.0,20.0
9036,2,1036,[303 315 272 276 509],894,5,3165,3.052073288331726,20.0,20.0
9037,2,1037,[303 315 272 276 509],894,5,3170,3.0539499036608864,20.0,20.0
9038,2,1038,[303 315 272 276 509],894,5,3175,3.055822906641001,20.0,20.0
9039,2,1039,[303 315 272 276 509],537,5,3180,3.0576923076923075,20.0,20.0
9040,2,1040,[303 315 272 276 509],894,5,3185,3.059558117195005,20.0,20.0
9041,2,1041,[303 315 272 276 509],13,5,3190,3.0614203454894433,20.0,20.0
9042,2,1042,[303 315 272 276 509],13,5,3195,3.0632790028763184,20.0,20.0
9043,2,1043,[303 315 272 276 509],13,5,3200,3.0651340996168583,20.0,20.0
9044,2,1044,[303 315 272 276 509],537,5,3205,3.0669856459330145,20.0,20.0
9045,2,1045,[303 315 272 276 509],537,5,3210,3.068833652007648,20.0,20.0
9046,2,1046,[303 315 272 276 509],894,5,3215,3.0706781279847184,20.0,20.0
9047,2,1047,[303 315 272 276 509],537,5,3220,3.072519083969466,20.0,20.0
9048,2,1048,[303 315 272 276 509],13,5,3225,3.0743565300285987,20.0,20.0
9049,2,1049,[303 315 272 276 509],894,5,3230,3.0761904761904764,20.0,20.0
9050,2,1050,[303 315 272 276 509],13,5,3235,3.0780209324452903,20.0,20.0
9051,2,1051,[303 315 272 276 509],13,5,3240,3.079847908745247,20.0,20.0
9052,2,1052,[303 315 272 276 509],537,5,3245,3.0816714150047484,20.0,20.0
9053,2,1053,[303 315 272 276 509],537,5,3250,3.0834914611005693,20.0,20.0
9054,2,1054,[303 315 272 276 509],13,5,3255,3.085308056872038,20.0,20.0
9055,2,1055,[303 315 272 276 509],13,5,3260,3.087121212121212,20.0,20.0
9056,2,1056,[303 315 272 276 509],537,5,3265,3.088930936613056,20.0,20.0
9057,2,1057,[303 315 272 276 509],13,5,3270,3.0907372400756143,20.0,20.0
9058,2,1058,[303 315 272 276 509],537,5,3275,3.0925401322001886,20.0,20.0
9059,2,1059,[303 315 272 276 509],13,5,3280,3.0943396226415096,20.0,20.0
9060,2,1060,[303 315 272 276 509],13,5,3285,3.0961357210179075,20.0,20.0
9061,2,1061,[303 315 272 276 509],13,5,3290,3.097928436911488,20.0,20.0
9062,2,1062,[303 315 272 276 509],894,5,3295,3.099717779868297,20.0,20.0
9063,2,1063,[303 315 272 276 509],13,5,3300,3.101503759398496,20.0,20.0
9064,2,1064,[303 315 272 276 509],13,5,3305,3.103286384976526,20.0,20.0
9065,2,1065,[303 315 272 276 509],894,5,3310,3.1050656660412757,20.0,20.0
9066,2,1066,[236 283 230 315 239],334,4,3314,3.105904404873477,20.0,0.0
9067,2,1067,[303 315 272 276 509],537,5,3319,3.107677902621723,20.0,20.0
9068,2,1068,[303 315 272 276 509],13,5,3324,3.109448082319925,20.0,20.0
9069,2,1069,[303 315 272 276 509],894,5,3329,3.111214953271028,20.0,20.0
9070,2,1070,[303 315 272 276 509],537,5,3334,3.1129785247432307,20.0,20.0
9071,2,1071,[272 215 226 216 230],479,2,3336,3.111940298507463,0.0,0.0
9072,2,1072,[303 315 272 276 509],13,5,3341,3.113699906803355,20.0,20.0
9073,2,1073,[303 315 272 276 509],537,5,3346,3.1154562383612663,20.0,20.0
9074,2,1074,[303 315 272 276 509],13,5,3351,3.1172093023255814,20.0,20.0
9075,2,1075,[303 315 272 276 509],537,5,3356,3.1189591078066914,20.0,20.0
9076,2,1076,[303 315 272 276 509],537,5,3361,3.1207056638811514,20.0,20.0
9077,2,1077,[303 315 272 276 509],13,5,3366,3.122448979591837,20.0,20.0
9078,2,1078,[250 276 485 227 240],339,4,3370,3.123262279888786,0.0,20.0
9079,2,1079,[303 315 272 276 509],894,5,3375,3.125,20.0,20.0
9080,2,1080,[303 315 272 276 509],13,5,3380,3.1267345050878816,20.0,20.0
9081,2,1081,[303 315 272 276 509],537,5,3385,3.1284658040665434,20.0,20.0
9082,2,1082,[303 315 272 276 509],13,5,3390,3.1301939058171744,20.0,20.0
9083,2,1083,[303 315 272 276 509],894,5,3395,3.1319188191881917,20.0,20.0
9084,2,1084,[303 315 272 276 509],13,5,3400,3.133640552995392,20.0,20.0
9085,2,1085,[303 315 272 276 509],13,5,3405,3.1353591160220993,20.0,20.0
9086,2,1086,[303 315 272 276 509],13,5,3410,3.137074517019319,20.0,20.0
9087,2,1087,[303 315 272 276 509],13,5,3415,3.1387867647058822,20.0,20.0
9088,2,1088,[303 315 272 276 509],894,5,3420,3.1404958677685952,20.0,20.0
9089,2,1089,[303 315 272 276 509],13,5,3425,3.1422018348623855,20.0,20.0
9090,2,1090,[303 315 272 276 509],894,5,3430,3.1439046746104493,20.0,20.0
9091,2,1091,[303 315 272 276 509],537,5,3435,3.1456043956043955,20.0,20.0
9092,2,1092,[303 315 272 276 509],537,5,3440,3.1473010064043914,20.0,20.0
9093,2,1093,[303 315 272 276 509],894,5,3445,3.148994515539305,20.0,20.0
9094,2,1094,[303 315 272 276 509],13,5,3450,3.1506849315068495,20.0,20.0
9095,2,1095,[303 315 272 276 509],13,5,3455,3.1523722627737225,20.0,20.0
9096,2,1096,[303 315 272 276 509],13,5,3460,3.1540565177757522,20.0,20.0
9097,2,1097,[303 315 272 276 509],537,5,3465,3.1557377049180326,20.0,20.0
9098,2,1098,[303 315 272 276 509],537,5,3470,3.1574158325750683,20.0,20.0
9099,2,1099,[303 315 272 276 509],13,5,3475,3.159090909090909,20.0,20.0
9100,2,1100,[303 315 272 276 509],13,5,3480,3.1607629427792916,20.0,20.0
9101,2,1101,[303 315 272 276 509],13,5,3485,3.1624319419237747,20.0,20.0
9102,2,1102,[303 315 272 276 509],894,5,3490,3.1640979147778787,20.0,20.0
9103,2,1103,[303 315 272 276 509],894,5,3495,3.1657608695652173,20.0,20.0
9104,2,1104,[303 315 272 276 509],13,5,3500,3.167420814479638,20.0,20.0
9105,2,1105,[303 315 272 276 509],13,5,3505,3.169077757685353,20.0,20.0
9106,2,1106,[303 315 272 276 509],13,5,3510,3.1707317073170733,20.0,20.0
9107,2,1107,[303 315 272 276 509],13,5,3515,3.172382671480144,20.0,20.0
9108,2,1108,[284 226 243 213 431],537,2,3517,3.171325518485122,0.0,0.0
9109,2,1109,[300 509 297 508 213],894,4,3521,3.172072072072072,20.0,20.0
9110,2,1110,[303 315 272 276 509],537,5,3526,3.173717371737174,20.0,20.0
9111,2,1111,[303 315 272 276 509],13,5,3531,3.175359712230216,20.0,20.0
9112,2,1112,[303 315 272 276 509],13,5,3536,3.1769991015274033,20.0,20.0
9113,2,1113,[303 315 272 276 509],894,5,3541,3.1786355475763015,20.0,20.0
9114,2,1114,[303 315 272 276 509],894,5,3546,3.180269058295964,20.0,20.0
9115,2,1115,[303 315 272 276 509],13,5,3551,3.181899641577061,20.0,20.0
9116,2,1116,[303 315 272 276 509],894,5,3556,3.1835273052820052,20.0,20.0
9117,2,1117,[303 315 272 276 509],13,5,3561,3.1851520572450807,20.0,20.0
9118,2,1118,[303 315 272 276 509],13,5,3566,3.186773905272565,20.0,20.0
9119,2,1119,[303 315 272 276 509],13,5,3571,3.188392857142857,20.0,20.0
9120,2,1120,[303 315 272 276 509],13,5,3576,3.1900089206066014,20.0,20.0
9121,2,1121,[303 315 272 276 509],537,5,3581,3.191622103386809,20.0,20.0
9122,2,1122,[303 315 272 276 509],894,5,3586,3.193232413178985,20.0,20.0
9123,2,1123,[303 315 272 276 509],537,5,3591,3.1948398576512456,20.0,20.0
9124,2,1124,[303 315 272 276 509],894,5,3596,3.1964444444444444,20.0,20.0
9125,2,1125,[303 315 272 276 509],13,5,3601,3.198046181172291,20.0,20.0
9126,2,1126,[303 315 272 276 509],894,5,3606,3.199645075421473,20.0,20.0
9127,2,1127,[303 315 272 276 509],537,5,3611,3.201241134751773,20.0,20.0
9128,2,1128,[239 452 222 202 215],406,0,3611,3.1984056687333924,0.0,20.0
9129,2,1129,[303 315 272 276 509],537,5,3616,3.2,20.0,20.0
9130,2,1130,[303 315 272 276 509],537,5,3621,3.2015915119363396,20.0,20.0
9131,2,1131,[303 315 272 276 509],537,5,3626,3.2031802120141344,20.0,20.0
9132,2,1132,[303 315 272 276 509],13,5,3631,3.204766107678729,20.0,20.0
9133,2,1133,[303 315 272 276 509],13,5,3636,3.2063492063492065,20.0,20.0
9134,2,1134,[303 315 272 276 509],537,5,3641,3.207929515418502,20.0,20.0
9135,2,1135,[303 315 272 276 509],13,5,3646,3.209507042253521,20.0,20.0
9136,2,1136,[303 315 272 276 509],13,5,3651,3.2110817941952505,20.0,20.0
9137,2,1137,[303 315 272 276 509],13,5,3656,3.212653778558875,20.0,20.0
9138,2,1138,[303 315 272 276 509],894,5,3661,3.214223002633889,20.0,20.0
9139,2,1139,[303 315 272 276 509],537,5,3666,3.2157894736842105,20.0,20.0
9140,2,1140,[303 315 272 276 509],894,5,3671,3.217353198948291,20.0,20.0
9141,2,1141,[303 315 272 276 509],537,5,3676,3.2189141856392296,20.0,20.0
9142,2,1142,[303 315 272 276 509],537,5,3681,3.220472440944882,20.0,20.0
9143,2,1143,[303 315 272 276 509],894,5,3686,3.222027972027972,20.0,20.0
9144,2,1144,[303 315 272 276 509],13,5,3691,3.2235807860262007,20.0,20.0
9145,2,1145,[303 315 272 276 509],894,5,3696,3.225130890052356,20.0,20.0
9146,2,1146,[303 315 272 276 509],894,5,3701,3.2266782911944203,20.0,20.0
9147,2,1147,[303 315 272 276 509],894,5,3706,3.2282229965156795,20.0,20.0
9148,2,1148,[303 315 272 276 509],537,5,3711,3.22976501305483,20.0,20.0
9149,2,1149,[303 315 272 276 509],537,5,3716,3.2313043478260868,20.0,20.0
9150,2,1150,[303 315 272 276 509],894,5,3721,3.2328410078192875,20.0,20.0
9151,2,1151,[303 315 272 276 509],537,5,3726,3.234375,20.0,20.0
9152,2,1152,[303 315 272 276 509],894,5,3731,3.2359063313096272,20.0,20.0
9153,2,1153,[303 315 272 276 509],894,5,3736,3.2374350086655115,20.0,20.0
9154,2,1154,[303 315 272 276 509],537,5,3741,3.238961038961039,20.0,20.0
9155,2,1155,[303 315 272 276 509],894,5,3746,3.2404844290657437,20.0,20.0
9156,2,1156,[303 315 272 276 509],894,5,3751,3.2420051858254104,20.0,20.0
9157,2,1157,[303 315 272 276 509],537,5,3756,3.243523316062176,20.0,20.0
9158,2,1158,[303 315 272 276 509],13,5,3761,3.2450388265746333,20.0,20.0
9159,2,1159,[303 315 272 276 509],537,5,3766,3.246551724137931,20.0,20.0
9160,2,1160,[303 315 272 276 509],537,5,3771,3.248062015503876,20.0,20.0
9161,2,1161,[303 315 272 276 509],537,5,3776,3.2495697074010326,20.0,20.0
9162,2,1162,[303 315 272 276 509],537,5,3781,3.251074806534824,20.0,20.0
9163,2,1163,[303 315 272 276 509],13,5,3786,3.252577319587629,20.0,20.0
9164,2,1164,[303 315 272 276 509],894,5,3791,3.254077253218884,20.0,20.0
9165,2,1165,[303 315 272 276 509],537,5,3796,3.2555746140651802,20.0,20.0
9166,2,1166,[303 315 272 276 509],537,5,3801,3.2570694087403598,20.0,20.0
9167,2,1167,[303 315 272 276 509],894,5,3806,3.2585616438356166,20.0,20.0
9168,2,1168,[303 315 272 276 509],13,5,3811,3.2600513259195893,20.0,20.0
9169,2,1169,[303 315 272 276 509],894,5,3816,3.2615384615384615,20.0,20.0
9170,2,1170,[303 315 272 276 509],537,5,3821,3.2630230572160546,20.0,20.0
9171,2,1171,[303 315 272 276 509],537,5,3826,3.2645051194539247,20.0,20.0
9172,2,1172,[303 315 272 276 509],537,5,3831,3.265984654731458,20.0,20.0
9173,2,1173,[303 315 272 276 509],894,5,3836,3.2674616695059626,20.0,20.0
9174,2,1174,[303 315 272 276 509],13,5,3841,3.268936170212766,20.0,20.0
9175,2,1175,[303 315 272 276 509],537,5,3846,3.270408163265306,20.0,20.0
9176,2,1176,[303 315 272 276 509],537,5,3851,3.271877655055225,20.0,20.0
9177,2,1177,[303 315 272 276 509],537,5,3856,3.2733446519524616,20.0,20.0
9178,2,1178,[303 315 272 276 509],894,5,3861,3.2748091603053435,20.0,20.0
9179,2,1179,[303 315 272 276 509],894,5,3866,3.276271186440678,20.0,20.0
9180,2,1180,[272 215 336 201 413],13,2,3868,3.275190516511431,0.0,0.0
9181,2,1181,[303 315 272 276 509],894,5,3873,3.2766497461928936,20.0,20.0
9182,2,1182,[303 315 272 276 509],13,5,3878,3.2781065088757395,20.0,20.0
9183,2,1183,[303 315 272 276 509],13,5,3883,3.279560810810811,20.0,20.0
9184,2,1184,[303 315 272 276 509],537,5,3888,3.2810126582278483,20.0,20.0
9185,2,1185,[429 290 509 268 272],13,5,3893,3.282462057335582,0.0,0.0
9186,2,1186,[303 315 272 276 509],537,5,3898,3.2839090143218197,20.0,20.0
9187,2,1187,[303 315 272 276 509],13,5,3903,3.2853535353535355,20.0,20.0
9188,2,1188,[303 315 272 276 509],13,5,3908,3.2867956265769553,20.0,20.0
9189,2,1189,[212 209 211 290 216],59,4,3912,3.287394957983193,0.0,20.0
9190,2,1190,[303 315 272 276 509],894,5,3917,3.288832913518052,20.0,20.0
9191,2,1191,[303 315 272 276 509],894,5,3922,3.290268456375839,20.0,20.0
9192,2,1192,[303 315 272 276 509],537,5,3927,3.291701592623638,20.0,20.0
9193,2,1193,[303 315 272 276 509],537,5,3932,3.2931323283082077,20.0,20.0
9194,2,1194,[303 315 272 276 509],537,5,3937,3.2945606694560667,20.0,20.0
9195,2,1195,[216 250 390 231 227],279,1,3938,3.2926421404682276,0.0,0.0
9196,2,1196,[303 315 272 276 509],894,5,3943,3.2940685045948204,20.0,20.0
9197,2,1197,[303 315 272 276 509],894,5,3948,3.295492487479132,20.0,20.0
9198,2,1198,[303 315 272 276 509],13,5,3953,3.2969140950792326,20.0,20.0
9199,2,1199,[231 485 227 275 255],334,1,3954,3.295,0.0,20.0
9200,2,1200,[303 315 272 276 509],13,5,3959,3.296419650291424,20.0,20.0
9201,2,1201,[303 315 272 276 509],894,5,3964,3.2978369384359403,20.0,20.0
9202,2,1202,[303 315 272 276 509],894,5,3969,3.2992518703241895,20.0,20.0
9203,2,1203,[303 315 272 276 509],13,5,3974,3.3006644518272426,20.0,20.0
9204,2,1204,[303 315 272 276 509],537,5,3979,3.3020746887966803,20.0,20.0
9205,2,1205,[303 315 272 276 509],894,5,3984,3.3034825870646767,20.0,20.0
9206,2,1206,[232 481 216 272 230],13,1,3985,3.3015741507870753,0.0,0.0
9207,2,1207,[303 315 272 276 509],537,5,3990,3.302980132450331,20.0,20.0
9208,2,1208,[303 315 272 276 509],13,5,3995,3.304383788254756,20.0,20.0
9209,2,1209,[303 315 272 276 509],894,5,4000,3.3057851239669422,20.0,20.0
9210,2,1210,[303 315 272 276 509],13,5,4005,3.307184145334434,20.0,20.0
9211,2,1211,[303 315 272 276 509],894,5,4010,3.3085808580858087,20.0,20.0
9212,2,1212,[303 315 272 276 509],13,5,4015,3.30997526793075,20.0,20.0
9213,2,1213,[215 429 290 481 508],524,2,4017,3.308896210873147,0.0,0.0
9214,2,1214,[303 315 272 276 509],13,5,4022,3.3102880658436216,20.0,20.0
9215,2,1215,[303 315 272 276 509],894,5,4027,3.3116776315789473,20.0,20.0
9216,2,1216,[303 315 272 276 509],894,5,4032,3.313064913722268,20.0,20.0
9217,2,1217,[303 315 272 276 509],894,5,4037,3.3144499178981937,20.0,20.0
9218,2,1218,[303 315 272 276 509],13,5,4042,3.3158326497128794,20.0,20.0
9219,2,1219,[303 315 272 276 509],537,5,4047,3.3172131147540984,20.0,20.0
9220,2,1220,[303 315 272 276 509],13,5,4052,3.3185913185913187,20.0,20.0
9221,2,1221,[303 315 272 276 509],894,5,4057,3.3199672667757776,20.0,20.0
9222,2,1222,[303 315 272 276 509],13,5,4062,3.321340964840556,20.0,20.0
9223,2,1223,[303 315 272 276 509],537,5,4067,3.322712418300654,20.0,20.0
9224,2,1224,[303 315 272 276 509],894,5,4072,3.324081632653061,20.0,20.0
9225,2,1225,[303 315 272 276 509],894,5,4077,3.3254486133768353,20.0,20.0
9226,2,1226,[303 315 272 276 509],894,5,4082,3.3268133659331705,20.0,20.0
9227,2,1227,[303 315 272 276 509],13,5,4087,3.3281758957654723,20.0,20.0
9228,2,1228,[303 315 272 276 509],894,5,4092,3.3295362082994306,20.0,20.0
9229,2,1229,[303 315 272 276 509],537,5,4097,3.3308943089430896,20.0,20.0
9230,2,1230,[303 315 272 276 509],13,5,4102,3.332250203086921,20.0,20.0
9231,2,1231,[303 315 272 276 509],537,5,4107,3.333603896103896,20.0,20.0
9232,2,1232,[303 315 272 276 509],894,5,4112,3.334955393349554,20.0,20.0
9233,2,1233,[303 315 272 276 509],894,5,4117,3.3363047001620747,20.0,20.0
9234,2,1234,[303 315 272 276 509],13,5,4122,3.337651821862348,20.0,20.0
9235,2,1235,[303 315 272 276 509],13,5,4127,3.338996763754045,20.0,20.0
9236,2,1236,[303 315 272 276 509],894,5,4132,3.3403395311236865,20.0,20.0
9237,2,1237,[303 315 272 276 509],537,5,4137,3.341680129240711,20.0,20.0
9238,2,1238,[303 315 272 276 509],537,5,4142,3.343018563357546,20.0,20.0
9239,2,1239,[303 315 272 276 509],13,5,4147,3.3443548387096773,20.0,20.0
9240,2,1240,[303 315 272 276 509],537,5,4152,3.345688960515713,20.0,20.0
9241,2,1241,[303 315 272 276 509],13,5,4157,3.347020933977456,20.0,20.0
9242,2,1242,[303 315 272 276 509],13,5,4162,3.3483507642799677,20.0,20.0
9243,2,1243,[303 315 272 276 509],13,5,4167,3.34967845659164,20.0,20.0
9244,2,1244,[303 315 272 276 509],894,5,4172,3.351004016064257,20.0,20.0
9245,2,1245,[303 315 272 276 509],894,5,4177,3.352327447833066,20.0,20.0
9246,2,1246,[303 315 272 276 509],894,5,4182,3.3536487570168405,20.0,20.0
9247,2,1247,[303 315 272 276 509],537,5,4187,3.354967948717949,20.0,20.0
9248,2,1248,[246 213 344 250 316],894,5,4192,3.356285028022418,20.0,0.0
9249,2,1249,[303 315 272 276 509],13,5,4197,3.3576,20.0,20.0
9250,2,1250,[303 315 272 276 509],894,5,4202,3.3589128697042367,20.0,20.0
9251,2,1251,[303 315 272 276 509],13,5,4207,3.360223642172524,20.0,20.0
9252,2,1252,[303 315 272 276 509],13,5,4212,3.3615323224261773,20.0,20.0
9253,2,1253,[303 315 272 276 509],894,5,4217,3.3628389154704945,20.0,20.0
9254,2,1254,[303 315 272 276 509],537,5,4222,3.3641434262948207,20.0,20.0
9255,2,1255,[303 315 272 276 509],13,5,4227,3.3654458598726116,20.0,20.0
9256,2,1256,[303 315 272 276 509],894,5,4232,3.366746221161496,20.0,20.0
9257,2,1257,[222 283 275 300 303],533,4,4236,3.3672496025437204,0.0,60.0
9258,2,1258,[303 315 272 276 509],13,5,4241,3.3685464654487687,20.0,20.0
9259,2,1259,[303 315 272 276 509],13,5,4246,3.36984126984127,20.0,20.0
9260,2,1260,[215 478 213 220 222],406,1,4247,3.3679619349722443,0.0,20.0
9261,2,1261,[303 315 272 276 509],13,5,4252,3.3692551505546753,20.0,20.0
9262,2,1262,[303 315 272 276 509],894,5,4257,3.370546318289786,20.0,20.0
9263,2,1263,[303 315 272 276 509],13,5,4262,3.3718354430379747,20.0,20.0
9264,2,1264,[303 315 272 276 509],894,5,4267,3.373122529644269,20.0,20.0
9265,2,1265,[303 315 272 276 509],894,5,4272,3.374407582938389,20.0,20.0
9266,2,1266,[303 315 272 276 509],13,5,4277,3.3756906077348066,20.0,20.0
9267,2,1267,[303 315 272 276 509],894,5,4282,3.3769716088328074,20.0,20.0
9268,2,1268,[303 315 272 276 509],894,5,4287,3.3782505910165486,20.0,20.0
9269,2,1269,[331 284 298 256 290],894,1,4288,3.3763779527559055,0.0,0.0
9270,2,1270,[303 315 272 276 509],894,5,4293,3.37765538945712,20.0,20.0
9271,2,1271,[303 315 272 276 509],894,5,4298,3.3789308176100628,20.0,20.0
9272,2,1272,[303 315 272 276 509],537,5,4303,3.380204241948154,20.0,20.0
9273,2,1273,[303 315 272 276 509],537,5,4308,3.381475667189953,20.0,20.0
9274,2,1274,[303 315 272 276 509],537,5,4313,3.3827450980392157,20.0,20.0
9275,2,1275,[303 315 272 276 509],894,5,4318,3.384012539184953,20.0,20.0
9276,2,1276,[303 315 272 276 509],13,5,4323,3.3852779953014878,20.0,20.0
9277,2,1277,[303 315 272 276 509],894,5,4328,3.3865414710485133,20.0,20.0
9278,2,1278,[303 315 272 276 509],894,5,4333,3.3878029710711495,20.0,20.0
9279,2,1279,[303 315 272 276 509],894,5,4338,3.3890625,20.0,20.0
9280,2,1280,[303 315 272 276 509],894,5,4343,3.39032006245121,20.0,20.0
9281,2,1281,[303 315 272 276 509],894,5,4348,3.3915756630265212,20.0,20.0
9282,2,1282,[303 315 272 276 509],894,5,4353,3.3928293063133284,20.0,20.0
9283,2,1283,[303 315 272 276 509],537,5,4358,3.3940809968847354,20.0,20.0
9284,2,1284,[303 315 272 276 509],537,5,4363,3.395330739299611,20.0,20.0
9285,2,1285,[303 315 272 276 509],537,5,4368,3.3965785381026437,20.0,20.0
9286,2,1286,[303 315 272 276 509],537,5,4373,3.397824397824398,20.0,20.0
9287,2,1287,[303 315 272 276 509],537,5,4378,3.3990683229813663,20.0,20.0
9288,2,1288,[303 315 272 276 509],894,5,4383,3.400310318076028,20.0,20.0
9289,2,1289,[303 315 272 276 509],13,5,4388,3.4015503875968993,20.0,20.0
9290,2,1290,[303 315 272 276 509],537,5,4393,3.40278853601859,20.0,20.0
9291,2,1291,[303 315 272 276 509],537,5,4398,3.4040247678018574,20.0,20.0
9292,2,1292,[303 315 272 276 509],537,5,4403,3.405259087393658,20.0,20.0
9293,2,1293,[303 315 272 276 509],894,5,4408,3.4064914992272026,20.0,20.0
9294,2,1294,[303 315 272 276 509],537,5,4413,3.4077220077220076,20.0,20.0
9295,2,1295,[303 315 272 276 509],894,5,4418,3.4089506172839505,20.0,20.0
9296,2,1296,[303 315 272 276 509],894,5,4423,3.41017733230532,20.0,20.0
9297,2,1297,[303 315 272 276 509],13,5,4428,3.411402157164869,20.0,20.0
9298,2,1298,[303 315 272 276 509],13,5,4433,3.4126250962278677,20.0,20.0
9299,2,1299,[303 315 272 276 509],894,5,4438,3.413846153846154,20.0,20.0
9300,2,1300,[303 315 272 276 509],13,5,4443,3.415065334358186,20.0,20.0
9301,2,1301,[303 315 272 276 509],894,5,4448,3.4162826420890937,20.0,20.0
9302,2,1302,[303 315 272 276 509],894,5,4453,3.417498081350729,20.0,20.0
9303,2,1303,[303 315 272 276 509],13,5,4458,3.418711656441718,20.0,20.0
9304,2,1304,[303 315 272 276 509],13,5,4463,3.4199233716475095,20.0,20.0
9305,2,1305,[303 315 272 276 509],13,5,4468,3.421133231240429,20.0,20.0
9306,2,1306,[303 315 272 276 509],894,5,4473,3.4223412394797244,20.0,20.0
9307,2,1307,[303 315 272 276 509],537,5,4478,3.423547400611621,20.0,20.0
9308,2,1308,[303 315 272 276 509],537,5,4483,3.424751718869366,20.0,20.0
9309,2,1309,[303 315 272 276 509],537,5,4488,3.4259541984732826,20.0,20.0
9310,2,1310,[303 315 272 276 509],13,5,4493,3.427154843630816,20.0,20.0
9311,2,1311,[303 315 272 276 509],537,5,4498,3.4283536585365852,20.0,20.0
9312,2,1312,[303 315 272 276 509],13,5,4503,3.4295506473724298,20.0,20.0
9313,2,1313,[303 315 272 276 509],894,5,4508,3.4307458143074583,20.0,20.0
9314,2,1314,[431 481 509 429 226],7,5,4513,3.431939163498099,0.0,0.0
9315,2,1315,[283 429 208 321 223],234,2,4515,3.4308510638297873,20.0,0.0
9316,2,1316,[303 315 272 276 509],537,5,4520,3.4320425208807896,20.0,20.0
9317,2,1317,[303 315 272 276 509],13,5,4525,3.4332321699544766,20.0,20.0
9318,2,1318,[303 315 272 276 509],894,5,4530,3.434420015163002,20.0,20.0
9319,2,1319,[303 315 272 276 509],537,5,4535,3.4356060606060606,20.0,20.0
9320,2,1320,[303 315 272 276 509],894,5,4540,3.436790310370931,20.0,20.0
9321,2,1321,[303 315 272 276 509],13,5,4545,3.4379727685325263,20.0,20.0
9322,2,1322,[303 315 272 276 509],894,5,4550,3.439153439153439,20.0,20.0
9323,2,1323,[303 315 272 276 509],894,5,4555,3.440332326283988,20.0,20.0
9324,2,1324,[303 315 272 276 509],13,5,4560,3.4415094339622643,20.0,20.0
9325,2,1325,[303 315 272 276 509],894,5,4565,3.442684766214178,20.0,20.0
9326,2,1326,[303 315 272 276 509],537,5,4570,3.4438583270535044,20.0,20.0
9327,2,1327,[303 315 272 276 509],894,5,4575,3.4450301204819276,20.0,20.0
9328,2,1328,[290 221 291 300 431],537,1,4576,3.443190368698269,0.0,20.0
9329,2,1329,[303 315 272 276 509],894,5,4581,3.444360902255639,20.0,20.0
9330,2,1330,[303 315 272 276 509],13,5,4586,3.4455296769346355,20.0,20.0
9331,2,1331,[303 315 272 276 509],537,5,4591,3.4466966966966965,20.0,20.0
9332,2,1332,[431 303 218 452 481],13,1,4592,3.444861215303826,0.0,0.0
9333,2,1333,[303 315 272 276 509],13,5,4597,3.4460269865067468,20.0,20.0
9334,2,1334,[303 315 272 276 509],537,5,4602,3.447191011235955,20.0,20.0
9335,2,1335,[303 315 272 276 509],894,5,4607,3.4483532934131738,20.0,20.0
9336,2,1336,[303 315 272 276 509],894,5,4612,3.449513836948392,20.0,20.0
9337,2,1337,[303 315 272 276 509],13,5,4617,3.4506726457399104,20.0,20.0
9338,2,1338,[303 315 272 276 509],894,5,4622,3.451829723674384,20.0,20.0
9339,2,1339,[300 420 452 231 212],13,2,4624,3.4507462686567165,0.0,20.0
9340,2,1340,[231 220 218 216 209],334,0,4624,3.448173005219985,0.0,0.0
9341,2,1341,[303 315 272 276 509],894,5,4629,3.4493293591654246,20.0,20.0
9342,2,1342,[303 315 272 276 509],894,5,4634,3.45048399106478,20.0,20.0
9343,2,1343,[303 315 272 276 509],537,5,4639,3.4516369047619047,20.0,20.0
9344,2,1344,[256 221 303 280 244],894,3,4642,3.4513011152416357,0.0,0.0
9345,2,1345,[303 315 272 276 509],537,5,4647,3.4524517087667164,20.0,20.0
9346,2,1346,[303 315 272 276 509],537,5,4652,3.4536005939123977,20.0,20.0
9347,2,1347,[303 315 272 276 509],537,5,4657,3.4547477744807122,20.0,20.0
9348,2,1348,[384 431 321 481 216],13,0,4657,3.452186805040771,0.0,0.0
9349,2,1349,[303 208 509 298 221],6,3,4660,3.4518518518518517,0.0,0.0
9350,2,1350,[303 315 272 276 509],13,5,4665,3.45299777942265,20.0,20.0
9351,2,1351,[303 315 272 276 509],537,5,4670,3.4541420118343193,20.0,20.0
9352,2,1352,[303 315 272 276 509],537,5,4675,3.4552845528455283,20.0,20.0
9353,2,1353,[303 315 272 276 509],537,5,4680,3.4564254062038406,20.0,20.0
9354,2,1354,[303 315 272 276 509],13,5,4685,3.4575645756457565,20.0,20.0
9355,2,1355,[303 315 272 276 509],13,5,4690,3.4587020648967552,20.0,20.0
9356,2,1356,[303 315 272 276 509],894,5,4695,3.4598378776713337,20.0,20.0
9357,2,1357,[509 280 232 301 299],13,2,4697,3.4587628865979383,0.0,0.0
9358,2,1358,[268 230 246 284 236],145,4,4701,3.45916114790287,0.0,0.0
9359,2,1359,[303 315 272 276 509],13,5,4706,3.460294117647059,20.0,20.0
9360,2,1360,[303 315 272 276 509],13,5,4711,3.461425422483468,20.0,20.0
9361,2,1361,[303 315 272 276 509],537,5,4716,3.462555066079295,20.0,20.0
9362,2,1362,[303 315 272 276 509],537,5,4721,3.4636830520909756,20.0,20.0
9363,2,1363,[303 315 272 276 509],894,5,4726,3.464809384164223,20.0,20.0
9364,2,1364,[303 315 272 276 509],13,5,4731,3.465934065934066,20.0,20.0
9365,2,1365,[303 315 272 276 509],537,5,4736,3.4670571010248903,20.0,20.0
9366,2,1366,[303 315 272 276 509],537,5,4741,3.4681784930504755,20.0,20.0
9367,2,1367,[303 315 272 276 509],894,5,4746,3.469298245614035,20.0,20.0
9368,2,1368,[303 315 272 276 509],894,5,4751,3.4704163623082542,20.0,20.0
9369,2,1369,[303 315 272 276 509],537,5,4756,3.4715328467153284,20.0,20.0
9370,2,1370,[303 315 272 276 509],537,5,4761,3.472647702407002,20.0,20.0
9371,2,1371,[303 315 272 276 509],894,5,4766,3.4737609329446064,20.0,20.0
9372,2,1372,[217 367 429 485 211],766,3,4769,3.4734158776402038,0.0,20.0
9373,2,1373,[303 315 272 276 509],13,5,4774,3.4745269286754,20.0,20.0
9374,2,1374,[303 315 272 276 509],894,5,4779,3.475636363636364,20.0,20.0
9375,2,1375,[303 315 272 276 509],537,5,4784,3.4767441860465116,20.0,20.0
9376,2,1376,[507 202 301 431 222],234,1,4785,3.474945533769063,0.0,20.0
9377,2,1377,[303 315 272 276 509],13,5,4790,3.476052249637155,20.0,20.0
9378,2,1378,[255 215 367 211 272],659,2,4792,3.4749818709209572,0.0,20.0
9379,2,1379,[303 315 272 276 509],894,5,4797,3.476086956521739,20.0,20.0
9380,2,1380,[293 218 413 301 202],145,3,4800,3.4757422157856626,0.0,0.0
9381,2,1381,[241 202 272 230 219],13,2,4802,3.4746743849493487,0.0,0.0
9382,2,1382,[230 215 218 244 209],474,4,4806,3.475054229934924,0.0,0.0
9383,2,1383,[303 315 272 276 509],13,5,4811,3.476156069364162,20.0,20.0
9384,2,1384,[303 315 272 276 509],13,5,4816,3.477256317689531,20.0,20.0
9385,2,1385,[303 315 272 276 509],13,5,4821,3.4783549783549783,20.0,20.0
9386,2,1386,[303 315 272 276 509],537,5,4826,3.4794520547945207,20.0,20.0
9387,2,1387,[303 315 272 276 509],13,5,4831,3.4805475504322767,20.0,20.0
9388,2,1388,[303 315 272 276 509],894,5,4836,3.4816414686825055,20.0,20.0
9389,2,1389,[303 315 272 276 509],894,5,4841,3.48273381294964,20.0,20.0
9390,2,1390,[303 315 272 276 509],13,5,4846,3.483824586628325,20.0,20.0
9391,2,1391,[303 315 272 276 509],537,5,4851,3.4849137931034484,20.0,20.0
9392,2,1392,[227 507 481 213 293],474,5,4856,3.4860014357501794,0.0,0.0
9393,2,1393,[303 315 272 276 509],13,5,4861,3.487087517934003,20.0,20.0
9394,2,1394,[303 315 272 276 509],537,5,4866,3.488172043010753,20.0,20.0
9395,2,1395,[303 315 272 276 509],537,5,4871,3.4892550143266474,20.0,20.0
9396,2,1396,[303 315 272 276 509],13,5,4876,3.490336435218325,20.0,20.0
9397,2,1397,[303 315 272 276 509],13,5,4881,3.4914163090128754,20.0,20.0
9398,2,1398,[303 315 272 276 509],894,5,4886,3.492494639027877,20.0,20.0
9399,2,1399,[303 315 272 276 509],537,5,4891,3.4935714285714288,20.0,20.0
9400,2,1400,[303 315 272 276 509],894,5,4896,3.4946466809421843,20.0,20.0
9401,2,1401,[284 452 509 239 507],308,2,4898,3.49358059914408,0.0,0.0
9402,2,1402,[303 315 272 276 509],537,5,4903,3.4946543121881684,20.0,20.0
9403,2,1403,[303 315 272 276 509],537,5,4908,3.4957264957264957,20.0,20.0
9404,2,1404,[303 315 272 276 509],13,5,4913,3.496797153024911,20.0,20.0
9405,2,1405,[268 264 301 280 303],13,4,4917,3.497155049786629,0.0,0.0
9406,2,1406,[303 315 272 276 509],894,5,4922,3.498223169864961,20.0,20.0
9407,2,1407,[303 315 272 276 509],894,5,4927,3.499289772727273,20.0,20.0
9408,2,1408,[303 315 272 276 509],13,5,4932,3.5003548616039746,20.0,20.0
9409,2,1409,[303 315 272 276 509],537,5,4937,3.501418439716312,20.0,20.0
9410,2,1410,[303 315 272 276 509],894,5,4942,3.5024805102763996,20.0,20.0
9411,2,1411,[303 315 272 276 509],537,5,4947,3.5035410764872523,20.0,20.0
9412,2,1412,[303 315 272 276 509],537,5,4952,3.5046001415428165,20.0,20.0
9413,2,1413,[303 315 272 276 509],13,5,4957,3.505657708628006,20.0,20.0
9414,2,1414,[303 315 272 276 509],13,5,4962,3.506713780918728,20.0,20.0
9415,2,1415,[301 222 300 259 239],537,0,4962,3.5042372881355934,0.0,40.0
9416,2,1416,[303 315 272 276 509],894,5,4967,3.505292872265349,20.0,20.0
9417,2,1417,[303 315 272 276 509],537,5,4972,3.5063469675599435,20.0,20.0
9418,2,1418,[303 315 272 276 509],537,5,4977,3.507399577167019,20.0,20.0
9419,2,1419,[303 315 272 276 509],537,5,4982,3.508450704225352,20.0,20.0
9420,2,1420,[303 315 272 276 509],537,5,4987,3.509500351864884,20.0,20.0
9421,2,1421,[243 216 321 259 236],537,0,4987,3.5070323488045005,0.0,0.0
9422,2,1422,[303 315 272 276 509],13,5,4992,3.5080815179198876,20.0,20.0
9423,2,1423,[303 315 272 276 509],894,5,4997,3.509129213483146,20.0,20.0
9424,2,1424,[303 315 272 276 509],894,5,5002,3.5101754385964914,20.0,20.0
9425,2,1425,[303 315 272 276 509],894,5,5007,3.5112201963534364,20.0,20.0
9426,2,1426,[303 315 272 276 509],13,5,5012,3.5122634898388227,20.0,20.0
9427,2,1427,[303 315 272 276 509],537,5,5017,3.5133053221288515,20.0,20.0
9428,2,1428,[303 315 272 276 509],894,5,5022,3.514345696291113,20.0,20.0
9429,2,1429,[303 315 272 276 509],537,5,5027,3.5153846153846153,20.0,20.0
9430,2,1430,[303 315 272 276 509],13,5,5032,3.5164220824598185,20.0,20.0
9431,2,1431,[202 431 259 236 300],234,0,5032,3.5139664804469275,0.0,20.0
9432,2,1432,[303 315 272 276 509],13,5,5037,3.515003489183531,20.0,20.0
9433,2,1433,[303 315 272 276 509],537,5,5042,3.5160390516039053,20.0,20.0
9434,2,1434,[303 315 272 276 509],537,5,5047,3.5170731707317073,20.0,20.0
9435,2,1435,[280 429 508 299 350],13,2,5049,3.516016713091922,0.0,0.0
9436,2,1436,[303 315 272 276 509],894,5,5054,3.5170494084899095,20.0,20.0
9437,2,1437,[303 315 272 276 509],13,5,5059,3.5180806675938805,20.0,20.0
9438,2,1438,[303 315 272 276 509],13,5,5064,3.5191104933981934,20.0,20.0
9439,2,1439,[303 315 272 276 509],894,5,5069,3.520138888888889,20.0,20.0
9440,2,1440,[303 315 272 276 509],13,5,5074,3.5211658570437194,20.0,20.0
9441,2,1441,[303 315 272 276 509],537,5,5079,3.5221914008321775,20.0,20.0
9442,2,1442,[331 280 481 290 243],13,2,5081,3.5211365211365213,0.0,0.0
9443,2,1443,[303 315 272 276 509],13,5,5086,3.5221606648199444,20.0,20.0
9444,2,1444,[303 315 272 276 509],894,5,5091,3.5231833910034602,20.0,20.0
9445,2,1445,[303 315 272 276 509],13,5,5096,3.524204702627939,20.0,20.0
9446,2,1446,[303 212 478 384 508],13,3,5099,3.523842432619212,0.0,0.0
9447,2,1447,[202 208 230 378 211],897,4,5103,3.524171270718232,0.0,20.0
9448,2,1448,[303 315 272 276 509],894,5,5108,3.525189786059351,20.0,20.0
9449,2,1449,[303 315 272 276 509],894,5,5113,3.526206896551724,20.0,20.0
9450,2,1450,[303 315 272 276 509],537,5,5118,3.527222605099931,20.0,20.0
9451,2,1451,[303 315 272 276 509],894,5,5123,3.528236914600551,20.0,20.0
9452,2,1452,[303 315 272 276 509],537,5,5128,3.5292498279421887,20.0,20.0
9453,2,1453,[303 315 272 276 509],13,5,5133,3.530261348005502,20.0,20.0
9454,2,1454,[303 315 272 276 509],537,5,5138,3.53127147766323,20.0,20.0
9455,2,1455,[303 315 272 276 509],537,5,5143,3.53228021978022,20.0,20.0
9456,2,1456,[303 315 272 276 509],13,5,5148,3.533287577213452,20.0,20.0
9457,2,1457,[272 218 298 284 331],548,3,5151,3.5329218106995883,0.0,0.0
9458,2,1458,[303 315 272 276 509],537,5,5156,3.5339273474982864,20.0,20.0
9459,2,1459,[303 315 272 276 509],13,5,5161,3.5349315068493152,20.0,20.0
9460,2,1460,[303 315 272 276 509],13,5,5166,3.5359342915811087,20.0,20.0
9461,2,1461,[344 509 321 275 264],13,2,5168,3.5348837209302326,0.0,20.0
9462,2,1462,[303 315 272 276 509],537,5,5173,3.535885167464115,20.0,20.0
9463,2,1463,[303 315 272 276 509],894,5,5178,3.5368852459016393,20.0,20.0
9464,2,1464,[303 315 272 276 509],13,5,5183,3.5378839590443687,20.0,20.0
9465,2,1465,[303 315 272 276 509],537,5,5188,3.538881309686221,20.0,20.0
9466,2,1466,[303 315 272 276 509],13,5,5193,3.539877300613497,20.0,20.0
9467,2,1467,[303 315 272 276 509],894,5,5198,3.5408719346049047,20.0,20.0
9468,2,1468,[344 208 217 212 300],13,2,5200,3.5398230088495577,0.0,20.0
9469,2,1469,[303 315 272 276 509],13,5,5205,3.5408163265306123,20.0,20.0
9470,2,1470,[303 315 272 276 509],537,5,5210,3.54180829367777,20.0,20.0
9471,2,1471,[303 315 272 276 509],13,5,5215,3.542798913043478,20.0,20.0
9472,2,1472,[303 315 272 276 509],13,5,5220,3.5437881873727086,20.0,20.0
9473,2,1473,[384 208 485 217 276],13,2,5222,3.542740841248304,0.0,20.0
9474,2,1474,[301 431 201 226 299],537,1,5223,3.5410169491525423,0.0,0.0
9475,2,1475,[303 315 272 276 509],13,5,5228,3.5420054200542004,20.0,20.0
9476,2,1476,[303 315 272 276 509],537,5,5233,3.5429925524712256,20.0,20.0
9477,2,1477,[303 315 272 276 509],894,5,5238,3.543978349120433,20.0,20.0
9478,2,1478,[303 315 272 276 509],13,5,5243,3.5449628127112915,20.0,20.0
9479,2,1479,[303 315 272 276 509],13,5,5248,3.545945945945946,20.0,20.0
9480,2,1480,[303 315 272 276 509],537,5,5253,3.546927751519244,20.0,20.0
9481,2,1481,[303 315 272 276 509],537,5,5258,3.5479082321187585,20.0,20.0
9482,2,1482,[303 315 272 276 509],537,5,5263,3.5488873904248144,20.0,20.0
9483,2,1483,[303 315 272 276 509],894,5,5268,3.549865229110512,20.0,20.0
9484,2,1484,[583 206 209 211 226],387,4,5272,3.55016835016835,0.0,20.0
9485,2,1485,[303 315 272 276 509],537,5,5277,3.5511440107671604,20.0,20.0
9486,2,1486,[303 315 272 276 509],537,5,5282,3.5521183591123067,20.0,20.0
9487,2,1487,[303 315 272 276 509],894,5,5287,3.5530913978494625,20.0,20.0
9488,2,1488,[275 223 300 230 481],13,1,5288,3.5513767629281396,20.0,40.0
9489,2,1489,[213 291 378 206 239],804,3,5291,3.551006711409396,0.0,0.0
9490,2,1490,[298 213 291 239 215],308,2,5293,3.5499664654594234,0.0,0.0
9491,2,1491,[211 213 259 254 420],308,3,5296,3.549597855227882,0.0,20.0
9492,2,1492,[303 315 272 276 509],894,5,5301,3.5505693235097118,20.0,20.0
9493,2,1493,[303 315 272 276 509],894,5,5306,3.5515394912985276,20.0,20.0
9494,2,1494,[303 315 272 276 509],894,5,5311,3.5525083612040134,20.0,20.0
9495,2,1495,[303 315 272 276 509],894,5,5316,3.553475935828877,20.0,20.0
9496,2,1496,[303 315 272 276 509],894,5,5321,3.5544422177688713,20.0,20.0
9497,2,1497,[303 315 272 276 509],537,5,5326,3.555407209612817,20.0,20.0
9498,2,1498,[303 315 272 276 509],894,5,5331,3.5563709139426285,20.0,20.0
9499,2,1499,[303 315 272 276 509],13,5,5336,3.5573333333333332,20.0,20.0
9500,2,1500,[303 315 272 276 509],537,5,5341,3.558294470353098,20.0,20.0
9501,2,1501,[303 315 272 276 509],894,5,5346,3.559254327563249,20.0,20.0
9502,2,1502,[303 315 272 276 509],894,5,5351,3.560212907518297,20.0,20.0
9503,2,1503,[303 315 272 276 509],894,5,5356,3.5611702127659575,20.0,20.0
9504,2,1504,[303 315 272 276 509],537,5,5361,3.562126245847176,20.0,20.0
9505,2,1505,[303 315 272 276 509],894,5,5366,3.5630810092961487,20.0,20.0
9506,2,1506,[303 315 272 276 509],537,5,5371,3.564034505640345,20.0,20.0
9507,2,1507,[303 315 272 276 509],537,5,5376,3.5649867374005306,20.0,20.0
9508,2,1508,[303 315 272 276 509],13,5,5381,3.5659377070907885,20.0,20.0
9509,2,1509,[303 315 272 276 509],894,5,5386,3.566887417218543,20.0,20.0
9510,2,1510,[303 315 272 276 509],13,5,5391,3.5678358702845796,20.0,20.0
9511,2,1511,[303 315 272 276 509],13,5,5396,3.568783068783069,20.0,20.0
9512,2,1512,[303 315 272 276 509],13,5,5401,3.5697290152015864,20.0,20.0
9513,2,1513,[303 315 272 276 509],13,5,5406,3.570673712021136,20.0,20.0
9514,2,1514,[303 315 272 276 509],537,5,5411,3.571617161716172,20.0,20.0
9515,2,1515,[303 315 272 276 509],894,5,5416,3.5725593667546174,20.0,20.0
9516,2,1516,[303 315 272 276 509],13,5,5421,3.5735003295978904,20.0,20.0
9517,2,1517,[303 315 272 276 509],13,5,5426,3.5744400527009224,20.0,20.0
9518,2,1518,[303 315 272 276 509],894,5,5431,3.575378538512179,20.0,20.0
9519,2,1519,[303 315 272 276 509],13,5,5436,3.5763157894736843,20.0,20.0
9520,2,1520,[303 315 272 276 509],13,5,5441,3.577251808021039,20.0,20.0
9521,2,1521,[384 208 230 291 239],279,4,5445,3.5775295663600524,0.0,0.0
9522,2,1522,[303 315 272 276 509],537,5,5450,3.5784635587655944,20.0,20.0
9523,2,1523,[236 209 315 202 216],145,4,5454,3.578740157480315,20.0,0.0
9524,2,1524,[211 202 226 221 243],234,0,5454,3.5763934426229507,0.0,20.0
9525,2,1525,[303 315 272 276 509],894,5,5459,3.5773263433813893,20.0,20.0
9526,2,1526,[303 315 272 276 509],894,5,5464,3.5782580222658806,20.0,20.0
9527,2,1527,[303 315 272 276 509],894,5,5469,3.5791884816753927,20.0,20.0
9528,2,1528,[303 315 272 276 509],894,5,5474,3.580117724002616,20.0,20.0
9529,2,1529,[303 315 272 276 509],894,5,5479,3.581045751633987,20.0,20.0
9530,2,1530,[303 315 272 276 509],894,5,5484,3.5819725669497062,20.0,20.0
9531,2,1531,[303 315 272 276 509],537,5,5489,3.58289817232376,20.0,20.0
9532,2,1532,[303 315 272 276 509],894,5,5494,3.58382257012394,20.0,20.0
9533,2,1533,[303 315 272 276 509],894,5,5499,3.5847457627118646,20.0,20.0
9534,2,1534,[226 208 431 275 508],537,4,5503,3.5850162866449513,0.0,20.0
9535,2,1535,[303 315 272 276 509],537,5,5508,3.5859375,20.0,20.0
9536,2,1536,[303 315 272 276 509],13,5,5513,3.586857514638907,20.0,20.0
9537,2,1537,[303 315 272 276 509],537,5,5518,3.5877763328998697,20.0,20.0
9538,2,1538,[303 315 272 276 509],13,5,5523,3.5886939571150096,20.0,20.0
9539,2,1539,[303 315 272 276 509],13,5,5528,3.5896103896103897,20.0,20.0
9540,2,1540,[303 315 272 276 509],537,5,5533,3.590525632706035,20.0,20.0
9541,2,1541,[303 315 272 276 509],537,5,5538,3.5914396887159534,20.0,20.0
9542,2,1542,[303 315 272 276 509],537,5,5543,3.592352559948153,20.0,20.0
9543,2,1543,[303 315 272 276 509],537,5,5548,3.593264248704663,20.0,20.0
9544,2,1544,[303 315 272 276 509],13,5,5553,3.5941747572815532,20.0,20.0
9545,2,1545,[303 315 272 276 509],537,5,5558,3.595084087968952,20.0,20.0
9546,2,1546,[303 315 272 276 509],537,5,5563,3.5959922430510667,20.0,20.0
9547,2,1547,[321 384 507 217 315],13,1,5564,3.594315245478036,20.0,0.0
9548,2,1548,[230 431 290 390 208],279,4,5568,3.594577146546159,0.0,0.0
9549,2,1549,[303 315 272 276 509],537,5,5573,3.595483870967742,20.0,20.0
9550,2,1550,[303 315 272 276 509],13,5,5578,3.59638942617666,20.0,20.0
9551,2,1551,[212 367 215 478 290],524,2,5580,3.595360824742268,0.0,0.0
9552,2,1552,[303 315 272 276 509],894,5,5585,3.5962652929813266,20.0,20.0
9553,2,1553,[303 315 272 276 509],537,5,5590,3.597168597168597,20.0,20.0
9554,2,1554,[303 315 272 276 509],894,5,5595,3.598070739549839,20.0,20.0
9555,2,1555,[303 315 272 276 509],537,5,5600,3.5989717223650386,20.0,20.0
9556,2,1556,[303 315 272 276 509],13,5,5605,3.5998715478484264,20.0,20.0
9557,2,1557,[303 315 272 276 509],537,5,5610,3.600770218228498,20.0,20.0
9558,2,1558,[303 315 272 276 509],537,5,5615,3.601667735728031,20.0,20.0
9559,2,1559,[303 315 272 276 509],894,5,5620,3.6025641025641026,20.0,20.0
9560,2,1560,[303 315 272 276 509],894,5,5625,3.6034593209481103,20.0,20.0
9561,2,1561,[303 315 272 276 509],894,5,5630,3.6043533930857876,20.0,20.0
9562,2,1562,[303 315 272 276 509],13,5,5635,3.605246321177223,20.0,20.0
9563,2,1563,[303 315 272 276 509],13,5,5640,3.60613810741688,20.0,20.0
9564,2,1564,[303 315 272 276 509],537,5,5645,3.6070287539936103,20.0,20.0
9565,2,1565,[303 315 272 276 509],537,5,5650,3.607918263090677,20.0,20.0
9566,2,1566,[303 315 272 276 509],13,5,5655,3.608806636885769,20.0,20.0
9567,2,1567,[303 315 272 276 509],537,5,5660,3.6096938775510203,20.0,20.0
9568,2,1568,[303 315 272 276 509],13,5,5665,3.6105799872530273,20.0,20.0
9569,2,1569,[303 315 272 276 509],13,5,5670,3.611464968152866,20.0,20.0
9570,2,1570,[303 315 272 276 509],894,5,5675,3.6123488224061107,20.0,20.0
9571,2,1571,[303 315 272 276 509],537,5,5680,3.61323155216285,20.0,20.0
9572,2,1572,[303 315 272 276 509],13,5,5685,3.614113159567705,20.0,20.0
9573,2,1573,[303 315 272 276 509],894,5,5690,3.6149936467598476,20.0,20.0
9574,2,1574,[303 315 272 276 509],537,5,5695,3.615873015873016,20.0,20.0
9575,2,1575,[303 315 272 276 509],894,5,5700,3.616751269035533,20.0,20.0
9576,2,1576,[303 315 272 276 509],13,5,5705,3.617628408370323,20.0,20.0
9577,2,1577,[316 378 212 291 208],234,3,5708,3.61723700887199,20.0,0.0
9578,2,1578,[303 315 272 276 509],13,5,5713,3.6181127295756808,20.0,20.0
9579,2,1579,[303 315 272 276 509],537,5,5718,3.618987341772152,20.0,20.0
9580,2,1580,[303 315 272 276 509],13,5,5723,3.619860847564832,20.0,20.0
9581,2,1581,[303 315 272 276 509],537,5,5728,3.620733249051833,20.0,20.0
9582,2,1582,[303 315 272 276 509],537,5,5733,3.6216045483259633,20.0,20.0
9583,2,1583,[303 315 272 276 509],894,5,5738,3.6224747474747474,20.0,20.0
9584,2,1584,[303 315 272 276 509],13,5,5743,3.6233438485804417,20.0,20.0
9585,2,1585,[303 315 272 276 509],894,5,5748,3.6242118537200505,20.0,20.0
9586,2,1586,[303 315 272 276 509],894,5,5753,3.6250787649653433,20.0,20.0
9587,2,1587,[303 315 272 276 509],537,5,5758,3.6259445843828715,20.0,20.0
9588,2,1588,[303 315 272 276 509],537,5,5763,3.6268093140339834,20.0,20.0
9589,2,1589,[303 315 272 276 509],13,5,5768,3.627672955974843,20.0,20.0
9590,2,1590,[303 315 272 276 509],537,5,5773,3.6285355122564424,20.0,20.0
9591,2,1591,[231 365 202 291 209],308,2,5775,3.6275125628140703,0.0,0.0
9592,2,1592,[303 315 272 276 509],894,5,5780,3.6283741368487132,20.0,20.0
9593,2,1593,[303 315 272 276 509],894,5,5785,3.6292346298619824,20.0,20.0
9594,2,1594,[303 315 272 276 509],13,5,5790,3.6300940438871474,20.0,20.0
9595,2,1595,[303 315 272 276 509],894,5,5795,3.630952380952381,20.0,20.0
9596,2,1596,[303 315 272 276 509],894,5,5800,3.6318096430807763,20.0,20.0
9597,2,1597,[303 315 272 276 509],894,5,5805,3.632665832290363,20.0,20.0
9598,2,1598,[303 315 272 276 509],537,5,5810,3.6335209505941215,20.0,20.0
9599,2,1599,[303 315 272 276 509],537,5,5815,3.634375,20.0,20.0
9600,2,1600,[303 315 272 276 509],537,5,5820,3.635227982510931,20.0,20.0
9601,2,1601,[303 315 272 276 509],894,5,5825,3.636079900124844,20.0,20.0
9602,2,1602,[303 315 272 276 509],537,5,5830,3.636930754834685,20.0,20.0
9603,2,1603,[303 315 272 276 509],537,5,5835,3.637780548628429,20.0,20.0
9604,2,1604,[303 315 272 276 509],13,5,5840,3.6386292834890965,20.0,20.0
9605,2,1605,[303 315 272 276 509],537,5,5845,3.6394769613947697,20.0,20.0
9606,2,1606,[215 478 283 378 236],234,1,5846,3.6378344741754822,0.0,0.0
9607,2,1607,[303 315 272 276 509],537,5,5851,3.638681592039801,20.0,20.0
9608,2,1608,[303 315 272 276 509],537,5,5856,3.63952765692977,20.0,20.0
9609,2,1609,[303 315 272 276 509],537,5,5861,3.6403726708074533,20.0,20.0
9610,2,1610,[303 315 272 276 509],537,5,5866,3.6412166356300433,20.0,20.0
9611,2,1611,[303 315 272 276 509],894,5,5871,3.642059553349876,20.0,20.0
9612,2,1612,[303 315 272 276 509],894,5,5876,3.642901425914445,20.0,20.0
9613,2,1613,[303 315 272 276 509],537,5,5881,3.6437422552664187,20.0,20.0
9614,2,1614,[303 315 272 276 509],13,5,5886,3.6445820433436533,20.0,20.0
9615,2,1615,[291 259 300 508 213],85,1,5887,3.6429455445544554,0.0,20.0
9616,2,1616,[303 315 272 276 509],894,5,5892,3.6437847866419295,20.0,20.0
9617,2,1617,[303 315 272 276 509],13,5,5897,3.6446229913473425,20.0,20.0
9618,2,1618,[303 315 272 276 509],537,5,5902,3.6454601605929584,20.0,20.0
9619,2,1619,[303 315 272 276 509],894,5,5907,3.6462962962962964,20.0,20.0
9620,2,1620,[303 315 272 276 509],894,5,5912,3.647131400370142,20.0,20.0
9621,2,1621,[303 315 272 276 509],537,5,5917,3.647965474722565,20.0,20.0
9622,2,1622,[303 315 272 276 509],894,5,5922,3.6487985212569316,20.0,20.0
9623,2,1623,[303 315 272 276 509],537,5,5927,3.6496305418719213,20.0,20.0
9624,2,1624,[303 315 272 276 509],537,5,5932,3.6504615384615384,20.0,20.0
9625,2,1625,[303 315 272 276 509],894,5,5937,3.651291512915129,20.0,20.0
9626,2,1626,[303 315 272 276 509],894,5,5942,3.652120467117394,20.0,20.0
9627,2,1627,[303 315 272 276 509],894,5,5947,3.652948402948403,20.0,20.0
9628,2,1628,[303 315 272 276 509],537,5,5952,3.6537753222836096,20.0,20.0
9629,2,1629,[303 315 272 276 509],13,5,5957,3.654601226993865,20.0,20.0
9630,2,1630,[303 315 272 276 509],13,5,5962,3.6554261189454325,20.0,20.0
9631,2,1631,[303 315 272 276 509],13,5,5967,3.65625,20.0,20.0
9632,2,1632,[303 315 272 276 509],13,5,5972,3.6570728720146968,20.0,20.0
9633,2,1633,[303 315 272 276 509],894,5,5977,3.6578947368421053,20.0,20.0
9634,2,1634,[303 315 272 276 509],537,5,5982,3.6587155963302753,20.0,20.0
9635,2,1635,[303 315 272 276 509],13,5,5987,3.6595354523227384,20.0,20.0
9636,2,1636,[303 315 272 276 509],537,5,5992,3.6603543066585216,20.0,20.0
9637,2,1637,[303 315 272 276 509],894,5,5997,3.661172161172161,20.0,20.0
9638,2,1638,[303 315 272 276 509],13,5,6002,3.6619890176937155,20.0,20.0
9639,2,1639,[303 315 272 276 509],537,5,6007,3.6628048780487803,20.0,20.0
9640,2,1640,[303 315 272 276 509],13,5,6012,3.6636197440585008,20.0,20.0
9641,2,1641,[303 315 272 276 509],537,5,6017,3.664433617539586,20.0,20.0
9642,2,1642,[303 315 272 276 509],13,5,6022,3.6652465003043213,20.0,20.0
9643,2,1643,[303 315 272 276 509],894,5,6027,3.6660583941605838,20.0,20.0
9644,2,1644,[303 315 272 276 509],537,5,6032,3.6668693009118543,20.0,20.0
9645,2,1645,[209 218 293 315 299],145,4,6036,3.667071688942892,20.0,0.0
9646,2,1646,[303 315 272 276 509],894,5,6041,3.667880995749848,20.0,20.0
9647,2,1647,[303 315 272 276 509],894,5,6046,3.6686893203883497,20.0,20.0
9648,2,1648,[303 315 272 276 509],537,5,6051,3.6694966646452394,20.0,20.0
9649,2,1649,[303 315 272 276 509],894,5,6056,3.6703030303030304,20.0,20.0
9650,2,1650,[303 315 272 276 509],537,5,6061,3.671108419139915,20.0,20.0
9651,2,1651,[303 315 272 276 509],537,5,6066,3.671912832929782,20.0,20.0
9652,2,1652,[303 315 272 276 509],894,5,6071,3.672716273442226,20.0,20.0
9653,2,1653,[303 315 272 276 509],537,5,6076,3.6735187424425635,20.0,20.0
9654,2,1654,[303 315 272 276 509],13,5,6081,3.674320241691843,20.0,20.0
9655,2,1655,[321 275 299 241 212],537,1,6082,3.672705314009662,0.0,20.0
9656,2,1656,[303 315 272 276 509],537,5,6087,3.673506336753168,20.0,20.0
9657,2,1657,[303 315 272 276 509],894,5,6092,3.674306393244873,20.0,20.0
9658,2,1658,[303 315 272 276 509],537,5,6097,3.6751054852320677,20.0,20.0
9659,2,1659,[303 315 272 276 509],13,5,6102,3.675903614457831,20.0,20.0
9660,2,1660,[303 315 272 276 509],894,5,6107,3.6767007826610474,20.0,20.0
9661,2,1661,[303 315 272 276 509],13,5,6112,3.677496991576414,20.0,20.0
9662,2,1662,[303 315 272 276 509],894,5,6117,3.678292242934456,20.0,20.0
9663,2,1663,[303 315 272 276 509],13,5,6122,3.6790865384615383,20.0,20.0
9664,2,1664,[303 315 272 276 509],537,5,6127,3.6798798798798797,20.0,20.0
9665,2,1665,[303 315 272 276 509],894,5,6132,3.680672268907563,20.0,20.0
9666,2,1666,[303 315 272 276 509],537,5,6137,3.681463707258548,20.0,20.0
9667,2,1667,[303 315 272 276 509],894,5,6142,3.682254196642686,20.0,20.0
9668,2,1668,[303 315 272 276 509],537,5,6147,3.6830437387657278,20.0,20.0
9669,2,1669,[202 216 217 429 507],13,2,6149,3.6820359281437125,0.0,0.0
9670,2,1670,[303 315 272 276 509],13,5,6154,3.682824655894674,20.0,20.0
9671,2,1671,[303 315 272 276 509],894,5,6159,3.6836124401913874,20.0,20.0
9672,2,1672,[303 315 272 276 509],537,5,6164,3.6843992827256424,20.0,20.0
9673,2,1673,[303 315 272 276 509],894,5,6169,3.685185185185185,20.0,20.0
9674,2,1674,[303 315 272 276 509],894,5,6174,3.6859701492537313,20.0,20.0
9675,2,1675,[303 315 272 276 509],13,5,6179,3.6867541766109784,20.0,20.0
9676,2,1676,[303 315 272 276 509],894,5,6184,3.687537268932618,20.0,20.0
9677,2,1677,[303 315 272 276 509],537,5,6189,3.6883194278903457,20.0,20.0
9678,2,1678,[256 276 326 316 264],894,2,6191,3.6873138773079215,20.0,20.0
9679,2,1679,[303 315 272 276 509],13,5,6196,3.6880952380952383,20.0,20.0
9680,2,1680,[303 315 272 276 509],13,5,6201,3.6888756692444975,20.0,20.0
9681,2,1681,[212 367 508 243 223],92,3,6204,3.6884661117717004,20.0,0.0
9682,2,1682,[303 315 272 276 509],537,5,6209,3.689245395127748,20.0,20.0
9683,2,1683,[303 315 272 276 509],13,5,6214,3.6900237529691213,20.0,20.0
9684,2,1684,[303 315 272 276 509],537,5,6219,3.69080118694362,20.0,20.0
9685,2,1685,[303 315 272 276 509],894,5,6224,3.6915776986951365,20.0,20.0
9686,2,1686,[303 315 272 276 509],894,5,6229,3.6923532898636635,20.0,20.0
9687,2,1687,[303 315 272 276 509],894,5,6234,3.693127962085308,20.0,20.0
9688,2,1688,[303 315 272 276 509],13,5,6239,3.693901716992303,20.0,20.0
9689,2,1689,[303 315 272 276 509],537,5,6244,3.694674556213018,20.0,20.0
9690,2,1690,[303 315 272 276 509],894,5,6249,3.6954464813719694,20.0,20.0
9691,2,1691,[280 326 261 336 420],13,2,6251,3.6944444444444446,0.0,0.0
9692,2,1692,[420 213 431 232 321],311,2,6253,3.693443591258122,0.0,0.0
9693,2,1693,[481 208 367 206 213],234,4,6257,3.6936245572609208,0.0,0.0
9694,2,1694,[303 315 272 276 509],537,5,6262,3.6943952802359883,20.0,20.0
9695,2,1695,[303 315 272 276 509],537,5,6267,3.6951650943396226,20.0,20.0
9696,2,1696,[303 315 272 276 509],894,5,6272,3.6959340011785504,20.0,20.0
9697,2,1697,[303 315 272 276 509],537,5,6277,3.6967020023557127,20.0,20.0
9698,2,1698,[303 315 272 276 509],894,5,6282,3.697469099470277,20.0,20.0
9699,2,1699,[303 315 272 276 509],537,5,6287,3.698235294117647,20.0,20.0
9700,2,1700,[303 315 272 276 509],537,5,6292,3.699000587889477,20.0,20.0
9701,2,1701,[303 315 272 276 509],537,5,6297,3.699764982373678,20.0,20.0
9702,2,1702,[303 315 272 276 509],894,5,6302,3.7005284791544333,20.0,20.0
9703,2,1703,[303 315 272 276 509],894,5,6307,3.7012910798122065,20.0,20.0
9704,2,1704,[303 315 272 276 509],537,5,6312,3.7020527859237538,20.0,20.0
9705,2,1705,[303 315 272 276 509],537,5,6317,3.7028135990621336,20.0,20.0
9706,2,1706,[301 321 208 478 223],234,1,6318,3.701230228471002,20.0,0.0
9707,2,1707,[303 315 272 276 509],537,5,6323,3.701990632318501,20.0,20.0
9708,2,1708,[303 315 272 276 509],894,5,6328,3.702750146284377,20.0,20.0
9709,2,1709,[303 315 272 276 509],13,5,6333,3.7035087719298247,20.0,20.0
9710,2,1710,[303 315 272 276 509],894,5,6338,3.7042665108123902,20.0,20.0
9711,2,1711,[303 315 272 276 509],13,5,6343,3.705023364485981,20.0,20.0
9712,2,1712,[303 315 272 276 509],537,5,6348,3.7057793345008756,20.0,20.0
9713,2,1713,[255 227 213 275 212],474,4,6352,3.705950991831972,0.0,20.0
9714,2,1714,[303 315 272 276 509],537,5,6357,3.7067055393586004,20.0,20.0
9715,2,1715,[303 315 272 276 509],537,5,6362,3.7074592074592077,20.0,20.0
9716,2,1716,[303 315 272 276 509],894,5,6367,3.708211997670355,20.0,20.0
9717,2,1717,[303 315 272 276 509],13,5,6372,3.708963911525029,20.0,20.0
9718,2,1718,[303 315 272 276 509],537,5,6377,3.7097149505526468,20.0,20.0
9719,2,1719,[303 315 272 276 509],537,5,6382,3.7104651162790696,20.0,20.0
9720,2,1720,[303 315 272 276 509],13,5,6387,3.7112144102266122,20.0,20.0
9721,2,1721,[303 315 272 276 509],894,5,6392,3.7119628339140536,20.0,20.0
9722,2,1722,[303 315 272 276 509],13,5,6397,3.7127103888566455,20.0,20.0
9723,2,1723,[303 315 272 276 509],13,5,6402,3.7134570765661254,20.0,20.0
9724,2,1724,[303 315 272 276 509],537,5,6407,3.7142028985507247,20.0,20.0
9725,2,1725,[303 315 272 276 509],537,5,6412,3.7149478563151797,20.0,20.0
9726,2,1726,[303 315 272 276 509],13,5,6417,3.7156919513607414,20.0,20.0
9727,2,1727,[303 315 272 276 509],894,5,6422,3.716435185185185,20.0,20.0
9728,2,1728,[303 315 272 276 509],13,5,6427,3.7171775592828222,20.0,20.0
9729,2,1729,[315 201 344 202 367],13,2,6429,3.716184971098266,20.0,0.0
9730,2,1730,[303 315 272 276 509],13,5,6434,3.7169266320046215,20.0,20.0
9731,2,1731,[303 315 272 276 509],13,5,6439,3.717667436489607,20.0,20.0
9732,2,1732,[303 315 272 276 509],537,5,6444,3.7184073860357763,20.0,20.0
9733,2,1733,[508 232 239 230 226],387,1,6445,3.7168396770472896,0.0,0.0
9734,2,1734,[303 315 272 276 509],894,5,6450,3.717579250720461,20.0,20.0
9735,2,1735,[303 315 272 276 509],13,5,6455,3.7183179723502304,20.0,20.0
9736,2,1736,[303 315 272 276 509],894,5,6460,3.719055843408175,20.0,20.0
9737,2,1737,[303 315 272 276 509],13,5,6465,3.7197928653624857,20.0,20.0
9738,2,1738,[303 315 272 276 509],13,5,6470,3.720529039677976,20.0,20.0
9739,2,1739,[303 315 272 276 509],13,5,6475,3.721264367816092,20.0,20.0
9740,2,1740,[303 315 272 276 509],537,5,6480,3.7219988512349222,20.0,20.0
9741,2,1741,[212 202 321 217 250],184,3,6483,3.72158438576349,0.0,0.0
9742,2,1742,[303 315 272 276 509],537,5,6488,3.7223178427997703,20.0,20.0
9743,2,1743,[303 315 272 276 509],13,5,6493,3.7230504587155964,20.0,20.0
9744,2,1744,[284 202 201 291 283],537,1,6494,3.721489971346705,0.0,0.0
9745,2,1745,[303 315 272 276 509],13,5,6499,3.7222222222222223,20.0,20.0
9746,2,1746,[303 315 272 276 509],537,5,6504,3.7229536348025185,20.0,20.0
9747,2,1747,[303 315 272 276 509],894,5,6509,3.723684210526316,20.0,20.0
9748,2,1748,[303 315 272 276 509],537,5,6514,3.724413950829045,20.0,20.0
9749,2,1749,[303 315 272 276 509],537,5,6519,3.725142857142857,20.0,20.0
9750,2,1750,[303 315 272 276 509],13,5,6524,3.7258709308966305,20.0,20.0
9751,2,1751,[303 315 272 276 509],13,5,6529,3.7265981735159817,20.0,20.0
9752,2,1752,[303 315 272 276 509],894,5,6534,3.7273245864232742,20.0,20.0
9753,2,1753,[303 315 272 276 509],13,5,6539,3.728050171037628,20.0,20.0
9754,2,1754,[303 315 272 276 509],894,5,6544,3.7287749287749286,20.0,20.0
9755,2,1755,[303 315 272 276 509],537,5,6549,3.729498861047836,20.0,20.0
9756,2,1756,[303 315 272 276 509],894,5,6554,3.730221969265794,20.0,20.0
9757,2,1757,[303 315 272 276 509],537,5,6559,3.7309442548350398,20.0,20.0
9758,2,1758,[303 315 272 276 509],894,5,6564,3.7316657191586127,20.0,20.0
9759,2,1759,[509 272 212 211 215],90,4,6568,3.731818181818182,0.0,20.0
9760,2,1760,[303 315 272 276 509],894,5,6573,3.7325383304940374,20.0,20.0
9761,2,1761,[303 315 272 276 509],537,5,6578,3.7332576617480138,20.0,20.0
9762,2,1762,[290 250 230 507 220],648,2,6580,3.7322745320476463,0.0,0.0
9763,2,1763,[303 315 272 276 509],537,5,6585,3.7329931972789114,20.0,20.0
9764,2,1764,[303 315 272 276 509],894,5,6590,3.73371104815864,20.0,20.0
9765,2,1765,[303 315 272 276 509],894,5,6595,3.7344280860702153,20.0,20.0
9766,2,1766,[303 315 272 276 509],894,5,6600,3.735144312393888,20.0,20.0
9767,2,1767,[303 315 272 276 509],537,5,6605,3.7358597285067874,20.0,20.0
9768,2,1768,[303 315 272 276 509],894,5,6610,3.736574335782928,20.0,20.0
9769,2,1769,[303 315 272 276 509],894,5,6615,3.73728813559322,20.0,20.0
9770,2,1770,[303 315 272 276 509],537,5,6620,3.738001129305477,20.0,20.0
9771,2,1771,[303 315 272 276 509],894,5,6625,3.7387133182844243,20.0,20.0
9772,2,1772,[303 315 272 276 509],13,5,6630,3.739424703891709,20.0,20.0
9773,2,1773,[303 315 272 276 509],13,5,6635,3.7401352874859075,20.0,20.0
9774,2,1774,[303 315 272 276 509],13,5,6640,3.740845070422535,20.0,20.0
9775,2,1775,[303 315 272 276 509],894,5,6645,3.741554054054054,20.0,20.0
9776,2,1776,[244 268 239 485 301],334,1,6646,3.7400112549240294,0.0,0.0
9777,2,1777,[303 315 272 276 509],13,5,6651,3.7407199100112485,20.0,20.0
9778,2,1778,[303 315 272 276 509],537,5,6656,3.7414277684092188,20.0,20.0
9779,2,1779,[303 315 272 276 509],537,5,6661,3.742134831460674,20.0,20.0
9780,2,1780,[303 315 272 276 509],894,5,6666,3.742841100505334,20.0,20.0
9781,2,1781,[321 272 227 217 350],13,2,6668,3.7418630751964086,0.0,0.0
9782,2,1782,[303 315 272 276 509],894,5,6673,3.7425687044307345,20.0,20.0
9783,2,1783,[300 250 201 231 226],774,0,6673,3.7404708520179373,0.0,20.0
9784,2,1784,[303 315 272 276 509],13,5,6678,3.7411764705882353,20.0,20.0
9785,2,1785,[303 315 272 276 509],894,5,6683,3.741881298992161,20.0,20.0
9786,2,1786,[303 315 272 276 509],537,5,6688,3.7425853385562395,20.0,20.0
9787,2,1787,[303 315 272 276 509],894,5,6693,3.7432885906040267,20.0,20.0
9788,2,1788,[303 315 272 276 509],894,5,6698,3.743991056456121,20.0,20.0
9789,2,1789,[303 315 272 276 509],894,5,6703,3.7446927374301677,20.0,20.0
9790,2,1790,[243 283 216 259 301],537,1,6704,3.7431602456728084,0.0,0.0
9791,2,1791,[303 315 272 276 509],537,5,6709,3.743861607142857,20.0,20.0
9792,2,1792,[303 315 272 276 509],537,5,6714,3.744562186279978,20.0,20.0
9793,2,1793,[303 315 272 276 509],894,5,6719,3.7452619843924193,20.0,20.0
9794,2,1794,[216 250 378 420 232],85,2,6721,3.744289693593315,0.0,0.0
9795,2,1795,[303 315 272 276 509],894,5,6726,3.744988864142539,20.0,20.0
9796,2,1796,[303 315 272 276 509],537,5,6731,3.7456872565386754,20.0,20.0
9797,2,1797,[303 315 272 276 509],13,5,6736,3.746384872080089,20.0,20.0
9798,2,1798,[303 315 272 276 509],537,5,6741,3.747081712062257,20.0,20.0
9799,2,1799,[303 315 272 276 509],537,5,6746,3.747777777777778,20.0,20.0
9800,2,1800,[303 315 272 276 509],13,5,6751,3.7484730705163796,20.0,20.0
9801,2,1801,[303 315 272 276 509],894,5,6756,3.749167591564928,20.0,20.0
9802,2,1802,[303 315 272 276 509],537,5,6761,3.749861342207432,20.0,20.0
9803,2,1803,[303 315 272 276 509],13,5,6766,3.7505543237250554,20.0,20.0
9804,2,1804,[303 315 272 276 509],537,5,6771,3.751246537396122,20.0,20.0
9805,2,1805,[272 336 301 223 429],13,3,6774,3.750830564784053,20.0,0.0
9806,2,1806,[264 255 431 326 295],548,5,6779,3.7515218594355284,0.0,0.0
9807,2,1807,[508 276 344 256 298],894,2,6781,3.750553097345133,0.0,20.0
9808,2,1808,[303 315 272 276 509],894,5,6786,3.7512437810945274,20.0,20.0
9809,2,1809,[303 315 272 276 509],894,5,6791,3.7519337016574585,20.0,20.0
9810,2,1810,[303 315 272 276 509],894,5,6796,3.7526228602981777,20.0,20.0
9811,2,1811,[303 315 272 276 509],13,5,6801,3.7533112582781456,20.0,20.0
9812,2,1812,[303 315 272 276 509],894,5,6806,3.75399889685604,20.0,20.0
9813,2,1813,[303 315 272 276 509],13,5,6811,3.754685777287762,20.0,20.0
9814,2,1814,[303 315 272 276 509],537,5,6816,3.755371900826446,20.0,20.0
9815,2,1815,[303 315 272 276 509],894,5,6821,3.756057268722467,20.0,20.0
9816,2,1816,[303 315 272 276 509],13,5,6826,3.7567418822234453,20.0,20.0
9817,2,1817,[303 315 272 276 509],13,5,6831,3.757425742574257,20.0,20.0
9818,2,1818,[303 315 272 276 509],894,5,6836,3.758108851017042,20.0,20.0
9819,2,1819,[303 315 272 276 509],13,5,6841,3.7587912087912088,20.0,20.0
9820,2,1820,[220 507 206 215 275],406,1,6842,3.757276221856123,0.0,20.0
9821,2,1821,[336 331 231 222 420],13,1,6843,3.75576289791438,0.0,20.0
9822,2,1822,[303 315 272 276 509],894,5,6848,3.7564454196379593,20.0,20.0
9823,2,1823,[303 315 272 276 509],13,5,6853,3.7571271929824563,20.0,20.0
9824,2,1824,[303 315 272 276 509],537,5,6858,3.757808219178082,20.0,20.0
9825,2,1825,[303 315 272 276 509],537,5,6863,3.758488499452355,20.0,20.0
9826,2,1826,[367 217 255 226 295],378,1,6864,3.7569786535303775,0.0,0.0
9827,2,1827,[303 315 272 276 509],13,5,6869,3.7576586433260393,20.0,20.0
9828,2,1828,[303 315 272 276 509],894,5,6874,3.758337889557135,20.0,20.0
9829,2,1829,[303 315 272 276 509],894,5,6879,3.759016393442623,20.0,20.0
9830,2,1830,[303 315 272 276 509],13,5,6884,3.7596941561987984,20.0,20.0
9831,2,1831,[303 315 272 276 509],894,5,6889,3.7603711790393013,20.0,20.0
9832,2,1832,[303 315 272 276 509],894,5,6894,3.7610474631751227,20.0,20.0
9833,2,1833,[326 240 250 209 254],749,2,6896,3.7600872410032715,0.0,0.0
9834,2,1834,[303 315 272 276 509],13,5,6901,3.7607629427792917,20.0,20.0
9835,2,1835,[303 315 272 276 509],537,5,6906,3.761437908496732,20.0,20.0
9836,2,1836,[303 315 272 276 509],13,5,6911,3.762112139357648,20.0,20.0
9837,2,1837,[303 315 272 276 509],537,5,6916,3.76278563656148,20.0,20.0
9838,2,1838,[303 315 272 276 509],537,5,6921,3.763458401305057,20.0,20.0
9839,2,1839,[303 315 272 276 509],894,5,6926,3.764130434782609,20.0,20.0
9840,2,1840,[303 315 272 276 509],894,5,6931,3.764801738185769,20.0,20.0
9841,2,1841,[303 315 272 276 509],894,5,6936,3.765472312703583,20.0,20.0
9842,2,1842,[303 315 272 276 509],13,5,6941,3.7661421595225177,20.0,20.0
9843,2,1843,[303 315 272 276 509],13,5,6946,3.7668112798264644,20.0,20.0
9844,2,1844,[303 315 272 276 509],894,5,6951,3.767479674796748,20.0,20.0
9845,2,1845,[303 315 272 276 509],894,5,6956,3.7681473456121344,20.0,20.0
9846,2,1846,[275 301 222 231 230],13,0,6956,3.7661072008662697,0.0,40.0
9847,2,1847,[303 315 272 276 509],894,5,6961,3.7667748917748916,20.0,20.0
9848,2,1848,[303 315 272 276 509],13,5,6966,3.7674418604651163,20.0,20.0
9849,2,1849,[303 315 272 276 509],894,5,6971,3.768108108108108,20.0,20.0
9850,2,1850,[316 222 211 202 226],102,1,6972,3.766612641815235,20.0,40.0
9851,2,1851,[303 315 272 276 509],13,5,6977,3.7672786177105833,20.0,20.0
9852,2,1852,[303 315 272 276 509],13,5,6982,3.7679438747976253,20.0,20.0
9853,2,1853,[303 315 272 276 509],13,5,6987,3.7686084142394822,20.0,20.0
9854,2,1854,[303 315 272 276 509],13,5,6992,3.7692722371967653,20.0,20.0
9855,2,1855,[303 315 272 276 509],13,5,6997,3.7699353448275863,20.0,20.0
9856,2,1856,[303 315 272 276 509],537,5,7002,3.7705977382875604,20.0,20.0
9857,2,1857,[303 315 272 276 509],13,5,7007,3.771259418729817,20.0,20.0
9858,2,1858,[303 315 272 276 509],13,5,7012,3.771920387305003,20.0,20.0
9859,2,1859,[303 315 272 276 509],13,5,7017,3.77258064516129,20.0,20.0
9860,2,1860,[303 315 272 276 509],13,5,7022,3.773240193444385,20.0,20.0
9861,2,1861,[303 315 272 276 509],13,5,7027,3.7738990332975297,20.0,20.0
9862,2,1862,[303 315 272 276 509],537,5,7032,3.7745571658615136,20.0,20.0
9863,2,1863,[303 315 272 276 509],894,5,7037,3.7752145922746783,20.0,20.0
9864,2,1864,[303 315 272 276 509],537,5,7042,3.7758713136729223,20.0,20.0
9865,2,1865,[303 315 272 276 509],894,5,7047,3.7765273311897105,20.0,20.0
9866,2,1866,[303 315 272 276 509],894,5,7052,3.777182645956079,20.0,20.0
9867,2,1867,[303 315 272 276 509],537,5,7057,3.7778372591006426,20.0,20.0
9868,2,1868,[303 315 272 276 509],13,5,7062,3.778491171749599,20.0,20.0
9869,2,1869,[303 315 272 276 509],537,5,7067,3.779144385026738,20.0,20.0
9870,2,1870,[303 315 272 276 509],537,5,7072,3.7797969000534475,20.0,20.0
9871,2,1871,[303 315 272 276 509],537,5,7077,3.780448717948718,20.0,20.0
9872,2,1872,[208 241 202 232 227],194,0,7077,3.778430325680726,0.0,0.0
9873,2,1873,[303 315 272 276 509],894,5,7082,3.7790821771611527,20.0,20.0
9874,2,1874,[303 315 272 276 509],13,5,7087,3.779733333333333,20.0,20.0
9875,2,1875,[303 315 272 276 509],894,5,7092,3.7803837953091683,20.0,20.0
9876,2,1876,[303 315 272 276 509],537,5,7097,3.7810335641981885,20.0,20.0
9877,2,1877,[303 315 272 276 509],13,5,7102,3.7816826411075612,20.0,20.0
9878,2,1878,[303 315 272 276 509],13,5,7107,3.7823310271420967,20.0,20.0
9879,2,1879,[303 315 272 276 509],894,5,7112,3.782978723404255,20.0,20.0
9880,2,1880,[303 315 272 276 509],13,5,7117,3.783625730994152,20.0,20.0
9881,2,1881,[303 315 272 276 509],894,5,7122,3.784272051009564,20.0,20.0
9882,2,1882,[303 315 272 276 509],894,5,7127,3.7849176845459374,20.0,20.0
9883,2,1883,[303 315 272 276 509],894,5,7132,3.7855626326963905,20.0,20.0
9884,2,1884,[303 315 272 276 509],537,5,7137,3.786206896551724,20.0,20.0
9885,2,1885,[303 315 272 276 509],894,5,7142,3.7868504772004243,20.0,20.0
9886,2,1886,[303 315 272 276 509],537,5,7147,3.78749337572867,20.0,20.0
9887,2,1887,[303 315 272 276 509],894,5,7152,3.788135593220339,20.0,20.0
9888,2,1888,[303 315 272 276 509],13,5,7157,3.788777130757014,20.0,20.0
9889,2,1889,[303 315 272 276 509],537,5,7162,3.7894179894179896,20.0,20.0
9890,2,1890,[303 315 272 276 509],13,5,7167,3.790058170280275,20.0,20.0
9891,2,1891,[303 315 272 276 509],13,5,7172,3.7906976744186047,20.0,20.0
9892,2,1892,[316 227 231 261 431],13,2,7174,3.7897517168515584,20.0,0.0
9893,2,1893,[303 315 272 276 509],894,5,7179,3.79039070749736,20.0,20.0
9894,2,1894,[303 315 272 276 509],537,5,7184,3.791029023746702,20.0,20.0
9895,2,1895,[303 315 272 276 509],537,5,7189,3.7916666666666665,20.0,20.0
9896,2,1896,[303 315 272 276 509],894,5,7194,3.7923036373220875,20.0,20.0
9897,2,1897,[303 315 272 276 509],894,5,7199,3.792939936775553,20.0,20.0
9898,2,1898,[303 315 272 276 509],894,5,7204,3.7935755660874144,20.0,20.0
9899,2,1899,[303 315 272 276 509],894,5,7209,3.7942105263157893,20.0,20.0
9900,2,1900,[303 315 272 276 509],13,5,7214,3.7948448185165704,20.0,20.0
9901,2,1901,[303 315 272 276 509],13,5,7219,3.795478443743428,20.0,20.0
9902,2,1902,[303 315 272 276 509],537,5,7224,3.7961114030478194,20.0,20.0
9903,2,1903,[303 315 272 276 509],537,5,7229,3.7967436974789917,20.0,20.0
9904,2,1904,[303 315 272 276 509],13,5,7234,3.7973753280839895,20.0,20.0
9905,2,1905,[303 315 272 276 509],13,5,7239,3.79800629590766,20.0,20.0
9906,2,1906,[303 315 272 276 509],13,5,7244,3.7986366019926585,20.0,20.0
9907,2,1907,[303 315 272 276 509],13,5,7249,3.799266247379455,20.0,20.0
9908,2,1908,[236 316 301 272 324],334,4,7253,3.7993713986380304,20.0,0.0
9909,2,1909,[303 315 272 276 509],13,5,7258,3.8,20.0,20.0
9910,2,1910,[303 315 272 276 509],894,5,7263,3.8006279434850865,20.0,20.0
9911,2,1911,[303 315 272 276 509],894,5,7268,3.801255230125523,20.0,20.0
9912,2,1912,[303 315 272 276 509],894,5,7273,3.801881860951385,20.0,20.0
9913,2,1913,[295 272 202 283 264],479,3,7276,3.8014629049111806,0.0,0.0
9914,2,1914,[303 315 272 276 509],894,5,7281,3.802088772845953,20.0,20.0
9915,2,1915,[303 315 272 276 509],537,5,7286,3.8027139874739038,20.0,20.0
9916,2,1916,[280 231 429 272 303],13,4,7290,3.8028169014084505,0.0,0.0
9917,2,1917,[303 315 272 276 509],894,5,7295,3.8034410844629822,20.0,20.0
9918,2,1918,[303 315 272 276 509],894,5,7300,3.804064616988015,20.0,20.0
9919,2,1919,[508 284 275 316 213],85,1,7301,3.802604166666667,20.0,20.0
9920,2,1920,[303 315 272 276 509],894,5,7306,3.8032274856845394,20.0,20.0
9921,2,1921,[303 315 272 276 509],13,5,7311,3.803850156087409,20.0,20.0
9922,2,1922,[303 315 272 276 509],537,5,7316,3.8044721788871554,20.0,20.0
9923,2,1923,[303 315 272 276 509],537,5,7321,3.805093555093555,20.0,20.0
9924,2,1924,[297 284 236 213 315],894,4,7325,3.8051948051948052,40.0,0.0
9925,2,1925,[303 315 272 276 509],894,5,7330,3.8058151609553477,20.0,20.0
9926,2,1926,[303 315 272 276 509],13,5,7335,3.806434872859367,20.0,20.0
9927,2,1927,[303 315 272 276 509],13,5,7340,3.8070539419087135,20.0,20.0
9928,2,1928,[303 315 272 276 509],13,5,7345,3.8076723691031624,20.0,20.0
9929,2,1929,[303 315 272 276 509],537,5,7350,3.8082901554404147,20.0,20.0
9930,2,1930,[303 315 272 276 509],894,5,7355,3.8089073019161055,20.0,20.0
9931,2,1931,[303 315 272 276 509],894,5,7360,3.8095238095238093,20.0,20.0
9932,2,1932,[303 315 272 276 509],894,5,7365,3.810139679255044,20.0,20.0
9933,2,1933,[303 315 272 276 509],894,5,7370,3.8107549120992763,20.0,20.0
9934,2,1934,[303 315 272 276 509],13,5,7375,3.8113695090439275,20.0,20.0
9935,2,1935,[303 315 272 276 509],537,5,7380,3.81198347107438,20.0,20.0
9936,2,1936,[303 315 272 276 509],537,5,7385,3.8125967991739804,20.0,20.0
9937,2,1937,[303 315 272 276 509],537,5,7390,3.8132094943240453,20.0,20.0
9938,2,1938,[303 315 272 276 509],13,5,7395,3.813821557503868,20.0,20.0
9939,2,1939,[303 315 272 276 509],13,5,7400,3.814432989690722,20.0,20.0
9940,2,1940,[303 315 272 276 509],537,5,7405,3.815043791859866,20.0,20.0
9941,2,1941,[303 315 272 276 509],537,5,7410,3.815653964984552,20.0,20.0
9942,2,1942,[303 315 272 276 509],894,5,7415,3.816263510036027,20.0,20.0
9943,2,1943,[303 315 272 276 509],13,5,7420,3.816872427983539,20.0,20.0
9944,2,1944,[303 315 272 276 509],894,5,7425,3.8174807197943443,20.0,20.0
9945,2,1945,[303 315 272 276 509],894,5,7430,3.8180883864337103,20.0,20.0
9946,2,1946,[303 315 272 276 509],894,5,7435,3.8186954288649204,20.0,20.0
9947,2,1947,[303 315 272 276 509],537,5,7440,3.8193018480492813,20.0,20.0
9948,2,1948,[303 315 272 276 509],894,5,7445,3.819907644946126,20.0,20.0
9949,2,1949,[303 315 272 276 509],537,5,7450,3.8205128205128207,20.0,20.0
9950,2,1950,[301 236 239 431 240],279,5,7455,3.821117375704767,0.0,0.0
9951,2,1951,[303 315 272 276 509],13,5,7460,3.82172131147541,20.0,20.0
9952,2,1952,[303 315 272 276 509],13,5,7465,3.822324628776242,20.0,20.0
9953,2,1953,[303 315 272 276 509],537,5,7470,3.8229273285568066,20.0,20.0
9954,2,1954,[303 315 272 276 509],537,5,7475,3.823529411764706,20.0,20.0
9955,2,1955,[303 315 272 276 509],537,5,7480,3.8241308793456033,20.0,20.0
9956,2,1956,[303 315 272 276 509],13,5,7485,3.8247317322432295,20.0,20.0
9957,2,1957,[303 509 209 246 216],6,3,7488,3.8243105209397346,0.0,0.0
9958,2,1958,[303 315 272 276 509],537,5,7493,3.8249106687085246,20.0,20.0
9959,2,1959,[303 315 272 276 509],894,5,7498,3.8255102040816324,20.0,20.0
9960,2,1960,[303 315 272 276 509],13,5,7503,3.8261091279959203,20.0,20.0
9961,2,1961,[303 315 272 276 509],894,5,7508,3.8267074413863407,20.0,20.0
9962,2,1962,[303 315 272 276 509],894,5,7513,3.8273051451859397,20.0,20.0
9963,2,1963,[303 315 272 276 509],894,5,7518,3.827902240325866,20.0,20.0
9964,2,1964,[275 507 230 431 301],13,0,7518,3.8259541984732826,0.0,20.0
9965,2,1965,[303 315 272 276 509],537,5,7523,3.826551373346897,20.0,20.0
9966,2,1966,[303 315 272 276 509],894,5,7528,3.8271479410269444,20.0,20.0
9967,2,1967,[218 290 429 284 202],234,1,7529,3.825711382113821,0.0,0.0
9968,2,1968,[303 315 272 276 509],537,5,7534,3.8263077704418484,20.0,20.0
9969,2,1969,[222 272 241 208 231],13,2,7536,3.8253807106598985,0.0,20.0
9970,2,1970,[303 315 272 276 509],13,5,7541,3.8259766615931,20.0,20.0
9971,2,1971,[303 315 272 276 509],537,5,7546,3.8265720081135903,20.0,20.0
9972,2,1972,[303 315 272 276 509],13,5,7551,3.8271667511403953,20.0,20.0
9973,2,1973,[303 315 272 276 509],894,5,7556,3.8277608915906787,20.0,20.0
9974,2,1974,[303 315 272 276 509],894,5,7561,3.828354430379747,20.0,20.0
9975,2,1975,[303 315 272 276 509],13,5,7566,3.8289473684210527,20.0,20.0
9976,2,1976,[303 315 272 276 509],13,5,7571,3.829539706626201,20.0,20.0
9977,2,1977,[303 315 272 276 509],537,5,7576,3.8301314459049545,20.0,20.0
9978,2,1978,[303 315 272 276 509],13,5,7581,3.830722587165235,20.0,20.0
9979,2,1979,[303 315 272 276 509],537,5,7586,3.8313131313131312,20.0,20.0
9980,2,1980,[303 315 272 276 509],537,5,7591,3.8319030792529025,20.0,20.0
9981,2,1981,[303 315 272 276 509],894,5,7596,3.832492431886983,20.0,20.0
9982,2,1982,[272 300 283 215 431],454,3,7599,3.832072617246596,0.0,20.0
9983,2,1983,[303 315 272 276 509],894,5,7604,3.8326612903225805,20.0,20.0
9984,2,1984,[303 315 272 276 509],13,5,7609,3.8332493702770782,20.0,20.0
9985,2,1985,[303 315 272 276 509],13,5,7614,3.8338368580060425,20.0,20.0
9986,2,1986,[303 315 272 276 509],537,5,7619,3.8344237544036237,20.0,20.0
9987,2,1987,[303 315 272 276 509],13,5,7624,3.835010060362173,20.0,20.0
9988,2,1988,[303 315 272 276 509],13,5,7629,3.8355957767722475,20.0,20.0
9989,2,1989,[303 315 272 276 509],894,5,7634,3.836180904522613,20.0,20.0
9990,2,1990,[303 315 272 276 509],13,5,7639,3.836765444500251,20.0,20.0
9991,2,1991,[303 315 272 276 509],894,5,7644,3.8373493975903616,20.0,20.0
9992,2,1992,[303 315 272 276 509],894,5,7649,3.8379327646763675,20.0,20.0
9993,2,1993,[303 315 272 276 509],13,5,7654,3.8385155466399197,20.0,20.0
9994,2,1994,[303 315 272 276 509],537,5,7659,3.8390977443609025,20.0,20.0
9995,2,1995,[303 315 272 276 509],537,5,7664,3.8396793587174347,20.0,20.0
9996,2,1996,[303 315 272 276 509],894,5,7669,3.840260390585879,20.0,20.0
9997,2,1997,[303 315 272 276 509],894,5,7674,3.840840840840841,20.0,20.0
9998,2,1998,[303 315 272 276 509],13,5,7679,3.8414207103551776,20.0,20.0
9999,2,1999,[303 315 272 276 509],894,5,7684,3.842,20.0,20.0
10000,2,2000,[303 315 272 276 509],537,5,7689,3.842578710644678,20.0,20.0
10001,2,2001,[303 315 272 276 509],537,5,7694,3.843156843156843,20.0,20.0
10002,2,2002,[303 315 272 276 509],894,5,7699,3.8437343984023964,20.0,20.0
10003,2,2003,[303 315 272 276 509],537,5,7704,3.844311377245509,20.0,20.0
10004,2,2004,[331 212 303 255 256],894,3,7707,3.8438902743142145,0.0,0.0
10005,2,2005,[303 315 272 276 509],537,5,7712,3.844466600199402,20.0,20.0
10006,2,2006,[303 315 272 276 509],537,5,7717,3.845042351768809,20.0,20.0
10007,2,2007,[303 315 272 276 509],13,5,7722,3.845617529880478,20.0,20.0
10008,2,2008,[303 315 272 276 509],537,5,7727,3.8461921353907416,20.0,20.0
10009,2,2009,[303 315 272 276 509],13,5,7732,3.846766169154229,20.0,20.0
10010,2,2010,[303 315 272 276 509],537,5,7737,3.8473396320238686,20.0,20.0
10011,2,2011,[303 315 272 276 509],537,5,7742,3.8479125248508947,20.0,20.0
10012,2,2012,[303 315 272 276 509],894,5,7747,3.8484848484848486,20.0,20.0
10013,2,2013,[303 315 272 276 509],13,5,7752,3.849056603773585,20.0,20.0
10014,2,2014,[303 315 272 276 509],894,5,7757,3.8496277915632753,20.0,20.0
10015,2,2015,[420 261 336 384 508],13,1,7758,3.8482142857142856,0.0,0.0
10016,2,2016,[303 315 272 276 509],894,5,7763,3.8487853247397124,20.0,20.0
10017,2,2017,[303 315 272 276 509],537,5,7768,3.8493557978196233,20.0,20.0
10018,2,2018,[303 315 272 276 509],537,5,7773,3.849925705794948,20.0,20.0
10019,2,2019,[303 315 272 276 509],13,5,7778,3.8504950495049504,20.0,20.0
10020,2,2020,[303 315 272 276 509],894,5,7783,3.851063829787234,20.0,20.0
10021,2,2021,[303 315 272 276 509],13,5,7788,3.851632047477745,20.0,20.0
10022,2,2022,[295 254 291 276 240],294,2,7790,3.850716757291152,0.0,20.0
10023,2,2023,[303 315 272 276 509],894,5,7795,3.8512845849802373,20.0,20.0
10024,2,2024,[303 315 272 276 509],13,5,7800,3.8518518518518516,20.0,20.0
10025,2,2025,[303 315 272 276 509],537,5,7805,3.8524185587364266,20.0,20.0
10026,2,2026,[303 315 272 276 509],13,5,7810,3.852984706462753,20.0,20.0
10027,2,2027,[303 315 272 276 509],13,5,7815,3.853550295857988,20.0,20.0
10028,2,2028,[303 315 272 276 509],13,5,7820,3.854115327747659,20.0,20.0
10029,2,2029,[303 315 272 276 509],537,5,7825,3.854679802955665,20.0,20.0
10030,2,2030,[303 315 272 276 509],13,5,7830,3.8552437223042837,20.0,20.0
10031,2,2031,[276 227 315 218 226],145,2,7832,3.854330708661417,20.0,20.0
10032,2,2032,[303 315 272 276 509],13,5,7837,3.85489424495819,20.0,20.0
10033,2,2033,[303 315 272 276 509],537,5,7842,3.855457227138643,20.0,20.0
10034,2,2034,[303 315 272 276 509],13,5,7847,3.8560196560196562,20.0,20.0
10035,2,2035,[303 315 272 276 509],13,5,7852,3.856581532416503,20.0,20.0
10036,2,2036,[303 315 272 276 509],13,5,7857,3.857142857142857,20.0,20.0
10037,2,2037,[303 315 272 276 509],537,5,7862,3.857703631010795,20.0,20.0
10038,2,2038,[303 315 272 276 509],537,5,7867,3.8582638548307995,20.0,20.0
10039,2,2039,[303 315 272 276 509],894,5,7872,3.8588235294117648,20.0,20.0
10040,2,2040,[303 315 272 276 509],13,5,7877,3.8593826555609994,20.0,20.0
10041,2,2041,[303 315 272 276 509],894,5,7882,3.859941234084231,20.0,20.0
10042,2,2042,[303 315 272 276 509],13,5,7887,3.8604992657856094,20.0,20.0
10043,2,2043,[303 315 272 276 509],13,5,7892,3.8610567514677103,20.0,20.0
10044,2,2044,[303 315 272 276 509],13,5,7897,3.8616136919315402,20.0,20.0
10045,2,2045,[303 315 272 276 509],537,5,7902,3.8621700879765397,20.0,20.0
10046,2,2046,[211 298 230 241 217],387,1,7903,3.860771861260381,0.0,20.0
10047,2,2047,[303 315 272 276 509],894,5,7908,3.861328125,20.0,20.0
10048,2,2048,[303 315 272 276 509],537,5,7913,3.8618838457784284,20.0,20.0
10049,2,2049,[303 315 272 276 509],894,5,7918,3.862439024390244,20.0,20.0
10050,2,2050,[303 315 272 276 509],13,5,7923,3.862993661628474,20.0,20.0
10051,2,2051,[303 315 272 276 509],537,5,7928,3.8635477582846005,20.0,20.0
10052,2,2052,[303 315 272 276 509],13,5,7933,3.864101315148563,20.0,20.0
10053,2,2053,[213 508 315 209 316],334,3,7936,3.863680623174294,40.0,0.0
10054,2,2054,[303 315 272 276 509],537,5,7941,3.8642335766423357,20.0,20.0
10055,2,2055,[303 315 272 276 509],537,5,7946,3.864785992217899,20.0,20.0
10056,2,2056,[303 315 272 276 509],13,5,7951,3.8653378706854644,20.0,20.0
10057,2,2057,[303 315 272 276 509],13,5,7956,3.8658892128279883,20.0,20.0
10058,2,2058,[303 315 272 276 509],13,5,7961,3.866440019426906,20.0,20.0
10059,2,2059,[303 315 272 276 509],894,5,7966,3.866990291262136,20.0,20.0
10060,2,2060,[303 315 272 276 509],537,5,7971,3.8675400291120816,20.0,20.0
10061,2,2061,[303 315 272 276 509],537,5,7976,3.8680892337536372,20.0,20.0
10062,2,2062,[303 315 272 276 509],537,5,7981,3.868637905962191,20.0,20.0
10063,2,2063,[303 315 272 276 509],13,5,7986,3.869186046511628,20.0,20.0
10064,2,2064,[303 315 272 276 509],537,5,7991,3.869733656174334,20.0,20.0
10065,2,2065,[303 315 272 276 509],13,5,7996,3.8702807357212006,20.0,20.0
10066,2,2066,[303 315 272 276 509],894,5,8001,3.8708272859216257,20.0,20.0
10067,2,2067,[303 315 272 276 509],894,5,8006,3.87137330754352,20.0,20.0
10068,2,2068,[303 315 272 276 509],894,5,8011,3.871918801353311,20.0,20.0
10069,2,2069,[303 315 272 276 509],537,5,8016,3.872463768115942,20.0,20.0
10070,2,2070,[303 315 272 276 509],894,5,8021,3.873008208594882,20.0,20.0
10071,2,2071,[303 315 272 276 509],537,5,8026,3.8735521235521237,20.0,20.0
10072,2,2072,[303 315 272 276 509],537,5,8031,3.874095513748191,20.0,20.0
10073,2,2073,[303 315 272 276 509],13,5,8036,3.874638379942141,20.0,20.0
10074,2,2074,[303 315 272 276 509],13,5,8041,3.8751807228915665,20.0,20.0
10075,2,2075,[303 315 272 276 509],13,5,8046,3.8757225433526012,20.0,20.0
10076,2,2076,[303 315 272 276 509],537,5,8051,3.876263842079923,20.0,20.0
10077,2,2077,[303 315 272 276 509],13,5,8056,3.8768046198267565,20.0,20.0
10078,2,2078,[303 315 272 276 509],894,5,8061,3.8773448773448775,20.0,20.0
10079,2,2079,[303 315 272 276 509],894,5,8066,3.8778846153846156,20.0,20.0
10080,2,2080,[303 315 272 276 509],537,5,8071,3.8784238346948583,20.0,20.0
10081,2,2081,[303 315 272 276 509],894,5,8076,3.878962536023055,20.0,20.0
10082,2,2082,[303 315 272 276 509],13,5,8081,3.8795007201152183,20.0,20.0
10083,2,2083,[303 315 272 276 509],537,5,8086,3.880038387715931,20.0,20.0
10084,2,2084,[201 211 326 367 300],409,1,8087,3.8786570743405275,0.0,40.0
10085,2,2085,[303 315 272 276 509],537,5,8092,3.879194630872483,20.0,20.0
10086,2,2086,[303 315 272 276 509],894,5,8097,3.879731672256828,20.0,20.0
10087,2,2087,[303 315 272 276 509],13,5,8102,3.8802681992337167,20.0,20.0
10088,2,2088,[303 315 272 276 509],537,5,8107,3.8808042125418862,20.0,20.0
10089,2,2089,[303 315 272 276 509],894,5,8112,3.88133971291866,20.0,20.0
10090,2,2090,[303 315 272 276 509],537,5,8117,3.881874701099952,20.0,20.0
10091,2,2091,[303 315 272 276 509],894,5,8122,3.882409177820268,20.0,20.0
10092,2,2092,[303 315 272 276 509],13,5,8127,3.882943143812709,20.0,20.0
10093,2,2093,[303 315 272 276 509],537,5,8132,3.883476599808978,20.0,20.0
10094,2,2094,[303 315 272 276 509],894,5,8137,3.8840095465393794,20.0,20.0
10095,2,2095,[303 315 272 276 509],537,5,8142,3.8845419847328246,20.0,20.0
10096,2,2096,[303 315 272 276 509],894,5,8147,3.8850739151168336,20.0,20.0
10097,2,2097,[303 315 272 276 509],13,5,8152,3.8856053384175406,20.0,20.0
10098,2,2098,[303 315 272 276 509],537,5,8157,3.886136255359695,20.0,20.0
10099,2,2099,[303 315 272 276 509],537,5,8162,3.8866666666666667,20.0,20.0
10100,2,2100,[303 315 272 276 509],537,5,8167,3.8871965730604474,20.0,20.0
10101,2,2101,[303 315 272 276 509],537,5,8172,3.8877259752616555,20.0,20.0
10102,2,2102,[303 315 272 276 509],894,5,8177,3.888254873989539,20.0,20.0
10103,2,2103,[303 315 272 276 509],894,5,8182,3.8887832699619773,20.0,20.0
10104,2,2104,[303 315 272 276 509],894,5,8187,3.889311163895487,20.0,20.0
10105,2,2105,[303 315 272 276 509],13,5,8192,3.8898385565052234,20.0,20.0
10106,2,2106,[303 315 272 276 509],894,5,8197,3.8903654485049834,20.0,20.0
10107,2,2107,[303 315 272 276 509],13,5,8202,3.890891840607211,20.0,20.0
10108,2,2108,[303 315 272 276 509],537,5,8207,3.8914177335229967,20.0,20.0
10109,2,2109,[303 315 272 276 509],537,5,8212,3.8919431279620853,20.0,20.0
10110,2,2110,[303 315 272 276 509],537,5,8217,3.8924680246328753,20.0,20.0
10111,2,2111,[303 315 272 276 509],13,5,8222,3.8929924242424243,20.0,20.0
10112,2,2112,[303 315 272 276 509],894,5,8227,3.8935163274964504,20.0,20.0
10113,2,2113,[303 315 272 276 509],537,5,8232,3.8940397350993377,20.0,20.0
10114,2,2114,[303 315 272 276 509],13,5,8237,3.894562647754137,20.0,20.0
10115,2,2115,[303 315 272 276 509],894,5,8242,3.895085066162571,20.0,20.0
10116,2,2116,[303 315 272 276 509],13,5,8247,3.8956069910250353,20.0,20.0
10117,2,2117,[303 315 272 276 509],13,5,8252,3.8961284230406044,20.0,20.0
10118,2,2118,[303 315 272 276 509],894,5,8257,3.8966493629070316,20.0,20.0
10119,2,2119,[420 268 208 429 215],13,5,8262,3.897169811320755,0.0,0.0
10120,2,2120,[303 315 272 276 509],537,5,8267,3.897689768976898,20.0,20.0
10121,2,2121,[429 508 226 350 215],13,3,8270,3.8972667295004713,0.0,0.0
10122,2,2122,[303 315 272 276 509],13,5,8275,3.897786151672162,20.0,20.0
10123,2,2123,[303 315 272 276 509],894,5,8280,3.8983050847457625,20.0,20.0
10124,2,2124,[303 315 272 276 509],894,5,8285,3.898823529411765,20.0,20.0
10125,2,2125,[303 315 272 276 509],537,5,8290,3.8993414863593605,20.0,20.0
10126,2,2126,[303 315 272 276 509],537,5,8295,3.8998589562764456,20.0,20.0
10127,2,2127,[303 315 272 276 509],894,5,8300,3.9003759398496243,20.0,20.0
10128,2,2128,[303 315 272 276 509],13,5,8305,3.9008924377642087,20.0,20.0
10129,2,2129,[303 315 272 276 509],537,5,8310,3.9014084507042255,20.0,20.0
10130,2,2130,[303 315 272 276 509],13,5,8315,3.9019239793524165,20.0,20.0
10131,2,2131,[303 315 272 276 509],537,5,8320,3.902439024390244,20.0,20.0
10132,2,2132,[303 315 272 276 509],537,5,8325,3.9029535864978904,20.0,20.0
10133,2,2133,[303 315 272 276 509],13,5,8330,3.9034676663542642,20.0,20.0
10134,2,2134,[303 315 272 276 509],13,5,8335,3.9039812646370025,20.0,20.0
10135,2,2135,[303 315 272 276 509],13,5,8340,3.904494382022472,20.0,20.0
10136,2,2136,[303 315 272 276 509],13,5,8345,3.9050070191857746,20.0,20.0
10137,2,2137,[303 315 272 276 509],13,5,8350,3.9055191768007482,20.0,20.0
10138,2,2138,[303 315 272 276 509],13,5,8355,3.906030855539972,20.0,20.0
10139,2,2139,[303 315 272 276 509],13,5,8360,3.9065420560747666,20.0,20.0
10140,2,2140,[303 315 272 276 509],537,5,8365,3.9070527790751983,20.0,20.0
10141,2,2141,[303 315 272 276 509],894,5,8370,3.907563025210084,20.0,20.0
10142,2,2142,[303 315 272 276 509],13,5,8375,3.9080727951469902,20.0,20.0
10143,2,2143,[303 315 272 276 509],537,5,8380,3.908582089552239,20.0,20.0
10144,2,2144,[431 478 321 326 509],13,2,8382,3.9076923076923076,0.0,0.0
10145,2,2145,[303 315 272 276 509],894,5,8387,3.908201304753029,20.0,20.0
10146,2,2146,[303 315 272 276 509],894,5,8392,3.9087098276665113,20.0,20.0
10147,2,2147,[303 315 272 276 509],13,5,8397,3.909217877094972,20.0,20.0
10148,2,2148,[303 315 272 276 509],537,5,8402,3.9097254536993953,20.0,20.0
10149,2,2149,[303 315 272 276 509],894,5,8407,3.9102325581395347,20.0,20.0
10150,2,2150,[303 315 272 276 509],537,5,8412,3.9107391910739193,20.0,20.0
10151,2,2151,[303 315 272 276 509],13,5,8417,3.9112453531598512,20.0,20.0
10152,2,2152,[303 315 272 276 509],13,5,8422,3.9117510450534136,20.0,20.0
10153,2,2153,[303 315 272 276 509],13,5,8427,3.9122562674094707,20.0,20.0
10154,2,2154,[303 315 272 276 509],537,5,8432,3.9127610208816703,20.0,20.0
10155,2,2155,[303 315 272 276 509],537,5,8437,3.913265306122449,20.0,20.0
10156,2,2156,[303 315 272 276 509],894,5,8442,3.913769123783032,20.0,20.0
10157,2,2157,[303 315 272 276 509],894,5,8447,3.9142724745134383,20.0,20.0
10158,2,2158,[303 315 272 276 509],537,5,8452,3.9147753589624825,20.0,20.0
10159,2,2159,[303 315 272 276 509],894,5,8457,3.915277777777778,20.0,20.0
10160,2,2160,[303 315 272 276 509],894,5,8462,3.915779731605738,20.0,20.0
10161,2,2161,[303 315 272 276 509],13,5,8467,3.916281221091582,20.0,20.0
10162,2,2162,[303 315 272 276 509],13,5,8472,3.9167822468793343,20.0,20.0
10163,2,2163,[303 315 272 276 509],13,5,8477,3.9172828096118297,20.0,20.0
10164,2,2164,[303 315 272 276 509],894,5,8482,3.917782909930716,20.0,20.0
10165,2,2165,[303 315 272 276 509],894,5,8487,3.918282548476454,20.0,20.0
10166,2,2166,[303 315 272 276 509],537,5,8492,3.918781725888325,20.0,20.0
10167,2,2167,[303 315 272 276 509],537,5,8497,3.919280442804428,20.0,20.0
10168,2,2168,[303 315 272 276 509],537,5,8502,3.9197786998616873,20.0,20.0
10169,2,2169,[275 222 217 215 240],648,2,8504,3.91889400921659,0.0,40.0
10170,2,2170,[303 315 272 276 509],537,5,8509,3.9193919852602486,20.0,20.0
10171,2,2171,[303 315 272 276 509],894,5,8514,3.9198895027624308,20.0,20.0
10172,2,2172,[303 315 272 276 509],894,5,8519,3.9203865623561898,20.0,20.0
10173,2,2173,[303 315 272 276 509],13,5,8524,3.920883164673413,20.0,20.0
10174,2,2174,[303 315 272 276 509],894,5,8529,3.9213793103448276,20.0,20.0
10175,2,2175,[303 315 272 276 509],894,5,8534,3.921875,20.0,20.0
10176,2,2176,[303 315 272 276 509],894,5,8539,3.9223702342673405,20.0,20.0
10177,2,2177,[303 315 272 276 509],13,5,8544,3.922865013774105,20.0,20.0
10178,2,2178,[303 315 272 276 509],894,5,8549,3.9233593391463972,20.0,20.0
10179,2,2179,[303 315 272 276 509],537,5,8554,3.9238532110091744,20.0,20.0
10180,2,2180,[303 315 272 276 509],13,5,8559,3.924346629986245,20.0,20.0
10181,2,2181,[303 315 272 276 509],537,5,8564,3.924839596700275,20.0,20.0
10182,2,2182,[303 315 272 276 509],537,5,8569,3.9253321117727897,20.0,20.0
10183,2,2183,[254 213 219 230 223],308,3,8572,3.9249084249084247,20.0,0.0
10184,2,2184,[303 315 272 276 509],894,5,8577,3.925400457665904,20.0,20.0
10185,2,2185,[303 315 272 276 509],537,5,8582,3.9258920402561754,20.0,20.0
10186,2,2186,[303 315 272 276 509],537,5,8587,3.9263831732967533,20.0,20.0
10187,2,2187,[303 315 272 276 509],894,5,8592,3.926873857404022,20.0,20.0
10188,2,2188,[303 315 272 276 509],537,5,8597,3.9273640931932388,20.0,20.0
10189,2,2189,[303 315 272 276 509],894,5,8602,3.927853881278539,20.0,20.0
10190,2,2190,[303 315 272 276 509],537,5,8607,3.9283432222729346,20.0,20.0
10191,2,2191,[303 315 272 276 509],13,5,8612,3.928832116788321,20.0,20.0
10192,2,2192,[303 315 272 276 509],894,5,8617,3.9293205654354764,20.0,20.0
10193,2,2193,[303 315 272 276 509],13,5,8622,3.9298085688240656,20.0,20.0
10194,2,2194,[303 315 272 276 509],894,5,8627,3.9302961275626425,20.0,20.0
10195,2,2195,[303 315 272 276 509],894,5,8632,3.930783242258652,20.0,20.0
10196,2,2196,[303 315 272 276 509],13,5,8637,3.931269913518434,20.0,20.0
10197,2,2197,[303 315 272 276 509],894,5,8642,3.9317561419472247,20.0,20.0
10198,2,2198,[303 315 272 276 509],894,5,8647,3.9322419281491587,20.0,20.0
10199,2,2199,[303 315 272 276 509],894,5,8652,3.9327272727272726,20.0,20.0
10200,2,2200,[303 315 272 276 509],894,5,8657,3.9332121762835075,20.0,20.0
10201,2,2201,[303 315 272 276 509],537,5,8662,3.9336966394187103,20.0,20.0
10202,2,2202,[303 315 272 276 509],13,5,8667,3.9341806627326372,20.0,20.0
10203,2,2203,[303 315 272 276 509],13,5,8672,3.9346642468239565,20.0,20.0
10204,2,2204,[303 315 272 276 509],537,5,8677,3.9351473922902493,20.0,20.0
10205,2,2205,[303 315 272 276 509],894,5,8682,3.9356300997280145,20.0,20.0
10206,2,2206,[303 315 272 276 509],894,5,8687,3.936112369732669,20.0,20.0
10207,2,2207,[303 315 272 276 509],537,5,8692,3.9365942028985508,20.0,20.0
10208,2,2208,[303 315 272 276 509],13,5,8697,3.9370755998189226,20.0,20.0
10209,2,2209,[336 213 303 316 283],894,3,8700,3.936651583710407,20.0,0.0
10210,2,2210,[303 315 272 276 509],537,5,8705,3.9371325192220716,20.0,20.0
10211,2,2211,[303 315 272 276 509],537,5,8710,3.9376130198915007,20.0,20.0
10212,2,2212,[303 315 272 276 509],13,5,8715,3.938093086308179,20.0,20.0
10213,2,2213,[303 315 272 276 509],894,5,8720,3.9385727190605238,20.0,20.0
10214,2,2214,[303 315 272 276 509],13,5,8725,3.9390519187358914,20.0,20.0
10215,2,2215,[478 291 215 365 230],749,3,8728,3.9386281588447654,0.0,0.0
10216,2,2216,[223 213 220 255 216],184,3,8731,3.9382047812359042,20.0,0.0
10217,2,2217,[303 315 272 276 509],13,5,8736,3.93868349864743,20.0,20.0
10218,2,2218,[303 315 272 276 509],894,5,8741,3.939161784587652,20.0,20.0
10219,2,2219,[303 315 272 276 509],894,5,8746,3.9396396396396396,20.0,20.0
10220,2,2220,[303 315 272 276 509],894,5,8751,3.940117064385412,20.0,20.0
10221,2,2221,[303 315 272 276 509],894,5,8756,3.9405940594059405,20.0,20.0
10222,2,2222,[303 315 272 276 509],13,5,8761,3.9410706252811516,20.0,20.0
10223,2,2223,[268 583 216 215 429],7,3,8764,3.9406474820143886,0.0,0.0
10224,2,2224,[303 315 272 276 509],894,5,8769,3.941123595505618,20.0,20.0
10225,2,2225,[303 315 272 276 509],13,5,8774,3.9415992812219227,20.0,20.0
10226,2,2226,[303 315 272 276 509],13,5,8779,3.94207453973956,20.0,20.0
10227,2,2227,[303 315 272 276 509],537,5,8784,3.9425493716337523,20.0,20.0
10228,2,2228,[303 315 272 276 509],537,5,8789,3.94302377747869,20.0,20.0
10229,2,2229,[303 315 272 276 509],537,5,8794,3.9434977578475334,20.0,20.0
10230,2,2230,[303 315 272 276 509],13,5,8799,3.943971313312416,20.0,20.0
10231,2,2231,[303 315 272 276 509],537,5,8804,3.9444444444444446,20.0,20.0
10232,2,2232,[303 315 272 276 509],537,5,8809,3.9449171518137036,20.0,20.0
10233,2,2233,[303 315 272 276 509],537,5,8814,3.9453894359892567,20.0,20.0
10234,2,2234,[303 315 272 276 509],894,5,8819,3.94586129753915,20.0,20.0
10235,2,2235,[303 315 272 276 509],537,5,8824,3.9463327370304113,20.0,20.0
10236,2,2236,[303 315 272 276 509],13,5,8829,3.9468037550290567,20.0,20.0
10237,2,2237,[303 315 272 276 509],13,5,8834,3.9472743521000893,20.0,20.0
10238,2,2238,[303 315 272 276 509],894,5,8839,3.9477445288075033,20.0,20.0
10239,2,2239,[303 315 272 276 509],537,5,8844,3.9482142857142857,20.0,20.0
10240,2,2240,[303 315 272 276 509],537,5,8849,3.9486836233824185,20.0,20.0
10241,2,2241,[303 315 272 276 509],537,5,8854,3.9491525423728815,20.0,20.0
10242,2,2242,[303 315 272 276 509],537,5,8859,3.9496210432456533,20.0,20.0
10243,2,2243,[303 315 272 276 509],13,5,8864,3.950089126559715,20.0,20.0
10244,2,2244,[230 209 290 485 215],537,1,8865,3.9487750556792873,0.0,0.0
10245,2,2245,[255 202 420 230 208],881,2,8867,3.947907390917186,0.0,0.0
10246,2,2246,[303 315 272 276 509],894,5,8872,3.948375611927014,20.0,20.0
10247,2,2247,[303 315 272 276 509],894,5,8877,3.948843416370107,20.0,20.0
10248,2,2248,[509 300 350 264 268],894,2,8879,3.947976878612717,0.0,20.0
10249,2,2249,[303 315 272 276 509],537,5,8884,3.9484444444444446,20.0,20.0
10250,2,2250,[303 315 272 276 509],894,5,8889,3.948911594846735,20.0,20.0
10251,2,2251,[303 315 272 276 509],894,5,8894,3.9493783303730017,20.0,20.0
10252,2,2252,[303 315 272 276 509],13,5,8899,3.9498446515756767,20.0,20.0
10253,2,2253,[303 315 272 276 509],894,5,8904,3.950310559006211,20.0,20.0
10254,2,2254,[303 315 272 276 509],13,5,8909,3.9507760532150775,20.0,20.0
10255,2,2255,[303 315 272 276 509],894,5,8914,3.951241134751773,20.0,20.0
10256,2,2256,[217 326 232 485 201],13,0,8914,3.949490474080638,0.0,0.0
10257,2,2257,[303 315 272 276 509],894,5,8919,3.949955713020372,20.0,20.0
10258,2,2258,[303 315 272 276 509],537,5,8924,3.9504205400619745,20.0,20.0
10259,2,2259,[303 315 272 276 509],894,5,8929,3.9508849557522123,20.0,20.0
10260,2,2260,[303 315 272 276 509],13,5,8934,3.9513489606368863,20.0,20.0
10261,2,2261,[303 315 272 276 509],894,5,8939,3.951812555260831,20.0,20.0
10262,2,2262,[303 315 272 276 509],13,5,8944,3.9522757401679187,20.0,20.0
10263,2,2263,[303 315 272 276 509],13,5,8949,3.95273851590106,20.0,20.0
10264,2,2264,[303 315 272 276 509],13,5,8954,3.9532008830022076,20.0,20.0
10265,2,2265,[303 315 272 276 509],894,5,8959,3.9536628420123567,20.0,20.0
10266,2,2266,[303 315 272 276 509],537,5,8964,3.9541243934715484,20.0,20.0
10267,2,2267,[303 315 272 276 509],13,5,8969,3.9545855379188715,20.0,20.0
10268,2,2268,[303 315 272 276 509],894,5,8974,3.955046275892464,20.0,20.0
10269,2,2269,[303 315 272 276 509],894,5,8979,3.9555066079295154,20.0,20.0
10270,2,2270,[303 315 272 276 509],13,5,8984,3.9559665345662705,20.0,20.0
10271,2,2271,[303 315 272 276 509],894,5,8989,3.956426056338028,20.0,20.0
10272,2,2272,[303 315 272 276 509],13,5,8994,3.9568851737791464,20.0,20.0
10273,2,2273,[303 315 272 276 509],13,5,8999,3.957343887423043,20.0,20.0
10274,2,2274,[303 315 272 276 509],13,5,9004,3.9578021978021978,20.0,20.0
10275,2,2275,[303 315 272 276 509],537,5,9009,3.9582601054481548,20.0,20.0
10276,2,2276,[303 315 272 276 509],537,5,9014,3.958717610891524,20.0,20.0
10277,2,2277,[303 315 272 276 509],13,5,9019,3.9591747146619842,20.0,20.0
10278,2,2278,[303 315 272 276 509],13,5,9024,3.9596314172882843,20.0,20.0
10279,2,2279,[303 315 272 276 509],13,5,9029,3.9600877192982455,20.0,20.0
10280,2,2280,[261 216 201 303 212],13,2,9031,3.9592284085927223,0.0,0.0
10281,2,2281,[303 315 272 276 509],894,5,9036,3.9596844872918493,20.0,20.0
10282,2,2282,[303 315 272 276 509],13,5,9041,3.9601401664476565,20.0,20.0
10283,2,2283,[303 315 272 276 509],537,5,9046,3.960595446584939,20.0,20.0
10284,2,2284,[303 315 272 276 509],13,5,9051,3.961050328227571,20.0,20.0
10285,2,2285,[303 315 272 276 509],13,5,9056,3.9615048118985126,20.0,20.0
10286,2,2286,[303 315 272 276 509],13,5,9061,3.9619588981198075,20.0,20.0
10287,2,2287,[303 315 272 276 509],894,5,9066,3.9624125874125875,20.0,20.0
10288,2,2288,[303 315 272 276 509],13,5,9071,3.962865880297073,20.0,20.0
10289,2,2289,[303 315 272 276 509],894,5,9076,3.963318777292576,20.0,20.0
10290,2,2290,[303 315 272 276 509],13,5,9081,3.9637712789175032,20.0,20.0
10291,2,2291,[303 315 272 276 509],537,5,9086,3.9642233856893543,20.0,20.0
10292,2,2292,[303 315 272 276 509],537,5,9091,3.9646750981247276,20.0,20.0
10293,2,2293,[303 315 272 276 509],13,5,9096,3.96512641673932,20.0,20.0
10294,2,2294,[303 315 272 276 509],537,5,9101,3.96557734204793,20.0,20.0
10295,2,2295,[303 315 272 276 509],537,5,9106,3.96602787456446,20.0,20.0
10296,2,2296,[303 315 272 276 509],13,5,9111,3.9664780148019156,20.0,20.0
10297,2,2297,[485 275 232 211 301],85,3,9114,3.966057441253264,0.0,40.0
10298,2,2298,[218 211 485 264 276],13,3,9117,3.9656372335798173,0.0,40.0
10299,2,2299,[303 315 272 276 509],13,5,9122,3.966086956521739,20.0,20.0
10300,2,2300,[303 315 272 276 509],13,5,9127,3.966536288570187,20.0,20.0
10301,2,2301,[303 315 272 276 509],537,5,9132,3.9669852302345787,20.0,20.0
10302,2,2302,[303 315 272 276 509],894,5,9137,3.9674337820234475,20.0,20.0
10303,2,2303,[303 315 272 276 509],13,5,9142,3.9678819444444446,20.0,20.0
10304,2,2304,[303 315 272 276 509],894,5,9147,3.9683297180043384,20.0,20.0
10305,2,2305,[303 315 272 276 509],13,5,9152,3.9687771032090198,20.0,20.0
10306,2,2306,[303 315 272 276 509],537,5,9157,3.9692241005635025,20.0,20.0
10307,2,2307,[303 315 272 276 509],13,5,9162,3.9696707105719238,20.0,20.0
10308,2,2308,[303 315 272 276 509],894,5,9167,3.9701169337375486,20.0,20.0
10309,2,2309,[303 315 272 276 509],537,5,9172,3.9705627705627706,20.0,20.0
10310,2,2310,[303 315 272 276 509],537,5,9177,3.971008221549113,20.0,20.0
10311,2,2311,[303 315 272 276 509],13,5,9182,3.9714532871972317,20.0,20.0
10312,2,2312,[303 315 272 276 509],894,5,9187,3.9718979680069175,20.0,20.0
10313,2,2313,[303 315 272 276 509],537,5,9192,3.972342264477096,20.0,20.0
10314,2,2314,[336 303 509 481 215],13,3,9195,3.9719222462203025,0.0,0.0
10315,2,2315,[303 315 272 276 509],894,5,9200,3.9723661485319517,20.0,20.0
10316,2,2316,[303 315 272 276 509],537,5,9205,3.972809667673716,20.0,20.0
10317,2,2317,[303 315 272 276 509],13,5,9210,3.9732528041415014,20.0,20.0
10318,2,2318,[303 315 272 276 509],537,5,9215,3.9736955584303577,20.0,20.0
10319,2,2319,[243 316 230 219 344],13,1,9216,3.972413793103448,20.0,0.0
10320,2,2320,[241 284 280 276 222],378,2,9218,3.971563981042654,0.0,40.0
10321,2,2321,[303 315 272 276 509],13,5,9223,3.9720068906115418,20.0,20.0
10322,2,2322,[392 321 300 227 241],311,3,9226,3.9715884631941454,0.0,20.0
10323,2,2323,[303 315 272 276 509],537,5,9231,3.9720309810671255,20.0,20.0
10324,2,2324,[303 315 272 276 509],537,5,9236,3.97247311827957,20.0,20.0
10325,2,2325,[303 315 272 276 509],537,5,9241,3.972914875322442,20.0,20.0
10326,2,2326,[303 315 272 276 509],537,5,9246,3.9733562526858615,20.0,20.0
10327,2,2327,[303 315 272 276 509],894,5,9251,3.9737972508591066,20.0,20.0
10328,2,2328,[303 315 272 276 509],537,5,9256,3.974237870330614,20.0,20.0
10329,2,2329,[303 315 272 276 509],894,5,9261,3.974678111587983,20.0,20.0
10330,2,2330,[303 315 272 276 509],894,5,9266,3.9751179751179753,20.0,20.0
10331,2,2331,[303 315 272 276 509],537,5,9271,3.975557461406518,20.0,20.0
10332,2,2332,[303 315 272 276 509],894,5,9276,3.9759965709387055,20.0,20.0
10333,2,2333,[303 315 272 276 509],537,5,9281,3.9764353041988003,20.0,20.0
10334,2,2334,[303 315 272 276 509],13,5,9286,3.9768736616702354,20.0,20.0
10335,2,2335,[303 315 272 276 509],13,5,9291,3.9773116438356166,20.0,20.0
10336,2,2336,[303 315 272 276 509],894,5,9296,3.9777492511767223,20.0,20.0
10337,2,2337,[226 291 230 223 208],653,1,9297,3.9764756201881952,20.0,0.0
10338,2,2338,[303 315 272 276 509],537,5,9302,3.976913210773835,20.0,20.0
10339,2,2339,[303 315 272 276 509],537,5,9307,3.9773504273504274,20.0,20.0
10340,2,2340,[303 315 272 276 509],537,5,9312,3.977787270397266,20.0,20.0
10341,2,2341,[303 315 272 276 509],894,5,9317,3.9782237403928264,20.0,20.0
10342,2,2342,[303 315 272 276 509],13,5,9322,3.9786598378147673,20.0,20.0
10343,2,2343,[291 226 429 231 283],537,1,9323,3.9773890784982937,0.0,0.0
10344,2,2344,[303 315 272 276 509],13,5,9328,3.9778251599147123,20.0,20.0
10345,2,2345,[303 315 272 276 509],13,5,9333,3.9782608695652173,20.0,20.0
10346,2,2346,[303 315 272 276 509],13,5,9338,3.9786962079250108,20.0,20.0
10347,2,2347,[303 315 272 276 509],894,5,9343,3.979131175468484,20.0,20.0
10348,2,2348,[303 315 272 276 509],13,5,9348,3.979565772669221,20.0,20.0
10349,2,2349,[283 378 272 202 220],271,3,9351,3.979148936170213,0.0,0.0
10350,2,2350,[303 315 272 276 509],894,5,9356,3.9795831561037858,20.0,20.0
10351,2,2351,[212 420 378 211 324],7,3,9359,3.9791666666666665,0.0,20.0
10352,2,2352,[303 315 272 276 509],13,5,9364,3.9796005099872502,20.0,20.0
10353,2,2353,[303 315 272 276 509],894,5,9369,3.980033984706882,20.0,20.0
10354,2,2354,[303 315 272 276 509],894,5,9374,3.9804670912951168,20.0,20.0
10355,2,2355,[303 315 272 276 509],13,5,9379,3.980899830220713,20.0,20.0
10356,2,2356,[303 315 272 276 509],537,5,9384,3.9813322019516333,20.0,20.0
10357,2,2357,[303 315 272 276 509],894,5,9389,3.9817642069550465,20.0,20.0
10358,2,2358,[316 211 291 232 331],328,4,9393,3.9817719372615517,20.0,20.0
10359,2,2359,[303 315 272 276 509],13,5,9398,3.9822033898305085,20.0,20.0
10360,2,2360,[303 315 272 276 509],537,5,9403,3.982634476916561,20.0,20.0
10361,2,2361,[303 315 272 276 509],537,5,9408,3.983065198983912,20.0,20.0
10362,2,2362,[303 315 272 276 509],13,5,9413,3.9834955564959795,20.0,20.0
10363,2,2363,[303 315 272 276 509],894,5,9418,3.983925549915398,20.0,20.0
10364,2,2364,[303 315 272 276 509],894,5,9423,3.984355179704017,20.0,20.0
10365,2,2365,[303 315 272 276 509],894,5,9428,3.984784446322908,20.0,20.0
10366,2,2366,[303 315 272 276 509],13,5,9433,3.9852133502323617,20.0,20.0
10367,2,2367,[303 315 272 276 509],894,5,9438,3.985641891891892,20.0,20.0
10368,2,2368,[303 315 272 276 509],13,5,9443,3.986070071760236,20.0,20.0
10369,2,2369,[303 315 272 276 509],537,5,9448,3.9864978902953587,20.0,20.0
10370,2,2370,[303 315 272 276 509],13,5,9453,3.9869253479544495,20.0,20.0
10371,2,2371,[303 315 272 276 509],894,5,9458,3.9873524451939293,20.0,20.0
10372,2,2372,[303 315 272 276 509],894,5,9463,3.9877791824694477,20.0,20.0
10373,2,2373,[303 315 272 276 509],894,5,9468,3.988205560235889,20.0,20.0
10374,2,2374,[303 315 272 276 509],13,5,9473,3.9886315789473685,20.0,20.0
10375,2,2375,[303 315 272 276 509],537,5,9478,3.989057239057239,20.0,20.0
10376,2,2376,[303 315 272 276 509],537,5,9483,3.98948254101809,20.0,20.0
10377,2,2377,[303 315 272 276 509],13,5,9488,3.9899074852817495,20.0,20.0
10378,2,2378,[303 315 272 276 509],13,5,9493,3.990332072299285,20.0,20.0
10379,2,2379,[303 315 272 276 509],13,5,9498,3.9907563025210084,20.0,20.0
10380,2,2380,[303 315 272 276 509],537,5,9503,3.991180176396472,20.0,20.0
10381,2,2381,[303 315 272 276 509],537,5,9508,3.9916036943744753,20.0,20.0
10382,2,2382,[303 315 272 276 509],537,5,9513,3.9920268569030632,20.0,20.0
10383,2,2383,[303 315 272 276 509],13,5,9518,3.99244966442953,20.0,20.0
10384,2,2384,[303 315 272 276 509],537,5,9523,3.9928721174004194,20.0,20.0
10385,2,2385,[303 315 272 276 509],894,5,9528,3.9932942162615257,20.0,20.0
10386,2,2386,[303 315 272 276 509],894,5,9533,3.9937159614578968,20.0,20.0
10387,2,2387,[431 226 365 420 250],749,3,9536,3.993299832495812,0.0,0.0
10388,2,2388,[303 315 272 276 509],894,5,9541,3.9937212222687317,20.0,20.0
10389,2,2389,[303 315 272 276 509],537,5,9546,3.9941422594142257,20.0,20.0
10390,2,2390,[303 315 272 276 509],537,5,9551,3.9945629443747386,20.0,20.0
10391,2,2391,[303 315 272 276 509],13,5,9556,3.9949832775919734,20.0,20.0
10392,2,2392,[303 315 272 276 509],537,5,9561,3.995403259506895,20.0,20.0
10393,2,2393,[303 315 272 276 509],894,5,9566,3.9958228905597326,20.0,20.0
10394,2,2394,[303 315 272 276 509],13,5,9571,3.996242171189979,20.0,20.0
10395,2,2395,[303 315 272 276 509],894,5,9576,3.996661101836394,20.0,20.0
10396,2,2396,[303 315 272 276 509],894,5,9581,3.9970796829370046,20.0,20.0
10397,2,2397,[303 315 272 276 509],537,5,9586,3.9974979149291077,20.0,20.0
10398,2,2398,[303 315 272 276 509],13,5,9591,3.9979157982492706,20.0,20.0
10399,2,2399,[303 315 272 276 509],894,5,9596,3.9983333333333335,20.0,20.0
10400,2,2400,[303 315 272 276 509],13,5,9601,3.99875052061641,20.0,20.0
10401,2,2401,[303 315 272 276 509],537,5,9606,3.9991673605328892,20.0,20.0
10402,2,2402,[303 315 272 276 509],537,5,9611,3.999583853516438,20.0,20.0
10403,2,2403,[303 315 272 276 509],894,5,9616,4.0,20.0,20.0
10404,2,2404,[303 315 272 276 509],537,5,9621,4.000415800415801,20.0,20.0
10405,2,2405,[303 315 272 276 509],537,5,9626,4.000831255195345,20.0,20.0
10406,2,2406,[303 315 272 276 509],537,5,9631,4.001246364769423,20.0,20.0
10407,2,2407,[303 315 272 276 509],537,5,9636,4.001661129568106,20.0,20.0
10408,2,2408,[303 315 272 276 509],537,5,9641,4.002075550020756,20.0,20.0
10409,2,2409,[303 315 272 276 509],537,5,9646,4.002489626556017,20.0,20.0
10410,2,2410,[303 315 272 276 509],13,5,9651,4.002903359601825,20.0,20.0
10411,2,2411,[303 315 272 276 509],13,5,9656,4.003316749585406,20.0,20.0
10412,2,2412,[303 315 272 276 509],894,5,9661,4.003729796933278,20.0,20.0
10413,2,2413,[303 315 272 276 509],13,5,9666,4.004142502071251,20.0,20.0
10414,2,2414,[303 315 272 276 509],13,5,9671,4.0045548654244305,20.0,20.0
10415,2,2415,[303 315 272 276 509],894,5,9676,4.004966887417218,20.0,20.0
10416,2,2416,[303 315 272 276 509],894,5,9681,4.005378568473314,20.0,20.0
10417,2,2417,[303 315 272 276 509],13,5,9686,4.005789909015715,20.0,20.0
10418,2,2418,[303 315 272 276 509],537,5,9691,4.006200909466722,20.0,20.0
10419,2,2419,[303 315 272 276 509],894,5,9696,4.006611570247934,20.0,20.0
10420,2,2420,[303 315 272 276 509],13,5,9701,4.007021891780256,20.0,20.0
10421,2,2421,[303 315 272 276 509],537,5,9706,4.007431874483897,20.0,20.0
10422,2,2422,[303 315 272 276 509],894,5,9711,4.007841518778374,20.0,20.0
10423,2,2423,[303 315 272 276 509],13,5,9716,4.008250825082508,20.0,20.0
10424,2,2424,[303 315 272 276 509],894,5,9721,4.008659793814433,20.0,20.0
10425,2,2425,[303 315 272 276 509],537,5,9726,4.009068425391591,20.0,20.0
10426,2,2426,[303 315 272 276 509],537,5,9731,4.0094767202307375,20.0,20.0
10427,2,2427,[303 315 272 276 509],537,5,9736,4.009884678747941,20.0,20.0
10428,2,2428,[303 315 272 276 509],537,5,9741,4.010292301358584,20.0,20.0
10429,2,2429,[429 420 367 276 478],892,4,9745,4.010288065843621,0.0,20.0
10430,2,2430,[303 315 272 276 509],894,5,9750,4.010695187165775,20.0,20.0
10431,2,2431,[303 315 272 276 509],894,5,9755,4.011101973684211,20.0,20.0
10432,2,2432,[303 315 272 276 509],537,5,9760,4.011508425811755,20.0,20.0
10433,2,2433,[303 315 272 276 509],894,5,9765,4.011914543960558,20.0,20.0
10434,2,2434,[303 315 272 276 509],537,5,9770,4.012320328542095,20.0,20.0
10435,2,2435,[303 315 272 276 509],894,5,9775,4.012725779967159,20.0,20.0
10436,2,2436,[303 315 272 276 509],537,5,9780,4.013130898645876,20.0,20.0
10437,2,2437,[219 208 202 509 507],406,1,9781,4.0118949958982775,0.0,0.0
10438,2,2438,[303 315 272 276 509],13,5,9786,4.01230012300123,20.0,20.0
10439,2,2439,[303 315 272 276 509],894,5,9791,4.012704918032787,20.0,20.0
10440,2,2440,[303 315 272 276 509],13,5,9796,4.013109381401065,20.0,20.0
10441,2,2441,[219 413 316 300 212],13,2,9798,4.012285012285012,20.0,20.0
10442,2,2442,[303 315 272 276 509],894,5,9803,4.012689316414245,20.0,20.0
10443,2,2443,[303 315 272 276 509],894,5,9808,4.013093289689034,20.0,20.0
10444,2,2444,[303 315 272 276 509],894,5,9813,4.013496932515338,20.0,20.0
10445,2,2445,[303 315 272 276 509],894,5,9818,4.013900245298446,20.0,20.0
10446,2,2446,[284 268 236 300 290],894,2,9820,4.013077237433592,0.0,20.0
10447,2,2447,[303 315 272 276 509],537,5,9825,4.013480392156863,20.0,20.0
10448,2,2448,[303 315 272 276 509],537,5,9830,4.013883217639853,20.0,20.0
10449,2,2449,[303 315 272 276 509],894,5,9835,4.014285714285714,20.0,20.0
10450,2,2450,[303 315 272 276 509],537,5,9840,4.01468788249694,20.0,20.0
10451,2,2451,[303 315 272 276 509],13,5,9845,4.015089722675367,20.0,20.0
10452,2,2452,[268 221 303 290 315],334,4,9849,4.0150835711373825,20.0,0.0
10453,2,2453,[303 315 272 276 509],13,5,9854,4.0154849225753875,20.0,20.0
10454,2,2454,[303 315 272 276 509],894,5,9859,4.0158859470468435,20.0,20.0
10455,2,2455,[303 315 272 276 509],537,5,9864,4.01628664495114,20.0,20.0
10456,2,2456,[303 315 272 276 509],537,5,9869,4.016687016687016,20.0,20.0
10457,2,2457,[303 315 272 276 509],894,5,9874,4.017087062652563,20.0,20.0
10458,2,2458,[303 315 272 276 509],894,5,9879,4.0174867832452215,20.0,20.0
10459,2,2459,[303 315 272 276 509],537,5,9884,4.017886178861788,20.0,20.0
10460,2,2460,[303 315 272 276 509],13,5,9889,4.018285249898415,20.0,20.0
10461,2,2461,[303 315 272 276 509],894,5,9894,4.018683996750609,20.0,20.0
10462,2,2462,[303 315 272 276 509],894,5,9899,4.019082419813236,20.0,20.0
10463,2,2463,[303 315 272 276 509],13,5,9904,4.01948051948052,20.0,20.0
10464,2,2464,[303 315 272 276 509],13,5,9909,4.019878296146045,20.0,20.0
10465,2,2465,[303 315 272 276 509],894,5,9914,4.0202757502027575,20.0,20.0
10466,2,2466,[303 315 272 276 509],537,5,9919,4.020672882042967,20.0,20.0
10467,2,2467,[303 315 272 276 509],537,5,9924,4.021069692058346,20.0,20.0
10468,2,2468,[303 315 272 276 509],894,5,9929,4.021466180639935,20.0,20.0
10469,2,2469,[303 315 272 276 509],537,5,9934,4.0218623481781375,20.0,20.0
10470,2,2470,[303 315 272 276 509],894,5,9939,4.022258195062728,20.0,20.0
10471,2,2471,[303 315 272 276 509],537,5,9944,4.022653721682848,20.0,20.0
10472,2,2472,[303 315 272 276 509],13,5,9949,4.023048928427012,20.0,20.0
10473,2,2473,[303 315 272 276 509],537,5,9954,4.0234438156831045,20.0,20.0
10474,2,2474,[303 315 272 276 509],894,5,9959,4.023838383838384,20.0,20.0
10475,2,2475,[218 431 283 223 209],234,1,9960,4.022617124394184,20.0,0.0
10476,2,2476,[303 315 272 276 509],13,5,9965,4.023011707710941,20.0,20.0
10477,2,2477,[303 315 272 276 509],13,5,9970,4.023405972558515,20.0,20.0
10478,2,2478,[303 315 272 276 509],13,5,9975,4.0237999193223075,20.0,20.0
10479,2,2479,[303 315 272 276 509],894,5,9980,4.024193548387097,20.0,20.0
10480,2,2480,[209 429 321 223 201],387,3,9983,4.023780733575172,20.0,0.0
10481,2,2481,[303 315 272 276 509],13,5,9988,4.024174053182917,20.0,20.0
10482,2,2482,[303 315 272 276 509],13,5,9993,4.024567055980668,20.0,20.0
10483,2,2483,[303 315 272 276 509],894,5,9998,4.024959742351046,20.0,20.0
10484,2,2484,[303 315 272 276 509],537,5,10003,4.025352112676057,20.0,20.0
10485,2,2485,[216 478 280 431 367],234,1,10004,4.024135156878519,0.0,0.0
10486,2,2486,[303 315 272 276 509],894,5,10009,4.024527543224769,20.0,20.0
10487,2,2487,[303 315 272 276 509],537,5,10014,4.02491961414791,20.0,20.0
10488,2,2488,[303 315 272 276 509],537,5,10019,4.025311370028124,20.0,20.0
10489,2,2489,[303 315 272 276 509],894,5,10024,4.0257028112449795,20.0,20.0
10490,2,2490,[303 315 272 276 509],537,5,10029,4.026093938177439,20.0,20.0
10491,2,2491,[303 315 272 276 509],894,5,10034,4.026484751203852,20.0,20.0
10492,2,2492,[303 315 272 276 509],13,5,10039,4.026875250701965,20.0,20.0
10493,2,2493,[213 259 283 291 212],85,1,10040,4.025661587810746,0.0,0.0
10494,2,2494,[303 315 272 276 509],13,5,10045,4.026052104208417,20.0,20.0
10495,2,2495,[303 315 272 276 509],13,5,10050,4.0264423076923075,20.0,20.0
10496,2,2496,[303 315 272 276 509],537,5,10055,4.026832198638366,20.0,20.0
10497,2,2497,[303 315 272 276 509],13,5,10060,4.027221777421937,20.0,20.0
10498,2,2498,[303 315 272 276 509],537,5,10065,4.0276110444177675,20.0,20.0
10499,2,2499,[303 315 272 276 509],13,5,10070,4.028,20.0,20.0
10500,2,2500,[303 315 272 276 509],537,5,10075,4.028388644542183,20.0,20.0
10501,2,2501,[223 365 264 481 392],308,3,10078,4.027977617905676,20.0,0.0
10502,2,2502,[230 431 276 284 211],537,3,10081,4.027566919696365,0.0,40.0
10503,2,2503,[303 315 272 276 509],13,5,10086,4.027955271565495,20.0,20.0
10504,2,2504,[303 315 272 276 509],13,5,10091,4.028343313373253,20.0,20.0
10505,2,2505,[303 315 272 276 509],13,5,10096,4.028731045490822,20.0,20.0
10506,2,2506,[303 315 272 276 509],13,5,10101,4.029118468288791,20.0,20.0
10507,2,2507,[303 315 272 276 509],537,5,10106,4.029505582137161,20.0,20.0
10508,2,2508,[303 315 272 276 509],894,5,10111,4.029892387405341,20.0,20.0
10509,2,2509,[303 315 272 276 509],13,5,10116,4.0302788844621515,20.0,20.0
10510,2,2510,[303 315 272 276 509],537,5,10121,4.030665073675826,20.0,20.0
10511,2,2511,[303 315 272 276 509],13,5,10126,4.031050955414012,20.0,20.0
10512,2,2512,[303 315 272 276 509],13,5,10131,4.031436530043773,20.0,20.0
10513,2,2513,[303 315 272 276 509],537,5,10136,4.031821797931583,20.0,20.0
10514,2,2514,[303 315 272 276 509],13,5,10141,4.03220675944334,20.0,20.0
10515,2,2515,[303 315 272 276 509],537,5,10146,4.032591414944356,20.0,20.0
10516,2,2516,[303 315 272 276 509],894,5,10151,4.032975764799365,20.0,20.0
10517,2,2517,[303 315 272 276 509],894,5,10156,4.033359809372518,20.0,20.0
10518,2,2518,[303 315 272 276 509],894,5,10161,4.033743549027392,20.0,20.0
10519,2,2519,[303 315 272 276 509],13,5,10166,4.034126984126984,20.0,20.0
10520,2,2520,[226 208 216 452 227],843,0,10166,4.03252677508925,0.0,0.0
10521,2,2521,[303 315 272 276 509],13,5,10171,4.032910388580492,20.0,20.0
10522,2,2522,[303 315 272 276 509],894,5,10176,4.033293697978597,20.0,20.0
10523,2,2523,[303 315 272 276 509],894,5,10181,4.033676703645008,20.0,20.0
10524,2,2524,[303 315 272 276 509],537,5,10186,4.034059405940594,20.0,20.0
10525,2,2525,[303 315 272 276 509],537,5,10191,4.034441805225653,20.0,20.0
10526,2,2526,[303 315 272 276 509],13,5,10196,4.034823901859913,20.0,20.0
10527,2,2527,[303 315 272 276 509],13,5,10201,4.0352056962025316,20.0,20.0
10528,2,2528,[303 315 272 276 509],537,5,10206,4.0355871886121,20.0,20.0
10529,2,2529,[303 315 272 276 509],894,5,10211,4.03596837944664,20.0,20.0
10530,2,2530,[303 315 272 276 509],537,5,10216,4.036349269063611,20.0,20.0
10531,2,2531,[303 315 272 276 509],894,5,10221,4.036729857819905,20.0,20.0
10532,2,2532,[303 315 272 276 509],537,5,10226,4.037110146071852,20.0,20.0
10533,2,2533,[303 315 272 276 509],894,5,10231,4.037490134175217,20.0,20.0
10534,2,2534,[303 315 272 276 509],894,5,10236,4.037869822485207,20.0,20.0
10535,2,2535,[303 315 272 276 509],13,5,10241,4.038249211356467,20.0,20.0
10536,2,2536,[303 315 272 276 509],13,5,10246,4.038628301143082,20.0,20.0
10537,2,2537,[303 315 272 276 509],894,5,10251,4.039007092198582,20.0,20.0
10538,2,2538,[303 315 272 276 509],537,5,10256,4.0393855848759355,20.0,20.0
10539,2,2539,[303 315 272 276 509],13,5,10261,4.039763779527559,20.0,20.0
10540,2,2540,[303 315 272 276 509],13,5,10266,4.040141676505313,20.0,20.0
10541,2,2541,[303 315 272 276 509],894,5,10271,4.040519276160503,20.0,20.0
10542,2,2542,[303 315 272 276 509],13,5,10276,4.040896578843885,20.0,20.0
10543,2,2543,[303 315 272 276 509],894,5,10281,4.04127358490566,20.0,20.0
10544,2,2544,[326 429 231 230 331],788,2,10283,4.040471512770138,0.0,0.0
10545,2,2545,[303 315 272 276 509],537,5,10288,4.040848389630793,20.0,20.0
10546,2,2546,[303 315 272 276 509],13,5,10293,4.041224970553593,20.0,20.0
10547,2,2547,[303 315 272 276 509],537,5,10298,4.04160125588697,20.0,20.0
10548,2,2548,[215 227 420 384 261],13,3,10301,4.041192624558651,0.0,0.0
10549,2,2549,[303 315 272 276 509],13,5,10306,4.041568627450981,20.0,20.0
10550,2,2550,[303 315 272 276 509],13,5,10311,4.0419443355546845,20.0,20.0
10551,2,2551,[303 315 272 276 509],13,5,10316,4.0423197492163006,20.0,20.0
10552,2,2552,[303 315 272 276 509],13,5,10321,4.042694868781825,20.0,20.0
10553,2,2553,[303 315 272 276 509],894,5,10326,4.043069694596711,20.0,20.0
10554,2,2554,[303 315 272 276 509],13,5,10331,4.043444227005871,20.0,20.0
10555,2,2555,[303 315 272 276 509],894,5,10336,4.043818466353677,20.0,20.0
10556,2,2556,[303 315 272 276 509],894,5,10341,4.044192412983966,20.0,20.0
10557,2,2557,[384 509 336 272 276],13,3,10344,4.043784206411258,0.0,20.0
10558,2,2558,[303 315 272 276 509],894,5,10349,4.044157874169597,20.0,20.0
10559,2,2559,[303 315 272 276 509],13,5,10354,4.04453125,20.0,20.0
10560,2,2560,[303 315 272 276 509],13,5,10359,4.0449043342444355,20.0,20.0
10561,2,2561,[303 315 272 276 509],537,5,10364,4.04527712724434,20.0,20.0
10562,2,2562,[303 315 272 276 509],537,5,10369,4.045649629340616,20.0,20.0
10563,2,2563,[303 315 272 276 509],537,5,10374,4.046021840873635,20.0,20.0
10564,2,2564,[303 315 272 276 509],537,5,10379,4.046393762183236,20.0,20.0
10565,2,2565,[303 315 272 276 509],537,5,10384,4.046765393608729,20.0,20.0
10566,2,2566,[303 315 272 276 509],537,5,10389,4.047136735488897,20.0,20.0
10567,2,2567,[303 315 272 276 509],894,5,10394,4.047507788161994,20.0,20.0
10568,2,2568,[303 315 272 276 509],13,5,10399,4.047878551965746,20.0,20.0
10569,2,2569,[303 315 272 276 509],13,5,10404,4.048249027237354,20.0,20.0
10570,2,2570,[303 315 272 276 509],537,5,10409,4.048619214313496,20.0,20.0
10571,2,2571,[275 239 315 367 222],311,3,10412,4.0482115085536545,20.0,40.0
10572,2,2572,[264 217 231 241 211],7,4,10416,4.048192771084337,0.0,20.0
10573,2,2573,[303 315 272 276 509],13,5,10421,4.048562548562549,20.0,20.0
10574,2,2574,[303 315 272 276 509],537,5,10426,4.048932038834952,20.0,20.0
10575,2,2575,[303 315 272 276 509],894,5,10431,4.049301242236025,20.0,20.0
10576,2,2576,[303 315 272 276 509],894,5,10436,4.049670159099728,20.0,20.0
10577,2,2577,[303 315 272 276 509],13,5,10441,4.050038789759504,20.0,20.0
10578,2,2578,[303 315 272 276 509],537,5,10446,4.050407134548275,20.0,20.0
10579,2,2579,[303 315 272 276 509],13,5,10451,4.05077519379845,20.0,20.0
10580,2,2580,[303 315 272 276 509],894,5,10456,4.051142967841922,20.0,20.0
10581,2,2581,[303 315 272 276 509],13,5,10461,4.051510457010069,20.0,20.0
10582,2,2582,[303 315 272 276 509],537,5,10466,4.0518776616337595,20.0,20.0
10583,2,2583,[303 315 272 276 509],537,5,10471,4.052244582043343,20.0,20.0
10584,2,2584,[303 315 272 276 509],13,5,10476,4.052611218568665,20.0,20.0
10585,2,2585,[303 315 272 276 509],894,5,10481,4.052977571539056,20.0,20.0
10586,2,2586,[303 315 272 276 509],13,5,10486,4.05334364128334,20.0,20.0
10587,2,2587,[303 315 272 276 509],537,5,10491,4.05370942812983,20.0,20.0
10588,2,2588,[216 508 367 227 331],13,1,10492,4.052529934337582,0.0,0.0
10589,2,2589,[303 315 272 276 509],894,5,10497,4.052895752895753,20.0,20.0
10590,2,2590,[303 315 272 276 509],537,5,10502,4.053261289077576,20.0,20.0
10591,2,2591,[303 315 272 276 509],537,5,10507,4.053626543209877,20.0,20.0
10592,2,2592,[303 315 272 276 509],537,5,10512,4.053991515618974,20.0,20.0
10593,2,2593,[303 315 272 276 509],894,5,10517,4.054356206630686,20.0,20.0
10594,2,2594,[303 315 272 276 509],537,5,10522,4.054720616570328,20.0,20.0
10595,2,2595,[303 315 272 276 509],894,5,10527,4.055084745762712,20.0,20.0
10596,2,2596,[303 315 272 276 509],13,5,10532,4.055448594532153,20.0,20.0
10597,2,2597,[303 315 272 276 509],13,5,10537,4.0558121632024635,20.0,20.0
10598,2,2598,[303 315 272 276 509],13,5,10542,4.05617545209696,20.0,20.0
10599,2,2599,[303 315 272 276 509],537,5,10547,4.056538461538461,20.0,20.0
10600,2,2600,[303 315 272 276 509],537,5,10552,4.056901191849288,20.0,20.0
10601,2,2601,[303 315 272 276 509],537,5,10557,4.057263643351268,20.0,20.0
10602,2,2602,[303 315 272 276 509],13,5,10562,4.057625816365732,20.0,20.0
10603,2,2603,[303 315 272 276 509],537,5,10567,4.057987711213518,20.0,20.0
10604,2,2604,[303 315 272 276 509],13,5,10572,4.058349328214971,20.0,20.0
10605,2,2605,[303 315 272 276 509],894,5,10577,4.0587106676899465,20.0,20.0
10606,2,2606,[303 315 272 276 509],13,5,10582,4.059071729957806,20.0,20.0
10607,2,2607,[303 315 272 276 509],894,5,10587,4.0594325153374236,20.0,20.0
10608,2,2608,[303 315 272 276 509],894,5,10592,4.059793024147183,20.0,20.0
10609,2,2609,[478 209 509 276 211],537,5,10597,4.0601532567049805,0.0,40.0
10610,2,2610,[303 315 272 276 509],13,5,10602,4.0605132133282265,20.0,20.0
10611,2,2611,[303 315 272 276 509],894,5,10607,4.060872894333844,20.0,20.0
10612,2,2612,[303 315 272 276 509],894,5,10612,4.06123230003827,20.0,20.0
10613,2,2613,[303 315 272 276 509],894,5,10617,4.06159143075746,20.0,20.0
10614,2,2614,[303 315 272 276 509],894,5,10622,4.0619502868068835,20.0,20.0
10615,2,2615,[303 315 272 276 509],894,5,10627,4.062308868501529,20.0,20.0
10616,2,2616,[303 315 272 276 509],13,5,10632,4.0626671761559034,20.0,20.0
10617,2,2617,[303 315 272 276 509],894,5,10637,4.063025210084033,20.0,20.0
10618,2,2618,[303 315 272 276 509],537,5,10642,4.0633829705994655,20.0,20.0
10619,2,2619,[303 315 272 276 509],13,5,10647,4.063740458015267,20.0,20.0
10620,2,2620,[303 315 272 276 509],537,5,10652,4.064097672644029,20.0,20.0
10621,2,2621,[303 315 272 276 509],894,5,10657,4.064454614797865,20.0,20.0
10622,2,2622,[303 315 272 276 509],13,5,10662,4.06481128478841,20.0,20.0
10623,2,2623,[303 315 272 276 509],894,5,10667,4.0651676829268295,20.0,20.0
10624,2,2624,[303 315 272 276 509],537,5,10672,4.0655238095238095,20.0,20.0
10625,2,2625,[303 315 272 276 509],894,5,10677,4.065879664889566,20.0,20.0
10626,2,2626,[290 226 240 217 413],648,1,10678,4.064712599923867,0.0,0.0
10627,2,2627,[303 315 272 276 509],13,5,10683,4.065068493150685,20.0,20.0
10628,2,2628,[303 315 272 276 509],13,5,10688,4.065424115633321,20.0,20.0
10629,2,2629,[303 315 272 276 509],13,5,10693,4.065779467680608,20.0,20.0
10630,2,2630,[303 315 272 276 509],13,5,10698,4.066134549600912,20.0,20.0
10631,2,2631,[303 315 272 276 509],894,5,10703,4.066489361702128,20.0,20.0
10632,2,2632,[303 315 272 276 509],894,5,10708,4.066843904291683,20.0,20.0
10633,2,2633,[303 315 272 276 509],537,5,10713,4.067198177676538,20.0,20.0
10634,2,2634,[303 315 272 276 509],537,5,10718,4.067552182163188,20.0,20.0
10635,2,2635,[303 315 272 276 509],13,5,10723,4.067905918057663,20.0,20.0
10636,2,2636,[303 315 272 276 509],13,5,10728,4.068259385665529,20.0,20.0
10637,2,2637,[276 275 429 216 284],271,3,10731,4.067854435178165,0.0,40.0
10638,2,2638,[303 315 272 276 509],537,5,10736,4.068207654414551,20.0,20.0
10639,2,2639,[303 315 272 276 509],537,5,10741,4.068560606060606,20.0,20.0
10640,2,2640,[303 315 272 276 509],537,5,10746,4.068913290420295,20.0,20.0
10641,2,2641,[303 315 272 276 509],13,5,10751,4.069265707797124,20.0,20.0
10642,2,2642,[303 315 272 276 509],894,5,10756,4.069617858494135,20.0,20.0
10643,2,2643,[303 315 272 276 509],13,5,10761,4.069969742813918,20.0,20.0
10644,2,2644,[303 315 272 276 509],894,5,10766,4.0703213610586015,20.0,20.0
10645,2,2645,[303 315 272 276 509],894,5,10771,4.070672713529857,20.0,20.0
10646,2,2646,[303 315 272 276 509],13,5,10776,4.0710238005289,20.0,20.0
10647,2,2647,[303 315 272 276 509],537,5,10781,4.071374622356496,20.0,20.0
10648,2,2648,[303 315 272 276 509],537,5,10786,4.071725179312948,20.0,20.0
10649,2,2649,[303 315 272 276 509],13,5,10791,4.072075471698113,20.0,20.0
10650,2,2650,[303 315 272 276 509],537,5,10796,4.072425499811392,20.0,20.0
10651,2,2651,[303 315 272 276 509],537,5,10801,4.072775263951734,20.0,20.0
10652,2,2652,[303 315 272 276 509],537,5,10806,4.07312476441764,20.0,20.0
10653,2,2653,[392 284 478 299 300],537,1,10807,4.071966842501884,0.0,20.0
10654,2,2654,[303 315 272 276 509],894,5,10812,4.072316384180791,20.0,20.0
10655,2,2655,[303 315 272 276 509],537,5,10817,4.072665662650603,20.0,20.0
10656,2,2656,[303 315 272 276 509],894,5,10822,4.073014678208506,20.0,20.0
10657,2,2657,[303 315 272 276 509],894,5,10827,4.073363431151241,20.0,20.0
10658,2,2658,[303 315 272 276 509],13,5,10832,4.073711921775104,20.0,20.0
10659,2,2659,[303 315 272 276 509],13,5,10837,4.0740601503759395,20.0,20.0
10660,2,2660,[303 315 272 276 509],13,5,10842,4.074408117249154,20.0,20.0
10661,2,2661,[303 315 272 276 509],537,5,10847,4.074755822689707,20.0,20.0
10662,2,2662,[303 315 272 276 509],894,5,10852,4.075103266992114,20.0,20.0
10663,2,2663,[212 223 220 216 221],184,4,10856,4.075075075075075,20.0,0.0
10664,2,2664,[303 315 272 276 509],537,5,10861,4.075422138836773,20.0,20.0
10665,2,2665,[303 315 272 276 509],13,5,10866,4.075768942235559,20.0,20.0
10666,2,2666,[303 315 272 276 509],537,5,10871,4.076115485564304,20.0,20.0
10667,2,2667,[303 315 272 276 509],537,5,10876,4.076461769115443,20.0,20.0
10668,2,2668,[303 315 272 276 509],13,5,10881,4.076807793180967,20.0,20.0
10669,2,2669,[303 315 272 276 509],537,5,10886,4.0771535580524345,20.0,20.0
10670,2,2670,[303 315 272 276 509],537,5,10891,4.077499064020966,20.0,20.0
10671,2,2671,[215 202 223 218 485],650,0,10891,4.075973053892215,20.0,0.0
10672,2,2672,[303 315 272 276 509],894,5,10896,4.07631874298541,20.0,20.0
10673,2,2673,[303 315 272 276 509],13,5,10901,4.076664173522812,20.0,20.0
10674,2,2674,[303 315 272 276 509],13,5,10906,4.077009345794393,20.0,20.0
10675,2,2675,[303 315 272 276 509],537,5,10911,4.077354260089686,20.0,20.0
10676,2,2676,[303 315 272 276 509],894,5,10916,4.077698916697796,20.0,20.0
10677,2,2677,[303 315 272 276 509],894,5,10921,4.078043315907394,20.0,20.0
10678,2,2678,[303 315 272 276 509],537,5,10926,4.078387458006719,20.0,20.0
10679,2,2679,[303 315 272 276 509],537,5,10931,4.078731343283582,20.0,20.0
10680,2,2680,[303 315 272 276 509],894,5,10936,4.079074972025364,20.0,20.0
10681,2,2681,[303 315 272 276 509],894,5,10941,4.0794183445190155,20.0,20.0
10682,2,2682,[303 315 272 276 509],537,5,10946,4.079761461051063,20.0,20.0
10683,2,2683,[303 315 272 276 509],13,5,10951,4.0801043219076005,20.0,20.0
10684,2,2684,[303 315 272 276 509],537,5,10956,4.080446927374302,20.0,20.0
10685,2,2685,[217 218 509 276 298],378,2,10958,4.079672375279226,0.0,20.0
10686,2,2686,[303 315 272 276 509],537,5,10963,4.08001488649051,20.0,20.0
10687,2,2687,[303 315 272 276 509],13,5,10968,4.080357142857143,20.0,20.0
10688,2,2688,[303 315 272 276 509],894,5,10973,4.080699144663444,20.0,20.0
10689,2,2689,[303 315 272 276 509],13,5,10978,4.081040892193308,20.0,20.0
10690,2,2690,[303 315 272 276 509],894,5,10983,4.081382385730212,20.0,20.0
10691,2,2691,[303 315 272 276 509],537,5,10988,4.081723625557206,20.0,20.0
10692,2,2692,[303 315 272 276 509],13,5,10993,4.082064611956925,20.0,20.0
10693,2,2693,[303 315 272 276 509],894,5,10998,4.082405345211582,20.0,20.0
10694,2,2694,[303 315 272 276 509],894,5,11003,4.082745825602968,20.0,20.0
10695,2,2695,[303 315 272 276 509],13,5,11008,4.083086053412463,20.0,20.0
10696,2,2696,[280 326 420 213 230],378,2,11010,4.082313681868743,0.0,0.0
10697,2,2697,[303 315 272 276 509],894,5,11015,4.082653817642698,20.0,20.0
10698,2,2698,[303 315 272 276 509],894,5,11020,4.082993701370878,20.0,20.0
10699,2,2699,[303 315 272 276 509],13,5,11025,4.083333333333333,20.0,20.0
10700,2,2700,[303 315 272 276 509],13,5,11030,4.0836727138097,20.0,20.0
10701,2,2701,[303 315 272 276 509],13,5,11035,4.0840118430792005,20.0,20.0
10702,2,2702,[303 315 272 276 509],537,5,11040,4.084350721420644,20.0,20.0
10703,2,2703,[303 315 272 276 509],13,5,11045,4.084689349112426,20.0,20.0
10704,2,2704,[303 315 272 276 509],13,5,11050,4.085027726432532,20.0,20.0
10705,2,2705,[303 315 272 276 509],894,5,11055,4.085365853658536,20.0,20.0
10706,2,2706,[431 202 211 232 215],774,2,11057,4.084595493165867,0.0,20.0
10707,2,2707,[303 315 272 276 509],894,5,11062,4.08493353028065,20.0,20.0
10708,2,2708,[303 315 272 276 509],894,5,11067,4.0852713178294575,20.0,20.0
10709,2,2709,[303 315 272 276 509],537,5,11072,4.085608856088561,20.0,20.0
10710,2,2710,[303 315 272 276 509],13,5,11077,4.085946145333825,20.0,20.0
10711,2,2711,[303 315 272 276 509],13,5,11082,4.086283185840708,20.0,20.0
10712,2,2712,[303 315 272 276 509],894,5,11087,4.086619977884261,20.0,20.0
10713,2,2713,[303 315 272 276 509],13,5,11092,4.086956521739131,20.0,20.0
10714,2,2714,[303 315 272 276 509],894,5,11097,4.087292817679558,20.0,20.0
10715,2,2715,[303 315 272 276 509],537,5,11102,4.087628865979381,20.0,20.0
10716,2,2716,[303 315 272 276 509],537,5,11107,4.087964666912035,20.0,20.0
10717,2,2717,[303 315 272 276 509],13,5,11112,4.088300220750551,20.0,20.0
10718,2,2718,[303 315 272 276 509],894,5,11117,4.088635527767561,20.0,20.0
10719,2,2719,[303 315 272 276 509],894,5,11122,4.088970588235294,20.0,20.0
10720,2,2720,[303 315 272 276 509],13,5,11127,4.089305402425579,20.0,20.0
10721,2,2721,[255 283 295 213 420],378,4,11131,4.089272593681117,0.0,0.0
10722,2,2722,[303 315 272 276 509],894,5,11136,4.08960705104664,20.0,20.0
10723,2,2723,[303 315 272 276 509],537,5,11141,4.089941262848752,20.0,20.0
10724,2,2724,[215 298 213 478 481],474,4,11145,4.089908256880734,0.0,0.0
10725,2,2725,[303 315 272 276 509],13,5,11150,4.09024211298606,20.0,20.0
10726,2,2726,[303 315 272 276 509],894,5,11155,4.09057572423909,20.0,20.0
10727,2,2727,[303 315 272 276 509],13,5,11160,4.090909090909091,20.0,20.0
10728,2,2728,[303 315 272 276 509],537,5,11165,4.091242213264932,20.0,20.0
10729,2,2729,[303 315 272 276 509],13,5,11170,4.091575091575091,20.0,20.0
10730,2,2730,[303 315 272 276 509],13,5,11175,4.091907726107653,20.0,20.0
10731,2,2731,[303 315 272 276 509],894,5,11180,4.0922401171303076,20.0,20.0
10732,2,2732,[481 223 246 297 208],334,5,11185,4.092572264910355,40.0,0.0
10733,2,2733,[303 315 272 276 509],537,5,11190,4.0929041697147035,20.0,20.0
10734,2,2734,[303 315 272 276 509],894,5,11195,4.093235831809872,20.0,20.0
10735,2,2735,[303 315 272 276 509],537,5,11200,4.093567251461988,20.0,20.0
10736,2,2736,[303 315 272 276 509],13,5,11205,4.093898428936792,20.0,20.0
10737,2,2737,[303 315 272 276 509],537,5,11210,4.094229364499634,20.0,20.0
10738,2,2738,[303 315 272 276 509],894,5,11215,4.09456005841548,20.0,20.0
10739,2,2739,[303 315 272 276 509],537,5,11220,4.094890510948905,20.0,20.0
10740,2,2740,[230 208 227 250 219],648,4,11224,4.094855892010215,0.0,0.0
10741,2,2741,[303 315 272 276 509],13,5,11229,4.095185995623632,20.0,20.0
10742,2,2742,[303 315 272 276 509],13,5,11234,4.095515858549034,20.0,20.0
10743,2,2743,[303 315 272 276 509],894,5,11239,4.095845481049563,20.0,20.0
10744,2,2744,[303 315 272 276 509],13,5,11244,4.096174863387978,20.0,20.0
10745,2,2745,[303 315 272 276 509],13,5,11249,4.096504005826657,20.0,20.0
10746,2,2746,[303 315 272 276 509],537,5,11254,4.096832908627594,20.0,20.0
10747,2,2747,[303 315 272 276 509],894,5,11259,4.097161572052402,20.0,20.0
10748,2,2748,[303 315 272 276 509],537,5,11264,4.097489996362314,20.0,20.0
10749,2,2749,[303 315 272 276 509],537,5,11269,4.097818181818182,20.0,20.0
10750,2,2750,[303 315 272 276 509],13,5,11274,4.0981461286804794,20.0,20.0
10751,2,2751,[303 315 272 276 509],537,5,11279,4.098473837209302,20.0,20.0
10752,2,2752,[303 315 272 276 509],894,5,11284,4.098801307664366,20.0,20.0
10753,2,2753,[303 315 272 276 509],537,5,11289,4.099128540305011,20.0,20.0
10754,2,2754,[303 315 272 276 509],894,5,11294,4.0994555353902,20.0,20.0
10755,2,2755,[303 315 272 276 509],537,5,11299,4.09978229317852,20.0,20.0
10756,2,2756,[321 429 283 509 264],308,2,11301,4.099020674646355,0.0,0.0
10757,2,2757,[303 315 272 276 509],13,5,11306,4.09934735315446,20.0,20.0
10758,2,2758,[303 315 272 276 509],894,5,11311,4.099673794853207,20.0,20.0
10759,2,2759,[303 315 272 276 509],894,5,11316,4.1,20.0,20.0
10760,2,2760,[303 315 272 276 509],537,5,11321,4.100325968851865,20.0,20.0
10761,2,2761,[303 315 272 276 509],13,5,11326,4.10065170166546,20.0,20.0
10762,2,2762,[303 315 272 276 509],13,5,11331,4.100977198697068,20.0,20.0
10763,2,2763,[303 315 272 276 509],894,5,11336,4.101302460202605,20.0,20.0
10764,2,2764,[303 315 272 276 509],13,5,11341,4.101627486437613,20.0,20.0
10765,2,2765,[303 315 272 276 509],894,5,11346,4.101952277657267,20.0,20.0
10766,2,2766,[303 315 272 276 509],13,5,11351,4.102276834116371,20.0,20.0
10767,2,2767,[303 315 272 276 509],537,5,11356,4.1026011560693645,20.0,20.0
10768,2,2768,[303 315 272 276 509],537,5,11361,4.102925243770314,20.0,20.0
10769,2,2769,[303 315 272 276 509],537,5,11366,4.103249097472924,20.0,20.0
10770,2,2770,[303 315 272 276 509],537,5,11371,4.103572717430531,20.0,20.0
10771,2,2771,[303 315 272 276 509],13,5,11376,4.103896103896104,20.0,20.0
10772,2,2772,[303 315 272 276 509],537,5,11381,4.10421925712225,20.0,20.0
10773,2,2773,[303 315 272 276 509],894,5,11386,4.104542177361211,20.0,20.0
10774,2,2774,[303 315 272 276 509],13,5,11391,4.104864864864865,20.0,20.0
10775,2,2775,[303 315 272 276 509],894,5,11396,4.105187319884727,20.0,20.0
10776,2,2776,[303 315 272 276 509],13,5,11401,4.105509542671948,20.0,20.0
10777,2,2777,[303 315 272 276 509],13,5,11406,4.105831533477322,20.0,20.0
10778,2,2778,[303 315 272 276 509],537,5,11411,4.106153292551277,20.0,20.0
10779,2,2779,[303 315 272 276 509],13,5,11416,4.106474820143885,20.0,20.0
10780,2,2780,[303 315 272 276 509],894,5,11421,4.106796116504855,20.0,20.0
10781,2,2781,[303 315 272 276 509],894,5,11426,4.107117181883537,20.0,20.0
10782,2,2782,[303 315 272 276 509],13,5,11431,4.107438016528926,20.0,20.0
10783,2,2783,[303 315 272 276 509],537,5,11436,4.107758620689655,20.0,20.0
10784,2,2784,[303 315 272 276 509],537,5,11441,4.1080789946140035,20.0,20.0
10785,2,2785,[301 208 250 384 236],279,4,11445,4.108040201005025,0.0,0.0
10786,2,2786,[303 315 272 276 509],13,5,11450,4.108360243989953,20.0,20.0
10787,2,2787,[303 315 272 276 509],894,5,11455,4.108680057388809,20.0,20.0
10788,2,2788,[303 315 272 276 509],537,5,11460,4.1089996414485475,20.0,20.0
10789,2,2789,[303 315 272 276 509],894,5,11465,4.10931899641577,20.0,20.0
10790,2,2790,[303 315 272 276 509],13,5,11470,4.109638122536725,20.0,20.0
10791,2,2791,[303 315 272 276 509],13,5,11475,4.109957020057307,20.0,20.0
10792,2,2792,[303 315 272 276 509],13,5,11480,4.110275689223058,20.0,20.0
10793,2,2793,[303 315 272 276 509],13,5,11485,4.1105941302791695,20.0,20.0
10794,2,2794,[303 315 272 276 509],13,5,11490,4.110912343470483,20.0,20.0
10795,2,2795,[303 315 272 276 509],894,5,11495,4.111230329041488,20.0,20.0
10796,2,2796,[303 315 272 276 509],537,5,11500,4.111548087236325,20.0,20.0
10797,2,2797,[202 219 264 384 394],13,2,11502,4.110793423874195,0.0,0.0
10798,2,2798,[508 295 336 221 299],486,2,11504,4.110039299749911,0.0,0.0
10799,2,2799,[303 315 272 276 509],537,5,11509,4.110357142857143,20.0,20.0
10800,2,2800,[303 315 272 276 509],13,5,11514,4.110674759014637,20.0,20.0
10801,2,2801,[303 315 272 276 509],13,5,11519,4.110992148465382,20.0,20.0
10802,2,2802,[303 315 272 276 509],537,5,11524,4.111309311452016,20.0,20.0
10803,2,2803,[303 315 272 276 509],894,5,11529,4.111626248216833,20.0,20.0
10804,2,2804,[303 315 272 276 509],13,5,11534,4.111942959001783,20.0,20.0
10805,2,2805,[303 315 272 276 509],13,5,11539,4.112259444048467,20.0,20.0
10806,2,2806,[303 315 272 276 509],13,5,11544,4.112575703598147,20.0,20.0
10807,2,2807,[303 315 272 276 509],894,5,11549,4.112891737891738,20.0,20.0
10808,2,2808,[303 315 272 276 509],894,5,11554,4.113207547169812,20.0,20.0
10809,2,2809,[303 315 272 276 509],537,5,11559,4.113523131672598,20.0,20.0
10810,2,2810,[303 315 272 276 509],894,5,11564,4.113838491639986,20.0,20.0
10811,2,2811,[303 315 272 276 509],537,5,11569,4.114153627311522,20.0,20.0
10812,2,2812,[303 315 272 276 509],894,5,11574,4.114468538926413,20.0,20.0
10813,2,2813,[303 315 272 276 509],537,5,11579,4.114783226723525,20.0,20.0
10814,2,2814,[303 315 272 276 509],537,5,11584,4.1150976909413854,20.0,20.0
10815,2,2815,[303 315 272 276 509],13,5,11589,4.115411931818182,20.0,20.0
10816,2,2816,[303 315 272 276 509],537,5,11594,4.115725949591765,20.0,20.0
10817,2,2817,[231 508 295 452 218],92,2,11596,4.114975159687722,0.0,0.0
10818,2,2818,[303 315 272 276 509],894,5,11601,4.115289109613338,20.0,20.0
10819,2,2819,[303 315 272 276 509],537,5,11606,4.115602836879432,20.0,20.0
10820,2,2820,[303 315 272 276 509],13,5,11611,4.1159163417227935,20.0,20.0
10821,2,2821,[303 315 272 276 509],13,5,11616,4.116229624379873,20.0,20.0
10822,2,2822,[303 315 272 276 509],13,5,11621,4.116542685086787,20.0,20.0
10823,2,2823,[303 315 272 276 509],537,5,11626,4.1168555240793205,20.0,20.0
10824,2,2824,[303 315 272 276 509],537,5,11631,4.11716814159292,20.0,20.0
10825,2,2825,[303 315 272 276 509],894,5,11636,4.117480537862703,20.0,20.0
10826,2,2826,[303 315 272 276 509],13,5,11641,4.117792713123452,20.0,20.0
10827,2,2827,[303 315 272 276 509],894,5,11646,4.118104667609618,20.0,20.0
10828,2,2828,[303 315 272 276 509],537,5,11651,4.1184164015553195,20.0,20.0
10829,2,2829,[303 315 272 276 509],537,5,11656,4.118727915194346,20.0,20.0
10830,2,2830,[303 315 272 276 509],13,5,11661,4.119039208760156,20.0,20.0
10831,2,2831,[303 315 272 276 509],13,5,11666,4.119350282485875,20.0,20.0
10832,2,2832,[431 250 261 211 216],479,3,11669,4.118955171196611,0.0,20.0
10833,2,2833,[303 315 272 276 509],894,5,11674,4.1192660550458715,20.0,20.0
10834,2,2834,[223 212 239 394 290],13,4,11678,4.1192239858906525,20.0,0.0
10835,2,2835,[303 315 272 276 509],13,5,11683,4.119534555712271,20.0,20.0
10836,2,2836,[303 315 272 276 509],894,5,11688,4.11984490659147,20.0,20.0
10837,2,2837,[303 315 272 276 509],537,5,11693,4.12015503875969,20.0,20.0
10838,2,2838,[303 315 272 276 509],13,5,11698,4.120464952448045,20.0,20.0
10839,2,2839,[303 315 272 276 509],537,5,11703,4.120774647887324,20.0,20.0
10840,2,2840,[303 315 272 276 509],537,5,11708,4.12108412530799,20.0,20.0
10841,2,2841,[303 315 272 276 509],894,5,11713,4.121393384940183,20.0,20.0
10842,2,2842,[303 315 272 276 509],13,5,11718,4.121702427013718,20.0,20.0
10843,2,2843,[303 315 272 276 509],13,5,11723,4.122011251758087,20.0,20.0
10844,2,2844,[303 315 272 276 509],13,5,11728,4.12231985940246,20.0,20.0
10845,2,2845,[303 315 272 276 509],537,5,11733,4.122628250175685,20.0,20.0
10846,2,2846,[303 315 272 276 509],13,5,11738,4.122936424306287,20.0,20.0
10847,2,2847,[303 315 272 276 509],537,5,11743,4.123244382022472,20.0,20.0
10848,2,2848,[303 315 272 276 509],894,5,11748,4.123552123552123,20.0,20.0
10849,2,2849,[303 315 272 276 509],894,5,11753,4.1238596491228074,20.0,20.0
10850,2,2850,[303 315 272 276 509],894,5,11758,4.1241669589617675,20.0,20.0
10851,2,2851,[303 315 272 276 509],13,5,11763,4.124474053295932,20.0,20.0
10852,2,2852,[303 315 272 276 509],13,5,11768,4.124780932351911,20.0,20.0
10853,2,2853,[303 315 272 276 509],537,5,11773,4.125087596355992,20.0,20.0
10854,2,2854,[303 315 272 276 509],537,5,11778,4.125394045534151,20.0,20.0
10855,2,2855,[303 315 272 276 509],13,5,11783,4.125700280112045,20.0,20.0
10856,2,2856,[303 315 272 276 509],13,5,11788,4.126006300315016,20.0,20.0
10857,2,2857,[303 315 272 276 509],13,5,11793,4.12631210636809,20.0,20.0
10858,2,2858,[392 508 206 208 276],537,3,11796,4.12591815320042,0.0,20.0
10859,2,2859,[303 315 272 276 509],13,5,11801,4.126223776223776,20.0,20.0
10860,2,2860,[485 213 301 321 303],6,2,11803,4.1254806011883955,0.0,0.0
10861,2,2861,[303 315 272 276 509],537,5,11808,4.1257861635220126,20.0,20.0
10862,2,2862,[303 315 272 276 509],894,5,11813,4.126091512399581,20.0,20.0
10863,2,2863,[303 315 272 276 509],894,5,11818,4.126396648044692,20.0,20.0
10864,2,2864,[331 223 227 261 344],13,2,11820,4.12565445026178,20.0,0.0
10865,2,2865,[324 297 299 275 298],116,0,11820,4.124214933705513,20.0,20.0
10866,2,2866,[303 315 272 276 509],894,5,11825,4.124520404604116,20.0,20.0
10867,2,2867,[303 315 272 276 509],537,5,11830,4.124825662482566,20.0,20.0
10868,2,2868,[215 243 485 201 508],537,1,11831,4.12373649355176,0.0,0.0
10869,2,2869,[303 315 272 276 509],13,5,11836,4.1240418118466895,20.0,20.0
10870,2,2870,[303 315 272 276 509],894,5,11841,4.1243469174503655,20.0,20.0
10871,2,2871,[303 315 272 276 509],894,5,11846,4.124651810584958,20.0,20.0
10872,2,2872,[303 315 272 276 509],537,5,11851,4.124956491472329,20.0,20.0
10873,2,2873,[303 315 272 276 509],13,5,11856,4.125260960334029,20.0,20.0
10874,2,2874,[303 315 272 276 509],13,5,11861,4.125565217391304,20.0,20.0
10875,2,2875,[303 315 272 276 509],13,5,11866,4.12586926286509,20.0,20.0
10876,2,2876,[303 315 272 276 509],13,5,11871,4.126173096976017,20.0,20.0
10877,2,2877,[299 344 508 243 227],13,1,11872,4.125086865879083,0.0,0.0
10878,2,2878,[303 315 272 276 509],537,5,11877,4.125390760680792,20.0,20.0
10879,2,2879,[213 481 217 220 290],334,2,11879,4.1246527777777775,0.0,0.0
10880,2,2880,[303 315 272 276 509],894,5,11884,4.1249566122874,20.0,20.0
10881,2,2881,[303 315 272 276 509],537,5,11889,4.125260235947259,20.0,20.0
10882,2,2882,[303 315 272 276 509],894,5,11894,4.12556364897676,20.0,20.0
10883,2,2883,[303 315 272 276 509],894,5,11899,4.125866851595007,20.0,20.0
10884,2,2884,[216 202 481 222 215],13,2,11901,4.125129982668978,0.0,20.0
10885,2,2885,[303 315 272 276 509],894,5,11906,4.125433125433125,20.0,20.0
10886,2,2886,[303 315 272 276 509],537,5,11911,4.125736058191895,20.0,20.0
10887,2,2887,[303 315 272 276 509],13,5,11916,4.126038781163435,20.0,20.0
10888,2,2888,[303 315 272 276 509],894,5,11921,4.126341294565593,20.0,20.0
10889,2,2889,[303 315 272 276 509],894,5,11926,4.126643598615917,20.0,20.0
10890,2,2890,[303 315 272 276 509],13,5,11931,4.12694569353165,20.0,20.0
10891,2,2891,[303 315 272 276 509],13,5,11936,4.127247579529738,20.0,20.0
10892,2,2892,[303 315 272 276 509],894,5,11941,4.127549256826823,20.0,20.0
10893,2,2893,[303 315 272 276 509],537,5,11946,4.127850725639254,20.0,20.0
10894,2,2894,[280 321 275 452 223],13,2,11948,4.127115716753022,20.0,20.0
10895,2,2895,[303 315 272 276 509],894,5,11953,4.127417127071824,20.0,20.0
10896,2,2896,[303 315 272 276 509],537,5,11958,4.1277183293061785,20.0,20.0
10897,2,2897,[303 315 272 276 509],13,5,11963,4.128019323671498,20.0,20.0
10898,2,2898,[303 315 272 276 509],13,5,11968,4.128320110382891,20.0,20.0
10899,2,2899,[303 315 272 276 509],894,5,11973,4.128620689655173,20.0,20.0
10900,2,2900,[303 315 272 276 509],894,5,11978,4.128921061702861,20.0,20.0
10901,2,2901,[293 216 218 226 378],308,2,11980,4.128187456926257,0.0,0.0
10902,2,2902,[303 315 272 276 509],13,5,11985,4.128487771271099,20.0,20.0
10903,2,2903,[303 315 272 276 509],13,5,11990,4.128787878787879,20.0,20.0
10904,2,2904,[303 315 272 276 509],894,5,11995,4.129087779690189,20.0,20.0
10905,2,2905,[303 315 272 276 509],894,5,12000,4.129387474191328,20.0,20.0
10906,2,2906,[303 315 272 276 509],894,5,12005,4.1296869625043,20.0,20.0
10907,2,2907,[303 315 272 276 509],537,5,12010,4.129986244841816,20.0,20.0
10908,2,2908,[303 315 272 276 509],894,5,12015,4.130285321416294,20.0,20.0
10909,2,2909,[303 315 272 276 509],894,5,12020,4.130584192439863,20.0,20.0
10910,2,2910,[303 315 272 276 509],537,5,12025,4.130882858124356,20.0,20.0
10911,2,2911,[303 315 272 276 509],13,5,12030,4.131181318681318,20.0,20.0
10912,2,2912,[303 315 272 276 509],894,5,12035,4.131479574322005,20.0,20.0
10913,2,2913,[303 315 272 276 509],537,5,12040,4.131777625257378,20.0,20.0
10914,2,2914,[303 315 272 276 509],13,5,12045,4.132075471698113,20.0,20.0
10915,2,2915,[303 315 272 276 509],537,5,12050,4.132373113854595,20.0,20.0
10916,2,2916,[413 290 367 429 213],804,3,12053,4.131984916009599,0.0,0.0
10917,2,2917,[508 216 213 321 215],524,3,12056,4.131596984235778,0.0,0.0
10918,2,2918,[303 315 272 276 509],894,5,12061,4.13189448441247,20.0,20.0
10919,2,2919,[303 315 272 276 509],13,5,12066,4.132191780821918,20.0,20.0
10920,2,2920,[303 315 272 276 509],894,5,12071,4.1324888736734,20.0,20.0
10921,2,2921,[303 315 272 276 509],13,5,12076,4.132785763175907,20.0,20.0
10922,2,2922,[303 315 272 276 509],894,5,12081,4.133082449538145,20.0,20.0
10923,2,2923,[303 315 272 276 509],894,5,12086,4.133378932968537,20.0,20.0
10924,2,2924,[303 315 272 276 509],537,5,12091,4.133675213675214,20.0,20.0
10925,2,2925,[303 315 272 276 509],13,5,12096,4.133971291866029,20.0,20.0
10926,2,2926,[303 315 272 276 509],894,5,12101,4.134267167748548,20.0,20.0
10927,2,2927,[303 315 272 276 509],894,5,12106,4.134562841530054,20.0,20.0
10928,2,2928,[303 315 272 276 509],537,5,12111,4.134858313417548,20.0,20.0
10929,2,2929,[303 315 272 276 509],537,5,12116,4.135153583617748,20.0,20.0
10930,2,2930,[303 315 272 276 509],13,5,12121,4.135448652337086,20.0,20.0
10931,2,2931,[255 272 216 301 218],184,2,12123,4.134720327421555,0.0,0.0
10932,2,2932,[226 231 367 301 261],13,1,12124,4.133651551312649,0.0,0.0
10933,2,2933,[303 315 272 276 509],13,5,12129,4.133946830265849,20.0,20.0
10934,2,2934,[303 315 272 276 509],894,5,12134,4.134241908006814,20.0,20.0
10935,2,2935,[243 276 215 236 478],537,2,12136,4.133514986376022,0.0,20.0
10936,2,2936,[303 315 272 276 509],894,5,12141,4.133810010214504,20.0,20.0
10937,2,2937,[303 315 272 276 509],13,5,12146,4.134104833219878,20.0,20.0
10938,2,2938,[303 315 272 276 509],537,5,12151,4.1343994555971415,20.0,20.0
10939,2,2939,[303 315 272 276 509],894,5,12156,4.134693877551021,20.0,20.0
10940,2,2940,[303 315 272 276 509],894,5,12161,4.134988099285957,20.0,20.0
10941,2,2941,[303 315 272 276 509],13,5,12166,4.135282121006118,20.0,20.0
10942,2,2942,[303 315 272 276 509],13,5,12171,4.135575942915392,20.0,20.0
10943,2,2943,[303 315 272 276 509],894,5,12176,4.135869565217392,20.0,20.0
10944,2,2944,[303 315 272 276 509],13,5,12181,4.13616298811545,20.0,20.0
10945,2,2945,[303 315 272 276 509],13,5,12186,4.136456211812627,20.0,20.0
10946,2,2946,[303 315 272 276 509],13,5,12191,4.136749236511707,20.0,20.0
10947,2,2947,[303 315 272 276 509],13,5,12196,4.137042062415197,20.0,20.0
10948,2,2948,[303 315 272 276 509],894,5,12201,4.13733468972533,20.0,20.0
10949,2,2949,[226 367 222 507 218],234,2,12203,4.136610169491526,0.0,20.0
10950,2,2950,[303 315 272 276 509],13,5,12208,4.13690274483226,20.0,20.0
10951,2,2951,[303 315 272 276 509],894,5,12213,4.137195121951219,20.0,20.0
10952,2,2952,[303 315 272 276 509],537,5,12218,4.13748730104978,20.0,20.0
10953,2,2953,[303 315 272 276 509],894,5,12223,4.137779282329046,20.0,20.0
10954,2,2954,[303 315 272 276 509],13,5,12228,4.138071065989847,20.0,20.0
10955,2,2955,[303 315 272 276 509],894,5,12233,4.138362652232747,20.0,20.0
10956,2,2956,[303 315 272 276 509],894,5,12238,4.1386540412580315,20.0,20.0
10957,2,2957,[303 315 272 276 509],537,5,12243,4.13894523326572,20.0,20.0
10958,2,2958,[303 315 272 276 509],894,5,12248,4.13923622845556,20.0,20.0
10959,2,2959,[303 315 272 276 509],13,5,12253,4.139527027027027,20.0,20.0
10960,2,2960,[303 315 272 276 509],894,5,12258,4.139817629179332,20.0,20.0
10961,2,2961,[303 315 272 276 509],13,5,12263,4.140108035111411,20.0,20.0
10962,2,2962,[303 315 272 276 509],13,5,12268,4.140398245021937,20.0,20.0
10963,2,2963,[303 315 272 276 509],13,5,12273,4.140688259109312,20.0,20.0
10964,2,2964,[303 315 272 276 509],537,5,12278,4.14097807757167,20.0,20.0
10965,2,2965,[303 315 272 276 509],537,5,12283,4.141267700606878,20.0,20.0
10966,2,2966,[303 315 272 276 509],894,5,12288,4.141557128412538,20.0,20.0
10967,2,2967,[303 315 272 276 509],537,5,12293,4.1418463611859835,20.0,20.0
10968,2,2968,[268 208 367 508 336],13,2,12295,4.141124957898282,0.0,0.0
10969,2,2969,[316 478 276 218 209],13,3,12298,4.140740740740741,20.0,20.0
10970,2,2970,[303 315 272 276 509],894,5,12303,4.141029956243689,20.0,20.0
10971,2,2971,[303 315 272 276 509],537,5,12308,4.141318977119784,20.0,20.0
10972,2,2972,[216 264 217 429 583],7,4,12312,4.1412714429868815,0.0,0.0
10973,2,2973,[300 481 241 429 211],694,4,12316,4.141223940820444,0.0,40.0
10974,2,2974,[303 315 272 276 509],13,5,12321,4.141512605042017,20.0,20.0
10975,2,2975,[303 315 272 276 509],13,5,12326,4.141801075268817,20.0,20.0
10976,2,2976,[303 315 272 276 509],894,5,12331,4.142089351696338,20.0,20.0
10977,2,2977,[303 315 272 276 509],13,5,12336,4.142377434519812,20.0,20.0
10978,2,2978,[303 315 272 276 509],894,5,12341,4.142665323934206,20.0,20.0
10979,2,2979,[303 315 272 276 509],13,5,12346,4.142953020134228,20.0,20.0
10980,2,2980,[303 315 272 276 509],13,5,12351,4.143240523314324,20.0,20.0
10981,2,2981,[303 315 272 276 509],537,5,12356,4.143527833668679,20.0,20.0
10982,2,2982,[303 315 272 276 509],537,5,12361,4.143814951391217,20.0,20.0
10983,2,2983,[303 315 272 276 509],13,5,12366,4.144101876675603,20.0,20.0
10984,2,2984,[303 315 272 276 509],13,5,12371,4.144388609715243,20.0,20.0
10985,2,2985,[303 315 272 276 509],537,5,12376,4.144675150703282,20.0,20.0
10986,2,2986,[303 315 272 276 509],13,5,12381,4.144961499832608,20.0,20.0
10987,2,2987,[303 315 272 276 509],13,5,12386,4.14524765729585,20.0,20.0
10988,2,2988,[303 315 272 276 509],537,5,12391,4.14553362328538,20.0,20.0
10989,2,2989,[303 315 272 276 509],13,5,12396,4.145819397993311,20.0,20.0
10990,2,2990,[303 315 272 276 509],894,5,12401,4.146104981611501,20.0,20.0
10991,2,2991,[230 255 222 216 212],474,4,12405,4.146056149732621,0.0,20.0
10992,2,2992,[303 315 272 276 509],537,5,12410,4.146341463414634,20.0,20.0
10993,2,2993,[303 315 272 276 509],537,5,12415,4.146626586506346,20.0,20.0
10994,2,2994,[303 315 272 276 509],537,5,12420,4.146911519198665,20.0,20.0
10995,2,2995,[303 315 272 276 509],537,5,12425,4.147196261682243,20.0,20.0
10996,2,2996,[303 315 272 276 509],13,5,12430,4.147480814147481,20.0,20.0
10997,2,2997,[303 315 272 276 509],13,5,12435,4.147765176784523,20.0,20.0
10998,2,2998,[303 315 272 276 509],13,5,12440,4.148049349783261,20.0,20.0
10999,2,2999,[303 315 272 276 509],894,5,12445,4.148333333333333,20.0,20.0
11000,2,3000,[303 315 272 276 509],13,5,12450,4.148617127624125,20.0,20.0
11001,2,3001,[303 315 272 276 509],13,5,12455,4.14890073284477,20.0,20.0
11002,2,3002,[303 315 272 276 509],13,5,12460,4.1491841491841495,20.0,20.0
11003,2,3003,[303 315 272 276 509],13,5,12465,4.149467376830892,20.0,20.0
11004,2,3004,[303 315 272 276 509],894,5,12470,4.149750415973378,20.0,20.0
11005,2,3005,[509 211 231 367 303],13,3,12473,4.149367930805057,0.0,20.0
11006,2,3006,[303 315 272 276 509],894,5,12478,4.149650814765547,20.0,20.0
11007,2,3007,[303 315 272 276 509],894,5,12483,4.149933510638298,20.0,20.0
11008,2,3008,[303 315 272 276 509],13,5,12488,4.150216018610834,20.0,20.0
11009,2,3009,[303 315 272 276 509],13,5,12493,4.150498338870432,20.0,20.0
11010,2,3010,[303 315 272 276 509],537,5,12498,4.150780471604119,20.0,20.0
11011,2,3011,[303 315 272 276 509],537,5,12503,4.151062416998672,20.0,20.0
11012,2,3012,[303 315 272 276 509],894,5,12508,4.151344175240624,20.0,20.0
11013,2,3013,[303 315 272 276 509],13,5,12513,4.151625746516258,20.0,20.0
11014,2,3014,[303 315 272 276 509],894,5,12518,4.151907131011608,20.0,20.0
11015,2,3015,[303 315 272 276 509],537,5,12523,4.152188328912467,20.0,20.0
11016,2,3016,[303 315 272 276 509],537,5,12528,4.152469340404375,20.0,20.0
11017,2,3017,[303 315 272 276 509],894,5,12533,4.1527501656726304,20.0,20.0
11018,2,3018,[303 315 272 276 509],537,5,12538,4.1530308049022855,20.0,20.0
11019,2,3019,[303 315 272 276 509],537,5,12543,4.153311258278146,20.0,20.0
11020,2,3020,[303 315 272 276 509],894,5,12548,4.1535915259847735,20.0,20.0
11021,2,3021,[303 315 272 276 509],537,5,12553,4.153871608206486,20.0,20.0
11022,2,3022,[303 315 272 276 509],13,5,12558,4.1541515051273565,20.0,20.0
11023,2,3023,[367 223 241 243 481],13,1,12559,4.153108465608466,20.0,0.0
11024,2,3024,[303 315 272 276 509],537,5,12564,4.1533884297520665,20.0,20.0
11025,2,3025,[303 315 272 276 509],13,5,12569,4.153668208856576,20.0,20.0
11026,2,3026,[303 315 272 276 509],894,5,12574,4.1539478031053845,20.0,20.0
11027,2,3027,[303 315 272 276 509],537,5,12579,4.154227212681638,20.0,20.0
11028,2,3028,[303 315 272 276 509],894,5,12584,4.15450643776824,20.0,20.0
11029,2,3029,[303 315 272 276 509],537,5,12589,4.154785478547855,20.0,20.0
11030,2,3030,[303 315 272 276 509],13,5,12594,4.155064335202903,20.0,20.0
11031,2,3031,[303 315 272 276 509],537,5,12599,4.155343007915567,20.0,20.0
11032,2,3032,[303 315 272 276 509],894,5,12604,4.155621496867788,20.0,20.0
11033,2,3033,[303 315 272 276 509],13,5,12609,4.155899802241266,20.0,20.0
11034,2,3034,[303 315 272 276 509],537,5,12614,4.156177924217463,20.0,20.0
11035,2,3035,[303 315 272 276 509],894,5,12619,4.1564558629776025,20.0,20.0
11036,2,3036,[303 315 272 276 509],537,5,12624,4.156733618702667,20.0,20.0
11037,2,3037,[303 315 272 276 509],537,5,12629,4.157011191573403,20.0,20.0
11038,2,3038,[303 315 272 276 509],13,5,12634,4.157288581770319,20.0,20.0
11039,2,3039,[303 315 272 276 509],13,5,12639,4.157565789473685,20.0,20.0
11040,2,3040,[303 315 272 276 509],894,5,12644,4.157842814863532,20.0,20.0
11041,2,3041,[303 315 272 276 509],13,5,12649,4.1581196581196584,20.0,20.0
11042,2,3042,[303 315 272 276 509],894,5,12654,4.158396319421623,20.0,20.0
11043,2,3043,[303 315 272 276 509],537,5,12659,4.158672798948752,20.0,20.0
11044,2,3044,[303 315 272 276 509],537,5,12664,4.158949096880131,20.0,20.0
11045,2,3045,[303 315 272 276 509],894,5,12669,4.159225213394616,20.0,20.0
11046,2,3046,[303 315 272 276 509],894,5,12674,4.159501148670824,20.0,20.0
11047,2,3047,[303 315 272 276 509],13,5,12679,4.159776902887139,20.0,20.0
11048,2,3048,[303 315 272 276 509],537,5,12684,4.160052476221712,20.0,20.0
11049,2,3049,[303 315 272 276 509],13,5,12689,4.160327868852459,20.0,20.0
11050,2,3050,[303 315 272 276 509],13,5,12694,4.160603080957063,20.0,20.0
11051,2,3051,[303 315 272 276 509],13,5,12699,4.160878112712975,20.0,20.0
11052,2,3052,[303 315 272 276 509],13,5,12704,4.161152964297412,20.0,20.0
11053,2,3053,[508 315 222 291 485],537,2,12706,4.160445317616241,20.0,20.0
11054,2,3054,[303 315 272 276 509],537,5,12711,4.160720130932897,20.0,20.0
11055,2,3055,[303 315 272 276 509],894,5,12716,4.1609947643979055,20.0,20.0
11056,2,3056,[231 239 315 209 201],537,2,12718,4.1602878639188745,20.0,0.0
11057,2,3057,[303 315 272 276 509],13,5,12723,4.16056245912361,20.0,20.0
11058,2,3058,[303 315 272 276 509],894,5,12728,4.1608368747956845,20.0,20.0
11059,2,3059,[303 315 272 276 509],894,5,12733,4.161111111111111,20.0,20.0
11060,2,3060,[303 315 272 276 509],537,5,12738,4.161385168245672,20.0,20.0
11061,2,3061,[303 315 272 276 509],13,5,12743,4.161659046374918,20.0,20.0
11062,2,3062,[303 315 272 276 509],537,5,12748,4.161932745674176,20.0,20.0
11063,2,3063,[303 315 272 276 509],537,5,12753,4.162206266318538,20.0,20.0
11064,2,3064,[303 315 272 276 509],13,5,12758,4.1624796084828715,20.0,20.0
11065,2,3065,[303 315 272 276 509],537,5,12763,4.162752772341814,20.0,20.0
11066,2,3066,[303 315 272 276 509],537,5,12768,4.163025758069775,20.0,20.0
11067,2,3067,[303 315 272 276 509],13,5,12773,4.163298565840939,20.0,20.0
11068,2,3068,[303 315 272 276 509],894,5,12778,4.1635711958292605,20.0,20.0
11069,2,3069,[303 315 272 276 509],894,5,12783,4.163843648208469,20.0,20.0
11070,2,3070,[303 315 272 276 509],13,5,12788,4.1641159231520675,20.0,20.0
11071,2,3071,[298 259 202 241 485],308,3,12791,4.163736979166667,0.0,0.0
11072,2,3072,[303 315 272 276 509],894,5,12796,4.164009111617312,20.0,20.0
11073,2,3073,[303 315 272 276 509],894,5,12801,4.164281067013663,20.0,20.0
11074,2,3074,[303 315 272 276 509],13,5,12806,4.164552845528456,20.0,20.0
11075,2,3075,[303 315 272 276 509],894,5,12811,4.1648244473342,20.0,20.0
11076,2,3076,[303 315 272 276 509],537,5,12816,4.165095872603185,20.0,20.0
11077,2,3077,[303 315 272 276 509],13,5,12821,4.165367121507472,20.0,20.0
11078,2,3078,[303 315 272 276 509],537,5,12826,4.165638194218902,20.0,20.0
11079,2,3079,[303 315 272 276 509],894,5,12831,4.165909090909091,20.0,20.0
11080,2,3080,[303 315 272 276 509],537,5,12836,4.166179811749432,20.0,20.0
11081,2,3081,[303 315 272 276 509],894,5,12841,4.166450356911096,20.0,20.0
11082,2,3082,[303 315 272 276 509],894,5,12846,4.166720726565034,20.0,20.0
11083,2,3083,[303 315 272 276 509],537,5,12851,4.166990920881972,20.0,20.0
11084,2,3084,[303 315 272 276 509],13,5,12856,4.167260940032415,20.0,20.0
11085,2,3085,[303 315 272 276 509],894,5,12861,4.167530784186649,20.0,20.0
11086,2,3086,[303 315 272 276 509],13,5,12866,4.167800453514739,20.0,20.0
11087,2,3087,[303 315 272 276 509],537,5,12871,4.168069948186528,20.0,20.0
11088,2,3088,[303 315 272 276 509],13,5,12876,4.168339268371641,20.0,20.0
11089,2,3089,[303 315 272 276 509],894,5,12881,4.168608414239483,20.0,20.0
11090,2,3090,[303 315 272 276 509],894,5,12886,4.168877385959236,20.0,20.0
11091,2,3091,[303 315 272 276 509],13,5,12891,4.169146183699871,20.0,20.0
11092,2,3092,[303 315 272 276 509],894,5,12896,4.169414807630132,20.0,20.0
11093,2,3093,[303 315 272 276 509],537,5,12901,4.169683257918552,20.0,20.0
11094,2,3094,[303 315 272 276 509],894,5,12906,4.169951534733441,20.0,20.0
11095,2,3095,[303 315 272 276 509],537,5,12911,4.170219638242894,20.0,20.0
11096,2,3096,[303 315 272 276 509],13,5,12916,4.170487568614789,20.0,20.0
11097,2,3097,[303 315 272 276 509],13,5,12921,4.170755326016785,20.0,20.0
11098,2,3098,[303 315 272 276 509],894,5,12926,4.171022910616328,20.0,20.0
11099,2,3099,[303 315 272 276 509],894,5,12931,4.171290322580645,20.0,20.0
11100,2,3100,[303 315 272 276 509],13,5,12936,4.1715575620767495,20.0,20.0
11101,2,3101,[303 315 272 276 509],13,5,12941,4.171824629271438,20.0,20.0
11102,2,3102,[303 315 272 276 509],537,5,12946,4.172091524331292,20.0,20.0
11103,2,3103,[303 315 272 276 509],537,5,12951,4.172358247422681,20.0,20.0
11104,2,3104,[303 315 272 276 509],894,5,12956,4.172624798711755,20.0,20.0
11105,2,3105,[303 315 272 276 509],894,5,12961,4.1728911783644556,20.0,20.0
11106,2,3106,[303 315 272 276 509],537,5,12966,4.1731573865465075,20.0,20.0
11107,2,3107,[303 315 272 276 509],537,5,12971,4.173423423423423,20.0,20.0
11108,2,3108,[303 315 272 276 509],537,5,12976,4.173689289160502,20.0,20.0
11109,2,3109,[303 315 272 276 509],537,5,12981,4.17395498392283,20.0,20.0
11110,2,3110,[509 508 299 350 223],894,2,12983,4.17325618772099,20.0,0.0
11111,2,3111,[303 315 272 276 509],537,5,12988,4.173521850899743,20.0,20.0
11112,2,3112,[303 315 272 276 509],894,5,12993,4.173787343398651,20.0,20.0
11113,2,3113,[303 315 272 276 509],894,5,12998,4.1740526653821455,20.0,20.0
11114,2,3114,[303 315 272 276 509],894,5,13003,4.174317817014447,20.0,20.0
11115,2,3115,[303 315 272 276 509],537,5,13008,4.174582798459563,20.0,20.0
11116,2,3116,[303 315 272 276 509],13,5,13013,4.174847609881296,20.0,20.0
11117,2,3117,[217 231 429 485 230],7,3,13016,4.174470814624759,0.0,0.0
11118,2,3118,[303 315 272 276 509],13,5,13021,4.174735492144919,20.0,20.0
11119,2,3119,[303 315 272 276 509],537,5,13026,4.175,20.0,20.0
11120,2,3120,[303 315 272 276 509],894,5,13031,4.175264338353092,20.0,20.0
11121,2,3121,[303 315 272 276 509],537,5,13036,4.175528507367073,20.0,20.0
11122,2,3122,[303 315 272 276 509],894,5,13041,4.175792507204611,20.0,20.0
11123,2,3123,[321 326 508 485 331],13,0,13041,4.1744558258642765,0.0,0.0
11124,2,3124,[303 315 272 276 509],13,5,13046,4.17472,20.0,20.0
11125,2,3125,[241 219 208 226 293],774,2,13048,4.17402431222009,0.0,0.0
11126,2,3126,[303 315 272 276 509],894,5,13053,4.1742884553885515,20.0,20.0
11127,2,3127,[303 315 272 276 509],894,5,13058,4.17455242966752,20.0,20.0
11128,2,3128,[303 315 272 276 509],13,5,13063,4.17481623521892,20.0,20.0
11129,2,3129,[303 315 272 276 509],537,5,13068,4.175079872204472,20.0,20.0
11130,2,3130,[303 315 272 276 509],537,5,13073,4.175343340785692,20.0,20.0
11131,2,3131,[303 315 272 276 509],13,5,13078,4.175606641123882,20.0,20.0
11132,2,3132,[315 255 230 222 485],334,3,13081,4.175231407596553,20.0,20.0
11133,2,3133,[303 315 272 276 509],894,5,13086,4.175494575622208,20.0,20.0
11134,2,3134,[303 315 272 276 509],537,5,13091,4.175757575757576,20.0,20.0
11135,2,3135,[303 315 272 276 509],537,5,13096,4.176020408163265,20.0,20.0
11136,2,3136,[303 315 272 276 509],13,5,13101,4.176283072999682,20.0,20.0
11137,2,3137,[232 300 507 298 230],85,2,13103,4.175589547482473,0.0,20.0
11138,2,3138,[303 315 272 276 509],537,5,13108,4.175852182223638,20.0,20.0
11139,2,3139,[295 226 507 276 452],308,1,13109,4.17484076433121,0.0,20.0
11140,2,3140,[303 315 272 276 509],537,5,13114,4.17510347023241,20.0,20.0
11141,2,3141,[303 315 272 276 509],537,5,13119,4.175366008911522,20.0,20.0
11142,2,3142,[303 315 272 276 509],13,5,13124,4.175628380528158,20.0,20.0
11143,2,3143,[303 315 272 276 509],537,5,13129,4.1758905852417305,20.0,20.0
11144,2,3144,[303 315 272 276 509],894,5,13134,4.176152623211447,20.0,20.0
11145,2,3145,[303 315 272 276 509],537,5,13139,4.176414494596313,20.0,20.0
11146,2,3146,[303 315 272 276 509],13,5,13144,4.176676199555132,20.0,20.0
11147,2,3147,[303 315 272 276 509],537,5,13149,4.176937738246505,20.0,20.0
11148,2,3148,[212 485 420 350 303],13,3,13152,4.176563988567799,0.0,0.0
11149,2,3149,[303 315 272 276 509],13,5,13157,4.1768253968253966,20.0,20.0
11150,2,3150,[303 315 272 276 509],894,5,13162,4.17708663916217,20.0,20.0
11151,2,3151,[303 315 272 276 509],894,5,13167,4.17734771573604,20.0,20.0
11152,2,3152,[303 315 272 276 509],537,5,13172,4.177608626704726,20.0,20.0
11153,2,3153,[303 315 272 276 509],537,5,13177,4.177869372225745,20.0,20.0
11154,2,3154,[303 315 272 276 509],537,5,13182,4.178129952456419,20.0,20.0
11155,2,3155,[303 315 272 276 509],13,5,13187,4.178390367553866,20.0,20.0
11156,2,3156,[303 315 272 276 509],537,5,13192,4.178650617675008,20.0,20.0
11157,2,3157,[303 315 272 276 509],13,5,13197,4.178910702976568,20.0,20.0
11158,2,3158,[303 315 272 276 509],537,5,13202,4.179170623615068,20.0,20.0
11159,2,3159,[303 315 272 276 509],13,5,13207,4.179430379746836,20.0,20.0
11160,2,3160,[303 315 272 276 509],537,5,13212,4.179689971527997,20.0,20.0
11161,2,3161,[303 315 272 276 509],13,5,13217,4.179949399114484,20.0,20.0
11162,2,3162,[303 315 272 276 509],537,5,13222,4.18020866266203,20.0,20.0
11163,2,3163,[303 315 272 276 509],894,5,13227,4.1804677623261695,20.0,20.0
11164,2,3164,[303 315 272 276 509],894,5,13232,4.1807266982622435,20.0,20.0
11165,2,3165,[303 315 272 276 509],13,5,13237,4.180985470625394,20.0,20.0
11166,2,3166,[303 315 272 276 509],537,5,13242,4.181244079570572,20.0,20.0
11167,2,3167,[303 315 272 276 509],537,5,13247,4.181502525252525,20.0,20.0
11168,2,3168,[303 315 272 276 509],537,5,13252,4.181760807825812,20.0,20.0
11169,2,3169,[303 315 272 276 509],13,5,13257,4.182018927444795,20.0,20.0
11170,2,3170,[303 315 272 276 509],537,5,13262,4.182276884263639,20.0,20.0
11171,2,3171,[303 315 272 276 509],537,5,13267,4.182534678436318,20.0,20.0
11172,2,3172,[303 315 272 276 509],894,5,13272,4.182792310116609,20.0,20.0
11173,2,3173,[303 315 272 276 509],537,5,13277,4.183049779458097,20.0,20.0
11174,2,3174,[303 315 272 276 509],537,5,13282,4.183307086614173,20.0,20.0
11175,2,3175,[213 299 509 344 297],894,4,13286,4.183249370277078,20.0,0.0
11176,2,3176,[303 315 272 276 509],13,5,13291,4.183506452628266,20.0,20.0
11177,2,3177,[303 315 272 276 509],537,5,13296,4.183763373190686,20.0,20.0
11178,2,3178,[303 315 272 276 509],894,5,13301,4.184020132117018,20.0,20.0
11179,2,3179,[303 315 272 276 509],894,5,13306,4.184276729559748,20.0,20.0
11180,2,3180,[303 315 272 276 509],894,5,13311,4.184533165671173,20.0,20.0
11181,2,3181,[303 315 272 276 509],537,5,13316,4.184789440603394,20.0,20.0
11182,2,3182,[303 315 272 276 509],537,5,13321,4.185045554508325,20.0,20.0
11183,2,3183,[303 315 272 276 509],13,5,13326,4.185301507537688,20.0,20.0
11184,2,3184,[303 315 272 276 509],537,5,13331,4.185557299843014,20.0,20.0
11185,2,3185,[303 315 272 276 509],537,5,13336,4.185812931575644,20.0,20.0
11186,2,3186,[508 239 509 290 241],13,3,13339,4.1854408534672105,0.0,0.0
11187,2,3187,[303 315 272 276 509],13,5,13344,4.185696361355082,20.0,20.0
11188,2,3188,[303 315 272 276 509],894,5,13349,4.185951708999687,20.0,20.0
11189,2,3189,[303 315 272 276 509],13,5,13354,4.186206896551724,20.0,20.0
11190,2,3190,[303 315 272 276 509],894,5,13359,4.186461924161705,20.0,20.0
11191,2,3191,[303 315 272 276 509],537,5,13364,4.18671679197995,20.0,20.0
11192,2,3192,[303 315 272 276 509],537,5,13369,4.186971500156592,20.0,20.0
11193,2,3193,[276 326 219 508 298],388,3,13372,4.186599874765185,0.0,20.0
11194,2,3194,[303 315 272 276 509],13,5,13377,4.186854460093897,20.0,20.0
11195,2,3195,[303 315 272 276 509],537,5,13382,4.187108886107635,20.0,20.0
11196,2,3196,[303 315 272 276 509],894,5,13387,4.187363152955896,20.0,20.0
11197,2,3197,[303 315 272 276 509],13,5,13392,4.1876172607879925,20.0,20.0
11198,2,3198,[303 315 272 276 509],537,5,13397,4.187871209753048,20.0,20.0
11199,2,3199,[201 431 303 276 384],13,2,13399,4.1871875,0.0,20.0
11200,2,3200,[303 315 272 276 509],13,5,13404,4.187441424554827,20.0,20.0
11201,2,3201,[303 315 272 276 509],13,5,13409,4.187695190505933,20.0,20.0
11202,2,3202,[303 315 272 276 509],537,5,13414,4.187948798001873,20.0,20.0
11203,2,3203,[303 315 272 276 509],537,5,13419,4.188202247191011,20.0,20.0
11204,2,3204,[303 315 272 276 509],13,5,13424,4.188455538221529,20.0,20.0
11205,2,3205,[303 315 272 276 509],13,5,13429,4.1887086712414225,20.0,20.0
11206,2,3206,[303 315 272 276 509],894,5,13434,4.1889616463985035,20.0,20.0
11207,2,3207,[303 315 272 276 509],537,5,13439,4.189214463840399,20.0,20.0
11208,2,3208,[303 315 272 276 509],894,5,13444,4.189467123714553,20.0,20.0
11209,2,3209,[303 315 272 276 509],537,5,13449,4.189719626168224,20.0,20.0
11210,2,3210,[303 315 272 276 509],13,5,13454,4.1899719713484895,20.0,20.0
11211,2,3211,[303 315 272 276 509],537,5,13459,4.190224159402241,20.0,20.0
11212,2,3212,[303 315 272 276 509],537,5,13464,4.190476190476191,20.0,20.0
11213,2,3213,[303 315 272 276 509],894,5,13469,4.190728064716864,20.0,20.0
11214,2,3214,[303 315 272 276 509],537,5,13474,4.190979782270607,20.0,20.0
11215,2,3215,[303 315 272 276 509],537,5,13479,4.191231343283582,20.0,20.0
11216,2,3216,[303 315 272 276 509],13,5,13484,4.191482747901772,20.0,20.0
11217,2,3217,[303 315 272 276 509],13,5,13489,4.191733996270976,20.0,20.0
11218,2,3218,[303 315 272 276 509],894,5,13494,4.191985088536812,20.0,20.0
11219,2,3219,[303 315 272 276 509],894,5,13499,4.19223602484472,20.0,20.0
11220,2,3220,[303 315 272 276 509],13,5,13504,4.192486805339956,20.0,20.0
11221,2,3221,[303 315 272 276 509],894,5,13509,4.192737430167598,20.0,20.0
11222,2,3222,[303 315 272 276 509],894,5,13514,4.192987899472541,20.0,20.0
11223,2,3223,[303 315 272 276 509],537,5,13519,4.193238213399503,20.0,20.0
11224,2,3224,[227 478 315 303 212],13,5,13524,4.193488372093023,20.0,0.0
11225,2,3225,[303 315 272 276 509],537,5,13529,4.193738375697458,20.0,20.0
11226,2,3226,[303 315 272 276 509],537,5,13534,4.193988224356988,20.0,20.0
11227,2,3227,[303 315 272 276 509],13,5,13539,4.194237918215613,20.0,20.0
11228,2,3228,[303 315 272 276 509],894,5,13544,4.194487457417157,20.0,20.0
11229,2,3229,[303 315 272 276 509],13,5,13549,4.1947368421052635,20.0,20.0
11230,2,3230,[303 315 272 276 509],537,5,13554,4.194986072423398,20.0,20.0
11231,2,3231,[303 315 272 276 509],13,5,13559,4.195235148514851,20.0,20.0
11232,2,3232,[303 315 272 276 509],13,5,13564,4.195484070522734,20.0,20.0
11233,2,3233,[303 315 272 276 509],537,5,13569,4.195732838589981,20.0,20.0
11234,2,3234,[303 315 272 276 509],537,5,13574,4.195981452859351,20.0,20.0
11235,2,3235,[303 315 272 276 509],13,5,13579,4.196229913473424,20.0,20.0
11236,2,3236,[303 315 272 276 509],537,5,13584,4.1964782205746065,20.0,20.0
11237,2,3237,[303 315 272 276 509],894,5,13589,4.196726374305126,20.0,20.0
11238,2,3238,[303 315 272 276 509],537,5,13594,4.19697437480704,20.0,20.0
11239,2,3239,[303 315 272 276 509],894,5,13599,4.197222222222222,20.0,20.0
11240,2,3240,[303 315 272 276 509],13,5,13604,4.197469916692379,20.0,20.0
11241,2,3241,[303 315 272 276 509],894,5,13609,4.197717458359038,20.0,20.0
11242,2,3242,[303 315 272 276 509],537,5,13614,4.1979648473635525,20.0,20.0
11243,2,3243,[429 220 206 218 284],406,1,13615,4.1969790382244145,0.0,0.0
11244,2,3244,[303 315 272 276 509],894,5,13620,4.197226502311248,20.0,20.0
11245,2,3245,[303 315 272 276 509],894,5,13625,4.19747381392483,20.0,20.0
11246,2,3246,[303 315 272 276 509],13,5,13630,4.197720973206036,20.0,20.0
11247,2,3247,[303 315 272 276 509],13,5,13635,4.197967980295567,20.0,20.0
11248,2,3248,[303 315 272 276 509],13,5,13640,4.198214835333949,20.0,20.0
11249,2,3249,[303 315 272 276 509],894,5,13645,4.1984615384615385,20.0,20.0
11250,2,3250,[303 315 272 276 509],537,5,13650,4.198708089818517,20.0,20.0
11251,2,3251,[303 315 272 276 509],894,5,13655,4.198954489544896,20.0,20.0
11252,2,3252,[303 315 272 276 509],13,5,13660,4.199200737780511,20.0,20.0
11253,2,3253,[303 315 272 276 509],13,5,13665,4.199446834665028,20.0,20.0
11254,2,3254,[303 315 272 276 509],894,5,13670,4.199692780337942,20.0,20.0
11255,2,3255,[303 315 272 276 509],894,5,13675,4.199938574938575,20.0,20.0
11256,2,3256,[303 315 272 276 509],894,5,13680,4.200184218606079,20.0,20.0
11257,2,3257,[303 315 272 276 509],537,5,13685,4.200429711479435,20.0,20.0
11258,2,3258,[303 315 272 276 509],894,5,13690,4.200675053697453,20.0,20.0
11259,2,3259,[303 315 272 276 509],894,5,13695,4.200920245398773,20.0,20.0
11260,2,3260,[303 315 272 276 509],13,5,13700,4.2011652867218645,20.0,20.0
11261,2,3261,[255 316 298 221 275],894,3,13703,4.200797057020233,20.0,20.0
11262,2,3262,[303 315 272 276 509],13,5,13708,4.201041985902544,20.0,20.0
11263,2,3263,[303 315 272 276 509],13,5,13713,4.201286764705882,20.0,20.0
11264,2,3264,[303 315 272 276 509],13,5,13718,4.201531393568147,20.0,20.0
11265,2,3265,[303 315 272 276 509],537,5,13723,4.201775872627067,20.0,20.0
11266,2,3266,[303 315 272 276 509],13,5,13728,4.202020202020202,20.0,20.0
11267,2,3267,[303 315 272 276 509],537,5,13733,4.2022643818849446,20.0,20.0
11268,2,3268,[303 315 272 276 509],13,5,13738,4.20250841235852,20.0,20.0
11269,2,3269,[303 315 272 276 509],13,5,13743,4.202752293577982,20.0,20.0
11270,2,3270,[303 315 272 276 509],537,5,13748,4.20299602568022,20.0,20.0
11271,2,3271,[250 211 300 478 232],85,2,13750,4.202322738386308,0.0,40.0
11272,2,3272,[303 315 272 276 509],13,5,13755,4.2025664527956,20.0,20.0
11273,2,3273,[303 315 272 276 509],537,5,13760,4.202810018326207,20.0,20.0
11274,2,3274,[303 315 272 276 509],894,5,13765,4.203053435114504,20.0,20.0
11275,2,3275,[303 315 272 276 509],13,5,13770,4.2032967032967035,20.0,20.0
11276,2,3276,[303 315 272 276 509],13,5,13775,4.20353982300885,20.0,20.0
11277,2,3277,[303 315 272 276 509],894,5,13780,4.203782794386822,20.0,20.0
11278,2,3278,[303 315 272 276 509],537,5,13785,4.204025617566331,20.0,20.0
11279,2,3279,[303 315 272 276 509],537,5,13790,4.204268292682927,20.0,20.0
11280,2,3280,[303 315 272 276 509],894,5,13795,4.20451081987199,20.0,20.0
11281,2,3281,[303 315 272 276 509],537,5,13800,4.204753199268739,20.0,20.0
11282,2,3282,[213 272 216 264 211],479,3,13803,4.204386232104782,0.0,20.0
11283,2,3283,[300 378 211 429 303],537,2,13805,4.203714981729598,0.0,40.0
11284,2,3284,[303 315 272 276 509],537,5,13810,4.203957382039574,20.0,20.0
11285,2,3285,[303 315 272 276 509],13,5,13815,4.204199634814364,20.0,20.0
11286,2,3286,[303 315 272 276 509],537,5,13820,4.204441740188622,20.0,20.0
11287,2,3287,[303 315 272 276 509],537,5,13825,4.204683698296837,20.0,20.0
11288,2,3288,[303 315 272 276 509],894,5,13830,4.204925509273336,20.0,20.0
11289,2,3289,[303 315 272 276 509],894,5,13835,4.2051671732522795,20.0,20.0
11290,2,3290,[303 315 272 276 509],537,5,13840,4.205408690367669,20.0,20.0
11291,2,3291,[303 315 272 276 509],894,5,13845,4.205650060753341,20.0,20.0
11292,2,3292,[303 315 272 276 509],13,5,13850,4.20589128454297,20.0,20.0
11293,2,3293,[303 315 272 276 509],537,5,13855,4.206132361870067,20.0,20.0
11294,2,3294,[303 315 272 276 509],537,5,13860,4.206373292867982,20.0,20.0
11295,2,3295,[303 315 272 276 509],13,5,13865,4.206614077669903,20.0,20.0
11296,2,3296,[303 315 272 276 509],13,5,13870,4.2068547164088566,20.0,20.0
11297,2,3297,[303 315 272 276 509],894,5,13875,4.207095209217708,20.0,20.0
11298,2,3298,[303 315 272 276 509],894,5,13880,4.20733555622916,20.0,20.0
11299,2,3299,[303 315 272 276 509],13,5,13885,4.207575757575758,20.0,20.0
11300,2,3300,[303 315 272 276 509],894,5,13890,4.207815813389882,20.0,20.0
11301,2,3301,[218 212 301 316 272],650,1,13891,4.206844336765597,20.0,0.0
11302,2,3302,[315 509 275 272 303],537,5,13896,4.20708446866485,20.0,20.0
11303,2,3303,[303 315 272 276 509],537,5,13901,4.2073244552058116,20.0,20.0
11304,2,3304,[303 315 272 276 509],894,5,13906,4.207564296520424,20.0,20.0
11305,2,3305,[303 315 272 276 509],537,5,13911,4.207803992740472,20.0,20.0
11306,2,3306,[208 244 485 272 384],271,2,13913,4.207136377381312,0.0,0.0
11307,2,3307,[303 315 272 276 509],13,5,13918,4.207376058041112,20.0,20.0
11308,2,3308,[303 315 272 276 509],13,5,13923,4.207615593834995,20.0,20.0
11309,2,3309,[303 315 272 276 509],13,5,13928,4.20785498489426,20.0,20.0
11310,2,3310,[303 315 272 276 509],13,5,13933,4.208094231350045,20.0,20.0
11311,2,3311,[303 315 272 276 509],13,5,13938,4.208333333333333,20.0,20.0
11312,2,3312,[303 315 272 276 509],894,5,13943,4.2085722909749474,20.0,20.0
11313,2,3313,[303 315 272 276 509],13,5,13948,4.2088111044055525,20.0,20.0
11314,2,3314,[303 315 272 276 509],894,5,13953,4.209049773755656,20.0,20.0
11315,2,3315,[303 315 272 276 509],13,5,13958,4.2092882991556095,20.0,20.0
11316,2,3316,[303 315 272 276 509],537,5,13963,4.209526680735604,20.0,20.0
11317,2,3317,[215 218 485 300 336],13,1,13964,4.208559373116335,0.0,20.0
11318,2,3318,[303 315 272 276 509],894,5,13969,4.208797830671889,20.0,20.0
11319,2,3319,[303 315 272 276 509],13,5,13974,4.209036144578313,20.0,20.0
11320,2,3320,[303 315 272 276 509],894,5,13979,4.209274314965372,20.0,20.0
11321,2,3321,[303 315 272 276 509],894,5,13984,4.209512341962673,20.0,20.0
11322,2,3322,[303 315 272 276 509],537,5,13989,4.209750225699669,20.0,20.0
11323,2,3323,[303 315 272 276 509],537,5,13994,4.209987966305656,20.0,20.0
11324,2,3324,[303 315 272 276 509],13,5,13999,4.210225563909774,20.0,20.0
11325,2,3325,[303 315 272 276 509],537,5,14004,4.21046301864101,20.0,20.0
11326,2,3326,[303 315 272 276 509],894,5,14009,4.210700330628193,20.0,20.0
11327,2,3327,[303 315 272 276 509],894,5,14014,4.2109375,20.0,20.0
11328,2,3328,[303 315 272 276 509],894,5,14019,4.2111745268849505,20.0,20.0
11329,2,3329,[508 272 326 244 246],334,2,14021,4.2105105105105105,0.0,0.0
11330,2,3330,[303 315 272 276 509],537,5,14026,4.210747523266287,20.0,20.0
11331,2,3331,[303 315 272 276 509],537,5,14031,4.210984393757503,20.0,20.0
11332,2,3332,[303 315 272 276 509],13,5,14036,4.211221122112211,20.0,20.0
11333,2,3333,[303 315 272 276 509],537,5,14041,4.211457708458308,20.0,20.0
11334,2,3334,[303 315 272 276 509],894,5,14046,4.211694152923538,20.0,20.0
11335,2,3335,[431 219 509 378 213],7,3,14049,4.211330935251799,0.0,0.0
11336,2,3336,[303 315 272 276 509],13,5,14054,4.211567275996404,20.0,20.0
11337,2,3337,[303 315 272 276 509],13,5,14059,4.211803475134811,20.0,20.0
11338,2,3338,[303 315 272 276 509],13,5,14064,4.2120395327942495,20.0,20.0
11339,2,3339,[303 315 272 276 509],13,5,14069,4.212275449101797,20.0,20.0
11340,2,3340,[303 315 272 276 509],13,5,14074,4.212511224184376,20.0,20.0
11341,2,3341,[303 315 272 276 509],537,5,14079,4.212746858168761,20.0,20.0
11342,2,3342,[303 315 272 276 509],13,5,14084,4.212982351181574,20.0,20.0
11343,2,3343,[303 315 272 276 509],537,5,14089,4.213217703349282,20.0,20.0
11344,2,3344,[303 315 272 276 509],537,5,14094,4.213452914798206,20.0,20.0
11345,2,3345,[303 315 272 276 509],13,5,14099,4.213687985654513,20.0,20.0
11346,2,3346,[303 315 272 276 509],894,5,14104,4.213922916044218,20.0,20.0
11347,2,3347,[303 315 272 276 509],13,5,14109,4.21415770609319,20.0,20.0
11348,2,3348,[303 315 272 276 509],894,5,14114,4.214392355927142,20.0,20.0
11349,2,3349,[303 315 272 276 509],13,5,14119,4.214626865671642,20.0,20.0
11350,2,3350,[303 315 272 276 509],537,5,14124,4.214861235452104,20.0,20.0
11351,2,3351,[303 315 272 276 509],13,5,14129,4.215095465393794,20.0,20.0
11352,2,3352,[275 321 213 301 284],318,4,14133,4.215031315240084,0.0,20.0
11353,2,3353,[303 315 272 276 509],537,5,14138,4.215265354800239,20.0,20.0
11354,2,3354,[217 431 367 298 227],648,1,14139,4.214307004470939,0.0,0.0
11355,2,3355,[299 275 219 394 209],145,3,14142,4.213945172824792,0.0,20.0
11356,2,3356,[303 315 272 276 509],537,5,14147,4.214179326779863,20.0,20.0
11357,2,3357,[303 315 272 276 509],894,5,14152,4.214413341274568,20.0,20.0
11358,2,3358,[303 315 272 276 509],894,5,14157,4.2146472164334625,20.0,20.0
11359,2,3359,[303 315 272 276 509],894,5,14162,4.214880952380953,20.0,20.0
11360,2,3360,[303 315 272 276 509],537,5,14167,4.215114549241298,20.0,20.0
11361,2,3361,[303 315 272 276 509],537,5,14172,4.215348007138608,20.0,20.0
11362,2,3362,[303 315 272 276 509],537,5,14177,4.215581326196848,20.0,20.0
11363,2,3363,[206 213 236 291 378],537,1,14178,4.214625445897741,0.0,0.0
11364,2,3364,[303 315 272 276 509],537,5,14183,4.214858841010401,20.0,20.0
11365,2,3365,[303 315 272 276 509],537,5,14188,4.215092097445039,20.0,20.0
11366,2,3366,[303 315 272 276 509],894,5,14193,4.215325215325215,20.0,20.0
11367,2,3367,[303 315 272 276 509],894,5,14198,4.215558194774347,20.0,20.0
11368,2,3368,[303 315 272 276 509],537,5,14203,4.215791035915702,20.0,20.0
11369,2,3369,[303 315 272 276 509],13,5,14208,4.216023738872404,20.0,20.0
11370,2,3370,[201 293 208 295 206],387,3,14211,4.215663008009493,0.0,0.0
11371,2,3371,[303 315 272 276 509],894,5,14216,4.215895610913405,20.0,20.0
11372,2,3372,[303 315 272 276 509],537,5,14221,4.216128075896828,20.0,20.0
11373,2,3373,[429 216 275 284 295],308,3,14224,4.215767634854772,0.0,20.0
11374,2,3374,[303 315 272 276 509],537,5,14229,4.216,20.0,20.0
11375,2,3375,[303 315 272 276 509],13,5,14234,4.216232227488152,20.0,20.0
11376,2,3376,[303 315 272 276 509],537,5,14239,4.216464317441516,20.0,20.0
11377,2,3377,[321 223 275 303 206],409,4,14243,4.216400236826525,20.0,20.0
11378,2,3378,[303 315 272 276 509],894,5,14248,4.216632139686298,20.0,20.0
11379,2,3379,[303 315 272 276 509],13,5,14253,4.216863905325444,20.0,20.0
11380,2,3380,[303 315 272 276 509],537,5,14258,4.21709553386572,20.0,20.0
11381,2,3381,[303 315 272 276 509],13,5,14263,4.21732702542874,20.0,20.0
11382,2,3382,[303 315 272 276 509],13,5,14268,4.217558380135974,20.0,20.0
11383,2,3383,[303 315 272 276 509],537,5,14273,4.217789598108747,20.0,20.0
11384,2,3384,[230 222 315 241 336],13,1,14274,4.216838995568685,20.0,20.0
11385,2,3385,[303 315 272 276 509],13,5,14279,4.217070289427053,20.0,20.0
11386,2,3386,[303 315 272 276 509],894,5,14284,4.217301446708001,20.0,20.0
11387,2,3387,[303 315 272 276 509],537,5,14289,4.217532467532467,20.0,20.0
11388,2,3388,[485 218 217 336 413],13,0,14289,4.216287990557687,0.0,0.0
11389,2,3389,[303 315 272 276 509],894,5,14294,4.216519174041298,20.0,20.0
11390,2,3390,[303 315 272 276 509],894,5,14299,4.216750221173695,20.0,20.0
11391,2,3391,[226 299 219 202 478],13,3,14302,4.216391509433962,0.0,0.0
11392,2,3392,[303 315 272 276 509],537,5,14307,4.216622458001768,20.0,20.0
11393,2,3393,[303 315 272 276 509],13,5,14312,4.216853270477313,20.0,20.0
11394,2,3394,[303 315 272 276 509],13,5,14317,4.217083946980854,20.0,20.0
11395,2,3395,[303 315 272 276 509],537,5,14322,4.217314487632509,20.0,20.0
11396,2,3396,[303 315 272 276 509],13,5,14327,4.217544892552252,20.0,20.0
11397,2,3397,[303 315 272 276 509],894,5,14332,4.217775161859918,20.0,20.0
11398,2,3398,[303 315 272 276 509],537,5,14337,4.218005295675199,20.0,20.0
11399,2,3399,[303 315 272 276 509],894,5,14342,4.218235294117647,20.0,20.0
11400,2,3400,[303 315 272 276 509],13,5,14347,4.2184651573066745,20.0,20.0
11401,2,3401,[303 315 272 276 509],13,5,14352,4.218694885361552,20.0,20.0
11402,2,3402,[303 315 272 276 509],537,5,14357,4.21892447840141,20.0,20.0
11403,2,3403,[303 315 272 276 509],894,5,14362,4.219153936545241,20.0,20.0
11404,2,3404,[303 315 272 276 509],13,5,14367,4.219383259911894,20.0,20.0
11405,2,3405,[303 315 272 276 509],894,5,14372,4.219612448620082,20.0,20.0
11406,2,3406,[303 315 272 276 509],894,5,14377,4.219841502788377,20.0,20.0
11407,2,3407,[303 315 272 276 509],537,5,14382,4.220070422535211,20.0,20.0
11408,2,3408,[303 315 272 276 509],894,5,14387,4.220299207978879,20.0,20.0
11409,2,3409,[303 315 272 276 509],13,5,14392,4.220527859237537,20.0,20.0
11410,2,3410,[303 315 272 276 509],537,5,14397,4.2207563764291995,20.0,20.0
11411,2,3411,[507 431 290 315 420],13,3,14400,4.220398593200469,20.0,0.0
11412,2,3412,[303 315 272 276 509],13,5,14405,4.220627014356871,20.0,20.0
11413,2,3413,[303 315 272 276 509],13,5,14410,4.220855301698887,20.0,20.0
11414,2,3414,[303 315 272 276 509],537,5,14415,4.22108345534407,20.0,20.0
11415,2,3415,[303 315 272 276 509],537,5,14420,4.221311475409836,20.0,20.0
11416,2,3416,[303 315 272 276 509],537,5,14425,4.221539362013462,20.0,20.0
11417,2,3417,[303 315 272 276 509],537,5,14430,4.221767115272089,20.0,20.0
11418,2,3418,[303 315 272 276 509],537,5,14435,4.2219947353027205,20.0,20.0
11419,2,3419,[303 315 272 276 509],13,5,14440,4.222222222222222,20.0,20.0
11420,2,3420,[272 431 227 239 202],653,3,14443,4.221864951768489,0.0,0.0
11421,2,3421,[303 315 272 276 509],537,5,14448,4.222092343658679,20.0,20.0
11422,2,3422,[303 315 272 276 509],894,5,14453,4.222319602687701,20.0,20.0
11423,2,3423,[208 478 507 209 272],840,4,14457,4.222254672897196,0.0,0.0
11424,2,3424,[303 315 272 276 509],13,5,14462,4.222481751824818,20.0,20.0
11425,2,3425,[303 315 272 276 509],894,5,14467,4.222708698190309,20.0,20.0
11426,2,3426,[303 315 272 276 509],894,5,14472,4.222935512109717,20.0,20.0
11427,2,3427,[231 216 315 211 209],311,3,14475,4.222578763127188,20.0,20.0
11428,2,3428,[303 315 272 276 509],537,5,14480,4.222805482648003,20.0,20.0
11429,2,3429,[303 315 272 276 509],13,5,14485,4.223032069970846,20.0,20.0
11430,2,3430,[303 315 272 276 509],894,5,14490,4.223258525211309,20.0,20.0
11431,2,3431,[303 315 272 276 509],894,5,14495,4.223484848484849,20.0,20.0
11432,2,3432,[303 315 272 276 509],537,5,14500,4.223711039906787,20.0,20.0
11433,2,3433,[303 315 272 276 509],894,5,14505,4.2239370995923124,20.0,20.0
11434,2,3434,[303 315 272 276 509],894,5,14510,4.224163027656477,20.0,20.0
11435,2,3435,[303 315 272 276 509],13,5,14515,4.224388824214203,20.0,20.0
11436,2,3436,[303 315 272 276 509],537,5,14520,4.224614489380273,20.0,20.0
11437,2,3437,[215 316 275 246 212],85,2,14522,4.223967422920302,20.0,20.0
11438,2,3438,[303 315 272 276 509],537,5,14527,4.224193079383542,20.0,20.0
11439,2,3439,[303 315 272 276 509],537,5,14532,4.224418604651163,20.0,20.0
11440,2,3440,[336 315 284 244 290],894,2,14534,4.22377215925603,20.0,0.0
11441,2,3441,[303 315 272 276 509],894,5,14539,4.223997675769901,20.0,20.0
11442,2,3442,[303 315 272 276 509],13,5,14544,4.224223061283764,20.0,20.0
11443,2,3443,[303 315 272 276 509],13,5,14549,4.22444831591173,20.0,20.0
11444,2,3444,[303 315 272 276 509],13,5,14554,4.22467343976778,20.0,20.0
11445,2,3445,[303 315 272 276 509],13,5,14559,4.224898432965757,20.0,20.0
11446,2,3446,[303 315 272 276 509],13,5,14564,4.22512329561938,20.0,20.0
11447,2,3447,[303 315 272 276 509],537,5,14569,4.2253480278422275,20.0,20.0
11448,2,3448,[303 315 272 276 509],13,5,14574,4.225572629747753,20.0,20.0
11449,2,3449,[303 315 272 276 509],894,5,14579,4.225797101449276,20.0,20.0
11450,2,3450,[303 315 272 276 509],13,5,14584,4.226021443059983,20.0,20.0
11451,2,3451,[303 315 272 276 509],894,5,14589,4.2262456546929315,20.0,20.0
11452,2,3452,[303 315 272 276 509],13,5,14594,4.226469736461048,20.0,20.0
11453,2,3453,[303 315 272 276 509],894,5,14599,4.226693688477128,20.0,20.0
11454,2,3454,[303 315 272 276 509],537,5,14604,4.226917510853835,20.0,20.0
11455,2,3455,[303 315 272 276 509],13,5,14609,4.227141203703703,20.0,20.0
11456,2,3456,[303 315 272 276 509],894,5,14614,4.227364767139138,20.0,20.0
11457,2,3457,[303 315 272 276 509],13,5,14619,4.227588201272412,20.0,20.0
11458,2,3458,[303 315 272 276 509],13,5,14624,4.227811506215669,20.0,20.0
11459,2,3459,[303 315 272 276 509],894,5,14629,4.228034682080925,20.0,20.0
11460,2,3460,[303 315 272 276 509],13,5,14634,4.228257728980063,20.0,20.0
11461,2,3461,[303 315 272 276 509],13,5,14639,4.228480647024841,20.0,20.0
11462,2,3462,[303 315 272 276 509],13,5,14644,4.228703436326884,20.0,20.0
11463,2,3463,[303 315 272 276 509],13,5,14649,4.22892609699769,20.0,20.0
11464,2,3464,[431 213 291 212 241],234,0,14649,4.227705627705627,0.0,0.0
11465,2,3465,[303 315 272 276 509],894,5,14654,4.227928447778419,20.0,20.0
11466,2,3466,[303 315 272 276 509],537,5,14659,4.228151139313527,20.0,20.0
11467,2,3467,[303 315 272 276 509],894,5,14664,4.228373702422146,20.0,20.0
11468,2,3468,[303 315 272 276 509],13,5,14669,4.228596137215336,20.0,20.0
11469,2,3469,[303 315 272 276 509],894,5,14674,4.228818443804035,20.0,20.0
11470,2,3470,[303 315 272 276 509],13,5,14679,4.229040622299049,20.0,20.0
11471,2,3471,[429 301 222 300 326],788,2,14681,4.2283986175115205,0.0,40.0
11472,2,3472,[298 420 316 275 231],85,2,14683,4.227756982435935,20.0,20.0
11473,2,3473,[303 315 272 276 509],537,5,14688,4.227979274611399,20.0,20.0
11474,2,3474,[303 315 272 276 509],537,5,14693,4.228201438848921,20.0,20.0
11475,2,3475,[303 315 272 276 509],537,5,14698,4.228423475258919,20.0,20.0
11476,2,3476,[303 315 272 276 509],13,5,14703,4.228645383951682,20.0,20.0
11477,2,3477,[303 315 272 276 509],537,5,14708,4.228867165037378,20.0,20.0
11478,2,3478,[303 315 272 276 509],894,5,14713,4.229088818626042,20.0,20.0
11479,2,3479,[303 315 272 276 509],13,5,14718,4.229310344827586,20.0,20.0
11480,2,3480,[303 315 272 276 509],13,5,14723,4.229531743751796,20.0,20.0
11481,2,3481,[303 315 272 276 509],13,5,14728,4.2297530155083285,20.0,20.0
11482,2,3482,[303 315 272 276 509],894,5,14733,4.2299741602067185,20.0,20.0
11483,2,3483,[303 315 272 276 509],537,5,14738,4.230195177956372,20.0,20.0
11484,2,3484,[303 315 272 276 509],537,5,14743,4.230416068866571,20.0,20.0
11485,2,3485,[303 315 272 276 509],537,5,14748,4.230636833046471,20.0,20.0
11486,2,3486,[303 315 272 276 509],537,5,14753,4.2308574706051045,20.0,20.0
11487,2,3487,[211 485 431 236 290],234,0,14753,4.229644495412844,0.0,20.0
11488,2,3488,[303 315 272 276 509],13,5,14758,4.229865290914302,20.0,20.0
11489,2,3489,[303 315 272 276 509],894,5,14763,4.230085959885387,20.0,20.0
11490,2,3490,[303 315 272 276 509],537,5,14768,4.230306502434832,20.0,20.0
11491,2,3491,[300 208 226 216 321],234,1,14769,4.229381443298969,0.0,20.0
11492,2,3492,[303 315 272 276 509],894,5,14774,4.229602061265388,20.0,20.0
11493,2,3493,[303 315 272 276 509],537,5,14779,4.229822552947911,20.0,20.0
11494,2,3494,[303 315 272 276 509],13,5,14784,4.230042918454935,20.0,20.0
11495,2,3495,[303 315 272 276 509],537,5,14789,4.230263157894737,20.0,20.0
11496,2,3496,[303 315 272 276 509],13,5,14794,4.230483271375465,20.0,20.0
11497,2,3497,[507 478 367 241 280],13,2,14796,4.229845626072041,0.0,0.0
11498,2,3498,[303 315 272 276 509],537,5,14801,4.23006573306659,20.0,20.0
11499,2,3499,[303 315 272 276 509],13,5,14806,4.230285714285714,20.0,20.0
11500,2,3500,[420 261 413 508 276],13,2,14808,4.229648671808055,0.0,20.0
11501,2,3501,[303 315 272 276 509],894,5,14813,4.229868646487721,20.0,20.0
11502,2,3502,[301 478 331 268 264],13,3,14816,4.229517556380245,0.0,0.0
11503,2,3503,[303 315 272 276 509],537,5,14821,4.229737442922374,20.0,20.0
11504,2,3504,[303 315 272 276 509],13,5,14826,4.229957203994294,20.0,20.0
11505,2,3505,[303 315 272 276 509],894,5,14831,4.230176839703366,20.0,20.0
11506,2,3506,[303 315 272 276 509],537,5,14836,4.23039635015683,20.0,20.0
11507,2,3507,[231 220 301 230 227],378,0,14836,4.229190421892817,0.0,0.0
11508,2,3508,[303 315 272 276 509],13,5,14841,4.229410088344258,20.0,20.0
11509,2,3509,[303 315 272 276 509],537,5,14846,4.229629629629629,20.0,20.0
11510,2,3510,[384 316 201 230 344],13,1,14847,4.228709769296497,20.0,0.0
11511,2,3511,[303 315 272 276 509],537,5,14852,4.228929384965832,20.0,20.0
11512,2,3512,[291 222 326 259 485],474,3,14855,4.228579561628238,0.0,20.0
11513,2,3513,[303 315 272 276 509],13,5,14860,4.228799089356858,20.0,20.0
11514,2,3514,[303 315 272 276 509],894,5,14865,4.229018492176387,20.0,20.0
11515,2,3515,[303 315 272 276 509],537,5,14870,4.229237770193402,20.0,20.0
11516,2,3516,[303 315 272 276 509],537,5,14875,4.229456923514359,20.0,20.0
11517,2,3517,[303 315 272 276 509],13,5,14880,4.229675952245594,20.0,20.0
11518,2,3518,[303 315 272 276 509],13,5,14885,4.229894856493322,20.0,20.0
11519,2,3519,[303 315 272 276 509],894,5,14890,4.230113636363637,20.0,20.0
11520,2,3520,[303 315 272 276 509],13,5,14895,4.230332291962511,20.0,20.0
11521,2,3521,[303 315 272 276 509],894,5,14900,4.230550823395798,20.0,20.0
11522,2,3522,[303 315 272 276 509],13,5,14905,4.230769230769231,20.0,20.0
11523,2,3523,[321 485 202 298 284],378,1,14906,4.229852440408626,0.0,0.0
11524,2,3524,[303 315 272 276 509],13,5,14911,4.230070921985815,20.0,20.0
11525,2,3525,[303 315 272 276 509],537,5,14916,4.230289279636982,20.0,20.0
11526,2,3526,[303 315 272 276 509],537,5,14921,4.230507513467536,20.0,20.0
11527,2,3527,[303 315 272 276 509],894,5,14926,4.230725623582766,20.0,20.0
11528,2,3528,[303 213 276 268 209],6,2,14928,4.230093510909606,0.0,20.0
11529,2,3529,[315 303 272 509 276],894,5,14933,4.230311614730878,20.0,20.0
11530,2,3530,[331 215 429 509 507],13,3,14936,4.2299631832342115,0.0,0.0
11531,2,3531,[315 303 272 509 276],13,5,14941,4.230181200453001,20.0,20.0
11532,2,3532,[315 303 272 509 276],537,5,14946,4.2303990942541745,20.0,20.0
11533,2,3533,[315 303 272 509 276],537,5,14951,4.230616864742501,20.0,20.0
11534,2,3534,[315 303 272 509 276],894,5,14956,4.230834512022631,20.0,20.0
11535,2,3535,[315 303 272 509 276],894,5,14961,4.231052036199095,20.0,20.0
11536,2,3536,[315 303 272 509 276],894,5,14966,4.231269437376308,20.0,20.0
11537,2,3537,[315 303 272 509 276],894,5,14971,4.231486715658564,20.0,20.0
11538,2,3538,[315 303 272 509 276],537,5,14976,4.231703871150042,20.0,20.0
11539,2,3539,[315 303 272 509 276],894,5,14981,4.231920903954802,20.0,20.0
11540,2,3540,[315 303 272 509 276],13,5,14986,4.232137814176786,20.0,20.0
11541,2,3541,[315 303 272 509 276],13,5,14991,4.23235460191982,20.0,20.0
11542,2,3542,[315 303 272 509 276],537,5,14996,4.232571267287609,20.0,20.0
11543,2,3543,[315 303 272 509 276],894,5,15001,4.232787810383747,20.0,20.0
11544,2,3544,[315 303 272 509 276],894,5,15006,4.233004231311707,20.0,20.0
11545,2,3545,[315 303 272 509 276],13,5,15011,4.233220530174845,20.0,20.0
11546,2,3546,[315 303 272 509 276],13,5,15016,4.233436707076403,20.0,20.0
11547,2,3547,[315 303 272 509 276],13,5,15021,4.233652762119504,20.0,20.0
11548,2,3548,[315 303 272 509 276],537,5,15026,4.233868695407157,20.0,20.0
11549,2,3549,[315 303 272 509 276],537,5,15031,4.234084507042254,20.0,20.0
11550,2,3550,[315 303 272 509 276],537,5,15036,4.2343001971275696,20.0,20.0
11551,2,3551,[315 303 272 509 276],13,5,15041,4.2345157657657655,20.0,20.0
11552,2,3552,[315 303 272 509 276],13,5,15046,4.234731213059386,20.0,20.0
11553,2,3553,[315 303 272 509 276],13,5,15051,4.234946539110861,20.0,20.0
11554,2,3554,[315 303 272 509 276],894,5,15056,4.235161744022504,20.0,20.0
11555,2,3555,[315 303 272 509 276],13,5,15061,4.235376827896513,20.0,20.0
11556,2,3556,[315 303 272 509 276],13,5,15066,4.235591790834973,20.0,20.0
11557,2,3557,[315 303 272 509 276],537,5,15071,4.235806632939854,20.0,20.0
11558,2,3558,[315 303 272 509 276],13,5,15076,4.236021354313009,20.0,20.0
11559,2,3559,[315 303 272 509 276],537,5,15081,4.23623595505618,20.0,20.0
11560,2,3560,[344 283 508 250 303],931,4,15085,4.236169615276608,0.0,0.0
11561,2,3561,[315 303 272 509 276],13,5,15090,4.236384053902302,20.0,20.0
11562,2,3562,[315 303 272 509 276],537,5,15095,4.236598372158293,20.0,20.0
11563,2,3563,[261 223 268 241 218],13,2,15097,4.2359708193041525,20.0,0.0
11564,2,3564,[315 303 272 509 276],537,5,15102,4.2361851332398315,20.0,20.0
11565,2,3565,[315 303 272 509 276],894,5,15107,4.236399326977005,20.0,20.0
11566,2,3566,[315 303 272 509 276],13,5,15112,4.236613400616765,20.0,20.0
11567,2,3567,[315 303 272 509 276],537,5,15117,4.23682735426009,20.0,20.0
11568,2,3568,[315 303 272 509 276],13,5,15122,4.237041188007845,20.0,20.0
11569,2,3569,[315 303 272 509 276],13,5,15127,4.237254901960784,20.0,20.0
11570,2,3570,[219 223 290 211 326],13,3,15130,4.236908429011481,20.0,20.0
11571,2,3571,[315 303 272 509 276],537,5,15135,4.237122060470325,20.0,20.0
11572,2,3572,[315 303 272 509 276],894,5,15140,4.237335572348167,20.0,20.0
11573,2,3573,[315 303 272 509 276],13,5,15145,4.2375489647453835,20.0,20.0
11574,2,3574,[315 303 272 509 276],894,5,15150,4.2377622377622375,20.0,20.0
11575,2,3575,[315 303 272 509 276],894,5,15155,4.237975391498882,20.0,20.0
11576,2,3576,[315 303 272 509 276],894,5,15160,4.238188426055354,20.0,20.0
11577,2,3577,[315 303 272 509 276],894,5,15165,4.238401341531582,20.0,20.0
11578,2,3578,[315 303 272 509 276],13,5,15170,4.238614138027382,20.0,20.0
11579,2,3579,[315 303 272 509 276],13,5,15175,4.238826815642458,20.0,20.0
11580,2,3580,[315 303 272 509 276],13,5,15180,4.239039374476404,20.0,20.0
11581,2,3581,[315 303 272 509 276],13,5,15185,4.239251814628699,20.0,20.0
11582,2,3582,[315 303 272 509 276],537,5,15190,4.239464136198716,20.0,20.0
11583,2,3583,[315 303 272 509 276],894,5,15195,4.239676339285714,20.0,20.0
11584,2,3584,[315 303 272 509 276],537,5,15200,4.239888423988843,20.0,20.0
11585,2,3585,[315 303 272 509 276],13,5,15205,4.240100390407139,20.0,20.0
11586,2,3586,[315 303 272 509 276],537,5,15210,4.2403122386395316,20.0,20.0
11587,2,3587,[315 303 272 509 276],894,5,15215,4.240523968784839,20.0,20.0
11588,2,3588,[315 303 272 509 276],13,5,15220,4.240735580941767,20.0,20.0
11589,2,3589,[217 429 223 239 209],650,1,15221,4.23983286908078,20.0,0.0
11590,2,3590,[315 303 272 509 276],894,5,15226,4.24004455583403,20.0,20.0
11591,2,3591,[315 303 272 509 276],894,5,15231,4.240256124721603,20.0,20.0
11592,2,3592,[315 303 272 509 276],537,5,15236,4.240467575841915,20.0,20.0
11593,2,3593,[315 303 272 509 276],894,5,15241,4.240678909293266,20.0,20.0
11594,2,3594,[315 303 272 509 276],537,5,15246,4.240890125173853,20.0,20.0
11595,2,3595,[315 303 272 509 276],537,5,15251,4.241101223581757,20.0,20.0
11596,2,3596,[315 303 272 509 276],894,5,15256,4.241312204614957,20.0,20.0
11597,2,3597,[315 303 272 509 276],894,5,15261,4.241523068371317,20.0,20.0
11598,2,3598,[315 303 272 509 276],894,5,15266,4.241733814948597,20.0,20.0
11599,2,3599,[315 303 272 509 276],894,5,15271,4.241944444444444,20.0,20.0
11600,2,3600,[315 303 272 509 276],13,5,15276,4.242154956956401,20.0,20.0
11601,2,3601,[315 303 272 509 276],13,5,15281,4.242365352581899,20.0,20.0
11602,2,3602,[315 303 272 509 276],894,5,15286,4.242575631418263,20.0,20.0
11603,2,3603,[315 303 272 509 276],894,5,15291,4.2427857935627085,20.0,20.0
11604,2,3604,[315 303 272 509 276],13,5,15296,4.242995839112344,20.0,20.0
11605,2,3605,[315 303 272 509 276],13,5,15301,4.243205768164171,20.0,20.0
11606,2,3606,[315 303 272 509 276],894,5,15306,4.243415580815082,20.0,20.0
11607,2,3607,[293 478 211 283 221],474,4,15310,4.243348115299335,0.0,20.0
11608,2,3608,[315 303 272 509 276],894,5,15315,4.243557772236077,20.0,20.0
11609,2,3609,[315 303 272 509 276],537,5,15320,4.243767313019391,20.0,20.0
11610,2,3610,[315 303 272 509 276],13,5,15325,4.243976737745776,20.0,20.0
11611,2,3611,[315 303 272 509 276],894,5,15330,4.244186046511628,20.0,20.0
11612,2,3612,[315 303 272 509 276],537,5,15335,4.24439523941323,20.0,20.0
11613,2,3613,[509 230 367 276 226],308,4,15339,4.244327614831212,0.0,20.0
11614,2,3614,[429 276 295 275 452],308,3,15342,4.243983402489627,0.0,40.0
11615,2,3615,[315 303 272 509 276],537,5,15347,4.244192477876106,20.0,20.0
11616,2,3616,[315 303 272 509 276],13,5,15352,4.244401437655515,20.0,20.0
11617,2,3617,[315 303 272 509 276],13,5,15357,4.244610281923714,20.0,20.0
11618,2,3618,[315 303 272 509 276],537,5,15362,4.244819010776458,20.0,20.0
11619,2,3619,[315 303 272 509 276],894,5,15367,4.245027624309392,20.0,20.0
11620,2,3620,[212 321 268 303 227],13,4,15371,4.244959955813311,0.0,0.0
11621,2,3621,[315 303 272 509 276],894,5,15376,4.245168415240199,20.0,20.0
11622,2,3622,[315 303 272 509 276],13,5,15381,4.245376759591498,20.0,20.0
11623,2,3623,[315 303 272 509 276],13,5,15386,4.245584988962473,20.0,20.0
11624,2,3624,[315 303 272 509 276],894,5,15391,4.245793103448276,20.0,20.0
11625,2,3625,[315 303 272 509 276],537,5,15396,4.246001103143961,20.0,20.0
11626,2,3626,[315 303 272 509 276],894,5,15401,4.246208988144472,20.0,20.0
11627,2,3627,[315 239 481 218 303],13,3,15404,4.245865490628446,20.0,0.0
11628,2,3628,[315 303 272 509 276],13,5,15409,4.2460732984293195,20.0,20.0
11629,2,3629,[315 303 272 509 276],537,5,15414,4.246280991735537,20.0,20.0
11630,2,3630,[315 303 272 509 276],13,5,15419,4.246488570641697,20.0,20.0
11631,2,3631,[315 303 272 509 276],13,5,15424,4.246696035242291,20.0,20.0
11632,2,3632,[315 303 272 509 276],13,5,15429,4.246903385631709,20.0,20.0
11633,2,3633,[315 303 272 509 276],894,5,15434,4.247110621904238,20.0,20.0
11634,2,3634,[315 303 272 509 276],894,5,15439,4.247317744154058,20.0,20.0
11635,2,3635,[315 303 272 509 276],894,5,15444,4.247524752475248,20.0,20.0
11636,2,3636,[315 303 272 509 276],894,5,15449,4.247731646961782,20.0,20.0
11637,2,3637,[246 275 219 301 217],145,3,15452,4.247388675096206,0.0,20.0
11638,2,3638,[315 303 272 509 276],13,5,15457,4.247595493267381,20.0,20.0
11639,2,3639,[315 303 272 509 276],894,5,15462,4.247802197802198,20.0,20.0
11640,2,3640,[315 303 272 509 276],894,5,15467,4.248008788794287,20.0,20.0
11641,2,3641,[315 303 272 509 276],13,5,15472,4.248215266337177,20.0,20.0
11642,2,3642,[315 303 272 509 276],894,5,15477,4.248421630524293,20.0,20.0
11643,2,3643,[315 303 272 509 276],13,5,15482,4.248627881448957,20.0,20.0
11644,2,3644,[315 303 272 509 276],537,5,15487,4.24883401920439,20.0,20.0
11645,2,3645,[315 303 272 509 276],894,5,15492,4.249040043883708,20.0,20.0
11646,2,3646,[315 303 272 509 276],894,5,15497,4.249245955579929,20.0,20.0
11647,2,3647,[315 303 272 509 276],894,5,15502,4.249451754385965,20.0,20.0
11648,2,3648,[315 303 272 509 276],894,5,15507,4.249657440394628,20.0,20.0
11649,2,3649,[315 303 272 509 276],537,5,15512,4.24986301369863,20.0,20.0
11650,2,3650,[315 303 272 509 276],894,5,15517,4.250068474390578,20.0,20.0
11651,2,3651,[315 303 272 509 276],13,5,15522,4.2502738225629795,20.0,20.0
11652,2,3652,[315 303 272 509 276],537,5,15527,4.2504790583082395,20.0,20.0
11653,2,3653,[315 303 272 509 276],894,5,15532,4.250684181718665,20.0,20.0
11654,2,3654,[315 303 272 509 276],537,5,15537,4.250889192886457,20.0,20.0
11655,2,3655,[315 303 272 509 276],13,5,15542,4.25109409190372,20.0,20.0
11656,2,3656,[315 303 272 509 276],537,5,15547,4.251298878862456,20.0,20.0
11657,2,3657,[315 303 272 509 276],537,5,15552,4.251503553854565,20.0,20.0
11658,2,3658,[315 303 272 509 276],537,5,15557,4.25170811697185,20.0,20.0
11659,2,3659,[315 303 272 509 276],13,5,15562,4.251912568306011,20.0,20.0
11660,2,3660,[315 303 272 509 276],537,5,15567,4.252116907948648,20.0,20.0
11661,2,3661,[315 303 272 509 276],537,5,15572,4.252321135991262,20.0,20.0
11662,2,3662,[315 303 272 509 276],13,5,15577,4.252525252525253,20.0,20.0
11663,2,3663,[315 303 272 509 276],537,5,15582,4.252729257641922,20.0,20.0
11664,2,3664,[431 216 394 478 231],13,1,15583,4.251841746248295,0.0,0.0
11665,2,3665,[315 303 272 509 276],894,5,15588,4.252045826513911,20.0,20.0
11666,2,3666,[315 303 272 509 276],13,5,15593,4.252249795473139,20.0,20.0
11667,2,3667,[315 303 272 509 276],13,5,15598,4.252453653217012,20.0,20.0
11668,2,3668,[315 303 272 509 276],894,5,15603,4.252657399836468,20.0,20.0
11669,2,3669,[315 303 272 509 276],894,5,15608,4.2528610354223435,20.0,20.0
11670,2,3670,[230 583 226 481 485],7,3,15611,4.252519749387088,0.0,0.0
11671,2,3671,[315 303 272 509 276],13,5,15616,4.252723311546841,20.0,20.0
11672,2,3672,[315 303 272 509 276],537,5,15621,4.252926762864144,20.0,20.0
11673,2,3673,[315 303 272 509 276],537,5,15626,4.253130103429505,20.0,20.0
11674,2,3674,[315 303 272 509 276],537,5,15631,4.253333333333333,20.0,20.0
11675,2,3675,[315 303 272 509 276],13,5,15636,4.253536452665942,20.0,20.0
11676,2,3676,[315 303 272 509 276],894,5,15641,4.253739461517542,20.0,20.0
11677,2,3677,[315 303 272 509 276],537,5,15646,4.253942359978249,20.0,20.0
11678,2,3678,[315 303 272 509 276],537,5,15651,4.254145148138081,20.0,20.0
11679,2,3679,[315 303 272 509 276],13,5,15656,4.254347826086956,20.0,20.0
11680,2,3680,[315 303 272 509 276],537,5,15661,4.254550393914697,20.0,20.0
11681,2,3681,[315 303 272 509 276],13,5,15666,4.254752851711027,20.0,20.0
11682,2,3682,[315 303 272 509 276],537,5,15671,4.254955199565572,20.0,20.0
11683,2,3683,[315 303 272 509 276],537,5,15676,4.255157437567861,20.0,20.0
11684,2,3684,[315 303 272 509 276],537,5,15681,4.255359565807327,20.0,20.0
11685,2,3685,[315 303 272 509 276],894,5,15686,4.255561584373305,20.0,20.0
11686,2,3686,[315 303 272 509 276],537,5,15691,4.2557634933550315,20.0,20.0
11687,2,3687,[315 303 272 509 276],13,5,15696,4.2559652928416485,20.0,20.0
11688,2,3688,[315 303 272 509 276],537,5,15701,4.256166982922201,20.0,20.0
11689,2,3689,[315 303 272 509 276],894,5,15706,4.256368563685637,20.0,20.0
11690,2,3690,[315 303 272 509 276],13,5,15711,4.256570035220808,20.0,20.0
11691,2,3691,[315 303 272 509 276],537,5,15716,4.256771397616468,20.0,20.0
11692,2,3692,[315 303 272 509 276],537,5,15721,4.256972650961278,20.0,20.0
11693,2,3693,[315 303 272 509 276],537,5,15726,4.2571737953438005,20.0,20.0
11694,2,3694,[315 303 272 509 276],894,5,15731,4.257374830852504,20.0,20.0
11695,2,3695,[315 303 272 509 276],894,5,15736,4.257575757575758,20.0,20.0
11696,2,3696,[315 303 272 509 276],894,5,15741,4.25777657560184,20.0,20.0
11697,2,3697,[315 303 272 509 276],894,5,15746,4.257977285018929,20.0,20.0
11698,2,3698,[315 303 272 509 276],537,5,15751,4.258177885915112,20.0,20.0
11699,2,3699,[315 303 272 509 276],13,5,15756,4.258378378378378,20.0,20.0
11700,2,3700,[315 303 272 509 276],13,5,15761,4.258578762496622,20.0,20.0
11701,2,3701,[315 303 272 509 276],13,5,15766,4.258779038357645,20.0,20.0
11702,2,3702,[315 303 272 509 276],537,5,15771,4.258979206049149,20.0,20.0
11703,2,3703,[315 303 272 509 276],537,5,15776,4.259179265658747,20.0,20.0
11704,2,3704,[255 378 272 508 215],184,4,15780,4.2591093117408905,0.0,0.0
11705,2,3705,[315 303 272 509 276],13,5,15785,4.259309228278467,20.0,20.0
11706,2,3706,[315 303 272 509 276],13,5,15790,4.259509036957108,20.0,20.0
11707,2,3707,[315 303 272 509 276],537,5,15795,4.259708737864078,20.0,20.0
11708,2,3708,[315 303 272 509 276],894,5,15800,4.259908331086546,20.0,20.0
11709,2,3709,[315 303 272 509 276],537,5,15805,4.2601078167115904,20.0,20.0
11710,2,3710,[315 303 272 509 276],894,5,15810,4.260307194826193,20.0,20.0
11711,2,3711,[315 303 272 509 276],537,5,15815,4.260506465517241,20.0,20.0
11712,2,3712,[315 303 272 509 276],537,5,15820,4.260705628871532,20.0,20.0
11713,2,3713,[303 218 431 243 301],13,1,15821,4.2598276790522345,0.0,0.0
11714,2,3714,[315 303 272 509 276],13,5,15826,4.2600269179004036,20.0,20.0
11715,2,3715,[315 303 272 509 276],894,5,15831,4.260226049515608,20.0,20.0
11716,2,3716,[315 303 272 509 276],13,5,15836,4.260425073984396,20.0,20.0
11717,2,3717,[315 303 272 509 276],537,5,15841,4.2606239913932225,20.0,20.0
11718,2,3718,[315 303 272 509 276],13,5,15846,4.260822801828448,20.0,20.0
11719,2,3719,[315 303 272 509 276],13,5,15851,4.261021505376344,20.0,20.0
11720,2,3720,[315 303 272 509 276],13,5,15856,4.261220102123085,20.0,20.0
11721,2,3721,[315 303 272 509 276],537,5,15861,4.261418592154755,20.0,20.0
11722,2,3722,[315 303 272 509 276],537,5,15866,4.261616975557346,20.0,20.0
11723,2,3723,[315 303 272 509 276],13,5,15871,4.261815252416756,20.0,20.0
11724,2,3724,[315 303 272 509 276],537,5,15876,4.262013422818792,20.0,20.0
11725,2,3725,[315 303 272 509 276],13,5,15881,4.262211486849168,20.0,20.0
11726,2,3726,[315 303 272 509 276],537,5,15886,4.262409444593507,20.0,20.0
11727,2,3727,[315 303 272 509 276],894,5,15891,4.262607296137339,20.0,20.0
11728,2,3728,[315 303 272 509 276],537,5,15896,4.262805041566104,20.0,20.0
11729,2,3729,[315 303 272 509 276],537,5,15901,4.263002680965148,20.0,20.0
11730,2,3730,[315 303 272 509 276],13,5,15906,4.263200214419727,20.0,20.0
11731,2,3731,[507 290 216 231 485],13,1,15907,4.262325830653805,0.0,0.0
11732,2,3732,[315 303 272 509 276],13,5,15912,4.262523439592821,20.0,20.0
11733,2,3733,[315 303 272 509 276],537,5,15917,4.262720942688806,20.0,20.0
11734,2,3734,[315 303 272 509 276],537,5,15922,4.262918340026774,20.0,20.0
11735,2,3735,[315 303 272 509 276],894,5,15927,4.263115631691649,20.0,20.0
11736,2,3736,[315 303 272 509 276],894,5,15932,4.263312817768263,20.0,20.0
11737,2,3737,[315 303 272 509 276],537,5,15937,4.263509898341359,20.0,20.0
11738,2,3738,[315 303 272 509 276],13,5,15942,4.263706873495587,20.0,20.0
11739,2,3739,[315 303 272 509 276],537,5,15947,4.263903743315508,20.0,20.0
11740,2,3740,[315 303 272 509 276],13,5,15952,4.264100507885592,20.0,20.0
11741,2,3741,[315 303 272 509 276],894,5,15957,4.264297167290219,20.0,20.0
11742,2,3742,[429 303 212 392 268],537,2,15959,4.263692225487577,0.0,0.0
11743,2,3743,[315 250 509 293 392],454,3,15962,4.263354700854701,20.0,0.0
11744,2,3744,[315 303 272 276 509],13,5,15967,4.263551401869159,20.0,20.0
11745,2,3745,[315 303 272 276 509],13,5,15972,4.263747997864389,20.0,20.0
11746,2,3746,[315 303 272 276 509],537,5,15977,4.263944488924473,20.0,20.0
11747,2,3747,[315 303 272 276 509],13,5,15982,4.264140875133404,20.0,20.0
11748,2,3748,[315 303 272 276 509],537,5,15987,4.2643371565750865,20.0,20.0
11749,2,3749,[315 303 272 276 509],13,5,15992,4.2645333333333335,20.0,20.0
11750,2,3750,[315 303 272 276 509],894,5,15997,4.2647294054918685,20.0,20.0
11751,2,3751,[315 303 272 276 509],13,5,16002,4.264925373134329,20.0,20.0
11752,2,3752,[315 303 272 276 509],13,5,16007,4.265121236344258,20.0,20.0
11753,2,3753,[315 303 272 276 509],13,5,16012,4.265316995205114,20.0,20.0
11754,2,3754,[315 303 272 276 509],894,5,16017,4.265512649800266,20.0,20.0
11755,2,3755,[315 303 272 276 509],537,5,16022,4.265708200212993,20.0,20.0
11756,2,3756,[315 303 272 276 509],894,5,16027,4.265903646526484,20.0,20.0
11757,2,3757,[315 303 272 276 509],894,5,16032,4.266098988823843,20.0,20.0
11758,2,3758,[315 303 272 276 509],894,5,16037,4.266294227188082,20.0,20.0
11759,2,3759,[315 303 272 276 509],537,5,16042,4.266489361702128,20.0,20.0
11760,2,3760,[315 303 272 276 509],537,5,16047,4.266684392448817,20.0,20.0
11761,2,3761,[508 293 268 295 429],387,2,16049,4.266081871345029,0.0,0.0
11762,2,3762,[315 303 272 276 509],894,5,16054,4.266276906723359,20.0,20.0
11763,2,3763,[315 303 272 276 509],13,5,16059,4.266471838469713,20.0,20.0
11764,2,3764,[315 303 272 276 509],894,5,16064,4.266666666666667,20.0,20.0
11765,2,3765,[315 303 272 276 509],894,5,16069,4.2668613913967075,20.0,20.0
11766,2,3766,[315 303 272 276 509],13,5,16074,4.267056012742235,20.0,20.0
11767,2,3767,[315 303 272 276 509],537,5,16079,4.267250530785563,20.0,20.0
11768,2,3768,[315 303 272 276 509],537,5,16084,4.267444945608915,20.0,20.0
11769,2,3769,[315 303 272 276 509],894,5,16089,4.267639257294429,20.0,20.0
11770,2,3770,[315 303 272 276 509],894,5,16094,4.267833465924158,20.0,20.0
11771,2,3771,[315 303 272 276 509],537,5,16099,4.268027571580063,20.0,20.0
11772,2,3772,[315 303 272 276 509],13,5,16104,4.2682215743440235,20.0,20.0
11773,2,3773,[315 303 272 276 509],13,5,16109,4.268415474297827,20.0,20.0
11774,2,3774,[315 303 272 276 509],537,5,16114,4.268609271523179,20.0,20.0
11775,2,3775,[315 303 272 276 509],13,5,16119,4.268802966101695,20.0,20.0
11776,2,3776,[315 303 272 276 509],13,5,16124,4.268996558114906,20.0,20.0
11777,2,3777,[315 303 272 276 509],13,5,16129,4.269190047644257,20.0,20.0
11778,2,3778,[315 303 272 276 509],894,5,16134,4.269383434771103,20.0,20.0
11779,2,3779,[315 303 272 276 509],894,5,16139,4.26957671957672,20.0,20.0
11780,2,3780,[315 303 272 276 509],894,5,16144,4.269769902142291,20.0,20.0
11781,2,3781,[315 303 272 276 509],894,5,16149,4.269962982548916,20.0,20.0
11782,2,3782,[315 303 272 276 509],13,5,16154,4.27015596087761,20.0,20.0
11783,2,3783,[315 303 272 276 509],537,5,16159,4.270348837209302,20.0,20.0
11784,2,3784,[315 303 272 276 509],13,5,16164,4.270541611624835,20.0,20.0
11785,2,3785,[315 303 272 276 509],13,5,16169,4.270734284204965,20.0,20.0
11786,2,3786,[315 303 272 276 509],13,5,16174,4.270926855030367,20.0,20.0
11787,2,3787,[315 303 272 276 509],894,5,16179,4.271119324181626,20.0,20.0
11788,2,3788,[315 303 272 276 509],537,5,16184,4.271311691739245,20.0,20.0
11789,2,3789,[315 303 272 276 509],894,5,16189,4.271503957783641,20.0,20.0
11790,2,3790,[315 303 272 276 509],13,5,16194,4.271696122395146,20.0,20.0
11791,2,3791,[315 303 272 276 509],13,5,16199,4.271888185654008,20.0,20.0
11792,2,3792,[315 303 272 276 509],537,5,16204,4.2720801476403905,20.0,20.0
11793,2,3793,[315 303 272 276 509],537,5,16209,4.27227200843437,20.0,20.0
11794,2,3794,[315 303 272 276 509],537,5,16214,4.272463768115942,20.0,20.0
11795,2,3795,[509 298 284 250 283],894,2,16216,4.2718651211801895,0.0,0.0
11796,2,3796,[315 303 272 276 509],537,5,16221,4.272056887016065,20.0,20.0
11797,2,3797,[315 303 272 276 509],894,5,16226,4.272248551869405,20.0,20.0
11798,2,3798,[315 303 272 276 509],13,5,16231,4.272440115819952,20.0,20.0
11799,2,3799,[315 303 272 276 509],537,5,16236,4.272631578947369,20.0,20.0
11800,2,3800,[315 303 272 276 509],894,5,16241,4.272822941331229,20.0,20.0
11801,2,3801,[315 303 272 276 509],537,5,16246,4.273014203051026,20.0,20.0
11802,2,3802,[315 303 272 276 509],13,5,16251,4.273205364186169,20.0,20.0
11803,2,3803,[315 303 272 276 509],537,5,16256,4.273396424815983,20.0,20.0
11804,2,3804,[315 303 272 276 509],894,5,16261,4.273587385019711,20.0,20.0
11805,2,3805,[315 303 272 276 509],894,5,16266,4.273778244876511,20.0,20.0
11806,2,3806,[315 303 272 276 509],13,5,16271,4.273969004465458,20.0,20.0
11807,2,3807,[315 303 272 276 509],537,5,16276,4.274159663865547,20.0,20.0
11808,2,3808,[236 298 243 211 215],533,4,16280,4.27408768705697,0.0,20.0
11809,2,3809,[315 303 272 276 509],894,5,16285,4.274278215223097,20.0,20.0
11810,2,3810,[315 303 272 276 509],13,5,16290,4.274468643400683,20.0,20.0
11811,2,3811,[315 303 272 276 509],537,5,16295,4.274658971668416,20.0,20.0
11812,2,3812,[315 303 272 276 509],537,5,16300,4.274849200104904,20.0,20.0
11813,2,3813,[315 303 272 276 509],13,5,16305,4.275039328788673,20.0,20.0
11814,2,3814,[315 303 272 276 509],894,5,16310,4.275229357798165,20.0,20.0
11815,2,3815,[300 293 413 241 230],774,1,16311,4.27437106918239,0.0,20.0
11816,2,3816,[315 303 272 276 509],537,5,16316,4.27456117369662,20.0,20.0
11817,2,3817,[315 303 272 276 509],13,5,16321,4.274751178627554,20.0,20.0
11818,2,3818,[315 303 272 276 509],894,5,16326,4.274941084053417,20.0,20.0
11819,2,3819,[315 303 272 276 509],894,5,16331,4.275130890052356,20.0,20.0
11820,2,3820,[315 303 272 276 509],537,5,16336,4.275320596702434,20.0,20.0
11821,2,3821,[315 303 272 276 509],13,5,16341,4.275510204081633,20.0,20.0
11822,2,3822,[315 303 272 276 509],537,5,16346,4.275699712267852,20.0,20.0
11823,2,3823,[315 303 272 276 509],894,5,16351,4.2758891213389125,20.0,20.0
11824,2,3824,[315 303 272 276 509],13,5,16356,4.276078431372549,20.0,20.0
11825,2,3825,[315 303 272 276 509],894,5,16361,4.276267642446419,20.0,20.0
11826,2,3826,[315 303 272 276 509],537,5,16366,4.276456754638097,20.0,20.0
11827,2,3827,[315 303 272 276 509],537,5,16371,4.2766457680250785,20.0,20.0
11828,2,3828,[315 303 272 276 509],894,5,16376,4.2768346826847745,20.0,20.0
11829,2,3829,[315 303 272 276 509],13,5,16381,4.277023498694517,20.0,20.0
11830,2,3830,[315 303 272 276 509],13,5,16386,4.277212216131558,20.0,20.0
11831,2,3831,[315 303 272 276 509],894,5,16391,4.277400835073069,20.0,20.0
11832,2,3832,[226 259 276 291 301],234,0,16391,4.276284894338638,0.0,20.0
11833,2,3833,[315 303 272 509 276],13,5,16396,4.276473656755347,20.0,20.0
11834,2,3834,[315 303 272 509 276],894,5,16401,4.276662320730117,20.0,20.0
11835,2,3835,[315 303 272 509 276],537,5,16406,4.276850886339937,20.0,20.0
11836,2,3836,[315 303 272 509 276],894,5,16411,4.277039353661715,20.0,20.0
11837,2,3837,[315 303 272 509 276],537,5,16416,4.2772277227722775,20.0,20.0
11838,2,3838,[315 303 272 509 276],537,5,16421,4.277415993748372,20.0,20.0
11839,2,3839,[315 303 272 509 276],13,5,16426,4.277604166666666,20.0,20.0
11840,2,3840,[315 303 272 509 276],13,5,16431,4.277792241603749,20.0,20.0
11841,2,3841,[315 303 272 509 276],537,5,16436,4.277980218636127,20.0,20.0
11842,2,3842,[315 303 272 509 276],537,5,16441,4.278168097840229,20.0,20.0
11843,2,3843,[315 303 272 509 276],537,5,16446,4.278355879292404,20.0,20.0
11844,2,3844,[211 507 230 413 241],13,1,16447,4.277503250975292,0.0,20.0
11845,2,3845,[315 303 272 509 276],894,5,16452,4.277691107644306,20.0,20.0
11846,2,3846,[315 303 272 509 276],894,5,16457,4.2778788666493375,20.0,20.0
11847,2,3847,[315 303 272 509 276],537,5,16462,4.278066528066528,20.0,20.0
11848,2,3848,[315 303 272 509 276],13,5,16467,4.278254091971941,20.0,20.0
11849,2,3849,[315 303 272 509 276],537,5,16472,4.278441558441559,20.0,20.0
11850,2,3850,[429 226 208 241 230],387,0,16472,4.277330563490002,0.0,0.0
11851,2,3851,[315 303 272 509 276],537,5,16477,4.277518172377985,20.0,20.0
11852,2,3852,[315 303 272 509 276],537,5,16482,4.277705683882689,20.0,20.0
11853,2,3853,[315 303 272 509 276],894,5,16487,4.277893098079917,20.0,20.0
11854,2,3854,[315 303 272 509 276],537,5,16492,4.2780804150453955,20.0,20.0
11855,2,3855,[315 303 272 509 276],894,5,16497,4.278267634854772,20.0,20.0
11856,2,3856,[315 303 272 509 276],894,5,16502,4.2784547575836145,20.0,20.0
11857,2,3857,[315 303 272 509 276],537,5,16507,4.278641783307413,20.0,20.0
11858,2,3858,[315 303 272 509 276],13,5,16512,4.278828712101581,20.0,20.0
11859,2,3859,[315 303 272 509 276],537,5,16517,4.27901554404145,20.0,20.0
11860,2,3860,[315 303 272 509 276],537,5,16522,4.279202279202279,20.0,20.0
11861,2,3861,[315 303 272 509 276],894,5,16527,4.279388917659244,20.0,20.0
11862,2,3862,[315 303 272 509 276],537,5,16532,4.279575459487445,20.0,20.0
11863,2,3863,[315 303 272 509 276],537,5,16537,4.279761904761905,20.0,20.0
11864,2,3864,[413 216 227 209 231],13,1,16538,4.278913324708927,0.0,0.0
11865,2,3865,[259 213 299 243 275],537,2,16540,4.278323848939472,0.0,20.0
11866,2,3866,[315 303 272 509 276],537,5,16545,4.278510473235066,20.0,20.0
11867,2,3867,[315 303 272 509 276],537,5,16550,4.278697001034126,20.0,20.0
11868,2,3868,[315 303 272 509 276],537,5,16555,4.278883432411476,20.0,20.0
11869,2,3869,[315 303 272 509 276],13,5,16560,4.27906976744186,20.0,20.0
11870,2,3870,[315 303 272 509 276],537,5,16565,4.279256006199948,20.0,20.0
11871,2,3871,[315 303 272 509 276],537,5,16570,4.279442148760331,20.0,20.0
11872,2,3872,[315 303 272 509 276],894,5,16575,4.279628195197521,20.0,20.0
11873,2,3873,[315 303 272 509 276],537,5,16580,4.2798141455859575,20.0,20.0
11874,2,3874,[315 303 272 509 276],537,5,16585,4.28,20.0,20.0
11875,2,3875,[315 303 272 509 276],894,5,16590,4.280185758513932,20.0,20.0
11876,2,3876,[315 303 272 509 276],894,5,16595,4.28037142120196,20.0,20.0
11877,2,3877,[315 303 272 509 276],13,5,16600,4.2805569881382155,20.0,20.0
11878,2,3878,[315 303 272 509 276],13,5,16605,4.280742459396752,20.0,20.0
11879,2,3879,[315 303 272 509 276],894,5,16610,4.280927835051546,20.0,20.0
11880,2,3880,[255 264 316 284 275],548,3,16613,4.280597784076269,20.0,20.0
11881,2,3881,[315 303 272 509 276],894,5,16618,4.280783101494075,20.0,20.0
11882,2,3882,[315 303 272 509 276],894,5,16623,4.2809683234612415,20.0,20.0
11883,2,3883,[315 303 272 509 276],894,5,16628,4.281153450051494,20.0,20.0
11884,2,3884,[315 303 272 509 276],894,5,16633,4.281338481338481,20.0,20.0
11885,2,3885,[315 303 272 509 276],894,5,16638,4.28152341739578,20.0,20.0
11886,2,3886,[429 290 303 350 215],13,4,16642,4.2814509904810905,0.0,0.0
11887,2,3887,[315 303 272 509 276],537,5,16647,4.281635802469136,20.0,20.0
11888,2,3888,[315 303 272 509 276],13,5,16652,4.281820519413731,20.0,20.0
11889,2,3889,[315 303 272 509 276],894,5,16657,4.282005141388175,20.0,20.0
11890,2,3890,[315 303 272 509 276],13,5,16662,4.28218966846569,20.0,20.0
11891,2,3891,[315 303 272 509 276],894,5,16667,4.282374100719425,20.0,20.0
11892,2,3892,[250 202 300 298 295],479,2,16669,4.281787824300026,0.0,20.0
11893,2,3893,[315 303 272 509 276],13,5,16674,4.2819722650231125,20.0,20.0
11894,2,3894,[315 303 272 509 276],13,5,16679,4.282156611039794,20.0,20.0
11895,2,3895,[315 303 272 509 276],537,5,16684,4.282340862422998,20.0,20.0
11896,2,3896,[315 303 272 509 276],13,5,16689,4.282525019245574,20.0,20.0
11897,2,3897,[315 303 272 509 276],894,5,16694,4.282709081580298,20.0,20.0
11898,2,3898,[280 215 240 326 298],749,4,16698,4.28263657348038,0.0,0.0
11899,2,3899,[315 303 272 509 276],537,5,16703,4.282820512820513,20.0,20.0
11900,2,3900,[315 303 272 509 276],894,5,16708,4.28300435785696,20.0,20.0
11901,2,3901,[315 303 272 509 276],894,5,16713,4.283188108662224,20.0,20.0
11902,2,3902,[315 303 272 509 276],894,5,16718,4.283371765308737,20.0,20.0
11903,2,3903,[315 303 272 509 276],537,5,16723,4.283555327868853,20.0,20.0
11904,2,3904,[315 303 272 509 276],537,5,16728,4.283738796414853,20.0,20.0
11905,2,3905,[315 303 272 509 276],13,5,16733,4.283922171018945,20.0,20.0
11906,2,3906,[315 303 272 509 276],894,5,16738,4.2841054517532635,20.0,20.0
11907,2,3907,[315 303 272 509 276],894,5,16743,4.284288638689867,20.0,20.0
11908,2,3908,[315 303 272 509 276],537,5,16748,4.284471731900742,20.0,20.0
11909,2,3909,[315 303 272 509 276],13,5,16753,4.284654731457801,20.0,20.0
11910,2,3910,[264 215 331 226 394],13,3,16756,4.284326259268729,0.0,0.0
11911,2,3911,[315 303 272 509 276],537,5,16761,4.284509202453988,20.0,20.0
11912,2,3912,[315 303 272 509 276],894,5,16766,4.284692052133913,20.0,20.0
11913,2,3913,[272 509 201 216 209],537,3,16769,4.284363822176801,0.0,0.0
11914,2,3914,[223 227 243 216 218],13,2,16771,4.283780332056194,20.0,0.0
11915,2,3915,[315 303 272 509 276],537,5,16776,4.2839632277834525,20.0,20.0
11916,2,3916,[315 303 272 509 276],894,5,16781,4.284146030125096,20.0,20.0
11917,2,3917,[315 303 272 509 276],537,5,16786,4.284328739152629,20.0,20.0
11918,2,3918,[315 303 272 509 276],13,5,16791,4.284511354937484,20.0,20.0
11919,2,3919,[315 303 272 509 276],537,5,16796,4.28469387755102,20.0,20.0
11920,2,3920,[315 303 272 509 276],13,5,16801,4.284876307064525,20.0,20.0
11921,2,3921,[315 303 272 509 276],894,5,16806,4.28505864354921,20.0,20.0
11922,2,3922,[315 303 272 509 276],537,5,16811,4.285240887076217,20.0,20.0
11923,2,3923,[315 303 272 509 276],13,5,16816,4.285423037716615,20.0,20.0
11924,2,3924,[315 303 272 509 276],13,5,16821,4.285605095541401,20.0,20.0
11925,2,3925,[315 303 272 509 276],13,5,16826,4.285787060621498,20.0,20.0
11926,2,3926,[315 303 272 509 276],13,5,16831,4.285968933027757,20.0,20.0
11927,2,3927,[315 303 272 509 276],13,5,16836,4.286150712830957,20.0,20.0
11928,2,3928,[315 303 272 509 276],537,5,16841,4.2863324001018075,20.0,20.0
11929,2,3929,[315 303 272 509 276],894,5,16846,4.286513994910941,20.0,20.0
11930,2,3930,[315 303 272 509 276],537,5,16851,4.286695497328924,20.0,20.0
11931,2,3931,[272 301 367 290 316],650,1,16852,4.285859613428281,20.0,0.0
11932,2,3932,[315 303 272 509 276],894,5,16857,4.28604118993135,20.0,20.0
11933,2,3933,[315 303 272 509 276],537,5,16862,4.28622267412303,20.0,20.0
11934,2,3934,[315 303 272 509 276],894,5,16867,4.286404066073698,20.0,20.0
11935,2,3935,[315 303 272 509 276],894,5,16872,4.286585365853658,20.0,20.0
11936,2,3936,[300 250 315 276 218],334,2,16874,4.286004572009144,20.0,40.0
11937,2,3937,[315 303 272 509 276],537,5,16879,4.286185881157948,20.0,20.0
11938,2,3938,[276 215 429 283 244],271,3,16882,4.285859355166286,0.0,20.0
11939,2,3939,[315 303 272 509 276],13,5,16887,4.286040609137056,20.0,20.0
11940,2,3940,[315 303 272 509 276],537,5,16892,4.28622177112408,20.0,20.0
11941,2,3941,[452 208 420 295 226],308,2,16894,4.285641806189751,0.0,0.0
11942,2,3942,[315 303 272 509 276],894,5,16899,4.285822977428354,20.0,20.0
11943,2,3943,[315 303 272 509 276],894,5,16904,4.286004056795131,20.0,20.0
11944,2,3944,[315 303 272 509 276],537,5,16909,4.286185044359949,20.0,20.0
11945,2,3945,[315 303 272 509 276],537,5,16914,4.2863659401926,20.0,20.0
11946,2,3946,[231 507 218 208 239],650,2,16916,4.2857866734228525,0.0,0.0
11947,2,3947,[315 303 272 509 276],13,5,16921,4.28596757852077,20.0,20.0
11948,2,3948,[315 303 272 509 276],894,5,16926,4.286148391997974,20.0,20.0
11949,2,3949,[315 303 272 509 276],894,5,16931,4.286329113924051,20.0,20.0
11950,2,3950,[218 324 208 321 230],387,1,16932,4.285497342444951,0.0,0.0
11951,2,3951,[315 303 272 509 276],537,5,16937,4.285678137651822,20.0,20.0
11952,2,3952,[315 303 272 509 276],894,5,16942,4.285858841386289,20.0,20.0
11953,2,3953,[315 303 272 509 276],537,5,16947,4.286039453717754,20.0,20.0
11954,2,3954,[315 303 272 509 276],894,5,16952,4.28621997471555,20.0,20.0
11955,2,3955,[315 303 272 509 276],13,5,16957,4.286400404448938,20.0,20.0
11956,2,3956,[315 303 272 509 276],537,5,16962,4.286580742987112,20.0,20.0
11957,2,3957,[315 303 272 509 276],13,5,16967,4.286760990399191,20.0,20.0
11958,2,3958,[315 303 272 509 276],537,5,16972,4.286941146754231,20.0,20.0
11959,2,3959,[315 303 272 509 276],13,5,16977,4.287121212121212,20.0,20.0
11960,2,3960,[315 303 272 509 276],13,5,16982,4.2873011865690485,20.0,20.0
11961,2,3961,[315 303 272 509 276],894,5,16987,4.287481070166582,20.0,20.0
11962,2,3962,[315 303 272 509 276],13,5,16992,4.287660862982589,20.0,20.0
11963,2,3963,[315 303 272 509 276],537,5,16997,4.287840565085772,20.0,20.0
11964,2,3964,[315 303 272 509 276],13,5,17002,4.288020176544767,20.0,20.0
11965,2,3965,[315 303 272 509 276],13,5,17007,4.288199697428139,20.0,20.0
11966,2,3966,[315 303 272 509 276],537,5,17012,4.288379127804387,20.0,20.0
11967,2,3967,[315 303 272 509 276],537,5,17017,4.288558467741935,20.0,20.0
11968,2,3968,[220 212 478 241 223],90,5,17022,4.288737717309146,20.0,0.0
11969,2,3969,[315 303 272 509 276],13,5,17027,4.288916876574307,20.0,20.0
11970,2,3970,[315 303 272 509 276],13,5,17032,4.289095945605641,20.0,20.0
11971,2,3971,[315 303 272 509 276],13,5,17037,4.289274924471299,20.0,20.0
11972,2,3972,[223 481 219 218 290],13,2,17039,4.288698716335263,20.0,0.0
11973,2,3973,[315 303 272 509 276],13,5,17044,4.288877705083039,20.0,20.0
11974,2,3974,[315 303 272 509 276],13,5,17049,4.289056603773585,20.0,20.0
11975,2,3975,[315 303 272 509 276],537,5,17054,4.2892354124748495,20.0,20.0
11976,2,3976,[315 303 272 509 276],894,5,17059,4.2894141312547145,20.0,20.0
11977,2,3977,[315 303 272 509 276],13,5,17064,4.289592760180995,20.0,20.0
11978,2,3978,[315 303 272 509 276],13,5,17069,4.289771299321438,20.0,20.0
11979,2,3979,[315 303 272 509 276],13,5,17074,4.289949748743719,20.0,20.0
11980,2,3980,[315 303 272 509 276],537,5,17079,4.290128108515448,20.0,20.0
11981,2,3981,[315 303 272 509 276],537,5,17084,4.290306378704169,20.0,20.0
11982,2,3982,[315 303 272 509 276],13,5,17089,4.2904845593773535,20.0,20.0
11983,2,3983,[315 303 272 509 276],537,5,17094,4.2906626506024095,20.0,20.0
11984,2,3984,[315 303 272 509 276],894,5,17099,4.290840652446675,20.0,20.0
11985,2,3985,[315 303 272 509 276],894,5,17104,4.291018564977421,20.0,20.0
11986,2,3986,[315 303 272 509 276],537,5,17109,4.291196388261851,20.0,20.0
11987,2,3987,[315 303 272 509 276],894,5,17114,4.291374122367102,20.0,20.0
11988,2,3988,[315 303 272 509 276],13,5,17119,4.29155176736024,20.0,20.0
11989,2,3989,[315 303 272 509 276],13,5,17124,4.291729323308271,20.0,20.0
11990,2,3990,[315 303 272 509 276],13,5,17129,4.291906790278126,20.0,20.0
11991,2,3991,[315 303 272 509 276],537,5,17134,4.2920841683366735,20.0,20.0
11992,2,3992,[232 508 299 429 215],13,2,17136,4.291510142749813,0.0,0.0
11993,2,3993,[315 303 272 509 276],13,5,17141,4.291687531296946,20.0,20.0
11994,2,3994,[315 303 272 509 276],894,5,17146,4.291864831038798,20.0,20.0
11995,2,3995,[315 303 272 509 276],537,5,17151,4.292042042042042,20.0,20.0
11996,2,3996,[315 303 272 509 276],13,5,17156,4.29221916437328,20.0,20.0
11997,2,3997,[222 394 212 290 336],13,2,17158,4.291645822911455,0.0,20.0
11998,2,3998,[315 303 272 509 276],13,5,17163,4.291822955738935,20.0,20.0
11999,2,3999,[315 303 272 509 276],537,5,17168,4.292,20.0,20.0
